Rk,Player,Nation,Pos,Squad,Comp,Age,Born,90s,Tkl,TklW,Def 3rd,Mid 3rd,Att 3rd,DribTkl,Att,Tkl%,Lost,Blocks,Sh,Pass,Int,Tkl+Int,Clr,Err,Matches
1,Patrick van Aanholt,NED,DF,Crystal Palace,Premier League,26,1990,24.3,47,32,29,15,3,16,34,47.1,18,24,5,19,47,94,64,2,Matches
2,Rolando Aarons,ENG,"MF,FW",Newcastle Utd,Premier League,21,1995,1.5,4,4,3,1,0,4,6,66.7,2,3,0,3,1,5,0,0,Matches
3,Rolando Aarons,ENG,"MF,FW",Hellas Verona,Serie A,21,1995,5.7,13,8,4,4,5,1,7,14.3,6,3,1,2,2,15,0,0,Matches
4,Ignazio Abate,ITA,DF,Milan,Serie A,30,1986,11.7,20,17,10,9,1,6,11,54.5,5,22,2,20,8,28,29,0,Matches
5,Aymen Abdennour,TUN,DF,Marseille,Ligue 1,27,1989,5.5,7,3,5,2,0,4,7,57.1,3,5,5,0,4,11,20,0,Matches
6,Aly Abeid,MTN,DF,Levante,La Liga,19,1997,0.9,2,1,1,1,0,0,1,0.0,1,1,0,1,3,5,3,0,Matches
7,Mehdi Abeid,ALG,MF,Dijon,Ligue 1,24,1992,13.1,23,15,8,14,1,8,32,25.0,24,11,6,5,18,41,25,2,Matches
8,David Abraham,ARG,DF,Eint Frankfurt,Bundesliga,31,1986,25.6,40,32,29,10,1,27,36,75.0,9,29,15,14,40,80,141,1,Matches
9,Tammy Abraham,ENG,FW,Swansea City,Premier League,19,1997,19.2,10,8,1,7,2,1,13,7.7,12,8,1,7,1,11,11,0,Matches
10,Amir Abrashi,ALB,MF,Freiburg,Bundesliga,27,1990,9.4,35,32,15,18,2,16,23,69.6,7,22,5,17,19,54,20,0,Matches
11,Francesco Acerbi,ITA,DF,Sassuolo,Serie A,29,1988,38.0,51,32,26,22,3,22,36,61.1,14,42,21,21,88,139,255,1,Matches
12,Afriyie Acquah,GHA,MF,Torino,Serie A,25,1992,10.6,8,6,2,6,0,1,7,14.3,6,8,1,7,16,24,10,2,Matches
13,Charlie Adam,SCO,MF,Stoke City,Premier League,31,1985,4.6,9,5,2,5,2,5,17,29.4,12,2,0,2,9,18,11,2,Matches
14,Antonio Adán,ESP,GK,Betis,La Liga,30,1987,30.0,1,0,1,0,0,1,1,100.0,0,1,0,1,0,1,11,2,Matches
15,Aday,ESP,DF,Girona,La Liga,29,1987,20.4,17,15,11,4,2,6,17,35.3,11,19,3,16,25,42,52,1,Matches
16,Khaled Adénon,BEN,DF,Amiens,Ligue 1,32,1985,32.5,38,24,26,12,0,15,32,46.9,17,42,26,16,65,103,221,1,Matches
17,Claud Adjapong,ITA,"DF,FW",Sassuolo,Serie A,19,1998,13.6,35,26,24,5,6,11,13,84.6,2,16,3,13,23,58,37,0,Matches
18,René Adler,GER,GK,Mainz 05,Bundesliga,32,1985,14.0,1,1,1,0,0,1,1,100.0,0,0,0,0,0,1,8,1,Matches
19,Yacine Adli,FRA,FW,Paris S-G,Ligue 1,17,2000,0.1,0,0,0,0,0,0,0,,0,0,0,0,0,0,0,0,Matches
20,Ali Adnan Kadhim,IRQ,"DF,FW",Udinese,Serie A,23,1993,18.6,54,35,35,14,5,29,50,58.0,21,31,6,25,41,95,90,0,Matches
21,Adrián,ESP,GK,West Ham,Premier League,30,1987,19.0,2,1,2,0,0,1,4,25.0,3,1,0,1,0,2,15,1,Matches
22,Aritz Aduriz,ESP,FW,Athletic Club,La Liga,36,1981,23.9,11,8,2,6,3,1,6,16.7,5,6,0,6,3,14,18,0,Matches
23,Ibrahim Afellay,NED,MF,Stoke City,Premier League,31,1986,1.8,3,3,0,3,0,1,2,50.0,1,1,0,1,1,4,1,0,Matches
24,Benik Afobe,COD,FW,Bournemouth,Premier League,24,1993,6.8,4,3,1,2,1,1,6,16.7,5,4,0,4,0,4,6,0,Matches
25,Martin Agirregabiria,ESP,DF,Alavés,La Liga,21,1996,20.3,50,33,31,17,2,32,50,64.0,18,13,7,6,41,91,66,0,Matches
26,Imanol Agirretxe,ESP,FW,Real Sociedad,La Liga,30,1987,2.6,0,0,0,0,0,0,1,0.0,1,0,0,0,0,0,2,0,Matches
27,Sergio Agüero,ARG,FW,Manchester City,Premier League,29,1988,21.8,9,6,2,6,1,2,17,11.8,15,12,1,11,6,15,3,0,Matches
28,Ruben Aguilar,FRA,DF,Montpellier,Ligue 1,24,1993,27.3,91,50,37,41,13,36,71,50.7,35,25,3,22,37,128,90,0,Matches
29,Matías Aguirregaray,URU,DF,Las Palmas,La Liga,28,1989,12.8,26,20,12,12,2,12,32,37.5,20,13,1,12,24,50,25,0,Matches
30,Jean-Eudes Aholou,CIV,MF,Strasbourg,Ligue 1,23,1994,33.4,70,34,32,37,1,17,55,30.9,38,29,7,22,75,145,58,1,Matches
31,Ailton,BRA,"DF,MF",Stuttgart,Bundesliga,22,1995,1.2,8,5,3,5,0,4,8,50.0,4,5,0,5,2,10,5,0,Matches
32,Youssef Aït Bennasser,MAR,MF,Caen,Ligue 1,21,1996,22.7,47,28,17,27,3,15,64,23.4,49,35,2,33,32,79,30,0,Matches
33,Arlind Ajeti,ALB,DF,Crotone,Serie A,23,1993,14.1,42,23,25,14,3,18,30,60.0,12,27,15,12,34,76,82,0,Matches
34,Manuel Akanji,SUI,DF,Dortmund,Bundesliga,22,1995,10.0,22,15,14,8,0,15,17,88.2,2,11,4,7,7,29,43,2,Matches
35,Nathan Aké,NED,DF,Bournemouth,Premier League,22,1995,37.3,53,32,34,16,3,22,40,55.0,18,47,24,23,48,101,246,2,Matches
36,Ager Aketxe,ESP,MF,Athletic Club,La Liga,23,1993,0.4,1,1,1,0,0,1,2,50.0,1,1,0,1,1,2,0,0,Matches
37,Chadrac Akolo,COD,"MF,FW",Stuttgart,Bundesliga,22,1995,12.2,20,14,3,12,5,6,14,42.9,8,19,0,19,5,25,5,0,Matches
38,Kevin Akpoguma,NGA,DF,Hoffenheim,Bundesliga,22,1995,18.8,47,39,29,16,2,24,35,68.6,11,18,4,14,22,69,60,1,Matches
39,David Alaba,AUT,DF,Bayern Munich,Bundesliga,25,1992,17.2,23,14,11,9,3,14,20,70.0,6,21,6,15,10,33,23,0,Matches
40,Lucas Alario,ARG,FW,Leverkusen,Bundesliga,24,1992,17.2,16,10,2,12,2,3,8,37.5,5,17,4,13,4,20,16,0,Matches
41,David Alba,ESP,DF,Getafe,La Liga,18,1999,0.7,1,1,1,0,0,1,1,100.0,0,0,0,0,0,1,7,1,Matches
42,Jordi Alba,ESP,DF,Barcelona,La Liga,28,1989,30.5,63,42,35,22,6,26,52,50.0,26,34,5,29,68,131,67,1,Matches
43,Raúl Albentosa,ESP,DF,La Coruña,La Liga,28,1988,19.4,13,6,9,4,0,7,20,35.0,13,26,19,7,26,39,92,1,Matches
44,Luis Alberto,ESP,"FW,MF",Lazio,Serie A,24,1992,29.7,39,28,8,23,8,10,44,22.7,34,30,2,28,16,55,7,0,Matches
45,Raúl Albiol,ESP,DF,Napoli,Serie A,31,1985,30.5,29,19,15,14,0,13,19,68.4,6,18,13,5,32,61,129,1,Matches
46,Miiko Albornoz,CHI,"DF,MF",Hannover 96,Bundesliga,26,1990,7.8,24,20,17,4,3,11,16,68.8,5,15,2,13,5,29,23,0,Matches
47,Marc Albrighton,ENG,"MF,FW",Leicester City,Premier League,27,1989,28.2,52,33,16,29,7,16,52,30.8,36,32,4,28,27,79,34,0,Matches
48,Paco Alcácer,ESP,"MF,FW",Barcelona,La Liga,23,1993,7.7,4,3,0,2,2,0,6,0.0,6,5,0,5,11,15,3,0,Matches
49,Pedro Alcalá,ESP,DF,Girona,La Liga,28,1989,7.7,9,5,5,4,0,1,3,33.3,2,7,3,4,14,23,41,0,Matches
50,Thiago Alcántara,ESP,"MF,FW",Bayern Munich,Bundesliga,26,1991,13.9,45,35,11,25,9,15,26,57.7,11,22,3,19,27,72,6,1,Matches
51,David Alcibiade,FRA,DF,Nantes,Ligue 1,25,1991,2.3,9,5,5,3,1,2,4,50.0,2,5,3,2,7,16,8,0,Matches
52,Toby Alderweireld,BEL,DF,Tottenham,Premier League,28,1989,13.1,19,13,7,11,1,8,15,53.3,7,11,5,6,4,23,55,0,Matches
53,Steve Aldo One,CMR,DF,La Coruña,La Liga,22,1995,1.0,1,0,0,1,0,0,0,,0,0,0,0,0,1,7,0,Matches
54,Álex Alegría,ESP,FW,Levante,La Liga,24,1992,7.0,8,5,1,3,4,2,6,33.3,4,7,0,7,4,12,9,0,Matches
55,Iván Alejo,ESP,"MF,FW",Eibar,La Liga,22,1995,12.2,20,16,4,9,7,1,10,10.0,9,9,0,9,5,25,1,0,Matches
56,Alexander,ARG,"MF,FW",Leganés,La Liga,28,1988,11.8,14,11,2,11,1,2,12,16.7,10,11,0,11,22,36,4,0,Matches
57,Trent Alexander-Arnold,ENG,DF,Liverpool,Premier League,18,1998,17.5,37,25,23,9,5,22,36,61.1,14,20,5,15,28,65,46,1,Matches
58,Alexis,ESP,DF,Alavés,La Liga,31,1985,24.3,33,24,24,7,2,20,45,44.4,25,28,14,14,30,63,114,3,Matches
59,Alisson,BRA,GK,Roma,Serie A,24,1992,37.0,1,0,1,0,0,0,1,0.0,1,0,0,0,2,3,22,4,Matches
60,Allan,BRA,MF,Napoli,Serie A,26,1991,31.7,107,68,24,65,18,36,104,34.6,68,52,3,49,28,135,16,0,Matches
61,Joe Allen,WAL,MF,Stoke City,Premier League,27,1990,34.9,96,62,41,43,12,27,87,31.0,60,43,9,34,58,154,68,1,Matches
62,Dele Alli,ENG,"MF,FW",Tottenham,Premier League,21,1996,32.9,46,30,15,21,10,8,34,23.5,26,33,7,26,19,65,22,1,Matches
63,Júnior Alonso,PAR,DF,Lille,Ligue 1,24,1993,30.9,58,31,36,22,0,28,50,56.0,22,26,16,10,56,114,153,1,Matches
64,José Alonso Lara,ESP,MF,Sevilla,La Liga,17,2000,0.1,0,0,0,0,0,0,0,,0,0,0,0,0,0,0,0,Matches
65,Marcos Alonso,ESP,"DF,MF",Chelsea,Premier League,26,1990,31.7,51,33,30,18,3,23,44,52.3,21,36,5,31,47,98,76,1,Matches
66,Ricky Álvarez,ARG,MF,Sampdoria,Serie A,29,1988,3.0,4,2,1,3,0,1,4,25.0,3,5,0,5,2,6,3,0,Matches
67,Sergio Álvarez,ESP,GK,Celta Vigo,La Liga,30,1986,16.4,0,0,0,0,0,0,1,0.0,1,1,0,1,0,0,11,1,Matches
68,Yeray Álvarez,ESP,DF,Athletic Club,La Liga,22,1995,7.5,12,7,8,4,0,6,9,66.7,3,8,2,6,11,23,18,0,Matches
69,Dani Alves,BRA,DF,Paris S-G,Ligue 1,34,1983,22.9,80,57,45,27,8,33,58,56.9,25,24,3,21,28,108,21,0,Matches
70,Ibrahim Amadou,FRA,"MF,DF",Lille,Ligue 1,24,1993,26.7,43,29,24,19,0,14,27,51.9,13,30,13,17,41,84,70,3,Matches
71,Eloi Amagat,ESP,MF,Girona,La Liga,32,1985,0.2,0,0,0,0,0,0,1,0.0,1,0,0,0,0,0,0,0,Matches
72,Morgan Amalfitano,FRA,"MF,FW",Rennes,Ligue 1,32,1985,8.3,8,5,3,3,2,2,5,40.0,3,6,0,6,4,12,7,0,Matches
73,Romain Amalfitano,FRA,MF,Dijon,Ligue 1,27,1989,30.0,59,37,18,38,3,25,69,36.2,44,29,7,22,85,144,35,2,Matches
74,Daniel Amartey,GHA,DF,Leicester City,Premier League,22,1994,5.4,8,4,7,1,0,3,7,42.9,4,7,3,4,7,15,21,1,Matches
75,Jordi Amat,IDN,"DF,MF",Betis,La Liga,25,1992,22.7,32,23,15,16,1,11,24,45.8,13,14,4,10,38,70,77,2,Matches
76,Amath,SEN,"MF,FW",Getafe,La Liga,21,1996,31.8,78,53,32,28,18,24,89,27.0,65,36,3,33,33,111,20,0,Matches
77,Jordan Amavi,FRA,DF,Marseille,Ligue 1,23,1994,24.4,52,35,32,12,8,23,56,41.1,33,28,11,17,45,97,86,1,Matches
78,Stephan Ambrosius,GHA,DF,Hamburger SV,Bundesliga,18,1998,0.5,0,0,0,0,0,0,0,,0,2,1,1,1,1,4,0,Matches
79,Kelvin Amian,FRA,DF,Toulouse,Ligue 1,19,1998,35.0,59,43,45,10,4,22,31,71.0,9,25,7,18,45,104,127,1,Matches
80,Nadiem Amiri,GER,MF,Hoffenheim,Bundesliga,20,1996,19.4,39,26,13,21,5,19,42,45.2,23,33,4,29,17,56,7,0,Matches
81,Ethan Ampadu,WAL,DF,Chelsea,Premier League,16,2000,0.1,1,1,0,1,0,0,0,,0,0,0,0,0,1,2,0,Matches
82,Nordin Amrabat,MAR,FW,Watford,Premier League,30,1987,2.2,6,3,1,5,0,1,3,33.3,2,1,0,1,0,6,2,0,Matches
83,Nordin Amrabat,MAR,"FW,MF",Leganés,La Liga,30,1987,18.0,19,10,5,10,4,5,17,29.4,12,13,0,13,5,24,2,0,Matches
84,Jon Ander Serantes,ESP,GK,Leganés,La Liga,27,1989,1.0,0,0,0,0,0,0,0,,0,0,0,0,0,0,0,1,Matches
85,Joachim Andersen,DEN,DF,Sampdoria,Serie A,21,1996,6.1,8,3,6,2,0,4,4,100.0,0,6,4,2,9,17,41,1,Matches
86,Felipe Anderson,BRA,"FW,MF",Lazio,Serie A,24,1993,12.9,34,21,7,11,16,6,35,17.1,29,17,0,17,11,45,8,1,Matches
87,Florin Andone,ROU,FW,La Coruña,La Liga,24,1993,18.2,9,7,4,4,1,4,17,23.5,13,9,2,7,3,12,12,0,Matches
88,Nícolas Andrade,BRA,GK,Hellas Verona,Serie A,29,1988,36.0,2,1,2,0,0,1,4,25.0,3,2,0,2,2,4,16,7,Matches
89,Benjamin André,FRA,MF,Rennes,Ligue 1,26,1990,33.5,93,54,36,50,7,43,113,38.1,70,56,4,52,57,150,96,1,Matches
90,Marco Andreolli,ITA,DF,Cagliari,Serie A,31,1986,20.3,25,17,20,4,1,12,20,60.0,8,24,17,7,30,55,139,0,Matches
91,Yoann Andreu,FRA,DF,Angers,Ligue 1,28,1989,23.0,48,30,40,6,2,16,39,41.0,23,23,5,18,37,85,75,1,Matches
92,Miguel Ángel Guerrero,ESP,FW,Leganés,La Liga,27,1990,16.0,7,5,0,2,5,1,11,9.1,10,11,0,11,9,16,16,0,Matches
93,José Ángel,ESP,DF,Eibar,La Liga,27,1989,27.0,61,44,36,19,6,38,58,65.5,20,31,1,30,38,99,76,0,Matches
94,Miguel Ángel Moyá,ESP,GK,Real Sociedad,La Liga,33,1984,8.5,0,0,0,0,0,0,1,0.0,1,0,0,0,2,2,7,0,Matches
95,Miguel Ángel Rubio,ESP,DF,Getafe,La Liga,19,1998,0.3,0,0,0,0,0,0,0,,0,0,0,0,0,0,1,0,Matches
96,Gabriele Angella,ITA,DF,Udinese,Serie A,28,1989,9.9,15,13,11,3,1,8,11,72.7,3,11,9,2,21,36,66,0,Matches
97,Cristian Ansaldi,ARG,DF,Torino,Serie A,30,1986,20.8,49,33,25,20,4,14,37,37.8,23,23,5,18,20,69,61,0,Matches
98,Luca Antei,ITA,DF,Benevento,Serie A,25,1992,6.6,19,14,12,7,0,6,11,54.5,5,10,8,2,26,45,35,0,Matches
99,Mirco Antenucci,ITA,FW,SPAL,Serie A,32,1984,28.6,16,13,6,8,2,0,21,0.0,21,14,0,14,11,27,15,0,Matches
100,Waldemar Anton,GER,"DF,MF",Hannover 96,Bundesliga,21,1996,25.3,65,49,39,21,5,41,65,63.1,24,56,27,29,39,104,112,3,Matches
101,Luca Antonelli,ITA,"DF,FW",Milan,Serie A,30,1987,1.6,1,1,0,0,1,0,2,0.0,2,1,0,1,1,2,8,0,Matches
102,Michail Antonio,JAM,"FW,MF",West Ham,Premier League,27,1990,15.0,15,9,7,6,2,4,14,28.6,10,14,0,14,13,28,16,0,Matches
103,Mirko Antonucci,ITA,FW,Roma,Serie A,18,1999,0.3,0,0,0,0,0,0,0,,0,0,0,0,0,0,0,0,Matches
104,Vitorino Antunes,POR,DF,Getafe,La Liga,30,1987,31.1,58,44,42,14,2,38,74,51.4,36,31,3,28,58,116,89,1,Matches
105,Dennis Aogo,GER,"MF,DF",Stuttgart,Bundesliga,30,1987,21.7,35,26,17,18,0,14,22,63.6,8,27,3,24,29,64,27,1,Matches
106,Houssem Aouar,ALG,"MF,FW",Lyon,Ligue 1,19,1998,27.0,66,42,22,39,5,20,66,30.3,46,30,0,30,39,105,34,0,Matches
107,Alberto Aquilani,ITA,MF,Las Palmas,La Liga,33,1984,14.4,33,19,13,17,3,11,31,35.5,20,20,4,16,23,56,23,0,Matches
108,Mauro Arambarri,URU,MF,Getafe,La Liga,21,1995,23.6,56,41,19,30,7,14,47,29.8,33,26,3,23,25,81,36,0,Matches
109,Guilherme Arana,BRA,DF,Sevilla,La Liga,20,1997,2.1,4,2,3,1,0,1,1,100.0,0,0,0,0,5,9,8,0,Matches
110,Charles Aránguiz,CHI,MF,Leverkusen,Bundesliga,28,1989,25.6,75,61,17,50,8,33,62,53.2,29,46,5,41,48,123,27,2,Matches
111,Luiz Araújo,BRA,"FW,MF",Lille,Ligue 1,21,1996,22.4,41,31,23,17,1,10,47,21.3,37,24,0,24,16,57,11,1,Matches
112,Sergio Araujo,ARG,"MF,FW",Las Palmas,La Liga,25,1992,0.4,3,2,0,0,3,1,1,100.0,0,0,0,0,0,3,0,0,Matches
113,Anaitz Arbilla,ESP,DF,Eibar,La Liga,30,1987,26.8,38,30,24,12,2,21,40,52.5,19,21,10,11,78,116,108,2,Matches
114,Alphonse Areola,FRA,GK,Paris S-G,Ligue 1,24,1993,34.0,0,0,0,0,0,0,1,0.0,1,0,0,0,0,0,7,4,Matches
115,Scott Arfield,CAN,"MF,FW",Burnley,Premier League,28,1988,14.8,36,26,20,13,3,19,44,43.2,25,22,1,21,11,47,24,0,Matches
116,Samuel Armenteros,SWE,FW,Benevento,Serie A,27,1990,4.8,4,2,1,3,0,0,3,0.0,3,1,1,0,1,5,3,0,Matches
117,Yoël Armougom,FRA,"DF,MF",Caen,Ligue 1,19,1998,1.5,2,1,0,1,1,1,1,100.0,0,1,1,0,1,3,2,1,Matches
118,José Arnaiz,ESP,MF,Barcelona,La Liga,22,1995,0.1,1,1,0,1,0,0,0,,0,0,0,0,0,1,0,0,Matches
119,Marko Arnautović,AUT,"FW,MF",West Ham,Premier League,28,1989,25.7,21,16,9,8,4,7,19,36.8,12,20,3,17,13,34,35,0,Matches
120,Maximilian Arnold,GER,MF,Wolfsburg,Bundesliga,23,1994,27.3,51,41,23,23,5,25,57,43.9,32,31,4,27,28,79,34,0,Matches
121,Jann-Fiete Arp,GER,"FW,MF",Hamburger SV,Bundesliga,17,2000,9.4,7,5,0,3,4,1,7,14.3,6,6,0,6,2,9,7,0,Matches
122,Alejandro Arribas,ESP,DF,La Coruña,La Liga,28,1989,3.0,2,2,1,1,0,1,5,20.0,4,5,3,2,6,8,8,0,Matches
123,Kepa Arrizabalaga,ESP,GK,Athletic Club,La Liga,22,1994,30.0,0,0,0,0,0,0,2,0.0,2,0,0,0,2,2,6,2,Matches
124,Harry Arter,IRL,MF,Bournemouth,Premier League,27,1989,10.7,19,16,10,7,2,6,23,26.1,17,18,5,13,9,28,6,0,Matches
125,Aythami Artiles,ESP,DF,Las Palmas,La Liga,31,1986,2.0,2,2,2,0,0,0,1,0.0,1,2,1,1,2,4,19,0,Matches
126,Kwadwo Asamoah,GHA,DF,Juventus,Serie A,28,1988,17.4,28,21,12,14,2,15,23,65.2,8,11,0,11,18,46,30,0,Matches
127,Takuma Asano,JPN,"FW,MF",Stuttgart,Bundesliga,22,1994,8.0,7,5,3,3,1,2,8,25.0,6,7,0,7,3,10,2,0,Matches
128,Santiago Ascacíbar,ARG,MF,Stuttgart,Bundesliga,20,1997,26.5,91,65,41,43,7,41,74,55.4,33,45,10,35,47,138,38,1,Matches
129,Sergio Asenjo,ESP,GK,Villarreal,La Liga,28,1989,23.0,2,2,2,0,0,1,5,20.0,4,0,0,0,0,2,11,2,Matches
130,Marco Asensio,ESP,"FW,MF",Real Madrid,La Liga,21,1996,20.5,26,17,7,13,6,11,26,42.3,15,15,0,15,9,35,2,0,Matches
131,Iago Aspas,ESP,FW,Celta Vigo,La Liga,29,1987,32.6,26,22,10,10,6,5,34,14.7,29,15,1,14,23,49,11,1,Matches
132,Benoît Assou-Ekotto,CMR,DF,Metz,Ligue 1,33,1984,11.7,12,9,5,6,1,5,15,33.3,10,7,4,3,46,58,21,0,Matches
133,Simon Asta,GER,MF,Augsburg,Bundesliga,16,2001,0.1,2,1,2,0,0,2,2,100.0,0,1,0,1,0,2,0,0,Matches
134,Davide Astori,ITA,DF,Fiorentina,Serie A,30,1987,25.0,47,31,33,13,1,18,29,62.1,11,29,17,12,51,98,131,2,Matches
135,Christian Atsu,GHA,"FW,MF",Newcastle Utd,Premier League,25,1992,19.8,17,16,10,7,0,7,20,35.0,13,35,5,30,13,30,27,1,Matches
136,Pierre-Emerick Aubameyang,GAB,FW,Arsenal,Premier League,28,1989,11.7,5,4,3,2,0,1,7,14.3,6,14,1,13,3,8,7,0,Matches
137,Pierre-Emerick Aubameyang,GAB,FW,Dortmund,Bundesliga,28,1989,15.7,5,5,1,1,3,2,8,25.0,6,16,1,15,3,8,1,0,Matches
138,Jean-Kévin Augustin,FRA,FW,RB Leipzig,Bundesliga,20,1997,14.1,16,11,4,11,1,3,7,42.9,4,17,1,16,4,20,4,0,Matches
139,Ludwig Augustinsson,SWE,"DF,FW",Werder Bremen,Bundesliga,23,1994,28.1,45,34,22,20,3,22,32,68.8,10,25,3,22,39,84,53,0,Matches
140,Yann Aurel Bisseck,GER,"DF,MF",Köln,Bundesliga,16,2000,1.7,2,2,2,0,0,1,1,100.0,0,1,1,0,3,5,8,0,Matches
141,Serge Aurier,CIV,DF,Tottenham,Premier League,24,1992,15.9,48,27,27,13,8,11,31,35.5,20,20,1,19,31,79,54,1,Matches
142,Charlie Austin,ENG,FW,Southampton,Premier League,28,1989,11.5,7,5,1,3,3,3,10,30.0,7,15,3,12,1,8,10,0,Matches
143,Danilo Avelar,BRA,DF,Amiens,Ligue 1,28,1989,19.2,41,33,27,9,5,14,45,31.1,31,16,7,9,37,78,83,1,Matches
144,Felipe Avenatti,URU,FW,Bologna,Serie A,24,1993,5.2,6,4,1,5,0,1,2,50.0,1,7,1,6,1,7,6,0,Matches
145,Durel Avounou,CGO,"DF,MF",Caen,Ligue 1,19,1997,7.2,16,11,6,9,1,5,17,29.4,12,12,1,11,10,26,25,0,Matches
146,Chidozie Awaziem,NGA,DF,Nantes,Ligue 1,20,1997,16.8,43,30,33,10,0,28,40,70.0,12,18,11,7,16,59,97,0,Matches
147,André Ayew,GHA,"MF,FW",West Ham,Premier League,27,1989,9.9,19,14,6,10,3,6,19,31.6,13,5,0,5,4,23,3,0,Matches
148,André Ayew,GHA,"MF,FW",Swansea City,Premier League,27,1989,10.6,15,10,3,10,2,2,13,15.4,11,13,1,12,5,20,8,0,Matches
149,Jordan Ayew,GHA,"FW,MF",Swansea City,Premier League,25,1991,31.7,82,60,20,35,27,15,54,27.8,39,43,3,40,24,106,20,1,Matches
150,Karim Azamoum,FRA,MF,Troyes,Ligue 1,27,1990,25.0,84,57,41,37,6,27,68,39.7,41,30,11,19,26,110,61,3,Matches
151,César Azpilicueta,ESP,DF,Chelsea,Premier League,27,1989,37.0,80,59,47,26,7,27,54,50.0,27,48,22,26,54,134,135,1,Matches
152,Ludovic Baal,GUF,DF,Rennes,Ligue 1,31,1986,12.9,41,27,29,8,4,13,35,37.1,22,13,2,11,15,56,37,1,Matches
153,Khouma Babacar,SEN,FW,Fiorentina,Serie A,24,1993,5.0,4,4,3,0,1,2,4,50.0,2,0,0,0,2,6,5,0,Matches
154,Khouma Babacar,SEN,FW,Sassuolo,Serie A,24,1993,8.3,10,6,2,4,4,2,6,33.3,4,8,0,8,3,13,1,0,Matches
155,Carlos Bacca,COL,FW,Villarreal,La Liga,30,1986,27.7,10,2,2,4,4,1,12,8.3,11,16,1,15,8,18,16,0,Matches
156,Milan Badelj,CRO,MF,Fiorentina,Serie A,28,1989,26.1,71,41,26,38,7,28,71,39.4,43,48,2,46,71,142,52,3,Matches
157,Holger Badstuber,GER,"DF,MF",Stuttgart,Bundesliga,28,1989,24.1,44,32,29,14,1,22,39,56.4,17,27,14,13,41,85,111,4,Matches
158,Dylan Bahamboula,CGO,"FW,MF",Dijon,Ligue 1,22,1995,0.3,0,0,0,0,0,0,0,,0,0,0,0,0,0,0,0,Matches
159,Farès Bahlouli,FRA,"MF,FW",Lille,Ligue 1,22,1995,3.4,10,8,4,3,3,2,7,28.6,5,7,0,7,1,11,1,0,Matches
160,Stéphane Bahoken,CMR,FW,Strasbourg,Ligue 1,25,1992,18.5,16,11,3,8,5,4,22,18.2,18,18,1,17,9,25,1,0,Matches
161,Daniel Baier,GER,MF,Augsburg,Bundesliga,33,1984,28.2,83,62,38,40,5,46,83,55.4,37,26,5,21,57,140,41,1,Matches
162,Leon Bailey,JAM,"FW,DF",Leverkusen,Bundesliga,19,1997,24.6,16,12,7,4,5,8,13,61.5,5,28,0,28,15,31,6,0,Matches
163,Eric Bailly,CIV,DF,Manchester Utd,Premier League,23,1994,11.1,17,10,10,5,2,5,12,41.7,7,11,6,5,25,42,58,1,Matches
164,Leighton Baines,ENG,DF,Everton,Premier League,32,1984,21.2,25,13,18,3,4,9,14,64.3,5,18,6,12,25,50,56,0,Matches
165,Riad Bajić,BIH,"FW,MF",Udinese,Serie A,23,1994,0.9,0,0,0,0,0,0,0,,0,0,0,0,0,0,3,0,Matches
166,Marvin Bakalorz,GER,MF,Hannover 96,Bundesliga,27,1989,22.8,44,25,19,23,2,22,37,59.5,15,38,7,31,20,64,46,1,Matches
167,Cédric Bakambu,COD,FW,Villarreal,La Liga,26,1991,14.0,10,7,3,6,1,1,7,14.3,6,9,1,8,3,13,27,0,Matches
168,Tiemoué Bakayoko,FRA,MF,Chelsea,Premier League,22,1994,23.6,64,41,25,32,7,16,48,33.3,32,23,6,17,37,101,38,4,Matches
169,Zakaria Bakkali,BEL,"FW,MF",La Coruña,La Liga,21,1996,10.1,12,10,7,4,1,4,14,28.6,10,5,0,5,4,16,6,0,Matches
170,Ridle Baku,GER,MF,Mainz 05,Bundesliga,19,1998,2.6,3,3,1,1,1,0,1,0.0,1,3,0,3,3,6,2,0,Matches
171,Keita Baldé,SEN,"FW,MF",Monaco,Ligue 1,22,1995,16.4,12,8,5,6,1,1,11,9.1,10,10,1,9,6,18,5,0,Matches
172,Sam Baldock,ENG,FW,Brighton,Premier League,28,1989,0.4,0,0,0,0,0,0,0,,0,0,0,0,0,0,0,0,Matches
173,Gareth Bale,WAL,"FW,MF",Real Madrid,La Liga,28,1989,20.0,19,13,7,8,4,3,14,21.4,11,13,1,12,12,31,18,0,Matches
174,Mikel Balenziaga,ESP,DF,Athletic Club,La Liga,29,1988,17.2,34,24,17,13,4,15,27,55.6,12,24,5,19,17,51,61,0,Matches
175,Andrija Balić,CRO,MF,Udinese,Serie A,19,1997,12.0,18,9,5,12,1,8,27,29.6,19,6,3,3,16,34,13,0,Matches
176,Iván Balliu,ALB,DF,Metz,Ligue 1,25,1992,21.7,34,22,22,6,6,12,28,42.9,16,23,9,14,27,61,64,1,Matches
177,Fodé Ballo-Touré,SEN,DF,Lille,Ligue 1,20,1997,22.8,50,36,29,16,5,21,47,44.7,26,27,2,25,28,78,47,1,Matches
178,Florent Balmont,FRA,MF,Dijon,Ligue 1,37,1980,9.6,14,9,4,9,1,4,25,16.0,21,15,1,14,8,22,5,0,Matches
179,Leon Balogun,NGA,DF,Mainz 05,Bundesliga,29,1988,13.0,39,32,27,11,1,22,31,71.0,9,21,9,12,32,71,64,0,Matches
180,Mario Balotelli,ITA,FW,Nice,Ligue 1,26,1990,25.2,7,4,1,3,3,0,6,0.0,6,9,2,7,8,15,26,0,Matches
181,Abdoulaye Bamba,CIV,DF,Angers,Ligue 1,27,1990,17.0,29,22,23,6,0,16,30,53.3,14,8,1,7,11,40,52,0,Matches
182,Jonathan Bamba,CIV,FW,Saint-Étienne,Ligue 1,21,1996,28.6,30,21,18,11,1,12,61,19.7,49,30,4,26,19,49,17,0,Matches
183,Yacine Bammou,MAR,"MF,FW",Nantes,Ligue 1,25,1991,8.1,18,11,6,10,2,4,14,28.6,10,16,4,12,6,24,9,0,Matches
184,Éver Banega,ARG,MF,Sevilla,La Liga,29,1988,26.7,71,53,25,37,9,22,63,34.9,41,23,1,22,12,83,17,3,Matches
185,Mattia Bani,ITA,DF,Chievo,Serie A,23,1993,14.6,28,20,22,6,0,11,26,42.3,15,19,10,9,27,55,111,0,Matches
186,Beni Baningime,COD,MF,Everton,Premier League,18,1998,2.2,6,2,1,2,3,0,4,0.0,4,5,1,4,2,8,2,0,Matches
187,Léo Baptistão,BRA,"FW,MF",Espanyol,La Liga,24,1992,29.7,54,34,12,28,14,13,52,25.0,39,22,1,21,23,77,25,0,Matches
188,Sekou Baradji,FRA,MF,Amiens,Ligue 1,33,1984,0.1,0,0,0,0,0,0,0,,0,0,0,0,1,1,0,0,Matches
189,Antonín Barák,CZE,MF,Udinese,Serie A,22,1994,30.1,58,38,22,27,9,21,58,36.2,37,34,2,32,18,76,26,1,Matches
190,Andrea Barberis,ITA,MF,Crotone,Serie A,23,1993,33.7,80,44,33,42,5,16,68,23.5,52,52,5,47,58,138,67,1,Matches
191,Mariano Barbosa,ARG,GK,Villarreal,La Liga,33,1984,12.5,0,0,0,0,0,0,0,,0,0,0,0,1,1,4,0,Matches
192,Enis Bardhi,MKD,MF,Levante,La Liga,22,1995,17.6,39,26,14,16,9,10,38,26.3,28,11,0,11,16,55,7,0,Matches
193,Phil Bardsley,SCO,DF,Burnley,Premier League,32,1985,12.5,17,16,9,7,1,4,11,36.4,7,22,6,16,22,39,77,0,Matches
194,Nicolò Barella,ITA,MF,Cagliari,Serie A,20,1997,32.8,92,69,37,43,12,25,78,32.1,53,48,6,42,45,137,53,0,Matches
195,Philipp Bargfrede,GER,MF,Werder Bremen,Bundesliga,28,1989,20.7,60,45,29,30,1,33,55,60.0,22,35,12,23,47,107,52,0,Matches
196,Ross Barkley,ENG,MF,Chelsea,Premier League,23,1993,1.4,0,0,0,0,0,0,1,0.0,1,3,1,2,0,0,2,0,Matches
197,Aymen Barkok,MAR,"FW,MF",Eint Frankfurt,Bundesliga,19,1998,3.5,11,11,6,4,1,5,7,71.4,2,8,2,6,2,13,3,0,Matches
198,Ashley Barnes,ENG,FW,Burnley,Premier League,27,1989,24.1,21,14,1,14,6,5,29,17.2,24,26,5,21,2,23,19,0,Matches
199,Harvey Barnes,ENG,"MF,FW",Leicester City,Premier League,19,1997,0.1,0,0,0,0,0,0,0,,0,0,0,0,0,0,0,0,Matches
200,Antonio Barragán,ESP,DF,Betis,La Liga,30,1987,26.4,59,42,40,11,8,24,36,66.7,12,22,5,17,24,83,66,0,Matches
201,Antonio Barreca,ITA,DF,Torino,Serie A,22,1995,5.2,9,8,3,5,1,4,4,100.0,0,3,0,3,5,14,16,0,Matches
202,Édgar Barreto,PAR,MF,Sampdoria,Serie A,33,1984,21.8,67,42,23,32,12,18,70,25.7,52,45,2,43,21,88,29,3,Matches
203,Barri,ESP,"MF,FW",Getafe,La Liga,21,1995,1.3,1,0,0,1,0,0,4,0.0,4,1,1,0,1,2,3,0,Matches
204,Musa Barrow,GAM,FW,Atalanta,Serie A,18,1998,4.9,5,2,1,3,1,2,4,50.0,2,2,0,2,1,6,2,0,Matches
205,Gareth Barry,ENG,MF,West Brom,Premier League,36,1981,21.4,35,19,17,14,4,15,45,33.3,30,19,11,8,14,49,34,0,Matches
206,Fin Bartels,GER,FW,Werder Bremen,Bundesliga,30,1987,12.5,12,9,4,3,5,4,12,33.3,8,5,1,4,7,19,1,1,Matches
207,Kyle Bartley,ENG,DF,Swansea City,Premier League,26,1991,2.6,3,2,3,0,0,2,2,100.0,0,6,6,0,4,7,21,0,Matches
208,Marc Bartra,ESP,DF,Betis,La Liga,26,1991,15.8,38,28,30,8,0,21,39,53.8,18,19,10,9,32,70,97,1,Matches
209,Marc Bartra,ESP,DF,Dortmund,Bundesliga,26,1991,9.0,28,19,16,12,0,15,24,62.5,9,14,2,12,28,56,43,1,Matches
210,Andrea Barzagli,ITA,DF,Juventus,Serie A,36,1981,16.1,26,15,14,11,1,9,16,56.3,7,14,7,7,17,43,46,0,Matches
211,Daniele Baselli,ITA,MF,Torino,Serie A,25,1992,28.0,63,33,23,36,4,20,56,35.7,36,29,5,24,57,120,40,1,Matches
212,Nicolas Basin,FRA,DF,Metz,Ligue 1,19,1998,3.5,9,7,5,3,1,4,9,44.4,5,6,3,3,8,17,14,0,Matches
213,Dušan Basta,SRB,DF,Lazio,Serie A,32,1984,8.6,9,7,4,3,2,6,14,42.9,8,10,3,7,13,22,15,0,Matches
214,Gil Bastião Dias,POR,"FW,MF",Fiorentina,Serie A,20,1996,13.2,49,31,28,15,6,19,48,39.6,29,23,0,23,19,68,12,1,Matches
215,Gil Bastião Dias,POR,MF,Monaco,Ligue 1,20,1996,0.1,1,1,0,1,0,0,0,,0,0,0,0,0,1,0,0,Matches
216,Samuel Bastien,COD,MF,Chievo,Serie A,20,1996,15.1,17,13,7,8,2,7,23,30.4,16,23,2,21,18,35,25,0,Matches
217,Borja Bastón,ESP,FW,Málaga,La Liga,24,1992,10.9,9,7,1,6,2,1,13,7.7,12,7,0,7,3,12,5,0,Matches
218,Alessandro Bastoni,ITA,DF,Atalanta,Serie A,18,1999,1.0,2,2,2,0,0,1,1,100.0,0,0,0,0,1,3,3,0,Matches
219,Bastos,ANG,DF,Lazio,Serie A,26,1991,15.6,33,24,19,13,1,19,30,63.3,11,13,8,5,24,57,67,0,Matches
220,Michy Batshuayi,BEL,FW,Chelsea,Premier League,23,1993,4.0,5,4,2,3,0,1,3,33.3,2,0,0,0,1,6,3,0,Matches
221,Michy Batshuayi,BEL,FW,Dortmund,Bundesliga,23,1993,9.3,8,6,1,4,3,2,4,50.0,2,4,0,4,0,8,5,0,Matches
222,Moritz Bauer,AUT,"DF,MF",Stoke City,Premier League,25,1992,14.5,24,17,17,7,0,10,26,38.5,16,9,1,8,12,36,48,0,Matches
223,Robert Bauer,GER,"DF,FW",Werder Bremen,Bundesliga,22,1995,10.6,31,25,21,9,1,15,25,60.0,10,8,2,6,21,52,25,2,Matches
224,Oliver Baumann,GER,GK,Hoffenheim,Bundesliga,27,1990,34.0,0,0,0,0,0,0,2,0.0,2,0,0,0,1,1,15,6,Matches
225,Timo Baumgartl,GER,DF,Stuttgart,Bundesliga,21,1996,29.0,87,71,55,29,3,56,75,74.7,19,50,21,29,34,121,132,1,Matches
226,Julian Baumgartlinger,AUT,"MF,DF",Leverkusen,Bundesliga,29,1988,15.5,47,37,21,21,5,14,29,48.3,15,25,2,23,18,65,23,0,Matches
227,Jon Bautista,ESP,"FW,MF",Real Sociedad,La Liga,22,1995,2.0,0,0,0,0,0,0,1,0.0,1,2,0,2,0,0,0,0,Matches
228,Paul Baysse,FRA,DF,Málaga,La Liga,29,1988,13.8,25,16,21,3,1,10,17,58.8,7,10,6,4,20,45,84,0,Matches
229,Paul Baysse,FRA,DF,Bordeaux,Ligue 1,29,1988,6.3,4,2,3,1,0,1,5,20.0,4,4,3,1,7,11,38,1,Matches
230,Noah Joel Sarenren Bazee,NGA,"FW,MF",Hannover 96,Bundesliga,20,1996,1.3,0,0,0,0,0,0,0,,0,3,0,3,0,0,3,0,Matches
231,Hervé Bazile,HAI,"MF,FW",Caen,Ligue 1,27,1990,9.7,21,15,9,7,5,5,15,33.3,10,22,0,22,15,36,8,0,Matches
232,Riechedly Bazoer,NED,MF,Wolfsburg,Bundesliga,20,1996,6.6,8,7,5,2,1,2,4,50.0,2,2,1,1,8,16,4,1,Matches
233,Enrico Bearzotti,ITA,"DF,FW",Hellas Verona,Serie A,20,1996,4.6,3,2,2,0,1,1,4,25.0,3,3,1,2,4,7,18,0,Matches
234,Claudio Beauvue,GLP,FW,Leganés,La Liga,29,1988,18.6,5,3,2,2,1,1,12,8.3,11,7,0,7,2,7,16,0,Matches
235,Bebé,CPV,"MF,FW",Eibar,La Liga,27,1990,4.1,9,7,1,4,4,3,8,37.5,5,5,0,5,3,12,1,0,Matches
236,Ihlas Bebou,TOG,"MF,FW",Hannover 96,Bundesliga,23,1994,23.8,37,29,15,17,5,14,27,51.9,13,34,3,31,24,61,27,0,Matches
237,Andreas Beck,GER,DF,Stuttgart,Bundesliga,30,1987,21.4,46,29,27,16,3,21,31,67.7,10,32,2,30,19,65,46,1,Matches
238,Henri Bedimo,CMR,"DF,FW",Marseille,Ligue 1,33,1984,0.5,0,0,0,0,0,0,1,0.0,1,0,0,0,1,1,1,0,Matches
239,Jan Bednarek,POL,DF,Southampton,Premier League,21,1996,4.7,6,3,6,0,0,3,6,50.0,3,2,1,1,5,11,27,0,Matches
240,Asmir Begović,BIH,GK,Bournemouth,Premier League,30,1987,38.0,0,0,0,0,0,0,2,0.0,2,0,0,0,2,2,16,7,Matches
241,Valon Behrami,SUI,MF,Udinese,Serie A,32,1985,15.5,63,46,30,27,6,8,44,18.2,36,47,15,32,22,85,19,0,Matches
242,Vid Belec,SVN,GK,Benevento,Serie A,27,1990,12.4,0,0,0,0,0,0,0,,0,0,0,0,1,1,6,1,Matches
243,Vid Belec,SVN,GK,Sampdoria,Serie A,27,1990,2.0,0,0,0,0,0,0,0,,0,0,0,0,0,0,1,0,Matches
244,Ishak Belfodil,ALG,FW,Werder Bremen,Bundesliga,25,1992,15.0,7,6,2,3,2,0,3,0.0,3,10,1,9,1,8,9,0,Matches
245,Stefan Bell,GER,DF,Mainz 05,Bundesliga,25,1991,24.2,36,25,23,13,0,27,39,69.2,12,35,18,17,46,82,123,2,Matches
246,Karim Bellarabi,GER,"MF,FW",Leverkusen,Bundesliga,27,1990,12.7,22,17,10,9,3,10,19,52.6,9,26,1,25,13,35,5,0,Matches
247,Héctor Bellerín,ESP,DF,Arsenal,Premier League,22,1995,33.9,57,43,36,12,9,25,52,48.1,27,42,8,34,23,80,89,4,Matches
248,François Bellugou,FRA,MF,Troyes,Ligue 1,30,1987,24.2,48,33,23,21,4,21,49,42.9,28,20,6,14,28,76,45,0,Matches
249,Andrea Belotti,ITA,FW,Torino,Serie A,23,1993,29.8,32,23,9,15,8,3,30,10.0,27,14,1,13,6,38,19,1,Matches
250,Chaouki Ben Saada,TUN,"FW,MF",Troyes,Ligue 1,33,1984,3.8,11,8,5,3,3,2,11,18.2,9,3,0,3,2,13,3,0,Matches
251,Wissam Ben Yedder,FRA,FW,Sevilla,La Liga,26,1990,18.9,12,8,2,5,5,1,2,50.0,1,10,0,10,5,17,2,0,Matches
252,Diego Benaglio,SUI,GK,Monaco,Ligue 1,33,1983,2.5,0,0,0,0,0,0,0,,0,0,0,0,0,0,0,0,Matches
253,Ahmad Benali,LBY,MF,Crotone,Serie A,25,1992,9.0,19,10,8,10,1,5,27,18.5,22,14,1,13,8,27,15,0,Matches
254,Yohan Benalouane,TUN,DF,Leicester City,Premier League,30,1987,1.0,7,3,6,1,0,4,6,66.7,2,1,1,0,1,8,4,0,Matches
255,Marco Benassi,ITA,"MF,FW",Fiorentina,Serie A,22,1994,30.9,54,38,18,22,14,17,52,32.7,35,52,2,50,28,82,36,0,Matches
256,Medhi Benatia,MAR,DF,Juventus,Serie A,30,1987,19.5,28,21,20,6,2,8,15,53.3,7,18,13,5,43,71,89,1,Matches
257,Lars Bender,GER,"DF,MF",Leverkusen,Bundesliga,28,1989,17.7,63,52,26,32,5,35,53,66.0,18,34,7,27,28,91,40,0,Matches
258,Sven Bender,GER,DF,Leverkusen,Bundesliga,28,1989,26.1,51,37,33,18,0,26,34,76.5,8,49,21,28,50,101,123,1,Matches
259,László Bénes,SVK,MF,Gladbach,Bundesliga,19,1997,0.4,0,0,0,0,0,0,1,0.0,1,2,1,1,1,1,2,0,Matches
260,Nicolas Benezet,FRA,"FW,MF",Guingamp,Ligue 1,26,1991,18.3,38,30,18,16,4,11,37,29.7,26,8,2,6,12,50,7,0,Matches
261,Marcel Benger,GER,MF,Gladbach,Bundesliga,19,1998,0.0,0,0,0,0,0,0,0,,0,0,0,0,0,0,0,0,Matches
262,Walter Benítez,ARG,GK,Nice,Ligue 1,24,1993,28.0,0,0,0,0,0,0,2,0.0,2,0,0,0,0,0,5,3,Matches
263,Charlison Benschop,CUW,"MF,DF",Hannover 96,Bundesliga,27,1989,2.0,4,4,1,3,0,3,8,37.5,5,1,0,1,2,6,2,0,Matches
264,Ramy Bensebaini,ALG,DF,Rennes,Ligue 1,22,1995,26.0,56,39,31,21,4,26,55,47.3,29,24,16,8,37,93,177,1,Matches
265,Nabil Bentaleb,ALG,MF,Schalke 04,Bundesliga,22,1994,11.2,25,22,7,17,1,8,23,34.8,15,18,6,12,23,48,27,2,Matches
266,Rodrigo Bentancur,URU,MF,Juventus,Serie A,20,1997,6.5,18,11,10,7,1,2,16,12.5,14,5,1,4,3,21,14,0,Matches
267,Christian Benteke,BEL,FW,Crystal Palace,Premier League,26,1990,24.9,11,4,3,7,1,2,17,11.8,15,15,3,12,3,14,44,0,Matches
268,Karim Benzema,FRA,FW,Real Madrid,La Liga,29,1987,23.9,14,8,2,6,6,3,20,15.0,17,18,0,18,8,22,19,0,Matches
269,Yassine Benzia,ALG,"MF,FW",Lille,Ligue 1,22,1994,25.4,62,41,21,31,10,17,62,27.4,45,31,4,27,28,90,14,0,Matches
270,Saido Berahino,BDI,FW,Stoke City,Premier League,23,1993,5.5,2,2,0,1,1,0,1,0.0,1,4,1,3,1,3,2,0,Matches
271,Domenico Berardi,ITA,FW,Sassuolo,Serie A,22,1994,25.5,31,17,9,16,6,11,65,16.9,54,23,0,23,17,48,14,1,Matches
272,Yuri Berchiche,ESP,DF,Paris S-G,Ligue 1,27,1990,19.1,39,27,21,11,7,12,25,48.0,13,15,2,13,24,63,53,0,Matches
273,Álex Berenguer,ESP,FW,Torino,Serie A,22,1995,11.6,18,15,7,8,3,5,17,29.4,12,22,3,19,10,28,13,0,Matches
274,Bartosz Bereszyński,POL,DF,Sampdoria,Serie A,25,1992,27.6,63,47,30,28,5,31,53,58.5,22,33,8,25,30,93,98,2,Matches
275,Jóhann Berg Guðmundsson,ISL,MF,Burnley,Premier League,26,1990,31.5,43,27,16,19,8,20,47,42.6,27,21,1,20,34,77,43,0,Matches
276,Markel Bergara,ESP,MF,Getafe,La Liga,31,1986,16.3,35,22,17,17,1,7,25,28.0,18,10,3,7,23,58,20,0,Matches
277,Emil Berggreen,DEN,FW,Mainz 05,Bundesliga,24,1993,7.4,2,2,0,0,2,1,4,25.0,3,7,1,6,1,3,10,0,Matches
278,Robert Berić,SVN,FW,Saint-Étienne,Ligue 1,26,1991,11.6,6,4,1,3,2,1,16,6.3,15,9,1,8,5,11,4,0,Matches
279,Kévin Bérigaud,FRA,"FW,MF",Montpellier,Ligue 1,29,1988,3.0,4,3,1,1,2,2,6,33.3,4,1,0,1,0,4,1,0,Matches
280,Etrit Berisha,ALB,GK,Atalanta,Serie A,28,1989,31.0,1,1,1,0,0,1,1,100.0,0,0,0,0,1,2,5,3,Matches
281,Federico Bernardeschi,ITA,"FW,MF",Juventus,Serie A,23,1994,9.4,8,5,4,3,1,1,7,14.3,6,9,0,9,11,19,18,1,Matches
282,Bernardo,BRA,DF,RB Leipzig,Bundesliga,22,1995,15.0,43,30,18,22,3,29,40,72.5,11,30,6,24,18,61,81,0,Matches
283,Juan Bernat,ESP,"DF,FW",Bayern Munich,Bundesliga,24,1993,9.9,25,19,13,8,4,11,18,61.1,7,11,1,10,10,35,9,1,Matches
284,Andrea Bertolacci,ITA,MF,Genoa,Serie A,26,1991,32.2,85,53,40,38,7,21,63,33.3,42,46,12,34,46,131,37,1,Matches
285,Ryan Bertrand,ENG,DF,Southampton,Premier League,27,1989,34.8,48,35,27,17,4,19,31,61.3,12,28,9,19,44,92,74,0,Matches
286,Muhamed Bešić,BIH,MF,Everton,Premier League,24,1992,0.5,1,1,1,0,0,1,3,33.3,2,2,2,0,0,1,1,0,Matches
287,Daniel Bessa,ITA,"MF,FW",Hellas Verona,Serie A,24,1993,15.4,26,19,9,15,2,8,29,27.6,21,12,2,10,14,40,8,1,Matches
288,Daniel Bessa,ITA,MF,Genoa,Serie A,24,1993,4.9,6,6,2,2,2,0,1,0.0,1,7,0,7,3,9,6,0,Matches
289,Vincent Bessat,FRA,"DF,MF",Caen,Ligue 1,31,1985,17.4,41,27,23,16,2,22,48,45.8,26,19,1,18,18,59,18,0,Matches
290,Quentin Beunardeau,FRA,GK,Metz,Ligue 1,23,1994,0.4,0,0,0,0,0,0,0,,0,0,0,0,0,0,0,0,Matches
291,Matteo Bianchetti,ITA,DF,Hellas Verona,Serie A,24,1993,1.4,3,1,3,0,0,1,3,33.3,2,3,2,1,2,5,8,0,Matches
292,Ermin Bičakčić,BIH,DF,Hoffenheim,Bundesliga,27,1990,6.1,17,15,8,8,1,8,12,66.7,4,4,2,2,9,26,26,0,Matches
293,Pedro Bigas,ESP,DF,Las Palmas,La Liga,26,1990,9.9,14,9,10,4,0,7,13,53.8,6,18,11,7,16,30,41,2,Matches
294,Lucas Biglia,ARG,MF,Milan,Serie A,31,1986,22.7,59,36,28,26,5,22,61,36.1,39,49,12,37,28,87,51,1,Matches
295,Philip Billing,DEN,MF,Huddersfield,Premier League,21,1996,8.5,25,16,11,11,3,8,22,36.4,14,17,1,16,18,43,19,0,Matches
296,Jean-Claude Billong,CMR,DF,Benevento,Serie A,23,1993,3.3,9,7,5,4,0,5,8,62.5,3,4,3,1,6,15,17,0,Matches
297,Davide Biondini,ITA,MF,Sassuolo,Serie A,34,1983,2.3,4,4,2,2,0,1,2,50.0,1,1,0,1,3,7,1,0,Matches
298,Cristiano Biraghi,ITA,DF,Fiorentina,Serie A,24,1992,33.1,74,48,33,32,9,36,58,62.1,22,42,5,37,43,117,103,2,Matches
299,Mame Biram Diouf,SEN,"FW,DF",Stoke City,Premier League,29,1987,28.8,48,36,26,15,7,8,21,38.1,13,22,0,22,14,62,76,1,Matches
300,Davide Biraschi,ITA,DF,Genoa,Serie A,23,1994,20.0,33,25,13,19,1,18,25,72.0,7,19,10,9,38,71,78,0,Matches
301,Valter Birsa,SVN,"MF,FW",Chievo,Serie A,30,1986,27.8,28,14,7,18,3,7,54,13.0,47,22,2,20,24,52,20,1,Matches
302,Milan Biševac,SRB,DF,Metz,Ligue 1,33,1983,7.9,7,5,5,1,1,5,7,71.4,2,2,0,2,5,12,43,0,Matches
303,Yves Bissouma,MLI,"MF,DF",Lille,Ligue 1,20,1996,17.3,67,50,30,32,5,19,39,48.7,20,13,2,11,31,98,31,1,Matches
304,Leonardo Bittencourt,GER,"MF,FW",Köln,Bundesliga,23,1993,17.9,49,42,17,21,11,19,43,44.2,24,26,0,26,17,66,11,1,Matches
305,Albano Bizzarri,ARG,GK,Udinese,Serie A,39,1977,32.0,2,2,2,0,0,2,2,100.0,0,0,0,0,1,3,12,4,Matches
306,Rubén Blanco,ESP,GK,Celta Vigo,La Liga,22,1995,21.6,0,0,0,0,0,0,2,0.0,2,1,0,1,3,3,16,1,Matches
307,Ludovic Blas,FRA,MF,Guingamp,Ligue 1,19,1997,19.9,23,14,10,12,1,7,36,19.4,29,15,3,12,19,42,9,1,Matches
308,Pablo de Blasis,ARG,"FW,MF",Mainz 05,Bundesliga,29,1988,18.4,39,23,19,11,9,16,33,48.5,17,33,0,33,10,49,34,0,Matches
309,Jérémy Blayac,FRA,FW,Strasbourg,Ligue 1,34,1983,10.2,5,3,0,3,2,2,9,22.2,7,7,2,5,1,6,11,0,Matches
310,Alexis Blin,FRA,MF,Toulouse,Ligue 1,20,1996,21.0,57,37,23,30,4,22,69,31.9,47,27,6,21,31,88,31,0,Matches
311,Daley Blind,NED,"DF,MF",Manchester Utd,Premier League,27,1990,4.0,6,4,3,2,1,2,7,28.6,5,3,0,3,7,13,14,0,Matches
312,Danny Blum,GER,"MF,DF",Eint Frankfurt,Bundesliga,26,1991,0.3,0,0,0,0,0,0,0,,0,0,0,0,1,1,0,0,Matches
313,Emmanuel Boateng,GHA,FW,Levante,La Liga,21,1996,14.2,4,3,0,0,4,0,6,0.0,6,8,1,7,5,9,17,0,Matches
314,Jérôme Boateng,GER,DF,Bayern Munich,Bundesliga,28,1988,18.2,26,18,18,7,1,19,32,59.4,13,20,12,8,21,47,52,1,Matches
315,Kevin-Prince Boateng,GHA,"MF,FW",Eint Frankfurt,Bundesliga,30,1987,26.2,34,22,10,22,2,11,36,30.6,25,29,6,23,23,57,43,1,Matches
316,Raúl Bobadilla,PAR,"FW,MF",Gladbach,Bundesliga,30,1987,5.0,7,6,1,3,3,4,8,50.0,4,6,0,6,0,7,1,0,Matches
317,Yann Bodiger,FRA,MF,Toulouse,Ligue 1,22,1995,2.5,3,1,0,3,0,1,6,16.7,5,0,0,0,2,5,3,0,Matches
318,Mathieu Bodmer,FRA,"DF,MF",Amiens,Ligue 1,34,1982,4.4,6,3,5,1,0,5,6,83.3,1,6,3,3,1,7,15,0,Matches
319,Jeremie Boga,CIV,MF,Chelsea,Premier League,20,1997,0.2,0,0,0,0,0,0,0,,0,0,0,0,0,0,0,0,Matches
320,Quentin Boisgard,FRA,MF,Toulouse,Ligue 1,20,1997,2.0,2,2,0,2,0,0,3,0.0,3,2,0,2,0,2,1,0,Matches
321,Yannick Bolasie,COD,FW,Everton,Premier League,28,1989,9.5,8,7,4,1,3,2,7,28.6,5,5,0,5,4,12,8,0,Matches
322,Deian Boldor,ROU,DF,Hellas Verona,Serie A,22,1995,1.0,3,2,3,0,0,2,3,66.7,1,5,2,3,3,6,11,0,Matches
323,Giacomo Bonaventura,ITA,MF,Milan,Serie A,27,1989,28.2,31,20,7,19,5,9,45,20.0,36,31,6,25,33,64,17,0,Matches
324,Federico Bonazzoli,ITA,"FW,DF",SPAL,Serie A,20,1997,2.0,1,0,0,1,0,0,0,,0,3,0,3,0,1,0,0,Matches
325,Federico Bonazzoli,ITA,FW,Sampdoria,Serie A,20,1997,0.3,0,0,0,0,0,0,0,,0,0,0,0,0,0,0,0,Matches
326,Daniele Bonera,ITA,DF,Villarreal,La Liga,36,1981,13.2,16,11,8,7,1,10,15,66.7,5,17,12,5,12,28,72,0,Matches
327,Gaëtan Bong,CMR,DF,Brighton,Premier League,29,1988,24.8,39,32,25,11,3,15,26,57.7,11,24,6,18,40,79,81,1,Matches
328,Kevin Bonifazi,ITA,"DF,MF",Torino,Serie A,21,1996,4.5,11,7,6,5,0,4,6,66.7,2,7,5,2,13,24,15,0,Matches
329,Landry Bonnefoi,FRA,GK,Strasbourg,Ligue 1,33,1983,3.0,0,0,0,0,0,0,0,,0,0,0,0,0,0,2,0,Matches
330,Leonardo Bonucci,ITA,DF,Milan,Serie A,30,1987,34.3,30,21,22,7,1,11,18,61.1,7,31,22,9,51,81,132,0,Matches
331,Wilfried Bony,CIV,FW,Swansea City,Premier League,28,1988,7.9,5,4,2,2,1,1,5,20.0,4,4,1,3,2,7,15,0,Matches
332,Celso Borges,CRC,MF,La Coruña,La Liga,29,1988,25.6,61,39,34,22,5,15,47,31.9,32,39,7,32,34,95,36,0,Matches
333,Fabio Borini,ITA,"DF,FW",Milan,Serie A,26,1991,17.9,38,23,12,18,8,16,37,43.2,21,32,6,26,13,51,43,0,Matches
334,Marco Borriello,ITA,FW,SPAL,Serie A,35,1982,8.6,4,2,2,1,1,0,1,0.0,1,1,0,1,1,5,6,0,Matches
335,Gabriel Boschilia,BRA,"FW,MF",Monaco,Ligue 1,21,1996,0.9,4,1,1,2,1,1,4,25.0,3,1,0,1,0,4,0,0,Matches
336,Ryad Boudebouz,ALG,"MF,FW",Betis,La Liga,27,1990,15.1,32,18,6,21,5,6,26,23.1,20,18,1,17,7,39,8,0,Matches
337,Jean-Christophe Bouet,FRA,GK,Amiens,Ligue 1,34,1983,1.0,0,0,0,0,0,0,0,,0,0,0,0,0,0,0,0,Matches
338,Sofiane Boufal,MAR,"FW,MF",Southampton,Premier League,23,1993,13.5,37,24,12,14,11,12,35,34.3,23,20,1,19,6,43,6,0,Matches
339,Arnold Bouka Moutou,CGO,DF,Dijon,Ligue 1,28,1988,3.7,8,5,6,0,2,6,8,75.0,2,4,1,3,4,12,5,0,Matches
340,Farid Boulaya,ALG,"MF,FW",Metz,Ligue 1,24,1993,2.0,5,1,4,1,0,3,6,50.0,3,1,0,1,1,6,2,0,Matches
341,Yassine Bounou,MAR,GK,Girona,La Liga,26,1991,29.5,1,1,1,0,0,0,2,0.0,2,0,0,0,4,5,14,0,Matches
342,Emmanuel Bourgaud,FRA,"FW,MF",Amiens,Ligue 1,29,1987,6.0,17,11,5,9,3,10,23,43.5,13,5,0,5,6,23,11,0,Matches
343,Benjamin Bourigeaud,FRA,"MF,FW",Rennes,Ligue 1,23,1994,34.5,55,30,18,30,7,20,93,21.5,73,48,4,44,45,100,29,0,Matches
344,Eneko Bóveda,ESP,DF,La Coruña,La Liga,28,1988,7.4,24,16,13,10,1,8,13,61.5,5,18,7,11,16,40,36,2,Matches
345,Eneko Bóveda,ESP,DF,Athletic Club,La Liga,28,1988,5.8,12,11,7,4,1,5,11,45.5,6,3,0,3,14,26,14,0,Matches
346,Lucas Boyé,ARG,FW,Torino,Serie A,21,1996,1.7,9,8,5,3,1,1,3,33.3,2,5,0,5,2,11,2,0,Matches
347,Lucas Boyé,ARG,"FW,MF",Celta Vigo,La Liga,21,1996,3.1,12,8,3,7,2,3,10,30.0,7,5,0,5,6,18,4,0,Matches
348,Robbie Brady,IRL,MF,Burnley,Premier League,25,1992,14.2,32,21,14,17,1,8,28,28.6,20,17,3,14,7,39,29,0,Matches
349,Martin Braithwaite,DEN,FW,Bordeaux,Ligue 1,26,1991,10.2,6,4,0,4,2,1,6,16.7,5,6,2,4,0,6,3,0,Matches
350,Brandon,ESP,"FW,MF",Rennes,Ligue 1,22,1995,4.0,10,9,3,4,3,1,11,9.1,10,11,1,10,5,15,1,0,Matches
351,Julian Brandt,GER,"FW,MF",Leverkusen,Bundesliga,21,1996,25.8,24,18,11,9,4,11,29,37.9,18,23,1,22,16,40,12,1,Matches
352,Darko Brašanac,SRB,"MF,FW",Leganés,La Liga,25,1992,13.4,32,17,11,17,4,13,33,39.4,20,14,3,11,14,46,12,0,Matches
353,Claudio Bravo,CHI,GK,Manchester City,Premier League,34,1983,2.5,0,0,0,0,0,0,1,0.0,1,0,0,0,0,0,0,0,Matches
354,Josip Brekalo,CRO,FW,Wolfsburg,Bundesliga,19,1998,9.7,15,12,6,7,2,6,12,50.0,6,17,0,17,4,19,3,0,Matches
355,Josip Brekalo,CRO,"MF,FW",Stuttgart,Bundesliga,19,1998,8.1,20,12,7,8,5,6,8,75.0,2,8,2,6,3,23,1,0,Matches
356,Jimmy Briand,FRA,FW,Guingamp,Ligue 1,31,1985,35.7,33,21,13,15,5,4,42,9.5,38,17,2,15,12,45,51,0,Matches
357,Enrico Brignola,ITA,"MF,FW",Benevento,Serie A,18,1999,15.0,28,21,17,10,1,12,38,31.6,26,13,0,13,6,34,7,0,Matches
358,Alberto Brignoli,ITA,GK,Benevento,Serie A,25,1991,12.5,0,0,0,0,0,0,0,,0,0,0,0,0,0,15,3,Matches
359,Miguel Britos,URU,DF,Watford,Premier League,32,1985,8.9,15,11,10,5,0,6,11,54.5,5,9,1,8,12,27,45,1,Matches
360,Leon Britton,ENG,MF,Swansea City,Premier League,34,1982,3.4,6,5,0,5,1,5,8,62.5,3,3,1,2,1,7,1,0,Matches
361,Petar Brlek,CRO,MF,Genoa,Serie A,23,1994,2.6,9,7,4,5,0,3,7,42.9,4,0,0,0,1,10,3,0,Matches
362,John Brooks,USA,DF,Wolfsburg,Bundesliga,24,1993,8.1,20,13,15,4,1,16,22,72.7,6,11,5,6,10,30,46,0,Matches
363,Daniel Brosinski,GER,"DF,FW",Mainz 05,Bundesliga,29,1988,27.8,45,35,21,18,6,22,44,50.0,22,46,11,35,24,69,75,2,Matches
364,Izzy Brown,ENG,"MF,FW",Brighton,Premier League,20,1997,3.5,3,3,2,1,0,1,7,14.3,6,3,0,3,1,4,3,0,Matches
365,Marcelo Brozović,CRO,MF,Inter,Serie A,24,1992,21.4,60,43,21,31,8,19,63,30.2,44,30,7,23,18,78,18,0,Matches
366,Bruma,POR,"MF,FW",RB Leipzig,Bundesliga,22,1994,17.9,18,16,7,7,4,9,18,50.0,9,28,2,26,12,30,11,0,Matches
367,Jeffrey Bruma,NED,DF,Wolfsburg,Bundesliga,25,1991,11.0,13,11,13,0,0,6,14,42.9,8,17,12,5,14,27,43,2,Matches
368,Bruno,ESP,DF,Brighton,Premier League,36,1980,22.4,30,17,21,6,3,14,22,63.6,8,17,11,6,38,68,76,0,Matches
369,Chris Brunt,NIR,"MF,DF",West Brom,Premier League,32,1984,21.3,41,24,19,21,1,11,31,35.5,20,28,4,24,22,63,45,1,Matches
370,Jacob Bruun Larsen,DEN,"MF,DF",Stuttgart,Bundesliga,18,1998,1.2,0,0,0,0,0,0,0,,0,1,0,1,1,1,2,0,Matches
371,Jacob Bruun Larsen,DEN,DF,Dortmund,Bundesliga,18,1998,0.1,1,1,1,0,0,1,2,50.0,1,0,0,0,0,1,0,0,Matches
372,Marcel Büchel,LIE,MF,Hellas Verona,Serie A,26,1991,18.8,37,21,15,21,1,13,48,27.1,35,35,6,29,45,82,46,1,Matches
373,Ante Budimir,CRO,FW,Crotone,Serie A,26,1991,17.6,28,20,4,16,8,2,20,10.0,18,20,3,17,7,35,27,0,Matches
374,Alberto Bueno,ESP,"MF,FW",Málaga,La Liga,29,1988,2.5,3,2,2,1,0,2,11,18.2,9,2,0,2,1,4,2,0,Matches
375,Gianluigi Buffon,ITA,GK,Juventus,Serie A,39,1978,20.7,0,0,0,0,0,0,0,,0,0,0,0,0,0,11,2,Matches
376,Onur Bulut,TUR,FW,Freiburg,Bundesliga,23,1994,0.4,0,0,0,0,0,0,1,0.0,1,0,0,0,0,0,0,0,Matches
377,Alessandro Buongiorno,ITA,DF,Torino,Serie A,18,1999,0.1,0,0,0,0,0,0,0,,0,0,0,0,0,0,1,0,Matches
378,Nicolás Burdisso,ARG,DF,Torino,Serie A,36,1981,23.0,20,11,13,7,0,7,11,63.6,4,23,14,9,30,50,124,3,Matches
379,Guido Burgstaller,AUT,FW,Schalke 04,Bundesliga,28,1989,25.8,14,9,0,10,4,4,14,28.6,10,28,3,25,10,24,9,0,Matches
380,Burgui,ESP,"MF,FW",Alavés,La Liga,23,1993,11.5,10,5,2,4,4,2,6,33.3,4,5,0,5,7,17,1,0,Matches
381,Oliver Burke,SCO,"FW,MF",West Brom,Premier League,20,1997,4.1,6,4,3,2,1,4,12,33.3,8,3,0,3,7,13,3,0,Matches
382,Roman Bürki,SUI,GK,Dortmund,Bundesliga,26,1990,33.0,1,1,1,0,0,1,3,33.3,2,1,0,1,0,1,10,4,Matches
383,Patrick Burner,MTQ,DF,Nice,Ligue 1,21,1996,10.0,18,12,13,5,0,7,20,35.0,13,6,0,6,13,31,23,0,Matches
384,Dženis Burnić,BIH,MF,Stuttgart,Bundesliga,19,1998,3.4,9,6,2,5,2,4,10,40.0,6,2,0,2,4,13,3,0,Matches
385,Sergio Busquets,ESP,MF,Barcelona,La Liga,29,1988,28.8,88,48,27,46,15,39,79,49.4,40,37,10,27,51,139,15,1,Matches
386,Unai Bustinza,ESP,DF,Leganés,La Liga,25,1992,18.2,36,21,25,8,3,21,38,55.3,17,17,9,8,47,83,64,0,Matches
387,Ludovic Butelle,FRA,GK,Angers,Ligue 1,34,1983,18.4,0,0,0,0,0,0,0,,0,0,0,0,1,1,10,2,Matches
388,Jack Butland,ENG,GK,Stoke City,Premier League,24,1993,35.0,1,1,1,0,0,1,1,100.0,0,1,0,1,1,2,26,1,Matches
389,Sam Byram,ENG,"DF,MF",West Ham,Premier League,23,1993,2.8,9,5,6,3,0,4,9,44.4,5,6,2,4,9,18,16,0,Matches
390,Jakub Błaszczykowski,POL,"FW,MF",Wolfsburg,Bundesliga,31,1985,5.8,12,8,8,2,2,6,13,46.2,7,11,3,8,5,17,3,0,Matches
391,Erick Cabaco,URU,DF,Levante,La Liga,22,1995,11.6,25,14,21,4,0,14,20,70.0,6,10,8,2,17,42,71,2,Matches
392,Willy Caballero,ARG,GK,Chelsea,Premier League,35,1981,3.0,0,0,0,0,0,0,0,,0,0,0,0,0,0,3,0,Matches
393,Yohan Cabaye,FRA,MF,Crystal Palace,Premier League,31,1986,26.4,70,44,39,28,3,24,97,24.7,73,47,4,43,79,149,29,4,Matches
394,Rémy Cabella,FRA,"FW,MF",Marseille,Ligue 1,27,1990,0.7,7,4,2,2,3,2,4,50.0,2,0,0,0,1,8,0,0,Matches
395,Rémy Cabella,FRA,"MF,FW",Saint-Étienne,Ligue 1,27,1990,25.1,58,39,29,22,7,17,73,23.3,56,31,0,31,14,72,4,2,Matches
396,Gustavo Cabral,ARG,DF,Celta Vigo,La Liga,31,1985,21.0,29,21,14,15,0,14,38,36.8,24,22,11,11,43,72,106,2,Matches
397,Leandro Cabrera,URU,DF,Crotone,Serie A,26,1991,4.1,8,5,8,0,0,0,3,0.0,3,5,2,3,6,14,33,0,Matches
398,Leandro Cabrera,URU,DF,Getafe,La Liga,26,1991,8.0,19,10,12,7,0,7,17,41.2,10,9,5,4,22,41,37,0,Matches
399,Fabrizio Cacciatore,ITA,DF,Chievo,Serie A,30,1986,31.9,34,27,20,9,5,15,30,50.0,15,33,11,22,38,72,99,3,Matches
400,Martín Cáceres,URU,DF,Hellas Verona,Serie A,30,1987,12.9,16,11,14,1,1,7,18,38.9,11,9,5,4,19,35,41,1,Matches
401,Martín Cáceres,URU,DF,Lazio,Serie A,30,1987,4.9,12,7,9,2,1,10,14,71.4,4,4,4,0,4,16,13,0,Matches
402,Cafú,POR,MF,Metz,Ligue 1,24,1993,7.6,9,7,3,4,2,3,11,27.3,8,3,1,2,12,21,13,0,Matches
403,Jonathan Cafu,BRA,"FW,MF",Bordeaux,Ligue 1,26,1991,7.0,16,9,7,6,3,5,13,38.5,8,6,1,5,10,26,1,0,Matches
404,Gary Cahill,ENG,DF,Chelsea,Premier League,31,1985,23.2,29,21,15,9,5,10,21,47.6,11,21,14,7,27,56,127,1,Matches
405,Yannick Cahuzac,FRA,MF,Toulouse,Ligue 1,32,1985,16.9,39,28,20,19,0,15,26,57.7,11,29,10,19,30,69,42,0,Matches
406,Felipe Caicedo,ECU,"FW,MF",Lazio,Serie A,28,1988,8.0,11,10,3,5,3,2,7,28.6,5,6,0,6,1,12,4,0,Matches
407,Caiuby,BRA,FW,Augsburg,Bundesliga,29,1988,31.7,53,40,20,27,6,17,42,40.5,25,36,1,35,15,68,42,2,Matches
408,Cala,ESP,DF,Getafe,La Liga,27,1989,20.0,21,14,16,5,0,13,27,48.1,14,21,10,11,39,60,124,0,Matches
409,Davide Calabria,ITA,DF,Milan,Serie A,20,1996,17.4,64,50,33,24,7,21,41,51.2,20,19,4,15,33,97,82,1,Matches
410,Mattia Caldara,ITA,DF,Atalanta,Serie A,23,1994,24.0,39,26,15,24,0,13,33,39.4,20,31,18,13,41,80,113,1,Matches
411,Carlos Calderón,ESP,MF,Getafe,La Liga,22,1995,0.0,1,1,0,0,1,0,0,,0,0,0,0,0,1,0,0,Matches
412,Luca Caldirola,ITA,DF,Werder Bremen,Bundesliga,26,1991,1.0,1,0,0,1,0,1,1,100.0,0,1,0,1,3,4,3,0,Matches
413,Hakan Çalhanoğlu,TUR,"FW,MF",Milan,Serie A,23,1994,24.1,37,27,11,18,8,8,31,25.8,23,29,2,27,22,59,15,0,Matches
414,Fabrizio Caligara,ITA,MF,Cagliari,Serie A,17,2000,0.2,0,0,0,0,0,0,0,,0,1,1,0,1,1,1,0,Matches
415,Daniel Caligiuri,ITA,"DF,MF",Schalke 04,Bundesliga,29,1988,32.4,100,66,48,43,9,49,94,52.1,45,59,4,55,67,167,71,0,Matches
416,José Callejón,ESP,FW,Napoli,Serie A,30,1987,36.0,33,27,15,14,4,10,47,21.3,37,42,5,37,22,55,31,0,Matches
417,Jonathan Calleri,ARG,FW,Las Palmas,La Liga,23,1993,34.5,24,16,5,10,9,4,23,17.4,19,15,2,13,7,31,35,0,Matches
418,Simone Calvano,ITA,MF,Hellas Verona,Serie A,24,1993,7.2,13,12,4,9,0,3,16,18.8,13,10,4,6,15,28,14,1,Matches
419,Dominic Calvert-Lewin,ENG,FW,Everton,Premier League,20,1997,20.9,15,8,5,3,7,2,15,13.3,13,13,1,12,10,25,23,1,Matches
420,Ignacio Camacho,ESP,"MF,DF",Wolfsburg,Bundesliga,27,1990,10.6,27,21,10,16,1,9,23,39.1,14,14,5,9,41,68,43,0,Matches
421,Abdoul Camara,GUI,"FW,MF",Guingamp,Ligue 1,27,1990,9.9,6,4,2,3,1,3,11,27.3,8,7,1,6,7,13,4,0,Matches
422,Souleymane Camara,SEN,FW,Montpellier,Ligue 1,34,1982,10.4,6,4,0,5,1,0,3,0.0,3,3,1,2,2,8,15,0,Matches
423,Víctor Camarasa,ESP,MF,Betis,La Liga,23,1994,13.9,20,15,8,10,2,3,13,23.1,10,8,0,8,15,35,13,0,Matches
424,Geoff Cameron,USA,"DF,MF",Stoke City,Premier League,32,1985,16.9,34,21,20,12,2,11,27,40.7,16,28,8,20,36,70,68,0,Matches
425,José Campaña,ESP,MF,Levante,La Liga,24,1993,30.4,57,36,25,27,5,19,58,32.8,39,31,10,21,45,102,37,0,Matches
426,Joel Campbell,CRC,"MF,FW",Betis,La Liga,25,1992,2.4,6,2,3,3,0,3,6,50.0,3,2,0,2,0,6,0,0,Matches
427,Tyrese Campbell,ENG,FW,Stoke City,Premier League,17,1999,0.9,2,1,0,2,0,1,1,100.0,0,1,1,0,1,3,0,0,Matches
428,Emre Can,GER,MF,Liverpool,Premier League,23,1994,23.2,67,54,32,29,6,18,43,41.9,25,32,4,28,28,95,37,1,Matches
429,Sergio Canales,ESP,"MF,FW",Real Sociedad,La Liga,26,1991,21.4,30,24,6,18,6,9,32,28.1,23,25,0,25,11,41,3,0,Matches
430,João Cancelo,POR,DF,Inter,Serie A,23,1994,20.6,42,29,27,11,4,17,42,40.5,25,15,2,13,35,77,51,0,Matches
431,João Cancelo,POR,MF,Valencia,La Liga,23,1994,1.0,1,1,0,1,0,1,1,100.0,0,1,0,1,2,3,0,0,Matches
432,Antonio Candreva,ITA,FW,Inter,Serie A,30,1987,28.2,12,7,7,5,0,8,39,20.5,31,20,2,18,22,34,24,0,Matches
433,Paolo Cannavaro,ITA,DF,Sassuolo,Serie A,36,1981,16.0,17,9,11,5,1,8,20,40.0,12,17,13,4,27,44,94,1,Matches
434,Ander Capa,ESP,DF,Eibar,La Liga,25,1992,25.0,57,38,34,14,9,25,38,65.8,13,21,2,19,52,109,50,1,Matches
435,Pierrick Capelle,FRA,MF,Angers,Ligue 1,30,1987,20.9,50,37,29,17,4,16,70,22.9,54,29,0,29,34,84,26,0,Matches
436,Leonardo Capezzi,ITA,MF,Sampdoria,Serie A,22,1995,2.4,8,4,5,3,0,4,6,66.7,2,6,0,6,0,8,3,0,Matches
437,Étienne Capoue,FRA,MF,Watford,Premier League,29,1988,17.1,43,26,15,25,3,19,47,40.4,28,21,1,20,43,86,38,0,Matches
438,Elio Capradossi,UGA,DF,Roma,Serie A,21,1996,0.9,1,0,1,0,0,0,0,,0,2,2,0,2,3,13,0,Matches
439,Gianluca Caprari,ITA,"FW,MF",Sampdoria,Serie A,24,1993,20.1,19,11,2,11,6,0,10,0.0,10,25,2,23,5,24,3,0,Matches
440,Marco Capuano,ITA,DF,Crotone,Serie A,25,1991,15.6,20,10,14,6,0,5,15,33.3,10,19,13,6,28,48,93,0,Matches
441,Marco Capuano,ITA,DF,Cagliari,Serie A,25,1991,7.7,13,9,6,7,0,4,8,50.0,4,7,2,5,6,19,23,1,Matches
442,Antonio Caracciolo,ITA,DF,Hellas Verona,Serie A,27,1990,31.7,52,34,41,8,3,17,30,56.7,13,64,44,20,39,91,203,0,Matches
443,Yoan Cardinale,FRA,GK,Nice,Ligue 1,23,1994,10.0,0,0,0,0,0,0,0,,0,0,0,0,0,0,0,3,Matches
444,Diego Carlos,BRA,DF,Nantes,Ligue 1,24,1993,25.5,70,42,51,15,4,28,38,73.7,10,50,29,21,29,99,155,3,Matches
445,Lionel Carole,FRA,DF,Sevilla,La Liga,26,1991,6.0,12,6,7,5,0,5,7,71.4,2,6,3,3,6,18,29,0,Matches
446,Yannick Carrasco,BEL,"MF,FW",Atlético Madrid,La Liga,23,1993,10.0,17,13,7,5,5,3,8,37.5,5,9,0,9,4,21,3,0,Matches
447,Michael Carrick,ENG,MF,Manchester Utd,Premier League,36,1981,1.2,1,1,0,1,0,0,1,0.0,1,2,0,2,1,2,3,0,Matches
448,Daniel Carriço,POR,DF,Sevilla,La Liga,28,1988,5.1,7,7,6,1,0,4,7,57.1,3,6,3,3,10,17,22,0,Matches
449,André Carrillo,PER,"FW,MF",Watford,Premier League,26,1991,17.1,31,24,16,12,3,8,33,24.2,25,7,0,7,15,46,16,0,Matches
450,Guido Carrillo,ARG,FW,Southampton,Premier League,26,1991,5.0,5,1,0,3,2,0,1,0.0,1,4,0,4,0,5,5,0,Matches
451,Guido Carrillo,ARG,FW,Monaco,Ligue 1,26,1991,4.7,3,1,0,2,1,0,4,0.0,4,3,1,2,0,3,8,0,Matches
452,Thomas Carrique,FRA,DF,Bordeaux,Ligue 1,18,1999,1.0,1,0,0,1,0,1,3,33.3,2,0,0,0,2,3,3,0,Matches
453,Andy Carroll,ENG,FW,West Ham,Premier League,28,1989,8.3,3,3,2,0,1,0,1,0.0,1,3,2,1,2,5,15,0,Matches
454,Tom Carroll,ENG,MF,Swansea City,Premier League,25,1992,28.6,53,33,22,23,8,14,53,26.4,39,37,8,29,29,82,18,1,Matches
455,Federico Cartabia,ARG,"FW,MF",La Coruña,La Liga,24,1993,14.7,37,23,15,15,7,11,30,36.7,19,15,0,15,18,55,10,0,Matches
456,Dani Carvajal,ESP,DF,Real Madrid,La Liga,25,1992,24.7,59,40,27,22,10,22,38,57.9,16,33,15,18,38,97,42,2,Matches
457,Casemiro,BRA,MF,Real Madrid,La Liga,25,1992,28.8,109,78,64,39,6,42,84,50.0,42,56,11,45,63,172,49,3,Matches
458,Kiko Casilla,ESP,GK,Real Madrid,La Liga,30,1986,10.0,1,0,1,0,0,1,1,100.0,0,0,0,0,2,3,6,2,Matches
459,Francesco Cassata,ITA,MF,Sassuolo,Serie A,20,1997,5.1,12,7,6,5,1,2,10,20.0,8,3,0,3,5,17,0,0,Matches
460,Timothy Castagne,BEL,DF,Atalanta,Serie A,21,1995,16.7,54,37,32,14,8,13,27,48.1,14,25,4,21,26,80,48,0,Matches
461,Leandro Castán,BRA,DF,Cagliari,Serie A,30,1986,12.7,24,15,16,8,0,15,20,75.0,5,16,10,6,23,47,48,1,Matches
462,Koen Casteels,BEL,GK,Wolfsburg,Bundesliga,25,1992,34.0,2,1,2,0,0,2,2,100.0,0,0,0,0,1,3,16,1,Matches
463,Dani Castellano,ESP,DF,Las Palmas,La Liga,29,1987,22.5,46,29,29,16,1,25,48,52.1,23,28,7,21,42,88,64,1,Matches
464,Javi Castellano,ESP,MF,Las Palmas,La Liga,29,1987,17.4,47,27,20,25,2,20,37,54.1,17,23,6,17,38,85,16,1,Matches
465,Samu Castillejo,ESP,"MF,FW",Villarreal,La Liga,22,1995,23.0,41,28,22,10,9,13,62,21.0,49,39,5,34,22,63,37,0,Matches
466,Chory Castro,URU,"MF,FW",Málaga,La Liga,32,1984,22.9,37,24,15,14,8,11,32,34.4,21,21,2,19,23,60,13,0,Matches
467,Gonzalo Castro,GER,MF,Dortmund,Bundesliga,30,1987,13.4,26,18,7,18,1,5,22,22.7,17,23,3,20,10,36,13,1,Matches
468,Jonny Castro,ESP,DF,Celta Vigo,La Liga,23,1994,35.6,102,78,60,31,11,43,91,47.3,48,48,8,40,93,195,92,1,Matches
469,Lucas Castro,ARG,MF,Chievo,Serie A,28,1989,22.1,54,40,14,29,11,16,43,37.2,27,39,7,32,38,92,35,0,Matches
470,Rubén Castro,ESP,FW,Betis,La Liga,36,1981,4.0,1,1,0,0,1,0,0,,0,0,0,0,0,1,2,0,Matches
471,Danilo Cataldi,ITA,MF,Benevento,Serie A,22,1994,25.4,33,25,12,19,2,5,28,17.9,23,18,5,13,37,70,20,1,Matches
472,Craig Cathcart,NIR,DF,Watford,Premier League,28,1989,5.8,8,5,5,3,0,4,5,80.0,1,8,6,2,3,11,38,0,Matches
473,Edinson Cavani,URU,FW,Paris S-G,Ligue 1,30,1987,28.7,15,9,5,4,6,2,16,12.5,14,10,1,9,5,20,22,0,Matches
474,Marijan Ćavar,BIH,MF,Eint Frankfurt,Bundesliga,19,1998,0.4,0,0,0,0,0,0,3,0.0,3,0,0,0,0,0,0,0,Matches
475,Dani Ceballos,ESP,MF,Real Madrid,La Liga,20,1996,4.5,8,7,3,2,3,4,16,25.0,12,6,0,6,5,13,1,0,Matches
476,Federico Ceccherini,ITA,DF,Crotone,Serie A,25,1992,35.9,35,21,28,4,3,13,25,52.0,12,39,21,18,83,118,276,1,Matches
477,Emanuel Cecchini,ARG,"MF,DF",Málaga,La Liga,20,1996,0.3,3,1,2,1,0,2,3,66.7,1,0,0,0,2,5,2,0,Matches
478,Petr Čech,CZE,GK,Arsenal,Premier League,35,1982,33.8,1,1,1,0,0,1,1,100.0,0,0,0,0,0,1,23,7,Matches
479,Ricardo Centurión,ARG,"MF,FW",Genoa,Serie A,24,1993,0.6,0,0,0,0,0,0,0,,0,0,0,0,0,0,0,0,Matches
480,Luca Ceppitelli,ITA,DF,Cagliari,Serie A,27,1989,24.7,45,33,31,12,2,16,34,47.1,18,33,21,12,50,95,156,0,Matches
481,Fabio Ceravolo,ITA,FW,Benevento,Serie A,30,1987,0.6,0,0,0,0,0,0,1,0.0,1,1,0,1,0,0,0,0,Matches
482,Alessio Cerci,ITA,FW,Hellas Verona,Serie A,30,1987,18.2,15,10,7,3,5,4,16,25.0,12,4,0,4,4,19,8,0,Matches
483,Boštjan Cesar,SVN,DF,Chievo,Serie A,35,1982,6.1,4,3,3,1,0,3,4,75.0,1,6,4,2,3,7,40,0,Matches
484,Damir Ceter,COL,FW,Cagliari,Serie A,19,1997,2.2,2,1,0,2,0,0,0,,0,3,0,3,0,2,1,0,Matches
485,Nacer Chadli,BEL,"FW,MF",West Brom,Premier League,27,1989,2.9,1,0,1,0,0,1,4,25.0,3,0,0,0,0,1,4,0,Matches
486,Fouad Chafik,MAR,DF,Dijon,Ligue 1,30,1986,17.9,58,49,31,19,8,20,35,57.1,15,17,1,16,33,91,46,1,Matches
487,Nathaniel Chalobah,ENG,MF,Watford,Premier League,22,1994,5.0,9,6,2,6,1,2,5,40.0,3,6,5,1,6,15,6,0,Matches
488,Calum Chambers,ENG,DF,Arsenal,Premier League,22,1995,9.6,17,10,10,6,1,5,14,35.7,9,14,11,3,18,35,47,0,Matches
489,Nereo Champagne,ARG,GK,Leganés,La Liga,32,1985,2.0,0,0,0,0,0,0,0,,0,0,0,0,0,0,3,0,Matches
490,Timothy Chandler,USA,"DF,FW",Eint Frankfurt,Bundesliga,27,1990,21.0,27,21,11,13,3,11,17,64.7,6,15,0,15,33,60,52,0,Matches
491,Kwon Chang-hoon,KOR,"FW,MF",Dijon,Ligue 1,23,1994,23.7,37,22,10,18,9,11,35,31.4,24,32,1,31,24,61,30,0,Matches
492,Charles,BRA,FW,Eibar,La Liga,33,1984,17.6,11,8,2,5,4,1,8,12.5,7,7,0,7,7,18,10,0,Matches
493,Charly Charrier,FRA,"MF,FW",Amiens,Ligue 1,31,1986,1.2,1,0,1,0,0,0,2,0.0,2,1,0,1,2,3,0,0,Matches
494,Pape Cheikh Diop,SEN,MF,Lyon,Ligue 1,19,1997,0.1,0,0,0,0,0,0,0,,0,0,0,0,0,0,0,0,Matches
495,Chema,ESP,DF,Levante,La Liga,25,1992,22.4,20,13,14,6,0,9,18,50.0,9,43,27,16,30,50,110,1,Matches
496,Denis Cheryshev,RUS,"MF,FW",Villarreal,La Liga,26,1990,10.3,27,16,12,10,5,6,23,26.1,17,18,1,17,13,40,10,0,Matches
497,Raman Chibsah,GHA,MF,Benevento,Serie A,24,1993,11.6,20,13,10,7,3,4,14,28.6,10,13,2,11,4,24,16,0,Matches
498,Leandro Chichizola,ARG,GK,Las Palmas,La Liga,27,1990,27.0,2,0,2,0,0,2,6,33.3,4,0,0,0,4,6,29,3,Matches
499,Giorgio Chiellini,ITA,DF,Juventus,Serie A,32,1984,24.0,28,19,17,10,1,7,15,46.7,8,21,14,7,47,75,142,3,Matches
500,Federico Chiesa,ITA,"FW,MF",Fiorentina,Serie A,19,1997,33.5,62,41,22,22,18,16,54,29.6,38,34,1,33,18,80,16,0,Matches
501,Ben Chilwell,ENG,DF,Leicester City,Premier League,20,1996,20.6,36,26,21,10,5,15,32,46.9,17,31,4,27,28,64,71,3,Matches
502,Vlad Chiricheș,ROU,DF,Napoli,Serie A,27,1989,6.5,8,4,7,1,0,2,5,40.0,3,2,1,1,16,24,19,1,Matches
503,Hamza Choudhury,ENG,"MF,DF",Leicester City,Premier League,19,1997,4.2,9,5,6,3,0,2,10,20.0,8,12,1,11,8,17,4,0,Matches
504,Andreas Christensen,DEN,DF,Chelsea,Premier League,21,1996,23.2,26,13,23,3,0,10,15,66.7,5,25,17,8,39,65,109,5,Matches
505,Chuca,ESP,MF,Villarreal,La Liga,20,1997,1.0,1,0,1,0,0,1,3,33.3,2,1,1,0,1,2,1,1,Matches
506,Lee Chung-yong,KOR,"FW,MF",Crystal Palace,Premier League,29,1988,1.5,2,0,0,1,1,0,0,,0,3,0,3,2,4,0,1,Matches
507,Amato Ciciretti,ITA,"MF,FW",Benevento,Serie A,23,1993,9.0,14,8,5,6,3,2,11,18.2,9,9,0,9,6,20,4,0,Matches
508,Cifu,ESP,DF,Málaga,La Liga,26,1990,1.2,2,1,0,1,1,1,5,20.0,4,1,1,0,2,4,2,0,Matches
509,Luca Cigarini,ITA,MF,Cagliari,Serie A,31,1986,22.5,42,30,16,25,1,18,64,28.1,46,32,5,27,42,84,27,1,Matches
510,Per Ciljan Skjelbred,NOR,MF,Hertha BSC,Bundesliga,30,1987,24.3,89,66,33,54,2,42,64,65.6,22,31,6,25,45,134,23,0,Matches
511,Jasper Cillessen,NED,GK,Barcelona,La Liga,28,1989,1.0,0,0,0,0,0,0,0,,0,0,0,0,0,0,0,0,Matches
512,Thiago Cionek,POL,DF,SPAL,Serie A,31,1986,15.0,28,21,18,6,4,11,20,55.0,9,19,9,10,35,63,99,0,Matches
513,Saliou Ciss,SEN,"DF,MF",Angers,Ligue 1,27,1989,1.6,3,2,1,1,1,2,5,40.0,3,0,0,0,2,5,1,0,Matches
514,Karamoko Cissé,GUI,"FW,MF",Benevento,Serie A,28,1988,0.2,1,1,1,0,0,0,0,,0,0,0,0,0,1,0,0,Matches
515,Issa Cissokho,SEN,DF,Amiens,Ligue 1,32,1985,18.1,31,23,22,9,0,18,32,56.3,14,18,8,10,34,65,87,1,Matches
516,Ciaran Clark,IRL,DF,Newcastle Utd,Premier League,27,1989,19.4,25,17,17,8,0,11,21,52.4,10,15,10,5,17,42,144,1,Matches
517,Christian Clemens,GER,"MF,FW",Köln,Bundesliga,25,1991,7.2,12,11,6,5,1,4,13,30.8,9,8,0,8,4,16,7,0,Matches
518,Tom Cleverley,ENG,MF,Watford,Premier League,27,1989,21.1,48,26,25,16,7,21,52,40.4,31,11,1,10,25,73,21,0,Matches
519,Sam Clucas,ENG,MF,Swansea City,Premier League,26,1990,22.7,34,19,21,11,2,10,29,34.5,19,31,7,24,29,63,34,1,Matches
520,Nathaniel Clyne,ENG,"DF,FW",Liverpool,Premier League,26,1991,1.9,3,1,2,1,0,0,1,0.0,1,2,1,1,0,3,3,0,Matches
521,Marcus Coco,FRA,"FW,MF",Guingamp,Ligue 1,21,1996,17.6,40,28,17,13,10,7,35,20.0,28,22,3,19,15,55,9,0,Matches
522,Massimo Coda,ITA,FW,Benevento,Serie A,28,1988,15.7,12,9,3,4,5,2,13,15.4,11,7,2,5,6,18,11,0,Matches
523,Isaac Cofie,GHA,MF,Genoa,Serie A,25,1991,6.6,13,10,3,9,1,7,15,46.7,8,9,3,6,10,23,7,0,Matches
524,Renaud Cohade,FRA,MF,Metz,Ligue 1,32,1984,36.6,143,86,63,71,9,46,119,38.7,73,70,10,60,53,196,91,0,Matches
525,Coke,ESP,DF,Levante,La Liga,30,1987,15.4,35,23,26,7,2,18,39,46.2,21,17,5,12,34,69,46,0,Matches
526,Coke,ESP,MF,Schalke 04,Bundesliga,30,1987,0.0,0,0,0,0,0,0,0,,0,0,0,0,0,0,0,0,Matches
527,Emre Çolak,TUR,MF,La Coruña,La Liga,26,1991,16.1,24,19,4,14,6,7,28,25.0,21,7,1,6,7,31,5,1,Matches
528,Séamus Coleman,IRL,DF,Everton,Premier League,28,1988,11.5,14,14,9,3,2,6,11,54.5,5,16,12,4,10,24,29,2,Matches
529,James Collins,WAL,DF,West Ham,Premier League,33,1983,11.7,15,9,11,4,0,8,11,72.7,3,13,10,3,16,31,120,1,Matches
530,Racine Coly,SEN,DF,Nice,Ligue 1,21,1995,6.9,15,12,9,5,1,9,19,47.4,10,5,2,3,15,30,18,0,Matches
531,Kingsley Coman,FRA,"FW,MF",Bayern Munich,Bundesliga,21,1996,12.8,11,10,2,6,3,5,10,50.0,5,6,0,6,7,18,1,0,Matches
532,Marvin Compper,GER,DF,RB Leipzig,Bundesliga,32,1985,1.0,2,2,0,2,0,2,3,66.7,1,2,2,0,0,2,8,0,Matches
533,Alois Confais,FRA,"MF,DF",Troyes,Ligue 1,20,1996,6.8,8,6,7,1,0,3,9,33.3,6,7,4,3,4,12,15,1,Matches
534,Daniel Congré,FRA,DF,Montpellier,Ligue 1,32,1985,29.3,62,46,36,24,2,31,59,52.5,28,29,16,13,56,118,124,2,Matches
535,Andrea Consigli,ITA,GK,Sassuolo,Serie A,30,1987,36.8,0,0,0,0,0,0,2,0.0,2,0,0,0,0,0,27,6,Matches
536,Diego Contento,GER,"DF,MF",Bordeaux,Ligue 1,27,1990,1.2,3,0,1,2,0,1,1,100.0,0,2,1,1,1,4,9,0,Matches
537,Andrea Conti,ITA,DF,Milan,Serie A,23,1994,1.7,4,2,1,3,0,2,3,66.7,1,3,0,3,1,5,5,0,Matches
538,Lewis Cook,ENG,MF,Bournemouth,Premier League,20,1997,24.9,67,35,37,30,0,26,69,37.7,43,33,12,21,35,102,25,2,Matches
539,Steve Cook,ENG,DF,Bournemouth,Premier League,26,1991,30.7,37,19,28,7,2,19,29,65.5,10,63,45,18,54,91,232,4,Matches
540,Duje Čop,CRO,"FW,MF",Cagliari,Serie A,27,1990,1.1,1,1,0,0,1,0,1,0.0,1,1,0,1,0,1,0,0,Matches
541,Francis Coquelin,FRA,"MF,DF",Arsenal,Premier League,26,1991,1.9,5,4,2,3,0,1,3,33.3,2,1,0,1,3,8,2,0,Matches
542,Francis Coquelin,FRA,"MF,DF",Valencia,La Liga,26,1991,7.3,18,14,11,6,1,9,16,56.3,7,9,2,7,20,38,23,0,Matches
543,Sébastien Corchia,FRA,DF,Sevilla,La Liga,26,1990,9.1,18,13,7,8,3,9,16,56.3,7,18,4,14,16,34,20,0,Matches
544,Alex Cordaz,ITA,GK,Crotone,Serie A,34,1983,38.0,0,0,0,0,0,0,0,,0,0,0,0,2,2,16,4,Matches
545,Iñigo Córdoba,ESP,FW,Athletic Club,La Liga,20,1997,16.2,44,30,18,21,5,16,58,27.6,42,31,0,31,21,65,9,0,Matches
546,Jhon Córdoba,COL,FW,Köln,Bundesliga,24,1993,10.6,13,10,0,11,2,1,5,20.0,4,6,2,4,1,14,9,0,Matches
547,Sergio Córdova,VEN,"FW,MF",Augsburg,Bundesliga,19,1997,6.5,5,5,0,2,3,3,4,75.0,1,12,2,10,0,5,6,0,Matches
548,Jérémy Cordoval,GLP,DF,Troyes,Ligue 1,27,1990,10.2,20,16,12,7,1,9,14,64.3,5,12,2,10,9,29,35,0,Matches
549,Benjamin Corgnet,FRA,"MF,FW",Strasbourg,Ligue 1,30,1987,15.3,28,19,5,16,7,6,28,21.4,22,18,1,17,11,39,11,0,Matches
550,Jack Cork,ENG,MF,Burnley,Premier League,28,1989,38.0,60,44,25,27,8,20,62,32.3,42,36,15,21,41,101,86,1,Matches
551,Andreas Cornelius,DEN,FW,Atalanta,Serie A,24,1993,10.4,9,5,3,3,3,1,7,14.3,6,7,0,7,2,11,7,0,Matches
552,Maxwel Cornet,CIV,FW,Lyon,Ligue 1,20,1996,14.1,17,12,6,9,2,3,25,12.0,22,11,1,10,14,31,14,0,Matches
553,Quentin Cornette,FRA,"FW,MF",Amiens,Ligue 1,23,1994,5.0,11,8,5,3,3,3,13,23.1,10,7,0,7,3,14,5,0,Matches
554,Ángel Correa,ARG,"MF,FW",Atlético Madrid,La Liga,22,1995,25.0,41,29,12,16,13,8,57,14.0,49,30,1,29,25,66,17,0,Matches
555,Joaquín Correa,ARG,FW,Sevilla,La Liga,22,1994,13.3,15,10,7,6,2,8,29,27.6,21,15,1,14,2,17,12,0,Matches
556,Andrea Cossu,ITA,"MF,FW",Cagliari,Serie A,37,1980,2.7,1,0,0,0,1,0,2,0.0,2,2,0,2,3,4,2,0,Matches
557,Andrea Costa,ITA,DF,Benevento,Serie A,31,1986,15.3,19,14,13,6,0,9,19,47.4,10,21,15,6,37,56,78,2,Matches
558,Danny da Costa,GER,"DF,FW",Eint Frankfurt,Bundesliga,24,1993,13.4,41,34,17,14,10,24,28,85.7,4,21,4,17,13,54,47,0,Matches
559,Diego Costa,ESP,FW,Atlético Madrid,La Liga,28,1988,11.6,17,11,2,10,5,4,15,26.7,11,14,4,10,5,22,3,0,Matches
560,Douglas Costa,BRA,"FW,MF",Juventus,Serie A,26,1990,19.9,17,14,10,5,2,8,25,32.0,17,15,0,15,7,24,7,0,Matches
561,Filippo Costa,ITA,DF,SPAL,Serie A,22,1995,16.4,19,12,7,7,5,7,17,41.2,10,23,6,17,22,41,50,0,Matches
562,Jaume Costa,ESP,DF,Villarreal,La Liga,29,1988,28.2,67,43,39,22,6,33,51,64.7,18,30,8,22,46,113,97,0,Matches
563,Angelo da Costa Júnior,BRA,GK,Bologna,Serie A,33,1983,4.0,0,0,0,0,0,0,0,,0,0,0,0,0,0,2,0,Matches
564,Nuno da Costa,CPV,"FW,MF",Strasbourg,Ligue 1,26,1991,19.2,50,32,12,29,9,7,35,20.0,28,21,0,21,19,69,9,0,Matches
565,Benoît Costil,FRA,GK,Bordeaux,Ligue 1,30,1987,36.0,0,0,0,0,0,0,2,0.0,2,0,0,0,3,3,13,4,Matches
566,Kalifa Coulibaly,MLI,FW,Nantes,Ligue 1,25,1991,3.8,6,6,3,1,2,2,4,50.0,2,0,0,0,0,6,6,0,Matches
567,Lassana Coulibaly,MLI,MF,Angers,Ligue 1,21,1996,9.3,26,17,13,10,3,10,35,28.6,25,15,1,14,8,34,10,0,Matches
568,Thibaut Courtois,BEL,GK,Chelsea,Premier League,25,1992,35.0,0,0,0,0,0,0,0,,0,0,0,0,0,0,8,1,Matches
569,Philippe Coutinho,BRA,"MF,FW",Liverpool,Premier League,25,1992,12.3,17,14,4,10,3,3,21,14.3,18,10,0,10,10,27,5,1,Matches
570,Philippe Coutinho,BRA,"MF,FW",Barcelona,La Liga,25,1992,14.4,27,14,8,14,5,9,32,28.1,23,14,0,14,6,33,4,0,Matches
571,Nicolas Cozza,FRA,"DF,MF",Montpellier,Ligue 1,18,1999,6.4,21,11,12,8,1,7,16,43.8,9,5,2,3,13,34,12,0,Matches
572,Alessio Cragno,ITA,GK,Cagliari,Serie A,23,1994,28.2,0,0,0,0,0,0,0,,0,1,0,1,0,0,12,0,Matches
573,Martin Cranie,ENG,DF,Huddersfield,Premier League,30,1986,2.0,3,2,2,1,0,0,1,0.0,1,3,3,0,1,4,10,0,Matches
574,Michele Cremonesi,ITA,DF,SPAL,Serie A,29,1988,4.3,4,2,2,2,0,1,4,25.0,3,5,3,2,7,11,28,0,Matches
575,Aaron Cresswell,ENG,DF,West Ham,Premier League,27,1989,34.1,34,21,12,20,2,19,30,63.3,11,42,17,25,44,78,117,1,Matches
576,Lorenzo Crisetig,ITA,MF,Bologna,Serie A,24,1993,6.2,18,14,8,9,1,7,24,29.2,17,8,2,6,13,31,16,1,Matches
577,Bryan Cristante,ITA,MF,Atalanta,Serie A,22,1995,31.4,66,50,21,32,13,18,59,30.5,41,43,6,37,23,89,27,0,Matches
578,Sebastián Cristóforo,URU,MF,Fiorentina,Serie A,23,1993,3.0,16,12,6,8,2,9,19,47.4,10,4,0,4,4,20,6,0,Matches
579,Enzo Crivelli,FRA,FW,Angers,Ligue 1,22,1995,11.4,13,9,2,6,5,1,5,20.0,4,4,0,4,2,15,6,0,Matches
580,Enzo Crivelli,FRA,FW,Caen,Ligue 1,22,1995,8.1,4,2,2,1,1,1,5,20.0,4,1,0,1,2,6,2,0,Matches
581,Giovanni Crociata,ITA,"MF,FW",Crotone,Serie A,19,1997,3.2,9,6,3,4,2,1,4,25.0,3,7,0,7,4,13,3,0,Matches
582,Luca Crosta,ITA,GK,Cagliari,Serie A,19,1998,1.0,0,0,0,0,0,0,0,,0,0,0,0,0,0,1,0,Matches
583,Peter Crouch,ENG,FW,Stoke City,Premier League,36,1981,17.4,2,0,0,1,1,0,12,0.0,12,7,4,3,1,3,31,0,Matches
584,Juan Cruz,ESP,FW,Málaga,La Liga,17,2000,0.1,2,2,0,2,0,0,0,,0,0,0,0,0,2,0,0,Matches
585,Juan Cuadrado,COL,"FW,MF",Juventus,Serie A,29,1988,15.0,28,19,17,9,2,11,27,40.7,16,14,0,14,19,47,14,1,Matches
586,Iván Cuéllar,ESP,GK,Leganés,La Liga,33,1984,35.0,4,3,4,0,0,3,4,75.0,1,0,0,0,3,7,22,6,Matches
587,Mickaël Cuisance,FRA,"MF,FW",Gladbach,Bundesliga,17,1999,13.4,31,20,16,11,4,19,29,65.5,10,22,4,18,10,41,10,1,Matches
588,Josh Cullen,IRL,MF,West Ham,Premier League,21,1996,0.1,0,0,0,0,0,0,1,0.0,1,1,1,0,2,2,0,0,Matches
589,Patrick Cutrone,ITA,FW,Milan,Serie A,19,1998,16.7,11,10,2,7,2,1,10,10.0,9,11,1,10,3,14,12,0,Matches
590,Wylan Cyprien,FRA,MF,Nice,Ligue 1,22,1995,10.6,9,7,4,4,1,2,11,18.2,9,7,1,6,11,20,7,2,Matches
591,Marco D'Alessandro,ITA,"MF,FW",Benevento,Serie A,26,1991,11.6,31,22,15,9,7,8,24,33.3,16,12,1,11,10,41,8,1,Matches
592,Danilo D'Ambrosio,ITA,DF,Inter,Serie A,28,1988,33.1,82,64,38,35,9,30,59,50.8,29,31,7,24,45,127,68,1,Matches
593,Damien Da Silva,FRA,DF,Caen,Ligue 1,29,1988,31.5,52,35,40,12,0,20,33,60.6,13,45,25,20,36,88,184,2,Matches
594,Kouadio-Yves Dabila,CIV,DF,Lille,Ligue 1,20,1997,10.5,20,11,14,4,2,6,10,60.0,4,14,6,8,10,30,46,0,Matches
595,Bryan Dabo,BFA,MF,Fiorentina,Serie A,25,1992,6.6,17,11,6,10,1,6,15,40.0,9,13,1,12,15,32,24,1,Matches
596,Bryan Dabo,BFA,"MF,FW",Saint-Étienne,Ligue 1,25,1992,14.3,25,16,12,10,3,7,29,24.1,22,12,1,11,11,36,22,0,Matches
597,Mahmoud Dahoud,GER,MF,Dortmund,Bundesliga,21,1996,12.7,38,23,11,21,6,13,30,43.3,17,18,2,16,12,50,7,0,Matches
598,Dario Dainelli,ITA,DF,Chievo,Serie A,38,1979,16.7,19,14,14,4,1,10,21,47.6,11,27,22,5,46,65,126,0,Matches
599,Felipe dal Belo,BRA,DF,SPAL,Serie A,33,1984,28.6,51,34,32,16,3,25,49,51.0,24,42,24,18,48,99,157,1,Matches
600,Charlie Daniels,ENG,"DF,MF",Bournemouth,Premier League,30,1986,33.4,48,34,32,12,4,22,41,53.7,19,34,7,27,31,79,114,0,Matches
601,Danilo,BRA,DF,Manchester City,Premier League,26,1991,15.0,43,29,25,12,6,19,35,54.3,16,15,6,9,19,62,33,0,Matches
602,Scott Dann,ENG,DF,Crystal Palace,Premier League,30,1987,15.9,10,5,8,2,0,7,17,41.2,10,17,14,3,23,33,98,1,Matches
603,Kevin Danso,AUT,DF,Augsburg,Bundesliga,18,1998,12.3,18,12,13,5,0,12,16,75.0,4,21,14,7,20,38,63,1,Matches
604,Dante,BRA,DF,Nice,Ligue 1,33,1983,32.4,43,28,32,10,1,21,36,58.3,15,44,25,19,47,90,130,2,Matches
605,Romain Danzé,FRA,DF,Rennes,Ligue 1,31,1986,7.6,12,7,3,4,5,8,13,61.5,5,11,2,9,3,15,34,0,Matches
606,Andrea Danzi,ITA,MF,Hellas Verona,Serie A,18,1999,4.4,11,6,7,4,0,5,13,38.5,8,3,0,3,5,16,5,1,Matches
607,Stéphane Darbion,FRA,"FW,MF",Troyes,Ligue 1,33,1984,19.0,19,14,13,4,2,5,40,12.5,35,21,2,19,20,39,17,0,Matches
608,Palkó Dárdai,HUN,"FW,MF",Hertha BSC,Bundesliga,18,1999,0.3,0,0,0,0,0,0,0,,0,0,0,0,0,0,1,0,Matches
609,Sergi Darder,ESP,MF,Espanyol,La Liga,23,1993,30.9,64,43,29,28,7,19,62,30.6,43,31,5,26,52,116,48,1,Matches
610,Sergi Darder,ESP,MF,Lyon,Ligue 1,23,1993,2.3,9,3,1,5,3,1,7,14.3,6,0,0,0,3,12,3,0,Matches
611,Vladimír Darida,CZE,MF,Hertha BSC,Bundesliga,26,1990,18.2,38,28,11,18,9,11,26,42.3,15,22,4,18,24,62,23,0,Matches
612,Karl Darlow,ENG,GK,Newcastle Utd,Premier League,26,1990,10.0,0,0,0,0,0,0,0,,0,0,0,0,0,0,3,4,Matches
613,Matteo Darmian,ITA,DF,Manchester Utd,Premier League,27,1989,4.9,16,14,7,7,2,6,19,31.6,13,5,3,2,7,23,23,0,Matches
614,Ben Davies,WAL,DF,Tottenham,Premier League,24,1993,25.8,47,33,13,21,13,25,48,52.1,23,24,5,19,28,75,70,1,Matches
615,Tom Davies,ENG,MF,Everton,Premier League,19,1998,21.1,30,20,14,11,5,12,54,22.2,42,19,5,14,24,54,21,0,Matches
616,Steven Davis,NIR,MF,Southampton,Premier League,32,1985,16.9,30,21,10,17,3,11,30,36.7,19,22,6,16,15,45,24,1,Matches
617,Salem Al-Dawsari,KSA,MF,Villarreal,La Liga,25,1991,0.4,1,0,0,1,0,1,1,100.0,0,1,0,1,0,1,0,0,Matches
618,Craig Dawson,ENG,DF,West Brom,Premier League,27,1990,27.9,38,28,25,7,6,13,36,36.1,23,39,26,13,52,90,140,0,Matches
619,Kevin De Bruyne,BEL,MF,Manchester City,Premier League,26,1991,34.1,62,43,23,25,14,23,80,28.8,57,45,2,43,25,87,14,2,Matches
620,Sebastien De Maio,FRA,DF,Bologna,Serie A,30,1987,22.8,26,17,15,11,0,10,25,40.0,15,35,18,17,36,62,147,0,Matches
621,Rodrigo De Paul,ARG,"FW,MF",Udinese,Serie A,23,1994,25.8,31,18,10,17,4,4,32,12.5,28,34,1,33,16,47,8,0,Matches
622,Daniele De Rossi,ITA,MF,Roma,Serie A,34,1983,20.3,23,13,12,9,2,9,33,27.3,24,18,13,5,43,66,45,2,Matches
623,Mattia De Sciglio,ITA,DF,Juventus,Serie A,24,1992,10.8,22,17,7,13,2,9,13,69.2,4,12,2,10,14,36,32,0,Matches
624,Lorenzo De Silvestri,ITA,DF,Torino,Serie A,29,1988,32.8,39,25,19,13,7,16,26,61.5,10,47,10,37,27,66,165,0,Matches
625,Lucas Deaux,FRA,MF,Guingamp,Ligue 1,28,1988,21.6,62,45,21,37,4,20,67,29.9,47,41,6,35,32,94,19,0,Matches
626,Mathieu Debuchy,FRA,DF,Saint-Étienne,Ligue 1,32,1985,14.6,34,25,22,8,4,17,30,56.7,13,16,10,6,27,61,73,0,Matches
627,Troy Deeney,ENG,FW,Watford,Premier League,29,1988,20.5,15,11,3,8,4,3,11,27.3,8,14,1,13,5,20,20,0,Matches
628,Jermain Defoe,ENG,FW,Bournemouth,Premier League,34,1982,12.1,12,9,2,6,4,2,10,20.0,8,10,0,10,4,16,1,0,Matches
629,Steven Defour,BEL,MF,Burnley,Premier League,29,1988,22.2,33,22,12,18,3,10,46,21.7,36,35,7,28,46,79,25,0,Matches
630,Grégoire Defrel,MTQ,"FW,MF",Roma,Serie A,26,1991,5.4,8,3,1,1,6,2,8,25.0,6,5,0,5,3,11,6,0,Matches
631,Alessandro Deiola,ITA,MF,Cagliari,Serie A,21,1995,5.0,9,7,5,3,1,6,13,46.2,7,8,0,8,4,13,12,0,Matches
632,Lorenzo Del Pinto,ITA,MF,Benevento,Serie A,27,1990,8.4,23,17,10,10,3,7,25,28.0,18,13,4,9,16,39,7,2,Matches
633,Damien Delaney,IRL,DF,Crystal Palace,Premier League,36,1981,1.1,2,1,2,0,0,1,1,100.0,0,5,4,1,3,5,7,0,Matches
634,Thomas Delaney,DEN,MF,Werder Bremen,Bundesliga,25,1991,31.1,79,61,27,46,6,36,53,67.9,17,37,12,25,43,122,74,4,Matches
635,Jonathan Delaplace,FRA,MF,Caen,Ligue 1,31,1986,6.5,10,8,1,8,1,3,10,30.0,7,13,5,8,8,18,8,0,Matches
636,Cristian Dell'Orco,ITA,DF,Sassuolo,Serie A,23,1994,4.7,4,1,1,2,1,1,3,33.3,2,5,1,4,10,14,19,0,Matches
637,Andy Delort,ALG,FW,Toulouse,Ligue 1,25,1991,25.9,20,13,2,9,9,4,19,21.1,15,10,0,10,12,32,22,0,Matches
638,Fabian Delph,ENG,DF,Manchester City,Premier League,27,1989,19.3,46,34,21,16,9,18,37,48.6,19,16,0,16,30,76,42,2,Matches
639,Mousa Dembélé,BEL,MF,Tottenham,Premier League,30,1987,20.9,36,24,19,11,6,9,37,24.3,28,20,0,20,33,69,15,0,Matches
640,Ousmane Dembélé,FRA,"FW,MF",Barcelona,La Liga,20,1997,10.3,10,7,2,5,3,1,13,7.7,12,8,0,8,5,15,2,0,Matches
641,Jessy Deminguet,FRA,"MF,FW",Caen,Ligue 1,19,1998,5.9,12,9,4,6,2,4,14,28.6,10,5,0,5,10,22,13,0,Matches
642,Kerem Demirbay,GER,MF,Hoffenheim,Bundesliga,24,1993,13.5,38,30,15,17,6,12,28,42.9,16,21,3,18,14,52,21,0,Matches
643,Ermedin Demirović,BIH,FW,Alavés,La Liga,19,1998,2.0,1,1,0,1,0,0,1,0.0,1,5,0,5,0,1,2,0,Matches
644,Diego Demme,GER,MF,RB Leipzig,Bundesliga,25,1991,25.4,81,57,29,48,4,47,87,54.0,40,31,3,28,48,129,29,0,Matches
645,Fabio Depaoli,ITA,"DF,MF",Chievo,Serie A,20,1997,13.2,31,22,21,7,3,21,40,52.5,19,27,10,17,15,46,42,0,Matches
646,Mathieu Deplagne,FRA,DF,Troyes,Ligue 1,25,1991,26.8,52,38,33,14,5,20,48,41.7,28,26,10,16,60,112,95,2,Matches
647,Laurent Depoitre,BEL,FW,Huddersfield,Premier League,28,1988,20.2,14,8,4,8,2,3,21,14.3,18,15,3,12,11,25,36,0,Matches
648,Mike van der Hoorn,NED,DF,Swansea City,Premier League,24,1992,21.6,32,22,23,8,1,16,24,66.7,8,24,14,10,39,71,127,0,Matches
649,Gregory van der Wiel,NED,DF,Cagliari,Serie A,29,1988,3.2,5,3,4,1,0,3,5,60.0,2,1,0,1,10,15,12,0,Matches
650,Daniele Dessena,ITA,"MF,DF",Cagliari,Serie A,30,1987,6.4,18,10,12,5,1,6,12,50.0,6,7,1,6,6,24,17,0,Matches
651,Mattia Destro,ITA,FW,Bologna,Serie A,26,1991,18.0,15,13,4,9,2,3,11,27.3,8,10,1,9,5,20,26,0,Matches
652,Gerard Deulofeu,ESP,"FW,MF",Watford,Premier League,23,1994,4.8,5,3,2,2,1,2,11,18.2,9,0,0,0,4,9,3,1,Matches
653,Gerard Deulofeu,ESP,"MF,FW",Barcelona,La Liga,23,1994,5.6,8,5,6,1,1,3,4,75.0,1,2,0,2,8,16,0,0,Matches
654,Gianluca Di Chiara,ITA,DF,Benevento,Serie A,23,1993,11.2,26,19,18,6,2,7,21,33.3,14,10,3,7,11,37,37,1,Matches
655,Federico Di Francesco,ITA,"FW,DF",Bologna,Serie A,23,1994,17.7,26,13,14,8,4,5,20,25.0,15,24,2,22,16,42,25,0,Matches
656,Davide Di Gennaro,ITA,MF,Lazio,Serie A,29,1988,0.1,1,0,1,0,0,1,1,100.0,0,0,0,0,0,1,0,0,Matches
657,Ángel Di María,ARG,FW,Paris S-G,Ligue 1,29,1988,23.5,13,10,5,3,5,7,39,17.9,32,18,2,16,10,23,8,0,Matches
658,Franco Di Santo,ARG,"FW,MF",Schalke 04,Bundesliga,28,1989,18.4,17,13,3,13,1,7,15,46.7,8,12,1,11,2,19,24,0,Matches
659,Cheick Diabaté,MLI,FW,Benevento,Serie A,29,1988,7.4,1,1,0,1,0,1,3,33.3,2,2,0,2,0,1,6,0,Matches
660,Fousseni Diabaté,MLI,"MF,FW",Leicester City,Premier League,21,1995,6.5,9,6,5,3,1,1,4,25.0,3,6,0,6,8,17,8,0,Matches
661,Moussa Diaby,FRA,MF,Crotone,Serie A,18,1999,0.8,1,0,1,0,0,1,4,25.0,3,1,0,1,1,2,0,0,Matches
662,Fallou Diagne,SEN,"DF,MF",Metz,Ligue 1,27,1989,24.9,33,20,21,12,0,7,22,31.8,15,33,18,15,46,79,116,3,Matches
663,Adama Diakhaby,FRA,FW,Monaco,Ligue 1,21,1996,9.4,23,15,6,12,5,6,16,37.5,10,13,0,13,13,36,5,0,Matches
664,Mouctar Diakhaby,GUI,DF,Lyon,Ligue 1,20,1996,8.1,10,6,7,3,0,4,7,57.1,3,14,9,5,12,22,52,1,Matches
665,Abdou Diallo,SEN,DF,Mainz 05,Bundesliga,21,1996,26.8,75,53,45,25,5,38,50,76.0,12,37,14,23,50,125,75,0,Matches
666,Abdoulaye Diallo,SEN,GK,Rennes,Ligue 1,25,1992,3.0,0,0,0,0,0,0,0,,0,0,0,0,0,0,4,1,Matches
667,Habib Diallo,SEN,"FW,MF",Metz,Ligue 1,22,1995,0.2,0,0,0,0,0,0,0,,0,0,0,0,0,0,0,0,Matches
668,Mustapha Diallo,SEN,MF,Guingamp,Ligue 1,31,1986,15.4,48,36,15,29,4,15,33,45.5,18,20,4,16,20,68,29,0,Matches
669,Mohamed Diamé,SEN,MF,Newcastle Utd,Premier League,30,1987,22.7,89,64,33,48,8,16,62,25.8,46,44,7,37,48,137,30,2,Matches
670,Lassana Diarra,FRA,MF,Paris S-G,Ligue 1,32,1985,6.7,12,4,4,7,1,8,12,66.7,4,3,1,2,6,18,6,0,Matches
671,Amadou Diawara,GUI,MF,Napoli,Serie A,20,1997,7.3,11,9,3,7,1,1,7,14.3,6,12,2,10,9,20,5,0,Matches
672,Brahim Díaz,MAR,"FW,DF",Manchester City,Premier League,17,1999,0.6,1,0,1,0,0,0,0,,0,3,0,3,1,2,0,0,Matches
673,Bakaye Dibassy,MLI,DF,Amiens,Ligue 1,27,1989,30.9,71,51,45,22,4,24,50,48.0,26,52,26,26,58,129,148,0,Matches
674,Daniel Didavi,GER,MF,Wolfsburg,Bundesliga,27,1990,24.9,34,19,10,19,5,14,33,42.4,19,20,1,19,7,41,12,0,Matches
675,Thomas Didillon,FRA,GK,Metz,Ligue 1,21,1995,9.0,0,0,0,0,0,0,1,0.0,1,0,0,0,0,0,5,2,Matches
676,Étienne Didot,FRA,MF,Guingamp,Ligue 1,34,1983,18.0,54,33,20,33,1,20,43,46.5,23,21,7,14,19,73,29,0,Matches
677,Adrián Diéguez,ESP,DF,Alavés,La Liga,21,1996,4.8,10,5,5,5,0,6,13,46.2,7,5,0,5,11,21,24,1,Matches
678,Dennis Diekmeier,GER,DF,Hamburger SV,Bundesliga,27,1989,20.8,47,43,31,10,6,25,36,69.4,11,22,11,11,16,63,50,0,Matches
679,Eric Dier,ENG,"MF,DF",Tottenham,Premier League,23,1994,31.4,61,43,15,39,7,17,42,40.5,25,32,11,21,48,109,93,7,Matches
680,Lucas Digne,FRA,DF,Barcelona,La Liga,24,1993,7.8,22,17,13,6,3,8,12,66.7,4,15,3,12,12,34,18,0,Matches
681,Landry Dimata,BEL,FW,Wolfsburg,Bundesliga,19,1997,10.0,7,6,4,3,0,5,6,83.3,1,6,2,4,2,9,5,0,Matches
682,Tristan Dingomé,CMR,MF,Troyes,Ligue 1,26,1991,13.2,25,20,12,9,4,5,13,38.5,8,12,0,12,12,37,16,1,Matches
683,Ismaël Diomandé,CIV,"DF,MF",Caen,Ligue 1,24,1992,7.9,14,8,7,6,1,10,15,66.7,5,11,5,6,5,19,20,0,Matches
684,Lois Diony,FRA,FW,Saint-Étienne,Ligue 1,24,1992,10.3,3,0,1,2,0,0,3,0.0,3,5,1,4,1,4,8,0,Matches
685,Issa Diop,FRA,DF,Toulouse,Ligue 1,20,1997,34.0,58,43,35,22,1,21,48,43.8,27,38,25,13,76,134,128,0,Matches
686,Papakouli Diop,SEN,MF,Espanyol,La Liga,31,1986,2.9,5,3,1,3,1,0,3,0.0,3,5,2,3,6,11,6,0,Matches
687,Papakouli Diop,SEN,MF,Eibar,La Liga,31,1986,10.4,26,20,6,16,4,11,26,42.3,15,3,0,3,13,39,10,0,Matches
688,Assane Dioussé,SEN,MF,Saint-Étienne,Ligue 1,19,1997,14.9,32,21,14,14,4,13,34,38.2,21,29,2,27,11,43,16,2,Matches
689,Djené,TOG,DF,Getafe,La Liga,25,1991,36.0,87,65,71,15,1,34,52,65.4,18,33,14,19,78,165,190,1,Matches
690,Koffi Djidji,CIV,DF,Nantes,Ligue 1,24,1992,26.8,55,39,32,20,3,19,29,65.5,10,34,15,19,45,100,126,0,Matches
691,Alexander Djiku,GHA,DF,Caen,Ligue 1,22,1994,28.0,65,43,52,11,2,25,52,48.1,27,34,5,29,57,122,155,2,Matches
692,Papy Djilobodji,SEN,DF,Dijon,Ligue 1,28,1988,30.0,45,29,34,11,0,21,43,48.8,22,38,25,13,71,116,211,5,Matches
693,Berat Djimsiti,ALB,DF,Benevento,Serie A,24,1993,30.0,32,17,28,4,0,12,30,40.0,18,37,23,14,62,94,178,1,Matches
694,Marko Dmitrović,SRB,GK,Eibar,La Liga,25,1992,36.0,4,4,4,0,0,4,11,36.4,7,1,0,1,2,6,26,2,Matches
695,Keagan Dolly,RSA,"MF,FW",Montpellier,Ligue 1,24,1993,9.8,12,7,2,7,3,1,11,9.1,10,11,0,11,1,13,2,0,Matches
696,Jaume Doménech,ESP,GK,Valencia,La Liga,26,1990,5.0,0,0,0,0,0,0,0,,0,0,0,0,0,0,2,0,Matches
697,Jean-Luc Dompé,FRA,FW,Amiens,Ligue 1,21,1995,0.3,0,0,0,0,0,0,0,,0,0,0,0,0,0,0,0,Matches
698,Giulio Donati,ITA,"DF,FW",Mainz 05,Bundesliga,27,1990,25.4,56,42,30,21,5,34,50,68.0,16,38,8,30,35,91,66,1,Matches
699,Ji Dong-won,KOR,"FW,MF",Augsburg,Bundesliga,26,1991,0.2,2,1,0,1,1,0,0,,0,1,1,0,1,3,0,0,Matches
700,Anastasios Donis,GRE,"MF,FW",Stuttgart,Bundesliga,20,1996,10.5,20,14,10,6,4,6,8,75.0,2,2,0,2,9,29,7,0,Matches
701,Gianluigi Donnarumma,ITA,GK,Milan,Serie A,18,1999,38.0,1,0,1,0,0,1,1,100.0,0,0,0,0,1,2,13,8,Matches
702,Godfred Donsah,GHA,MF,Bologna,Serie A,21,1996,19.9,29,20,11,14,4,10,17,58.8,7,25,0,25,22,51,43,0,Matches
703,Dória,BRA,DF,Marseille,Ligue 1,22,1994,0.9,2,2,0,2,0,0,0,,0,3,1,2,1,3,1,0,Matches
704,Niklas Dorsch,GER,MF,Bayern Munich,Bundesliga,19,1998,1.0,1,1,0,1,0,0,2,0.0,2,0,0,0,1,2,0,0,Matches
705,Mauro dos Santos,ARG,DF,Leganés,La Liga,28,1989,10.9,16,14,11,5,0,10,15,66.7,5,7,5,2,12,28,53,1,Matches
706,Mathieu Dossevi,TOG,"FW,MF",Metz,Ligue 1,29,1988,27.9,35,25,15,15,5,7,39,17.9,32,24,3,21,28,63,12,0,Matches
707,Abdoulaye Doucouré,MLI,MF,Watford,Premier League,24,1993,36.9,79,52,28,42,9,27,79,34.2,52,43,10,33,54,133,61,0,Matches
708,Cheick Doukouré,CIV,MF,Levante,La Liga,24,1992,11.4,34,19,18,15,1,6,22,27.3,16,15,4,11,14,48,4,0,Matches
709,Mohamed Dräger,TUN,"MF,FW",Freiburg,Bundesliga,21,1996,0.6,0,0,0,0,0,0,1,0.0,1,1,0,1,0,0,0,0,Matches
710,Aleksandar Dragović,AUT,DF,Leicester City,Premier League,26,1991,8.5,13,10,13,0,0,7,13,53.8,6,16,8,8,16,29,46,0,Matches
711,Aleksandar Dragović,AUT,DF,Leverkusen,Bundesliga,26,1991,0.5,0,0,0,0,0,0,1,0.0,1,0,0,0,0,0,0,1,Matches
712,Bartłomiej Drągowski,POL,GK,Fiorentina,Serie A,19,1997,2.4,0,0,0,0,0,0,0,,0,0,0,0,0,0,0,1,Matches
713,Boukary Dramé,SEN,"DF,MF",SPAL,Serie A,32,1985,1.1,1,1,1,0,0,0,0,,0,0,0,0,2,3,4,0,Matches
714,Julian Draxler,GER,"MF,FW",Paris S-G,Ligue 1,23,1993,18.9,20,14,4,13,3,6,32,18.8,26,18,2,16,28,48,8,0,Matches
715,Danny Drinkwater,ENG,MF,Chelsea,Premier League,27,1990,5.9,15,10,6,8,1,3,17,17.6,14,10,2,8,8,23,7,0,Matches
716,Josip Drmić,SUI,"FW,MF",Gladbach,Bundesliga,24,1992,5.2,0,0,0,0,0,0,4,0.0,4,1,0,1,0,0,1,1,Matches
717,Rick van Drongelen,NED,DF,Hamburger SV,Bundesliga,18,1998,16.0,30,25,23,7,0,21,28,75.0,7,20,11,9,19,49,58,1,Matches
718,Óscar Duarte,CRC,DF,Espanyol,La Liga,28,1989,11.0,12,9,8,4,0,4,11,36.4,7,8,8,0,9,21,60,2,Matches
719,Rubén Duarte,ESP,DF,Alavés,La Liga,21,1995,23.8,76,40,42,27,7,35,59,59.3,24,40,10,30,44,120,94,0,Matches
720,Leo Dubois,FRA,DF,Nantes,Ligue 1,22,1994,33.6,50,39,33,15,2,20,47,42.6,27,47,13,34,50,100,99,2,Matches
721,Martin Dúbravka,SVK,GK,Newcastle Utd,Premier League,28,1989,12.0,0,0,0,0,0,0,0,,0,0,0,0,0,0,3,2,Matches
722,Ondrej Duda,SVK,MF,Hertha BSC,Bundesliga,22,1994,8.3,16,12,7,6,3,6,14,42.9,8,15,0,15,4,20,8,0,Matches
723,Shane Duffy,IRL,DF,Brighton,Premier League,25,1992,36.6,31,19,22,9,0,7,20,35.0,13,66,59,7,50,81,332,5,Matches
724,Paul Dummett,WAL,DF,Newcastle Utd,Premier League,25,1991,17.8,28,19,21,7,0,13,27,48.1,14,27,10,17,23,51,107,1,Matches
725,Alfred Duncan,GHA,MF,Sassuolo,Serie A,24,1993,21.6,39,29,16,18,5,15,52,28.8,37,32,2,30,19,58,29,1,Matches
726,Lewis Dunk,ENG,DF,Brighton,Premier League,25,1991,38.0,67,33,49,18,0,25,48,52.1,23,73,58,15,71,138,230,2,Matches
727,Maxime Dupé,FRA,GK,Nantes,Ligue 1,24,1993,1.0,0,0,0,0,0,0,0,,0,0,0,0,0,0,2,0,Matches
728,Jimmy Durmaz,SWE,"MF,FW",Toulouse,Ligue 1,28,1989,11.4,16,9,5,5,6,6,14,42.9,8,2,0,2,14,30,9,0,Matches
729,Riza Durmisi,DEN,DF,Betis,La Liga,23,1994,23.1,39,21,24,14,1,10,18,55.6,8,18,7,11,15,54,65,1,Matches
730,Hugo Duro,ESP,FW,Getafe,La Liga,17,1999,0.2,0,0,0,0,0,0,1,0.0,1,0,0,0,0,0,0,0,Matches
731,Noë Dussenne,BEL,FW,Crotone,Serie A,25,1992,0.9,2,0,2,0,0,0,0,,0,0,0,0,1,3,8,0,Matches
732,Paulo Dybala,ARG,"MF,FW",Juventus,Serie A,23,1993,26.1,19,11,4,10,5,4,32,12.5,28,22,0,22,12,31,4,0,Matches
733,Nathan Dyer,ENG,"MF,FW",Swansea City,Premier League,29,1987,14.5,22,16,8,9,5,6,24,25.0,18,13,0,13,11,33,3,0,Matches
734,Edin Džeko,BIH,FW,Roma,Serie A,31,1986,33.5,15,10,1,9,5,3,15,20.0,12,9,1,8,4,19,36,0,Matches
735,Blerim Džemaili,SUI,"MF,FW",Bologna,Serie A,31,1986,13.3,27,19,11,15,1,9,27,33.3,18,15,4,11,18,45,11,0,Matches
736,Félix Eboa Eboa,CMR,DF,Guingamp,Ligue 1,20,1997,16.9,19,11,12,7,0,8,16,50.0,8,21,11,10,39,58,119,2,Matches
737,Éder,ITA,"FW,MF",Inter,Serie A,30,1986,8.9,10,7,2,4,4,0,10,0.0,10,6,1,5,5,15,4,0,Matches
738,Simone Edera,ITA,"FW,MF",Torino,Serie A,20,1997,3.6,6,2,2,4,0,3,10,30.0,7,0,0,0,2,8,1,0,Matches
739,Ederson,BRA,GK,Manchester City,Premier League,23,1993,35.5,1,1,1,0,0,0,0,,0,1,0,1,0,1,15,6,Matches
740,Tom Edwards,ENG,"DF,MF",Stoke City,Premier League,18,1999,5.3,15,9,10,5,0,8,8,100.0,0,5,2,3,5,20,20,0,Matches
741,Mandela Egbo,ENG,"DF,MF",Gladbach,Bundesliga,19,1997,0.1,0,0,0,0,0,0,0,,0,0,0,0,0,0,2,0,Matches
742,Johannes Eggestein,GER,"FW,DF",Werder Bremen,Bundesliga,19,1998,1.1,0,0,0,0,0,0,1,0.0,1,2,1,1,1,1,0,0,Matches
743,Maximilian Eggestein,GER,MF,Werder Bremen,Bundesliga,20,1996,29.9,70,48,32,34,4,34,58,58.6,24,41,6,35,40,110,51,0,Matches
744,Albin Ekdal,SWE,MF,Hamburger SV,Bundesliga,28,1989,12.3,39,28,19,19,1,18,29,62.1,11,20,3,17,21,60,19,0,Matches
745,Josip Elez,CRO,DF,Hannover 96,Bundesliga,23,1994,8.6,12,8,9,2,1,5,9,55.6,4,9,7,2,16,28,39,1,Matches
746,Rob Elliot,IRL,GK,Newcastle Utd,Premier League,31,1986,16.0,0,0,0,0,0,0,1,0.0,1,0,0,0,0,0,8,0,Matches
747,Mohamed Elneny,EGY,MF,Arsenal,Premier League,25,1992,9.6,12,6,6,3,3,6,10,60.0,4,11,0,11,10,22,12,2,Matches
748,Aritz Elustondo,ESP,DF,Real Sociedad,La Liga,23,1994,17.7,32,20,20,9,3,19,30,63.3,11,20,7,13,45,77,84,0,Matches
749,Nico Elvedi,SUI,DF,Gladbach,Bundesliga,20,1996,32.4,66,46,41,22,3,37,55,67.3,18,39,9,30,51,117,108,3,Matches
750,Rodrigo Ely,BRA,DF,Alavés,La Liga,23,1993,29.9,32,18,26,6,0,19,34,55.9,15,45,36,9,50,82,183,0,Matches
751,Breel Embolo,SUI,"FW,MF",Schalke 04,Bundesliga,20,1997,10.2,14,10,3,7,4,2,9,22.2,7,13,0,13,6,20,3,0,Matches
752,Youssef En-Nesyri,MAR,FW,Málaga,La Liga,20,1997,17.7,31,25,10,14,7,6,26,23.1,20,11,0,11,9,40,32,0,Matches
753,Sergi Enrich,ESP,FW,Eibar,La Liga,27,1990,14.8,11,8,3,3,5,2,8,25.0,6,13,1,12,6,17,8,0,Matches
754,Javier Eraso,ESP,"MF,FW",Leganés,La Liga,27,1990,28.1,32,15,10,18,4,13,42,31.0,29,16,5,11,23,55,17,0,Matches
755,Christian Eriksen,DEN,"MF,FW",Tottenham,Premier League,25,1992,35.8,51,29,16,30,5,17,59,28.8,42,38,1,37,31,82,21,0,Matches
756,Gonzalo Escalante,ARG,MF,Eibar,La Liga,24,1993,17.4,59,35,21,32,6,17,39,43.6,22,26,3,23,32,91,19,0,Matches
757,Sergio Escudero,ESP,DF,Sevilla,La Liga,27,1989,25.9,78,49,40,26,12,32,62,51.6,30,35,6,29,66,144,69,1,Matches
758,Bernardo Espinosa,COL,DF,Girona,La Liga,28,1989,31.9,36,22,29,6,1,18,33,54.5,15,27,19,8,66,102,169,0,Matches
759,Michael Esser,GER,GK,Hannover 96,Bundesliga,29,1987,3.0,0,0,0,0,0,0,1,0.0,1,0,0,0,0,0,0,0,Matches
760,Alexander Esswein,GER,"FW,MF",Hertha BSC,Bundesliga,27,1990,6.9,25,16,13,10,2,12,25,48.0,13,4,0,4,9,34,11,0,Matches
761,Oghenekaro Etebo,NGA,MF,Las Palmas,La Liga,21,1995,13.5,24,17,9,12,3,12,26,46.2,14,17,3,14,27,51,10,0,Matches
762,Beñat Etxebarria,ESP,MF,Athletic Club,La Liga,30,1987,12.4,28,20,12,13,3,13,36,36.1,23,6,1,5,28,56,12,0,Matches
763,Xabier Etxeita,ESP,DF,Athletic Club,La Liga,29,1987,4.2,2,2,2,0,0,1,4,25.0,3,3,2,1,7,9,25,1,Matches
764,Jonny Evans,NIR,DF,West Brom,Premier League,29,1988,25.2,29,22,19,8,2,14,33,42.4,19,22,13,9,48,77,131,1,Matches
765,Franck Evina,CMR,FW,Bayern Munich,Bundesliga,17,2000,1.2,2,2,2,0,0,2,2,100.0,0,5,0,5,0,2,0,0,Matches
766,Patrice Evra,FRA,"DF,MF",West Ham,Premier League,36,1981,2.5,6,4,5,1,0,6,8,75.0,2,4,1,3,7,13,6,0,Matches
767,Patrice Evra,FRA,DF,Marseille,Ligue 1,36,1981,3.9,6,5,5,1,0,3,6,50.0,3,2,2,0,3,9,16,0,Matches
768,Edu Expósito,ESP,"MF,FW",La Coruña,La Liga,20,1996,1.1,1,0,0,0,1,0,1,0.0,1,1,0,1,2,3,2,0,Matches
769,Erik Expósito,ESP,FW,Las Palmas,La Liga,21,1996,5.2,1,1,0,1,0,0,6,0.0,6,6,0,6,1,2,5,0,Matches
770,Valentin Eysseric,FRA,"FW,MF",Fiorentina,Serie A,25,1992,7.8,17,13,7,4,6,6,20,30.0,14,10,2,8,6,23,6,0,Matches
771,Valentin Eysseric,FRA,FW,Nice,Ligue 1,25,1992,1.0,0,0,0,0,0,0,0,,0,4,0,4,1,1,0,0,Matches
772,Imoh Ezekiel,NGA,"MF,FW",Las Palmas,La Liga,23,1993,5.2,8,6,3,2,3,3,4,75.0,1,4,0,4,2,10,3,0,Matches
773,Marco Fabián,MEX,"MF,FW",Eint Frankfurt,Bundesliga,28,1989,4.7,5,3,2,3,0,3,4,75.0,1,2,0,2,3,8,1,0,Matches
774,Łukasz Fabiański,POL,GK,Swansea City,Premier League,32,1985,38.0,0,0,0,0,0,0,0,,0,0,0,0,0,0,10,2,Matches
775,Fabinho,BRA,MF,Monaco,Ligue 1,23,1993,34.0,114,64,38,67,9,48,112,42.9,64,48,13,35,43,157,62,0,Matches
776,Cesc Fàbregas,ESP,MF,Chelsea,Premier League,30,1987,25.6,68,49,30,29,9,18,69,26.1,51,25,4,21,22,90,26,2,Matches
777,Ralf Fährmann,GER,GK,Schalke 04,Bundesliga,28,1988,33.5,1,0,1,0,0,1,3,33.3,2,1,0,1,1,2,12,7,Matches
778,Fayçal Fajr,MAR,"MF,FW",Getafe,La Liga,28,1988,26.5,62,45,22,34,6,17,66,25.8,49,26,4,22,30,92,42,0,Matches
779,Radamel Falcao,COL,FW,Monaco,Ligue 1,31,1986,23.7,11,6,0,8,3,2,13,15.4,11,13,3,10,10,21,11,0,Matches
780,Diego Falcinelli,ITA,FW,Fiorentina,Serie A,26,1991,4.9,1,1,1,0,0,0,5,0.0,5,5,1,4,1,2,4,0,Matches
781,Diego Falcinelli,ITA,FW,Sassuolo,Serie A,26,1991,14.6,4,4,1,2,1,1,13,7.7,12,12,2,10,2,6,9,0,Matches
782,Simon Falette,GUI,DF,Metz,Ligue 1,25,1992,1.0,0,0,0,0,0,0,0,,0,0,0,0,1,1,8,0,Matches
783,Simon Falette,GUI,DF,Eint Frankfurt,Bundesliga,25,1992,24.6,34,30,23,10,1,19,31,61.3,12,37,15,22,58,92,134,1,Matches
784,Cesar Falletti,URU,"MF,FW",Bologna,Serie A,24,1992,3.6,11,7,4,6,1,4,8,50.0,4,10,0,10,0,11,5,0,Matches
785,Iago Falque,ESP,"FW,MF",Torino,Serie A,27,1990,31.3,41,31,15,20,6,6,43,14.0,37,22,0,22,15,56,15,0,Matches
786,Paolo Faragò,ITA,DF,Cagliari,Serie A,24,1993,27.3,92,67,53,24,15,24,60,40.0,36,41,5,36,23,115,76,0,Matches
787,Imad Faraj,MAR,"MF,DF",Lille,Ligue 1,18,1999,1.8,5,2,2,1,2,4,8,50.0,4,1,0,1,4,9,3,0,Matches
788,Davide Faraoni,ITA,"DF,MF",Crotone,Serie A,25,1991,19.5,62,39,36,20,6,28,47,59.6,19,30,8,22,58,120,76,0,Matches
789,Mohamed Fares,ALG,"DF,MF",Hellas Verona,Serie A,21,1996,28.9,50,33,29,17,4,16,42,38.1,26,24,5,19,50,100,132,2,Matches
790,Diego Farias,BRA,"FW,MF",Cagliari,Serie A,27,1990,17.9,21,15,3,9,9,6,24,25.0,18,17,0,17,8,29,6,0,Matches
791,Federico Fazio,ARG,DF,Roma,Serie A,30,1987,32.5,56,43,38,18,0,25,31,80.6,6,30,22,8,46,102,161,3,Matches
792,Zouhair Feddal,MAR,DF,Betis,La Liga,28,1989,14.0,22,14,14,6,2,7,12,58.3,5,17,13,4,36,58,95,2,Matches
793,Nabil Fekir,FRA,"MF,FW",Lyon,Ligue 1,24,1993,27.5,45,33,11,24,10,8,40,20.0,32,11,0,11,8,53,5,0,Matches
794,Felipe,BRA,DF,Hannover 96,Bundesliga,30,1987,5.1,8,8,4,4,0,2,4,50.0,2,4,3,1,11,19,29,0,Matches
795,Luiz Felipe,ITA,DF,Lazio,Serie A,20,1997,13.0,40,28,24,16,0,15,25,60.0,10,26,14,12,18,58,50,1,Matches
796,Ohis Felix Uduokhai,GER,DF,Wolfsburg,Bundesliga,19,1997,17.3,42,23,27,13,2,17,24,70.8,7,23,10,13,34,76,66,6,Matches
797,Marouane Fellaini,BEL,MF,Manchester Utd,Premier League,29,1987,7.6,15,8,6,8,1,2,11,18.2,9,12,3,9,14,29,19,1,Matches
798,Kiko Femenía,ESP,"DF,FW",Watford,Premier League,26,1991,19.0,36,28,22,11,3,14,27,51.9,13,15,2,13,34,70,31,1,Matches
799,Leroy Fer,NED,MF,Swansea City,Premier League,27,1990,15.5,44,32,18,21,5,13,30,43.3,17,18,4,14,12,56,24,3,Matches
800,Julien Féret,FRA,MF,Caen,Ligue 1,35,1982,34.0,40,27,10,25,5,14,75,18.7,61,52,7,45,49,89,58,2,Matches
801,Edimilson Fernandes,SUI,"MF,DF",West Ham,Premier League,21,1996,9.4,17,9,10,7,0,9,21,42.9,12,13,1,12,16,33,8,0,Matches
802,Gelson Fernandes,SUI,MF,Eint Frankfurt,Bundesliga,30,1986,11.5,58,46,25,29,4,23,45,51.1,22,23,3,20,16,74,21,0,Matches
803,Andrés Fernández,ESP,GK,Villarreal,La Liga,30,1986,2.5,1,0,1,0,0,0,0,,0,0,0,0,0,1,4,0,Matches
804,Augusto Fernández,ARG,MF,Atlético Madrid,La Liga,31,1986,1.2,3,2,1,2,0,1,3,33.3,2,3,2,1,2,5,3,0,Matches
805,Brian Fernández,ARG,FW,Metz,Ligue 1,22,1994,1.4,0,0,0,0,0,0,1,0.0,1,2,0,2,0,0,0,0,Matches
806,Carlos Fernández,ESP,FW,Sevilla,La Liga,21,1996,1.5,2,1,1,1,0,0,2,0.0,2,1,0,1,0,2,0,0,Matches
807,Federico Fernández,ARG,DF,Swansea City,Premier League,28,1989,29.7,40,29,30,6,4,20,30,66.7,10,35,27,8,38,78,201,1,Matches
808,Raúl Fernández,ESP,GK,Levante,La Liga,29,1988,11.0,0,0,0,0,0,0,0,,0,1,0,1,0,0,10,1,Matches
809,Fernandinho,BRA,MF,Manchester City,Premier League,32,1985,32.0,62,35,22,28,12,24,65,36.9,41,38,6,32,47,109,68,2,Matches
810,Alex Ferrari,ITA,DF,Hellas Verona,Serie A,23,1994,23.7,73,54,42,23,8,36,67,53.7,31,41,15,26,47,120,117,4,Matches
811,Jordan Ferri,FRA,MF,Lyon,Ligue 1,25,1992,7.1,20,11,8,11,1,7,20,35.0,13,11,1,10,5,25,11,2,Matches
812,Sam Field,ENG,MF,West Brom,Premier League,19,1998,6.0,14,11,8,4,2,3,10,30.0,7,6,1,5,11,25,8,0,Matches
813,Afonso Figueiredo,POR,"DF,FW",Rennes,Ligue 1,24,1993,2.5,6,3,3,3,0,3,5,60.0,2,0,0,0,0,6,4,0,Matches
814,Gian Filippo Felicioli,ITA,"MF,DF",Hellas Verona,Serie A,19,1997,3.1,13,8,5,5,3,0,4,0.0,4,0,0,0,5,18,6,0,Matches
815,Alfreð Finnbogason,ISL,FW,Augsburg,Bundesliga,28,1989,20.2,18,13,7,5,6,8,15,53.3,7,15,1,14,14,32,7,0,Matches
816,Roberto Firmino,BRA,FW,Liverpool,Premier League,25,1991,30.7,65,50,9,36,20,8,58,13.8,50,40,2,38,18,83,10,0,Matches
817,Junior Firpo,DOM,DF,Betis,La Liga,20,1996,13.2,26,17,15,8,3,10,18,55.6,8,21,2,19,20,46,37,1,Matches
818,Viktor Fischer,DEN,"FW,MF",Mainz 05,Bundesliga,23,1994,3.7,4,4,2,1,1,2,5,40.0,3,2,0,2,3,7,2,0,Matches
819,Mathieu Flamini,FRA,MF,Getafe,La Liga,33,1984,5.3,11,5,3,7,1,4,9,44.4,5,2,0,2,8,19,8,0,Matches
820,Darren Fletcher,SCO,MF,Stoke City,Premier League,33,1984,24.7,47,26,23,20,4,15,55,27.3,40,13,3,10,26,73,33,3,Matches
821,Sergio Floccari,ITA,FW,SPAL,Serie A,35,1981,9.8,13,9,7,5,1,6,11,54.5,5,6,1,5,2,15,6,0,Matches
822,Alessandro Florenzi,ITA,DF,Roma,Serie A,26,1991,26.5,38,28,20,13,5,18,47,38.3,29,19,8,11,44,82,62,1,Matches
823,Phil Foden,ENG,"MF,FW",Manchester City,Premier League,17,2000,0.5,1,1,0,1,0,0,1,0.0,1,0,0,0,0,1,1,0,Matches
824,Guessouma Fofana,MTN,MF,Amiens,Ligue 1,24,1992,8.3,20,13,8,12,0,6,13,46.2,7,7,1,6,12,32,11,0,Matches
825,Seko Fofana,CIV,MF,Udinese,Serie A,22,1995,20.8,20,17,8,12,0,4,20,20.0,16,17,3,14,27,47,26,1,Matches
826,Andreu Fontàs,ESP,DF,Celta Vigo,La Liga,27,1989,9.8,13,9,8,5,0,3,13,23.1,10,9,5,4,14,27,30,0,Matches
827,José Fonte,POR,DF,West Ham,Premier League,33,1983,7.6,11,6,5,6,0,2,6,33.3,4,12,9,3,14,25,37,1,Matches
828,Pablo Fornals,ESP,"MF,FW",Villarreal,La Liga,21,1996,29.1,52,33,19,26,7,18,60,30.0,42,29,3,26,22,74,18,0,Matches
829,Emil Forsberg,SWE,MF,RB Leipzig,Bundesliga,25,1991,15.2,24,17,3,15,6,9,21,42.9,12,19,1,18,8,32,4,0,Matches
830,Fraser Forster,ENG,GK,Southampton,Premier League,29,1988,20.0,0,0,0,0,0,0,0,,0,0,0,0,0,0,7,4,Matches
831,Steven Fortes,CPV,DF,Toulouse,Ligue 1,25,1992,1.7,4,2,3,1,0,1,3,33.3,2,0,0,0,3,7,6,0,Matches
832,Marco Fossati,ITA,MF,Hellas Verona,Serie A,24,1992,12.2,27,13,11,14,2,11,33,33.3,22,19,6,13,23,50,31,1,Matches
833,Iver Fossum,NOR,MF,Hannover 96,Bundesliga,21,1996,14.5,27,19,8,13,6,10,31,32.3,21,28,3,25,15,42,14,0,Matches
834,Ben Foster,ENG,GK,West Brom,Premier League,34,1983,37.0,1,0,1,0,0,0,7,0.0,7,0,0,0,1,2,12,1,Matches
835,Timothy Fosu-Mensah,NED,DF,Crystal Palace,Premier League,19,1998,17.7,42,33,33,8,1,21,34,61.8,13,17,9,8,31,73,74,1,Matches
836,Dimitri Foulquier,FRA,DF,Strasbourg,Ligue 1,24,1993,13.8,25,12,15,8,2,7,17,41.2,10,15,4,11,14,39,33,0,Matches
837,Lilian Fournier,FRA,FW,Metz,Ligue 1,19,1998,0.2,0,0,0,0,0,0,0,,0,0,0,0,0,0,0,0,Matches
838,Raphael Framberger,GER,DF,Augsburg,Bundesliga,21,1995,7.7,22,18,14,6,2,15,16,93.8,1,12,3,9,14,36,15,0,Matches
839,Simon Francis,ENG,DF,Bournemouth,Premier League,32,1985,30.1,49,34,26,16,7,24,43,55.8,19,29,18,11,49,98,194,4,Matches
840,Mike Frantz,GER,MF,Freiburg,Bundesliga,30,1986,11.6,23,16,9,11,3,6,16,37.5,10,13,3,10,13,36,15,0,Matches
841,Ryan Fraser,SCO,"MF,DF",Bournemouth,Premier League,23,1994,22.3,11,8,7,2,2,7,20,35.0,13,20,4,16,17,28,34,0,Matches
842,Fabian Frei,SUI,MF,Mainz 05,Bundesliga,28,1989,8.9,22,15,7,12,3,8,15,53.3,7,10,0,10,16,38,17,1,Matches
843,Remo Freuler,SUI,MF,Atalanta,Serie A,25,1992,33.4,89,62,35,41,13,27,82,32.9,55,46,13,33,28,117,37,2,Matches
844,Marco Friedl,AUT,"DF,MF",Werder Bremen,Bundesliga,19,1998,6.7,9,8,4,4,1,7,10,70.0,3,10,1,9,8,17,17,1,Matches
845,Marco Friedl,AUT,MF,Bayern Munich,Bundesliga,19,1998,0.5,0,0,0,0,0,0,0,,0,1,0,1,1,1,0,0,Matches
846,Christian Fuchs,AUT,DF,Leicester City,Premier League,31,1986,21.3,41,27,25,12,4,14,40,35.0,26,23,3,20,58,99,86,0,Matches
847,Javi Fuego,ESP,MF,Villarreal,La Liga,33,1984,6.0,20,13,8,11,1,7,14,50.0,7,7,4,3,3,23,14,0,Matches
848,Javi Fuego,ESP,MF,Espanyol,La Liga,33,1984,14.9,34,25,19,12,3,11,28,39.3,17,15,6,9,19,53,23,0,Matches
849,Chris Führich,GER,MF,Köln,Bundesliga,19,1998,1.1,4,3,1,2,1,2,5,40.0,3,3,0,3,0,4,1,0,Matches
850,Angelo Fulgini,FRA,MF,Angers,Ligue 1,20,1996,17.0,21,11,9,8,4,8,27,29.6,19,21,2,19,20,41,7,0,Matches
851,Niclas Füllkrug,GER,FW,Hannover 96,Bundesliga,24,1993,26.5,16,11,4,8,4,10,20,50.0,10,22,3,19,8,24,30,0,Matches
852,Jay Fulton,SCO,MF,Swansea City,Premier League,23,1994,0.2,0,0,0,0,0,0,0,,0,0,0,0,0,0,1,0,Matches
853,Ramiro Funes Mori,ARG,DF,Everton,Premier League,26,1991,1.3,0,0,0,0,0,0,0,,0,1,1,0,3,3,14,0,Matches
854,Manolo Gabbiadini,ITA,FW,Southampton,Premier League,25,1991,12.0,3,2,0,2,1,1,15,6.7,14,3,0,3,4,7,6,0,Matches
855,Gabi,ESP,MF,Atlético Madrid,La Liga,34,1983,26.1,80,49,39,37,4,38,104,36.5,66,28,10,18,44,124,38,0,Matches
856,Gabriel,BRA,MF,Leganés,La Liga,23,1993,26.4,90,69,28,54,8,29,74,39.2,45,38,4,34,38,128,27,0,Matches
857,Mijat Gaćinović,SRB,"MF,FW",Eint Frankfurt,Bundesliga,22,1995,20.2,56,44,21,27,8,20,52,38.5,32,38,1,37,39,95,22,1,Matches
858,Roberto Gagliardini,ITA,MF,Inter,Serie A,23,1994,22.1,63,45,28,29,6,20,54,37.0,34,18,3,15,45,108,32,2,Matches
859,Nicolás Gaitán,ARG,"MF,FW",Atlético Madrid,La Liga,29,1988,2.4,9,6,3,5,1,3,9,33.3,6,2,0,2,1,10,3,0,Matches
860,Milan Gajić,SRB,DF,Bordeaux,Ligue 1,21,1996,4.0,6,3,4,2,0,2,4,50.0,2,7,0,7,4,10,14,0,Matches
861,Serge Gakpé,TOG,"FW,MF",Amiens,Ligue 1,30,1987,20.3,16,11,9,7,0,6,27,22.2,21,18,1,17,10,26,15,0,Matches
862,Andrey Galabinov,BUL,FW,Genoa,Serie A,28,1988,12.5,7,5,0,5,2,0,5,0.0,5,17,1,16,2,9,11,0,Matches
863,Álex Gálvez,ESP,DF,Las Palmas,La Liga,28,1989,18.0,50,36,26,24,0,22,41,53.7,19,20,11,9,43,93,74,2,Matches
864,Álex Gálvez,ESP,DF,Eibar,La Liga,28,1989,4.0,11,4,5,6,0,7,12,58.3,5,5,1,4,13,24,17,0,Matches
865,Bruno Gama,POR,"FW,MF",La Coruña,La Liga,29,1987,1.3,1,1,1,0,0,1,3,33.3,2,0,0,0,0,1,2,0,Matches
866,Alessandro Gamberini,ITA,DF,Chievo,Serie A,35,1981,20.2,13,8,11,2,0,8,12,66.7,4,32,25,7,16,29,117,1,Matches
867,Kévin Gameiro,FRA,FW,Atlético Madrid,La Liga,30,1987,12.5,11,9,3,4,4,1,10,10.0,9,6,0,6,4,15,11,0,Matches
868,Jesús Gámez,ESP,DF,Newcastle Utd,Premier League,32,1985,1.1,4,2,1,0,3,1,3,33.3,2,2,0,2,2,6,5,0,Matches
869,Idrissa Gana Gueye,SEN,MF,Everton,Premier League,27,1989,30.6,117,93,65,41,11,35,86,40.7,51,59,9,50,62,179,48,1,Matches
870,Ignatius Ganago,CMR,"FW,MF",Nice,Ligue 1,18,1999,0.8,0,0,0,0,0,0,2,0.0,2,1,0,1,0,0,1,0,Matches
871,Najib Gandi,FRA,"FW,MF",Nantes,Ligue 1,23,1994,1.1,6,5,3,2,1,4,6,66.7,2,4,1,3,4,10,3,0,Matches
872,Ganso,BRA,MF,Sevilla,La Liga,27,1989,5.8,15,11,3,12,0,3,11,27.3,8,7,0,7,2,17,4,0,Matches
873,Ezequiel Garay,ARG,DF,Valencia,La Liga,30,1986,22.5,18,12,15,3,0,10,14,71.4,4,22,11,11,24,42,139,0,Matches
874,Aleix García,ESP,MF,Girona,La Liga,20,1997,9.5,24,14,13,9,2,12,22,54.5,10,9,1,8,17,41,12,0,Matches
875,Borja García,ESP,MF,Girona,La Liga,26,1990,31.1,39,18,15,18,6,13,39,33.3,26,31,2,29,30,69,15,0,Matches
876,Dani García,ESP,MF,Eibar,La Liga,27,1990,30.8,80,59,23,47,10,31,80,38.8,49,28,4,24,70,150,25,0,Matches
877,David García,ESP,DF,Las Palmas,La Liga,35,1982,9.6,16,10,10,4,2,8,12,66.7,4,15,8,7,19,35,33,1,Matches
878,Javi García,ESP,"MF,DF",Betis,La Liga,30,1987,26.8,34,22,18,16,0,13,40,32.5,27,19,12,7,25,59,78,1,Matches
879,Manu García,ESP,MF,Alavés,La Liga,31,1986,27.1,95,65,38,51,6,24,89,27.0,65,34,11,23,35,130,67,0,Matches
880,Raúl García,ESP,"MF,FW",Athletic Club,La Liga,31,1986,29.2,82,51,28,36,18,26,71,36.6,45,55,3,52,30,112,23,0,Matches
881,Raúl García,ESP,DF,Leganés,La Liga,28,1989,15.5,34,25,24,9,1,18,30,60.0,12,18,3,15,19,53,50,1,Matches
882,Samu García,ESP,MF,Málaga,La Liga,27,1990,2.0,8,6,4,3,1,3,10,30.0,7,4,0,4,6,14,3,0,Matches
883,Samu García,ESP,"FW,MF",Levante,La Liga,27,1990,2.1,9,7,1,6,2,2,5,40.0,3,3,0,3,1,10,2,0,Matches
884,Sergio García,ESP,"FW,MF",Espanyol,La Liga,34,1983,18.2,15,12,1,10,4,3,22,13.6,19,6,3,3,10,25,12,0,Matches
885,Ulisses Garcia,SUI,FW,Werder Bremen,Bundesliga,21,1996,1.0,1,1,1,0,0,1,2,50.0,1,0,0,0,0,1,3,0,Matches
886,Luca Garritano,ITA,"MF,FW",Chievo,Serie A,23,1994,2.1,4,3,2,1,1,0,4,0.0,4,3,1,2,1,5,6,0,Matches
887,Bruno Gaspar,ANG,DF,Fiorentina,Serie A,24,1993,8.7,20,11,13,6,1,9,15,60.0,6,8,1,7,9,29,25,0,Matches
888,Mario Gaspar,ESP,DF,Villarreal,La Liga,26,1990,31.2,110,66,63,37,10,58,87,66.7,29,58,11,47,58,168,114,0,Matches
889,Gianluca Gaudino,GER,MF,Chievo,Serie A,20,1996,0.2,0,0,0,0,0,0,0,,0,1,0,1,0,0,1,0,Matches
890,Dwight Gayle,ENG,FW,Newcastle Utd,Premier League,26,1990,21.8,12,10,2,8,2,1,21,4.8,20,16,2,14,6,18,17,0,Matches
891,Paulo Gazzaniga,ARG,GK,Tottenham,Premier League,25,1992,1.0,0,0,0,0,0,0,1,0.0,1,0,0,0,0,0,0,0,Matches
892,Marcello Gazzola,ITA,DF,Sassuolo,Serie A,32,1985,8.2,10,9,3,6,1,8,12,66.7,4,10,2,8,8,18,25,0,Matches
893,Jean-Philippe Gbamin,CIV,"MF,DF",Mainz 05,Bundesliga,21,1995,28.8,78,63,48,26,4,43,65,66.2,22,50,10,40,50,128,80,0,Matches
894,David de Gea,ESP,GK,Manchester Utd,Premier League,26,1990,37.0,0,0,0,0,0,0,1,0.0,1,1,0,1,0,0,9,3,Matches
895,Theodor Gebre Selassie,CZE,"DF,FW",Werder Bremen,Bundesliga,30,1986,31.4,67,41,36,25,6,36,57,63.2,21,34,2,32,51,118,83,1,Matches
896,Dennis Geiger,GER,MF,Hoffenheim,Bundesliga,19,1998,17.6,52,36,19,31,2,16,40,40.0,24,38,2,36,15,67,7,0,Matches
897,Johannes Geis,GER,"DF,MF",Sevilla,La Liga,23,1993,7.5,20,15,12,7,1,11,21,52.4,10,13,5,8,10,30,27,1,Matches
898,Jérémy Gélin,FRA,"DF,MF",Rennes,Ligue 1,20,1997,25.7,37,18,22,14,1,20,53,37.7,33,22,12,10,37,74,92,3,Matches
899,Romain Genevois,HAI,DF,Caen,Ligue 1,29,1987,20.1,48,28,27,13,8,21,39,53.8,18,25,11,14,31,79,76,0,Matches
900,Santiago Gentiletti,ARG,DF,Genoa,Serie A,32,1985,3.2,4,3,4,0,0,1,6,16.7,5,1,0,1,3,7,11,1,Matches
901,Christian Gentner,GER,MF,Stuttgart,Bundesliga,31,1985,26.8,91,67,35,44,12,44,84,52.4,40,41,5,36,35,126,52,0,Matches
902,Yannick Gerhardt,GER,"DF,MF",Wolfsburg,Bundesliga,23,1994,13.6,37,28,18,14,5,22,34,64.7,12,25,5,20,15,52,31,0,Matches
903,Valère Germain,FRA,FW,Marseille,Ligue 1,27,1990,24.1,16,11,5,7,4,3,18,16.7,15,11,0,11,6,22,19,0,Matches
904,Gerson,BRA,"MF,FW",Roma,Serie A,20,1997,10.1,20,12,10,8,2,2,7,28.6,5,15,2,13,11,31,11,1,Matches
905,Willem Geubbels,FRA,"FW,MF",Lyon,Ligue 1,15,2001,0.4,2,2,1,1,0,0,1,0.0,1,0,0,0,0,2,0,0,Matches
906,Yassine El Ghanassy,BEL,"MF,FW",Nantes,Ligue 1,27,1990,7.2,7,4,1,3,3,1,4,25.0,3,1,0,1,4,11,4,0,Matches
907,Anwar El Ghazi,NED,"FW,MF",Lille,Ligue 1,22,1995,18.3,23,18,7,13,3,9,29,31.0,20,11,1,10,7,30,7,1,Matches
908,Rachid Ghezzal,ALG,"FW,MF",Monaco,Ligue 1,25,1992,11.2,31,24,6,22,3,7,34,20.6,27,17,0,17,11,42,2,1,Matches
909,Faouzi Ghoulam,ALG,DF,Napoli,Serie A,26,1991,10.9,8,4,3,5,0,4,6,66.7,2,10,2,8,15,23,19,0,Matches
910,Emanuele Giaccherini,ITA,"MF,FW",Chievo,Serie A,32,1985,10.0,7,4,4,2,1,5,25,20.0,20,9,3,6,5,12,6,0,Matches
911,Emanuele Giaccherini,ITA,"FW,MF",Napoli,Serie A,32,1985,0.7,1,1,0,1,0,0,0,,0,0,0,0,0,1,0,0,Matches
912,Niccolò Giannetti,ITA,"FW,DF",Cagliari,Serie A,26,1991,3.3,5,4,2,3,0,2,6,33.3,4,1,0,1,1,6,3,0,Matches
913,Kieran Gibbs,ENG,DF,West Brom,Premier League,27,1989,31.4,41,24,27,10,4,16,30,53.3,14,32,12,20,48,89,102,0,Matches
914,Rafał Gikiewicz,POL,GK,Freiburg,Bundesliga,29,1987,1.7,0,0,0,0,0,0,0,,0,0,0,0,0,0,0,0,Matches
915,Carles Gil,ESP,"FW,MF",La Coruña,La Liga,24,1992,5.3,6,4,1,4,1,1,5,20.0,4,5,0,5,4,10,0,0,Matches
916,Nacho Gil,ESP,"FW,MF",Las Palmas,La Liga,21,1995,8.1,10,6,6,2,2,5,21,23.8,16,9,0,9,6,16,2,0,Matches
917,Nacho Gil,ESP,MF,Valencia,La Liga,21,1995,2.5,6,1,2,4,0,1,8,12.5,7,6,0,6,2,8,2,0,Matches
918,Guillaume Gillet,BEL,MF,Nantes,Ligue 1,33,1984,0.2,0,0,0,0,0,0,0,,0,1,1,0,0,0,0,0,Matches
919,Dani Giménez,ESP,GK,Betis,La Liga,34,1983,3.4,0,0,0,0,0,0,0,,0,0,0,0,0,0,0,0,Matches
920,Daniel Ginczek,GER,FW,Stuttgart,Bundesliga,26,1991,16.9,8,4,3,5,0,2,12,16.7,10,16,1,15,5,13,13,0,Matches
921,Matthias Ginter,GER,DF,Gladbach,Bundesliga,23,1994,34.0,48,37,27,20,1,35,45,77.8,10,40,17,23,40,88,114,1,Matches
922,Jimmy Giraudon,FRA,DF,Troyes,Ligue 1,25,1992,23.2,26,16,20,6,0,10,16,62.5,6,30,22,8,31,57,128,2,Matches
923,Thibault Giresse,FRA,"FW,MF",Guingamp,Ligue 1,36,1981,0.3,0,0,0,0,0,0,0,,0,0,0,0,1,1,0,0,Matches
924,Andrei Girotto,BRA,MF,Nantes,Ligue 1,25,1992,16.9,57,38,15,37,5,21,52,40.4,31,32,7,25,15,72,45,1,Matches
925,Olivier Giroud,FRA,FW,Arsenal,Premier League,30,1986,4.3,5,4,1,2,2,1,5,20.0,4,1,0,1,1,6,4,0,Matches
926,Olivier Giroud,FRA,FW,Chelsea,Premier League,30,1986,6.8,4,3,1,2,1,1,3,33.3,2,0,0,0,1,5,5,0,Matches
927,Kamil Glik,POL,DF,Monaco,Ligue 1,29,1988,36.0,36,23,22,12,2,15,29,51.7,14,28,18,10,54,90,279,2,Matches
928,Serge Gnabry,GER,FW,Hoffenheim,Bundesliga,22,1995,16.7,32,22,10,18,4,13,24,54.2,11,15,1,14,8,40,9,2,Matches
929,Joris Gnagnon,FRA,DF,Rennes,Ligue 1,20,1997,32.4,42,29,29,9,4,21,31,67.7,10,22,16,6,29,71,154,2,Matches
930,Massimo Gobbi,ITA,DF,Chievo,Serie A,36,1980,22.8,24,18,13,9,2,11,26,42.3,15,20,5,15,22,46,90,1,Matches
931,Diego Godín,URU,DF,Atlético Madrid,La Liga,31,1986,28.4,50,33,37,11,2,26,47,55.3,21,33,20,13,59,109,145,1,Matches
932,Edoardo Goldaniga,ITA,DF,Sassuolo,Serie A,23,1993,12.8,14,8,10,4,0,5,9,55.6,4,10,5,5,19,33,56,0,Matches
933,Connor Goldson,ENG,DF,Brighton,Premier League,24,1992,2.2,2,2,1,1,0,1,4,25.0,3,3,3,0,1,3,9,0,Matches
934,Pierluigi Gollini,ITA,GK,Atalanta,Serie A,22,1995,6.9,0,0,0,0,0,0,0,,0,0,0,0,0,0,1,0,Matches
935,André Gomes,POR,MF,Barcelona,La Liga,24,1993,7.1,19,12,8,10,1,5,13,38.5,8,7,1,6,4,23,6,0,Matches
936,Heurelho Gomes,BRA,GK,Watford,Premier League,36,1981,23.6,0,0,0,0,0,0,1,0.0,1,1,0,1,2,2,15,3,Matches
937,Ibai Gómez,ESP,"MF,FW",Alavés,La Liga,27,1989,25.8,19,15,11,4,4,6,30,20.0,24,16,1,15,15,34,20,1,Matches
938,Joe Gomez,ENG,DF,Liverpool,Premier League,20,1997,21.1,58,45,32,23,3,21,40,52.5,19,19,8,11,34,92,57,1,Matches
939,Mario Gómez,GER,FW,Wolfsburg,Bundesliga,32,1985,10.4,6,6,2,3,1,2,6,33.3,4,10,1,9,0,6,16,0,Matches
940,Mario Gómez,GER,FW,Stuttgart,Bundesliga,32,1985,15.4,13,11,0,8,5,2,10,20.0,8,6,0,6,4,17,17,0,Matches
941,Maxi Gómez,URU,FW,Celta Vigo,La Liga,20,1996,34.1,7,4,1,4,2,0,18,0.0,18,9,4,5,3,10,34,0,Matches
942,Papu Gómez,ARG,"MF,FW",Atalanta,Serie A,29,1988,30.6,14,9,6,5,3,5,26,19.2,21,16,1,15,22,36,7,0,Matches
943,Sergi Gómez,ESP,DF,Celta Vigo,La Liga,25,1992,29.8,52,37,38,13,1,20,34,58.8,14,32,22,10,56,108,118,1,Matches
944,Sergio Gómez,ESP,MF,Dortmund,Bundesliga,16,2000,0.1,0,0,0,0,0,0,0,,0,0,0,0,0,0,0,0,Matches
945,Vicente Gómez,ESP,MF,Las Palmas,La Liga,28,1988,16.9,21,13,6,11,4,10,29,34.5,19,18,4,14,17,38,14,1,Matches
946,Alfred Gomis,SEN,GK,SPAL,Serie A,23,1993,25.1,0,0,0,0,0,0,1,0.0,1,0,0,0,1,1,10,3,Matches
947,Maxime Gonalons,FRA,MF,Roma,Serie A,28,1989,12.2,26,18,7,12,7,9,23,39.1,14,15,4,11,23,49,19,1,Matches
948,Anthony Gonçalves,FRA,"MF,FW",Strasbourg,Ligue 1,31,1986,19.5,50,31,14,32,4,15,50,30.0,35,27,0,27,25,75,27,0,Matches
949,Vagner Gonçalves,CPV,FW,Saint-Étienne,Ligue 1,21,1996,1.2,0,0,0,0,0,0,3,0.0,3,2,0,2,0,0,0,0,Matches
950,Jérôme Gondorf,GER,"MF,FW",Werder Bremen,Bundesliga,29,1988,8.9,12,9,3,9,0,4,18,22.2,14,11,2,9,6,18,12,0,Matches
951,Adrián González,ESP,"MF,FW",Málaga,La Liga,29,1988,26.0,40,25,14,22,4,12,50,24.0,38,25,8,17,38,78,34,0,Matches
952,Álvaro González,ESP,DF,Villarreal,La Liga,27,1990,32.2,38,26,30,7,1,22,41,53.7,19,34,23,11,53,91,188,0,Matches
953,Bruno González,ESP,DF,Getafe,La Liga,27,1990,17.1,25,18,18,7,0,13,26,50.0,13,11,3,8,31,56,107,0,Matches
954,Diego González,ESP,DF,Málaga,La Liga,22,1995,15.9,27,19,20,7,0,18,26,69.2,8,25,10,15,19,46,69,0,Matches
955,Fabio González,ESP,MF,Las Palmas,La Liga,20,1997,0.7,2,1,2,0,0,1,4,25.0,3,1,0,1,1,3,1,0,Matches
956,Giancarlo González,CRC,DF,Bologna,Serie A,29,1988,20.6,20,15,14,5,1,9,13,69.2,4,26,18,8,33,53,152,1,Matches
957,Mario González,ESP,FW,Villarreal,La Liga,21,1996,0.2,0,0,0,0,0,0,0,,0,1,0,1,0,0,0,0,Matches
958,Georges Gope-Fenepej,NCL,FW,Amiens,Ligue 1,28,1988,0.5,0,0,0,0,0,0,0,,0,0,0,0,0,0,0,0,Matches
959,Leon Goretzka,GER,MF,Schalke 04,Bundesliga,22,1995,22.0,50,34,22,22,6,14,50,28.0,36,45,4,41,41,91,35,0,Matches
960,Mathieu Gorgelin,FRA,GK,Lyon,Ligue 1,26,1990,4.0,0,0,0,0,0,0,0,,0,0,0,0,0,0,0,1,Matches
961,Andoni Gorosabel,ESP,DF,Real Sociedad,La Liga,20,1996,0.8,3,2,1,2,0,2,5,40.0,3,1,0,1,4,7,1,0,Matches
962,Robin Gosens,GER,DF,Atalanta,Serie A,23,1994,16.1,61,46,35,22,4,27,46,58.7,19,17,2,15,22,83,40,0,Matches
963,Dan Gosling,ENG,MF,Bournemouth,Premier League,27,1990,21.6,50,25,19,26,5,19,68,27.9,49,36,8,28,25,75,35,0,Matches
964,Mario Götze,GER,MF,Dortmund,Bundesliga,25,1992,17.8,50,43,19,24,7,14,34,41.2,20,17,1,16,8,58,9,0,Matches
965,Mohamed Gouaida,TUN,MF,Hamburger SV,Bundesliga,24,1993,0.6,3,3,1,1,1,0,0,,0,0,0,0,0,3,3,0,Matches
966,Prince-Désir Gouano,FRA,DF,Amiens,Ligue 1,23,1993,30.5,42,29,32,8,2,22,31,71.0,9,58,47,11,49,91,191,6,Matches
967,Lemouya Goudiaby,SEN,DF,Metz,Ligue 1,20,1997,0.9,2,1,0,2,0,1,3,33.3,2,2,1,1,0,2,3,0,Matches
968,Amine Gouiri,ALG,"FW,MF",Lyon,Ligue 1,17,2000,0.9,1,1,1,0,0,0,1,0.0,1,0,0,0,2,3,0,0,Matches
969,Yoann Gourcuff,FRA,"MF,FW",Rennes,Ligue 1,31,1986,4.7,7,5,1,3,3,0,2,0.0,2,5,0,5,2,9,2,0,Matches
970,Jeffrey Gouweleeuw,NED,DF,Augsburg,Bundesliga,26,1991,26.5,57,44,36,18,3,27,41,65.9,14,36,10,26,54,111,128,0,Matches
971,Julio Gracia,ESP,"DF,FW",Betis,La Liga,19,1998,0.3,0,0,0,0,0,0,0,,0,0,0,0,1,1,0,0,Matches
972,Max Gradel,CIV,"FW,MF",Toulouse,Ligue 1,29,1987,26.8,63,36,28,21,14,24,72,33.3,48,39,2,37,14,77,30,0,Matches
973,Samuel Grandsir,FRA,"FW,MF",Troyes,Ligue 1,20,1996,28.9,69,43,39,18,12,21,73,28.8,52,31,3,28,23,92,19,1,Matches
974,Álex Granell,ESP,MF,Girona,La Liga,28,1988,31.6,78,53,31,39,8,38,114,33.3,76,46,3,43,47,125,29,0,Matches
975,Esteban Granero,ESP,MF,Espanyol,La Liga,30,1987,13.7,32,22,15,13,4,9,27,33.3,18,19,0,19,19,51,21,0,Matches
976,Lee Grant,ENG,GK,Stoke City,Premier League,34,1983,3.0,1,1,1,0,0,1,1,100.0,0,0,0,0,0,1,0,0,Matches
977,Alberto Grassi,ITA,MF,SPAL,Serie A,22,1995,25.0,44,33,22,12,10,16,35,45.7,19,27,8,19,47,91,55,0,Matches
978,Andrew Gravillon,GLP,DF,Benevento,Serie A,19,1998,0.9,2,1,2,0,0,0,1,0.0,1,1,1,0,3,5,10,0,Matches
979,Andre Gray,JAM,FW,Watford,Premier League,26,1991,16.6,2,1,0,1,1,0,3,0.0,3,11,0,11,4,6,3,0,Matches
980,Demarai Gray,JAM,"MF,FW",Leicester City,Premier League,21,1996,18.9,17,15,6,9,2,4,23,17.4,19,27,0,27,11,28,14,1,Matches
981,Michael Gregoritsch,AUT,"MF,FW",Augsburg,Bundesliga,23,1994,28.1,35,27,13,15,7,11,26,42.3,15,27,1,26,10,45,56,0,Matches
982,Clément Grenier,FRA,MF,Guingamp,Ligue 1,26,1991,13.4,23,14,3,13,7,12,42,28.6,30,16,1,15,14,37,15,1,Matches
983,Clément Grenier,FRA,FW,Lyon,Ligue 1,26,1991,0.1,1,1,1,0,0,0,0,,0,0,0,0,0,1,0,0,Matches
984,Anto Grgić,SUI,MF,Stuttgart,Bundesliga,20,1996,0.1,0,0,0,0,0,0,0,,0,0,0,0,0,0,0,0,Matches
985,Antoine Griezmann,FRA,"FW,MF",Atlético Madrid,La Liga,26,1991,28.0,36,24,6,23,7,10,30,33.3,20,20,1,19,10,46,14,0,Matches
986,Vincenzo Grifo,ITA,"MF,FW",Gladbach,Bundesliga,24,1993,8.7,8,5,3,3,2,4,8,50.0,4,8,1,7,5,13,6,0,Matches
987,Florian Grillitsch,AUT,MF,Hoffenheim,Bundesliga,21,1995,21.0,68,46,30,36,2,35,58,60.3,23,26,3,23,39,107,25,1,Matches
988,Jérémy Grimm,FRA,MF,Strasbourg,Ligue 1,30,1987,9.0,23,17,15,6,2,9,24,37.5,15,11,3,8,19,42,31,1,Matches
989,Pascal Groß,GER,"FW,MF",Brighton,Premier League,26,1991,32.5,36,24,18,16,2,10,67,14.9,57,31,5,26,14,50,20,0,Matches
990,Marko Grujić,SRB,"MF,DF",Liverpool,Premier League,21,1996,0.2,2,2,0,1,1,2,2,100.0,0,0,0,0,0,2,0,0,Matches
991,Vicente Guaita,ESP,GK,Getafe,La Liga,30,1987,33.0,0,0,0,0,0,0,0,,0,0,0,0,3,3,12,1,Matches
992,Andrés Guardado,MEX,MF,Betis,La Liga,30,1986,25.2,41,27,17,18,6,15,55,27.3,40,27,5,22,22,63,29,1,Matches
993,Karim Guédé,SVK,FW,Freiburg,Bundesliga,32,1985,0.7,2,2,2,0,0,2,2,100.0,0,1,1,0,1,3,0,0,Matches
994,Gonçalo Guedes,POR,MF,Valencia,La Liga,20,1996,27.1,38,26,18,15,5,16,51,31.4,35,22,0,22,16,54,10,0,Matches
995,Gonçalo Guedes,POR,FW,Paris S-G,Ligue 1,20,1996,0.1,0,0,0,0,0,0,0,,0,0,0,0,0,0,0,0,Matches
996,Ramiro Guerra,URU,MF,Villarreal,La Liga,20,1997,0.8,3,2,1,0,2,2,3,66.7,1,0,0,0,0,3,2,0,Matches
997,Raphaël Guerreiro,POR,"DF,MF",Dortmund,Bundesliga,23,1993,6.1,10,8,5,4,1,2,5,40.0,3,3,0,3,11,21,8,0,Matches
998,Francis Guerrero,ESP,"DF,MF",Betis,La Liga,21,1996,11.0,31,19,22,7,2,16,34,47.1,18,16,4,12,21,52,26,0,Matches
999,John Guidetti,SWE,FW,Alavés,La Liga,25,1992,13.6,7,7,3,1,3,2,10,20.0,8,10,1,9,2,9,7,0,Matches
1000,John Guidetti,SWE,"FW,MF",Celta Vigo,La Liga,25,1992,1.3,0,0,0,0,0,0,0,,0,0,0,0,0,0,0,0,Matches
1001,Josuha Guilavogui,FRA,MF,Wolfsburg,Bundesliga,26,1990,26.7,65,46,43,20,2,30,50,60.0,20,34,10,24,66,131,63,0,Matches
1002,Frederic Guilbert,FRA,DF,Caen,Ligue 1,22,1994,36.0,136,89,71,58,7,50,105,47.6,55,43,13,30,88,224,136,0,Matches
1003,Guilherme,BRA,"MF,FW",Benevento,Serie A,26,1991,10.5,20,11,7,7,6,3,19,15.8,16,14,1,13,8,28,4,0,Matches
1004,Guilherme,BRA,MF,La Coruña,La Liga,26,1991,29.3,79,56,35,37,7,28,77,36.4,49,36,9,27,46,125,62,0,Matches
1005,Baptiste Guillaume,BEL,"FW,MF",Angers,Ligue 1,22,1995,5.1,4,1,0,2,2,0,5,0.0,5,4,1,3,2,6,1,0,Matches
1006,Serhou Guirassy,GUI,FW,Köln,Bundesliga,21,1996,9.5,3,3,0,2,1,1,5,20.0,4,9,1,8,1,4,11,0,Matches
1007,Péter Gulácsi,HUN,GK,RB Leipzig,Bundesliga,27,1990,33.0,0,0,0,0,0,0,2,0.0,2,0,0,0,0,0,12,4,Matches
1008,Manuel Gulde,GER,DF,Freiburg,Bundesliga,26,1991,17.0,16,10,14,2,0,10,19,52.6,9,24,17,7,14,30,71,0,Matches
1009,Gerard Gumbau,ESP,MF,Leganés,La Liga,22,1994,15.9,35,26,13,21,1,12,37,32.4,25,12,4,8,14,49,27,0,Matches
1010,İlkay Gündoğan,GER,MF,Manchester City,Premier League,26,1990,16.9,27,15,8,14,5,9,37,24.3,28,14,1,13,16,43,12,0,Matches
1011,Christian Günter,GER,"DF,MF",Freiburg,Bundesliga,24,1993,34.0,73,54,45,21,7,38,63,60.3,25,38,7,31,20,93,68,0,Matches
1012,Jon Guridi,ESP,MF,Real Sociedad,La Liga,22,1995,0.6,1,0,1,0,0,0,1,0.0,1,1,0,1,0,1,0,0,Matches
1013,Régis Gurtner,FRA,GK,Amiens,Ligue 1,30,1986,37.0,1,0,1,0,0,1,1,100.0,0,0,0,0,4,5,15,4,Matches
1014,Samuel Gustafson,SWE,"MF,FW",Torino,Serie A,22,1995,0.9,3,2,3,0,0,1,3,33.3,2,2,0,2,0,3,0,0,Matches
1015,Luiz Gustavo,BRA,"MF,DF",Marseille,Ligue 1,30,1987,33.5,89,54,45,40,4,26,62,41.9,36,44,13,31,50,139,56,1,Matches
1016,Alejandro Gutiérrez Mozo,ESP,MF,Leganés,La Liga,22,1995,0.5,3,2,1,2,0,1,4,25.0,3,0,0,0,0,3,0,0,Matches
1017,Jonathan de Guzmán,NED,MF,Eint Frankfurt,Bundesliga,29,1987,12.1,16,16,8,8,0,6,16,37.5,10,13,0,13,13,29,12,0,Matches
1018,Bright Gyamfi,GHA,DF,Benevento,Serie A,21,1996,3.6,2,2,1,1,0,1,2,50.0,1,3,1,2,7,9,8,0,Matches
1019,Nicolas Haas,SUI,MF,Atalanta,Serie A,21,1996,1.9,1,1,1,0,0,0,2,0.0,2,1,1,0,1,2,4,1,Matches
1020,Janik Haberer,GER,"MF,FW",Freiburg,Bundesliga,23,1994,30.5,62,49,20,34,8,23,57,40.4,34,43,1,42,30,92,42,0,Matches
1021,Hacen,MTN,"FW,MF",Levante,La Liga,19,1997,0.9,0,0,0,0,0,0,0,,0,4,2,2,1,1,0,0,Matches
1022,Alexander Hack,GER,DF,Mainz 05,Bundesliga,23,1993,14.3,46,34,25,19,2,24,37,64.9,13,31,18,13,26,72,87,2,Matches
1023,Robin Hack,GER,"FW,MF",Hoffenheim,Bundesliga,18,1998,0.8,2,2,1,0,1,0,1,0.0,1,1,1,0,0,2,1,0,Matches
1024,Munir El Haddadi,MAR,FW,Alavés,La Liga,21,1995,27.2,25,20,8,9,8,5,14,35.7,9,13,2,11,9,34,5,0,Matches
1025,Oussama Haddadi,TUN,DF,Dijon,Ligue 1,25,1992,27.8,44,29,33,9,2,14,47,29.8,33,29,12,17,43,87,79,1,Matches
1026,Florent Hadergjonaj,KVX,"DF,MF",Huddersfield,Premier League,23,1994,18.6,21,16,7,10,4,12,30,40.0,18,22,10,12,17,38,45,0,Matches
1027,André Hahn,GER,FW,Hamburger SV,Bundesliga,26,1990,15.1,33,24,15,13,5,10,32,31.3,22,30,2,28,10,43,26,0,Matches
1028,Massadio Haïdara,MLI,FW,Newcastle Utd,Premier League,24,1992,0.0,0,0,0,0,0,0,0,,0,0,0,0,0,0,0,0,Matches
1029,Oualid El Hajjam,MAR,DF,Amiens,Ligue 1,26,1991,24.4,64,44,37,22,5,23,49,46.9,26,25,5,20,59,123,91,1,Matches
1030,Izet Hajrović,BIH,"MF,FW",Werder Bremen,Bundesliga,25,1991,2.1,1,0,1,0,0,0,1,0.0,1,0,0,0,2,3,1,0,Matches
1031,Achraf Hakimi,MAR,DF,Real Madrid,La Liga,18,1998,8.4,21,15,9,6,6,11,25,44.0,14,9,1,8,10,31,19,1,Matches
1032,Alen Halilović,CRO,"FW,MF",Las Palmas,La Liga,21,1996,14.5,11,7,5,6,0,4,17,23.5,13,10,1,9,5,16,4,0,Matches
1033,Sébastien Haller,CIV,FW,Eint Frankfurt,Bundesliga,23,1994,26.1,25,16,4,16,5,7,14,50.0,7,17,4,13,8,33,39,0,Matches
1034,Emil Hallfreðsson,ISL,MF,Udinese,Serie A,33,1984,8.5,19,14,9,7,3,7,24,29.2,17,13,2,11,20,39,16,0,Matches
1035,Marcel Halstenberg,GER,DF,RB Leipzig,Bundesliga,25,1991,13.1,29,19,16,9,4,15,19,78.9,4,15,1,14,23,52,42,1,Matches
1036,Ben Hamer,ENG,GK,Leicester City,Premier League,29,1987,3.1,0,0,0,0,0,0,1,0.0,1,0,0,0,0,0,3,1,Matches
1037,Romain Hamouma,FRA,FW,Saint-Étienne,Ligue 1,30,1987,20.5,19,13,7,6,6,1,22,4.5,21,15,4,11,13,32,8,1,Matches
1038,Marek Hamšík,SVK,MF,Napoli,Serie A,30,1987,26.3,36,22,10,15,11,15,37,40.5,22,35,2,33,14,50,16,0,Matches
1039,Samir Handanović,SVN,GK,Inter,Serie A,33,1984,38.0,0,0,0,0,0,0,0,,0,1,0,1,0,0,7,1,Matches
1040,Tim Handwerker,GER,"MF,DF",Köln,Bundesliga,19,1998,4.4,12,7,9,2,1,5,7,71.4,2,3,0,3,6,18,10,0,Matches
1041,Genki Haraguchi,JPN,FW,Hertha BSC,Bundesliga,26,1991,2.3,6,6,2,3,1,2,6,33.3,4,4,0,4,2,8,3,0,Matches
1042,Amine Harit,MAR,"MF,FW",Schalke 04,Bundesliga,20,1997,22.7,39,27,11,21,7,13,37,35.1,24,23,0,23,19,58,11,0,Matches
1043,Martin Harnik,AUT,"FW,MF",Hannover 96,Bundesliga,30,1987,21.0,17,10,4,10,3,4,25,16.0,21,21,2,19,8,25,26,0,Matches
1044,Rekeem Harper,ENG,MF,West Brom,Premier League,17,2000,0.2,1,1,0,1,0,0,0,,0,0,0,0,0,1,0,0,Matches
1045,Joe Hart,ENG,GK,West Ham,Premier League,30,1987,19.0,1,1,1,0,0,1,2,50.0,1,1,0,1,0,1,2,4,Matches
1046,Makoto Hasebe,JPN,"DF,MF",Eint Frankfurt,Bundesliga,33,1984,23.2,38,23,19,19,0,21,33,63.6,12,40,19,21,25,63,74,0,Matches
1047,Hans Hateboer,NED,DF,Atalanta,Serie A,23,1994,26.6,31,25,13,13,5,15,26,57.7,11,32,5,27,30,61,46,1,Matches
1048,Kai Havertz,GER,"MF,FW",Leverkusen,Bundesliga,18,1999,23.8,34,23,8,23,3,12,25,48.0,13,33,2,31,19,53,23,0,Matches
1049,Isaac Hayden,ENG,MF,Newcastle Utd,Premier League,22,1995,15.3,40,23,23,16,1,12,34,35.3,22,21,6,15,23,63,43,0,Matches
1050,Eden Hazard,BEL,"FW,MF",Chelsea,Premier League,26,1991,26.9,6,3,2,3,1,3,21,14.3,18,11,0,11,3,9,0,0,Matches
1051,Thorgan Hazard,BEL,"MF,FW",Gladbach,Bundesliga,24,1993,32.7,49,32,16,23,10,20,54,37.0,34,39,1,38,28,77,18,0,Matches
1052,Tom Heaton,ENG,GK,Burnley,Premier League,31,1986,3.4,0,0,0,0,0,0,0,,0,0,0,0,0,0,0,0,Matches
1053,Jonas Hector,GER,"DF,MF",Köln,Bundesliga,27,1990,19.5,47,35,23,18,6,18,40,45.0,22,39,6,33,28,75,65,2,Matches
1054,Michael Hefele,GER,DF,Huddersfield,Premier League,26,1990,0.4,0,0,0,0,0,0,0,,0,0,0,0,1,1,5,0,Matches
1055,Ahmed Hegazi,EGY,DF,West Brom,Premier League,26,1991,37.6,58,38,46,12,0,26,50,52.0,24,55,37,18,60,118,278,2,Matches
1056,Gauthier Hein,FRA,FW,Metz,Ligue 1,20,1996,0.9,2,2,2,0,0,2,4,50.0,2,1,0,1,2,4,1,0,Matches
1057,Dominique Heintz,GER,DF,Köln,Bundesliga,23,1993,31.0,60,42,47,13,0,38,64,59.4,26,35,17,18,53,113,140,0,Matches
1058,Filip Helander,SWE,DF,Bologna,Serie A,24,1993,27.8,48,32,33,15,0,15,29,51.7,14,47,25,22,37,85,160,2,Matches
1059,Marcel Heller,GER,"FW,MF",Augsburg,Bundesliga,31,1986,14.4,37,24,21,14,2,12,28,42.9,16,22,1,21,10,47,7,0,Matches
1060,Tomer Hemed,ISR,FW,Brighton,Premier League,30,1987,9.4,7,5,3,4,0,2,10,20.0,8,10,1,9,2,9,12,0,Matches
1061,Jordan Henderson,ENG,MF,Liverpool,Premier League,27,1990,24.1,51,33,13,32,6,18,52,34.6,34,33,2,31,31,82,27,0,Matches
1062,Jeff Hendrick,IRL,"FW,MF",Burnley,Premier League,25,1992,25.9,16,10,4,10,2,3,17,17.6,14,11,2,9,8,24,21,1,Matches
1063,Wayne Hennessey,WAL,GK,Crystal Palace,Premier League,30,1987,27.0,0,0,0,0,0,0,0,,0,1,0,1,2,2,5,1,Matches
1064,Benjamin Henrichs,GER,DF,Leverkusen,Bundesliga,20,1997,14.1,42,28,23,16,3,27,43,62.8,16,23,3,20,31,73,32,0,Matches
1065,Dalbert Henrique,BRA,DF,Inter,Serie A,23,1993,5.9,15,10,11,3,1,7,13,53.8,6,7,4,3,13,28,19,0,Matches
1066,Christophe Hérelle,MTQ,DF,Troyes,Ligue 1,24,1992,32.9,39,26,27,12,0,16,30,53.3,14,38,27,11,56,95,241,1,Matches
1067,Mario Hermoso,ESP,DF,Espanyol,La Liga,22,1995,21.4,14,12,13,1,0,8,21,38.1,13,15,8,7,25,39,122,0,Matches
1068,Hernán,ESP,MF,Las Palmas,La Liga,26,1990,3.9,18,9,8,7,3,10,17,58.8,7,2,0,2,8,26,5,0,Matches
1069,Héctor Hernández,ESP,DF,Alavés,La Liga,26,1991,0.2,1,1,0,1,0,1,1,100.0,0,0,0,0,0,1,1,0,Matches
1070,Javier Hernández,MEX,FW,West Ham,Premier League,29,1988,17.2,11,7,2,7,2,3,14,21.4,11,6,1,5,6,17,1,0,Matches
1071,Lucas Hernández,FRA,DF,Atlético Madrid,La Liga,21,1996,23.5,93,68,51,35,7,55,74,74.3,19,35,10,25,40,133,90,0,Matches
1072,Luis Hernández,ESP,DF,Málaga,La Liga,28,1989,36.0,49,43,37,9,3,17,33,51.5,16,32,21,11,77,126,185,1,Matches
1073,Pablo Hernández,CHI,MF,Celta Vigo,La Liga,30,1986,20.2,48,33,17,27,4,14,46,30.4,32,29,11,18,40,88,72,0,Matches
1074,Theo Hernández,FRA,DF,Real Madrid,La Liga,19,1997,10.7,21,15,16,2,3,13,25,52.0,12,9,2,7,17,38,20,0,Matches
1075,Hernani,BRA,"MF,FW",Saint-Étienne,Ligue 1,23,1994,6.0,21,13,9,9,3,10,22,45.5,12,15,2,13,6,27,5,0,Matches
1076,Ander Herrera,ESP,MF,Manchester Utd,Premier League,27,1989,14.1,56,29,32,20,4,20,69,29.0,49,33,6,27,34,90,22,2,Matches
1077,Borja Herrera,ESP,DF,Las Palmas,La Liga,24,1993,2.7,2,1,2,0,0,2,7,28.6,5,6,1,5,3,5,4,0,Matches
1078,Iago Herrerín,ESP,GK,Athletic Club,La Liga,29,1988,8.0,2,1,2,0,0,2,2,100.0,0,0,0,0,0,2,7,1,Matches
1079,Patrick Herrmann,GER,"MF,FW",Gladbach,Bundesliga,26,1991,12.5,29,21,9,13,7,17,29,58.6,12,13,0,13,17,46,19,0,Matches
1080,Përparim Hetemaj,FIN,MF,Chievo,Serie A,30,1986,26.8,74,48,34,25,15,29,78,37.2,49,39,6,33,39,113,47,1,Matches
1081,Son Heung-min,KOR,FW,Tottenham,Premier League,25,1992,25.7,17,10,2,12,3,2,28,7.1,26,18,0,18,10,27,12,0,Matches
1082,Thomas Heurtaux,FRA,DF,Hellas Verona,Serie A,29,1988,15.5,14,11,12,2,0,4,8,50.0,4,25,16,9,37,51,97,1,Matches
1083,Gonzalo Higuaín,ARG,FW,Juventus,Serie A,29,1987,31.3,19,17,3,7,9,2,19,10.5,17,19,4,15,7,26,20,0,Matches
1084,Oscar Hiljemark,SWE,MF,Genoa,Serie A,25,1992,14.2,12,8,2,8,2,3,24,12.5,21,14,4,10,9,21,12,0,Matches
1085,Vitorino Hilton,BRA,DF,Montpellier,Ligue 1,39,1977,27.0,44,26,33,11,0,13,36,36.1,23,28,14,14,58,102,140,5,Matches
1086,Kaylen Hinds,ENG,FW,Wolfsburg,Bundesliga,19,1998,1.0,1,1,1,0,0,0,0,,0,1,0,1,1,2,0,0,Matches
1087,Martin Hinteregger,AUT,DF,Augsburg,Bundesliga,24,1992,29.5,79,51,55,22,2,47,61,77.0,14,40,27,13,49,128,135,3,Matches
1088,Marwin Hitz,SUI,GK,Augsburg,Bundesliga,29,1987,32.0,1,1,1,0,0,1,3,33.3,2,0,0,0,0,1,12,3,Matches
1089,Andrew Hjulsager,DEN,"DF,MF",Celta Vigo,La Liga,22,1995,0.2,0,0,0,0,0,0,2,0.0,2,1,0,1,0,0,0,0,Matches
1090,Wesley Hoedt,NED,DF,Southampton,Premier League,23,1994,28.0,60,51,48,12,0,36,61,59.0,25,32,17,15,40,100,177,2,Matches
1091,Nicolas Höfler,GER,MF,Freiburg,Bundesliga,27,1990,25.1,57,36,23,30,4,31,50,62.0,19,42,10,32,44,101,51,2,Matches
1092,Jonas Hofmann,GER,"MF,FW",Gladbach,Bundesliga,25,1992,11.5,23,19,12,11,0,12,26,46.2,14,15,4,11,12,35,16,0,Matches
1093,Marco Höger,GER,MF,Köln,Bundesliga,27,1989,18.6,60,40,31,28,1,30,64,46.9,34,35,5,30,25,85,27,1,Matches
1094,Jonathan Hogg,ENG,MF,Huddersfield,Premier League,28,1988,26.6,93,64,29,59,5,26,89,29.2,63,51,12,39,69,162,48,0,Matches
1095,Rob Holding,ENG,DF,Arsenal,Premier League,21,1995,9.1,19,14,13,5,1,4,12,33.3,8,16,10,6,21,40,40,2,Matches
1096,José Holebas,GRE,DF,Watford,Premier League,33,1984,26.5,51,31,34,14,3,18,44,40.9,26,24,8,16,29,80,95,2,Matches
1097,Lucas Höler,GER,"FW,MF",Freiburg,Bundesliga,23,1994,10.1,24,20,8,13,3,9,24,37.5,15,10,0,10,7,31,13,0,Matches
1098,Mason Holgate,ENG,DF,Everton,Premier League,20,1996,13.2,23,16,15,7,1,10,21,47.6,11,12,9,3,23,46,86,2,Matches
1099,Lewis Holtby,GER,"MF,FW",Hamburger SV,Bundesliga,26,1990,13.3,44,29,14,26,4,17,32,53.1,15,23,2,21,10,54,9,0,Matches
1100,Gerrit Holtmann,PHI,"FW,DF",Mainz 05,Bundesliga,22,1995,10.0,16,13,8,5,3,11,22,50.0,11,19,2,17,12,28,9,0,Matches
1101,Jannes Horn,GER,DF,Köln,Bundesliga,20,1997,9.2,16,11,11,4,1,11,14,78.6,3,12,3,9,17,33,26,0,Matches
1102,Timo Horn,GER,GK,Köln,Bundesliga,24,1993,34.0,3,2,3,0,0,3,6,50.0,3,0,0,0,0,3,18,2,Matches
1103,Benedikt Höwedes,GER,DF,Juventus,Serie A,29,1988,2.7,1,1,1,0,0,0,0,,0,0,0,0,8,9,10,1,Matches
1104,Lukáš Hrádecký,FIN,GK,Eint Frankfurt,Bundesliga,27,1989,34.0,0,0,0,0,0,0,2,0.0,2,0,0,0,0,0,23,3,Matches
1105,Branimir Hrgota,SWE,"MF,FW",Eint Frankfurt,Bundesliga,24,1993,2.2,5,4,0,3,2,4,7,57.1,3,2,0,2,0,5,1,0,Matches
1106,Timo Hübers,GER,DF,Hannover 96,Bundesliga,21,1996,5.0,11,10,9,2,0,9,15,60.0,6,13,8,5,9,20,31,0,Matches
1107,Benjamin Hübner,GER,DF,Hoffenheim,Bundesliga,28,1989,25.7,71,56,43,27,1,31,46,67.4,15,40,18,22,51,122,114,0,Matches
1108,Florian Hübner,GER,DF,Hannover 96,Bundesliga,26,1991,3.6,10,9,8,2,0,5,9,55.6,4,3,2,1,6,16,21,0,Matches
1109,Tomáš Hubočan,SVK,DF,Marseille,Ligue 1,31,1985,1.0,1,0,1,0,0,0,4,0.0,4,0,0,0,0,1,1,0,Matches
1110,Callum Hudson-Odoi,ENG,"FW,DF",Chelsea,Premier League,16,2000,0.3,0,0,0,0,0,0,0,,0,0,0,0,0,0,0,0,Matches
1111,Will Hughes,ENG,MF,Watford,Premier League,22,1995,11.0,34,18,7,18,9,9,19,47.4,10,16,1,15,15,49,6,0,Matches
1112,Jordan Hugill,ENG,FW,West Ham,Premier League,25,1992,0.3,0,0,0,0,0,0,1,0.0,1,0,0,0,0,0,0,0,Matches
1113,Vitor Hugo,BRA,DF,Fiorentina,Serie A,26,1991,13.4,32,21,26,6,0,10,17,58.8,7,10,6,4,43,75,92,0,Matches
1114,Mats Hummels,GER,DF,Bayern Munich,Bundesliga,28,1988,24.6,62,52,41,18,3,35,51,68.6,16,31,12,19,55,117,59,2,Matches
1115,Uwe Hünemeier,GER,DF,Brighton,Premier League,31,1986,0.2,0,0,0,0,0,0,0,,0,0,0,0,0,0,4,0,Matches
1116,Adrien Hunou,FRA,"FW,MF",Rennes,Ligue 1,23,1994,16.2,27,15,11,8,8,11,42,26.2,31,22,1,21,9,36,8,1,Matches
1117,Aaron Hunt,GER,"MF,FW",Hamburger SV,Bundesliga,30,1986,23.1,36,24,12,20,4,11,37,29.7,26,20,2,18,14,50,18,2,Matches
1118,Emerson Hyndman,USA,MF,Bournemouth,Premier League,21,1996,0.6,0,0,0,0,0,0,1,0.0,1,2,0,2,1,1,1,0,Matches
1119,Elseid Hysaj,ALB,DF,Napoli,Serie A,23,1994,34.7,64,45,28,30,6,32,56,57.1,24,35,4,31,43,107,68,4,Matches
1120,Suk Hyun-jun,KOR,FW,Troyes,Ligue 1,26,1991,13.3,6,5,2,2,2,1,9,11.1,8,10,0,10,1,7,7,0,Matches
1121,Pierre Højbjerg,DEN,MF,Southampton,Premier League,21,1995,18.6,45,29,24,18,3,13,56,23.2,43,30,3,27,37,82,26,1,Matches
1122,Jordon Ibe,ENG,"MF,FW",Bournemouth,Premier League,21,1995,22.2,14,12,7,5,2,6,22,27.3,16,5,0,5,10,24,11,0,Matches
1123,Vedad Ibišević,BIH,FW,Hertha BSC,Bundesliga,32,1984,16.1,10,8,1,5,4,4,7,57.1,3,8,1,7,4,14,23,0,Matches
1124,Vicente Iborra,ESP,MF,Leicester City,Premier League,29,1988,15.7,23,18,13,10,0,9,36,25.0,27,25,11,14,19,42,49,1,Matches
1125,Zlatan Ibrahimović,SWE,"MF,FW",Manchester Utd,Premier League,35,1981,1.2,2,1,1,0,1,0,1,0.0,1,0,0,0,0,2,1,0,Matches
1126,Mauro Icardi,ARG,FW,Inter,Serie A,24,1993,32.9,3,2,1,2,0,1,8,12.5,7,14,6,8,5,8,23,1,Matches
1127,Brown Ideye,NGA,FW,Málaga,La Liga,28,1988,8.1,2,2,0,2,0,0,5,0.0,5,2,0,2,1,3,11,0,Matches
1128,Edgar Ié,GNB,DF,Lille,Ligue 1,23,1994,35.0,74,42,55,18,1,31,69,44.9,38,57,26,31,84,158,135,3,Matches
1129,Julien Ielsch,FRA,"MF,DF",Amiens,Ligue 1,34,1983,6.8,28,18,12,11,5,7,25,28.0,18,16,3,13,11,39,15,2,Matches
1130,Pietro Iemmello,ITA,FW,Benevento,Serie A,25,1992,9.8,2,2,1,1,0,2,8,25.0,6,4,0,4,1,3,11,2,Matches
1131,Kelechi Iheanacho,NGA,"FW,MF",Leicester City,Premier League,20,1996,9.2,9,6,3,5,1,3,20,15.0,17,10,2,8,3,12,4,0,Matches
1132,Jordan Ikoko,COD,DF,Guingamp,Ligue 1,23,1994,26.9,44,29,24,15,5,22,42,52.4,20,20,2,18,48,92,74,0,Matches
1133,Jonathan Ikone,FRA,"MF,FW",Montpellier,Ligue 1,19,1998,11.1,13,10,3,6,4,4,14,28.6,10,8,0,8,6,19,3,0,Matches
1134,Josip Iličić,SVN,"MF,FW",Atalanta,Serie A,29,1988,22.2,24,19,5,13,6,8,29,27.6,21,19,0,19,16,40,2,0,Matches
1135,Asier Illarramendi,ESP,MF,Real Sociedad,La Liga,27,1990,35.1,85,57,35,41,9,37,90,41.1,53,44,8,36,75,160,35,0,Matches
1136,Jules Iloki,FRA,"MF,FW",Nantes,Ligue 1,25,1992,15.8,13,9,1,9,3,3,16,18.8,13,8,0,8,12,25,16,0,Matches
1137,Stefan Ilsanker,AUT,"DF,MF",RB Leipzig,Bundesliga,28,1989,14.3,37,29,23,11,3,22,39,56.4,17,23,10,13,25,62,55,1,Matches
1138,Giannelli Imbula,COD,MF,Toulouse,Ligue 1,24,1992,24.9,29,19,10,15,4,7,29,24.1,22,17,2,15,20,49,13,3,Matches
1139,Ciro Immobile,ITA,FW,Lazio,Serie A,27,1990,29.8,4,2,0,3,1,0,17,0.0,17,14,1,13,0,4,9,0,Matches
1140,Emmanuel Imorou,BEN,DF,Caen,Ligue 1,28,1988,0.4,0,0,0,0,0,0,0,,0,0,0,0,1,1,1,0,Matches
1141,Tom Ince,ENG,"MF,FW",Huddersfield,Premier League,25,1992,27.2,35,27,14,16,5,10,29,34.5,19,20,0,20,12,47,12,0,Matches
1142,Svante Ingelsson,SWE,MF,Udinese,Serie A,19,1998,3.6,9,6,3,3,3,2,10,20.0,8,4,0,4,6,15,4,0,Matches
1143,Roberto Inglese,ITA,FW,Chievo,Serie A,25,1991,30.9,31,21,13,9,9,7,30,23.3,23,21,2,19,8,39,17,1,Matches
1144,Danny Ings,ENG,FW,Liverpool,Premier League,25,1992,3.0,5,3,1,3,1,0,0,,0,4,0,4,2,7,1,0,Matches
1145,Andrés Iniesta,ESP,MF,Barcelona,La Liga,33,1984,20.3,28,22,11,8,9,6,31,19.4,25,21,2,19,10,38,12,1,Matches
1146,Lorenzo Insigne,ITA,FW,Napoli,Serie A,26,1991,34.3,29,17,11,13,5,13,33,39.4,20,20,0,20,17,46,4,0,Matches
1147,Emiliano Insúa,ARG,DF,Stuttgart,Bundesliga,28,1989,23.4,46,34,27,16,3,17,32,53.1,15,30,4,26,36,82,48,1,Matches
1148,Pablo Insua,ESP,DF,Schalke 04,Bundesliga,23,1993,0.3,0,0,0,0,0,0,0,,0,1,1,0,0,0,1,0,Matches
1149,Takashi Inui,JPN,"MF,FW",Eibar,La Liga,29,1988,29.2,39,21,12,19,8,13,42,31.0,29,36,0,36,18,57,10,0,Matches
1150,Artur Ioniță,MDA,MF,Cagliari,Serie A,26,1990,29.7,63,45,30,24,9,17,38,44.7,21,39,7,32,28,91,29,0,Matches
1151,Gorka Iraizoz,ESP,GK,Girona,La Liga,36,1981,8.5,1,1,1,0,0,1,2,50.0,1,0,0,0,1,2,9,2,Matches
1152,Stephen Ireland,IRL,"MF,FW",Stoke City,Premier League,30,1986,1.5,3,1,2,1,0,1,5,20.0,4,4,2,2,1,4,1,0,Matches
1153,Carlos Isaac,ESP,DF,Atlético Madrid,La Liga,19,1998,0.7,1,0,1,0,0,1,3,33.3,2,0,0,0,2,3,1,0,Matches
1154,Alexander Isak,SWE,"FW,MF",Dortmund,Bundesliga,17,1999,1.3,1,0,0,1,0,0,1,0.0,1,1,0,1,0,1,0,0,Matches
1155,Isco,ESP,MF,Real Madrid,La Liga,25,1992,19.7,22,12,5,10,7,5,35,14.3,30,11,0,11,15,37,2,0,Matches
1156,Tatsuya Ito,JPN,"MF,FW",Hamburger SV,Bundesliga,20,1997,11.2,16,13,4,8,4,11,22,50.0,11,28,0,28,6,22,1,0,Matches
1157,Gian-Luca Itter,GER,DF,Wolfsburg,Bundesliga,18,1999,4.6,19,12,15,2,2,14,22,63.6,8,6,0,6,5,24,15,0,Matches
1158,Manuel Iturra,CHI,MF,Málaga,La Liga,33,1984,17.6,70,45,36,27,7,22,55,40.0,33,19,2,17,29,99,23,0,Matches
1159,Ander Iturraspe,ESP,MF,Athletic Club,La Liga,28,1989,21.2,42,31,18,22,2,10,32,31.3,22,22,7,15,35,77,57,0,Matches
1160,Ivi,ESP,"MF,FW",Levante,La Liga,23,1994,19.6,48,34,19,23,6,21,62,33.9,41,21,1,20,15,63,15,0,Matches
1161,Alex Iwobi,NGA,"MF,FW",Arsenal,Premier League,21,1996,20.3,19,15,8,8,3,5,18,27.8,13,19,1,18,7,26,10,1,Matches
1162,José Izquierdo,COL,"MF,FW",Brighton,Premier League,25,1992,22.0,23,15,12,9,2,7,19,36.8,12,6,0,6,16,39,34,0,Matches
1163,Armando Izzo,ITA,DF,Genoa,Serie A,25,1992,15.4,30,23,14,10,6,12,18,66.7,6,15,6,9,34,64,70,0,Matches
1164,Koo Ja-cheol,KOR,MF,Augsburg,Bundesliga,28,1989,22.7,54,41,18,31,5,27,44,61.4,17,22,3,19,27,81,34,2,Matches
1165,Paul Jaeckel,GER,DF,Wolfsburg,Bundesliga,19,1998,3.0,3,3,3,0,0,1,2,50.0,1,5,2,3,1,4,8,0,Matches
1166,Phil Jagielka,ENG,DF,Everton,Premier League,34,1982,22.9,33,23,24,9,0,8,21,38.1,13,30,20,10,39,72,179,1,Matches
1167,Kilian Jakob,GER,FW,Augsburg,Bundesliga,19,1998,0.6,0,0,0,0,0,0,0,,0,1,0,1,0,0,1,0,Matches
1168,Eldin Jakupović,SUI,GK,Leicester City,Premier League,32,1984,2.0,0,0,0,0,0,0,0,,0,0,0,0,0,0,4,0,Matches
1169,Christophe Jallet,FRA,DF,Nice,Ligue 1,33,1983,13.0,29,21,21,8,0,11,26,42.3,15,18,6,12,16,45,47,0,Matches
1170,Ablie Jallow,GAM,FW,Metz,Ligue 1,18,1998,1.4,1,1,1,0,0,0,5,0.0,5,1,0,1,3,4,1,0,Matches
1171,Matty James,ENG,MF,Leicester City,Premier League,26,1991,11.0,19,10,7,11,1,2,10,20.0,8,14,2,12,17,36,25,0,Matches
1172,Vasilije Janjicic,SUI,MF,Hamburger SV,Bundesliga,18,1998,3.6,14,11,5,9,0,2,4,50.0,2,6,1,5,3,17,5,0,Matches
1173,Christoph Janker,GER,"DF,MF",Augsburg,Bundesliga,32,1985,0.9,4,3,3,1,0,2,3,66.7,1,0,0,0,1,5,4,1,Matches
1174,Saidy Janko,GAM,DF,Saint-Étienne,Ligue 1,21,1995,15.8,43,30,25,14,4,14,24,58.3,10,21,1,20,14,57,50,0,Matches
1175,Jakub Jankto,CZE,"MF,FW",Udinese,Serie A,21,1996,29.5,29,18,9,14,6,10,46,21.7,36,46,8,38,20,49,27,0,Matches
1176,Daryl Janmaat,NED,DF,Watford,Premier League,28,1989,20.2,46,31,29,10,7,22,52,42.3,30,16,5,11,33,79,61,0,Matches
1177,Vincent Janssen,NED,DF,Tottenham,Premier League,23,1994,0.0,0,0,0,0,0,0,0,,0,0,0,0,0,0,0,0,Matches
1178,Tony Jantschke,GER,DF,Gladbach,Bundesliga,27,1990,8.1,13,11,9,4,0,8,13,61.5,5,10,1,9,6,19,25,0,Matches
1179,Adnan Januzaj,BEL,FW,Real Sociedad,La Liga,22,1995,17.5,16,11,2,8,6,5,18,27.8,13,12,0,12,11,27,5,0,Matches
1180,Nicolas Janvier,FRA,MF,Rennes,Ligue 1,18,1998,0.8,4,1,1,1,2,1,2,50.0,1,1,0,1,1,5,0,0,Matches
1181,Paweł Jaroszyński,POL,DF,Chievo,Serie A,22,1994,9.0,20,12,14,5,1,9,18,50.0,9,11,4,7,21,41,40,1,Matches
1182,Rune Jarstein,NOR,GK,Hertha BSC,Bundesliga,32,1984,31.0,1,1,1,0,0,1,2,50.0,1,0,0,0,0,1,8,5,Matches
1183,Jason,ESP,"FW,MF",Levante,La Liga,23,1994,19.8,32,25,11,14,7,11,38,28.9,27,14,1,13,20,52,8,0,Matches
1184,Bakery Jatta,GAM,"MF,FW",Hamburger SV,Bundesliga,19,1998,3.3,14,12,2,12,0,4,6,66.7,2,6,1,5,3,17,5,0,Matches
1185,Corentin Jean,FRA,"FW,MF",Toulouse,Ligue 1,22,1995,18.8,12,8,4,7,1,5,21,23.8,16,14,1,13,14,26,10,0,Matches
1186,Benjamin Jeannot,FRA,FW,Dijon,Ligue 1,25,1992,15.6,12,7,5,6,1,1,13,7.7,12,9,3,6,6,18,26,0,Matches
1187,Tin Jedvaj,CRO,DF,Leverkusen,Bundesliga,21,1995,6.7,10,6,2,6,2,8,15,53.3,7,9,1,8,9,19,18,0,Matches
1188,Jemerson,BRA,DF,Monaco,Ligue 1,24,1992,31.7,48,32,32,15,1,24,31,77.4,7,46,32,14,56,104,169,1,Matches
1189,Jesé,ESP,"FW,MF",Stoke City,Premier League,24,1993,6.8,10,7,3,5,2,3,13,23.1,10,5,0,5,0,10,3,0,Matches
1190,Gabriel Jesus,BRA,FW,Manchester City,Premier League,20,1997,18.5,23,15,6,10,7,3,22,13.6,19,16,0,16,8,31,6,0,Matches
1191,Juan Jesus,BRA,DF,Roma,Serie A,26,1991,18.4,42,30,25,15,2,18,34,52.9,16,18,9,9,39,81,63,0,Matches
1192,Álvaro Jiménez,ESP,"MF,FW",Getafe,La Liga,22,1995,5.9,15,8,5,6,4,8,21,38.1,13,6,0,6,1,16,6,0,Matches
1193,Joaquín,ESP,"MF,FW",Betis,La Liga,36,1981,27.5,22,19,11,10,1,4,16,25.0,12,17,2,15,15,37,38,0,Matches
1194,Aron Jóhannsson,USA,"MF,FW",Werder Bremen,Bundesliga,26,1990,3.1,4,3,2,2,0,1,7,14.3,6,3,0,3,1,5,5,0,Matches
1195,Fabian Johnson,USA,"MF,DF",Gladbach,Bundesliga,29,1987,5.2,16,10,7,7,2,6,7,85.7,1,10,2,8,2,18,13,0,Matches
1196,Glen Johnson,ENG,DF,Stoke City,Premier League,32,1984,6.1,7,5,5,2,0,3,12,25.0,9,7,2,5,10,17,23,0,Matches
1197,Karl-Johan Johnsson,SWE,GK,Guingamp,Ligue 1,27,1990,38.0,0,0,0,0,0,0,1,0.0,1,0,0,0,0,0,14,4,Matches
1198,Miloš Jojić,SRB,MF,Köln,Bundesliga,25,1992,16.2,36,26,18,15,3,16,40,40.0,24,31,4,27,15,51,16,0,Matches
1199,Jonathas,BRA,FW,Hannover 96,Bundesliga,28,1989,7.0,7,3,2,4,1,1,2,50.0,1,3,1,2,0,7,9,0,Matches
1200,Phil Jones,ENG,DF,Manchester Utd,Premier League,25,1992,21.9,25,18,20,5,0,9,20,45.0,11,25,17,8,41,66,133,2,Matches
1201,Nigel de Jong,NED,MF,Mainz 05,Bundesliga,32,1984,8.2,17,12,7,9,1,10,14,71.4,4,5,1,4,12,29,22,1,Matches
1202,Jony,ESP,"FW,MF",Málaga,La Liga,26,1991,2.4,3,2,2,0,1,0,4,0.0,4,1,0,1,2,5,1,0,Matches
1203,Joan Jordán,ESP,MF,Eibar,La Liga,23,1994,27.0,31,24,8,19,4,10,68,14.7,58,24,0,24,30,61,12,0,Matches
1204,Jorge,BRA,DF,Monaco,Ligue 1,21,1996,21.3,69,40,34,25,10,23,38,60.5,15,19,2,17,66,135,86,0,Matches
1205,Jorginho,ITA,MF,Napoli,Serie A,25,1991,29.4,62,46,14,39,9,15,68,22.1,53,32,3,29,50,112,12,2,Matches
1206,Willian José,BRA,FW,Real Sociedad,La Liga,25,1991,30.8,10,7,1,5,4,2,9,22.2,7,10,1,9,5,15,31,0,Matches
1207,Joselu,ESP,FW,Newcastle Utd,Premier League,27,1990,19.0,22,17,10,11,1,7,34,20.6,27,25,2,23,11,33,39,0,Matches
1208,Yann Jouffre,FRA,"FW,MF",Metz,Ligue 1,33,1984,3.1,3,2,0,2,1,1,6,16.7,5,5,1,4,3,6,2,0,Matches
1209,Vukašin Jovanović,SRB,DF,Bordeaux,Ligue 1,21,1996,16.0,18,14,11,7,0,6,14,42.9,8,18,10,8,27,45,67,0,Matches
1210,Stevan Jovetić,MNE,FW,Monaco,Ligue 1,27,1989,8.4,4,4,0,3,1,0,9,0.0,9,5,0,5,3,7,3,0,Matches
1211,Luka Jović,SRB,FW,Eint Frankfurt,Bundesliga,19,1997,10.4,5,5,0,5,0,1,3,33.3,2,6,2,4,1,6,2,0,Matches
1212,Jozabed,ESP,MF,Celta Vigo,La Liga,26,1991,16.4,18,12,7,9,2,3,18,16.7,15,18,2,16,16,34,19,0,Matches
1213,Juanfran,ESP,DF,La Coruña,La Liga,28,1988,34.0,64,44,38,22,4,35,65,53.8,30,29,11,18,63,127,121,0,Matches
1214,Juanfran,ESP,DF,Atlético Madrid,La Liga,32,1985,14.5,33,24,21,9,3,21,32,65.6,11,14,4,10,26,59,35,0,Matches
1215,Juankar,ESP,DF,Málaga,La Liga,27,1990,8.7,23,17,13,8,2,11,20,55.0,9,8,1,7,19,42,26,0,Matches
1216,Juanmi,ESP,"FW,MF",Real Sociedad,La Liga,24,1993,16.5,22,13,7,12,3,4,22,18.2,18,11,0,11,10,32,6,0,Matches
1217,Juanpe,ESP,DF,Girona,La Liga,26,1991,34.1,48,30,28,20,0,30,43,69.8,13,27,19,8,53,101,137,0,Matches
1218,Juanpi,VEN,"MF,FW",Málaga,La Liga,23,1994,6.8,11,8,2,7,2,3,8,37.5,5,7,0,7,6,17,1,0,Matches
1219,Mariano Julio Izco,ARG,MF,Crotone,Serie A,34,1983,2.0,6,4,2,4,0,2,4,50.0,2,2,0,2,4,10,1,0,Matches
1220,Christopher Jullien,FRA,DF,Toulouse,Ligue 1,24,1993,28.9,36,25,27,9,0,15,32,46.9,17,29,19,10,40,76,182,5,Matches
1221,David Juncà,ESP,DF,Eibar,La Liga,23,1993,10.0,15,13,9,6,0,7,19,36.8,12,7,1,6,11,26,25,0,Matches
1222,Gideon Jung,GER,"MF,DF",Hamburger SV,Bundesliga,22,1994,28.6,59,41,32,24,3,22,38,57.9,16,29,12,17,38,97,71,1,Matches
1223,Sebastian Jung,GER,DF,Wolfsburg,Bundesliga,27,1990,0.9,2,2,1,1,0,1,1,100.0,0,0,0,0,0,2,5,0,Matches
1224,Zlatko Junuzović,AUT,"MF,FW",Werder Bremen,Bundesliga,29,1987,18.1,35,23,17,12,6,18,38,47.4,20,23,2,21,18,53,12,0,Matches
1225,Mathias Jørgensen,DEN,DF,Huddersfield,Premier League,27,1990,38.0,55,36,40,13,2,19,45,42.2,26,49,20,29,76,131,249,5,Matches
1226,Christian Kabasele,BEL,DF,Watford,Premier League,26,1991,25.9,42,25,28,14,0,21,36,58.3,15,37,23,14,34,76,185,0,Matches
1227,Younès Kaboul,FRA,DF,Watford,Premier League,31,1986,1.7,3,2,0,3,0,0,0,,0,4,2,2,2,5,15,0,Matches
1228,Alexander Kačaniklić,SWE,"MF,FW",Nantes,Ligue 1,25,1991,3.5,8,5,7,1,0,5,10,50.0,5,5,2,3,6,14,7,0,Matches
1229,Gojko Kačar,SRB,DF,Augsburg,Bundesliga,30,1987,2.5,7,6,6,1,0,3,7,42.9,4,3,2,1,4,11,7,0,Matches
1230,Elias Kachunga,COD,"FW,MF",Huddersfield,Premier League,25,1992,14.8,30,26,13,12,5,8,19,42.1,11,14,1,13,2,32,9,0,Matches
1231,Pavel Kadeřábek,CZE,"FW,DF",Hoffenheim,Bundesliga,25,1992,24.4,44,30,22,18,4,20,44,45.5,24,27,8,19,34,78,45,1,Matches
1232,Shinji Kagawa,JPN,MF,Dortmund,Bundesliga,28,1989,13.0,32,22,11,14,7,18,27,66.7,9,6,0,6,6,38,2,0,Matches
1233,Sullay Kaikai,SLE,MF,Crystal Palace,Premier League,21,1995,0.2,1,0,0,1,0,0,0,,0,1,0,1,0,1,1,0,Matches
1234,Florian Kainz,AUT,"MF,FW",Werder Bremen,Bundesliga,24,1992,19.0,33,25,9,18,6,9,19,47.4,10,23,0,23,17,50,13,0,Matches
1235,Dominik Kaiser,GER,"MF,FW",RB Leipzig,Bundesliga,28,1988,3.1,5,5,1,3,1,4,11,36.4,7,6,0,6,1,6,8,0,Matches
1236,Gaël Kakuta,COD,"MF,FW",Amiens,Ligue 1,26,1991,34.3,54,32,14,27,13,9,40,22.5,31,33,3,30,26,80,19,0,Matches
1237,Nikola Kalinić,CRO,FW,Milan,Serie A,29,1988,20.1,6,5,1,4,1,0,8,0.0,8,4,1,3,3,9,12,0,Matches
1238,Salomon Kalou,CIV,"FW,MF",Hertha BSC,Bundesliga,31,1985,24.5,19,11,12,5,2,9,17,52.9,8,37,1,36,10,29,29,0,Matches
1239,Daichi Kamada,JPN,"MF,FW",Eint Frankfurt,Bundesliga,20,1996,1.6,1,1,0,1,0,0,0,,0,0,0,0,1,2,0,0,Matches
1240,François Kamano,GUI,FW,Bordeaux,Ligue 1,21,1996,22.4,32,24,11,14,7,10,35,28.6,25,18,2,16,15,47,8,0,Matches
1241,Bingourou Kamara,SEN,GK,Strasbourg,Ligue 1,20,1996,18.8,0,0,0,0,0,0,2,0.0,2,0,0,0,1,1,6,3,Matches
1242,Boubacar Kamara,FRA,"DF,MF",Marseille,Ligue 1,17,1999,5.1,14,14,9,5,0,8,12,66.7,4,7,3,4,3,17,18,0,Matches
1243,Marcin Kamiński,POL,DF,Stuttgart,Bundesliga,25,1992,12.6,17,14,5,11,1,12,18,66.7,6,12,3,9,30,47,55,0,Matches
1244,Kevin Kampl,SVN,MF,RB Leipzig,Bundesliga,26,1990,22.4,42,33,16,20,6,16,39,41.0,23,37,2,35,33,75,33,0,Matches
1245,Kevin Kampl,SVN,MF,Leverkusen,Bundesliga,26,1990,0.3,1,1,1,0,0,1,1,100.0,0,0,0,0,0,1,0,0,Matches
1246,Harry Kane,ENG,FW,Tottenham,Premier League,24,1993,34.2,17,12,2,8,7,4,15,26.7,11,15,4,11,5,22,19,0,Matches
1247,Wilfried Kanga,CIV,"FW,MF",Angers,Ligue 1,19,1998,1.9,2,2,0,2,0,0,2,0.0,2,0,0,0,0,2,1,0,Matches
1248,Mamadou Kanouté,SEN,"FW,MF",Benevento,Serie A,23,1993,0.4,0,0,0,0,0,0,0,,0,0,0,0,1,1,1,0,Matches
1249,N'Golo Kanté,FRA,MF,Chelsea,Premier League,26,1991,33.3,113,77,55,52,6,33,92,35.9,59,40,4,36,85,198,29,3,Matches
1250,Bartosz Kapustka,POL,"FW,MF",Freiburg,Bundesliga,20,1996,2.6,9,5,2,6,1,4,6,66.7,2,4,0,4,3,12,0,0,Matches
1251,Kenan Karaman,TUR,"MF,FW",Hannover 96,Bundesliga,23,1994,9.5,16,13,9,6,1,6,7,85.7,1,10,4,6,1,17,17,0,Matches
1252,Yann Karamoh,FRA,"FW,MF",Inter,Serie A,19,1998,5.4,3,1,1,1,1,0,3,0.0,3,4,0,4,4,7,1,1,Matches
1253,Loris Karius,GER,GK,Liverpool,Premier League,24,1993,19.0,0,0,0,0,0,0,0,,0,0,0,0,1,1,4,0,Matches
1254,Orestis Karnezis,GRE,GK,Watford,Premier League,32,1985,14.4,0,0,0,0,0,0,2,0.0,2,0,0,0,1,1,3,3,Matches
1255,Rick Karsdorp,NED,DF,Roma,Serie A,22,1995,0.9,1,1,1,0,0,0,0,,0,0,0,0,1,2,0,0,Matches
1256,Aleksandar Katai,SRB,"MF,DF",Alavés,La Liga,26,1991,0.6,1,1,0,1,0,0,1,0.0,1,0,0,0,0,1,0,0,Matches
1257,Florian Kath,GER,"FW,MF",Freiburg,Bundesliga,22,1994,7.5,15,10,3,9,3,9,17,52.9,8,9,0,9,8,23,1,0,Matches
1258,Ole Käuper,GER,MF,Werder Bremen,Bundesliga,20,1997,0.8,6,5,2,4,0,1,4,25.0,3,1,0,1,2,8,0,0,Matches
1259,Eiji Kawashima,JPN,GK,Metz,Ligue 1,34,1983,28.5,1,1,1,0,0,1,3,33.3,2,0,0,0,3,4,9,2,Matches
1260,Beram Kayal,ISR,MF,Brighton,Premier League,29,1988,8.3,18,11,10,7,1,6,26,23.1,20,11,4,7,12,30,9,0,Matches
1261,Joris Kayembe,COD,"FW,MF",Nantes,Ligue 1,22,1994,1.0,1,0,1,0,0,0,4,0.0,4,0,0,0,0,1,4,0,Matches
1262,Olarenwaju Kayode,NGA,"FW,MF",Girona,La Liga,24,1993,4.3,3,3,1,2,0,0,4,0.0,4,1,0,1,1,4,0,0,Matches
1263,Moise Kean,ITA,FW,Hellas Verona,Serie A,17,2000,12.6,8,5,1,3,4,1,6,16.7,5,6,0,6,7,15,4,0,Matches
1264,Michael Keane,ENG,DF,Everton,Premier League,24,1993,28.4,33,25,26,5,2,19,43,44.2,24,39,28,11,53,86,214,0,Matches
1265,Thilo Kehrer,GER,DF,Schalke 04,Bundesliga,20,1996,26.3,81,64,41,36,4,46,68,67.6,22,42,12,30,35,116,113,2,Matches
1266,Cheick Keita,MLI,DF,Bologna,Serie A,21,1996,1.4,2,2,1,1,0,1,3,33.3,2,5,0,5,2,4,1,0,Matches
1267,Naby Keïta,GUI,MF,RB Leipzig,Bundesliga,22,1995,21.8,65,48,25,33,7,17,43,39.5,26,26,3,23,36,101,18,0,Matches
1268,Keko,ESP,"MF,FW",Málaga,La Liga,25,1991,13.4,38,23,17,13,8,15,47,31.9,32,25,3,22,13,51,9,0,Matches
1269,Martin Kelly,ENG,DF,Crystal Palace,Premier League,27,1990,13.3,19,13,15,4,0,14,26,53.8,12,16,11,5,9,28,67,3,Matches
1270,Marc-Oliver Kempf,GER,DF,Freiburg,Bundesliga,22,1995,10.0,13,12,9,4,0,5,8,62.5,3,7,7,0,17,30,52,0,Matches
1271,Kenedy,BRA,"MF,DF",Newcastle Utd,Premier League,21,1996,11.4,31,17,16,13,2,12,35,34.3,23,12,1,11,14,45,11,0,Matches
1272,Jonjoe Kenny,ENG,DF,Everton,Premier League,20,1997,17.7,41,33,28,10,3,20,32,62.5,12,17,7,10,28,69,95,0,Matches
1273,Ryan Kent,ENG,"FW,MF",Freiburg,Bundesliga,20,1996,2.7,4,3,2,1,1,2,5,40.0,3,6,0,6,1,5,1,0,Matches
1274,Christophe Kerbrat,FRA,DF,Guingamp,Ligue 1,30,1986,36.9,62,45,47,14,1,35,65,53.8,30,49,40,9,62,124,249,2,Matches
1275,Franck Kessié,CIV,MF,Milan,Serie A,20,1996,36.3,48,34,20,19,9,17,44,38.6,27,47,11,36,26,74,45,3,Matches
1276,Billy Ketkeophomphone,LAO,MF,Angers,Ligue 1,27,1990,4.9,14,9,4,5,5,5,15,33.3,10,9,0,9,5,19,8,0,Matches
1277,Driss Khalid,MAR,FW,Toulouse,Ligue 1,18,1999,0.3,1,0,0,0,1,0,0,,0,0,0,0,0,1,2,0,Matches
1278,Saîf-Eddine Khaoui,TUN,"MF,FW",Troyes,Ligue 1,22,1995,21.7,57,25,22,27,8,15,50,30.0,35,12,2,10,27,84,9,0,Matches
1279,Wahbi Khazri,TUN,"FW,MF",Rennes,Ligue 1,26,1991,21.3,26,18,7,10,9,7,39,17.9,32,29,0,29,7,33,7,0,Matches
1280,Rani Khedira,GER,"MF,DF",Augsburg,Bundesliga,23,1994,25.3,62,47,25,28,9,33,47,70.2,14,41,18,23,36,98,96,0,Matches
1281,Sami Khedira,GER,MF,Juventus,Serie A,30,1987,21.2,14,9,1,9,4,2,23,8.7,21,13,3,10,20,34,20,0,Matches
1282,Stefan Kießling,GER,"DF,MF",Leverkusen,Bundesliga,33,1984,0.9,0,0,0,0,0,0,0,,0,2,0,2,0,0,1,0,Matches
1283,Kiké,ESP,FW,Eibar,La Liga,27,1989,27.3,14,8,1,7,6,2,11,18.2,9,15,1,14,10,24,14,0,Matches
1284,Joshua Kimmich,GER,DF,Bayern Munich,Bundesliga,22,1995,25.9,32,23,14,13,5,20,38,52.6,18,26,5,21,20,52,40,0,Matches
1285,Presnel Kimpembe,FRA,DF,Paris S-G,Ligue 1,21,1995,26.9,39,28,20,18,1,9,14,64.3,5,17,10,7,24,63,80,1,Matches
1286,Andy King,WAL,MF,Leicester City,Premier League,28,1988,6.0,8,5,0,5,3,0,3,0.0,3,4,2,2,5,13,13,0,Matches
1287,Andy King,WAL,MF,Swansea City,Premier League,28,1988,7.9,18,11,10,8,0,5,14,35.7,9,7,0,7,6,24,14,1,Matches
1288,Joshua King,NOR,"FW,MF",Bournemouth,Premier League,25,1992,27.3,36,26,11,17,8,4,27,14.8,23,23,3,20,4,40,14,1,Matches
1289,Simon Kjær,DEN,DF,Sevilla,La Liga,28,1989,17.5,35,24,25,8,2,13,22,59.1,9,16,10,6,32,67,109,0,Matches
1290,Davy Klaassen,NED,"MF,FW",Everton,Premier League,24,1993,2.8,3,1,1,2,0,2,6,33.3,4,2,1,1,1,4,2,0,Matches
1291,Felix Klaus,GER,"MF,FW",Hannover 96,Bundesliga,24,1992,22.0,48,38,20,21,7,23,50,46.0,27,29,4,25,8,56,28,0,Matches
1292,Ragnar Klavan,EST,DF,Liverpool,Premier League,31,1985,16.1,14,10,6,7,1,6,12,50.0,6,11,5,6,15,29,85,1,Matches
1293,Tim Kleindienst,GER,"FW,DF",Freiburg,Bundesliga,21,1995,12.6,22,15,6,12,4,4,17,23.5,13,17,3,14,6,28,21,0,Matches
1294,Lukas Klostermann,GER,DF,RB Leipzig,Bundesliga,21,1996,24.3,56,41,34,18,4,28,37,75.7,9,33,6,27,33,89,79,0,Matches
1295,Lukas Klünter,GER,"DF,FW",Köln,Bundesliga,21,1996,14.8,25,20,16,8,1,16,24,66.7,8,11,2,9,13,38,28,1,Matches
1296,Robin Knoche,GER,DF,Wolfsburg,Bundesliga,25,1992,23.4,34,20,26,8,0,25,35,71.4,10,36,24,12,25,59,89,1,Matches
1297,Anthony Knockaert,FRA,"MF,FW",Brighton,Premier League,25,1991,26.9,39,26,25,11,3,16,55,29.1,39,29,3,26,23,62,16,0,Matches
1298,Törles Knöll,GER,"MF,FW",Hamburger SV,Bundesliga,19,1997,0.2,0,0,0,0,0,0,0,,0,1,0,1,0,0,0,0,Matches
1299,Robin Koch,GER,"MF,DF",Freiburg,Bundesliga,21,1996,21.3,34,24,21,13,0,10,18,55.6,8,27,11,16,35,69,67,0,Matches
1300,Kenan Kodro,BIH,"FW,DF",Mainz 05,Bundesliga,23,1993,2.6,1,1,0,1,0,0,0,,0,1,0,1,3,4,0,0,Matches
1301,Hervé Koffi,BFA,GK,Lille,Ligue 1,20,1996,4.0,0,0,0,0,0,0,0,,0,0,0,0,1,1,1,1,Matches
1302,Dominik Kohr,GER,MF,Leverkusen,Bundesliga,23,1994,18.5,49,26,20,25,4,25,41,61.0,16,39,5,34,30,79,24,0,Matches
1303,Seybou Koita,NIG,FW,Amiens,Ligue 1,23,1994,2.4,1,1,1,0,0,1,1,100.0,0,0,0,0,0,1,2,0,Matches
1304,Koke,ESP,MF,Atlético Madrid,La Liga,25,1992,30.6,75,45,31,32,12,27,95,28.4,68,40,3,37,24,99,38,0,Matches
1305,Aleksandar Kolarov,SRB,DF,Roma,Serie A,31,1985,34.0,58,47,34,16,8,27,49,55.1,22,24,7,17,53,111,100,2,Matches
1306,Sead Kolašinac,BIH,DF,Arsenal,Premier League,24,1993,23.9,49,37,28,13,8,20,39,51.3,19,15,3,12,26,75,56,0,Matches
1307,Vincent Kompany,BEL,DF,Manchester City,Premier League,31,1986,15.5,20,11,14,5,1,13,19,68.4,6,10,8,2,16,36,73,1,Matches
1308,Ibrahima Konaté,FRA,DF,RB Leipzig,Bundesliga,18,1999,13.6,32,25,20,12,0,18,23,78.3,5,14,3,11,20,52,66,0,Matches
1309,Moussa Konaté,SEN,FW,Amiens,Ligue 1,24,1993,27.5,8,6,1,4,3,3,23,13.0,20,10,2,8,3,11,11,0,Matches
1310,Geoffrey Kondogbia,CTA,MF,Valencia,La Liga,24,1993,29.0,88,57,38,43,7,23,68,33.8,45,46,14,32,62,150,66,0,Matches
1311,Bakary Koné,BFA,DF,Strasbourg,Ligue 1,29,1988,27.4,26,17,23,3,0,12,31,38.7,19,20,10,10,33,59,122,2,Matches
1312,Terence Kongolo,NED,DF,Huddersfield,Premier League,23,1994,11.7,33,20,19,13,1,14,22,63.6,8,12,6,6,32,65,71,0,Matches
1313,Terence Kongolo,NED,DF,Monaco,Ligue 1,23,1994,2.9,6,4,4,2,0,0,2,0.0,2,5,3,2,5,11,14,0,Matches
1314,Yevhen Konoplyanka,UKR,"FW,MF",Schalke 04,Bundesliga,27,1989,17.4,11,9,3,4,4,3,11,27.3,8,18,1,17,5,16,6,0,Matches
1315,Julian Korb,GER,"DF,MF",Hannover 96,Bundesliga,25,1992,26.0,52,41,27,19,6,37,68,54.4,31,30,2,28,22,74,77,0,Matches
1316,Laurent Koscielny,FRA,DF,Arsenal,Premier League,31,1985,24.7,43,21,27,12,4,19,33,57.6,14,28,15,13,54,97,138,3,Matches
1317,Filip Kostić,SRB,"FW,MF",Hamburger SV,Bundesliga,24,1992,27.1,48,38,16,21,11,20,41,48.8,21,42,1,41,10,58,12,0,Matches
1318,Christian Kouakou,CIV,"MF,FW",Caen,Ligue 1,26,1991,9.4,24,13,14,8,2,5,19,26.3,14,16,1,15,8,32,6,1,Matches
1319,Rominigue Kouamé,MLI,"DF,MF",Lille,Ligue 1,20,1996,2.2,5,2,2,2,1,2,3,66.7,1,1,0,1,5,10,0,0,Matches
1320,Tomáš Koubek,CZE,GK,Rennes,Ligue 1,24,1992,34.0,0,0,0,0,0,0,1,0.0,1,0,0,0,3,3,22,3,Matches
1321,Kalidou Koulibaly,SEN,DF,Napoli,Serie A,26,1991,34.1,54,42,31,19,4,20,40,50.0,20,36,16,20,40,94,119,3,Matches
1322,Jules Koundé,FRA,DF,Bordeaux,Ligue 1,18,1998,17.7,26,19,19,7,0,13,17,76.5,4,14,11,3,14,40,97,0,Matches
1323,Cheikhou Kouyaté,SEN,MF,West Ham,Premier League,27,1989,31.1,71,49,43,26,2,23,62,37.1,39,31,11,20,32,103,56,1,Matches
1324,Mateo Kovačić,CRO,MF,Real Madrid,La Liga,23,1994,11.0,37,27,19,18,0,8,27,29.6,19,9,4,5,5,42,5,0,Matches
1325,Maksym Koval,UKR,GK,La Coruña,La Liga,24,1992,1.3,0,0,0,0,0,0,0,,0,0,0,0,0,0,0,2,Matches
1326,Dawid Kownacki,POL,FW,Sampdoria,Serie A,20,1997,9.1,8,7,1,4,3,3,11,27.3,8,7,0,7,1,9,5,0,Matches
1327,Vincent Koziello,FRA,MF,Nice,Ligue 1,21,1995,9.0,16,8,9,5,2,5,16,31.3,11,8,3,5,19,35,7,1,Matches
1328,Vincent Koziello,FRA,MF,Köln,Bundesliga,21,1995,8.8,28,21,6,21,1,10,21,47.6,11,9,0,9,10,38,5,1,Matches
1329,Thomas Kraft,GER,GK,Hertha BSC,Bundesliga,29,1988,3.0,0,0,0,0,0,0,0,,0,0,0,0,0,0,1,0,Matches
1330,Emil Krafth,SWE,DF,Bologna,Serie A,22,1994,10.5,23,16,14,8,1,10,19,52.6,9,12,4,8,16,39,39,1,Matches
1331,Oliver Kragl,GER,MF,Crotone,Serie A,27,1990,1.1,1,0,0,1,0,0,0,,0,1,0,1,2,3,2,0,Matches
1332,Andrej Kramarić,CRO,"FW,MF",Hoffenheim,Bundesliga,26,1991,24.8,8,6,4,3,1,3,8,37.5,5,15,0,15,6,14,7,0,Matches
1333,Christoph Kramer,GER,MF,Gladbach,Bundesliga,26,1991,23.9,89,70,43,34,12,39,76,51.3,37,29,4,25,43,132,37,1,Matches
1334,Ladislav Krejčí,CZE,"MF,FW",Bologna,Serie A,25,1992,4.4,7,5,1,3,3,1,5,20.0,4,3,0,3,2,9,3,0,Matches
1335,Rene Krhin,SVN,MF,Nantes,Ligue 1,27,1990,14.6,18,12,7,11,0,3,17,17.6,14,11,2,9,16,34,39,0,Matches
1336,Bojan Krkić,ESP,MF,Stoke City,Premier League,26,1990,0.8,0,0,0,0,0,0,1,0.0,1,1,0,1,0,0,0,0,Matches
1337,Bojan Krkić,ESP,"FW,MF",Alavés,La Liga,26,1990,4.9,2,1,1,1,0,1,2,50.0,1,5,0,5,3,5,0,0,Matches
1338,Michael Krohn-Dehli,DEN,MF,La Coruña,La Liga,34,1983,8.1,12,9,6,5,1,4,17,23.5,13,2,0,2,13,25,7,0,Matches
1339,Michael Krohn-Dehli,DEN,"MF,FW",Sevilla,La Liga,34,1983,6.0,13,7,4,5,4,6,11,54.5,5,5,0,5,4,17,7,0,Matches
1340,Toni Kroos,GER,MF,Real Madrid,La Liga,27,1990,25.1,55,35,19,29,7,22,59,37.3,37,20,2,18,16,71,10,1,Matches
1341,Max Kruse,GER,FW,Werder Bremen,Bundesliga,29,1988,27.3,17,12,3,10,4,5,22,22.7,17,9,0,9,11,28,4,1,Matches
1342,Grzegorz Krychowiak,POL,MF,West Brom,Premier League,27,1990,18.2,39,24,18,17,4,12,49,24.5,37,23,5,18,45,84,23,0,Matches
1343,Lukas Kübler,GER,"DF,MF",Freiburg,Bundesliga,24,1992,12.8,31,19,16,15,0,13,23,56.5,10,15,6,9,18,49,41,0,Matches
1344,Jasmin Kurtić,SVN,"MF,FW",SPAL,Serie A,28,1989,16.0,28,18,13,11,4,5,21,23.8,16,13,1,12,17,45,25,0,Matches
1345,Jasmin Kurtić,SVN,MF,Atalanta,Serie A,28,1989,7.4,12,7,6,3,3,3,7,42.9,4,7,0,7,5,17,4,0,Matches
1346,Layvin Kurzawa,FRA,DF,Paris S-G,Ligue 1,24,1992,18.9,44,32,20,15,9,15,39,38.5,24,16,3,13,35,79,41,2,Matches
1347,Filip Kusić,SRB,"DF,MF",Köln,Bundesliga,21,1996,0.2,0,0,0,0,0,0,0,,0,0,0,0,0,0,1,0,Matches
1348,Zdravko Kuzmanović,SRB,MF,Málaga,La Liga,29,1987,5.3,4,4,1,3,0,0,5,0.0,5,2,2,0,4,8,9,0,Matches
1349,Han Kwang-song,PRK,FW,Cagliari,Serie A,18,1998,3.1,1,1,0,0,1,0,4,0.0,4,4,0,4,0,1,0,0,Matches
1350,Enock Kwateng,FRA,DF,Nantes,Ligue 1,20,1997,1.0,8,6,6,2,0,7,11,63.6,4,2,0,2,1,9,7,0,Matches
1351,Alberto de la Bella,ESP,DF,Real Sociedad,La Liga,31,1985,17.0,36,22,25,10,1,16,28,57.1,12,19,5,14,21,57,54,0,Matches
1352,Rajiv van La Parra,NED,"FW,MF",Huddersfield,Premier League,26,1991,23.7,41,29,18,15,8,12,41,29.3,29,27,1,26,21,62,8,1,Matches
1353,Brighton Labeau,MTQ,FW,Amiens,Ligue 1,21,1996,0.3,0,0,0,0,0,0,0,,0,0,0,0,0,0,0,0,Matches
1354,Gaëtan Laborde,FRA,FW,Bordeaux,Ligue 1,23,1994,10.6,9,7,1,6,2,2,7,28.6,5,8,2,6,1,10,7,1,Matches
1355,Alexandre Lacazette,FRA,FW,Arsenal,Premier League,26,1991,24.5,24,17,6,11,7,4,27,14.8,23,19,3,16,7,31,5,0,Matches
1356,Mehdi Lacen,ALG,MF,Málaga,La Liga,33,1984,11.7,35,19,18,17,0,14,38,36.8,24,13,1,12,15,50,11,0,Matches
1357,Mehdi Lacen,ALG,MF,Getafe,La Liga,33,1984,0.7,3,1,2,1,0,0,0,,0,1,0,1,0,3,1,0,Matches
1358,Léo Lacroix,SUI,DF,Saint-Étienne,Ligue 1,25,1992,8.6,13,8,8,5,0,5,9,55.6,4,6,3,3,11,24,54,1,Matches
1359,Freddie Ladapo,ENG,FW,Crystal Palace,Premier League,24,1993,0.2,0,0,0,0,0,0,0,,0,0,0,0,0,0,0,0,Matches
1360,Alban Lafont,FRA,GK,Toulouse,Ligue 1,18,1999,38.0,1,0,1,0,0,1,4,25.0,3,0,0,0,2,3,20,5,Matches
1361,Víctor Laguardia,ESP,DF,Alavés,La Liga,27,1989,17.0,20,15,13,5,2,11,19,57.9,8,23,14,9,29,49,109,0,Matches
1362,Konrad Laimer,AUT,"DF,MF",RB Leipzig,Bundesliga,20,1997,14.9,57,39,31,22,4,28,57,49.1,29,37,2,35,11,68,32,0,Matches
1363,Kenny Lala,MAD,DF,Strasbourg,Ligue 1,25,1991,30.3,87,47,53,28,6,21,47,44.7,26,18,10,8,42,129,70,2,Matches
1364,Adam Lallana,ENG,"MF,FW",Liverpool,Premier League,29,1988,3.4,3,1,3,0,0,2,10,20.0,8,3,0,3,1,4,1,0,Matches
1365,Eugenio Lamanna,ITA,GK,Genoa,Serie A,27,1989,1.0,0,0,0,0,0,0,0,,0,0,0,0,0,0,1,0,Matches
1366,Érik Lamela,ARG,"FW,MF",Tottenham,Premier League,25,1992,9.4,23,13,9,7,7,3,20,15.0,17,11,1,10,7,30,5,0,Matches
1367,Ádám Lang,HUN,DF,Dijon,Ligue 1,24,1993,2.6,3,1,3,0,0,3,5,60.0,2,2,1,1,3,6,12,0,Matches
1368,Sebastian Langkamp,GER,DF,Hertha BSC,Bundesliga,29,1988,10.6,15,12,9,6,0,11,18,61.1,7,7,4,3,21,36,58,1,Matches
1369,Sebastian Langkamp,GER,DF,Werder Bremen,Bundesliga,29,1988,4.6,7,3,4,3,0,4,4,100.0,0,7,5,2,8,15,18,0,Matches
1370,Manuel Lanzini,ARG,"MF,FW",West Ham,Premier League,24,1993,22.7,20,11,6,11,3,2,34,5.9,32,7,1,6,30,50,5,2,Matches
1371,Gianluca Lapadula,PER,FW,Genoa,Serie A,27,1990,16.6,8,5,4,4,0,1,11,9.1,10,7,1,6,3,11,8,0,Matches
1372,Aymeric Laporte,ESP,DF,Manchester City,Premier League,23,1994,9.0,8,7,6,2,0,3,8,37.5,5,2,1,1,11,19,27,0,Matches
1373,Aymeric Laporte,ESP,DF,Athletic Club,La Liga,23,1994,19.0,38,23,27,11,0,14,25,56.0,11,19,13,6,27,65,94,1,Matches
1374,Danilo Larangeira,BRA,DF,Udinese,Serie A,33,1984,30.8,35,21,26,8,1,16,29,55.2,13,50,38,12,50,85,161,2,Matches
1375,Kevin Lasagna,ITA,FW,Udinese,Serie A,24,1992,23.7,10,7,0,8,2,2,7,28.6,5,27,4,23,8,18,18,0,Matches
1376,Jamaal Lascelles,ENG,DF,Newcastle Utd,Premier League,23,1993,32.5,31,19,19,11,1,12,19,63.2,7,33,24,9,28,59,232,1,Matches
1377,Paul Lasne,FRA,MF,Montpellier,Ligue 1,28,1989,34.0,68,45,27,39,2,12,54,22.2,42,20,1,19,57,125,26,0,Matches
1378,Borja Lasso,ESP,MF,Sevilla,La Liga,23,1994,0.6,4,1,2,2,0,1,2,50.0,1,3,0,3,0,4,0,0,Matches
1379,Toni Lato,ESP,"DF,MF",Valencia,La Liga,19,1997,8.9,30,16,22,6,2,16,27,59.3,11,9,3,6,9,39,23,0,Matches
1380,Danny Latza,GER,MF,Mainz 05,Bundesliga,27,1989,26.1,67,48,28,33,6,33,73,45.2,40,43,8,35,26,93,47,1,Matches
1381,Vincent Laurini,FRA,DF,Fiorentina,Serie A,28,1989,17.9,34,23,21,9,4,12,22,54.5,10,20,5,15,11,45,72,1,Matches
1382,Wesley Lautoa,NCL,"DF,MF",Dijon,Ligue 1,29,1987,6.9,17,13,11,6,0,6,12,50.0,6,10,4,6,19,36,24,1,Matches
1383,Diego Laxalt,URU,DF,Genoa,Serie A,24,1993,31.2,54,43,31,17,6,22,59,37.3,37,38,3,35,25,79,55,1,Matches
1384,Miguel Layún,MEX,DF,Sevilla,La Liga,29,1988,13.2,28,19,14,12,2,17,36,47.2,19,18,4,14,15,43,44,1,Matches
1385,Achraf Lazaar,MAR,"MF,DF",Benevento,Serie A,25,1992,5.3,12,8,9,2,1,5,11,45.5,6,5,1,4,6,18,10,0,Matches
1386,Valentino Lazaro,AUT,"MF,FW",Hertha BSC,Bundesliga,21,1996,20.7,33,28,11,12,10,15,31,48.4,16,35,2,33,15,48,32,0,Matches
1387,Darko Lazović,SRB,"DF,MF",Genoa,Serie A,26,1990,13.8,19,12,16,2,1,9,18,50.0,9,8,0,8,13,32,12,0,Matches
1388,Manuel Lazzari,ITA,DF,SPAL,Serie A,23,1993,34.6,61,47,33,21,7,27,62,43.5,35,32,7,25,31,92,73,2,Matches
1389,Mickaël Le Bihan,FRA,"FW,MF",Nice,Ligue 1,27,1990,1.2,0,0,0,0,0,0,3,0.0,3,0,0,0,1,1,0,0,Matches
1390,Maxime Le Marchand,FRA,DF,Nice,Ligue 1,27,1989,28.2,48,36,28,18,2,20,41,48.8,21,36,13,23,65,113,105,4,Matches
1391,James Lea Siliki,CMR,MF,Rennes,Ligue 1,21,1996,20.2,31,21,9,19,3,6,41,14.6,35,21,1,20,18,49,14,1,Matches
1392,Mathew Leckie,AUS,"FW,MF",Hertha BSC,Bundesliga,26,1991,20.6,35,30,16,15,4,20,35,57.1,15,26,3,23,19,54,32,1,Matches
1393,Benjamin Lecomte,FRA,GK,Montpellier,Ligue 1,26,1991,38.0,1,1,1,0,0,0,0,,0,1,0,1,0,1,14,1,Matches
1394,Pierre Lees-Melou,FRA,"MF,FW",Nice,Ligue 1,24,1993,32.1,78,47,29,39,10,27,76,35.5,49,52,11,41,34,112,38,2,Matches
1395,Matthias Lehmann,GER,MF,Köln,Bundesliga,34,1983,16.8,33,23,14,18,1,17,29,58.6,12,15,7,8,26,59,24,1,Matches
1396,Lucas Leiva,BRA,MF,Lazio,Serie A,30,1987,32.0,107,80,43,59,5,29,100,29.0,71,33,7,26,70,177,59,0,Matches
1397,Florian Lejeune,FRA,DF,Newcastle Utd,Premier League,26,1991,23.4,34,20,26,8,0,14,30,46.7,16,21,15,6,46,80,154,0,Matches
1398,Iñigo Lekue,ESP,"DF,FW",Athletic Club,La Liga,24,1993,23.5,71,42,37,26,8,34,53,64.2,19,29,3,26,16,87,46,1,Matches
1399,Thomas Lemar,FRA,"MF,FW",Monaco,Ligue 1,21,1995,26.4,33,17,9,19,5,10,41,24.4,31,22,1,21,18,51,16,1,Matches
1400,Mario Lemina,GAB,MF,Southampton,Premier League,23,1993,19.1,55,40,21,29,5,12,30,40.0,18,18,6,12,36,91,36,4,Matches
1401,Mauricio Lemos,URU,DF,Sassuolo,Serie A,21,1995,7.8,11,9,8,3,0,7,14,50.0,7,10,5,5,9,20,33,1,Matches
1402,Mauricio Lemos,URU,"DF,MF",Las Palmas,La Liga,21,1995,14.0,22,10,17,5,0,15,27,55.6,12,16,13,3,25,47,51,1,Matches
1403,Dylan Lempereur,FRA,DF,Metz,Ligue 1,18,1998,1.6,5,3,3,1,1,2,6,33.3,4,1,0,1,0,5,6,0,Matches
1404,Clément Lenglet,FRA,DF,Sevilla,La Liga,22,1995,33.3,67,50,32,35,0,21,38,55.3,17,44,27,17,35,102,157,1,Matches
1405,Aaron Lennon,ENG,MF,Burnley,Premier League,30,1987,12.4,20,14,5,14,1,2,20,10.0,18,20,5,15,8,28,18,0,Matches
1406,Aaron Lennon,ENG,"FW,MF",Everton,Premier League,30,1987,8.8,17,10,10,5,2,5,21,23.8,16,13,1,12,11,28,9,0,Matches
1407,Bernd Leno,GER,GK,Leverkusen,Bundesliga,25,1992,33.0,0,0,0,0,0,0,1,0.0,1,0,0,0,1,1,11,2,Matches
1408,Pedro León,ESP,"FW,MF",Eibar,La Liga,30,1986,10.3,9,4,0,2,7,0,4,0.0,4,18,2,16,9,18,5,0,Matches
1409,Sergio León,ESP,FW,Betis,La Liga,28,1989,22.0,13,7,3,6,4,3,11,27.3,8,12,1,11,6,19,5,0,Matches
1410,Lukas Lerager,DEN,MF,Bordeaux,Ligue 1,24,1993,36.5,107,74,33,61,13,33,107,30.8,74,44,8,36,67,174,66,1,Matches
1411,Mehdi Léris,ALG,"MF,FW",Chievo,Serie A,19,1998,0.5,1,1,1,0,0,0,1,0.0,1,0,0,0,1,2,0,0,Matches
1412,Jefferson Lerma,COL,MF,Levante,La Liga,22,1994,23.7,51,35,26,23,2,17,45,37.8,28,25,10,15,49,100,43,0,Matches
1413,Maxime Lestienne,BEL,MF,Málaga,La Liga,25,1992,7.4,8,5,5,0,3,3,15,20.0,12,7,1,6,6,14,6,0,Matches
1414,Alexandre Letellier,FRA,GK,Angers,Ligue 1,26,1990,13.0,0,0,0,0,0,0,0,,0,0,0,0,0,0,1,2,Matches
1415,Gaetano Letizia,ITA,DF,Benevento,Serie A,27,1990,23.8,36,26,21,14,1,19,49,38.8,30,24,3,21,33,69,47,3,Matches
1416,Timo Letschert,NED,DF,Sassuolo,Serie A,24,1993,4.6,13,8,10,3,0,5,8,62.5,3,9,3,6,7,20,23,0,Matches
1417,Robert Lewandowski,POL,FW,Bayern Munich,Bundesliga,28,1988,24.1,5,3,1,1,3,0,3,0.0,3,6,0,6,5,10,10,0,Matches
1418,Igor Lewczuk,POL,DF,Bordeaux,Ligue 1,32,1985,4.9,9,7,5,3,1,3,6,50.0,3,2,2,0,7,16,11,0,Matches
1419,Stephan Lichtsteiner,SUI,DF,Juventus,Serie A,33,1984,18.9,31,27,16,10,5,9,17,52.9,8,11,2,9,15,46,38,1,Matches
1420,Dimitri Liénard,FRA,"MF,FW",Strasbourg,Ligue 1,29,1988,28.9,77,51,37,32,8,30,84,35.7,54,35,2,33,52,129,41,1,Matches
1421,Philipp Lienhart,AUT,DF,Freiburg,Bundesliga,21,1996,9.6,16,14,12,4,0,6,17,35.3,11,14,9,5,11,27,60,0,Matches
1422,Lucas Lima,BRA,"DF,FW",Nantes,Ligue 1,25,1991,29.5,73,46,40,27,6,31,68,45.6,37,42,6,36,38,111,85,0,Matches
1423,Victor Lindelöf,SWE,DF,Manchester Utd,Premier League,23,1994,14.3,17,11,10,6,1,9,14,64.3,5,15,11,4,13,30,67,1,Matches
1424,Karol Linetty,POL,MF,Sampdoria,Serie A,22,1995,23.8,66,49,25,31,10,17,77,22.1,60,40,2,38,18,84,13,0,Matches
1425,Jesse Lingard,ENG,"MF,FW",Manchester Utd,Premier League,24,1992,20.2,30,21,10,13,7,5,27,18.5,22,18,3,15,9,39,13,0,Matches
1426,Pol Lirola,ESP,"DF,FW",Sassuolo,Serie A,19,1997,22.5,34,21,26,6,2,20,35,57.1,15,11,4,7,28,62,88,1,Matches
1427,Jake Livermore,ENG,MF,West Brom,Premier League,27,1989,29.7,72,41,27,35,10,24,64,37.5,40,44,9,35,26,98,36,2,Matches
1428,Raúl Lizoain,ESP,GK,Las Palmas,La Liga,26,1991,11.0,1,0,1,0,0,1,3,33.3,2,0,0,0,1,2,2,3,Matches
1429,Adem Ljajić,SRB,"MF,FW",Torino,Serie A,25,1991,24.1,12,9,4,6,2,5,13,38.5,8,11,1,10,9,21,13,0,Matches
1430,Diego Llorente,ESP,DF,Real Sociedad,La Liga,23,1993,25.8,30,22,16,13,1,18,29,62.1,11,41,18,23,43,73,96,0,Matches
1431,Fernando Llorente,ESP,"FW,MF",Tottenham,Premier League,32,1985,2.6,6,3,1,2,3,1,2,50.0,1,0,0,0,0,6,6,0,Matches
1432,Marcos Llorente,ESP,MF,Real Madrid,La Liga,22,1995,6.1,15,8,7,8,0,6,11,54.5,5,7,0,7,5,20,8,0,Matches
1433,Hugo Lloris,FRA,GK,Tottenham,Premier League,30,1986,36.0,1,1,1,0,0,1,4,25.0,3,0,0,0,2,3,34,8,Matches
1434,Giovani Lo Celso,ARG,MF,Paris S-G,Ligue 1,21,1996,19.7,77,58,26,36,15,26,74,35.1,48,30,5,25,19,96,12,1,Matches
1435,Simone Lo Faso,ITA,FW,Fiorentina,Serie A,19,1998,0.4,1,1,1,0,0,0,1,0.0,1,0,0,0,1,2,0,0,Matches
1436,Stanislav Lobotka,SVK,MF,Celta Vigo,La Liga,22,1994,34.0,64,45,24,35,5,23,65,35.4,42,25,9,16,39,103,22,0,Matches
1437,Jürgen Locadia,CUW,"FW,MF",Brighton,Premier League,23,1993,2.5,1,0,0,1,0,0,1,0.0,1,0,0,0,1,2,1,1,Matches
1438,Manuel Locatelli,ITA,MF,Milan,Serie A,19,1998,7.6,16,13,6,9,1,4,18,22.2,14,10,2,8,9,25,13,0,Matches
1439,Ruben Loftus-Cheek,ENG,MF,Crystal Palace,Premier League,21,1996,20.8,21,15,7,13,1,7,30,23.3,23,19,2,17,22,43,31,0,Matches
1440,Enzo Loiodice,FRA,MF,Dijon,Ligue 1,16,2000,1.9,9,5,4,5,0,4,7,57.1,3,0,0,0,2,11,0,0,Matches
1441,Joe Lolley,ENG,"FW,MF",Huddersfield,Premier League,24,1992,2.5,2,0,1,1,0,0,2,0.0,2,0,0,0,3,5,2,1,Matches
1442,David Lombán,ESP,DF,Eibar,La Liga,30,1987,11.0,16,8,12,3,1,10,15,66.7,5,6,4,2,29,45,66,2,Matches
1443,Cristiano Lombardi,ITA,"MF,DF",Benevento,Serie A,21,1995,12.4,25,19,16,7,2,6,27,22.2,21,12,2,10,13,38,22,0,Matches
1444,Kevin Long,IRL,DF,Burnley,Premier League,26,1990,16.0,32,23,28,4,0,16,26,61.5,10,25,14,11,19,51,129,1,Matches
1445,Shane Long,IRL,FW,Southampton,Premier League,30,1987,17.6,25,20,1,19,5,10,30,33.3,20,14,2,12,12,37,29,0,Matches
1446,Ademola Lookman,NGA,"FW,MF",Everton,Premier League,19,1997,1.8,1,1,0,1,0,0,2,0.0,2,2,0,2,1,2,3,0,Matches
1447,Ademola Lookman,NGA,"MF,FW",RB Leipzig,Bundesliga,19,1997,6.4,5,4,2,3,0,0,0,,0,3,0,3,2,7,2,0,Matches
1448,Anthony Lopes,POR,GK,Lyon,Ligue 1,26,1990,34.0,0,0,0,0,0,0,0,,0,0,0,0,1,1,17,4,Matches
1449,Rony Lopes,POR,"FW,MF",Monaco,Ligue 1,21,1995,28.1,55,32,15,27,13,21,78,26.9,57,23,2,21,16,71,22,0,Matches
1450,Adrián López,ESP,"FW,MF",La Coruña,La Liga,29,1988,26.1,24,14,11,8,5,7,25,28.0,18,22,4,18,10,34,49,0,Matches
1451,Alberto López,ESP,DF,Málaga,La Liga,22,1995,0.5,1,1,0,1,0,1,1,100.0,0,1,0,1,2,3,2,0,Matches
1452,Andoni López,ESP,DF,Athletic Club,La Liga,21,1996,1.0,1,0,1,0,0,1,1,100.0,0,1,0,1,1,2,6,0,Matches
1453,David López,ESP,"DF,MF",Espanyol,La Liga,27,1989,37.0,67,49,47,19,1,27,54,50.0,27,43,26,17,67,134,161,0,Matches
1454,Diego López,ESP,GK,Espanyol,La Liga,35,1981,9.5,0,0,0,0,0,0,1,0.0,1,0,0,0,0,0,1,0,Matches
1455,Iván López,ESP,DF,Levante,La Liga,23,1993,1.9,1,1,1,0,0,0,0,,0,2,2,0,8,9,2,0,Matches
1456,Javi López,ESP,DF,Espanyol,La Liga,31,1986,10.7,47,35,31,12,4,18,35,51.4,17,7,2,5,18,65,48,0,Matches
1457,Lisandro López,ARG,DF,Inter,Serie A,27,1989,0.5,2,2,1,1,0,0,2,0.0,2,0,0,0,1,3,3,0,Matches
1458,Maxi López,ARG,FW,Udinese,Serie A,33,1984,18.7,12,8,2,7,3,0,4,0.0,4,8,2,6,2,14,18,0,Matches
1459,Maxime Lopez,FRA,"MF,FW",Marseille,Ligue 1,19,1997,15.3,30,20,12,12,6,12,56,21.4,44,16,2,14,7,37,6,1,Matches
1460,Pedro López Muñoz,ESP,DF,Levante,La Liga,33,1983,17.7,33,23,21,10,2,17,30,56.7,13,22,7,15,26,59,45,0,Matches
1461,Pau López,ESP,GK,Espanyol,La Liga,22,1994,28.5,0,0,0,0,0,0,0,,0,0,0,0,1,1,15,2,Matches
1462,Pedro López,ESP,GK,Betis,La Liga,22,1995,4.6,0,0,0,0,0,0,0,,0,1,0,1,0,0,3,0,Matches
1463,Víctor López,ESP,MF,Alavés,La Liga,20,1997,0.7,2,1,0,2,0,0,1,0.0,1,0,0,0,1,3,1,0,Matches
1464,Jonas Lössl,DEN,GK,Huddersfield,Premier League,28,1989,38.0,1,0,1,0,0,1,5,20.0,4,0,0,0,4,5,13,6,Matches
1465,Dejan Lovren,CRO,DF,Liverpool,Premier League,28,1989,23.6,26,17,14,11,1,12,22,54.5,10,26,15,11,38,64,146,2,Matches
1466,Chris Löwe,GER,DF,Huddersfield,Premier League,28,1989,17.6,43,29,26,15,2,20,44,45.5,24,21,8,13,34,77,65,3,Matches
1467,Matthew Lowton,ENG,DF,Burnley,Premier League,28,1989,25.5,55,34,26,27,2,28,60,46.7,32,35,15,20,39,94,141,2,Matches
1468,Anthony Lozano,HON,"FW,MF",Girona,La Liga,24,1993,5.2,9,5,2,7,0,1,5,20.0,4,3,0,3,3,12,2,0,Matches
1469,Fabio Lucioni,ITA,DF,Benevento,Serie A,29,1987,8.0,11,9,7,4,0,7,11,63.6,4,14,11,3,7,18,61,0,Matches
1470,Filipe Luís,BRA,DF,Atlético Madrid,La Liga,31,1985,18.4,83,52,41,33,9,36,49,73.5,13,27,7,20,35,118,34,0,Matches
1471,José Luis Gayà,ESP,DF,Valencia,La Liga,22,1995,32.4,77,60,52,22,3,43,68,63.2,25,43,12,31,56,133,90,1,Matches
1472,José Luis Morales,ESP,"MF,FW",Levante,La Liga,30,1987,34.0,37,23,15,15,7,13,65,20.0,52,28,0,28,26,63,20,0,Matches
1473,José Luis Palomino,ARG,DF,Atalanta,Serie A,27,1990,22.0,60,39,36,19,5,24,51,47.1,27,36,21,15,39,99,111,1,Matches
1474,Luisinho,POR,DF,La Coruña,La Liga,32,1985,29.1,111,77,64,40,7,65,96,67.7,31,24,4,20,55,166,113,0,Matches
1475,David Luiz,BRA,"DF,MF",Chelsea,Premier League,30,1987,9.3,18,11,13,4,1,11,21,52.4,10,9,5,4,24,42,45,2,Matches
1476,Douglas Luiz,BRA,"MF,FW",Girona,La Liga,19,1998,3.4,10,9,4,6,0,3,11,27.3,8,1,0,1,4,14,0,0,Matches
1477,Everton Luiz,BRA,MF,SPAL,Serie A,29,1988,7.1,22,16,10,10,2,6,29,20.7,23,8,1,7,10,32,8,1,Matches
1478,Jordan Lukaku,BEL,DF,Lazio,Serie A,23,1994,15.1,28,15,14,11,3,10,16,62.5,6,14,2,12,15,43,23,0,Matches
1479,Romelu Lukaku,BEL,FW,Manchester Utd,Premier League,24,1993,31.9,7,4,1,3,3,0,13,0.0,13,9,2,7,3,10,22,2,Matches
1480,Lars Lukas Mai,GER,DF,Bayern Munich,Bundesliga,17,2000,2.0,4,4,4,0,0,3,4,75.0,1,3,2,1,3,7,3,0,Matches
1481,Dodi Lukebakio,BEL,"MF,FW",Watford,Premier League,19,1997,0.2,1,0,1,0,0,0,0,,0,0,0,0,0,1,0,0,Matches
1482,Saša Lukić,SRB,MF,Levante,La Liga,20,1996,11.0,21,16,9,8,4,5,16,31.3,11,14,6,8,17,38,13,0,Matches
1483,Senad Lulić,BIH,"DF,MF",Lazio,Serie A,31,1986,27.0,66,40,32,22,12,21,80,26.3,59,32,4,28,36,102,39,0,Matches
1484,Levi Lumeka,ENG,FW,Crystal Palace,Premier League,18,1998,0.3,1,1,1,0,0,0,0,,0,0,0,0,1,2,0,0,Matches
1485,Antonio Luna,ESP,DF,Levante,La Liga,26,1991,22.5,39,26,23,13,3,24,41,58.5,17,26,9,17,36,75,68,0,Matches
1486,Arnaud Lusamba,COD,MF,Nice,Ligue 1,20,1997,1.8,12,9,4,6,2,3,7,42.9,4,5,0,5,1,13,1,0,Matches
1487,Fabian Lustenberger,SUI,"MF,DF",Hertha BSC,Bundesliga,29,1988,17.6,47,34,26,20,1,21,31,67.7,10,31,12,19,24,71,74,1,Matches
1488,Andreas Luthe,GER,GK,Augsburg,Bundesliga,30,1987,2.0,0,0,0,0,0,0,0,,0,0,0,0,0,0,2,0,Matches
1489,Lyanco,BRA,DF,Torino,Serie A,20,1997,3.5,11,8,8,3,0,5,8,62.5,3,4,3,1,5,16,17,0,Matches
1490,Charalambos Lykogiannis,GRE,DF,Cagliari,Serie A,23,1993,7.6,16,12,9,5,2,11,18,61.1,7,12,3,9,15,31,28,0,Matches
1491,Cheikh M'Bengue,SEN,DF,Saint-Étienne,Ligue 1,29,1988,5.4,8,4,8,0,0,4,4,100.0,0,6,4,2,8,16,22,1,Matches
1492,Raïs M'Bolhi,ALG,GK,Rennes,Ligue 1,31,1986,1.0,0,0,0,0,0,0,1,0.0,1,0,0,0,0,0,0,0,Matches
1493,Yann M'Vila,FRA,MF,Saint-Étienne,Ligue 1,27,1990,16.4,26,16,11,12,3,7,24,29.2,17,13,1,12,31,57,56,0,Matches
1494,Zinédine Machach,FRA,"FW,MF",Toulouse,Ligue 1,21,1996,2.1,7,3,5,1,1,4,5,80.0,1,1,0,1,2,9,2,0,Matches
1495,Pablo Maffeo,ESP,DF,Girona,La Liga,20,1997,29.4,74,55,39,23,12,25,49,51.0,24,28,7,21,50,124,82,0,Matches
1496,Gabriel Magalhães,BRA,DF,Troyes,Ligue 1,19,1997,0.9,1,1,1,0,0,0,1,0.0,1,2,1,1,0,1,4,1,Matches
1497,Christian Maggio,ITA,DF,Napoli,Serie A,35,1982,7.1,17,10,9,6,2,7,19,36.8,12,15,4,11,13,30,21,0,Matches
1498,Francesco Magnanelli,ITA,MF,Sassuolo,Serie A,32,1984,27.7,56,38,30,20,6,20,65,30.8,45,26,7,19,58,114,78,2,Matches
1499,Harry Maguire,ENG,DF,Leicester City,Premier League,24,1993,38.0,63,46,47,15,1,26,43,60.5,17,35,28,7,48,111,181,1,Matches
1500,Hicham Mahou,FRA,"MF,FW",Nice,Ligue 1,18,1999,0.6,1,1,1,0,0,1,3,33.3,2,0,0,0,3,4,0,0,Matches
1501,Riyad Mahrez,ALG,"MF,FW",Leicester City,Premier League,26,1991,32.8,39,27,16,17,6,10,63,15.9,53,32,1,31,18,57,15,0,Matches
1502,Thiago Maia,BRA,"MF,DF",Lille,Ligue 1,20,1997,27.4,55,40,26,26,3,15,61,24.6,46,32,10,22,61,116,47,1,Matches
1503,Arne Maier,GER,MF,Hertha BSC,Bundesliga,18,1999,13.6,29,23,12,16,1,18,24,75.0,6,19,3,16,24,53,20,0,Matches
1504,Sebastian Maier,GER,MF,Hannover 96,Bundesliga,23,1993,2.9,11,6,4,7,0,2,12,16.7,10,6,1,5,4,15,1,1,Matches
1505,Domenico Maietta,ITA,DF,Bologna,Serie A,34,1982,5.2,5,4,4,1,0,3,9,33.3,6,8,6,2,7,12,13,1,Matches
1506,Habib Maïga,CIV,"MF,DF",Saint-Étienne,Ligue 1,21,1996,7.9,29,18,16,10,3,12,30,40.0,18,8,4,4,19,48,10,0,Matches
1507,Mike Maignan,FRA,GK,Lille,Ligue 1,22,1995,33.7,1,1,1,0,0,1,1,100.0,0,0,0,0,0,1,8,6,Matches
1508,Linton Maina,GER,MF,Hannover 96,Bundesliga,18,1999,0.1,1,1,0,0,1,0,0,,0,0,0,0,1,2,0,0,Matches
1509,Ainsley Maitland-Niles,ENG,"DF,MF",Arsenal,Premier League,19,1997,10.2,25,17,12,7,6,14,31,45.2,17,15,1,14,12,37,35,2,Matches
1510,Jean-Victor Makengo,FRA,"FW,MF",Nice,Ligue 1,19,1998,2.7,4,2,2,2,0,1,2,50.0,1,1,0,1,3,7,1,1,Matches
1511,Nemanja Maksimović,SRB,MF,Valencia,La Liga,22,1995,6.2,21,13,10,8,3,8,16,50.0,8,15,6,9,16,37,8,0,Matches
1512,Nikola Maksimović,SRB,DF,Napoli,Serie A,25,1991,1.1,1,1,0,1,0,1,1,100.0,0,1,0,1,0,1,5,0,Matches
1513,Malcom,BRA,FW,Bordeaux,Ligue 1,20,1997,31.7,15,10,3,7,5,1,28,3.6,27,13,1,12,14,29,6,0,Matches
1514,Kévin Malcuit,MAR,DF,Lille,Ligue 1,26,1991,20.2,51,37,31,16,4,17,25,68.0,8,13,5,8,38,89,47,0,Matches
1515,Yunus Mallı,TUR,"FW,MF",Wolfsburg,Bundesliga,25,1992,24.9,25,17,8,14,3,12,25,48.0,13,23,0,23,12,37,17,0,Matches
1516,Hugo Mallo,ESP,DF,Celta Vigo,La Liga,26,1991,33.3,84,55,55,26,3,35,53,66.0,18,30,15,15,68,152,111,1,Matches
1517,Scott Malone,ENG,DF,Huddersfield,Premier League,26,1991,12.4,39,29,27,10,2,17,24,70.8,7,12,2,10,26,65,43,2,Matches
1518,Vincent Manceau,FRA,DF,Angers,Ligue 1,28,1989,33.0,84,49,56,22,6,42,76,55.3,34,34,2,32,34,118,103,0,Matches
1519,Gianluca Mancini,ITA,DF,Atalanta,Serie A,21,1996,7.6,20,14,11,8,1,10,17,58.8,7,8,2,6,15,35,22,0,Matches
1520,Steve Mandanda,FRA,GK,Marseille,Ligue 1,32,1985,30.0,0,0,0,0,0,0,0,,0,0,0,0,0,0,10,3,Matches
1521,Aïssa Mandi,ALG,DF,Betis,La Liga,25,1991,33.6,54,35,27,25,2,19,34,55.9,15,39,24,15,71,125,133,3,Matches
1522,Georges Mandjeck,CMR,"MF,DF",Metz,Ligue 1,28,1988,10.8,25,14,8,16,1,8,18,44.4,10,9,3,6,18,43,21,1,Matches
1523,Rolando Mandragora,ITA,MF,Crotone,Serie A,20,1997,36.0,91,60,48,34,9,26,69,37.7,43,41,13,28,86,177,75,0,Matches
1524,Mario Mandžukić,CRO,FW,Juventus,Serie A,31,1986,25.8,36,23,13,11,12,8,29,27.6,21,20,3,17,25,61,42,2,Matches
1525,Sadio Mané,SEN,FW,Liverpool,Premier League,25,1992,24.3,28,20,8,11,9,3,23,13.0,20,20,0,20,9,37,8,0,Matches
1526,Eliaquim Mangala,FRA,DF,Everton,Premier League,26,1991,1.5,2,1,1,1,0,0,0,,0,0,0,0,1,3,4,1,Matches
1527,Eliaquim Mangala,FRA,DF,Manchester City,Premier League,26,1991,5.4,5,3,5,0,0,1,3,33.3,2,4,3,1,2,7,24,0,Matches
1528,Orel Mangala,BEL,MF,Stuttgart,Bundesliga,19,1998,8.7,28,18,7,19,2,11,21,52.4,10,8,2,6,18,46,15,0,Matches
1529,Kader Mangane,SEN,DF,Strasbourg,Ligue 1,34,1983,19.1,37,24,29,8,0,11,21,52.4,10,28,18,10,24,61,120,4,Matches
1530,Thomas Mangani,FRA,MF,Angers,Ligue 1,30,1987,33.6,92,59,35,46,11,28,120,23.3,92,40,5,35,40,132,45,1,Matches
1531,Kostas Manolas,GRE,DF,Roma,Serie A,26,1991,26.0,23,20,14,7,2,9,15,60.0,6,31,24,7,46,69,133,2,Matches
1532,Javier Manquillo,ESP,DF,Newcastle Utd,Premier League,23,1994,19.5,36,22,25,8,3,15,30,50.0,15,25,6,19,18,54,65,0,Matches
1533,Martín Mantovani,ARG,DF,Leganés,La Liga,33,1984,11.4,12,5,10,2,0,7,10,70.0,3,10,6,4,22,34,67,0,Matches
1534,José Manuel Jurado,ESP,"MF,FW",Espanyol,La Liga,31,1986,16.7,18,14,8,8,2,5,14,35.7,9,13,1,12,16,34,5,0,Matches
1535,Harrison Manzala,COD,"FW,MF",Amiens,Ligue 1,23,1994,20.7,32,23,16,9,7,8,25,32.0,17,22,3,19,18,50,15,0,Matches
1536,Myziane Maolida,COM,"FW,MF",Lyon,Ligue 1,18,1999,3.7,5,5,3,2,0,0,2,0.0,2,1,0,1,0,5,0,0,Matches
1537,Faitout Maouassa,FRA,"MF,FW",Rennes,Ligue 1,19,1998,9.9,6,3,2,3,1,2,10,20.0,8,12,2,10,6,12,5,0,Matches
1538,Fernando Marçal,BRA,DF,Lyon,Ligue 1,28,1989,14.4,34,20,22,8,4,14,29,48.3,15,14,6,8,26,60,69,0,Matches
1539,Vincent Marcel,FRA,"MF,FW",Nice,Ligue 1,20,1997,0.5,1,1,0,1,0,0,1,0.0,1,1,0,1,0,1,0,0,Matches
1540,Marcelo,BRA,DF,Real Madrid,La Liga,29,1988,25.1,53,37,19,23,11,22,58,37.9,36,26,2,24,30,83,23,2,Matches
1541,Marcelo,BRA,DF,Lyon,Ligue 1,30,1987,34.5,27,25,16,10,1,9,25,36.0,16,32,18,14,57,84,235,4,Matches
1542,Solly March,ENG,"MF,FW",Brighton,Premier League,23,1994,20.6,54,41,34,14,6,22,54,40.7,32,27,3,24,13,67,49,0,Matches
1543,Gabriele Marchegiani,ITA,GK,SPAL,Serie A,21,1996,0.0,0,0,0,0,0,0,0,,0,0,0,0,0,0,0,0,Matches
1544,Claudio Marchisio,ITA,MF,Juventus,Serie A,31,1986,9.1,17,10,9,5,3,6,21,28.6,15,7,2,5,4,21,7,0,Matches
1545,Gian Marco Ferrari,ITA,DF,Sampdoria,Serie A,25,1992,29.4,12,8,8,4,0,5,10,50.0,5,42,38,4,31,43,149,4,Matches
1546,Óscar de Marcos,ESP,"DF,FW",Athletic Club,La Liga,28,1989,18.4,28,21,11,15,2,13,29,44.8,16,15,2,13,19,47,36,0,Matches
1547,José María Giménez,URU,DF,Atlético Madrid,La Liga,22,1995,18.8,38,27,29,6,3,23,35,65.7,12,28,15,13,30,68,101,1,Matches
1548,Mariano,DOM,FW,Lyon,Ligue 1,23,1993,27.9,16,11,0,5,11,2,23,8.7,21,9,1,8,3,19,20,0,Matches
1549,Adrian Mariappa,JAM,DF,Watford,Premier League,30,1986,24.6,45,26,33,12,0,14,34,41.2,20,25,16,9,45,90,133,4,Matches
1550,Jordan Marié,FRA,MF,Dijon,Ligue 1,25,1991,20.9,63,38,22,36,5,18,66,27.3,48,26,9,17,40,103,25,2,Matches
1551,Adrián Marín,ESP,DF,Villarreal,La Liga,20,1997,2.6,6,4,3,3,0,2,8,25.0,6,2,0,2,3,9,8,0,Matches
1552,João Mário,POR,MF,West Ham,Premier League,24,1993,11.4,14,11,6,5,3,6,19,31.6,13,7,0,7,8,22,4,1,Matches
1553,João Mário,POR,"MF,FW",Inter,Serie A,24,1993,6.2,8,4,3,3,2,2,8,25.0,6,6,1,5,4,12,5,0,Matches
1554,Guillermo Maripán,CHI,DF,Alavés,La Liga,23,1994,17.0,28,16,24,4,0,17,32,53.1,15,19,10,9,36,64,108,0,Matches
1555,Marlon,BRA,DF,Nice,Ligue 1,21,1995,21.4,36,26,22,13,1,15,22,68.2,7,19,15,4,15,51,72,2,Matches
1556,Dominic Maroh,SVN,DF,Köln,Bundesliga,30,1987,10.2,22,15,18,4,0,15,18,83.3,3,17,9,8,21,43,68,1,Matches
1557,Marquinhos,BRA,DF,Paris S-G,Ligue 1,23,1994,25.1,28,14,14,14,0,13,21,61.9,8,36,22,14,14,42,114,2,Matches
1558,Bruno Martella,ITA,DF,Crotone,Serie A,24,1992,29.1,30,21,19,7,4,12,30,40.0,18,22,9,13,48,78,151,1,Matches
1559,Roger Martí,ESP,FW,Levante,La Liga,26,1991,10.7,8,4,2,5,1,2,13,15.4,11,11,0,11,1,9,5,0,Matches
1560,Anthony Martial,FRA,FW,Manchester Utd,Premier League,21,1995,17.6,15,13,9,2,4,3,12,25.0,9,5,1,4,3,18,7,0,Matches
1561,Aarón Martín,ESP,DF,Espanyol,La Liga,20,1997,31.3,56,36,41,12,3,31,59,52.5,28,26,5,21,49,105,78,0,Matches
1562,Jonas Martin,FRA,MF,Strasbourg,Ligue 1,27,1990,33.6,73,50,41,28,4,17,54,31.5,37,30,3,27,33,106,36,0,Matches
1563,Cuco Martina,CUW,DF,Everton,Premier League,27,1989,20.3,61,35,38,15,8,27,46,58.7,19,17,4,13,42,103,130,2,Matches
1564,Carlos Martínez,ESP,DF,Real Sociedad,La Liga,31,1986,0.0,0,0,0,0,0,0,0,,0,0,0,0,0,0,0,0,Matches
1565,Emiliano Martínez,ARG,GK,Getafe,La Liga,24,1992,5.0,0,0,0,0,0,0,0,,0,0,0,0,0,0,3,0,Matches
1566,Iñigo Martínez,ESP,DF,Athletic Club,La Liga,26,1991,16.0,28,20,20,8,0,18,29,62.1,11,17,8,9,30,58,82,0,Matches
1567,Iñigo Martínez,ESP,DF,Real Sociedad,La Liga,26,1991,11.7,14,9,9,4,1,5,11,45.5,6,9,4,5,23,37,55,0,Matches
1568,Javi Martínez,ESP,"MF,DF",Bayern Munich,Bundesliga,28,1988,17.9,31,22,11,15,5,9,19,47.4,10,16,5,11,33,64,40,1,Matches
1569,Pablo Martinez,FRA,DF,Strasbourg,Ligue 1,28,1989,23.5,41,34,28,12,1,22,49,44.9,27,25,12,13,51,92,112,3,Matches
1570,Roger Martínez,COL,FW,Villarreal,La Liga,23,1994,2.6,1,1,0,1,0,0,2,0.0,2,2,0,2,0,1,1,0,Matches
1571,Christopher Martins,LUX,MF,Lyon,Ligue 1,20,1997,0.8,3,2,0,3,0,1,2,50.0,1,0,0,0,1,4,0,0,Matches
1572,Bruno Martins Indi,NED,DF,Stoke City,Premier League,25,1992,13.8,21,12,18,3,0,10,19,52.6,9,16,11,5,21,42,77,1,Matches
1573,Jonathan Martins Pereira,FRA,DF,Guingamp,Ligue 1,31,1986,12.6,34,18,21,10,3,8,23,34.8,15,9,3,6,37,71,39,1,Matches
1574,Adam Marušić,MNE,DF,Lazio,Serie A,24,1992,28.0,28,21,17,8,3,12,28,42.9,16,22,2,20,31,59,33,0,Matches
1575,Omar Mascarell,EQG,MF,Eint Frankfurt,Bundesliga,24,1993,8.6,20,16,8,12,0,10,18,55.6,8,14,1,13,21,41,10,0,Matches
1576,Javier Mascherano,ARG,DF,Barcelona,La Liga,33,1984,6.0,15,13,9,6,0,8,9,88.9,1,14,8,6,8,23,20,0,Matches
1577,Andrea Masiello,ITA,DF,Atalanta,Serie A,31,1986,30.1,58,38,34,20,4,30,54,55.6,24,24,6,18,72,130,137,0,Matches
1578,Adam Masina,MAR,DF,Bologna,Serie A,23,1994,31.4,82,57,49,26,7,36,84,42.9,48,46,7,39,51,133,127,0,Matches
1579,Eden Massouema,CGO,"MF,FW",Dijon,Ligue 1,20,1997,2.1,2,1,2,0,0,2,2,100.0,0,3,0,3,5,7,2,0,Matches
1580,Arthur Masuaku,COD,DF,West Ham,Premier League,23,1993,20.8,58,37,36,16,6,25,58,43.1,33,25,2,23,26,84,38,1,Matches
1581,Juan Mata,ESP,FW,Manchester Utd,Premier League,29,1988,21.4,18,13,4,12,2,2,24,8.3,22,10,0,10,15,33,10,1,Matches
1582,Christian Mathenia,GER,GK,Hamburger SV,Bundesliga,25,1992,24.0,0,0,0,0,0,0,3,0.0,3,0,0,0,0,0,11,3,Matches
1583,Nemanja Matić,SRB,MF,Manchester Utd,Premier League,28,1988,34.6,70,42,32,34,4,23,71,32.4,48,50,13,37,64,134,62,2,Matches
1584,Joël Matip,CMR,DF,Liverpool,Premier League,25,1991,22.2,35,24,23,11,1,12,24,50.0,12,26,15,11,35,70,101,1,Matches
1585,Ryder Matos,BRA,MF,Udinese,Serie A,24,1993,1.9,3,1,1,1,1,1,1,100.0,0,2,0,2,2,5,3,0,Matches
1586,Ryder Matos,BRA,"FW,MF",Hellas Verona,Serie A,24,1993,10.9,18,15,11,5,2,4,9,44.4,5,5,0,5,3,21,9,1,Matches
1587,Alessandro Matri,ITA,FW,Sassuolo,Serie A,32,1984,10.2,2,1,1,1,0,0,3,0.0,3,1,0,1,0,2,5,0,Matches
1588,Ville Matti Steinmann,GER,MF,Hamburger SV,Bundesliga,22,1995,6.6,16,10,6,8,2,8,17,47.1,9,6,1,5,18,34,9,1,Matches
1589,Federico Mattiello,ITA,DF,SPAL,Serie A,22,1995,24.5,59,40,31,22,6,21,44,47.7,23,53,15,38,64,123,66,0,Matches
1590,Blaise Matuidi,FRA,MF,Juventus,Serie A,30,1987,26.2,49,35,14,25,10,10,35,28.6,25,28,4,24,32,81,22,1,Matches
1591,Blaise Matuidi,FRA,MF,Paris S-G,Ligue 1,30,1987,0.3,1,1,1,0,0,0,0,,0,2,1,1,0,1,0,0,Matches
1592,José Mauri,ITA,MF,Milan,Serie A,21,1996,0.1,0,0,0,0,0,0,0,,0,0,0,0,0,0,0,0,Matches
1593,Maurício,BRA,DF,Lazio,Serie A,28,1988,0.1,0,0,0,0,0,0,0,,0,0,0,0,0,0,0,0,Matches
1594,Mërgim Mavraj,ALB,DF,Hamburger SV,Bundesliga,31,1986,16.1,45,32,32,11,2,22,37,59.5,15,28,12,16,21,66,91,3,Matches
1595,Konstantinos Mavropanos,GRE,DF,Arsenal,Premier League,19,1997,2.2,1,1,1,0,0,1,2,50.0,1,4,3,1,6,7,11,1,Matches
1596,Alfie Mawson,ENG,DF,Swansea City,Premier League,23,1994,38.0,32,22,24,8,0,16,27,59.3,11,41,32,9,35,67,229,5,Matches
1597,Philipp Max,GER,DF,Augsburg,Bundesliga,23,1993,32.9,65,47,36,19,10,34,59,57.6,25,27,8,19,33,98,65,1,Matches
1598,Alexandru Maxim,ROU,MF,Mainz 05,Bundesliga,27,1990,10.6,17,12,6,8,3,7,22,31.8,15,20,2,18,6,23,3,0,Matches
1599,Eric Maxim Choupo-Moting,CMR,"FW,MF",Stoke City,Premier League,28,1989,25.7,42,30,21,16,5,9,32,28.1,23,31,3,28,23,65,29,1,Matches
1600,Florian Mayer,GER,DF,Gladbach,Bundesliga,19,1998,0.2,1,1,1,0,0,1,1,100.0,0,0,0,0,0,1,1,0,Matches
1601,Borja Mayoral,ESP,"FW,MF",Real Madrid,La Liga,20,1997,3.8,6,3,0,4,2,1,5,20.0,4,3,0,3,0,6,0,0,Matches
1602,Róbert Mazáň,SVK,DF,Celta Vigo,La Liga,23,1994,0.9,0,0,0,0,0,0,1,0.0,1,1,0,1,2,2,0,0,Matches
1603,Luca Mazzitelli,ITA,MF,Sassuolo,Serie A,21,1995,11.3,37,24,14,15,8,10,36,27.8,26,21,2,19,21,58,19,0,Matches
1604,Kylian Mbappé,FRA,"FW,MF",Monaco,Ligue 1,18,1998,0.8,1,1,0,1,0,0,0,,0,0,0,0,1,2,0,0,Matches
1605,Kylian Mbappé,FRA,FW,Paris S-G,Ligue 1,18,1998,23.3,11,8,3,3,5,1,13,7.7,12,4,1,3,0,11,1,0,Matches
1606,Ibrahima Mbaye,SEN,DF,Bologna,Serie A,22,1994,19.6,59,34,40,17,2,25,36,69.4,11,25,6,19,28,87,95,0,Matches
1607,Chancel Mbemba,COD,DF,Newcastle Utd,Premier League,22,1994,7.5,16,12,13,3,0,10,17,58.8,7,7,3,4,15,31,44,1,Matches
1608,Adama Mbengue,SEN,DF,Caen,Ligue 1,23,1993,17.7,71,48,48,18,5,41,65,63.1,24,21,1,20,28,99,50,0,Matches
1609,Isaac Mbenza,BEL,"FW,MF",Montpellier,Ligue 1,21,1996,23.3,16,11,4,8,4,6,16,37.5,10,8,1,7,4,20,5,0,Matches
1610,Bryan Mbeumo,CMR,"FW,MF",Troyes,Ligue 1,17,1999,0.7,0,0,0,0,0,0,3,0.0,3,2,0,2,0,0,2,0,Matches
1611,Jordi Mboula,ESP,MF,Monaco,Ligue 1,18,1999,0.3,0,0,0,0,0,0,0,,0,2,0,2,0,0,2,0,Matches
1612,James McArthur,SCO,MF,Crystal Palace,Premier League,29,1987,27.0,58,44,28,27,3,23,61,37.7,38,39,2,37,36,94,44,2,Matches
1613,Gareth McAuley,NIR,DF,West Brom,Premier League,37,1979,5.1,8,7,6,2,0,3,7,42.9,4,7,4,3,11,19,16,0,Matches
1614,Oliver McBurnie,SCO,"FW,MF",Swansea City,Premier League,21,1996,3.1,4,3,0,2,2,1,3,33.3,2,2,0,2,0,4,3,0,Matches
1615,Alex McCarthy,ENG,GK,Southampton,Premier League,27,1989,18.0,0,0,0,0,0,0,0,,0,0,0,0,1,1,8,0,Matches
1616,James McCarthy,IRL,MF,Everton,Premier League,26,1990,2.3,9,9,3,4,2,1,5,20.0,4,9,2,7,5,14,3,1,Matches
1617,James McClean,IRL,"MF,FW",West Brom,Premier League,28,1989,15.6,40,28,23,14,3,10,55,18.2,45,18,4,14,20,60,22,0,Matches
1618,Weston McKennie,USA,MF,Schalke 04,Bundesliga,18,1998,14.0,36,23,11,21,4,13,32,40.6,19,16,2,14,20,56,32,0,Matches
1619,Sam McQueen,ENG,"DF,MF",Southampton,Premier League,22,1995,1.6,4,4,4,0,0,2,4,50.0,2,2,1,1,3,7,3,0,Matches
1620,Scott McTominay,SCO,MF,Manchester Utd,Premier League,20,1996,7.0,11,9,4,5,2,5,13,38.5,8,3,0,3,13,24,9,0,Matches
1621,Iuri Medeiros,POR,"FW,MF",Genoa,Serie A,23,1994,7.1,6,4,3,2,1,4,8,50.0,4,3,1,2,2,8,3,0,Matches
1622,Slobodan Medojević,SRB,MF,Eint Frankfurt,Bundesliga,26,1990,0.3,0,0,0,0,0,0,0,,0,0,0,0,0,0,1,0,Matches
1623,Álvaro Medrán,ESP,MF,Alavés,La Liga,23,1994,10.5,20,14,5,10,5,8,21,38.1,13,7,0,7,13,33,10,0,Matches
1624,Álvaro Medrán,ESP,MF,Valencia,La Liga,23,1994,0.8,1,1,1,0,0,1,2,50.0,1,0,0,0,3,4,1,0,Matches
1625,Ben Mee,ENG,DF,Burnley,Premier League,27,1989,29.0,33,20,22,11,0,16,29,55.2,13,51,42,9,33,66,217,1,Matches
1626,Riccardo Meggiorini,ITA,FW,Chievo,Serie A,31,1985,8.7,9,6,3,6,0,1,6,16.7,5,12,3,9,2,11,9,0,Matches
1627,Admir Mehmedi,SUI,"FW,MF",Wolfsburg,Bundesliga,26,1991,3.2,4,2,3,1,0,2,2,100.0,0,1,1,0,1,5,3,0,Matches
1628,Admir Mehmedi,SUI,"DF,MF",Leverkusen,Bundesliga,26,1991,7.8,20,18,6,11,3,4,13,30.8,9,13,0,13,13,33,5,0,Matches
1629,Alexander Meier,GER,FW,Eint Frankfurt,Bundesliga,34,1983,0.0,0,0,0,0,0,0,0,,0,0,0,0,0,0,0,0,Matches
1630,Soualiho Meïté,FRA,MF,Bordeaux,Ligue 1,23,1994,14.8,25,13,4,19,2,9,32,28.1,23,22,6,16,23,48,13,1,Matches
1631,Soualiho Meïté,FRA,MF,Monaco,Ligue 1,23,1994,1.1,2,1,1,1,0,2,5,40.0,3,1,0,1,3,5,3,0,Matches
1632,Óscar Melendo,ESP,"MF,FW",Espanyol,La Liga,19,1997,7.6,2,2,2,0,0,0,5,0.0,5,2,0,2,3,5,3,0,Matches
1633,Memphis,NED,FW,Lyon,Ligue 1,23,1994,28.4,13,9,4,3,6,3,28,10.7,25,15,0,15,9,22,5,0,Matches
1634,Ledian Memushaj,ALB,MF,Benevento,Serie A,30,1986,14.0,28,18,11,13,4,7,30,23.3,23,24,5,19,10,38,10,1,Matches
1635,Pedro Mendes,POR,DF,Montpellier,Ligue 1,26,1990,31.7,62,50,37,19,6,23,41,56.1,18,36,25,11,44,106,152,0,Matches
1636,Thiago Mendes,BRA,MF,Lille,Ligue 1,25,1992,25.5,25,16,10,11,4,5,23,21.7,18,21,3,18,25,50,29,0,Matches
1637,Brais Méndez,ESP,"MF,FW",Celta Vigo,La Liga,20,1997,10.5,19,15,9,6,4,7,17,41.2,10,13,0,13,4,23,12,0,Matches
1638,Stiven Mendoza,COL,"FW,MF",Amiens,Ligue 1,25,1992,11.5,18,10,7,7,4,2,11,18.2,9,11,1,10,15,33,8,0,Matches
1639,Alexandre Mendy,GNB,FW,Bordeaux,Ligue 1,23,1994,8.8,4,4,1,2,1,1,6,16.7,5,5,1,4,1,5,4,0,Matches
1640,Benjamin Mendy,FRA,"DF,FW",Manchester City,Premier League,23,1994,4.0,5,4,2,0,3,5,7,71.4,2,5,0,5,8,13,9,0,Matches
1641,Ferland Mendy,FRA,DF,Lyon,Ligue 1,22,1995,23.6,45,28,29,13,3,20,31,64.5,11,18,5,13,25,70,43,0,Matches
1642,Nampalys Mendy,SEN,MF,Nice,Ligue 1,25,1992,10.7,13,6,8,5,0,5,17,29.4,12,9,1,8,13,26,10,1,Matches
1643,Hamza Mendyl,MAR,"DF,MF",Lille,Ligue 1,19,1997,9.5,18,10,12,6,0,11,20,55.0,9,5,0,5,17,35,26,0,Matches
1644,Gabriel Mercado,ARG,DF,Sevilla,La Liga,30,1987,23.5,55,37,35,18,2,36,67,53.7,31,32,20,12,42,97,83,1,Matches
1645,Jorge Meré,ESP,DF,Köln,Bundesliga,20,1997,21.0,34,23,25,9,0,23,35,65.7,12,25,13,12,34,68,110,1,Matches
1646,Alex Meret,ITA,GK,SPAL,Serie A,20,1997,12.9,0,0,0,0,0,0,1,0.0,1,0,0,0,0,0,5,0,Matches
1647,Mikel Merino,ESP,MF,Newcastle Utd,Premier League,21,1996,15.0,56,40,21,32,3,17,56,30.4,39,36,8,28,34,90,25,0,Matches
1648,Sabin Merino,ESP,"FW,MF",Athletic Club,La Liga,25,1992,4.2,7,3,2,3,2,3,8,37.5,5,6,2,4,1,8,10,0,Matches
1649,Dries Mertens,BEL,FW,Napoli,Serie A,30,1987,33.4,28,22,5,13,10,5,36,13.9,31,18,2,16,5,33,8,1,Matches
1650,Per Mertesacker,GER,DF,Arsenal,Premier League,32,1984,4.1,2,2,0,2,0,0,1,0.0,1,4,3,1,6,8,22,2,Matches
1651,Roque Mesa,ESP,MF,Swansea City,Premier League,28,1989,8.4,20,13,8,8,4,10,37,27.0,27,6,0,6,13,33,8,1,Matches
1652,Roque Mesa,ESP,MF,Sevilla,La Liga,28,1989,3.8,13,10,2,7,4,6,8,75.0,2,3,2,1,0,13,5,0,Matches
1653,Lionel Messi,ARG,FW,Barcelona,La Liga,30,1987,33.3,17,8,0,11,6,2,18,11.1,16,11,1,10,7,24,0,0,Matches
1654,Thomas Meunier,BEL,DF,Paris S-G,Ligue 1,25,1991,17.5,38,21,22,12,4,18,34,52.9,16,7,2,5,18,56,54,2,Matches
1655,Mexer,MOZ,DF,Rennes,Ligue 1,28,1988,13.3,15,12,9,6,0,9,12,75.0,3,13,7,6,16,31,98,2,Matches
1656,Max Meyer,GER,MF,Schalke 04,Bundesliga,21,1995,19.2,48,38,23,21,4,19,47,40.4,28,25,3,22,54,102,11,0,Matches
1657,Senna Miangue,BEL,"DF,FW",Cagliari,Serie A,20,1997,8.9,7,5,4,2,1,3,7,42.9,4,8,1,7,7,14,35,0,Matches
1658,Michel,BRA,DF,Las Palmas,La Liga,27,1990,23.7,33,24,21,8,4,14,25,56.0,11,21,11,10,39,72,64,1,Matches
1659,Mathieu Michel,FRA,GK,Angers,Ligue 1,25,1991,6.6,0,0,0,0,0,0,1,0.0,1,0,0,0,0,0,0,1,Matches
1660,Clément Michelin,FRA,DF,Toulouse,Ligue 1,20,1997,3.1,11,7,7,4,0,7,11,63.6,4,3,1,2,4,15,12,0,Matches
1661,Francesco Migliore,ITA,DF,Genoa,Serie A,29,1988,3.7,5,5,4,1,0,2,6,33.3,4,1,0,1,3,8,9,1,Matches
1662,Simon Mignolet,BEL,GK,Liverpool,Premier League,29,1988,19.0,2,1,2,0,0,1,3,33.3,2,0,0,0,0,2,5,3,Matches
1663,Nikola Milenković,SRB,DF,Fiorentina,Serie A,19,1997,13.9,39,25,20,16,3,16,29,55.2,13,18,8,10,23,62,70,0,Matches
1664,Danijel Milićević,BIH,"MF,FW",Metz,Ligue 1,31,1986,7.9,8,4,0,4,4,1,9,11.1,8,5,0,5,3,11,2,0,Matches
1665,Arkadiusz Milik,POL,"FW,MF",Napoli,Serie A,23,1994,5.0,2,1,0,1,1,0,1,0.0,1,5,0,5,1,3,4,0,Matches
1666,Sergej Milinković-Savić,SRB,MF,Lazio,Serie A,22,1995,31.6,55,39,11,34,10,13,52,25.0,39,29,6,23,33,88,36,1,Matches
1667,Vanja Milinković-Savić,SRB,GK,Torino,Serie A,20,1997,1.0,0,0,0,0,0,0,0,,0,0,0,0,0,0,0,0,Matches
1668,Luka Milivojević,SRB,MF,Crystal Palace,Premier League,26,1991,34.2,85,52,40,37,8,31,86,36.0,55,50,12,38,71,156,81,3,Matches
1669,James Milner,ENG,MF,Liverpool,Premier League,31,1986,19.7,58,45,18,32,8,15,39,38.5,24,33,5,28,21,79,23,0,Matches
1670,Santi Mina,ESP,FW,Valencia,La Liga,21,1995,17.3,17,9,4,9,4,4,22,18.2,18,14,1,13,2,19,19,0,Matches
1671,Yerry Mina,COL,DF,Barcelona,La Liga,22,1994,4.1,10,8,6,4,0,4,6,66.7,2,6,3,3,6,16,16,0,Matches
1672,Tyrone Mings,ENG,DF,Bournemouth,Premier League,24,1993,2.2,1,1,1,0,0,0,0,,0,2,2,0,6,7,13,1,Matches
1673,Ignasi Miquel,ESP,DF,Málaga,La Liga,24,1992,19.7,19,10,11,7,1,4,15,26.7,11,23,13,10,33,52,113,0,Matches
1674,Kevin Mirallas,BEL,"FW,MF",Everton,Premier League,29,1987,1.5,4,3,1,2,1,0,1,0.0,1,0,0,0,0,4,3,0,Matches
1675,Miranda,BRA,DF,Inter,Serie A,32,1984,30.3,48,37,38,10,0,22,25,88.0,3,30,23,7,38,86,131,2,Matches
1676,Antonio Mirante,ITA,GK,Bologna,Serie A,34,1983,33.0,0,0,0,0,0,0,3,0.0,3,1,0,1,0,0,11,5,Matches
1677,Simone Missiroli,ITA,MF,Sassuolo,Serie A,31,1986,32.4,62,37,25,31,6,14,72,19.4,58,46,8,38,67,129,70,0,Matches
1678,Kostas Mitroglou,GRE,FW,Marseille,Ligue 1,29,1988,9.7,3,2,1,2,0,1,4,25.0,3,1,1,0,0,3,2,0,Matches
1679,Aleksandar Mitrović,SRB,FW,Newcastle Utd,Premier League,22,1994,1.1,1,1,0,1,0,0,1,0.0,1,1,0,1,0,1,2,0,Matches
1680,Maximilian Mittelstädt,GER,"MF,DF",Hertha BSC,Bundesliga,20,1997,4.7,19,11,14,4,1,10,19,52.6,9,8,1,7,9,28,11,0,Matches
1681,Henrikh Mkhitaryan,ARM,"FW,MF",Arsenal,Premier League,28,1989,8.8,18,13,9,7,2,5,21,23.8,16,16,2,14,8,26,7,0,Matches
1682,Henrikh Mkhitaryan,ARM,"MF,FW",Manchester Utd,Premier League,28,1989,10.2,15,11,4,7,4,5,25,20.0,20,8,0,8,7,22,3,0,Matches
1683,Luka Modrić,CRO,MF,Real Madrid,La Liga,31,1985,21.9,33,22,14,15,4,15,41,36.6,26,13,4,9,31,64,7,0,Matches
1684,Niklas Moisander,FIN,DF,Werder Bremen,Bundesliga,31,1985,25.0,36,28,22,13,1,24,36,66.7,12,21,9,12,38,74,98,2,Matches
1685,Johan Mojica,COL,DF,Girona,La Liga,24,1992,23.7,42,27,31,8,3,21,37,56.8,16,24,3,21,32,74,42,2,Matches
1686,Jorge Molina,ESP,FW,Getafe,La Liga,35,1982,31.0,18,10,3,6,9,4,27,14.8,23,25,4,21,7,25,27,0,Matches
1687,Daniel Molina Orta,ESP,MF,Celta Vigo,La Liga,21,1996,0.1,0,0,0,0,0,0,0,,0,0,0,0,0,0,0,0,Matches
1688,Cristian Molinaro,ITA,DF,Torino,Serie A,34,1983,17.4,37,29,19,14,4,11,18,61.1,7,15,4,11,22,59,70,1,Matches
1689,Francisco Molinero,ESP,DF,Getafe,La Liga,32,1985,6.4,13,10,10,3,0,7,16,43.8,9,6,0,6,14,27,27,0,Matches
1690,Florent Mollet,FRA,"MF,FW",Metz,Ligue 1,25,1991,15.7,25,18,10,12,3,3,25,12.0,22,8,1,7,11,36,8,0,Matches
1691,Momo,ESP,"FW,MF",Las Palmas,La Liga,35,1982,7.5,14,8,8,3,3,4,13,30.8,9,5,0,5,5,19,1,0,Matches
1692,Thomas Monconduit,FRA,MF,Amiens,Ligue 1,26,1991,32.8,81,49,33,43,5,34,87,39.1,53,52,17,35,55,136,81,2,Matches
1693,Kévin Monnet-Paquet,FRA,"FW,MF",Saint-Étienne,Ligue 1,28,1988,19.6,33,25,9,19,5,11,48,22.9,37,15,2,13,13,46,23,1,Matches
1694,Nacho Monreal,ESP,DF,Arsenal,Premier League,31,1986,24.9,54,32,19,29,6,21,48,43.8,27,26,7,19,56,110,83,2,Matches
1695,Jefferson Montero,ECU,"MF,FW",Getafe,La Liga,27,1989,0.6,1,1,1,0,0,1,1,100.0,0,0,0,0,0,1,2,0,Matches
1696,Riccardo Montolivo,ITA,MF,Milan,Serie A,32,1985,12.1,29,21,11,15,3,7,24,29.2,17,17,4,13,19,48,15,0,Matches
1697,Martín Montoya,ESP,DF,Valencia,La Liga,26,1991,23.9,66,48,36,22,8,30,55,54.5,25,35,10,25,53,119,89,0,Matches
1698,Walter Montoya,ARG,FW,Sevilla,La Liga,24,1993,0.8,1,1,1,0,0,1,3,33.3,2,1,0,1,0,1,3,0,Matches
1699,Shaq Moore,USA,DF,Levante,La Liga,20,1996,4.7,8,6,3,3,2,3,7,42.9,4,4,0,4,13,21,11,0,Matches
1700,Aaron Mooy,AUS,MF,Huddersfield,Premier League,26,1990,34.1,102,60,39,51,12,23,55,41.8,32,39,5,34,38,140,52,0,Matches
1701,Emre Mor,TUR,"FW,MF",Celta Vigo,La Liga,20,1997,7.4,14,7,6,7,1,6,11,54.5,5,7,1,6,4,18,7,0,Matches
1702,Luca Mora,ITA,MF,SPAL,Serie A,29,1988,10.4,19,17,6,8,5,5,17,29.4,12,9,3,6,4,23,20,0,Matches
1703,Sergio Mora,ESP,MF,Getafe,La Liga,37,1979,9.0,21,15,8,12,1,14,31,45.2,17,10,2,8,15,36,11,0,Matches
1704,Erik Morán,ESP,MF,Leganés,La Liga,26,1991,2.5,2,2,1,0,1,0,3,0.0,3,1,1,0,4,6,0,0,Matches
1705,Álvaro Morata,ESP,FW,Chelsea,Premier League,24,1992,22.9,13,8,0,7,6,1,21,4.8,20,17,4,13,6,19,20,0,Matches
1706,Jan Morávek,CZE,MF,Augsburg,Bundesliga,27,1989,7.8,41,37,17,23,1,21,36,58.3,15,19,3,16,11,52,11,0,Matches
1707,Jérémy Morel,MAD,DF,Lyon,Ligue 1,33,1984,32.4,39,27,23,15,1,18,23,78.3,5,28,23,5,46,85,129,5,Matches
1708,Alberto Moreno,ESP,DF,Liverpool,Premier League,25,1992,14.1,35,26,21,12,2,13,29,44.8,16,19,2,17,12,47,44,0,Matches
1709,Gerard Moreno,ESP,FW,Espanyol,La Liga,25,1992,37.9,41,28,7,22,12,12,53,22.6,41,27,6,21,19,60,46,0,Matches
1710,Héctor Moreno,MEX,DF,Roma,Serie A,29,1988,2.6,2,2,1,1,0,0,1,0.0,1,1,1,0,3,5,5,0,Matches
1711,Héctor Moreno,MEX,DF,Real Sociedad,La Liga,29,1988,8.0,7,3,7,0,0,5,7,71.4,2,3,3,0,10,17,17,0,Matches
1712,Marlos Moreno,COL,"MF,DF",Girona,La Liga,20,1996,0.3,1,1,0,0,1,0,1,0.0,1,1,0,1,0,1,0,0,Matches
1713,Emiliano Moretti,ITA,DF,Torino,Serie A,36,1981,19.8,31,18,25,6,0,14,16,87.5,2,30,23,7,21,52,77,2,Matches
1714,Wes Morgan,JAM,DF,Leicester City,Premier League,33,1984,31.3,35,25,26,8,1,12,18,66.7,6,41,27,14,31,66,146,1,Matches
1715,Loren Morón,ESP,FW,Betis,La Liga,23,1993,11.8,14,8,4,5,5,4,17,23.5,13,14,1,13,1,15,12,0,Matches
1716,James Morrison,SCO,MF,West Brom,Premier League,31,1986,2.3,2,1,0,2,0,1,4,25.0,3,1,1,0,1,3,1,0,Matches
1717,Victor Moses,NGA,"DF,MF",Chelsea,Premier League,26,1990,23.4,37,29,21,13,3,14,24,58.3,10,29,4,25,15,52,39,2,Matches
1718,Pedro Mosquera,ESP,MF,La Coruña,La Liga,29,1988,15.5,48,31,15,29,4,13,38,34.2,25,26,6,20,23,71,38,0,Matches
1719,Lebo Mothiba,RSA,FW,Lille,Ligue 1,21,1996,13.2,8,5,4,0,4,0,7,0.0,7,6,2,4,2,10,11,0,Matches
1720,Thiago Motta,ITA,MF,Paris S-G,Ligue 1,34,1982,12.8,28,21,14,11,3,8,24,33.3,16,15,6,9,21,49,26,1,Matches
1721,François Moubandje,SUI,DF,Toulouse,Ligue 1,27,1990,18.9,28,15,20,7,1,10,34,29.4,24,23,7,16,27,55,75,0,Matches
1722,Jessy Moulin,FRA,GK,Saint-Étienne,Ligue 1,31,1986,3.4,0,0,0,0,0,0,0,,0,0,0,0,0,0,3,2,Matches
1723,Steve Mounié,BEN,FW,Huddersfield,Premier League,22,1994,20.6,11,8,2,4,5,0,19,0.0,19,23,3,20,7,18,30,0,Matches
1724,Lucas Moura,BRA,"FW,MF",Tottenham,Premier League,24,1992,2.3,4,2,3,0,1,1,3,33.3,2,2,0,2,2,6,2,0,Matches
1725,Lucas Moura,BRA,FW,Paris S-G,Ligue 1,24,1992,0.8,1,1,0,1,0,0,1,0.0,1,0,0,0,0,1,0,0,Matches
1726,Lys Mousset,FRA,"FW,MF",Bournemouth,Premier League,21,1996,6.6,9,5,6,3,0,0,8,0.0,8,5,2,3,3,12,9,0,Matches
1727,João Moutinho,POR,MF,Monaco,Ligue 1,30,1986,31.1,65,41,19,37,9,27,80,33.8,53,52,12,40,36,101,54,0,Matches
1728,Samuel Moutoussamy,COD,MF,Nantes,Ligue 1,20,1996,4.8,15,7,6,7,2,5,8,62.5,3,7,1,6,3,18,4,0,Matches
1729,Toni Moya,ESP,MF,Atlético Madrid,La Liga,19,1998,0.0,0,0,0,0,0,0,0,,0,0,0,0,0,0,0,0,Matches
1730,Ndombe Mubele,COD,"FW,MF",Toulouse,Ligue 1,23,1994,4.1,8,4,6,2,0,4,10,40.0,6,11,0,11,9,17,4,0,Matches
1731,Ndombe Mubele,COD,"FW,MF",Rennes,Ligue 1,23,1994,13.6,14,8,5,6,3,5,13,38.5,8,9,0,9,3,17,3,0,Matches
1732,Nordi Mukiele,FRA,DF,Montpellier,Ligue 1,19,1997,31.0,70,55,41,25,4,25,44,56.8,19,26,14,12,73,143,104,2,Matches
1733,Álex Mula,ESP,"FW,MF",Málaga,La Liga,21,1996,6.2,7,3,3,4,0,2,12,16.7,10,5,0,5,6,13,1,0,Matches
1734,Florian Müller,GER,GK,Mainz 05,Bundesliga,19,1997,5.0,0,0,0,0,0,0,0,,0,0,0,0,0,0,1,1,Matches
1735,Nicolai Müller,GER,"DF,MF",Hamburger SV,Bundesliga,29,1987,1.1,2,0,0,1,1,0,0,,0,1,0,1,0,2,0,0,Matches
1736,Thomas Müller,GER,"MF,FW",Bayern Munich,Bundesliga,27,1989,22.3,35,30,10,15,10,13,27,48.1,14,17,1,16,7,42,14,1,Matches
1737,Iker Muniain,ESP,"MF,FW",Athletic Club,La Liga,24,1992,8.7,10,8,2,6,2,1,7,14.3,6,4,0,4,4,14,3,0,Matches
1738,Marc Muniesa,ESP,DF,Girona,La Liga,25,1992,12.5,33,18,17,15,1,11,23,47.8,12,12,5,7,33,66,40,0,Matches
1739,Ezequiel Muñoz,ARG,DF,Leganés,La Liga,26,1990,15.6,36,28,24,12,0,11,20,55.0,9,18,11,7,24,60,84,0,Matches
1740,Sulley Muntari,GHA,MF,La Coruña,La Liga,32,1984,4.5,9,7,2,7,0,1,7,14.3,6,10,4,6,11,20,10,0,Matches
1741,Alessandro Murgia,ITA,MF,Lazio,Serie A,20,1996,8.6,19,12,9,9,1,5,19,26.3,14,14,3,11,17,36,13,0,Matches
1742,Luis Muriel,COL,FW,Sevilla,La Liga,26,1991,17.9,16,9,2,8,6,2,23,8.7,21,16,2,14,3,19,4,1,Matches
1743,Jeison Murillo,COL,DF,Valencia,La Liga,25,1992,15.3,31,24,25,6,0,14,21,66.7,7,18,9,9,29,60,85,1,Matches
1744,Jacob Murphy,ENG,"MF,FW",Newcastle Utd,Premier League,22,1995,12.8,13,10,5,4,4,7,27,25.9,20,16,0,16,6,19,13,2,Matches
1745,Jamie Murphy,SCO,MF,Brighton,Premier League,27,1989,1.9,2,2,2,0,0,2,4,50.0,2,0,0,0,1,3,3,0,Matches
1746,Glenn Murray,ENG,FW,Brighton,Premier League,33,1983,24.4,18,12,4,11,3,2,18,11.1,16,16,4,12,5,23,27,0,Matches
1747,Nicola Murru,ITA,DF,Sampdoria,Serie A,22,1994,16.1,40,31,18,18,4,24,38,63.2,14,29,4,25,17,57,60,1,Matches
1748,Mateo Musacchio,ARG,DF,Milan,Serie A,26,1990,13.4,22,15,13,7,2,8,16,50.0,8,9,3,6,12,34,58,1,Matches
1749,Charly Musonda Jr.,BEL,FW,Chelsea,Premier League,20,1996,0.4,1,0,0,0,1,1,1,100.0,0,0,0,0,0,1,0,0,Matches
1750,Shkodran Mustafi,GER,DF,Arsenal,Premier League,25,1992,25.3,64,46,42,18,4,28,54,51.9,26,23,15,8,57,121,175,2,Matches
1751,Yoshinori Mutō,JPN,FW,Mainz 05,Bundesliga,25,1992,21.2,21,15,6,8,7,5,14,35.7,9,16,0,16,6,27,12,0,Matches
1752,Fahad Al Muwallad,KSA,MF,Levante,La Liga,22,1994,0.3,0,0,0,0,0,0,1,0.0,1,0,0,0,1,1,0,0,Matches
1753,Yvon Mvogo,SUI,GK,RB Leipzig,Bundesliga,23,1994,1.0,0,0,0,0,0,0,0,,0,0,0,0,0,0,1,1,Matches
1754,Boaz Myhill,WAL,GK,West Brom,Premier League,34,1982,1.0,0,0,0,0,0,0,0,,0,0,0,0,0,0,1,0,Matches
1755,Alfred N'Diaye,SEN,"DF,MF",Villarreal,La Liga,27,1990,1.1,3,1,1,1,1,1,1,100.0,0,0,0,0,3,6,3,0,Matches
1756,Kévin N'Doram,FRA,"MF,DF",Monaco,Ligue 1,21,1996,8.0,16,10,6,9,1,6,24,25.0,18,6,2,4,16,32,29,0,Matches
1757,Abdallah N'dour,SEN,DF,Strasbourg,Ligue 1,23,1993,2.8,9,5,6,3,0,5,10,50.0,5,6,1,5,2,11,5,0,Matches
1758,Clinton N'Jie,CMR,FW,Marseille,Ligue 1,23,1993,9.7,10,6,2,5,3,2,9,22.2,7,5,0,5,3,13,0,0,Matches
1759,Georges-Kévin N'Koudou,CMR,MF,Tottenham,Premier League,22,1995,0.0,0,0,0,0,0,0,0,,0,0,0,0,0,0,1,0,Matches
1760,Georges-Kévin N'Koudou,CMR,"MF,FW",Burnley,Premier League,22,1995,2.5,7,6,5,1,1,3,8,37.5,5,4,0,4,1,8,1,0,Matches
1761,Stanley N'Soki,FRA,DF,Paris S-G,Ligue 1,18,1999,0.3,0,0,0,0,0,0,1,0.0,1,0,0,0,0,0,1,0,Matches
1762,Nacho,ESP,DF,Real Madrid,La Liga,27,1990,23.0,55,40,29,19,7,20,38,52.6,18,21,9,12,46,101,51,0,Matches
1763,Yuto Nagatomo,JPN,DF,Inter,Serie A,30,1986,8.8,10,6,4,5,1,5,14,35.7,9,8,3,5,10,20,28,0,Matches
1764,Ádám Nagy,HUN,MF,Bologna,Serie A,22,1995,7.9,16,9,6,8,2,7,13,53.8,6,11,0,11,7,23,5,0,Matches
1765,Matías Nahuel,ESP,"MF,FW",Betis,La Liga,20,1996,2.8,4,4,1,1,2,2,5,40.0,3,2,0,2,2,6,1,0,Matches
1766,Radja Nainggolan,BEL,MF,Roma,Serie A,29,1988,29.0,49,36,14,28,7,9,33,27.3,24,18,1,17,18,67,31,1,Matches
1767,Préjuce Nakoulma,BFA,FW,Nantes,Ligue 1,30,1987,12.8,10,8,3,6,1,2,7,28.6,5,2,0,2,5,15,0,0,Matches
1768,Naldo,BRA,DF,Espanyol,La Liga,28,1988,10.2,14,8,12,1,1,5,10,50.0,5,13,10,3,16,30,57,1,Matches
1769,Naldo,BRA,DF,Schalke 04,Bundesliga,34,1982,34.0,51,36,38,12,1,31,46,67.4,15,39,21,18,55,106,200,1,Matches
1770,Andrea Nalini,ITA,"FW,MF",Crotone,Serie A,27,1990,18.2,43,32,22,16,5,16,25,64.0,9,25,2,23,15,58,19,1,Matches
1771,Nani,POR,"FW,MF",Lazio,Serie A,30,1986,4.3,9,6,2,2,5,3,9,33.3,6,8,0,8,2,11,0,0,Matches
1772,Nano,ESP,FW,Levante,La Liga,22,1995,3.1,7,6,2,4,1,1,1,100.0,0,4,0,4,0,7,0,0,Matches
1773,Naranjo,ESP,"MF,FW",Leganés,La Liga,23,1994,6.2,17,10,3,12,2,4,12,33.3,8,11,1,10,3,20,4,0,Matches
1774,Luciano Narsingh,NED,"FW,MF",Swansea City,Premier League,26,1990,6.9,7,5,1,5,1,2,7,28.6,5,7,0,7,3,10,3,0,Matches
1775,Nikolas Nartey,DEN,MF,Köln,Bundesliga,17,2000,0.1,0,0,0,0,0,0,0,,0,0,0,0,0,0,0,0,Matches
1776,Juanjo Narváez,COL,MF,Betis,La Liga,22,1995,3.4,8,6,4,4,0,3,6,50.0,3,3,0,3,8,16,4,0,Matches
1777,Matija Nastasić,SRB,DF,Schalke 04,Bundesliga,24,1993,22.1,48,38,37,10,1,28,37,75.7,9,40,22,18,36,84,85,0,Matches
1778,Nathan,BRA,MF,Amiens,Ligue 1,21,1996,0.1,0,0,0,0,0,0,0,,0,0,0,0,0,0,0,0,Matches
1779,Kyle Naughton,ENG,DF,Swansea City,Premier League,28,1988,33.7,92,60,49,35,8,54,100,54.0,46,60,13,47,60,152,144,4,Matches
1780,Fernando Navarro,ESP,DF,La Coruña,La Liga,35,1982,11.6,32,22,24,7,1,16,25,64.0,9,13,3,10,29,61,49,0,Matches
1781,Marc Navarro,ESP,DF,Espanyol,La Liga,22,1995,12.3,20,13,12,8,0,10,20,50.0,10,11,6,5,22,42,17,0,Matches
1782,Rafa Navarro,ESP,DF,Betis,La Liga,23,1994,1.5,3,2,3,0,0,0,4,0.0,4,0,0,0,1,4,6,0,Matches
1783,Ximo Navarro,ESP,DF,Las Palmas,La Liga,27,1990,29.0,63,43,44,19,0,28,50,56.0,22,27,16,11,66,129,131,4,Matches
1784,Jesús Navas,ESP,"FW,DF",Sevilla,La Liga,31,1985,19.6,32,25,17,9,6,12,26,46.2,14,14,5,9,19,51,37,0,Matches
1785,Keylor Navas,CRC,GK,Real Madrid,La Liga,30,1986,27.0,2,1,2,0,0,1,1,100.0,0,0,0,0,3,5,10,2,Matches
1786,Raúl Navas,ESP,DF,Real Sociedad,La Liga,29,1988,19.9,22,15,18,4,0,14,26,53.8,12,23,13,10,30,52,73,0,Matches
1787,Badou Ndiaye,SEN,MF,Stoke City,Premier League,26,1990,12.6,53,28,22,25,6,16,41,39.0,25,21,9,12,13,66,18,0,Matches
1788,Wilfred Ndidi,NGA,MF,Leicester City,Premier League,20,1996,32.2,138,89,68,65,5,45,119,37.8,74,67,10,57,51,189,103,2,Matches
1789,Merveille Ndockyt,CGO,"MF,FW",Getafe,La Liga,19,1998,0.8,1,1,0,1,0,0,1,0.0,1,2,0,2,2,3,0,0,Matches
1790,Tanguy Ndombele,FRA,MF,Amiens,Ligue 1,20,1996,2.6,6,5,2,4,0,1,4,25.0,3,4,0,4,5,11,3,0,Matches
1791,Tanguy Ndombele,FRA,MF,Lyon,Ligue 1,20,1996,26.1,62,39,23,31,8,11,40,27.5,29,53,8,45,36,98,9,0,Matches
1792,Reiss Nelson,ENG,"FW,MF",Arsenal,Premier League,17,1999,1.6,4,3,1,1,2,0,0,,0,4,0,4,3,7,0,0,Matches
1793,Neto,BRA,GK,Valencia,La Liga,28,1989,33.0,1,1,1,0,0,1,2,50.0,1,1,0,1,1,2,8,3,Matches
1794,Manuel Neuer,GER,GK,Bayern Munich,Bundesliga,31,1986,3.0,0,0,0,0,0,0,0,,0,0,0,0,0,0,1,0,Matches
1795,Neymar,BRA,FW,Paris S-G,Ligue 1,25,1992,19.8,20,14,3,11,6,7,40,17.5,33,4,0,4,5,25,2,0,Matches
1796,Yeni Ngbakoto,COD,"FW,MF",Guingamp,Ligue 1,25,1992,6.4,11,10,4,6,1,3,10,30.0,7,10,0,10,9,20,6,0,Matches
1797,Santy Ngom,SEN,"FW,MF",Nantes,Ligue 1,24,1993,5.2,10,5,5,5,0,1,8,12.5,7,9,1,8,2,12,2,0,Matches
1798,Guy Ngosso,CMR,MF,Amiens,Ligue 1,32,1985,6.8,8,5,4,4,0,4,20,20.0,16,5,3,2,9,17,19,0,Matches
1799,Julien Ngoy,BEL,MF,Stoke City,Premier League,19,1997,0.2,1,1,0,1,0,1,2,50.0,1,0,0,0,0,1,0,0,Matches
1800,Opa Nguette,SEN,"FW,MF",Metz,Ligue 1,23,1994,11.4,27,22,11,12,4,5,21,23.8,16,10,0,10,18,45,13,0,Matches
1801,Moussa Niakhate,SEN,DF,Metz,Ligue 1,21,1996,34.5,57,38,44,12,1,22,37,59.5,15,27,14,13,55,112,139,1,Matches
1802,Adama Niane,MLI,FW,Troyes,Ligue 1,24,1993,24.0,22,12,5,10,7,6,26,23.1,20,11,2,9,9,31,13,0,Matches
1803,Ibrahima Niane,SEN,"FW,MF",Metz,Ligue 1,18,1999,9.4,6,5,4,1,1,2,8,25.0,6,6,0,6,4,10,8,0,Matches
1804,M'Baye Niang,SEN,FW,Torino,Serie A,22,1994,17.0,29,23,11,9,9,6,18,33.3,12,17,3,14,13,42,15,0,Matches
1805,Oumar Niasse,SEN,FW,Everton,Premier League,27,1990,12.1,10,6,2,5,3,4,19,21.1,15,3,2,1,2,12,6,0,Matches
1806,Florian Niederlechner,GER,"FW,MF",Freiburg,Bundesliga,26,1990,7.7,8,6,1,5,2,2,5,40.0,3,5,1,4,3,11,6,0,Matches
1807,Saúl Ñíguez,ESP,MF,Atlético Madrid,La Liga,22,1994,35.1,132,90,53,69,10,40,104,38.5,64,61,12,49,55,187,77,0,Matches
1808,Casimir Ninga,CHA,"FW,MF",Montpellier,Ligue 1,24,1993,14.3,12,7,1,6,5,2,10,20.0,8,12,2,10,4,16,13,0,Matches
1809,Benjamin Nivet,FRA,"MF,FW",Troyes,Ligue 1,40,1977,15.2,31,14,12,14,5,11,51,21.6,40,18,1,17,16,47,20,0,Matches
1810,Eddie Nketiah,ENG,FW,Arsenal,Premier League,18,1999,0.2,1,1,0,1,0,0,0,,0,0,0,0,0,1,0,0,Matches
1811,Jordan Nkololo,COD,"MF,FW",Caen,Ligue 1,24,1992,4.7,9,6,4,5,0,1,4,25.0,3,7,1,6,1,10,0,0,Matches
1812,Nicolas Nkoulou,CMR,DF,Torino,Serie A,27,1990,36.2,56,40,40,15,1,22,33,66.7,11,44,22,22,57,113,163,1,Matches
1813,Christopher Nkunku,FRA,"FW,MF",Paris S-G,Ligue 1,19,1997,7.0,5,2,2,2,1,3,14,21.4,11,8,2,6,5,10,2,1,Matches
1814,Lukas Nmecha,GER,FW,Manchester City,Premier League,18,1998,0.2,0,0,0,0,0,0,0,,0,0,0,0,0,0,0,0,Matches
1815,Mark Noble,ENG,MF,West Ham,Premier League,30,1987,26.7,61,36,32,22,7,16,76,21.1,60,28,10,18,47,108,32,1,Matches
1816,Vincent Nogueira,FRA,MF,Strasbourg,Ligue 1,29,1988,0.7,0,0,0,0,0,0,0,,0,0,0,0,0,0,2,0,Matches
1817,Nolito,ESP,"FW,MF",Sevilla,La Liga,30,1986,17.8,49,36,21,21,7,14,33,42.4,19,17,2,15,10,59,17,0,Matches
1818,Håvard Nordtveit,NOR,DF,Hoffenheim,Bundesliga,27,1990,10.8,19,16,10,9,0,13,18,72.2,5,19,8,11,10,29,50,0,Matches
1819,Paul-Georges Ntep,CMR,"FW,MF",Saint-Étienne,Ligue 1,25,1992,5.7,14,8,8,5,1,8,17,47.1,9,4,1,3,3,17,4,0,Matches
1820,Paul-Georges Ntep,CMR,"FW,MF",Wolfsburg,Bundesliga,25,1992,1.8,2,2,0,0,2,0,1,0.0,1,3,1,2,1,3,0,0,Matches
1821,Alexander Nübel,GER,GK,Schalke 04,Bundesliga,20,1996,0.5,0,0,0,0,0,0,0,,0,0,0,0,0,0,0,0,Matches
1822,Unai Núñez,ESP,DF,Athletic Club,La Liga,20,1997,32.7,73,52,54,19,0,38,56,67.9,18,52,27,25,67,140,155,2,Matches
1823,Bram Nuytinck,NED,DF,Udinese,Serie A,27,1990,26.2,65,41,40,24,1,25,39,64.1,14,43,24,19,37,102,124,1,Matches
1824,Simeon Nwankwo,NGA,FW,Crotone,Serie A,25,1992,13.5,12,9,1,5,6,1,12,8.3,11,16,3,13,1,13,20,0,Matches
1825,Gerzino Nyamsi,FRA,DF,Rennes,Ligue 1,20,1997,3.0,4,2,4,0,0,0,3,0.0,3,2,2,0,3,7,18,2,Matches
1826,Allan Nyom,CMR,DF,West Brom,Premier League,29,1988,25.7,64,39,43,17,4,28,43,65.1,15,20,9,11,27,91,93,0,Matches
1827,Steven Nzonzi,FRA,MF,Sevilla,La Liga,28,1988,24.6,39,26,14,19,6,20,30,66.7,10,27,8,19,28,67,36,2,Matches
1828,Aiden O'Neill,AUS,MF,Burnley,Premier League,19,1998,0.0,,,,,,,,,,,,,,,,,Matches
1829,Michael Obafemi,IRL,FW,Southampton,Premier League,17,2000,0.1,0,0,0,0,0,0,0,,0,0,0,0,0,0,0,0,Matches
1830,Joel Obi,NGA,MF,Torino,Serie A,26,1991,13.9,45,25,20,20,5,8,26,30.8,18,17,3,14,24,69,15,0,Matches
1831,Johann Obiang,GAB,DF,Troyes,Ligue 1,24,1993,5.2,13,9,9,2,2,6,13,46.2,7,9,1,8,7,20,15,0,Matches
1832,Pedro Obiang,EQG,MF,West Ham,Premier League,25,1992,17.4,53,34,20,29,4,17,51,33.3,34,37,16,21,24,77,27,1,Matches
1833,Jan Oblak,SVN,GK,Atlético Madrid,La Liga,24,1993,37.0,0,0,0,0,0,0,0,,0,0,0,0,2,2,7,0,Matches
1834,Lucas Ocampos,ARG,FW,Marseille,Ligue 1,23,1994,22.6,83,57,30,44,9,30,93,32.3,63,42,3,39,30,113,26,0,Matches
1835,Philipp Ochs,GER,"FW,DF",Hoffenheim,Bundesliga,20,1997,0.8,5,4,1,3,1,1,2,50.0,1,0,0,0,1,6,0,0,Matches
1836,Bastian Oczipka,GER,"DF,MF",Schalke 04,Bundesliga,28,1989,25.8,60,48,29,26,5,29,37,78.4,8,41,2,39,40,100,40,1,Matches
1837,Álvaro Odriozola,ESP,DF,Real Sociedad,La Liga,21,1995,32.4,41,27,22,15,4,20,35,57.1,15,25,7,18,26,67,50,0,Matches
1838,Ebenezer Ofori,GHA,MF,Stuttgart,Bundesliga,22,1995,0.1,0,0,0,0,0,0,1,0.0,1,1,0,1,0,0,0,0,Matches
1839,Angelo Ogbonna,ITA,DF,West Ham,Premier League,29,1988,32.0,30,24,18,10,2,8,18,44.4,10,40,27,13,58,88,197,1,Matches
1840,Marios Oikonomou,GRE,DF,SPAL,Serie A,24,1992,1.9,5,3,4,1,0,0,2,0.0,2,0,0,0,4,9,12,0,Matches
1841,Stefano Okaka,ITA,FW,Watford,Premier League,27,1989,5.0,6,4,0,6,0,3,6,50.0,3,3,0,3,0,6,0,0,Matches
1842,Shinji Okazaki,JPN,"FW,MF",Leicester City,Premier League,31,1986,14.7,25,16,3,18,4,4,28,14.3,24,15,1,14,8,33,6,0,Matches
1843,Orji Okwonkwo,NGA,"FW,MF",Bologna,Serie A,19,1998,2.9,9,3,6,3,0,1,4,25.0,3,2,0,2,1,10,1,0,Matches
1844,Kwasi Okyere Wriedt,GHA,MF,Bayern Munich,Bundesliga,23,1994,0.3,2,2,1,1,0,0,0,,0,0,0,0,0,2,0,0,Matches
1845,Oier Olazábal,ESP,GK,Levante,La Liga,27,1989,26.0,0,0,0,0,0,0,2,0.0,2,1,0,1,1,1,12,3,Matches
1846,Paulo Oliveira,POR,DF,Eibar,La Liga,25,1992,24.6,41,22,28,13,0,16,22,72.7,6,23,9,14,62,103,140,0,Matches
1847,Mathías Olivera,URU,MF,Getafe,La Liga,19,1997,1.1,3,1,1,0,2,3,5,60.0,2,3,0,3,1,4,2,0,Matches
1848,Maximiliano Olivera,URU,DF,Fiorentina,Serie A,25,1992,4.6,12,9,5,4,3,3,8,37.5,5,4,1,3,11,23,11,0,Matches
1849,Paweł Olkowski,POL,DF,Köln,Bundesliga,27,1990,5.0,17,12,9,8,0,5,9,55.6,4,11,2,9,3,20,17,0,Matches
1850,Martin Olsson,SWE,DF,Swansea City,Premier League,29,1988,35.0,34,26,18,10,6,12,29,41.4,17,21,4,17,31,65,81,0,Matches
1851,Michael Olunga,KEN,"FW,MF",Girona,La Liga,23,1994,4.8,6,5,1,3,2,1,3,33.3,2,5,0,5,3,9,5,0,Matches
1852,Stephane Omeonga,BEL,"MF,DF",Genoa,Serie A,21,1996,8.9,25,15,16,8,1,7,18,38.9,11,20,1,19,5,30,6,0,Matches
1853,Prince Oniangué,CGO,MF,Angers,Ligue 1,28,1988,11.7,16,11,5,9,2,8,31,25.8,23,20,4,16,11,27,8,0,Matches
1854,Karim Onisiwo,AUT,"DF,FW",Mainz 05,Bundesliga,25,1992,2.8,7,5,5,1,1,3,7,42.9,4,4,0,4,1,8,8,0,Matches
1855,Javier Ontiveros,ESP,"MF,FW",Málaga,La Liga,19,1997,4.3,10,7,8,2,0,2,4,50.0,2,4,2,2,4,14,4,0,Matches
1856,Daniel Opare,GHA,DF,Augsburg,Bundesliga,26,1990,15.7,31,27,20,10,1,21,27,77.8,6,14,5,9,28,59,56,0,Matches
1857,Willi Orban,HUN,DF,RB Leipzig,Bundesliga,24,1992,23.6,49,30,35,14,0,29,43,67.4,14,45,18,27,28,77,155,1,Matches
1858,Fabián Orellana,CHI,"MF,FW",Eibar,La Liga,31,1986,13.1,14,8,5,8,1,4,23,17.4,19,10,1,9,7,21,3,0,Matches
1859,Divock Origi,BEL,FW,Liverpool,Premier League,22,1995,0.1,0,0,0,0,0,0,0,,0,0,0,0,0,0,0,0,Matches
1860,Divock Origi,BEL,FW,Wolfsburg,Bundesliga,22,1995,21.9,6,5,2,3,1,1,7,14.3,6,16,2,14,3,9,17,0,Matches
1861,Riccardo Orsolini,ITA,"FW,DF",Bologna,Serie A,20,1997,3.8,5,5,4,1,0,1,5,20.0,4,2,1,1,3,8,4,0,Matches
1862,Riccardo Orsolini,ITA,"MF,FW",Atalanta,Serie A,20,1997,1.4,3,2,3,0,0,1,1,100.0,0,1,0,1,0,3,0,0,Matches
1863,Yuya Osako,JPN,"FW,MF",Köln,Bundesliga,27,1990,21.1,13,10,4,9,0,4,18,22.2,14,13,2,11,8,21,22,0,Matches
1864,Victor Osimhen,NGA,"FW,MF",Wolfsburg,Bundesliga,18,1998,3.2,4,4,3,1,0,2,5,40.0,3,2,1,1,2,6,7,0,Matches
1865,David Ospina,COL,GK,Arsenal,Premier League,28,1988,4.2,0,0,0,0,0,0,0,,0,0,0,0,0,0,1,0,Matches
1866,Matthias Ostrzolek,GER,"DF,MF",Hannover 96,Bundesliga,27,1990,26.4,68,53,43,20,5,38,57,66.7,19,39,10,29,30,98,58,1,Matches
1867,Nicolás Otamendi,ARG,DF,Manchester City,Premier League,29,1988,33.0,58,43,35,22,1,19,44,43.2,25,21,10,11,48,106,129,3,Matches
1868,Otávio,BRA,MF,Bordeaux,Ligue 1,23,1994,16.5,64,42,25,37,2,20,61,32.8,41,26,4,22,32,96,35,0,Matches
1869,Anas Ouahim,GER,MF,Köln,Bundesliga,19,1997,0.2,1,1,0,1,0,1,1,100.0,0,0,0,0,0,1,0,0,Matches
1870,Alexandre Oukidja,ALG,GK,Strasbourg,Ligue 1,29,1988,16.2,0,0,0,0,0,0,1,0.0,1,0,0,0,3,3,9,1,Matches
1871,Adam Ounas,ALG,FW,Napoli,Serie A,20,1996,1.1,4,3,0,2,2,1,4,25.0,3,2,0,2,0,4,2,0,Matches
1872,Reece Oxford,ENG,MF,West Ham,Premier League,18,1998,0.1,2,1,1,1,0,1,1,100.0,0,0,0,0,0,2,0,0,Matches
1873,Reece Oxford,ENG,"DF,MF",Gladbach,Bundesliga,18,1998,5.1,8,6,3,4,1,3,4,75.0,1,4,0,4,9,17,26,1,Matches
1874,Alex Oxlade-Chamberlain,ENG,DF,Arsenal,Premier League,23,1993,2.7,5,3,2,2,1,2,3,66.7,1,5,2,3,6,11,8,0,Matches
1875,Alex Oxlade-Chamberlain,ENG,"MF,FW",Liverpool,Premier League,23,1993,16.6,32,21,13,14,5,6,21,28.6,15,24,0,24,20,52,14,0,Matches
1876,Mikel Oyarzabal,ESP,"FW,MF",Real Sociedad,La Liga,20,1997,30.8,33,23,10,13,10,7,39,17.9,32,32,2,30,18,51,19,0,Matches
1877,Ambroise Oyongo,CMR,DF,Montpellier,Ligue 1,26,1991,2.2,2,1,1,1,0,0,1,0.0,1,2,1,1,6,8,6,0,Matches
1878,Berkay Özcan,TUR,"MF,FW",Stuttgart,Bundesliga,19,1998,11.1,19,10,7,9,3,7,11,63.6,4,14,2,12,3,22,8,0,Matches
1879,Ramazan Özcan,AUT,GK,Leverkusen,Bundesliga,33,1984,1.0,0,0,0,0,0,0,1,0.0,1,0,0,0,0,0,0,0,Matches
1880,Salih Özcan,TUR,MF,Köln,Bundesliga,19,1998,18.6,56,42,24,29,3,28,54,51.9,26,27,5,22,29,85,22,1,Matches
1881,Mesut Özil,GER,"MF,FW",Arsenal,Premier League,28,1988,24.0,20,13,6,10,4,5,22,22.7,17,11,1,10,12,32,9,0,Matches
1882,Levin Öztunalı,GER,"FW,MF",Mainz 05,Bundesliga,21,1996,19.3,26,19,8,15,3,10,20,50.0,10,25,0,25,11,37,9,0,Matches
1883,Pablo,BRA,DF,Bordeaux,Ligue 1,26,1991,14.3,16,15,13,3,0,10,16,62.5,6,13,7,6,16,32,96,1,Matches
1884,Daniel Pacheco,ESP,"MF,FW",Getafe,La Liga,26,1991,1.9,4,4,1,2,1,0,1,0.0,1,2,0,2,2,6,1,0,Matches
1885,Fernando Pacheco,ESP,GK,Alavés,La Liga,25,1992,37.3,0,0,0,0,0,0,0,,0,1,0,1,3,3,12,4,Matches
1886,Simone Padoin,ITA,"DF,MF",Cagliari,Serie A,33,1984,34.5,22,18,8,10,4,12,28,42.9,16,38,14,24,24,46,74,0,Matches
1887,Vincent Pajot,FRA,MF,Saint-Étienne,Ligue 1,26,1990,14.3,24,16,9,13,2,3,17,17.6,14,21,9,12,24,48,34,0,Matches
1888,Rodrigo Palacio,ARG,"FW,MF",Bologna,Serie A,35,1982,22.9,25,18,6,12,7,10,28,35.7,18,16,2,14,12,37,14,0,Matches
1889,Raffaele Palladino,ITA,"MF,FW",Genoa,Serie A,33,1984,2.6,1,1,1,0,0,0,1,0.0,1,0,0,0,1,2,0,0,Matches
1890,Nicolas Pallois,FRA,DF,Nantes,Ligue 1,29,1987,27.0,39,28,25,9,5,18,36,50.0,18,34,19,15,35,74,182,3,Matches
1891,Kasey Palmer,JAM,"MF,FW",Huddersfield,Premier League,20,1996,1.9,6,3,2,3,1,2,8,25.0,6,5,0,5,0,6,2,0,Matches
1892,Emerson Palmieri,ITA,DF,Chelsea,Premier League,22,1994,3.1,6,4,4,2,0,5,5,100.0,0,2,0,2,2,8,10,0,Matches
1893,Emerson Palmieri,ITA,DF,Roma,Serie A,22,1994,0.2,0,0,0,0,0,0,0,,0,0,0,0,0,0,0,0,Matches
1894,Julian Palmieri,FRA,DF,Metz,Ligue 1,30,1986,12.5,29,15,17,9,3,17,29,58.6,12,16,2,14,22,51,31,0,Matches
1895,Simone Palombi,ITA,FW,Lazio,Serie A,21,1996,0.7,0,0,0,0,0,0,0,,0,0,0,0,0,0,0,0,Matches
1896,Alberto Paloschi,ITA,FW,SPAL,Serie A,27,1990,24.3,10,7,0,9,1,0,10,0.0,10,2,1,1,4,14,11,0,Matches
1897,Goran Pandev,MKD,"FW,MF",Genoa,Serie A,34,1983,20.0,10,9,3,6,1,2,13,15.4,11,8,0,8,4,14,5,0,Matches
1898,Costel Pantilimon,ROU,GK,La Coruña,La Liga,30,1987,6.0,0,0,0,0,0,0,1,0.0,1,0,0,0,0,0,0,1,Matches
1899,Kyriakos Papadopoulos,GRE,DF,Hamburger SV,Bundesliga,25,1992,29.0,60,54,36,24,0,41,69,59.4,28,54,35,19,43,103,181,2,Matches
1900,Sokratis Papastathopoulos,GRE,DF,Dortmund,Bundesliga,29,1988,26.4,65,47,50,13,2,39,47,83.0,8,36,11,25,30,95,112,0,Matches
1901,Rubén Pardo,ESP,MF,Real Sociedad,La Liga,24,1992,2.5,1,0,0,1,0,1,2,50.0,1,5,0,5,5,6,1,0,Matches
1902,Nicolás Pareja,ARG,DF,Sevilla,La Liga,33,1984,4.5,11,8,7,3,1,3,5,60.0,2,8,1,7,13,24,24,0,Matches
1903,Daniel Parejo,ESP,MF,Valencia,La Liga,28,1989,33.3,88,57,35,43,10,31,87,35.6,56,37,10,27,34,122,27,1,Matches
1904,Vittorio Parigini,ITA,"MF,FW",Benevento,Serie A,21,1996,9.5,18,11,11,6,1,6,17,35.3,11,8,1,7,5,23,1,0,Matches
1905,Shawn Parker,GER,"FW,MF",Augsburg,Bundesliga,24,1993,0.5,0,0,0,0,0,0,0,,0,0,0,0,0,0,0,0,Matches
1906,Marco Parolo,ITA,MF,Lazio,Serie A,32,1985,29.0,70,37,27,36,7,14,58,24.1,44,49,8,41,43,113,64,0,Matches
1907,Thomas Partey,GHA,"MF,DF",Atlético Madrid,La Liga,24,1993,26.4,94,64,48,39,7,33,69,47.8,36,32,7,25,53,147,34,1,Matches
1908,Felix Passlack,GER,"FW,DF",Hoffenheim,Bundesliga,19,1998,0.7,2,2,2,0,0,2,3,66.7,1,0,0,0,0,2,2,0,Matches
1909,Felix Passlack,GER,DF,Dortmund,Bundesliga,19,1998,0.1,0,0,0,0,0,0,0,,0,0,0,0,1,1,0,0,Matches
1910,Javier Pastore,ARG,"MF,FW",Paris S-G,Ligue 1,28,1989,15.0,33,21,9,16,8,5,23,21.7,18,13,0,13,10,43,14,1,Matches
1911,Patric,ESP,DF,Lazio,Serie A,24,1993,6.6,11,6,8,2,1,4,6,66.7,2,3,0,3,3,14,32,0,Matches
1912,Paulinho,BRA,MF,Barcelona,La Liga,29,1988,21.6,39,28,17,15,7,11,38,28.9,27,25,3,22,15,54,16,1,Matches
1913,Gabriel Paulista,BRA,DF,Valencia,La Liga,26,1990,28.7,47,27,41,4,2,32,46,69.6,14,30,14,16,51,98,142,2,Matches
1914,Benjamin Pavard,FRA,DF,Stuttgart,Bundesliga,21,1996,34.0,55,40,40,13,2,36,47,76.6,11,59,34,25,70,125,192,1,Matches
1915,Jiří Pavlenka,CZE,GK,Werder Bremen,Bundesliga,25,1992,34.0,1,1,1,0,0,0,0,,0,2,0,2,0,1,17,4,Matches
1916,Daniel Pavlović,BIH,DF,Crotone,Serie A,29,1988,8.4,10,5,9,0,1,5,10,50.0,5,4,3,1,5,15,22,0,Matches
1917,Daniel Pavlović,BIH,DF,Sampdoria,Serie A,29,1988,1.0,3,1,1,1,1,1,1,100.0,0,0,0,0,0,3,5,0,Matches
1918,Mateo Pavlović,BIH,DF,Angers,Ligue 1,27,1990,21.8,13,7,10,3,0,7,20,35.0,13,14,11,3,21,34,120,0,Matches
1919,Leonardo Pavoletti,ITA,FW,Cagliari,Serie A,28,1988,30.2,27,13,5,14,8,2,21,9.5,19,13,5,8,13,40,28,0,Matches
1920,Dimitri Payet,FRA,"MF,FW",Marseille,Ligue 1,30,1987,26.1,22,11,5,13,4,8,37,21.6,29,19,2,17,19,41,7,1,Matches
1921,Giampaolo Pazzini,ITA,FW,Hellas Verona,Serie A,32,1984,11.0,0,0,0,0,0,0,4,0.0,4,2,0,2,1,1,13,0,Matches
1922,Giampaolo Pazzini,ITA,FW,Levante,La Liga,32,1984,4.9,0,0,0,0,0,0,0,,0,1,0,1,1,1,1,0,Matches
1923,Alfonso Pedraza,ESP,"MF,DF",Alavés,La Liga,21,1996,27.1,57,40,24,21,12,19,56,33.9,37,39,5,34,32,89,26,0,Matches
1924,Pedro,ESP,"MF,FW",Chelsea,Premier League,30,1987,16.9,20,11,6,8,6,5,18,27.8,13,13,1,12,13,33,7,1,Matches
1925,João Pedro,ITA,"MF,FW",Cagliari,Serie A,25,1992,18.4,15,9,4,9,2,0,12,0.0,12,9,1,8,11,26,24,0,Matches
1926,Stef Peeters,BEL,MF,Caen,Ligue 1,25,1992,12.3,22,11,6,14,2,6,31,19.4,25,17,3,14,7,29,11,0,Matches
1927,Gianluca Pegolo,ITA,GK,Sassuolo,Serie A,36,1981,1.2,0,0,0,0,0,0,0,,0,0,0,0,0,0,0,0,Matches
1928,Peter Pekarík,SVK,DF,Hertha BSC,Bundesliga,30,1986,15.3,42,33,17,21,4,21,29,72.4,8,23,3,20,18,60,44,0,Matches
1929,Bryan Pelé,FRA,"FW,MF",Troyes,Ligue 1,25,1992,17.9,20,9,9,8,3,4,28,14.3,24,11,0,11,15,35,13,0,Matches
1930,Yohann Pelé,FRA,GK,Marseille,Ligue 1,34,1982,8.2,0,0,0,0,0,0,1,0.0,1,0,0,0,1,1,2,0,Matches
1931,Pietro Pellegri,ITA,FW,Genoa,Serie A,16,2001,3.1,1,0,0,0,1,0,5,0.0,5,3,0,3,2,3,1,0,Matches
1932,Pietro Pellegri,ITA,FW,Monaco,Ligue 1,16,2001,0.3,0,0,0,0,0,0,2,0.0,2,1,0,1,0,0,0,0,Matches
1933,Lorenzo Pellegrini,ITA,MF,Roma,Serie A,21,1996,20.0,36,20,16,11,9,10,35,28.6,25,21,2,19,41,77,21,1,Matches
1934,Théo Pellenard,FRA,DF,Bordeaux,Ligue 1,23,1994,15.9,32,20,13,15,4,10,28,35.7,18,15,6,9,32,64,31,0,Matches
1935,Sergio Pellissier,ITA,FW,Chievo,Serie A,38,1979,6.2,6,2,1,3,2,1,3,33.3,2,3,0,3,1,7,2,0,Matches
1936,Federico Peluso,ITA,DF,Sassuolo,Serie A,33,1984,28.8,46,34,29,13,4,14,26,53.8,12,39,13,26,40,86,132,1,Matches
1937,Rubén Peña,ESP,"DF,MF",Eibar,La Liga,26,1991,19.2,41,28,20,17,4,20,42,47.6,22,24,6,18,30,71,31,0,Matches
1938,Gabriel Peñalba,ARG,MF,Las Palmas,La Liga,32,1984,6.3,6,5,4,2,0,5,11,45.5,6,7,4,3,8,14,15,0,Matches
1939,Adalberto Peñaranda,VEN,"FW,MF",Málaga,La Liga,20,1997,8.9,10,6,2,6,2,2,3,66.7,1,8,1,7,0,10,1,0,Matches
1940,Nicolas Pépé,CIV,"FW,MF",Lille,Ligue 1,22,1995,31.6,30,18,14,11,5,11,42,26.2,31,23,0,23,10,40,20,0,Matches
1941,Andreas Pereira,BRA,MF,Valencia,La Liga,21,1996,12.0,26,15,12,11,3,10,30,33.3,20,9,1,8,11,37,5,0,Matches
1942,Pedro Pereira,POR,DF,Genoa,Serie A,19,1998,4.2,5,4,2,1,2,3,5,60.0,2,5,2,3,5,10,15,0,Matches
1943,Bruno Peres,BRA,DF,Roma,Serie A,27,1990,12.8,26,17,16,7,3,10,23,43.5,13,9,2,7,22,48,28,1,Matches
1944,Roberto Pereyra,ARG,"MF,FW",Watford,Premier League,26,1991,18.0,10,8,4,5,1,2,13,15.4,11,16,0,16,9,19,6,0,Matches
1945,Ayoze Pérez,ESP,"MF,FW",Newcastle Utd,Premier League,24,1993,27.7,39,21,11,15,13,12,54,22.2,42,36,1,35,24,63,28,0,Matches
1946,Hernán Pérez,PAR,MF,Alavés,La Liga,28,1989,4.2,11,8,6,4,1,2,19,10.5,17,5,0,5,3,14,6,0,Matches
1947,Hernán Pérez,PAR,"MF,DF",Espanyol,La Liga,28,1989,1.6,4,3,1,1,2,2,3,66.7,1,1,0,1,1,5,1,0,Matches
1948,Lucas Pérez,ESP,FW,La Coruña,La Liga,28,1988,31.1,17,12,5,8,4,1,32,3.1,31,19,1,18,9,26,1,0,Matches
1949,Rubén Pérez,ESP,MF,Leganés,La Liga,28,1989,28.0,99,61,47,48,4,48,101,47.5,53,30,5,25,77,176,40,0,Matches
1950,Stipe Perica,CRO,FW,Udinese,Serie A,22,1995,10.5,8,5,2,5,1,2,13,15.4,11,7,1,6,3,11,9,0,Matches
1951,Mattia Perin,ITA,GK,Genoa,Serie A,24,1992,37.0,0,0,0,0,0,0,1,0.0,1,0,0,0,1,1,14,2,Matches
1952,Ivan Perišić,CRO,FW,Inter,Serie A,28,1989,36.8,47,31,15,23,9,8,56,14.3,48,47,6,41,45,92,62,0,Matches
1953,Diego Perotti,ARG,"FW,MF",Roma,Serie A,29,1988,17.9,25,17,6,14,5,8,20,40.0,12,19,0,19,11,36,13,0,Matches
1954,Romain Perraud,FRA,FW,Nice,Ligue 1,19,1997,0.0,0,0,0,0,0,0,0,,0,0,0,0,0,0,0,0,Matches
1955,Loïc Perrin,FRA,DF,Saint-Étienne,Ligue 1,31,1985,27.4,39,26,28,10,1,21,31,67.7,10,35,22,13,36,75,142,1,Matches
1956,Andrea Petagna,ITA,FW,Atalanta,Serie A,22,1995,18.0,8,3,2,4,2,1,11,9.1,10,14,3,11,4,12,5,0,Matches
1957,Nils Petersen,GER,FW,Freiburg,Bundesliga,28,1988,24.9,27,18,7,18,2,10,27,37.0,17,28,2,26,17,44,33,0,Matches
1958,Bruno Petković,CRO,FW,Hellas Verona,Serie A,22,1994,10.2,14,12,3,8,3,6,13,46.2,7,11,1,10,7,21,12,0,Matches
1959,Bruno Petković,CRO,"FW,MF",Bologna,Serie A,22,1994,3.7,7,6,0,5,2,1,1,100.0,0,3,0,3,4,11,5,0,Matches
1960,Germán Pezzella,ARG,DF,Fiorentina,Serie A,26,1991,33.1,63,47,42,19,2,19,41,46.3,22,33,16,17,63,126,185,1,Matches
1961,Giuseppe Pezzella,ITA,"DF,FW",Udinese,Serie A,19,1997,10.0,19,11,10,4,5,7,19,36.8,12,8,1,7,6,25,32,0,Matches
1962,Maximilian Philipp,GER,FW,Dortmund,Bundesliga,23,1994,13.4,24,19,9,12,3,6,19,31.6,13,12,0,12,6,30,7,0,Matches
1963,Chris Philipps,LUX,"MF,DF",Metz,Ligue 1,23,1994,9.4,22,12,10,10,2,5,26,19.2,21,13,5,8,30,52,18,0,Matches
1964,Matt Phillips,SCO,"MF,DF",West Brom,Premier League,26,1991,23.3,27,16,17,5,5,10,29,34.5,19,21,1,20,24,51,43,0,Matches
1965,Lebogang Phiri,RSA,MF,Guingamp,Ligue 1,22,1994,11.5,28,17,14,12,2,11,43,25.6,32,9,2,7,19,47,13,0,Matches
1966,Pablo Piatti,ARG,"MF,FW",Espanyol,La Liga,28,1989,19.3,45,32,14,21,10,17,57,29.8,40,28,3,25,22,67,16,0,Matches
1967,Jordan Pickford,ENG,GK,Everton,Premier League,23,1994,38.0,0,0,0,0,0,0,2,0.0,2,0,0,0,2,2,26,5,Matches
1968,Jérémy Pied,FRA,DF,Southampton,Premier League,28,1989,2.0,9,6,8,1,0,6,9,66.7,3,3,2,1,8,17,4,0,Matches
1969,Nicholas Pierini,ITA,"MF,FW",Sassuolo,Serie A,18,1998,0.5,1,1,0,0,1,0,0,,0,1,0,1,1,2,0,0,Matches
1970,Ronaël Pierre-Gabriel,FRA,DF,Saint-Étienne,Ligue 1,19,1998,13.0,43,31,33,7,3,17,28,60.7,11,11,2,9,9,52,35,0,Matches
1971,Erik Pieters,NED,DF,Stoke City,Premier League,28,1988,30.2,71,47,43,26,2,24,51,47.1,27,70,25,45,61,132,127,5,Matches
1972,Tomás Pina Isla,ESP,MF,Alavés,La Liga,29,1987,26.5,71,49,27,38,6,20,40,50.0,20,28,10,18,43,114,37,0,Matches
1973,Andrea Pinamonti,ITA,FW,Inter,Serie A,18,1999,0.2,0,0,0,0,0,0,0,,0,0,0,0,0,0,0,0,Matches
1974,Carlo Pinsoglio,ITA,GK,Juventus,Serie A,27,1990,0.3,0,0,0,0,0,0,0,,0,0,0,0,0,0,0,0,Matches
1975,Gerard Piqué,ESP,DF,Barcelona,La Liga,30,1987,29.2,31,22,22,9,0,16,36,44.4,20,40,27,13,30,61,127,0,Matches
1976,Facundo Píriz,URU,MF,Montpellier,Ligue 1,27,1990,9.0,25,16,9,12,4,6,35,17.1,29,10,1,9,18,43,14,0,Matches
1977,Fabio Pisacane,ITA,DF,Cagliari,Serie A,31,1986,21.4,52,39,36,13,3,15,41,36.6,26,29,16,13,38,90,105,1,Matches
1978,Łukasz Piszczek,POL,DF,Dortmund,Bundesliga,32,1985,23.8,51,37,23,23,5,30,52,57.7,22,39,11,28,42,93,64,1,Matches
1979,Claudio Pizarro,PER,"FW,MF",Köln,Bundesliga,38,1978,6.4,11,9,3,6,2,6,9,66.7,3,10,2,8,3,14,5,0,Matches
1980,Guido Pizarro,ARG,MF,Sevilla,La Liga,27,1990,19.5,75,47,36,36,3,29,67,43.3,38,20,7,13,26,101,48,0,Matches
1981,Marko Pjaca,CRO,"FW,MF",Schalke 04,Bundesliga,22,1995,2.9,5,3,2,3,0,4,6,66.7,2,3,0,3,1,6,2,0,Matches
1982,Miralem Pjanić,BIH,MF,Juventus,Serie A,27,1990,27.6,36,30,13,18,5,13,51,25.5,38,25,5,20,64,100,27,2,Matches
1983,Carles Planas,ESP,DF,Girona,La Liga,26,1991,2.1,5,2,4,1,0,3,6,50.0,3,1,0,1,5,10,6,0,Matches
1984,Jaroslav Plašil,CZE,MF,Bordeaux,Ligue 1,35,1982,11.6,24,14,7,17,0,7,31,22.6,24,18,6,12,21,45,15,0,Matches
1985,Marvin Plattenhardt,GER,DF,Hertha BSC,Bundesliga,25,1992,33.0,57,43,39,15,3,35,50,70.0,15,24,7,17,27,84,92,0,Matches
1986,Alassane Pléa,FRA,FW,Nice,Ligue 1,24,1993,33.8,15,9,5,7,3,5,32,15.6,27,14,3,11,8,23,21,0,Matches
1987,Morgan Poaty,CGO,DF,Montpellier,Ligue 1,20,1997,1.9,0,0,0,0,0,0,1,0.0,1,5,3,2,1,1,2,0,Matches
1988,Gerónimo Poblete,ARG,MF,Metz,Ligue 1,24,1993,18.4,58,37,23,29,6,25,66,37.9,41,19,0,19,24,82,22,1,Matches
1989,Florentin Pogba,GUI,DF,Saint-Étienne,Ligue 1,26,1990,3.6,6,0,4,2,0,3,5,60.0,2,2,2,0,1,7,12,0,Matches
1990,Paul Pogba,FRA,MF,Manchester Utd,Premier League,24,1993,23.9,33,23,13,15,5,5,33,15.2,28,16,0,16,21,54,26,0,Matches
1991,Joel Pohjanpalo,FIN,"MF,FW",Leverkusen,Bundesliga,22,1994,1.3,0,0,0,0,0,0,2,0.0,2,1,1,0,0,0,2,0,Matches
1992,Eugen Polanski,POL,MF,Hoffenheim,Bundesliga,31,1986,2.9,8,7,3,4,1,5,6,83.3,1,6,1,5,4,12,4,0,Matches
1993,Andrea Poli,ITA,MF,Bologna,Serie A,27,1989,28.3,66,53,33,27,6,18,64,28.1,46,55,3,52,43,109,27,0,Matches
1994,Matteo Politano,ITA,FW,Sassuolo,Serie A,23,1993,31.2,23,16,8,10,5,3,32,9.4,29,13,2,11,14,37,13,0,Matches
1995,Julian Pollersbeck,GER,GK,Hamburger SV,Bundesliga,22,1994,10.0,0,0,0,0,0,0,1,0.0,1,0,0,0,0,0,4,1,Matches
1996,Ezequiel Ponce,ARG,FW,Lille,Ligue 1,20,1997,12.2,9,8,3,5,1,0,7,0.0,7,2,1,1,3,12,11,0,Matches
1997,Pere Pons,ESP,MF,Girona,La Liga,24,1993,28.4,80,54,28,48,4,23,87,26.4,64,28,3,25,30,110,25,0,Matches
1998,Simone Pontisso,ITA,MF,Udinese,Serie A,20,1997,0.1,1,0,0,1,0,0,0,,0,0,0,0,0,1,0,0,Matches
1999,Nick Pope,ENG,GK,Burnley,Premier League,25,1992,34.6,0,0,0,0,0,0,1,0.0,1,0,0,0,0,0,21,0,Matches
2000,Jérémie Porsan-Clémenté,FRA,DF,Montpellier,Ligue 1,19,1997,1.0,3,2,1,2,0,2,2,100.0,0,1,0,1,1,4,4,1,Matches
2001,Francisco Portillo,ESP,"MF,FW",Getafe,La Liga,27,1990,27.3,38,23,15,18,5,11,45,24.4,34,25,1,24,22,60,21,0,Matches
2002,Portu,ESP,MF,Girona,La Liga,25,1992,33.3,30,24,9,11,10,8,33,24.2,25,14,0,14,12,42,1,0,Matches
2003,Stefan Posch,AUT,DF,Hoffenheim,Bundesliga,20,1997,8.4,28,21,18,7,3,15,27,55.6,12,15,4,11,24,52,30,0,Matches
2004,Sergio Postigo,ESP,DF,Levante,La Liga,28,1988,26.9,36,23,30,5,1,18,32,56.3,14,27,13,14,40,76,140,1,Matches
2005,Yussuf Poulsen,DEN,FW,RB Leipzig,Bundesliga,23,1994,18.5,23,19,2,13,8,7,12,58.3,5,24,5,19,9,32,8,0,Matches
2006,Maxime Poundjé,FRA,DF,Bordeaux,Ligue 1,24,1992,18.9,53,29,32,16,5,28,51,54.9,23,14,6,8,35,88,63,1,Matches
2007,Darío Poveda,ESP,MF,Villarreal,La Liga,20,1997,0.0,1,0,0,1,0,1,1,100.0,0,0,0,0,0,1,0,0,Matches
2008,Dennis Praet,BEL,MF,Sampdoria,Serie A,23,1994,29.5,85,57,34,36,15,38,73,52.1,35,49,1,48,37,122,22,0,Matches
2009,Sanjin Prcić,BIH,MF,Rennes,Ligue 1,23,1993,17.4,37,18,9,24,4,8,39,20.5,31,19,5,14,30,67,25,0,Matches
2010,Nicolas de Préville,FRA,FW,Bordeaux,Ligue 1,26,1991,21.5,34,27,10,15,9,9,33,27.3,24,25,4,21,21,55,12,0,Matches
2011,Nicolas de Préville,FRA,"FW,MF",Lille,Ligue 1,26,1991,3.2,3,3,0,1,2,1,5,20.0,4,3,0,3,0,3,2,0,Matches
2012,Andrés Prieto,ESP,GK,Málaga,La Liga,23,1993,4.0,0,0,0,0,0,0,0,,0,0,0,0,0,0,2,0,Matches
2013,Xabi Prieto,ESP,"MF,FW",Real Sociedad,La Liga,33,1983,21.4,18,14,5,9,4,2,10,20.0,8,8,2,6,7,25,20,0,Matches
2014,Jérôme Prior,FRA,GK,Bordeaux,Ligue 1,21,1995,2.0,0,0,0,0,0,0,0,,0,0,0,0,0,0,2,2,Matches
2015,Alex Pritchard,ENG,"MF,FW",Huddersfield,Premier League,24,1993,11.1,18,8,2,6,10,10,21,47.6,11,6,1,5,5,23,11,0,Matches
2016,Sloan Privat,FRA,FW,Guingamp,Ligue 1,28,1989,0.0,0,0,0,0,0,0,0,,0,0,0,0,0,0,0,0,Matches
2017,Sebastian Prödl,AUT,DF,Watford,Premier League,30,1987,17.4,22,17,19,3,0,8,15,53.3,7,20,9,11,31,53,92,1,Matches
2018,Davy Pröpper,NED,MF,Brighton,Premier League,25,1991,34.7,73,44,35,35,3,18,83,21.7,65,35,11,24,60,133,80,2,Matches
2019,Manuel Pucciarelli,ITA,"FW,MF",Chievo,Serie A,26,1991,15.3,23,14,3,11,9,8,21,38.1,13,15,0,15,7,30,4,0,Matches
2020,Christian Puggioni,ITA,GK,Benevento,Serie A,36,1981,13.1,0,0,0,0,0,0,0,,0,0,0,0,0,0,5,1,Matches
2021,Christian Puggioni,ITA,GK,Sampdoria,Serie A,36,1981,9.0,0,0,0,0,0,0,0,,0,0,0,0,0,0,6,1,Matches
2022,Marc Pugh,ENG,"MF,FW",Bournemouth,Premier League,30,1987,10.9,7,3,2,4,1,2,10,20.0,8,6,1,5,13,20,13,2,Matches
2023,Erick Pulgar,CHI,MF,Bologna,Serie A,23,1994,30.8,70,48,41,29,0,24,75,32.0,51,49,13,36,46,116,83,1,Matches
2024,Christian Pulisic,USA,"FW,DF",Dortmund,Bundesliga,18,1998,25.6,46,30,12,20,14,26,44,59.1,18,24,2,22,16,62,11,0,Matches
2025,Jason Puncheon,ENG,MF,Crystal Palace,Premier League,31,1986,7.2,13,4,3,7,3,1,5,20.0,4,3,0,3,5,18,4,0,Matches
2026,George Pușcaș,ROU,"FW,MF",Benevento,Serie A,21,1996,7.8,0,0,0,0,0,0,3,0.0,3,0,0,0,1,1,13,0,Matches
2027,Loïc Puyo,FRA,MF,Angers,Ligue 1,28,1988,1.9,9,5,2,5,2,3,4,75.0,1,7,3,4,4,13,2,0,Matches
2028,Fabio Quagliarella,ITA,FW,Sampdoria,Serie A,34,1983,30.2,11,9,1,3,7,2,25,8.0,23,34,0,34,7,18,23,0,Matches
2029,Robin Quaison,SWE,FW,Mainz 05,Bundesliga,23,1993,15.7,17,14,1,10,6,7,11,63.6,4,16,2,14,7,24,9,0,Matches
2030,Collin Quaner,GER,"FW,MF",Huddersfield,Premier League,26,1991,14.2,22,15,8,8,6,9,26,34.6,17,24,4,20,11,33,15,0,Matches
2031,Dani Raba,ESP,"MF,FW",Villarreal,La Liga,21,1995,12.3,25,21,9,12,4,9,45,20.0,36,21,1,20,17,42,10,0,Matches
2032,Adrien Rabiot,FRA,MF,Paris S-G,Ligue 1,22,1995,26.2,59,36,27,23,9,15,36,41.7,21,29,10,19,33,92,22,1,Matches
2033,Nemanja Radoja,SRB,MF,Celta Vigo,La Liga,24,1993,12.3,18,16,6,8,4,3,8,37.5,5,8,2,6,10,28,11,0,Matches
2034,Ivan Radovanović,SRB,MF,Chievo,Serie A,28,1988,34.9,55,35,30,22,3,18,48,37.5,30,39,16,23,47,102,107,1,Matches
2035,Ștefan Radu,ROU,DF,Lazio,Serie A,30,1986,28.8,53,38,36,16,1,25,41,61.0,16,30,14,16,55,108,105,1,Matches
2036,Rafael,BRA,GK,Cagliari,Serie A,35,1982,8.8,0,0,0,0,0,0,0,,0,0,0,0,1,1,9,0,Matches
2037,Rafael,BRA,DF,Lyon,Ligue 1,27,1990,20.1,54,28,30,18,6,22,43,51.2,21,20,3,17,42,96,53,0,Matches
2038,Raffael,BRA,FW,Gladbach,Bundesliga,32,1985,23.0,40,32,12,23,5,17,36,47.2,19,18,0,18,8,48,2,0,Matches
2039,Rafinha,BRA,MF,Inter,Serie A,24,1993,11.6,14,9,1,10,3,3,16,18.8,13,15,0,15,7,21,9,0,Matches
2040,Rafinha,BRA,DF,Bayern Munich,Bundesliga,31,1985,20.6,39,33,24,11,4,28,47,59.6,19,17,6,11,32,71,30,0,Matches
2041,Andrea Raggi,ITA,DF,Monaco,Ligue 1,33,1984,17.9,20,10,15,4,1,10,27,37.0,17,12,6,6,31,51,66,0,Matches
2042,Antonino Ragusa,ITA,"FW,MF",Sassuolo,Serie A,27,1990,9.2,17,7,11,4,2,8,23,34.8,15,12,1,11,6,23,16,0,Matches
2043,Baba Rahman,GHA,DF,Schalke 04,Bundesliga,23,1994,0.4,1,0,0,1,0,0,0,,0,2,0,2,2,3,1,0,Matches
2044,Ivan Rakitić,CRO,MF,Barcelona,La Liga,29,1988,31.5,52,31,16,30,6,15,45,33.3,30,42,7,35,44,96,16,0,Matches
2045,André Ramalho,BRA,"DF,FW",Leverkusen,Bundesliga,25,1992,0.4,3,1,2,1,0,2,2,100.0,0,1,0,1,1,4,1,0,Matches
2046,Jonás Ramalho,ESP,DF,Girona,La Liga,24,1993,25.5,25,16,20,5,0,15,24,62.5,9,25,11,14,35,60,115,0,Matches
2047,Adil Rami,FRA,DF,Marseille,Ligue 1,31,1985,32.8,39,29,22,15,2,22,41,53.7,19,25,19,6,45,84,163,3,Matches
2048,Benito Ramírez,ESP,"FW,DF",Las Palmas,La Liga,22,1995,1.8,6,3,2,3,1,1,5,20.0,4,0,0,0,2,8,3,0,Matches
2049,Gastón Ramírez,URU,MF,Sampdoria,Serie A,26,1990,24.6,33,20,4,15,14,9,56,16.1,47,30,3,27,18,51,24,0,Matches
2050,Sandro Ramírez,ESP,"FW,MF",Everton,Premier League,22,1995,3.1,2,1,0,1,1,0,3,0.0,3,1,0,1,1,3,0,0,Matches
2051,Sandro Ramírez,ESP,"FW,MF",Sevilla,La Liga,22,1995,8.0,8,8,1,5,2,1,7,14.3,6,2,0,2,4,12,2,0,Matches
2052,Toño Ramírez,ESP,GK,Real Sociedad,La Liga,30,1986,3.5,0,0,0,0,0,0,1,0.0,1,0,0,0,0,0,1,3,Matches
2053,Iván Ramis,ESP,DF,Eibar,La Liga,32,1984,14.5,20,14,8,12,0,8,19,42.1,11,12,5,7,25,45,51,2,Matches
2054,Omar Ramos,ESP,"FW,MF",Leganés,La Liga,29,1988,16.1,22,14,6,8,8,9,22,40.9,13,16,1,15,14,36,15,0,Matches
2055,Sergio Ramos,ESP,DF,Real Madrid,La Liga,31,1986,25.4,40,29,22,18,0,19,28,67.9,9,22,12,10,47,87,91,0,Matches
2056,Aaron Ramsey,WAL,MF,Arsenal,Premier League,26,1990,20.5,35,27,18,17,0,8,44,18.2,36,14,3,11,24,59,6,1,Matches
2057,Àngel Rangel,ESP,DF,Swansea City,Premier League,34,1982,1.7,4,3,2,2,0,1,3,33.3,2,0,0,0,3,7,4,0,Matches
2058,Andrea Ranocchia,ITA,DF,Inter,Serie A,29,1988,7.0,8,4,6,2,0,3,6,50.0,3,6,5,1,12,20,35,0,Matches
2059,Marcus Rashford,ENG,"FW,MF",Manchester Utd,Premier League,19,1997,20.1,14,11,4,5,5,6,18,33.3,12,18,0,18,8,22,19,0,Matches
2060,Milot Rashica,KVX,"FW,MF",Werder Bremen,Bundesliga,21,1996,4.3,2,2,1,1,0,1,8,12.5,7,3,0,3,3,5,4,0,Matches
2061,Konstantin Rausch,RUS,DF,Köln,Bundesliga,27,1990,10.3,21,16,13,7,1,11,26,42.3,15,9,2,7,17,38,25,0,Matches
2062,Yoric Ravet,FRA,"FW,MF",Freiburg,Bundesliga,27,1989,5.5,9,7,3,6,0,3,7,42.9,4,7,0,7,3,12,6,0,Matches
2063,Ante Rebić,CRO,FW,Eint Frankfurt,Bundesliga,23,1993,19.5,37,29,7,21,9,7,24,29.2,17,27,2,25,6,43,13,0,Matches
2064,Pedro Rebocho,POR,DF,Guingamp,Ligue 1,22,1995,19.1,29,22,18,8,3,12,28,42.9,16,20,6,14,19,48,76,0,Matches
2065,Recio,ESP,MF,Málaga,La Liga,26,1991,20.4,54,42,26,23,5,17,62,27.4,45,15,3,12,30,84,17,0,Matches
2066,Nathan Redmond,ENG,"FW,MF",Southampton,Premier League,23,1994,21.6,32,17,16,14,2,12,31,38.7,19,20,0,20,15,47,17,2,Matches
2067,Alberto Redondo,ESP,DF,Getafe,La Liga,20,1997,1.0,4,3,4,0,0,2,4,50.0,2,2,1,1,0,4,1,0,Matches
2068,Fabian Reese,GER,"FW,MF",Schalke 04,Bundesliga,19,1997,0.8,2,2,1,1,0,1,2,50.0,1,1,0,1,2,4,1,0,Matches
2069,Vasco Regini,ITA,DF,Sampdoria,Serie A,26,1990,12.0,13,7,11,0,2,6,11,54.5,5,14,7,7,11,24,68,0,Matches
2070,Xesc Regis,ESP,FW,Eibar,La Liga,20,1996,0.0,1,1,0,1,0,0,0,,0,0,0,0,0,1,0,0,Matches
2071,Winston Reid,NZL,DF,West Ham,Premier League,29,1988,16.1,11,9,7,4,0,4,15,26.7,11,27,14,13,22,33,104,0,Matches
2072,Pepe Reina,ESP,GK,Napoli,Serie A,34,1982,37.0,1,0,1,0,0,1,2,50.0,1,0,0,0,0,1,13,2,Matches
2073,Jeff Reine-Adélaïde,FRA,MF,Angers,Ligue 1,19,1998,4.9,13,8,7,5,1,6,17,35.3,11,7,2,5,1,14,9,0,Matches
2074,Karim Rekik,NED,DF,Hertha BSC,Bundesliga,22,1994,25.6,38,29,32,6,0,24,26,92.3,2,27,11,16,28,66,116,2,Matches
2075,Loïc Rémy,FRA,FW,Las Palmas,La Liga,30,1987,8.5,4,3,1,3,0,0,1,0.0,1,0,0,0,1,5,2,0,Matches
2076,Loïc Rémy,FRA,"FW,MF",Getafe,La Liga,30,1987,5.1,4,2,1,3,0,1,5,20.0,4,4,0,4,1,5,2,0,Matches
2077,Jan Repas,SVN,"MF,FW",Caen,Ligue 1,20,1997,10.0,14,11,5,5,4,4,18,22.2,14,10,0,10,7,21,3,0,Matches
2078,Panagiotis Retsos,GRE,DF,Leverkusen,Bundesliga,18,1998,19.1,48,40,32,14,2,33,46,71.7,13,29,8,21,29,77,47,0,Matches
2079,Marco Reus,GER,"MF,FW",Dortmund,Bundesliga,28,1989,10.3,16,8,2,12,2,5,12,41.7,7,16,3,13,4,20,9,0,Matches
2080,Elvis Rexhbeçaj,GER,"DF,MF",Wolfsburg,Bundesliga,19,1997,1.4,4,2,1,2,1,1,1,100.0,0,3,0,3,2,6,3,0,Matches
2081,Baptiste Reynet,FRA,GK,Dijon,Ligue 1,26,1990,38.0,6,4,5,1,0,5,7,71.4,2,2,0,2,2,8,35,1,Matches
2082,Franck Ribéry,FRA,"FW,MF",Bayern Munich,Bundesliga,34,1983,13.4,19,16,9,5,5,13,17,76.5,4,11,0,11,7,26,3,0,Matches
2083,Federico Ricca,URU,DF,Málaga,La Liga,22,1994,12.3,43,24,32,9,2,23,33,69.7,10,10,2,8,24,67,46,0,Matches
2084,Federico Ricci,ITA,FW,Crotone,Serie A,23,1994,10.2,25,18,9,10,6,9,28,32.1,19,14,0,14,11,36,5,0,Matches
2085,Federico Ricci,ITA,MF,Genoa,Serie A,23,1994,2.4,2,2,2,0,0,1,3,33.3,2,2,0,2,1,3,1,0,Matches
2086,Declan Rice,ENG,"DF,MF",West Ham,Premier League,18,1999,15.9,36,24,25,10,1,15,25,60.0,10,19,13,6,27,63,77,1,Matches
2087,Richarlison,BRA,"FW,MF",Watford,Premier League,20,1997,31.4,64,44,26,28,10,10,39,25.6,29,39,5,34,24,88,32,1,Matches
2088,Marco Richter,GER,FW,Augsburg,Bundesliga,19,1997,7.2,17,14,8,8,1,8,17,47.1,9,5,1,4,1,18,10,0,Matches
2089,Diego Rico,ESP,DF,Leganés,La Liga,24,1993,24.8,68,43,37,21,10,36,53,67.9,17,30,6,24,76,144,61,0,Matches
2090,Mikel Rico,ESP,MF,Athletic Club,La Liga,32,1984,13.0,24,13,7,16,1,12,34,35.3,22,15,5,10,23,47,12,1,Matches
2091,Sergio Rico,ESP,GK,Sevilla,La Liga,23,1993,24.0,1,1,1,0,0,0,2,0.0,2,0,0,0,1,2,5,3,Matches
2092,Jaïro Riedewald,NED,"MF,DF",Crystal Palace,Premier League,20,1996,4.9,11,8,6,4,1,0,2,0.0,2,7,1,6,12,23,13,0,Matches
2093,Asier Riesgo,ESP,GK,Eibar,La Liga,33,1983,1.0,0,0,0,0,0,0,0,,0,0,0,0,0,0,0,0,Matches
2094,Luca Rigoni,ITA,MF,Genoa,Serie A,32,1984,17.5,32,22,11,20,1,7,35,20.0,28,24,2,22,19,51,13,0,Matches
2095,Nicola Rigoni,ITA,MF,Chievo,Serie A,26,1990,10.4,29,20,15,12,2,9,26,34.6,17,8,3,5,11,40,22,1,Matches
2096,Kévin Rimane,GUF,DF,Paris S-G,Ligue 1,26,1991,0.1,0,0,0,0,0,0,0,,0,0,0,0,0,0,0,0,Matches
2097,Tomás Rincón,VEN,MF,Torino,Serie A,29,1988,33.3,66,40,30,34,2,24,66,36.4,42,33,8,25,57,123,61,1,Matches
2098,Birk Risa,NOR,FW,Köln,Bundesliga,19,1998,0.9,1,1,0,1,0,0,3,0.0,3,2,1,1,0,1,0,0,Matches
2099,Marcel Risse,GER,"DF,MF",Köln,Bundesliga,27,1989,13.0,21,14,17,4,0,11,19,57.9,8,21,3,18,6,27,10,2,Matches
2100,Matt Ritchie,SCO,"MF,FW",Newcastle Utd,Premier League,27,1989,31.2,46,32,22,18,6,14,53,26.4,39,37,5,32,35,81,63,1,Matches
2101,Cristian Rivera,ESP,MF,Eibar,La Liga,20,1997,2.7,13,10,4,8,1,5,7,71.4,2,2,2,0,3,16,2,0,Matches
2102,Emmanuel Rivière,FRA,FW,Metz,Ligue 1,27,1990,22.3,10,3,1,6,3,1,12,8.3,11,8,0,8,2,12,5,0,Matches
2103,Jonathan Rivierez,MTQ,DF,Metz,Ligue 1,28,1989,22.9,81,59,50,26,5,41,80,51.3,39,21,7,14,39,120,73,0,Matches
2104,Luca Rizzo,ITA,MF,SPAL,Serie A,25,1992,5.4,18,10,7,10,1,5,17,29.4,12,10,0,10,3,21,5,1,Matches
2105,Arjen Robben,NED,"FW,MF",Bayern Munich,Bundesliga,33,1984,16.7,14,11,1,7,6,4,12,33.3,8,9,0,9,4,18,4,0,Matches
2106,Rober,ESP,"DF,MF",Levante,La Liga,22,1995,21.2,35,22,27,8,0,17,32,53.1,15,29,18,11,41,76,75,1,Matches
2107,Roberto,ESP,GK,Málaga,La Liga,31,1986,34.0,0,0,0,0,0,0,0,,0,0,0,0,2,2,15,0,Matches
2108,Sergi Roberto,ESP,DF,Barcelona,La Liga,25,1992,24.7,63,40,30,25,8,25,49,51.0,24,18,8,10,39,102,30,1,Matches
2109,Connor Roberts,WAL,DF,Swansea City,Premier League,21,1995,3.0,6,4,5,1,0,3,3,100.0,0,2,0,2,3,9,6,0,Matches
2110,Andrew Robertson,SCO,DF,Liverpool,Premier League,23,1994,21.6,31,17,19,9,3,15,29,51.7,14,22,2,20,26,57,56,0,Matches
2111,Álex Robles,ESP,DF,Málaga,La Liga,18,1999,1.0,2,1,1,1,0,0,0,,0,1,0,1,3,5,4,0,Matches
2112,Hal Robson-Kanu,WAL,"FW,MF",West Brom,Premier League,28,1989,9.2,5,4,1,2,2,0,13,0.0,13,9,3,6,4,9,9,0,Matches
2113,Marc Roca,ESP,MF,Espanyol,La Liga,20,1996,2.9,8,7,3,5,0,3,4,75.0,1,4,2,2,4,12,10,0,Matches
2114,Rubén Rochina,ESP,"MF,DF",Levante,La Liga,26,1991,1.7,8,5,5,2,1,4,6,66.7,2,0,0,0,2,10,0,0,Matches
2115,Ronny Rodelin,FRA,"FW,MF",Caen,Ligue 1,27,1989,35.1,33,22,7,18,8,8,42,19.0,34,21,2,19,28,61,41,1,Matches
2116,Rodri,ESP,MF,Villarreal,La Liga,21,1996,35.9,104,71,50,48,6,30,86,34.9,56,49,21,28,52,156,100,1,Matches
2117,Rodrigo,ESP,FW,Valencia,La Liga,26,1991,29.8,23,13,9,12,2,3,21,14.3,18,14,2,12,17,40,11,1,Matches
2118,Kévin Rodrigues,POR,DF,Real Sociedad,La Liga,23,1994,18.2,44,32,18,20,6,19,34,55.9,15,22,6,16,27,71,39,0,Matches
2119,Ángel Rodríguez,ESP,FW,Getafe,La Liga,30,1987,25.5,28,19,3,19,6,3,26,11.5,23,18,3,15,6,34,14,0,Matches
2120,Iván Rodríguez,ESP,DF,Málaga,La Liga,21,1996,0.2,1,1,0,1,0,0,0,,0,0,0,0,1,2,1,0,Matches
2121,James Rodríguez,COL,"MF,FW",Bayern Munich,Bundesliga,26,1991,18.0,35,27,10,15,10,15,30,50.0,15,16,1,15,12,47,4,0,Matches
2122,Jay Rodriguez,ENG,"FW,MF",West Brom,Premier League,28,1989,31.2,31,21,12,11,8,9,50,18.0,41,32,2,30,19,50,41,0,Matches
2123,Ricardo Rodríguez,SUI,DF,Milan,Serie A,24,1992,33.4,48,29,24,18,6,18,28,64.3,10,36,6,30,33,81,93,3,Matches
2124,Marko Rog,CRO,"MF,FW",Napoli,Serie A,22,1995,3.2,11,7,3,6,2,1,11,9.1,10,4,1,3,2,13,1,0,Matches
2125,Rogério,BRA,DF,Sassuolo,Serie A,19,1998,10.1,18,14,10,5,3,7,15,46.7,8,11,1,10,9,27,31,0,Matches
2126,Marcus Rohdén,SWE,MF,Crotone,Serie A,26,1991,18.1,33,19,21,10,2,14,50,28.0,36,14,1,13,18,51,30,0,Matches
2127,Marcos Rojo,ARG,DF,Manchester Utd,Premier League,27,1990,7.1,7,5,6,0,1,1,8,12.5,7,11,6,5,7,14,56,2,Matches
2128,Diego Rolán,URU,"FW,MF",Málaga,La Liga,24,1993,21.6,33,25,7,13,13,9,44,20.5,35,18,1,17,12,45,9,0,Matches
2129,Rolando,POR,DF,Marseille,Ligue 1,31,1985,27.9,44,29,28,15,1,23,40,57.5,17,22,14,8,37,81,126,0,Matches
2130,Esteban Rolón,ARG,MF,Málaga,La Liga,22,1995,4.6,6,4,4,2,0,2,4,50.0,2,7,1,6,9,15,8,1,Matches
2131,Filippo Romagna,ITA,DF,Cagliari,Serie A,20,1997,21.0,33,18,20,12,1,16,26,61.5,10,20,11,9,33,66,96,0,Matches
2132,Alessio Romagnoli,ITA,DF,Milan,Serie A,22,1995,26.1,20,14,17,2,1,9,14,64.3,5,24,14,10,23,43,154,1,Matches
2133,Simone Romagnoli,ITA,DF,Bologna,Serie A,27,1990,6.2,12,9,10,2,0,4,9,44.4,5,12,8,4,7,19,41,2,Matches
2134,Aristóteles Romero,VEN,"MF,FW",Crotone,Serie A,21,1995,1.0,11,7,7,4,0,3,5,60.0,2,3,0,3,5,16,0,0,Matches
2135,Óscar Romero,PAR,"MF,FW",Alavés,La Liga,25,1992,2.8,5,2,4,1,0,0,3,0.0,3,3,0,3,3,8,2,0,Matches
2136,Sergio Romero,ARG,GK,Manchester Utd,Premier League,30,1987,1.0,0,0,0,0,0,0,0,,0,0,0,0,0,0,0,0,Matches
2137,Oriol Romeu,ESP,MF,Southampton,Premier League,25,1991,32.2,93,64,41,44,8,32,100,32.0,68,59,19,40,69,162,77,2,Matches
2138,Rômulo,ITA,"MF,DF",Hellas Verona,Serie A,30,1987,35.2,58,44,23,29,6,13,54,24.1,41,29,2,27,43,101,41,0,Matches
2139,Cristiano Ronaldo,POR,FW,Real Madrid,La Liga,32,1985,25.4,7,4,3,3,1,1,6,16.7,5,10,3,7,6,13,14,0,Matches
2140,Facundo Roncaglia,ARG,DF,Celta Vigo,La Liga,30,1987,16.6,35,25,30,5,0,22,36,61.1,14,18,6,12,31,66,50,1,Matches
2141,Salomón Rondón,VEN,FW,West Brom,Premier League,27,1989,30.7,14,6,0,7,7,5,26,19.2,21,27,0,27,14,28,20,0,Matches
2142,Valentin Rongier,FRA,MF,Nantes,Ligue 1,22,1994,26.1,73,49,25,39,9,17,64,26.6,47,42,6,36,40,113,13,1,Matches
2143,Marten de Roon,NED,MF,Atalanta,Serie A,26,1991,28.6,77,50,27,44,6,29,82,35.4,53,40,5,35,46,123,36,0,Matches
2144,Wayne Rooney,ENG,"MF,FW",Everton,Premier League,31,1985,25.2,28,19,11,13,4,10,42,23.8,32,25,6,19,16,44,43,2,Matches
2145,Roberto Rosales,VEN,DF,Málaga,La Liga,28,1988,34.7,104,69,52,40,12,50,84,59.5,34,37,13,24,58,162,104,1,Matches
2146,Danny Rose,ENG,DF,Tottenham,Premier League,27,1990,8.9,15,11,6,7,2,8,15,53.3,7,12,6,6,9,24,15,0,Matches
2147,Liam Rosenior,ENG,DF,Brighton,Premier League,33,1984,1.8,4,3,2,1,1,2,5,40.0,3,2,1,1,4,8,7,0,Matches
2148,Aleandro Rosi,ITA,DF,Genoa,Serie A,30,1987,18.9,24,17,7,13,4,5,19,26.3,14,24,5,19,20,44,61,1,Matches
2149,Valentin Rosier,FRA,DF,Dijon,Ligue 1,20,1996,30.9,73,54,47,23,3,26,68,38.2,42,43,9,34,58,131,124,0,Matches
2150,Luca Rossettini,ITA,DF,Genoa,Serie A,32,1985,22.5,16,8,12,3,1,6,17,35.3,11,31,21,10,29,45,151,1,Matches
2151,Francesco Rossi,ITA,GK,Atalanta,Serie A,26,1991,0.1,0,0,0,0,0,0,0,,0,0,0,0,0,0,0,0,Matches
2152,Giuseppe Rossi,ITA,"FW,MF",Genoa,Serie A,30,1987,2.9,1,1,0,1,0,0,3,0.0,3,2,0,2,1,2,1,0,Matches
2153,Jérôme Roussillon,FRA,DF,Montpellier,Ligue 1,24,1993,20.9,40,27,17,19,4,15,26,57.7,11,26,3,23,15,55,52,0,Matches
2154,Wayne Routledge,ENG,"MF,FW",Swansea City,Premier League,32,1985,4.8,10,5,2,6,2,2,8,25.0,6,5,0,5,2,12,5,0,Matches
2155,Nolan Roux,FRA,"FW,MF",Metz,Ligue 1,29,1988,31.5,24,17,8,10,6,7,38,18.4,31,32,2,30,25,49,22,0,Matches
2156,Rubén,ESP,GK,La Coruña,La Liga,33,1984,27.5,1,0,1,0,0,1,3,33.3,2,0,0,0,1,2,5,4,Matches
2157,Antonio Rüdiger,GER,DF,Chelsea,Premier League,24,1993,26.0,31,21,20,10,1,15,31,48.4,16,29,15,14,24,55,115,1,Matches
2158,Sebastian Rudy,GER,MF,Bayern Munich,Bundesliga,27,1990,16.8,50,40,12,33,5,28,55,50.9,27,11,1,10,18,68,7,1,Matches
2159,Stéphane Ruffier,FRA,GK,Saint-Étienne,Ligue 1,30,1986,34.6,0,0,0,0,0,0,0,,0,0,0,0,0,0,14,1,Matches
2160,Vincent Rüfli,SUI,"DF,FW",Dijon,Ligue 1,29,1988,0.3,4,1,3,1,0,3,3,100.0,0,1,0,1,1,5,0,0,Matches
2161,Daniele Rugani,ITA,DF,Juventus,Serie A,23,1994,21.5,18,12,11,5,2,7,13,53.8,6,18,14,4,20,38,87,1,Matches
2162,Mário Rui,POR,DF,Napoli,Serie A,26,1991,23.2,55,39,18,32,5,30,52,57.7,22,30,5,25,14,69,43,1,Matches
2163,Aitor Ruibal,ESP,MF,Betis,La Liga,21,1996,0.1,0,0,0,0,0,0,0,,0,0,0,0,0,0,0,0,Matches
2164,Fabián Ruiz Peña,ESP,MF,Betis,La Liga,21,1996,29.5,83,53,34,40,9,26,73,35.6,47,35,3,32,42,125,36,1,Matches
2165,Víctor Ruiz,ESP,DF,Villarreal,La Liga,28,1989,26.8,33,22,29,4,0,13,25,52.0,12,27,18,9,58,91,134,1,Matches
2166,Antonio Rukavina,SRB,DF,Villarreal,La Liga,33,1984,14.1,25,22,12,9,4,17,25,68.0,8,11,3,8,16,41,68,0,Matches
2167,Gerónimo Rulli,ARG,GK,Real Sociedad,La Liga,25,1992,26.0,2,1,2,0,0,2,6,33.3,4,0,0,0,0,2,10,2,Matches
2168,Lukas Rupp,GER,"MF,FW",Hoffenheim,Bundesliga,26,1991,12.9,36,32,18,14,4,19,36,52.8,17,18,0,18,13,49,13,2,Matches
2169,Marco Russ,GER,DF,Eint Frankfurt,Bundesliga,31,1985,12.7,17,11,9,8,0,13,19,68.4,6,23,11,12,24,41,66,0,Matches
2170,Mathew Ryan,AUS,GK,Brighton,Premier League,25,1992,38.0,0,0,0,0,0,0,3,0.0,3,0,0,0,3,3,10,3,Matches
2171,Idriss Saadi,ALG,FW,Strasbourg,Ligue 1,25,1992,10.5,6,5,2,3,1,2,11,18.2,9,3,2,1,5,11,1,0,Matches
2172,Youssouf Sabaly,SEN,DF,Bordeaux,Ligue 1,24,1993,34.4,93,61,54,34,5,43,68,63.2,25,26,6,20,54,147,104,0,Matches
2173,Abdelhamid Sabiri,MAR,MF,Huddersfield,Premier League,20,1996,2.4,5,4,2,0,3,1,7,14.3,6,4,0,4,1,6,2,0,Matches
2174,Marcel Sabitzer,AUT,"MF,FW",RB Leipzig,Bundesliga,23,1994,19.9,38,28,12,20,6,23,49,46.9,26,23,2,21,24,62,21,1,Matches
2175,Enric Saborit,ESP,DF,Athletic Club,La Liga,25,1992,15.9,50,27,31,17,2,19,29,65.5,10,17,5,12,24,74,55,0,Matches
2176,Ihsan Sacko,FRA,"FW,MF",Nice,Ligue 1,20,1997,2.9,1,1,0,1,0,0,1,0.0,1,1,0,1,2,3,1,0,Matches
2177,Ihsan Sacko,FRA,"FW,MF",Strasbourg,Ligue 1,20,1997,7.9,10,8,6,0,4,2,10,20.0,8,2,0,2,5,15,6,0,Matches
2178,Mujaid Sadick,ESP,DF,La Coruña,La Liga,17,2000,1.2,4,2,2,2,0,2,3,66.7,1,3,2,1,1,5,4,0,Matches
2179,Armando Sadiku,ALB,FW,Levante,La Liga,26,1991,3.0,1,1,0,1,0,0,1,0.0,1,4,2,2,2,3,2,0,Matches
2180,Umar Sadiq,NGA,FW,Torino,Serie A,20,1997,2.5,0,0,0,0,0,0,3,0.0,3,1,0,1,1,1,2,0,Matches
2181,Bacary Sagna,FRA,DF,Benevento,Serie A,34,1983,10.6,9,7,5,3,1,1,7,14.3,6,9,2,7,20,29,28,0,Matches
2182,Adrián Sahibeddine,FRA,"FW,MF",Dijon,Ligue 1,22,1994,0.4,0,0,0,0,0,0,1,0.0,1,1,0,1,0,0,0,0,Matches
2183,Nuri Şahin,TUR,MF,Dortmund,Bundesliga,28,1988,13.6,40,34,9,28,3,15,39,38.5,24,12,0,12,20,60,29,1,Matches
2184,Wesley Saïd,FRA,"FW,MF",Dijon,Ligue 1,22,1995,20.4,33,22,17,11,5,7,26,26.9,19,15,1,14,15,48,4,0,Matches
2185,Allan Saint-Maximin,FRA,"FW,MF",Nice,Ligue 1,20,1997,25.0,18,14,13,2,3,12,28,42.9,16,12,1,11,11,29,10,0,Matches
2186,Allan Saint-Maximin,FRA,MF,Monaco,Ligue 1,20,1997,0.2,0,0,0,0,0,0,0,,0,0,0,0,0,0,0,0,Matches
2187,Henri Saivet,SEN,MF,Newcastle Utd,Premier League,26,1990,0.9,5,3,4,1,0,2,5,40.0,3,0,0,0,4,9,8,1,Matches
2188,Gōtoku Sakai,JPN,"DF,MF",Hamburger SV,Bundesliga,26,1991,25.4,50,40,25,18,7,22,47,46.8,25,40,12,28,44,94,55,0,Matches
2189,Hiroki Sakai,JPN,DF,Marseille,Ligue 1,27,1990,28.0,66,45,30,30,6,32,49,65.3,17,32,7,25,45,111,90,1,Matches
2190,Diafra Sakho,SEN,FW,West Ham,Premier League,27,1989,3.4,5,2,1,4,0,0,3,0.0,3,3,0,3,1,6,2,0,Matches
2191,Diafra Sakho,SEN,FW,Rennes,Ligue 1,27,1989,8.6,5,4,1,2,2,0,7,0.0,7,4,0,4,2,7,11,0,Matches
2192,Mamadou Sakho,FRA,DF,Crystal Palace,Premier League,27,1990,17.8,21,14,15,5,1,9,16,56.3,7,19,11,8,30,51,101,3,Matches
2193,Bakary Sako,MLI,"FW,MF",Crystal Palace,Premier League,29,1988,5.3,7,6,5,0,2,2,9,22.2,7,2,0,2,1,8,2,0,Matches
2194,Emiliano Sala,ARG,FW,Nantes,Ligue 1,26,1990,33.7,19,11,3,9,7,5,33,15.2,28,27,3,24,9,28,50,0,Matches
2195,Jacopo Sala,ITA,DF,Sampdoria,Serie A,25,1991,11.0,17,10,12,4,1,4,10,40.0,6,9,1,8,8,25,28,2,Matches
2196,Mohamed Salah,EGY,FW,Liverpool,Premier League,25,1992,32.3,12,6,2,5,5,3,23,13.0,20,10,0,10,5,17,5,0,Matches
2197,Bartosz Salamon,POL,DF,SPAL,Serie A,26,1991,19.2,28,22,21,7,0,12,21,57.1,9,24,18,6,58,86,148,0,Matches
2198,Carlos Salcedo,MEX,DF,Eint Frankfurt,Bundesliga,23,1993,17.9,26,22,16,9,1,19,29,65.5,10,28,12,16,21,47,94,1,Matches
2199,Eddie Salcedo,ITA,FW,Genoa,Serie A,15,2001,0.4,0,0,0,0,0,0,0,,0,0,0,0,0,0,0,0,Matches
2200,Yannis Salibur,FRA,"FW,MF",Guingamp,Ligue 1,26,1991,16.9,11,9,4,6,1,4,15,26.7,11,7,1,6,7,18,2,0,Matches
2201,Sejad Salihović,BIH,MF,Hamburger SV,Bundesliga,32,1984,4.1,7,5,3,3,1,0,3,0.0,3,5,0,5,5,12,1,0,Matches
2202,Yoann Salmier,GUF,DF,Strasbourg,Ligue 1,24,1992,12.3,15,13,10,5,0,5,12,41.7,7,11,6,5,26,41,62,1,Matches
2203,Mamadou Samassa,MLI,GK,Troyes,Ligue 1,27,1990,21.0,0,0,0,0,0,0,2,0.0,2,0,0,0,0,0,12,3,Matches
2204,Brice Samba,FRA,GK,Caen,Ligue 1,23,1994,3.5,0,0,0,0,0,0,0,,0,0,0,0,0,0,2,0,Matches
2205,Junior Sambia,FRA,MF,Montpellier,Ligue 1,20,1996,17.1,21,12,6,11,4,6,28,21.4,22,16,0,16,20,41,18,0,Matches
2206,Frédéric Sammaritano,FRA,"FW,MF",Dijon,Ligue 1,31,1986,15.9,29,25,17,9,3,10,36,27.8,26,14,0,14,5,34,15,0,Matches
2207,Sergi Samper,ESP,MF,Las Palmas,La Liga,22,1995,1.6,10,4,4,6,0,2,3,66.7,1,0,0,0,0,10,0,0,Matches
2208,Jairo Samperio,ESP,"FW,MF",Las Palmas,La Liga,24,1993,6.2,9,6,2,6,1,3,13,23.1,10,5,1,4,1,10,5,0,Matches
2209,Jairo Samperio,ESP,"MF,FW",Mainz 05,Bundesliga,24,1993,0.4,1,1,0,1,0,1,1,100.0,0,0,0,0,0,1,0,0,Matches
2210,Mario Sampirisi,ITA,DF,Crotone,Serie A,24,1992,24.4,44,32,29,12,3,13,22,59.1,9,27,14,13,43,87,116,2,Matches
2211,Mikel San José,ESP,MF,Athletic Club,La Liga,28,1989,23.9,52,37,19,23,10,19,73,26.0,54,43,13,30,41,93,30,0,Matches
2212,Antonio Sanabria,PAR,FW,Betis,La Liga,21,1996,9.5,8,8,0,4,4,0,3,0.0,3,5,0,5,4,12,6,0,Matches
2213,Renato Sanches,POR,MF,Swansea City,Premier League,19,1997,7.8,12,7,6,6,0,6,18,33.3,12,9,1,8,7,19,5,1,Matches
2214,Alexis Sánchez,CHI,"MF,FW",Arsenal,Premier League,28,1988,16.7,20,9,9,4,7,7,32,21.9,25,5,2,3,6,26,1,0,Matches
2215,Alexis Sánchez,CHI,"FW,MF",Manchester Utd,Premier League,28,1988,11.6,21,17,10,4,7,4,27,14.8,23,8,0,8,17,38,0,0,Matches
2216,Carlos Sánchez,COL,"MF,DF",Fiorentina,Serie A,31,1986,4.1,7,6,2,5,0,4,6,66.7,2,3,1,2,8,15,10,0,Matches
2217,Carlos Sánchez,COL,MF,Espanyol,La Liga,31,1986,12.5,25,12,6,16,3,9,24,37.5,15,13,5,8,18,43,24,2,Matches
2218,Davinson Sánchez,COL,DF,Tottenham,Premier League,21,1996,28.2,38,24,28,9,1,18,40,45.0,22,26,10,16,38,76,162,0,Matches
2219,Sergio Sánchez,ESP,DF,Espanyol,La Liga,31,1986,1.1,4,3,4,0,0,3,4,75.0,1,1,0,1,3,7,3,0,Matches
2220,Víctor Sánchez,ESP,"MF,DF",Espanyol,La Liga,29,1987,27.3,106,72,56,45,5,49,113,43.4,64,38,14,24,79,185,73,1,Matches
2221,Jadon Sancho,ENG,FW,Dortmund,Bundesliga,17,2000,7.7,5,5,2,2,1,2,7,28.6,5,8,0,8,5,10,2,0,Matches
2222,Sandro,BRA,MF,Benevento,Serie A,28,1989,12.8,29,21,15,13,1,12,18,66.7,6,23,16,7,18,47,43,1,Matches
2223,Alex Sandro,BRA,DF,Juventus,Serie A,26,1991,23.5,57,31,33,17,7,20,39,51.3,19,21,1,20,30,87,45,0,Matches
2224,Arona Sané,SEN,"MF,FW",Atlético Madrid,La Liga,22,1995,0.7,1,0,1,0,0,0,0,,0,1,0,1,0,1,0,0,Matches
2225,Lamine Sané,SEN,DF,Werder Bremen,Bundesliga,30,1987,8.7,19,14,15,4,0,8,10,80.0,2,8,6,2,20,39,49,1,Matches
2226,Leroy Sané,GER,FW,Manchester City,Premier League,21,1996,26.9,27,21,14,7,6,8,22,36.4,14,22,1,21,13,40,6,0,Matches
2227,Salif Sané,SEN,DF,Hannover 96,Bundesliga,26,1990,32.0,57,43,46,10,1,40,64,62.5,24,49,29,20,57,114,238,6,Matches
2228,Ibrahim Sangaré,CIV,MF,Toulouse,Ligue 1,19,1997,17.6,72,47,35,34,3,29,69,42.0,40,33,7,26,24,96,19,1,Matches
2229,Younousse Sankharé,SEN,MF,Bordeaux,Ligue 1,27,1989,20.9,33,23,10,20,3,4,34,11.8,30,15,4,11,21,54,7,0,Matches
2230,Baissama Sankoh,GUI,"MF,DF",Caen,Ligue 1,25,1992,17.1,27,19,8,18,1,8,28,28.6,20,20,8,12,25,52,64,1,Matches
2231,Siriki Sanogo,CIV,MF,Benevento,Serie A,15,2001,0.4,1,1,0,1,0,0,0,,0,0,0,0,1,2,1,0,Matches
2232,Yaya Sanogo,FRA,FW,Toulouse,Ligue 1,24,1993,16.8,11,6,1,5,5,3,11,27.3,8,6,1,5,6,17,14,1,Matches
2233,Morgan Sanson,FRA,MF,Marseille,Ligue 1,22,1994,24.1,64,40,13,34,17,21,71,29.6,50,30,0,30,25,89,5,1,Matches
2234,Nicola Sansone,ITA,"FW,MF",Villarreal,La Liga,25,1991,7.1,8,4,2,4,2,2,17,11.8,15,1,0,1,1,9,2,0,Matches
2235,Baptiste Santamaria,FRA,MF,Angers,Ligue 1,22,1995,28.8,59,40,25,29,5,23,83,27.7,60,39,8,31,43,102,48,2,Matches
2236,Ivan Santini,CRO,FW,Caen,Ligue 1,28,1989,30.9,19,12,5,8,6,4,29,13.8,25,13,5,8,4,23,33,0,Matches
2237,Davide Santon,ITA,DF,Inter,Serie A,26,1991,9.3,19,14,13,6,0,9,17,52.9,8,10,3,7,20,39,32,2,Matches
2238,Christian Santos,VEN,FW,Alavés,La Liga,29,1988,4.8,2,0,1,0,1,0,4,0.0,4,2,1,1,2,4,9,0,Matches
2239,Douglas Santos,BRA,DF,Hamburger SV,Bundesliga,23,1994,26.4,90,60,53,34,3,50,87,57.5,37,63,2,61,56,146,96,1,Matches
2240,Samir Santos,BRA,DF,Udinese,Serie A,22,1994,28.5,55,38,35,17,3,19,38,50.0,19,33,16,17,75,130,161,1,Matches
2241,Antonio Santurro,DOM,GK,Bologna,Serie A,25,1992,1.0,0,0,0,0,0,0,0,,0,0,0,0,0,0,1,0,Matches
2242,Riccardo Saponara,ITA,"MF,FW",Fiorentina,Serie A,25,1991,10.0,12,8,2,8,2,2,11,18.2,9,3,1,2,1,13,5,0,Matches
2243,Pablo Sarabia,ESP,"FW,MF",Sevilla,La Liga,25,1992,26.6,27,19,10,13,4,11,49,22.4,38,39,1,38,30,57,34,1,Matches
2244,Yusuf Sari,TUR,FW,Marseille,Ligue 1,18,1998,0.0,0,0,0,0,0,0,0,,0,0,0,0,0,0,0,0,Matches
2245,Bouna Sarr,SEN,"DF,FW",Marseille,Ligue 1,25,1992,19.9,65,42,42,20,3,22,38,57.9,16,20,4,16,32,97,53,2,Matches
2246,Ismaila Sarr,SEN,"FW,MF",Rennes,Ligue 1,19,1998,20.6,20,10,5,10,5,7,29,24.1,22,17,0,17,9,29,3,1,Matches
2247,Malang Sarr,FRA,DF,Nice,Ligue 1,18,1999,14.7,24,18,17,7,0,8,18,44.4,10,14,6,8,31,55,44,2,Matches
2248,Imanol Sarriegi,ESP,"MF,FW",Eibar,La Liga,22,1995,0.5,2,2,1,0,1,2,3,66.7,1,2,0,2,1,3,0,0,Matches
2249,Marco Sau,ITA,"FW,MF",Cagliari,Serie A,29,1987,14.6,9,6,2,4,3,1,17,5.9,16,10,0,10,9,18,1,0,Matches
2250,Stefan Savić,MNE,DF,Atlético Madrid,La Liga,26,1991,25.5,30,20,23,7,0,16,39,41.0,23,38,23,15,45,75,150,1,Matches
2251,Gianluca Scamacca,ITA,"FW,MF",Sassuolo,Serie A,18,1999,0.3,0,0,0,0,0,0,0,,0,1,0,1,0,0,0,0,Matches
2252,Fabian Schär,SUI,DF,La Coruña,La Liga,25,1991,24.7,59,45,45,14,0,32,61,52.5,29,36,20,16,45,104,141,1,Matches
2253,Ezequiel Schelotto,ITA,DF,Brighton,Premier League,28,1989,14.6,20,13,14,6,0,12,27,44.4,15,7,3,4,19,39,58,2,Matches
2254,Pasquale Schiattarella,ITA,MF,SPAL,Serie A,30,1987,22.1,40,31,20,15,5,13,43,30.2,30,7,2,5,24,64,26,0,Matches
2255,Eros Schiavon,ITA,"MF,DF",SPAL,Serie A,34,1983,4.3,6,5,2,3,1,1,7,14.3,6,6,2,4,2,8,4,0,Matches
2256,Patrik Schick,CZE,"FW,MF",Roma,Serie A,21,1996,11.0,9,7,1,5,3,1,9,11.1,8,14,0,14,2,11,11,0,Matches
2257,Julian Schieber,GER,"MF,FW",Hertha BSC,Bundesliga,28,1989,0.6,1,1,0,0,1,1,1,100.0,0,1,0,1,0,1,2,0,Matches
2258,Christopher Schindler,GER,DF,Huddersfield,Premier League,27,1990,36.3,83,61,56,27,0,24,41,58.5,17,54,30,24,75,158,275,1,Matches
2259,Sven Schipplock,GER,"FW,MF",Hamburger SV,Bundesliga,28,1988,3.8,7,6,1,5,1,0,1,0.0,1,4,0,4,1,8,3,0,Matches
2260,Jeffrey Schlupp,GHA,"DF,MF",Crystal Palace,Premier League,24,1992,19.4,57,36,35,20,2,23,43,53.5,20,34,8,26,24,81,67,0,Matches
2261,Kasper Schmeichel,DEN,GK,Leicester City,Premier League,30,1986,32.9,1,0,1,0,0,1,3,33.3,2,1,0,1,0,1,18,5,Matches
2262,Marcel Schmelzer,GER,DF,Dortmund,Bundesliga,29,1988,16.6,35,27,21,12,2,20,30,66.7,10,27,6,21,30,65,57,1,Matches
2263,Jonathan Schmid,FRA,"DF,FW",Augsburg,Bundesliga,27,1990,16.4,23,16,6,13,4,11,18,61.1,7,16,1,15,10,33,35,1,Matches
2264,Manuel Schmiedebach,GER,MF,Hannover 96,Bundesliga,28,1988,1.8,5,5,5,0,0,4,9,44.4,5,2,0,2,5,10,6,0,Matches
2265,Benno Schmitz,GER,DF,RB Leipzig,Bundesliga,22,1994,0.9,3,2,2,1,0,2,3,66.7,1,0,0,0,0,3,1,0,Matches
2266,Morgan Schneiderlin,FRA,MF,Everton,Premier League,27,1989,23.7,58,40,34,21,3,15,44,34.1,29,18,7,11,61,119,59,1,Matches
2267,Alessandro Schöpf,AUT,"DF,FW",Schalke 04,Bundesliga,23,1994,9.0,22,17,10,9,3,11,23,47.8,12,16,0,16,15,37,13,1,Matches
2268,Nico Schulz,GER,"FW,MF",Hoffenheim,Bundesliga,24,1993,19.8,40,29,17,14,9,20,27,74.1,7,33,5,28,23,63,24,0,Matches
2269,André Schürrle,GER,FW,Dortmund,Bundesliga,26,1990,13.7,22,19,8,7,7,9,18,50.0,9,13,1,12,7,29,7,1,Matches
2270,Julian Schuster,GER,"DF,MF",Freiburg,Bundesliga,32,1985,14.5,14,10,6,7,1,6,11,54.5,5,17,10,7,19,33,56,0,Matches
2271,Pirmin Schwegler,SUI,MF,Hannover 96,Bundesliga,30,1987,25.8,81,57,25,55,1,42,70,60.0,28,33,9,24,49,130,46,1,Matches
2272,Alexander Schwolow,GER,GK,Freiburg,Bundesliga,25,1992,32.3,0,0,0,0,0,0,1,0.0,1,0,0,0,0,0,9,1,Matches
2273,Simone Scuffet,ITA,GK,Udinese,Serie A,21,1996,6.0,0,0,0,0,0,0,0,,0,0,0,0,1,1,1,1,Matches
2274,Sergio Segura García,ESP,DF,Leganés,La Liga,21,1995,0.3,,2,,,,,,,,,,,1,,,,Matches
2275,Ernest Seka,GUI,DF,Strasbourg,Ligue 1,30,1987,24.2,60,47,41,14,5,40,61,65.6,21,25,8,17,51,111,98,1,Matches
2276,Vahid Selimović,LUX,DF,Metz,Ligue 1,20,1997,11.7,20,14,10,9,1,11,14,78.6,3,10,8,2,17,37,58,1,Matches
2277,Davie Selke,GER,FW,Hertha BSC,Bundesliga,22,1995,21.0,13,10,1,5,7,4,9,44.4,5,26,5,21,2,15,20,1,Matches
2278,Ole Selnæs,NOR,MF,Saint-Étienne,Ligue 1,23,1994,22.9,73,45,29,42,2,18,61,29.5,43,37,15,22,34,107,53,1,Matches
2279,Nélson Semedo,POR,DF,Barcelona,La Liga,23,1993,16.6,34,25,19,11,4,17,29,58.6,12,16,2,14,22,56,26,1,Matches
2280,Rúben Semedo,POR,"DF,MF",Villarreal,La Liga,23,1994,2.6,6,5,6,0,0,4,6,66.7,2,5,1,4,5,11,13,2,Matches
2281,Stefano Sensi,ITA,MF,Sassuolo,Serie A,21,1995,11.6,17,13,11,6,0,9,22,40.9,13,16,3,13,22,39,10,1,Matches
2282,Luigi Sepe,ITA,GK,Napoli,Serie A,26,1991,1.0,0,0,0,0,0,0,0,,0,0,0,0,0,0,1,0,Matches
2283,Suat Serdar,GER,MF,Mainz 05,Bundesliga,20,1997,18.9,59,47,21,26,12,27,64,42.2,37,38,3,35,21,80,17,1,Matches
2284,Jean Seri,CIV,MF,Nice,Ligue 1,26,1991,29.1,25,14,9,12,4,9,56,16.1,47,16,4,12,26,51,15,4,Matches
2285,Julien Serrano,FRA,DF,Monaco,Ligue 1,19,1998,3.1,2,2,1,0,1,1,2,50.0,1,2,0,2,4,6,14,0,Matches
2286,Grégory Sertic,FRA,"DF,MF",Marseille,Ligue 1,27,1989,3.9,5,3,3,2,0,2,6,33.3,4,8,7,1,6,11,23,0,Matches
2287,Stéphane Sessègnon,BEN,"MF,FW",Montpellier,Ligue 1,33,1984,10.9,4,4,2,2,0,1,7,14.3,6,0,0,0,0,4,2,0,Matches
2288,Lee Seung-woo,KOR,"MF,FW",Hellas Verona,Serie A,19,1998,4.0,3,2,0,1,2,0,6,0.0,6,1,0,1,2,5,0,0,Matches
2289,Stephan El Shaarawy,ITA,FW,Roma,Serie A,24,1992,23.9,22,16,9,8,5,5,21,23.8,16,16,1,15,24,46,8,0,Matches
2290,Meritan Shabani,ALB,FW,Bayern Munich,Bundesliga,18,1999,0.6,2,1,1,0,1,1,2,50.0,1,1,0,1,0,2,0,1,Matches
2291,Xherdan Shaqiri,SUI,"MF,FW",Stoke City,Premier League,25,1991,33.8,25,17,9,11,5,10,39,25.6,29,9,1,8,16,41,6,2,Matches
2292,Luke Shaw,ENG,DF,Manchester Utd,Premier League,22,1995,8.8,18,15,10,7,1,11,18,61.1,7,16,2,14,4,22,22,1,Matches
2293,Ryan Shawcross,ENG,DF,Stoke City,Premier League,29,1987,26.3,36,20,25,9,2,13,25,52.0,12,33,23,10,40,76,224,1,Matches
2294,Jonjo Shelvey,ENG,MF,Newcastle Utd,Premier League,25,1992,25.2,39,24,17,21,1,8,26,30.8,18,26,5,21,28,67,33,0,Matches
2295,Gaku Shibasaki,JPN,"MF,FW",Getafe,La Liga,25,1992,11.1,21,10,8,10,3,6,21,28.6,15,6,1,5,19,40,9,0,Matches
2296,Djibril Sidibé,FRA,DF,Monaco,Ligue 1,25,1992,23.9,59,39,24,27,8,23,45,51.1,22,20,4,16,46,105,52,1,Matches
2297,Sidnei,BRA,DF,La Coruña,La Liga,27,1989,19.8,41,28,30,11,0,18,25,72.0,7,26,9,17,31,72,101,1,Matches
2298,Jaime Sierra Mateos,ESP,"FW,MF",Leganés,La Liga,19,1998,0.3,1,1,1,0,0,0,1,0.0,1,0,0,0,1,2,0,0,Matches
2299,Vincent Sierro,SUI,"MF,FW",Freiburg,Bundesliga,21,1995,2.4,8,6,2,6,0,4,9,44.4,5,2,1,1,4,12,0,0,Matches
2300,Gylfi Sigurðsson,ISL,"MF,FW",Everton,Premier League,27,1989,25.1,38,26,15,14,9,16,57,28.1,41,37,7,30,34,72,36,0,Matches
2301,Kolbeinn Sigþórsson,ISL,FW,Nantes,Ligue 1,27,1990,0.3,0,0,0,0,0,0,0,,0,0,0,0,1,1,0,0,Matches
2302,Adrien Silva,POR,MF,Leicester City,Premier League,28,1989,8.5,22,13,8,13,1,6,28,21.4,22,12,2,10,14,36,0,0,Matches
2303,André Silva,POR,FW,Milan,Serie A,21,1995,10.4,5,4,1,0,4,2,7,28.6,5,10,1,9,4,9,6,0,Matches
2304,Bernardo Silva,POR,"FW,MF",Manchester City,Premier League,22,1994,17.0,27,18,11,9,7,6,30,20.0,24,17,1,16,10,37,12,1,Matches
2305,David Silva,ESP,MF,Manchester City,Premier League,31,1986,27.0,32,21,11,17,4,9,45,20.0,36,28,5,23,18,50,7,0,Matches
2306,Gabriel Silva,BRA,DF,Saint-Étienne,Ligue 1,26,1991,23.1,28,20,19,4,5,19,31,61.3,12,21,6,15,37,65,83,1,Matches
2307,Jonathan Silva,ARG,DF,Roma,Serie A,23,1994,1.2,0,0,0,0,0,0,1,0.0,1,1,1,0,3,3,1,0,Matches
2308,Thiago Silva,BRA,DF,Paris S-G,Ligue 1,32,1984,23.5,31,23,19,12,0,12,21,57.1,9,28,18,10,18,49,114,0,Matches
2309,Matías Silvestre,ARG,DF,Sampdoria,Serie A,32,1984,34.0,12,8,10,1,1,6,12,50.0,6,33,26,7,11,23,154,3,Matches
2310,Marco Silvestri,ITA,GK,Hellas Verona,Serie A,26,1991,2.0,0,0,0,0,0,0,0,,0,0,0,0,1,1,0,0,Matches
2311,Giovanni Simeone,ARG,FW,Fiorentina,Serie A,22,1995,33.3,32,23,9,17,6,8,40,20.0,32,27,1,26,12,44,32,0,Matches
2312,Lorenco Šimić,CRO,DF,SPAL,Serie A,21,1996,3.5,5,3,5,0,0,3,4,75.0,1,7,4,3,11,16,15,0,Matches
2313,Stefan Simić,CZE,DF,Crotone,Serie A,22,1995,6.2,13,8,11,2,0,10,11,90.9,1,6,3,3,10,23,44,0,Matches
2314,David Simón,ESP,DF,Las Palmas,La Liga,28,1988,8.0,24,17,11,10,3,9,16,56.3,7,13,4,9,22,46,11,1,Matches
2315,Danny Simpson,ENG,DF,Leicester City,Premier League,30,1987,25.6,38,22,31,6,1,22,45,48.9,23,31,19,12,34,72,132,1,Matches
2316,Jack Simpson,ENG,DF,Bournemouth,Premier League,20,1996,0.8,1,1,1,0,0,0,1,0.0,1,1,0,1,0,1,4,0,Matches
2317,Josh Sims,ENG,"FW,MF",Southampton,Premier League,20,1997,1.8,4,3,1,2,1,2,7,28.6,5,5,0,5,1,5,0,0,Matches
2318,Jerome Sinclair,ENG,"MF,FW",Watford,Premier League,20,1996,0.3,0,0,0,0,0,0,1,0.0,1,0,0,0,1,1,0,0,Matches
2319,Giovanni Sio,CIV,FW,Montpellier,Ligue 1,28,1989,24.4,14,8,2,9,3,0,20,0.0,20,11,0,11,6,20,23,1,Matches
2320,Dimitris Siovas,GRE,DF,Leganés,La Liga,28,1988,22.9,48,33,43,5,0,29,46,63.0,17,27,12,15,62,110,89,0,Matches
2321,Tobias Sippel,GER,GK,Gladbach,Bundesliga,29,1988,4.8,1,1,1,0,0,1,2,50.0,1,0,0,0,0,1,5,1,Matches
2322,Salvatore Sirigu,ITA,GK,Torino,Serie A,30,1987,37.0,0,0,0,0,0,0,0,,0,0,0,0,1,1,35,3,Matches
2323,Moussa Sissoko,FRA,"MF,FW",Tottenham,Premier League,27,1989,15.4,23,17,14,5,4,9,12,75.0,3,11,1,10,9,32,23,1,Matches
2324,Pione Sisto,DEN,"FW,MF",Celta Vigo,La Liga,22,1995,28.0,18,12,8,6,4,9,33,27.3,24,12,1,11,12,30,7,1,Matches
2325,Antonio Sivera,ESP,GK,Alavés,La Liga,20,1996,0.7,0,0,0,0,0,0,0,,0,0,0,0,0,0,0,0,Matches
2326,Ellyes Skhiri,TUN,MF,Montpellier,Ligue 1,22,1995,33.9,89,54,34,47,8,37,88,42.0,51,59,10,49,77,166,57,4,Matches
2327,Łukasz Skorupski,POL,GK,Roma,Serie A,26,1991,1.0,0,0,0,0,0,0,0,,0,0,0,0,0,0,1,0,Matches
2328,Milan Škriniar,SVK,DF,Inter,Serie A,22,1995,38.0,86,55,69,16,1,44,70,62.9,26,38,26,12,35,121,180,0,Matches
2329,Islam Slimani,ALG,FW,Leicester City,Premier League,29,1988,2.8,2,2,1,1,0,1,4,25.0,3,2,0,2,0,2,2,0,Matches
2330,Islam Slimani,ALG,FW,Newcastle Utd,Premier League,29,1988,1.5,0,0,0,0,0,0,2,0.0,2,0,0,0,1,1,1,0,Matches
2331,Naïm Sliti,TUN,"FW,MF",Dijon,Ligue 1,25,1992,25.4,47,32,20,17,10,20,52,38.5,32,22,2,20,13,60,7,0,Matches
2332,Chris Smalling,ENG,DF,Manchester Utd,Premier League,27,1989,28.2,40,25,28,12,0,16,28,57.1,12,32,28,4,63,103,162,1,Matches
2333,Adam Smith,ENG,"DF,MF",Bournemouth,Premier League,26,1991,23.0,50,36,33,16,1,24,53,45.3,29,46,8,38,31,81,73,0,Matches
2334,Tommy Smith,ENG,DF,Huddersfield,Premier League,25,1992,21.2,38,27,18,14,6,23,36,63.9,13,22,6,16,26,64,80,3,Matches
2335,Wesley Sneijder,NED,"MF,FW",Nice,Ligue 1,33,1984,4.4,0,0,0,0,0,0,3,0.0,3,1,0,1,2,2,2,1,Matches
2336,Cédric Soares,POR,DF,Southampton,Premier League,25,1991,31.0,54,34,40,10,4,22,31,71.0,9,32,8,24,24,78,109,2,Matches
2337,Ramadan Sobhi,EGY,"MF,FW",Stoke City,Premier League,20,1997,13.8,32,21,17,14,1,11,36,30.6,25,14,0,14,14,46,14,0,Matches
2338,Rubén Sobrino,ESP,"FW,MF",Alavés,La Liga,25,1992,16.3,33,24,12,16,5,6,27,22.2,21,19,2,17,18,51,10,0,Matches
2339,Dominic Solanke,ENG,FW,Liverpool,Premier League,19,1997,6.6,7,4,0,6,1,1,4,25.0,3,5,1,4,2,9,9,0,Matches
2340,Carlos Soler,ESP,MF,Valencia,La Liga,20,1997,26.3,51,32,21,21,9,22,53,41.5,31,25,1,24,5,56,19,0,Matches
2341,Somália,BRA,"MF,FW",Toulouse,Ligue 1,28,1988,22.2,65,45,21,36,8,14,54,25.9,40,34,2,32,34,99,35,0,Matches
2342,Yann Sommer,SUI,GK,Gladbach,Bundesliga,28,1988,29.2,0,0,0,0,0,0,0,,0,0,0,0,3,3,6,3,Matches
2343,Kévin Soni,CMR,MF,Girona,La Liga,19,1998,0.2,1,1,0,1,0,0,0,,0,0,0,0,0,1,0,0,Matches
2344,Jérémy Sorbon,FRA,DF,Guingamp,Ligue 1,33,1983,29.0,32,19,24,7,1,10,32,31.3,22,37,24,13,53,85,152,4,Matches
2345,Oliver Sorg,GER,"DF,MF",Hannover 96,Bundesliga,27,1990,18.7,46,28,27,18,1,23,53,43.4,30,24,7,17,42,88,71,0,Matches
2346,David Soria,ESP,GK,Sevilla,La Liga,24,1993,14.0,1,0,1,0,0,1,1,100.0,0,0,0,0,2,3,13,2,Matches
2347,Roberto Soriano,ITA,"MF,FW",Villarreal,La Liga,26,1991,12.7,30,20,10,16,4,3,16,18.8,13,14,0,14,4,34,9,0,Matches
2348,Stefano Sorrentino,ITA,GK,Chievo,Serie A,38,1979,38.0,0,0,0,0,0,0,0,,0,0,0,0,0,0,23,3,Matches
2349,Pape Souaré,SEN,DF,Crystal Palace,Premier League,27,1990,0.1,0,0,0,0,0,0,0,,0,0,0,0,0,0,0,0,Matches
2350,Rayan Souici,FRA,MF,Saint-Étienne,Ligue 1,19,1998,0.1,0,0,0,0,0,0,0,,0,1,0,1,0,0,0,0,Matches
2351,Adama Soumaoro,FRA,DF,Lille,Ligue 1,25,1992,13.2,9,5,7,2,0,2,3,66.7,1,22,16,6,16,25,50,1,Matches
2352,Boubakary Soumaré,FRA,MF,Lille,Ligue 1,18,1999,5.7,13,9,8,5,0,3,14,21.4,11,8,1,7,7,20,6,1,Matches
2353,Samuel Souprayen,FRA,DF,Hellas Verona,Serie A,28,1989,17.6,29,19,25,3,1,12,19,63.2,7,18,9,9,22,51,67,1,Matches
2354,Arnaud Souquet,FRA,DF,Nice,Ligue 1,25,1992,26.8,89,68,58,26,5,36,56,64.3,20,46,16,30,39,128,72,2,Matches
2355,Çağlar Söyüncü,TUR,DF,Freiburg,Bundesliga,21,1996,23.9,42,26,26,15,1,15,26,57.7,11,30,20,10,54,96,91,2,Matches
2356,Luca Sparandeo,ITA,DF,Benevento,Serie A,17,1999,0.4,0,0,0,0,0,0,1,0.0,1,1,0,1,0,0,0,0,Matches
2357,Julián Speroni,ARG,GK,Crystal Palace,Premier League,38,1979,11.0,0,0,0,0,0,0,0,,0,0,0,0,1,1,4,0,Matches
2358,Leonardo Spinazzola,ITA,DF,Atalanta,Serie A,24,1993,16.7,14,5,9,4,1,7,15,46.7,8,25,6,19,18,32,44,1,Matches
2359,Nicolás Spolli,ARG,DF,Genoa,Serie A,34,1983,20.0,27,21,24,2,1,13,22,59.1,9,26,17,9,36,63,120,2,Matches
2360,Marco Sportiello,ITA,GK,Fiorentina,Serie A,25,1992,35.6,0,0,0,0,0,0,1,0.0,1,0,0,0,1,1,13,4,Matches
2361,Bassem Srarfi,TUN,"FW,MF",Nice,Ligue 1,20,1997,9.7,17,11,6,9,2,4,14,28.6,10,12,0,12,7,24,6,1,Matches
2362,Kostas Stafylidis,GRE,"DF,MF",Stoke City,Premier League,23,1993,3.7,12,6,6,4,2,6,9,66.7,3,7,2,5,5,17,19,0,Matches
2363,Kostas Stafylidis,GRE,"FW,DF",Augsburg,Bundesliga,23,1993,0.4,1,1,1,0,0,0,0,,0,1,0,1,0,1,2,0,Matches
2364,Benjamin Stambouli,FRA,"DF,MF",Schalke 04,Bundesliga,26,1990,24.4,95,75,45,48,2,49,74,66.2,25,39,7,32,64,159,76,1,Matches
2365,Junior Stanislas,ENG,"MF,FW",Bournemouth,Premier League,27,1989,14.3,16,8,8,4,4,7,15,46.7,8,21,6,15,6,22,15,0,Matches
2366,Caleb Stanko,USA,DF,Freiburg,Bundesliga,24,1993,2.1,2,2,1,1,0,1,2,50.0,1,3,0,3,1,3,8,0,Matches
2367,Niklas Stark,GER,"DF,MF",Hertha BSC,Bundesliga,22,1995,24.6,49,31,32,17,0,22,30,73.3,8,39,14,25,34,83,165,0,Matches
2368,Tom Starke,GER,GK,Bayern Munich,Bundesliga,36,1981,2.0,0,0,0,0,0,0,0,,0,0,0,0,0,0,0,0,Matches
2369,Timo Stavitski,FIN,"MF,FW",Caen,Ligue 1,18,1999,4.5,4,3,1,1,2,1,16,6.3,15,7,0,7,3,7,1,0,Matches
2370,Renato Steffen,SUI,"FW,MF",Wolfsburg,Bundesliga,25,1991,7.3,10,9,6,3,1,8,12,66.7,4,6,0,6,5,15,6,0,Matches
2371,Marc Stendera,GER,MF,Eint Frankfurt,Bundesliga,21,1995,4.1,23,20,6,15,2,8,20,40.0,12,10,1,9,8,31,2,0,Matches
2372,Pascal Stenzel,GER,"MF,DF",Freiburg,Bundesliga,21,1996,21.6,62,45,35,25,2,34,57,59.6,23,20,3,17,35,97,51,1,Matches
2373,Dale Stephens,ENG,MF,Brighton,Premier League,28,1989,36.0,104,62,63,39,2,32,114,28.1,82,53,16,37,63,167,69,1,Matches
2374,Jack Stephens,ENG,DF,Southampton,Premier League,23,1994,22.0,29,20,24,5,0,13,25,52.0,12,30,18,12,41,70,108,2,Matches
2375,Mariusz Stępiński,POL,FW,Chievo,Serie A,22,1995,7.9,9,5,4,4,1,2,10,20.0,8,5,1,4,4,13,5,0,Matches
2376,Mariusz Stępiński,POL,FW,Nantes,Ligue 1,22,1995,0.0,0,0,0,0,0,0,0,,0,0,0,0,0,0,0,0,Matches
2377,Raheem Sterling,ENG,FW,Manchester City,Premier League,22,1994,28.7,19,14,7,7,5,3,32,9.4,29,24,0,24,9,28,9,0,Matches
2378,Ognjen Stijepović,MNE,"FW,MF",Sampdoria,Serie A,17,1999,0.1,0,0,0,0,0,0,0,,0,0,0,0,0,0,0,0,Matches
2379,Lars Stindl,GER,"FW,MF",Gladbach,Bundesliga,28,1988,30.3,52,39,11,29,12,14,38,36.8,24,53,4,49,31,83,32,1,Matches
2380,Valentin Stocker,SUI,MF,Hertha BSC,Bundesliga,28,1989,0.6,1,0,0,1,0,0,0,,0,1,0,1,0,1,0,0,Matches
2381,Adrian Stoian,ROU,"MF,FW",Crotone,Serie A,26,1991,23.7,23,19,12,10,1,11,44,25.0,33,29,0,29,25,48,26,0,Matches
2382,John Stones,ENG,DF,Manchester City,Premier League,23,1994,14.5,15,11,11,4,0,4,11,36.4,7,8,5,3,19,34,44,0,Matches
2383,Thomas Strakosha,ALB,GK,Lazio,Serie A,22,1995,38.0,0,0,0,0,0,0,0,,0,0,0,0,2,2,13,4,Matches
2384,Ivan Strinić,CRO,DF,Sampdoria,Serie A,30,1987,13.9,35,24,22,12,1,17,38,44.7,21,21,2,19,22,57,46,2,Matches
2385,Tobias Strobl,GER,MF,Gladbach,Bundesliga,27,1990,1.3,3,1,0,2,1,0,1,0.0,1,2,0,2,6,9,2,0,Matches
2386,Kevin Strootman,NED,MF,Roma,Serie A,27,1990,25.1,57,38,19,24,14,15,46,32.6,31,27,3,24,27,84,21,0,Matches
2387,Jens Stryger Larsen,DEN,DF,Udinese,Serie A,26,1991,28.1,36,27,25,10,1,21,39,53.8,18,35,14,21,31,67,82,2,Matches
2388,Cristhian Stuani,URU,FW,Girona,La Liga,30,1986,30.1,22,14,2,17,3,3,29,10.3,26,10,0,10,5,27,32,0,Matches
2389,Stefano Sturaro,ITA,"MF,DF",Juventus,Serie A,24,1993,6.8,17,11,5,9,3,4,11,36.4,7,9,2,7,5,22,18,1,Matches
2390,Daniel Sturridge,ENG,FW,West Brom,Premier League,27,1989,1.3,0,0,0,0,0,0,0,,0,0,0,0,0,0,0,0,Matches
2391,Daniel Sturridge,ENG,FW,Liverpool,Premier League,27,1989,4.8,0,0,0,0,0,0,1,0.0,1,1,0,1,0,0,1,0,Matches
2392,Damián Suárez,URU,DF,Getafe,La Liga,29,1988,32.0,86,64,54,21,11,44,90,48.9,46,34,8,26,46,132,76,1,Matches
2393,Denis Suárez,ESP,"MF,FW",Barcelona,La Liga,23,1994,6.6,11,9,3,8,0,3,8,37.5,5,7,0,7,2,13,3,0,Matches
2394,Leonardo Suárez,ARG,MF,Villarreal,La Liga,21,1996,0.3,0,0,0,0,0,0,0,,0,0,0,0,0,0,1,0,Matches
2395,Luis Suárez,URU,FW,Barcelona,La Liga,30,1987,32.2,17,10,4,5,8,4,19,21.1,15,4,3,1,8,25,31,0,Matches
2396,Danijel Subašić,CRO,GK,Monaco,Ligue 1,32,1984,32.7,0,0,0,0,0,0,2,0.0,2,1,0,1,0,0,13,2,Matches
2397,Neven Subotić,SRB,DF,Saint-Étienne,Ligue 1,28,1988,16.0,23,14,16,7,0,10,27,37.0,17,13,9,4,18,41,96,1,Matches
2398,Neven Subotić,SRB,DF,Dortmund,Bundesliga,28,1988,3.0,9,9,5,3,1,6,7,85.7,1,6,2,4,5,14,16,0,Matches
2399,Isaac Success,NGA,"MF,FW",Málaga,La Liga,21,1996,5.5,9,7,4,4,1,3,8,37.5,5,2,0,2,5,14,0,0,Matches
2400,Niklas Süle,GER,DF,Bayern Munich,Bundesliga,21,1995,21.4,34,25,25,7,2,24,31,77.4,7,24,16,8,33,67,58,0,Matches
2401,Ki Sung-yueng,KOR,MF,Swansea City,Premier League,28,1989,20.8,25,18,10,13,2,4,16,25.0,12,16,1,15,32,57,23,0,Matches
2402,Gilles Sunu,TOG,"MF,FW",Angers,Ligue 1,26,1991,7.3,4,4,1,3,0,0,4,0.0,4,7,0,7,3,7,3,0,Matches
2403,Andrew Surman,ENG,MF,Bournemouth,Premier League,30,1986,20.6,16,12,5,8,3,6,23,26.1,17,33,12,21,16,32,52,2,Matches
2404,Markel Susaeta,ESP,"FW,MF",Athletic Club,La Liga,29,1987,25.2,42,29,16,15,11,16,65,24.6,49,17,0,17,18,60,13,0,Matches
2405,Suso,ESP,"FW,MF",Milan,Serie A,23,1993,31.4,18,14,3,5,10,4,31,12.9,27,25,0,25,16,34,2,1,Matches
2406,Markus Suttner,AUT,DF,Brighton,Premier League,30,1987,13.1,25,15,18,4,3,10,22,45.5,12,16,2,14,12,37,49,1,Matches
2407,Seydou Sy,SEN,GK,Monaco,Ligue 1,21,1995,2.8,0,0,0,0,0,0,0,,0,0,0,0,0,0,2,0,Matches
2408,Issiaga Sylla,GUI,"DF,FW",Toulouse,Ligue 1,23,1994,17.8,44,32,22,16,6,19,47,40.4,28,31,4,27,34,78,65,1,Matches
2409,Moussa Sylla,MLI,FW,Monaco,Ligue 1,17,1999,3.4,0,0,0,0,0,0,2,0.0,2,2,0,2,0,0,1,0,Matches
2410,Ádám Szalai,HUN,FW,Hoffenheim,Bundesliga,29,1987,10.0,8,7,1,4,3,2,5,40.0,3,9,2,7,0,8,10,0,Matches
2411,Wojciech Szczęsny,POL,GK,Juventus,Serie A,27,1990,17.0,0,0,0,0,0,0,0,,0,0,0,0,0,0,4,0,Matches
2412,Alexander Søderlund,NOR,FW,Saint-Étienne,Ligue 1,29,1987,4.0,1,1,1,0,0,0,2,0.0,2,1,0,1,2,3,2,0,Matches
2413,Frederik Sørensen,DEN,DF,Köln,Bundesliga,25,1992,22.2,56,45,40,14,2,30,41,73.2,11,35,17,18,37,93,130,3,Matches
2414,Lasse Sørensen,DEN,MF,Stoke City,Premier League,17,1999,0.8,2,2,2,0,0,1,5,20.0,4,2,0,2,0,2,3,0,Matches
2415,Alexander Sørloth,NOR,FW,Crystal Palace,Premier League,21,1995,4.0,6,3,1,4,1,4,12,33.3,8,5,0,5,2,8,5,0,Matches
2416,Adel Taarabt,MAR,"FW,MF",Genoa,Serie A,28,1989,17.9,18,11,5,11,2,7,16,43.8,9,13,3,10,12,30,7,0,Matches
2417,Franck Tabanou,FRA,DF,Guingamp,Ligue 1,28,1989,11.6,23,17,17,5,1,10,26,38.5,16,5,3,2,26,49,48,0,Matches
2418,Dušan Tadić,SRB,"MF,FW",Southampton,Premier League,28,1988,31.0,46,29,16,22,8,11,35,31.4,24,38,2,36,19,65,29,1,Matches
2419,Jonathan Tah,GER,DF,Leverkusen,Bundesliga,21,1996,27.0,47,34,35,12,0,30,38,78.9,8,22,13,9,34,81,112,2,Matches
2420,Ervin Taha,FRA,FW,Bordeaux,Ligue 1,18,1999,0.4,1,1,0,1,0,0,1,0.0,1,0,0,0,0,1,0,0,Matches
2421,Mehdi Tahrat,ALG,MF,Angers,Ligue 1,27,1990,4.9,7,6,4,3,0,2,5,40.0,3,3,1,2,9,16,15,1,Matches
2422,Saphir Taïder,ALG,MF,Bologna,Serie A,25,1992,4.3,6,2,4,2,0,1,2,50.0,1,3,2,1,1,7,4,0,Matches
2423,Flavien Tait,FRA,MF,Angers,Ligue 1,24,1993,24.8,50,36,26,18,6,18,78,23.1,60,43,4,39,20,70,17,1,Matches
2424,Adrien Tameze,CMR,MF,Nice,Ligue 1,23,1994,18.7,58,36,32,21,5,26,47,55.3,21,26,5,21,41,99,22,1,Matches
2425,Tana,ESP,"MF,FW",Las Palmas,La Liga,26,1990,17.2,31,24,13,14,4,12,36,33.3,24,8,0,8,23,54,5,0,Matches
2426,Oussama Tannane,MAR,FW,Las Palmas,La Liga,23,1994,6.4,15,13,6,8,1,7,12,58.3,5,5,0,5,5,20,0,0,Matches
2427,Oussama Tannane,MAR,FW,Saint-Étienne,Ligue 1,23,1994,2.3,12,6,4,5,3,2,5,40.0,3,2,0,2,3,15,2,0,Matches
2428,Matt Targett,ENG,DF,Southampton,Premier League,21,1995,1.8,6,3,5,0,1,1,3,33.3,2,3,2,1,3,9,7,1,Matches
2429,James Tarkowski,ENG,DF,Burnley,Premier League,24,1992,31.0,46,26,36,10,0,17,38,44.7,21,55,43,12,50,96,223,2,Matches
2430,Ciprian Tătărușanu,ROU,GK,Nantes,Ligue 1,31,1986,37.0,1,0,1,0,0,1,2,50.0,1,0,0,0,1,2,12,3,Matches
2431,Júlio Tavares,CPV,FW,Dijon,Ligue 1,28,1988,22.8,3,1,1,1,1,1,11,9.1,10,11,6,5,3,6,36,0,Matches
2432,Taleb Tawatha,ISR,"DF,MF",Eint Frankfurt,Bundesliga,25,1992,4.9,12,7,7,5,0,5,9,55.6,4,7,1,6,6,18,18,0,Matches
2433,Charlie Taylor,ENG,DF,Burnley,Premier League,23,1993,10.6,16,4,9,6,1,7,12,58.3,5,13,5,8,15,31,52,0,Matches
2434,Jordan Tell,GLP,"FW,MF",Rennes,Ligue 1,20,1997,1.3,4,4,1,3,0,0,1,0.0,1,0,0,0,1,5,0,0,Matches
2435,Cristian Tello,ESP,"FW,MF",Betis,La Liga,25,1991,18.8,32,24,12,14,6,7,37,18.9,30,19,0,19,16,48,4,1,Matches
2436,Marc-André ter Stegen,GER,GK,Barcelona,La Liga,25,1992,37.0,1,0,1,0,0,1,3,33.3,2,1,0,1,4,5,12,1,Matches
2437,Simon Terodde,GER,FW,Stuttgart,Bundesliga,29,1988,10.6,9,6,1,7,1,2,5,40.0,3,8,2,6,5,14,8,0,Matches
2438,Simon Terodde,GER,FW,Köln,Bundesliga,29,1988,12.9,11,9,3,8,0,4,11,36.4,7,3,0,3,4,15,7,0,Matches
2439,Marco Terrazzino,GER,"MF,FW",Freiburg,Bundesliga,26,1991,16.5,31,24,12,13,6,21,39,53.8,18,16,0,16,9,40,19,0,Matches
2440,Martin Terrier,FRA,"FW,MF",Strasbourg,Ligue 1,20,1997,18.6,42,30,16,23,3,9,28,32.1,19,11,1,10,14,56,6,0,Matches
2441,Kenny Tete,NED,DF,Lyon,Ligue 1,21,1995,17.9,37,25,24,10,3,15,26,57.7,11,20,7,13,29,66,52,0,Matches
2442,Cedric Teuchert,GER,FW,Schalke 04,Bundesliga,20,1997,0.4,0,0,0,0,0,0,0,,0,1,0,1,0,0,0,0,Matches
2443,Florian Thauvin,FRA,FW,Marseille,Ligue 1,24,1993,32.8,44,28,16,20,8,15,46,32.6,31,22,1,21,17,61,20,0,Matches
2444,Kévin Théophile-Catherine,FRA,DF,Saint-Étienne,Ligue 1,27,1989,24.1,36,27,23,13,0,11,24,45.8,13,19,15,4,31,67,113,1,Matches
2445,Cyril Théréau,FRA,"FW,MF",Udinese,Serie A,34,1983,2.0,1,1,1,0,0,1,2,50.0,1,0,0,0,0,1,2,0,Matches
2446,Cyril Théréau,FRA,"FW,MF",Fiorentina,Serie A,34,1983,12.4,11,6,3,6,2,7,19,36.8,12,13,0,13,8,19,9,0,Matches
2447,Vincent Thill,LUX,MF,Metz,Ligue 1,17,2000,0.3,0,0,0,0,0,0,0,,0,0,0,0,0,0,0,0,Matches
2448,Romain Thomas,FRA,DF,Angers,Ligue 1,29,1988,27.4,31,21,16,15,0,14,29,48.3,15,32,19,13,34,65,151,1,Matches
2449,Adrien Thomasson,FRA,"MF,FW",Nantes,Ligue 1,23,1993,28.6,71,52,41,23,7,22,73,30.1,51,58,4,54,18,89,20,0,Matches
2450,Erik Thommy,GER,FW,Augsburg,Bundesliga,22,1994,1.9,6,5,1,3,2,3,8,37.5,5,2,0,2,5,11,0,0,Matches
2451,Erik Thommy,GER,MF,Stuttgart,Bundesliga,22,1994,10.9,19,11,7,7,5,9,17,52.9,8,17,2,15,9,28,8,1,Matches
2452,Marcus Thuram,FRA,FW,Guingamp,Ligue 1,19,1997,21.4,20,15,6,10,4,6,25,24.0,19,14,0,14,5,25,12,0,Matches
2453,Youri Tielemans,BEL,MF,Monaco,Ligue 1,20,1997,17.4,47,24,14,28,5,17,55,30.9,38,24,5,19,34,81,20,1,Matches
2454,David Timor,ESP,"MF,DF",Girona,La Liga,27,1989,10.3,17,10,7,7,3,7,18,38.9,11,10,5,5,20,37,30,1,Matches
2455,Jonathan Tinhan,BEN,"MF,FW",Troyes,Ligue 1,28,1989,0.8,1,0,0,1,0,0,1,0.0,1,1,0,1,1,2,0,0,Matches
2456,Marcel Tisserand,COD,DF,Wolfsburg,Bundesliga,24,1993,13.9,15,10,10,4,1,7,14,50.0,7,18,13,5,31,46,50,0,Matches
2457,Tito,ESP,DF,Leganés,La Liga,32,1985,6.8,8,5,5,3,0,6,18,33.3,12,12,5,7,12,20,16,0,Matches
2458,Ola Toivonen,SWE,"FW,MF",Toulouse,Ligue 1,31,1986,8.9,4,4,1,0,3,0,7,0.0,7,2,0,2,2,6,12,0,Matches
2459,Karl Toko Ekambi,CMR,"FW,MF",Angers,Ligue 1,24,1992,33.8,17,8,2,5,10,5,29,17.2,24,13,0,13,15,32,2,0,Matches
2460,Hernán Toledo,ARG,"FW,MF",Las Palmas,La Liga,21,1996,6.9,5,5,2,2,1,1,11,9.1,10,2,0,2,5,10,5,0,Matches
2461,Corentin Tolisso,FRA,MF,Bayern Munich,Bundesliga,22,1994,17.5,33,22,8,18,7,14,32,43.8,18,13,3,10,16,49,8,0,Matches
2462,Jeremy Toljan,GER,"DF,FW",Hoffenheim,Bundesliga,22,1994,2.0,3,1,1,2,0,2,3,66.7,1,3,0,3,0,3,3,0,Matches
2463,Jeremy Toljan,GER,DF,Dortmund,Bundesliga,22,1994,13.5,29,20,17,11,1,19,32,59.4,13,17,2,15,12,41,45,0,Matches
2464,Rafael Tolói,ITA,DF,Atalanta,Serie A,26,1990,27.2,72,40,34,38,0,35,68,51.5,33,35,14,21,63,135,119,1,Matches
2465,James Tomkins,ENG,DF,Crystal Palace,Premier League,28,1989,26.5,47,26,36,10,1,16,31,51.6,15,24,12,12,63,110,216,1,Matches
2466,Nenad Tomović,SRB,DF,Fiorentina,Serie A,29,1987,1.5,2,1,1,1,0,0,2,0.0,2,0,0,0,3,5,5,1,Matches
2467,Nenad Tomović,SRB,DF,Chievo,Serie A,29,1987,25.6,23,17,17,6,0,10,17,58.8,7,29,21,8,50,73,146,0,Matches
2468,Lorenzo Tonelli,ITA,DF,Napoli,Serie A,27,1990,3.9,7,1,4,3,0,5,9,55.6,4,2,1,1,7,14,10,0,Matches
2469,Aleksandar Tonev,BUL,"FW,MF",Crotone,Serie A,27,1990,4.5,5,3,1,2,2,0,1,0.0,1,4,1,3,1,6,6,0,Matches
2470,Toño,ESP,DF,Levante,La Liga,27,1989,12.0,12,11,11,1,0,5,10,50.0,5,4,0,4,6,18,29,0,Matches
2471,Ömer Toprak,TUR,DF,Dortmund,Bundesliga,28,1989,22.4,36,25,29,6,1,26,29,89.7,3,27,16,11,21,57,104,1,Matches
2472,Vasilis Torosidis,GRE,DF,Bologna,Serie A,32,1985,9.1,8,7,5,2,1,4,9,44.4,5,8,3,5,15,23,42,0,Matches
2473,Emanuele Torrasi,ITA,MF,Milan,Serie A,18,1999,0.1,,,,,,,,,,,,,,,,,Matches
2474,Emanuele Torrasi,ITA,MF,Milan,Serie A,18,1999,0.1,0,0,0,0,0,0,0,,0,0,0,0,0,0,0,0,Matches
2475,Lucas Torreira,URU,MF,Sampdoria,Serie A,21,1996,35.3,101,73,36,57,8,30,77,39.0,47,52,17,35,72,173,36,1,Matches
2476,Daniel Torres,COL,MF,Alavés,La Liga,27,1989,13.5,19,11,14,5,0,7,31,22.6,24,15,7,8,19,38,32,2,Matches
2477,Fernando Torres,ESP,FW,Atlético Madrid,La Liga,33,1984,10.9,11,8,3,7,1,2,6,33.3,4,4,1,3,2,13,9,0,Matches
2478,Ferrán Torres,ESP,MF,Valencia,La Liga,17,2000,3.5,8,7,3,5,0,2,6,33.3,4,1,0,1,3,11,1,0,Matches
2479,Miguel Torres,ESP,DF,Málaga,La Liga,31,1986,7.5,16,13,13,3,0,6,14,42.9,8,9,7,2,13,29,35,0,Matches
2480,Pau Torres,ESP,DF,Villarreal,La Liga,20,1997,0.6,0,0,0,0,0,0,1,0.0,1,1,1,0,0,0,4,0,Matches
2481,Jordan Torunarigha,GER,DF,Hertha BSC,Bundesliga,19,1997,7.4,18,12,16,2,0,7,13,53.8,6,20,13,7,23,41,43,1,Matches
2482,Alin Toșca,ROU,DF,Benevento,Serie A,25,1992,13.0,11,8,7,4,0,6,12,50.0,6,9,4,5,13,24,69,0,Matches
2483,Alin Toșca,ROU,DF,Betis,La Liga,25,1992,4.7,12,9,7,5,0,5,9,55.6,4,7,1,6,5,17,17,1,Matches
2484,Cenk Tosun,TUR,FW,Everton,Premier League,26,1991,11.0,6,3,2,2,2,1,11,9.1,10,9,4,5,1,7,13,0,Matches
2485,Jérémy Toulalan,FRA,DF,Bordeaux,Ligue 1,33,1983,21.0,43,25,35,7,1,17,39,43.6,22,25,16,9,28,71,121,0,Matches
2486,Abdoulaye Touré,GUI,MF,Nantes,Ligue 1,23,1994,31.2,74,52,28,38,8,23,67,34.3,44,40,10,30,62,136,49,1,Matches
2487,Almamy Touré,MLI,DF,Monaco,Ligue 1,21,1996,13.9,51,29,31,13,7,18,30,60.0,12,15,2,13,22,73,61,0,Matches
2488,Thomas Touré,CIV,FW,Bordeaux,Ligue 1,23,1993,0.1,0,0,0,0,0,0,0,,0,0,0,0,1,1,0,0,Matches
2489,Thomas Touré,CIV,MF,Angers,Ligue 1,23,1993,1.4,2,1,0,1,1,0,7,0.0,7,5,0,5,1,3,0,0,Matches
2490,Yaya Touré,CIV,MF,Manchester City,Premier League,34,1983,2.6,2,2,1,0,1,1,1,100.0,0,3,1,2,5,7,4,0,Matches
2491,Lucas Tousart,FRA,MF,Lyon,Ligue 1,20,1997,34.8,98,59,41,55,2,38,98,38.8,60,41,16,25,52,150,79,0,Matches
2492,Andros Townsend,ENG,"FW,MF",Crystal Palace,Premier League,26,1991,34.7,60,34,35,12,13,24,75,32.0,51,49,1,48,35,95,28,0,Matches
2493,Adama Traoré,MLI,"MF,FW",Monaco,Ligue 1,22,1995,2.1,6,4,0,4,2,1,4,25.0,3,3,0,3,3,9,1,0,Matches
2494,Bertrand Traoré,BFA,FW,Lyon,Ligue 1,21,1995,25.4,32,20,7,20,5,10,35,28.6,25,24,3,21,39,71,31,1,Matches
2495,Charles Traore,MLI,DF,Troyes,Ligue 1,25,1992,33.3,60,32,46,9,5,26,56,46.4,30,52,16,36,57,117,171,0,Matches
2496,Hamari Traoré,MLI,DF,Rennes,Ligue 1,25,1992,29.3,79,55,43,31,5,41,66,62.1,25,31,12,19,61,140,117,0,Matches
2497,Ibrahima Traoré,GUI,MF,Gladbach,Bundesliga,29,1988,2.2,4,2,2,2,0,4,7,57.1,3,2,0,2,0,4,1,0,Matches
2498,Ismaël Traoré,CIV,DF,Angers,Ligue 1,30,1986,31.7,54,32,40,13,1,14,29,48.3,15,25,10,15,52,106,132,2,Matches
2499,Lacina Traoré,CIV,FW,Amiens,Ligue 1,27,1990,8.7,9,9,2,3,4,3,7,42.9,4,6,3,3,2,11,21,0,Matches
2500,Kevin Trapp,GER,GK,Paris S-G,Ligue 1,27,1990,4.0,0,0,0,0,0,0,0,,0,0,0,0,0,0,1,0,Matches
2501,Manu Trigueros,ESP,MF,Villarreal,La Liga,25,1991,30.0,61,41,23,34,4,21,71,29.6,50,38,13,25,22,83,44,0,Matches
2502,Kieran Trippier,ENG,DF,Tottenham,Premier League,26,1990,21.3,52,30,29,21,2,21,44,47.7,23,31,6,25,20,72,53,1,Matches
2503,Marcello Trotta,ITA,FW,Crotone,Serie A,24,1992,25.1,39,21,12,18,9,10,55,18.2,45,22,2,20,14,53,20,0,Matches
2504,Philipp Tschauner,GER,GK,Hannover 96,Bundesliga,31,1985,31.0,1,0,1,0,0,1,2,50.0,1,2,0,2,0,1,8,5,Matches
2505,Axel Tuanzebe,COD,FW,Manchester Utd,Premier League,19,1997,0.0,0,0,0,0,0,0,0,,0,0,0,0,0,0,0,0,Matches
2506,Marco Tumminello,ITA,FW,Crotone,Serie A,18,1998,2.3,2,2,0,1,1,0,2,0.0,2,2,0,2,0,2,0,0,Matches
2507,Marco Tumminello,ITA,FW,Roma,Serie A,18,1998,0.0,0,0,0,0,0,0,0,,0,0,0,0,0,0,0,0,Matches
2508,Ľubomír Tupta,SVK,"MF,FW",Hellas Verona,Serie A,19,1998,0.4,0,0,0,0,0,0,3,0.0,3,0,0,0,0,0,0,0,Matches
2509,Josh Tymon,ENG,DF,Stoke City,Premier League,18,1999,1.8,5,1,4,1,0,2,3,66.7,1,1,0,1,1,6,3,0,Matches
2510,Przemysław Tytoń,POL,GK,La Coruña,La Liga,30,1987,1.1,0,0,0,0,0,0,0,,0,0,0,0,0,0,0,0,Matches
2511,Matthieu Udol,FRA,DF,Metz,Ligue 1,21,1996,3.9,14,8,13,1,0,5,14,35.7,9,10,2,8,5,19,17,0,Matches
2512,Anthony Ujah,NGA,FW,Mainz 05,Bundesliga,26,1990,2.3,4,3,0,2,2,1,1,100.0,0,2,0,2,0,4,6,0,Matches
2513,Leonardo Ulloa,ARG,FW,Leicester City,Premier League,31,1986,0.2,1,0,0,0,1,0,0,,0,0,0,0,0,1,1,0,Matches
2514,Leonardo Ulloa,ARG,FW,Brighton,Premier League,31,1986,3.0,3,1,0,1,2,1,7,14.3,6,1,0,1,0,3,3,0,Matches
2515,Sven Ulreich,GER,GK,Bayern Munich,Bundesliga,28,1988,29.0,1,0,1,0,0,1,1,100.0,0,0,0,0,3,4,6,1,Matches
2516,Samuel Umtiti,FRA,DF,Barcelona,La Liga,23,1993,24.3,50,35,35,15,0,20,29,69.0,9,25,17,8,37,87,72,3,Matches
2517,Enes Ünal,TUR,FW,Villarreal,La Liga,20,1997,12.5,9,5,0,4,5,0,12,0.0,12,16,3,13,4,13,11,0,Matches
2518,Enes Ünal,TUR,FW,Levante,La Liga,20,1997,6.6,6,6,2,2,2,1,10,10.0,9,7,1,6,2,8,5,0,Matches
2519,Cengiz Ünder,TUR,FW,Roma,Serie A,20,1997,13.9,10,6,4,6,0,3,18,16.7,15,8,1,7,9,19,10,0,Matches
2520,Dayot Upamecano,FRA,DF,RB Leipzig,Bundesliga,18,1998,25.2,57,43,36,17,4,31,45,68.9,14,32,9,23,55,112,141,1,Matches
2521,Mark Uth,GER,FW,Hoffenheim,Bundesliga,25,1991,24.2,32,23,4,21,7,5,22,22.7,17,30,3,27,9,41,19,0,Matches
2522,Francis Uzoho,NGA,GK,La Coruña,La Liga,18,1998,2.0,0,0,0,0,0,0,0,,0,0,0,0,0,0,1,0,Matches
2523,Valentín Vada,ARG,MF,Bordeaux,Ligue 1,21,1996,9.6,22,11,7,14,1,8,32,25.0,24,8,1,7,6,28,5,1,Matches
2524,Josha Vagnoman,GER,MF,Hamburger SV,Bundesliga,16,2000,0.2,1,1,0,1,0,1,1,100.0,0,0,0,0,0,1,0,0,Matches
2525,Sauli Väisänen,FIN,DF,SPAL,Serie A,23,1994,6.0,12,9,9,3,0,6,8,75.0,2,5,4,1,13,25,26,0,Matches
2526,Mirko Valdifiori,ITA,MF,Torino,Serie A,31,1986,6.9,13,9,5,7,1,2,11,18.2,9,3,1,2,6,19,9,0,Matches
2527,Antonio Valencia,ECU,DF,Manchester Utd,Premier League,31,1985,30.4,57,32,21,28,8,16,36,44.4,20,47,6,41,48,105,80,0,Matches
2528,Gerard Valentín,ESP,"DF,FW",La Coruña,La Liga,24,1993,1.8,5,4,4,0,1,1,2,50.0,1,1,0,1,3,8,3,0,Matches
2529,Borja Valero,ESP,MF,Inter,Serie A,32,1985,28.5,46,31,17,25,4,20,58,34.5,38,15,4,11,18,64,41,1,Matches
2530,Borja Valle,ESP,"FW,MF",La Coruña,La Liga,25,1992,5.4,6,6,3,3,0,1,4,25.0,3,2,0,2,3,9,4,0,Matches
2531,Jesús Vallejo,ESP,DF,Real Madrid,La Liga,20,1997,7.0,8,7,6,2,0,2,5,40.0,3,6,5,1,16,24,21,1,Matches
2532,Mattia Valoti,ITA,"MF,FW",Hellas Verona,Serie A,23,1993,17.5,62,41,21,35,6,11,53,20.8,42,25,3,22,41,103,37,1,Matches
2533,Federico Valverde,URU,"MF,FW",La Coruña,La Liga,19,1998,13.7,25,16,12,10,3,8,15,53.3,7,12,1,11,21,46,17,0,Matches
2534,Virgil van Dijk,NED,DF,Southampton,Premier League,26,1991,11.0,10,7,6,2,2,2,3,66.7,1,14,13,1,29,39,81,1,Matches
2535,Virgil van Dijk,NED,DF,Liverpool,Premier League,26,1991,14.0,15,8,7,7,1,4,5,80.0,1,8,2,6,18,33,80,1,Matches
2536,Raphaël Varane,FRA,DF,Real Madrid,La Liga,24,1993,25.8,28,19,20,7,1,8,15,53.3,7,27,10,17,33,61,109,2,Matches
2537,Jamie Vardy,ENG,FW,Leicester City,Premier League,30,1987,36.1,15,9,3,7,5,1,8,12.5,7,21,1,20,2,17,17,0,Matches
2538,Cédric Varrault,FRA,DF,Dijon,Ligue 1,37,1980,9.8,13,7,6,7,0,9,12,75.0,3,14,11,3,16,29,72,0,Matches
2539,Franco Vázquez,ARG,MF,Sevilla,La Liga,28,1989,20.4,39,32,16,15,8,6,34,17.6,28,20,2,18,11,50,11,0,Matches
2540,Lucas Vázquez,ESP,"MF,FW",Real Madrid,La Liga,26,1991,18.7,48,33,16,21,11,12,42,28.6,30,28,2,26,7,55,9,0,Matches
2541,Matías Vecino,URU,MF,Inter,Serie A,25,1991,23.7,54,34,15,30,9,19,49,38.8,30,28,6,22,20,74,31,0,Matches
2542,Koke Vegas,ESP,GK,Levante,La Liga,21,1995,1.0,0,0,0,0,0,0,0,,0,0,0,0,0,0,1,0,Matches
2543,Carlos Vela,MEX,FW,Real Sociedad,La Liga,28,1989,4.2,12,7,5,3,4,6,7,85.7,1,2,0,2,0,12,1,0,Matches
2544,Miloš Veljković,SRB,DF,Werder Bremen,Bundesliga,21,1995,29.5,45,32,30,13,2,30,52,57.7,22,34,12,22,34,79,134,1,Matches
2545,Miguel Veloso,POR,MF,Genoa,Serie A,31,1986,19.3,40,29,18,19,3,11,41,26.8,30,26,3,23,13,53,35,0,Matches
2546,Lorenzo Venuti,ITA,DF,Benevento,Serie A,22,1995,26.6,44,34,26,12,6,16,37,43.2,21,40,16,24,40,84,105,3,Matches
2547,Rémy Vercoutre,FRA,GK,Caen,Ligue 1,37,1980,34.5,2,2,2,0,0,2,2,100.0,0,0,0,0,2,4,14,2,Matches
2548,Daniele Verde,ITA,"FW,MF",Hellas Verona,Serie A,21,1996,21.7,10,9,8,1,1,6,20,30.0,14,8,0,8,30,40,19,0,Matches
2549,Simone Verdi,ITA,"FW,MF",Bologna,Serie A,25,1992,31.4,33,24,17,13,3,11,43,25.6,32,20,1,19,36,69,12,0,Matches
2550,Olivier Verdon,BEN,DF,Bordeaux,Ligue 1,21,1995,0.1,0,0,0,0,0,0,0,,0,0,0,0,0,0,3,0,Matches
2551,Jordan Veretout,FRA,MF,Fiorentina,Serie A,24,1993,35.7,65,45,34,23,8,20,69,29.0,49,39,4,35,37,102,59,0,Matches
2552,Paul Verhaegh,NED,DF,Wolfsburg,Bundesliga,33,1983,29.0,45,38,21,22,2,24,33,72.7,9,38,10,28,33,78,60,0,Matches
2553,Thomas Vermaelen,BEL,DF,Barcelona,La Liga,31,1985,11.3,13,9,7,5,1,5,11,45.5,6,10,3,7,18,31,28,0,Matches
2554,Marco Verratti,ITA,MF,Paris S-G,Ligue 1,24,1992,19.1,51,33,20,25,6,12,55,21.8,43,25,6,19,26,77,11,3,Matches
2555,Valerio Verre,ITA,MF,Sampdoria,Serie A,23,1994,4.0,7,3,3,2,2,2,7,28.6,5,12,0,12,8,15,7,0,Matches
2556,Jan Vertonghen,BEL,DF,Tottenham,Premier League,30,1987,35.6,64,41,40,20,4,25,36,69.4,11,29,11,18,60,124,177,0,Matches
2557,Mikel Vesga,ESP,MF,Athletic Club,La Liga,24,1993,9.0,17,8,6,11,0,4,25,16.0,21,14,3,11,8,25,15,0,Matches
2558,Jannik Vestergaard,DEN,DF,Gladbach,Bundesliga,24,1992,32.0,58,41,43,15,0,32,48,66.7,16,55,39,16,40,98,161,3,Matches
2559,Rúben Vezo,POR,DF,Valencia,La Liga,23,1994,17.3,43,24,30,12,1,16,32,50.0,16,25,9,16,23,66,83,0,Matches
2560,Francesco Vicari,ITA,DF,SPAL,Serie A,22,1994,31.7,38,22,25,13,0,21,39,53.8,18,33,27,6,45,83,210,1,Matches
2561,Aleix Vidal,ESP,"MF,FW",Barcelona,La Liga,27,1989,5.1,6,4,2,3,1,1,10,10.0,9,4,0,4,9,15,1,0,Matches
2562,Arturo Vidal,CHI,MF,Bayern Munich,Bundesliga,30,1987,16.2,69,51,36,28,5,33,69,47.8,36,22,1,21,28,97,20,1,Matches
2563,Nacho Vidal,ESP,DF,Valencia,La Liga,22,1995,5.0,17,14,15,1,1,14,22,63.6,8,5,2,3,10,27,18,0,Matches
2564,Luca Vido,ITA,"FW,MF",Atalanta,Serie A,20,1997,0.8,5,5,2,3,0,1,1,100.0,0,1,0,1,0,5,0,0,Matches
2565,Jonathan Viera,ESP,MF,Las Palmas,La Liga,27,1989,22.1,36,25,10,22,4,3,28,10.7,25,21,0,21,11,47,2,0,Matches
2566,Luciano Vietto,ARG,FW,Atlético Madrid,La Liga,23,1993,3.0,5,4,1,2,2,0,3,0.0,3,3,0,3,3,8,3,0,Matches
2567,Luciano Vietto,ARG,FW,Valencia,La Liga,23,1993,5.9,8,6,2,3,3,1,4,25.0,3,3,0,3,2,10,5,0,Matches
2568,Carlos Vigaray,ESP,DF,Alavés,La Liga,22,1994,9.9,27,16,16,9,2,11,16,68.8,5,5,1,4,14,41,13,0,Matches
2569,Dídac Vilà,ESP,"DF,MF",Espanyol,La Liga,28,1989,8.1,29,26,15,9,5,13,18,72.2,5,14,3,11,14,43,27,0,Matches
2570,Julio Villalba,PAR,DF,Gladbach,Bundesliga,18,1998,0.1,0,0,0,0,0,0,0,,0,0,0,0,0,0,0,0,Matches
2571,Nicolas Viola,ITA,MF,Benevento,Serie A,27,1989,20.6,37,27,20,14,3,15,39,38.5,24,29,8,21,24,61,23,2,Matches
2572,Mattia Vitale,ITA,"MF,FW",SPAL,Serie A,19,1997,1.1,2,1,2,0,0,0,0,,0,1,0,1,3,5,1,0,Matches
2573,Vitolo,ESP,"FW,MF",Las Palmas,La Liga,27,1989,7.7,15,12,9,5,1,4,17,23.5,13,10,3,7,6,21,9,0,Matches
2574,Vitolo,ESP,"MF,FW",Atlético Madrid,La Liga,27,1989,6.9,9,6,4,3,2,3,15,20.0,12,10,1,9,6,15,5,0,Matches
2575,Federico Viviani,ITA,MF,SPAL,Serie A,25,1992,27.6,52,36,23,26,3,18,55,32.7,37,39,9,30,58,110,26,2,Matches
2576,Emiliano Viviano,ITA,GK,Sampdoria,Serie A,31,1985,27.0,0,0,0,0,0,0,0,,0,0,0,0,2,2,10,4,Matches
2577,Oswaldo Vizcarrondo,VEN,DF,Troyes,Ligue 1,33,1984,19.1,21,15,17,3,1,14,37,37.8,23,18,16,2,20,41,129,2,Matches
2578,Nikola Vlašić,CRO,"MF,FW",Everton,Premier League,19,1997,6.4,9,5,3,6,0,2,9,22.2,7,14,2,12,9,18,10,0,Matches
2579,Kevin Vogt,GER,DF,Hoffenheim,Bundesliga,25,1991,31.0,38,28,30,7,1,23,34,67.6,11,37,23,14,25,63,114,2,Matches
2580,Sam Vokes,WAL,FW,Burnley,Premier League,27,1989,11.1,3,1,1,2,0,0,3,0.0,3,6,2,4,3,6,15,0,Matches
2581,Kevin Volland,GER,"FW,MF",Leverkusen,Bundesliga,25,1992,28.8,23,20,7,8,8,11,26,42.3,15,16,1,15,3,26,35,0,Matches
2582,Giovanni Volpicelli,ITA,MF,Benevento,Serie A,17,1999,0.0,0,0,0,0,0,0,1,0.0,1,0,0,0,0,0,0,0,Matches
2583,Michel Vorm,NED,GK,Tottenham,Premier League,33,1983,1.0,0,0,0,0,0,0,0,,0,0,0,0,0,0,1,0,Matches
2584,Stefan de Vrij,NED,DF,Lazio,Serie A,25,1992,33.7,31,22,14,17,0,14,23,60.9,9,43,24,19,71,102,156,1,Matches
2585,Šime Vrsaljko,CRO,DF,Atlético Madrid,La Liga,25,1992,18.8,48,30,25,17,6,26,40,65.0,14,24,8,16,36,84,63,0,Matches
2586,Jagoš Vuković,SRB,DF,Hellas Verona,Serie A,29,1988,14.8,5,4,3,1,1,3,6,50.0,3,19,14,5,20,25,113,0,Matches
2587,Sandro Wagner,GER,FW,Hoffenheim,Bundesliga,29,1987,9.7,8,5,3,5,0,5,6,83.3,1,11,3,8,3,11,13,0,Matches
2588,Sandro Wagner,GER,FW,Bayern Munich,Bundesliga,29,1987,8.1,9,6,3,5,1,1,1,100.0,0,4,0,4,2,11,1,0,Matches
2589,Molla Wagué,MLI,DF,Watford,Premier League,26,1991,4.9,5,3,3,2,0,2,5,40.0,3,1,0,1,9,14,30,0,Matches
2590,Molla Wagué,MLI,DF,Udinese,Serie A,26,1991,0.6,1,0,0,1,0,0,0,,0,0,0,0,2,3,5,0,Matches
2591,Wakaso,GHA,MF,Alavés,La Liga,27,1990,12.2,43,30,25,15,3,13,39,33.3,26,22,1,21,35,78,21,0,Matches
2592,Walace,BRA,MF,Hamburger SV,Bundesliga,22,1995,14.6,38,25,13,23,2,19,44,43.2,25,25,3,22,21,59,14,1,Matches
2593,Theo Walcott,ENG,"FW,MF",Arsenal,Premier League,28,1989,0.8,1,0,1,0,0,0,0,,0,0,0,0,1,2,0,0,Matches
2594,Theo Walcott,ENG,FW,Everton,Premier League,28,1989,12.8,27,19,12,13,2,7,15,46.7,8,9,0,9,8,35,12,0,Matches
2595,Luca Waldschmidt,GER,"MF,FW",Hamburger SV,Bundesliga,21,1996,8.8,10,6,1,8,1,3,10,30.0,7,11,0,11,3,13,2,0,Matches
2596,Kyle Walker,ENG,DF,Manchester City,Premier League,27,1990,30.9,47,31,20,21,6,18,31,58.1,13,21,2,19,29,76,75,2,Matches
2597,Kyle Walker-Peters,ENG,DF,Tottenham,Premier League,20,1997,2.1,5,4,4,1,0,2,4,50.0,2,2,0,2,3,8,8,0,Matches
2598,Wallace,BRA,DF,Lazio,Serie A,22,1994,11.1,17,7,11,6,0,4,13,30.8,9,13,5,8,29,46,43,3,Matches
2599,Anthony Walongwa,,DF,Nantes,Ligue 1,23,1993,1.0,2,1,2,0,0,0,0,,0,0,0,0,1,3,8,0,Matches
2600,Rémi Walter,FRA,"MF,FW",Nice,Ligue 1,22,1995,5.5,11,7,4,6,1,3,7,42.9,4,2,1,1,5,16,3,0,Matches
2601,Rémi Walter,FRA,MF,Troyes,Ligue 1,22,1995,11.1,23,10,9,13,1,2,23,8.7,21,7,3,4,11,34,14,0,Matches
2602,Jonathan Walters,IRL,FW,Burnley,Premier League,33,1983,0.4,0,0,0,0,0,0,0,,0,0,0,0,0,0,1,0,Matches
2603,Aaron Wan-Bissaka,ENG,DF,Crystal Palace,Premier League,19,1997,7.0,30,19,20,7,3,15,19,78.9,4,18,7,11,15,45,45,0,Matches
2604,Victor Wanyama,KEN,MF,Tottenham,Premier League,26,1991,9.4,30,20,13,16,1,14,31,45.2,17,13,3,10,10,40,20,1,Matches
2605,Joel Ward,ENG,DF,Crystal Palace,Premier League,27,1989,17.9,35,30,23,12,0,16,28,57.1,12,27,11,16,28,63,76,0,Matches
2606,Stephen Ward,IRL,DF,Burnley,Premier League,31,1985,27.3,39,31,27,8,4,20,42,47.6,22,27,12,15,42,81,126,0,Matches
2607,James Ward-Prowse,ENG,"FW,MF",Southampton,Premier League,22,1994,19.1,23,16,9,11,3,3,27,11.1,24,29,1,28,8,31,31,0,Matches
2608,Daniel Wass,DEN,"MF,DF",Celta Vigo,La Liga,28,1989,32.6,30,21,8,18,4,8,25,32.0,17,23,3,20,30,60,47,0,Matches
2609,Ben Watson,ENG,MF,Watford,Premier League,32,1985,5.1,19,9,9,9,1,10,31,32.3,21,6,1,5,7,26,10,0,Matches
2610,Timothy Weah,USA,FW,Paris S-G,Ligue 1,17,2000,1.4,1,1,1,0,0,1,1,100.0,0,0,0,0,0,1,0,0,Matches
2611,Roman Weidenfeller,GER,GK,Dortmund,Bundesliga,36,1980,1.0,0,0,0,0,0,0,0,,0,0,0,0,0,0,0,1,Matches
2612,Julian Weigl,GER,MF,Dortmund,Bundesliga,21,1995,21.6,69,49,20,42,7,42,66,63.6,24,26,6,20,34,103,29,2,Matches
2613,Mitchell Weiser,GER,"DF,FW",Hertha BSC,Bundesliga,23,1994,22.0,54,43,20,27,7,17,38,44.7,21,28,1,27,44,98,37,1,Matches
2614,Danny Welbeck,ENG,"FW,MF",Arsenal,Premier League,26,1990,13.3,20,13,9,5,6,4,12,33.3,8,22,1,21,11,31,13,0,Matches
2615,Nahki Wells,BER,"FW,MF",Burnley,Premier League,27,1990,0.6,4,3,0,3,1,1,1,100.0,0,2,0,2,0,4,0,0,Matches
2616,Wendell,BRA,DF,Leverkusen,Bundesliga,24,1993,23.5,54,41,29,20,5,32,58,55.2,26,44,8,36,28,82,58,0,Matches
2617,Oscar Wendt,SWE,DF,Gladbach,Bundesliga,31,1985,27.3,54,40,31,19,4,30,45,66.7,15,46,12,34,27,81,71,0,Matches
2618,Axel Werner,ARG,GK,Atlético Madrid,La Liga,21,1996,1.0,0,0,0,0,0,0,0,,0,0,0,0,0,0,1,0,Matches
2619,Timo Werner,GER,FW,RB Leipzig,Bundesliga,21,1996,27.7,16,11,2,8,6,3,19,15.8,16,26,0,26,7,23,11,0,Matches
2620,Ashley Westwood,ENG,MF,Burnley,Premier League,27,1990,12.3,13,10,10,3,0,2,16,12.5,14,17,9,8,19,32,16,0,Matches
2621,Dean Whitehead,ENG,MF,Huddersfield,Premier League,35,1982,0.8,0,0,0,0,0,0,1,0.0,1,1,0,1,2,2,0,0,Matches
2622,Silvan Widmer,SUI,"DF,FW",Udinese,Serie A,24,1993,18.1,45,32,30,15,0,22,40,55.0,18,22,5,17,28,73,59,0,Matches
2623,Georginio Wijnaldum,NED,MF,Liverpool,Premier League,26,1990,26.5,34,23,13,16,5,11,23,47.8,12,20,2,18,25,59,20,0,Matches
2624,Jetro Willems,NED,"FW,DF",Eint Frankfurt,Bundesliga,23,1994,18.5,55,42,28,23,4,27,42,64.3,15,31,1,30,20,75,53,0,Matches
2625,William,BRA,DF,Wolfsburg,Bundesliga,22,1995,17.9,76,61,43,26,7,46,86,53.5,40,41,6,35,46,122,65,1,Matches
2626,Ashley Williams,WAL,DF,Everton,Premier League,32,1984,20.4,23,13,17,6,0,9,18,50.0,9,31,23,8,36,59,173,3,Matches
2627,Danny Williams,USA,MF,Huddersfield,Premier League,28,1989,12.5,23,14,13,9,1,7,22,31.8,15,12,2,10,26,49,27,0,Matches
2628,Iñaki Williams,GHA,"FW,MF",Athletic Club,La Liga,23,1994,31.7,28,17,11,15,2,8,41,19.5,33,24,2,22,17,45,13,0,Matches
2629,Willian,BRA,"MF,FW",Chelsea,Premier League,28,1988,21.0,22,17,7,12,3,0,16,0.0,16,13,1,12,10,32,10,0,Matches
2630,Joe Willock,ENG,MF,Arsenal,Premier League,17,1999,0.9,4,2,4,0,0,1,1,100.0,0,3,0,3,1,5,2,0,Matches
2631,Jack Wilshere,ENG,MF,Arsenal,Premier League,25,1992,13.3,15,10,3,7,5,4,20,20.0,16,10,2,8,8,23,5,0,Matches
2632,Callum Wilson,ENG,FW,Bournemouth,Premier League,25,1992,22.0,9,5,2,6,1,1,14,7.1,13,15,3,12,3,12,15,0,Matches
2633,Kevin Wimmer,AUT,DF,Stoke City,Premier League,24,1992,14.7,24,17,17,7,0,9,20,45.0,11,25,12,13,30,54,88,0,Matches
2634,Harry Winks,ENG,MF,Tottenham,Premier League,21,1996,8.6,15,12,8,5,2,8,16,50.0,8,12,2,10,11,26,10,1,Matches
2635,Marius Wolf,GER,"MF,FW",Eint Frankfurt,Bundesliga,22,1995,26.3,37,28,15,18,4,18,46,39.1,28,45,1,44,27,64,46,0,Matches
2636,Bobby Wood,USA,"FW,MF",Hamburger SV,Bundesliga,24,1992,17.9,13,8,2,4,7,3,9,33.3,6,4,0,4,2,15,13,0,Matches
2637,Chris Wood,NZL,FW,Burnley,Premier League,25,1991,18.0,7,3,2,3,2,3,13,23.1,10,12,4,8,0,7,16,0,Matches
2638,Ben Woodburn,WAL,FW,Liverpool,Premier League,17,1999,0.1,0,0,0,0,0,0,0,,0,0,0,0,0,0,0,0,Matches
2639,Xeka,POR,MF,Dijon,Ligue 1,22,1994,15.5,25,14,10,11,4,10,38,26.3,28,13,2,11,16,41,21,0,Matches
2640,Xeka,POR,MF,Lille,Ligue 1,22,1994,0.2,1,0,1,0,0,0,0,,0,1,0,1,1,2,0,0,Matches
2641,Granit Xhaka,SUI,MF,Arsenal,Premier League,24,1992,36.2,78,57,35,40,3,26,69,37.7,43,30,9,21,37,115,68,4,Matches
2642,Claudio Yacob,ARG,MF,West Brom,Premier League,30,1987,10.0,36,27,23,13,0,13,27,48.1,14,14,6,8,16,52,25,2,Matches
2643,Steeve Yago,BFA,DF,Toulouse,Ligue 1,24,1992,17.5,49,36,28,17,4,20,37,54.1,17,16,7,9,34,83,64,1,Matches
2644,Cédric Yamberé,CTA,DF,Dijon,Ligue 1,26,1990,31.4,58,42,46,12,0,16,34,47.1,18,24,16,8,54,112,138,5,Matches
2645,Jawad El Yamiq,MAR,DF,Genoa,Serie A,25,1992,4.0,8,5,7,1,0,6,8,75.0,2,11,5,6,5,13,22,1,Matches
2646,Mapou Yanga-Mbiwa,FRA,DF,Lyon,Ligue 1,28,1989,1.4,3,2,3,0,0,1,1,100.0,0,0,0,0,1,4,2,0,Matches
2647,Andriy Yarmolenko,UKR,"FW,MF",Dortmund,Bundesliga,27,1989,11.5,17,12,6,6,5,7,16,43.8,9,4,0,4,7,24,4,0,Matches
2648,DeAndre Yedlin,USA,DF,Newcastle Utd,Premier League,24,1993,31.6,57,33,39,14,4,26,54,48.1,28,37,7,30,44,101,114,0,Matches
2649,Yoel,ESP,GK,Eibar,La Liga,28,1988,1.0,0,0,0,0,0,0,0,,0,0,0,0,0,0,2,0,Matches
2650,Maya Yoshida,JPN,DF,Southampton,Premier League,28,1988,22.8,27,20,22,5,0,18,25,72.0,7,32,14,18,41,68,133,2,Matches
2651,Ashley Young,ENG,DF,Manchester Utd,Premier League,32,1985,27.1,53,32,30,17,6,18,47,38.3,29,24,5,19,57,110,86,1,Matches
2652,Zaydou Youssouf,FRA,FW,Bordeaux,Ligue 1,18,1999,1.5,3,1,2,1,0,1,2,50.0,1,1,0,1,1,4,1,0,Matches
2653,Pablo Zabaleta,ARG,"DF,MF",West Ham,Premier League,32,1985,36.5,96,67,54,28,14,48,98,49.0,50,72,13,59,61,157,152,0,Matches
2654,Mattia Zaccagni,ITA,"MF,FW",Hellas Verona,Serie A,22,1995,1.7,7,5,4,0,3,2,3,66.7,1,0,0,0,5,12,0,0,Matches
2655,Dan-Axel Zagadou,FRA,DF,Dortmund,Bundesliga,18,1999,7.3,9,8,5,3,1,6,7,85.7,1,9,0,9,11,20,20,1,Matches
2656,Wilfried Zaha,CIV,"FW,MF",Crystal Palace,Premier League,24,1992,28.3,30,23,9,13,8,4,23,17.4,19,24,0,24,7,37,4,0,Matches
2657,Denis Zakaria,SUI,MF,Gladbach,Bundesliga,20,1996,25.5,74,48,38,32,4,40,61,65.6,21,52,9,43,45,119,40,1,Matches
2658,Joseba Zaldúa,ESP,DF,Leganés,La Liga,25,1992,28.4,68,52,31,31,6,39,62,62.9,23,28,5,23,61,129,85,0,Matches
2659,Andre-Frank Zambo Anguissa,CMR,MF,Marseille,Ligue 1,21,1995,27.1,88,65,23,57,8,32,94,34.0,62,50,7,43,67,155,46,3,Matches
2660,Francesco Zampano,ITA,DF,Udinese,Serie A,23,1993,4.6,9,7,5,3,1,5,10,50.0,5,4,0,4,6,15,7,0,Matches
2661,Niccolò Zanellato,ITA,MF,Crotone,Serie A,19,1998,0.8,3,2,0,3,0,1,2,50.0,1,3,0,3,0,3,0,0,Matches
2662,Cristián Zapata,COL,DF,Milan,Serie A,30,1986,11.0,25,20,21,4,0,15,16,93.8,1,12,6,6,15,40,50,1,Matches
2663,Duván Zapata,COL,FW,Sampdoria,Serie A,26,1991,23.4,12,7,1,7,4,1,6,16.7,5,13,0,13,5,17,22,1,Matches
2664,Davide Zappacosta,ITA,"DF,MF",Chelsea,Premier League,25,1992,12.2,26,11,14,9,3,11,25,44.0,14,11,2,9,6,32,26,0,Matches
2665,Davide Zappacosta,ITA,"DF,FW",Torino,Serie A,25,1992,1.1,1,0,1,0,0,0,0,,0,0,0,0,2,3,1,0,Matches
2666,Simone Zaza,ITA,FW,Valencia,La Liga,26,1991,23.1,21,14,4,10,7,1,20,5.0,19,26,1,25,8,29,34,0,Matches
2667,Marvin Zeegelaar,NED,DF,Watford,Premier League,26,1990,11.0,23,18,15,3,5,11,24,45.8,13,5,1,4,20,43,30,0,Matches
2668,Mehdi Zeffane,ALG,"DF,MF",Rennes,Ligue 1,25,1992,11.0,17,12,10,5,2,9,25,36.0,16,10,2,8,12,29,44,0,Matches
2669,Rafik Zekhnini,NOR,FW,Fiorentina,Serie A,19,1998,0.1,0,0,0,0,0,0,0,,0,0,0,0,0,0,0,0,Matches
2670,Erwin Zelazny,FRA,GK,Troyes,Ligue 1,25,1991,17.0,1,1,1,0,0,1,2,50.0,1,0,0,0,2,3,10,1,Matches
2671,Robin Zentner,GER,GK,Mainz 05,Bundesliga,22,1994,15.0,0,0,0,0,0,0,1,0.0,1,0,0,0,1,1,10,2,Matches
2672,Nabil El Zhar,MAR,"FW,MF",Leganés,La Liga,30,1986,22.0,11,6,4,6,1,3,18,16.7,15,14,1,13,18,29,3,0,Matches
2673,Enzo Zidane,ESP,MF,Alavés,La Liga,22,1995,0.8,2,2,2,0,0,0,0,,0,0,0,0,0,2,1,0,Matches
2674,Luca Zidane,FRA,GK,Real Madrid,La Liga,19,1998,1.0,0,0,0,0,0,0,1,0.0,1,0,0,0,0,0,0,0,Matches
2675,Ron-Robert Zieler,GER,GK,Stuttgart,Bundesliga,28,1989,34.0,1,1,1,0,0,1,1,100.0,0,2,0,2,1,2,14,5,Matches
2676,Piotr Zieliński,POL,"MF,FW",Napoli,Serie A,23,1994,18.5,31,19,7,21,3,9,24,37.5,15,32,3,29,13,44,19,1,Matches
2677,Matthias Zimmermann,GER,DF,Stuttgart,Bundesliga,25,1992,0.9,3,1,2,1,0,3,4,75.0,1,0,0,0,1,4,5,1,Matches
2678,Oleksandr Zinchenko,UKR,DF,Manchester City,Premier League,20,1996,5.9,23,16,11,9,3,7,13,53.8,6,3,0,3,6,29,7,0,Matches
2679,Kévin Zohi,MLI,MF,Strasbourg,Ligue 1,20,1996,0.0,0,0,0,0,0,0,0,,0,0,0,0,0,0,0,0,Matches
2680,Simon Zoller,GER,"MF,FW",Köln,Bundesliga,26,1991,10.7,11,7,3,6,2,7,10,70.0,3,5,2,3,8,19,9,0,Matches
2681,Kurt Zouma,FRA,DF,Stoke City,Premier League,22,1994,32.1,50,38,35,13,2,21,28,75.0,7,42,23,19,61,111,246,2,Matches
2682,Igor Zubeldia,ESP,MF,Real Sociedad,La Liga,20,1997,17.6,39,29,17,16,6,14,42,33.3,28,20,5,15,32,71,31,0,Matches
2683,Steven Zuber,SUI,"FW,DF",Hoffenheim,Bundesliga,25,1991,15.9,40,30,22,13,5,26,41,63.4,15,18,3,15,17,57,27,0,Matches
2684,Bruno Zuculini,ARG,MF,Hellas Verona,Serie A,24,1993,13.5,68,49,37,28,3,20,48,41.7,28,35,8,27,38,106,31,0,Matches
2685,Franco Zuculini,ARG,"MF,FW",Hellas Verona,Serie A,26,1990,3.7,11,8,5,5,1,5,14,35.7,9,4,0,4,5,16,6,1,Matches
2686,Ervin Zukanović,BIH,DF,Genoa,Serie A,30,1987,31.9,50,41,33,16,1,20,51,39.2,31,32,19,13,48,98,175,0,Matches
2687,Robert Žulj,AUT,"MF,FW",Hoffenheim,Bundesliga,25,1992,2.3,3,3,1,2,0,1,1,100.0,0,3,0,3,0,3,2,0,Matches
2688,Bongani Zungu,RSA,MF,Amiens,Ligue 1,24,1992,23.2,54,37,21,26,7,24,56,42.9,32,30,5,25,38,92,41,2,Matches
2689,David Zurutuza,ESP,MF,Real Sociedad,La Liga,31,1986,24.9,49,36,22,25,2,20,49,40.8,29,32,10,22,41,90,24,1,Matches
2690,Filip Đuričić,SRB,"MF,FW",Benevento,Serie A,25,1992,10.8,22,14,11,8,3,5,9,55.6,4,7,1,6,9,31,5,0,Matches
2691,Filip Đuričić,SRB,MF,Sampdoria,Serie A,25,1992,0.1,0,0,0,0,0,0,1,0.0,1,0,0,0,0,0,0,0,Matches
2692,Christian Rutjens,,,Benevento,Serie A,,,0.0,,,,,,,,,,,,,,,,,Matches
1,Ismael Aaneba,FRA,DF,Strasbourg,Ligue 1,19,1999,2.3,12,6,7,5,0,5,10,50.0,5,5,0,5,8,20,9,0,Matches
2,Patrick van Aanholt,NED,DF,Crystal Palace,Premier League,27,1990,35.5,48,24,35,11,2,24,40,60.0,16,33,9,24,40,88,91,2,Matches
3,Ignazio Abate,ITA,DF,Milan,Serie A,31,1986,14.5,34,19,16,13,5,14,22,63.6,8,19,6,13,18,52,50,0,Matches
4,Yunis Abdelhamid,MAR,DF,Reims,Ligue 1,30,1987,38.0,60,33,48,11,1,30,40,75.0,10,44,24,20,65,125,196,0,Matches
5,Mehdi Abeid,ALG,MF,Dijon,Ligue 1,25,1992,22.5,51,33,27,16,8,15,45,33.3,30,33,7,26,29,80,23,1,Matches
6,Charles Abi,FRA,"DF,FW",Saint-Étienne,Ligue 1,18,2000,0.4,4,4,2,1,1,2,2,100.0,0,1,0,1,0,4,1,0,Matches
7,David Abraham,ARG,DF,Eint Frankfurt,Bundesliga,32,1986,15.8,22,14,13,8,1,11,25,44.0,14,23,12,11,24,46,64,0,Matches
8,Amir Abrashi,ALB,MF,Freiburg,Bundesliga,28,1990,8.8,20,11,7,10,3,6,19,31.6,13,11,3,8,14,34,15,0,Matches
9,Francesco Acerbi,ITA,DF,Lazio,Serie A,30,1988,36.8,40,30,22,13,5,12,16,75.0,4,50,32,18,61,101,169,1,Matches
10,Afriyie Acquah,GHA,MF,Empoli,Serie A,26,1992,16.8,27,9,9,12,6,4,11,36.4,7,11,1,10,12,39,16,0,Matches
11,Tyler Adams,USA,MF,RB Leipzig,Bundesliga,19,1999,8.0,29,17,12,16,1,11,26,42.3,15,17,1,16,16,45,8,0,Matches
12,Antonio Adán,ESP,GK,Atlético Madrid,La Liga,31,1987,1.0,0,0,0,0,0,0,0,,0,0,0,0,0,0,0,0,Matches
13,Aday,ESP,"DF,MF",Girona,La Liga,30,1987,7.2,9,8,2,5,2,6,7,85.7,1,1,0,1,7,16,17,1,Matches
14,Khaled Adénon,BEN,DF,Amiens,Ligue 1,33,1985,22.2,31,22,20,11,0,16,28,57.1,12,26,11,15,31,62,101,0,Matches
15,Claud Adjapong,ITA,"MF,FW",Sassuolo,Serie A,20,1998,3.0,4,2,1,3,0,1,2,50.0,1,3,1,2,1,5,4,0,Matches
16,Yacine Adli,FRA,MF,Bordeaux,Ligue 1,18,2000,2.4,7,2,2,3,2,3,9,33.3,6,3,0,3,2,9,0,0,Matches
17,Ali Adnan Kadhim,IRQ,DF,Atalanta,Serie A,24,1993,1.8,1,1,1,0,0,1,2,50.0,1,1,1,0,3,4,6,0,Matches
18,Aritz Aduriz,ESP,FW,Athletic Club,La Liga,37,1981,10.5,4,2,1,1,2,1,7,14.3,6,2,1,1,0,4,4,0,Matches
19,Luis Advíncula,PER,DF,Rayo Vallecano,La Liga,28,1990,26.5,52,38,38,12,2,21,31,67.7,10,22,2,20,19,71,60,1,Matches
20,Martin Agirregabiria,ESP,DF,Alavés,La Liga,22,1996,22.6,45,29,32,10,3,28,46,60.9,18,33,11,22,27,72,65,1,Matches
21,Nayef Aguerd,MAR,DF,Dijon,Ligue 1,22,1996,11.7,17,12,8,9,0,8,19,42.1,11,20,11,9,14,31,59,1,Matches
22,Sergio Agüero,ARG,FW,Manchester City,Premier League,30,1988,27.3,17,9,1,10,6,5,9,55.6,4,15,1,14,9,26,3,0,Matches
23,Ruben Aguilar,FRA,DF,Montpellier,Ligue 1,25,1993,28.1,88,51,40,33,15,39,69,56.5,30,23,3,20,37,125,50,1,Matches
24,Juan Aguilera,ESP,MF,Huesca,La Liga,32,1985,3.8,2,2,0,1,1,1,4,25.0,3,4,2,2,4,6,2,0,Matches
25,Emmanuel Agyemang-Badu,GHA,MF,Udinese,Serie A,27,1990,1.8,4,0,1,2,1,1,1,100.0,0,2,0,2,1,5,2,0,Matches
26,Jean-Eudes Aholou,CIV,MF,Monaco,Ligue 1,24,1994,11.9,20,11,6,11,3,8,16,50.0,8,7,0,7,17,37,12,0,Matches
27,Antonis Aidonis,GER,DF,Stuttgart,Bundesliga,17,2001,0.9,3,1,1,1,1,1,4,25.0,3,1,0,1,2,5,2,0,Matches
28,Ola Aina,NGA,DF,Torino,Serie A,21,1996,24.0,54,36,32,20,2,23,48,47.9,25,30,3,27,39,93,59,2,Matches
29,Youssef Aït Bennasser,MAR,MF,Saint-Étienne,Ligue 1,22,1996,10.4,25,13,9,12,4,13,28,46.4,15,15,2,13,19,44,6,2,Matches
30,Youssef Aït Bennasser,MAR,MF,Monaco,Ligue 1,22,1996,11.9,33,16,14,18,1,13,29,44.8,16,15,5,10,15,48,19,0,Matches
31,Rayan Aït-Nouri,ALG,"DF,MF",Angers,Ligue 1,17,2001,0.6,2,2,1,1,0,0,1,0.0,1,0,0,0,0,2,1,0,Matches
32,Ludovic Ajorque,FRA,FW,Strasbourg,Ligue 1,24,1994,17.0,17,13,1,10,6,4,9,44.4,5,5,0,5,5,22,9,0,Matches
33,Manuel Akanji,SUI,DF,Dortmund,Bundesliga,23,1995,24.5,29,19,14,13,2,14,25,56.0,11,22,13,9,27,56,92,2,Matches
34,Carlos Akapo,EQG,DF,Huesca,La Liga,25,1993,11.4,28,15,18,8,2,19,33,57.6,14,12,2,10,23,51,36,0,Matches
35,Nathan Aké,NED,DF,Bournemouth,Premier League,23,1995,37.9,66,35,42,21,3,22,35,62.9,13,51,35,16,32,98,241,0,Matches
36,Sergio Akieme,ESP,DF,Rayo Vallecano,La Liga,20,1997,2.0,3,3,3,0,0,2,2,100.0,0,0,0,0,1,4,5,0,Matches
37,Chadrac Akolo,COD,"MF,FW",Stuttgart,Bundesliga,23,1995,5.8,9,6,2,7,0,1,3,33.3,2,7,0,7,4,13,1,0,Matches
38,Kevin Akpoguma,NGA,DF,Hoffenheim,Bundesliga,23,1995,5.5,23,15,13,10,0,11,21,52.4,10,18,5,13,12,35,20,2,Matches
39,Kevin Akpoguma,NGA,DF,Hannover 96,Bundesliga,23,1995,3.5,10,6,5,5,0,6,7,85.7,1,7,2,5,10,20,7,2,Matches
40,David Alaba,AUT,DF,Bayern Munich,Bundesliga,26,1992,28.1,34,21,13,13,8,17,26,65.4,9,24,3,21,31,65,40,0,Matches
41,Sofiane Alakouch,MAR,DF,Nîmes,Ligue 1,20,1998,21.1,81,44,44,31,6,36,63,57.1,27,15,4,11,46,127,57,0,Matches
42,Lucas Alario,ARG,"FW,MF",Leverkusen,Bundesliga,25,1992,14.1,15,8,5,6,4,4,14,28.6,10,9,0,9,1,16,16,0,Matches
43,Jordi Alba,ESP,DF,Barcelona,La Liga,29,1989,33.2,42,22,20,15,7,20,48,41.7,28,24,6,18,60,102,76,1,Matches
44,Luis Alberto,ESP,"MF,FW",Lazio,Serie A,25,1992,22.1,53,22,15,29,9,21,55,38.2,34,23,3,20,10,63,10,0,Matches
45,Raúl Albiol,ESP,DF,Napoli,Serie A,32,1985,19.0,16,8,12,4,0,8,15,53.3,7,19,16,3,20,36,90,1,Matches
46,Miiko Albornoz,CHI,"DF,MF",Hannover 96,Bundesliga,27,1990,18.4,46,26,31,10,5,21,45,46.7,24,23,3,20,16,62,37,1,Matches
47,Marc Albrighton,ENG,"FW,MF",Leicester City,Premier League,28,1989,18.1,35,22,18,14,3,13,31,41.9,18,26,3,23,23,58,30,0,Matches
48,Paco Alcácer,ESP,FW,Dortmund,Bundesliga,24,1993,13.5,3,1,2,0,1,0,6,0.0,6,5,0,5,6,9,7,0,Matches
49,Pedro Alcalá,ESP,DF,Girona,La Liga,29,1989,20.8,32,23,23,9,0,15,23,65.2,8,21,18,3,36,68,120,0,Matches
50,Thiago Alcántara,ESP,MF,Bayern Munich,Bundesliga,27,1991,26.8,87,65,31,44,12,25,48,52.1,23,23,4,19,44,131,17,1,Matches
51,Rubén Alcaraz,ESP,MF,Valladolid,La Liga,27,1991,33.1,96,54,50,40,6,32,89,36.0,57,59,10,49,38,134,52,1,Matches
52,Toby Alderweireld,BEL,DF,Tottenham,Premier League,29,1989,32.5,37,23,25,10,2,12,22,54.5,10,41,22,19,24,61,175,0,Matches
53,Álex Alegría,ESP,"FW,MF",Rayo Vallecano,La Liga,25,1992,1.6,1,1,0,1,0,0,3,0.0,3,1,0,1,0,1,0,0,Matches
54,Alexis Alegue,FRA,FW,Nantes,Ligue 1,21,1996,0.1,1,0,0,1,0,0,0,,0,0,0,0,0,1,0,0,Matches
55,Iván Alejo,ESP,MF,Getafe,La Liga,23,1995,1.6,2,0,0,2,0,0,4,0.0,4,2,0,2,0,2,3,0,Matches
56,Carles Aleñá,ESP,MF,Barcelona,La Liga,20,1998,7.1,7,4,0,6,1,2,8,25.0,6,4,0,4,2,9,0,0,Matches
57,Rúnar Alex Rúnarsson,ISL,GK,Dijon,Ligue 1,23,1995,25.0,2,0,2,0,0,2,6,33.3,4,0,0,0,1,3,7,2,Matches
58,Alexander,ARG,FW,Leganés,La Liga,29,1988,0.1,1,0,1,0,0,1,1,100.0,0,0,0,0,0,1,0,0,Matches
59,Trent Alexander-Arnold,ENG,DF,Liverpool,Premier League,19,1998,27.4,61,39,31,22,8,36,68,52.9,32,19,3,16,35,96,68,0,Matches
60,Alfonso,MOZ,MF,Hoffenheim,Bundesliga,18,1999,0.1,1,1,0,1,0,1,2,50.0,1,0,0,0,1,2,0,0,Matches
61,Rachid Alioui,MAR,FW,Nîmes,Ligue 1,26,1992,13.9,15,5,3,9,3,4,9,44.4,5,8,1,7,10,25,11,0,Matches
62,Alisson,BRA,GK,Liverpool,Premier League,25,1992,38.0,2,1,2,0,0,2,2,100.0,0,0,0,0,1,3,14,6,Matches
63,Bobby Allain,FRA,GK,Dijon,Ligue 1,26,1991,13.0,0,0,0,0,0,0,1,0.0,1,1,0,1,0,0,16,1,Matches
64,Allan,BRA,MF,Napoli,Serie A,27,1991,29.1,106,70,39,55,12,36,107,33.6,71,55,13,42,36,142,28,0,Matches
65,Allan,BRA,MF,Eint Frankfurt,Bundesliga,21,1997,2.0,4,4,2,2,0,0,4,0.0,4,4,2,2,0,4,1,0,Matches
66,Dele Alli,ENG,MF,Tottenham,Premier League,22,1996,20.3,33,19,6,14,13,5,24,20.8,19,33,5,28,19,52,20,0,Matches
67,Miguel Almirón,PAR,MF,Newcastle Utd,Premier League,24,1994,8.4,20,12,7,10,3,4,10,40.0,6,14,1,13,8,28,5,0,Matches
68,Júnior Alonso,PAR,"DF,MF",Celta Vigo,La Liga,25,1993,6.0,13,9,8,4,1,7,12,58.3,5,8,3,5,5,18,24,1,Matches
69,Marcos Alonso,ESP,DF,Chelsea,Premier League,27,1990,30.7,73,46,44,22,7,33,58,56.9,25,25,2,23,39,112,101,0,Matches
70,Mickaël Alphonse,GLP,DF,Dijon,Ligue 1,29,1989,6.3,10,5,6,1,3,3,4,75.0,1,3,1,2,9,19,30,0,Matches
71,Sergio Álvarez,ESP,"DF,MF",Eibar,La Liga,26,1992,11.9,34,25,12,20,2,13,23,56.5,10,9,4,5,17,51,43,0,Matches
72,Sergio Álvarez,ESP,GK,Celta Vigo,La Liga,31,1986,13.0,0,0,0,0,0,0,0,,0,0,0,0,0,0,4,0,Matches
73,Yeray Álvarez,ESP,DF,Athletic Club,La Liga,23,1995,29.0,55,30,39,14,2,19,33,57.6,14,35,16,19,63,118,149,1,Matches
74,Bruno Alves,POR,DF,Parma,Serie A,36,1981,32.5,15,8,11,4,0,4,7,57.1,3,36,28,8,29,44,210,0,Matches
75,Dani Alves,BRA,"MF,DF",Paris S-G,Ligue 1,35,1983,18.0,42,22,16,23,3,13,38,34.2,25,18,5,13,8,50,11,0,Matches
76,Ibrahim Amadou,FRA,"MF,DF",Sevilla,La Liga,25,1993,8.5,27,20,9,15,3,2,9,22.2,7,7,4,3,11,38,24,0,Matches
77,Romain Amalfitano,FRA,"MF,FW",Dijon,Ligue 1,28,1989,28.0,52,33,20,28,4,25,67,37.3,42,45,13,32,47,99,35,0,Matches
78,Daniel Amartey,GHA,DF,Leicester City,Premier League,23,1994,7.1,18,12,11,6,1,10,15,66.7,5,6,4,2,17,35,28,1,Matches
79,Jordi Amat,IDN,DF,Rayo Vallecano,La Liga,26,1992,30.7,54,31,34,19,1,24,42,57.1,18,31,10,21,43,97,133,1,Matches
80,Amath,SEN,MF,Getafe,La Liga,22,1996,11.1,20,13,7,11,2,6,27,22.2,21,17,0,17,10,30,12,0,Matches
81,Jordan Amavi,FRA,DF,Marseille,Ligue 1,24,1994,24.2,74,50,34,26,14,35,56,62.5,21,24,8,16,46,120,93,4,Matches
82,Kelvin Amian,FRA,DF,Toulouse,Ligue 1,20,1998,32.0,68,45,54,12,2,20,30,66.7,10,36,13,23,36,104,113,1,Matches
83,Nadiem Amiri,GER,MF,Hoffenheim,Bundesliga,21,1996,8.4,14,9,8,4,2,3,13,23.1,10,11,0,11,7,21,4,0,Matches
84,Yanis Ammour,FRA,MF,Montpellier,Ligue 1,19,1999,0.0,0,0,0,0,0,0,0,,0,0,0,0,0,0,0,0,Matches
85,Luke Amos,ENG,MF,Tottenham,Premier League,21,1997,0.0,1,0,0,1,0,0,0,,0,0,0,0,0,1,0,0,Matches
86,Joachim Andersen,DEN,DF,Sampdoria,Serie A,22,1996,32.0,40,27,31,8,1,19,31,61.3,12,30,15,15,35,75,147,1,Matches
87,Felipe Anderson,BRA,"MF,FW",West Ham,Premier League,25,1993,33.8,89,49,33,44,12,31,101,30.7,70,71,0,71,41,130,18,1,Matches
88,Florin Andone,ROU,FW,Brighton,Premier League,25,1993,9.8,10,2,3,4,3,1,6,16.7,5,9,1,8,3,13,12,0,Matches
89,Benjamin André,FRA,MF,Rennes,Ligue 1,27,1990,27.7,101,60,39,50,12,33,85,38.8,52,40,6,34,54,155,58,0,Matches
90,Marco Andreolli,ITA,DF,Cagliari,Serie A,32,1986,1.2,1,1,1,0,0,1,1,100.0,0,2,1,1,1,2,5,0,Matches
91,Marco Andreolli,ITA,DF,Chievo,Serie A,32,1986,7.2,10,6,7,2,1,6,10,60.0,4,4,2,2,6,16,33,0,Matches
92,Yoann Andreu,FRA,DF,Angers,Ligue 1,29,1989,0.0,1,0,1,0,0,0,1,0.0,1,0,0,0,1,2,0,0,Matches
93,José Ángel,ESP,DF,Eibar,La Liga,28,1989,33.6,66,46,36,23,7,31,56,55.4,25,24,5,19,41,107,113,1,Matches
94,Miguel Ángel Moyá,ESP,GK,Real Sociedad,La Liga,34,1984,11.0,1,1,1,0,0,1,2,50.0,1,0,0,0,1,2,9,2,Matches
95,Cristian Ansaldi,ARG,"DF,MF",Torino,Serie A,31,1986,20.1,50,26,19,21,10,15,30,50.0,15,21,4,17,15,65,31,0,Matches
96,Mirco Antenucci,ITA,FW,SPAL,Serie A,33,1984,23.7,11,9,5,1,5,1,10,10.0,9,14,0,14,5,16,5,0,Matches
97,Waldemar Anton,GER,DF,Hannover 96,Bundesliga,22,1996,34.0,49,32,33,14,2,22,50,44.0,28,56,33,23,69,118,169,3,Matches
98,Luca Antonelli,ITA,DF,Empoli,Serie A,31,1987,8.4,13,11,4,5,4,7,17,41.2,10,19,4,15,16,29,25,1,Matches
99,Mauro Antonio Burruchaga,ARG,MF,Chievo,Serie A,20,1998,0.6,2,2,1,1,0,0,2,0.0,2,2,1,1,0,2,3,0,Matches
100,Michail Antonio,JAM,"MF,FW",West Ham,Premier League,28,1990,23.4,23,14,12,6,5,6,12,50.0,6,38,3,35,18,41,26,1,Matches
101,Antoñito,ESP,"DF,MF",Valladolid,La Liga,30,1987,20.7,35,21,16,15,4,18,42,42.9,24,21,8,13,18,53,31,0,Matches
102,Vitorino Antunes,POR,"DF,MF",Getafe,La Liga,31,1987,24.2,41,26,22,17,2,27,45,60.0,18,33,7,26,43,84,75,1,Matches
103,Anuar,MAR,"MF,FW",Valladolid,La Liga,23,1995,12.0,33,19,15,16,2,6,14,42.9,8,14,1,13,11,44,25,1,Matches
104,Dennis Aogo,GER,MF,Stuttgart,Bundesliga,31,1987,11.4,15,10,6,7,2,6,15,40.0,9,8,1,7,9,24,19,0,Matches
105,Houssem Aouar,ALG,MF,Lyon,Ligue 1,20,1998,34.0,63,38,28,25,10,17,61,27.9,44,33,6,27,32,95,25,3,Matches
106,Emmanuel Apeh,NGA,"FW,MF",Celta Vigo,La Liga,21,1996,0.2,0,0,0,0,0,0,1,0.0,1,0,0,0,0,0,0,0,Matches
107,Mauro Arambarri,URU,MF,Getafe,La Liga,22,1995,29.7,59,33,18,37,4,23,76,30.3,53,44,9,35,30,89,36,0,Matches
108,Guilherme Arana,BRA,DF,Sevilla,La Liga,21,1997,7.0,11,6,5,5,1,6,7,85.7,1,6,3,3,9,20,8,0,Matches
109,Charles Aránguiz,CHI,MF,Leverkusen,Bundesliga,29,1989,21.0,48,30,21,22,5,21,66,31.8,45,31,2,29,25,73,27,1,Matches
110,Luiz Araújo,BRA,"FW,MF",Lille,Ligue 1,22,1996,8.7,23,17,8,9,6,9,24,37.5,15,6,1,5,3,26,4,0,Matches
111,Néstor Araujo,MEX,DF,Celta Vigo,La Liga,26,1991,29.8,42,22,32,9,1,18,22,81.8,4,32,21,11,35,77,153,1,Matches
112,Anaitz Arbilla,ESP,DF,Eibar,La Liga,31,1987,21.7,31,24,25,5,1,17,27,63.0,10,12,5,7,46,77,92,2,Matches
113,Joaquín Ardaiz,URU,FW,Frosinone,Serie A,19,1999,0.2,0,0,0,0,0,0,0,,0,0,0,0,0,0,0,0,Matches
114,Alphonse Areola,FRA,GK,Paris S-G,Ligue 1,25,1993,21.0,1,1,1,0,0,1,1,100.0,0,0,0,0,0,1,4,1,Matches
115,Santiago Arias,COL,DF,Atlético Madrid,La Liga,26,1992,19.7,48,32,31,16,1,20,31,64.5,11,14,2,12,34,82,43,0,Matches
116,Lorenzo Ariaudo,ITA,DF,Frosinone,Serie A,29,1989,18.7,20,14,15,4,1,6,10,60.0,4,31,20,11,14,34,103,0,Matches
117,Nicolò Armini,ITA,DF,Lazio,Serie A,17,2001,0.4,1,1,0,1,0,1,2,50.0,1,1,0,1,0,1,0,0,Matches
118,Yoël Armougom,FRA,DF,Caen,Ligue 1,20,1998,20.6,31,21,20,9,2,15,29,51.7,14,9,3,6,21,52,66,0,Matches
119,Stuart Armstrong,SCO,MF,Southampton,Premier League,26,1992,15.9,28,20,14,6,8,8,42,19.0,34,14,0,14,12,40,12,0,Matches
120,José Arnaiz,ESP,"MF,FW",Leganés,La Liga,23,1995,1.3,1,1,1,0,0,0,3,0.0,3,0,0,0,2,3,1,0,Matches
121,Marko Arnautović,AUT,FW,West Ham,Premier League,29,1989,22.1,9,5,4,3,2,1,7,14.3,6,4,2,2,3,12,6,0,Matches
122,Maximilian Arnold,GER,MF,Wolfsburg,Bundesliga,24,1994,31.9,52,30,21,27,4,21,61,34.4,40,31,10,21,35,87,48,1,Matches
123,Kepa Arrizabalaga,ESP,GK,Chelsea,Premier League,23,1994,36.0,1,1,1,0,0,1,2,50.0,1,1,0,1,0,1,4,2,Matches
124,Harry Arter,IRL,MF,Cardiff City,Premier League,28,1989,22.2,62,37,27,26,9,16,46,34.8,30,33,5,28,21,83,21,2,Matches
125,Kwadwo Asamoah,GHA,DF,Inter,Serie A,29,1988,29.7,44,26,22,14,8,29,51,56.9,22,21,4,17,40,84,46,1,Matches
126,Takuma Asano,JPN,"MF,FW",Hannover 96,Bundesliga,23,1994,7.8,5,3,1,1,3,1,6,16.7,5,9,0,9,2,7,2,0,Matches
127,Santiago Ascacíbar,ARG,MF,Stuttgart,Bundesliga,21,1997,27.0,78,50,43,29,6,34,74,45.9,40,48,10,38,43,121,34,1,Matches
128,Sergio Asenjo,ESP,GK,Villarreal,La Liga,29,1989,32.0,0,0,0,0,0,0,1,0.0,1,0,0,0,3,3,26,2,Matches
129,Marco Asensio,ESP,FW,Real Madrid,La Liga,22,1996,19.8,12,8,3,5,4,2,24,8.3,22,16,1,15,14,26,7,0,Matches
130,Iago Aspas,ESP,"FW,MF",Celta Vigo,La Liga,30,1987,25.0,16,11,4,8,4,4,20,20.0,16,14,0,14,16,32,5,0,Matches
131,Simon Asta,GER,DF,Augsburg,Bundesliga,17,2001,1.0,6,3,4,2,0,2,2,100.0,0,2,1,1,3,9,1,0,Matches
132,Youcef Atal,ALG,"DF,FW",Nice,Ligue 1,22,1996,25.1,68,44,34,25,9,34,67,50.7,33,38,8,30,56,124,42,0,Matches
133,Christian Atsu,GHA,MF,Newcastle Utd,Premier League,26,1992,16.6,24,15,9,11,4,5,16,31.3,11,13,3,10,7,31,16,0,Matches
134,Pierre-Emerick Aubameyang,GAB,FW,Arsenal,Premier League,29,1989,30.3,21,17,6,9,6,8,28,28.6,20,26,0,26,8,29,22,0,Matches
135,Emil Audero,ITA,GK,Sampdoria,Serie A,21,1997,36.0,4,3,4,0,0,3,3,100.0,0,0,0,0,1,5,21,4,Matches
136,Jean-Kévin Augustin,FRA,FW,RB Leipzig,Bundesliga,21,1997,5.1,2,0,0,0,2,0,1,0.0,1,6,0,6,3,5,0,0,Matches
137,Ludwig Augustinsson,SWE,DF,Werder Bremen,Bundesliga,24,1994,33.6,53,31,25,22,6,23,39,59.0,16,37,11,26,38,91,86,1,Matches
138,Serge Aurier,CIV,DF,Tottenham,Premier League,25,1992,6.3,20,12,12,4,4,8,15,53.3,7,8,2,6,7,27,20,0,Matches
139,Charlie Austin,ENG,FW,Southampton,Premier League,29,1989,10.9,13,7,3,6,4,6,11,54.5,5,12,2,10,2,15,13,0,Matches
140,Ezequiel Ávila,ARG,"FW,MF",Huesca,La Liga,24,1994,22.2,18,10,7,7,4,4,26,15.4,22,21,2,19,13,31,22,0,Matches
141,Jordan Ayew,GHA,FW,Crystal Palace,Premier League,26,1991,13.1,38,23,12,19,7,6,20,30.0,14,16,0,16,7,45,6,0,Matches
142,Kaan Ayhan,TUR,DF,Düsseldorf,Bundesliga,23,1994,27.2,53,29,38,15,0,23,47,48.9,24,34,16,18,59,112,118,3,Matches
143,Floyd Ayité,TOG,"FW,MF",Fulham,Premier League,29,1988,5.3,4,4,2,1,1,2,6,33.3,4,8,1,7,7,11,5,0,Matches
144,César Azpilicueta,ESP,DF,Chelsea,Premier League,28,1989,37.8,105,60,52,40,13,38,67,56.7,29,63,16,47,43,148,91,3,Matches
145,Abdoulaye Ba,SEN,DF,Rayo Vallecano,La Liga,27,1991,23.4,46,33,37,8,1,29,39,74.4,10,32,18,14,29,75,165,4,Matches
146,Florian Baak,GER,MF,Hertha BSC,Bundesliga,19,1999,0.0,0,0,0,0,0,0,0,,0,0,0,0,0,0,0,0,Matches
147,Ludovic Baal,GUF,DF,Rennes,Ligue 1,32,1986,1.4,4,3,3,1,0,0,0,,0,1,0,1,2,6,1,0,Matches
148,Khouma Babacar,SEN,FW,Sassuolo,Serie A,25,1993,16.5,7,3,2,5,0,2,10,20.0,8,8,2,6,3,10,25,1,Matches
149,Ryan Babel,NED,"FW,MF",Fulham,Premier League,31,1986,13.9,8,4,1,5,2,3,9,33.3,6,12,0,12,6,14,13,1,Matches
150,Carlos Bacca,COL,FW,Villarreal,La Liga,31,1986,14.1,4,2,1,2,1,0,5,0.0,5,4,0,4,8,12,5,0,Matches
151,Juninho Bacuna,CUW,"MF,DF",Huddersfield,Premier League,20,1997,15.7,46,29,22,19,5,22,54,40.7,32,21,1,20,24,70,12,1,Matches
152,Leandro Bacuna,CUW,MF,Cardiff City,Premier League,26,1991,6.2,15,10,5,7,3,8,22,36.4,14,5,2,3,15,30,9,0,Matches
153,Milan Badelj,CRO,MF,Lazio,Serie A,29,1989,12.7,33,20,10,19,4,16,37,43.2,21,27,9,18,33,66,20,1,Matches
154,Benoît Badiashile,FRA,DF,Monaco,Ligue 1,17,2001,19.6,25,18,18,7,0,17,25,68.0,8,12,5,7,21,46,79,2,Matches
155,Holger Badstuber,GER,DF,Stuttgart,Bundesliga,29,1989,5.8,12,4,8,4,0,7,8,87.5,1,6,2,4,9,21,21,1,Matches
156,Stéphane Bahoken,CMR,FW,Angers,Ligue 1,26,1992,27.4,15,7,0,10,5,3,21,14.3,18,35,3,32,8,23,5,0,Matches
157,Daniel Baier,GER,MF,Augsburg,Bundesliga,34,1984,31.3,62,39,21,37,4,24,66,36.4,42,27,8,19,60,122,48,2,Matches
158,Leon Bailey,JAM,FW,Leverkusen,Bundesliga,20,1997,21.3,15,11,9,2,4,6,20,30.0,14,20,0,20,14,29,11,0,Matches
159,Eric Bailly,CIV,DF,Manchester Utd,Premier League,24,1994,7.1,15,9,14,1,0,8,10,80.0,2,9,4,5,13,28,39,1,Matches
160,Leighton Baines,ENG,DF,Everton,Premier League,33,1984,4.2,8,6,4,3,1,4,6,66.7,2,2,0,2,2,10,8,0,Matches
161,Marvin Bakalorz,GER,MF,Hannover 96,Bundesliga,28,1989,16.3,18,11,7,9,2,6,36,16.7,30,29,4,25,28,46,47,0,Matches
162,Tiemoué Bakayoko,FRA,MF,Milan,Serie A,23,1994,25.6,69,43,22,40,7,26,62,41.9,36,34,5,29,50,119,42,2,Matches
163,Ridle Baku,GER,MF,Mainz 05,Bundesliga,20,1998,10.4,18,9,6,9,3,2,7,28.6,5,13,1,12,8,26,9,0,Matches
164,Fabián Balbuena,PAR,DF,West Ham,Premier League,26,1991,22.4,40,20,34,6,0,16,42,38.1,26,23,15,8,53,93,175,0,Matches
165,Keita Baldé,SEN,FW,Inter,Serie A,23,1995,9.9,10,6,4,2,4,2,9,22.2,7,8,0,8,3,13,1,0,Matches
166,Gareth Bale,WAL,FW,Real Madrid,La Liga,29,1989,19.8,16,8,5,7,4,6,20,30.0,14,19,3,16,11,27,13,0,Matches
167,Mikel Balenziaga,ESP,DF,Athletic Club,La Liga,30,1988,5.8,10,6,7,1,2,5,8,62.5,3,6,2,4,2,12,21,0,Matches
168,Andrija Balić,CRO,"FW,MF",Udinese,Serie A,20,1997,0.3,1,0,0,0,1,0,1,0.0,1,0,0,0,0,1,1,0,Matches
169,Fodé Ballo-Touré,SEN,DF,Lille,Ligue 1,21,1997,17.7,47,35,26,19,2,21,32,65.6,11,25,7,18,27,74,42,2,Matches
170,Fodé Ballo-Touré,SEN,DF,Monaco,Ligue 1,21,1997,17.7,46,31,26,16,4,20,40,50.0,20,20,2,18,28,74,38,2,Matches
171,Florent Balmont,FRA,MF,Dijon,Ligue 1,38,1980,12.0,29,16,16,10,3,9,36,25.0,27,13,2,11,6,35,8,0,Matches
172,Leon Balogun,NGA,DF,Brighton,Premier League,30,1988,6.6,12,6,11,1,0,8,9,88.9,1,5,3,2,17,29,32,1,Matches
173,Mario Balotelli,ITA,FW,Nice,Ligue 1,27,1990,8.4,1,0,0,1,0,1,4,25.0,3,9,1,8,1,2,8,0,Matches
174,Mario Balotelli,ITA,FW,Marseille,Ligue 1,27,1990,10.4,5,3,1,3,1,2,7,28.6,5,8,2,6,3,8,6,0,Matches
175,Abdoulaye Bamba,CIV,DF,Angers,Ligue 1,28,1990,28.6,51,29,31,14,6,24,44,54.5,20,20,4,16,37,88,86,0,Matches
176,Jonathan Bamba,CIV,"FW,MF",Lille,Ligue 1,22,1996,33.4,29,19,7,17,5,13,39,33.3,26,24,1,23,41,70,18,0,Matches
177,Sol Bamba,CIV,DF,Cardiff City,Premier League,33,1985,27.5,74,42,44,30,0,31,55,56.4,24,72,32,40,82,156,181,3,Matches
178,Yacine Bammou,MAR,"FW,MF",Caen,Ligue 1,26,1991,10.3,14,7,7,4,3,3,8,37.5,5,14,3,11,9,23,17,0,Matches
179,Éver Banega,ARG,MF,Sevilla,La Liga,30,1988,29.6,71,50,32,35,4,20,70,28.6,50,26,5,21,28,99,28,0,Matches
180,Mattia Bani,ITA,DF,Chievo,Serie A,24,1993,29.0,67,40,46,21,0,27,40,67.5,13,51,35,16,57,124,162,2,Matches
181,Léo Baptistão,BRA,"FW,MF",Espanyol,La Liga,25,1992,13.7,22,14,11,5,6,8,27,29.6,19,17,0,17,8,30,14,0,Matches
182,Antonín Barák,CZE,"MF,FW",Udinese,Serie A,23,1994,3.7,9,6,4,5,0,2,11,18.2,9,4,0,4,2,11,2,0,Matches
183,Federico Barba,ITA,DF,Chievo,Serie A,24,1993,27.6,30,14,21,9,0,8,21,38.1,13,29,15,14,65,95,129,0,Matches
184,Danilo Barbosa,BRA,MF,Nice,Ligue 1,22,1996,17.2,29,20,13,13,3,6,17,35.3,11,17,2,15,15,44,25,1,Matches
185,Enis Bardhi,MKD,MF,Levante,La Liga,23,1995,31.5,70,43,30,34,6,28,87,32.2,59,35,3,32,31,101,36,1,Matches
186,Francesco Bardi,ITA,GK,Frosinone,Serie A,26,1992,3.0,0,0,0,0,0,0,0,,0,0,0,0,0,0,2,0,Matches
187,Phil Bardsley,SCO,DF,Burnley,Premier League,33,1985,18.6,32,19,15,14,3,12,21,57.1,9,25,12,13,31,63,68,1,Matches
188,Nicolò Barella,ITA,MF,Cagliari,Serie A,21,1997,34.5,99,65,38,41,20,30,82,36.6,52,61,2,59,38,137,27,0,Matches
189,Philipp Bargfrede,GER,"MF,DF",Werder Bremen,Bundesliga,29,1989,12.0,23,15,9,12,2,10,28,35.7,18,35,11,24,34,57,45,1,Matches
190,Antonino Barillà,ITA,MF,Parma,Serie A,30,1988,29.1,64,36,40,17,7,19,53,35.8,34,40,13,27,36,100,50,1,Matches
191,Ross Barkley,ENG,MF,Chelsea,Premier League,24,1993,13.8,15,10,5,7,3,4,14,28.6,10,8,1,7,9,24,17,2,Matches
192,Aymen Barkok,MAR,MF,Düsseldorf,Bundesliga,20,1998,5.7,13,6,4,9,0,4,19,21.1,15,8,1,7,4,17,3,0,Matches
193,Ashley Barnes,ENG,FW,Burnley,Premier League,28,1989,26.5,28,17,4,17,7,6,29,20.7,23,29,8,21,2,30,25,0,Matches
194,Harvey Barnes,ENG,"MF,FW",Leicester City,Premier League,20,1997,11.2,10,6,5,4,1,4,6,66.7,2,7,1,6,3,13,7,0,Matches
195,Antonio Barragán,ESP,"DF,FW",Betis,La Liga,31,1987,10.4,14,8,9,4,1,2,12,16.7,10,15,4,11,5,19,30,2,Matches
196,Antonio Barreca,ITA,DF,Newcastle Utd,Premier League,23,1995,0.1,0,0,0,0,0,0,0,,0,0,0,0,0,0,0,0,Matches
197,Antonio Barreca,ITA,DF,Monaco,Ligue 1,23,1995,6.6,11,8,8,3,0,7,11,63.6,4,3,2,1,7,18,18,0,Matches
198,Leandro Barreiro Martins,LUX,MF,Mainz 05,Bundesliga,18,2000,1.0,4,4,2,0,2,1,2,50.0,1,0,0,0,2,6,1,0,Matches
199,Ander Barrenetxea,ESP,"FW,MF",Real Sociedad,La Liga,16,2001,4.4,7,2,2,0,5,2,8,25.0,6,8,0,8,4,11,1,0,Matches
200,Édgar Barreto,PAR,MF,Sampdoria,Serie A,34,1984,8.7,28,19,15,6,7,10,26,38.5,16,11,3,8,17,45,7,0,Matches
201,Musa Barrow,GAM,FW,Atalanta,Serie A,19,1998,6.7,9,5,5,3,1,4,6,66.7,2,4,0,4,0,9,2,0,Matches
202,Fin Bartels,GER,"MF,FW",Werder Bremen,Bundesliga,31,1987,0.3,0,0,0,0,0,0,1,0.0,1,0,0,0,1,1,0,0,Matches
203,Marc Bartra,ESP,DF,Betis,La Liga,27,1991,32.5,86,55,55,26,5,41,76,53.9,35,46,21,25,60,146,132,2,Matches
204,Andrea Barzagli,ITA,DF,Juventus,Serie A,37,1981,2.9,1,1,0,1,0,1,2,50.0,1,2,2,0,4,5,10,0,Matches
205,Daniele Baselli,ITA,MF,Torino,Serie A,26,1992,26.4,65,45,22,34,9,16,44,36.4,28,30,6,24,34,99,32,0,Matches
206,Toma Bašić,CRO,MF,Bordeaux,Ligue 1,21,1996,14.8,32,16,5,21,6,11,31,35.5,20,13,1,12,9,41,22,1,Matches
207,Thomas Basila,FRA,DF,Nantes,Ligue 1,19,1999,1.0,2,1,1,1,0,0,0,,0,2,1,1,0,2,8,0,Matches
208,Borja Bastón,ESP,FW,Alavés,La Liga,25,1992,16.0,16,7,4,9,3,2,24,8.3,22,16,5,11,4,20,10,0,Matches
209,Alessandro Bastoni,ITA,DF,Parma,Serie A,19,1999,18.8,25,12,20,5,0,6,15,40.0,9,26,18,8,22,47,96,0,Matches
210,Bastos,ANG,DF,Lazio,Serie A,27,1991,12.7,22,17,16,4,2,17,27,63.0,10,16,8,8,7,29,49,1,Matches
211,Michy Batshuayi,BEL,FW,Crystal Palace,Premier League,24,1993,8.3,2,1,1,1,0,1,2,50.0,1,8,3,5,3,5,0,0,Matches
212,Michy Batshuayi,BEL,FW,Valencia,La Liga,24,1993,5.9,1,1,0,1,0,0,3,0.0,3,5,2,3,0,1,3,0,Matches
213,Robert Bauer,GER,DF,Nürnberg,Bundesliga,23,1995,19.1,48,29,32,13,3,20,39,51.3,19,19,5,14,28,76,80,0,Matches
214,Oliver Baumann,GER,GK,Hoffenheim,Bundesliga,28,1990,33.0,0,0,0,0,0,0,0,,0,0,0,0,2,2,11,5,Matches
215,Timo Baumgartl,GER,DF,Stuttgart,Bundesliga,22,1996,18.0,33,23,21,12,0,11,19,57.9,8,31,22,9,26,59,100,0,Matches
216,Julian Baumgartlinger,AUT,MF,Leverkusen,Bundesliga,30,1988,17.3,52,30,24,20,8,20,45,44.4,25,18,6,12,26,78,21,1,Matches
217,Christoph Baumgartner,AUT,MF,Hoffenheim,Bundesliga,18,1999,0.9,1,0,0,0,1,1,3,33.3,2,2,0,2,0,1,0,0,Matches
218,Jon Bautista,ESP,FW,Real Sociedad,La Liga,23,1995,6.6,5,3,0,3,2,0,3,0.0,3,8,1,7,5,10,4,0,Matches
219,Paul Baysse,FRA,DF,Bordeaux,Ligue 1,30,1988,0.8,1,0,1,0,0,0,1,0.0,1,1,1,0,1,2,6,0,Matches
220,Paul Baysse,FRA,DF,Caen,Ligue 1,30,1988,19.9,25,14,20,5,0,13,18,72.2,5,25,20,5,31,56,113,1,Matches
221,Noah Joel Sarenren Bazee,NGA,"FW,MF",Hannover 96,Bundesliga,21,1996,1.7,0,0,0,0,0,0,0,,0,1,0,1,0,0,3,0,Matches
222,Claudio Beauvue,GLP,"FW,MF",Caen,Ligue 1,30,1988,16.7,18,11,7,9,2,1,14,7.1,13,11,2,9,10,28,21,0,Matches
223,Bebé,CPV,"FW,MF",Rayo Vallecano,La Liga,28,1990,14.5,19,9,10,4,5,9,19,47.4,10,16,1,15,9,28,16,1,Matches
224,Bebé,CPV,MF,Eibar,La Liga,28,1990,0.7,0,0,0,0,0,0,0,,0,1,0,1,1,1,0,0,Matches
225,Ihlas Bebou,TOG,"MF,FW",Hannover 96,Bundesliga,24,1994,11.8,15,9,4,10,1,4,9,44.4,5,18,2,16,9,24,9,0,Matches
226,Uffe Bech,DEN,FW,Hannover 96,Bundesliga,25,1993,0.2,0,0,0,0,0,0,1,0.0,1,0,0,0,0,0,0,0,Matches
227,Andreas Beck,GER,DF,Stuttgart,Bundesliga,31,1987,19.7,35,19,17,17,1,11,27,40.7,16,32,6,26,22,57,54,0,Matches
228,Jan Bednarek,POL,DF,Southampton,Premier League,22,1996,23.9,41,25,25,16,0,21,37,56.8,16,44,27,17,71,112,171,0,Matches
229,Andrea Beghetto,ITA,DF,Frosinone,Serie A,23,1994,24.7,26,14,13,10,3,15,25,60.0,10,20,4,16,17,43,59,0,Matches
230,Asmir Begović,BIH,GK,Bournemouth,Premier League,31,1987,24.0,0,0,0,0,0,0,3,0.0,3,1,0,1,1,1,15,7,Matches
231,Valon Behrami,SUI,MF,Udinese,Serie A,33,1985,15.1,65,38,25,34,6,18,44,40.9,26,29,12,17,18,83,26,0,Matches
232,Hanno Behrens,GER,MF,Nürnberg,Bundesliga,28,1990,29.3,46,26,29,17,0,21,47,44.7,26,43,13,30,33,79,49,0,Matches
233,Ishak Belfodil,ALG,"FW,MF",Hoffenheim,Bundesliga,26,1992,20.7,13,10,5,6,2,4,16,25.0,12,6,0,6,3,16,14,0,Matches
234,Stefan Bell,GER,DF,Mainz 05,Bundesliga,26,1991,25.0,31,20,18,13,0,15,34,44.1,19,31,11,20,54,85,122,1,Matches
235,Karim Bellarabi,GER,FW,Leverkusen,Bundesliga,28,1990,11.7,13,6,7,4,2,3,19,15.8,16,13,0,13,10,23,8,0,Matches
236,Héctor Bellerín,ESP,DF,Arsenal,Premier League,23,1995,17.0,15,12,8,4,3,6,13,46.2,7,17,5,12,20,35,37,3,Matches
237,Andrea Belotti,ITA,FW,Torino,Serie A,24,1993,36.7,33,22,8,15,10,6,30,20.0,24,36,5,31,15,48,23,0,Matches
238,Fran Beltrán,ESP,MF,Celta Vigo,La Liga,19,1999,16.9,23,17,8,12,3,13,31,41.9,18,19,2,17,19,42,15,1,Matches
239,Hatem Ben Arfa,FRA,"FW,MF",Rennes,Ligue 1,31,1987,22.6,15,7,4,8,3,7,16,43.8,9,9,0,9,4,19,0,0,Matches
240,Wissam Ben Yedder,FRA,FW,Sevilla,La Liga,27,1990,31.2,18,16,3,11,4,2,12,16.7,10,18,0,18,11,29,2,0,Matches
241,Diego Benaglio,SUI,GK,Monaco,Ligue 1,34,1983,22.9,1,0,1,0,0,1,1,100.0,0,0,0,0,0,1,16,0,Matches
242,Marco Benassi,ITA,MF,Fiorentina,Serie A,23,1994,25.4,30,19,8,15,7,14,41,34.1,27,16,3,13,9,39,27,1,Matches
243,Medhi Benatia,MAR,DF,Juventus,Serie A,31,1987,5.0,7,6,6,1,0,3,5,60.0,2,10,5,5,16,23,18,0,Matches
244,Lars Bender,GER,"MF,DF",Leverkusen,Bundesliga,29,1989,15.1,43,29,20,20,3,18,35,51.4,17,26,4,22,21,64,26,0,Matches
245,Sven Bender,GER,DF,Leverkusen,Bundesliga,29,1989,22.1,40,25,25,15,0,18,30,60.0,12,31,14,17,52,92,98,0,Matches
246,László Bénes,SVK,"MF,FW",Gladbach,Bundesliga,20,1997,0.3,3,1,3,0,0,3,3,100.0,0,1,0,1,0,3,0,0,Matches
247,Nicolas Benezet,FRA,"MF,FW",Guingamp,Ligue 1,27,1991,18.5,32,19,14,15,3,5,19,26.3,14,12,0,12,19,51,4,0,Matches
248,Walter Benítez,ARG,GK,Nice,Ligue 1,25,1993,35.0,1,0,1,0,0,1,2,50.0,1,0,0,0,2,3,6,2,Matches
249,Ismaël Bennacer,ALG,MF,Empoli,Serie A,20,1997,32.9,94,57,43,41,10,32,75,42.7,43,38,9,29,57,151,34,0,Matches
250,Joe Bennett,ENG,DF,Cardiff City,Premier League,28,1990,29.3,50,29,34,16,0,22,38,57.9,16,30,8,22,60,110,93,0,Matches
251,Ryan Bennett,ENG,DF,Wolves,Premier League,28,1990,34.0,58,32,41,16,1,25,41,61.0,16,42,21,21,43,101,131,1,Matches
252,Yassine Benrahou,FRA,"MF,FW",Bordeaux,Ligue 1,19,1999,2.0,9,6,1,7,1,2,5,40.0,3,4,0,4,2,11,1,0,Matches
253,Ramy Bensebaini,ALG,DF,Rennes,Ligue 1,23,1995,23.9,69,48,42,19,8,40,58,69.0,18,24,10,14,41,110,98,0,Matches
254,Nabil Bentaleb,ALG,MF,Schalke 04,Bundesliga,23,1994,19.9,32,17,8,21,3,4,18,22.2,14,28,8,20,35,67,19,0,Matches
255,Rodrigo Bentancur,URU,MF,Juventus,Serie A,21,1997,22.3,53,34,22,29,2,18,39,46.2,21,20,8,12,43,96,42,1,Matches
256,Christian Benteke,BEL,FW,Crystal Palace,Premier League,27,1990,9.0,5,1,0,4,1,1,4,25.0,3,7,2,5,0,5,14,0,Matches
257,Karim Benzema,FRA,FW,Real Madrid,La Liga,30,1987,32.8,24,11,2,11,11,2,17,11.8,15,16,1,15,8,32,25,0,Matches
258,Yassine Benzia,ALG,MF,Lille,Ligue 1,23,1994,1.8,1,1,0,1,0,1,1,100.0,0,0,0,0,1,2,1,0,Matches
259,Domenico Berardi,ITA,"FW,MF",Sassuolo,Serie A,23,1994,31.9,38,21,16,9,13,15,73,20.5,58,31,2,29,27,65,24,0,Matches
260,Yuri Berchiche,ESP,"DF,FW",Athletic Club,La Liga,28,1990,34.7,46,31,26,11,9,23,46,50.0,23,34,9,25,42,88,82,0,Matches
261,Álex Berenguer,ESP,"MF,DF",Torino,Serie A,23,1995,16.5,31,20,12,17,2,14,34,41.2,20,20,1,19,8,39,14,0,Matches
262,Bartosz Bereszyński,POL,DF,Sampdoria,Serie A,26,1992,24.4,46,30,27,15,4,24,51,47.1,27,22,7,15,31,77,76,0,Matches
263,Jóhann Berg Guðmundsson,ISL,MF,Burnley,Premier League,27,1990,19.5,27,11,14,10,3,16,34,47.1,18,25,4,21,33,60,34,0,Matches
264,Markel Bergara,ESP,MF,Getafe,La Liga,32,1986,0.6,2,2,0,1,1,2,3,66.7,1,3,0,3,1,3,2,0,Matches
265,Robert Berić,SVN,FW,Saint-Étienne,Ligue 1,27,1991,13.1,12,5,1,9,2,1,11,9.1,10,8,2,6,4,16,3,0,Matches
266,Etrit Berisha,ALB,GK,Atalanta,Serie A,29,1989,18.0,0,0,0,0,0,0,2,0.0,2,0,0,0,0,0,5,3,Matches
267,Valon Berisha,KVX,"MF,FW",Lazio,Serie A,25,1993,2.2,8,5,1,6,1,4,6,66.7,2,6,0,6,4,12,3,0,Matches
268,Bernard,BRA,"FW,MF",Everton,Premier League,25,1992,23.5,49,30,19,22,8,15,55,27.3,40,37,2,35,27,76,14,1,Matches
269,Federico Bernardeschi,ITA,"MF,FW",Juventus,Serie A,24,1994,16.4,14,8,5,6,3,7,18,38.9,11,9,0,9,6,20,10,0,Matches
270,Bernardo,BRA,DF,Brighton,Premier League,23,1995,19.5,62,43,43,13,6,31,45,68.9,14,32,13,19,34,96,82,0,Matches
271,Paul Bernardoni,FRA,GK,Nîmes,Ligue 1,21,1997,38.0,1,1,1,0,0,1,2,50.0,1,0,0,0,1,2,20,1,Matches
272,Juan Bernat,ESP,"DF,MF",Paris S-G,Ligue 1,25,1993,20.4,47,32,22,19,6,22,46,47.8,24,19,5,14,20,67,41,1,Matches
273,Antoine Bernede,FRA,MF,Paris S-G,Ligue 1,19,1999,1.9,13,7,3,8,2,5,9,55.6,4,3,1,2,3,16,1,1,Matches
274,Dimitry Bertaud,COD,GK,Montpellier,Ligue 1,20,1998,1.0,0,0,0,0,0,0,0,,0,0,0,0,0,0,0,0,Matches
275,Ryan Bertrand,ENG,DF,Southampton,Premier League,28,1989,24.0,46,27,22,20,4,16,31,51.6,15,27,5,22,28,74,51,0,Matches
276,Daniel Bessa,ITA,MF,Genoa,Serie A,25,1993,27.1,60,35,28,23,9,11,39,28.2,28,30,4,26,19,79,16,1,Matches
277,Marcus Bettinelli,ENG,GK,Fulham,Premier League,26,1992,7.0,0,0,0,0,0,0,0,,0,0,0,0,0,0,5,0,Matches
278,Jordan Beyer,GER,DF,Gladbach,Bundesliga,18,2000,8.0,32,18,21,10,1,17,24,70.8,7,12,6,6,11,43,32,0,Matches
279,Jonathan Biabiany,FRA,FW,Parma,Serie A,30,1988,11.9,30,22,18,10,2,9,17,52.9,8,8,1,7,11,41,11,1,Matches
280,Giulian Biancone,FRA,DF,Monaco,Ligue 1,18,2000,1.0,4,3,4,0,0,1,3,33.3,2,0,0,0,3,7,2,0,Matches
281,Ermin Bičakčić,BIH,DF,Hoffenheim,Bundesliga,28,1990,19.9,32,19,18,11,3,13,22,59.1,9,36,15,21,56,88,79,1,Matches
282,Pedro Bigas,ESP,DF,Eibar,La Liga,27,1990,6.5,4,3,2,0,2,1,5,20.0,4,6,2,4,8,12,22,0,Matches
283,Lucas Biglia,ARG,MF,Milan,Serie A,32,1986,12.4,60,33,31,25,4,20,45,44.4,25,19,3,16,22,82,21,1,Matches
284,Philip Billing,DEN,MF,Huddersfield,Premier League,22,1996,24.3,73,44,26,39,8,19,42,45.2,23,57,16,41,53,126,43,0,Matches
285,Cristiano Biraghi,ITA,DF,Fiorentina,Serie A,25,1992,35.5,52,33,31,17,4,18,38,47.4,20,40,17,23,44,96,113,0,Matches
286,Davide Biraschi,ITA,DF,Genoa,Serie A,24,1994,31.6,58,38,37,19,2,25,42,59.5,17,32,13,19,64,122,107,1,Matches
287,Valter Birsa,SVN,"MF,FW",Cagliari,Serie A,31,1986,3.9,5,3,1,3,1,4,8,50.0,4,5,0,5,4,9,3,0,Matches
288,Valter Birsa,SVN,"MF,FW",Chievo,Serie A,31,1986,12.2,14,9,4,7,3,4,17,23.5,13,9,1,8,6,20,13,0,Matches
289,Yves Bissouma,MLI,MF,Brighton,Premier League,21,1996,19.7,62,30,33,27,2,20,38,52.6,18,21,5,16,33,95,29,2,Matches
290,Leonardo Bittencourt,GER,MF,Hoffenheim,Bundesliga,24,1993,11.9,37,26,9,22,6,8,32,25.0,24,22,1,21,13,50,7,0,Matches
291,Alejandro Blanco,ESP,"FW,MF",Alavés,La Liga,19,1998,0.2,1,1,1,0,0,1,3,33.3,2,1,0,1,0,1,0,0,Matches
292,Rubén Blanco,ESP,GK,Celta Vigo,La Liga,23,1995,25.0,1,0,1,0,0,1,2,50.0,1,1,0,1,2,3,13,2,Matches
293,Ludovic Blas,FRA,"MF,FW",Guingamp,Ligue 1,20,1997,26.4,62,38,22,32,8,20,43,46.5,23,44,7,37,26,88,14,0,Matches
294,Pablo de Blasis,ARG,"DF,MF",Eibar,La Liga,30,1988,16.9,32,19,17,8,7,12,32,37.5,20,18,0,18,13,45,20,0,Matches
295,Pablo de Blasis,ARG,FW,Mainz 05,Bundesliga,30,1988,1.0,2,0,0,1,1,2,3,66.7,1,0,0,0,1,3,0,0,Matches
296,Alexis Blin,FRA,MF,Amiens,Ligue 1,21,1996,22.1,77,45,33,36,8,35,89,39.3,54,39,14,25,33,110,48,1,Matches
297,Danny Blum,GER,MF,Eint Frankfurt,Bundesliga,27,1991,0.0,0,0,0,0,0,0,0,,0,0,0,0,0,0,5,0,Matches
298,Emmanuel Boateng,GHA,FW,Levante,La Liga,22,1996,7.8,4,3,0,0,4,0,3,0.0,3,5,0,5,1,5,7,0,Matches
299,Jérôme Boateng,GER,DF,Bayern Munich,Bundesliga,29,1988,18.8,21,15,12,9,0,10,22,45.5,12,8,3,5,25,46,49,0,Matches
300,Kevin-Prince Boateng,GHA,FW,Sassuolo,Serie A,31,1987,10.4,5,4,0,4,1,1,4,25.0,3,7,3,4,3,8,13,0,Matches
301,Kevin-Prince Boateng,GHA,FW,Barcelona,La Liga,31,1987,2.7,3,2,0,1,2,0,1,0.0,1,1,0,1,1,4,4,0,Matches
302,Antonin Bobichon,FRA,MF,Nîmes,Ligue 1,22,1995,23.9,34,16,17,12,5,16,58,27.6,42,15,3,12,15,49,13,0,Matches
303,Yann Bodiger,FRA,MF,Toulouse,Ligue 1,23,1995,0.1,0,0,0,0,0,0,1,0.0,1,0,0,0,0,0,0,0,Matches
304,Mathieu Bodmer,FRA,"MF,FW",Amiens,Ligue 1,35,1982,11.9,15,11,3,11,1,3,10,30.0,7,3,0,3,2,17,10,0,Matches
305,Adam Bodzek,GER,"MF,DF",Düsseldorf,Bundesliga,32,1985,17.7,44,27,27,16,1,17,43,39.5,26,15,6,9,26,70,39,0,Matches
306,Jean-Paul Boëtius,NED,MF,Mainz 05,Bundesliga,24,1994,23.6,51,32,21,25,5,16,44,36.4,28,59,2,57,37,88,13,0,Matches
307,Sacha Boey,FRA,DF,Rennes,Ligue 1,17,2000,0.2,0,0,0,0,0,0,0,,0,0,0,0,0,0,0,0,Matches
308,Jeremie Boga,CIV,"FW,MF",Sassuolo,Serie A,21,1997,16.0,7,4,5,1,1,4,14,28.6,10,19,0,19,2,9,4,0,Matches
309,Willy Boly,CIV,DF,Wolves,Premier League,27,1991,35.2,85,52,49,34,2,34,56,60.7,22,55,32,23,72,157,177,6,Matches
310,Léo Bonatini,BRA,FW,Wolves,Premier League,24,1994,1.5,1,1,0,0,1,1,5,20.0,4,1,0,1,0,1,0,0,Matches
311,Giacomo Bonaventura,ITA,MF,Milan,Serie A,28,1989,7.2,6,2,2,4,0,2,7,28.6,5,3,0,3,7,13,8,0,Matches
312,Daniele Bonera,ITA,DF,Villarreal,La Liga,37,1981,2.6,2,2,2,0,0,1,1,100.0,0,5,5,0,4,6,10,0,Matches
313,Gaëtan Bong,CMR,DF,Brighton,Premier League,30,1988,20.1,16,10,7,6,3,6,10,60.0,4,16,6,10,25,41,57,2,Matches
314,Kevin Bonifazi,ITA,DF,SPAL,Serie A,22,1996,25.6,40,24,31,8,1,15,33,45.5,18,38,21,17,36,76,79,0,Matches
315,Leonardo Bonucci,ITA,DF,Juventus,Serie A,31,1987,27.5,18,9,11,6,1,10,13,76.9,3,32,21,11,38,56,88,3,Matches
316,Fabio Borini,ITA,"FW,DF",Milan,Serie A,27,1991,11.7,14,10,7,7,0,3,9,33.3,6,17,0,17,12,26,28,0,Matches
317,Robin Bormuth,GER,DF,Düsseldorf,Bundesliga,22,1995,6.8,7,4,7,0,0,5,10,50.0,5,6,4,2,10,17,49,1,Matches
318,Artur Boruc,POL,GK,Bournemouth,Premier League,38,1980,12.0,1,0,1,0,0,1,3,33.3,2,0,0,0,0,1,1,0,Matches
319,Olivier Boscagli,FRA,DF,Nice,Ligue 1,20,1997,9.6,20,12,14,4,2,9,20,45.0,11,12,1,11,17,37,37,0,Matches
320,Gabriel Boschilia,BRA,"FW,MF",Nantes,Ligue 1,22,1996,14.7,33,23,11,9,13,8,33,24.2,25,14,2,12,8,41,7,0,Matches
321,John Bostock,TRI,MF,Toulouse,Ligue 1,26,1992,10.9,24,14,14,10,0,9,30,30.0,21,12,2,10,17,41,11,0,Matches
322,Denis Bouanga,GAB,"MF,FW",Nîmes,Ligue 1,23,1994,29.3,52,32,21,22,9,13,61,21.3,48,24,3,21,20,72,16,0,Matches
323,Zacharie Boucher,FRA,GK,Angers,Ligue 1,26,1992,2.0,0,0,0,0,0,0,0,,0,1,0,1,0,0,1,0,Matches
324,Ryad Boudebouz,ALG,"MF,FW",Celta Vigo,La Liga,28,1990,8.0,14,4,4,6,4,3,8,37.5,5,9,1,8,3,17,9,0,Matches
325,Ryad Boudebouz,ALG,"MF,FW",Betis,La Liga,28,1990,6.0,8,4,4,1,3,4,10,40.0,6,5,1,4,5,13,2,0,Matches
326,Sofiane Boufal,MAR,"MF,FW",Celta Vigo,La Liga,24,1993,23.2,35,21,18,11,6,15,47,31.9,32,24,0,24,10,45,12,0,Matches
327,Nassim Boujellab,MAR,MF,Schalke 04,Bundesliga,19,1999,4.2,10,4,3,6,1,3,11,27.3,8,6,0,6,2,12,3,0,Matches
328,Arnold Bouka Moutou,CGO,"DF,FW",Dijon,Ligue 1,29,1988,0.7,3,1,2,1,0,0,4,0.0,4,1,0,1,3,6,1,0,Matches
329,Yassine Bounou,MAR,GK,Girona,La Liga,27,1991,31.8,0,0,0,0,0,0,2,0.0,2,0,0,0,1,1,7,2,Matches
330,Mehdi Bourabia,MAR,MF,Sassuolo,Serie A,26,1991,22.3,51,28,23,21,7,15,46,32.6,31,28,5,23,33,84,32,0,Matches
331,Benjamin Bourigeaud,FRA,"MF,FW",Rennes,Ligue 1,24,1994,26.9,55,35,23,21,11,20,67,29.9,47,44,5,39,32,87,34,1,Matches
332,Bilal Boutobba,FRA,"FW,MF",Montpellier,Ligue 1,19,1998,0.4,0,0,0,0,0,0,2,0.0,2,0,0,0,0,0,0,0,Matches
333,Umut Bozok,TUR,FW,Nîmes,Ligue 1,21,1996,13.7,9,6,0,3,6,2,4,50.0,2,3,0,3,5,14,1,0,Matches
334,Filip Bradarić,CRO,MF,Cagliari,Serie A,26,1992,16.6,26,21,11,12,3,10,20,50.0,10,13,3,10,39,65,50,0,Matches
335,Robbie Brady,IRL,MF,Burnley,Premier League,26,1992,8.0,15,7,5,5,5,6,17,35.3,11,7,1,6,7,22,18,1,Matches
336,Martin Braithwaite,DEN,FW,Leganés,La Liga,27,1991,15.6,5,3,0,0,5,0,4,0.0,4,9,0,9,3,8,4,0,Matches
337,Julian Brandt,GER,"MF,FW",Leverkusen,Bundesliga,22,1996,29.6,27,16,13,10,4,7,43,16.3,36,27,1,26,17,44,12,1,Matches
338,Darko Brašanac,SRB,MF,Alavés,La Liga,26,1992,17.6,32,16,15,13,4,10,26,38.5,16,17,4,13,13,45,19,0,Matches
339,Pedro Brazão,POR,"MF,FW",Nice,Ligue 1,15,2002,0.2,0,0,0,0,0,0,1,0.0,1,0,0,0,0,0,0,0,Matches
340,Fabian Bredlow,GER,GK,Nürnberg,Bundesliga,23,1995,12.5,1,1,1,0,0,1,1,100.0,0,0,0,0,1,2,3,4,Matches
341,Josip Brekalo,CRO,"FW,MF",Wolfsburg,Bundesliga,20,1998,15.7,15,7,7,6,2,5,18,27.8,13,15,1,14,12,27,9,1,Matches
342,Gleison Bremer,BRA,DF,Torino,Serie A,21,1997,2.0,3,1,1,2,0,1,2,50.0,1,4,1,3,8,11,9,0,Matches
343,Joshua Brenet,CUW,DF,Hoffenheim,Bundesliga,24,1994,10.1,20,13,12,5,3,7,13,53.8,6,16,1,15,8,28,19,0,Matches
344,Rajko Brežančić,SRB,DF,Huesca,La Liga,28,1989,0.7,1,0,0,0,1,0,0,,0,0,0,0,0,1,0,0,Matches
345,Anthony Briançon,FRA,DF,Nîmes,Ligue 1,23,1994,32.5,46,27,36,10,0,27,50,54.0,23,51,38,13,70,116,184,1,Matches
346,Jimmy Briand,FRA,FW,Bordeaux,Ligue 1,32,1985,27.7,14,8,2,10,2,4,24,16.7,20,14,6,8,4,18,29,0,Matches
347,Nicolò Brighenti,ITA,DF,Frosinone,Serie A,28,1989,11.0,27,17,9,15,3,6,14,42.9,8,17,8,9,31,58,37,0,Matches
348,Matteo Brighi,ITA,MF,Empoli,Serie A,37,1981,2.6,11,4,2,9,0,2,9,22.2,7,2,0,2,3,14,4,0,Matches
349,Enrico Brignola,ITA,"FW,MF",Sassuolo,Serie A,19,1999,1.9,2,2,2,0,0,0,2,0.0,2,0,0,0,1,3,1,0,Matches
350,Miguel Britos,URU,DF,Watford,Premier League,33,1985,2.1,4,2,4,0,0,2,4,50.0,2,1,1,0,3,7,11,1,Matches
351,David Brooks,WAL,"MF,FW",Bournemouth,Premier League,21,1997,25.1,37,26,12,19,6,19,44,43.2,25,36,7,29,24,61,28,0,Matches
352,John Brooks,USA,DF,Wolfsburg,Bundesliga,25,1993,29.0,29,15,18,9,2,13,27,48.1,14,28,13,15,37,66,135,3,Matches
353,Daniel Brosinski,GER,DF,Mainz 05,Bundesliga,30,1988,24.5,27,16,16,10,1,18,33,54.5,15,30,9,21,26,53,58,0,Matches
354,Marcelo Brozović,CRO,MF,Inter,Serie A,25,1992,29.4,101,70,47,40,14,31,86,36.0,55,45,8,37,44,145,32,3,Matches
355,Bruma,POR,MF,RB Leipzig,Bundesliga,23,1994,6.1,5,2,3,1,1,1,5,20.0,4,4,0,4,4,9,2,0,Matches
356,Jeffrey Bruma,NED,DF,Schalke 04,Bundesliga,26,1991,6.9,12,11,8,4,0,6,12,50.0,6,8,2,6,4,16,35,0,Matches
357,Bruno,ESP,DF,Brighton,Premier League,37,1980,12.6,25,16,20,3,2,14,18,77.8,4,7,2,5,11,36,30,1,Matches
358,Jacob Bruun Larsen,DEN,FW,Dortmund,Bundesliga,19,1998,14.1,15,9,8,2,5,7,17,41.2,10,15,1,14,13,28,12,0,Matches
359,Joe Bryan,ENG,"DF,MF",Fulham,Premier League,24,1993,26.1,61,41,35,21,5,24,42,57.1,18,34,12,22,31,92,82,1,Matches
360,Gianluigi Buffon,ITA,GK,Paris S-G,Ligue 1,40,1978,17.0,0,0,0,0,0,0,1,0.0,1,0,0,0,0,0,5,0,Matches
361,Niko Bungert,GER,DF,Mainz 05,Bundesliga,31,1986,3.2,7,5,5,2,0,5,5,100.0,0,7,6,1,4,11,16,0,Matches
362,Guido Burgstaller,AUT,FW,Schalke 04,Bundesliga,29,1989,17.0,11,9,2,5,4,3,8,37.5,5,5,0,5,2,13,10,0,Matches
363,Burgui,ESP,"MF,FW",Alavés,La Liga,24,1993,6.2,6,6,4,2,0,1,3,33.3,2,4,0,4,0,6,2,1,Matches
364,Jonathan Burkardt,GER,"FW,MF",Mainz 05,Bundesliga,18,2000,2.9,4,4,2,1,1,1,2,50.0,1,2,0,2,3,7,5,0,Matches
365,Roman Bürki,SUI,GK,Dortmund,Bundesliga,27,1990,32.0,1,0,1,0,0,1,2,50.0,1,1,0,1,2,3,8,4,Matches
366,Patrick Burner,MTQ,DF,Nice,Ligue 1,22,1996,15.0,36,23,22,10,4,16,34,47.1,18,15,5,10,31,67,40,0,Matches
367,Sergio Busquets,ESP,MF,Barcelona,La Liga,30,1988,30.2,90,60,35,45,10,41,89,46.1,48,43,8,35,54,144,22,1,Matches
368,Gaëtan Bussmann,FRA,DF,Mainz 05,Bundesliga,27,1991,1.0,2,1,2,0,0,2,5,40.0,3,0,0,0,1,3,2,0,Matches
369,Unai Bustinza,ESP,DF,Leganés,La Liga,26,1992,22.5,41,31,25,14,2,17,33,51.5,16,31,13,18,53,94,110,2,Matches
370,Ludovic Butelle,FRA,GK,Angers,Ligue 1,35,1983,36.0,1,0,1,0,0,1,1,100.0,0,0,0,0,1,2,31,1,Matches
371,David Button,ENG,GK,Brighton,Premier League,29,1989,4.0,0,0,0,0,0,0,0,,0,0,0,0,0,0,2,0,Matches
372,Jakub Błaszczykowski,POL,MF,Wolfsburg,Bundesliga,32,1985,0.1,0,0,0,0,0,0,0,,0,0,0,0,0,0,0,0,Matches
373,Erick Cabaco,URU,DF,Levante,La Liga,23,1995,18.1,22,13,19,3,0,12,29,41.4,17,29,14,15,29,51,69,0,Matches
374,Willy Caballero,ARG,GK,Chelsea,Premier League,36,1981,2.0,0,0,0,0,0,0,0,,0,0,0,0,0,0,1,0,Matches
375,Rémy Cabella,FRA,"MF,FW",Saint-Étienne,Ligue 1,28,1990,33.3,88,51,31,38,19,30,87,34.5,57,39,1,38,19,107,5,3,Matches
376,Gustavo Cabral,ARG,DF,Celta Vigo,La Liga,32,1985,21.1,37,26,28,7,2,17,27,63.0,10,31,11,20,33,70,102,1,Matches
377,Rafael Cabral,BRA,GK,Sampdoria,Serie A,28,1990,2.0,0,0,0,0,0,0,0,,0,0,0,0,0,0,0,0,Matches
378,Leandro Cabrera,URU,DF,Getafe,La Liga,27,1991,31.0,47,26,28,17,2,24,41,58.5,17,29,16,13,52,99,216,2,Matches
379,Fabrizio Cacciatore,ITA,DF,Cagliari,Serie A,31,1986,6.4,9,7,7,0,2,1,5,20.0,4,6,4,2,7,16,17,0,Matches
380,Fabrizio Cacciatore,ITA,DF,Chievo,Serie A,31,1986,5.5,8,4,6,2,0,4,9,44.4,5,8,2,6,5,13,20,0,Matches
381,Martín Cáceres,URU,DF,Lazio,Serie A,31,1987,3.4,4,2,3,1,0,4,6,66.7,2,4,0,4,0,4,12,1,Matches
382,Martín Cáceres,URU,DF,Juventus,Serie A,31,1987,7.0,7,3,6,0,1,4,4,100.0,0,6,3,3,4,11,14,0,Matches
383,Anthony Caci,FRA,DF,Strasbourg,Ligue 1,21,1997,25.5,56,30,38,14,4,24,46,52.2,22,20,10,10,47,103,63,0,Matches
384,Mathieu Cafaro,FRA,"FW,MF",Reims,Ligue 1,21,1997,23.3,59,28,29,24,6,18,63,28.6,45,28,0,28,20,79,14,0,Matches
385,Gary Cahill,ENG,DF,Chelsea,Premier League,32,1985,0.3,0,0,0,0,0,0,0,,0,0,0,0,0,0,1,0,Matches
386,Yannick Cahuzac,FRA,"MF,DF",Toulouse,Ligue 1,33,1985,15.9,33,19,15,15,3,17,32,53.1,15,16,4,12,24,57,55,0,Matches
387,Felipe Caicedo,ECU,FW,Lazio,Serie A,29,1988,15.2,16,12,4,6,6,1,8,12.5,7,9,2,7,5,21,5,0,Matches
388,Marc-Aurèle Caillard,FRA,GK,Guingamp,Ligue 1,24,1994,21.0,0,0,0,0,0,0,2,0.0,2,0,0,0,2,2,8,3,Matches
389,Tom Cairney,SCO,"MF,FW",Fulham,Premier League,27,1991,24.4,37,21,9,22,6,12,16,75.0,4,21,5,16,10,47,13,1,Matches
390,Caiuby,BRA,"MF,FW",Augsburg,Bundesliga,30,1988,11.2,12,10,5,6,1,3,11,27.3,8,16,1,15,5,17,10,0,Matches
391,Arturo Calabresi,ITA,DF,Bologna,Serie A,22,1996,15.7,46,27,22,17,7,22,40,55.0,18,18,3,15,34,80,60,0,Matches
392,Davide Calabria,ITA,DF,Milan,Serie A,21,1996,21.7,79,51,58,16,5,37,67,55.2,30,33,1,32,32,111,78,1,Matches
393,Jordi Calavera,ESP,DF,Eibar,La Liga,22,1995,0.0,0,0,0,0,0,0,0,,0,0,0,0,0,0,0,0,Matches
394,Fernando Calero,ESP,DF,Valladolid,La Liga,22,1995,34.8,51,31,33,18,0,23,38,60.5,15,55,31,24,55,106,170,0,Matches
395,Duje Ćaleta-Car,CRO,DF,Marseille,Ligue 1,21,1996,17.2,22,16,14,8,0,14,18,77.8,4,15,9,6,20,42,86,2,Matches
396,Hakan Çalhanoğlu,TUR,"MF,FW",Milan,Serie A,24,1994,32.0,52,31,27,16,9,23,46,50.0,23,27,5,22,28,80,19,0,Matches
397,Daniel Caligiuri,ITA,"DF,FW",Schalke 04,Bundesliga,30,1988,30.6,93,52,55,29,9,44,103,42.7,59,66,10,56,50,143,72,1,Matches
398,José Callejón,ESP,"MF,FW",Napoli,Serie A,31,1987,29.4,34,18,12,14,8,18,57,31.6,39,34,5,29,22,56,11,0,Matches
399,Jonathan Calleri,ARG,FW,Alavés,La Liga,24,1993,31.9,20,13,3,11,6,1,24,4.2,23,34,7,27,7,27,53,0,Matches
400,Jan-Ingwer Callsen-Bracker,GER,DF,Augsburg,Bundesliga,33,1984,0.1,0,0,0,0,0,0,0,,0,0,0,0,0,0,0,0,Matches
401,Dominic Calvert-Lewin,ENG,FW,Everton,Premier League,21,1997,19.8,13,7,3,3,7,7,15,46.7,8,16,3,13,7,20,19,0,Matches
402,Ignacio Camacho,ESP,MF,Wolfsburg,Bundesliga,28,1990,6.0,15,9,9,6,0,3,7,42.9,4,7,2,5,18,33,12,0,Matches
403,Juanjo Camacho,ESP,"MF,DF",Huesca,La Liga,37,1980,0.4,1,1,1,0,0,1,1,100.0,0,0,0,0,0,1,1,0,Matches
404,Rafael Camacho,POR,DF,Liverpool,Premier League,18,2000,0.0,1,0,1,0,0,1,1,100.0,0,0,0,0,0,1,0,0,Matches
405,Mahdi Camara,FRA,FW,Saint-Étienne,Ligue 1,20,1998,0.1,0,0,0,0,0,0,0,,0,0,0,0,0,0,2,0,Matches
406,Souleymane Camara,SEN,"FW,MF",Montpellier,Ligue 1,35,1982,1.5,0,0,0,0,0,0,2,0.0,2,0,0,0,0,0,3,0,Matches
407,Víctor Camarasa,ESP,MF,Cardiff City,Premier League,24,1994,28.5,28,15,8,15,5,6,31,19.4,25,17,2,15,33,61,28,1,Matches
408,Eduardo Camavinga,FRA,MF,Rennes,Ligue 1,15,2002,4.0,23,15,8,12,3,8,18,44.4,10,13,2,11,4,27,4,0,Matches
409,Sergio Camello,ESP,FW,Atlético Madrid,La Liga,17,2001,0.5,1,0,1,0,0,1,1,100.0,0,0,0,0,0,1,0,0,Matches
410,José Campaña,ESP,MF,Levante,La Liga,25,1993,35.7,65,45,31,29,5,27,86,31.4,59,51,7,44,48,113,46,1,Matches
411,Joel Campbell,CRC,"FW,MF",Frosinone,Serie A,26,1992,9.9,15,10,5,8,2,3,17,17.6,14,2,0,2,3,18,2,1,Matches
412,Emre Can,GER,MF,Juventus,Serie A,24,1994,20.1,64,38,28,27,9,24,40,60.0,16,43,13,30,28,92,36,2,Matches
413,Sergio Canales,ESP,MF,Betis,La Liga,27,1991,29.5,44,30,19,18,7,11,53,20.8,42,34,3,31,9,53,8,1,Matches
414,João Cancelo,POR,DF,Juventus,Serie A,24,1994,21.9,43,28,18,18,7,27,49,55.1,22,14,4,10,15,58,48,0,Matches
415,Antonio Candreva,ITA,"FW,MF",Inter,Serie A,31,1987,5.6,1,1,0,1,0,1,8,12.5,7,0,0,0,4,5,9,0,Matches
416,Ander Capa,ESP,"DF,FW",Athletic Club,La Liga,26,1992,18.2,43,27,32,8,3,13,27,48.1,14,20,2,18,30,73,47,0,Matches
417,Luan Capanni,BRA,FW,Lazio,Serie A,18,2000,0.1,1,1,0,0,1,0,0,,0,0,0,0,0,1,0,0,Matches
418,Pierrick Capelle,FRA,"DF,MF",Angers,Ligue 1,31,1987,20.5,51,31,23,22,6,19,54,35.2,35,23,2,21,38,89,49,0,Matches
419,Leonardo Capezzi,ITA,MF,Empoli,Serie A,23,1995,8.6,14,9,6,8,0,7,13,53.8,6,14,4,10,10,24,13,0,Matches
420,Étienne Capoue,FRA,MF,Watford,Premier League,30,1988,32.7,91,56,36,48,7,33,87,37.9,54,50,13,37,85,176,96,1,Matches
421,Gianluca Caprari,ITA,"FW,MF",Sampdoria,Serie A,25,1993,11.5,15,9,4,9,2,5,12,41.7,7,7,0,7,4,19,3,0,Matches
422,Marco Capuano,ITA,DF,Frosinone,Serie A,26,1991,25.6,53,33,37,15,1,26,46,56.5,20,44,31,13,34,87,101,2,Matches
423,Francesco Caputo,ITA,FW,Empoli,Serie A,30,1987,38.0,13,9,2,4,7,3,10,30.0,7,11,1,10,2,15,11,0,Matches
424,Yoan Cardinale,FRA,GK,Nice,Ligue 1,24,1994,3.0,1,0,1,0,0,1,1,100.0,0,0,0,0,0,1,1,0,Matches
425,Marc Cardona,ESP,"FW,MF",Eibar,La Liga,23,1995,6.7,7,5,2,1,4,2,6,33.3,4,7,0,7,1,8,3,0,Matches
426,Diego Carlos,BRA,DF,Nantes,Ligue 1,25,1993,35.0,58,34,43,14,1,26,33,78.8,7,44,31,13,50,108,186,1,Matches
427,Jonas Carls,GER,FW,Schalke 04,Bundesliga,21,1997,1.0,5,2,4,0,1,5,5,100.0,0,0,0,0,1,6,0,0,Matches
428,Louis Carnot,FRA,MF,Guingamp,Ligue 1,17,2001,0.1,0,0,0,0,0,0,0,,0,0,0,0,0,0,0,0,Matches
429,Lionel Carole,FRA,"DF,FW",Strasbourg,Ligue 1,27,1991,19.2,25,12,16,7,2,11,16,68.8,5,19,5,14,32,57,51,0,Matches
430,Daniel Carriço,POR,DF,Sevilla,La Liga,29,1988,23.7,35,18,23,11,1,12,20,60.0,8,19,12,7,31,66,104,1,Matches
431,Guido Carrillo,ARG,FW,Leganés,La Liga,27,1991,22.1,25,14,4,12,9,6,19,31.6,13,12,1,11,8,33,25,0,Matches
432,Andy Carroll,ENG,FW,West Ham,Premier League,29,1989,5.1,4,2,1,3,0,1,4,25.0,3,3,2,1,1,5,8,0,Matches
433,Dani Carvajal,ESP,DF,Real Madrid,La Liga,26,1992,23.4,40,24,17,15,8,18,41,43.9,23,31,7,24,26,66,35,0,Matches
434,William Carvalho,POR,MF,Betis,La Liga,26,1992,26.5,45,27,20,21,4,16,29,55.2,13,8,0,8,12,57,30,0,Matches
435,Casemiro,BRA,MF,Real Madrid,La Liga,26,1992,25.7,86,52,44,35,7,38,94,40.4,56,52,12,40,41,127,56,3,Matches
436,Santiago Cáseres,ARG,MF,Villarreal,La Liga,21,1997,17.6,67,35,20,38,9,25,57,43.9,32,22,9,13,14,81,24,1,Matches
437,Moreto Cassamã,GNB,MF,Reims,Ligue 1,20,1998,0.7,3,3,1,2,0,1,7,14.3,6,1,0,1,1,4,2,0,Matches
438,Francesco Cassata,ITA,MF,Frosinone,Serie A,21,1997,12.5,20,11,12,4,4,9,23,39.1,14,8,1,7,6,26,15,1,Matches
439,Timothy Castagne,BEL,DF,Atalanta,Serie A,22,1995,22.3,61,39,30,22,9,32,57,56.1,25,32,6,26,28,89,50,0,Matches
440,Koen Casteels,BEL,GK,Wolfsburg,Bundesliga,26,1992,25.5,1,0,1,0,0,1,2,50.0,1,1,0,1,0,1,11,1,Matches
441,Samu Castillejo,ESP,"FW,MF",Milan,Serie A,23,1995,11.4,15,10,10,2,3,4,25,16.0,21,16,0,16,8,23,11,0,Matches
442,Gonzalo Castro,GER,MF,Stuttgart,Bundesliga,31,1987,18.8,50,28,21,25,4,19,43,44.2,24,23,5,18,29,79,22,1,Matches
443,Jonny Castro,ESP,"DF,MF",Wolves,Premier League,24,1994,30.8,79,43,42,33,4,31,60,51.7,29,45,8,37,60,139,64,2,Matches
444,Lucas Castro,ARG,MF,Cagliari,Serie A,29,1989,10.0,18,11,8,8,2,8,23,34.8,15,20,4,16,17,35,6,0,Matches
445,Danilo Cataldi,ITA,"MF,FW",Lazio,Serie A,23,1994,6.4,12,7,4,5,3,2,9,22.2,7,3,0,3,7,19,6,0,Matches
446,Catena,ESP,DF,Rayo Vallecano,La Liga,23,1994,2.0,4,4,3,1,0,2,2,100.0,0,4,2,2,8,12,8,0,Matches
447,Craig Cathcart,NIR,DF,Watford,Premier League,29,1989,34.4,50,31,36,11,3,21,37,56.8,16,42,30,12,38,88,184,4,Matches
448,Ivan Cavaleiro,POR,"FW,MF",Wolves,Premier League,24,1993,7.7,5,4,3,1,1,1,14,7.1,13,12,0,12,4,9,5,0,Matches
449,Edinson Cavani,URU,FW,Paris S-G,Ligue 1,31,1987,18.6,11,8,1,4,6,3,13,23.1,10,11,2,9,6,17,16,0,Matches
450,Santi Cazorla,ESP,"MF,FW",Villarreal,La Liga,33,1984,29.4,69,34,32,26,11,24,69,34.8,45,35,6,29,28,97,17,1,Matches
451,Dani Ceballos,ESP,"MF,FW",Real Madrid,La Liga,21,1996,13.9,32,21,9,16,7,11,31,35.5,20,26,1,25,15,47,6,0,Matches
452,Federico Ceccherini,ITA,DF,Fiorentina,Serie A,26,1992,11.0,13,10,8,3,2,5,9,55.6,4,12,8,4,21,34,40,0,Matches
453,Petr Čech,CZE,GK,Arsenal,Premier League,36,1982,6.5,1,1,1,0,0,1,1,100.0,0,0,0,0,0,1,5,2,Matches
454,Žan Celar,SVN,FW,Roma,Serie A,19,1999,0.1,0,0,0,0,0,0,0,,0,0,0,0,0,0,0,0,Matches
455,Zeki Çelik,TUR,DF,Lille,Ligue 1,21,1997,33.0,90,59,40,39,11,36,89,40.4,53,34,5,29,34,124,89,1,Matches
456,Luca Ceppitelli,ITA,DF,Cagliari,Serie A,28,1989,22.8,40,24,28,11,1,13,22,59.1,9,34,24,10,20,60,111,2,Matches
457,Fabio Ceravolo,ITA,FW,Parma,Serie A,31,1987,13.2,5,1,2,1,2,1,11,9.1,10,9,1,8,2,7,19,0,Matches
458,Alberto Cerri,ITA,FW,Cagliari,Serie A,22,1996,7.4,3,2,2,1,0,0,7,0.0,7,7,1,6,2,5,4,0,Matches
459,Boštjan Cesar,SVN,DF,Chievo,Serie A,36,1982,12.0,16,10,9,7,0,7,17,41.2,10,14,8,6,14,30,60,2,Matches
460,Nacer Chadli,BEL,"MF,DF",Monaco,Ligue 1,28,1989,7.7,11,5,4,4,3,3,8,37.5,5,7,1,6,3,14,7,0,Matches
461,Fouad Chafik,MAR,DF,Dijon,Ligue 1,31,1986,20.5,44,31,29,12,3,23,36,63.9,13,17,3,14,25,69,71,0,Matches
462,Nathaniel Chalobah,ENG,MF,Watford,Premier League,23,1994,3.0,3,2,1,2,0,2,7,28.6,5,2,1,1,5,8,7,0,Matches
463,Calum Chambers,ENG,"MF,DF",Fulham,Premier League,23,1995,28.8,64,36,32,27,5,16,48,33.3,32,37,12,25,69,133,113,4,Matches
464,Timothy Chandler,USA,DF,Eint Frankfurt,Bundesliga,28,1990,0.2,0,0,0,0,0,0,0,,0,0,0,0,0,0,0,0,Matches
465,Kwon Chang-hoon,KOR,"FW,MF",Dijon,Ligue 1,24,1994,10.4,7,4,3,2,2,0,12,0.0,12,16,0,16,8,15,8,0,Matches
466,Charles,BRA,FW,Eibar,La Liga,34,1984,19.3,7,5,1,3,3,2,13,15.4,11,14,1,13,4,11,14,0,Matches
467,Xavier Chavalerin,FRA,MF,Reims,Ligue 1,27,1991,36.0,106,61,56,39,11,28,72,38.9,44,44,12,32,72,178,39,1,Matches
468,Pablo Chavarría,ARG,FW,Reims,Ligue 1,30,1988,21.9,20,12,8,6,6,3,15,20.0,12,11,0,11,4,24,19,0,Matches
469,Chechu,ESP,DF,Rayo Vallecano,La Liga,36,1982,1.0,0,0,0,0,0,0,2,0.0,2,0,0,0,2,2,5,0,Matches
470,Pape Cheikh Diop,SEN,MF,Lyon,Ligue 1,20,1997,5.0,1,0,0,1,0,0,5,0.0,5,6,2,4,2,3,2,1,Matches
471,Chema,ESP,DF,Levante,La Liga,26,1992,13.9,27,19,16,9,2,13,19,68.4,6,19,11,8,19,46,83,0,Matches
472,Denis Cheryshev,RUS,MF,Valencia,La Liga,27,1990,19.0,46,32,15,22,9,17,37,45.9,20,35,3,32,15,61,16,0,Matches
473,Raman Chibsah,GHA,MF,Frosinone,Serie A,25,1993,29.1,46,27,25,19,2,16,54,29.6,38,45,10,35,32,78,28,1,Matches
474,Leandro Chichizola,ARG,GK,Getafe,La Liga,28,1990,1.0,0,0,0,0,0,0,0,,0,0,0,0,0,0,1,0,Matches
475,Giorgio Chiellini,ITA,DF,Juventus,Serie A,33,1984,22.1,24,13,20,2,2,5,8,62.5,3,22,15,7,30,54,96,1,Matches
476,Federico Chiesa,ITA,FW,Fiorentina,Serie A,20,1997,33.7,46,27,8,17,21,10,40,25.0,30,24,1,23,10,56,12,0,Matches
477,Ben Chilwell,ENG,DF,Leicester City,Premier League,21,1996,36.0,55,29,34,18,3,24,55,43.6,31,37,7,30,38,93,156,0,Matches
478,Vlad Chiricheș,ROU,DF,Napoli,Serie A,28,1989,1.6,2,1,1,1,0,0,2,0.0,2,2,2,0,1,3,2,0,Matches
479,Tahith Chong,NED,FW,Manchester Utd,Premier League,18,1999,0.4,0,0,0,0,0,0,0,,0,1,0,1,0,0,1,0,Matches
480,Hamza Choudhury,ENG,MF,Leicester City,Premier League,20,1997,6.6,24,10,13,10,1,9,15,60.0,6,12,3,9,15,39,13,0,Matches
481,Andreas Christensen,DEN,DF,Chelsea,Premier League,22,1996,6.9,10,4,2,6,2,2,5,40.0,3,4,2,2,4,14,29,0,Matches
482,Cyrus Christie,IRL,"DF,MF",Fulham,Premier League,25,1992,21.6,43,23,26,13,4,18,41,43.9,23,25,11,14,29,72,96,1,Matches
483,Samuel Chukwueze,NGA,"MF,FW",Villarreal,La Liga,19,1999,19.0,19,11,7,10,2,9,31,29.0,22,11,2,9,10,29,2,0,Matches
484,Camillo Ciano,ITA,"FW,MF",Frosinone,Serie A,28,1990,27.3,33,15,12,10,11,8,50,16.0,42,28,4,24,8,41,16,0,Matches
485,Amato Ciciretti,ITA,"FW,MF",Parma,Serie A,24,1993,1.5,1,0,1,0,0,0,0,,0,3,0,3,3,4,0,0,Matches
486,Luca Cigarini,ITA,MF,Cagliari,Serie A,32,1986,18.7,54,33,27,22,5,28,63,44.4,35,28,5,23,26,80,41,0,Matches
487,Per Ciljan Skjelbred,NOR,MF,Hertha BSC,Bundesliga,31,1987,11.1,26,18,13,12,1,5,22,22.7,17,10,1,9,20,46,14,0,Matches
488,Jasper Cillessen,NED,GK,Barcelona,La Liga,29,1989,3.0,0,0,0,0,0,0,0,,0,0,0,0,0,0,3,2,Matches
489,Laurent Ciman,BEL,DF,Dijon,Ligue 1,32,1985,8.0,11,6,9,2,0,7,16,43.8,9,13,9,4,7,18,37,0,Matches
490,Daniel Ciofani,ITA,FW,Frosinone,Serie A,33,1985,18.0,8,6,2,5,1,3,7,42.9,4,4,0,4,3,11,9,0,Matches
491,Thiago Cionek,POL,DF,SPAL,Serie A,32,1986,28.2,75,44,46,25,4,29,56,51.8,27,34,22,12,55,130,144,0,Matches
492,Ibrahima Cissé,GUI,MF,Fulham,Premier League,24,1994,1.0,0,0,0,0,0,0,1,0.0,1,0,0,0,3,3,4,0,Matches
493,Till Cissokho,FRA,DF,Bordeaux,Ligue 1,18,2000,0.9,1,0,1,0,0,0,0,,0,0,0,0,2,3,3,0,Matches
494,Ciaran Clark,IRL,DF,Newcastle Utd,Premier League,28,1989,9.5,20,17,15,5,0,9,12,75.0,3,11,7,4,12,32,58,0,Matches
495,Tom Cleverley,ENG,MF,Watford,Premier League,28,1989,5.3,17,9,11,4,2,6,22,27.3,16,4,0,4,5,22,11,0,Matches
496,Nathaniel Clyne,ENG,DF,Bournemouth,Premier League,27,1991,12.7,33,18,16,14,3,11,23,47.8,12,13,3,10,16,49,33,1,Matches
497,Nathaniel Clyne,ENG,DF,Liverpool,Premier League,27,1991,1.2,4,3,2,2,0,2,4,50.0,2,1,0,1,2,6,1,0,Matches
498,Conor Coady,ENG,DF,Wolves,Premier League,25,1993,38.0,31,19,26,5,0,17,32,53.1,15,35,27,8,30,61,133,3,Matches
499,Marcus Coco,FRA,"FW,MF",Guingamp,Ligue 1,22,1996,20.4,39,23,20,10,9,16,33,48.5,17,24,0,24,23,62,14,0,Matches
500,Coke,ESP,DF,Levante,La Liga,31,1987,20.2,44,27,24,17,3,26,56,46.4,30,18,8,10,40,84,54,1,Matches
501,Joel Coleman,ENG,GK,Huddersfield,Premier League,22,1995,1.0,0,0,0,0,0,0,0,,0,0,0,0,0,0,0,0,Matches
502,Séamus Coleman,IRL,DF,Everton,Premier League,29,1988,28.4,44,25,23,18,3,19,30,63.3,11,14,5,9,26,70,86,0,Matches
503,Álex Collado,ESP,FW,Barcelona,La Liga,19,1999,0.9,1,0,0,1,0,0,1,0.0,1,3,0,3,0,1,2,0,Matches
504,Omar Colley,GAM,DF,Sampdoria,Serie A,25,1992,19.6,18,11,12,6,0,12,13,92.3,1,24,16,8,22,40,102,0,Matches
505,Racine Coly,SEN,"DF,MF",Nice,Ligue 1,22,1995,5.6,7,2,1,5,1,4,11,36.4,7,6,1,5,9,16,11,1,Matches
506,Kingsley Coman,FRA,"FW,MF",Bayern Munich,Bundesliga,22,1996,15.3,11,6,4,4,3,6,19,31.6,13,20,0,20,5,16,3,0,Matches
507,Santi Comesaña,ESP,MF,Rayo Vallecano,La Liga,21,1996,22.6,56,35,29,25,2,22,61,36.1,39,30,5,25,30,86,45,2,Matches
508,Daniel Congré,FRA,DF,Montpellier,Ligue 1,33,1985,36.6,75,45,46,26,3,38,65,58.5,27,35,15,20,67,142,106,1,Matches
509,Andrea Consigli,ITA,GK,Sassuolo,Serie A,31,1987,35.7,0,0,0,0,0,0,2,0.0,2,0,0,0,1,1,15,6,Matches
510,Andrea Conti,ITA,DF,Milan,Serie A,24,1994,5.6,9,5,3,4,2,2,9,22.2,7,4,0,4,15,24,12,1,Matches
511,Lewis Cook,ENG,MF,Bournemouth,Premier League,21,1997,8.0,13,6,6,7,0,8,19,42.1,11,8,2,6,8,21,7,1,Matches
512,Steve Cook,ENG,DF,Bournemouth,Premier League,27,1991,31.0,36,19,31,5,0,20,27,74.1,7,36,21,15,50,86,202,1,Matches
513,Duje Čop,CRO,FW,Valladolid,La Liga,28,1990,7.6,5,4,1,2,2,0,8,0.0,8,8,3,5,3,8,3,0,Matches
514,Francis Coquelin,FRA,MF,Valencia,La Liga,27,1991,19.6,46,31,25,14,7,17,35,48.6,18,21,5,16,49,95,29,1,Matches
515,Gabriele Corbo,ITA,DF,Bologna,Serie A,18,2000,0.1,0,0,0,0,0,0,0,,0,0,0,0,0,0,0,0,Matches
516,Iñigo Córdoba,ESP,"FW,MF",Athletic Club,La Liga,21,1997,14.7,37,23,15,17,5,14,47,29.8,33,27,0,27,17,54,13,0,Matches
517,Sergio Córdova,VEN,FW,Augsburg,Bundesliga,20,1997,5.9,9,5,3,4,2,2,6,33.3,4,0,0,0,3,12,5,0,Matches
518,Benjamin Corgnet,FRA,"MF,FW",Strasbourg,Ligue 1,31,1987,7.5,21,12,7,9,5,4,11,36.4,7,1,0,1,6,27,9,0,Matches
519,Ante Ćorić,CRO,MF,Roma,Serie A,21,1997,0.3,0,0,0,0,0,0,0,,0,0,0,0,0,0,0,0,Matches
520,Jack Cork,ENG,MF,Burnley,Premier League,29,1989,36.8,51,27,12,34,5,18,46,39.1,28,39,16,23,29,80,82,2,Matches
521,Andreas Cornelius,DEN,FW,Bordeaux,Ligue 1,25,1993,8.8,4,1,1,3,0,1,4,25.0,3,4,1,3,1,5,21,0,Matches
522,Maxwel Cornet,CIV,FW,Lyon,Ligue 1,21,1996,14.2,14,11,4,7,3,1,11,9.1,10,10,0,10,5,19,8,0,Matches
523,Quentin Cornette,FRA,"FW,MF",Amiens,Ligue 1,24,1994,2.3,5,1,2,2,1,3,6,50.0,3,3,0,3,1,6,5,0,Matches
524,Ángel Correa,ARG,"MF,FW",Atlético Madrid,La Liga,23,1995,21.3,38,19,19,12,7,10,53,18.9,43,28,5,23,17,55,20,0,Matches
525,Joaquín Correa,ARG,"FW,MF",Lazio,Serie A,23,1994,21.4,21,13,6,12,3,5,18,27.8,13,14,3,11,2,23,7,0,Matches
526,Danny da Costa,GER,"DF,FW",Eint Frankfurt,Bundesliga,25,1993,33.7,61,35,29,25,7,18,42,42.9,24,51,9,42,32,93,67,0,Matches
527,Diego Costa,ESP,FW,Atlético Madrid,La Liga,29,1988,12.4,4,1,0,4,0,1,8,12.5,7,5,0,5,2,6,6,0,Matches
528,Douglas Costa,BRA,"FW,MF",Juventus,Serie A,27,1990,6.9,10,8,2,8,0,4,9,44.4,5,8,0,8,4,14,2,0,Matches
529,Filippo Costa,ITA,"DF,FW",SPAL,Serie A,23,1995,6.3,15,13,6,6,3,4,9,44.4,5,10,3,7,8,23,31,1,Matches
530,Hélder Costa,ANG,"FW,MF",Wolves,Premier League,24,1994,14.9,18,14,7,7,4,7,23,30.4,16,15,0,15,9,27,6,0,Matches
531,Jaume Costa,ESP,DF,Villarreal,La Liga,30,1988,16.6,33,21,26,5,2,20,33,60.6,13,12,3,9,21,54,61,0,Matches
532,Nuno da Costa,CPV,FW,Strasbourg,Ligue 1,27,1991,22.8,39,27,10,19,10,10,38,26.3,28,24,1,23,14,53,9,0,Matches
533,David Costas,ESP,DF,Celta Vigo,La Liga,23,1995,13.0,25,13,21,4,0,10,15,66.7,5,12,6,6,18,43,58,1,Matches
534,Benoît Costil,FRA,GK,Bordeaux,Ligue 1,31,1987,37.0,2,0,2,0,0,2,2,100.0,0,0,0,0,0,2,14,3,Matches
535,Kalifa Coulibaly,MLI,FW,Nantes,Ligue 1,26,1991,19.5,15,7,1,10,4,4,11,36.4,7,8,1,7,4,19,22,0,Matches
536,Senou Coulibaly,MLI,DF,Dijon,Ligue 1,23,1994,4.6,13,7,10,3,0,3,8,37.5,5,8,2,6,11,24,20,0,Matches
537,Thibaut Courtois,BEL,GK,Real Madrid,La Liga,26,1992,27.0,0,0,0,0,0,0,2,0.0,2,0,0,0,2,2,5,0,Matches
538,Philippe Coutinho,BRA,"FW,MF",Barcelona,La Liga,26,1992,22.4,16,11,1,6,9,7,22,31.8,15,21,2,19,12,28,8,0,Matches
539,Nicolas Cozza,FRA,DF,Montpellier,Ligue 1,19,1999,10.9,19,15,14,5,0,4,10,40.0,6,13,10,3,23,42,37,1,Matches
540,Alessio Cragno,ITA,GK,Cagliari,Serie A,24,1994,38.0,0,0,0,0,0,0,1,0.0,1,0,0,0,2,2,19,1,Matches
541,Aaron Cresswell,ENG,DF,West Ham,Premier League,28,1989,17.7,29,16,14,11,4,13,25,52.0,12,28,7,21,23,52,58,0,Matches
542,Domenico Criscito,ITA,DF,Genoa,Serie A,31,1986,34.1,111,75,64,36,11,57,83,68.7,26,40,11,29,70,181,142,0,Matches
543,Lorenzo Crisetig,ITA,MF,Frosinone,Serie A,25,1993,5.6,14,11,4,8,2,6,15,40.0,9,8,3,5,12,26,12,0,Matches
544,Bryan Cristante,ITA,MF,Roma,Serie A,23,1995,26.9,63,34,21,35,7,19,49,38.8,30,37,5,32,29,92,48,0,Matches
545,Sebastián Cristóforo,URU,MF,Getafe,La Liga,24,1993,5.0,15,8,4,8,3,5,14,35.7,9,13,0,13,8,23,5,0,Matches
546,Enzo Crivelli,FRA,FW,Caen,Ligue 1,23,1995,25.1,20,14,10,8,2,8,13,61.5,5,5,0,5,4,24,28,1,Matches
547,Peter Crouch,ENG,FW,Burnley,Premier League,37,1981,1.0,1,1,0,1,0,1,1,100.0,0,0,0,0,0,1,2,0,Matches
548,Alessio da Cruz,,"FW,MF",Parma,Serie A,21,1997,1.6,2,1,0,2,0,0,1,0.0,1,0,0,0,0,2,0,0,Matches
549,Juan Cuadrado,COL,"MF,DF",Juventus,Serie A,30,1988,13.6,20,15,6,9,5,5,23,21.7,18,14,3,11,18,38,11,0,Matches
550,Cucho,COL,FW,Huesca,La Liga,19,1999,23.9,22,13,6,10,6,6,18,33.3,12,23,2,21,9,31,21,0,Matches
551,Marc Cucurella,ESP,"MF,FW",Eibar,La Liga,20,1998,26.2,49,37,13,21,15,10,23,43.5,13,36,3,33,20,69,24,0,Matches
552,Iván Cuéllar,ESP,GK,Leganés,La Liga,34,1984,33.9,0,0,0,0,0,0,1,0.0,1,0,0,0,2,2,10,0,Matches
553,Mickaël Cuisance,FRA,MF,Gladbach,Bundesliga,18,1999,3.1,11,6,6,3,2,3,8,37.5,5,3,0,3,5,16,4,0,Matches
554,Matheus Cunha,BRA,"FW,MF",RB Leipzig,Bundesliga,19,1999,9.5,10,6,3,5,2,3,13,23.1,10,13,1,12,4,14,8,0,Matches
555,Greg Cunningham,IRL,DF,Cardiff City,Premier League,27,1991,7.0,18,7,11,4,3,9,16,56.3,7,9,3,6,17,35,16,1,Matches
556,Patrick Cutrone,ITA,FW,Milan,Serie A,20,1998,16.2,9,5,0,3,6,2,16,12.5,14,13,2,11,7,16,13,0,Matches
557,Wylan Cyprien,FRA,MF,Nice,Ligue 1,23,1995,26.2,40,20,16,21,3,15,43,34.9,28,20,5,15,11,51,15,0,Matches
558,Marco D'Alessandro,ITA,DF,Udinese,Serie A,27,1991,16.6,55,34,34,15,6,29,49,59.2,20,24,2,22,9,64,50,1,Matches
559,Danilo D'Ambrosio,ITA,DF,Inter,Serie A,29,1988,28.7,69,40,34,27,8,24,57,42.1,33,25,8,17,27,96,39,0,Matches
560,Damien Da Silva,FRA,DF,Rennes,Ligue 1,30,1988,31.9,41,25,31,9,1,18,24,75.0,6,42,36,6,39,80,152,0,Matches
561,Kouadio-Yves Dabila,CIV,DF,Lille,Ligue 1,21,1997,8.7,11,6,10,1,0,5,6,83.3,1,13,9,4,6,17,44,0,Matches
562,Abdoulaye Dabo,FRA,FW,Nantes,Ligue 1,17,2001,1.3,3,1,1,0,2,0,0,,0,0,0,0,0,3,0,0,Matches
563,Bryan Dabo,BFA,"MF,DF",Fiorentina,Serie A,26,1992,9.2,10,6,1,8,1,1,6,16.7,5,11,6,5,10,20,21,0,Matches
564,Christoph Daferner,GER,FW,Freiburg,Bundesliga,20,1998,0.3,1,0,1,0,0,0,0,,0,0,0,0,1,2,0,0,Matches
565,Colin Dagba,FRA,"DF,MF",Paris S-G,Ligue 1,19,1998,10.2,24,12,10,12,2,13,19,68.4,6,10,0,10,9,33,10,1,Matches
566,Mahmoud Dahoud,GER,MF,Dortmund,Bundesliga,22,1996,7.7,16,10,4,10,2,3,15,20.0,12,10,0,10,17,33,8,0,Matches
567,Leon Dajaku,GER,"DF,MF",Stuttgart,Bundesliga,17,2001,0.3,2,1,0,1,1,0,0,,0,1,0,1,0,2,0,0,Matches
568,Felipe dal Belo,BRA,DF,SPAL,Serie A,34,1984,26.2,36,25,21,13,2,16,32,50.0,16,29,18,11,17,53,88,1,Matches
569,Nicola Dalmonte,ITA,"FW,MF",Genoa,Serie A,20,1997,0.5,2,2,0,2,0,0,0,,0,0,0,0,0,2,0,0,Matches
570,Diogo Dalot,POR,"DF,FW",Manchester Utd,Premier League,19,1999,11.3,24,12,8,14,2,14,19,73.7,5,15,2,13,10,34,35,1,Matches
571,Matty Daly,ENG,MF,Huddersfield,Premier League,17,2001,0.8,0,0,0,0,0,0,0,,0,0,0,0,0,0,0,0,Matches
572,Vitalie Damașcan,MDA,MF,Torino,Serie A,19,1999,0.0,1,1,0,1,0,1,1,100.0,0,0,0,0,0,1,0,0,Matches
573,Loïc Damour,FRA,MF,Cardiff City,Premier League,27,1991,0.3,0,0,0,0,0,0,1,0.0,1,0,0,0,0,0,0,0,Matches
574,Charlie Daniels,ENG,DF,Bournemouth,Premier League,31,1986,17.6,25,15,18,6,1,13,22,59.1,9,14,4,10,20,45,56,2,Matches
575,Danilo,BRA,DF,Manchester City,Premier League,27,1991,9.0,20,16,6,12,2,12,17,70.6,5,5,0,5,15,35,22,1,Matches
576,Scott Dann,ENG,DF,Crystal Palace,Premier League,31,1987,7.4,6,2,5,1,0,3,7,42.9,4,16,12,4,5,11,46,0,Matches
577,Kevin Danso,AUT,DF,Augsburg,Bundesliga,19,1998,13.9,25,14,21,3,1,11,14,78.6,3,25,17,8,19,44,72,0,Matches
578,Dante,BRA,DF,Nice,Ligue 1,34,1983,35.8,54,40,36,16,2,24,41,58.5,17,56,30,26,38,92,156,2,Matches
579,Palkó Dárdai,HUN,"FW,MF",Hertha BSC,Bundesliga,19,1999,1.3,1,1,1,0,0,0,0,,0,1,0,1,0,1,0,0,Matches
580,Sergi Darder,ESP,MF,Espanyol,La Liga,24,1993,30.1,60,35,23,32,5,25,69,36.2,44,18,3,15,22,82,30,0,Matches
581,Vladimír Darida,CZE,MF,Hertha BSC,Bundesliga,27,1990,4.2,8,5,3,4,1,2,3,66.7,1,5,0,5,8,16,5,0,Matches
582,Matteo Darmian,ITA,DF,Manchester Utd,Premier League,28,1989,4.9,14,8,10,4,0,4,11,36.4,7,9,0,9,7,21,20,0,Matches
583,Alphonso Davies,CAN,"MF,FW",Bayern Munich,Bundesliga,17,2000,0.9,1,1,1,0,0,0,0,,0,2,0,2,2,3,1,0,Matches
584,Ben Davies,WAL,DF,Tottenham,Premier League,25,1993,20.5,56,30,39,13,4,38,54,70.4,16,23,10,13,23,79,68,1,Matches
585,Tom Davies,ENG,MF,Everton,Premier League,20,1998,10.9,27,17,9,17,1,7,23,30.4,16,15,1,14,16,43,9,1,Matches
586,Steven Davis,NIR,MF,Southampton,Premier League,33,1985,1.1,2,2,0,2,0,0,0,,0,2,0,2,1,3,5,0,Matches
587,Kevin De Bruyne,BEL,MF,Manchester City,Premier League,27,1991,10.8,22,15,6,12,4,7,21,33.3,14,13,1,12,3,25,2,1,Matches
588,Sebastien De Maio,FRA,DF,Udinese,Serie A,31,1987,13.0,11,7,7,4,0,3,12,25.0,9,22,17,5,12,23,93,0,Matches
589,Sebastien De Maio,FRA,DF,Bologna,Serie A,31,1987,5.5,5,4,3,2,0,1,2,50.0,1,8,5,3,1,6,32,0,Matches
590,Rodrigo De Paul,ARG,"MF,FW",Udinese,Serie A,24,1994,35.4,53,33,21,27,5,13,42,31.0,29,35,2,33,32,85,28,0,Matches
591,Daniele De Rossi,ITA,MF,Roma,Serie A,35,1983,14.1,16,10,6,7,3,3,14,21.4,11,18,12,6,26,42,33,0,Matches
592,Mattia De Sciglio,ITA,DF,Juventus,Serie A,25,1992,19.4,40,28,24,14,2,17,28,60.7,11,18,6,12,26,66,58,1,Matches
593,Lorenzo De Silvestri,ITA,DF,Torino,Serie A,30,1988,26.8,15,11,8,5,2,7,24,29.2,17,53,3,50,22,37,69,2,Matches
594,Lucas Deaux,FRA,MF,Guingamp,Ligue 1,29,1988,13.2,41,28,21,18,2,20,41,48.8,21,10,0,10,11,52,7,0,Matches
595,Mathieu Debuchy,FRA,DF,Saint-Étienne,Ligue 1,33,1985,21.6,43,26,25,13,5,22,37,59.5,15,17,7,10,47,90,64,0,Matches
596,Troy Deeney,ENG,FW,Watford,Premier League,30,1988,28.3,24,14,8,10,6,7,32,21.9,25,22,4,18,7,31,29,0,Matches
597,Jermain Defoe,ENG,FW,Bournemouth,Premier League,35,1982,0.3,0,0,0,0,0,0,0,,0,0,0,0,0,0,0,0,Matches
598,Steven Defour,BEL,MF,Burnley,Premier League,30,1988,5.0,8,4,2,4,2,3,14,21.4,11,11,3,8,8,16,7,0,Matches
599,Grégoire Defrel,MTQ,"FW,MF",Sampdoria,Serie A,27,1991,26.0,40,29,10,16,14,9,21,42.9,12,15,0,15,3,43,9,0,Matches
600,Alessandro Deiola,ITA,MF,Cagliari,Serie A,22,1995,5.0,7,3,1,6,0,3,13,23.1,10,14,0,14,6,13,8,0,Matches
601,Alessandro Deiola,ITA,"MF,FW",Parma,Serie A,22,1995,6.1,12,8,4,7,1,4,10,40.0,6,15,4,11,11,23,10,0,Matches
602,Romain Del Castillo,FRA,"MF,FW",Rennes,Ligue 1,22,1996,14.9,36,20,15,13,8,13,37,35.1,24,19,0,19,20,56,7,1,Matches
603,Thomas Delaney,DEN,MF,Dortmund,Bundesliga,26,1991,25.4,69,54,28,39,2,19,30,63.3,11,30,9,21,58,127,43,0,Matches
604,Moisés Delgado,ESP,DF,Valladolid,La Liga,24,1994,3.0,7,6,3,3,1,2,3,66.7,1,2,1,1,3,10,9,0,Matches
605,Cristian Dell'Orco,ITA,DF,Empoli,Serie A,24,1994,11.5,18,11,11,5,2,4,11,36.4,7,13,7,6,17,35,44,0,Matches
606,Cristian Dell'Orco,ITA,DF,Sassuolo,Serie A,24,1994,1.2,1,1,1,0,0,1,3,33.3,2,1,0,1,1,2,3,0,Matches
607,Andy Delort,ALG,FW,Montpellier,Ligue 1,26,1991,34.6,34,20,7,20,7,8,34,23.5,26,28,7,21,4,38,7,0,Matches
608,Fabian Delph,ENG,DF,Manchester City,Premier League,28,1989,8.1,23,14,11,7,5,12,23,52.2,11,3,0,3,13,36,19,1,Matches
609,Mousa Dembélé,BEL,MF,Tottenham,Premier League,31,1987,5.7,13,9,6,6,1,4,7,57.1,3,4,1,3,7,20,5,2,Matches
610,Moussa Dembélé,FRA,FW,Lyon,Ligue 1,22,1996,22.4,12,4,0,8,4,4,14,28.6,10,15,2,13,2,14,13,0,Matches
611,Ousmane Dembélé,FRA,"FW,MF",Barcelona,La Liga,21,1997,18.5,23,15,4,13,6,6,18,33.3,12,13,0,13,5,28,4,0,Matches
612,Jessy Deminguet,FRA,MF,Caen,Ligue 1,20,1998,14.1,37,25,18,17,2,15,40,37.5,25,19,3,16,18,55,28,1,Matches
613,Merih Demiral,TUR,DF,Sassuolo,Serie A,20,1998,14.0,24,16,23,1,0,10,13,76.9,3,16,11,5,19,43,80,0,Matches
614,Kerem Demirbay,GER,MF,Hoffenheim,Bundesliga,25,1993,22.4,57,35,20,27,10,11,51,21.6,40,34,10,24,22,79,25,0,Matches
615,Diego Demme,GER,MF,RB Leipzig,Bundesliga,26,1991,22.8,75,47,24,43,8,33,67,49.3,34,36,3,33,26,101,15,0,Matches
616,Jason Denayer,BEL,DF,Lyon,Ligue 1,23,1995,30.6,33,21,22,11,0,16,24,66.7,8,36,32,4,26,59,122,1,Matches
617,Leander Dendoncker,BEL,MF,Wolves,Premier League,23,1995,16.3,53,26,25,25,3,16,47,34.0,31,35,6,29,23,76,34,1,Matches
618,Fabio Depaoli,ITA,DF,Chievo,Serie A,21,1997,27.4,74,43,37,32,5,34,67,50.7,33,42,16,26,35,109,99,3,Matches
619,Laurent Depoitre,BEL,FW,Huddersfield,Premier League,29,1988,11.9,6,4,2,3,1,0,3,0.0,3,9,0,9,2,8,8,0,Matches
620,Clément Depres,FRA,FW,Nîmes,Ligue 1,23,1994,4.9,2,2,1,1,0,1,4,25.0,3,3,0,3,0,2,6,0,Matches
621,Kiril Despodov,BUL,"FW,MF",Cagliari,Serie A,21,1996,1.2,0,0,0,0,0,0,1,0.0,1,1,0,1,0,0,0,0,Matches
622,Daniele Dessena,ITA,MF,Cagliari,Serie A,31,1987,3.9,2,2,0,2,0,1,3,33.3,2,3,1,2,3,5,5,0,Matches
623,Mattia Destro,ITA,FW,Bologna,Serie A,27,1991,5.5,3,2,2,0,1,0,0,,0,4,0,4,0,3,6,0,Matches
624,Gerard Deulofeu,ESP,"FW,MF",Watford,Premier League,24,1994,23.0,11,6,5,3,3,4,26,15.4,22,16,0,16,14,25,3,0,Matches
625,Jacopo Dezi,ITA,MF,Parma,Serie A,26,1992,1.0,1,1,1,0,0,0,1,0.0,1,1,0,1,3,4,2,0,Matches
626,Federico Di Francesco,ITA,"FW,MF",Sassuolo,Serie A,24,1994,11.9,10,6,3,4,3,4,7,57.1,3,12,1,11,5,15,5,0,Matches
627,Antonio Di Gaudio,ITA,FW,Parma,Serie A,28,1989,7.8,2,0,0,1,1,1,5,20.0,4,6,1,5,3,5,5,0,Matches
628,Giovanni Di Lorenzo,ITA,"DF,FW",Empoli,Serie A,24,1993,37.0,66,43,38,23,5,24,44,54.5,20,34,13,21,36,102,93,3,Matches
629,Ángel Di María,ARG,"FW,MF",Paris S-G,Ligue 1,30,1988,25.8,29,17,12,10,7,10,42,23.8,32,24,1,23,16,45,4,0,Matches
630,Franco Di Santo,ARG,FW,Rayo Vallecano,La Liga,29,1989,1.9,2,2,1,0,1,1,2,50.0,1,0,0,0,0,2,2,0,Matches
631,Franco Di Santo,ARG,"MF,FW",Schalke 04,Bundesliga,29,1989,2.7,2,1,0,2,0,1,4,25.0,3,3,1,2,1,3,3,0,Matches
632,Boulaye Dia,SEN,FW,Reims,Ligue 1,21,1996,8.3,12,6,3,8,1,5,11,45.5,6,4,2,2,4,16,9,0,Matches
633,Fousseni Diabaté,MLI,FW,Leicester City,Premier League,22,1995,0.6,2,0,2,0,0,0,1,0.0,1,2,0,2,0,2,0,0,Matches
634,Moussa Diaby,FRA,"MF,DF",Paris S-G,Ligue 1,19,1999,12.7,14,8,7,2,5,2,11,18.2,9,7,1,6,12,26,6,0,Matches
635,Adama Diakhaby,FRA,"FW,MF",Huddersfield,Premier League,22,1996,6.1,6,3,4,1,1,3,11,27.3,8,7,0,7,1,7,2,0,Matches
636,Mouctar Diakhaby,GUI,DF,Valencia,La Liga,21,1996,17.6,14,8,10,4,0,5,10,50.0,5,24,16,8,20,34,94,1,Matches
637,Bafodé Diakité,FRA,DF,Toulouse,Ligue 1,17,2001,7.0,15,7,5,9,1,10,14,71.4,4,15,3,12,11,26,29,0,Matches
638,Abdou Diallo,SEN,DF,Dortmund,Bundesliga,22,1996,26.4,36,20,20,13,3,11,15,73.3,4,28,15,13,26,62,91,1,Matches
639,Abdoulaye Diallo,SEN,GK,Rennes,Ligue 1,26,1992,5.5,1,1,1,0,0,1,1,100.0,0,0,0,0,0,1,1,0,Matches
640,Mustapha Diallo,SEN,MF,Nîmes,Ligue 1,32,1986,5.1,16,11,6,9,1,5,13,38.5,8,7,1,6,10,26,14,1,Matches
641,Mohamed Diamé,SEN,MF,Newcastle Utd,Premier League,31,1987,24.1,76,46,35,36,5,16,54,29.6,38,42,9,33,30,106,39,1,Matches
642,Grady Diangana,COD,"MF,FW",West Ham,Premier League,20,1998,6.8,20,9,8,8,4,5,14,35.7,9,11,0,11,1,21,4,0,Matches
643,Lassana Diarra,FRA,MF,Paris S-G,Ligue 1,33,1985,1.8,2,1,0,2,0,0,1,0.0,1,0,0,0,2,4,3,0,Matches
644,Amadou Diawara,GUI,MF,Napoli,Serie A,21,1997,7.3,12,4,1,9,2,4,5,80.0,1,6,0,6,11,23,12,0,Matches
645,Brahim Díaz,MAR,FW,Real Madrid,La Liga,18,1999,4.2,9,7,5,4,0,3,8,37.5,5,2,0,2,0,9,0,0,Matches
646,Javier Díaz,ESP,GK,Sevilla,La Liga,21,1997,1.0,0,0,0,0,0,0,0,,0,0,0,0,0,0,0,0,Matches
647,Bakaye Dibassy,MLI,DF,Amiens,Ligue 1,28,1989,32.7,38,26,18,16,4,18,27,66.7,9,40,21,19,44,82,102,0,Matches
648,Lorenzo Dickmann,ITA,"DF,MF",SPAL,Serie A,21,1996,1.9,5,4,4,1,0,5,7,71.4,2,0,0,0,1,6,5,0,Matches
649,Daniel Didavi,GER,"MF,FW",Stuttgart,Bundesliga,28,1990,10.6,21,15,8,10,3,7,20,35.0,13,11,1,10,4,25,5,0,Matches
650,Étienne Didot,FRA,MF,Guingamp,Ligue 1,35,1983,23.4,41,29,12,27,2,17,44,38.6,27,37,10,27,37,78,35,0,Matches
651,Adrián Diéguez,ESP,DF,Huesca,La Liga,22,1996,8.3,16,10,11,4,1,9,16,56.3,7,9,4,5,12,28,46,1,Matches
652,Eric Dier,ENG,"MF,DF",Tottenham,Premier League,24,1994,16.7,26,16,7,15,4,19,47,40.4,28,27,12,15,21,47,46,1,Matches
653,Tim Dierßen,GER,MF,Hannover 96,Bundesliga,22,1996,0.2,0,0,0,0,0,0,0,,0,1,0,1,0,0,0,0,Matches
654,Lucas Digne,FRA,DF,Everton,Premier League,25,1993,32.9,71,46,45,18,8,28,45,62.2,17,43,9,34,60,131,116,0,Matches
655,Mitchell Dijks,NED,DF,Bologna,Serie A,25,1993,22.5,30,18,19,7,4,13,36,36.1,23,18,1,17,23,53,49,0,Matches
656,Javairô Dilrosun,NED,"FW,MF",Hertha BSC,Bundesliga,20,1998,10.0,14,10,7,5,2,3,7,42.9,4,18,2,16,7,21,9,0,Matches
657,Federico Dimarco,ITA,"DF,MF",Parma,Serie A,20,1997,9.9,22,7,10,8,4,10,20,50.0,10,13,6,7,15,37,27,0,Matches
658,Stole Dimitrievski,MKD,GK,Rayo Vallecano,La Liga,24,1993,21.0,0,0,0,0,0,0,1,0.0,1,0,0,0,0,0,8,1,Matches
659,Tristan Dingomé,CMR,MF,Reims,Ligue 1,27,1991,14.9,27,15,11,10,6,7,24,29.2,17,16,3,13,11,38,5,0,Matches
660,Ismaël Diomandé,CIV,"MF,DF",Caen,Ligue 1,25,1992,14.4,28,15,15,12,1,11,20,55.0,9,17,7,10,10,38,37,0,Matches
661,Federico Dionisi,ITA,"FW,MF",Frosinone,Serie A,31,1987,2.3,3,1,0,2,1,0,2,0.0,2,0,0,0,0,3,0,0,Matches
662,Lois Diony,FRA,FW,Saint-Étienne,Ligue 1,25,1992,17.7,17,12,3,9,5,4,10,40.0,6,14,0,14,1,18,9,0,Matches
663,Issa Diop,FRA,DF,West Ham,Premier League,21,1997,33.0,68,38,47,21,0,37,57,64.9,20,58,36,22,64,132,161,4,Matches
664,Papakouli Diop,SEN,MF,Eibar,La Liga,32,1986,26.1,66,40,14,44,8,14,34,41.2,20,21,1,20,37,103,27,0,Matches
665,Sofiane Diop,FRA,"MF,FW",Monaco,Ligue 1,18,2000,8.2,12,7,3,6,3,1,15,6.7,14,6,0,6,8,20,6,0,Matches
666,Assane Dioussé,SEN,MF,Chievo,Serie A,20,1997,9.9,24,16,11,8,5,10,23,43.5,13,14,4,10,19,43,13,2,Matches
667,Assane Dioussé,SEN,MF,Saint-Étienne,Ligue 1,20,1997,2.4,6,4,3,3,0,2,4,50.0,2,2,0,2,1,7,7,1,Matches
668,Axel Disasi,FRA,DF,Reims,Ligue 1,20,1998,1.8,2,1,1,1,0,1,2,50.0,1,2,1,1,2,4,16,0,Matches
669,Djené,TOG,DF,Getafe,La Liga,26,1991,33.1,54,34,43,11,0,26,43,60.5,17,27,11,16,74,128,154,3,Matches
670,Koffi Djidji,CIV,DF,Torino,Serie A,25,1992,15.4,37,23,27,9,1,12,20,60.0,8,26,19,7,24,61,72,1,Matches
671,Koffi Djidji,CIV,DF,Nantes,Ligue 1,25,1992,1.0,1,1,1,0,0,0,0,,0,1,1,0,1,2,3,0,Matches
672,Alexander Djiku,GHA,DF,Caen,Ligue 1,23,1994,30.6,48,37,33,13,2,23,43,53.5,20,56,31,25,83,131,183,3,Matches
673,Papy Djilobodji,SEN,DF,Guingamp,Ligue 1,29,1988,1.9,1,1,1,0,0,0,0,,0,4,2,2,0,1,11,0,Matches
674,Berat Djimsiti,ALB,DF,Atalanta,Serie A,25,1993,20.1,32,22,18,12,2,13,29,44.8,16,21,11,10,34,66,96,0,Matches
675,Johan Djourou,SUI,DF,SPAL,Serie A,31,1987,3.1,3,1,3,0,0,2,2,100.0,0,5,3,2,4,7,20,0,Matches
676,Marko Dmitrović,SRB,GK,Eibar,La Liga,26,1992,24.0,0,0,0,0,0,0,0,,0,0,0,0,2,2,11,3,Matches
677,Matt Doherty,IRL,"DF,MF",Wolves,Premier League,26,1992,34.9,67,42,48,15,4,35,58,60.3,23,49,7,42,60,127,107,2,Matches
678,Keagan Dolly,RSA,FW,Montpellier,Ligue 1,25,1993,1.0,1,1,0,1,0,0,3,0.0,3,0,0,0,0,1,0,0,Matches
679,Jaume Doménech,ESP,GK,Valencia,La Liga,27,1990,4.0,0,0,0,0,0,0,1,0.0,1,0,0,0,0,0,1,0,Matches
680,Giulio Donati,ITA,DF,Mainz 05,Bundesliga,28,1990,6.9,9,7,6,3,0,8,10,80.0,2,5,3,2,16,25,24,0,Matches
681,Ji Dong-won,KOR,"MF,FW",Augsburg,Bundesliga,27,1991,9.9,10,6,5,3,2,6,16,37.5,10,13,2,11,8,18,10,0,Matches
682,Anastasios Donis,GRE,"FW,MF",Stuttgart,Bundesliga,21,1996,10.7,15,13,8,4,3,3,11,27.3,8,7,0,7,4,19,0,0,Matches
683,Gianluigi Donnarumma,ITA,GK,Milan,Serie A,19,1999,34.3,1,1,1,0,0,1,2,50.0,1,0,0,0,1,2,13,3,Matches
684,Godfred Donsah,GHA,MF,Bologna,Serie A,22,1996,1.7,3,1,3,0,0,3,5,60.0,2,4,2,2,0,3,7,0,Matches
685,Riccardo Doratiotto,ITA,FW,Cagliari,Serie A,19,1999,0.9,1,1,0,0,1,0,0,,0,0,0,0,0,1,0,0,Matches
686,Mathieu Dossevi,TOG,"FW,MF",Toulouse,Ligue 1,30,1988,27.4,42,28,20,11,11,13,40,32.5,27,29,1,28,33,75,13,0,Matches
687,Abdoulaye Doucouré,MLI,MF,Watford,Premier League,25,1993,34.0,71,38,27,32,12,19,57,33.3,38,31,8,23,34,105,55,5,Matches
688,Cheick Doukouré,CIV,MF,Levante,La Liga,25,1992,3.5,13,7,3,7,3,4,15,26.7,11,10,2,8,3,16,3,1,Matches
689,Moussa Doumbia,MLI,"FW,MF",Reims,Ligue 1,23,1994,17.8,28,13,13,13,2,11,39,28.2,28,7,2,5,7,35,13,0,Matches
690,Seydou Doumbia,CIV,FW,Girona,La Liga,30,1987,6.0,5,1,1,2,2,0,2,0.0,2,2,0,2,3,8,1,0,Matches
691,Souleyman Doumbia,CIV,DF,Rennes,Ligue 1,21,1996,6.7,11,7,9,2,0,6,10,60.0,4,6,1,5,4,15,20,0,Matches
692,Aleksandar Dragović,AUT,DF,Leverkusen,Bundesliga,27,1991,14.8,18,12,14,4,0,9,14,64.3,5,15,8,7,25,43,66,0,Matches
693,Bartłomiej Drągowski,POL,GK,Fiorentina,Serie A,20,1997,2.5,0,0,0,0,0,0,0,,0,0,0,0,0,0,2,0,Matches
694,Bartłomiej Drągowski,POL,GK,Empoli,Serie A,20,1997,14.0,0,0,0,0,0,0,1,0.0,1,0,0,0,0,0,7,1,Matches
695,Julian Draxler,GER,"MF,FW",Paris S-G,Ligue 1,24,1993,22.7,41,22,11,19,11,16,43,37.2,27,20,1,19,15,56,2,1,Matches
696,Luke Dreher,ENG,FW,Crystal Palace,Premier League,19,1998,0.0,0,0,0,0,0,0,0,,0,0,0,0,0,0,0,0,Matches
697,Josip Drmić,SUI,FW,Gladbach,Bundesliga,25,1992,2.5,2,0,0,2,0,1,2,50.0,1,1,0,1,1,3,0,0,Matches
698,Jaroslav Drobný,CZE,GK,Düsseldorf,Bundesliga,38,1979,2.0,0,0,0,0,0,0,0,,0,0,0,0,0,0,1,0,Matches
699,Óscar Duarte,CRC,"DF,MF",Espanyol,La Liga,29,1989,7.3,12,5,7,5,0,4,7,57.1,3,7,7,0,13,25,34,0,Matches
700,Rubén Duarte,ESP,DF,Alavés,La Liga,22,1995,30.8,72,35,45,20,7,34,64,53.1,30,46,12,34,57,129,130,1,Matches
701,Leo Dubois,FRA,DF,Lyon,Ligue 1,23,1994,22.7,51,22,25,21,5,20,35,57.1,15,30,10,20,22,73,61,1,Matches
702,Martin Dúbravka,SVK,GK,Newcastle Utd,Premier League,29,1989,38.0,2,0,2,0,0,1,3,33.3,2,0,0,0,0,2,20,5,Matches
703,Marvin Ducksch,GER,FW,Düsseldorf,Bundesliga,24,1994,9.1,3,1,0,2,1,1,5,20.0,4,4,0,4,4,7,11,0,Matches
704,Ondrej Duda,SVK,MF,Hertha BSC,Bundesliga,23,1994,28.5,54,33,13,35,6,15,55,27.3,40,36,4,32,15,69,17,1,Matches
705,Shane Duffy,IRL,DF,Brighton,Premier League,26,1992,34.3,35,20,23,7,5,14,25,56.0,11,57,47,10,36,71,244,3,Matches
706,Demeaco Duhaney,ENG,DF,Huddersfield,Premier League,19,1998,0.5,1,0,1,0,0,1,3,33.3,2,2,0,2,1,2,1,0,Matches
707,Paul Dummett,WAL,DF,Newcastle Utd,Premier League,26,1991,22.1,34,22,24,9,1,19,32,59.4,13,25,11,14,37,71,133,0,Matches
708,Alfred Duncan,GHA,MF,Sassuolo,Serie A,25,1993,20.5,33,21,15,15,3,19,48,39.6,29,20,6,14,15,48,18,0,Matches
709,Lewis Dunk,ENG,DF,Brighton,Premier League,26,1991,35.0,42,26,31,10,1,17,39,43.6,22,49,38,11,46,88,196,5,Matches
710,Maxime Dupé,FRA,GK,Nantes,Ligue 1,25,1993,10.4,0,0,0,0,0,0,0,,0,0,0,0,0,0,3,1,Matches
711,Erik Durm,GER,DF,Huddersfield,Premier League,26,1992,22.8,35,22,24,8,3,14,33,42.4,19,26,6,20,41,76,42,0,Matches
712,Jimmy Durmaz,SWE,"MF,FW",Toulouse,Ligue 1,29,1989,21.1,34,22,8,13,13,15,38,39.5,23,14,2,12,11,45,16,1,Matches
713,Riza Durmisi,DEN,DF,Lazio,Serie A,24,1994,3.6,4,4,2,0,2,2,3,66.7,1,0,0,0,1,5,9,0,Matches
714,Hugo Duro,ESP,"MF,FW",Getafe,La Liga,18,1999,4.6,6,4,1,2,3,3,6,50.0,3,6,1,5,3,9,4,0,Matches
715,Raphael Dwamena,GHA,FW,Levante,La Liga,22,1995,2.5,0,0,0,0,0,0,0,,0,2,1,1,0,0,2,0,Matches
716,Paulo Dybala,ARG,"FW,MF",Juventus,Serie A,24,1993,23.7,17,8,3,9,5,7,23,30.4,16,20,2,18,14,31,1,0,Matches
717,Edin Džeko,BIH,FW,Roma,Serie A,32,1986,28.7,13,7,3,5,5,4,16,25.0,12,10,1,9,0,13,36,1,Matches
718,Blerim Džemaili,SUI,MF,Bologna,Serie A,32,1986,19.4,44,27,22,19,3,19,58,32.8,39,22,1,21,17,61,12,1,Matches
719,Félix Eboa Eboa,CMR,DF,Guingamp,Ligue 1,21,1997,27.0,47,33,26,20,1,16,22,72.7,6,37,24,13,39,86,136,2,Matches
720,Dennis Eckert,GER,FW,Celta Vigo,La Liga,21,1997,2.4,3,2,0,1,2,0,2,0.0,2,1,0,1,2,5,3,0,Matches
721,Bruno Ecuele Manga,GAB,DF,Cardiff City,Premier League,30,1988,37.5,69,36,48,16,5,29,58,50.0,29,62,28,34,81,150,179,4,Matches
722,Simone Edera,ITA,MF,Torino,Serie A,21,1997,0.9,0,0,0,0,0,0,1,0.0,1,1,0,1,1,1,0,0,Matches
723,Simone Edera,ITA,FW,Bologna,Serie A,21,1997,2.2,4,4,3,0,1,1,3,33.3,2,5,1,4,0,4,1,0,Matches
724,Ederson,BRA,GK,Manchester City,Premier League,24,1993,38.0,3,3,2,1,0,3,3,100.0,0,0,0,0,1,4,12,2,Matches
725,Johannes Eggestein,GER,"FW,MF",Werder Bremen,Bundesliga,20,1998,12.4,13,9,7,4,2,5,19,26.3,14,13,0,13,4,17,7,0,Matches
726,Maximilian Eggestein,GER,MF,Werder Bremen,Bundesliga,21,1996,33.9,68,42,29,34,5,24,54,44.4,30,49,10,39,30,98,69,0,Matches
727,Albin Ekdal,SWE,MF,Sampdoria,Serie A,29,1989,29.4,61,39,16,38,7,37,68,54.4,31,42,12,30,53,114,62,1,Matches
728,Josip Elez,CRO,DF,Hannover 96,Bundesliga,24,1994,7.2,8,3,5,3,0,2,11,18.2,9,13,4,9,6,14,27,0,Matches
729,Harvey Elliott,ENG,MF,Fulham,Premier League,15,2003,0.2,0,0,0,0,0,0,0,,0,1,0,1,0,0,0,0,Matches
730,Mohamed Elneny,EGY,MF,Arsenal,Premier League,26,1992,4.2,13,4,9,1,3,1,2,50.0,1,7,4,3,2,15,8,0,Matches
731,Aritz Elustondo,ESP,DF,Real Sociedad,La Liga,24,1994,25.0,47,29,31,14,2,26,41,63.4,15,23,7,16,39,86,150,0,Matches
732,Gorka Elustondo,ESP,"MF,DF",Rayo Vallecano,La Liga,31,1987,3.2,7,5,4,3,0,5,8,62.5,3,6,1,5,6,13,10,0,Matches
733,Nico Elvedi,SUI,DF,Gladbach,Bundesliga,21,1996,29.1,41,19,34,7,0,23,33,69.7,10,30,13,17,47,88,135,6,Matches
734,Rodrigo Ely,BRA,DF,Alavés,La Liga,24,1993,4.8,8,5,5,3,0,5,7,71.4,2,9,7,2,7,15,30,0,Matches
735,Mohamed Elyounoussi,NOR,MF,Southampton,Premier League,23,1994,8.8,16,12,7,6,3,6,19,31.6,13,11,1,10,6,22,5,0,Matches
736,Adri Embarba,ESP,"MF,FW",Rayo Vallecano,La Liga,26,1992,25.4,54,26,20,24,10,22,61,36.1,39,38,2,36,29,83,22,0,Matches
737,Breel Embolo,SUI,FW,Schalke 04,Bundesliga,21,1997,14.9,22,17,4,13,5,1,9,11.1,8,11,0,11,4,26,6,0,Matches
738,Emerson,BRA,"FW,DF",Betis,La Liga,19,1999,3.5,9,7,6,1,2,3,10,30.0,7,6,0,6,7,16,12,0,Matches
739,Youssef En-Nesyri,MAR,FW,Leganés,La Liga,21,1997,23.4,16,8,6,5,5,4,24,16.7,20,18,3,15,6,22,23,0,Matches
740,Björn Engels,BEL,DF,Reims,Ligue 1,23,1994,33.0,11,8,6,5,0,6,16,37.5,10,30,24,6,44,55,181,3,Matches
741,Sergi Enrich,ESP,FW,Eibar,La Liga,28,1990,28.7,27,17,3,11,13,7,30,23.3,23,11,1,10,6,33,14,0,Matches
742,Javier Eraso,ESP,"MF,FW",Leganés,La Liga,28,1990,7.0,6,3,3,2,1,0,6,0.0,6,3,1,2,7,13,4,0,Matches
743,Christian Eriksen,DEN,MF,Tottenham,Premier League,26,1992,30.8,41,25,8,20,13,17,59,28.8,42,26,3,23,15,56,13,0,Matches
744,Patrick Erras,GER,MF,Nürnberg,Bundesliga,23,1995,13.6,15,10,7,7,1,7,19,36.8,12,24,13,11,23,38,45,0,Matches
745,Gonzalo Escalante,ARG,MF,Eibar,La Liga,25,1993,19.9,49,28,11,35,3,19,46,41.3,27,37,2,35,21,70,21,0,Matches
746,Sergio Escudero,ESP,"DF,FW",Sevilla,La Liga,28,1989,17.2,43,29,20,18,5,18,35,51.4,17,22,4,18,24,67,52,0,Matches
747,Bernardo Espinosa,COL,DF,Girona,La Liga,29,1989,30.3,20,14,16,4,0,8,17,47.1,9,46,31,15,40,60,197,5,Matches
748,Michael Esser,GER,GK,Hannover 96,Bundesliga,30,1987,32.0,3,2,3,0,0,2,5,40.0,3,1,0,1,1,4,15,0,Matches
749,Alexander Esswein,GER,"MF,FW",Stuttgart,Bundesliga,28,1990,13.9,17,11,6,4,7,6,21,28.6,15,17,0,17,12,29,16,0,Matches
750,Neil Etheridge,PHI,GK,Cardiff City,Premier League,28,1990,38.0,1,1,1,0,0,1,2,50.0,1,0,0,0,7,8,19,1,Matches
751,Beñat Etxebarria,ESP,MF,Athletic Club,La Liga,31,1987,22.6,47,24,14,25,8,19,59,32.2,40,18,1,17,24,71,11,0,Matches
752,Xabier Etxeita,ESP,DF,Huesca,La Liga,30,1987,29.7,47,23,32,12,3,26,47,55.3,21,38,25,13,39,86,163,3,Matches
753,Lucas Evangelista,BRA,"FW,MF",Nantes,Ligue 1,23,1995,8.0,30,17,11,12,7,14,25,56.0,11,10,0,10,9,39,6,0,Matches
754,Jonny Evans,NIR,DF,Leicester City,Premier League,30,1988,22.2,24,13,20,4,0,13,18,72.2,5,28,10,18,33,57,152,3,Matches
755,Ewerton,BRA,DF,Nürnberg,Bundesliga,29,1989,14.9,24,20,21,3,0,8,14,57.1,6,23,16,7,25,49,108,1,Matches
756,Valentin Eysseric,FRA,"FW,MF",Fiorentina,Serie A,26,1992,4.0,6,5,3,2,1,2,4,50.0,2,6,1,5,4,10,1,0,Matches
757,Valentin Eysseric,FRA,"MF,FW",Nantes,Ligue 1,26,1992,2.3,1,1,0,1,0,0,2,0.0,2,2,0,2,0,1,0,0,Matches
758,Marco Fabián,MEX,FW,Eint Frankfurt,Bundesliga,29,1989,0.7,3,2,2,1,0,1,1,100.0,0,0,0,0,3,6,0,0,Matches
759,Łukasz Fabiański,POL,GK,West Ham,Premier League,33,1985,38.0,1,0,1,0,0,1,3,33.3,2,0,0,0,1,2,10,1,Matches
760,Fabinho,BRA,MF,Liverpool,Premier League,24,1993,22.4,59,31,17,38,4,24,59,40.7,35,34,6,28,28,87,27,2,Matches
761,Fábio,BRA,"DF,FW",Nantes,Ligue 1,28,1990,14.2,53,34,25,27,1,26,53,49.1,27,18,4,14,18,71,27,0,Matches
762,Cesc Fàbregas,ESP,MF,Chelsea,Premier League,31,1987,2.0,6,4,4,2,0,1,5,20.0,4,2,1,1,1,7,0,0,Matches
763,Cesc Fàbregas,ESP,MF,Monaco,Ligue 1,31,1987,10.7,14,10,5,5,4,8,28,28.6,20,12,3,9,9,23,5,1,Matches
764,Fabricio,ESP,GK,Fulham,Premier League,30,1987,2.0,1,1,1,0,0,0,0,,0,0,0,0,0,1,3,2,Matches
765,Ralf Fährmann,GER,GK,Schalke 04,Bundesliga,29,1988,16.3,0,0,0,0,0,0,0,,0,0,0,0,2,2,10,4,Matches
766,Romain Faivre,FRA,MF,Monaco,Ligue 1,20,1998,1.0,1,0,0,1,0,0,1,0.0,1,0,0,0,1,2,1,1,Matches
767,Fayçal Fajr,MAR,MF,Caen,Ligue 1,29,1988,36.0,65,32,22,33,10,25,66,37.9,41,27,6,21,29,94,19,2,Matches
768,Radamel Falcao,COL,FW,Monaco,Ligue 1,32,1986,28.4,34,15,6,16,12,8,27,29.6,19,11,6,5,3,37,23,2,Matches
769,Diego Falcinelli,ITA,FW,Bologna,Serie A,27,1991,7.8,8,5,1,3,4,2,3,66.7,1,4,1,3,1,9,5,0,Matches
770,Simon Falette,GUI,DF,Eint Frankfurt,Bundesliga,26,1992,6.7,9,6,7,1,1,2,6,33.3,4,11,5,6,14,23,32,0,Matches
771,Iago Falque,ESP,"FW,MF",Torino,Serie A,28,1990,17.9,13,8,3,8,2,3,16,18.8,13,14,0,14,3,16,2,0,Matches
772,Paolo Faragò,ITA,"MF,DF",Cagliari,Serie A,25,1993,18.9,46,29,20,16,10,13,43,30.2,30,28,2,26,15,61,38,0,Matches
773,Mohamed Fares,ALG,DF,SPAL,Serie A,22,1996,32.8,63,43,37,18,8,25,54,46.3,29,48,4,44,54,117,83,2,Matches
774,Diego Farias,BRA,FW,Empoli,Serie A,28,1990,13.3,11,4,2,8,1,3,10,30.0,7,7,1,6,0,11,4,0,Matches
775,Diego Farias,BRA,FW,Cagliari,Serie A,28,1990,7.8,13,9,3,7,3,2,11,18.2,9,7,1,6,1,14,5,0,Matches
776,Andrea Favilli,ITA,"FW,DF",Genoa,Serie A,21,1997,1.9,1,1,0,0,1,0,1,0.0,1,1,0,1,0,1,1,0,Matches
777,Federico Fazio,ARG,DF,Roma,Serie A,31,1987,31.2,28,20,14,11,3,12,25,48.0,13,45,33,12,53,81,171,2,Matches
778,Zouhair Feddal,MAR,DF,Betis,La Liga,29,1989,18.9,38,23,31,6,1,16,28,57.1,12,19,8,11,31,69,94,2,Matches
779,Nabil Fekir,FRA,MF,Lyon,Ligue 1,25,1993,22.1,51,31,16,19,16,13,38,34.2,25,42,0,42,7,58,3,0,Matches
780,Yassin Fekir,FRA,FW,Lyon,Ligue 1,21,1997,0.1,0,0,0,0,0,0,1,0.0,1,0,0,0,0,0,0,0,Matches
781,Felipe,BRA,DF,Hannover 96,Bundesliga,31,1987,12.2,23,15,21,2,0,9,17,52.9,8,17,9,8,35,58,71,0,Matches
782,Luiz Felipe,ITA,DF,Lazio,Serie A,21,1997,14.3,27,18,20,7,0,13,20,65.0,7,27,15,12,26,53,57,1,Matches
783,Ohis Felix Uduokhai,GER,DF,Wolfsburg,Bundesliga,20,1997,2.7,13,7,7,5,1,9,10,90.0,1,6,2,4,6,19,11,1,Matches
784,Marouane Fellaini,BEL,MF,Manchester Utd,Premier League,30,1987,8.4,21,13,11,9,1,9,17,52.9,8,9,5,4,4,25,34,1,Matches
785,Kiko Femenía,ESP,DF,Watford,Premier League,27,1991,22.8,48,30,34,12,2,24,51,47.1,27,24,6,18,36,84,68,0,Matches
786,Edimilson Fernandes,SUI,MF,Fiorentina,Serie A,22,1996,21.9,36,24,17,16,3,14,36,38.9,22,31,6,25,26,62,31,0,Matches
787,Gelson Fernandes,SUI,MF,Eint Frankfurt,Bundesliga,31,1986,24.7,74,48,33,38,3,23,65,35.4,42,45,9,36,53,127,16,0,Matches
788,Aitor Fernández,ESP,GK,Levante,La Liga,27,1991,16.0,1,0,1,0,0,1,1,100.0,0,0,0,0,1,2,10,1,Matches
789,Andrés Fernández,ESP,GK,Villarreal,La Liga,31,1986,6.0,1,0,1,0,0,1,1,100.0,0,0,0,0,0,1,4,1,Matches
790,Borja Fernández,ESP,"MF,DF",Valladolid,La Liga,37,1981,9.3,17,12,7,9,1,6,16,37.5,10,14,2,12,14,31,25,0,Matches
791,Federico Fernández,ARG,DF,Newcastle Utd,Premier League,29,1989,16.5,16,12,12,4,0,10,18,55.6,8,19,12,7,25,41,106,1,Matches
792,Joaquín Fernández,ESP,"DF,MF",Valladolid,La Liga,22,1996,9.3,16,9,14,1,1,8,16,50.0,8,9,7,2,17,33,45,0,Matches
793,Valery Fernández,ESP,"DF,FW",Girona,La Liga,18,1999,9.9,20,15,13,6,1,10,17,58.8,7,15,1,14,8,28,10,0,Matches
794,Fernandinho,BRA,MF,Manchester City,Premier League,33,1985,26.4,57,43,19,30,8,26,47,55.3,21,28,4,24,41,98,70,0,Matches
795,Juan Ferney Otero,COL,"FW,MF",Amiens,Ligue 1,23,1995,24.2,29,13,11,12,6,13,46,28.3,33,23,3,20,22,51,18,0,Matches
796,Alex Ferrari,ITA,DF,Sampdoria,Serie A,24,1994,6.0,10,8,4,6,0,5,7,71.4,2,7,4,3,9,19,26,0,Matches
797,David Ferreiro,ESP,"MF,FW",Huesca,La Liga,30,1988,25.3,36,22,13,19,4,11,64,17.2,53,27,1,26,24,60,14,2,Matches
798,Facundo Ferreyra,ARG,FW,Espanyol,La Liga,27,1991,2.3,5,2,0,4,1,1,3,33.3,2,3,0,3,0,5,5,0,Matches
799,Jordan Ferri,FRA,MF,Nîmes,Ligue 1,26,1992,20.8,52,31,22,23,7,26,62,41.9,36,27,2,25,15,67,9,1,Matches
800,Jordan Ferri,FRA,MF,Lyon,Ligue 1,26,1992,1.3,5,3,3,1,1,1,4,25.0,3,4,2,2,1,6,3,0,Matches
801,Oliver Fink,GER,MF,Düsseldorf,Bundesliga,36,1982,11.7,38,22,17,17,4,12,38,31.6,26,20,3,17,13,51,19,0,Matches
802,Alfreð Finnbogason,ISL,FW,Augsburg,Bundesliga,29,1989,14.8,7,3,2,5,0,1,9,11.1,8,6,1,5,3,10,11,0,Matches
803,Roberto Firmino,BRA,"FW,MF",Liverpool,Premier League,26,1991,29.0,30,20,5,16,9,7,34,20.6,27,35,1,34,6,36,16,0,Matches
804,Junior Firpo,DOM,"DF,FW",Betis,La Liga,21,1996,21.5,38,25,16,14,8,10,24,41.7,14,27,2,25,23,61,48,0,Matches
805,Mathieu Flamini,FRA,MF,Getafe,La Liga,34,1984,5.0,9,4,4,4,1,4,7,57.1,3,3,1,2,5,14,4,0,Matches
806,Mark Flekken,NED,GK,Freiburg,Bundesliga,25,1993,1.0,0,0,0,0,0,0,0,,0,0,0,0,0,0,0,0,Matches
807,Sergio Floccari,ITA,FW,SPAL,Serie A,36,1981,10.8,13,5,1,5,7,1,7,14.3,6,6,2,4,2,15,6,0,Matches
808,Alessandro Florenzi,ITA,"DF,FW",Roma,Serie A,27,1991,24.2,38,21,22,11,5,17,37,45.9,20,27,5,22,46,84,58,0,Matches
809,Phil Foden,ENG,MF,Manchester City,Premier League,18,2000,3.7,7,6,1,3,3,2,9,22.2,7,1,0,1,4,11,1,0,Matches
810,Guessouma Fofana,MTN,MF,Amiens,Ligue 1,25,1992,2.1,6,4,3,3,0,1,3,33.3,2,2,1,1,3,9,0,0,Matches
811,Guessouma Fofana,MTN,MF,Guingamp,Ligue 1,25,1992,5.3,14,9,2,10,2,4,10,40.0,6,3,0,3,6,20,8,0,Matches
812,Seko Fofana,CIV,MF,Udinese,Serie A,23,1995,29.3,25,13,14,10,1,6,36,16.7,30,20,7,13,29,54,18,3,Matches
813,Wesley Fofana,FRA,DF,Saint-Étienne,Ligue 1,17,2000,1.8,7,6,5,2,0,6,13,46.2,7,1,0,1,4,11,9,0,Matches
814,Youssouf Fofana,FRA,MF,Strasbourg,Ligue 1,19,1999,10.1,28,20,5,20,3,9,27,33.3,18,7,0,7,11,39,8,0,Matches
815,Thomas Foket,BEL,DF,Reims,Ligue 1,23,1994,32.0,91,52,55,23,13,42,69,60.9,27,30,4,26,49,140,80,1,Matches
816,Thomas Fontaine,MAD,"DF,MF",Reims,Ligue 1,27,1991,4.7,6,3,5,0,1,2,5,40.0,3,6,2,4,7,13,28,1,Matches
817,José Fonte,POR,DF,Lille,Ligue 1,34,1983,34.6,27,15,15,9,3,17,24,70.8,7,33,26,7,37,64,153,1,Matches
818,Rui Fonte,POR,"FW,MF",Lille,Ligue 1,28,1990,7.0,25,12,4,16,5,6,11,54.5,5,4,0,4,2,27,8,0,Matches
819,Pablo Fornals,ESP,"MF,FW",Villarreal,La Liga,22,1996,27.5,49,26,14,26,9,15,54,27.8,39,32,4,28,24,73,19,0,Matches
820,Emil Forsberg,SWE,"MF,FW",RB Leipzig,Bundesliga,26,1991,13.9,12,7,0,12,0,5,16,31.3,11,16,1,15,3,15,6,0,Matches
821,Fraser Forster,ENG,GK,Southampton,Premier League,30,1988,1.0,0,0,0,0,0,0,0,,0,0,0,0,0,0,1,0,Matches
822,Steven Fortes,CPV,DF,Toulouse,Ligue 1,26,1992,1.5,3,1,1,2,0,0,0,,0,1,1,0,2,5,9,2,Matches
823,Iver Fossum,NOR,MF,Hannover 96,Bundesliga,22,1996,5.1,9,5,1,7,1,4,8,50.0,4,8,2,6,7,16,10,0,Matches
824,Ben Foster,ENG,GK,Watford,Premier League,35,1983,38.0,2,2,2,0,0,2,6,33.3,4,0,0,0,2,4,34,3,Matches
825,Timothy Fosu-Mensah,NED,DF,Fulham,Premier League,20,1998,8.8,18,7,12,6,0,8,13,61.5,5,11,5,6,12,30,30,1,Matches
826,Dimitri Foulquier,FRA,"MF,DF",Getafe,La Liga,25,1993,20.0,29,12,10,14,5,11,22,50.0,11,23,2,21,20,49,38,0,Matches
827,Juan Foyth,ARG,DF,Tottenham,Premier League,20,1998,9.9,31,17,20,11,0,14,19,73.7,5,12,5,7,10,41,50,1,Matches
828,Raphael Framberger,GER,"DF,MF",Augsburg,Bundesliga,22,1995,6.1,8,6,4,4,0,0,3,0.0,3,10,3,7,11,19,15,1,Matches
829,Simon Francis,ENG,DF,Bournemouth,Premier League,33,1985,13.7,25,14,19,5,1,12,24,50.0,12,15,7,8,19,44,73,1,Matches
830,Mike Frantz,GER,"MF,FW",Freiburg,Bundesliga,31,1986,24.6,34,26,15,15,4,6,20,30.0,14,24,4,20,21,55,32,0,Matches
831,Ryan Fraser,SCO,"MF,FW",Bournemouth,Premier League,24,1994,35.2,19,11,9,8,2,10,32,31.3,22,23,6,17,22,41,33,0,Matches
832,Pierluigi Frattali,ITA,GK,Parma,Serie A,32,1985,1.0,0,0,0,0,0,0,0,,0,0,0,0,0,0,1,0,Matches
833,Fred,BRA,MF,Manchester Utd,Premier League,25,1993,11.6,29,17,12,16,1,15,33,45.5,18,26,2,24,16,45,14,2,Matches
834,Ryan Fredericks,ENG,DF,West Ham,Premier League,25,1992,12.1,38,23,33,5,0,21,32,65.6,11,15,5,10,13,51,49,1,Matches
835,Remo Freuler,SUI,MF,Atalanta,Serie A,26,1992,33.6,84,45,34,34,16,30,70,42.9,40,62,12,50,38,122,45,0,Matches
836,Nicolas Frey,FRA,DF,Chievo,Serie A,34,1984,2.5,3,1,2,1,0,0,3,0.0,3,3,3,0,7,10,18,0,Matches
837,Marco Friedl,AUT,DF,Werder Bremen,Bundesliga,20,1998,5.3,8,6,4,3,1,3,11,27.3,8,9,6,3,13,21,21,0,Matches
838,Alexander Fuchs,GER,"MF,FW",Nürnberg,Bundesliga,21,1997,7.3,14,12,5,7,2,5,15,33.3,10,9,1,8,5,19,10,0,Matches
839,Christian Fuchs,AUT,DF,Leicester City,Premier League,32,1986,2.3,4,3,0,4,0,1,2,50.0,1,0,0,0,4,8,8,0,Matches
840,Javi Fuego,ESP,MF,Villarreal,La Liga,34,1984,2.6,6,3,5,1,0,4,8,50.0,4,2,0,2,3,9,9,0,Matches
841,Angelo Fulgini,FRA,"MF,FW",Angers,Ligue 1,21,1996,18.2,38,22,18,13,7,12,31,38.7,19,21,3,18,28,66,15,0,Matches
842,Niclas Füllkrug,GER,FW,Hannover 96,Bundesliga,25,1993,12.4,3,0,0,1,2,1,5,20.0,4,10,4,6,1,4,17,0,Matches
843,Ramiro Funes Mori,ARG,"DF,MF",Villarreal,La Liga,27,1991,29.2,41,29,30,9,2,19,44,43.2,25,36,24,12,42,83,149,2,Matches
844,Manolo Gabbiadini,ITA,"FW,MF",Southampton,Premier League,26,1991,5.3,6,2,1,4,1,1,2,50.0,1,5,0,5,3,9,6,0,Matches
845,Manolo Gabbiadini,ITA,FW,Sampdoria,Serie A,26,1991,9.0,5,2,1,3,1,3,11,27.3,8,6,1,5,4,9,4,0,Matches
846,Mijat Gaćinović,SRB,MF,Eint Frankfurt,Bundesliga,23,1995,18.1,31,20,7,13,11,11,42,26.2,31,26,1,25,24,55,10,0,Matches
847,Gianluca Gaetano,ITA,"MF,FW",Napoli,Serie A,18,2000,0.1,0,0,0,0,0,0,0,,0,0,0,0,0,0,0,0,Matches
848,Roberto Gagliardini,ITA,MF,Inter,Serie A,24,1994,12.1,23,14,13,8,2,10,27,37.0,17,21,3,18,16,39,19,0,Matches
849,Riccardo Gagliolo,SWE,DF,Parma,Serie A,28,1990,33.8,69,45,52,15,2,33,68,48.5,35,60,33,27,66,135,213,2,Matches
850,Milan Gajić,SRB,DF,Bordeaux,Ligue 1,22,1996,1.0,2,1,1,0,1,1,1,100.0,0,0,0,0,1,3,7,0,Matches
851,Javi Galán,ESP,"DF,FW",Huesca,La Liga,23,1994,16.0,61,39,36,23,2,34,59,57.6,25,22,1,21,19,80,52,1,Matches
852,Sam Gallagher,ENG,FW,Southampton,Premier League,22,1995,0.4,0,0,0,0,0,0,0,,0,1,0,1,0,0,1,0,Matches
853,Álex Gallar,ESP,"MF,FW",Huesca,La Liga,26,1992,11.2,15,9,6,5,4,8,19,42.1,11,9,1,8,9,24,5,0,Matches
854,Enric Gallego,ESP,FW,Huesca,La Liga,31,1986,17.1,21,15,3,13,5,3,19,15.8,16,17,2,15,8,29,32,0,Matches
855,Álex Gálvez,ESP,DF,Rayo Vallecano,La Liga,29,1989,15.7,38,28,25,13,0,14,28,50.0,14,7,2,5,45,83,69,1,Matches
856,Kévin Gameiro,FRA,FW,Valencia,La Liga,31,1987,17.9,14,9,4,6,4,1,6,16.7,5,12,2,10,5,19,3,0,Matches
857,Idrissa Gana Gueye,SEN,MF,Everton,Premier League,28,1989,31.4,142,89,70,63,9,38,76,50.0,38,52,8,44,74,216,48,1,Matches
858,Ignatius Ganago,CMR,FW,Nice,Ligue 1,19,1999,11.5,3,1,0,2,1,0,7,0.0,7,2,0,2,1,4,7,0,Matches
859,Cristian Ganea,ROU,DF,Athletic Club,La Liga,26,1992,0.5,0,0,0,0,0,0,3,0.0,3,1,0,1,1,1,2,0,Matches
860,Ganso,BRA,"MF,FW",Amiens,Ligue 1,28,1989,5.8,12,8,2,8,2,2,15,13.3,13,5,1,4,6,18,0,0,Matches
861,Ezequiel Garay,ARG,DF,Valencia,La Liga,31,1986,23.7,20,17,15,3,2,9,18,50.0,9,30,23,7,16,36,140,0,Matches
862,Borja Garcés,ESP,FW,Atlético Madrid,La Liga,18,1999,0.2,0,0,0,0,0,0,0,,0,0,0,0,0,0,0,0,Matches
863,Alberto García,ESP,GK,Rayo Vallecano,La Liga,33,1985,17.0,1,1,1,0,0,1,3,33.3,2,1,0,1,2,3,1,2,Matches
864,Aleix García,ESP,MF,Girona,La Liga,21,1997,18.5,37,19,17,20,0,13,36,36.1,23,21,6,15,21,58,18,0,Matches
865,Álvaro García,ESP,"FW,MF",Rayo Vallecano,La Liga,25,1992,19.6,22,19,11,7,4,4,25,16.0,21,24,0,24,19,41,30,0,Matches
866,Borja García,ESP,"MF,FW",Girona,La Liga,27,1990,29.2,39,27,17,15,7,22,44,50.0,22,23,2,21,38,77,17,0,Matches
867,Dani García,ESP,MF,Athletic Club,La Liga,28,1990,27.5,56,34,21,32,3,24,63,38.1,39,28,8,20,49,105,46,1,Matches
868,Javi García,ESP,"DF,MF",Betis,La Liga,31,1987,5.8,3,1,3,0,0,2,3,66.7,1,5,1,4,5,8,27,0,Matches
869,Manu García,ESP,MF,Alavés,La Liga,32,1986,25.9,83,48,29,40,14,24,77,31.2,53,42,7,35,23,106,67,0,Matches
870,Manu García,ESP,MF,Toulouse,Ligue 1,20,1998,20.5,37,26,14,17,6,15,49,30.6,34,16,1,15,15,52,5,0,Matches
871,Raúl García,ESP,"MF,FW",Athletic Club,La Liga,32,1986,26.3,61,41,13,37,11,22,68,32.4,46,56,1,55,21,82,39,0,Matches
872,Raúl García,ESP,DF,Leganés,La Liga,29,1989,4.2,8,6,4,4,0,6,8,75.0,2,5,2,3,6,14,28,1,Matches
873,Raúl García,ESP,DF,Girona,La Liga,29,1989,9.4,21,12,11,7,3,11,16,68.8,5,14,4,10,11,32,35,1,Matches
874,Sergio García,ESP,"FW,MF",Espanyol,La Liga,35,1983,16.5,18,10,4,11,3,3,16,18.8,13,6,1,5,10,28,4,0,Matches
875,James Garner,ENG,MF,Manchester Utd,Premier League,17,2001,0.0,0,0,0,0,0,0,0,,0,0,0,0,0,0,0,0,Matches
876,Mario Gaspar,ESP,DF,Villarreal,La Liga,27,1990,28.9,62,43,39,17,6,29,49,59.2,20,48,11,37,42,104,91,0,Matches
877,Paulo Gazzaniga,ARG,GK,Tottenham,Premier League,26,1992,3.0,0,0,0,0,0,0,0,,0,0,0,0,0,0,1,0,Matches
878,Marcello Gazzola,ITA,"DF,MF",Parma,Serie A,33,1985,10.2,9,4,2,5,2,5,9,55.6,4,6,3,3,4,13,33,0,Matches
879,Jean-Philippe Gbamin,CIV,MF,Mainz 05,Bundesliga,22,1995,29.7,51,31,29,15,7,23,51,45.1,28,39,5,34,30,81,32,1,Matches
880,David de Gea,ESP,GK,Manchester Utd,Premier League,27,1990,38.0,0,0,0,0,0,0,2,0.0,2,1,0,1,0,0,11,4,Matches
881,Theodor Gebre Selassie,CZE,DF,Werder Bremen,Bundesliga,31,1986,31.3,53,38,27,16,10,22,51,43.1,29,33,8,25,69,122,100,0,Matches
882,Dennis Geiger,GER,MF,Hoffenheim,Bundesliga,20,1998,2.7,2,1,1,1,0,1,6,16.7,5,1,0,1,3,5,1,0,Matches
883,Jérémy Gélin,FRA,"DF,MF",Rennes,Ligue 1,21,1997,14.2,30,16,18,10,2,18,34,52.9,16,14,6,8,19,49,29,0,Matches
884,Romain Genevois,HAI,DF,Caen,Ligue 1,30,1987,4.0,10,6,9,1,0,6,11,54.5,5,3,0,3,8,18,13,0,Matches
885,Christian Gentner,GER,"MF,FW",Stuttgart,Bundesliga,32,1985,22.4,61,38,29,26,6,16,50,32.0,34,30,3,27,31,92,41,1,Matches
886,Yannick Gerhardt,GER,MF,Wolfsburg,Bundesliga,24,1994,27.3,52,34,22,20,10,16,43,37.2,27,35,7,28,30,82,34,0,Matches
887,Valère Germain,FRA,FW,Marseille,Ligue 1,28,1990,24.1,38,25,8,22,8,8,33,24.2,25,20,5,15,6,44,30,0,Matches
888,Gerson,BRA,"MF,FW",Fiorentina,Serie A,21,1997,27.0,42,26,22,15,5,12,38,31.6,26,46,9,37,16,58,32,0,Matches
889,Gervinho,CIV,FW,Parma,Serie A,31,1987,25.6,19,12,11,5,3,5,13,38.5,8,7,0,7,10,29,2,0,Matches
890,Willem Geubbels,FRA,MF,Monaco,Ligue 1,16,2001,0.1,0,0,0,0,0,0,0,,0,0,0,0,0,0,0,0,Matches
891,Lamine Ghezali,FRA,"FW,MF",Saint-Étienne,Ligue 1,19,1999,0.5,1,1,0,1,0,1,2,50.0,1,0,0,0,0,1,2,0,Matches
892,Rachid Ghezzal,ALG,"FW,MF",Leicester City,Premier League,26,1992,8.3,14,5,3,7,4,3,18,16.7,15,10,1,9,7,21,4,1,Matches
893,Paolo Ghiglione,ITA,DF,Frosinone,Serie A,21,1997,5.7,8,4,6,1,1,6,14,42.9,8,2,0,2,4,12,22,0,Matches
894,Saman Ghoddos,IRN,"FW,MF",Amiens,Ligue 1,24,1993,20.3,33,17,14,15,4,13,32,40.6,19,15,2,13,7,40,13,0,Matches
895,Faouzi Ghoulam,ALG,DF,Napoli,Serie A,27,1991,12.8,9,7,3,5,1,8,9,88.9,1,6,2,4,8,17,17,0,Matches
896,Emanuele Giaccherini,ITA,"MF,FW",Chievo,Serie A,33,1985,22.3,14,8,5,7,2,6,31,19.4,25,21,2,19,16,30,10,2,Matches
897,Morgan Gibbs-White,ENG,"MF,FW",Wolves,Premier League,18,2000,7.4,6,3,2,4,0,1,4,25.0,3,6,0,6,1,7,0,0,Matches
898,Ben Gibson,ENG,DF,Burnley,Premier League,25,1993,0.7,1,1,1,0,0,0,0,,0,1,1,0,0,1,2,0,Matches
899,Fabian Giefer,GER,GK,Augsburg,Bundesliga,28,1990,4.0,0,0,0,0,0,0,2,0.0,2,0,0,0,0,0,1,2,Matches
900,Niko Gießelmann,GER,DF,Düsseldorf,Bundesliga,26,1991,28.8,57,37,38,14,5,26,59,44.1,33,25,6,19,36,93,85,1,Matches
901,Bryan Gil,ESP,"MF,FW",Sevilla,La Liga,17,2001,1.9,6,4,4,1,1,1,5,20.0,4,0,0,0,1,7,0,0,Matches
902,Daniel Ginczek,GER,FW,Wolfsburg,Bundesliga,27,1991,14.2,9,7,4,3,2,5,19,26.3,14,12,2,10,3,12,23,1,Matches
903,Matthias Ginter,GER,DF,Gladbach,Bundesliga,24,1994,26.4,24,14,16,7,1,9,17,52.9,8,31,19,12,17,41,98,1,Matches
904,Andrei Girotto,BRA,MF,Nantes,Ligue 1,26,1992,16.4,57,40,18,36,3,20,44,45.5,24,22,6,16,29,86,43,1,Matches
905,Olivier Giroud,FRA,FW,Chelsea,Premier League,31,1986,9.4,3,2,0,1,2,1,4,25.0,3,6,1,5,3,6,7,0,Matches
906,Kamil Glik,POL,DF,Monaco,Ligue 1,30,1988,33.0,32,23,26,5,1,16,32,50.0,16,25,17,8,61,93,200,1,Matches
907,Serge Gnabry,GER,"FW,MF",Bayern Munich,Bundesliga,23,1995,19.6,36,20,12,13,11,5,30,16.7,25,18,0,18,11,47,3,0,Matches
908,Joris Gnagnon,FRA,"DF,MF",Sevilla,La Liga,21,1997,5.0,11,8,6,4,1,4,7,57.1,3,2,2,0,10,21,16,0,Matches
909,Eddy Gnahoré,FRA,MF,Amiens,Ligue 1,24,1993,24.9,39,27,17,17,5,9,39,23.1,30,29,4,25,23,62,23,1,Matches
910,Massimo Gobbi,ITA,DF,Parma,Serie A,37,1980,13.1,14,7,5,5,4,8,25,32.0,17,16,8,8,9,23,48,0,Matches
911,Kevin Goden,GER,"DF,MF",Nürnberg,Bundesliga,19,1999,3.0,4,3,3,1,0,2,7,28.6,5,4,1,3,4,8,11,0,Matches
912,Diego Godín,URU,DF,Atlético Madrid,La Liga,32,1986,27.9,52,30,33,19,0,20,42,47.6,22,22,9,13,45,97,141,2,Matches
913,Mauro Goicoechea,URU,GK,Toulouse,Ligue 1,30,1988,7.9,0,0,0,0,0,0,0,,0,0,0,0,0,0,7,0,Matches
914,Edoardo Goldaniga,ITA,DF,Frosinone,Serie A,24,1993,29.0,43,28,34,7,2,19,32,59.4,13,29,16,13,57,100,119,0,Matches
915,Pierluigi Gollini,ITA,GK,Atalanta,Serie A,23,1995,20.0,2,2,2,0,0,1,2,50.0,1,0,0,0,0,2,3,2,Matches
916,Aleksandr Golovin,RUS,"MF,FW",Monaco,Ligue 1,22,1996,25.4,36,17,3,20,13,10,44,22.7,34,34,3,31,22,58,12,0,Matches
917,André Gomes,POR,MF,Everton,Premier League,25,1993,22.0,39,23,12,24,3,13,59,22.0,46,27,4,23,20,59,18,0,Matches
918,Angel Gomes,ENG,"MF,FW",Manchester Utd,Premier League,17,2000,0.3,1,0,0,0,1,0,0,,0,0,0,0,0,1,0,0,Matches
919,Ibai Gómez,ESP,FW,Athletic Club,La Liga,28,1989,6.4,6,3,3,2,1,4,9,44.4,5,8,1,7,2,8,8,0,Matches
920,Ibai Gómez,ESP,"MF,FW",Alavés,La Liga,28,1989,16.1,14,8,9,3,2,6,19,31.6,13,10,0,10,8,22,17,0,Matches
921,Joe Gomez,ENG,DF,Liverpool,Premier League,21,1997,11.8,18,11,10,7,1,9,15,60.0,6,10,5,5,14,32,42,0,Matches
922,Mario Gómez,GER,FW,Stuttgart,Bundesliga,33,1985,24.6,19,11,6,10,3,2,12,16.7,10,17,6,11,5,24,33,0,Matches
923,Maxi Gómez,URU,FW,Celta Vigo,La Liga,21,1996,32.9,6,4,1,4,1,1,12,8.3,11,3,0,3,2,8,43,0,Matches
924,Moi Gómez,ESP,MF,Huesca,La Liga,24,1994,33.9,42,28,15,25,2,11,46,23.9,35,27,3,24,28,70,27,0,Matches
925,Papu Gómez,ARG,"MF,FW",Atalanta,Serie A,30,1988,32.2,19,14,5,10,4,6,30,20.0,24,21,0,21,16,35,4,0,Matches
926,Sergi Gómez,ESP,DF,Sevilla,La Liga,26,1992,30.7,49,38,33,12,4,18,28,64.3,10,30,20,10,40,89,135,1,Matches
927,Alfred Gomis,SEN,GK,SPAL,Serie A,24,1993,19.2,0,0,0,0,0,0,1,0.0,1,0,0,0,1,1,14,1,Matches
928,Maxime Gonalons,FRA,MF,Sevilla,La Liga,29,1989,6.0,8,4,2,5,1,1,15,6.7,14,10,4,6,5,13,12,0,Matches
929,Anthony Gonçalves,FRA,"MF,FW",Strasbourg,Ligue 1,32,1986,11.8,22,15,12,8,2,7,22,31.8,15,21,2,19,10,32,17,0,Matches
930,Jérôme Gondorf,GER,"MF,FW",Freiburg,Bundesliga,30,1988,14.4,33,18,12,19,2,14,28,50.0,14,29,5,24,19,52,23,1,Matches
931,Álvaro González,ESP,DF,Villarreal,La Liga,28,1990,32.9,49,35,33,14,2,25,35,71.4,10,34,24,10,37,86,177,2,Matches
932,Bruno González,ESP,DF,Getafe,La Liga,28,1990,18.9,23,10,14,8,1,9,18,50.0,9,13,6,7,22,45,110,0,Matches
933,Cristo González,ESP,FW,Real Madrid,La Liga,20,1997,0.5,1,0,0,1,0,0,0,,0,0,0,0,1,2,0,0,Matches
934,Giancarlo González,CRC,DF,Bologna,Serie A,30,1988,8.3,13,7,12,1,0,5,9,55.6,4,15,11,4,12,25,42,0,Matches
935,Nicolás González,ARG,"FW,MF",Stuttgart,Bundesliga,20,1998,24.0,19,14,3,7,9,9,19,47.4,10,32,2,30,11,30,27,0,Matches
936,Jon Gorenc Stanković,SVN,"MF,DF",Huddersfield,Premier League,22,1996,7.9,26,18,18,7,1,14,26,53.8,12,16,9,7,9,35,20,1,Matches
937,Leon Goretzka,GER,MF,Bayern Munich,Bundesliga,23,1995,22.5,41,22,7,27,7,14,38,36.8,24,25,4,21,26,67,14,1,Matches
938,Mathieu Gorgelin,FRA,GK,Lyon,Ligue 1,27,1990,4.0,0,0,0,0,0,0,0,,0,0,0,0,0,0,3,0,Matches
939,Mirko Gori,ITA,MF,Frosinone,Serie A,25,1993,3.7,16,13,7,9,0,5,16,31.3,11,2,0,2,4,20,9,0,Matches
940,Andoni Gorosabel,ESP,DF,Real Sociedad,La Liga,21,1996,5.1,16,9,10,5,1,8,13,61.5,5,5,1,4,4,20,20,1,Matches
941,Robin Gosens,GER,"DF,MF",Atalanta,Serie A,24,1994,21.6,63,46,32,26,5,37,54,68.5,17,41,3,38,38,101,60,0,Matches
942,Dan Gosling,ENG,MF,Bournemouth,Premier League,28,1990,19.3,57,23,27,21,9,28,53,52.8,25,33,11,22,20,77,46,1,Matches
943,Felix Götze,GER,MF,Augsburg,Bundesliga,20,1998,1.4,4,2,2,2,0,3,3,100.0,0,1,0,1,3,7,7,0,Matches
944,Mario Götze,GER,"FW,MF",Dortmund,Bundesliga,26,1992,18.6,26,19,6,11,9,4,25,16.0,21,10,0,10,8,34,4,1,Matches
945,Prince-Désir Gouano,FRA,DF,Amiens,Ligue 1,24,1993,29.1,31,18,25,5,1,12,22,54.5,10,36,27,9,46,77,127,6,Matches
946,Yoann Gourcuff,FRA,"MF,FW",Dijon,Ligue 1,32,1986,1.5,0,0,0,0,0,0,2,0.0,2,1,1,0,0,0,1,0,Matches
947,Jeffrey Gouweleeuw,NED,DF,Augsburg,Bundesliga,27,1991,23.2,42,31,23,19,0,24,39,61.5,15,44,21,23,56,98,71,1,Matches
948,Paolo Gozzi Iweru,ITA,DF,Juventus,Serie A,17,2001,1.0,3,2,2,1,0,0,0,,0,0,0,0,3,6,3,0,Matches
949,Max Gradel,CIV,"FW,MF",Toulouse,Ligue 1,30,1987,36.0,58,35,34,19,5,24,70,34.3,46,53,9,44,18,76,41,0,Matches
950,Jonathan Gradit,FRA,DF,Caen,Ligue 1,25,1992,22.3,52,28,30,21,1,28,52,53.8,24,40,15,25,45,97,82,3,Matches
951,Samuel Grandsir,FRA,"MF,FW",Strasbourg,Ligue 1,21,1996,2.6,9,6,5,3,1,3,7,42.9,4,2,0,2,1,10,0,0,Matches
952,Samuel Grandsir,FRA,"FW,MF",Monaco,Ligue 1,21,1996,5.2,12,7,4,5,3,2,10,20.0,8,11,0,11,1,13,5,1,Matches
953,Álex Granell,ESP,"MF,DF",Girona,La Liga,29,1988,26.6,64,28,30,31,3,34,83,41.0,49,34,5,29,35,99,36,1,Matches
954,Esteban Granero,ESP,MF,Espanyol,La Liga,31,1987,22.4,50,32,26,18,6,17,50,34.0,33,42,8,34,26,76,34,2,Matches
955,Karlan Grant,ENG,FW,Huddersfield,Premier League,20,1997,9.7,5,2,1,2,2,1,3,33.3,2,8,0,8,2,7,1,1,Matches
956,Alberto Grassi,ITA,MF,Parma,Serie A,23,1995,5.1,20,12,7,10,3,2,10,20.0,8,8,2,6,8,28,10,0,Matches
957,Andre Gray,JAM,FW,Watford,Premier League,27,1991,15.2,3,1,0,2,1,1,6,16.7,5,3,1,2,2,5,6,0,Matches
958,Demarai Gray,JAM,"FW,MF",Leicester City,Premier League,22,1996,22.1,25,12,7,14,4,6,16,37.5,10,19,0,19,9,34,15,0,Matches
959,Mason Greenwood,ENG,FW,Manchester Utd,Premier League,16,2001,1.3,3,3,2,0,1,2,3,66.7,1,2,0,2,0,3,1,0,Matches
960,Michael Gregoritsch,AUT,"MF,FW",Augsburg,Bundesliga,24,1994,27.6,22,13,7,9,6,4,28,14.3,24,29,10,19,15,37,58,0,Matches
961,Clément Grenier,FRA,MF,Rennes,Ligue 1,27,1991,29.6,44,27,7,33,4,21,61,34.4,40,28,4,24,29,73,34,1,Matches
962,Antoine Griezmann,FRA,"FW,MF",Atlético Madrid,La Liga,27,1991,35.5,31,19,8,13,10,8,28,28.6,20,18,1,17,12,43,21,0,Matches
963,Vincenzo Grifo,ITA,"MF,FW",Hoffenheim,Bundesliga,25,1993,3.7,6,3,2,3,1,0,5,0.0,5,2,1,1,2,8,5,0,Matches
964,Vincenzo Grifo,ITA,"MF,FW",Freiburg,Bundesliga,25,1993,15.9,26,14,11,8,7,14,27,51.9,13,10,1,9,2,28,10,0,Matches
965,Florian Grillitsch,AUT,MF,Hoffenheim,Bundesliga,22,1995,26.6,77,49,30,38,9,36,80,45.0,44,34,8,26,72,149,56,1,Matches
966,Jérémy Grimm,FRA,MF,Strasbourg,Ligue 1,31,1987,1.9,4,2,2,2,0,3,5,60.0,2,1,0,1,4,8,5,0,Matches
967,Pascal Groß,GER,"MF,FW",Brighton,Premier League,27,1991,20.7,27,12,12,12,3,11,36,30.6,25,20,8,12,13,40,23,0,Matches
968,Sergej Grubac,MNE,FW,Chievo,Serie A,18,2000,1.7,2,1,1,0,1,1,1,100.0,0,1,0,1,0,2,1,0,Matches
969,Marko Grujić,SRB,MF,Hertha BSC,Bundesliga,22,1996,19.8,45,33,17,20,8,13,38,34.2,25,29,6,23,29,74,51,1,Matches
970,Vicente Guaita,ESP,GK,Crystal Palace,Premier League,31,1987,19.5,0,0,0,0,0,0,0,,0,0,0,0,0,0,5,2,Matches
971,Andrés Guardado,MEX,"MF,DF",Betis,La Liga,31,1986,25.9,24,15,9,12,3,11,47,23.4,36,27,1,26,28,52,28,1,Matches
972,Sergi Guardiola,ESP,FW,Valladolid,La Liga,27,1991,16.8,19,11,1,10,8,2,13,15.4,11,12,0,12,5,24,17,0,Matches
973,Sergi Guardiola,ESP,"MF,FW",Getafe,La Liga,27,1991,0.3,1,1,0,1,0,0,0,,0,0,0,0,0,1,0,0,Matches
974,Metehan Güçlü,TUR,MF,Paris S-G,Ligue 1,19,1999,0.2,0,0,0,0,0,0,0,,0,0,0,0,0,0,0,0,Matches
975,Gonçalo Guedes,POR,"MF,FW",Valencia,La Liga,21,1996,16.3,31,13,16,12,3,14,43,32.6,29,15,0,15,7,38,1,0,Matches
976,Mattéo Guendouzi,FRA,MF,Arsenal,Premier League,19,1999,23.9,44,26,18,23,3,17,47,36.2,30,28,5,23,30,74,24,3,Matches
977,Javi Guerra,ESP,"FW,MF",Rayo Vallecano,La Liga,36,1982,2.6,3,3,1,1,1,0,3,0.0,3,2,0,2,1,4,0,0,Matches
978,Raphaël Guerreiro,POR,"FW,DF",Dortmund,Bundesliga,24,1993,17.0,25,12,11,7,7,12,23,52.2,11,7,1,6,18,43,12,1,Matches
979,Francis Guerrero,ESP,"DF,FW",Betis,La Liga,22,1996,19.8,51,28,25,16,10,23,41,56.1,18,15,1,14,21,72,47,4,Matches
980,Guido Guerrieri,ITA,GK,Lazio,Serie A,22,1996,1.0,0,0,0,0,0,0,0,,0,0,0,0,0,0,2,0,Matches
981,Ander Guevara,ESP,MF,Real Sociedad,La Liga,21,1997,1.0,3,1,0,3,0,2,6,33.3,4,1,0,1,1,4,0,0,Matches
982,Makhtar Gueye,SEN,"FW,MF",Saint-Étienne,Ligue 1,20,1997,0.6,2,1,2,0,0,2,2,100.0,0,2,0,2,0,2,0,0,Matches
983,John Guidetti,SWE,FW,Alavés,La Liga,26,1992,7.0,4,1,0,3,1,0,4,0.0,4,4,0,4,1,5,6,0,Matches
984,Josuha Guilavogui,FRA,MF,Wolfsburg,Bundesliga,27,1990,17.4,31,16,18,13,0,14,25,56.0,11,17,8,9,43,74,56,2,Matches
985,Frederic Guilbert,FRA,DF,Caen,Ligue 1,23,1994,32.4,98,67,59,29,10,41,83,49.4,42,49,21,28,78,176,121,2,Matches
986,Baptiste Guillaume,BEL,FW,Nîmes,Ligue 1,23,1995,13.1,12,6,1,8,3,2,9,22.2,7,6,0,6,2,14,6,0,Matches
987,Serhou Guirassy,GUI,FW,Amiens,Ligue 1,22,1996,12.3,7,5,1,5,1,0,4,0.0,4,7,0,7,4,11,14,0,Matches
988,Péter Gulácsi,HUN,GK,RB Leipzig,Bundesliga,28,1990,32.5,0,0,0,0,0,0,0,,0,0,0,0,0,0,11,0,Matches
989,Manuel Gulde,GER,DF,Freiburg,Bundesliga,27,1991,19.0,24,16,18,5,1,12,16,75.0,4,25,13,12,26,50,90,0,Matches
990,Gerard Gumbau,ESP,MF,Leganés,La Liga,23,1994,13.3,22,16,9,13,0,6,25,24.0,19,15,2,13,13,35,13,0,Matches
991,İlkay Gündoğan,GER,MF,Manchester City,Premier League,27,1990,23.7,19,12,4,12,3,6,31,19.4,25,12,3,9,28,47,19,1,Matches
992,Angus Gunn,SCO,GK,Southampton,Premier League,22,1996,12.0,0,0,0,0,0,0,0,,0,0,0,0,0,0,8,3,Matches
993,Aron Gunnarsson,ISL,MF,Cardiff City,Premier League,29,1989,25.2,51,29,23,25,3,23,84,27.4,61,40,12,28,38,89,55,1,Matches
994,Christian Günter,GER,"DF,MF",Freiburg,Bundesliga,25,1993,32.0,38,26,16,16,6,20,43,46.5,23,31,7,24,14,52,55,0,Matches
995,Koray Günter,GER,DF,Genoa,Serie A,23,1994,9.3,18,13,13,3,2,9,16,56.3,7,9,7,2,18,36,34,0,Matches
996,Serdar Gürler,TUR,"MF,FW",Huesca,La Liga,26,1991,5.4,5,5,3,2,0,3,11,27.3,8,8,0,8,1,6,2,0,Matches
997,Ahmet Gürleyen,GER,DF,Mainz 05,Bundesliga,19,1999,0.1,0,0,0,0,0,0,0,,0,0,0,0,0,0,1,0,Matches
998,Régis Gurtner,FRA,GK,Amiens,Ligue 1,31,1986,38.0,1,1,1,0,0,0,1,0.0,1,0,0,0,1,2,7,3,Matches
999,Gorka Guruzeta,ESP,"MF,FW",Athletic Club,La Liga,21,1996,0.6,1,1,1,0,0,0,2,0.0,2,1,0,1,2,3,0,0,Matches
1000,Luiz Gustavo,BRA,"MF,DF",Marseille,Ligue 1,31,1987,27.1,72,43,49,18,5,30,66,45.5,36,26,12,14,34,106,61,0,Matches
1001,Jonathan de Guzmán,NED,MF,Eint Frankfurt,Bundesliga,30,1987,17.4,34,24,11,20,3,13,28,46.4,15,18,2,16,11,45,16,0,Matches
1002,Janik Haberer,GER,"MF,FW",Freiburg,Bundesliga,24,1994,26.0,71,47,37,24,10,30,75,40.0,45,31,4,27,36,107,49,0,Matches
1003,Hacen,MTN,MF,Valladolid,La Liga,20,1997,0.0,0,0,0,0,0,0,0,,0,1,0,1,1,1,1,0,Matches
1004,Alexander Hack,GER,DF,Mainz 05,Bundesliga,24,1993,11.3,29,13,20,9,0,19,28,67.9,9,26,15,11,41,70,59,2,Matches
1005,Munir El Haddadi,MAR,"FW,MF",Sevilla,La Liga,22,1995,11.6,17,10,5,7,5,2,7,28.6,5,15,0,15,6,23,9,0,Matches
1006,Munir El Haddadi,MAR,FW,Barcelona,La Liga,22,1995,1.7,3,3,1,1,1,1,3,33.3,2,1,0,1,0,3,1,0,Matches
1007,Oussama Haddadi,TUN,DF,Dijon,Ligue 1,26,1992,29.7,51,25,38,11,2,24,43,55.8,19,33,8,25,45,96,93,2,Matches
1008,Florent Hadergjonaj,KVX,"DF,MF",Huddersfield,Premier League,24,1994,20.5,30,17,10,18,2,13,37,35.1,24,21,7,14,21,51,37,1,Matches
1009,Benjamin Hadžić,BIH,"FW,MF",Hannover 96,Bundesliga,19,1999,0.3,0,0,0,0,0,0,1,0.0,1,0,0,0,0,0,0,0,Matches
1010,André Hahn,GER,"FW,MF",Augsburg,Bundesliga,27,1990,22.8,64,38,22,39,3,22,53,41.5,31,28,2,26,27,91,32,0,Matches
1011,Amadou Haidara,MLI,MF,RB Leipzig,Bundesliga,20,1998,4.2,13,11,4,8,1,8,14,57.1,6,9,1,8,4,17,7,0,Matches
1012,Oualid El Hajjam,MAR,"DF,MF",Amiens,Ligue 1,27,1991,6.0,14,9,10,3,1,5,15,33.3,10,8,2,6,12,26,26,0,Matches
1013,Achraf Hakimi,MAR,DF,Dortmund,Bundesliga,19,1998,19.3,34,19,25,8,1,17,36,47.2,19,27,4,23,29,63,45,2,Matches
1014,Sébastien Haller,CIV,FW,Eint Frankfurt,Bundesliga,24,1994,24.2,24,11,7,10,7,8,21,38.1,13,21,1,20,15,39,23,0,Matches
1015,Emil Hallfreðsson,ISL,MF,Udinese,Serie A,34,1984,1.5,0,0,0,0,0,0,1,0.0,1,1,1,0,3,3,4,0,Matches
1016,Emil Hallfreðsson,ISL,MF,Frosinone,Serie A,34,1984,4.4,10,6,5,4,1,0,9,0.0,9,4,1,3,2,12,3,0,Matches
1017,Marcel Halstenberg,GER,"DF,FW",RB Leipzig,Bundesliga,26,1991,26.8,68,44,31,24,13,42,65,64.6,23,27,4,23,38,106,69,0,Matches
1018,Ben Hamer,ENG,GK,Huddersfield,Premier League,30,1987,6.1,0,0,0,0,0,0,3,0.0,3,0,0,0,1,1,3,2,Matches
1019,Romain Hamouma,FRA,"FW,MF",Saint-Étienne,Ligue 1,31,1987,17.6,30,19,6,18,6,12,32,37.5,20,12,1,11,9,39,7,0,Matches
1020,Marek Hamšík,SVK,MF,Napoli,Serie A,31,1987,10.2,7,5,2,4,1,0,11,0.0,11,8,1,7,12,19,14,1,Matches
1021,Dávid Hancko,SVK,DF,Fiorentina,Serie A,20,1997,3.1,7,6,4,3,0,6,9,66.7,3,3,1,2,3,10,12,0,Matches
1022,Samir Handanović,SVN,GK,Inter,Serie A,34,1984,38.0,1,0,1,0,0,1,1,100.0,0,0,0,0,0,1,12,1,Matches
1023,Genki Haraguchi,JPN,"MF,DF",Hannover 96,Bundesliga,27,1991,23.7,44,26,21,20,3,17,66,25.8,49,34,5,29,21,65,33,0,Matches
1024,Féthi Harek,ALG,DF,Nîmes,Ligue 1,35,1982,2.0,4,4,2,2,0,3,4,75.0,1,1,0,1,1,5,6,0,Matches
1025,Amine Harit,MAR,"MF,FW",Schalke 04,Bundesliga,21,1997,12.0,15,8,4,9,2,8,24,33.3,16,11,1,10,9,24,2,0,Matches
1026,Martin Harnik,AUT,"FW,MF",Werder Bremen,Bundesliga,31,1987,9.2,12,7,4,3,5,4,15,26.7,11,8,0,8,3,15,10,0,Matches
1027,Kadeem Harris,ENG,MF,Cardiff City,Premier League,25,1993,4.2,12,5,6,4,2,7,8,87.5,1,3,0,3,3,15,5,0,Matches
1028,Joe Hart,ENG,GK,Burnley,Premier League,31,1987,19.0,0,0,0,0,0,0,1,0.0,1,0,0,0,0,0,11,3,Matches
1029,Makoto Hasebe,JPN,"DF,MF",Eint Frankfurt,Bundesliga,34,1984,28.0,52,34,35,17,0,25,42,59.5,17,43,22,21,40,92,101,3,Matches
1030,Hans Hateboer,NED,DF,Atalanta,Serie A,24,1994,33.0,43,31,19,19,5,17,34,50.0,17,29,5,24,23,66,47,1,Matches
1031,Kai Havertz,GER,"MF,FW",Leverkusen,Bundesliga,19,1999,32.2,26,17,10,11,5,8,32,25.0,24,31,4,27,16,42,29,0,Matches
1032,Isaac Hayden,ENG,MF,Newcastle Utd,Premier League,23,1995,20.7,73,43,19,45,9,23,41,56.1,18,32,4,28,40,113,30,0,Matches
1033,Eden Hazard,BEL,FW,Chelsea,Premier League,27,1991,32.5,14,9,2,1,11,5,17,29.4,12,10,0,10,13,27,6,1,Matches
1034,Thorgan Hazard,BEL,"FW,MF",Gladbach,Bundesliga,25,1993,31.9,50,33,22,20,8,17,48,35.4,31,35,2,33,27,77,12,0,Matches
1035,Rhys Healey,WAL,FW,Cardiff City,Premier League,23,1994,0.6,1,0,0,1,0,0,1,0.0,1,0,0,0,0,1,0,0,Matches
1036,Tom Heaton,ENG,GK,Burnley,Premier League,32,1986,19.0,0,0,0,0,0,0,2,0.0,2,0,0,0,0,0,8,2,Matches
1037,Dominique Heintz,GER,DF,Freiburg,Bundesliga,24,1993,33.9,41,21,34,6,1,18,32,56.3,14,45,22,23,45,86,214,0,Matches
1038,Filip Helander,SWE,DF,Bologna,Serie A,25,1993,19.0,42,26,25,13,4,19,23,82.6,4,27,16,11,14,56,84,0,Matches
1039,Jordan Henderson,ENG,MF,Liverpool,Premier League,28,1990,22.1,46,36,20,22,4,16,39,41.0,23,27,3,24,30,76,17,0,Matches
1040,Jeff Hendrick,IRL,"MF,FW",Burnley,Premier League,26,1992,22.9,24,12,13,7,4,9,32,28.1,23,20,5,15,12,36,31,0,Matches
1041,Wayne Hennessey,WAL,GK,Crystal Palace,Premier League,31,1987,17.5,0,0,0,0,0,0,2,0.0,2,0,0,0,0,0,5,1,Matches
1042,Rouwen Hennings,GER,FW,Düsseldorf,Bundesliga,30,1987,20.4,14,10,1,8,5,2,13,15.4,11,16,1,15,4,18,20,0,Matches
1043,Benjamin Henrichs,GER,"DF,MF",Monaco,Ligue 1,21,1997,20.3,58,39,32,22,4,16,38,42.1,22,18,0,18,35,93,45,0,Matches
1044,Benjamin Henrichs,GER,DF,Leverkusen,Bundesliga,21,1997,0.7,0,0,0,0,0,0,0,,0,2,0,2,3,3,0,0,Matches
1045,Dalbert Henrique,BRA,DF,Inter,Serie A,24,1993,8.6,33,24,18,14,1,12,21,57.1,9,9,3,6,8,41,20,0,Matches
1046,Uche Henry Agbo,NGA,MF,Rayo Vallecano,La Liga,22,1995,4.1,7,4,3,4,0,5,10,50.0,5,3,1,2,6,13,1,0,Matches
1047,Christophe Hérelle,MTQ,DF,Nice,Ligue 1,25,1992,32.6,72,52,51,19,2,40,50,80.0,10,39,16,23,61,133,158,2,Matches
1048,Mario Hermoso,ESP,DF,Espanyol,La Liga,23,1995,31.2,38,24,29,7,2,21,39,53.8,18,34,25,9,37,75,175,2,Matches
1049,Javier Hernández,MEX,FW,West Ham,Premier League,30,1988,14.8,3,0,0,3,0,0,6,0.0,6,8,1,7,1,4,8,0,Matches
1050,Lucas Hernández,FRA,DF,Atlético Madrid,La Liga,22,1996,12.4,35,25,20,14,1,17,20,85.0,3,17,9,8,14,49,49,0,Matches
1051,Theo Hernández,FRA,DF,Real Sociedad,La Liga,20,1997,22.0,54,33,30,15,9,28,44,63.6,16,21,5,16,33,87,42,3,Matches
1052,Ander Herrera,ESP,MF,Manchester Utd,Premier League,28,1989,15.6,54,28,24,22,8,21,61,34.4,40,38,6,32,37,91,25,1,Matches
1053,Yangel Herrera,VEN,"MF,DF",Huesca,La Liga,20,1998,12.8,48,24,18,25,5,23,43,53.5,20,13,1,12,14,62,32,0,Matches
1054,Iago Herrerín,ESP,GK,Athletic Club,La Liga,30,1988,31.0,0,0,0,0,0,0,2,0.0,2,0,0,0,0,0,11,2,Matches
1055,Patrick Herrmann,GER,"FW,DF",Gladbach,Bundesliga,27,1991,12.0,20,14,8,7,5,6,17,35.3,11,6,3,3,6,26,12,0,Matches
1056,Pablo Hervías,ESP,MF,Valladolid,La Liga,25,1993,1.8,1,0,0,1,0,0,1,0.0,1,0,0,0,2,3,0,0,Matches
1057,Pablo Hervías,ESP,MF,Eibar,La Liga,25,1993,2.0,1,1,0,1,0,0,4,0.0,4,2,0,2,0,1,0,0,Matches
1058,Përparim Hetemaj,FIN,MF,Chievo,Serie A,31,1986,24.0,53,27,27,23,3,20,68,29.4,48,25,1,24,30,83,24,2,Matches
1059,Son Heung-min,KOR,"FW,MF",Tottenham,Premier League,26,1992,22.7,23,12,7,12,4,10,34,29.4,24,26,2,24,8,31,4,1,Matches
1060,Gonzalo Higuaín,ARG,FW,Chelsea,Premier League,30,1987,12.1,10,7,2,4,4,2,11,18.2,9,4,0,4,1,11,5,0,Matches
1061,Gonzalo Higuaín,ARG,FW,Milan,Serie A,30,1987,14.2,8,6,1,5,2,5,13,38.5,8,3,0,3,0,8,11,1,Matches
1062,Oscar Hiljemark,SWE,MF,Genoa,Serie A,26,1992,13.3,16,9,8,7,1,5,16,31.3,11,13,3,10,13,29,14,0,Matches
1063,Vitorino Hilton,BRA,DF,Montpellier,Ligue 1,40,1977,35.9,33,13,28,5,0,12,30,40.0,18,31,15,16,66,99,198,2,Matches
1064,Martin Hinteregger,AUT,DF,Augsburg,Bundesliga,25,1992,17.5,48,35,31,16,1,24,35,68.6,11,24,13,11,22,70,68,0,Matches
1065,Martin Hinteregger,AUT,DF,Eint Frankfurt,Bundesliga,25,1992,12.7,34,26,19,12,3,13,28,46.4,15,20,7,13,13,47,51,0,Matches
1066,Marwin Hitz,SUI,GK,Dortmund,Bundesliga,30,1987,2.0,0,0,0,0,0,0,0,,0,0,0,0,0,0,0,1,Matches
1067,Andrew Hjulsager,DEN,"MF,FW",Celta Vigo,La Liga,23,1995,4.0,16,10,11,2,3,2,18,11.1,16,4,0,4,2,18,1,0,Matches
1068,Wesley Hoedt,NED,DF,Southampton,Premier League,24,1994,13.0,28,12,23,5,0,17,26,65.4,9,20,13,7,23,51,79,2,Matches
1069,Wesley Hoedt,NED,DF,Celta Vigo,La Liga,24,1994,9.9,17,11,15,2,0,12,17,70.6,5,17,11,6,11,28,58,3,Matches
1070,André Hoffmann,GER,"DF,MF",Düsseldorf,Bundesliga,25,1993,11.7,22,14,12,10,0,9,25,36.0,16,17,12,5,21,43,44,0,Matches
1071,Nicolas Höfler,GER,MF,Freiburg,Bundesliga,28,1990,17.9,45,22,19,22,4,14,36,38.9,22,21,4,17,32,77,41,0,Matches
1072,Jonas Hofmann,GER,MF,Gladbach,Bundesliga,26,1992,21.2,37,18,11,19,7,9,37,24.3,28,33,2,31,16,53,14,1,Matches
1073,Jonathan Hogg,ENG,MF,Huddersfield,Premier League,29,1988,26.3,78,41,18,51,9,27,69,39.1,42,46,7,39,73,151,19,1,Matches
1074,Junior Hoilett,CAN,"MF,FW",Cardiff City,Premier League,28,1990,23.8,40,27,26,11,3,15,53,28.3,38,34,0,34,32,72,30,0,Matches
1075,Rob Holding,ENG,DF,Arsenal,Premier League,22,1995,9.0,11,7,9,2,0,2,8,25.0,6,9,7,2,12,23,40,0,Matches
1076,José Holebas,GRE,DF,Watford,Premier League,34,1984,26.6,68,40,44,20,4,28,53,52.8,25,27,8,19,21,89,97,0,Matches
1077,Lucas Höler,GER,FW,Freiburg,Bundesliga,24,1994,11.2,18,13,6,9,3,4,18,22.2,14,10,1,9,3,21,15,2,Matches
1078,Mason Holgate,ENG,DF,Everton,Premier League,21,1996,4.5,5,4,4,1,0,1,1,100.0,0,3,2,1,3,8,32,0,Matches
1079,Gerrit Holtmann,PHI,"FW,MF",Mainz 05,Bundesliga,23,1995,1.6,2,0,1,0,1,1,2,50.0,1,3,2,1,4,6,1,0,Matches
1080,Justin Hoogma,NED,"DF,MF",Hoffenheim,Bundesliga,20,1998,1.2,4,2,2,1,1,2,2,100.0,0,3,1,2,2,6,1,0,Matches
1081,Lukáš Hrádecký,FIN,GK,Leverkusen,Bundesliga,28,1989,32.0,0,0,0,0,0,0,1,0.0,1,0,0,0,1,1,9,1,Matches
1082,Branimir Hrgota,SWE,FW,Eint Frankfurt,Bundesliga,25,1993,0.1,0,0,0,0,0,0,0,,0,0,0,0,0,0,0,0,Matches
1083,Benjamin Hübner,GER,DF,Hoffenheim,Bundesliga,29,1989,9.0,29,18,18,9,2,14,18,77.8,4,16,7,9,21,50,35,0,Matches
1084,Tomáš Hubočan,SVK,DF,Marseille,Ligue 1,32,1985,0.8,3,2,3,0,0,3,4,75.0,1,0,0,0,2,5,5,0,Matches
1085,Callum Hudson-Odoi,ENG,FW,Chelsea,Premier League,17,2000,4.4,8,6,8,0,0,2,4,50.0,2,1,0,1,3,11,0,0,Matches
1086,Will Hughes,ENG,MF,Watford,Premier League,23,1995,26.9,74,43,27,35,12,25,59,42.4,34,55,6,49,25,99,30,0,Matches
1087,Vitor Hugo,BRA,DF,Fiorentina,Serie A,27,1991,27.4,64,42,38,25,1,17,27,63.0,10,28,13,15,74,138,141,2,Matches
1088,Mats Hummels,GER,DF,Bayern Munich,Bundesliga,29,1988,19.7,26,17,19,6,1,9,24,37.5,15,20,8,12,34,60,50,1,Matches
1089,Adrien Hunou,FRA,"FW,MF",Rennes,Ligue 1,24,1994,13.8,11,7,3,5,3,2,9,22.2,7,14,0,14,5,16,8,0,Matches
1090,Emerson Hyndman,USA,MF,Bournemouth,Premier League,22,1996,0.4,6,2,6,0,0,2,3,66.7,1,0,0,0,1,7,0,0,Matches
1091,Elseid Hysaj,ALB,DF,Napoli,Serie A,24,1994,23.4,40,28,22,15,3,25,49,51.0,24,11,3,8,24,64,51,0,Matches
1092,Suk Hyun-jun,KOR,FW,Reims,Ligue 1,27,1991,8.8,11,8,1,6,4,0,8,0.0,8,2,1,1,2,13,4,1,Matches
1093,Pierre Højbjerg,DEN,MF,Southampton,Premier League,22,1995,30.7,71,49,20,44,7,24,73,32.9,49,51,8,43,60,131,30,1,Matches
1094,Simone Iacoponi,ITA,DF,Parma,Serie A,31,1987,37.2,62,43,50,11,1,27,47,57.4,20,40,26,14,37,99,178,3,Matches
1095,Robert Ibáñez,ESP,MF,Getafe,La Liga,25,1993,0.8,2,2,1,1,0,0,1,0.0,1,3,0,3,0,2,0,0,Matches
1096,Roger Ibanez,BRA,"DF,FW",Atalanta,Serie A,19,1998,0.0,0,0,0,0,0,0,0,,0,0,0,0,0,0,1,0,Matches
1097,Jordon Ibe,ENG,"MF,DF",Bournemouth,Premier League,22,1995,8.9,6,5,0,5,1,2,7,28.6,5,2,0,2,4,10,4,0,Matches
1098,Vedad Ibišević,BIH,FW,Hertha BSC,Bundesliga,33,1984,20.1,12,8,2,5,5,0,10,0.0,10,10,4,6,3,15,20,0,Matches
1099,Vicente Iborra,ESP,MF,Leicester City,Premier League,30,1988,2.5,4,1,1,3,0,0,7,0.0,7,1,0,1,8,12,4,1,Matches
1100,Vicente Iborra,ESP,MF,Villarreal,La Liga,30,1988,18.5,31,18,22,5,4,14,37,37.8,23,25,7,18,22,53,41,1,Matches
1101,Didier Ibrahim Ndong,GAB,MF,Guingamp,Ligue 1,24,1994,8.3,16,11,3,13,0,5,13,38.5,8,15,3,12,15,31,6,1,Matches
1102,Mauro Icardi,ARG,FW,Inter,Serie A,25,1993,25.2,9,8,2,2,5,1,6,16.7,5,4,1,3,3,12,20,1,Matches
1103,Salvador Ichazo,URU,GK,Torino,Serie A,26,1992,2.8,0,0,0,0,0,0,0,,0,0,0,0,0,0,0,0,Matches
1104,Edgar Ié,GNB,DF,Lille,Ligue 1,24,1994,2.7,5,4,3,2,0,3,5,60.0,2,2,1,1,7,12,17,0,Matches
1105,Edgar Ié,GNB,DF,Nantes,Ligue 1,24,1994,8.6,20,13,12,6,2,9,16,56.3,7,10,3,7,8,28,23,0,Matches
1106,Borja Iglesias,ESP,FW,Espanyol,La Liga,25,1993,34.2,23,14,7,8,8,5,24,20.8,19,14,6,8,7,30,41,0,Matches
1107,Kelechi Iheanacho,NGA,"FW,MF",Leicester City,Premier League,21,1996,10.5,6,5,4,1,1,1,5,20.0,4,5,0,5,2,8,3,0,Matches
1108,Jordan Ikoko,COD,DF,Guingamp,Ligue 1,24,1994,19.0,37,24,22,14,1,16,28,57.1,12,18,5,13,24,61,30,0,Matches
1109,Jonathan Ikone,FRA,"MF,FW",Lille,Ligue 1,20,1998,31.1,25,14,7,12,6,8,30,26.7,22,24,2,22,6,31,4,0,Matches
1110,Ivo Iličević,CRO,MF,Nürnberg,Bundesliga,31,1986,0.4,1,0,0,1,0,1,2,50.0,1,1,0,1,0,1,0,0,Matches
1111,Josip Iličić,SVN,"FW,MF",Atalanta,Serie A,30,1988,23.8,15,7,2,7,6,5,20,25.0,15,20,1,19,5,20,2,0,Matches
1112,Asier Illarramendi,ESP,MF,Real Sociedad,La Liga,28,1990,20.2,39,24,22,14,3,21,51,41.2,30,36,9,27,31,70,46,1,Matches
1113,Stefan Ilsanker,AUT,"DF,MF",RB Leipzig,Bundesliga,29,1989,10.4,26,17,15,10,1,14,23,60.9,9,9,2,7,18,44,43,1,Matches
1114,Giannelli Imbula,COD,MF,Rayo Vallecano,La Liga,25,1992,19.2,14,7,6,7,1,5,12,41.7,7,12,3,9,8,22,6,0,Matches
1115,Ciro Immobile,ITA,FW,Lazio,Serie A,28,1990,31.8,12,6,4,3,5,4,9,44.4,5,18,1,17,1,13,8,0,Matches
1116,Emmanuel Imorou,BEN,DF,Caen,Ligue 1,29,1988,12.4,18,13,10,7,1,11,17,64.7,6,14,4,10,28,46,49,1,Matches
1117,Svante Ingelsson,SWE,"DF,MF",Udinese,Serie A,20,1998,1.1,1,1,1,0,0,0,0,,0,2,0,2,0,1,4,0,Matches
1118,Roberto Inglese,ITA,FW,Parma,Serie A,26,1991,21.8,20,14,7,7,6,1,13,7.7,12,26,2,24,6,26,27,0,Matches
1119,Danny Ings,ENG,FW,Southampton,Premier League,26,1992,18.3,30,14,5,19,6,11,28,39.3,17,30,2,28,5,35,9,0,Matches
1120,Lorenzo Insigne,ITA,"FW,MF",Napoli,Serie A,27,1991,23.0,14,4,5,6,3,6,18,33.3,12,7,0,7,8,22,3,0,Matches
1121,Emiliano Insúa,ARG,DF,Stuttgart,Bundesliga,29,1989,23.5,51,33,26,18,7,25,42,59.5,17,29,2,27,31,82,55,1,Matches
1122,Pablo Insua,ESP,DF,Huesca,La Liga,24,1993,8.6,23,10,14,9,0,8,15,53.3,7,2,0,2,12,35,40,0,Matches
1123,Takashi Inui,JPN,"MF,FW",Alavés,La Liga,30,1988,9.2,9,5,6,2,1,5,18,27.8,13,5,0,5,4,13,3,0,Matches
1124,Takashi Inui,JPN,MF,Betis,La Liga,30,1988,4.2,4,3,0,4,0,3,7,42.9,4,3,0,3,1,5,1,0,Matches
1125,Artur Ioniță,MDA,MF,Cagliari,Serie A,27,1990,33.0,67,38,23,31,13,16,57,28.1,41,40,5,35,27,94,30,0,Matches
1126,Gorka Iraizoz,ESP,GK,Girona,La Liga,37,1981,6.2,1,0,1,0,0,1,1,100.0,0,0,0,0,1,2,7,0,Matches
1127,Carlos Isaac,ESP,DF,Atlético Madrid,La Liga,20,1998,1.0,0,0,0,0,0,0,2,0.0,2,2,0,2,1,1,2,0,Matches
1128,Isco,ESP,"MF,FW",Real Madrid,La Liga,26,1992,13.2,29,14,14,8,7,14,34,41.2,20,9,1,8,6,35,3,0,Matches
1129,Mikael Ishak,SWE,FW,Nürnberg,Bundesliga,25,1993,21.3,9,6,3,6,0,3,16,18.8,13,8,3,5,3,12,10,0,Matches
1130,Wilson Isidor,FRA,FW,Monaco,Ligue 1,17,2000,0.5,0,0,0,0,0,0,0,,0,1,1,0,0,0,1,0,Matches
1131,Abass Issah,GHA,FW,Mainz 05,Bundesliga,19,1998,0.1,0,0,0,0,0,0,0,,0,0,0,0,0,0,0,0,Matches
1132,Gian-Luca Itter,GER,DF,Wolfsburg,Bundesliga,19,1999,1.0,4,3,3,1,0,1,2,50.0,1,2,0,2,1,5,2,0,Matches
1133,Manuel Iturra,CHI,MF,Villarreal,La Liga,34,1984,0.8,2,0,0,2,0,0,0,,0,1,0,1,2,4,2,0,Matches
1134,Ander Iturraspe,ESP,MF,Athletic Club,La Liga,29,1989,1.1,2,2,1,1,0,1,1,100.0,0,0,0,0,6,8,2,0,Matches
1135,Ivi,ESP,"MF,FW",Valladolid,La Liga,24,1994,0.2,0,0,0,0,0,0,0,,0,0,0,0,0,0,0,0,Matches
1136,Alex Iwobi,NGA,"FW,MF",Arsenal,Premier League,22,1996,21.9,28,14,10,16,2,6,25,24.0,19,21,1,20,12,40,13,1,Matches
1137,José Izquierdo,COL,"MF,FW",Brighton,Premier League,26,1992,8.8,15,9,9,4,2,10,20,50.0,10,7,1,6,5,20,7,0,Matches
1138,Armando Izzo,ITA,DF,Torino,Serie A,26,1992,36.3,76,50,35,35,6,33,53,62.3,20,52,24,28,88,164,149,2,Matches
1139,Koo Ja-cheol,KOR,MF,Augsburg,Bundesliga,29,1989,18.2,36,23,10,20,6,12,30,40.0,18,28,5,23,27,63,21,0,Matches
1140,Lukas Jäger,AUT,"FW,MF",Nürnberg,Bundesliga,24,1994,0.3,0,0,0,0,0,0,2,0.0,2,0,0,0,0,0,0,0,Matches
1141,Phil Jagielka,ENG,DF,Everton,Premier League,35,1982,3.7,7,5,3,4,0,1,4,25.0,3,1,0,1,2,9,14,0,Matches
1142,Alireza Jahanbakhsh,IRN,"FW,MF",Brighton,Premier League,24,1993,11.3,32,18,17,11,4,11,30,36.7,19,16,0,16,11,43,4,0,Matches
1143,Christophe Jallet,FRA,DF,Nice,Ligue 1,34,1983,9.8,29,21,12,13,4,16,27,59.3,11,21,5,16,14,43,32,0,Matches
1144,Jandrei,BRA,GK,Genoa,Serie A,25,1993,1.0,0,0,0,0,0,0,1,0.0,1,0,0,0,0,0,0,0,Matches
1145,Christoph Janker,GER,"MF,FW",Augsburg,Bundesliga,33,1985,0.8,2,1,2,0,0,0,0,,0,1,0,1,0,2,1,0,Matches
1146,Marko Janković,MNE,"DF,MF",SPAL,Serie A,23,1995,0.6,3,1,2,1,0,0,2,0.0,2,0,0,0,0,3,0,0,Matches
1147,Jakub Jankto,CZE,MF,Sampdoria,Serie A,22,1996,10.7,7,4,5,2,0,4,15,26.7,11,18,2,16,9,16,16,0,Matches
1148,Daryl Janmaat,NED,DF,Watford,Premier League,29,1989,16.9,36,24,23,11,2,20,29,69.0,9,16,6,10,33,69,71,0,Matches
1149,Vincent Janssen,NED,FW,Tottenham,Premier League,24,1994,0.4,2,1,0,2,0,0,0,,0,0,0,0,0,2,1,0,Matches
1150,Tony Jantschke,GER,DF,Gladbach,Bundesliga,28,1990,10.4,15,10,9,5,1,6,8,75.0,2,10,7,3,27,42,51,1,Matches
1151,Adnan Januzaj,BEL,"FW,MF",Real Sociedad,La Liga,23,1995,13.9,11,8,5,2,4,3,13,23.1,10,7,0,7,6,17,6,0,Matches
1152,Nicolas Janvier,FRA,MF,Rennes,Ligue 1,19,1998,0.0,0,0,0,0,0,0,0,,0,0,0,0,0,0,0,0,Matches
1153,Paweł Jaroszyński,POL,DF,Chievo,Serie A,23,1994,15.0,29,18,17,8,4,16,32,50.0,16,15,4,11,24,53,41,1,Matches
1154,Rune Jarstein,NOR,GK,Hertha BSC,Bundesliga,33,1984,30.5,0,0,0,0,0,0,0,,0,0,0,0,1,1,8,1,Matches
1155,Jason,ESP,"DF,FW",Levante,La Liga,24,1994,25.9,44,25,22,11,11,20,71,28.2,51,25,4,21,46,90,27,0,Matches
1156,Dennis Jastrzembski,POL,"FW,DF",Hertha BSC,Bundesliga,18,2000,0.7,0,0,0,0,0,0,3,0.0,3,0,0,0,1,1,0,0,Matches
1157,Assil Jaziri,TUN,FW,Nice,Ligue 1,18,1999,0.4,2,2,0,2,0,1,2,50.0,1,1,0,1,1,3,0,0,Matches
1158,Corentin Jean,FRA,"FW,MF",Toulouse,Ligue 1,23,1995,7.0,9,6,3,6,0,2,8,25.0,6,8,0,8,2,11,5,0,Matches
1159,Benjamin Jeannot,FRA,"FW,MF",Dijon,Ligue 1,26,1992,16.0,17,12,5,7,5,6,19,31.6,13,15,3,12,12,29,14,0,Matches
1160,Tin Jedvaj,CRO,DF,Leverkusen,Bundesliga,22,1995,12.5,23,15,9,8,6,10,19,52.6,9,28,2,26,22,45,52,0,Matches
1161,Jemerson,BRA,"DF,MF",Monaco,Ligue 1,25,1992,24.7,54,38,34,19,1,29,46,63.0,17,29,17,12,25,79,121,1,Matches
1162,Carl Jenkinson,ENG,DF,Arsenal,Premier League,26,1992,1.8,3,2,2,0,1,2,3,66.7,1,4,3,1,0,3,2,0,Matches
1163,Fredrik Jensen,FIN,"FW,MF",Augsburg,Bundesliga,20,1997,2.3,5,4,3,1,1,2,4,50.0,2,6,0,6,2,7,3,0,Matches
1164,Mathias Jensen,DEN,"MF,FW",Celta Vigo,La Liga,22,1996,2.6,4,2,2,2,0,2,9,22.2,7,2,0,2,4,8,1,0,Matches
1165,Jesé,ESP,"FW,MF",Betis,La Liga,25,1993,8.7,7,4,3,3,1,2,8,25.0,6,8,0,8,1,8,1,0,Matches
1166,Gabriel Jesus,BRA,FW,Manchester City,Premier League,21,1997,11.5,10,3,5,2,3,0,5,0.0,5,16,2,14,3,13,4,0,Matches
1167,Juan Jesus,BRA,DF,Roma,Serie A,27,1991,15.6,37,29,30,5,2,17,30,56.7,13,20,12,8,16,53,41,0,Matches
1168,Raúl Jiménez,MEX,FW,Wolves,Premier League,27,1991,34.6,30,18,5,17,8,6,23,26.1,17,25,3,22,26,56,40,0,Matches
1169,Joaquín,ESP,"FW,MF",Betis,La Liga,37,1981,18.8,10,4,4,2,4,3,7,42.9,4,13,2,11,14,24,31,1,Matches
1170,Joelinton,BRA,"FW,MF",Hoffenheim,Bundesliga,21,1996,23.7,35,22,9,20,6,10,30,33.3,20,36,3,33,14,49,8,0,Matches
1171,Aron Jóhannsson,USA,MF,Werder Bremen,Bundesliga,27,1990,0.0,0,0,0,0,0,0,0,,0,0,0,0,0,0,0,0,Matches
1172,Stefan Johansen,NOR,MF,Fulham,Premier League,27,1991,4.6,11,3,4,7,0,5,8,62.5,3,5,0,5,3,14,6,0,Matches
1173,Jakob Johansson,SWE,MF,Rennes,Ligue 1,28,1990,7.9,17,9,5,12,0,10,20,50.0,10,7,3,4,3,20,17,1,Matches
1174,Ben Johnson,ENG,DF,West Ham,Premier League,18,2000,0.7,1,0,1,0,0,0,1,0.0,1,0,0,0,1,2,5,0,Matches
1175,Fabian Johnson,USA,"DF,FW",Gladbach,Bundesliga,30,1987,11.2,13,5,2,8,3,6,8,75.0,2,8,3,5,10,23,16,0,Matches
1176,Tyreke Johnson,ENG,MF,Southampton,Premier League,19,1998,0.0,0,0,0,0,0,0,0,,0,0,0,0,0,0,0,0,Matches
1177,Karl-Johan Johnsson,SWE,GK,Guingamp,Ligue 1,28,1990,17.0,0,0,0,0,0,0,1,0.0,1,0,0,0,0,0,4,1,Matches
1178,Jonathas,BRA,FW,Hannover 96,Bundesliga,29,1989,6.7,7,4,3,4,0,3,10,30.0,7,9,1,8,3,10,4,0,Matches
1179,Phil Jones,ENG,DF,Manchester Utd,Premier League,26,1992,14.0,19,13,12,7,0,8,13,61.5,5,16,11,5,23,42,67,3,Matches
1180,Jony,ESP,"MF,FW",Alavés,La Liga,27,1991,33.0,20,14,6,7,7,7,37,18.9,30,18,0,18,22,42,12,2,Matches
1181,Joan Jordán,ESP,MF,Eibar,La Liga,24,1994,31.9,63,40,16,38,9,28,80,35.0,52,38,4,34,32,95,18,1,Matches
1182,Bruno Jordão,POR,"MF,DF",Lazio,Serie A,19,1998,1.0,4,3,2,1,1,1,3,33.3,2,1,0,1,0,4,2,0,Matches
1183,Jorginho,ITA,MF,Chelsea,Premier League,26,1991,35.1,76,38,27,41,8,45,96,46.9,51,46,7,39,64,140,38,1,Matches
1184,Willian José,BRA,FW,Real Sociedad,La Liga,26,1991,26.3,5,3,1,3,1,2,7,28.6,5,11,5,6,1,6,27,0,Matches
1185,Joselu,ESP,FW,Newcastle Utd,Premier League,28,1990,6.6,14,8,4,5,5,4,9,44.4,5,5,0,5,3,17,15,0,Matches
1186,Evens Joseph,FRA,"MF,FW",Caen,Ligue 1,19,1999,3.8,5,2,1,2,2,1,3,33.3,2,3,0,3,2,7,1,0,Matches
1187,Diogo Jota,POR,"FW,MF",Wolves,Premier League,21,1996,26.2,28,16,11,11,6,10,38,26.3,28,20,1,19,13,41,11,0,Matches
1188,Aleksandar Jovanović,SRB,GK,Huesca,La Liga,25,1992,12.0,0,0,0,0,0,0,0,,0,0,0,0,1,1,3,0,Matches
1189,Vukašin Jovanović,SRB,DF,Bordeaux,Ligue 1,22,1996,15.3,26,21,21,5,0,13,19,68.4,6,23,12,11,36,62,105,0,Matches
1190,Stevan Jovetić,MNE,"MF,FW",Monaco,Ligue 1,28,1989,4.4,2,1,1,1,0,1,3,33.3,2,1,0,1,1,3,3,0,Matches
1191,Luka Jović,SRB,"FW,MF",Eint Frankfurt,Bundesliga,20,1997,24.9,10,5,1,8,1,1,12,8.3,11,8,0,8,3,13,30,0,Matches
1192,Jozabed,ESP,MF,Celta Vigo,La Liga,27,1991,12.8,19,10,8,8,3,8,24,33.3,16,8,2,6,9,28,13,2,Matches
1193,Miguel Juan Llambrich,ESP,"DF,FW",Villarreal,La Liga,22,1996,6.0,21,14,11,9,1,6,14,42.9,8,9,2,7,12,33,17,0,Matches
1194,Juanfran,ESP,"DF,FW",Leganés,La Liga,29,1988,16.2,20,12,13,5,2,9,16,56.3,7,9,4,5,19,39,37,0,Matches
1195,Juanfran,ESP,DF,Atlético Madrid,La Liga,33,1985,17.9,35,22,27,5,3,24,38,63.2,14,13,5,8,19,54,36,1,Matches
1196,Juanmi,ESP,"FW,MF",Real Sociedad,La Liga,25,1993,16.9,21,12,7,11,3,8,22,36.4,14,12,0,12,16,37,13,0,Matches
1197,Juanpe,ESP,DF,Girona,La Liga,27,1991,30.7,48,25,32,15,1,24,45,53.3,21,31,15,16,57,105,138,0,Matches
1198,Juanpi,VEN,"MF,FW",Huesca,La Liga,24,1994,7.4,16,6,9,5,2,4,12,33.3,8,15,0,15,6,22,3,0,Matches
1199,Nathaël Julan,FRA,"FW,MF",Guingamp,Ligue 1,22,1996,4.8,1,0,0,0,1,0,3,0.0,3,6,1,5,0,1,2,0,Matches
1200,Christopher Jullien,FRA,DF,Toulouse,Ligue 1,25,1993,33.5,35,24,23,10,2,12,32,37.5,20,39,27,12,41,76,203,4,Matches
1201,David Juncà,ESP,DF,Celta Vigo,La Liga,24,1993,19.5,55,30,40,13,2,28,46,60.9,18,27,6,21,35,90,63,1,Matches
1202,Sebastian Jung,GER,DF,Wolfsburg,Bundesliga,28,1990,0.6,1,0,0,1,0,1,1,100.0,0,0,0,0,0,1,1,0,Matches
1203,Hamed Junior Traorè,CIV,MF,Empoli,Serie A,18,2000,25.1,67,38,26,32,9,27,72,37.5,45,29,4,25,30,97,17,0,Matches
1204,Vinicius Júnior,BRA,"FW,MF",Real Madrid,La Liga,18,2000,9.7,10,6,3,6,1,3,16,18.8,13,6,1,5,7,17,1,0,Matches
1205,Musa Juwara,GAM,FW,Chievo,Serie A,16,2001,0.1,0,0,0,0,0,0,0,,0,0,0,0,1,1,0,0,Matches
1206,Mathias Jørgensen,DEN,DF,Huddersfield,Premier League,28,1990,23.9,49,31,27,21,1,27,46,58.7,19,29,14,15,69,118,83,0,Matches
1207,Sory Kaba,GUI,"FW,MF",Dijon,Ligue 1,23,1995,2.6,1,1,1,0,0,1,3,33.3,2,2,0,2,0,1,1,0,Matches
1208,Ozan Kabak,TUR,DF,Stuttgart,Bundesliga,18,2000,15.0,33,19,22,9,2,9,19,47.4,10,15,8,7,23,56,58,1,Matches
1209,Christian Kabasele,BEL,DF,Watford,Premier League,27,1991,17.6,25,14,20,5,0,10,23,43.5,13,21,16,5,38,63,111,0,Matches
1210,Elias Kachunga,COD,"FW,MF",Huddersfield,Premier League,26,1992,13.1,22,9,8,12,2,9,25,36.0,16,16,1,15,4,26,10,0,Matches
1211,Pavel Kadeřábek,CZE,DF,Hoffenheim,Bundesliga,26,1992,27.9,30,19,12,13,5,11,24,45.8,13,37,10,27,34,64,71,1,Matches
1212,Shinji Kagawa,JPN,MF,Dortmund,Bundesliga,29,1989,1.1,0,0,0,0,0,0,0,,0,0,0,0,0,0,0,0,Matches
1213,Florian Kainz,AUT,FW,Werder Bremen,Bundesliga,25,1992,4.1,6,5,5,1,0,3,6,50.0,3,4,1,3,3,9,5,0,Matches
1214,Gaël Kakuta,COD,"MF,FW",Rayo Vallecano,La Liga,27,1991,8.0,12,7,5,5,2,2,10,20.0,8,4,1,3,9,21,9,0,Matches
1215,Nikola Kalinić,CRO,FW,Atlético Madrid,La Liga,30,1988,7.1,6,4,2,4,0,1,3,33.3,2,1,0,1,2,8,2,0,Matches
1216,Salomon Kalou,CIV,"FW,MF",Hertha BSC,Bundesliga,32,1985,25.7,21,12,5,11,5,6,24,25.0,18,23,1,22,6,27,25,0,Matches
1217,Samuel Kalu,NGA,FW,Bordeaux,Ligue 1,20,1997,14.2,27,18,15,7,5,4,11,36.4,7,11,3,8,8,35,4,1,Matches
1218,François Kamano,GUI,"FW,MF",Bordeaux,Ligue 1,22,1996,28.5,29,18,6,17,6,11,30,36.7,19,27,0,27,17,46,6,1,Matches
1219,Aboubakar Kamara,MTN,FW,Fulham,Premier League,23,1995,7.7,8,4,1,5,2,3,7,42.9,4,6,0,6,1,9,6,0,Matches
1220,Boubacar Kamara,FRA,DF,Marseille,Ligue 1,18,1999,26.8,67,39,38,24,5,32,49,65.3,17,24,13,11,45,112,95,2,Matches
1221,Hassane Kamara,CIV,"DF,FW",Reims,Ligue 1,24,1994,10.3,29,21,22,5,2,16,19,84.2,3,6,1,5,14,43,41,0,Matches
1222,Marcin Kamiński,POL,DF,Düsseldorf,Bundesliga,26,1992,27.0,18,13,14,3,1,7,11,63.6,4,21,11,10,39,57,103,2,Matches
1223,Patrick Kammerbauer,GER,FW,Freiburg,Bundesliga,21,1997,0.0,0,0,0,0,0,0,0,,0,0,0,0,1,1,1,0,Matches
1224,Kevin Kampl,SVN,MF,RB Leipzig,Bundesliga,27,1990,23.5,41,24,16,21,4,8,28,28.6,20,32,2,30,33,74,22,0,Matches
1225,Harry Kane,ENG,FW,Tottenham,Premier League,25,1993,26.9,10,6,2,8,0,1,14,7.1,13,16,6,10,1,11,14,0,Matches
1226,Lee Kang-in,KOR,"MF,FW",Valencia,La Liga,17,2001,0.3,2,0,1,1,0,1,3,33.3,2,0,0,0,1,3,0,0,Matches
1227,Wilfried Kanga,CIV,FW,Angers,Ligue 1,20,1998,5.5,0,0,0,0,0,0,1,0.0,1,3,0,3,0,0,4,0,Matches
1228,N'Golo Kanté,FRA,MF,Chelsea,Premier League,27,1991,34.4,75,41,21,41,13,23,67,34.3,44,63,6,57,44,119,32,1,Matches
1229,Stefanos Kapino,GRE,GK,Werder Bremen,Bundesliga,24,1994,0.5,0,0,0,0,0,0,0,,0,0,0,0,0,0,0,0,Matches
1230,Wilfrid Kaptoum,CMR,MF,Betis,La Liga,22,1996,8.6,15,6,4,10,1,5,11,45.5,6,9,1,8,10,25,6,2,Matches
1231,Kenan Karaman,TUR,"FW,MF",Düsseldorf,Bundesliga,24,1994,10.2,13,9,3,10,0,7,12,58.3,5,5,1,4,2,15,8,0,Matches
1232,Yann Karamoh,FRA,"FW,MF",Inter,Serie A,20,1998,0.1,0,0,0,0,0,0,0,,0,0,0,0,0,0,0,0,Matches
1233,Yann Karamoh,FRA,FW,Bordeaux,Ligue 1,20,1998,13.6,7,3,1,4,2,1,13,7.7,12,9,0,9,6,13,3,0,Matches
1234,Ibrahim Karamoko,FRA,MF,Chievo,Serie A,17,2001,0.7,0,0,0,0,0,0,0,,0,1,0,1,0,0,1,0,Matches
1235,Orestis Karnezis,GRE,GK,Napoli,Serie A,33,1985,9.0,0,0,0,0,0,0,0,,0,0,0,0,0,0,3,0,Matches
1236,Rick Karsdorp,NED,DF,Roma,Serie A,23,1995,6.6,9,6,3,5,1,5,11,45.5,6,4,2,2,12,21,12,1,Matches
1237,Grigoris Kastanos,CYP,MF,Juventus,Serie A,20,1998,0.7,3,1,3,0,0,0,0,,0,3,1,2,0,3,0,0,Matches
1238,Eiji Kawashima,JPN,GK,Strasbourg,Ligue 1,35,1983,1.0,0,0,0,0,0,0,0,,0,0,0,0,0,0,0,0,Matches
1239,Beram Kayal,ISR,MF,Brighton,Premier League,30,1988,10.4,28,17,16,11,1,5,21,23.8,16,17,10,7,15,43,25,0,Matches
1240,Moise Kean,ITA,FW,Juventus,Serie A,18,2000,6.0,0,0,0,0,0,0,1,0.0,1,1,0,1,2,2,1,0,Matches
1241,Michael Keane,ENG,DF,Everton,Premier League,25,1993,33.0,41,25,22,16,3,19,32,59.4,13,30,22,8,43,84,185,4,Matches
1242,Neeskens Kebano,COD,"FW,MF",Fulham,Premier League,26,1992,1.2,3,1,2,1,0,1,1,100.0,0,3,0,3,0,3,3,0,Matches
1243,Thilo Kehrer,GER,DF,Paris S-G,Ligue 1,21,1996,21.1,64,43,27,31,6,31,55,56.4,24,32,17,15,31,95,69,1,Matches
1244,Jules Keita,GUI,"FW,MF",Dijon,Ligue 1,20,1998,5.1,10,4,0,3,7,5,12,41.7,7,2,0,2,2,12,1,0,Matches
1245,Naby Keïta,GUI,"MF,FW",Liverpool,Premier League,23,1995,15.4,37,15,13,19,5,14,42,33.3,28,29,4,25,12,49,16,1,Matches
1246,Keko,ESP,"MF,FW",Valladolid,La Liga,26,1991,17.0,42,18,21,15,6,18,50,36.0,32,20,1,19,14,56,17,0,Matches
1247,Martin Kelly,ENG,DF,Crystal Palace,Premier League,28,1990,12.3,21,13,18,2,1,14,19,73.7,5,18,12,6,11,32,88,1,Matches
1248,Marc-Oliver Kempf,GER,DF,Stuttgart,Bundesliga,23,1995,22.5,33,18,26,7,0,12,24,50.0,12,35,21,14,46,79,141,1,Matches
1249,Kenedy,BRA,"MF,DF",Newcastle Utd,Premier League,22,1996,15.0,30,22,11,16,3,12,29,41.4,17,10,0,10,32,62,24,1,Matches
1250,Jonjoe Kenny,ENG,DF,Everton,Premier League,21,1997,8.8,21,16,16,4,1,10,18,55.6,8,13,2,11,17,38,36,1,Matches
1251,Christophe Kerbrat,FRA,DF,Guingamp,Ligue 1,31,1986,23.3,40,24,28,12,0,24,38,63.2,14,19,10,9,50,90,140,5,Matches
1252,Sebastian Kerk,GER,"MF,FW",Nürnberg,Bundesliga,24,1994,13.1,16,9,8,5,3,7,23,30.4,16,14,5,9,3,19,22,1,Matches
1253,Franck Kessié,CIV,MF,Milan,Serie A,21,1996,33.5,42,27,16,20,6,18,38,47.4,20,35,10,25,27,69,53,2,Matches
1254,Saîf-Eddine Khaoui,TUN,"MF,FW",Caen,Ligue 1,23,1995,15.0,20,14,5,11,4,8,27,29.6,19,9,1,8,20,40,4,0,Matches
1255,Wahbi Khazri,TUN,"FW,MF",Saint-Étienne,Ligue 1,27,1991,31.3,41,26,8,14,19,17,49,34.7,32,27,2,25,11,52,5,0,Matches
1256,Rani Khedira,GER,"DF,MF",Augsburg,Bundesliga,24,1994,29.2,56,39,22,28,6,18,36,50.0,18,44,22,22,80,136,95,1,Matches
1257,Sami Khedira,GER,MF,Juventus,Serie A,31,1987,7.8,10,9,6,2,2,5,9,55.6,4,8,3,5,5,15,6,0,Matches
1258,Isaac Kiese Thelin,SWE,"FW,MF",Leverkusen,Bundesliga,26,1992,2.0,2,1,0,2,0,1,2,50.0,1,1,0,1,0,2,4,0,Matches
1259,Kiké,ESP,FW,Eibar,La Liga,28,1989,14.4,7,4,1,2,4,1,5,20.0,4,18,0,18,4,11,6,0,Matches
1260,Max Kilman,ENG,DF,Wolves,Premier League,21,1997,0.0,0,0,0,0,0,0,0,,0,0,0,0,0,0,0,0,Matches
1261,Joshua Kimmich,GER,"DF,MF",Bayern Munich,Bundesliga,23,1995,34.0,46,26,17,22,7,25,54,46.3,29,35,9,26,34,80,41,3,Matches
1262,Presnel Kimpembe,FRA,DF,Paris S-G,Ligue 1,22,1995,22.3,55,34,26,25,4,24,40,60.0,16,17,10,7,30,85,48,5,Matches
1263,Joshua King,NOR,"FW,MF",Bournemouth,Premier League,26,1992,32.9,30,19,7,19,4,8,29,27.6,21,28,4,24,7,37,14,0,Matches
1264,Sofian Kiyine,MAR,"MF,DF",Chievo,Serie A,20,1997,9.1,28,13,11,14,3,9,18,50.0,9,10,0,10,10,38,4,0,Matches
1265,Simon Kjær,DEN,DF,Sevilla,La Liga,29,1989,22.3,29,19,25,3,1,9,16,56.3,7,41,34,7,27,56,136,0,Matches
1266,Davy Klaassen,NED,MF,Werder Bremen,Bundesliga,25,1993,31.3,64,47,24,33,7,14,49,28.6,35,44,9,35,47,111,47,0,Matches
1267,Felix Klaus,GER,"FW,MF",Wolfsburg,Bundesliga,25,1992,4.9,10,7,4,5,1,2,7,28.6,5,5,0,5,4,14,0,0,Matches
1268,Ragnar Klavan,EST,DF,Cagliari,Serie A,32,1985,13.7,9,8,5,3,1,5,11,45.5,6,19,13,6,10,19,68,1,Matches
1269,Tim Kleindienst,GER,FW,Freiburg,Bundesliga,22,1995,2.2,4,3,1,2,1,1,3,33.3,2,3,0,3,0,4,7,0,Matches
1270,Lukas Klostermann,GER,DF,RB Leipzig,Bundesliga,22,1996,22.3,50,29,33,12,5,29,45,64.4,16,37,5,32,29,79,74,0,Matches
1271,Justin Kluivert,NED,FW,Roma,Serie A,19,1999,14.9,28,27,12,9,7,10,23,43.5,13,17,0,17,7,35,12,0,Matches
1272,Lukas Klünter,GER,DF,Hertha BSC,Bundesliga,22,1996,6.6,11,8,6,5,0,4,5,80.0,1,6,2,4,12,23,20,0,Matches
1273,Robin Knoche,GER,DF,Wolfsburg,Bundesliga,26,1992,31.0,26,20,19,6,1,16,29,55.2,13,46,29,17,44,70,138,2,Matches
1274,Anthony Knockaert,FRA,"MF,FW",Brighton,Premier League,26,1991,20.4,33,21,12,15,6,13,30,43.3,17,13,0,13,29,62,11,0,Matches
1275,Törles Knöll,GER,"FW,MF",Nürnberg,Bundesliga,20,1997,4.1,3,2,1,1,1,0,4,0.0,4,5,1,4,0,3,2,0,Matches
1276,Gregor Kobel,SUI,GK,Hoffenheim,Bundesliga,20,1997,1.0,0,0,0,0,0,0,0,,0,0,0,0,0,0,0,0,Matches
1277,Gregor Kobel,SUI,GK,Augsburg,Bundesliga,20,1997,15.4,1,1,1,0,0,1,1,100.0,0,0,0,0,2,3,5,3,Matches
1278,Robin Koch,GER,"MF,DF",Freiburg,Bundesliga,22,1996,21.1,25,14,17,7,1,7,24,29.2,17,31,18,13,32,57,77,4,Matches
1279,Kenan Kodro,BIH,"FW,MF",Athletic Club,La Liga,24,1993,1.8,3,1,1,1,1,1,3,33.3,2,1,0,1,0,3,0,0,Matches
1280,Dominik Kohr,GER,MF,Leverkusen,Bundesliga,24,1994,10.8,42,29,21,21,0,14,35,40.0,21,25,12,13,15,57,17,1,Matches
1281,Djégui Koita,FRA,DF,Guingamp,Ligue 1,18,1999,1.9,8,6,8,0,0,3,4,75.0,1,5,3,2,0,8,9,0,Matches
1282,Koke,ESP,MF,Atlético Madrid,La Liga,26,1992,28.7,84,46,41,32,11,34,86,39.5,52,25,5,20,31,115,37,1,Matches
1283,Aleksandar Kolarov,SRB,DF,Roma,Serie A,32,1985,32.3,38,26,22,10,6,21,34,61.8,13,23,15,8,41,79,82,2,Matches
1284,Sead Kolašinac,BIH,"DF,MF",Arsenal,Premier League,25,1993,21.0,34,21,21,7,6,20,34,58.8,14,12,3,9,20,54,28,3,Matches
1285,Randal Kolo Muani,FRA,FW,Nantes,Ligue 1,19,1998,1.4,2,0,1,1,0,0,1,0.0,1,2,0,2,0,2,2,0,Matches
1286,Timothée Kolodziejczak,FRA,DF,Saint-Étienne,Ligue 1,26,1991,35.4,34,22,21,10,3,20,45,44.4,25,25,11,14,53,87,118,2,Matches
1287,Vincent Kompany,BEL,DF,Manchester City,Premier League,32,1986,13.6,16,10,11,3,2,8,9,88.9,1,11,8,3,16,32,55,0,Matches
1288,Ghislain Konan,CIV,DF,Reims,Ligue 1,22,1995,20.0,45,28,31,10,4,24,40,60.0,16,18,4,14,40,85,55,1,Matches
1289,Ibrahima Konaté,FRA,DF,RB Leipzig,Bundesliga,19,1999,27.0,44,32,30,14,0,17,27,63.0,10,29,18,11,58,102,126,0,Matches
1290,Moussa Konaté,SEN,FW,Amiens,Ligue 1,25,1993,20.8,10,8,3,3,4,2,12,16.7,10,14,3,11,5,15,15,0,Matches
1291,Geoffrey Kondogbia,CTA,MF,Valencia,La Liga,25,1993,13.8,47,33,18,23,6,12,27,44.4,15,20,7,13,27,74,22,2,Matches
1292,Lamine Koné,CIV,DF,Strasbourg,Ligue 1,29,1989,23.9,21,16,9,9,3,6,9,66.7,3,18,13,5,33,54,66,3,Matches
1293,Manu Koné,FRA,MF,Toulouse,Ligue 1,17,2001,0.8,4,2,0,4,0,2,4,50.0,2,0,0,0,0,4,0,0,Matches
1294,Youssouf Koné,MLI,DF,Lille,Ligue 1,23,1995,19.0,67,38,45,19,3,41,65,63.1,24,31,3,28,39,106,52,1,Matches
1295,Terence Kongolo,NED,DF,Huddersfield,Premier League,24,1994,30.2,74,46,44,26,4,27,47,57.4,20,42,16,26,65,139,106,1,Matches
1296,Yevhen Konoplyanka,UKR,"FW,MF",Schalke 04,Bundesliga,28,1989,7.3,2,0,0,0,2,2,4,50.0,2,6,0,6,3,5,3,0,Matches
1297,Pascal Köpke,GER,"FW,MF",Hertha BSC,Bundesliga,22,1995,0.8,1,0,1,0,0,1,2,50.0,1,0,0,0,0,1,0,0,Matches
1298,Julian Korb,GER,DF,Hannover 96,Bundesliga,26,1992,11.2,26,17,16,9,1,10,29,34.5,19,27,4,23,23,49,34,1,Matches
1299,Laurent Koscielny,FRA,DF,Arsenal,Premier League,32,1985,14.8,19,11,9,9,1,10,16,62.5,6,20,15,5,30,49,72,0,Matches
1300,Filip Kostić,SRB,"DF,FW",Eint Frankfurt,Bundesliga,25,1992,32.8,64,42,35,22,7,23,65,35.4,42,80,6,74,23,87,50,0,Matches
1301,Christian Kouamé,CIV,FW,Genoa,Serie A,20,1997,34.1,31,22,8,16,7,2,13,15.4,11,23,3,20,25,56,28,0,Matches
1302,Tomáš Koubek,CZE,GK,Rennes,Ligue 1,25,1992,32.5,0,0,0,0,0,0,1,0.0,1,0,0,0,0,0,26,4,Matches
1303,Kalidou Koulibaly,SEN,DF,Napoli,Serie A,27,1991,34.8,61,40,37,22,2,19,36,52.8,17,55,33,22,40,101,144,0,Matches
1304,Jules Koundé,FRA,DF,Bordeaux,Ligue 1,19,1998,37.0,48,31,37,11,0,27,41,65.9,14,44,23,21,50,98,193,7,Matches
1305,Cheikhou Kouyaté,SEN,MF,Crystal Palace,Premier League,28,1989,21.1,59,33,23,31,5,9,33,27.3,24,29,11,18,16,75,33,0,Matches
1306,Mateo Kovačić,CRO,MF,Chelsea,Premier League,24,1994,19.3,45,29,23,19,3,20,46,43.5,26,19,2,17,8,53,18,1,Matches
1307,Dawid Kownacki,POL,FW,Sampdoria,Serie A,21,1997,1.9,2,1,0,1,1,1,4,25.0,3,0,0,0,0,2,0,0,Matches
1308,Dawid Kownacki,POL,"MF,FW",Düsseldorf,Bundesliga,21,1997,6.4,13,6,9,3,1,7,16,43.8,9,8,0,8,2,15,8,0,Matches
1309,Thomas Kraft,GER,GK,Hertha BSC,Bundesliga,30,1988,3.5,0,0,0,0,0,0,0,,0,0,0,0,0,0,1,1,Matches
1310,Emil Krafth,SWE,DF,Amiens,Ligue 1,23,1994,33.0,55,35,34,14,7,32,65,49.2,33,27,12,15,23,78,94,4,Matches
1311,Luka Krajnc,SVN,DF,Frosinone,Serie A,23,1994,8.8,10,8,6,3,1,5,6,83.3,1,11,3,8,11,21,42,0,Matches
1312,Andrej Kramarić,CRO,"MF,FW",Hoffenheim,Bundesliga,27,1991,26.6,9,4,1,5,3,4,26,15.4,22,15,3,12,8,17,13,0,Matches
1313,Christoph Kramer,GER,MF,Gladbach,Bundesliga,27,1991,12.6,41,22,17,23,1,15,40,37.5,25,19,4,15,21,62,23,0,Matches
1314,Vasyl Kravets,UKR,"DF,FW",Leganés,La Liga,20,1997,5.3,16,11,8,6,2,6,13,46.2,7,5,1,4,4,20,10,1,Matches
1315,Ladislav Krejčí,CZE,"DF,MF",Bologna,Serie A,26,1992,11.8,16,12,6,9,1,7,12,58.3,5,8,2,6,6,22,18,0,Matches
1316,Rene Krhin,SVN,MF,Nantes,Ligue 1,28,1990,11.7,22,14,7,12,3,11,19,57.9,8,7,4,3,21,43,32,0,Matches
1317,Toni Kroos,GER,MF,Real Madrid,La Liga,28,1990,24.7,51,35,18,24,9,14,57,24.6,43,25,4,21,14,65,13,1,Matches
1318,Rade Krunić,BIH,MF,Empoli,Serie A,24,1993,30.8,38,23,21,14,3,14,41,34.1,27,35,12,23,24,62,32,0,Matches
1319,Max Kruse,GER,"FW,MF",Werder Bremen,Bundesliga,30,1988,31.5,17,5,2,13,2,6,38,15.8,32,16,1,15,8,25,6,2,Matches
1320,Lukas Kübler,GER,"DF,MF",Freiburg,Bundesliga,25,1992,13.2,35,22,23,12,0,16,26,61.5,10,15,5,10,30,65,50,1,Matches
1321,Yuya Kubo,JPN,"FW,MF",Nürnberg,Bundesliga,24,1993,15.1,21,11,6,10,5,12,33,36.4,21,11,0,11,10,31,6,0,Matches
1322,Juraj Kucka,SVK,MF,Parma,Serie A,31,1987,17.1,51,32,17,29,5,19,53,35.8,34,27,7,20,17,68,37,1,Matches
1323,Dejan Kulusevski,SWE,MF,Atalanta,Serie A,18,2000,1.2,3,3,0,2,1,1,3,33.3,2,1,0,1,0,3,0,0,Matches
1324,Pierre Kunde,CMR,MF,Mainz 05,Bundesliga,23,1995,21.2,48,29,20,26,2,16,27,59.3,11,34,14,20,24,72,49,1,Matches
1325,Jasmin Kurtić,SVN,MF,SPAL,Serie A,29,1989,28.4,35,20,19,13,3,13,41,31.7,28,30,3,27,20,55,52,0,Matches
1326,Layvin Kurzawa,FRA,"DF,MF",Paris S-G,Ligue 1,25,1992,11.2,19,11,6,5,8,6,16,37.5,10,10,2,8,10,29,16,0,Matches
1327,Rafał Kurzawa,POL,FW,Amiens,Ligue 1,25,1993,2.7,8,3,6,2,0,2,6,33.3,4,1,0,1,3,11,3,0,Matches
1328,Ahmed Kutucu,TUR,"FW,MF",Schalke 04,Bundesliga,18,2000,4.7,8,3,3,4,1,1,3,33.3,2,2,1,1,0,8,0,0,Matches
1329,Enock Kwateng,FRA,DF,Nantes,Ligue 1,21,1997,22.7,65,41,34,27,4,33,70,47.1,37,28,4,24,78,143,56,0,Matches
1330,Grejohn Kyei,FRA,FW,Reims,Ligue 1,22,1995,0.0,0,0,0,0,0,0,1,0.0,1,0,0,0,0,0,0,0,Matches
1331,Antonino La Gumina,ITA,"FW,MF",Empoli,Serie A,22,1996,12.1,5,4,1,2,2,2,6,33.3,4,8,2,6,6,11,5,0,Matches
1332,Rajiv van La Parra,NED,"FW,MF",Huddersfield,Premier League,27,1991,4.5,8,5,1,7,0,1,6,16.7,5,0,0,0,4,12,3,1,Matches
1333,Gaëtan Laborde,FRA,FW,Bordeaux,Ligue 1,24,1994,1.0,4,3,0,1,3,2,4,50.0,2,0,0,0,0,4,0,0,Matches
1334,Gaëtan Laborde,FRA,"FW,MF",Montpellier,Ligue 1,24,1994,32.2,36,15,6,15,15,11,27,40.7,16,18,2,16,6,42,27,0,Matches
1335,Alexandre Lacazette,FRA,FW,Arsenal,Premier League,27,1991,27.8,35,16,6,19,10,5,28,17.9,23,27,1,26,15,50,31,0,Matches
1336,Alban Lafont,FRA,GK,Fiorentina,Serie A,19,1999,33.5,0,0,0,0,0,0,0,,0,0,0,0,1,1,16,4,Matches
1337,Víctor Laguardia,ESP,DF,Alavés,La Liga,28,1989,36.0,47,34,37,10,0,24,33,72.7,9,42,19,23,53,100,232,0,Matches
1338,Abdou Lahat Diakhate,SEN,MF,Parma,Serie A,19,1998,0.0,0,0,0,0,0,0,0,,0,0,0,0,0,0,0,0,Matches
1339,Konrad Laimer,AUT,"MF,DF",RB Leipzig,Bundesliga,21,1997,20.8,72,38,21,34,17,20,71,28.2,51,67,2,65,32,104,23,0,Matches
1340,Diego Lainez,MEX,"FW,MF",Betis,La Liga,18,2000,3.9,4,4,0,3,1,1,1,100.0,0,2,0,2,1,5,2,0,Matches
1341,Kenny Lala,MAD,"DF,FW",Strasbourg,Ligue 1,26,1991,34.0,78,45,48,23,7,30,53,56.6,23,26,9,17,28,106,62,2,Matches
1342,Adam Lallana,ENG,"MF,FW",Liverpool,Premier League,30,1988,5.2,16,9,6,7,3,5,12,41.7,7,10,1,9,5,21,4,0,Matches
1343,Érik Lamela,ARG,"MF,FW",Tottenham,Premier League,26,1992,10.8,17,13,6,7,4,5,14,35.7,9,14,0,14,7,24,1,0,Matches
1344,Mohamed Lamine Diaby,FRA,FW,Nice,Ligue 1,17,2001,1.8,1,1,0,1,0,1,1,100.0,0,2,0,2,2,3,0,0,Matches
1345,Loïck Landre,FRA,DF,Nîmes,Ligue 1,26,1992,17.7,31,21,23,8,0,14,22,63.6,8,16,11,5,38,69,83,1,Matches
1346,Michael Lang,SUI,DF,Gladbach,Bundesliga,27,1991,13.9,14,9,7,6,1,6,16,37.5,10,14,3,11,16,30,42,1,Matches
1347,Sebastian Langkamp,GER,DF,Werder Bremen,Bundesliga,30,1988,15.7,24,15,18,6,0,7,14,50.0,7,17,11,6,20,44,79,1,Matches
1348,Manuel Lanzini,ARG,MF,West Ham,Premier League,25,1993,7.6,12,7,5,6,1,5,18,27.8,13,3,1,2,9,21,7,1,Matches
1349,Gianluca Lapadula,PER,FW,Genoa,Serie A,28,1990,4.5,2,1,2,0,0,1,5,20.0,4,2,0,2,1,3,2,0,Matches
1350,Aymeric Laporte,ESP,DF,Manchester City,Premier League,24,1994,34.0,42,20,27,14,1,22,34,64.7,12,16,9,7,39,81,98,2,Matches
1351,Danilo Larangeira,BRA,DF,Bologna,Serie A,34,1984,34.2,40,26,29,11,0,20,30,66.7,10,52,39,13,37,77,182,3,Matches
1352,Johan Larsson,SWE,DF,Guingamp,Ligue 1,28,1990,1.0,1,1,0,1,0,1,2,50.0,1,0,0,0,1,2,1,1,Matches
1353,Kevin Lasagna,ITA,FW,Udinese,Serie A,25,1992,27.3,6,1,0,3,3,2,12,16.7,10,20,2,18,8,14,35,0,Matches
1354,Jamaal Lascelles,ENG,DF,Newcastle Utd,Premier League,24,1993,30.5,32,21,25,5,2,11,14,78.6,3,43,28,15,39,71,218,3,Matches
1355,Paul Lasne,FRA,"MF,DF",Montpellier,Ligue 1,29,1989,19.9,53,33,32,16,5,24,43,55.8,19,22,2,20,22,75,23,1,Matches
1356,Toni Lato,ESP,DF,Valencia,La Liga,20,1997,3.0,6,4,4,1,1,1,5,20.0,4,9,3,6,6,12,13,0,Matches
1357,Danny Latza,GER,MF,Mainz 05,Bundesliga,28,1989,20.7,41,22,16,23,2,20,61,32.8,41,49,10,39,20,61,31,0,Matches
1358,Alexandre Lauray,FRA,DF,Bordeaux,Ligue 1,21,1997,2.9,11,6,9,2,0,6,8,75.0,2,2,0,2,4,15,10,0,Matches
1359,Armand Lauriente,FRA,MF,Rennes,Ligue 1,19,1998,0.0,0,0,0,0,0,0,0,,0,0,0,0,0,0,0,0,Matches
1360,Vincent Laurini,FRA,DF,Fiorentina,Serie A,29,1989,10.2,13,5,6,5,2,6,10,60.0,4,11,5,6,13,26,30,0,Matches
1361,Wesley Lautoa,NCL,"DF,MF",Dijon,Ligue 1,30,1987,33.6,81,55,46,31,4,34,75,45.3,41,37,14,23,87,168,110,1,Matches
1362,Diego Laxalt,URU,"DF,MF",Milan,Serie A,25,1993,7.2,26,13,14,7,5,13,22,59.1,9,23,3,20,8,34,12,0,Matches
1363,Miguel Layún,MEX,"MF,DF",Villarreal,La Liga,30,1988,5.6,8,2,0,7,1,2,6,33.3,4,8,2,6,1,9,10,0,Matches
1364,Valentino Lazaro,AUT,"DF,FW",Hertha BSC,Bundesliga,22,1996,30.5,46,31,23,17,6,21,53,39.6,32,52,12,40,44,90,65,0,Matches
1365,Darko Lazović,SRB,"DF,FW",Genoa,Serie A,27,1990,28.2,28,17,13,8,7,14,31,45.2,17,21,6,15,20,48,33,0,Matches
1366,Manuel Lazzari,ITA,DF,SPAL,Serie A,24,1993,31.5,29,17,16,10,3,13,24,54.2,11,26,5,21,20,49,51,1,Matches
1367,Mickaël Le Bihan,FRA,FW,Nice,Ligue 1,28,1990,2.3,1,1,0,1,0,1,2,50.0,1,1,0,1,1,2,1,0,Matches
1368,Maxime Le Marchand,FRA,DF,Fulham,Premier League,28,1989,25.0,56,36,45,11,0,23,47,48.9,24,30,16,14,54,110,129,2,Matches
1369,Robin Le Normand,ESP,DF,Real Sociedad,La Liga,21,1996,3.2,5,2,2,3,0,1,3,33.3,2,3,0,3,4,9,13,1,Matches
1370,Damien Le Tallec,FRA,MF,Montpellier,Ligue 1,28,1990,31.2,95,58,42,43,10,33,89,37.1,56,35,8,27,59,154,50,0,Matches
1371,James Lea Siliki,CMR,"MF,FW",Rennes,Ligue 1,22,1996,13.6,26,17,13,10,3,12,35,34.3,23,14,1,13,10,36,7,1,Matches
1372,Rafael Leão,POR,FW,Lille,Ligue 1,19,1999,14.3,5,2,0,4,1,2,15,13.3,13,13,4,9,4,9,12,0,Matches
1373,Mathew Leckie,AUS,"FW,MF",Hertha BSC,Bundesliga,27,1991,10.5,20,13,5,10,5,7,16,43.8,9,10,1,9,13,33,16,0,Matches
1374,Benjamin Lecomte,FRA,GK,Montpellier,Ligue 1,27,1991,37.0,1,0,1,0,0,1,3,33.3,2,0,0,0,5,6,24,3,Matches
1375,Pierre Lees-Melou,FRA,MF,Nice,Ligue 1,25,1993,26.6,74,46,31,36,7,25,62,40.3,37,44,8,36,36,110,37,0,Matches
1376,Jordan Lefort,FRA,DF,Amiens,Ligue 1,24,1993,20.0,33,18,23,6,4,16,25,64.0,9,11,8,3,46,79,107,0,Matches
1377,Wu Lei,CHN,"FW,MF",Espanyol,La Liga,26,1991,11.8,13,6,5,6,2,5,16,31.3,11,9,0,9,7,20,7,0,Matches
1378,Tim Leibold,GER,DF,Nürnberg,Bundesliga,24,1993,30.7,62,42,45,16,1,33,71,46.5,38,23,3,20,38,100,57,0,Matches
1379,Lucas Leiva,BRA,MF,Lazio,Serie A,31,1987,22.1,91,54,40,46,5,38,79,48.1,41,27,11,16,52,143,43,3,Matches
1380,Florian Lejeune,FRA,DF,Newcastle Utd,Premier League,27,1991,11.7,25,15,17,7,1,11,24,45.8,13,16,5,11,21,46,49,0,Matches
1381,Iñigo Lekue,ESP,DF,Athletic Club,La Liga,25,1993,2.3,5,2,3,2,0,2,7,28.6,5,4,0,4,4,9,11,0,Matches
1382,Thomas Lemar,FRA,MF,Atlético Madrid,La Liga,22,1995,20.2,38,21,23,11,4,19,42,45.2,23,26,1,25,22,60,7,1,Matches
1383,Mario Lemina,GAB,MF,Southampton,Premier League,24,1993,17.9,49,32,23,23,3,15,34,44.1,19,27,3,24,43,92,31,1,Matches
1384,Mauricio Lemos,URU,DF,Sassuolo,Serie A,22,1995,2.0,2,1,2,0,0,1,2,50.0,1,2,1,1,3,5,10,1,Matches
1385,Clément Lenglet,FRA,DF,Barcelona,La Liga,23,1995,21.5,47,29,26,19,2,22,36,61.1,14,30,20,10,21,68,70,0,Matches
1386,Aaron Lennon,ENG,MF,Burnley,Premier League,31,1987,13.5,26,16,11,12,3,6,14,42.9,8,24,0,24,10,36,18,0,Matches
1387,Bernd Leno,GER,GK,Arsenal,Premier League,26,1992,31.5,0,0,0,0,0,0,3,0.0,3,0,0,0,4,4,16,6,Matches
1388,Pedro León,ESP,"MF,FW",Eibar,La Liga,31,1986,4.7,7,4,2,2,3,4,7,57.1,3,10,0,10,4,11,2,0,Matches
1389,Sergio León,ESP,"FW,MF",Betis,La Liga,29,1989,7.1,4,2,2,1,1,2,8,25.0,6,4,0,4,2,6,6,0,Matches
1390,Lukas Lerager,DEN,MF,Genoa,Serie A,25,1993,12.5,34,18,12,20,2,13,42,31.0,29,11,1,10,18,52,12,0,Matches
1391,Lukas Lerager,DEN,MF,Bordeaux,Ligue 1,25,1993,14.4,38,21,14,23,1,18,43,41.9,25,22,10,12,32,70,26,1,Matches
1392,Mehdi Léris,ALG,"MF,DF",Chievo,Serie A,20,1998,17.9,53,33,19,24,10,24,54,44.4,30,34,1,33,28,81,24,1,Matches
1393,Jefferson Lerma,COL,MF,Bournemouth,Premier League,23,1994,27.8,45,31,20,20,5,14,54,25.9,40,35,19,16,54,99,88,1,Matches
1394,Robert Lewandowski,POL,FW,Bayern Munich,Bundesliga,29,1988,32.9,12,9,0,8,4,3,11,27.3,8,11,1,10,7,19,15,0,Matches
1395,Igor Lewczuk,POL,DF,Bordeaux,Ligue 1,33,1985,5.0,12,7,8,2,2,1,4,25.0,3,2,2,0,4,16,27,0,Matches
1396,Aaron Leya Iseka,BEL,FW,Toulouse,Ligue 1,20,1997,16.0,6,4,1,4,1,1,4,25.0,3,5,3,2,1,7,10,0,Matches
1397,Stephan Lichtsteiner,SUI,DF,Arsenal,Premier League,34,1984,10.4,15,9,5,4,6,9,16,56.3,7,11,4,7,9,24,25,1,Matches
1398,Dimitri Liénard,FRA,"MF,DF",Strasbourg,Ligue 1,30,1988,14.3,33,18,20,9,4,21,45,46.7,24,11,2,9,18,51,22,0,Matches
1399,Philipp Lienhart,AUT,DF,Freiburg,Bundesliga,22,1996,6.8,6,6,4,2,0,3,6,50.0,3,9,7,2,11,17,42,0,Matches
1400,Lucas Lima,BRA,"DF,FW",Nantes,Ligue 1,26,1991,27.7,49,28,26,15,8,20,53,37.7,33,39,3,36,29,78,62,1,Matches
1401,Anthony Limbombe,BEL,FW,Nantes,Ligue 1,24,1994,13.7,12,10,4,6,2,7,16,43.8,9,5,0,5,8,20,10,0,Matches
1402,Victor Lindelöf,SWE,DF,Manchester Utd,Premier League,24,1994,28.9,40,27,28,12,0,13,23,56.5,10,21,12,9,24,64,121,3,Matches
1403,Karol Linetty,POL,MF,Sampdoria,Serie A,23,1995,27.9,72,48,26,32,14,15,69,21.7,54,39,4,35,25,97,17,0,Matches
1404,Jesse Lingard,ENG,"FW,MF",Manchester Utd,Premier League,25,1992,18.5,29,18,8,11,10,7,28,25.0,21,18,2,16,10,39,9,1,Matches
1405,Pol Lirola,ESP,"DF,MF",Sassuolo,Serie A,20,1997,33.1,35,22,19,11,5,21,34,61.8,13,25,5,20,32,67,89,0,Matches
1406,Adem Ljajić,SRB,MF,Torino,Serie A,26,1991,0.3,0,0,0,0,0,0,1,0.0,1,0,0,0,0,0,0,0,Matches
1407,Diego Llorente,ESP,DF,Real Sociedad,La Liga,24,1993,19.5,26,15,16,8,2,17,29,58.6,12,27,15,12,26,52,83,2,Matches
1408,Fernando Llorente,ESP,FW,Tottenham,Premier League,33,1985,7.7,4,2,3,0,1,2,3,66.7,1,7,2,5,1,5,10,0,Matches
1409,Marcos Llorente,ESP,MF,Real Madrid,La Liga,23,1995,6.0,16,12,7,7,2,8,18,44.4,10,8,0,8,7,23,12,0,Matches
1410,Hugo Lloris,FRA,GK,Tottenham,Premier League,31,1986,33.0,1,0,1,0,0,0,2,0.0,2,0,0,0,0,1,13,5,Matches
1411,Giovani Lo Celso,ARG,"MF,FW",Betis,La Liga,22,1996,26.6,52,31,16,28,8,9,35,25.7,26,24,1,23,17,69,8,0,Matches
1412,Giovani Lo Celso,ARG,MF,Paris S-G,Ligue 1,22,1996,0.1,1,1,0,0,1,0,1,0.0,1,0,0,0,0,1,0,0,Matches
1413,Stanislav Lobotka,SVK,MF,Celta Vigo,La Liga,23,1994,27.7,30,19,10,17,3,9,32,28.1,23,15,1,14,26,56,18,1,Matches
1414,Jürgen Locadia,CUW,"FW,MF",Brighton,Premier League,24,1993,13.7,15,10,5,8,2,3,7,42.9,4,8,0,8,9,24,13,0,Matches
1415,Manuel Locatelli,ITA,MF,Sassuolo,Serie A,20,1998,20.5,44,28,19,15,10,13,29,44.8,16,21,3,18,27,71,33,1,Matches
1416,Ruben Loftus-Cheek,ENG,"MF,FW",Chelsea,Premier League,22,1996,11.1,18,12,7,7,4,3,12,25.0,9,10,4,6,11,29,5,0,Matches
1417,Enzo Loiodice,FRA,MF,Dijon,Ligue 1,17,2000,9.4,25,14,8,15,2,10,21,47.6,11,7,0,7,11,36,7,0,Matches
1418,Kevin Long,IRL,DF,Burnley,Premier League,27,1990,5.7,18,10,13,5,0,7,17,41.2,10,7,5,2,7,25,35,1,Matches
1419,Shane Long,IRL,"FW,MF",Southampton,Premier League,31,1987,14.1,15,8,4,5,6,3,16,18.8,13,10,1,9,7,22,18,0,Matches
1420,Samuele Longo,ITA,FW,Huesca,La Liga,26,1992,6.2,4,3,2,2,0,0,6,0.0,6,4,0,4,1,5,7,0,Matches
1421,Sean Longstaff,ENG,MF,Newcastle Utd,Premier League,20,1997,7.6,17,13,6,11,0,9,24,37.5,15,19,4,15,10,27,7,0,Matches
1422,Ademola Lookman,NGA,"FW,MF",Everton,Premier League,20,1997,6.9,15,7,7,5,3,4,6,66.7,2,10,0,10,7,22,2,0,Matches
1423,Anthony Lopes,POR,GK,Lyon,Ligue 1,27,1990,34.0,1,0,1,0,0,1,3,33.3,2,3,0,3,2,3,16,3,Matches
1424,Rony Lopes,POR,"FW,MF",Monaco,Ligue 1,22,1995,20.5,33,22,10,17,6,9,22,40.9,13,17,1,16,8,41,10,0,Matches
1425,Álex López,ESP,MF,Espanyol,La Liga,21,1997,1.2,3,1,1,2,0,2,3,66.7,1,0,0,0,3,6,1,0,Matches
1426,Cristian López,ESP,FW,Angers,Ligue 1,29,1989,4.1,6,3,1,2,3,1,8,12.5,7,4,0,4,1,7,2,0,Matches
1427,David López,ESP,DF,Espanyol,La Liga,28,1989,20.2,27,18,15,10,2,10,22,45.5,12,18,12,6,28,55,65,2,Matches
1428,Diego López,ESP,GK,Espanyol,La Liga,36,1981,38.0,0,0,0,0,0,0,0,,0,0,0,0,2,2,9,3,Matches
1429,Javi López,ESP,DF,Espanyol,La Liga,32,1986,21.6,63,40,37,22,4,28,60,46.7,32,27,5,22,40,103,90,0,Matches
1430,Lluis López,ESP,DF,Espanyol,La Liga,21,1997,5.8,5,3,4,1,0,3,6,50.0,3,6,2,4,7,12,21,0,Matches
1431,Maxime Lopez,FRA,MF,Marseille,Ligue 1,20,1997,24.2,46,24,17,23,6,19,53,35.8,34,10,2,8,20,66,8,0,Matches
1432,Pedro López Muñoz,ESP,DF,Levante,La Liga,34,1983,5.2,5,3,5,0,0,3,7,42.9,4,8,3,5,8,13,7,0,Matches
1433,Pau López,ESP,GK,Betis,La Liga,23,1994,33.0,0,0,0,0,0,0,2,0.0,2,1,0,1,2,2,17,2,Matches
1434,Roberto López,ESP,MF,Real Sociedad,La Liga,18,2000,0.3,0,0,0,0,0,0,1,0.0,1,1,0,1,1,1,2,0,Matches
1435,Unai López,ESP,MF,Athletic Club,La Liga,22,1995,3.6,7,5,3,2,2,2,12,16.7,10,10,3,7,1,8,2,0,Matches
1436,Jonas Lössl,DEN,GK,Huddersfield,Premier League,29,1989,30.9,0,0,0,0,0,0,1,0.0,1,1,0,1,2,2,12,2,Matches
1437,Albert Lottin,FRA,"MF,FW",Bordeaux,Ligue 1,16,2001,0.2,1,1,0,1,0,0,1,0.0,1,1,0,1,0,1,0,0,Matches
1438,Imran Louza,MAR,MF,Nantes,Ligue 1,19,1999,1.0,2,0,1,1,0,1,1,100.0,0,1,0,1,0,2,1,0,Matches
1439,Davor Lovren,CRO,MF,Düsseldorf,Bundesliga,19,1998,0.5,1,1,0,0,1,0,0,,0,1,0,1,0,1,0,0,Matches
1440,Dejan Lovren,CRO,DF,Liverpool,Premier League,29,1989,11.0,15,9,10,5,0,7,15,46.7,8,11,7,4,11,26,51,2,Matches
1441,Chris Löwe,GER,"DF,MF",Huddersfield,Premier League,29,1989,22.9,34,18,17,15,2,12,33,36.4,21,21,3,18,23,57,56,0,Matches
1442,Eduard Löwen,GER,"MF,FW",Nürnberg,Bundesliga,21,1997,18.0,30,22,14,13,3,11,34,32.4,23,15,2,13,8,38,23,0,Matches
1443,Matthew Lowton,ENG,DF,Burnley,Premier League,29,1989,19.4,56,35,21,31,4,32,60,53.3,28,29,7,22,30,86,80,1,Matches
1444,Anthony Lozano,HON,"FW,MF",Girona,La Liga,25,1993,8.1,6,5,3,3,0,0,6,0.0,6,7,1,6,0,6,6,0,Matches
1445,Derrick Luckassen,NED,DF,Hertha BSC,Bundesliga,23,1995,2.8,4,2,4,0,0,1,3,33.3,2,1,0,1,0,4,13,0,Matches
1446,Filipe Luís,BRA,DF,Atlético Madrid,La Liga,32,1985,22.6,66,36,33,25,8,32,58,55.2,26,18,3,15,44,110,47,0,Matches
1447,José Luis Gayà,ESP,DF,Valencia,La Liga,23,1995,34.9,83,59,56,20,7,46,80,57.5,34,48,6,42,43,126,105,1,Matches
1448,José Luis Morales,ESP,"FW,MF",Levante,La Liga,31,1987,35.5,21,15,6,10,5,8,49,16.3,41,22,1,21,12,33,17,0,Matches
1449,José Luis Palomino,ARG,DF,Atalanta,Serie A,28,1990,25.1,49,31,31,15,3,23,38,60.5,15,34,17,17,68,117,79,0,Matches
1450,Luisinho,POR,DF,Huesca,La Liga,33,1985,5.6,14,10,9,5,0,10,17,58.8,7,6,1,5,16,30,17,0,Matches
1451,David Luiz,BRA,DF,Chelsea,Premier League,31,1987,36.0,41,31,27,13,1,21,28,75.0,7,33,18,15,35,76,149,1,Matches
1452,Douglas Luiz,BRA,MF,Girona,La Liga,20,1998,16.6,34,19,13,20,1,9,38,23.7,29,19,7,12,21,55,26,0,Matches
1453,Everton Luiz,BRA,MF,SPAL,Serie A,30,1988,3.5,11,6,5,5,1,4,7,57.1,3,9,1,8,3,14,7,2,Matches
1454,Jordan Lukaku,BEL,"DF,MF",Lazio,Serie A,24,1994,1.9,4,3,2,1,1,3,5,60.0,2,3,0,3,5,9,2,0,Matches
1455,Romelu Lukaku,BEL,FW,Manchester Utd,Premier League,25,1993,23.7,8,4,0,6,2,2,10,20.0,8,12,1,11,2,10,19,0,Matches
1456,Dodi Lukebakio,BEL,"FW,MF",Düsseldorf,Bundesliga,20,1997,21.9,25,17,11,6,8,8,15,53.3,7,13,0,13,9,34,19,0,Matches
1457,Saša Lukić,SRB,MF,Torino,Serie A,21,1996,11.0,21,11,5,11,5,5,16,31.3,11,13,4,9,12,33,11,0,Matches
1458,Senad Lulić,BIH,"DF,FW",Lazio,Serie A,32,1986,32.5,71,43,37,27,7,32,76,42.1,44,27,3,24,49,120,58,1,Matches
1459,Antonio Luna,ESP,"DF,FW",Levante,La Liga,27,1991,14.0,14,10,6,7,1,6,23,26.1,17,22,7,15,15,29,48,1,Matches
1460,Andriy Lunin,UKR,GK,Leganés,La Liga,19,1999,4.1,0,0,0,0,0,0,0,,0,0,0,0,0,0,0,0,Matches
1461,Sebastiano Luperto,ITA,DF,Napoli,Serie A,21,1996,8.1,8,6,5,2,1,2,5,40.0,3,7,3,4,13,21,30,0,Matches
1462,Fabian Lustenberger,SUI,"DF,MF",Hertha BSC,Bundesliga,30,1988,24.1,45,30,23,21,1,15,33,45.5,18,39,18,21,39,84,108,2,Matches
1463,Andreas Luthe,GER,GK,Augsburg,Bundesliga,31,1987,14.6,0,0,0,0,0,0,0,,0,0,0,0,0,0,4,0,Matches
1464,Lyanco,BRA,DF,Torino,Serie A,21,1997,1.0,1,1,1,0,0,0,0,,0,1,1,0,4,5,5,0,Matches
1465,Lyanco,BRA,DF,Bologna,Serie A,21,1997,12.4,29,18,19,10,0,13,18,72.2,5,24,16,8,22,51,64,0,Matches
1466,Hervé Lybohy,NIG,DF,Nîmes,Ligue 1,35,1983,16.4,22,13,13,9,0,11,16,68.8,5,17,11,6,14,36,70,0,Matches
1467,Charalambos Lykogiannis,GRE,DF,Cagliari,Serie A,24,1993,9.2,14,8,8,3,3,6,11,54.5,5,18,3,15,19,33,33,0,Matches
1468,Yann M'Vila,FRA,MF,Saint-Étienne,Ligue 1,28,1990,36.2,72,40,22,48,2,29,72,40.3,43,42,12,30,74,146,86,5,Matches
1469,Darwin Machís,VEN,"FW,MF",Udinese,Serie A,25,1993,5.1,7,6,4,3,0,0,4,0.0,4,6,0,6,2,9,8,0,Matches
1470,James Maddison,ENG,"MF,FW",Leicester City,Premier League,21,1996,31.5,48,32,20,25,3,14,58,24.1,44,20,4,16,12,60,10,1,Matches
1471,Gary Madine,ENG,"FW,MF",Cardiff City,Premier League,27,1990,0.4,1,1,0,1,0,0,0,,0,0,0,0,0,1,0,0,Matches
1472,Pablo Maffeo,ESP,"DF,MF",Stuttgart,Bundesliga,21,1997,6.6,15,13,10,5,0,6,13,46.2,7,8,4,4,13,28,17,0,Matches
1473,Gabriel Magalhães,BRA,DF,Lille,Ligue 1,20,1997,11.8,18,11,13,4,1,4,7,57.1,3,14,6,8,19,37,60,2,Matches
1474,Francesco Magnanelli,ITA,MF,Sassuolo,Serie A,33,1984,20.7,52,33,29,22,1,22,49,44.9,27,18,5,13,24,76,38,2,Matches
1475,Giangiacomo Magnani,ITA,DF,Sassuolo,Serie A,22,1995,16.8,11,9,9,2,0,6,15,40.0,9,17,13,4,16,27,99,1,Matches
1476,Harry Maguire,ENG,DF,Leicester City,Premier League,25,1993,28.8,31,17,21,9,1,11,17,64.7,6,32,18,14,36,67,155,4,Matches
1477,Riyad Mahrez,ALG,"FW,MF",Manchester City,Premier League,27,1991,14.9,14,7,3,7,4,6,18,33.3,12,18,1,17,9,23,3,1,Matches
1478,Thiago Maia,BRA,MF,Lille,Ligue 1,21,1997,11.3,32,19,17,13,2,13,33,39.4,20,14,5,9,23,55,23,0,Matches
1479,Raffaele Maiello,ITA,MF,Frosinone,Serie A,27,1991,22.7,42,27,30,8,4,16,27,59.3,11,23,10,13,30,72,41,0,Matches
1480,Arne Maier,GER,MF,Hertha BSC,Bundesliga,19,1999,22.9,31,16,12,19,0,6,25,24.0,19,32,9,23,28,59,35,0,Matches
1481,Domenico Maietta,ITA,DF,Empoli,Serie A,35,1982,19.0,33,15,22,10,1,16,36,44.4,20,19,14,5,24,57,78,2,Matches
1482,Mike Maignan,FRA,GK,Lille,Ligue 1,23,1995,38.0,0,0,0,0,0,0,0,,0,1,0,1,0,0,12,1,Matches
1483,Linton Maina,GER,"FW,MF",Hannover 96,Bundesliga,19,1999,15.7,28,14,13,10,5,12,23,52.2,11,20,0,20,14,42,4,0,Matches
1484,Ainsley Maitland-Niles,ENG,DF,Arsenal,Premier League,20,1997,11.0,33,22,19,12,2,14,28,50.0,14,22,4,18,19,52,15,2,Matches
1485,Josh Maja,NGA,FW,Bordeaux,Ligue 1,19,1998,2.2,2,1,1,1,0,0,1,0.0,1,1,0,1,0,2,0,0,Matches
1486,Abdul Majeed Waris,GHA,"FW,MF",Nantes,Ligue 1,26,1991,25.0,22,13,6,13,3,7,28,25.0,21,9,0,9,7,29,7,0,Matches
1487,Jean-Victor Makengo,FRA,"MF,FW",Nice,Ligue 1,20,1998,11.4,10,8,3,6,1,1,5,20.0,4,5,1,4,9,19,5,0,Matches
1488,Nemanja Maksimović,SRB,MF,Getafe,La Liga,23,1995,35.7,77,45,21,51,5,21,61,34.4,40,60,15,45,71,148,33,0,Matches
1489,Nikola Maksimović,SRB,DF,Napoli,Serie A,26,1991,15.3,20,13,14,6,0,6,12,50.0,6,16,10,6,28,48,56,1,Matches
1490,Malcom,BRA,"FW,MF",Barcelona,La Liga,21,1997,6.8,3,2,0,1,2,2,3,66.7,1,7,0,7,1,4,1,0,Matches
1491,Kévin Malcuit,MAR,DF,Napoli,Serie A,27,1991,20.1,43,31,23,14,6,23,36,63.9,13,18,4,14,44,87,67,0,Matches
1492,Yunus Mallı,TUR,"MF,FW",Wolfsburg,Bundesliga,26,1992,7.8,15,7,8,6,1,2,11,18.2,9,2,0,2,4,19,1,0,Matches
1493,Hugo Mallo,ESP,DF,Celta Vigo,La Liga,27,1991,34.4,73,41,41,27,5,27,52,51.9,25,44,13,31,50,123,135,1,Matches
1494,Antonio Mance,CRO,FW,Nantes,Ligue 1,22,1995,0.6,1,1,0,0,1,1,2,50.0,1,0,0,0,0,1,0,0,Matches
1495,Vincent Manceau,FRA,DF,Angers,Ligue 1,29,1989,31.0,98,65,64,23,11,33,62,53.2,29,41,10,31,44,142,87,0,Matches
1496,Gianluca Mancini,ITA,DF,Atalanta,Serie A,22,1996,25.0,40,30,22,17,1,16,29,55.2,13,19,4,15,48,88,77,1,Matches
1497,Steve Mandanda,FRA,GK,Marseille,Ligue 1,33,1985,30.4,0,0,0,0,0,0,3,0.0,3,0,0,0,1,1,7,4,Matches
1498,Reinildo Mandava,MOZ,DF,Lille,Ligue 1,24,1994,1.1,3,2,1,2,0,2,3,66.7,1,1,0,1,1,4,0,0,Matches
1499,Aïssa Mandi,ALG,DF,Betis,La Liga,26,1991,34.0,52,34,27,20,5,12,29,41.4,17,39,23,16,41,93,71,2,Matches
1500,Rolando Mandragora,ITA,MF,Udinese,Serie A,21,1997,32.4,66,35,25,34,7,24,69,34.8,45,49,9,40,43,109,59,0,Matches
1501,Mario Mandžukić,CRO,FW,Juventus,Serie A,32,1986,22.4,34,25,13,15,6,9,18,50.0,9,17,5,12,13,47,22,0,Matches
1502,Sadio Mané,SEN,FW,Liverpool,Premier League,26,1992,34.2,35,29,12,17,6,14,43,32.6,29,28,4,24,15,50,10,1,Matches
1503,Thomas Mangani,FRA,MF,Angers,Ligue 1,31,1987,17.8,42,27,13,26,3,19,62,30.6,43,13,2,11,23,65,24,0,Matches
1504,Kostas Manolas,GRE,DF,Roma,Serie A,27,1991,25.8,32,24,23,8,1,17,26,65.4,9,34,25,9,50,82,117,2,Matches
1505,Javier Manquillo,ESP,DF,Newcastle Utd,Premier League,24,1994,12.2,27,19,14,11,2,9,14,64.3,5,9,1,8,17,44,58,0,Matches
1506,Martín Mantovani,ARG,DF,Huesca,La Liga,34,1984,7.8,15,9,12,3,0,6,11,54.5,5,4,3,1,22,37,48,0,Matches
1507,Juan Manuel Valencia,COL,FW,Bologna,Serie A,20,1998,0.3,0,0,0,0,0,0,0,,0,0,0,0,1,1,0,0,Matches
1508,Harrison Manzala,COD,"MF,FW",Angers,Ligue 1,24,1994,0.8,2,2,1,0,1,0,0,,0,0,0,0,0,2,1,0,Matches
1509,Fran Manzanara,ESP,"DF,MF",Levante,La Liga,21,1996,1.7,7,5,3,3,1,4,4,100.0,0,3,2,1,1,8,7,0,Matches
1510,Myziane Maolida,COM,FW,Nice,Ligue 1,19,1999,10.6,12,8,5,5,2,2,4,50.0,2,5,0,5,1,13,5,0,Matches
1511,Faitout Maouassa,FRA,DF,Nîmes,Ligue 1,20,1998,23.7,55,30,35,15,5,23,39,59.0,16,24,5,19,23,78,81,1,Matches
1512,Fernando Marçal,BRA,DF,Lyon,Ligue 1,29,1989,9.8,25,16,17,7,1,12,15,80.0,3,9,3,6,30,55,42,0,Matches
1513,Iván Marcano,ESP,DF,Roma,Serie A,31,1987,9.0,8,4,4,4,0,5,8,62.5,3,13,6,7,24,32,45,0,Matches
1514,Marcelo,BRA,DF,Real Madrid,La Liga,30,1988,20.6,34,19,17,12,5,15,39,38.5,24,19,2,17,17,51,21,0,Matches
1515,Marcelo,BRA,DF,Lyon,Ligue 1,31,1987,32.0,48,33,29,17,2,19,24,79.2,5,30,22,8,62,110,152,2,Matches
1516,Solly March,ENG,"FW,MF",Brighton,Premier League,24,1994,27.4,56,24,27,16,13,19,45,42.2,26,34,4,30,27,83,44,0,Matches
1517,Federico Marchetti,ITA,GK,Genoa,Serie A,35,1983,4.0,0,0,0,0,0,0,0,,0,0,0,0,0,0,1,0,Matches
1518,Gian Marco Ferrari,ITA,DF,Sassuolo,Serie A,26,1992,31.0,41,23,27,12,2,12,16,75.0,4,36,20,16,36,77,97,1,Matches
1519,Óscar de Marcos,ESP,"DF,FW",Athletic Club,La Liga,29,1989,26.9,60,32,34,17,9,29,62,46.8,33,29,4,25,27,87,62,0,Matches
1520,Georg Margreitter,AUT,DF,Nürnberg,Bundesliga,29,1988,22.9,39,24,28,8,3,31,38,81.6,7,29,26,3,26,65,141,0,Matches
1521,Miguel Marí,ESP,MF,Eibar,La Liga,21,1997,0.8,0,0,0,0,0,0,2,0.0,2,0,0,0,1,1,2,0,Matches
1522,José María Giménez,URU,DF,Atlético Madrid,La Liga,23,1995,19.7,26,15,20,6,0,13,26,50.0,13,27,14,13,44,70,128,2,Matches
1523,Mariano,DOM,FW,Real Madrid,La Liga,24,1993,5.0,2,1,1,1,0,0,3,0.0,3,2,0,2,0,2,2,0,Matches
1524,Mariano,DOM,FW,Lyon,Ligue 1,24,1993,1.6,0,0,0,0,0,0,0,,0,0,0,0,1,1,0,0,Matches
1525,Adrian Mariappa,JAM,DF,Watford,Premier League,31,1986,21.4,35,22,29,6,0,16,32,50.0,16,23,15,8,26,61,120,2,Matches
1526,Jordan Marié,FRA,MF,Dijon,Ligue 1,26,1991,20.0,52,28,15,31,6,21,58,36.2,37,28,5,23,40,92,32,0,Matches
1527,Adrián Marín,ESP,"DF,MF",Alavés,La Liga,21,1997,3.2,13,8,8,5,0,4,7,57.1,3,1,0,1,7,20,13,0,Matches
1528,João Mário,POR,"MF,FW",Inter,Serie A,25,1993,12.0,28,16,9,15,4,9,31,29.0,22,14,0,14,6,34,4,1,Matches
1529,Guillermo Maripán,CHI,DF,Alavés,La Liga,24,1994,22.3,46,26,34,12,0,26,38,68.4,12,35,19,16,40,86,133,2,Matches
1530,Lazar Marković,SRB,MF,Fulham,Premier League,24,1994,0.5,0,0,0,0,0,0,0,,0,0,0,0,0,0,2,0,Matches
1531,Marlon,BRA,DF,Sassuolo,Serie A,22,1995,16.8,29,18,25,3,1,15,21,71.4,6,22,12,10,24,53,39,0,Matches
1532,Marquinhos,BRA,"DF,MF",Paris S-G,Ligue 1,24,1994,29.9,65,41,34,28,3,31,52,59.6,21,30,13,17,44,109,84,1,Matches
1533,Roger Martí,ESP,FW,Levante,La Liga,27,1991,21.0,8,6,1,4,3,1,19,5.3,18,14,1,13,4,12,9,0,Matches
1534,Anthony Martial,FRA,FW,Manchester Utd,Premier League,22,1995,18.0,9,7,2,5,2,1,11,9.1,10,12,0,12,3,12,8,0,Matches
1535,Aarón Martín,ESP,DF,Mainz 05,Bundesliga,21,1997,32.0,55,30,29,21,5,20,38,52.6,18,38,11,27,38,93,75,1,Matches
1536,Jonas Martin,FRA,MF,Strasbourg,Ligue 1,28,1990,22.9,46,28,23,18,5,17,33,51.5,16,30,12,18,30,76,42,0,Matches
1537,Marvin Martin,FRA,MF,Reims,Ligue 1,30,1988,6.9,2,1,0,2,0,0,6,0.0,6,2,1,1,2,4,1,0,Matches
1538,Iñigo Martínez,ESP,DF,Athletic Club,La Liga,27,1991,32.2,53,26,36,16,1,23,37,62.2,14,24,14,10,69,122,144,0,Matches
1539,Javi Martínez,ESP,MF,Bayern Munich,Bundesliga,29,1988,14.5,26,15,7,17,2,5,16,31.3,11,17,5,12,31,57,13,0,Matches
1540,Lautaro Martínez,ARG,"FW,MF",Inter,Serie A,20,1997,14.9,6,5,0,2,4,2,6,33.3,4,16,0,16,3,9,7,0,Matches
1541,Pablo Martinez,FRA,DF,Strasbourg,Ligue 1,29,1989,31.3,51,34,34,17,0,30,49,61.2,19,37,23,14,52,103,132,1,Matches
1542,Gelson Martins,POR,"FW,MF",Atlético Madrid,La Liga,23,1995,2.5,5,3,3,1,1,3,4,75.0,1,1,0,1,1,6,1,0,Matches
1543,Gelson Martins,POR,"FW,MF",Monaco,Ligue 1,23,1995,15.4,20,12,8,7,5,13,32,40.6,19,9,1,8,8,28,7,0,Matches
1544,Adam Marušić,MNE,DF,Lazio,Serie A,25,1992,23.5,32,15,14,14,4,16,25,64.0,9,25,4,21,24,56,36,0,Matches
1545,Omar Mascarell,EQG,MF,Schalke 04,Bundesliga,25,1993,11.0,20,10,9,9,2,10,24,41.7,14,21,7,14,23,43,8,0,Matches
1546,Andrea Masiello,ITA,DF,Atalanta,Serie A,32,1986,20.4,28,14,13,15,0,17,29,58.6,12,21,6,15,44,72,49,0,Matches
1547,Adam Masina,MAR,DF,Watford,Premier League,24,1994,11.2,30,17,16,13,1,13,25,52.0,12,19,4,15,17,47,40,0,Matches
1548,Jordi Masip,ESP,GK,Valladolid,La Liga,29,1989,35.0,1,1,1,0,0,0,0,,0,1,0,1,1,2,3,3,Matches
1549,Han-Noah Massengo,FRA,MF,Monaco,Ligue 1,17,2001,0.7,2,2,2,0,0,2,5,40.0,3,0,0,0,2,4,1,0,Matches
1550,Arthur Masuaku,COD,DF,West Ham,Premier League,24,1993,19.5,57,25,38,13,6,31,56,55.4,25,27,6,21,36,93,72,0,Matches
1551,Jaime Mata,ESP,"FW,MF",Getafe,La Liga,29,1988,27.0,30,21,8,14,8,7,26,26.9,19,14,0,14,17,47,27,0,Matches
1552,Juan Mata,ESP,"FW,MF",Manchester Utd,Premier League,30,1988,14.3,9,4,7,1,1,6,21,28.6,15,8,1,7,6,15,6,0,Matches
1553,Luca Matarese,ITA,FW,Frosinone,Serie A,20,1998,0.2,0,0,0,0,0,0,0,,0,0,0,0,0,0,0,0,Matches
1554,Jean-Philippe Mateta,FRA,FW,Mainz 05,Bundesliga,21,1997,27.6,13,9,4,4,5,1,10,10.0,9,15,2,13,3,16,22,0,Matches
1555,Christian Mathenia,GER,GK,Nürnberg,Bundesliga,26,1992,21.5,0,0,0,0,0,0,0,,0,1,0,1,1,1,18,2,Matches
1556,Nemanja Matić,SRB,MF,Manchester Utd,Premier League,29,1988,27.1,50,30,27,19,4,30,59,50.8,29,39,18,21,31,81,53,4,Matches
1557,Joël Matip,CMR,DF,Liverpool,Premier League,26,1991,17.1,39,26,23,12,4,13,24,54.2,11,12,7,5,32,71,78,0,Matches
1558,Rabbi Matondo,WAL,"FW,MF",Schalke 04,Bundesliga,17,2000,2.1,4,1,4,0,0,1,5,20.0,4,2,0,2,0,4,1,0,Matches
1559,Alessandro Matri,ITA,FW,Sassuolo,Serie A,33,1984,6.7,2,1,0,0,2,0,3,0.0,3,4,2,2,4,6,7,0,Matches
1560,Federico Mattiello,ITA,"DF,FW",Bologna,Serie A,23,1995,14.8,33,20,19,9,5,15,23,65.2,8,9,3,6,20,53,43,0,Matches
1561,Blaise Matuidi,FRA,MF,Juventus,Serie A,31,1987,26.9,59,33,25,21,13,20,36,55.6,16,33,8,25,26,85,21,1,Matches
1562,José Mauri,ITA,MF,Milan,Serie A,22,1996,2.3,8,4,2,6,0,2,6,33.3,4,0,0,0,5,13,0,0,Matches
1563,Stephy Mavididi,ENG,FW,Juventus,Serie A,20,1998,0.2,0,0,0,0,0,0,0,,0,1,0,1,0,0,0,0,Matches
1564,Konstantinos Mavropanos,GRE,DF,Arsenal,Premier League,20,1997,1.6,1,0,0,1,0,1,1,100.0,0,1,1,0,7,8,5,0,Matches
1565,Alfie Mawson,ENG,DF,Fulham,Premier League,24,1994,12.6,11,7,7,4,0,6,10,60.0,4,20,17,3,19,30,64,1,Matches
1566,Philipp Max,GER,"DF,MF",Augsburg,Bundesliga,24,1993,28.5,35,24,17,15,3,21,39,53.8,18,16,3,13,22,57,46,1,Matches
1567,Alexandru Maxim,ROU,"MF,FW",Mainz 05,Bundesliga,28,1990,6.4,16,10,6,9,1,10,19,52.6,9,12,0,12,5,21,7,0,Matches
1568,Eric Maxim Choupo-Moting,CMR,FW,Paris S-G,Ligue 1,29,1989,8.9,9,4,3,2,4,2,9,22.2,7,7,0,7,3,12,4,0,Matches
1569,Borja Mayoral,ESP,FW,Levante,La Liga,21,1997,18.0,9,4,1,6,2,5,16,31.3,11,10,1,9,5,14,5,0,Matches
1570,Róbert Mazáň,SVK,DF,Celta Vigo,La Liga,24,1994,1.0,3,3,3,0,0,2,2,100.0,0,2,0,2,3,6,0,0,Matches
1571,Luca Mazzitelli,ITA,MF,Genoa,Serie A,22,1995,3.6,5,2,3,1,1,2,3,66.7,1,4,1,3,6,11,7,0,Matches
1572,Kylian Mbappé,FRA,FW,Paris S-G,Ligue 1,19,1998,26.0,8,4,2,1,5,1,6,16.7,5,2,0,2,5,13,2,0,Matches
1573,Ibrahima Mbaye,SEN,DF,Bologna,Serie A,23,1994,22.3,48,32,30,16,2,19,32,59.4,13,21,12,9,19,67,66,1,Matches
1574,Loïc Mbe Soh,FRA,DF,Paris S-G,Ligue 1,17,2001,2.0,0,0,0,0,0,0,3,0.0,3,2,2,0,3,3,5,0,Matches
1575,Nolan Mbemba,CGO,"MF,DF",Reims,Ligue 1,23,1995,4.0,14,8,10,4,0,6,9,66.7,3,4,1,3,10,24,4,2,Matches
1576,Adama Mbengue,SEN,DF,Caen,Ligue 1,24,1993,8.2,48,32,34,12,2,19,26,73.1,7,15,4,11,7,55,22,0,Matches
1577,Isaac Mbenza,BEL,"FW,MF",Huddersfield,Premier League,22,1996,11.0,10,9,5,5,0,2,4,50.0,2,4,0,4,5,15,4,0,Matches
1578,Stéphane Mbia,CMR,"DF,MF",Toulouse,Ligue 1,32,1986,5.0,1,0,1,0,0,1,2,50.0,1,9,4,5,7,8,25,1,Matches
1579,Kara Mbodji,SEN,DF,Nantes,Ligue 1,28,1989,5.6,12,10,10,1,1,6,8,75.0,2,4,1,3,6,18,25,0,Matches
1580,Jordi Mboula,ESP,"FW,MF",Monaco,Ligue 1,19,1999,3.1,3,0,0,1,2,3,6,50.0,3,1,0,1,1,4,5,0,Matches
1581,James McArthur,SCO,MF,Crystal Palace,Premier League,30,1987,34.0,84,51,38,32,14,30,78,38.5,48,64,22,42,39,123,55,0,Matches
1582,Alex McCarthy,ENG,GK,Southampton,Premier League,28,1989,25.0,0,0,0,0,0,0,0,,0,0,0,0,0,0,6,2,Matches
1583,James McCarthy,IRL,MF,Everton,Premier League,27,1990,0.2,2,1,1,1,0,0,0,,0,0,0,0,1,3,0,0,Matches
1584,Kevin McDonald,SCO,MF,Fulham,Premier League,29,1988,9.3,15,11,6,8,1,5,13,38.5,8,8,2,6,9,24,22,0,Matches
1585,Levan Mchedlidze,GEO,FW,Empoli,Serie A,28,1990,2.3,1,1,0,0,1,0,1,0.0,1,2,0,2,0,1,5,0,Matches
1586,Weston McKennie,USA,"MF,FW",Schalke 04,Bundesliga,19,1998,19.4,28,14,5,17,6,11,35,31.4,24,28,9,19,36,64,46,1,Matches
1587,Dwight McNeil,ENG,MF,Burnley,Premier League,18,1999,17.7,36,22,16,17,3,13,44,29.5,31,30,3,27,13,49,35,0,Matches
1588,Scott McTominay,SCO,"MF,DF",Manchester Utd,Premier League,21,1996,9.6,10,9,3,6,1,4,10,40.0,6,9,4,5,15,25,16,0,Matches
1589,Iuri Medeiros,POR,"MF,FW",Genoa,Serie A,24,1994,1.2,2,2,0,1,1,1,2,50.0,1,2,0,2,0,2,1,0,Matches
1590,Nicky Medja,SUI,"FW,MF",Fiorentina,Serie A,18,2000,0.5,1,0,0,0,1,1,2,50.0,1,0,0,0,0,1,0,0,Matches
1591,Álvaro Medrán,ESP,MF,Rayo Vallecano,La Liga,24,1994,12.8,15,8,5,6,4,6,21,28.6,15,10,1,9,17,32,9,0,Matches
1592,Ben Mee,ENG,DF,Burnley,Premier League,28,1989,38.0,55,24,38,17,0,35,44,79.5,9,59,50,9,48,103,235,4,Matches
1593,Riccardo Meggiorini,ITA,FW,Chievo,Serie A,32,1985,17.2,17,13,5,9,3,1,10,10.0,9,20,2,18,8,25,26,0,Matches
1594,Admir Mehmedi,SUI,"FW,MF",Wolfsburg,Bundesliga,27,1991,18.8,46,28,19,19,8,18,44,40.9,26,25,0,25,12,58,9,0,Matches
1595,Soualiho Meïté,FRA,MF,Torino,Serie A,24,1994,29.5,46,21,13,22,11,23,46,50.0,23,46,6,40,29,75,26,0,Matches
1596,Farid El Melali,ALG,"MF,FW",Angers,Ligue 1,21,1997,3.6,8,4,3,4,1,3,12,25.0,9,2,0,2,5,13,1,0,Matches
1597,Óscar Melendo,ESP,"MF,FW",Espanyol,La Liga,20,1997,22.2,17,8,7,6,4,10,26,38.5,16,17,1,16,13,30,9,0,Matches
1598,Gonzalo Melero,ESP,MF,Huesca,La Liga,24,1994,14.9,26,23,5,19,2,11,48,22.9,37,14,4,10,2,28,23,0,Matches
1599,Arthur Melo,BRA,MF,Barcelona,La Liga,21,1996,15.9,15,10,5,6,4,6,13,46.2,7,8,0,8,9,24,9,1,Matches
1600,Memphis,NED,"FW,MF",Lyon,Ligue 1,24,1994,30.4,12,9,0,7,5,5,21,23.8,16,16,2,14,9,21,1,0,Matches
1601,Pedro Mendes,POR,DF,Montpellier,Ligue 1,27,1990,29.6,71,42,56,13,2,31,47,66.0,16,42,22,20,48,119,73,1,Matches
1602,Thiago Mendes,BRA,MF,Lille,Ligue 1,26,1992,34.2,85,47,42,41,2,39,71,54.9,32,44,11,33,68,153,49,0,Matches
1603,Brais Méndez,ESP,"MF,FW",Celta Vigo,La Liga,21,1997,26.1,61,31,23,29,9,14,53,26.4,39,32,3,29,24,85,24,0,Matches
1604,Nathaniel Mendez-Laing,GUA,"MF,FW",Cardiff City,Premier League,26,1992,10.9,34,25,18,12,4,12,26,46.2,14,17,1,16,13,47,20,0,Matches
1605,Stiven Mendoza,COL,"FW,MF",Amiens,Ligue 1,26,1992,20.9,29,18,10,12,7,14,38,36.8,24,18,0,18,17,46,12,0,Matches
1606,Alexandre Mendy,GNB,FW,Guingamp,Ligue 1,24,1994,8.5,5,3,0,4,1,3,8,37.5,5,3,0,3,1,6,6,0,Matches
1607,Benjamin Mendy,FRA,DF,Manchester City,Premier League,24,1994,10.0,16,10,10,5,1,9,17,52.9,8,13,4,9,10,26,18,0,Matches
1608,Edouard Mendy,SEN,GK,Reims,Ligue 1,26,1992,38.0,0,0,0,0,0,0,1,0.0,1,1,0,1,2,2,16,3,Matches
1609,Ferland Mendy,FRA,DF,Lyon,Ligue 1,23,1995,28.1,44,28,25,14,5,14,17,82.4,3,22,5,17,34,78,53,2,Matches
1610,Nampalys Mendy,SEN,MF,Leicester City,Premier League,26,1992,23.2,33,18,16,16,1,6,22,27.3,16,24,8,16,26,59,26,2,Matches
1611,Hamza Mendyl,MAR,DF,Schalke 04,Bundesliga,20,1997,6.0,17,15,6,8,3,8,18,44.4,10,11,2,9,8,25,8,0,Matches
1612,Chris Mepham,WAL,DF,Bournemouth,Premier League,20,1997,9.4,9,3,9,0,0,7,11,63.6,4,12,5,7,14,23,57,2,Matches
1613,Gabriel Mercado,ARG,DF,Sevilla,La Liga,31,1987,19.3,35,23,21,12,2,18,36,50.0,18,24,12,12,26,61,75,1,Matches
1614,Alex Meret,ITA,GK,Napoli,Serie A,21,1997,12.8,0,0,0,0,0,0,0,,0,0,0,0,0,0,3,1,Matches
1615,Mehdi Merghem,FRA,"FW,MF",Guingamp,Ligue 1,21,1997,8.0,25,18,15,7,3,11,21,52.4,10,14,1,13,9,34,6,0,Matches
1616,Mikel Merino,ESP,MF,Real Sociedad,La Liga,22,1996,22.8,50,28,19,25,6,14,52,26.9,38,37,2,35,29,79,37,1,Matches
1617,Sabin Merino,ESP,"FW,MF",Leganés,La Liga,26,1992,3.3,1,1,0,0,1,1,1,100.0,0,1,0,1,0,1,4,0,Matches
1618,Martín Merquelanz,ESP,MF,Real Sociedad,La Liga,23,1995,0.1,0,0,0,0,0,0,0,,0,0,0,0,0,0,0,0,Matches
1619,Dries Mertens,BEL,FW,Napoli,Serie A,31,1987,25.0,19,11,2,7,10,1,21,4.8,20,7,0,7,13,32,3,0,Matches
1620,Roque Mesa,ESP,MF,Sevilla,La Liga,29,1989,19.4,46,27,16,22,8,15,38,39.5,23,16,0,16,14,60,12,4,Matches
1621,Lionel Messi,ARG,FW,Barcelona,La Liga,31,1987,30.1,12,7,5,3,4,1,17,5.9,16,10,0,10,3,15,1,0,Matches
1622,Romain Métanire,MAD,DF,Reims,Ligue 1,28,1990,3.5,12,9,10,1,1,5,7,71.4,2,4,3,1,6,18,13,0,Matches
1623,Thomas Meunier,BEL,DF,Paris S-G,Ligue 1,26,1991,17.9,44,33,25,15,4,21,35,60.0,14,13,2,11,19,63,29,0,Matches
1624,Mexer,MOZ,DF,Rennes,Ligue 1,29,1988,27.4,23,12,18,5,0,12,18,66.7,6,26,18,8,30,53,125,0,Matches
1625,Max Meyer,GER,MF,Crystal Palace,Premier League,22,1995,15.7,33,18,14,18,1,11,20,55.0,9,6,0,6,15,48,19,0,Matches
1626,Matt Miazga,USA,DF,Nantes,Ligue 1,23,1995,8.0,12,11,11,1,0,7,9,77.8,2,11,7,4,12,24,41,1,Matches
1627,Míchel,ESP,MF,Valladolid,La Liga,30,1988,28.4,60,38,25,31,4,18,73,24.7,55,40,4,36,43,103,30,1,Matches
1628,Clément Michelin,FRA,DF,Toulouse,Ligue 1,21,1997,1.0,3,2,2,1,0,2,3,66.7,1,0,0,0,3,6,7,0,Matches
1629,Petar Mićin,SRB,MF,Udinese,Serie A,19,1998,0.0,0,0,0,0,0,0,0,,0,0,0,0,0,0,0,0,Matches
1630,Miguel,ESP,FW,Valladolid,La Liga,18,1999,0.1,0,0,0,0,0,0,1,0.0,1,0,0,0,1,1,0,0,Matches
1631,Florian Miguel,FRA,DF,Nîmes,Ligue 1,21,1996,12.4,19,16,13,6,0,7,11,63.6,4,15,7,8,21,40,47,0,Matches
1632,Nikola Milenković,SRB,DF,Fiorentina,Serie A,20,1997,33.4,59,40,36,21,2,17,33,51.5,16,39,21,18,48,107,143,0,Matches
1633,Arkadiusz Milik,POL,FW,Napoli,Serie A,24,1994,26.6,19,9,1,8,10,1,20,5.0,19,7,2,5,3,22,15,0,Matches
1634,Sergej Milinković-Savić,SRB,MF,Lazio,Serie A,23,1995,26.6,44,28,17,21,6,23,60,38.3,37,28,4,24,27,71,48,0,Matches
1635,Vanja Milinković-Savić,SRB,GK,SPAL,Serie A,21,1997,1.8,0,0,0,0,0,0,0,,0,0,0,0,0,0,1,0,Matches
1636,Luka Milivojević,SRB,MF,Crystal Palace,Premier League,27,1991,38.0,90,69,36,47,7,39,91,42.9,52,47,15,32,72,162,68,3,Matches
1637,Pere Milla,ESP,"MF,FW",Eibar,La Liga,25,1992,3.8,7,6,1,5,1,0,5,0.0,5,4,1,3,2,9,1,0,Matches
1638,Vincenzo Millico,ITA,MF,Torino,Serie A,17,2000,0.0,0,0,0,0,0,0,0,,0,0,0,0,0,0,0,0,Matches
1639,James Milner,ENG,"MF,DF",Liverpool,Premier League,32,1986,19.9,43,23,14,24,5,15,41,36.6,26,40,5,35,18,61,30,0,Matches
1640,Santi Mina,ESP,FW,Valencia,La Liga,22,1995,20.6,17,10,1,15,1,3,25,12.0,22,19,2,17,4,21,20,0,Matches
1641,Yerry Mina,COL,DF,Everton,Premier League,23,1994,9.9,14,7,8,6,0,6,9,66.7,3,11,5,6,8,22,54,3,Matches
1642,Tyrone Mings,ENG,DF,Bournemouth,Premier League,25,1993,1.6,4,3,3,1,0,2,3,66.7,1,5,2,3,6,10,8,0,Matches
1643,Ignasi Miquel,ESP,DF,Getafe,La Liga,25,1992,3.5,1,0,0,1,0,1,2,50.0,1,4,4,0,5,6,25,0,Matches
1644,Kevin Mirallas,BEL,"FW,MF",Fiorentina,Serie A,30,1987,14.4,17,7,8,4,5,6,15,40.0,9,17,0,17,4,21,10,0,Matches
1645,Jorge Miramón,ESP,DF,Huesca,La Liga,29,1989,27.7,73,55,49,17,7,34,53,64.2,19,34,11,23,44,117,65,1,Matches
1646,Miranda,BRA,DF,Inter,Serie A,33,1984,12.9,11,7,7,4,0,4,8,50.0,4,11,7,4,14,25,48,2,Matches
1647,Antonio Mirante,ITA,GK,Roma,Serie A,35,1983,11.0,0,0,0,0,0,0,0,,0,0,0,0,0,0,6,1,Matches
1648,Virgil Misidjan,SUR,"MF,FW",Nürnberg,Bundesliga,25,1993,17.1,21,13,10,5,6,4,25,16.0,21,17,0,17,9,30,5,0,Matches
1649,Simone Missiroli,ITA,MF,SPAL,Serie A,32,1986,30.5,58,43,31,22,5,25,49,51.0,24,44,11,33,46,104,46,0,Matches
1650,Kostas Mitroglou,GRE,FW,Marseille,Ligue 1,30,1988,6.4,0,0,0,0,0,0,3,0.0,3,0,0,0,0,0,5,0,Matches
1651,Aleksandar Mitrović,SRB,FW,Fulham,Premier League,23,1994,36.4,19,9,3,13,3,5,15,33.3,10,22,8,14,6,25,53,0,Matches
1652,Stefan Mitrović,SRB,DF,Strasbourg,Ligue 1,28,1990,33.6,23,16,20,3,0,12,24,50.0,12,41,31,10,46,69,146,2,Matches
1653,Maximilian Mittelstädt,GER,"DF,MF",Hertha BSC,Bundesliga,21,1997,20.0,61,37,33,23,5,23,49,46.9,26,32,4,28,46,107,64,0,Matches
1654,Henrikh Mkhitaryan,ARM,"FW,MF",Arsenal,Premier League,29,1989,18.2,28,22,8,17,3,6,22,27.3,16,34,2,32,16,44,13,0,Matches
1655,Luka Modrić,CRO,MF,Real Madrid,La Liga,32,1985,29.0,49,30,11,25,13,14,48,29.2,34,20,3,17,31,80,7,1,Matches
1656,Kevin Möhwald,GER,MF,Werder Bremen,Bundesliga,25,1993,9.7,16,10,3,11,2,3,20,15.0,17,14,0,14,17,33,14,0,Matches
1657,Niklas Moisander,FIN,DF,Werder Bremen,Bundesliga,32,1985,29.3,34,23,26,8,0,22,51,43.1,29,42,19,23,39,73,140,2,Matches
1658,Johan Mojica,COL,"FW,MF",Girona,La Liga,25,1992,0.2,1,1,1,0,0,0,0,,0,0,0,0,0,1,0,0,Matches
1659,Hakim El Mokeddem,,"FW,MF",Toulouse,Ligue 1,19,1999,0.3,1,1,1,0,0,0,1,0.0,1,0,0,0,0,1,1,0,Matches
1660,Jorge Molina,ESP,FW,Getafe,La Liga,36,1982,29.4,12,9,1,4,7,2,15,13.3,13,22,0,22,7,19,26,1,Matches
1661,Cristian Molinaro,ITA,"DF,MF",Frosinone,Serie A,35,1983,12.9,15,10,7,7,1,3,9,33.3,6,11,4,7,15,30,43,0,Matches
1662,Victor Mollejo,ESP,"FW,DF",Atlético Madrid,La Liga,17,2001,0.7,0,0,0,0,0,0,2,0.0,2,0,0,0,0,0,0,0,Matches
1663,Florent Mollet,FRA,MF,Montpellier,Ligue 1,26,1991,28.5,36,20,8,20,8,13,51,25.5,38,32,1,31,23,59,7,0,Matches
1664,Gabriele Moncini,ITA,MF,SPAL,Serie A,22,1996,0.1,1,1,1,0,0,0,0,,0,0,0,0,0,1,0,0,Matches
1665,Thomas Monconduit,FRA,MF,Amiens,Ligue 1,27,1991,31.3,76,47,38,33,5,26,63,41.3,37,46,17,29,36,112,77,1,Matches
1666,Kévin Monnet-Paquet,FRA,"DF,MF",Saint-Étienne,Ligue 1,29,1988,16.5,46,25,23,16,7,20,36,55.6,16,22,4,18,14,60,28,0,Matches
1667,Nacho Monreal,ESP,DF,Arsenal,Premier League,32,1986,20.7,35,17,21,9,5,15,25,60.0,10,28,10,18,31,66,62,0,Matches
1668,Francisco Montero,ESP,DF,Atlético Madrid,La Liga,19,1999,4.5,8,4,5,3,0,5,6,83.3,1,10,4,6,5,13,18,1,Matches
1669,Cristóbal Montiel,ESP,FW,Fiorentina,Serie A,18,2000,0.1,0,0,0,0,0,0,0,,0,0,0,0,0,0,0,0,Matches
1670,Martín Montoya,ESP,DF,Brighton,Premier League,27,1991,24.1,58,35,29,21,8,32,55,58.2,23,30,10,20,48,106,76,1,Matches
1671,Aaron Mooy,AUS,"MF,FW",Huddersfield,Premier League,27,1990,25.9,62,42,19,27,16,21,52,40.4,31,43,7,36,14,76,22,0,Matches
1672,Emre Mor,TUR,"FW,MF",Celta Vigo,La Liga,21,1997,4.1,7,4,1,3,3,2,7,28.6,5,5,0,5,3,10,1,0,Matches
1673,Alfredo Morales,USA,MF,Düsseldorf,Bundesliga,28,1990,17.0,32,18,16,15,1,6,24,25.0,18,18,9,9,24,56,31,0,Matches
1674,Álvaro Morata,ESP,FW,Chelsea,Premier League,25,1992,10.5,8,5,0,5,3,1,7,14.3,6,6,1,5,0,8,6,0,Matches
1675,Álvaro Morata,ESP,FW,Atlético Madrid,La Liga,25,1992,12.0,20,14,2,7,11,3,10,30.0,7,7,0,7,5,25,13,0,Matches
1676,Jan Morávek,CZE,MF,Augsburg,Bundesliga,28,1989,8.4,38,21,17,16,5,19,42,45.2,23,21,1,20,9,47,13,0,Matches
1677,Steven Moreira,CPV,"DF,MF",Toulouse,Ligue 1,23,1994,9.6,19,8,13,5,1,10,17,58.8,7,14,0,14,10,29,19,1,Matches
1678,Jérémy Morel,MAD,DF,Lyon,Ligue 1,34,1984,11.8,16,10,11,5,0,9,13,69.2,4,18,14,4,18,34,45,1,Matches
1679,Alberto Moreno,ESP,DF,Liverpool,Premier League,26,1992,1.7,3,2,1,2,0,1,3,33.3,2,1,0,1,2,5,0,0,Matches
1680,Álex Moreno,ESP,DF,Rayo Vallecano,La Liga,25,1993,34.8,63,40,41,18,4,29,53,54.7,24,35,9,26,41,104,97,0,Matches
1681,Gerard Moreno,ESP,FW,Villarreal,La Liga,26,1992,25.7,22,12,2,15,5,8,27,29.6,19,23,9,14,9,31,39,0,Matches
1682,Héctor Moreno,MEX,DF,Real Sociedad,La Liga,30,1988,21.5,16,9,12,4,0,9,17,52.9,8,34,19,15,31,47,73,0,Matches
1683,Sergio Moreno,ESP,FW,Rayo Vallecano,La Liga,19,1999,0.2,0,0,0,0,0,0,0,,0,0,0,0,0,0,0,0,Matches
1684,Emiliano Moretti,ITA,DF,Torino,Serie A,37,1981,22.3,30,21,21,9,0,13,20,65.0,7,14,6,8,24,54,65,1,Matches
1685,Wes Morgan,JAM,DF,Leicester City,Premier League,34,1984,21.4,27,15,14,12,1,6,7,85.7,1,24,10,14,32,59,109,1,Matches
1686,Manu Morlanes,ESP,MF,Villarreal,La Liga,19,1999,6.8,21,11,9,9,3,7,19,36.8,12,7,3,4,5,26,9,0,Matches
1687,Loren Morón,ESP,FW,Betis,La Liga,24,1993,21.7,18,12,4,11,3,6,27,22.2,21,24,1,23,6,24,18,0,Matches
1688,Sean Morrison,ENG,DF,Cardiff City,Premier League,27,1991,33.8,35,17,29,4,2,15,28,53.6,13,47,30,17,52,87,204,5,Matches
1689,Victor Moses,NGA,FW,Chelsea,Premier League,27,1990,0.3,0,0,0,0,0,0,0,,0,1,0,1,0,0,0,0,Matches
1690,Lebo Mothiba,RSA,FW,Strasbourg,Ligue 1,22,1996,19.7,10,9,2,7,1,0,8,0.0,8,5,1,4,0,10,6,0,Matches
1691,Lebo Mothiba,RSA,FW,Lille,Ligue 1,22,1996,2.8,1,1,0,1,0,0,0,,0,0,0,0,0,1,8,0,Matches
1692,François Moubandje,SUI,DF,Toulouse,Ligue 1,28,1990,21.5,38,22,22,10,6,17,22,77.3,5,18,4,14,27,65,74,0,Matches
1693,Jessy Moulin,FRA,GK,Saint-Étienne,Ligue 1,32,1986,1.0,1,0,1,0,0,1,1,100.0,0,0,0,0,0,1,2,0,Matches
1694,Steve Mounié,BEN,FW,Huddersfield,Premier League,23,1994,19.8,9,6,3,4,2,2,12,16.7,10,10,1,9,5,14,15,0,Matches
1695,Lucas Moura,BRA,"FW,MF",Tottenham,Premier League,25,1992,23.6,35,18,8,20,7,9,27,33.3,18,15,1,14,24,59,24,0,Matches
1696,Herman Moussaki,FRA,"MF,FW",Caen,Ligue 1,19,1999,2.3,3,3,2,1,0,1,4,25.0,3,2,1,1,0,3,3,0,Matches
1697,Lys Mousset,FRA,FW,Bournemouth,Premier League,22,1996,4.1,3,1,1,1,1,1,4,25.0,3,3,0,3,1,4,3,0,Matches
1698,João Moutinho,POR,MF,Wolves,Premier League,31,1986,33.7,113,58,50,56,7,44,126,34.9,82,56,11,45,40,153,50,0,Matches
1699,Samuel Moutoussamy,COD,"MF,FW",Nantes,Ligue 1,21,1996,18.3,35,20,16,11,8,12,34,35.3,22,17,2,15,9,44,17,0,Matches
1700,Toni Moya,ESP,DF,Atlético Madrid,La Liga,20,1998,1.0,2,2,2,0,0,0,1,0.0,1,0,0,0,0,2,3,0,Matches
1701,Javi Moyano,ESP,DF,Valladolid,La Liga,32,1986,23.3,25,17,17,6,2,15,30,50.0,15,20,9,11,25,50,88,2,Matches
1702,Samuel Mráz,SVK,FW,Empoli,Serie A,21,1997,1.9,0,0,0,0,0,0,0,,0,2,0,2,0,0,2,0,Matches
1703,Ndombe Mubele,COD,FW,Toulouse,Ligue 1,24,1994,5.2,9,4,5,2,2,4,9,44.4,5,4,0,4,2,11,2,0,Matches
1704,Lukas Mühl,GER,DF,Nürnberg,Bundesliga,21,1997,31.0,57,34,49,6,2,32,51,62.7,19,53,18,35,48,105,139,2,Matches
1705,Nordi Mukiele,FRA,DF,RB Leipzig,Bundesliga,20,1997,13.6,38,21,23,12,3,19,22,86.4,3,17,3,14,24,62,35,0,Matches
1706,Florian Müller,GER,GK,Mainz 05,Bundesliga,20,1997,24.0,1,1,1,0,0,1,2,50.0,1,0,0,0,3,4,8,5,Matches
1707,Nicolai Müller,GER,"MF,FW",Hannover 96,Bundesliga,30,1987,10.0,18,9,7,7,4,8,27,29.6,19,9,1,8,1,19,7,0,Matches
1708,Nicolai Müller,GER,"FW,MF",Eint Frankfurt,Bundesliga,30,1987,2.4,4,2,3,1,0,1,2,50.0,1,4,1,3,0,4,0,0,Matches
1709,Thomas Müller,GER,"MF,FW",Bayern Munich,Bundesliga,28,1989,26.4,42,23,13,15,14,10,38,26.3,28,46,6,40,9,51,12,0,Matches
1710,Gianni Munari,ITA,MF,Parma,Serie A,35,1983,0.0,0,0,0,0,0,0,0,,0,0,0,0,0,0,0,0,Matches
1711,Iker Muniain,ESP,"MF,FW",Athletic Club,La Liga,25,1992,26.5,29,20,10,14,5,6,29,20.7,23,17,3,14,12,41,6,0,Matches
1712,Marc Muniesa,ESP,"DF,MF",Girona,La Liga,26,1992,15.6,49,34,27,17,5,15,28,53.6,13,18,6,12,37,86,49,1,Matches
1713,Aihen Muñoz,ESP,DF,Real Sociedad,La Liga,20,1997,10.6,13,8,11,2,0,10,19,52.6,9,19,9,10,7,20,26,0,Matches
1714,Ezequiel Muñoz,ARG,DF,Leganés,La Liga,27,1990,2.3,3,2,1,2,0,0,0,,0,3,1,2,1,4,10,0,Matches
1715,Joaquín Muñoz,ESP,FW,Atlético Madrid,La Liga,19,1999,0.0,0,0,0,0,0,0,0,,0,0,0,0,0,0,0,0,Matches
1716,Alessandro Murgia,ITA,MF,SPAL,Serie A,21,1996,11.9,22,15,9,12,1,7,32,21.9,25,14,2,12,19,41,12,1,Matches
1717,Alessandro Murgia,ITA,MF,Lazio,Serie A,21,1996,0.1,0,0,0,0,0,0,0,,0,0,0,0,0,0,0,0,Matches
1718,Luis Muriel,COL,FW,Fiorentina,Serie A,27,1991,16.0,19,11,4,13,2,6,18,33.3,12,10,0,10,3,22,1,0,Matches
1719,Luis Muriel,COL,"MF,FW",Sevilla,La Liga,27,1991,1.4,0,0,0,0,0,0,6,0.0,6,3,0,3,0,0,1,0,Matches
1720,Jeison Murillo,COL,DF,Valencia,La Liga,26,1992,1.0,2,1,1,1,0,1,2,50.0,1,1,0,1,2,4,6,0,Matches
1721,Jeison Murillo,COL,DF,Barcelona,La Liga,26,1992,1.3,2,2,1,1,0,0,3,0.0,3,0,0,0,0,2,5,1,Matches
1722,Jacob Murphy,ENG,"MF,DF",Newcastle Utd,Premier League,23,1995,3.4,6,2,4,2,0,2,4,50.0,2,5,2,3,1,7,7,0,Matches
1723,Josh Murphy,ENG,"MF,FW",Cardiff City,Premier League,23,1995,20.2,26,17,15,7,4,9,29,31.0,20,30,0,30,11,37,17,0,Matches
1724,Glenn Murray,ENG,FW,Brighton,Premier League,34,1983,27.9,17,7,4,7,6,4,20,20.0,16,20,3,17,2,19,17,1,Matches
1725,Nicola Murru,ITA,DF,Sampdoria,Serie A,23,1994,32.6,83,59,42,25,16,41,54,75.9,13,50,22,28,41,124,99,0,Matches
1726,Mateo Musacchio,ARG,DF,Milan,Serie A,27,1990,29.0,41,22,30,8,3,19,27,70.4,8,26,19,7,29,70,114,0,Matches
1727,Florent Muslija,KVX,"MF,FW",Hannover 96,Bundesliga,20,1998,7.5,16,10,8,6,2,8,12,66.7,4,4,0,4,3,19,4,0,Matches
1728,Juan Musso,ARG,GK,Udinese,Serie A,24,1994,29.0,0,0,0,0,0,0,1,0.0,1,0,0,0,0,0,10,4,Matches
1729,Shkodran Mustafi,GER,DF,Arsenal,Premier League,26,1992,29.0,62,45,42,17,3,31,40,77.5,9,34,17,17,58,120,168,1,Matches
1730,Damián Musto,ARG,"MF,DF",Huesca,La Liga,31,1987,18.7,52,34,22,27,3,16,33,48.5,17,30,11,19,34,86,54,1,Matches
1731,Yoshinori Mutō,JPN,"FW,MF",Newcastle Utd,Premier League,26,1992,5.8,8,4,3,5,0,2,7,28.6,5,9,0,9,5,13,3,1,Matches
1732,Yvon Mvogo,SUI,GK,RB Leipzig,Bundesliga,24,1994,1.5,0,0,0,0,0,0,0,,0,0,0,0,0,0,1,0,Matches
1733,Phillipp Mwene,AUT,"DF,MF",Mainz 05,Bundesliga,24,1994,3.0,7,2,3,4,0,5,6,83.3,1,6,0,6,6,13,10,0,Matches
1734,Obite N'Dicka,CIV,DF,Eint Frankfurt,Bundesliga,18,1999,25.6,43,28,31,10,2,31,52,59.6,21,29,11,18,29,72,123,0,Matches
1735,Kévin N'Doram,FRA,"DF,MF",Monaco,Ligue 1,22,1996,2.2,5,4,1,4,0,3,5,60.0,2,1,1,0,5,10,8,1,Matches
1736,Abdallah N'dour,SEN,DF,Strasbourg,Ligue 1,24,1993,3.2,6,4,3,3,0,4,9,44.4,5,4,2,2,5,11,8,0,Matches
1737,Cheikh N'Doye,SEN,MF,Angers,Ligue 1,32,1986,25.9,25,15,14,11,0,10,32,31.3,22,33,8,25,25,50,61,0,Matches
1738,Nathan N'Goumou,FRA,FW,Toulouse,Ligue 1,18,2000,0.8,1,1,0,1,0,0,1,0.0,1,1,0,1,0,1,3,0,Matches
1739,Clinton N'Jie,CMR,FW,Marseille,Ligue 1,24,1993,4.0,7,4,2,3,2,3,3,100.0,0,2,0,2,2,9,0,0,Matches
1740,Georges-Kévin N'Koudou,CMR,FW,Tottenham,Premier League,23,1995,0.1,0,0,0,0,0,0,0,,0,0,0,0,0,0,0,0,Matches
1741,Georges-Kévin N'Koudou,CMR,FW,Monaco,Ligue 1,23,1995,0.3,2,1,0,0,2,1,1,100.0,0,2,0,2,0,2,0,0,Matches
1742,Stanley N'Soki,FRA,DF,Paris S-G,Ligue 1,19,1999,7.8,20,14,8,10,2,6,13,46.2,7,10,1,9,18,38,20,1,Matches
1743,Nacho,ESP,DF,Valladolid,La Liga,29,1989,35.0,110,66,73,30,7,67,100,67.0,33,43,10,33,45,155,113,2,Matches
1744,Nacho,ESP,DF,Real Madrid,La Liga,28,1990,18.9,26,19,14,7,5,11,22,50.0,11,19,7,12,32,58,65,1,Matches
1745,Ádám Nagy,HUN,MF,Bologna,Serie A,23,1995,10.8,29,21,15,13,1,11,21,52.4,10,13,5,8,25,54,12,2,Matches
1746,Radja Nainggolan,BEL,MF,Inter,Serie A,30,1988,21.9,35,26,7,20,8,10,24,41.7,14,17,2,15,8,43,5,0,Matches
1747,Naldo,BRA,DF,Espanyol,La Liga,29,1988,15.1,18,10,9,5,4,6,10,60.0,4,19,13,6,26,44,112,1,Matches
1748,Naldo,BRA,DF,Monaco,Ligue 1,35,1982,3.3,5,3,4,1,0,2,4,50.0,2,5,2,3,5,10,23,0,Matches
1749,Naldo,BRA,DF,Schalke 04,Bundesliga,35,1982,7.0,10,7,8,2,0,5,8,62.5,3,8,3,5,14,24,25,0,Matches
1750,Samir Nasri,FRA,MF,West Ham,Premier League,31,1987,2.7,0,0,0,0,0,0,0,,0,1,0,1,1,1,1,0,Matches
1751,Matija Nastasić,SRB,DF,Schalke 04,Bundesliga,25,1993,27.2,35,23,22,13,0,20,29,69.0,9,32,20,12,38,73,114,1,Matches
1752,Marc Navarro,ESP,DF,Watford,Premier League,23,1995,0.9,4,2,3,1,0,3,4,75.0,1,0,0,0,0,4,4,0,Matches
1753,Ximo Navarro,ESP,DF,Alavés,La Liga,28,1990,28.1,57,35,44,12,1,32,45,71.1,13,25,11,14,47,104,143,1,Matches
1754,Jesús Navas,ESP,"DF,FW",Sevilla,La Liga,32,1985,30.1,28,21,15,11,2,16,24,66.7,8,23,5,18,29,57,62,0,Matches
1755,Keylor Navas,CRC,GK,Real Madrid,La Liga,31,1986,10.0,0,0,0,0,0,0,0,,0,0,0,0,1,1,5,0,Matches
1756,Raúl Navas,ESP,DF,Real Sociedad,La Liga,30,1988,14.6,23,14,20,3,0,13,21,61.9,8,20,9,11,20,43,60,1,Matches
1757,Wilfred Ndidi,NGA,MF,Leicester City,Premier League,21,1996,36.6,142,98,66,67,9,46,95,48.4,49,64,9,55,83,225,85,2,Matches
1758,Aly Ndom,FRA,MF,Caen,Ligue 1,22,1996,0.5,0,0,0,0,0,0,0,,0,0,0,0,1,1,1,0,Matches
1759,Aly Ndom,FRA,MF,Reims,Ligue 1,22,1996,4.0,11,9,5,5,1,3,7,42.9,4,6,2,4,3,14,9,1,Matches
1760,Tanguy Ndombele,FRA,MF,Lyon,Ligue 1,21,1996,29.9,66,43,21,35,10,22,54,40.7,32,29,9,20,30,96,13,3,Matches
1761,Angelo Ndrecka,ALB,DF,Chievo,Serie A,16,2001,1.0,1,1,1,0,0,1,2,50.0,1,3,2,1,0,1,1,0,Matches
1762,Reiss Nelson,ENG,"MF,FW",Hoffenheim,Bundesliga,18,1999,7.1,17,10,8,4,5,2,13,15.4,11,12,1,11,5,22,2,0,Matches
1763,Neto,BRA,GK,Valencia,La Liga,29,1989,34.0,2,0,2,0,0,2,3,66.7,1,0,0,0,1,3,9,3,Matches
1764,Pedro Neto,POR,"FW,DF",Lazio,Serie A,18,2000,0.5,0,0,0,0,0,0,0,,0,1,0,1,0,0,0,0,Matches
1765,Manuel Neuer,GER,GK,Bayern Munich,Bundesliga,32,1986,25.6,1,1,1,0,0,0,1,0.0,1,1,0,1,0,1,8,3,Matches
1766,Florian Neuhaus,GER,MF,Gladbach,Bundesliga,21,1997,22.9,22,15,9,9,4,10,36,27.8,26,20,1,19,10,32,23,0,Matches
1767,Rúben Neves,POR,MF,Wolves,Premier League,21,1997,33.4,75,32,33,36,6,27,83,32.5,56,57,18,39,73,148,46,3,Matches
1768,Neymar,BRA,"MF,FW",Paris S-G,Ligue 1,26,1992,16.0,14,9,3,10,1,4,21,19.0,17,8,0,8,5,19,1,1,Matches
1769,Yeni Ngbakoto,COD,"MF,FW",Guingamp,Ligue 1,26,1992,6.3,9,4,4,3,2,4,8,50.0,4,7,0,7,4,13,2,0,Matches
1770,Moussa Niakhate,SEN,DF,Mainz 05,Bundesliga,22,1996,31.0,49,30,35,12,2,20,33,60.6,13,42,24,18,44,93,143,1,Matches
1771,M'Baye Niang,SEN,"FW,MF",Rennes,Ligue 1,23,1994,19.9,16,10,3,8,5,2,11,18.2,9,19,3,16,8,24,14,0,Matches
1772,Oumar Niasse,SEN,FW,Cardiff City,Premier League,28,1990,10.3,12,3,1,5,6,4,8,50.0,4,7,0,7,2,14,7,0,Matches
1773,Oumar Niasse,SEN,FW,Everton,Premier League,28,1990,0.7,0,0,0,0,0,0,1,0.0,1,0,0,0,0,0,0,0,Matches
1774,Hans Nicolussi Caviglia,ITA,MF,Juventus,Serie A,18,2000,0.6,2,1,0,2,0,0,2,0.0,2,2,1,1,0,2,0,0,Matches
1775,Florian Niederlechner,GER,"FW,MF",Freiburg,Bundesliga,27,1990,10.8,7,5,1,4,2,0,5,0.0,5,12,4,8,6,13,10,0,Matches
1776,Saúl Ñíguez,ESP,"MF,DF",Atlético Madrid,La Liga,23,1994,32.5,83,56,35,41,7,32,81,39.5,49,57,10,47,42,125,86,1,Matches
1777,Dimitris Nikolaou,GRE,DF,Empoli,Serie A,19,1998,3.9,5,3,3,2,0,1,2,50.0,1,2,2,0,2,7,14,0,Matches
1778,Casimir Ninga,CHA,"FW,MF",Caen,Ligue 1,25,1993,27.4,53,30,23,21,9,20,49,40.8,29,22,1,21,22,75,12,0,Matches
1779,Eddie Nketiah,ENG,"MF,FW",Arsenal,Premier League,19,1999,0.7,1,1,0,1,0,0,0,,0,0,0,0,0,1,1,0,Matches
1780,Nicolas Nkoulou,CMR,DF,Torino,Serie A,28,1990,35.7,45,29,34,10,1,15,25,60.0,10,42,28,14,70,115,174,2,Matches
1781,Christopher Nkunku,FRA,"MF,FW",Paris S-G,Ligue 1,20,1997,12.8,21,16,8,10,3,7,16,43.8,9,12,2,10,9,30,7,1,Matches
1782,Mark Noble,ENG,MF,West Ham,Premier League,31,1987,25.5,47,26,19,24,4,17,52,32.7,35,17,2,15,21,68,13,0,Matches
1783,Peru Nolaskoain,ESP,DF,Athletic Club,La Liga,19,1998,5.2,11,8,7,4,0,5,9,55.6,4,11,6,5,10,21,18,0,Matches
1784,Nolito,ESP,"FW,DF",Sevilla,La Liga,31,1986,0.8,3,2,1,1,1,1,2,50.0,1,2,0,2,0,3,1,0,Matches
1785,Arnaud Nordin,FRA,"FW,MF",Saint-Étienne,Ligue 1,20,1998,11.7,14,12,4,4,6,4,11,36.4,7,13,2,11,5,19,9,0,Matches
1786,Håvard Nordtveit,NOR,DF,Fulham,Premier League,28,1990,4.0,9,4,8,1,0,4,5,80.0,1,3,3,0,8,17,15,1,Matches
1787,Håvard Nordtveit,NOR,"MF,DF",Hoffenheim,Bundesliga,28,1990,5.2,8,5,2,4,2,3,7,42.9,4,8,5,3,4,12,14,0,Matches
1788,Will Norris,ENG,GK,Wolves,Premier League,24,1993,0.0,0,0,0,0,0,0,0,,0,0,0,0,0,0,0,0,Matches
1789,Alexander Nübel,GER,GK,Schalke 04,Bundesliga,21,1996,17.6,0,0,0,0,0,0,1,0.0,1,0,0,0,1,1,4,1,Matches
1790,Kasim Nuhu,GHA,DF,Hoffenheim,Bundesliga,23,1995,10.0,19,11,14,3,2,10,23,43.5,13,11,5,6,23,42,44,0,Matches
1791,Unai Núñez,ESP,DF,Athletic Club,La Liga,21,1997,11.8,15,11,11,4,0,7,11,63.6,4,20,12,8,28,43,60,2,Matches
1792,Hans Nunoo Sarpei,GHA,"FW,MF",Stuttgart,Bundesliga,19,1998,0.5,1,1,0,1,0,0,0,,0,0,0,0,0,1,0,0,Matches
1793,Bram Nuytinck,NED,DF,Udinese,Serie A,28,1990,23.6,50,35,34,13,3,25,33,75.8,8,44,27,17,29,79,126,0,Matches
1794,Gerzino Nyamsi,FRA,DF,Rennes,Ligue 1,21,1997,6.0,6,3,5,1,0,4,9,44.4,5,8,4,4,4,10,17,0,Matches
1795,Allan Nyom,CMR,"DF,FW",Leganés,La Liga,30,1988,19.0,32,24,20,10,2,12,17,70.6,5,7,2,5,20,52,35,0,Matches
1796,Steven Nzonzi,FRA,MF,Roma,Serie A,29,1988,29.1,66,45,24,36,6,21,34,61.8,13,40,24,16,27,93,55,2,Matches
1797,Christian Nørgaard,DEN,MF,Fiorentina,Serie A,24,1994,3.6,4,2,1,2,1,2,5,40.0,3,2,0,2,10,14,16,0,Matches
1798,Michael Obafemi,IRL,FW,Southampton,Premier League,18,2000,1.5,1,1,0,0,1,0,0,,0,1,1,0,1,2,0,0,Matches
1799,Dimitri Oberlin,SUI,FW,Empoli,Serie A,20,1997,1.5,1,1,0,0,1,0,3,0.0,3,1,0,1,0,1,1,0,Matches
1800,Joel Obi,NGA,MF,Chievo,Serie A,27,1991,7.3,22,15,9,11,2,7,17,41.2,10,12,1,11,14,36,15,0,Matches
1801,Pedro Obiang,EQG,MF,West Ham,Premier League,26,1992,12.5,41,23,23,16,2,18,43,41.9,25,27,9,18,12,53,18,0,Matches
1802,Jan Oblak,SVN,GK,Atlético Madrid,La Liga,25,1993,37.0,1,0,1,0,0,1,1,100.0,0,0,0,0,1,2,13,1,Matches
1803,Lucas Ocampos,ARG,"FW,MF",Marseille,Ligue 1,24,1994,30.1,80,54,37,33,10,34,80,42.5,46,40,5,35,29,109,30,0,Matches
1804,Bastian Oczipka,GER,"DF,FW",Schalke 04,Bundesliga,29,1989,20.8,41,27,20,19,2,21,26,80.8,5,23,5,18,24,65,24,2,Matches
1805,Jens Odgaard,DEN,FW,Sassuolo,Serie A,19,1999,0.2,0,0,0,0,0,0,0,,0,1,0,1,0,0,1,0,Matches
1806,Denis Odoi,GHA,DF,Fulham,Premier League,30,1988,28.8,48,34,29,16,3,21,33,63.6,12,45,24,21,42,90,153,0,Matches
1807,Álvaro Odriozola,ESP,DF,Real Madrid,La Liga,22,1995,13.1,28,25,13,11,4,14,18,77.8,4,11,1,10,11,39,17,1,Matches
1808,Angelo Ogbonna,ITA,DF,West Ham,Premier League,30,1988,20.8,31,13,23,6,2,14,23,60.9,9,29,19,10,35,66,101,0,Matches
1809,Dani Ojeda,ESP,"MF,DF",Leganés,La Liga,23,1994,2.1,3,2,2,0,1,1,3,33.3,2,2,0,2,2,5,2,0,Matches
1810,Sheyi Ojo,ENG,"FW,MF",Reims,Ligue 1,21,1997,5.2,8,6,2,4,2,2,8,25.0,6,1,0,1,3,11,2,0,Matches
1811,Stefano Okaka,ITA,"FW,MF",Watford,Premier League,28,1989,0.3,0,0,0,0,0,0,0,,0,1,0,1,0,0,0,0,Matches
1812,Stefano Okaka,ITA,FW,Udinese,Serie A,28,1989,10.8,13,7,4,5,4,2,8,25.0,6,6,1,5,0,13,16,1,Matches
1813,Shinji Okazaki,JPN,"MF,FW",Leicester City,Premier League,32,1986,3.2,5,5,2,3,0,0,1,0.0,1,7,1,6,2,7,1,0,Matches
1814,Chima Okoroji,NGA,"DF,MF",Freiburg,Bundesliga,21,1997,1.2,3,0,1,1,1,1,1,100.0,0,0,0,0,1,4,1,0,Matches
1815,Orji Okwonkwo,NGA,FW,Bologna,Serie A,20,1998,2.9,4,3,1,2,1,2,2,100.0,0,0,0,0,1,5,0,0,Matches
1816,Lucas Olaza,URU,DF,Celta Vigo,La Liga,24,1994,10.0,29,18,19,8,2,14,18,77.8,4,13,6,7,8,37,18,0,Matches
1817,Oier Olazábal,ESP,GK,Levante,La Liga,28,1989,21.0,1,1,1,0,0,1,2,50.0,1,1,0,1,1,2,15,2,Matches
1818,Kiko Olivas,ESP,DF,Valladolid,La Liga,29,1988,34.4,51,38,35,15,1,22,48,45.8,26,31,18,13,46,97,173,2,Matches
1819,Paulo Oliveira,POR,DF,Eibar,La Liga,26,1992,24.9,49,39,33,16,0,28,44,63.6,16,25,10,15,36,85,116,0,Matches
1820,Mathías Olivera,URU,"DF,MF",Getafe,La Liga,20,1997,11.2,24,17,11,8,5,10,18,55.6,8,25,2,23,10,34,22,0,Matches
1821,Alexandre Olliero,FRA,GK,Nantes,Ligue 1,22,1996,1.0,0,0,0,0,0,0,0,,0,0,0,0,0,0,0,0,Matches
1822,Robin Olsen,SWE,GK,Roma,Serie A,28,1990,27.0,0,0,0,0,0,0,1,0.0,1,1,0,1,0,0,10,4,Matches
1823,Stephane Omeonga,BEL,MF,Genoa,Serie A,22,1996,0.6,1,1,1,0,0,0,1,0.0,1,1,0,1,0,1,2,0,Matches
1824,Kenneth Omeruo,NGA,DF,Leganés,La Liga,24,1993,27.0,49,27,41,8,0,20,29,69.0,9,23,11,12,37,86,159,3,Matches
1825,Prince Oniangué,CGO,MF,Caen,Ligue 1,29,1988,26.0,59,33,22,34,3,24,57,42.1,33,30,10,20,29,88,42,0,Matches
1826,Karim Onisiwo,AUT,"FW,MF",Mainz 05,Bundesliga,26,1992,12.9,23,15,6,12,5,4,12,33.3,8,14,3,11,9,32,13,0,Matches
1827,Nicholas Opoku,GHA,DF,Udinese,Serie A,20,1997,10.1,16,9,15,1,0,10,17,58.8,7,8,5,3,18,34,29,0,Matches
1828,Willi Orban,HUN,DF,RB Leipzig,Bundesliga,25,1992,22.8,49,26,31,15,3,24,38,63.2,14,33,15,18,36,85,140,0,Matches
1829,Fabián Orellana,CHI,"MF,FW",Eibar,La Liga,32,1986,30.4,44,21,14,16,14,9,42,21.4,33,17,0,17,19,63,4,0,Matches
1830,Divock Origi,BEL,FW,Liverpool,Premier League,23,1995,4.1,6,1,2,3,1,1,4,25.0,3,2,0,2,0,6,2,0,Matches
1831,Riccardo Orsolini,ITA,"FW,MF",Bologna,Serie A,21,1997,21.8,40,24,16,18,6,9,39,23.1,30,23,2,21,14,54,25,1,Matches
1832,Yuya Osako,JPN,"FW,MF",Werder Bremen,Bundesliga,28,1990,15.0,23,11,6,12,5,7,22,31.8,15,15,3,12,7,30,8,0,Matches
1833,David Ospina,COL,GK,Napoli,Serie A,29,1988,16.2,1,0,1,0,0,1,1,100.0,0,0,0,0,0,1,7,1,Matches
1834,Matthias Ostrzolek,GER,DF,Hannover 96,Bundesliga,28,1990,16.3,32,18,24,8,0,20,33,60.6,13,20,5,15,26,58,44,2,Matches
1835,Nicolás Otamendi,ARG,DF,Manchester City,Premier League,30,1988,13.7,24,14,17,6,1,5,9,55.6,4,6,4,2,29,53,56,1,Matches
1836,Otávio,BRA,MF,Bordeaux,Ligue 1,24,1994,31.9,127,74,59,64,4,49,109,45.0,60,45,11,34,43,170,54,1,Matches
1837,David Otto,GER,"MF,FW",Hoffenheim,Bundesliga,19,1999,0.3,2,1,1,1,0,0,1,0.0,1,0,0,0,0,2,0,0,Matches
1838,Remi Oudin,FRA,"FW,MF",Reims,Ligue 1,21,1996,29.0,51,32,25,18,8,20,45,44.4,25,29,5,24,42,93,34,0,Matches
1839,Adam Ounas,ALG,"MF,FW",Napoli,Serie A,21,1996,6.0,5,2,0,3,2,2,11,18.2,9,6,0,6,2,7,0,1,Matches
1840,Reece Oxford,ENG,DF,Augsburg,Bundesliga,19,1998,5.6,12,9,9,3,0,4,6,66.7,2,10,9,1,11,23,39,0,Matches
1841,Alex Oxlade-Chamberlain,ENG,MF,Liverpool,Premier League,24,1993,0.2,1,1,0,1,0,1,1,100.0,0,0,0,0,1,2,0,0,Matches
1842,Mikel Oyarzabal,ESP,"FW,MF",Real Sociedad,La Liga,21,1997,35.0,36,20,15,15,6,12,49,24.5,37,54,3,51,14,50,26,0,Matches
1843,Ambroise Oyongo,CMR,DF,Montpellier,Ligue 1,27,1991,23.7,44,21,23,16,5,20,38,52.6,18,26,6,20,38,82,60,0,Matches
1844,Berkay Özcan,TUR,"MF,DF",Stuttgart,Bundesliga,20,1998,0.6,0,0,0,0,0,0,0,,0,1,0,1,0,0,0,0,Matches
1845,Ramazan Özcan,AUT,GK,Leverkusen,Bundesliga,34,1984,2.0,0,0,0,0,0,0,0,,0,0,0,0,1,1,2,0,Matches
1846,Mesut Özil,GER,"MF,FW",Arsenal,Premier League,29,1988,19.3,12,5,6,3,3,3,21,14.3,18,10,2,8,4,16,5,0,Matches
1847,Levin Öztunalı,GER,"MF,FW",Mainz 05,Bundesliga,22,1996,10.2,17,7,5,9,3,4,18,22.2,14,14,2,12,7,24,10,0,Matches
1848,Pablo,BRA,DF,Bordeaux,Ligue 1,27,1991,21.5,26,15,22,3,1,13,23,56.5,10,28,22,6,32,58,173,2,Matches
1849,Fernando Pacheco,ESP,GK,Alavés,La Liga,26,1992,35.0,0,0,0,0,0,0,1,0.0,1,0,0,0,1,1,23,0,Matches
1850,Gonçalo Paciência,POR,FW,Eint Frankfurt,Bundesliga,23,1994,4.3,3,2,0,2,1,1,2,50.0,1,8,1,7,0,3,1,0,Matches
1851,Simone Padoin,ITA,"DF,MF",Cagliari,Serie A,34,1984,21.3,34,25,12,18,4,14,33,42.4,19,18,5,13,14,48,54,0,Matches
1852,Luca Paganini,ITA,"DF,MF",Frosinone,Serie A,25,1993,12.5,25,13,8,13,4,8,23,34.8,15,19,4,15,19,44,17,1,Matches
1853,Marko Pajač,CRO,"FW,DF",Empoli,Serie A,25,1993,8.2,7,7,2,3,2,5,11,45.5,6,3,0,3,7,14,18,0,Matches
1854,Marko Pajač,CRO,DF,Cagliari,Serie A,25,1993,1.1,1,1,0,0,1,0,0,,0,1,1,0,1,2,3,0,Matches
1855,Vincent Pajot,FRA,MF,Angers,Ligue 1,27,1990,7.9,18,14,6,8,4,4,14,28.6,10,9,0,9,8,26,6,0,Matches
1856,Rodrigo Palacio,ARG,FW,Bologna,Serie A,36,1982,25.9,24,13,8,12,4,4,34,11.8,30,35,0,35,5,29,13,0,Matches
1857,Federico Palacios Martínez,GER,"MF,FW",Nürnberg,Bundesliga,23,1995,10.5,21,10,11,8,2,10,20,50.0,10,10,0,10,9,30,4,0,Matches
1858,Sergi Palencia,ESP,DF,Bordeaux,Ligue 1,22,1996,22.1,74,50,46,20,8,27,55,49.1,28,22,3,19,17,91,70,1,Matches
1859,Nicolas Pallois,FRA,DF,Nantes,Ligue 1,30,1987,24.0,77,48,60,17,0,40,69,58.0,29,30,14,16,34,111,114,0,Matches
1860,Emerson Palmieri,ITA,DF,Chelsea,Premier League,23,1994,7.4,14,9,6,5,3,6,10,60.0,4,11,1,10,8,22,14,0,Matches
1861,Alberto Paloschi,ITA,FW,SPAL,Serie A,28,1990,9.6,13,9,3,5,5,1,2,50.0,1,2,0,2,1,14,0,0,Matches
1862,Goran Pandev,MKD,"FW,MF",Genoa,Serie A,35,1983,12.5,14,10,0,10,4,2,8,25.0,6,7,0,7,1,15,3,0,Matches
1863,Mickaël Panos,FRA,DF,Saint-Étienne,Ligue 1,21,1997,0.3,1,0,0,1,0,1,2,50.0,1,2,0,2,1,2,0,0,Matches
1864,Sokratis Papastathopoulos,GRE,DF,Arsenal,Premier League,30,1988,24.4,42,25,30,11,1,15,28,53.6,13,34,17,17,26,68,112,1,Matches
1865,Elhadji Pape Diaw,SEN,DF,Angers,Ligue 1,23,1994,0.2,0,0,0,0,0,0,0,,0,0,0,0,1,1,0,0,Matches
1866,Lucas Paquetá,BRA,MF,Milan,Serie A,20,1997,9.4,18,9,9,8,1,7,24,29.2,17,12,0,12,4,22,11,2,Matches
1867,Gaëtan Paquiez,FRA,DF,Nîmes,Ligue 1,24,1994,14.8,43,29,30,10,3,23,48,47.9,25,24,6,18,22,65,50,0,Matches
1868,Rubén Pardo,ESP,"MF,FW",Real Sociedad,La Liga,25,1992,15.2,11,7,2,9,0,4,17,23.5,13,14,6,8,21,32,9,0,Matches
1869,Leandro Paredes,ARG,MF,Paris S-G,Ligue 1,24,1994,13.9,34,19,16,15,3,13,30,43.3,17,17,5,12,14,48,20,2,Matches
1870,Daniel Parejo,ESP,MF,Valencia,La Liga,29,1989,34.0,73,42,41,24,8,31,90,34.4,59,41,7,34,46,119,26,2,Matches
1871,Vittorio Parigini,ITA,"MF,DF",Torino,Serie A,22,1996,4.2,11,10,3,6,2,6,9,66.7,3,3,0,3,1,12,5,0,Matches
1872,Marco Parolo,ITA,MF,Lazio,Serie A,33,1985,28.5,68,45,24,37,7,18,56,32.1,38,48,11,37,28,96,56,0,Matches
1873,Thomas Partey,GHA,MF,Atlético Madrid,La Liga,25,1993,23.0,66,42,32,25,9,21,49,42.9,28,26,5,21,49,115,22,2,Matches
1874,Mario Pašalić,CRO,MF,Atalanta,Serie A,23,1995,18.0,32,19,9,13,10,7,29,24.1,22,19,4,15,12,44,14,1,Matches
1875,Manuel Pasqual,ITA,DF,Empoli,Serie A,36,1982,14.9,26,19,12,11,3,17,45,37.8,28,7,0,7,11,37,31,0,Matches
1876,Javier Pastore,ARG,"MF,FW",Roma,Serie A,29,1989,6.6,10,4,4,3,3,4,16,25.0,12,7,0,7,3,13,5,0,Matches
1877,Callum Paterson,SCO,"FW,MF",Cardiff City,Premier League,23,1994,22.2,21,14,7,7,7,5,26,19.2,21,23,2,21,8,29,29,0,Matches
1878,Patric,ESP,DF,Lazio,Serie A,25,1993,12.1,19,11,8,8,3,8,15,53.3,7,14,7,7,12,31,29,1,Matches
1879,Rui Patrício,POR,GK,Wolves,Premier League,30,1988,37.0,2,0,2,0,0,2,3,66.7,1,0,0,0,1,3,7,4,Matches
1880,Paulinho,BRA,"FW,MF",Leverkusen,Bundesliga,18,2000,2.0,4,4,2,2,0,1,2,50.0,1,3,0,3,2,6,0,1,Matches
1881,Gabriel Paulista,BRA,DF,Valencia,La Liga,27,1990,29.1,29,16,20,6,3,14,28,50.0,14,37,21,16,70,99,162,1,Matches
1882,Benjamin Pavard,FRA,DF,Stuttgart,Bundesliga,22,1996,29.0,28,20,21,6,1,12,19,63.2,7,27,19,8,48,76,189,2,Matches
1883,Jiří Pavlenka,CZE,GK,Werder Bremen,Bundesliga,26,1992,33.1,3,0,3,0,0,3,6,50.0,3,1,0,1,3,6,14,1,Matches
1884,Mateo Pavlović,BIH,DF,Angers,Ligue 1,28,1990,27.7,26,18,24,2,0,12,24,50.0,12,37,29,8,20,46,164,2,Matches
1885,Leonardo Pavoletti,ITA,FW,Cagliari,Serie A,29,1988,30.4,32,21,6,17,9,6,16,37.5,10,12,3,9,7,39,26,0,Matches
1886,Dimitri Payet,FRA,"MF,FW",Marseille,Ligue 1,31,1987,21.2,11,9,2,8,1,5,22,22.7,17,14,0,14,8,19,8,0,Matches
1887,Nehuén Paz,ARG,DF,Bologna,Serie A,25,1993,1.3,2,1,2,0,0,1,2,50.0,1,3,1,2,0,2,2,0,Matches
1888,Alfonso Pedraza,ESP,"DF,FW",Villarreal,La Liga,22,1996,23.3,59,44,34,19,6,22,62,35.5,40,33,7,26,29,88,55,0,Matches
1889,Pedro,ESP,FW,Chelsea,Premier League,31,1987,19.8,27,14,11,10,6,9,35,25.7,26,13,2,11,18,45,8,1,Matches
1890,João Pedro,ITA,"FW,MF",Cagliari,Serie A,26,1992,28.4,17,12,4,8,5,4,11,36.4,7,14,5,9,6,23,14,0,Matches
1891,Adrià Pedrosa,ESP,DF,Espanyol,La Liga,20,1998,8.5,14,9,11,2,1,7,14,50.0,7,10,4,6,8,22,27,0,Matches
1892,Stef Peeters,BEL,MF,Caen,Ligue 1,26,1992,4.5,15,8,8,4,3,4,11,36.4,7,1,0,1,6,21,1,0,Matches
1893,Jordan Pefok,USA,FW,Rennes,Ligue 1,22,1996,6.8,6,2,0,3,3,2,4,50.0,2,7,2,5,4,10,5,0,Matches
1894,Gianluca Pegolo,ITA,GK,Sassuolo,Serie A,37,1981,2.3,0,0,0,0,0,0,0,,0,0,0,0,0,0,0,0,Matches
1895,Peter Pekarík,SVK,DF,Hertha BSC,Bundesliga,31,1986,2.4,2,1,1,1,0,1,3,33.3,2,2,1,1,1,3,5,0,Matches
1896,Pelé,GNB,MF,Monaco,Ligue 1,26,1991,5.2,8,7,3,5,0,2,6,33.3,4,2,1,1,3,11,10,0,Matches
1897,Yohann Pelé,FRA,GK,Marseille,Ligue 1,35,1982,7.6,0,0,0,0,0,0,2,0.0,2,0,0,0,0,0,1,1,Matches
1898,Maxime Pélican,FRA,"FW,MF",Nice,Ligue 1,20,1998,1.0,1,1,0,1,0,0,0,,0,1,0,1,0,1,0,0,Matches
1899,Pietro Pellegri,ITA,"FW,MF",Monaco,Ligue 1,17,2001,0.9,1,1,0,0,1,0,0,,0,0,0,0,0,1,0,0,Matches
1900,Lorenzo Pellegrini,ITA,MF,Roma,Serie A,22,1996,20.2,39,23,16,18,5,10,30,33.3,20,20,2,18,12,51,21,0,Matches
1901,Luca Pellegrini,ITA,DF,Cagliari,Serie A,19,1999,10.4,28,19,16,11,1,14,25,56.0,11,13,3,10,18,46,22,0,Matches
1902,Luca Pellegrini,ITA,DF,Roma,Serie A,19,1999,1.8,1,1,1,0,0,1,2,50.0,1,2,1,1,3,4,2,0,Matches
1903,Théo Pellenard,FRA,DF,Angers,Ligue 1,24,1994,5.5,11,6,7,2,2,5,8,62.5,3,6,2,4,5,16,16,0,Matches
1904,Sergio Pellissier,ITA,FW,Chievo,Serie A,39,1979,10.6,4,3,1,1,2,3,4,75.0,1,8,1,7,2,6,8,0,Matches
1905,Andy Pelmard,FRA,DF,Nice,Ligue 1,18,2000,3.1,5,5,3,2,0,1,4,25.0,3,0,0,0,3,8,3,0,Matches
1906,Lee Peltier,ENG,DF,Cardiff City,Premier League,31,1986,17.2,39,25,27,11,1,15,27,55.6,12,18,12,6,18,57,60,0,Matches
1907,Federico Peluso,ITA,DF,Sassuolo,Serie A,34,1984,15.1,23,14,15,5,3,13,16,81.3,3,8,3,5,23,46,70,0,Matches
1908,Rubén Peña,ESP,DF,Eibar,La Liga,27,1991,29.7,63,46,24,27,12,24,53,45.3,29,37,9,28,35,98,57,0,Matches
1909,Nicolas Pépé,CIV,"FW,MF",Lille,Ligue 1,23,1995,36.9,27,10,6,15,6,8,35,22.9,27,33,0,33,13,40,11,1,Matches
1910,Pepín,EQG,MF,Parma,Serie A,21,1996,0.9,4,2,3,1,0,1,4,25.0,3,0,0,0,3,7,0,0,Matches
1911,Andreas Pereira,BRA,MF,Manchester Utd,Premier League,22,1996,6.7,8,6,5,2,1,4,15,26.7,11,9,2,7,11,19,8,1,Matches
1912,Matheus Pereira,POR,"MF,FW",Nürnberg,Bundesliga,22,1996,13.7,16,11,4,8,4,2,13,15.4,11,15,2,13,14,30,7,0,Matches
1913,Pedro Pereira,POR,"DF,FW",Genoa,Serie A,20,1998,15.4,20,14,15,2,3,11,19,57.9,8,10,5,5,14,34,55,1,Matches
1914,Ricardo Pereira,POR,"DF,FW",Leicester City,Premier League,24,1993,34.7,118,66,66,40,12,54,112,48.2,58,60,6,54,60,178,130,1,Matches
1915,Roberto Pereyra,ARG,MF,Watford,Premier League,27,1991,31.3,21,12,10,10,1,7,24,29.2,17,26,0,26,24,45,27,2,Matches
1916,Ayoze Pérez,ESP,"MF,FW",Newcastle Utd,Premier League,25,1993,32.4,59,22,24,28,7,17,63,27.0,46,55,4,51,42,101,33,1,Matches
1917,Carles Pérez,ESP,FW,Barcelona,La Liga,20,1998,0.2,0,0,0,0,0,0,0,,0,1,0,1,0,0,0,0,Matches
1918,Hernán Pérez,PAR,"FW,MF",Espanyol,La Liga,29,1989,8.8,13,10,8,3,2,6,27,22.2,21,14,3,11,5,18,13,0,Matches
1919,Lucas Pérez,ESP,"FW,MF",West Ham,Premier League,29,1988,5.3,6,4,3,2,1,1,3,33.3,2,2,1,1,2,8,2,0,Matches
1920,Rubén Pérez,ESP,MF,Leganés,La Liga,29,1989,27.5,71,42,27,40,4,32,80,40.0,48,35,8,27,40,111,34,1,Matches
1921,Stipe Perica,CRO,FW,Frosinone,Serie A,23,1995,5.3,5,3,2,2,1,1,3,33.3,2,3,1,2,0,5,4,0,Matches
1922,Mattia Perin,ITA,GK,Juventus,Serie A,25,1992,9.0,0,0,0,0,0,0,0,,0,0,0,0,0,0,3,2,Matches
1923,Ivan Perišić,CRO,FW,Inter,Serie A,29,1989,30.0,34,26,7,20,7,16,51,31.4,35,40,4,36,23,57,55,0,Matches
1924,Diego Perotti,ARG,"FW,MF",Roma,Serie A,30,1988,7.4,14,12,5,5,4,6,19,31.6,13,4,0,4,4,18,2,0,Matches
1925,Loïc Perrin,FRA,DF,Saint-Étienne,Ligue 1,32,1985,30.0,53,36,34,17,2,20,33,60.6,13,37,24,13,44,97,118,2,Matches
1926,Pavao Pervan,AUT,GK,Wolfsburg,Bundesliga,30,1987,8.5,0,0,0,0,0,0,0,,0,0,0,0,0,0,3,1,Matches
1927,Matteo Pessina,ITA,"MF,FW",Atalanta,Serie A,21,1997,2.6,4,2,0,4,0,2,3,66.7,1,2,1,1,0,4,4,0,Matches
1928,Andrea Petagna,ITA,FW,SPAL,Serie A,23,1995,33.7,15,6,5,5,5,2,9,22.2,7,23,8,15,4,19,15,0,Matches
1929,Nils Petersen,GER,FW,Freiburg,Bundesliga,29,1988,21.4,29,21,10,16,3,4,24,16.7,20,28,2,26,13,42,34,0,Matches
1930,Ondřej Petrák,CZE,MF,Nürnberg,Bundesliga,26,1992,18.0,36,24,17,18,1,14,25,56.0,11,18,4,14,40,76,22,0,Matches
1931,Germán Pezzella,ARG,DF,Fiorentina,Serie A,27,1991,31.7,56,36,42,13,1,31,51,60.8,20,42,30,12,60,116,159,1,Matches
1932,Giuseppe Pezzella,ITA,DF,Udinese,Serie A,20,1997,2.0,5,4,4,1,0,2,8,25.0,6,2,1,1,1,6,9,0,Matches
1933,Giuseppe Pezzella,ITA,"DF,MF",Genoa,Serie A,20,1997,1.2,2,1,1,1,0,0,0,,0,1,0,1,1,3,4,0,Matches
1934,Matthias Phaeton,GLP,"FW,MF",Guingamp,Ligue 1,18,2000,0.6,1,1,0,1,0,0,0,,0,0,0,0,0,1,0,0,Matches
1935,Maximilian Philipp,GER,"FW,MF",Dortmund,Bundesliga,24,1994,8.4,7,5,3,4,0,2,9,22.2,7,10,0,10,3,10,6,0,Matches
1936,Lebogang Phiri,RSA,MF,Guingamp,Ligue 1,23,1994,21.4,60,38,16,41,3,24,43,55.8,19,26,3,23,29,89,19,0,Matches
1937,Krzysztof Piątek,POL,FW,Genoa,Serie A,23,1995,17.7,9,4,2,5,2,1,15,6.7,14,18,3,15,3,12,19,0,Matches
1938,Krzysztof Piątek,POL,FW,Milan,Serie A,23,1995,15.3,8,6,2,1,5,3,10,30.0,7,7,2,5,1,9,15,0,Matches
1939,Pablo Piatti,ARG,"FW,MF",Espanyol,La Liga,29,1989,8.3,21,15,8,10,3,8,16,50.0,8,15,0,15,2,23,8,0,Matches
1940,Lucas Piazon,BRA,"MF,FW",Chievo,Serie A,24,1994,0.9,2,0,1,1,0,0,2,0.0,2,1,0,1,1,3,0,0,Matches
1941,Cristiano Piccini,ITA,DF,Valencia,La Liga,25,1992,20.8,32,23,25,7,0,13,26,50.0,13,27,7,20,27,59,64,1,Matches
1942,Roberto Piccoli,ITA,"FW,MF",Atalanta,Serie A,17,2001,0.5,2,2,0,1,1,1,1,100.0,0,1,0,1,0,2,0,0,Matches
1943,Jordan Pickford,ENG,GK,Everton,Premier League,24,1994,38.0,0,0,0,0,0,0,0,,0,0,0,0,0,0,20,8,Matches
1944,Jérémy Pied,FRA,DF,Lille,Ligue 1,29,1989,5.2,12,8,5,6,1,3,9,33.3,6,8,1,7,5,17,13,0,Matches
1945,Ronaël Pierre-Gabriel,FRA,DF,Monaco,Ligue 1,20,1998,3.9,13,8,10,2,1,9,10,90.0,1,3,1,2,3,16,18,0,Matches
1946,Erik Pieters,NED,DF,Amiens,Ligue 1,29,1988,14.0,49,28,28,18,3,25,33,75.8,8,21,13,8,17,66,56,0,Matches
1947,Tomás Pina Isla,ESP,MF,Alavés,La Liga,30,1987,26.0,64,41,23,36,5,18,46,39.1,28,15,4,11,41,105,43,1,Matches
1948,Andrea Pinamonti,ITA,FW,Frosinone,Serie A,19,1999,18.1,14,6,6,5,3,4,20,20.0,16,16,3,13,5,19,17,0,Matches
1949,Carlo Pinsoglio,ITA,GK,Juventus,Serie A,28,1990,1.0,0,0,0,0,0,0,0,,0,0,0,0,0,0,0,0,Matches
1950,Virgile Pinson,FRA,MF,Reims,Ligue 1,22,1996,0.1,0,0,0,0,0,0,0,,0,0,0,0,0,0,0,0,Matches
1951,Lenny Pintor,FRA,FW,Lyon,Ligue 1,17,2000,0.0,0,0,0,0,0,0,0,,0,0,0,0,0,0,0,0,Matches
1952,Gerard Piqué,ESP,DF,Barcelona,La Liga,31,1987,35.0,42,27,25,17,0,24,37,64.9,13,41,27,14,36,78,154,5,Matches
1953,Facundo Píriz,URU,"MF,FW",Montpellier,Ligue 1,28,1990,1.3,9,6,3,4,2,4,9,44.4,5,2,1,1,0,9,2,0,Matches
1954,Fabio Pisacane,ITA,DF,Cagliari,Serie A,32,1986,25.2,33,17,22,8,3,18,31,58.1,13,36,23,13,23,56,108,0,Matches
1955,Łukasz Piszczek,POL,DF,Dortmund,Bundesliga,33,1985,19.5,57,36,34,15,8,18,33,54.5,15,26,3,23,39,96,69,0,Matches
1956,Claudio Pizarro,PER,FW,Werder Bremen,Bundesliga,39,1978,7.7,10,6,4,2,4,4,7,57.1,3,14,1,13,1,11,7,0,Matches
1957,Marko Pjaca,CRO,"FW,MF",Fiorentina,Serie A,23,1995,8.3,9,4,3,4,2,2,6,33.3,4,2,0,2,7,16,6,0,Matches
1958,Miralem Pjanić,BIH,MF,Juventus,Serie A,28,1990,25.3,41,20,15,18,8,16,59,27.1,43,34,6,28,36,77,19,2,Matches
1959,Carles Planas,ESP,DF,Girona,La Liga,27,1991,4.7,12,6,7,5,0,4,11,36.4,7,2,0,2,4,16,15,0,Matches
1960,Óscar Plano,ESP,"MF,FW",Valladolid,La Liga,27,1991,29.9,63,45,23,28,12,14,48,29.2,34,19,3,16,22,85,28,1,Matches
1961,Jaroslav Plašil,CZE,MF,Bordeaux,Ligue 1,36,1982,16.0,34,26,11,20,3,18,44,40.9,26,21,5,16,19,53,28,1,Matches
1962,Marvin Plattenhardt,GER,DF,Hertha BSC,Bundesliga,26,1992,21.4,27,21,12,10,5,14,21,66.7,7,18,3,15,7,34,56,0,Matches
1963,Stiven Plaza,ECU,"FW,MF",Valladolid,La Liga,19,1999,0.4,0,0,0,0,0,0,0,,0,0,0,0,0,0,0,0,Matches
1964,Alassane Pléa,FRA,FW,Gladbach,Bundesliga,25,1993,27.8,14,10,7,4,3,5,22,22.7,17,17,2,15,3,17,15,2,Matches
1965,Luca Plogmann,GER,GK,Werder Bremen,Bundesliga,18,2000,0.4,0,0,0,0,0,0,0,,0,0,0,0,0,0,0,0,Matches
1966,Morgan Poaty,CGO,MF,Montpellier,Ligue 1,21,1997,1.0,1,1,1,0,0,0,0,,0,1,0,1,0,1,2,0,Matches
1967,Paul Pogba,FRA,MF,Manchester Utd,Premier League,25,1993,33.4,47,30,21,21,5,17,43,39.5,26,30,9,21,18,65,39,0,Matches
1968,Denis-Will Poha,FRA,MF,Rennes,Ligue 1,21,1997,0.3,0,0,0,0,0,0,1,0.0,1,0,0,0,1,1,1,0,Matches
1969,Andrea Poli,ITA,MF,Bologna,Serie A,28,1989,21.5,65,47,30,28,7,24,67,35.8,43,36,5,31,35,100,13,2,Matches
1970,Matteo Politano,ITA,FW,Inter,Serie A,24,1993,28.3,18,7,9,4,5,8,30,26.7,22,18,0,18,14,32,10,1,Matches
1971,Pierre-Yves Polomat,FRA,DF,Saint-Étienne,Ligue 1,24,1993,10.6,18,13,11,6,1,10,18,55.6,8,4,2,2,21,39,27,0,Matches
1972,Giacomo Poluzzi,ITA,GK,SPAL,Serie A,30,1988,0.1,0,0,0,0,0,0,0,,0,0,0,0,0,0,0,0,Matches
1973,Pere Pons,ESP,MF,Girona,La Liga,25,1993,31.0,83,46,34,38,11,30,82,36.6,52,48,12,36,35,118,39,0,Matches
1974,Pedro Porro,ESP,DF,Girona,La Liga,18,1999,24.6,51,31,28,16,7,32,80,40.0,48,36,2,34,39,90,60,1,Matches
1975,Manolo Portanova,ITA,MF,Juventus,Serie A,18,2000,0.4,1,1,0,1,0,0,1,0.0,1,2,0,2,1,2,2,0,Matches
1976,Francisco Portillo,ESP,MF,Getafe,La Liga,28,1990,22.2,26,16,6,15,5,9,29,31.0,20,14,0,14,17,43,9,0,Matches
1977,Portu,ESP,"FW,MF",Girona,La Liga,26,1992,31.3,33,24,8,15,10,12,43,27.9,31,16,1,15,8,41,5,0,Matches
1978,Stefan Posch,AUT,DF,Hoffenheim,Bundesliga,21,1997,15.6,45,32,28,15,2,17,28,60.7,11,26,11,15,21,66,58,0,Matches
1979,Sergio Postigo,ESP,DF,Levante,La Liga,29,1988,16.1,25,15,22,3,0,15,19,78.9,4,21,12,9,20,45,77,0,Matches
1980,Yussuf Poulsen,DEN,FW,RB Leipzig,Bundesliga,24,1994,27.2,20,10,5,10,5,3,25,12.0,22,33,2,31,7,27,28,0,Matches
1981,Maxime Poundjé,FRA,DF,Bordeaux,Ligue 1,25,1992,28.2,48,35,34,12,2,31,62,50.0,31,24,5,19,29,77,79,0,Matches
1982,Gaëtan Poussin,FRA,GK,Bordeaux,Ligue 1,19,1999,1.0,0,0,0,0,0,0,0,,0,0,0,0,0,0,0,0,Matches
1983,José Pozo,ESP,MF,Rayo Vallecano,La Liga,22,1996,18.0,13,10,4,5,4,4,25,16.0,21,7,1,6,4,17,6,0,Matches
1984,Dennis Praet,BEL,MF,Sampdoria,Serie A,24,1994,32.1,62,44,30,25,7,27,51,52.9,24,33,4,29,36,98,31,0,Matches
1985,Sanjin Prcić,BIH,MF,Levante,La Liga,24,1993,5.9,18,13,7,9,2,5,11,45.5,6,11,7,4,11,29,11,1,Matches
1986,Sanjin Prcić,BIH,MF,Strasbourg,Ligue 1,24,1993,11.7,19,14,11,7,1,8,18,44.4,10,22,8,14,18,37,7,1,Matches
1987,Nicolas de Préville,FRA,"FW,MF",Bordeaux,Ligue 1,27,1991,14.1,28,19,10,15,3,8,29,27.6,21,23,1,22,10,38,21,1,Matches
1988,Edgar Prib,GER,MF,Hannover 96,Bundesliga,28,1989,2.2,10,9,3,5,2,2,4,50.0,2,4,0,4,2,12,1,0,Matches
1989,Alex Pritchard,ENG,"MF,FW",Huddersfield,Premier League,25,1993,23.1,36,24,10,18,8,10,35,28.6,25,26,2,24,17,53,9,0,Matches
1990,Sebastian Prödl,AUT,DF,Watford,Premier League,31,1987,0.1,0,0,0,0,0,0,0,,0,0,0,0,0,0,0,0,Matches
1991,Quincy Promes,NED,"FW,DF",Sevilla,La Liga,26,1992,17.6,35,25,23,9,3,15,22,68.2,7,19,3,16,25,60,22,1,Matches
1992,Davy Pröpper,NED,MF,Brighton,Premier League,26,1991,28.3,50,28,23,21,6,16,52,30.8,36,21,6,15,53,103,37,0,Matches
1993,Silvio Proto,BEL,GK,Lazio,Serie A,35,1983,2.0,0,0,0,0,0,0,1,0.0,1,0,0,0,0,0,1,0,Matches
1994,Ivan Provedel,ITA,GK,Empoli,Serie A,24,1994,16.0,0,0,0,0,0,0,1,0.0,1,0,0,0,0,0,4,0,Matches
1995,Javi Puado,ESP,"FW,MF",Espanyol,La Liga,20,1998,4.0,2,1,0,2,0,0,7,0.0,7,5,1,4,6,8,4,0,Matches
1996,Manuel Pucciarelli,ITA,FW,Chievo,Serie A,27,1991,3.4,4,2,2,1,1,2,5,40.0,3,5,0,5,3,7,4,0,Matches
1997,Riqui Puig,ESP,MF,Barcelona,La Liga,18,1999,1.7,3,3,0,2,1,2,3,66.7,1,0,0,0,0,3,1,0,Matches
1998,Erick Pulgar,CHI,MF,Bologna,Serie A,24,1994,26.2,65,36,35,23,7,22,73,30.1,51,35,5,30,50,115,54,1,Matches
1999,Jorge Pulido,ESP,DF,Huesca,La Liga,27,1991,30.9,63,42,40,19,4,32,51,62.7,19,39,18,21,50,113,158,0,Matches
2000,Christian Pulisic,USA,FW,Dortmund,Bundesliga,19,1998,10.4,10,6,2,6,2,2,6,33.3,4,12,2,10,6,16,10,0,Matches
2001,Jason Puncheon,ENG,MF,Crystal Palace,Premier League,32,1986,0.1,1,1,1,0,0,0,0,,0,0,0,0,0,1,0,0,Matches
2002,Jason Puncheon,ENG,MF,Huddersfield,Premier League,32,1986,4.2,7,4,1,5,1,1,7,14.3,6,3,1,2,3,10,8,0,Matches
2003,Ignacio Pussetto,ARG,"FW,MF",Udinese,Serie A,22,1995,24.2,65,40,25,30,10,15,43,34.9,28,28,3,25,29,94,34,0,Matches
2004,Fabio Quagliarella,ITA,FW,Sampdoria,Serie A,35,1983,35.5,14,8,6,4,4,2,15,13.3,13,32,1,31,8,22,17,0,Matches
2005,Robin Quaison,SWE,"FW,MF",Mainz 05,Bundesliga,24,1993,24.4,19,12,3,10,6,5,12,41.7,7,9,1,8,7,26,4,0,Matches
2006,Collin Quaner,GER,FW,Huddersfield,Premier League,27,1991,0.4,0,0,0,0,0,0,1,0.0,1,0,0,0,0,0,0,0,Matches
2007,Domingos Quina,POR,MF,Watford,Premier League,18,1999,3.8,9,7,3,5,1,3,11,27.3,8,6,0,6,3,12,1,0,Matches
2008,Xavi Quintillà,ESP,DF,Villarreal,La Liga,21,1996,7.0,10,4,5,4,1,6,12,50.0,6,5,2,3,8,18,17,0,Matches
2009,Dani Raba,ESP,"MF,FW",Villarreal,La Liga,22,1995,2.1,6,5,1,2,3,1,5,20.0,4,1,0,1,1,7,0,0,Matches
2010,Adrien Rabiot,FRA,MF,Paris S-G,Ligue 1,23,1995,11.8,35,20,13,17,5,9,12,75.0,3,9,2,7,10,45,20,0,Matches
2011,Nemanja Radonjić,SRB,"FW,MF",Marseille,Ligue 1,22,1996,7.6,8,5,1,5,2,5,16,31.3,11,3,0,3,5,13,4,0,Matches
2012,Ivan Radovanović,SRB,MF,Genoa,Serie A,29,1988,14.2,20,12,11,8,1,8,17,47.1,9,12,4,8,13,33,20,1,Matches
2013,Ivan Radovanović,SRB,MF,Chievo,Serie A,29,1988,19.0,27,22,20,7,0,11,31,35.5,20,19,7,12,26,53,36,0,Matches
2014,Ionuț Radu,ROU,GK,Genoa,Serie A,21,1997,33.0,0,0,0,0,0,0,1,0.0,1,0,0,0,1,1,11,4,Matches
2015,Ștefan Radu,ROU,DF,Lazio,Serie A,31,1986,24.9,43,27,24,15,4,25,38,65.8,13,20,14,6,42,85,85,1,Matches
2016,Rafael,BRA,DF,Lyon,Ligue 1,28,1990,11.4,31,19,14,12,5,17,24,70.8,7,19,2,17,15,46,30,2,Matches
2017,Raffael,BRA,FW,Gladbach,Bundesliga,33,1985,6.0,8,4,2,4,2,2,7,28.6,5,5,0,5,1,9,0,0,Matches
2018,Rafinha,BRA,"FW,MF",Barcelona,La Liga,25,1993,2.5,8,6,2,3,3,2,2,100.0,0,5,1,4,1,9,2,0,Matches
2019,Rafinha,BRA,DF,Bayern Munich,Bundesliga,32,1985,10.0,15,7,6,6,3,6,14,42.9,8,8,3,5,19,34,11,0,Matches
2020,Andrea Raggi,ITA,DF,Monaco,Ligue 1,34,1984,5.5,7,5,7,0,0,6,6,100.0,0,1,0,1,7,14,21,0,Matches
2021,Baba Rahman,GHA,DF,Reims,Ligue 1,24,1994,10.7,26,20,17,8,1,18,21,85.7,3,21,3,18,16,42,37,2,Matches
2022,Baba Rahman,GHA,DF,Schalke 04,Bundesliga,24,1994,1.8,3,1,1,1,1,1,1,100.0,0,3,0,3,2,5,2,0,Matches
2023,Ivan Rakitić,CRO,MF,Barcelona,La Liga,30,1988,29.4,30,24,10,14,6,12,37,32.4,25,32,8,24,51,81,33,0,Matches
2024,Joe Ralls,ENG,MF,Cardiff City,Premier League,24,1993,21.8,45,23,21,21,3,10,33,30.3,23,21,6,15,29,74,30,0,Matches
2025,Jonás Ramalho,ESP,DF,Girona,La Liga,25,1993,18.0,13,6,12,1,0,8,14,57.1,6,24,11,13,16,29,80,1,Matches
2026,Benito Raman,BEL,"MF,FW",Düsseldorf,Bundesliga,23,1994,18.7,35,20,14,16,5,11,53,20.8,42,30,2,28,15,50,8,0,Matches
2027,Adil Rami,FRA,DF,Marseille,Ligue 1,32,1985,15.7,14,9,12,2,0,8,12,66.7,4,14,14,0,18,32,52,3,Matches
2028,Gastón Ramírez,URU,MF,Sampdoria,Serie A,27,1990,17.5,38,22,12,18,8,11,31,35.5,20,28,4,24,8,46,27,0,Matches
2029,Sandro Ramírez,ESP,"FW,MF",Real Sociedad,La Liga,23,1995,11.7,19,10,7,10,2,4,11,36.4,7,12,1,11,9,28,3,0,Matches
2030,Iván Ramis,ESP,DF,Eibar,La Liga,33,1984,18.6,23,13,10,11,2,17,23,73.9,6,10,5,5,18,41,65,2,Matches
2031,Chris Ramos,ESP,FW,Valladolid,La Liga,21,1997,0.7,1,1,0,0,1,1,1,100.0,0,0,0,0,0,1,1,0,Matches
2032,Sergio Ramos,ESP,DF,Real Madrid,La Liga,32,1986,27.5,41,32,25,12,4,22,39,56.4,17,29,15,14,37,78,90,2,Matches
2033,Aaron Ramsey,WAL,MF,Arsenal,Premier League,27,1990,14.8,34,18,11,15,8,7,25,28.0,18,7,1,6,9,43,3,0,Matches
2034,Kayne Ramsey,ENG,DF,Southampton,Premier League,17,2000,1.0,0,0,0,0,0,0,0,,0,0,0,0,0,0,7,0,Matches
2035,Andrea Ranocchia,ITA,"DF,FW",Inter,Serie A,30,1988,0.7,2,2,1,1,0,0,1,0.0,1,1,0,1,0,2,3,0,Matches
2036,Marcus Rashford,ENG,FW,Manchester Utd,Premier League,20,1997,25.9,24,12,4,12,8,7,29,24.1,22,27,0,27,3,27,24,0,Matches
2037,Milot Rashica,KVX,"FW,MF",Werder Bremen,Bundesliga,22,1996,17.2,24,16,8,11,5,9,24,37.5,15,16,2,14,6,30,6,1,Matches
2038,Jacob Rasmussen,DEN,"DF,MF",Empoli,Serie A,21,1997,11.3,18,12,10,6,2,5,14,35.7,9,18,13,5,12,30,55,1,Matches
2039,Giacomo Raspadori,ITA,DF,Sassuolo,Serie A,18,2000,0.0,0,0,0,0,0,0,0,,0,0,0,0,0,0,0,0,Matches
2040,Yoric Ravet,FRA,"FW,MF",Freiburg,Bundesliga,28,1989,0.8,2,1,1,0,1,1,2,50.0,1,2,1,1,0,2,1,0,Matches
2041,Tim Ream,USA,DF,Fulham,Premier League,30,1987,22.7,23,14,16,7,0,14,28,50.0,14,19,10,9,25,48,80,2,Matches
2042,Ante Rebić,CRO,"FW,MF",Eint Frankfurt,Bundesliga,24,1993,22.0,22,9,5,12,5,5,12,41.7,7,18,1,17,8,30,3,0,Matches
2043,Pedro Rebocho,POR,DF,Guingamp,Ligue 1,23,1995,36.0,61,35,31,22,8,29,54,53.7,25,48,13,35,40,101,92,1,Matches
2044,Arkadiusz Reca,POL,DF,Atalanta,Serie A,23,1995,0.5,2,0,1,0,1,0,1,0.0,1,0,0,0,3,5,0,0,Matches
2045,Recio,ESP,MF,Leganés,La Liga,27,1991,14.3,30,21,14,13,3,6,24,25.0,18,14,2,12,14,44,14,0,Matches
2046,Nathan Redmond,ENG,"MF,FW",Southampton,Premier League,24,1994,36.3,45,22,14,19,12,14,41,34.1,27,54,2,52,20,65,23,1,Matches
2047,Vasco Regini,ITA,"DF,FW",SPAL,Serie A,27,1990,0.9,1,0,0,1,0,1,3,33.3,2,2,1,1,0,1,4,0,Matches
2048,Sergio Reguilón,ESP,DF,Real Madrid,La Liga,21,1996,12.4,25,14,15,9,1,10,21,47.6,11,13,3,10,20,45,41,1,Matches
2049,Bobby Reid,JAM,"FW,MF",Cardiff City,Premier League,25,1993,15.8,16,9,6,7,3,3,8,37.5,5,13,0,13,3,19,12,0,Matches
2050,Pepe Reina,ESP,GK,Milan,Serie A,35,1982,3.7,0,0,0,0,0,0,0,,0,0,0,0,0,0,1,0,Matches
2051,Jeff Reine-Adélaïde,FRA,"FW,MF",Angers,Ligue 1,20,1998,28.4,40,22,18,19,3,16,39,41.0,23,20,0,20,19,59,10,0,Matches
2052,Karim Rekik,NED,DF,Hertha BSC,Bundesliga,23,1994,23.0,36,22,23,12,1,12,18,66.7,6,24,16,8,34,70,88,0,Matches
2053,Loïc Rémy,FRA,FW,Lille,Ligue 1,31,1987,13.4,2,1,0,2,0,0,3,0.0,3,3,1,2,2,4,17,1,Matches
2054,Michael Rensing,GER,GK,Düsseldorf,Bundesliga,34,1984,32.0,2,1,2,0,0,1,5,20.0,4,1,0,1,2,4,13,2,Matches
2055,Marco Reus,GER,"MF,FW",Dortmund,Bundesliga,29,1989,25.7,33,22,11,16,6,6,31,19.4,25,28,1,27,8,41,32,0,Matches
2056,Elvis Rexhbeçaj,GER,MF,Wolfsburg,Bundesliga,20,1997,12.7,28,18,11,12,5,12,24,50.0,12,18,2,16,14,42,21,0,Matches
2057,Diego Reyes,MEX,DF,Leganés,La Liga,25,1992,3.6,7,4,4,3,0,3,4,75.0,1,4,4,0,7,14,17,1,Matches
2058,Baptiste Reynet,FRA,GK,Toulouse,Ligue 1,27,1990,30.0,0,0,0,0,0,0,3,0.0,3,0,0,0,1,1,14,2,Matches
2059,Simon Rhein,GER,MF,Nürnberg,Bundesliga,20,1998,5.5,7,4,7,0,0,2,7,28.6,5,6,1,5,7,14,6,0,Matches
2060,Franck Ribéry,FRA,"MF,FW",Bayern Munich,Bundesliga,35,1983,13.0,15,7,7,6,2,4,10,40.0,6,9,0,9,7,22,1,0,Matches
2061,Declan Rice,ENG,MF,West Ham,Premier League,19,1999,33.4,98,60,35,58,5,38,88,43.2,50,51,12,39,52,150,56,0,Matches
2062,Jazz Richards,WAL,"DF,MF",Cardiff City,Premier League,27,1991,1.5,0,0,0,0,0,0,1,0.0,1,2,1,1,2,2,5,0,Matches
2063,Richarlison,BRA,"FW,MF",Everton,Premier League,21,1997,29.6,49,34,19,20,10,8,24,33.3,16,30,2,28,16,65,39,0,Matches
2064,Marco Richter,GER,"MF,FW",Augsburg,Bundesliga,20,1997,15.8,13,8,4,5,4,7,20,35.0,13,16,1,15,13,26,9,1,Matches
2065,Diego Rico,ESP,"DF,MF",Bournemouth,Premier League,25,1993,6.8,14,9,8,2,4,4,12,33.3,8,13,2,11,14,28,20,0,Matches
2066,Mikel Rico,ESP,MF,Athletic Club,La Liga,33,1984,2.7,5,2,1,4,0,2,7,28.6,5,3,2,1,2,7,3,0,Matches
2067,Sergio Rico,ESP,GK,Fulham,Premier League,24,1993,29.0,1,1,1,0,0,1,1,100.0,0,0,0,0,1,2,13,5,Matches
2068,Asier Riesgo,ESP,GK,Eibar,La Liga,34,1983,14.0,1,1,1,0,0,1,3,33.3,2,0,0,0,0,1,8,1,Matches
2069,Sascha Riether,GER,FW,Schalke 04,Bundesliga,35,1983,0.0,0,0,0,0,0,0,0,,0,0,0,0,0,0,0,0,Matches
2070,Emiliano Rigoni,ARG,"FW,MF",Atalanta,Serie A,25,1993,5.8,6,1,2,2,2,2,6,33.3,4,3,0,3,3,9,3,0,Matches
2071,Luca Rigoni,ITA,MF,Parma,Serie A,33,1984,19.6,42,25,25,15,2,9,26,34.6,17,19,2,17,18,60,39,0,Matches
2072,Nicola Rigoni,ITA,MF,Chievo,Serie A,27,1990,21.7,43,25,22,15,6,22,51,43.1,29,20,5,15,23,66,45,1,Matches
2073,Kévin Rimane,GUF,MF,Paris S-G,Ligue 1,27,1991,0.1,0,0,0,0,0,0,0,,0,0,0,0,0,0,0,0,Matches
2074,Tomás Rincón,VEN,MF,Torino,Serie A,30,1988,31.1,75,44,25,41,9,31,68,45.6,37,35,5,30,42,117,71,1,Matches
2075,Renaud Ripart,FRA,"FW,DF",Nîmes,Ligue 1,25,1993,33.4,76,49,41,22,13,32,76,42.1,44,43,7,36,27,103,79,0,Matches
2076,Mihailo Ristić,SRB,"DF,MF",Montpellier,Ligue 1,22,1995,3.6,14,9,8,5,1,6,10,60.0,4,11,3,8,9,23,6,0,Matches
2077,Matt Ritchie,SCO,"DF,MF",Newcastle Utd,Premier League,28,1989,32.5,70,44,35,27,8,19,47,40.4,28,34,11,23,51,121,76,1,Matches
2078,Cristian Rivera,ESP,MF,Huesca,La Liga,21,1997,18.8,38,25,18,19,1,11,25,44.0,14,21,4,17,31,69,31,0,Matches
2079,Arjen Robben,NED,"FW,MF",Bayern Munich,Bundesliga,34,1984,6.3,3,1,0,3,0,0,1,0.0,1,6,1,5,3,6,0,0,Matches
2080,Rober,ESP,DF,Levante,La Liga,23,1995,31.7,41,29,33,6,2,24,48,50.0,24,52,36,16,51,92,129,2,Matches
2081,Sergi Roberto,ESP,"DF,MF",Barcelona,La Liga,26,1992,23.2,28,20,15,9,4,16,24,66.7,8,18,3,15,43,71,31,0,Matches
2082,Patrick Roberts,ENG,"MF,FW",Girona,La Liga,21,1997,6.7,7,6,5,2,0,3,15,20.0,12,5,0,5,3,10,2,1,Matches
2083,Andrew Robertson,SCO,DF,Liverpool,Premier League,24,1994,35.7,80,49,41,31,8,39,70,55.7,31,33,6,27,29,109,57,3,Matches
2084,Joel Robles,ESP,GK,Betis,La Liga,28,1990,5.0,1,0,1,0,0,1,1,100.0,0,0,0,0,0,1,5,1,Matches
2085,Marc Roca,ESP,MF,Espanyol,La Liga,21,1996,34.6,71,45,36,26,9,28,70,40.0,42,43,21,22,36,107,60,3,Matches
2086,Christopher Rocchia,FRA,DF,Marseille,Ligue 1,20,1998,0.0,0,0,0,0,0,0,0,,0,0,0,0,0,0,1,0,Matches
2087,Kenny Rocha Santos,CPV,MF,Saint-Étienne,Ligue 1,18,2000,0.0,0,0,0,0,0,0,0,,0,0,0,0,0,0,0,0,Matches
2088,Rubén Rochina,ESP,MF,Levante,La Liga,27,1991,20.0,51,33,26,16,9,23,81,28.4,58,29,0,29,21,72,19,1,Matches
2089,Sebastian Rode,GER,MF,Eint Frankfurt,Bundesliga,27,1990,10.3,31,19,17,9,5,16,35,45.7,19,17,0,17,19,50,14,0,Matches
2090,Ronny Rodelin,FRA,"MF,FW",Guingamp,Ligue 1,28,1989,8.8,13,5,2,7,4,3,8,37.5,5,8,1,7,8,21,13,0,Matches
2091,Rodri,ESP,MF,Atlético Madrid,La Liga,22,1996,30.4,103,70,45,50,8,39,75,52.0,36,35,11,24,41,144,68,0,Matches
2092,Rodrigo,ESP,FW,Valencia,La Liga,27,1991,28.1,21,10,6,9,6,3,17,17.6,14,17,1,16,3,24,18,0,Matches
2093,Kévin Rodrigues,POR,DF,Real Sociedad,La Liga,24,1994,5.4,21,11,14,6,1,9,17,52.9,8,13,3,10,8,29,15,0,Matches
2094,Alejandro Rodríguez,ESP,MF,Empoli,Serie A,27,1991,0.3,0,0,0,0,0,0,0,,0,0,0,0,0,0,1,0,Matches
2095,Ángel Rodríguez,ESP,FW,Getafe,La Liga,31,1987,20.2,16,7,1,6,9,6,26,23.1,20,15,1,14,8,24,8,0,Matches
2096,Óscar Rodríguez Arnaiz,ESP,MF,Leganés,La Liga,20,1998,27.8,46,25,26,15,5,16,58,27.6,42,12,2,10,16,62,16,0,Matches
2097,James Rodríguez,COL,MF,Bayern Munich,Bundesliga,27,1991,12.6,12,8,3,4,5,5,19,26.3,14,9,0,9,4,16,1,0,Matches
2098,Ricardo Rodríguez,SUI,DF,Milan,Serie A,25,1992,33.9,57,32,34,21,2,32,39,82.1,7,25,5,20,38,95,98,0,Matches
2099,Marko Rog,CRO,MF,Napoli,Serie A,23,1995,3.7,12,9,3,7,2,5,11,45.5,6,8,2,6,5,17,1,0,Matches
2100,Marko Rog,CRO,MF,Sevilla,La Liga,23,1995,4.0,12,11,4,8,0,5,9,55.6,4,4,0,4,8,20,1,0,Matches
2101,Rogério,BRA,"DF,MF",Sassuolo,Serie A,20,1998,29.7,55,38,35,13,7,30,55,54.5,25,32,7,25,37,92,109,1,Matches
2102,Marcos Rojo,ARG,DF,Manchester Utd,Premier League,28,1990,2.4,5,3,3,2,0,1,6,16.7,5,3,2,1,6,11,9,1,Matches
2103,Diego Rolán,URU,"MF,FW",Leganés,La Liga,25,1993,2.4,6,4,3,3,0,2,9,22.2,7,2,0,2,3,9,3,0,Matches
2104,Diego Rolán,URU,"MF,FW",Alavés,La Liga,25,1993,3.3,7,4,3,1,3,0,2,0.0,2,1,0,1,1,8,4,0,Matches
2105,Rolando,POR,DF,Marseille,Ligue 1,32,1985,8.9,18,7,15,3,0,8,10,80.0,2,8,6,2,11,29,25,0,Matches
2106,Esteban Rolón,ARG,MF,Genoa,Serie A,23,1995,11.6,46,29,14,20,12,20,44,45.5,24,18,2,16,16,62,12,0,Matches
2107,Filippo Romagna,ITA,DF,Cagliari,Serie A,21,1997,16.4,14,9,10,4,0,4,8,50.0,4,20,12,8,19,33,68,0,Matches
2108,Alessio Romagnoli,ITA,DF,Milan,Serie A,23,1995,31.6,34,19,26,6,2,16,19,84.2,3,48,32,16,37,71,173,1,Matches
2109,Alaixys Romao,TOG,MF,Reims,Ligue 1,34,1984,35.1,118,71,61,50,7,43,102,42.2,59,44,16,28,58,176,65,1,Matches
2110,Cristian Romero,ARG,DF,Genoa,Serie A,20,1998,26.0,61,35,38,18,5,27,40,67.5,13,49,27,22,37,98,128,1,Matches
2111,Oriol Romeu,ESP,MF,Southampton,Premier League,26,1991,23.7,81,46,39,38,4,32,77,41.6,45,43,17,26,52,133,44,1,Matches
2112,Rômulo,ITA,"MF,FW",Genoa,Serie A,31,1987,15.0,26,18,9,10,7,7,17,41.2,10,16,3,13,18,44,20,0,Matches
2113,Rômulo,ITA,DF,Lazio,Serie A,31,1987,8.6,10,5,8,2,0,5,7,71.4,2,10,2,8,5,15,13,0,Matches
2114,Cristiano Ronaldo,POR,FW,Juventus,Serie A,33,1985,29.9,10,7,5,4,1,1,11,9.1,10,7,2,5,6,16,32,0,Matches
2115,Facundo Roncaglia,ARG,DF,Valencia,La Liga,31,1987,6.7,13,10,8,5,0,4,6,66.7,2,4,2,2,10,23,22,0,Matches
2116,Facundo Roncaglia,ARG,DF,Celta Vigo,La Liga,31,1987,11.9,34,22,26,8,0,17,24,70.8,7,12,5,7,20,54,51,2,Matches
2117,Salomón Rondón,VEN,FW,Newcastle Utd,Premier League,28,1989,28.9,8,3,2,4,2,4,24,16.7,20,14,3,11,5,13,39,0,Matches
2118,Valentin Rongier,FRA,MF,Nantes,Ligue 1,23,1994,35.8,86,54,24,46,16,26,65,40.0,39,46,6,40,33,119,19,0,Matches
2119,Marten de Roon,NED,MF,Atalanta,Serie A,27,1991,33.1,102,57,32,61,9,34,94,36.2,60,48,9,39,53,155,49,1,Matches
2120,Roberto Rosales,VEN,DF,Espanyol,La Liga,29,1988,19.4,48,31,22,16,10,21,44,47.7,23,19,7,12,22,70,68,0,Matches
2121,Danny Rose,ENG,DF,Tottenham,Premier League,28,1990,20.0,49,31,26,16,7,20,32,62.5,12,24,4,20,24,73,28,3,Matches
2122,Valentin Rosier,FRA,"DF,MF",Dijon,Ligue 1,21,1996,16.2,44,25,22,19,3,16,31,51.6,15,25,4,21,32,76,45,1,Matches
2123,Luca Rossettini,ITA,DF,Chievo,Serie A,33,1985,20.3,26,17,18,8,0,15,20,75.0,5,23,15,8,35,61,114,0,Matches
2124,Francesco Rossi,ITA,GK,Atalanta,Serie A,27,1991,0.0,0,0,0,0,0,0,0,,0,0,0,0,0,0,0,0,Matches
2125,Jérôme Roussillon,FRA,DF,Wolfsburg,Bundesliga,25,1993,27.3,42,29,25,15,2,20,30,66.7,10,50,7,43,31,73,54,0,Matches
2126,Nolan Roux,FRA,FW,Guingamp,Ligue 1,30,1988,17.1,11,9,0,6,5,4,14,28.6,10,6,2,4,4,15,21,0,Matches
2127,Aaron Rowe,ENG,FW,Huddersfield,Premier League,17,2000,0.8,1,0,1,0,0,0,0,,0,0,0,0,1,2,1,0,Matches
2128,Waldo Rubio,ESP,MF,Valladolid,La Liga,22,1995,5.5,4,2,3,1,0,1,6,16.7,5,2,0,2,1,5,8,1,Matches
2129,John Ruddy,ENG,GK,Wolves,Premier League,31,1986,1.0,0,0,0,0,0,0,0,,0,0,0,0,0,0,0,0,Matches
2130,Antonio Rüdiger,GER,DF,Chelsea,Premier League,25,1993,31.9,34,16,27,6,1,15,27,55.6,12,15,8,7,32,66,96,1,Matches
2131,Sebastian Rudy,GER,MF,Schalke 04,Bundesliga,28,1990,15.1,44,24,11,27,6,11,41,26.8,30,23,2,21,15,59,15,0,Matches
2132,Stéphane Ruffier,FRA,GK,Saint-Étienne,Ligue 1,31,1986,37.0,2,2,2,0,0,2,4,50.0,2,0,0,0,0,2,18,3,Matches
2133,Daniele Rugani,ITA,DF,Juventus,Serie A,24,1994,15.0,8,5,5,3,0,2,5,40.0,3,19,14,5,16,24,51,1,Matches
2134,Mário Rui,POR,DF,Napoli,Serie A,27,1991,15.7,24,18,9,12,3,14,25,56.0,11,15,3,12,21,45,38,0,Matches
2135,Abel Ruiz,ESP,FW,Barcelona,La Liga,18,2000,0.2,1,1,1,0,0,1,1,100.0,0,0,0,0,0,1,0,0,Matches
2136,Fabián Ruiz Peña,ESP,MF,Napoli,Serie A,22,1996,22.1,54,33,22,25,7,20,46,43.5,26,23,4,19,21,75,29,2,Matches
2137,Víctor Ruiz,ESP,DF,Villarreal,La Liga,29,1989,21.9,28,19,20,6,2,13,18,72.2,5,28,16,12,38,66,67,1,Matches
2138,Gerónimo Rulli,ARG,GK,Real Sociedad,La Liga,26,1992,27.0,2,1,2,0,0,1,3,33.3,2,1,0,1,1,3,12,6,Matches
2139,Lukas Rupp,GER,"MF,DF",Hoffenheim,Bundesliga,27,1991,0.3,1,1,0,0,1,0,0,,0,0,0,0,0,1,0,0,Matches
2140,Marco Russ,GER,DF,Eint Frankfurt,Bundesliga,32,1985,4.2,7,2,5,2,0,4,6,66.7,2,2,2,0,7,14,8,0,Matches
2141,Mathew Ryan,AUS,GK,Brighton,Premier League,26,1992,34.0,1,0,1,0,0,1,2,50.0,1,0,0,0,0,1,13,1,Matches
2142,Frederik Rønnow,DEN,GK,Eint Frankfurt,Bundesliga,25,1992,1.4,0,0,0,0,0,0,0,,0,0,0,0,0,0,1,0,Matches
2143,Idriss Saadi,ALG,"FW,MF",Strasbourg,Ligue 1,26,1992,0.1,0,0,0,0,0,0,0,,0,0,0,0,0,0,0,0,Matches
2144,Youssouf Sabaly,SEN,DF,Bordeaux,Ligue 1,25,1993,21.2,46,32,32,12,2,25,46,54.3,21,19,2,17,26,72,42,0,Matches
2145,Abdelhamid Sabiri,MAR,FW,Huddersfield,Premier League,21,1996,0.5,2,1,1,1,0,0,0,,0,1,0,1,1,3,0,0,Matches
2146,Marcel Sabitzer,AUT,MF,RB Leipzig,Bundesliga,24,1994,26.1,45,28,17,21,7,18,46,39.1,28,21,2,19,33,78,31,0,Matches
2147,Ihsan Sacko,FRA,FW,Nice,Ligue 1,21,1997,4.9,7,2,2,5,0,2,5,40.0,3,5,0,5,2,9,2,0,Matches
2148,Nuri Şahin,TUR,MF,Werder Bremen,Bundesliga,29,1988,16.4,60,33,22,33,5,23,59,39.0,36,30,3,27,37,97,39,1,Matches
2149,Samuel Şahin-Radlinger,AUT,GK,Hannover 96,Bundesliga,25,1992,1.0,0,0,0,0,0,0,0,,0,1,0,1,0,0,2,0,Matches
2150,Wesley Saïd,FRA,"FW,MF",Dijon,Ligue 1,23,1995,25.0,25,18,6,11,8,5,20,25.0,15,9,0,9,9,34,9,0,Matches
2151,Allan Saint-Maximin,FRA,FW,Nice,Ligue 1,21,1997,32.2,12,6,1,7,4,2,14,14.3,12,11,0,11,4,16,3,0,Matches
2152,Théo Sainte-Luce,FRA,MF,Nîmes,Ligue 1,19,1998,0.0,0,0,0,0,0,0,0,,0,0,0,0,0,0,0,0,Matches
2153,Romain Saïss,MAR,"MF,DF",Wolves,Premier League,28,1990,12.8,39,26,23,14,2,20,37,54.1,17,25,12,13,26,65,61,0,Matches
2154,Samuel Sáiz,ESP,MF,Getafe,La Liga,27,1991,3.4,4,3,0,3,1,2,5,40.0,3,1,0,1,0,4,2,0,Matches
2155,Bukayo Saka,ENG,FW,Arsenal,Premier League,16,2001,0.1,0,0,0,0,0,0,0,,0,0,0,0,0,0,0,0,Matches
2156,Hiroki Sakai,JPN,DF,Marseille,Ligue 1,28,1990,26.4,59,41,30,23,6,29,54,53.7,25,25,10,15,37,96,77,0,Matches
2157,Diafra Sakho,SEN,FW,Rennes,Ligue 1,28,1989,1.6,2,1,0,0,2,0,0,,0,0,0,0,0,2,0,0,Matches
2158,Mamadou Sakho,FRA,DF,Crystal Palace,Premier League,28,1990,26.8,25,16,22,3,0,11,18,61.1,7,26,16,10,41,66,136,2,Matches
2159,Bakary Sako,MLI,FW,Crystal Palace,Premier League,30,1988,0.3,2,1,2,0,0,1,1,100.0,0,0,0,0,0,2,0,0,Matches
2160,Emiliano Sala,ARG,FW,Nantes,Ligue 1,27,1990,15.2,7,5,0,2,5,1,8,12.5,7,8,1,7,2,9,20,0,Matches
2161,Jacopo Sala,ITA,DF,Sampdoria,Serie A,26,1991,16.9,38,23,20,14,4,23,41,56.1,18,11,3,8,20,58,47,2,Matches
2162,Mohamed Salah,EGY,FW,Liverpool,Premier League,26,1992,36.1,21,9,3,11,7,5,16,31.3,11,9,0,9,5,26,6,0,Matches
2163,Bartosz Salamon,POL,DF,Frosinone,Serie A,27,1991,19.2,17,10,12,5,0,6,14,42.9,8,27,19,8,27,44,143,1,Matches
2164,Carlos Salcedo,MEX,DF,Eint Frankfurt,Bundesliga,24,1993,5.1,7,3,4,3,0,4,7,57.1,3,7,3,4,9,16,22,0,Matches
2165,William Saliba,FRA,DF,Saint-Étienne,Ligue 1,17,2001,14.2,32,20,28,4,0,16,24,66.7,8,11,10,1,28,60,44,2,Matches
2166,Yannis Salibur,FRA,"FW,MF",Saint-Étienne,Ligue 1,27,1991,9.8,9,5,1,7,1,1,7,14.3,6,6,0,6,8,17,4,0,Matches
2167,Yannis Salibur,FRA,MF,Guingamp,Ligue 1,27,1991,0.2,0,0,0,0,0,0,0,,0,0,0,0,0,0,0,0,Matches
2168,Roland Sallai,HUN,MF,Freiburg,Bundesliga,21,1997,5.9,12,7,5,5,2,5,13,38.5,8,3,0,3,3,15,8,0,Matches
2169,Edgar Salli,CMR,"FW,MF",Nürnberg,Bundesliga,25,1992,1.3,2,1,1,1,0,0,1,0.0,1,0,0,0,1,3,1,0,Matches
2170,Brice Samba,FRA,GK,Caen,Ligue 1,24,1994,38.0,1,0,1,0,0,0,1,0.0,1,0,0,0,1,2,12,4,Matches
2171,Junior Sambia,FRA,"MF,FW",Montpellier,Ligue 1,21,1996,10.3,15,7,7,7,1,6,15,40.0,9,14,2,12,5,20,3,0,Matches
2172,Paolo Sammarco,ITA,MF,Frosinone,Serie A,35,1983,6.1,16,7,7,6,3,6,9,66.7,3,5,0,5,3,19,1,2,Matches
2173,Frédéric Sammaritano,FRA,"FW,MF",Dijon,Ligue 1,32,1986,6.0,11,5,5,5,1,5,13,38.5,8,8,1,7,8,19,2,1,Matches
2174,Mikel San José,ESP,MF,Athletic Club,La Liga,29,1989,19.3,43,25,19,19,5,15,48,31.3,33,27,6,21,21,64,35,0,Matches
2175,Antonio Sanabria,PAR,FW,Genoa,Serie A,22,1996,8.5,6,3,1,1,4,0,1,0.0,1,8,0,8,4,10,3,0,Matches
2176,Antonio Sanabria,PAR,FW,Betis,La Liga,22,1996,9.0,8,6,0,5,3,1,6,16.7,5,8,2,6,3,11,4,0,Matches
2177,Renato Sanches,POR,MF,Bayern Munich,Bundesliga,20,1997,6.4,5,5,2,1,2,3,10,30.0,7,7,0,7,4,9,2,0,Matches
2178,Alexis Sánchez,CHI,"FW,MF",Manchester Utd,Premier League,29,1988,9.8,17,10,5,9,3,5,13,38.5,8,7,0,7,9,26,2,0,Matches
2179,Carlos Sánchez,COL,MF,West Ham,Premier League,32,1986,2.7,4,3,4,0,0,3,8,37.5,5,1,0,1,1,5,5,2,Matches
2180,Davinson Sánchez,COL,DF,Tottenham,Premier League,22,1996,21.6,37,20,28,9,0,20,37,54.1,17,17,9,8,30,67,103,2,Matches
2181,Javi Sánchez,ESP,DF,Real Madrid,La Liga,21,1997,0.5,1,0,1,0,0,0,0,,0,0,0,0,0,1,4,0,Matches
2182,Víctor Sánchez,ESP,MF,Espanyol,La Liga,30,1987,14.1,45,30,21,17,7,14,67,20.9,53,17,2,15,25,70,25,0,Matches
2183,Jadon Sancho,ENG,"FW,MF",Dortmund,Bundesliga,18,2000,27.3,19,10,7,6,6,10,31,32.3,21,21,1,20,14,33,12,1,Matches
2184,Sandro,BRA,MF,Udinese,Serie A,29,1989,6.6,18,10,10,8,0,7,13,53.8,6,14,5,9,11,29,16,0,Matches
2185,Sandro,BRA,MF,Genoa,Serie A,29,1989,7.9,27,17,12,11,4,9,17,52.9,8,9,4,5,20,47,25,0,Matches
2186,Alex Sandro,BRA,DF,Juventus,Serie A,27,1991,26.5,68,45,28,33,7,21,36,58.3,15,32,8,24,38,106,71,0,Matches
2187,Leroy Sané,GER,FW,Manchester City,Premier League,22,1996,20.7,24,15,8,7,9,2,23,8.7,21,21,2,19,8,32,2,0,Matches
2188,Salif Sané,SEN,DF,Schalke 04,Bundesliga,27,1990,29.0,54,37,34,19,1,27,46,58.7,19,44,29,15,68,122,146,3,Matches
2189,Luca Sangalli,ESP,"MF,FW",Real Sociedad,La Liga,23,1995,11.1,19,13,6,11,2,5,22,22.7,17,9,1,8,5,24,5,0,Matches
2190,Ibrahim Sangaré,CIV,MF,Toulouse,Ligue 1,20,1997,27.4,102,66,50,44,8,32,63,50.8,31,52,20,32,29,131,49,2,Matches
2191,Younousse Sankharé,SEN,MF,Bordeaux,Ligue 1,28,1989,16.4,25,12,2,19,4,6,19,31.6,13,14,0,14,9,34,4,0,Matches
2192,Baissama Sankoh,GUI,"MF,FW",Caen,Ligue 1,26,1992,7.2,4,1,4,0,0,1,4,25.0,3,8,1,7,5,9,16,0,Matches
2193,Yaya Sanogo,FRA,FW,Toulouse,Ligue 1,25,1993,13.8,4,2,0,2,2,2,4,50.0,2,3,0,3,3,7,15,0,Matches
2194,Morgan Sanson,FRA,MF,Marseille,Ligue 1,23,1994,26.7,70,47,27,35,8,21,77,27.3,56,40,1,39,42,112,8,1,Matches
2195,Nicola Sansone,ITA,FW,Bologna,Serie A,26,1991,12.7,29,17,9,14,6,9,27,33.3,18,13,1,12,9,38,4,0,Matches
2196,Nicola Sansone,ITA,"FW,MF",Villarreal,La Liga,26,1991,0.4,0,0,0,0,0,0,0,,0,0,0,0,0,0,0,0,Matches
2197,Baptiste Santamaria,FRA,MF,Angers,Ligue 1,23,1995,36.1,118,60,48,63,7,51,106,48.1,55,41,4,37,57,175,57,2,Matches
2198,Roberto Santamaría,ESP,GK,Huesca,La Liga,33,1985,20.0,0,0,0,0,0,0,0,,0,0,0,0,1,1,12,1,Matches
2199,Federico Santander,PAR,FW,Bologna,Serie A,27,1991,22.9,18,10,6,8,4,2,23,8.7,21,20,2,18,9,27,30,0,Matches
2200,Davide Santon,ITA,DF,Roma,Serie A,27,1991,11.2,14,6,8,6,0,8,12,66.7,4,11,7,4,15,29,27,0,Matches
2201,Michael Santos,URU,"FW,MF",Leganés,La Liga,25,1993,6.2,12,5,1,7,4,2,7,28.6,5,7,1,6,1,13,1,0,Matches
2202,Samir Santos,BRA,DF,Udinese,Serie A,23,1994,20.0,47,33,27,18,2,19,25,76.0,6,18,9,9,34,81,96,0,Matches
2203,Riccardo Saponara,ITA,MF,Sampdoria,Serie A,26,1991,10.1,12,6,2,6,4,3,12,25.0,9,5,1,4,4,16,10,0,Matches
2204,Pablo Sarabia,ESP,"MF,FW",Sevilla,La Liga,26,1992,30.3,30,15,6,15,9,6,47,12.8,41,30,3,27,22,52,20,0,Matches
2205,Marcelo Saracchi,URU,DF,RB Leipzig,Bundesliga,20,1998,7.3,17,11,12,4,1,8,13,61.5,5,12,1,11,11,28,14,0,Matches
2206,Josh Sargent,USA,FW,Werder Bremen,Bundesliga,18,2000,2.4,2,1,1,0,1,2,2,100.0,0,2,0,2,0,2,3,0,Matches
2207,Bouna Sarr,SEN,"DF,MF",Marseille,Ligue 1,26,1992,24.9,67,48,27,27,13,26,42,61.9,16,28,3,25,39,106,56,1,Matches
2208,Ismaila Sarr,SEN,"FW,MF",Rennes,Ligue 1,20,1998,31.0,35,24,16,15,4,17,34,50.0,17,17,2,15,14,49,4,0,Matches
2209,Malang Sarr,FRA,DF,Nice,Ligue 1,19,1999,33.3,59,36,38,17,4,31,57,54.4,26,29,12,17,68,127,107,2,Matches
2210,Lluís Sastre,ESP,MF,Huesca,La Liga,32,1986,1.3,5,3,0,5,0,0,1,0.0,1,0,0,0,1,6,0,0,Matches
2211,Marco Sau,ITA,"MF,FW",Sampdoria,Serie A,30,1987,0.6,0,0,0,0,0,0,0,,0,1,0,1,0,0,0,0,Matches
2212,Marco Sau,ITA,"FW,MF",Cagliari,Serie A,30,1987,6.2,4,2,0,2,2,0,3,0.0,3,5,0,5,1,5,4,0,Matches
2213,Téji Savanier,FRA,MF,Nîmes,Ligue 1,26,1991,31.8,95,58,35,52,8,43,116,37.1,73,32,15,17,64,159,53,2,Matches
2214,Stefan Savić,MNE,DF,Atlético Madrid,La Liga,27,1991,15.5,11,10,9,2,0,7,12,58.3,5,13,9,4,22,33,67,0,Matches
2215,Fabian Schär,SUI,DF,Newcastle Utd,Premier League,26,1991,22.2,60,39,37,19,4,24,50,48.0,26,40,16,24,67,127,145,2,Matches
2216,Ezequiel Schelotto,ITA,DF,Chievo,Serie A,29,1989,1.6,3,0,3,0,0,2,3,66.7,1,1,0,1,2,5,8,0,Matches
2217,Nicolás Schiappacasse,URU,"FW,MF",Parma,Serie A,19,1999,0.9,0,0,0,0,0,0,0,,0,2,0,2,0,0,0,0,Matches
2218,Pasquale Schiattarella,ITA,MF,SPAL,Serie A,31,1987,20.5,43,27,18,21,4,13,38,34.2,25,17,5,12,22,65,25,1,Matches
2219,Patrik Schick,CZE,"FW,MF",Roma,Serie A,22,1996,14.6,11,5,3,5,3,1,19,5.3,18,19,2,17,3,14,15,1,Matches
2220,Julian Schieber,GER,FW,Augsburg,Bundesliga,29,1989,2.9,3,2,1,2,0,0,1,0.0,1,1,0,1,1,4,3,0,Matches
2221,Christopher Schindler,GER,DF,Huddersfield,Premier League,28,1990,36.2,61,36,46,14,1,27,47,57.4,20,69,34,35,70,131,138,4,Matches
2222,Keven Schlotterbeck,GER,DF,Freiburg,Bundesliga,21,1997,8.6,22,16,19,2,1,8,12,66.7,4,17,11,6,13,35,26,0,Matches
2223,Nico Schlotterbeck,GER,DF,Freiburg,Bundesliga,18,1999,2.5,6,6,6,0,0,2,2,100.0,0,3,1,2,5,11,10,0,Matches
2224,Jeffrey Schlupp,GHA,"MF,FW",Crystal Palace,Premier League,25,1992,18.6,41,20,18,18,5,10,27,37.0,17,30,8,22,19,60,27,1,Matches
2225,Kasper Schmeichel,DEN,GK,Leicester City,Premier League,31,1986,38.0,1,1,1,0,0,1,1,100.0,0,0,0,0,3,4,14,3,Matches
2226,Marcel Schmelzer,GER,DF,Dortmund,Bundesliga,30,1988,6.3,10,5,7,2,1,5,9,55.6,4,7,1,6,9,19,14,0,Matches
2227,Jonathan Schmid,FRA,DF,Augsburg,Bundesliga,28,1990,28.0,44,22,23,19,2,16,28,57.1,12,22,8,14,43,87,70,2,Matches
2228,Morgan Schneiderlin,FRA,MF,Everton,Premier League,28,1989,9.3,24,16,11,11,2,6,14,42.9,8,16,3,13,15,39,16,0,Matches
2229,Alessandro Schöpf,AUT,"MF,DF",Schalke 04,Bundesliga,24,1994,11.2,26,16,12,13,1,12,29,41.4,17,14,0,14,9,35,12,0,Matches
2230,Nico Schulz,GER,DF,Hoffenheim,Bundesliga,25,1993,28.2,34,20,19,12,3,15,36,41.7,21,32,4,28,24,58,36,0,Matches
2231,André Schürrle,GER,"FW,MF",Fulham,Premier League,27,1990,18.2,30,19,14,10,6,12,42,28.6,30,16,1,15,8,38,17,1,Matches
2232,Pirmin Schwegler,SUI,MF,Hannover 96,Bundesliga,31,1987,23.1,63,34,30,29,4,34,60,56.7,26,21,5,16,41,104,54,0,Matches
2233,Alexander Schwolow,GER,GK,Freiburg,Bundesliga,26,1992,33.0,0,0,0,0,0,0,1,0.0,1,0,0,0,0,0,13,2,Matches
2234,Matteo Scozzarella,ITA,MF,Parma,Serie A,30,1988,16.2,18,13,9,8,1,9,33,27.3,24,22,10,12,23,41,33,0,Matches
2235,Simone Scuffet,ITA,GK,Udinese,Serie A,22,1996,9.0,0,0,0,0,0,0,1,0.0,1,0,0,0,0,0,4,2,Matches
2236,Andrea Seculin,ITA,GK,Chievo,Serie A,28,1990,1.0,0,0,0,0,0,0,0,,0,0,0,0,0,0,1,0,Matches
2237,Stanley Segarel,SMN,FW,Amiens,Ligue 1,24,1994,0.2,0,0,0,0,0,0,0,,0,0,0,0,0,0,0,0,Matches
2238,Davie Selke,GER,FW,Hertha BSC,Bundesliga,23,1995,19.3,5,2,1,4,0,2,9,22.2,7,11,0,11,1,6,7,0,Matches
2239,Ole Selnæs,NOR,MF,Saint-Étienne,Ligue 1,24,1994,18.5,44,26,12,23,9,13,35,37.1,22,24,7,17,19,63,29,0,Matches
2240,Matz Sels,BEL,GK,Strasbourg,Ligue 1,26,1992,37.0,0,0,0,0,0,0,1,0.0,1,0,0,0,1,1,24,1,Matches
2241,Ken Sema,SWE,"MF,FW",Watford,Premier League,24,1993,8.4,15,7,7,5,3,9,21,42.9,12,7,0,7,8,23,5,0,Matches
2242,Alfa Semedo,GNB,MF,Espanyol,La Liga,20,1997,0.5,0,0,0,0,0,0,3,0.0,3,1,1,0,2,2,0,0,Matches
2243,Nélson Semedo,POR,DF,Barcelona,La Liga,24,1993,17.8,38,27,23,12,3,12,18,66.7,6,23,7,16,22,60,26,0,Matches
2244,Rúben Semedo,POR,DF,Huesca,La Liga,24,1994,9.4,20,16,14,6,0,12,16,75.0,4,15,9,6,16,36,35,2,Matches
2245,Adrian Šemper,CRO,GK,Chievo,Serie A,20,1998,6.0,0,0,0,0,0,0,0,,0,0,0,0,1,1,3,0,Matches
2246,Stefano Sensi,ITA,MF,Sassuolo,Serie A,22,1995,21.9,36,20,15,18,3,6,30,20.0,24,36,7,29,33,69,17,0,Matches
2247,Luigi Sepe,ITA,GK,Parma,Serie A,27,1991,37.0,1,1,1,0,0,1,2,50.0,1,0,0,0,3,4,21,3,Matches
2248,Suat Serdar,GER,MF,Schalke 04,Bundesliga,21,1997,19.2,51,32,20,26,5,14,49,28.6,35,37,6,31,23,74,5,1,Matches
2249,Jean Seri,CIV,MF,Fulham,Premier League,27,1991,24.9,41,28,20,20,1,13,45,28.9,32,40,9,31,32,73,17,4,Matches
2250,Leonardo Sernicola,ITA,FW,Sassuolo,Serie A,21,1997,0.1,0,0,0,0,0,0,0,,0,0,0,0,0,0,0,0,Matches
2251,Julien Serrano,FRA,"MF,DF",Monaco,Ligue 1,20,1998,1.3,5,4,3,2,0,3,6,50.0,3,1,0,1,3,8,3,0,Matches
2252,Grégory Sertic,FRA,MF,Marseille,Ligue 1,28,1989,1.2,2,0,1,1,0,0,1,0.0,1,2,1,1,1,3,2,0,Matches
2253,Ryan Sessegnon,ENG,"FW,DF",Fulham,Premier League,18,2000,25.6,22,14,8,8,6,6,22,27.3,16,25,2,23,19,41,49,1,Matches
2254,Paik Seung-ho,KOR,"FW,MF",Girona,La Liga,21,1997,0.7,0,0,0,0,0,0,1,0.0,1,1,0,1,3,3,1,0,Matches
2255,Stephan El Shaarawy,ITA,"FW,MF",Roma,Serie A,25,1992,23.4,27,14,14,8,5,9,24,37.5,15,11,2,9,20,47,9,0,Matches
2256,Meritan Shabani,ALB,MF,Bayern Munich,Bundesliga,19,1999,0.0,0,0,0,0,0,0,0,,0,0,0,0,0,0,0,0,Matches
2257,Xherdan Shaqiri,SUI,"FW,MF",Liverpool,Premier League,26,1991,11.8,14,4,3,9,2,9,19,47.4,10,6,1,5,6,20,6,0,Matches
2258,Luke Shaw,ENG,DF,Manchester Utd,Premier League,23,1995,28.8,55,29,17,31,7,28,47,59.6,19,42,12,30,21,76,93,2,Matches
2259,Jonjo Shelvey,ENG,MF,Newcastle Utd,Premier League,26,1992,10.5,22,12,10,9,3,8,17,47.1,9,10,3,7,7,29,15,0,Matches
2260,Gaku Shibasaki,JPN,"MF,FW",Getafe,La Liga,26,1992,4.3,7,3,2,4,1,3,6,50.0,3,2,0,2,3,10,4,0,Matches
2261,Gen Shoji,JPN,DF,Toulouse,Ligue 1,25,1992,18.0,24,13,16,8,0,11,24,45.8,13,22,14,8,21,45,56,0,Matches
2262,Djibril Sidibé,FRA,"DF,MF",Monaco,Ligue 1,26,1992,23.1,50,34,27,12,11,26,48,54.2,22,25,9,16,30,80,51,0,Matches
2263,Kalidou Sidibé,FRA,MF,Toulouse,Ligue 1,19,1999,14.0,24,12,11,12,1,7,15,46.7,8,16,3,13,17,41,26,1,Matches
2264,Sidnei,BRA,DF,Betis,La Liga,28,1989,19.4,48,29,33,12,3,18,34,52.9,16,21,8,13,41,89,57,0,Matches
2265,Francisco Sierralta,CHI,DF,Parma,Serie A,21,1997,3.0,11,8,8,3,0,4,6,66.7,2,1,1,0,4,15,27,0,Matches
2266,Gylfi Sigurðsson,ISL,MF,Everton,Premier League,28,1989,34.6,56,36,20,25,11,16,47,34.0,31,38,4,34,28,84,24,0,Matches
2267,Luca Siligardi,ITA,FW,Parma,Serie A,30,1988,18.2,30,20,10,13,7,8,23,34.8,15,19,3,16,15,45,11,0,Matches
2268,Adrien Silva,POR,MF,Leicester City,Premier League,29,1989,1.0,2,2,0,1,1,0,2,0.0,2,1,0,1,1,3,1,0,Matches
2269,Adrien Silva,POR,MF,Monaco,Ligue 1,29,1989,13.2,50,31,19,26,5,30,62,48.4,32,15,2,13,16,66,23,0,Matches
2270,André Silva,POR,FW,Sevilla,La Liga,22,1995,24.0,8,5,1,4,3,1,11,9.1,10,17,1,16,3,11,32,0,Matches
2271,Bernardo Silva,POR,"MF,FW",Manchester City,Premier League,23,1994,31.7,52,39,18,21,13,16,67,23.9,51,47,3,44,25,77,26,1,Matches
2272,David Silva,ESP,MF,Manchester City,Premier League,32,1986,26.7,30,18,12,11,7,1,20,5.0,19,18,1,17,22,52,15,0,Matches
2273,Gabriel Silva,BRA,DF,Saint-Étienne,Ligue 1,27,1991,15.9,19,10,13,6,0,6,17,35.3,11,15,3,12,14,33,60,1,Matches
2274,Jonathan Silva,ARG,"DF,FW",Leganés,La Liga,24,1994,30.0,51,38,30,17,4,23,52,44.2,29,23,2,21,29,80,86,0,Matches
2275,Matheus Pereira da Silva,BRA,MF,Juventus,Serie A,20,1998,1.0,3,2,0,2,1,2,4,50.0,2,1,0,1,0,3,1,0,Matches
2276,Thiago Silva,BRA,DF,Paris S-G,Ligue 1,33,1984,23.1,16,13,7,8,1,6,11,54.5,5,28,20,8,32,48,99,1,Matches
2277,Xande Silva,POR,FW,West Ham,Premier League,21,1997,0.2,0,0,0,0,0,0,0,,0,1,0,1,0,0,0,0,Matches
2278,Matías Silvestre,ARG,DF,Empoli,Serie A,33,1984,34.0,31,17,22,5,4,17,26,65.4,9,29,24,5,21,52,165,0,Matches
2279,Giovanni Simeone,ARG,FW,Fiorentina,Serie A,23,1995,27.3,43,27,10,23,10,7,29,24.1,22,26,2,24,4,47,14,0,Matches
2280,Lorenco Šimić,CRO,DF,SPAL,Serie A,22,1996,2.6,6,3,5,1,0,2,4,50.0,2,2,1,1,12,18,19,1,Matches
2281,Moses Simon,NGA,"DF,MF",Levante,La Liga,23,1995,8.7,14,8,10,2,2,5,9,55.6,4,10,1,9,12,26,14,0,Matches
2282,Unai Simón,ESP,GK,Athletic Club,La Liga,21,1997,7.0,0,0,0,0,0,0,1,0.0,1,0,0,0,1,1,1,1,Matches
2283,Danny Simpson,ENG,DF,Leicester City,Premier League,31,1987,3.2,11,3,8,3,0,3,5,60.0,2,7,3,4,6,17,20,0,Matches
2284,Jack Simpson,ENG,DF,Bournemouth,Premier League,21,1996,4.5,9,5,8,1,0,6,9,66.7,3,5,4,1,9,18,25,2,Matches
2285,Josh Sims,ENG,MF,Southampton,Premier League,21,1997,2.4,1,0,1,0,0,1,3,33.3,2,2,0,2,1,2,1,0,Matches
2286,Giovanni Sio,CIV,FW,Montpellier,Ligue 1,29,1989,0.7,0,0,0,0,0,0,0,,0,0,0,0,0,0,0,0,Matches
2287,Dimitris Siovas,GRE,DF,Leganés,La Liga,29,1988,32.9,57,32,38,18,1,27,47,57.4,20,32,15,17,65,122,155,1,Matches
2288,Salvatore Sirigu,ITA,GK,Torino,Serie A,31,1987,35.2,0,0,0,0,0,0,2,0.0,2,0,0,0,2,2,21,1,Matches
2289,Ibrahima Sissoko,MLI,MF,Strasbourg,Ligue 1,20,1997,29.6,60,41,23,34,3,23,55,41.8,32,37,3,34,34,94,39,1,Matches
2290,Moussa Sissoko,FRA,"MF,FW",Tottenham,Premier League,28,1989,25.9,36,25,18,14,4,15,29,51.7,14,31,4,27,16,52,25,2,Matches
2291,Pione Sisto,DEN,"FW,MF",Celta Vigo,La Liga,23,1995,9.4,4,3,4,0,0,0,9,0.0,9,5,0,5,3,7,3,0,Matches
2292,Antonio Sivera,ESP,GK,Alavés,La Liga,21,1996,3.0,0,0,0,0,0,0,0,,0,0,0,0,0,0,4,1,Matches
2293,Ellyes Skhiri,TUN,MF,Montpellier,Ligue 1,23,1995,34.3,105,58,31,64,10,43,91,47.3,48,60,7,53,60,165,41,0,Matches
2294,Oliver Skipp,ENG,MF,Tottenham,Premier League,17,2000,2.4,7,3,4,3,0,4,6,66.7,2,2,1,1,1,8,7,0,Matches
2295,Łukasz Skorupski,POL,GK,Bologna,Serie A,27,1991,38.0,0,0,0,0,0,0,0,,0,0,0,0,3,3,12,4,Matches
2296,Milan Škriniar,SVK,DF,Inter,Serie A,23,1995,35.0,64,37,46,17,1,38,60,63.3,22,48,29,19,27,91,138,0,Matches
2297,Steven Skrzybski,GER,"FW,MF",Schalke 04,Bundesliga,25,1992,7.4,9,3,0,6,3,3,11,27.3,8,8,1,7,3,12,2,0,Matches
2298,Petar Škuletić,SRB,FW,Montpellier,Ligue 1,28,1990,6.7,9,5,4,2,3,1,15,6.7,14,7,1,6,3,12,14,1,Matches
2299,Callum Slattery,ENG,MF,Southampton,Premier League,19,1999,1.2,4,3,0,4,0,3,7,42.9,4,1,1,0,2,6,1,0,Matches
2300,Naïm Sliti,TUN,"MF,FW",Dijon,Ligue 1,26,1992,25.4,56,33,24,19,13,15,46,32.6,31,18,0,18,11,67,9,0,Matches
2301,Chris Smalling,ENG,DF,Manchester Utd,Premier League,28,1989,23.6,30,17,21,9,0,11,17,64.7,6,37,25,12,26,56,109,1,Matches
2302,Adam Smith,ENG,"DF,MF",Bournemouth,Premier League,27,1991,23.0,46,32,26,14,6,19,41,46.3,22,26,7,19,31,77,68,1,Matches
2303,Emile Smith Rowe,ENG,MF,RB Leipzig,Bundesliga,18,2000,0.3,1,0,0,1,0,1,1,100.0,0,0,0,0,1,2,0,0,Matches
2304,Tommy Smith,ENG,DF,Huddersfield,Premier League,26,1992,12.7,26,13,14,11,1,10,25,40.0,15,12,4,8,18,44,25,0,Matches
2305,Robert Snodgrass,SCO,MF,West Ham,Premier League,30,1987,24.7,44,27,18,24,2,13,46,28.3,33,24,4,20,11,55,23,0,Matches
2306,Cédric Soares,POR,DF,Southampton,Premier League,26,1991,16.6,22,16,15,6,1,9,15,60.0,6,21,5,16,22,44,60,2,Matches
2307,Cédric Soares,POR,DF,Inter,Serie A,26,1991,2.9,8,6,2,4,2,4,7,57.1,3,4,1,3,2,10,3,0,Matches
2308,Ramadan Sobhi,EGY,"FW,MF",Huddersfield,Premier League,21,1997,0.9,1,1,0,1,0,0,0,,0,2,0,2,1,2,0,0,Matches
2309,Marcel Sobottka,GER,MF,Düsseldorf,Bundesliga,24,1994,10.5,30,20,12,18,0,10,19,52.6,9,13,5,8,24,54,17,0,Matches
2310,Rubén Sobrino,ESP,"FW,MF",Alavés,La Liga,26,1992,10.7,16,11,7,6,3,5,13,38.5,8,16,1,15,2,18,13,0,Matches
2311,Rubén Sobrino,ESP,"FW,MF",Valencia,La Liga,26,1992,2.1,6,3,1,4,1,1,1,100.0,0,1,1,0,1,7,1,0,Matches
2312,Danilo Soddimo,ITA,"MF,FW",Frosinone,Serie A,30,1987,2.8,11,9,3,6,2,3,6,50.0,3,2,1,1,7,18,3,0,Matches
2313,Alex Sola,ESP,DF,Real Sociedad,La Liga,19,1999,1.0,4,3,0,3,1,3,4,75.0,1,0,0,0,1,5,2,0,Matches
2314,Dominic Solanke,ENG,"FW,MF",Bournemouth,Premier League,20,1997,3.9,8,3,1,4,3,1,8,12.5,7,4,1,3,2,10,9,0,Matches
2315,Andrés Solano,COL,DF,Atlético Madrid,La Liga,20,1998,0.5,4,3,2,2,0,2,2,100.0,0,1,0,1,0,4,1,0,Matches
2316,Carlos Soler,ESP,MF,Valencia,La Liga,21,1997,27.3,41,28,15,23,3,16,65,24.6,49,46,6,40,19,60,37,0,Matches
2317,Oumar Solet,FRA,DF,Lyon,Ligue 1,18,2000,0.7,1,0,1,0,0,1,1,100.0,0,1,0,1,0,1,0,0,Matches
2318,Yann Sommer,SUI,GK,Gladbach,Bundesliga,29,1988,34.0,2,2,2,0,0,2,2,100.0,0,1,0,1,1,3,12,5,Matches
2319,Kévin Soni,CMR,"FW,DF",Girona,La Liga,20,1998,0.9,3,2,0,2,1,2,4,50.0,2,3,0,3,1,4,0,0,Matches
2320,Jérémy Sorbon,FRA,DF,Guingamp,Ligue 1,34,1983,29.4,33,20,23,10,0,14,22,63.6,8,33,23,10,34,67,105,2,Matches
2321,Oliver Sorg,GER,DF,Hannover 96,Bundesliga,28,1990,17.6,42,28,26,16,0,20,43,46.5,23,16,9,7,46,88,47,0,Matches
2322,David Soria,ESP,GK,Getafe,La Liga,25,1993,37.0,1,0,1,0,0,1,2,50.0,1,2,0,2,1,2,15,6,Matches
2323,Juan Soriano,ESP,GK,Sevilla,La Liga,20,1997,4.0,0,0,0,0,0,0,0,,0,0,0,0,1,1,1,0,Matches
2324,Roberto Soriano,ITA,MF,Torino,Serie A,27,1991,5.2,9,5,0,5,4,1,8,12.5,7,9,0,9,6,15,1,0,Matches
2325,Roberto Soriano,ITA,MF,Bologna,Serie A,27,1991,16.5,27,18,14,10,3,8,24,33.3,16,21,2,19,3,30,11,0,Matches
2326,Stefano Sorrentino,ITA,GK,Chievo,Serie A,39,1979,31.0,1,1,1,0,0,1,2,50.0,1,0,0,0,3,4,10,1,Matches
2327,Borna Sosa,CRO,"DF,MF",Stuttgart,Bundesliga,20,1998,6.8,13,7,8,4,1,4,9,44.4,5,5,1,4,6,19,34,0,Matches
2328,Sebastian Soto,USA,"MF,FW",Hannover 96,Bundesliga,18,2000,0.3,0,0,0,0,0,0,0,,0,0,0,0,0,0,0,0,Matches
2329,Riccardo Sottil,ITA,"FW,MF",Fiorentina,Serie A,19,1999,0.2,1,1,0,1,0,1,1,100.0,0,0,0,0,0,1,0,0,Matches
2330,Pape Souaré,SEN,DF,Crystal Palace,Premier League,28,1990,0.0,0,0,0,0,0,0,0,,0,0,0,0,1,1,0,0,Matches
2331,Adama Soumaoro,FRA,DF,Lille,Ligue 1,26,1992,19.1,14,11,12,2,0,4,6,66.7,2,21,18,3,21,35,92,1,Matches
2332,Boubakary Soumaré,FRA,MF,Lille,Ligue 1,19,1999,6.3,20,15,9,11,0,10,18,55.6,8,9,3,6,7,27,5,0,Matches
2333,Çağlar Söyüncü,TUR,DF,Leicester City,Premier League,22,1996,4.1,5,2,4,1,0,3,6,50.0,3,8,5,3,7,12,22,3,Matches
2334,Julián Speroni,ARG,GK,Crystal Palace,Premier League,39,1979,1.0,0,0,0,0,0,0,0,,0,0,0,0,0,0,1,2,Matches
2335,Leonardo Spinazzola,ITA,DF,Juventus,Serie A,25,1993,6.7,9,4,4,2,3,4,8,50.0,4,5,0,5,3,12,7,0,Matches
2336,Nicolás Spolli,ARG,DF,Genoa,Serie A,35,1983,6.0,7,6,3,4,0,0,2,0.0,2,8,6,2,7,14,39,1,Matches
2337,Marco Sportiello,ITA,GK,Frosinone,Serie A,26,1992,35.0,1,0,1,0,0,1,1,100.0,0,1,0,1,0,1,8,2,Matches
2338,Mattia Sprocati,ITA,"FW,MF",Parma,Serie A,25,1993,7.2,10,4,5,5,0,5,11,45.5,6,6,0,6,7,17,6,0,Matches
2339,Bassem Srarfi,TUN,"FW,MF",Nice,Ligue 1,21,1997,9.1,20,11,8,8,4,6,17,35.3,11,8,0,8,5,25,5,0,Matches
2340,Darijo Srna,CRO,DF,Cagliari,Serie A,36,1982,23.2,24,16,6,13,5,9,14,64.3,5,24,5,19,18,42,66,0,Matches
2341,Kostas Stafylidis,GRE,DF,Augsburg,Bundesliga,24,1993,10.2,22,14,17,4,1,10,19,52.6,9,13,2,11,15,37,31,0,Matches
2342,Benjamin Stambouli,FRA,"DF,MF",Schalke 04,Bundesliga,27,1990,19.6,51,31,24,24,3,25,46,54.3,21,41,9,32,32,83,65,2,Matches
2343,Jozo Stanić,CRO,MF,Augsburg,Bundesliga,19,1999,0.0,0,0,0,0,0,0,0,,0,0,0,0,0,0,0,0,Matches
2344,Junior Stanislas,ENG,"MF,FW",Bournemouth,Premier League,28,1989,11.5,12,6,5,4,3,3,7,42.9,4,8,1,7,2,14,15,0,Matches
2345,Niklas Stark,GER,DF,Hertha BSC,Bundesliga,23,1995,20.8,34,19,23,11,0,9,24,37.5,15,45,26,19,37,71,141,1,Matches
2346,Timo Stavitski,FIN,"MF,FW",Caen,Ligue 1,19,1999,0.2,0,0,0,0,0,0,1,0.0,1,0,0,0,0,0,0,0,Matches
2347,Renato Steffen,SUI,"FW,MF",Wolfsburg,Bundesliga,26,1991,16.7,26,17,5,17,4,7,17,41.2,10,13,2,11,16,42,14,0,Matches
2348,Marc Stendera,GER,MF,Eint Frankfurt,Bundesliga,22,1995,1.2,6,1,2,4,0,2,4,50.0,2,4,1,3,0,6,0,0,Matches
2349,Pascal Stenzel,GER,"DF,MF",Freiburg,Bundesliga,22,1996,16.1,42,26,26,14,2,24,43,55.8,19,16,3,13,30,72,48,1,Matches
2350,Dale Stephens,ENG,MF,Brighton,Premier League,29,1989,27.6,83,57,37,41,5,28,74,37.8,46,33,13,20,46,129,47,0,Matches
2351,Jack Stephens,ENG,DF,Southampton,Premier League,24,1994,18.9,25,13,17,7,1,16,28,57.1,12,25,13,12,37,62,96,2,Matches
2352,Mariusz Stępiński,POL,FW,Chievo,Serie A,23,1995,27.5,18,13,1,11,6,1,17,5.9,16,10,2,8,5,23,20,0,Matches
2353,Raheem Sterling,ENG,FW,Manchester City,Premier League,23,1994,30.8,32,16,11,12,9,9,25,36.0,16,28,3,25,17,49,4,0,Matches
2354,Lars Stindl,GER,"FW,MF",Gladbach,Bundesliga,29,1988,16.8,21,14,8,11,2,3,15,20.0,12,22,2,20,14,35,13,0,Matches
2355,Kevin Stöger,AUT,MF,Düsseldorf,Bundesliga,24,1993,23.5,63,35,28,27,8,30,67,44.8,37,32,5,27,31,94,19,1,Matches
2356,John Stones,ENG,DF,Manchester City,Premier League,24,1994,19.6,16,11,9,5,2,4,9,44.4,5,15,9,6,14,30,64,1,Matches
2357,Thomas Strakosha,ALB,GK,Lazio,Serie A,23,1995,35.0,1,1,1,0,0,1,1,100.0,0,0,0,0,1,2,8,1,Matches
2358,Tobias Strobl,GER,"MF,DF",Gladbach,Bundesliga,28,1990,25.5,31,17,17,13,1,9,29,31.0,20,36,14,22,29,60,35,1,Matches
2359,Kevin Strootman,NED,MF,Roma,Serie A,28,1990,1.0,2,2,1,0,1,0,1,0.0,1,5,0,5,2,4,2,0,Matches
2360,Kevin Strootman,NED,MF,Marseille,Ligue 1,28,1990,21.6,76,40,21,47,8,20,52,38.5,32,24,6,18,24,100,26,0,Matches
2361,Jens Stryger Larsen,DEN,DF,Udinese,Serie A,27,1991,35.9,42,20,24,14,4,22,44,50.0,22,27,8,19,26,68,98,1,Matches
2362,Cristhian Stuani,URU,FW,Girona,La Liga,31,1986,30.3,23,13,7,13,3,5,20,25.0,15,13,1,12,4,27,39,0,Matches
2363,Leo Štulac,SVN,MF,Parma,Serie A,23,1994,16.1,21,13,10,10,1,4,17,23.5,13,29,13,16,34,55,31,1,Matches
2364,Stefano Sturaro,ITA,"MF,FW",Genoa,Serie A,25,1993,2.4,4,3,0,3,1,2,9,22.2,7,3,1,2,3,7,2,0,Matches
2365,Daniel Sturridge,ENG,"FW,MF",Liverpool,Premier League,28,1989,5.7,3,3,1,1,1,2,3,66.7,1,4,0,4,1,4,0,0,Matches
2366,Damián Suárez,URU,DF,Getafe,La Liga,30,1988,36.0,96,62,43,41,12,53,120,44.2,67,47,6,41,46,142,57,2,Matches
2367,Denis Suárez,ESP,"MF,FW",Arsenal,Premier League,24,1994,0.8,1,1,0,1,0,0,5,0.0,5,0,0,0,1,2,0,0,Matches
2368,Denis Suárez,ESP,"MF,DF",Barcelona,La Liga,24,1994,0.2,0,0,0,0,0,0,0,,0,1,0,1,0,0,0,0,Matches
2369,Leonardo Suárez,ARG,"FW,MF",Valladolid,La Liga,22,1996,5.7,3,3,2,0,1,2,4,50.0,2,7,1,6,1,4,4,0,Matches
2370,Luis Suárez,URU,FW,Barcelona,La Liga,31,1987,31.4,18,11,1,6,11,4,10,40.0,6,12,4,8,8,26,24,0,Matches
2371,Mario Suárez,ESP,MF,Rayo Vallecano,La Liga,31,1987,11.4,37,23,17,17,3,15,28,53.6,13,10,3,7,14,51,17,2,Matches
2372,Mathías Suárez,URU,DF,Montpellier,Ligue 1,22,1996,6.1,20,11,7,10,3,10,23,43.5,13,11,0,11,9,29,18,0,Matches
2373,Danijel Subašić,CRO,GK,Monaco,Ligue 1,33,1984,12.6,0,0,0,0,0,0,1,0.0,1,0,0,0,0,0,6,2,Matches
2374,Neven Subotić,SRB,DF,Saint-Étienne,Ligue 1,29,1988,23.9,44,23,36,7,1,20,39,51.3,19,14,6,8,38,82,107,3,Matches
2375,Isaac Success,NGA,"FW,MF",Watford,Premier League,22,1996,11.7,15,12,4,8,3,2,5,40.0,3,6,0,6,2,17,11,0,Matches
2376,Niklas Süle,GER,DF,Bayern Munich,Bundesliga,22,1995,29.5,28,23,17,10,1,18,25,72.0,7,23,13,10,40,68,83,0,Matches
2377,Ki Sung-yueng,KOR,MF,Newcastle Utd,Premier League,29,1989,14.5,14,10,5,8,1,3,12,25.0,9,11,1,10,19,33,20,0,Matches
2378,Andrew Surman,ENG,MF,Bournemouth,Premier League,31,1986,16.0,11,6,6,5,0,3,13,23.1,10,20,7,13,10,21,34,1,Matches
2379,Sam Surridge,ENG,"MF,FW",Bournemouth,Premier League,20,1998,0.1,1,0,0,0,1,0,0,,0,0,0,0,0,1,0,0,Matches
2380,Markel Susaeta,ESP,"FW,MF",Athletic Club,La Liga,30,1987,15.3,17,10,4,6,7,3,23,13.0,20,10,1,9,12,29,5,0,Matches
2381,Suso,ESP,"FW,MF",Milan,Serie A,24,1993,33.5,28,18,10,14,4,10,41,24.4,31,26,1,25,16,44,3,0,Matches
2382,Markus Suttner,AUT,"DF,MF",Düsseldorf,Bundesliga,31,1987,5.4,10,7,5,4,1,4,8,50.0,4,8,3,5,8,18,10,0,Matches
2383,Mattias Svanberg,SWE,MF,Bologna,Serie A,19,1999,13.1,22,11,14,7,1,11,25,44.0,14,25,6,19,11,33,16,2,Matches
2384,Sanasi Sy,FRA,MF,Amiens,Ligue 1,19,1999,0.0,0,0,0,0,0,0,0,,0,0,0,0,0,0,0,0,Matches
2385,Seydou Sy,SEN,GK,Monaco,Ligue 1,22,1995,2.5,0,0,0,0,0,0,0,,0,0,0,0,0,0,0,1,Matches
2386,Issiaga Sylla,GUI,"DF,MF",Toulouse,Ligue 1,24,1994,22.2,54,36,30,24,0,28,53,52.8,25,36,10,26,39,93,77,0,Matches
2387,Moussa Sylla,MLI,"FW,MF",Monaco,Ligue 1,18,1999,8.5,6,4,4,1,1,2,6,33.3,4,5,2,3,2,8,5,0,Matches
2388,Eddy Sylvestre,FRA,"FW,MF",Nice,Ligue 1,18,1999,3.0,3,2,0,3,0,3,9,33.3,6,1,0,1,0,3,0,0,Matches
2389,Ádám Szalai,HUN,FW,Hoffenheim,Bundesliga,30,1987,18.1,19,13,3,12,4,4,11,36.4,7,8,1,7,4,23,8,0,Matches
2390,Wojciech Szczęsny,POL,GK,Juventus,Serie A,28,1990,28.0,2,1,2,0,0,1,1,100.0,0,0,0,0,1,3,8,2,Matches
2391,Alexander Sørloth,NOR,FW,Crystal Palace,Premier League,22,1995,2.1,2,1,0,0,2,1,2,50.0,1,0,0,0,0,2,3,0,Matches
2392,Franck Tabanou,FRA,DF,Guingamp,Ligue 1,29,1989,2.0,4,3,4,0,0,1,2,50.0,1,0,0,0,6,10,15,0,Matches
2393,Jonathan Tah,GER,DF,Leverkusen,Bundesliga,22,1996,32.6,44,30,30,10,4,17,32,53.1,15,39,26,13,45,89,142,1,Matches
2394,Flavien Tait,FRA,"MF,FW",Angers,Ligue 1,25,1993,33.2,58,35,33,16,9,23,59,39.0,36,29,2,27,28,86,15,0,Matches
2395,Adrien Tameze,CMR,MF,Nice,Ligue 1,24,1994,32.7,74,44,32,31,11,39,92,42.4,53,53,12,41,56,130,59,1,Matches
2396,Strahinja Tanasijević,SRB,"DF,MF",Chievo,Serie A,21,1997,0.2,0,0,0,0,0,0,0,,0,0,0,0,0,0,0,0,Matches
2397,Matt Targett,ENG,DF,Southampton,Premier League,22,1995,13.2,27,19,15,7,5,12,26,46.2,14,19,3,16,27,54,42,0,Matches
2398,Rodrigo Tarín,ESP,DF,Leganés,La Liga,22,1996,15.9,22,14,15,5,2,7,10,70.0,3,11,5,6,31,53,79,0,Matches
2399,James Tarkowski,ENG,DF,Burnley,Premier League,25,1992,34.3,71,36,52,18,1,29,50,58.0,21,72,56,16,42,113,240,2,Matches
2400,Ciprian Tătărușanu,ROU,GK,Nantes,Ligue 1,32,1986,26.6,0,0,0,0,0,0,0,,0,0,0,0,2,2,20,0,Matches
2401,Júlio Tavares,CPV,FW,Dijon,Ligue 1,29,1988,31.2,15,9,1,7,7,3,9,33.3,6,17,3,14,13,28,51,0,Matches
2402,Júnior Tavares,BRA,DF,Sampdoria,Serie A,21,1996,2.0,2,1,1,1,0,2,4,50.0,2,0,0,0,2,4,1,0,Matches
2403,Taleb Tawatha,ISR,"FW,DF",Eint Frankfurt,Bundesliga,26,1992,1.4,1,1,1,0,0,1,2,50.0,1,0,0,0,0,1,1,0,Matches
2404,Charlie Taylor,ENG,DF,Burnley,Premier League,24,1993,36.0,55,26,37,15,3,24,50,48.0,26,74,35,39,40,95,120,0,Matches
2405,Malik Tchokounté,FRA,"FW,MF",Caen,Ligue 1,29,1988,16.4,21,13,6,12,3,5,10,50.0,5,11,0,11,6,27,26,0,Matches
2406,Aurélien Tchouaméni,FRA,MF,Bordeaux,Ligue 1,18,2000,7.8,24,12,10,14,0,7,18,38.9,11,11,5,6,21,45,14,0,Matches
2407,Georg Teigl,AUT,"MF,FW",Augsburg,Bundesliga,27,1991,3.3,5,3,4,0,1,2,2,100.0,0,1,0,1,7,12,5,1,Matches
2408,Cristian Tello,ESP,"DF,FW",Betis,La Liga,26,1991,17.5,32,20,18,9,5,17,35,48.6,18,19,0,19,16,48,17,1,Matches
2409,Łukasz Teodorczyk,POL,FW,Udinese,Serie A,27,1991,4.4,4,2,2,2,0,2,8,25.0,6,8,2,6,1,5,4,0,Matches
2410,Hidde ter Avest,NED,"DF,FW",Udinese,Serie A,21,1997,10.8,26,14,17,6,3,14,20,70.0,6,14,3,11,10,36,39,1,Matches
2411,Marc-André ter Stegen,GER,GK,Barcelona,La Liga,26,1992,35.0,0,0,0,0,0,0,3,0.0,3,0,0,0,2,2,5,2,Matches
2412,Pietro Terracciano,ITA,GK,Fiorentina,Serie A,28,1990,2.0,0,0,0,0,0,0,0,,0,0,0,0,0,0,1,1,Matches
2413,Pietro Terracciano,ITA,GK,Empoli,Serie A,28,1990,8.0,0,0,0,0,0,0,0,,0,0,0,0,1,1,4,0,Matches
2414,Marco Terrazzino,GER,"MF,FW",Freiburg,Bundesliga,27,1991,5.7,6,3,4,2,0,1,7,14.3,6,5,2,3,3,9,2,0,Matches
2415,Martin Terrier,FRA,FW,Lyon,Ligue 1,21,1997,16.5,23,13,5,13,5,9,23,39.1,14,17,2,15,6,29,14,0,Matches
2416,Kenny Tete,NED,DF,Lyon,Ligue 1,22,1995,11.6,30,23,11,16,3,13,19,68.4,6,13,5,8,18,48,29,0,Matches
2417,Cedric Teuchert,GER,"FW,MF",Schalke 04,Bundesliga,21,1997,1.8,0,0,0,0,0,0,0,,0,2,0,2,1,1,0,0,Matches
2418,Florian Thauvin,FRA,"FW,MF",Marseille,Ligue 1,25,1993,29.0,42,23,10,21,11,16,35,45.7,19,19,1,18,8,50,4,0,Matches
2419,Cyril Théréau,FRA,"FW,MF",Fiorentina,Serie A,35,1983,0.3,0,0,0,0,0,0,0,,0,0,0,0,0,0,1,0,Matches
2420,Cyril Théréau,FRA,FW,Cagliari,Serie A,35,1983,1.5,1,1,0,1,0,1,1,100.0,0,0,0,0,0,1,2,0,Matches
2421,Sada Thioub,SEN,"MF,FW",Nîmes,Ligue 1,23,1995,27.5,30,19,13,10,7,20,45,44.4,25,29,1,28,16,46,11,0,Matches
2422,Romain Thomas,FRA,DF,Angers,Ligue 1,30,1988,26.6,35,26,25,10,0,14,19,73.7,5,31,24,7,29,64,133,1,Matches
2423,Adrien Thomasson,FRA,"MF,FW",Strasbourg,Ligue 1,24,1993,27.5,54,27,18,23,13,21,66,31.8,45,29,5,24,18,72,12,1,Matches
2424,Erik Thommy,GER,"MF,FW",Stuttgart,Bundesliga,23,1994,8.8,5,3,3,1,1,1,7,14.3,6,16,1,15,14,19,4,0,Matches
2425,Marcus Thuram,FRA,"FW,MF",Guingamp,Ligue 1,20,1997,28.6,45,28,23,15,7,20,43,46.5,23,24,1,23,10,55,14,0,Matches
2426,Youri Tielemans,BEL,MF,Leicester City,Premier League,21,1997,12.1,17,8,5,9,3,5,17,29.4,12,13,2,11,5,22,13,1,Matches
2427,Youri Tielemans,BEL,MF,Monaco,Ligue 1,21,1997,18.7,45,24,17,23,5,24,47,51.1,23,20,3,17,18,63,22,0,Matches
2428,Timmy Tillman,GER,"FW,MF",Nürnberg,Bundesliga,19,1999,2.3,0,0,0,0,0,0,4,0.0,4,3,0,3,3,3,0,2,Matches
2429,Cheick Timite,CIV,"FW,MF",Amiens,Ligue 1,20,1997,16.2,18,13,5,7,6,3,16,18.8,13,14,2,12,12,30,13,0,Matches
2430,David Timor,ESP,MF,Girona,La Liga,28,1989,1.8,2,2,1,1,0,0,1,0.0,1,1,1,0,3,5,3,0,Matches
2431,George Timotheou,AUS,DF,Schalke 04,Bundesliga,21,1997,1.0,3,3,3,0,0,0,0,,0,1,1,0,1,4,4,0,Matches
2432,Marcel Tisserand,COD,DF,Wolfsburg,Bundesliga,25,1993,9.8,14,9,9,5,0,10,13,76.9,3,12,5,7,20,34,42,1,Matches
2433,Tito,ESP,DF,Rayo Vallecano,La Liga,33,1985,12.2,14,9,12,2,0,7,22,31.8,15,22,2,20,17,31,41,0,Matches
2434,Jean-Clair Todibo,FRA,DF,Barcelona,La Liga,18,1999,1.7,7,2,4,3,0,5,6,83.3,1,1,0,1,3,10,8,0,Matches
2435,Jean-Clair Todibo,FRA,DF,Toulouse,Ligue 1,18,1999,9.3,21,18,19,2,0,11,13,84.6,2,14,5,9,14,35,62,2,Matches
2436,Karl Toko Ekambi,CMR,"FW,MF",Villarreal,La Liga,25,1992,23.8,11,8,1,6,4,2,14,14.3,12,8,0,8,11,22,9,1,Matches
2437,Corentin Tolisso,FRA,MF,Bayern Munich,Bundesliga,23,1994,0.6,0,0,0,0,0,0,2,0.0,2,1,1,0,0,0,0,0,Matches
2438,Rafael Tolói,ITA,DF,Atalanta,Serie A,27,1990,19.4,27,17,15,9,3,16,24,66.7,8,28,10,18,33,60,54,1,Matches
2439,Raúl de Tomás,ESP,FW,Rayo Vallecano,La Liga,23,1994,31.3,8,3,0,7,1,0,12,0.0,12,18,4,14,9,17,45,0,Matches
2440,James Tomkins,ENG,DF,Crystal Palace,Premier League,29,1989,28.4,34,20,27,7,0,15,28,53.6,13,23,10,13,34,68,184,3,Matches
2441,Nenad Tomović,SRB,DF,Chievo,Serie A,30,1987,8.2,9,7,5,4,0,7,10,70.0,3,5,1,4,13,22,34,0,Matches
2442,Lorenzo Tonelli,ITA,DF,Sampdoria,Serie A,28,1990,18.4,31,22,19,9,3,15,19,78.9,4,27,21,6,24,55,92,0,Matches
2443,Toño,ESP,"DF,FW",Levante,La Liga,28,1989,19.6,17,13,12,3,2,10,21,47.6,11,20,5,15,14,31,42,0,Matches
2444,Ömer Toprak,TUR,DF,Dortmund,Bundesliga,29,1989,2.6,1,1,0,1,0,0,1,0.0,1,1,1,0,0,1,7,0,Matches
2445,Lucas Torreira,URU,MF,Arsenal,Premier League,22,1996,26.5,65,39,24,32,9,25,57,43.9,32,34,7,27,41,106,33,2,Matches
2446,Daniel Torres,COL,MF,Alavés,La Liga,28,1989,0.8,2,1,2,0,0,0,3,0.0,3,0,0,0,2,4,0,0,Matches
2447,Ferrán Torres,ESP,MF,Valencia,La Liga,18,2000,9.4,15,8,4,8,3,5,11,45.5,6,10,1,9,10,25,9,0,Matches
2448,Lucas Torró,ESP,MF,Eint Frankfurt,Bundesliga,24,1994,6.2,14,7,5,7,2,5,11,45.5,6,12,1,11,14,28,13,0,Matches
2449,Jordan Torunarigha,GER,DF,Hertha BSC,Bundesliga,20,1997,12.9,34,30,23,10,1,18,28,64.3,10,19,7,12,29,63,55,0,Matches
2450,Cenk Tosun,TUR,FW,Everton,Premier League,27,1991,11.8,13,9,3,6,4,4,13,30.8,9,12,0,12,5,18,3,0,Matches
2451,Abdoulaye Touré,GUI,MF,Nantes,Ligue 1,24,1994,30.5,48,31,14,28,6,19,56,33.9,37,25,10,15,47,95,29,1,Matches
2452,Almamy Touré,MLI,DF,Monaco,Ligue 1,22,1996,3.8,13,6,6,7,0,3,10,30.0,7,3,1,2,11,24,12,0,Matches
2453,Almamy Touré,MLI,"DF,MF",Eint Frankfurt,Bundesliga,22,1996,5.8,18,11,7,11,0,5,8,62.5,3,4,1,3,9,27,25,0,Matches
2454,Lucas Tousart,FRA,MF,Lyon,Ligue 1,21,1997,19.2,74,38,33,34,7,25,59,42.4,34,30,13,17,26,100,27,0,Matches
2455,Andros Townsend,ENG,"FW,MF",Crystal Palace,Premier League,27,1991,33.4,62,35,38,16,8,35,89,39.3,54,48,5,43,38,100,28,0,Matches
2456,Adama Traoré,ESP,"FW,MF",Wolves,Premier League,22,1996,10.0,16,13,11,3,2,4,9,44.4,5,11,0,11,6,22,7,0,Matches
2457,Adama Traoré,MLI,MF,Monaco,Ligue 1,23,1995,2.7,2,1,1,0,1,1,4,25.0,3,4,0,4,3,5,1,0,Matches
2458,Bertrand Traoré,BFA,FW,Lyon,Ligue 1,22,1995,23.5,36,22,19,13,4,12,26,46.2,14,23,5,18,15,51,18,0,Matches
2459,Charles Traore,MLI,"DF,FW",Nantes,Ligue 1,26,1992,12.9,40,20,22,16,2,23,34,67.6,11,16,3,13,19,59,46,0,Matches
2460,Cheick Traoré,MLI,DF,Guingamp,Ligue 1,23,1995,16.8,37,21,23,11,3,15,25,60.0,10,13,3,10,23,60,46,1,Matches
2461,Gaoussou Traoré,MLI,MF,Amiens,Ligue 1,18,1999,1.2,10,5,6,4,0,4,8,50.0,4,1,0,1,0,10,0,0,Matches
2462,Hamari Traoré,MLI,DF,Rennes,Ligue 1,26,1992,33.0,61,33,32,27,2,36,71,50.7,35,39,11,28,44,105,82,0,Matches
2463,Ibrahima Traoré,GUI,"FW,MF",Gladbach,Bundesliga,30,1988,6.1,12,6,8,2,2,3,11,27.3,8,3,1,2,3,15,1,0,Matches
2464,Ismaël Traoré,CIV,DF,Angers,Ligue 1,31,1986,29.3,27,11,19,8,0,9,24,37.5,15,27,16,11,42,69,120,2,Matches
2465,Kevin Trapp,GER,GK,Eint Frankfurt,Bundesliga,28,1990,32.6,0,0,0,0,0,0,2,0.0,2,0,0,0,0,0,17,1,Matches
2466,Mark Travers,IRL,GK,Bournemouth,Premier League,19,1999,2.0,0,0,0,0,0,0,0,,0,0,0,0,0,0,2,0,Matches
2467,Óscar Trejo,ARG,"MF,FW",Rayo Vallecano,La Liga,30,1988,19.6,57,41,21,25,11,8,33,24.2,25,24,2,22,18,75,15,0,Matches
2468,Driss Trichard,FRA,DF,Bordeaux,Ligue 1,23,1995,1.0,2,2,2,0,0,1,1,100.0,0,1,0,1,1,3,4,0,Matches
2469,Manu Trigueros,ESP,MF,Villarreal,La Liga,26,1991,17.2,46,35,18,23,5,20,57,35.1,37,17,6,11,16,62,17,0,Matches
2470,Kieran Trippier,ENG,DF,Tottenham,Premier League,27,1990,25.3,67,37,43,16,8,37,62,59.7,25,38,5,33,23,90,77,2,Matches
2471,William Troost-Ekong,NGA,DF,Udinese,Serie A,24,1993,34.0,31,15,21,9,1,13,24,54.2,11,53,41,12,40,71,200,2,Matches
2472,Marcello Trotta,ITA,FW,Frosinone,Serie A,25,1992,4.4,7,6,2,4,1,1,3,33.3,2,2,1,1,3,10,3,0,Matches
2473,Marcello Trotta,ITA,MF,Sassuolo,Serie A,25,1992,0.1,0,0,0,0,0,0,1,0.0,1,0,0,0,0,0,0,0,Matches
2474,Philipp Tschauner,GER,GK,Hannover 96,Bundesliga,32,1985,1.0,0,0,0,0,0,0,0,,0,0,0,0,0,0,0,0,Matches
2475,Marco Tumminello,ITA,"FW,DF",Atalanta,Serie A,19,1998,0.1,0,0,0,0,0,0,0,,0,0,0,0,0,0,0,0,Matches
2476,Patrick Twumasi,GHA,"MF,FW",Alavés,La Liga,24,1994,1.9,3,3,2,0,1,0,4,0.0,4,2,0,2,1,4,1,0,Matches
2477,Salih Uçan,TUR,MF,Empoli,Serie A,24,1994,2.9,10,4,3,5,2,3,10,30.0,7,4,0,4,6,16,2,0,Matches
2478,Anthony Ujah,NGA,FW,Mainz 05,Bundesliga,27,1990,8.2,2,0,0,1,1,1,2,50.0,1,7,2,5,1,3,10,0,Matches
2479,Sven Ulreich,GER,GK,Bayern Munich,Bundesliga,29,1988,8.4,0,0,0,0,0,0,0,,0,0,0,0,0,0,2,1,Matches
2480,Samuel Umtiti,FRA,DF,Barcelona,La Liga,24,1993,13.2,8,5,3,4,1,4,6,66.7,2,10,8,2,18,26,28,2,Matches
2481,Enes Ünal,TUR,FW,Valladolid,La Liga,21,1997,23.9,17,10,3,4,10,4,24,16.7,20,17,4,13,2,19,18,0,Matches
2482,Cengiz Ünder,TUR,FW,Roma,Serie A,21,1997,15.3,6,3,3,3,0,2,11,18.2,9,7,0,7,13,19,5,0,Matches
2483,Joel Untersee,SUI,DF,Empoli,Serie A,24,1994,1.4,3,2,1,2,0,2,3,66.7,1,2,1,1,1,4,5,1,Matches
2484,Dayot Upamecano,FRA,DF,RB Leipzig,Bundesliga,19,1998,14.4,22,16,14,8,0,15,18,83.3,3,19,5,14,33,55,47,0,Matches
2485,Takashi Usami,JPN,"MF,FW",Düsseldorf,Bundesliga,26,1992,9.8,18,12,7,11,0,9,26,34.6,17,15,2,13,8,26,13,1,Matches
2486,Mark Uth,GER,"FW,MF",Schalke 04,Bundesliga,26,1991,15.6,20,11,8,8,4,4,23,17.4,19,19,2,17,8,28,12,0,Matches
2487,Tomáš Vaclík,CZE,GK,Sevilla,La Liga,29,1989,33.0,0,0,0,0,0,0,1,0.0,1,0,0,0,0,0,9,6,Matches
2488,Valentín Vada,ARG,MF,Bordeaux,Ligue 1,22,1996,0.4,2,1,0,2,0,1,1,100.0,0,0,0,0,0,2,0,0,Matches
2489,Valentín Vada,ARG,MF,Saint-Étienne,Ligue 1,22,1996,4.5,7,4,4,3,0,3,12,25.0,9,4,1,3,7,14,4,0,Matches
2490,William Vainqueur,FRA,MF,Monaco,Ligue 1,29,1988,0.9,6,3,4,2,0,1,1,100.0,0,1,0,1,0,6,0,0,Matches
2491,Mirko Valdifiori,ITA,MF,SPAL,Serie A,32,1986,7.4,20,15,12,7,1,8,14,57.1,6,4,2,2,5,25,9,0,Matches
2492,Pierrick Valdivia,FRA,MF,Nîmes,Ligue 1,30,1988,0.3,1,1,0,1,0,1,2,50.0,1,1,0,1,1,2,0,0,Matches
2493,Antonio Valencia,ECU,DF,Manchester Utd,Premier League,32,1985,5.2,8,6,2,4,2,3,4,75.0,1,9,0,9,5,13,10,0,Matches
2494,Enrico Valentini,ITA,DF,Nürnberg,Bundesliga,29,1989,14.4,44,27,31,10,3,22,40,55.0,18,17,3,14,13,57,58,0,Matches
2495,Borja Valero,ESP,MF,Inter,Serie A,33,1985,13.7,22,19,9,10,3,8,30,26.7,22,11,1,10,16,38,27,2,Matches
2496,Yan Valery,TUN,DF,Southampton,Premier League,19,1999,19.0,42,36,26,10,6,16,29,55.2,13,24,3,21,22,64,72,1,Matches
2497,Jesús Vallejo,ESP,DF,Real Madrid,La Liga,21,1997,3.5,6,5,4,2,0,5,6,83.3,1,4,4,0,7,13,12,0,Matches
2498,Theo Valls,FRA,MF,Nîmes,Ligue 1,22,1995,19.7,37,21,16,19,2,15,43,34.9,28,17,4,13,22,59,15,0,Matches
2499,Mattia Valoti,ITA,MF,SPAL,Serie A,24,1993,13.6,33,19,13,14,6,13,29,44.8,16,23,0,23,19,52,17,1,Matches
2500,Federico Valverde,URU,MF,Real Madrid,La Liga,20,1998,7.3,12,8,3,7,2,5,11,45.5,6,10,2,8,21,33,10,0,Matches
2501,Luca Valzania,ITA,MF,Frosinone,Serie A,22,1996,10.0,21,12,7,10,4,13,33,39.4,20,18,0,18,16,37,8,1,Matches
2502,Luca Valzania,ITA,MF,Atalanta,Serie A,22,1996,0.8,5,4,2,3,0,3,5,60.0,2,0,0,0,1,6,0,0,Matches
2503,Virgil van Dijk,NED,DF,Liverpool,Premier League,27,1991,37.6,38,28,26,11,1,14,14,100.0,0,29,18,11,40,78,201,1,Matches
2504,Raphaël Varane,FRA,DF,Real Madrid,La Liga,25,1993,30.6,33,18,25,7,1,15,19,78.9,4,21,9,12,32,65,141,1,Matches
2505,Jamie Vardy,ENG,FW,Leicester City,Premier League,31,1987,30.3,14,8,3,6,5,4,17,23.5,13,16,1,15,6,20,28,0,Matches
2506,Franco Vázquez,ARG,MF,Sevilla,La Liga,29,1989,25.3,51,37,21,21,9,23,66,34.8,43,25,2,23,23,74,27,1,Matches
2507,Kevin Vázquez,ESP,DF,Celta Vigo,La Liga,25,1993,2.4,6,5,5,0,1,4,7,57.1,3,8,3,5,2,8,9,0,Matches
2508,Lucas Vázquez,ESP,"FW,MF",Real Madrid,La Liga,27,1991,16.8,43,26,11,21,11,15,41,36.6,26,16,1,15,12,55,11,0,Matches
2509,Matías Vecino,URU,MF,Inter,Serie A,26,1991,22.4,50,39,18,23,9,26,53,49.1,27,38,9,29,17,67,22,0,Matches
2510,Koke Vegas,ESP,GK,Levante,La Liga,22,1995,1.0,0,0,0,0,0,0,0,,0,0,0,0,0,0,0,0,Matches
2511,Emiliano Velázquez,URU,DF,Rayo Vallecano,La Liga,24,1994,14.2,49,32,38,9,2,20,34,58.8,14,29,7,22,47,96,106,1,Matches
2512,Miloš Veljković,SRB,DF,Werder Bremen,Bundesliga,22,1995,20.9,36,24,29,6,1,22,37,59.5,15,27,13,14,27,63,111,0,Matches
2513,Miguel Veloso,POR,MF,Genoa,Serie A,32,1986,14.0,31,20,14,13,4,9,26,34.6,17,12,1,11,13,44,21,0,Matches
2514,Daniele Verde,ITA,"MF,FW",Valladolid,La Liga,22,1996,7.3,6,3,2,2,2,1,6,16.7,5,3,0,3,7,13,3,1,Matches
2515,Francesco Verde,ITA,FW,Cagliari,Serie A,19,1999,0.1,1,0,0,1,0,0,0,,0,0,0,0,0,1,0,0,Matches
2516,Simone Verdi,ITA,"MF,FW",Napoli,Serie A,26,1992,7.8,16,11,5,9,2,8,16,50.0,8,6,0,6,4,20,3,0,Matches
2517,Jordan Veretout,FRA,MF,Fiorentina,Serie A,25,1993,32.7,64,40,22,31,11,21,52,40.4,31,33,7,26,46,110,54,2,Matches
2518,Paul Verhaegh,NED,DF,Wolfsburg,Bundesliga,34,1983,2.0,1,0,0,0,1,1,2,50.0,1,5,0,5,1,2,7,1,Matches
2519,Thomas Vermaelen,BEL,DF,Barcelona,La Liga,32,1985,6.5,6,4,3,3,0,3,7,42.9,4,4,2,2,6,12,21,0,Matches
2520,Marco Verratti,ITA,MF,Paris S-G,Ligue 1,25,1992,20.9,72,42,25,39,8,36,81,44.4,45,26,1,25,18,90,8,2,Matches
2521,Jan Vertonghen,BEL,DF,Tottenham,Premier League,31,1987,21.2,39,24,17,20,2,14,24,58.3,10,18,11,7,32,71,81,0,Matches
2522,Freddie Veseli,ALB,DF,Empoli,Serie A,25,1992,28.2,34,21,16,15,3,19,27,70.4,8,28,17,11,30,64,99,1,Matches
2523,Mikel Vesga,ESP,MF,Leganés,La Liga,25,1993,23.0,50,32,27,15,8,20,82,24.4,62,42,4,38,39,89,26,0,Matches
2524,Jannik Vestergaard,DEN,DF,Southampton,Premier League,25,1992,22.5,53,33,37,13,3,28,45,62.2,17,35,20,15,35,88,174,1,Matches
2525,Rúben Vezo,POR,DF,Levante,La Liga,24,1994,14.9,26,17,17,8,1,14,22,63.6,8,23,20,3,19,45,88,0,Matches
2526,Rúben Vezo,POR,DF,Valencia,La Liga,24,1994,2.2,2,1,2,0,0,2,4,50.0,2,2,1,1,2,4,10,0,Matches
2527,Francesco Vicari,ITA,DF,SPAL,Serie A,23,1994,25.9,28,24,21,7,0,18,28,64.3,10,31,24,7,34,62,139,1,Matches
2528,Aleix Vidal,ESP,"DF,MF",Sevilla,La Liga,28,1989,5.9,13,11,5,5,3,5,14,35.7,9,5,0,5,4,17,12,0,Matches
2529,Arturo Vidal,CHI,MF,Barcelona,La Liga,31,1987,21.4,78,44,32,37,9,30,69,43.5,39,46,5,41,29,107,23,1,Matches
2530,Ronaldo Vieira,ENG,MF,Sampdoria,Serie A,20,1998,6.7,19,10,3,14,2,5,9,55.6,4,10,2,8,8,27,24,1,Matches
2531,Luciano Vietto,ARG,"FW,MF",Fulham,Premier League,24,1993,11.0,15,11,5,5,5,4,19,21.1,15,9,0,9,6,21,5,0,Matches
2532,Carlos Vigaray,ESP,DF,Alavés,La Liga,23,1994,7.2,15,8,10,4,1,9,15,60.0,6,6,1,5,6,21,24,1,Matches
2533,Emanuel Vignato,ITA,"MF,FW",Chievo,Serie A,17,2000,7.3,8,4,4,3,1,0,6,0.0,6,4,0,4,10,18,0,0,Matches
2534,Dídac Vilà,ESP,DF,Espanyol,La Liga,29,1989,26.2,67,31,33,26,8,31,58,53.4,27,41,12,29,53,120,94,1,Matches
2535,Toni Villa,ESP,"MF,FW",Valladolid,La Liga,23,1995,19.6,51,32,24,18,9,20,47,42.6,27,15,0,15,12,63,10,0,Matches
2536,Rúben Vinagre,POR,"DF,MF",Wolves,Premier League,19,1999,7.9,14,9,7,7,0,2,5,40.0,3,10,2,8,14,28,16,1,Matches
2537,Carlos Vinícius,BRA,"FW,MF",Monaco,Ligue 1,23,1995,5.8,4,1,1,2,1,0,1,0.0,1,7,0,7,1,5,2,0,Matches
2538,Vitolo,ESP,"MF,FW",Atlético Madrid,La Liga,28,1989,8.4,17,13,8,6,3,6,19,31.6,13,8,1,7,10,27,6,0,Matches
2539,Federico Viviani,ITA,MF,Frosinone,Serie A,26,1992,3.7,6,5,2,3,1,3,8,37.5,5,6,3,3,8,14,2,0,Matches
2540,Emiliano Viviano,ITA,GK,SPAL,Serie A,32,1985,16.9,0,0,0,0,0,0,0,,0,0,0,0,0,0,5,2,Matches
2541,Felipe Vizeu,BRA,"FW,DF",Udinese,Serie A,21,1997,0.4,0,0,0,0,0,0,0,,0,0,0,0,0,0,0,0,Matches
2542,Dušan Vlahović,SRB,FW,Fiorentina,Serie A,18,2000,1.8,0,0,0,0,0,0,0,,0,2,0,2,0,0,4,0,Matches
2543,Rai Vloet,NED,MF,Frosinone,Serie A,23,1995,1.4,4,2,1,2,1,0,3,0.0,3,4,0,4,0,4,1,0,Matches
2544,Kevin Vogt,GER,DF,Hoffenheim,Bundesliga,26,1991,26.6,24,15,20,4,0,12,32,37.5,20,28,11,17,33,57,103,3,Matches
2545,Sam Vokes,WAL,FW,Burnley,Premier League,28,1989,10.2,4,2,1,2,1,0,0,,0,2,1,1,0,4,17,0,Matches
2546,Kevin Volland,GER,FW,Leverkusen,Bundesliga,26,1992,31.3,33,20,7,14,12,13,27,48.1,14,17,1,16,6,39,33,0,Matches
2547,Michel Vorm,NED,GK,Tottenham,Premier League,34,1983,2.0,0,0,0,0,0,0,0,,0,0,0,0,0,0,1,0,Matches
2548,Stefan de Vrij,NED,DF,Inter,Serie A,26,1992,28.0,25,16,14,10,1,8,15,53.3,7,32,23,9,25,50,95,1,Matches
2549,Šime Vrsaljko,CRO,DF,Inter,Serie A,26,1992,8.1,20,14,8,6,6,9,14,64.3,5,5,1,4,11,31,27,1,Matches
2550,Nikola Vukčević,MNE,MF,Levante,La Liga,26,1991,7.4,25,18,12,9,4,9,24,37.5,15,15,5,10,10,35,17,0,Matches
2551,Matěj Vydra,CZE,FW,Burnley,Premier League,26,1992,3.5,2,1,0,1,1,0,3,0.0,3,4,1,3,1,3,6,0,Matches
2552,Paul Wade,FRA,MF,Nice,Ligue 1,18,2000,0.1,0,0,0,0,0,0,3,0.0,3,0,0,0,0,0,1,0,Matches
2553,Sandro Wagner,GER,FW,Bayern Munich,Bundesliga,30,1987,1.6,3,2,0,2,1,0,1,0.0,1,0,0,0,0,3,2,0,Matches
2554,Molla Wagué,MLI,DF,Udinese,Serie A,27,1991,1.1,1,1,1,0,0,0,1,0.0,1,1,0,1,4,5,5,0,Matches
2555,Moussa Wagué,SEN,"DF,FW",Barcelona,La Liga,19,1998,2.5,6,5,1,4,1,3,7,42.9,4,1,0,1,4,10,3,0,Matches
2556,Wakaso,GHA,MF,Alavés,La Liga,28,1990,18.5,46,30,23,19,4,12,36,33.3,24,37,9,28,16,62,19,2,Matches
2557,Walace,BRA,MF,Hannover 96,Bundesliga,23,1995,22.2,52,22,17,28,7,27,61,44.3,34,30,4,26,45,97,36,1,Matches
2558,Theo Walcott,ENG,"FW,MF",Everton,Premier League,29,1989,23.5,27,17,11,9,7,10,22,45.5,12,17,1,16,22,49,8,0,Matches
2559,Luca Waldschmidt,GER,"FW,MF",Freiburg,Bundesliga,22,1996,19.1,20,13,7,10,3,2,20,10.0,18,20,3,17,13,33,8,1,Matches
2560,Kyle Walker,ENG,DF,Manchester City,Premier League,28,1990,30.9,40,26,20,20,0,24,38,63.2,14,19,5,14,36,76,58,2,Matches
2561,Kyle Walker-Peters,ENG,DF,Tottenham,Premier League,21,1997,4.2,7,4,4,2,1,3,4,75.0,1,5,1,4,4,11,6,0,Matches
2562,Wallace,BRA,DF,Lazio,Serie A,23,1994,13.7,17,13,11,6,0,8,17,47.1,9,13,7,6,30,47,60,2,Matches
2563,Anthony Walongwa,,DF,Nantes,Ligue 1,24,1993,1.0,0,0,0,0,0,0,0,,0,3,2,1,1,1,2,0,Matches
2564,Rémi Walter,FRA,MF,Nice,Ligue 1,23,1995,9.3,20,12,7,10,3,5,15,33.3,10,9,1,8,6,26,11,0,Matches
2565,Aaron Wan-Bissaka,ENG,DF,Crystal Palace,Premier League,20,1997,34.8,129,90,90,33,6,55,65,84.6,10,49,16,33,84,213,161,0,Matches
2566,Victor Wanyama,KEN,MF,Tottenham,Premier League,27,1991,5.7,13,13,8,5,0,6,12,50.0,6,9,3,6,7,20,11,0,Matches
2567,Danny Ward,ENG,FW,Cardiff City,Premier League,26,1991,4.9,2,1,0,1,1,0,3,0.0,3,3,1,2,0,2,9,0,Matches
2568,Joel Ward,ENG,DF,Crystal Palace,Premier League,28,1989,6.1,12,7,7,4,1,3,10,30.0,7,2,0,2,10,22,35,0,Matches
2569,Stephen Ward,IRL,DF,Burnley,Premier League,32,1985,2.5,4,2,1,2,1,1,4,25.0,3,3,1,2,4,8,14,0,Matches
2570,James Ward-Prowse,ENG,"MF,DF",Southampton,Premier League,23,1994,21.6,36,17,19,13,4,14,43,32.6,29,30,6,24,27,63,59,0,Matches
2571,Daniel Wass,DEN,"DF,MF",Valencia,La Liga,29,1989,26.2,35,25,9,19,7,20,42,47.6,22,23,4,19,34,69,49,0,Matches
2572,Timothy Weah,USA,FW,Paris S-G,Ligue 1,18,2000,0.6,0,0,0,0,0,0,0,,0,0,0,0,0,0,0,0,Matches
2573,Wout Weghorst,NED,FW,Wolfsburg,Bundesliga,25,1992,32.5,30,23,10,12,8,7,35,20.0,28,27,3,24,9,39,33,0,Matches
2574,Julian Weigl,GER,"DF,MF",Dortmund,Bundesliga,22,1995,16.2,32,18,19,12,1,24,41,58.5,17,18,10,8,16,48,56,2,Matches
2575,Mitchell Weiser,GER,DF,Leverkusen,Bundesliga,24,1994,23.5,63,37,34,22,7,26,50,52.0,24,31,3,28,27,90,48,0,Matches
2576,Danny Welbeck,ENG,"FW,MF",Arsenal,Premier League,27,1990,1.7,3,2,0,2,1,0,0,,0,2,0,2,1,4,2,0,Matches
2577,Wendell,BRA,DF,Leverkusen,Bundesliga,25,1993,25.3,75,48,47,24,4,34,57,59.6,23,49,13,36,29,104,66,0,Matches
2578,Oscar Wendt,SWE,DF,Gladbach,Bundesliga,32,1985,30.3,45,34,34,8,3,31,53,58.5,22,37,11,26,19,64,90,0,Matches
2579,Axel Werner,ARG,GK,Huesca,La Liga,22,1996,6.0,0,0,0,0,0,0,0,,0,0,0,0,0,0,2,0,Matches
2580,Timo Werner,GER,FW,RB Leipzig,Bundesliga,22,1996,27.9,18,12,6,8,4,3,16,18.8,13,18,2,16,3,21,7,0,Matches
2581,Ashley Westwood,ENG,MF,Burnley,Premier League,28,1990,31.4,58,30,24,27,7,14,39,35.9,25,38,9,29,47,105,42,2,Matches
2582,Hendrik Weydandt,GER,FW,Hannover 96,Bundesliga,23,1995,19.1,18,12,7,8,3,3,24,12.5,21,14,4,10,5,23,44,0,Matches
2583,Connor Wickham,ENG,"FW,MF",Crystal Palace,Premier League,25,1993,0.7,0,0,0,0,0,0,0,,0,0,0,0,0,0,2,0,Matches
2584,Georginio Wijnaldum,NED,MF,Liverpool,Premier League,27,1990,30.3,41,28,14,20,7,14,27,51.9,13,21,7,14,21,62,24,0,Matches
2585,Jetro Willems,NED,"MF,DF",Eint Frankfurt,Bundesliga,24,1994,8.1,20,15,10,8,2,9,15,60.0,6,10,4,6,10,30,14,0,Matches
2586,William,BRA,DF,Wolfsburg,Bundesliga,23,1995,29.7,82,57,52,21,9,35,75,46.7,40,41,2,39,85,167,127,3,Matches
2587,Danny Williams,USA,MF,Huddersfield,Premier League,29,1989,1.1,0,0,0,0,0,0,0,,0,4,1,3,1,1,2,0,Matches
2588,Iñaki Williams,GHA,FW,Athletic Club,La Liga,24,1994,33.6,27,18,9,7,11,5,22,22.7,17,22,1,21,7,34,33,0,Matches
2589,Willian,BRA,FW,Chelsea,Premier League,29,1988,23.3,35,21,11,15,9,9,25,36.0,16,16,1,15,14,49,12,2,Matches
2590,Joe Willock,ENG,"MF,FW",Arsenal,Premier League,18,1999,0.7,1,0,0,1,0,0,0,,0,1,0,1,1,2,0,0,Matches
2591,Ben Wilmot,ENG,"MF,DF",Watford,Premier League,18,1999,0.3,0,0,0,0,0,0,1,0.0,1,2,1,1,0,0,1,0,Matches
2592,Ben Wilmot,ENG,"DF,MF",Udinese,Serie A,18,1999,2.2,0,0,0,0,0,0,2,0.0,2,2,2,0,2,2,11,0,Matches
2593,Jack Wilshere,ENG,MF,West Ham,Premier League,26,1992,4.4,7,4,1,4,2,2,6,33.3,4,3,1,2,7,14,0,0,Matches
2594,Callum Wilson,ENG,FW,Bournemouth,Premier League,26,1992,28.1,9,7,4,3,2,0,8,0.0,8,14,4,10,4,13,16,0,Matches
2595,Kevin Wimmer,AUT,DF,Hannover 96,Bundesliga,25,1992,18.7,25,17,17,6,2,15,27,55.6,12,30,23,7,41,66,63,0,Matches
2596,Harry Winks,ENG,MF,Tottenham,Premier League,22,1996,17.7,22,13,12,9,1,5,30,16.7,25,19,3,16,21,43,19,0,Matches
2597,Axel Witsel,BEL,MF,Dortmund,Bundesliga,29,1989,31.9,47,33,19,24,4,17,28,60.7,11,33,6,27,47,94,49,0,Matches
2598,Maximilian Wöber,AUT,DF,Sevilla,La Liga,20,1998,6.0,12,9,8,2,2,3,6,50.0,3,6,0,6,7,19,16,0,Matches
2599,Marius Wolf,GER,"DF,FW",Dortmund,Bundesliga,23,1995,9.2,14,10,11,3,0,5,13,38.5,8,6,0,6,13,27,12,0,Matches
2600,Jeong Woo-yeong,KOR,FW,Bayern Munich,Bundesliga,18,1999,0.1,0,0,0,0,0,0,1,0.0,1,0,0,0,0,0,0,0,Matches
2601,Bobby Wood,USA,"FW,MF",Hannover 96,Bundesliga,25,1992,13.1,13,10,2,10,1,5,8,62.5,3,2,0,2,4,17,6,0,Matches
2602,Chris Wood,NZL,FW,Burnley,Premier League,26,1991,28.8,12,8,0,7,5,5,17,29.4,12,17,4,13,3,15,26,0,Matches
2603,Haji Wright,USA,FW,Schalke 04,Bundesliga,20,1998,2.2,3,2,1,1,1,0,1,0.0,1,1,0,1,0,3,1,0,Matches
2604,Xeka,POR,MF,Lille,Ligue 1,23,1994,25.1,59,31,25,27,7,18,57,31.6,39,20,2,18,21,80,30,4,Matches
2605,Granit Xhaka,SUI,"MF,DF",Arsenal,Premier League,25,1992,27.8,52,29,29,20,3,24,59,40.7,35,35,9,26,36,88,56,3,Matches
2606,Cédric Yamberé,CTA,DF,Dijon,Ligue 1,27,1990,31.2,47,31,36,11,0,21,39,53.8,18,45,32,13,52,99,136,4,Matches
2607,Andriy Yarmolenko,UKR,"MF,FW",West Ham,Premier League,28,1989,5.1,4,1,2,1,1,4,6,66.7,2,4,1,3,2,6,4,2,Matches
2608,John Yeboah,ECU,"MF,FW",Wolfsburg,Bundesliga,18,2000,0.6,0,0,0,0,0,0,3,0.0,3,1,0,1,1,1,0,0,Matches
2609,DeAndre Yedlin,USA,DF,Newcastle Utd,Premier League,25,1993,27.5,54,32,36,14,4,19,41,46.3,22,36,10,26,28,82,88,0,Matches
2610,Yoel,ESP,GK,Valladolid,La Liga,29,1988,3.0,0,0,0,0,0,0,0,,0,0,0,0,0,0,0,1,Matches
2611,Okay Yokuşlu,TUR,MF,Celta Vigo,La Liga,24,1994,24.4,61,39,31,28,2,28,45,62.2,17,32,11,21,37,98,53,2,Matches
2612,Maya Yoshida,JPN,DF,Southampton,Premier League,29,1988,16.9,16,12,5,10,1,4,13,30.8,9,24,20,4,42,58,103,1,Matches
2613,Elie Youan,FRA,FW,Nantes,Ligue 1,19,1999,0.2,1,0,0,1,0,0,0,,0,0,0,0,0,1,0,0,Matches
2614,Amin Younes,GER,"MF,FW",Napoli,Serie A,24,1993,5.5,11,6,3,6,2,3,6,50.0,3,7,0,7,2,13,0,0,Matches
2615,Ashley Young,ENG,DF,Manchester Utd,Premier League,33,1985,28.5,52,32,34,16,2,20,39,51.3,19,36,10,26,55,107,74,0,Matches
2616,Zaydou Youssouf,FRA,"MF,FW",Bordeaux,Ligue 1,19,1999,4.7,7,5,3,4,0,3,7,42.9,4,5,1,4,5,12,0,0,Matches
2617,Pablo Zabaleta,ARG,DF,West Ham,Premier League,33,1985,23.2,47,24,26,15,6,17,44,38.6,27,39,15,24,48,95,96,3,Matches
2618,Dan-Axel Zagadou,FRA,DF,Dortmund,Bundesliga,19,1999,14.1,13,10,10,2,1,4,6,66.7,2,17,11,6,25,38,70,2,Matches
2619,Wilfried Zaha,CIV,FW,Crystal Palace,Premier League,25,1992,33.7,39,20,11,23,5,12,34,35.3,22,19,0,19,10,49,4,0,Matches
2620,Younn Zahary,COM,DF,Caen,Ligue 1,19,1998,8.2,16,9,7,6,3,8,14,57.1,6,13,8,5,16,32,35,0,Matches
2621,Miha Zajc,SVN,"MF,FW",Empoli,Serie A,24,1994,13.0,6,4,1,1,4,2,11,18.2,9,15,4,11,5,11,8,0,Matches
2622,Denis Zakaria,SUI,MF,Gladbach,Bundesliga,21,1996,21.8,40,21,15,24,1,12,30,40.0,18,38,9,29,26,66,20,0,Matches
2623,Joseba Zaldúa,ESP,DF,Real Sociedad,La Liga,26,1992,23.8,36,27,23,10,3,15,32,46.9,17,19,3,16,38,74,72,0,Matches
2624,Andre-Frank Zambo Anguissa,CMR,MF,Fulham,Premier League,22,1995,16.9,48,29,23,20,5,18,52,34.6,34,25,6,19,34,82,32,0,Matches
2625,Francesco Zampano,ITA,"DF,MF",Frosinone,Serie A,24,1993,23.4,35,25,23,9,3,15,31,48.4,16,24,4,20,13,48,48,0,Matches
2626,Nicolò Zaniolo,ITA,"MF,FW",Roma,Serie A,19,1999,19.6,35,21,7,18,10,7,37,18.9,30,14,0,14,13,48,8,0,Matches
2627,Cristián Zapata,COL,DF,Milan,Serie A,31,1986,11.4,23,16,15,7,1,9,10,90.0,1,18,15,3,8,31,59,0,Matches
2628,Duván Zapata,COL,FW,Atalanta,Serie A,27,1991,32.2,9,5,3,2,4,1,9,11.1,8,26,6,20,4,13,25,0,Matches
2629,Davide Zappacosta,ITA,DF,Chelsea,Premier League,26,1992,1.4,0,0,0,0,0,0,1,0.0,1,0,0,0,3,3,5,0,Matches
2630,Simone Zaza,ITA,"FW,MF",Torino,Serie A,27,1991,16.0,20,9,3,12,5,1,8,12.5,7,12,1,11,4,24,9,0,Matches
2631,Marvin Zeegelaar,NED,DF,Udinese,Serie A,27,1990,10.6,30,23,21,6,3,16,24,66.7,8,11,2,9,17,47,38,0,Matches
2632,Mehdi Zeffane,ALG,"DF,MF",Rennes,Ligue 1,26,1992,13.5,19,13,12,7,0,10,26,38.5,16,14,5,9,18,37,35,1,Matches
2633,Arton Zekaj,KVX,FW,Lille,Ligue 1,18,2000,0.0,0,0,0,0,0,0,0,,0,0,0,0,0,0,0,0,Matches
2634,Mootaz Zemzemi,TUN,"FW,MF",Strasbourg,Ligue 1,18,1999,0.0,1,0,0,0,1,0,0,,0,0,0,0,0,1,0,0,Matches
2635,Arber Zeneli,KVX,FW,Reims,Ligue 1,23,1995,9.0,8,6,3,2,3,0,10,0.0,10,3,0,3,2,10,3,1,Matches
2636,Robin Zentner,GER,GK,Mainz 05,Bundesliga,23,1994,10.0,0,0,0,0,0,0,1,0.0,1,0,0,0,1,1,3,0,Matches
2637,Nabil El Zhar,MAR,"MF,FW",Leganés,La Liga,31,1986,10.7,8,4,2,4,2,0,5,0.0,5,4,0,4,4,12,1,0,Matches
2638,Luca Zidane,FRA,GK,Real Madrid,La Liga,20,1998,1.0,0,0,0,0,0,0,0,,0,0,0,0,0,0,0,0,Matches
2639,Ron-Robert Zieler,GER,GK,Stuttgart,Bundesliga,29,1989,34.0,2,1,2,0,0,1,4,25.0,3,1,0,1,1,3,19,3,Matches
2640,Piotr Zieliński,POL,MF,Napoli,Serie A,24,1994,31.9,41,25,11,20,10,13,34,38.2,21,30,4,26,20,61,18,0,Matches
2641,Jean Zimmer,GER,"DF,FW",Düsseldorf,Bundesliga,24,1993,15.9,17,11,11,5,1,6,16,37.5,10,13,2,11,11,28,32,1,Matches
2642,Matthias Zimmermann,GER,"DF,MF",Düsseldorf,Bundesliga,26,1992,33.9,97,64,69,24,4,45,90,50.0,45,51,18,33,67,164,90,2,Matches
2643,Oleksandr Zinchenko,UKR,DF,Manchester City,Premier League,21,1996,12.8,34,20,13,15,6,14,33,42.4,19,14,3,11,20,54,19,1,Matches
2644,Kévin Zohi,MLI,"FW,MF",Strasbourg,Ligue 1,21,1996,7.0,14,10,6,6,2,5,9,55.6,4,8,0,8,7,21,5,0,Matches
2645,Kenneth Zohore,DEN,FW,Cardiff City,Premier League,24,1994,8.4,3,2,0,3,0,1,3,33.3,2,4,2,2,2,5,5,0,Matches
2646,Kurt Zouma,FRA,DF,Everton,Premier League,23,1994,29.0,32,21,16,14,2,4,11,36.4,7,27,12,15,54,86,126,2,Matches
2647,Adam Zreľák,SVK,FW,Nürnberg,Bundesliga,24,1994,10.5,14,9,2,11,1,5,9,55.6,4,14,2,12,2,16,13,0,Matches
2648,Igor Zubeldia,ESP,MF,Real Sociedad,La Liga,21,1997,28.3,61,35,32,24,5,22,54,40.7,32,30,6,24,45,106,60,0,Matches
2649,Steven Zuber,SUI,"MF,FW",Hoffenheim,Bundesliga,26,1991,6.3,12,9,5,6,1,6,13,46.2,7,5,1,4,5,17,4,0,Matches
2650,Steven Zuber,SUI,"MF,FW",Stuttgart,Bundesliga,26,1991,11.7,6,3,2,2,2,1,13,7.7,12,14,2,12,6,12,6,0,Matches
2651,Martín Zubimendi,ESP,MF,Real Sociedad,La Liga,19,1999,0.1,1,0,0,1,0,0,1,0.0,1,0,0,0,0,1,0,0,Matches
2652,Ervin Zukanović,BIH,DF,Genoa,Serie A,31,1987,21.8,28,16,20,7,1,17,30,56.7,13,17,9,8,19,47,96,0,Matches
2653,Bongani Zungu,RSA,MF,Amiens,Ligue 1,25,1992,2.6,3,2,0,1,2,2,8,25.0,6,0,0,0,2,5,5,0,Matches
2654,David Zurutuza,ESP,MF,Real Sociedad,La Liga,32,1986,13.6,27,16,9,15,3,8,22,36.4,14,19,4,15,24,51,26,1,Matches
2655,Filip Đorđević,SRB,FW,Chievo,Serie A,30,1987,7.0,11,6,3,6,2,3,12,25.0,9,7,1,6,2,13,8,1,Matches
2656,Filip Đuričić,SRB,"FW,MF",Sassuolo,Serie A,26,1992,13.9,17,13,2,11,4,5,22,22.7,17,20,1,19,8,25,8,1,Matches
1,Patrick van Aanholt,NED,DF,Crystal Palace,Premier League,28,1990,27.9,43,23,31,10,2,23,50,46.0,27,31,9,22,45,88,52,1,Matches
2,Max Aarons,ENG,DF,Norwich City,Premier League,19,2000,36.0,48,30,33,9,6,18,36,50.0,18,46,29,17,37,85,97,1,Matches
3,Yunis Abdelhamid,MAR,DF,Reims,Ligue 1,31,1987,28.0,46,33,29,15,2,17,30,56.7,13,26,14,12,47,93,99,1,Matches
4,Suleiman Abdullahi,NGA,"FW,MF",Union Berlin,Bundesliga,22,1996,1.7,0,0,0,0,0,0,3,0.0,3,2,1,1,1,1,1,0,Matches
5,Mehdi Abeid,ALG,MF,Nantes,Ligue 1,26,1992,20.2,55,29,18,32,5,20,53,37.7,33,16,3,13,23,78,8,1,Matches
6,Charles Abi,FRA,FW,Saint-Étienne,Ligue 1,19,2000,6.9,9,9,2,5,2,2,7,28.6,5,2,0,2,4,13,4,0,Matches
7,David Abraham,ARG,DF,Eint Frankfurt,Bundesliga,33,1986,18.8,21,14,16,4,1,15,32,46.9,17,27,11,16,25,46,61,1,Matches
8,Tammy Abraham,ENG,FW,Chelsea,Premier League,21,1997,24.6,8,4,2,5,1,3,14,21.4,11,20,2,18,6,14,27,0,Matches
9,Amir Abrashi,ALB,MF,Freiburg,Bundesliga,29,1990,7.4,16,8,7,8,1,10,19,52.6,9,18,3,15,7,23,16,2,Matches
10,Francesco Acerbi,ITA,DF,Lazio,Serie A,31,1988,35.1,59,29,42,12,5,14,20,70.0,6,40,27,13,42,101,109,1,Matches
11,Che Adams,SCO,FW,Southampton,Premier League,23,1996,12.3,6,4,1,5,0,1,4,25.0,3,9,1,8,2,8,10,0,Matches
12,Tyler Adams,USA,"MF,DF",RB Leipzig,Bundesliga,20,1999,10.6,22,15,13,8,1,12,25,48.0,13,16,1,15,14,36,14,0,Matches
13,Sargis Adamyan,ARM,"FW,MF",Hoffenheim,Bundesliga,26,1993,8.3,11,7,3,6,2,3,21,14.3,18,8,1,7,2,13,4,0,Matches
14,Antonio Adán,ESP,GK,Atlético Madrid,La Liga,32,1987,0.3,0,0,0,0,0,0,0,,0,0,0,0,0,0,0,0,Matches
15,Bobby Adekanye,NED,FW,Lazio,Serie A,20,1999,2.1,3,2,0,3,0,0,5,0.0,5,0,0,0,2,5,1,0,Matches
16,Claud Adjapong,ITA,DF,Hellas Verona,Serie A,21,1998,2.6,5,3,4,1,0,2,3,66.7,1,4,3,1,3,8,7,0,Matches
17,Amine Adli,MAR,"MF,FW",Toulouse,Ligue 1,19,2000,0.5,0,0,0,0,0,0,1,0.0,1,0,0,0,1,1,0,0,Matches
18,Yacine Adli,FRA,MF,Bordeaux,Ligue 1,19,2000,11.3,22,14,4,15,3,11,34,32.4,23,10,0,10,8,30,3,0,Matches
19,Adrián,ESP,GK,Liverpool,Premier League,32,1987,9.7,1,1,1,0,0,1,1,100.0,0,0,0,0,0,1,8,3,Matches
20,Aritz Aduriz,ESP,"FW,MF",Athletic Club,La Liga,38,1981,2.3,3,2,0,3,0,0,0,,0,0,0,0,0,3,2,0,Matches
21,Lumor Agbenyenu,GHA,DF,Mallorca,La Liga,22,1996,20.1,31,21,19,9,3,16,35,45.7,19,13,2,11,21,52,66,1,Matches
22,Martin Agirregabiria,ESP,DF,Alavés,La Liga,23,1996,23.3,55,30,32,18,5,30,54,55.6,24,19,7,12,18,73,48,0,Matches
23,Lucien Agoume,FRA,MF,Inter,Serie A,17,2002,0.8,3,2,0,2,1,0,0,,0,3,1,2,0,3,0,0,Matches
24,Kevin Agudelo,COL,"MF,FW",Fiorentina,Serie A,20,1998,0.7,2,1,0,1,1,0,1,0.0,1,1,0,1,1,3,0,0,Matches
25,Kevin Agudelo,COL,"MF,FW",Genoa,Serie A,20,1998,7.4,23,14,9,12,2,10,20,50.0,10,12,1,11,6,29,2,0,Matches
26,Nayef Aguerd,MAR,DF,Dijon,Ligue 1,23,1996,10.6,13,9,7,5,1,8,12,66.7,4,11,11,0,18,31,54,0,Matches
27,Sergio Agüero,ARG,FW,Manchester City,Premier League,31,1988,16.1,7,4,0,4,3,1,8,12.5,7,9,1,8,3,10,2,0,Matches
28,Ruben Aguilar,FRA,DF,Monaco,Ligue 1,26,1993,11.9,36,22,19,15,2,19,28,67.9,9,6,2,4,11,47,21,0,Matches
29,Emmanuel Agyemang-Badu,GHA,MF,Hellas Verona,Serie A,28,1990,2.6,1,1,0,1,0,1,2,50.0,1,2,2,0,1,2,6,0,Matches
30,Jean-Eudes Aholou,CIV,MF,Saint-Étienne,Ligue 1,25,1994,7.0,16,12,2,11,3,3,9,33.3,6,6,1,5,15,31,10,0,Matches
31,Joseph Aidoo,GHA,DF,Celta Vigo,La Liga,23,1995,27.8,43,27,30,11,2,13,27,48.1,14,31,14,17,45,88,124,3,Matches
32,Ola Aina,NGA,DF,Torino,Serie A,22,1996,23.1,45,24,23,18,4,17,37,45.9,20,24,6,18,41,86,61,0,Matches
33,Youssef Aït Bennasser,MAR,MF,Bordeaux,Ligue 1,23,1996,6.0,11,8,6,4,1,4,24,16.7,20,6,1,5,4,15,10,1,Matches
34,Rayan Aït-Nouri,ALG,DF,Angers,Ligue 1,18,2001,14.2,29,22,14,8,7,10,21,47.6,11,14,1,13,18,47,33,0,Matches
35,Albian Ajeti,SUI,FW,West Ham,Premier League,22,1997,1.5,1,0,0,0,1,0,0,,0,0,0,0,0,1,0,0,Matches
36,Ludovic Ajorque,FRA,FW,Strasbourg,Ligue 1,25,1994,22.9,15,10,2,10,3,2,13,15.4,11,11,0,11,2,17,20,0,Matches
37,Manuel Akanji,SUI,DF,Dortmund,Bundesliga,24,1995,25.7,38,21,23,14,1,12,20,60.0,8,20,11,9,30,68,61,2,Matches
38,Marley Aké,FRA,"FW,MF",Marseille,Ligue 1,18,2001,1.1,2,2,1,1,0,1,3,33.3,2,0,0,0,1,3,1,0,Matches
39,Nathan Aké,NED,DF,Bournemouth,Premier League,24,1995,27.8,31,21,23,8,0,14,23,60.9,9,40,29,11,36,67,152,0,Matches
40,Chadrac Akolo,COD,"FW,MF",Amiens,Ligue 1,24,1995,6.0,16,8,8,6,2,5,12,41.7,7,6,1,5,5,21,5,0,Matches
41,Kevin Akpoguma,NGA,DF,Hoffenheim,Bundesliga,24,1995,12.7,24,16,20,4,0,13,24,54.2,11,21,11,10,13,37,48,0,Matches
42,David Alaba,AUT,DF,Bayern Munich,Bundesliga,27,1992,27.8,30,17,14,15,1,16,25,64.0,9,19,10,9,29,59,40,0,Matches
43,Sofiane Alakouch,MAR,DF,Nîmes,Ligue 1,21,1998,15.6,45,26,25,13,7,25,48,52.1,23,13,2,11,23,68,39,3,Matches
44,Lucas Alario,ARG,FW,Leverkusen,Bundesliga,26,1992,13.0,6,3,0,4,2,1,8,12.5,7,12,2,10,1,7,9,0,Matches
45,Jordi Alba,ESP,DF,Barcelona,La Liga,30,1989,24.3,20,13,9,7,4,6,27,22.2,21,12,3,9,37,57,40,0,Matches
46,Luis Alberto,ESP,MF,Lazio,Serie A,26,1992,34.6,50,30,21,19,10,27,82,32.9,55,32,1,31,21,71,9,1,Matches
47,Raúl Albiol,ESP,DF,Villarreal,La Liga,33,1985,36.0,43,23,27,16,0,18,27,66.7,9,29,21,8,42,85,175,2,Matches
48,Marc Albrighton,ENG,"MF,DF",Leicester City,Premier League,29,1989,9.6,24,17,10,13,1,9,30,30.0,21,19,2,17,10,34,8,0,Matches
49,Paco Alcácer,ESP,FW,Villarreal,La Liga,25,1993,10.3,3,3,2,1,0,1,7,14.3,6,4,1,3,2,5,10,0,Matches
50,Paco Alcácer,ESP,FW,Dortmund,Bundesliga,25,1993,5.9,2,2,0,2,0,1,5,20.0,4,4,1,3,2,4,3,0,Matches
51,Thiago Alcántara,ESP,MF,Bayern Munich,Bundesliga,28,1991,19.7,45,26,17,23,5,12,33,36.4,21,12,3,9,45,90,13,1,Matches
52,Rubén Alcaraz,ESP,MF,Valladolid,La Liga,28,1991,21.4,61,30,37,20,4,30,63,47.6,33,46,15,31,15,76,41,0,Matches
53,Toby Alderweireld,BEL,DF,Tottenham,Premier League,30,1989,32.9,40,29,24,13,3,11,24,45.8,13,48,32,16,31,71,172,2,Matches
54,Haitam Aleesami,NOR,DF,Amiens,Ligue 1,28,1991,21.3,36,16,25,9,2,18,43,41.9,25,33,10,23,34,70,59,1,Matches
55,Álex Alegría,ESP,FW,Mallorca,La Liga,26,1992,1.2,1,0,1,0,0,0,0,,0,2,0,2,0,1,0,0,Matches
56,Carles Aleñá,ESP,MF,Barcelona,La Liga,21,1998,1.9,2,1,1,1,0,1,4,25.0,3,1,0,1,0,2,0,0,Matches
57,Carles Aleñá,ESP,"MF,FW",Betis,La Liga,21,1998,8.2,14,9,5,7,2,3,17,17.6,14,4,1,3,1,15,3,0,Matches
58,Rúnar Alex Rúnarsson,ISL,GK,Dijon,Ligue 1,24,1995,10.0,0,0,0,0,0,0,2,0.0,2,0,0,0,0,0,3,3,Matches
59,Trent Alexander-Arnold,ENG,DF,Liverpool,Premier League,20,1998,35.3,55,34,35,17,3,36,78,46.2,42,27,9,18,45,100,84,3,Matches
60,Enrico Alfonso,ITA,GK,Brescia,Serie A,31,1988,3.1,0,0,0,0,0,0,0,,0,0,0,0,0,0,2,0,Matches
61,Rachid Alioui,MAR,FW,Angers,Ligue 1,27,1992,17.4,8,5,0,7,1,2,13,15.4,11,3,0,3,2,10,9,0,Matches
62,Alisson,BRA,GK,Liverpool,Premier League,26,1992,28.3,0,0,0,0,0,0,2,0.0,2,0,0,0,1,1,13,3,Matches
63,Allan,BRA,MF,Napoli,Serie A,28,1991,14.2,50,27,20,21,9,18,54,33.3,36,19,3,16,16,66,11,1,Matches
64,Dele Alli,ENG,"MF,FW",Tottenham,Premier League,23,1996,20.5,34,16,11,20,3,13,37,35.1,24,35,3,32,17,51,17,2,Matches
65,Miguel Almirón,PAR,"MF,FW",Newcastle Utd,Premier League,25,1994,33.6,60,39,32,20,8,19,52,36.5,33,25,1,24,31,91,25,0,Matches
66,Marcos Alonso,ESP,DF,Chelsea,Premier League,28,1990,15.9,28,16,20,6,2,14,33,42.4,19,18,2,16,20,48,32,0,Matches
67,Mickaël Alphonse,GLP,DF,Dijon,Ligue 1,30,1989,15.3,39,25,26,12,1,23,37,62.2,14,19,3,16,17,56,64,0,Matches
68,Sergio Álvarez,ESP,"MF,DF",Eibar,La Liga,27,1992,12.7,37,22,11,24,2,8,24,33.3,16,16,2,14,17,54,26,1,Matches
69,Sergio Álvarez,ESP,GK,Celta Vigo,La Liga,32,1986,2.0,0,0,0,0,0,0,0,,0,0,0,0,0,0,1,0,Matches
70,Yeray Álvarez,ESP,DF,Athletic Club,La Liga,24,1995,31.2,36,19,28,7,1,17,30,56.7,13,33,22,11,62,98,138,2,Matches
71,Bruno Alves,POR,DF,Parma,Serie A,37,1981,29.7,17,11,12,5,0,8,13,61.5,5,30,21,9,25,42,150,2,Matches
72,Steven Alzate,COL,"MF,DF",Brighton,Premier League,20,1998,13.2,33,19,20,11,2,17,27,63.0,10,18,3,15,14,47,13,0,Matches
73,Ibrahim Amadou,FRA,"DF,MF",Norwich City,Premier League,26,1993,8.4,18,11,9,8,1,3,11,27.3,8,8,5,3,16,34,55,1,Matches
74,Ibrahim Amadou,FRA,MF,Leganés,La Liga,26,1993,8.6,16,9,5,9,2,4,11,36.4,7,5,0,5,12,28,6,0,Matches
75,Romain Amalfitano,FRA,MF,Dijon,Ligue 1,29,1989,18.8,43,27,18,21,4,21,61,34.4,40,23,9,14,36,79,14,2,Matches
76,Amath,SEN,MF,Getafe,La Liga,23,1996,0.7,2,1,1,1,0,0,5,0.0,5,2,0,2,0,2,0,0,Matches
77,Jordan Amavi,FRA,DF,Marseille,Ligue 1,25,1994,24.0,55,29,31,19,5,31,64,48.4,33,27,6,21,56,111,97,0,Matches
78,Thierry Ambrose,GLP,FW,Metz,Ligue 1,22,1997,6.1,7,5,2,2,3,2,7,28.6,5,3,0,3,3,10,3,0,Matches
79,Kelvin Amian,FRA,DF,Toulouse,Ligue 1,21,1998,18.1,27,21,21,5,1,14,25,56.0,11,14,7,7,18,45,56,0,Matches
80,Nadiem Amiri,GER,"MF,FW",Leverkusen,Bundesliga,22,1996,20.6,26,16,7,15,4,16,34,47.1,18,12,2,10,14,40,8,1,Matches
81,Ethan Ampadu,WAL,DF,RB Leipzig,Bundesliga,18,2000,0.9,5,4,3,2,0,1,1,100.0,0,3,1,2,1,6,3,0,Matches
82,Opoku Ampomah,GHA,"FW,MF",Düsseldorf,Bundesliga,23,1996,5.6,9,4,3,4,2,3,12,25.0,9,3,0,3,4,13,5,0,Matches
83,Sofyan Amrabat,MAR,MF,Hellas Verona,Serie A,22,1996,32.4,58,36,26,21,11,26,55,47.3,29,29,10,19,31,89,15,1,Matches
84,Joachim Andersen,DEN,DF,Lyon,Ligue 1,23,1996,17.0,17,9,15,2,0,7,19,36.8,12,16,12,4,10,27,74,2,Matches
85,Djavan Anderson,NED,"FW,DF",Lazio,Serie A,24,1995,1.9,0,0,0,0,0,0,0,,0,1,0,1,3,3,3,0,Matches
86,Felipe Anderson,BRA,"MF,FW",West Ham,Premier League,26,1993,16.6,46,32,20,21,5,11,47,23.4,36,19,1,18,22,68,11,0,Matches
87,Sebastian Andersson,SWE,FW,Union Berlin,Bundesliga,28,1991,29.8,20,10,0,12,8,4,19,21.1,15,19,3,16,5,25,36,0,Matches
88,Florin Andone,ROU,FW,Brighton,Premier League,26,1993,0.8,1,1,0,1,0,1,1,100.0,0,1,1,0,0,1,1,0,Matches
89,Benjamin André,FRA,MF,Lille,Ligue 1,28,1990,22.8,72,44,31,35,6,29,74,39.2,45,32,9,23,59,131,40,1,Matches
90,Lorenzo Andrenacci,ITA,GK,Brescia,Serie A,24,1995,5.9,1,0,1,0,0,1,3,33.3,2,0,0,0,0,1,0,0,Matches
91,Robert Andrich,GER,MF,Union Berlin,Bundesliga,24,1994,28.6,52,27,28,18,6,19,60,31.7,41,27,7,20,47,99,36,0,Matches
92,Victorien Angban,CIV,MF,Metz,Ligue 1,22,1996,11.4,23,18,11,11,1,11,24,45.8,13,9,2,7,8,31,5,0,Matches
93,Miguel Ángel Guerrero,ESP,FW,Leganés,La Liga,29,1990,8.8,1,0,0,1,0,1,10,10.0,9,4,0,4,2,3,4,0,Matches
94,José Ángel,ESP,DF,Eibar,La Liga,29,1989,26.2,54,31,26,25,3,26,43,60.5,17,23,7,16,33,87,61,1,Matches
95,Miguel Ángel Moyá,ESP,GK,Real Sociedad,La Liga,35,1984,13.0,0,0,0,0,0,0,1,0.0,1,0,0,0,1,1,6,2,Matches
96,Angeliño,ESP,DF,Manchester City,Premier League,22,1997,4.7,5,2,3,1,1,5,7,71.4,2,1,0,1,9,14,15,0,Matches
97,Angeliño,ESP,"DF,FW",RB Leipzig,Bundesliga,22,1997,12.2,15,9,7,5,3,5,15,33.3,10,14,1,13,19,34,24,0,Matches
98,Faustino Anjorin,ENG,FW,Chelsea,Premier League,17,2001,0.2,0,0,0,0,0,0,0,,0,1,0,1,0,0,0,0,Matches
99,Peter Ankersen,DEN,DF,Genoa,Serie A,28,1990,11.8,16,4,7,7,2,4,13,30.8,9,19,5,14,9,25,25,1,Matches
100,Cristian Ansaldi,ARG,"DF,MF",Torino,Serie A,32,1986,19.6,37,25,24,7,6,19,34,55.9,15,23,3,20,14,51,20,4,Matches
101,Janis Antiste,FRA,MF,Toulouse,Ligue 1,16,2002,0.1,0,0,0,0,0,0,0,,0,0,0,0,0,0,0,0,Matches
102,Michail Antonio,JAM,FW,West Ham,Premier League,29,1990,19.6,13,9,5,4,4,4,14,28.6,10,17,2,15,9,22,5,0,Matches
103,Antoñito,ESP,"DF,MF",Valladolid,La Liga,31,1987,11.4,26,18,19,7,0,12,20,60.0,8,9,0,9,15,41,20,1,Matches
104,Mirko Antonucci,ITA,"FW,MF",Roma,Serie A,20,1999,0.9,4,3,1,0,3,3,3,100.0,0,2,0,2,2,6,1,0,Matches
105,Vitorino Antunes,POR,MF,Getafe,La Liga,32,1987,0.1,0,0,0,0,0,0,0,,0,0,0,0,0,0,1,0,Matches
106,Christopher Antwi-Adjei,GHA,"MF,FW",Paderborn 07,Bundesliga,25,1994,27.4,25,16,13,9,3,9,33,27.3,24,29,2,27,15,40,14,0,Matches
107,Anuar,MAR,"MF,FW",Valladolid,La Liga,24,1995,2.1,4,2,1,2,1,2,6,33.3,4,7,3,4,5,9,0,0,Matches
108,Houssem Aouar,ALG,"MF,FW",Lyon,Ligue 1,21,1998,21.7,28,12,6,18,4,10,35,28.6,25,15,1,14,13,41,11,0,Matches
109,Adil Aouchiche,FRA,MF,Paris S-G,Ligue 1,17,2002,0.7,3,2,1,2,0,2,4,50.0,2,3,0,3,0,3,0,0,Matches
110,Dennis Appiah,FRA,DF,Nantes,Ligue 1,27,1992,17.8,58,35,32,20,6,28,52,53.8,24,9,3,6,23,81,34,0,Matches
111,Mauro Arambarri,URU,MF,Getafe,La Liga,23,1995,34.1,72,33,24,40,8,31,69,44.9,38,52,5,47,43,115,40,2,Matches
112,Guilherme Arana,BRA,DF,Atalanta,Serie A,22,1997,0.9,4,4,1,3,0,3,5,60.0,2,0,0,0,2,6,0,0,Matches
113,Charles Aránguiz,CHI,MF,Leverkusen,Bundesliga,30,1989,23.5,56,37,19,29,8,27,74,36.5,47,27,6,21,22,78,21,1,Matches
114,Luiz Araújo,BRA,"FW,MF",Lille,Ligue 1,23,1996,9.2,20,11,3,8,9,5,31,16.1,26,14,0,14,4,24,6,0,Matches
115,Néstor Araujo,MEX,DF,Celta Vigo,La Liga,27,1991,32.1,44,27,35,8,1,22,36,61.1,14,26,18,8,52,96,142,0,Matches
116,Ronald Araújo,URU,DF,Barcelona,La Liga,20,1999,2.6,3,2,2,1,0,1,1,100.0,0,6,2,4,0,3,9,0,Matches
117,Anaitz Arbilla,ESP,DF,Eibar,La Liga,32,1987,22.3,33,20,23,8,2,16,34,47.1,18,20,4,16,29,62,82,0,Matches
118,Alphonse Areola,FRA,GK,Real Madrid,La Liga,26,1993,4.0,0,0,0,0,0,0,0,,0,0,0,0,0,0,0,0,Matches
119,Alphonse Areola,FRA,GK,Paris S-G,Ligue 1,26,1993,3.0,0,0,0,0,0,0,0,,0,0,0,0,0,0,1,1,Matches
120,Santiago Arias,COL,DF,Atlético Madrid,La Liga,27,1992,12.0,36,24,20,12,4,10,18,55.6,8,12,7,5,19,55,20,1,Matches
121,Nicolò Armini,ITA,DF,Lazio,Serie A,18,2001,0.0,1,1,1,0,0,1,1,100.0,0,0,0,0,0,1,1,0,Matches
122,Stuart Armstrong,SCO,MF,Southampton,Premier League,27,1992,19.1,32,19,19,11,2,9,38,23.7,29,22,4,18,11,43,23,1,Matches
123,José Arnaiz,ESP,"FW,MF",Osasuna,La Liga,24,1995,8.8,3,2,0,2,1,0,12,0.0,12,7,0,7,5,8,5,0,Matches
124,José Arnaiz,ESP,MF,Leganés,La Liga,24,1995,3.7,3,0,1,2,0,2,5,40.0,3,4,0,4,2,5,1,0,Matches
125,Maximilian Arnold,GER,MF,Wolfsburg,Bundesliga,25,1994,31.3,42,24,15,23,4,16,62,25.8,46,25,6,19,25,67,35,0,Matches
126,Kepa Arrizabalaga,ESP,GK,Chelsea,Premier League,24,1994,33.0,1,1,1,0,0,1,2,50.0,1,0,0,0,1,2,7,2,Matches
127,Kwadwo Asamoah,GHA,"DF,FW",Inter,Serie A,30,1988,7.1,10,8,4,5,1,6,14,42.9,8,8,1,7,9,19,13,0,Matches
128,Santiago Ascacíbar,ARG,MF,Hertha BSC,Bundesliga,22,1997,7.0,26,13,15,11,0,11,28,39.3,17,13,2,11,16,42,13,0,Matches
129,Sergio Asenjo,ESP,GK,Villarreal,La Liga,30,1989,34.0,0,0,0,0,0,0,2,0.0,2,0,0,0,1,1,15,1,Matches
130,Marco Asensio,ESP,FW,Real Madrid,La Liga,23,1996,3.7,4,3,3,1,0,1,4,25.0,3,2,0,2,1,5,4,0,Matches
131,Kristoffer Askildsen,NOR,MF,Sampdoria,Serie A,18,2001,0.8,1,1,1,0,0,0,0,,0,1,0,1,1,2,0,0,Matches
132,Iago Aspas,ESP,FW,Celta Vigo,La Liga,31,1987,36.2,29,19,7,9,13,12,45,26.7,33,16,1,15,22,51,7,0,Matches
133,Roger Assalé,CIV,"FW,MF",Leganés,La Liga,25,1993,5.9,3,2,1,0,2,1,9,11.1,8,8,0,8,0,3,1,0,Matches
134,Youcef Atal,ALG,"FW,DF",Nice,Ligue 1,23,1996,11.1,24,11,15,6,3,13,31,41.9,18,12,1,11,24,48,11,1,Matches
135,Miguel Atienza,ESP,MF,Eibar,La Liga,20,1999,0.3,1,1,0,1,0,1,2,50.0,1,1,1,0,2,3,1,0,Matches
136,Christian Atsu,GHA,"MF,FW",Newcastle Utd,Premier League,27,1992,8.3,10,8,5,5,0,5,14,35.7,9,19,0,19,5,15,9,0,Matches
137,Pierre-Emerick Aubameyang,GAB,FW,Arsenal,Premier League,30,1989,34.8,31,19,10,12,9,12,51,23.5,39,39,1,38,14,45,16,0,Matches
138,Emil Audero,ITA,GK,Sampdoria,Serie A,22,1997,36.0,1,1,1,0,0,1,3,33.3,2,0,0,0,0,1,21,1,Matches
139,Tommaso Augello,ITA,DF,Sampdoria,Serie A,24,1994,12.6,14,9,6,3,5,5,7,71.4,2,8,0,8,15,29,21,1,Matches
140,Jean-Kévin Augustin,FRA,FW,Monaco,Ligue 1,22,1997,3.0,3,0,1,2,0,1,6,16.7,5,2,0,2,3,6,0,0,Matches
141,Ludwig Augustinsson,SWE,"DF,MF",Werder Bremen,Bundesliga,25,1994,10.3,29,12,15,9,5,12,23,52.2,11,19,5,14,10,39,29,0,Matches
142,Serge Aurier,CIV,DF,Tottenham,Premier League,26,1992,30.0,93,69,58,27,8,39,69,56.5,30,38,6,32,47,140,98,2,Matches
143,Mathias Autret,FRA,"MF,FW",Brest,Ligue 1,28,1991,13.6,23,17,5,11,7,8,25,32.0,17,14,1,13,10,33,3,0,Matches
144,Ezequiel Ávila,ARG,FW,Osasuna,La Liga,25,1994,17.7,17,12,6,7,4,6,18,33.3,12,12,0,12,3,20,5,0,Matches
145,Javier Avilés,ESP,"MF,FW",Leganés,La Liga,21,1997,2.0,9,7,2,7,0,2,4,50.0,2,3,0,3,3,12,1,0,Matches
146,Chidozie Awaziem,NGA,DF,Leganés,La Liga,22,1997,22.2,34,22,29,5,0,16,27,59.3,11,26,15,11,28,62,73,1,Matches
147,Taiwo Awoniyi,NGA,"FW,MF",Mainz 05,Bundesliga,21,1997,5.4,2,0,0,2,0,0,4,0.0,4,4,2,2,2,4,3,0,Matches
148,Florian Ayé,FRA,"FW,MF",Brescia,Serie A,22,1997,15.3,17,9,9,5,3,6,13,46.2,7,17,2,15,4,21,18,1,Matches
149,Jordan Ayew,GHA,FW,Crystal Palace,Premier League,27,1991,35.0,48,30,10,22,16,17,49,34.7,32,29,4,25,15,63,21,0,Matches
150,Kaan Ayhan,TUR,DF,Düsseldorf,Bundesliga,24,1994,30.3,38,25,26,11,1,20,37,54.1,17,28,15,13,45,83,72,1,Matches
151,Ramon Azeez,NGA,MF,Granada,La Liga,26,1992,15.1,11,8,2,8,1,7,19,36.8,12,8,2,6,19,30,11,1,Matches
152,César Azpilicueta,ESP,DF,Chelsea,Premier League,29,1989,35.9,86,56,40,32,14,35,69,50.7,34,56,21,35,67,153,94,0,Matches
153,Ludovic Baal,GUF,DF,Brest,Ligue 1,33,1986,9.2,27,15,13,12,2,10,22,45.5,12,9,3,6,17,44,20,0,Matches
154,Iddrisu Baba,GHA,MF,Mallorca,La Liga,23,1996,32.3,59,37,26,29,4,20,70,28.6,50,31,8,23,39,98,42,0,Matches
155,Khouma Babacar,SEN,FW,Lecce,Serie A,26,1993,15.8,12,8,2,6,4,1,7,14.3,6,12,3,9,3,15,34,0,Matches
156,Carlos Bacca,COL,FW,Villarreal,La Liga,32,1986,7.6,5,1,1,2,2,2,6,33.3,4,4,0,4,0,5,7,0,Matches
157,Milan Badelj,CRO,MF,Fiorentina,Serie A,30,1989,17.6,29,17,10,16,3,15,50,30.0,35,21,3,18,45,74,34,1,Matches
158,Matthias Bader,GER,DF,Köln,Bundesliga,22,1997,0.1,1,1,1,0,0,1,2,50.0,1,0,0,0,0,1,1,0,Matches
159,Benoît Badiashile,FRA,DF,Monaco,Ligue 1,18,2001,15.7,18,12,12,5,1,6,12,50.0,6,20,11,9,27,45,57,1,Matches
160,Bastian Badu,FRA,FW,Montpellier,Ligue 1,19,2000,0.1,0,0,0,0,0,0,0,,0,0,0,0,0,0,0,0,Matches
161,Alex Baena,ESP,MF,Villarreal,La Liga,18,2001,0.2,0,0,0,0,0,0,0,,0,1,0,1,0,0,0,0,Matches
162,Stéphane Bahoken,CMR,FW,Angers,Ligue 1,27,1992,10.1,7,4,1,2,4,1,7,14.3,6,4,1,3,2,9,2,0,Matches
163,Daniel Baier,GER,MF,Augsburg,Bundesliga,35,1984,21.6,33,17,14,14,5,15,43,34.9,28,19,7,12,58,91,27,0,Matches
164,Leon Bailey,JAM,"FW,MF",Leverkusen,Bundesliga,21,1997,12.1,6,3,1,5,0,6,16,37.5,10,9,0,9,8,14,3,0,Matches
165,Eric Bailly,CIV,DF,Manchester Utd,Premier League,25,1994,1.7,0,0,0,0,0,0,1,0.0,1,3,3,0,4,4,7,1,Matches
166,Dénys Bain,FRA,DF,Brest,Ligue 1,26,1993,14.1,21,14,15,6,0,9,9,100.0,0,13,10,3,28,49,66,0,Matches
167,Leighton Baines,ENG,DF,Everton,Premier League,34,1984,4.5,10,6,6,2,2,8,10,80.0,2,5,2,3,5,15,14,0,Matches
168,Stefan Bajic,FRA,GK,Saint-Étienne,Ligue 1,17,2001,1.0,0,0,0,0,0,0,0,,0,1,0,1,0,0,2,0,Matches
169,Tiemoué Bakayoko,FRA,MF,Monaco,Ligue 1,24,1994,19.1,48,24,16,27,5,29,54,53.7,25,12,4,8,29,77,17,0,Matches
170,Lewis Baker,ENG,MF,Düsseldorf,Bundesliga,24,1995,6.1,8,5,6,2,0,2,10,20.0,8,5,2,3,2,10,5,0,Matches
171,Mitchel Bakker,NED,DF,Paris S-G,Ligue 1,19,2000,1.0,2,2,1,1,0,1,1,100.0,0,0,0,0,0,2,2,0,Matches
172,Ridle Baku,GER,"DF,MF",Mainz 05,Bundesliga,21,1998,26.1,54,31,25,22,7,26,53,49.1,27,45,7,38,42,96,57,0,Matches
173,Fabián Balbuena,PAR,DF,West Ham,Premier League,27,1991,13.1,17,12,13,3,1,9,25,36.0,16,15,5,10,26,43,75,3,Matches
174,Keita Baldé,SEN,"FW,MF",Monaco,Ligue 1,24,1995,9.5,6,5,1,1,4,3,9,33.3,6,4,1,3,2,8,7,1,Matches
175,George Baldock,GRE,DF,Sheffield Utd,Premier League,26,1993,38.0,62,43,35,17,10,27,47,57.4,20,26,3,23,34,96,83,3,Matches
176,Gareth Bale,WAL,"FW,MF",Real Madrid,La Liga,30,1989,12.1,9,5,5,2,2,3,14,21.4,11,8,2,6,6,15,9,0,Matches
177,Mikel Balenziaga,ESP,DF,Athletic Club,La Liga,31,1988,6.3,15,10,4,10,1,9,11,81.8,2,4,1,3,2,17,20,0,Matches
178,Leonardo Balerdi,ARG,"DF,MF",Dortmund,Bundesliga,20,1999,1.5,2,1,1,1,0,2,2,100.0,0,0,0,0,4,6,3,0,Matches
179,Marco Ballarini,ITA,MF,Udinese,Serie A,18,2001,0.0,0,0,0,0,0,0,0,,0,0,0,0,0,0,0,0,Matches
180,Fodé Ballo-Touré,SEN,DF,Monaco,Ligue 1,22,1997,18.7,36,25,21,11,4,17,32,53.1,15,10,1,9,24,60,45,0,Matches
181,Florent Balmont,FRA,MF,Dijon,Ligue 1,39,1980,4.5,12,6,5,7,0,7,12,58.3,5,6,0,6,1,13,3,0,Matches
182,Mario Balotelli,ITA,FW,Brescia,Serie A,28,1990,15.6,2,2,0,2,0,0,2,0.0,2,1,1,0,8,10,22,0,Matches
183,Abdoulaye Bamba,CIV,DF,Angers,Ligue 1,29,1990,6.2,10,7,7,1,2,8,15,53.3,7,4,1,3,4,14,18,0,Matches
184,Jonathan Bamba,CIV,"FW,MF",Lille,Ligue 1,23,1996,21.5,12,6,5,5,2,7,29,24.1,22,19,3,16,16,28,8,2,Matches
185,Éver Banega,ARG,MF,Sevilla,La Liga,31,1988,27.5,43,28,16,18,9,21,70,30.0,49,19,1,18,15,58,5,0,Matches
186,Mattia Bani,ITA,DF,Bologna,Serie A,25,1993,24.5,47,28,27,19,1,25,36,69.4,11,29,15,14,52,99,92,2,Matches
187,Antonín Barák,CZE,"MF,FW",Udinese,Serie A,24,1994,2.2,5,4,3,0,2,1,5,20.0,4,6,1,5,0,5,4,0,Matches
188,Antonín Barák,CZE,MF,Lecce,Serie A,24,1994,15.2,19,10,9,10,0,6,24,25.0,18,18,1,17,9,28,20,2,Matches
189,Federico Barba,ITA,DF,Valladolid,La Liga,25,1993,5.0,12,6,10,2,0,7,9,77.8,2,5,2,3,8,20,12,0,Matches
190,Danilo Barbosa,BRA,"DF,MF",Nice,Ligue 1,23,1996,12.5,28,21,17,9,2,13,29,44.8,16,21,6,15,20,48,38,0,Matches
191,Melvin Bard,FRA,DF,Lyon,Ligue 1,18,2000,0.5,0,0,0,0,0,0,0,,0,0,0,0,1,1,0,0,Matches
192,Enis Bardhi,MKD,MF,Levante,La Liga,24,1995,23.5,24,11,7,15,2,8,35,22.9,27,15,4,11,15,39,19,0,Matches
193,Phil Bardsley,SCO,DF,Burnley,Premier League,34,1985,21.0,49,36,16,24,9,24,37,64.9,13,24,11,13,30,79,73,0,Matches
194,Nicolò Barella,ITA,MF,Inter,Serie A,22,1997,22.4,36,21,14,15,7,8,37,21.6,29,20,5,15,14,50,14,0,Matches
195,Philipp Bargfrede,GER,MF,Werder Bremen,Bundesliga,30,1989,6.5,15,12,8,5,2,6,23,26.1,17,8,2,6,16,31,15,0,Matches
196,Antonino Barillà,ITA,MF,Parma,Serie A,31,1988,18.8,43,31,22,19,2,16,45,35.6,29,26,8,18,17,60,32,0,Matches
197,Kike Barja,ESP,"MF,FW",Osasuna,La Liga,22,1997,3.5,1,1,1,0,0,1,1,100.0,0,3,1,2,0,1,2,0,Matches
198,Ross Barkley,ENG,MF,Chelsea,Premier League,25,1993,12.3,16,9,6,6,4,5,18,27.8,13,7,2,5,7,23,7,0,Matches
199,Aymen Barkok,MAR,"FW,MF",Düsseldorf,Bundesliga,21,1998,0.9,1,1,0,0,1,0,2,0.0,2,2,0,2,3,4,1,0,Matches
200,Ashley Barnes,ENG,FW,Burnley,Premier League,29,1989,15.0,10,5,3,5,2,3,9,33.3,6,7,2,5,6,16,9,0,Matches
201,Harvey Barnes,ENG,"MF,FW",Leicester City,Premier League,21,1997,23.1,16,11,7,7,2,5,23,21.7,18,13,3,10,8,24,6,1,Matches
202,Antonio Barragán,ESP,DF,Betis,La Liga,32,1987,7.1,7,5,4,2,1,3,6,50.0,3,2,2,0,8,15,22,0,Matches
203,Antonio Barreca,ITA,"DF,FW",Genoa,Serie A,24,1995,12.2,10,7,5,3,2,4,5,80.0,1,12,7,5,1,11,22,0,Matches
204,Leandro Barreiro Martins,LUX,MF,Mainz 05,Bundesliga,19,2000,10.4,38,21,16,19,3,14,29,48.3,15,18,3,15,9,47,18,1,Matches
205,Ander Barrenetxea,ESP,"FW,MF",Real Sociedad,La Liga,17,2001,4.9,12,9,5,5,2,4,10,40.0,6,3,0,3,3,15,4,0,Matches
206,Édgar Barreto,PAR,MF,Sampdoria,Serie A,35,1984,1.0,4,3,0,1,3,2,3,66.7,1,1,0,1,0,4,0,0,Matches
207,Musa Barrow,GAM,"FW,MF",Bologna,Serie A,20,1998,15.0,20,13,11,7,2,6,20,30.0,14,15,0,15,5,25,11,0,Matches
208,Musa Barrow,GAM,"FW,MF",Atalanta,Serie A,20,1998,2.1,1,1,0,0,1,1,4,25.0,3,4,0,4,0,1,1,0,Matches
209,Fin Bartels,GER,"MF,FW",Werder Bremen,Bundesliga,32,1987,3.8,9,5,4,4,1,3,12,25.0,9,3,1,2,1,10,1,0,Matches
210,Marc Bartra,ESP,"DF,MF",Betis,La Liga,28,1991,28.0,62,34,39,23,0,27,54,50.0,27,45,24,21,35,97,127,0,Matches
211,Daniele Baselli,ITA,MF,Torino,Serie A,27,1992,14.2,43,23,17,19,7,13,40,32.5,27,20,4,16,25,68,25,0,Matches
212,Chris Basham,ENG,DF,Sheffield Utd,Premier League,31,1988,36.0,85,48,58,20,7,48,81,59.3,33,38,15,23,77,162,173,1,Matches
213,Toma Bašić,CRO,MF,Bordeaux,Ligue 1,22,1996,11.0,26,22,9,16,1,12,27,44.4,15,14,2,12,9,35,12,1,Matches
214,Thomas Basila,FRA,DF,Nantes,Ligue 1,20,1999,4.6,6,3,2,4,0,4,4,100.0,0,0,0,0,4,10,14,0,Matches
215,Gil Bastião Dias,POR,"MF,DF",Granada,La Liga,22,1996,4.0,19,14,10,6,3,7,17,41.2,10,4,1,3,3,22,7,0,Matches
216,Gil Bastião Dias,POR,"DF,MF",Monaco,Ligue 1,22,1996,11.7,53,33,30,21,2,29,58,50.0,29,15,1,14,13,66,22,1,Matches
217,Borja Bastón,ESP,"MF,FW",Aston Villa,Premier League,26,1992,0.2,1,0,0,1,0,0,2,0.0,2,1,0,1,0,1,0,1,Matches
218,Alessandro Bastoni,ITA,DF,Inter,Serie A,20,1999,21.3,32,17,14,11,7,15,24,62.5,9,18,9,9,26,58,54,0,Matches
219,Bastos,ANG,DF,Lazio,Serie A,28,1991,8.5,9,5,6,3,0,4,11,36.4,7,13,8,5,13,22,26,0,Matches
220,Oliver Batista-Meier,GER,MF,Bayern Munich,Bundesliga,18,2001,0.1,0,0,0,0,0,0,2,0.0,2,0,0,0,0,0,0,0,Matches
221,Michy Batshuayi,BEL,FW,Chelsea,Premier League,25,1993,2.7,4,1,2,2,0,0,5,0.0,5,1,1,0,0,4,1,0,Matches
222,Cristian Battocchio,ITA,MF,Brest,Ligue 1,27,1992,15.5,31,24,13,13,5,14,36,38.9,22,13,4,9,19,50,21,0,Matches
223,Oliver Baumann,GER,GK,Hoffenheim,Bundesliga,29,1990,30.0,0,0,0,0,0,0,0,,0,1,0,1,3,3,15,0,Matches
224,Julian Baumgartlinger,AUT,MF,Leverkusen,Bundesliga,31,1988,19.9,42,21,15,21,6,18,42,42.9,24,37,4,33,20,62,16,1,Matches
225,Christoph Baumgartner,AUT,"MF,FW",Hoffenheim,Bundesliga,19,1999,16.6,32,17,15,16,1,10,37,27.0,27,25,1,24,8,40,13,0,Matches
226,Noah Joel Sarenren Bazee,NGA,FW,Augsburg,Bundesliga,22,1996,4.2,4,3,0,4,0,1,4,25.0,3,2,1,1,5,9,4,0,Matches
227,Ihlas Bebou,TOG,"FW,MF",Hoffenheim,Bundesliga,25,1994,23.4,27,15,9,13,5,8,23,34.8,15,25,4,21,11,38,25,0,Matches
228,Rodrigo Becão,BRA,DF,Udinese,Serie A,23,1996,24.6,56,25,34,19,3,26,46,56.5,20,40,20,20,45,101,77,0,Matches
229,Sheraldo Becker,SUR,"MF,FW",Union Berlin,Bundesliga,24,1995,6.0,2,1,2,0,0,1,3,33.3,2,1,0,1,0,2,1,0,Matches
230,Timo Becker,GER,"DF,MF",Schalke 04,Bundesliga,22,1997,3.7,10,9,3,6,1,5,9,55.6,4,6,1,5,3,13,8,0,Matches
231,Jan Bednarek,POL,DF,Southampton,Premier League,23,1996,34.0,65,38,41,18,6,31,61,50.8,30,44,23,21,77,142,198,4,Matches
232,Asmir Begović,BIH,GK,Milan,Serie A,32,1987,1.4,0,0,0,0,0,0,0,,0,0,0,0,0,0,0,0,Matches
233,Valon Behrami,SUI,MF,Genoa,Serie A,34,1985,12.3,34,26,13,17,4,8,32,25.0,24,25,10,15,9,43,16,0,Matches
234,Maximilian Beier,GER,FW,Hoffenheim,Bundesliga,16,2002,1.2,5,2,0,1,4,1,2,50.0,1,2,0,2,0,5,0,0,Matches
235,Gaëtan Belaud,FRA,DF,Brest,Ligue 1,32,1986,6.4,13,7,10,2,1,4,8,50.0,4,8,3,5,15,28,15,0,Matches
236,Ishak Belfodil,ALG,"FW,MF",Hoffenheim,Bundesliga,27,1992,3.0,0,0,0,0,0,0,1,0.0,1,0,0,0,0,0,2,0,Matches
237,Haris Belkebla,ALG,MF,Brest,Ligue 1,25,1994,20.2,44,24,17,17,10,10,28,35.7,18,25,5,20,53,97,21,2,Matches
238,Raoul Bellanova,ITA,DF,Atalanta,Serie A,19,2000,0.2,0,0,0,0,0,0,0,,0,0,0,0,0,0,0,0,Matches
239,Raoul Bellanova,ITA,DF,Bordeaux,Ligue 1,19,2000,0.7,1,1,1,0,0,0,1,0.0,1,0,0,0,0,1,0,0,Matches
240,Karim Bellarabi,GER,"FW,DF",Leverkusen,Bundesliga,29,1990,15.8,19,11,9,7,3,9,28,32.1,19,16,0,16,10,29,4,0,Matches
241,Jean-Ricner Bellegarde,FRA,MF,Strasbourg,Ligue 1,21,1998,16.6,40,27,18,19,3,13,21,61.9,8,16,3,13,22,62,6,0,Matches
242,Héctor Bellerín,ESP,"DF,MF",Arsenal,Premier League,24,1995,12.9,20,13,7,11,2,11,29,37.9,18,20,4,16,19,39,27,1,Matches
243,Andrea Belotti,ITA,FW,Torino,Serie A,25,1993,33.4,29,16,7,17,5,5,31,16.1,26,23,5,18,5,34,20,1,Matches
244,Fran Beltrán,ESP,MF,Celta Vigo,La Liga,20,1999,20.3,31,19,15,12,4,11,35,31.4,24,14,1,13,14,45,17,0,Matches
245,Sami Ben Amar,MAR,FW,Nîmes,Ligue 1,21,1998,0.2,1,1,0,0,1,1,1,100.0,0,1,0,1,1,2,0,0,Matches
246,Hatem Ben Arfa,FRA,"MF,FW",Valladolid,La Liga,32,1987,1.8,0,0,0,0,0,0,4,0.0,4,1,0,1,0,0,0,0,Matches
247,Wissam Ben Yedder,FRA,FW,Monaco,Ligue 1,28,1990,24.0,22,16,2,12,8,8,19,42.1,11,12,0,12,4,26,1,0,Matches
248,Marco Benassi,ITA,MF,Fiorentina,Serie A,24,1994,10.9,18,12,9,5,4,10,24,41.7,14,11,1,10,4,22,9,0,Matches
249,Cristian Benavente,PER,"MF,FW",Nantes,Ligue 1,25,1994,3.9,8,5,2,5,1,2,8,25.0,6,1,0,1,3,11,0,0,Matches
250,Lars Bender,GER,"DF,MF",Leverkusen,Bundesliga,30,1989,15.3,42,26,17,20,5,19,38,50.0,19,32,6,26,24,66,30,0,Matches
251,Sven Bender,GER,DF,Leverkusen,Bundesliga,30,1989,30.3,53,34,29,17,7,23,48,47.9,25,42,13,29,67,120,88,2,Matches
252,Darío Benedetto,ARG,FW,Marseille,Ligue 1,29,1990,23.3,12,9,0,9,3,3,18,16.7,15,15,2,13,3,15,23,1,Matches
253,László Bénes,SVK,MF,Gladbach,Bundesliga,21,1997,10.0,15,8,3,5,7,6,19,31.6,13,6,2,4,8,23,3,1,Matches
254,Walter Benítez,ARG,GK,Nice,Ligue 1,26,1993,26.0,1,1,1,0,0,1,3,33.3,2,0,0,0,0,1,8,0,Matches
255,Loris Benito,SUI,DF,Bordeaux,Ligue 1,27,1992,21.1,40,25,23,11,6,16,43,37.2,27,14,5,9,29,69,58,1,Matches
256,Bilal Benkhedim,FRA,"MF,FW",Saint-Étienne,Ligue 1,18,2001,1.5,3,3,1,1,1,1,4,25.0,3,1,0,1,1,4,0,0,Matches
257,Ismaël Bennacer,ALG,MF,Milan,Serie A,21,1997,27.6,67,47,21,34,12,29,73,39.7,44,25,7,18,54,121,15,2,Matches
258,Ryan Bennett,ENG,DF,Wolves,Premier League,29,1990,6.7,4,2,4,0,0,2,6,33.3,4,14,8,6,9,13,29,0,Matches
259,Ryan Bennett,ENG,DF,Leicester City,Premier League,29,1990,3.7,5,4,3,2,0,4,6,66.7,2,3,1,2,7,12,8,0,Matches
260,Keanan Bennetts,ENG,MF,Gladbach,Bundesliga,20,1999,0.0,0,0,0,0,0,0,1,0.0,1,0,0,0,0,0,0,0,Matches
261,Yassine Benrahou,FRA,"FW,MF",Bordeaux,Ligue 1,20,1999,1.9,3,0,1,1,1,2,5,40.0,3,1,0,1,2,5,1,0,Matches
262,Yassine Benrahou,FRA,"MF,FW",Nîmes,Ligue 1,20,1999,8.5,13,8,3,3,7,5,16,31.3,11,1,0,1,2,15,0,0,Matches
263,Ramy Bensebaini,ALG,DF,Gladbach,Bundesliga,24,1995,16.1,33,17,17,12,4,18,31,58.1,13,24,4,20,38,71,49,0,Matches
264,Nabil Bentaleb,ALG,MF,Newcastle Utd,Premier League,24,1994,8.3,23,13,14,9,0,7,25,28.0,18,9,2,7,19,42,9,1,Matches
265,Rodrigo Bentancur,URU,MF,Juventus,Serie A,22,1997,24.4,58,32,27,18,13,31,66,47.0,35,44,9,35,32,90,34,1,Matches
266,Christian Benteke,BEL,FW,Crystal Palace,Premier League,28,1990,14.0,9,5,1,6,2,0,10,0.0,10,11,4,7,4,13,28,1,Matches
267,Romario Benzar,ROU,DF,Lecce,Serie A,27,1992,1.1,2,2,1,1,0,2,3,66.7,1,1,0,1,0,2,2,0,Matches
268,Karim Benzema,FRA,FW,Real Madrid,La Liga,31,1987,34.9,18,8,3,11,4,2,16,12.5,14,16,4,12,7,25,30,1,Matches
269,Yassine Benzia,ALG,MF,Dijon,Ligue 1,24,1994,1.9,3,2,2,1,0,1,6,16.7,5,4,2,2,3,6,1,0,Matches
270,Domenico Berardi,ITA,FW,Sassuolo,Serie A,24,1994,27.7,32,16,19,8,5,13,59,22.0,46,31,3,28,33,65,27,0,Matches
271,Yuri Berchiche,ESP,DF,Athletic Club,La Liga,29,1990,31.7,48,35,32,15,1,21,40,52.5,19,26,4,22,30,78,73,1,Matches
272,Álex Berenguer,ESP,"MF,DF",Torino,Serie A,24,1995,20.3,20,6,6,13,1,8,33,24.2,25,17,1,16,18,38,17,0,Matches
273,Bartosz Bereszyński,POL,DF,Sampdoria,Serie A,27,1992,26.7,53,35,25,23,5,26,52,50.0,26,38,16,22,35,88,88,1,Matches
274,Jóhann Berg Guðmundsson,ISL,MF,Burnley,Premier League,28,1990,6.9,4,2,2,2,0,1,8,12.5,7,8,1,7,7,11,9,0,Matches
275,Markel Bergara,ESP,MF,Getafe,La Liga,33,1986,0.8,0,0,0,0,0,0,0,,0,0,0,0,0,0,2,0,Matches
276,Sander Berge,NOR,MF,Sheffield Utd,Premier League,21,1998,10.5,22,15,3,14,5,5,10,50.0,5,15,1,14,10,32,16,0,Matches
277,Steven Bergwijn,NED,"FW,MF",Tottenham,Premier League,21,1997,7.8,10,6,3,6,1,4,12,33.3,8,12,0,12,1,11,5,0,Matches
278,Robert Berić,SVN,FW,Saint-Étienne,Ligue 1,28,1991,4.6,3,2,0,2,1,0,5,0.0,5,2,0,2,4,7,2,0,Matches
279,Etrit Berisha,ALB,GK,SPAL,Serie A,30,1989,26.0,3,2,3,0,0,2,3,66.7,1,0,0,0,1,4,9,0,Matches
280,Valon Berisha,KVX,MF,Lazio,Serie A,26,1993,0.4,1,1,0,1,0,1,2,50.0,1,0,0,0,0,1,1,0,Matches
281,Valon Berisha,KVX,MF,Düsseldorf,Bundesliga,26,1993,10.5,14,9,3,8,3,6,21,28.6,15,4,1,3,9,23,8,0,Matches
282,Sergio Bermejo,ESP,"MF,FW",Celta Vigo,La Liga,21,1997,0.1,0,0,0,0,0,0,0,,0,0,0,0,0,0,0,0,Matches
283,Bernard,BRA,"MF,FW",Everton,Premier League,26,1992,14.2,32,22,12,14,6,13,44,29.5,31,22,2,20,16,48,7,0,Matches
284,Federico Bernardeschi,ITA,"MF,FW",Juventus,Serie A,25,1994,17.5,13,5,4,5,4,5,25,20.0,20,11,0,11,13,26,12,1,Matches
285,Bernardo,BRA,"DF,MF",Brighton,Premier League,24,1995,7.5,27,16,12,9,6,13,17,76.5,4,7,3,4,6,33,24,0,Matches
286,Paul Bernardoni,FRA,GK,Nîmes,Ligue 1,22,1997,24.5,0,0,0,0,0,0,1,0.0,1,0,0,0,0,0,11,1,Matches
287,Juan Bernat,ESP,"DF,MF",Paris S-G,Ligue 1,26,1993,15.4,42,27,19,16,7,20,51,39.2,31,13,1,12,10,52,26,0,Matches
288,Dimitry Bertaud,COD,GK,Montpellier,Ligue 1,21,1998,2.2,0,0,0,0,0,0,0,,0,0,0,0,0,0,0,0,Matches
289,Andrea Bertolacci,ITA,MF,Sampdoria,Serie A,28,1991,5.9,7,4,2,3,2,1,8,12.5,7,4,1,3,2,9,13,0,Matches
290,Ryan Bertrand,ENG,DF,Southampton,Premier League,29,1989,30.5,47,29,22,15,10,26,58,44.8,32,27,12,15,37,84,31,1,Matches
291,Muhamed Bešić,BIH,MF,Sheffield Utd,Premier League,26,1992,2.8,8,6,4,4,0,2,5,40.0,3,4,0,4,1,9,6,0,Matches
292,Jordan Beyer,GER,DF,Gladbach,Bundesliga,19,2000,1.2,3,1,3,0,0,0,1,0.0,1,4,2,2,1,4,4,0,Matches
293,Ermin Bičakčić,BIH,DF,Hoffenheim,Bundesliga,29,1990,13.1,7,3,5,2,0,4,11,36.4,7,14,8,6,25,32,64,2,Matches
294,Pedro Bigas,ESP,DF,Eibar,La Liga,28,1990,19.7,18,9,11,7,0,9,19,47.4,10,16,10,6,36,54,82,0,Matches
295,Lucas Biglia,ARG,MF,Milan,Serie A,33,1986,7.6,13,7,7,6,0,4,15,26.7,11,12,4,8,7,20,10,1,Matches
296,El Bilal Touré,MLI,FW,Reims,Ligue 1,17,2001,5.0,3,3,1,0,2,0,0,,0,6,0,6,1,4,1,0,Matches
297,Philip Billing,DEN,MF,Bournemouth,Premier League,23,1996,28.1,72,46,30,37,5,17,65,26.2,48,59,16,43,66,138,97,1,Matches
298,Cristiano Biraghi,ITA,DF,Inter,Serie A,26,1992,17.5,22,6,10,8,4,10,24,41.7,14,21,7,14,13,35,41,0,Matches
299,Davide Biraschi,ITA,DF,Genoa,Serie A,25,1994,21.9,32,17,17,13,2,15,26,57.7,11,22,12,10,34,66,69,0,Matches
300,Valter Birsa,SVN,"MF,FW",Cagliari,Serie A,32,1986,4.8,10,6,3,6,1,7,21,33.3,14,6,1,5,4,14,3,0,Matches
301,Dimitri Bisoli,ITA,MF,Brescia,Serie A,25,1994,23.9,64,35,34,20,10,30,49,61.2,19,41,7,34,25,89,49,0,Matches
302,Yves Bissouma,MLI,MF,Brighton,Premier League,22,1996,14.0,49,38,24,22,3,17,40,42.5,23,18,2,16,21,70,23,0,Matches
303,Leonardo Bittencourt,GER,MF,Hoffenheim,Bundesliga,25,1993,0.0,1,1,0,0,1,0,0,,0,0,0,0,0,1,0,0,Matches
304,Leonardo Bittencourt,GER,"FW,MF",Werder Bremen,Bundesliga,25,1993,21.0,52,28,23,18,11,9,51,17.6,42,20,3,17,12,64,14,0,Matches
305,Birkir Bjarnason,ISL,"MF,FW",Brescia,Serie A,31,1988,8.9,5,3,1,3,1,2,13,15.4,11,9,4,5,5,10,4,0,Matches
306,Rubén Blanco,ESP,GK,Celta Vigo,La Liga,24,1995,32.9,1,1,1,0,0,1,1,100.0,0,0,0,0,0,1,14,1,Matches
307,Ludovic Blas,FRA,"FW,MF",Nantes,Ligue 1,21,1997,20.5,26,18,7,15,4,5,26,19.2,21,17,1,16,14,40,11,0,Matches
308,Pablo de Blasis,ARG,"DF,MF",Eibar,La Liga,31,1988,17.8,41,32,22,13,6,30,63,47.6,33,13,0,13,24,65,21,0,Matches
309,Alejandro Blesa,ESP,MF,Levante,La Liga,17,2002,0.0,0,0,0,0,0,0,1,0.0,1,0,0,0,0,0,0,0,Matches
310,Alexis Blin,FRA,MF,Amiens,Ligue 1,22,1996,20.5,39,25,18,15,6,20,61,32.8,41,25,6,19,16,55,49,0,Matches
311,Jérôme Boateng,GER,DF,Bayern Munich,Bundesliga,30,1988,20.0,21,14,9,12,0,11,22,50.0,11,15,11,4,33,54,58,1,Matches
312,Kevin-Prince Boateng,GHA,FW,Fiorentina,Serie A,32,1987,6.7,3,1,0,2,1,2,8,25.0,6,3,0,3,1,4,7,0,Matches
313,Antonin Bobichon,FRA,MF,Nîmes,Ligue 1,23,1995,2.0,4,3,1,3,0,3,3,100.0,0,1,0,1,1,5,0,0,Matches
314,Antonin Bobichon,FRA,MF,Angers,Ligue 1,23,1995,7.2,9,4,4,5,0,2,19,10.5,17,7,0,7,7,16,4,0,Matches
315,Salvatore Bocchetti,ITA,DF,Hellas Verona,Serie A,32,1986,3.4,5,3,3,2,0,2,3,66.7,1,2,2,0,17,22,23,0,Matches
316,Mathieu Bodmer,FRA,"MF,FW",Amiens,Ligue 1,36,1982,1.0,0,0,0,0,0,0,1,0.0,1,1,1,0,1,1,1,0,Matches
317,Adam Bodzek,GER,MF,Düsseldorf,Bundesliga,33,1985,22.4,42,26,21,20,1,14,46,30.4,32,34,11,23,25,67,39,0,Matches
318,Jean-Paul Boëtius,NED,MF,Mainz 05,Bundesliga,25,1994,25.2,63,33,21,31,11,20,57,35.1,37,38,1,37,26,89,6,0,Matches
319,Sacha Boey,FRA,DF,Rennes,Ligue 1,18,2000,1.9,6,4,3,1,2,4,8,50.0,4,0,0,0,2,8,5,0,Matches
320,Jeremie Boga,CIV,FW,Sassuolo,Serie A,22,1997,27.9,12,7,3,8,1,6,20,30.0,14,24,0,24,3,15,4,0,Matches
321,Melayro Bogarde,NED,DF,Hoffenheim,Bundesliga,17,2002,0.6,2,1,2,0,0,2,2,100.0,0,0,0,0,0,2,3,0,Matches
322,Quentin Boisgard,FRA,"MF,FW",Toulouse,Ligue 1,22,1997,12.7,31,19,10,14,7,14,35,40.0,21,11,0,11,12,43,4,1,Matches
323,Willy Boly,CIV,DF,Wolves,Premier League,28,1991,22.0,57,33,36,21,0,25,43,58.1,18,28,11,17,39,96,108,3,Matches
324,Giacomo Bonaventura,ITA,"MF,FW",Milan,Serie A,29,1989,14.9,16,9,5,6,5,5,17,29.4,12,8,3,5,7,23,10,0,Matches
325,Federico Bonazzoli,ITA,FW,Sampdoria,Serie A,22,1997,8.3,7,5,1,4,2,0,7,0.0,7,3,0,3,5,12,2,0,Matches
326,Gaëtan Bong,CMR,"DF,MF",Brighton,Premier League,31,1988,0.7,1,0,0,0,1,0,0,,0,1,1,0,0,1,0,0,Matches
327,Kevin Bonifazi,ITA,DF,Torino,Serie A,23,1996,2.7,9,8,6,3,0,5,6,83.3,1,3,2,1,5,14,10,0,Matches
328,Kevin Bonifazi,ITA,DF,SPAL,Serie A,23,1996,13.2,16,9,15,1,0,9,18,50.0,9,20,12,8,35,51,50,2,Matches
329,Federico Bonini,ITA,DF,Bologna,Serie A,17,2001,0.1,0,0,0,0,0,0,0,,0,0,0,0,0,0,0,0,Matches
330,Leonardo Bonucci,ITA,DF,Juventus,Serie A,32,1987,34.2,28,17,18,8,2,12,17,70.6,5,32,29,3,31,59,94,2,Matches
331,Fabio Borini,ITA,"MF,FW",Hellas Verona,Serie A,28,1991,9.0,2,1,2,0,0,0,4,0.0,4,3,0,3,13,15,6,0,Matches
332,Fabio Borini,ITA,MF,Milan,Serie A,28,1991,0.8,2,2,0,0,2,0,2,0.0,2,1,0,1,0,2,3,0,Matches
333,Dennis Borkowski,GER,FW,RB Leipzig,Bundesliga,17,2002,0.1,0,0,0,0,0,0,0,,0,0,0,0,0,0,0,0,Matches
334,Robin Bormuth,GER,DF,Düsseldorf,Bundesliga,23,1995,2.0,2,1,2,0,0,2,3,66.7,1,6,5,1,0,2,12,0,Matches
335,Sebastiaan Bornauw,BEL,DF,Köln,Bundesliga,20,1999,27.2,37,24,24,12,1,20,39,51.3,19,32,12,20,42,79,99,0,Matches
336,Brandon Borrello,AUS,"MF,FW",Freiburg,Bundesliga,24,1995,3.3,10,4,6,4,0,4,10,40.0,6,7,1,6,1,11,1,0,Matches
337,Gabriel Boschilia,BRA,"MF,FW",Monaco,Ligue 1,23,1996,1.4,3,1,0,3,0,1,5,20.0,4,1,1,0,2,5,2,0,Matches
338,Denis Bouanga,GAB,"FW,MF",Saint-Étienne,Ligue 1,24,1994,22.7,45,34,10,25,10,20,55,36.4,35,30,0,30,10,55,15,0,Matches
339,Hicham Boudaoui,ALG,"MF,FW",Nice,Ligue 1,19,1999,5.4,20,10,6,11,3,9,23,39.1,14,10,3,7,13,33,7,0,Matches
340,Ryad Boudebouz,ALG,"MF,FW",Saint-Étienne,Ligue 1,29,1990,17.7,25,16,9,14,2,8,25,32.0,17,14,1,13,7,32,5,0,Matches
341,Sofiane Boufal,MAR,"MF,FW",Southampton,Premier League,25,1993,8.5,16,8,6,5,5,6,15,40.0,9,17,0,17,4,20,1,0,Matches
342,Nassim Boujellab,MAR,"MF,FW",Schalke 04,Bundesliga,20,1999,4.7,12,10,5,4,3,5,14,35.7,9,8,1,7,7,19,5,0,Matches
343,Farid Boulaya,ALG,FW,Metz,Ligue 1,26,1993,9.1,14,10,7,4,3,7,19,36.8,12,5,0,5,6,20,3,0,Matches
344,Yassine Bounou,MAR,GK,Sevilla,La Liga,28,1991,5.5,0,0,0,0,0,0,0,,0,0,0,0,0,0,0,0,Matches
345,Mehdi Bourabia,MAR,MF,Sassuolo,Serie A,27,1991,10.3,19,9,8,10,1,9,22,40.9,13,12,2,10,22,41,23,0,Matches
346,Benjamin Bourigeaud,FRA,MF,Rennes,Ligue 1,25,1994,21.1,40,12,18,20,2,17,68,25.0,51,38,7,31,20,60,25,0,Matches
347,Bilal Boutobba,FRA,MF,Montpellier,Ligue 1,20,1998,0.1,0,0,0,0,0,0,1,0.0,1,0,0,0,0,0,0,0,Matches
348,Jarrod Bowen,ENG,"FW,MF",West Ham,Premier League,22,1996,10.2,19,15,7,9,3,4,17,23.5,13,6,0,6,16,35,8,0,Matches
349,Dedryck Boyata,BEL,DF,Hertha BSC,Bundesliga,28,1990,27.1,24,18,17,5,2,4,12,33.3,8,39,32,7,62,86,158,1,Matches
350,John Boye,GHA,DF,Metz,Ligue 1,32,1987,23.5,30,19,25,5,0,19,32,59.4,13,31,18,13,31,61,116,0,Matches
351,Can Bozdogan,GER,MF,Schalke 04,Bundesliga,18,2001,2.6,8,6,5,3,0,3,12,25.0,9,2,0,2,2,10,2,0,Matches
352,Domagoj Bradarić,CRO,DF,Lille,Ligue 1,19,1999,15.8,28,11,9,17,2,12,27,44.4,15,16,3,13,22,50,28,0,Matches
353,Filip Bradarić,CRO,MF,Celta Vigo,La Liga,27,1992,7.8,12,9,5,5,2,3,8,37.5,5,12,3,9,17,29,19,0,Matches
354,Robbie Brady,IRL,MF,Burnley,Premier League,27,1992,5.0,11,9,5,4,2,3,10,30.0,7,10,2,8,5,16,8,0,Matches
355,Martin Braithwaite,DEN,"FW,MF",Barcelona,La Liga,28,1991,4.5,2,2,2,0,0,0,8,0.0,8,3,0,3,1,3,1,0,Matches
356,Martin Braithwaite,DEN,"FW,MF",Leganés,La Liga,28,1991,21.5,13,7,4,5,4,4,12,33.3,8,10,2,8,4,17,9,0,Matches
357,Federico Brancolini,ITA,GK,Fiorentina,Serie A,18,2001,0.1,0,0,0,0,0,0,0,,0,0,0,0,0,0,0,0,Matches
358,Brandon,ESP,FW,Osasuna,La Liga,24,1995,4.5,5,3,1,3,1,0,5,0.0,5,4,0,4,0,5,1,0,Matches
359,Julian Brandt,GER,"MF,FW",Dortmund,Bundesliga,23,1996,24.5,48,33,15,21,12,25,55,45.5,30,35,2,33,16,64,10,1,Matches
360,Jarrad Branthwaite,ENG,DF,Everton,Premier League,17,2002,3.3,8,7,5,3,0,3,5,60.0,2,6,3,3,2,10,12,0,Matches
361,Darko Brašanac,SRB,MF,Osasuna,La Liga,27,1992,24.9,45,25,14,26,5,15,41,36.6,26,19,4,15,20,65,21,0,Matches
362,Claudio Bravo,CHI,GK,Manchester City,Premier League,36,1983,3.9,0,0,0,0,0,0,0,,0,0,0,0,0,0,1,1,Matches
363,Josip Brekalo,CRO,"MF,FW",Wolfsburg,Bundesliga,21,1998,18.6,18,8,5,6,7,5,23,21.7,18,26,0,26,16,34,4,0,Matches
364,Gleison Bremer,BRA,DF,Torino,Serie A,22,1997,25.2,63,36,37,20,6,20,34,58.8,14,48,22,26,74,137,118,1,Matches
365,Marco Brescianini,ITA,MF,Milan,Serie A,19,2000,0.3,1,1,1,0,0,0,0,,0,0,0,0,2,3,0,0,Matches
366,Anthony Briançon,FRA,DF,Nîmes,Ligue 1,24,1994,19.3,29,19,20,9,0,17,34,50.0,17,22,16,6,39,68,80,0,Matches
367,Jimmy Briand,FRA,FW,Bordeaux,Ligue 1,33,1985,16.9,12,8,5,4,3,3,13,23.1,10,8,4,4,6,18,12,0,Matches
368,Yan Brice Eteki,CMR,MF,Granada,La Liga,21,1997,16.7,37,21,14,18,5,15,31,48.4,16,17,4,13,24,61,20,1,Matches
369,Armando Broja,ALB,FW,Chelsea,Premier League,17,2001,0.1,0,0,0,0,0,0,0,,0,0,0,0,0,0,0,0,Matches
370,Dylan Bronn,TUN,DF,Metz,Ligue 1,24,1995,9.0,7,5,6,1,0,4,7,57.1,3,11,9,2,6,13,42,0,Matches
371,David Brooks,WAL,"MF,FW",Bournemouth,Premier League,22,1997,5.6,5,5,1,2,2,2,14,14.3,12,5,1,4,2,7,1,0,Matches
372,John Brooks,USA,DF,Wolfsburg,Bundesliga,26,1993,24.7,38,27,27,9,2,24,49,49.0,25,31,12,19,41,79,93,0,Matches
373,Daniel Brosinski,GER,DF,Mainz 05,Bundesliga,31,1988,19.0,40,27,13,23,4,15,34,44.1,19,16,2,14,14,54,58,0,Matches
374,Josh Brownhill,ENG,MF,Burnley,Premier League,23,1995,8.9,14,8,5,7,2,5,13,38.5,8,9,4,5,14,28,18,0,Matches
375,Marcelo Brozović,CRO,MF,Inter,Serie A,26,1992,30.0,67,35,26,31,10,19,71,26.8,52,26,9,17,46,113,46,2,Matches
376,Gastón Brugman,URU,MF,Parma,Serie A,26,1992,16.2,47,24,25,15,7,19,46,41.3,27,33,15,18,27,74,19,2,Matches
377,Jeffrey Bruma,NED,DF,Wolfsburg,Bundesliga,27,1991,9.0,9,5,4,5,0,7,13,53.8,6,6,3,3,13,22,51,1,Matches
378,Jeffrey Bruma,NED,DF,Mainz 05,Bundesliga,27,1991,7.5,12,8,8,4,0,4,6,66.7,2,11,5,6,6,18,34,1,Matches
379,Jacob Bruun Larsen,DEN,"FW,MF",Hoffenheim,Bundesliga,20,1998,4.3,3,2,3,0,0,3,8,37.5,5,3,0,3,3,6,1,0,Matches
380,Jacob Bruun Larsen,DEN,FW,Dortmund,Bundesliga,20,1998,0.8,0,0,0,0,0,0,0,,0,0,0,0,0,0,0,0,Matches
381,Lucas Buadés,FRA,"MF,FW",Nîmes,Ligue 1,21,1997,1.3,4,4,3,1,0,1,5,20.0,4,0,0,0,1,5,3,0,Matches
382,Ante Budimir,CRO,FW,Mallorca,La Liga,28,1991,30.7,31,15,4,22,5,7,29,24.1,22,21,4,17,8,39,29,0,Matches
383,Emi Buendía,ARG,"FW,MF",Norwich City,Premier League,22,1996,27.4,82,39,57,21,4,38,118,32.2,80,58,5,53,23,105,32,2,Matches
384,Gianluigi Buffon,ITA,GK,Juventus,Serie A,41,1978,9.0,0,0,0,0,0,0,0,,0,0,0,0,0,0,3,1,Matches
385,Marius Bülter,GER,"MF,FW",Union Berlin,Bundesliga,26,1993,25.8,38,22,19,13,6,17,54,31.5,37,37,3,34,11,49,20,1,Matches
386,Esteban Burgos,ARG,DF,Eibar,La Liga,27,1992,12.4,11,9,9,2,0,5,9,55.6,4,11,6,5,17,28,66,2,Matches
387,Guido Burgstaller,AUT,FW,Schalke 04,Bundesliga,30,1989,13.7,7,3,0,5,2,4,15,26.7,11,12,3,9,4,11,10,0,Matches
388,Burgui,ESP,MF,Alavés,La Liga,25,1993,0.2,0,0,0,0,0,0,0,,0,0,0,0,0,0,0,0,Matches
389,Jonathan Burkardt,GER,"FW,MF",Mainz 05,Bundesliga,19,2000,2.8,9,4,2,5,2,3,8,37.5,5,6,1,5,0,9,1,0,Matches
390,Oliver Burke,SCO,"MF,FW",Alavés,La Liga,22,1997,15.9,19,14,8,9,2,10,23,43.5,13,24,0,24,8,27,16,0,Matches
391,Roman Bürki,SUI,GK,Dortmund,Bundesliga,28,1990,30.8,2,2,2,0,0,2,3,66.7,1,1,0,1,2,4,13,1,Matches
392,Dan Burn,ENG,DF,Brighton,Premier League,27,1992,32.0,67,42,35,27,5,25,53,47.2,28,44,20,24,42,109,130,0,Matches
393,Patrick Burner,MTQ,DF,Nice,Ligue 1,23,1996,15.9,35,25,15,17,3,14,25,56.0,11,11,2,9,30,65,37,0,Matches
394,Sergio Busquets,ESP,MF,Barcelona,La Liga,31,1988,27.6,80,44,23,43,14,41,71,57.7,30,36,5,31,44,124,24,2,Matches
395,Unai Bustinza,ESP,DF,Leganés,La Liga,27,1992,29.8,66,40,40,19,7,32,53,60.4,21,30,9,21,65,131,77,0,Matches
396,Ludovic Butelle,FRA,GK,Angers,Ligue 1,36,1983,26.0,1,1,1,0,0,1,2,50.0,1,1,0,1,0,1,10,4,Matches
397,Marcin Bułka,POL,GK,Paris S-G,Ligue 1,19,1999,1.0,0,0,0,0,0,0,0,,0,0,0,0,0,0,0,0,Matches
398,Sam Byram,ENG,DF,Norwich City,Premier League,25,1993,14.4,40,22,24,11,5,18,37,48.6,19,16,8,8,26,66,73,0,Matches
399,Erick Cabaco,URU,DF,Getafe,La Liga,24,1995,3.0,3,2,1,2,0,0,3,0.0,3,1,1,0,3,6,11,0,Matches
400,Erick Cabaco,URU,DF,Levante,La Liga,24,1995,9.0,12,9,9,3,0,4,6,66.7,2,12,7,5,12,24,50,1,Matches
401,Willy Caballero,ARG,GK,Chelsea,Premier League,37,1981,5.0,0,0,0,0,0,0,0,,0,0,0,0,0,0,3,0,Matches
402,Yohan Cabaye,FRA,MF,Saint-Étienne,Ligue 1,33,1986,9.5,29,18,11,14,4,14,25,56.0,11,10,0,10,22,51,7,1,Matches
403,Manuel Cabit,MTQ,DF,Metz,Ligue 1,26,1993,3.0,3,1,1,2,0,2,10,20.0,8,5,0,5,4,7,5,0,Matches
404,Ariday Cabrera,ESP,MF,Mallorca,La Liga,30,1988,0.4,1,1,1,0,0,0,1,0.0,1,2,0,2,0,1,0,0,Matches
405,Leandro Cabrera,URU,DF,Getafe,La Liga,28,1991,17.0,10,6,5,5,0,5,12,41.7,7,10,4,6,21,31,66,0,Matches
406,Leandro Cabrera,URU,DF,Espanyol,La Liga,28,1991,17.0,27,11,17,9,1,17,28,60.7,11,19,12,7,21,48,78,1,Matches
407,Fabrizio Cacciatore,ITA,DF,Cagliari,Serie A,32,1986,12.8,14,4,9,4,1,6,9,66.7,3,10,6,4,16,30,44,0,Matches
408,Martín Cáceres,URU,DF,Fiorentina,Serie A,32,1987,26.2,47,31,34,11,2,16,34,47.1,18,29,13,16,31,78,74,2,Matches
409,Anthony Caci,FRA,DF,Strasbourg,Ligue 1,22,1997,7.7,29,17,19,9,1,8,17,47.1,9,15,5,10,19,48,15,1,Matches
410,Jhonder Cádiz,VEN,"FW,MF",Dijon,Ligue 1,24,1995,8.9,16,8,6,7,3,3,7,42.9,4,4,2,2,1,17,9,0,Matches
411,Mathieu Cafaro,FRA,"FW,MF",Reims,Ligue 1,22,1997,10.3,12,6,5,5,2,6,17,35.3,11,13,0,13,2,14,0,0,Matches
412,Jonathan Cafu,BRA,DF,Bordeaux,Ligue 1,28,1991,2.2,7,3,4,3,0,4,7,57.1,3,1,0,1,1,8,3,0,Matches
413,Gary Cahill,ENG,DF,Crystal Palace,Premier League,33,1985,24.1,15,8,11,4,0,7,15,46.7,8,34,25,9,18,33,114,1,Matches
414,Felipe Caicedo,ECU,FW,Lazio,Serie A,30,1988,15.6,17,10,4,7,6,2,11,18.2,9,9,1,8,4,21,2,0,Matches
415,Arturo Calabresi,ITA,DF,Amiens,Ligue 1,23,1996,20.9,53,33,29,20,4,33,75,44.0,42,24,11,13,29,82,60,0,Matches
416,Davide Calabria,ITA,DF,Milan,Serie A,22,1996,18.0,52,33,28,22,2,17,41,41.5,24,23,5,18,21,73,47,1,Matches
417,Riccardo Calafiori,ITA,DF,Roma,Serie A,17,2002,0.7,0,0,0,0,0,0,1,0.0,1,0,0,0,2,2,0,0,Matches
418,Mattia Caldara,ITA,DF,Atalanta,Serie A,25,1994,10.7,21,11,12,8,1,5,11,45.5,6,9,5,4,30,51,22,1,Matches
419,Marco Calderoni,ITA,DF,Lecce,Serie A,30,1989,22.9,38,25,22,13,3,20,39,51.3,19,27,10,17,37,75,54,1,Matches
420,Fernando Calero,ESP,DF,Espanyol,La Liga,23,1995,11.6,14,9,10,4,0,7,15,46.7,8,13,5,8,8,22,42,1,Matches
421,Duje Ćaleta-Car,CRO,DF,Marseille,Ligue 1,22,1996,21.0,29,15,17,11,1,18,26,69.2,8,17,6,11,26,55,98,0,Matches
422,Hakan Çalhanoğlu,TUR,"MF,FW",Milan,Serie A,25,1994,30.0,42,21,15,21,6,12,35,34.3,23,26,2,24,26,68,26,1,Matches
423,Daniel Caligiuri,ITA,"MF,FW",Schalke 04,Bundesliga,31,1988,25.5,58,37,18,25,15,27,74,36.5,47,67,6,61,25,83,39,0,Matches
424,José Callejón,ESP,"FW,MF",Napoli,Serie A,32,1987,24.1,13,9,3,7,3,9,25,36.0,16,15,3,12,10,23,14,1,Matches
425,Jonathan Calleri,ARG,FW,Espanyol,La Liga,25,1993,20.1,12,8,6,4,2,3,24,12.5,21,11,3,8,7,19,22,0,Matches
426,Dominic Calvert-Lewin,ENG,FW,Everton,Premier League,22,1997,29.2,7,5,1,4,2,1,10,10.0,9,15,2,13,6,13,36,0,Matches
427,Mahdi Camara,FRA,MF,Saint-Étienne,Ligue 1,21,1998,10.0,33,20,12,16,5,18,32,56.3,14,20,2,18,18,51,5,0,Matches
428,Souleymane Camara,SEN,FW,Montpellier,Ligue 1,36,1982,1.8,0,0,0,0,0,0,2,0.0,2,0,0,0,0,0,1,0,Matches
429,Víctor Camarasa,ESP,FW,Crystal Palace,Premier League,25,1994,0.1,0,0,0,0,0,0,0,,0,0,0,0,0,0,0,0,Matches
430,Víctor Camarasa,ESP,MF,Alavés,La Liga,25,1994,14.4,18,10,5,10,3,7,18,38.9,11,8,3,5,15,33,12,0,Matches
431,Eduardo Camavinga,FRA,MF,Rennes,Ligue 1,16,2002,23.4,105,64,45,56,4,48,96,50.0,48,26,8,18,34,139,35,0,Matches
432,Sergio Camello,ESP,FW,Atlético Madrid,La Liga,18,2001,0.3,0,0,0,0,0,0,0,,0,0,0,0,0,0,0,0,Matches
433,José Campaña,ESP,MF,Levante,La Liga,26,1993,35.1,38,25,15,13,10,13,53,24.5,40,30,5,25,44,82,42,2,Matches
434,Xisco Campos,ESP,DF,Mallorca,La Liga,37,1982,5.3,7,4,5,2,0,5,9,55.6,4,8,5,3,11,18,23,0,Matches
435,Víctor Campuzano,ESP,FW,Espanyol,La Liga,22,1997,9.7,12,9,1,6,5,3,19,15.8,16,8,0,8,2,14,4,0,Matches
436,Emre Can,GER,MF,Juventus,Serie A,25,1994,3.2,10,7,5,3,2,3,10,30.0,7,4,0,4,2,12,3,0,Matches
437,Emre Can,GER,"MF,DF",Dortmund,Bundesliga,25,1994,10.6,19,12,11,7,1,5,12,41.7,7,14,6,8,19,38,15,0,Matches
438,Sergio Canales,ESP,"MF,FW",Betis,La Liga,28,1991,35.1,25,16,14,6,5,7,28,25.0,21,30,1,29,13,38,16,0,Matches
439,João Cancelo,POR,DF,Manchester City,Premier League,25,1994,13.4,40,24,21,12,7,24,40,60.0,16,9,2,7,21,61,18,0,Matches
440,Antonio Candreva,ITA,DF,Inter,Serie A,32,1987,22.1,11,6,9,1,1,7,29,24.1,22,26,10,16,14,25,33,1,Matches
441,Gianmarco Cangiano,ITA,"FW,MF",Bologna,Serie A,17,2001,0.2,1,1,0,1,0,0,0,,0,0,0,0,1,2,0,0,Matches
442,Todd Cantwell,ENG,"FW,MF",Norwich City,Premier League,21,1998,27.7,51,31,19,27,5,26,73,35.6,47,38,2,36,18,69,35,1,Matches
443,Ander Capa,ESP,DF,Athletic Club,La Liga,27,1992,31.9,64,36,37,21,6,24,59,40.7,35,26,7,19,28,92,63,0,Matches
444,Pierrick Capelle,FRA,"MF,DF",Angers,Ligue 1,32,1987,19.4,42,32,18,16,8,16,48,33.3,32,17,3,14,21,63,28,0,Matches
445,Étienne Capoue,FRA,MF,Watford,Premier League,31,1988,29.2,75,40,38,30,7,37,85,43.5,48,30,11,19,68,143,61,0,Matches
446,Gianluca Caprari,ITA,"FW,MF",Sampdoria,Serie A,26,1993,7.4,9,7,1,6,2,4,13,30.8,9,5,0,5,7,16,1,0,Matches
447,Gianluca Caprari,ITA,"FW,MF",Parma,Serie A,26,1993,6.5,1,1,0,1,0,0,5,0.0,5,7,2,5,4,5,2,0,Matches
448,Francesco Caputo,ITA,FW,Sassuolo,Serie A,31,1987,32.6,7,4,3,2,2,3,11,27.3,8,15,0,15,1,8,8,0,Matches
449,Maxence Caqueret,FRA,MF,Lyon,Ligue 1,19,2000,6.3,24,15,10,13,1,11,25,44.0,14,14,2,12,9,33,6,1,Matches
450,Andrea Carboni,ITA,DF,Cagliari,Serie A,18,2001,4.1,8,4,3,5,0,3,4,75.0,1,6,6,0,7,15,20,0,Matches
451,Irvin Cardona,FRA,"FW,MF",Brest,Ligue 1,21,1997,16.1,13,8,5,6,2,9,32,28.1,23,8,0,8,1,14,7,0,Matches
452,Marc Cardona,ESP,FW,Osasuna,La Liga,24,1995,7.8,1,0,0,1,0,0,8,0.0,8,3,1,2,2,3,2,0,Matches
453,Diego Carlos,BRA,DF,Sevilla,La Liga,26,1993,34.8,35,23,25,9,1,15,25,60.0,10,33,24,9,37,72,176,1,Matches
454,Lionel Carole,FRA,DF,Strasbourg,Ligue 1,28,1991,14.1,23,8,15,6,2,13,17,76.5,4,2,1,1,19,42,22,0,Matches
455,Yannick Carrasco,BEL,"MF,FW",Atlético Madrid,La Liga,25,1993,7.0,11,7,4,4,3,7,21,33.3,14,9,0,9,5,16,2,0,Matches
456,Daniel Carriço,POR,DF,Sevilla,La Liga,30,1988,9.4,8,2,4,3,1,1,6,16.7,5,4,3,1,8,16,23,0,Matches
457,Guido Carrillo,ARG,FW,Leganés,La Liga,28,1991,13.5,13,10,3,6,4,2,14,14.3,12,9,1,8,3,16,22,0,Matches
458,Andy Carroll,ENG,FW,Newcastle Utd,Premier League,30,1989,7.0,5,3,3,2,0,2,8,25.0,6,2,1,1,2,7,24,1,Matches
459,Dani Carvajal,ESP,DF,Real Madrid,La Liga,27,1992,30.4,65,46,33,25,7,23,42,54.8,19,43,14,29,36,101,53,0,Matches
460,Matis Carvalho,POR,GK,Montpellier,Ligue 1,20,1999,0.8,0,0,0,0,0,0,1,0.0,1,0,0,0,0,0,1,0,Matches
461,William Carvalho,POR,MF,Betis,La Liga,27,1992,9.9,7,4,4,2,1,4,14,28.6,10,7,5,2,4,11,8,1,Matches
462,Casemiro,BRA,MF,Real Madrid,La Liga,27,1992,34.3,96,60,43,45,8,39,99,39.4,60,53,10,43,68,164,72,0,Matches
463,Moreto Cassamã,GNB,MF,Reims,Ligue 1,21,1998,6.6,17,11,2,13,2,5,7,71.4,2,7,2,5,5,22,6,0,Matches
464,Francesco Cassata,ITA,MF,Genoa,Serie A,22,1997,16.2,20,10,12,5,3,9,30,30.0,21,12,2,10,11,31,11,0,Matches
465,Timothy Castagne,BEL,DF,Atalanta,Serie A,23,1995,19.7,31,20,9,16,6,13,25,52.0,12,34,5,29,17,48,23,0,Matches
466,Koen Casteels,BEL,GK,Wolfsburg,Bundesliga,27,1992,26.0,0,0,0,0,0,0,0,,0,0,0,0,0,0,9,1,Matches
467,Jean-Charles Castelletto,CMR,DF,Brest,Ligue 1,24,1995,20.4,18,9,13,5,0,9,18,50.0,9,20,16,4,33,51,87,1,Matches
468,Samu Castillejo,ESP,"FW,MF",Milan,Serie A,24,1995,13.4,24,15,10,11,3,9,42,21.4,33,17,2,15,24,48,5,0,Matches
469,Jonny Castro,ESP,"MF,DF",Wolves,Premier League,25,1994,32.1,91,55,54,26,11,29,82,35.4,53,45,10,35,53,144,45,2,Matches
470,Lucas Castro,ARG,MF,SPAL,Serie A,30,1989,4.7,13,5,5,5,3,2,4,50.0,2,4,0,4,2,15,3,0,Matches
471,Lucas Castro,ARG,MF,Cagliari,Serie A,30,1989,6.7,7,3,3,4,0,1,12,8.3,11,6,1,5,8,15,14,0,Matches
472,Gaetano Castrovilli,ITA,MF,Fiorentina,Serie A,22,1997,29.7,59,31,25,23,11,18,53,34.0,35,29,2,27,15,74,31,1,Matches
473,Danilo Cataldi,ITA,MF,Lazio,Serie A,24,1994,6.6,17,11,10,5,2,10,20,50.0,10,7,1,6,13,30,10,0,Matches
474,Craig Cathcart,NIR,DF,Watford,Premier League,30,1989,27.6,41,26,25,15,1,10,24,41.7,14,19,16,3,25,66,136,1,Matches
475,Edinson Cavani,URU,FW,Paris S-G,Ligue 1,32,1987,6.7,5,1,0,2,3,0,3,0.0,3,7,0,7,1,6,2,0,Matches
476,Santi Cazorla,ESP,MF,Villarreal,La Liga,34,1984,27.2,48,25,14,21,13,20,57,35.1,37,23,1,22,19,67,16,2,Matches
477,Dani Ceballos,ESP,MF,Arsenal,Premier League,22,1996,18.8,45,23,26,14,5,18,61,29.5,43,14,3,11,32,77,16,1,Matches
478,Federico Ceccherini,ITA,DF,Fiorentina,Serie A,27,1992,9.3,14,8,11,3,0,10,10,100.0,0,9,5,4,13,27,37,1,Matches
479,Christian Celesia,ITA,DF,Torino,Serie A,17,2002,0.0,0,0,0,0,0,0,0,,0,0,0,0,0,0,0,0,Matches
480,Zeki Çelik,TUR,DF,Lille,Ligue 1,22,1997,23.0,53,28,18,28,7,27,60,45.0,33,24,4,20,26,79,39,0,Matches
481,Fabien Centonze,FRA,DF,Metz,Ligue 1,23,1996,28.0,76,49,53,22,1,34,57,59.6,23,30,11,19,59,135,98,0,Matches
482,Luca Ceppitelli,ITA,DF,Cagliari,Serie A,29,1989,13.8,22,15,16,6,0,6,11,54.5,5,23,17,6,23,45,66,2,Matches
483,Alberto Cerri,ITA,FW,SPAL,Serie A,23,1996,4.7,2,1,0,2,0,1,3,33.3,2,1,0,1,0,2,3,0,Matches
484,Alberto Cerri,ITA,FW,Cagliari,Serie A,23,1996,2.7,3,1,1,0,2,2,6,33.3,4,1,0,1,2,5,4,0,Matches
485,Julian Chabot,GER,DF,Sampdoria,Serie A,21,1998,6.3,11,7,6,5,0,6,11,54.5,5,3,2,1,15,26,26,0,Matches
486,Florian Chabrolle,FRA,MF,Marseille,Ligue 1,21,1998,0.2,0,0,0,0,0,0,0,,0,0,0,0,0,0,0,0,Matches
487,Fouad Chafik,MAR,DF,Dijon,Ligue 1,32,1986,17.0,32,21,22,7,3,17,36,47.2,19,12,5,7,26,58,36,0,Matches
488,Sofian Chakla,MAR,DF,Villarreal,La Liga,25,1993,2.0,0,0,0,0,0,0,1,0.0,1,2,1,1,3,3,7,1,Matches
489,Nathaniel Chalobah,ENG,MF,Watford,Premier League,24,1994,10.3,30,11,13,13,4,12,27,44.4,15,10,4,6,18,48,20,0,Matches
490,Calum Chambers,ENG,DF,Arsenal,Premier League,24,1995,12.2,26,10,12,8,6,11,16,68.8,5,13,7,6,16,42,43,1,Matches
491,Jhon Chancellor,VEN,DF,Brescia,Serie A,27,1992,24.9,30,14,22,8,0,11,22,50.0,11,34,29,5,34,64,145,3,Matches
492,Timothy Chandler,USA,"DF,MF",Eint Frankfurt,Bundesliga,29,1990,13.6,22,10,9,8,5,9,16,56.3,7,9,4,5,13,35,21,0,Matches
493,Kwon Chang-hoon,KOR,"MF,FW",Freiburg,Bundesliga,25,1994,7.5,7,4,2,3,2,1,10,10.0,9,5,1,4,7,14,14,0,Matches
494,Gaëtan Charbonnier,FRA,"FW,MF",Brest,Ligue 1,30,1988,22.9,36,16,11,11,14,10,35,28.6,25,19,6,13,7,43,33,1,Matches
495,Brendan Chardonnet,FRA,DF,Brest,Ligue 1,24,1994,9.1,12,6,10,2,0,7,12,58.3,5,8,5,3,15,27,50,0,Matches
496,Charles,BRA,FW,Eibar,La Liga,35,1984,14.5,10,5,0,6,4,4,22,18.2,18,7,2,5,7,17,6,0,Matches
497,Xavier Chavalerin,FRA,MF,Reims,Ligue 1,28,1991,23.9,71,52,29,33,9,19,49,38.8,30,23,8,15,36,107,36,0,Matches
498,Pablo Chavarría,ARG,"FW,MF",Mallorca,La Liga,31,1988,2.3,1,1,0,1,0,0,4,0.0,4,1,1,0,1,2,2,0,Matches
499,Aurélien Chedjou,CMR,DF,Amiens,Ligue 1,34,1985,21.9,27,19,18,9,0,10,22,45.5,12,15,11,4,40,67,120,3,Matches
500,Pape Cheikh Diop,SEN,MF,Celta Vigo,La Liga,21,1997,6.7,10,4,6,3,1,2,12,16.7,10,4,2,2,5,15,3,0,Matches
501,Chema,ESP,DF,Getafe,La Liga,27,1992,3.4,4,3,1,3,0,1,2,50.0,1,1,0,1,5,9,12,0,Matches
502,Rayan Cherki,FRA,"MF,FW",Lyon,Ligue 1,15,2003,1.6,3,2,0,1,2,3,4,75.0,1,3,0,3,0,3,0,0,Matches
503,Denis Cheryshev,RUS,"MF,FW",Valencia,La Liga,28,1990,10.3,16,9,5,4,7,3,17,17.6,14,15,1,14,7,23,10,0,Matches
504,Giorgio Chiellini,ITA,DF,Juventus,Serie A,34,1984,2.2,3,0,3,0,0,1,1,100.0,0,2,2,0,1,4,9,0,Matches
505,Federico Chiesa,ITA,"FW,DF",Fiorentina,Serie A,21,1997,29.3,38,22,13,15,10,10,52,19.2,42,19,0,19,6,44,6,0,Matches
506,Ben Chilwell,ENG,DF,Leicester City,Premier League,22,1996,26.4,43,26,28,13,2,23,52,44.2,29,30,6,24,28,71,68,2,Matches
507,Vlad Chiricheș,ROU,DF,Sassuolo,Serie A,29,1989,7.9,14,9,12,2,0,7,10,70.0,3,13,8,5,11,25,28,2,Matches
508,Tahith Chong,NED,"FW,DF",Manchester Utd,Premier League,19,1999,0.4,0,0,0,0,0,0,0,,0,0,0,0,0,0,0,0,Matches
509,Joris Chotard,FRA,MF,Montpellier,Ligue 1,17,2001,13.9,30,18,13,17,0,15,35,42.9,20,12,5,7,20,50,12,1,Matches
510,Hamza Choudhury,ENG,MF,Leicester City,Premier League,21,1997,9.9,17,8,7,8,2,3,25,12.0,22,15,6,9,24,41,13,0,Matches
511,Mounir Chouiar,FRA,"MF,FW",Dijon,Ligue 1,20,1999,16.7,36,23,13,18,5,12,42,28.6,30,8,0,8,13,49,13,0,Matches
512,Andreas Christensen,DEN,DF,Chelsea,Premier League,23,1996,19.5,38,21,25,12,1,15,21,71.4,6,12,8,4,29,67,56,0,Matches
513,Samuel Chukwueze,NGA,"FW,MF",Villarreal,La Liga,20,1999,22.8,23,14,12,6,5,13,30,43.3,17,15,1,14,10,33,14,1,Matches
514,Darko Churlinov,MKD,MF,Köln,Bundesliga,19,2000,0.2,1,1,1,0,0,1,2,50.0,1,0,0,0,1,2,0,0,Matches
515,Churripi,ESP,GK,Valladolid,La Liga,25,1994,2.7,1,1,1,0,0,1,1,100.0,0,0,0,0,0,1,2,0,Matches
516,Luca Cigarini,ITA,MF,Cagliari,Serie A,33,1986,17.8,37,20,23,13,1,16,40,40.0,24,28,10,18,20,57,29,0,Matches
517,Per Ciljan Skjelbred,NOR,MF,Hertha BSC,Bundesliga,32,1987,18.1,50,30,18,29,3,17,41,41.5,24,14,3,11,23,73,17,0,Matches
518,Jasper Cillessen,NED,GK,Valencia,La Liga,30,1989,23.3,0,0,0,0,0,0,1,0.0,1,0,0,0,3,3,3,1,Matches
519,Thiago Cionek,POL,DF,SPAL,Serie A,33,1986,24.1,53,32,36,12,5,22,53,41.5,31,30,11,19,46,99,91,2,Matches
520,Ibrahim Cissé,CIV,DF,Nice,Ligue 1,20,1999,0.6,1,1,1,0,0,0,0,,0,0,0,0,0,1,6,0,Matches
521,Ibrahim Cissé,SEN,DF,Angers,Ligue 1,23,1996,0.7,2,1,0,2,0,0,0,,0,0,0,0,0,2,2,0,Matches
522,Andrea Cistana,ITA,DF,Brescia,Serie A,22,1997,20.4,20,8,13,7,0,6,17,35.3,11,38,34,4,33,53,96,1,Matches
523,Ciaran Clark,IRL,DF,Newcastle Utd,Premier League,29,1989,13.2,20,12,18,2,0,9,15,60.0,6,18,14,4,11,31,82,0,Matches
524,Leon Clarke,ENG,"FW,MF",Sheffield Utd,Premier League,34,1985,0.4,0,0,0,0,0,0,0,,0,0,0,0,0,0,2,0,Matches
525,Alexis Claude-Maurice,FRA,"FW,MF",Nice,Ligue 1,21,1998,18.1,26,16,8,11,7,13,35,37.1,22,20,4,16,11,37,4,0,Matches
526,Christian Clemens,GER,FW,Köln,Bundesliga,27,1991,0.2,0,0,0,0,0,0,0,,0,1,1,0,0,0,0,0,Matches
527,Óscar Clemente,ESP,MF,Atlético Madrid,La Liga,20,1999,0.0,0,0,0,0,0,0,0,,0,1,0,1,0,0,0,0,Matches
528,Yannis Clementia,MTQ,GK,Nice,Ligue 1,22,1997,2.0,0,0,0,0,0,0,0,,0,0,0,0,0,0,0,0,Matches
529,Denilho Cleonise,NED,FW,Genoa,Serie A,17,2001,0.5,1,0,1,0,0,0,0,,0,0,0,0,1,2,0,0,Matches
530,Carlos Clerc,ESP,DF,Levante,La Liga,27,1992,20.5,28,16,14,13,1,12,20,60.0,8,22,9,13,22,50,61,0,Matches
531,Tom Cleverley,ENG,MF,Watford,Premier League,29,1989,10.8,28,15,8,14,6,9,36,25.0,27,13,1,12,10,38,15,0,Matches
532,Conor Coady,ENG,DF,Wolves,Premier League,26,1993,38.0,36,23,30,6,0,15,30,50.0,15,22,15,7,28,64,119,2,Matches
533,Marcus Coco,FRA,FW,Nantes,Ligue 1,23,1996,0.2,1,0,1,0,0,1,1,100.0,0,0,0,0,0,1,0,0,Matches
534,Renaud Cohade,FRA,MF,Metz,Ligue 1,34,1984,8.5,28,20,11,12,5,12,28,42.9,16,14,3,11,8,36,6,0,Matches
535,Coke,ESP,DF,Levante,La Liga,32,1987,11.0,25,18,14,8,3,14,30,46.7,16,9,2,7,13,38,19,0,Matches
536,Séamus Coleman,IRL,DF,Everton,Premier League,30,1988,20.4,42,31,24,14,4,19,25,76.0,6,21,9,12,24,66,43,1,Matches
537,Álex Collado,ESP,FW,Barcelona,La Liga,20,1999,0.1,0,0,0,0,0,0,0,,0,0,0,0,0,0,0,0,Matches
538,Ebrima Colley,GAM,FW,Atalanta,Serie A,19,2000,0.9,2,1,1,0,1,1,2,50.0,1,1,0,1,1,3,0,0,Matches
539,Omar Colley,GAM,DF,Sampdoria,Serie A,26,1992,30.8,42,26,27,14,1,12,24,50.0,12,33,22,11,59,101,155,1,Matches
540,Jamilu Collins,NGA,DF,Paderborn 07,Bundesliga,24,1994,29.6,69,43,44,21,4,37,62,59.7,25,53,19,34,70,139,91,1,Matches
541,Simone Colombi,ITA,GK,Parma,Serie A,28,1991,4.0,0,0,0,0,0,0,0,,0,0,0,0,0,0,1,0,Matches
542,Lorenzo Colombo,ITA,FW,Milan,Serie A,17,2002,0.1,0,0,0,0,0,0,0,,0,0,0,0,0,0,0,0,Matches
543,Racine Coly,SEN,"DF,FW",Nice,Ligue 1,23,1995,7.2,21,13,15,5,1,9,17,52.9,8,5,0,5,12,33,23,0,Matches
544,Kingsley Coman,FRA,"FW,MF",Bayern Munich,Bundesliga,23,1996,16.7,19,11,6,7,6,12,27,44.4,15,9,0,9,4,23,3,0,Matches
545,Daniel Congré,FRA,DF,Montpellier,Ligue 1,34,1985,21.6,37,27,20,16,1,18,38,47.4,20,8,7,1,47,84,66,1,Matches
546,Aaron Connolly,IRL,FW,Brighton,Premier League,19,2000,14.0,7,6,1,4,2,3,10,30.0,7,11,0,11,0,7,3,0,Matches
547,Andrea Consigli,ITA,GK,Sassuolo,Serie A,32,1987,31.0,0,0,0,0,0,0,1,0.0,1,0,0,0,4,4,19,2,Matches
548,Andrea Conti,ITA,DF,Milan,Serie A,25,1994,19.2,41,25,23,15,3,21,49,42.9,28,21,8,13,43,84,42,1,Matches
549,Lewis Cook,ENG,"MF,FW",Bournemouth,Premier League,22,1997,15.0,27,14,15,9,3,10,47,21.3,37,17,5,12,17,44,17,1,Matches
550,Steve Cook,ENG,DF,Bournemouth,Premier League,28,1991,27.0,22,11,18,4,0,8,20,40.0,12,32,23,9,44,66,153,1,Matches
551,Francis Coquelin,FRA,MF,Valencia,La Liga,28,1991,21.2,37,21,25,11,1,16,38,42.1,22,19,9,10,38,75,25,0,Matches
552,Gabriele Corbo,ITA,DF,Bologna,Serie A,19,2000,1.4,1,1,1,0,0,0,3,0.0,3,2,2,0,4,5,5,0,Matches
553,Sébastien Corchia,FRA,DF,Espanyol,La Liga,28,1990,3.0,2,1,2,0,0,2,4,50.0,2,5,2,3,5,7,8,0,Matches
554,Iñigo Córdoba,ESP,FW,Athletic Club,La Liga,22,1997,16.0,33,20,16,12,5,14,52,26.9,38,30,2,28,16,49,13,0,Matches
555,Jhon Córdoba,COL,FW,Köln,Bundesliga,26,1993,22.2,9,6,1,5,3,3,13,23.1,10,19,1,18,5,14,17,0,Matches
556,Sergio Córdova,VEN,FW,Augsburg,Bundesliga,21,1997,4.1,3,0,0,2,1,1,10,10.0,9,0,0,0,0,3,3,0,Matches
557,Benjamin Corgnet,FRA,"MF,FW",Strasbourg,Ligue 1,32,1987,2.9,1,1,1,0,0,1,3,33.3,2,2,0,2,2,3,3,0,Matches
558,Jack Cork,ENG,MF,Burnley,Premier League,30,1989,29.0,35,24,10,20,5,12,62,19.4,50,34,12,22,28,63,49,0,Matches
559,Andreas Cornelius,DEN,FW,Parma,Serie A,26,1993,16.6,9,4,2,5,2,4,11,36.4,7,7,0,7,2,11,26,0,Matches
560,Maxwel Cornet,CIV,"FW,DF",Lyon,Ligue 1,22,1996,14.8,30,19,18,8,4,13,23,56.5,10,16,1,15,21,51,19,1,Matches
561,Quentin Cornette,FRA,"FW,MF",Amiens,Ligue 1,25,1994,3.9,8,3,3,2,3,3,9,33.3,6,7,1,6,6,14,5,0,Matches
562,Ángel Correa,ARG,"MF,FW",Atlético Madrid,La Liga,24,1995,22.9,25,9,7,9,9,9,36,25.0,27,23,5,18,14,39,21,0,Matches
563,Joaquín Correa,ARG,FW,Lazio,Serie A,24,1994,22.2,13,7,3,7,3,5,24,20.8,19,5,1,4,7,20,10,0,Matches
564,Rober Correa,ESP,DF,Eibar,La Liga,26,1992,10.3,13,6,8,3,2,6,10,60.0,4,6,4,2,16,29,31,0,Matches
565,Edmilson Correia,GNB,"FW,DF",Saint-Étienne,Ligue 1,19,2000,0.5,0,0,0,0,0,0,1,0.0,1,1,0,1,1,1,0,0,Matches
566,Thierry Correia,POR,DF,Valencia,La Liga,20,1999,2.9,8,3,5,3,0,1,2,50.0,1,5,0,5,2,10,10,0,Matches
567,Antonio Cortés,ESP,"FW,MF",Granada,La Liga,19,2000,2.0,1,1,0,1,0,0,1,0.0,1,0,0,0,0,1,2,0,Matches
568,Danny da Costa,GER,"DF,FW",Eint Frankfurt,Bundesliga,26,1993,15.4,26,17,14,8,4,6,16,37.5,10,16,1,15,15,41,26,0,Matches
569,Diego Costa,ESP,FW,Atlético Madrid,La Liga,30,1988,15.0,9,5,1,4,4,1,10,10.0,9,4,2,2,3,12,10,0,Matches
570,Douglas Costa,BRA,"FW,MF",Juventus,Serie A,28,1990,8.9,2,1,1,1,0,1,12,8.3,11,7,0,7,5,7,5,0,Matches
571,Jaume Costa,ESP,DF,Valencia,La Liga,31,1988,15.4,27,23,17,8,2,14,28,50.0,14,11,6,5,24,51,52,1,Matches
572,Angelo da Costa Júnior,BRA,GK,Bologna,Serie A,35,1983,1.0,0,0,0,0,0,0,0,,0,0,0,0,0,0,0,0,Matches
573,Nuno da Costa,CPV,FW,Strasbourg,Ligue 1,28,1991,5.9,15,10,3,8,4,4,10,40.0,6,7,0,7,4,19,3,0,Matches
574,David Costas,ESP,DF,Celta Vigo,La Liga,24,1995,3.8,4,3,3,1,0,2,4,50.0,2,3,3,0,8,12,12,0,Matches
575,Benoît Costil,FRA,GK,Bordeaux,Ligue 1,32,1987,28.0,0,0,0,0,0,0,3,0.0,3,0,0,0,2,2,9,0,Matches
576,Kalifa Coulibaly,MLI,FW,Nantes,Ligue 1,27,1991,18.0,11,7,0,5,6,3,5,60.0,2,3,1,2,6,17,32,0,Matches
577,Senou Coulibaly,MLI,DF,Dijon,Ligue 1,24,1994,7.4,14,7,11,3,0,2,4,50.0,2,11,10,1,10,24,44,1,Matches
578,Yoann Court,FRA,"FW,MF",Brest,Ligue 1,29,1990,16.3,48,26,28,17,3,20,64,31.3,44,21,0,21,15,63,14,0,Matches
579,Thibaut Courtois,BEL,GK,Real Madrid,La Liga,27,1992,34.0,0,0,0,0,0,0,2,0.0,2,0,0,0,2,2,18,2,Matches
580,Philippe Coutinho,BRA,"MF,FW",Bayern Munich,Bundesliga,27,1992,15.7,21,15,1,13,7,2,13,15.4,11,9,2,7,6,27,0,0,Matches
581,Nicolas Cozza,FRA,DF,Montpellier,Ligue 1,20,1999,6.2,5,5,3,2,0,2,3,66.7,1,8,6,2,9,14,18,0,Matches
582,Alessio Cragno,ITA,GK,Cagliari,Serie A,25,1994,16.0,0,0,0,0,0,0,0,,0,0,0,0,0,0,10,0,Matches
583,Aaron Cresswell,ENG,DF,West Ham,Premier League,29,1989,30.3,43,26,21,18,4,23,46,50.0,23,33,10,23,35,78,75,2,Matches
584,Domenico Criscito,ITA,DF,Genoa,Serie A,32,1986,22.8,53,33,34,12,7,24,56,42.9,32,25,13,12,53,106,81,1,Matches
585,Bryan Cristante,ITA,MF,Roma,Serie A,24,1995,18.0,25,15,6,14,5,8,27,29.6,19,13,4,9,22,47,23,0,Matches
586,Sebastián Cristóforo,URU,MF,Fiorentina,Serie A,25,1993,1.0,5,5,2,2,1,1,5,20.0,4,2,1,1,1,6,0,0,Matches
587,Sebastián Cristóforo,URU,MF,Eibar,La Liga,25,1993,9.7,35,19,11,14,10,13,32,40.6,19,25,3,22,8,43,2,0,Matches
588,Juan Cuadrado,COL,"DF,FW",Juventus,Serie A,31,1988,29.5,67,43,32,28,7,35,62,56.5,27,22,8,14,35,102,47,0,Matches
589,Cucho,COL,"FW,MF",Mallorca,La Liga,20,1999,16.5,15,8,6,8,1,6,21,28.6,15,14,1,13,10,25,15,0,Matches
590,Marc Cucurella,ESP,"MF,DF",Getafe,La Liga,21,1998,36.0,74,51,23,38,13,24,76,31.6,52,58,8,50,36,110,28,1,Matches
591,Iván Cuéllar,ESP,GK,Leganés,La Liga,35,1984,27.0,0,0,0,0,0,0,2,0.0,2,0,0,0,0,0,28,2,Matches
592,Jaume Cuéllar,BOL,"MF,FW",SPAL,Serie A,17,2001,0.8,1,0,0,0,1,0,1,0.0,1,0,0,0,0,1,0,0,Matches
593,Mickaël Cuisance,FRA,"MF,FW",Bayern Munich,Bundesliga,19,1999,3.4,2,1,0,2,0,1,9,11.1,8,1,1,0,3,5,0,0,Matches
594,Matheus Cunha,BRA,"FW,MF",Hertha BSC,Bundesliga,20,1999,8.3,10,5,6,4,0,4,11,36.4,7,11,1,10,10,20,1,0,Matches
595,Matheus Cunha,BRA,"FW,MF",RB Leipzig,Bundesliga,20,1999,3.1,6,2,0,1,5,0,2,0.0,2,5,1,4,1,7,0,0,Matches
596,Felipe Curcio,BRA,DF,Brescia,Serie A,25,1993,0.1,0,0,0,0,0,0,0,,0,0,0,0,0,0,0,0,Matches
597,Patrick Cutrone,ITA,FW,Wolves,Premier League,21,1998,3.3,4,2,2,1,1,1,5,20.0,4,1,1,0,2,6,1,0,Matches
598,Patrick Cutrone,ITA,FW,Fiorentina,Serie A,21,1998,9.3,4,2,2,1,1,1,15,6.7,14,6,1,5,2,6,6,0,Matches
599,Wylan Cyprien,FRA,MF,Nice,Ligue 1,24,1995,19.7,17,11,5,12,0,7,27,25.9,20,8,2,6,19,36,16,3,Matches
600,Rafael Czichos,GER,DF,Köln,Bundesliga,29,1990,24.5,43,34,26,16,1,22,45,48.9,23,24,13,11,35,78,110,1,Matches
601,Lennart-Marten Czyborra,GER,DF,Atalanta,Serie A,20,1999,0.2,0,0,0,0,0,0,0,,0,2,0,2,0,0,0,0,Matches
602,Marco D'Alessandro,ITA,"MF,DF",SPAL,Serie A,28,1991,8.7,11,8,5,3,3,5,8,62.5,3,11,0,11,5,16,6,0,Matches
603,Danilo D'Ambrosio,ITA,DF,Inter,Serie A,30,1988,15.6,30,16,16,12,2,16,33,48.5,17,15,4,11,14,44,25,0,Matches
604,Felice D'Amico,ITA,MF,Sampdoria,Serie A,18,2000,0.0,1,1,0,0,1,0,0,,0,0,0,0,0,1,0,0,Matches
605,Lucas Da Cunha,FRA,MF,Rennes,Ligue 1,18,2001,0.8,1,0,1,0,0,1,1,100.0,0,0,0,0,0,1,0,0,Matches
606,Jacopo Da Riva,ITA,MF,Atalanta,Serie A,18,2000,0.0,0,0,0,0,0,0,0,,0,0,0,0,0,0,0,0,Matches
607,Damien Da Silva,FRA,DF,Rennes,Ligue 1,31,1988,24.9,27,14,20,5,2,10,19,52.6,9,21,13,8,26,53,143,1,Matches
608,Moanes Dabbur,ISR,FW,Sevilla,La Liga,27,1992,0.3,1,1,0,0,1,0,0,,0,1,0,1,0,1,0,0,Matches
609,Moanes Dabbur,ISR,FW,Hoffenheim,Bundesliga,27,1992,8.5,8,5,1,3,4,3,10,30.0,7,6,2,4,4,12,1,0,Matches
610,Bryan Dabo,BFA,MF,SPAL,Serie A,27,1992,12.5,18,10,13,4,1,5,15,33.3,10,13,2,11,9,27,14,0,Matches
611,Colin Dagba,FRA,DF,Paris S-G,Ligue 1,20,1998,7.4,10,4,2,4,4,5,9,55.6,4,6,1,5,6,16,9,0,Matches
612,Mahmoud Dahoud,GER,MF,Dortmund,Bundesliga,23,1996,6.2,10,6,4,4,2,6,18,33.3,12,8,2,6,8,18,4,0,Matches
613,Leon Dajaku,GER,"DF,MF",Bayern Munich,Bundesliga,18,2001,0.1,0,0,0,0,0,0,1,0.0,1,0,0,0,0,0,0,0,Matches
614,Felipe dal Belo,BRA,DF,SPAL,Serie A,35,1984,11.1,13,6,9,4,0,9,15,60.0,6,14,12,2,9,22,30,0,Matches
615,Christian Dalle Mura,ITA,FW,Fiorentina,Serie A,17,2002,0.0,0,0,0,0,0,0,0,,0,0,0,0,0,0,0,0,Matches
616,Diogo Dalot,POR,"DF,MF",Manchester Utd,Premier League,20,1999,0.7,3,2,3,0,0,3,4,75.0,1,1,0,1,2,5,1,0,Matches
617,Charlie Daniels,ENG,DF,Bournemouth,Premier League,32,1986,1.4,1,1,0,1,0,0,1,0.0,1,2,0,2,1,2,5,1,Matches
618,Danilo,BRA,DF,Juventus,Serie A,28,1991,16.0,30,20,16,12,2,18,30,60.0,12,12,3,9,26,56,44,0,Matches
619,Arnaut Danjuma,NED,MF,Bournemouth,Premier League,22,1997,7.0,4,2,3,1,0,1,4,25.0,3,2,0,2,8,12,4,1,Matches
620,Scott Dann,ENG,DF,Crystal Palace,Premier League,32,1987,14.1,8,4,7,1,0,8,14,57.1,6,9,7,2,14,22,67,0,Matches
621,Kevin Danso,AUT,DF,Southampton,Premier League,20,1998,3.1,6,4,3,3,0,4,7,57.1,3,7,3,4,2,8,7,0,Matches
622,Dante,BRA,DF,Nice,Ligue 1,35,1983,21.0,34,21,24,10,0,17,25,68.0,8,27,16,11,26,60,79,0,Matches
623,Andrea Danzi,ITA,MF,Hellas Verona,Serie A,20,1999,0.0,0,0,0,0,0,0,0,,0,0,0,0,0,0,0,0,Matches
624,Sergi Darder,ESP,MF,Espanyol,La Liga,25,1993,29.5,47,23,11,26,10,17,58,29.3,41,30,1,29,24,71,23,1,Matches
625,Vladimír Darida,CZE,MF,Hertha BSC,Bundesliga,28,1990,25.1,50,27,14,31,5,11,48,22.9,37,44,7,37,27,77,19,2,Matches
626,Matteo Darmian,ITA,DF,Parma,Serie A,29,1989,29.8,81,42,48,30,3,40,83,48.2,43,38,16,22,25,106,78,1,Matches
627,Alphonso Davies,CAN,DF,Bayern Munich,Bundesliga,18,2000,24.8,70,43,35,24,11,38,58,65.5,20,35,6,29,31,101,51,0,Matches
628,Ben Davies,WAL,DF,Tottenham,Premier League,26,1993,15.9,28,15,13,11,4,7,21,33.3,14,28,12,16,22,50,47,0,Matches
629,Tom Davies,ENG,MF,Everton,Premier League,21,1998,22.5,38,17,12,22,4,17,55,30.9,38,12,4,8,35,73,28,0,Matches
630,Keinan Davis,ENG,FW,Aston Villa,Premier League,21,1998,6.1,1,1,0,1,0,0,3,0.0,3,4,0,4,0,1,3,0,Matches
631,Paweł Dawidowicz,POL,DF,Hellas Verona,Serie A,24,1995,7.7,15,12,11,4,0,5,11,45.5,6,6,5,1,12,27,26,0,Matches
632,Craig Dawson,ENG,DF,Watford,Premier League,29,1990,26.2,29,18,16,13,0,17,31,54.8,14,41,32,9,34,63,116,0,Matches
633,Kevin De Bruyne,BEL,MF,Manchester City,Premier League,28,1991,31.0,45,24,8,20,17,18,66,27.3,48,26,4,22,18,63,24,2,Matches
634,Sebastien De Maio,FRA,DF,Udinese,Serie A,32,1987,16.7,18,11,11,7,0,7,11,63.6,4,28,20,8,32,50,86,2,Matches
635,Rodrigo De Paul,ARG,MF,Udinese,Serie A,25,1994,31.4,61,31,31,26,4,27,65,41.5,38,38,3,35,29,90,8,1,Matches
636,Mattia De Sciglio,ITA,DF,Juventus,Serie A,26,1992,5.2,10,8,6,4,0,6,14,42.9,8,5,2,3,8,18,18,1,Matches
637,Lorenzo De Silvestri,ITA,DF,Torino,Serie A,31,1988,24.9,15,8,4,7,4,11,27,40.7,16,20,7,13,19,34,72,0,Matches
638,Lucas Deaux,FRA,MF,Nîmes,Ligue 1,30,1988,14.8,49,26,16,29,4,16,45,35.6,29,20,4,16,15,64,19,0,Matches
639,Mathieu Debuchy,FRA,DF,Saint-Étienne,Ligue 1,34,1985,19.7,44,26,22,15,7,24,47,51.1,23,21,11,10,43,87,59,0,Matches
640,Troy Deeney,ENG,FW,Watford,Premier League,31,1988,24.7,19,12,6,10,3,6,29,20.7,23,13,1,12,11,30,27,0,Matches
641,Grégoire Defrel,MTQ,"FW,MF",Sassuolo,Serie A,28,1991,10.9,12,8,4,6,2,4,15,26.7,11,9,0,9,3,15,5,0,Matches
642,Alessandro Deiola,ITA,MF,Cagliari,Serie A,23,1995,0.0,0,0,0,0,0,0,0,,0,0,0,0,1,1,0,0,Matches
643,Alessandro Deiola,ITA,MF,Lecce,Serie A,23,1995,8.0,16,9,9,7,0,9,24,37.5,15,12,4,8,8,24,14,1,Matches
644,Romain Del Castillo,FRA,"FW,MF",Rennes,Ligue 1,23,1996,13.8,20,14,5,11,4,6,27,22.2,21,12,2,10,7,27,7,0,Matches
645,Thomas Delaine,FRA,DF,Metz,Ligue 1,27,1992,13.9,25,16,18,6,1,12,21,57.1,9,17,1,16,15,40,28,0,Matches
646,Thomas Delaney,DEN,MF,Dortmund,Bundesliga,27,1991,9.2,22,10,10,11,1,9,15,60.0,6,16,7,9,26,48,26,0,Matches
647,Paul Delecroix,FRA,GK,Metz,Ligue 1,30,1988,1.5,0,0,0,0,0,0,0,,0,0,0,0,0,0,0,0,Matches
648,Cristian Dell'Orco,ITA,DF,Lecce,Serie A,25,1994,11.2,22,12,14,7,1,8,14,57.1,6,11,7,4,16,38,33,0,Matches
649,Andy Delort,ALG,FW,Montpellier,Ligue 1,27,1991,25.3,28,18,11,9,8,7,27,25.9,20,21,6,15,3,31,10,0,Matches
650,Fabian Delph,ENG,MF,Everton,Premier League,29,1989,13.2,26,12,10,13,3,9,22,40.9,13,12,3,9,15,41,19,1,Matches
651,Moussa Dembélé,FRA,FW,Lyon,Ligue 1,23,1996,24.3,12,7,2,5,5,4,14,28.6,10,14,3,11,5,17,31,0,Matches
652,Ousmane Dembélé,FRA,FW,Barcelona,La Liga,22,1997,4.0,2,2,1,1,0,2,5,40.0,3,4,0,4,0,2,0,1,Matches
653,Merih Demiral,TUR,DF,Juventus,Serie A,21,1998,4.6,8,7,5,3,0,1,3,33.3,2,4,3,1,4,12,16,1,Matches
654,Kerem Demirbay,GER,MF,Leverkusen,Bundesliga,26,1993,17.5,35,19,10,21,4,12,31,38.7,19,19,5,14,22,57,7,1,Matches
655,Diego Demme,GER,MF,Napoli,Serie A,27,1991,10.0,18,8,14,3,1,8,23,34.8,15,9,1,8,8,26,9,0,Matches
656,Diego Demme,GER,MF,RB Leipzig,Bundesliga,27,1991,13.5,41,18,17,19,5,17,42,40.5,25,14,2,12,15,56,14,0,Matches
657,Jason Denayer,BEL,DF,Lyon,Ligue 1,24,1995,23.7,17,13,12,5,0,10,14,71.4,4,32,29,3,20,37,83,0,Matches
658,Leander Dendoncker,BEL,"MF,DF",Wolves,Premier League,24,1995,31.1,68,31,41,19,8,28,67,41.8,39,39,12,27,38,106,64,2,Matches
659,Kévin Denkey,TOG,FW,Nîmes,Ligue 1,18,2000,6.7,10,5,1,8,1,6,10,60.0,4,7,0,7,2,12,1,1,Matches
660,Stefano Denswil,SUR,DF,Bologna,Serie A,26,1993,24.9,49,28,29,19,1,26,44,59.1,18,23,8,15,31,80,68,0,Matches
661,Fabio Depaoli,ITA,"MF,DF",Sampdoria,Serie A,22,1997,20.6,41,28,26,10,5,17,31,54.8,14,29,3,26,16,57,39,0,Matches
662,Kastriot Dermaku,ALB,DF,Parma,Serie A,27,1992,11.4,13,5,10,3,0,3,5,60.0,2,20,16,4,12,25,61,1,Matches
663,Daniele Dessena,ITA,MF,Brescia,Serie A,32,1987,20.8,21,11,5,14,2,6,25,24.0,19,11,1,10,11,32,21,0,Matches
664,Mattia Destro,ITA,FW,Bologna,Serie A,28,1991,2.1,3,2,1,2,0,1,3,33.3,2,1,0,1,0,3,0,0,Matches
665,Mattia Destro,ITA,"FW,MF",Genoa,Serie A,28,1991,1.7,0,0,0,0,0,0,0,,0,0,0,0,0,0,1,0,Matches
666,Gerard Deulofeu,ESP,FW,Watford,Premier League,25,1994,23.3,33,16,18,9,6,12,59,20.3,47,10,0,10,25,58,6,0,Matches
667,Deyverson,BRA,FW,Getafe,La Liga,28,1991,2.3,0,0,0,0,0,0,1,0.0,1,2,1,1,0,0,5,0,Matches
668,Samuel Di Carmine,ITA,"FW,MF",Hellas Verona,Serie A,30,1988,14.4,2,1,0,0,2,0,8,0.0,8,3,0,3,1,3,10,0,Matches
669,Federico Di Francesco,ITA,FW,SPAL,Serie A,25,1994,12.0,11,5,2,6,3,3,15,20.0,12,9,1,8,3,14,2,1,Matches
670,Giovanni Di Lorenzo,ITA,DF,Napoli,Serie A,25,1993,33.0,59,35,27,19,13,32,61,52.5,29,27,11,16,28,87,54,0,Matches
671,Ángel Di María,ARG,"FW,MF",Paris S-G,Ligue 1,31,1988,22.2,17,12,2,8,7,4,34,11.8,30,14,3,11,11,28,1,3,Matches
672,Boulaye Dia,SEN,FW,Reims,Ligue 1,22,1996,20.1,15,9,7,6,2,3,10,30.0,7,9,2,7,7,22,16,0,Matches
673,Fousseni Diabaté,MLI,"FW,MF",Amiens,Ligue 1,23,1995,13.2,16,10,6,6,4,5,16,31.3,11,11,0,11,8,24,3,1,Matches
674,Moussa Diaby,FRA,"FW,MF",Leverkusen,Bundesliga,20,1999,19.7,10,8,3,7,0,5,15,33.3,10,6,0,6,9,19,4,0,Matches
675,Mouctar Diakhaby,GUI,DF,Valencia,La Liga,22,1996,16.0,11,8,7,3,1,5,8,62.5,3,17,15,2,11,22,73,0,Matches
676,Bafodé Diakité,FRA,DF,Toulouse,Ligue 1,18,2001,15.2,23,19,15,8,0,7,13,53.8,6,18,9,9,20,43,75,0,Matches
677,Abdou Diallo,SEN,DF,Paris S-G,Ligue 1,23,1996,13.3,20,11,9,10,1,8,14,57.1,6,9,5,4,10,30,32,0,Matches
678,Amad Diallo,CIV,FW,Atalanta,Serie A,17,2002,0.3,1,1,0,1,0,0,0,,0,0,0,0,0,1,0,0,Matches
679,Habib Diallo,SEN,FW,Metz,Ligue 1,24,1995,24.4,2,1,0,2,0,0,6,0.0,6,6,5,1,4,6,43,0,Matches
680,Ibrahima Diallo,FRA,MF,Brest,Ligue 1,20,1999,17.3,38,24,15,22,1,12,29,41.4,17,9,2,7,23,61,16,3,Matches
681,Moussa Diarra,MLI,DF,Toulouse,Ligue 1,18,2000,1.0,3,3,2,1,0,1,1,100.0,0,0,0,0,3,6,2,0,Matches
682,Lucas Dias,FRA,GK,Nîmes,Ligue 1,20,1999,3.5,1,1,1,0,0,1,1,100.0,0,0,0,0,0,1,2,0,Matches
683,Amadou Diawara,GUI,MF,Roma,Serie A,22,1997,16.9,40,25,14,20,6,8,30,26.7,22,10,1,9,33,73,16,2,Matches
684,Brahim Díaz,MAR,FW,Real Madrid,La Liga,19,1999,0.7,1,0,0,1,0,0,2,0.0,2,2,0,2,0,1,0,0,Matches
685,Víctor Díaz,ESP,DF,Granada,La Liga,31,1988,32.0,74,43,38,31,5,31,60,51.7,29,53,23,30,48,122,94,1,Matches
686,Bakaye Dibassy,MLI,DF,Amiens,Ligue 1,29,1989,20.8,26,14,17,8,1,15,20,75.0,5,29,18,11,37,63,78,2,Matches
687,Eric Dier,ENG,"DF,MF",Tottenham,Premier League,25,1994,14.9,21,12,10,10,1,10,20,50.0,10,14,9,5,21,42,65,0,Matches
688,Lucas Digne,FRA,DF,Everton,Premier League,26,1993,33.7,73,49,49,19,5,33,68,48.5,35,39,10,29,42,115,108,0,Matches
689,Mitchell Dijks,NED,DF,Bologna,Serie A,26,1993,11.2,13,10,6,5,2,8,12,66.7,4,5,1,4,10,23,23,0,Matches
690,Javairô Dilrosun,NED,"MF,FW",Hertha BSC,Bundesliga,21,1998,14.5,15,8,11,1,3,5,13,38.5,8,20,0,20,18,33,10,0,Matches
691,Federico Dimarco,ITA,DF,Hellas Verona,Serie A,21,1997,5.8,11,5,4,4,3,6,10,60.0,4,3,2,1,4,15,11,0,Matches
692,Federico Dimarco,ITA,DF,Inter,Serie A,21,1997,0.3,1,0,0,1,0,0,0,,0,0,0,0,1,2,1,0,Matches
693,Tristan Dingomé,CMR,MF,Reims,Ligue 1,28,1991,9.9,10,4,3,6,1,2,12,16.7,10,6,0,6,6,16,1,0,Matches
694,Lois Diony,FRA,FW,Saint-Étienne,Ligue 1,26,1992,7.4,15,5,0,11,4,5,9,55.6,4,3,0,3,1,16,0,0,Matches
695,Issa Diop,FRA,DF,West Ham,Premier League,22,1997,30.7,27,15,18,9,0,16,25,64.0,9,37,21,16,47,74,166,2,Matches
696,Papakouli Diop,SEN,MF,Eibar,La Liga,33,1986,25.0,39,26,13,22,4,18,42,42.9,24,24,7,17,34,73,38,0,Matches
697,Assane Dioussé,SEN,MF,Saint-Étienne,Ligue 1,21,1997,1.3,1,1,0,1,0,0,3,0.0,3,0,0,0,0,1,2,0,Matches
698,Axel Disasi,FRA,DF,Reims,Ligue 1,21,1998,27.0,32,21,18,13,1,17,27,63.0,10,29,24,5,26,58,97,0,Matches
699,Tiago Djaló,POR,DF,Lille,Ligue 1,19,2000,7.3,9,4,5,3,1,2,7,28.6,5,3,2,1,11,20,28,0,Matches
700,Djené,TOG,DF,Getafe,La Liga,27,1991,34.0,42,32,27,15,0,17,30,56.7,13,20,7,13,34,76,105,1,Matches
701,Moussa Djenepo,MLI,"MF,DF",Southampton,Premier League,21,1998,10.3,27,21,13,9,5,11,21,52.4,10,15,1,14,9,36,9,0,Matches
702,Koffi Djidji,CIV,DF,Torino,Serie A,26,1992,9.5,27,12,19,8,0,8,18,44.4,10,28,23,5,15,42,53,1,Matches
703,Alexander Djiku,GHA,"DF,MF",Strasbourg,Ligue 1,24,1994,22.9,46,32,27,19,0,21,29,72.4,8,14,8,6,55,101,82,4,Matches
704,Berat Djimsiti,ALB,DF,Atalanta,Serie A,26,1993,30.9,42,23,17,23,2,22,39,56.4,17,21,14,7,49,91,92,0,Matches
705,Naïs Djouahra,FRA,FW,Real Sociedad,La Liga,19,1999,0.3,0,0,0,0,0,0,0,,0,0,0,0,0,0,0,0,Matches
706,Marko Dmitrović,SRB,GK,Eibar,La Liga,27,1992,35.0,3,2,3,0,0,3,5,60.0,2,1,0,1,3,6,24,0,Matches
707,Matt Doherty,IRL,"MF,DF",Wolves,Premier League,27,1992,31.5,55,29,34,17,4,27,41,65.9,14,34,4,30,40,95,52,1,Matches
708,Kasper Dolberg,DEN,FW,Nice,Ligue 1,21,1997,21.0,10,6,0,3,7,4,17,23.5,13,18,2,16,10,20,24,0,Matches
709,Keagan Dolly,RSA,MF,Montpellier,Ligue 1,26,1993,1.6,6,3,1,3,2,2,5,40.0,3,1,0,1,1,7,0,0,Matches
710,Jaume Doménech,ESP,GK,Valencia,La Liga,28,1990,14.7,0,0,0,0,0,0,1,0.0,1,0,0,0,1,1,3,1,Matches
711,Nicolás Domínguez,ARG,MF,Bologna,Serie A,21,1998,7.8,21,14,15,5,1,7,18,38.9,11,12,2,10,12,33,7,0,Matches
712,Giulio Donati,ITA,DF,Lecce,Serie A,29,1990,19.6,32,21,22,8,2,15,28,53.6,13,19,10,9,25,57,42,0,Matches
713,Ji Dong-won,KOR,"FW,MF",Mainz 05,Bundesliga,28,1991,1.1,0,0,0,0,0,0,1,0.0,1,1,0,1,0,0,0,0,Matches
714,Anastasios Donis,GRE,FW,Reims,Ligue 1,22,1996,6.8,3,2,2,1,0,1,9,11.1,8,2,0,2,1,4,3,0,Matches
715,Alfredo Donnarumma,ITA,FW,Brescia,Serie A,28,1990,18.7,17,9,3,9,5,6,18,33.3,12,7,0,7,5,22,1,0,Matches
716,Gianluigi Donnarumma,ITA,GK,Milan,Serie A,20,1999,35.6,1,0,1,0,0,1,2,50.0,1,0,0,0,3,4,25,7,Matches
717,Mathieu Dossevi,TOG,"MF,FW",Toulouse,Ligue 1,31,1988,19.5,32,20,7,17,8,15,30,50.0,15,17,0,17,14,46,7,0,Matches
718,Bas Dost,NED,FW,Eint Frankfurt,Bundesliga,30,1989,16.4,11,7,1,7,3,3,7,42.9,4,6,2,4,5,16,22,0,Matches
719,Abdoulaye Doucouré,MLI,MF,Watford,Premier League,26,1993,35.1,64,30,29,29,6,16,57,28.1,41,46,8,38,31,95,32,0,Matches
720,Mamadou Doucouré,FRA,MF,Gladbach,Bundesliga,21,1998,0.0,0,0,0,0,0,0,0,,0,0,0,0,0,0,0,0,Matches
721,Moussa Doumbia,MLI,"FW,MF",Reims,Ligue 1,24,1994,19.1,16,8,5,6,5,7,24,29.2,17,14,1,13,9,25,5,0,Matches
722,Souleyman Doumbia,CIV,DF,Angers,Ligue 1,22,1996,5.0,10,4,7,2,1,5,6,83.3,1,5,0,5,6,16,18,0,Matches
723,Souleyman Doumbia,CIV,DF,Rennes,Ligue 1,22,1996,1.0,1,1,1,0,0,1,1,100.0,0,2,2,0,0,1,3,0,Matches
724,Tommy Doyle,ENG,MF,Manchester City,Premier League,17,2001,0.2,0,0,0,0,0,0,1,0.0,1,0,0,0,0,0,0,0,Matches
725,Mohamed Dräger,TUN,DF,Paderborn 07,Bundesliga,23,1996,16.2,32,21,22,8,2,14,33,42.4,19,17,5,12,18,50,39,0,Matches
726,Aleksandar Dragović,AUT,DF,Leverkusen,Bundesliga,28,1991,11.4,18,11,11,6,1,10,21,47.6,11,9,3,6,15,33,39,0,Matches
727,Bartłomiej Drągowski,POL,GK,Fiorentina,Serie A,21,1997,31.0,0,0,0,0,0,0,1,0.0,1,0,0,0,3,3,8,1,Matches
728,Julian Draxler,GER,MF,Paris S-G,Ligue 1,25,1993,7.6,13,10,2,9,2,7,15,46.7,8,7,1,6,10,23,1,0,Matches
729,Dominick Drexler,GER,"MF,FW",Köln,Bundesliga,29,1990,17.6,34,25,12,19,3,8,32,25.0,24,11,5,6,26,60,11,0,Matches
730,Danny Drinkwater,ENG,MF,Aston Villa,Premier League,29,1990,2.9,5,3,3,2,0,2,18,11.1,16,5,0,5,5,10,5,1,Matches
731,Danny Drinkwater,ENG,MF,Burnley,Premier League,29,1990,0.6,2,1,1,1,0,0,1,0.0,1,0,0,0,1,3,0,0,Matches
732,Josip Drmić,SUI,FW,Norwich City,Premier League,26,1992,7.2,3,2,1,2,0,0,8,0.0,8,6,0,6,1,4,5,1,Matches
733,Domingos Duarte,POR,DF,Granada,La Liga,24,1995,34.3,30,19,24,5,1,11,20,55.0,9,34,24,10,34,64,153,1,Matches
734,Léo Duarte,BRA,DF,Milan,Serie A,23,1996,4.5,4,3,0,3,1,1,4,25.0,3,9,6,3,3,7,9,0,Matches
735,Óscar Duarte,CRC,DF,Levante,La Liga,30,1989,5.4,12,3,11,1,0,3,4,75.0,1,7,6,1,6,18,29,0,Matches
736,Rubén Duarte,ESP,DF,Alavés,La Liga,23,1995,29.6,61,32,30,28,3,34,60,56.7,26,30,8,22,47,108,71,0,Matches
737,Edgaras Dubickas,LTU,DF,Lecce,Serie A,21,1998,0.0,0,0,0,0,0,0,0,,0,0,0,0,0,0,0,0,Matches
738,Leo Dubois,FRA,DF,Lyon,Ligue 1,24,1994,15.0,32,23,20,9,3,13,22,59.1,9,12,4,8,18,50,34,1,Matches
739,Martin Dúbravka,SVK,GK,Newcastle Utd,Premier League,30,1989,38.0,1,1,1,0,0,1,2,50.0,1,2,0,2,1,2,17,5,Matches
740,Ondrej Duda,SVK,MF,Norwich City,Premier League,24,1994,8.0,18,11,9,6,3,7,16,43.8,9,10,2,8,6,24,8,0,Matches
741,Ondrej Duda,SVK,MF,Hertha BSC,Bundesliga,24,1994,5.0,6,4,1,2,3,1,10,10.0,9,3,1,2,5,11,5,0,Matches
742,Shane Duffy,IRL,DF,Brighton,Premier League,27,1992,13.8,18,9,14,4,0,6,17,35.3,11,13,7,6,21,39,72,0,Matches
743,Haris Duljević,BIH,"FW,MF",Nîmes,Ligue 1,25,1993,5.8,11,6,3,7,1,4,12,33.3,8,5,0,5,2,13,1,0,Matches
744,Paul Dummett,WAL,DF,Newcastle Utd,Premier League,27,1991,13.6,27,17,19,7,1,21,27,77.8,6,23,9,14,23,50,69,0,Matches
745,Alfred Duncan,GHA,MF,Fiorentina,Serie A,26,1993,9.9,12,9,11,1,0,2,19,10.5,17,4,0,4,5,17,12,0,Matches
746,Alfred Duncan,GHA,MF,Sassuolo,Serie A,26,1993,9.4,19,12,8,7,4,6,16,37.5,10,7,0,7,9,28,13,0,Matches
747,Lewis Dunk,ENG,DF,Brighton,Premier League,27,1991,35.9,40,24,23,17,0,15,34,44.1,19,55,33,22,55,95,125,2,Matches
748,Erik Durm,GER,"DF,FW",Eint Frankfurt,Bundesliga,27,1992,5.7,13,6,9,2,2,9,17,52.9,8,11,2,9,3,16,11,0,Matches
749,Riza Durmisi,DEN,"DF,MF",Nice,Ligue 1,25,1994,1.8,1,1,1,0,0,0,0,,0,2,1,1,1,2,3,0,Matches
750,Hugo Duro,ESP,"FW,MF",Getafe,La Liga,19,1999,4.2,6,5,2,2,2,4,8,50.0,4,3,0,3,1,7,3,0,Matches
751,Jean-Kevin Duverne,HAI,DF,Brest,Ligue 1,22,1997,13.1,12,8,5,6,1,2,6,33.3,4,23,8,15,20,32,50,0,Matches
752,Paulo Dybala,ARG,"FW,MF",Juventus,Serie A,25,1993,23.9,19,10,6,9,4,9,39,23.1,30,15,0,15,13,32,3,0,Matches
753,Edin Džeko,BIH,FW,Roma,Serie A,33,1986,31.7,16,11,2,7,7,2,13,15.4,11,11,4,7,6,22,33,0,Matches
754,Blerim Džemaili,SUI,MF,Bologna,Serie A,33,1986,7.8,19,12,3,13,3,4,22,18.2,18,9,3,6,7,26,6,0,Matches
755,Bruno Ecuele Manga,GAB,DF,Dijon,Ligue 1,31,1988,28.0,22,15,17,5,0,9,20,45.0,11,34,23,11,37,59,112,2,Matches
756,Simone Edera,ITA,"MF,FW",Torino,Serie A,22,1997,4.4,13,5,3,7,3,2,12,16.7,10,1,0,1,1,14,3,0,Matches
757,Ederson,BRA,GK,Manchester City,Premier League,25,1993,34.1,2,2,2,0,0,2,5,40.0,3,0,0,0,3,5,16,6,Matches
758,John Egan,IRL,DF,Sheffield Utd,Premier League,26,1992,35.4,44,27,34,10,0,25,45,55.6,20,39,27,12,58,102,171,4,Matches
759,Johannes Eggestein,GER,"MF,FW",Werder Bremen,Bundesliga,21,1998,5.7,8,6,2,2,4,3,12,25.0,9,6,0,6,2,10,4,0,Matches
760,Maximilian Eggestein,GER,MF,Werder Bremen,Bundesliga,22,1996,31.7,40,28,20,18,2,15,43,34.9,28,37,8,29,36,76,57,0,Matches
761,Kingsley Ehizibue,NED,DF,Köln,Bundesliga,24,1995,25.9,79,53,44,30,5,33,53,62.3,20,28,8,20,39,118,79,1,Matches
762,Albin Ekdal,SWE,MF,Sampdoria,Serie A,30,1989,26.5,51,25,18,31,2,24,68,35.3,44,35,14,21,33,84,46,1,Matches
763,Harvey Elliott,ENG,DF,Liverpool,Premier League,16,2003,0.1,0,0,0,0,0,0,0,,0,0,0,0,0,0,0,0,Matches
764,Elif Elmas,MKD,MF,Napoli,Serie A,19,1999,12.6,16,7,5,6,5,5,20,25.0,15,11,1,10,11,27,4,0,Matches
765,Ilay Elmkies,ISR,MF,Hoffenheim,Bundesliga,19,2000,0.0,1,1,1,0,0,0,0,,0,0,0,0,0,1,0,0,Matches
766,Ahmed Elmohamady,EGY,DF,Aston Villa,Premier League,31,1987,11.5,19,9,10,7,2,10,21,47.6,11,11,5,6,13,32,25,1,Matches
767,Aritz Elustondo,ESP,DF,Real Sociedad,La Liga,25,1994,16.8,28,17,19,8,1,13,23,56.5,10,21,8,13,15,43,67,0,Matches
768,Nico Elvedi,SUI,DF,Gladbach,Bundesliga,22,1996,29.1,45,27,37,8,0,19,38,50.0,19,32,15,17,62,107,112,0,Matches
769,Rodrigo Ely,BRA,DF,Alavés,La Liga,25,1993,23.6,22,13,15,7,0,13,29,44.8,16,23,19,4,32,54,116,0,Matches
770,Adri Embarba,ESP,"MF,FW",Espanyol,La Liga,27,1992,15.2,37,22,16,16,5,16,33,48.5,17,28,4,24,16,53,11,0,Matches
771,Breel Embolo,SUI,"FW,MF",Gladbach,Bundesliga,22,1997,17.2,22,11,2,15,5,4,15,26.7,11,12,1,11,8,30,5,0,Matches
772,Emerson,BRA,DF,Betis,La Liga,20,1999,31.5,74,46,49,19,6,36,79,45.6,43,30,9,21,31,105,57,1,Matches
773,Renaud Emond,BEL,FW,Nantes,Ligue 1,27,1991,3.2,3,1,0,2,1,1,5,20.0,4,0,0,0,0,3,7,0,Matches
774,Alan Empereur,BRA,DF,Hellas Verona,Serie A,25,1994,9.5,16,8,11,4,1,6,10,60.0,4,19,12,7,22,38,36,0,Matches
775,Youssef En-Nesyri,MAR,FW,Leganés,La Liga,22,1997,15.4,9,7,1,2,6,3,17,17.6,14,15,2,13,5,14,22,0,Matches
776,Youssef En-Nesyri,MAR,FW,Sevilla,La Liga,22,1997,8.8,7,5,1,6,0,3,10,30.0,7,9,3,6,5,12,7,0,Matches
777,Björn Engels,BEL,DF,Aston Villa,Premier League,24,1994,16.1,11,6,8,2,1,8,13,61.5,5,18,17,1,28,39,86,3,Matches
778,Sergi Enrich,ESP,FW,Eibar,La Liga,29,1990,20.7,17,6,4,8,5,4,21,19.0,17,16,2,14,9,26,12,0,Matches
779,Javier Eraso,ESP,MF,Leganés,La Liga,29,1990,9.1,11,5,4,5,2,5,15,33.3,10,5,0,5,7,18,5,0,Matches
780,Christian Eriksen,DEN,"MF,FW",Tottenham,Premier League,27,1992,12.2,19,9,10,8,1,7,24,29.2,17,10,1,9,12,31,16,0,Matches
781,Christian Eriksen,DEN,MF,Inter,Serie A,27,1992,7.8,11,6,2,8,1,5,20,25.0,15,3,0,3,0,11,0,0,Matches
782,Gonzalo Escalante,ARG,MF,Eibar,La Liga,26,1993,18.6,41,22,15,17,9,24,41,58.5,17,22,4,18,29,70,14,0,Matches
783,Aarón Escandell,ESP,GK,Granada,La Liga,23,1995,3.0,1,1,1,0,0,1,1,100.0,0,0,0,0,0,1,0,0,Matches
784,Sergio Escudero,ESP,DF,Sevilla,La Liga,29,1989,8.6,29,16,17,10,2,19,28,67.9,9,11,1,10,13,42,35,0,Matches
785,Bernardo Espinosa,COL,DF,Espanyol,La Liga,30,1989,25.1,24,16,18,4,2,16,28,57.1,12,19,11,8,24,48,108,2,Matches
786,Sebastiano Esposito,ITA,FW,Inter,Serie A,17,2002,2.2,3,2,0,2,1,0,5,0.0,5,3,0,3,3,6,1,0,Matches
787,Vicente Esquerdo,ESP,"MF,FW",Valencia,La Liga,20,1999,0.2,1,0,1,0,0,0,0,,0,1,0,1,0,1,1,0,Matches
788,Alexander Esswein,GER,"FW,MF",Hertha BSC,Bundesliga,29,1990,2.4,6,4,4,2,0,3,8,37.5,5,8,1,7,7,13,7,1,Matches
789,Pervis Estupiñán,ECU,DF,Osasuna,La Liga,21,1998,33.1,84,45,53,27,4,42,77,54.5,35,30,7,23,58,142,61,6,Matches
790,Oghenekaro Etebo,NGA,MF,Getafe,La Liga,23,1995,6.4,12,4,5,7,0,7,12,58.3,5,10,1,9,11,23,4,1,Matches
791,Beñat Etxebarria,ESP,MF,Athletic Club,La Liga,32,1987,4.4,6,1,2,3,1,2,13,15.4,11,6,1,5,4,10,6,0,Matches
792,Xabier Etxeita,ESP,DF,Getafe,La Liga,31,1987,16.1,20,11,11,9,0,12,23,52.2,11,9,5,4,17,37,68,0,Matches
793,Antony Evans,ENG,"MF,DF",Paderborn 07,Bundesliga,20,1998,1.7,5,4,1,3,1,1,5,20.0,4,1,1,0,2,7,4,0,Matches
794,Jonny Evans,NIR,DF,Leicester City,Premier League,31,1988,37.6,48,34,33,14,1,28,39,71.8,11,33,18,15,57,105,174,4,Matches
795,Edu Expósito,ESP,MF,Eibar,La Liga,22,1996,25.7,52,28,12,31,9,18,49,36.7,31,20,6,14,31,83,18,1,Matches
796,Valentin Eysseric,FRA,"MF,FW",Hellas Verona,Serie A,27,1992,3.9,4,4,1,2,1,0,4,0.0,4,3,0,3,1,5,2,0,Matches
797,Valentin Eysseric,FRA,"FW,MF",Fiorentina,Serie A,27,1992,0.5,0,0,0,0,0,0,0,,0,1,0,1,0,0,0,0,Matches
798,Łukasz Fabiański,POL,GK,West Ham,Premier League,34,1985,23.5,2,2,2,0,0,2,4,50.0,2,0,0,0,1,3,5,3,Matches
799,Fabinho,BRA,MF,Liverpool,Premier League,25,1993,23.1,62,35,20,35,7,26,67,38.8,41,25,2,23,34,96,19,1,Matches
800,Fábio,BRA,DF,Nantes,Ligue 1,29,1990,9.3,38,22,18,20,0,25,35,71.4,10,10,5,5,18,56,19,0,Matches
801,Cesc Fàbregas,ESP,MF,Monaco,Ligue 1,32,1987,10.3,11,4,6,3,2,6,29,20.7,23,8,1,7,7,18,3,0,Matches
802,Fabricio,ESP,GK,Mallorca,La Liga,31,1987,1.0,0,0,0,0,0,0,0,,0,0,0,0,0,0,0,1,Matches
803,Ralf Fährmann,GER,GK,Norwich City,Premier League,30,1988,0.2,0,0,0,0,0,0,0,,0,0,0,0,0,0,0,0,Matches
804,Fayçal Fajr,MAR,MF,Getafe,La Liga,30,1988,4.5,1,1,0,1,0,0,3,0.0,3,4,0,4,4,5,1,0,Matches
805,Luca Falbo,ITA,DF,Lazio,Serie A,19,2000,0.0,0,0,0,0,0,0,0,,0,0,0,0,0,0,0,0,Matches
806,Filippo Falco,ITA,"FW,MF",Lecce,Serie A,27,1992,22.4,13,7,4,5,4,5,18,27.8,13,11,1,10,2,15,1,0,Matches
807,Eliseo Falcon,ESP,DF,Levante,La Liga,22,1997,0.8,0,0,0,0,0,0,0,,0,0,0,0,0,0,2,0,Matches
808,Wladimiro Falcone,ITA,GK,Sampdoria,Serie A,24,1995,2.0,0,0,0,0,0,0,0,,0,0,0,0,0,0,0,0,Matches
809,Simon Falette,GUI,DF,Eint Frankfurt,Bundesliga,27,1992,1.0,0,0,0,0,0,0,1,0.0,1,3,3,0,3,3,5,0,Matches
810,Iago Falque,ESP,"FW,MF",Torino,Serie A,29,1990,1.1,0,0,0,0,0,0,1,0.0,1,1,0,1,0,0,0,0,Matches
811,Iago Falque,ESP,MF,Genoa,Serie A,29,1990,5.8,7,3,1,4,2,4,8,50.0,4,7,0,7,1,8,4,0,Matches
812,Akin Famewo,ENG,MF,Norwich City,Premier League,20,1998,0.0,0,0,0,0,0,0,0,,0,0,0,0,0,0,0,0,Matches
813,Andri Fannar Baldursson,ISL,MF,Bologna,Serie A,17,2002,1.6,1,0,0,1,0,0,1,0.0,1,2,0,2,1,2,3,0,Matches
814,Paolo Faragò,ITA,"DF,MF",Cagliari,Serie A,26,1993,14.9,41,28,21,15,5,23,46,50.0,23,18,9,9,10,51,58,0,Matches
815,Davide Faraoni,ITA,DF,Hellas Verona,Serie A,27,1991,35.9,67,37,43,19,5,30,67,44.8,37,50,15,35,36,103,115,0,Matches
816,Mohamed Fares,ALG,"DF,MF",SPAL,Serie A,23,1996,4.7,6,4,3,2,1,2,10,20.0,8,5,3,2,5,11,8,0,Matches
817,Diego Farias,BRA,"MF,FW",Lecce,Serie A,29,1990,9.2,9,6,3,5,1,5,18,27.8,13,7,0,7,4,13,4,0,Matches
818,Ansu Fati,ESP,FW,Barcelona,La Liga,16,2002,11.4,16,8,4,7,5,5,15,33.3,10,14,1,13,8,24,3,0,Matches
819,Julien Faussurier,FRA,DF,Brest,Ligue 1,32,1987,22.0,36,22,23,13,0,21,53,39.6,32,22,7,15,33,69,46,1,Matches
820,Andrea Favilli,ITA,FW,Genoa,Serie A,22,1997,7.3,8,7,2,3,3,4,11,36.4,7,5,1,4,0,8,7,0,Matches
821,Federico Fazio,ARG,DF,Roma,Serie A,32,1987,13.5,19,11,12,6,1,6,11,54.5,5,8,6,2,19,38,52,0,Matches
822,Aleix Febas,ESP,"MF,FW",Mallorca,La Liga,23,1996,18.8,36,24,13,19,4,12,36,33.3,24,15,0,15,17,53,6,0,Matches
823,Zouhair Feddal,MAR,DF,Betis,La Liga,30,1989,15.9,20,13,14,5,1,10,14,71.4,4,15,9,6,23,43,74,0,Matches
824,Ljubomir Fejsa,SRB,MF,Alavés,La Liga,30,1988,8.7,19,13,8,10,1,6,23,26.1,17,8,1,7,6,25,13,0,Matches
825,Nabil Fekir,FRA,"MF,FW",Betis,La Liga,26,1993,29.3,41,26,14,19,8,12,37,32.4,25,27,3,24,10,51,3,0,Matches
826,Felipe,BRA,DF,Atlético Madrid,La Liga,30,1989,23.4,27,19,21,6,0,14,24,58.3,10,18,13,5,40,67,130,0,Matches
827,Luiz Felipe,ITA,DF,Lazio,Serie A,22,1997,22.5,42,24,24,15,3,19,32,59.4,13,39,30,9,41,83,69,2,Matches
828,Lucas Felippe,BRA,"MF,DF",Hellas Verona,Serie A,19,2000,0.3,1,1,1,0,0,1,1,100.0,0,0,0,0,0,1,0,0,Matches
829,João Félix,POR,"FW,MF",Atlético Madrid,La Liga,19,1999,19.4,9,3,3,3,3,4,14,28.6,10,4,0,4,10,19,4,1,Matches
830,Ohis Felix Uduokhai,GER,DF,Augsburg,Bundesliga,21,1997,21.8,43,26,30,12,1,19,29,65.5,10,40,30,10,36,79,125,2,Matches
831,Kiko Femenía,ESP,DF,Watford,Premier League,28,1991,24.9,68,38,49,17,2,43,80,53.8,37,16,2,14,36,104,49,0,Matches
832,Zinedine Ferhat,ALG,"FW,MF",Nîmes,Ligue 1,26,1993,25.0,26,16,5,16,5,15,46,32.6,31,15,3,12,16,42,18,0,Matches
833,Bruno Fernandes,POR,MF,Manchester Utd,Premier League,24,1994,13.2,22,12,9,9,4,5,38,13.2,33,6,0,6,11,33,16,0,Matches
834,Edimilson Fernandes,SUI,"MF,DF",Mainz 05,Bundesliga,23,1996,16.5,33,20,12,15,6,15,33,45.5,18,17,9,8,32,65,47,1,Matches
835,Gedson Fernandes,POR,"MF,DF",Tottenham,Premier League,20,1999,0.8,2,0,2,0,0,0,2,0.0,2,2,0,2,1,3,0,0,Matches
836,Gelson Fernandes,SUI,MF,Eint Frankfurt,Bundesliga,32,1986,8.6,30,18,13,17,0,7,21,33.3,14,11,3,8,16,46,9,2,Matches
837,Matheus Fernandes,BRA,"MF,FW",Valladolid,La Liga,21,1998,1.8,6,2,2,2,2,3,5,60.0,2,4,0,4,2,8,2,0,Matches
838,Aitor Fernández,ESP,GK,Levante,La Liga,28,1991,36.0,1,1,1,0,0,1,1,100.0,0,0,0,0,2,3,18,3,Matches
839,Andrés Fernández,ESP,GK,Villarreal,La Liga,32,1986,4.0,0,0,0,0,0,0,0,,0,0,0,0,0,0,2,0,Matches
840,Carlos Fernández,ESP,"FW,MF",Granada,La Liga,23,1996,24.5,24,15,7,11,6,3,32,9.4,29,25,2,23,11,35,30,0,Matches
841,Federico Fernández,ARG,DF,Newcastle Utd,Premier League,30,1989,29.1,42,25,30,10,2,23,46,50.0,23,41,28,13,24,66,190,2,Matches
842,Gabriel Fernández,URU,"FW,MF",Celta Vigo,La Liga,25,1994,6.2,1,0,0,1,0,1,3,33.3,2,5,1,4,2,3,2,0,Matches
843,Joaquín Fernández,ESP,"MF,DF",Valladolid,La Liga,23,1996,18.4,30,24,17,10,3,9,30,30.0,21,14,10,4,32,62,57,0,Matches
844,Fernandinho,BRA,DF,Manchester City,Premier League,34,1985,26.6,50,35,32,16,2,29,48,60.4,19,28,16,12,25,75,82,0,Matches
845,Fernando,BRA,MF,Sevilla,La Liga,32,1987,29.5,62,33,37,24,1,34,58,58.6,24,38,15,23,67,129,73,1,Matches
846,Juan Ferney Otero,COL,"FW,MF",Amiens,Ligue 1,24,1995,13.4,17,10,6,9,2,8,24,33.3,16,12,1,11,19,36,10,0,Matches
847,Alex Ferrari,ITA,DF,Sampdoria,Serie A,25,1994,11.2,18,13,13,5,0,7,12,58.3,5,13,8,5,12,30,31,0,Matches
848,Facundo Ferreyra,ARG,"FW,MF",Espanyol,La Liga,28,1991,6.4,9,4,4,5,0,3,10,30.0,7,4,0,4,2,11,5,0,Matches
849,Jordan Ferri,FRA,MF,Montpellier,Ligue 1,27,1992,12.8,22,13,7,12,3,13,44,29.5,31,9,0,9,10,32,10,0,Matches
850,Oliver Fink,GER,"MF,FW",Düsseldorf,Bundesliga,37,1982,7.5,21,12,7,11,3,5,16,31.3,11,12,1,11,15,36,7,0,Matches
851,Alfreð Finnbogason,ISL,FW,Augsburg,Bundesliga,30,1989,10.7,11,6,1,9,1,2,7,28.6,5,8,2,6,3,14,8,0,Matches
852,Roberto Firmino,BRA,FW,Liverpool,Premier League,27,1991,33.2,37,19,8,14,15,10,43,23.3,33,34,3,31,7,44,11,1,Matches
853,Junior Firpo,DOM,DF,Barcelona,La Liga,22,1996,11.3,23,15,12,8,3,11,17,64.7,6,15,3,12,17,40,12,1,Matches
854,John Fleck,SCO,MF,Sheffield Utd,Premier League,27,1991,28.0,36,25,13,14,9,22,64,34.4,42,25,3,22,24,60,26,0,Matches
855,Mark Flekken,NED,GK,Freiburg,Bundesliga,26,1993,10.0,0,0,0,0,0,0,1,0.0,1,0,0,0,0,0,2,2,Matches
856,Sergio Floccari,ITA,FW,SPAL,Serie A,37,1981,10.5,8,3,3,1,4,0,13,0.0,13,9,1,8,5,13,1,0,Matches
857,Alessandro Florenzi,ITA,"DF,FW",Roma,Serie A,28,1991,11.1,14,11,8,4,2,7,20,35.0,13,9,3,6,16,30,19,0,Matches
858,Alessandro Florenzi,ITA,DF,Valencia,La Liga,28,1991,8.4,13,9,9,4,0,8,18,44.4,10,11,1,10,14,27,21,0,Matches
859,Phil Foden,ENG,"FW,MF",Manchester City,Premier League,19,2000,10.0,14,10,4,6,4,6,19,31.6,13,5,0,5,6,20,2,0,Matches
860,Mamadou Fofana,MLI,"DF,MF",Metz,Ligue 1,21,1998,17.6,57,35,38,15,4,21,41,51.2,20,22,10,12,22,79,61,1,Matches
861,Seko Fofana,CIV,MF,Udinese,Serie A,24,1995,25.0,17,12,8,8,1,9,35,25.7,26,20,1,19,17,34,19,0,Matches
862,Wesley Fofana,FRA,DF,Saint-Étienne,Ligue 1,18,2000,13.5,25,15,16,9,0,12,18,66.7,6,10,5,5,36,61,55,4,Matches
863,Youssouf Fofana,FRA,MF,Strasbourg,Ligue 1,20,1999,11.2,25,17,10,12,3,13,30,43.3,17,11,0,11,14,39,7,0,Matches
864,Youssouf Fofana,FRA,MF,Monaco,Ligue 1,20,1999,6.8,16,9,6,10,0,8,15,53.3,7,12,2,10,8,24,9,0,Matches
865,Thomas Foket,BEL,DF,Reims,Ligue 1,24,1994,27.0,61,36,31,23,7,30,48,62.5,18,15,4,11,39,100,59,1,Matches
866,Lamine Fomba,FRA,MF,Nîmes,Ligue 1,21,1998,15.3,65,31,20,37,8,21,43,48.8,22,29,4,25,25,90,11,1,Matches
867,José Fonte,POR,DF,Lille,Ligue 1,35,1983,24.5,19,11,11,7,1,11,22,50.0,11,19,11,8,28,47,90,1,Matches
868,Pablo Fornals,ESP,"MF,FW",West Ham,Premier League,23,1996,24.1,46,28,21,18,7,19,64,29.7,45,35,1,34,25,71,15,0,Matches
869,Emil Forsberg,SWE,MF,RB Leipzig,Bundesliga,27,1991,12.7,16,10,5,8,3,6,26,23.1,20,15,0,15,5,21,3,0,Matches
870,Hernâni Fortes,POR,"MF,FW",Levante,La Liga,27,1991,7.3,5,2,4,0,1,1,3,33.3,2,3,0,3,4,9,9,0,Matches
871,Ben Foster,ENG,GK,Watford,Premier League,36,1983,38.0,1,0,1,0,0,1,3,33.3,2,1,0,1,0,1,16,2,Matches
872,Lyle Foster,RSA,FW,Monaco,Ligue 1,18,2000,0.7,0,0,0,0,0,0,1,0.0,1,0,0,0,0,0,1,0,Matches
873,Timothy Fosu-Mensah,NED,DF,Manchester Utd,Premier League,21,1998,1.5,1,1,0,1,0,1,4,25.0,3,0,0,0,4,5,1,0,Matches
874,Dimitri Foulquier,FRA,"DF,MF",Watford,Premier League,26,1993,0.7,1,0,1,0,0,0,0,,0,1,0,1,2,3,2,0,Matches
875,Dimitri Foulquier,FRA,"DF,MF",Granada,La Liga,26,1993,12.4,25,11,13,9,3,11,20,55.0,9,8,3,5,16,41,32,0,Matches
876,Juan Foyth,ARG,DF,Tottenham,Premier League,21,1998,0.8,7,3,5,2,0,3,4,75.0,1,1,0,1,1,8,3,1,Matches
877,Gianluca Frabotta,ITA,DF,Juventus,Serie A,20,1999,1.0,3,1,0,2,1,2,2,100.0,0,2,0,2,1,4,2,0,Matches
878,Raphael Framberger,GER,DF,Augsburg,Bundesliga,23,1995,13.1,43,25,23,16,4,21,29,72.4,8,23,9,14,20,63,26,0,Matches
879,Simon Francis,ENG,DF,Bournemouth,Premier League,34,1985,10.8,13,9,11,2,0,11,21,52.4,10,17,12,5,20,33,71,0,Matches
880,Mike Frantz,GER,MF,Freiburg,Bundesliga,32,1986,3.9,4,2,1,3,0,2,9,22.2,7,5,3,2,1,5,4,0,Matches
881,Ryan Fraser,SCO,"MF,FW",Bournemouth,Premier League,25,1994,23.0,12,6,5,5,2,7,22,31.8,15,15,3,12,15,27,24,0,Matches
882,Fred,BRA,MF,Manchester Utd,Premier League,26,1993,24.0,60,32,33,22,5,25,100,25.0,75,44,8,36,38,98,32,0,Matches
883,Ryan Fredericks,ENG,DF,West Ham,Premier League,26,1992,24.9,82,56,59,18,5,41,64,64.1,23,20,10,10,24,106,73,1,Matches
884,Kieron Freeman,WAL,FW,Sheffield Utd,Premier League,27,1992,0.1,0,0,0,0,0,0,0,,0,0,0,0,0,0,0,0,Matches
885,Luke Freeman,ENG,MF,Sheffield Utd,Premier League,27,1992,4.1,6,4,2,2,2,2,8,25.0,6,1,0,1,10,16,6,0,Matches
886,Remo Freuler,SUI,MF,Atalanta,Serie A,27,1992,26.0,51,30,18,25,8,22,63,34.9,41,41,6,35,28,79,26,0,Matches
887,Marco Friedl,AUT,"DF,MF",Werder Bremen,Bundesliga,21,1998,24.3,61,39,42,15,4,29,54,53.7,25,29,9,20,34,95,78,0,Matches
888,Marvin Friedrich,GER,DF,Union Berlin,Bundesliga,23,1995,31.0,45,31,30,14,1,12,37,32.4,25,46,24,22,42,87,110,0,Matches
889,Samúel Friðjónsson,ISL,MF,Paderborn 07,Bundesliga,23,1996,2.1,4,1,3,1,0,1,3,33.3,2,4,1,3,4,8,4,0,Matches
890,Jorge de Frutos,ESP,"MF,DF",Valladolid,La Liga,22,1997,0.7,2,2,2,0,0,1,2,50.0,1,0,0,0,0,2,1,0,Matches
891,Christian Fuchs,AUT,DF,Leicester City,Premier League,33,1986,8.6,14,9,8,6,0,8,19,42.1,11,8,3,5,17,31,33,1,Matches
892,Angelo Fulgini,FRA,MF,Angers,Ligue 1,22,1996,17.5,28,18,8,15,5,12,23,52.2,11,6,1,5,19,47,10,0,Matches
893,Niclas Füllkrug,GER,FW,Werder Bremen,Bundesliga,26,1993,4.5,2,2,1,1,0,1,3,33.3,2,3,0,3,3,5,6,0,Matches
894,Ramiro Funes Mori,ARG,DF,Villarreal,La Liga,28,1991,5.0,5,2,2,3,0,0,2,0.0,2,8,2,6,3,8,9,1,Matches
895,Daniel Fuzato,BRA,GK,Roma,Serie A,22,1997,1.0,0,0,0,0,0,0,0,,0,0,0,0,0,0,0,0,Matches
896,Matteo Gabbia,ITA,DF,Milan,Serie A,19,1999,7.6,7,5,5,2,0,5,8,62.5,3,6,6,0,9,16,21,0,Matches
897,Manolo Gabbiadini,ITA,FW,Sampdoria,Serie A,27,1991,22.6,9,7,2,3,4,1,7,14.3,6,12,0,12,10,19,11,0,Matches
898,Gabriel,BRA,GK,Lecce,Serie A,26,1992,33.3,2,1,2,0,0,2,3,66.7,1,0,0,0,0,2,11,10,Matches
899,Ruben Gabrielsen,NOR,DF,Toulouse,Ligue 1,27,1992,7.3,3,2,3,0,0,2,4,50.0,2,5,3,2,8,11,41,0,Matches
900,Mijat Gaćinović,SRB,"MF,FW",Eint Frankfurt,Bundesliga,24,1995,11.6,19,11,7,8,4,6,25,24.0,19,26,2,24,15,34,6,0,Matches
901,Luca Gagliano,ITA,FW,Cagliari,Serie A,19,2000,0.6,0,0,0,0,0,0,0,,0,0,0,0,1,1,0,0,Matches
902,Roberto Gagliardini,ITA,MF,Inter,Serie A,25,1994,20.0,38,19,12,18,8,14,41,34.1,27,28,8,20,30,68,20,1,Matches
903,Riccardo Gagliolo,SWE,DF,Parma,Serie A,29,1990,28.9,57,32,37,12,8,30,60,50.0,30,35,18,17,53,110,100,0,Matches
904,Nicolás Gaitán,ARG,"MF,FW",Lille,Ligue 1,31,1988,0.6,1,0,0,1,0,1,1,100.0,0,1,0,1,0,1,1,0,Matches
905,Marvin Gakpa,FRA,"MF,FW",Metz,Ligue 1,25,1993,5.2,10,6,3,4,3,4,8,50.0,4,3,0,3,5,15,1,0,Matches
906,Enric Gallego,ESP,FW,Osasuna,La Liga,32,1986,9.8,9,5,1,5,3,0,4,0.0,4,10,2,8,4,13,8,0,Matches
907,Enric Gallego,ESP,FW,Getafe,La Liga,32,1986,1.8,3,1,1,1,1,2,4,50.0,2,2,0,2,2,5,1,0,Matches
908,Kévin Gameiro,FRA,FW,Valencia,La Liga,32,1987,17.6,17,9,7,6,4,5,21,23.8,16,10,1,9,5,22,5,0,Matches
909,Fran Gámez,ESP,DF,Mallorca,La Liga,28,1991,19.6,64,42,32,27,5,33,74,44.6,41,31,11,20,29,93,41,0,Matches
910,Idrissa Gana Gueye,SEN,MF,Paris S-G,Ligue 1,29,1989,18.4,65,34,30,25,10,18,43,41.9,25,29,4,25,33,98,15,0,Matches
911,Ignatius Ganago,CMR,"FW,MF",Nice,Ligue 1,20,1999,13.8,10,6,4,3,3,3,18,16.7,15,8,1,7,4,14,13,0,Matches
912,Ezequiel Garay,ARG,DF,Valencia,La Liga,32,1986,16.0,12,8,9,2,1,7,11,63.6,4,19,17,2,14,26,71,0,Matches
913,Dani García,ESP,MF,Athletic Club,La Liga,29,1990,33.7,59,30,30,27,2,30,86,34.9,56,25,7,18,52,111,56,1,Matches
914,David García,ESP,DF,Osasuna,La Liga,25,1994,31.0,28,16,15,12,1,14,31,45.2,17,20,16,4,48,76,123,2,Matches
915,Eric García,ESP,DF,Manchester City,Premier League,18,2001,8.8,6,1,4,2,0,5,9,55.6,4,2,0,2,18,24,33,0,Matches
916,Javi García,ESP,MF,Betis,La Liga,32,1987,4.2,2,2,2,0,0,2,3,66.7,1,1,0,1,4,6,15,0,Matches
917,Manu García,ESP,MF,Alavés,La Liga,33,1986,21.9,46,23,11,31,4,17,72,23.6,55,28,12,16,28,74,32,1,Matches
918,Raúl García,ESP,"DF,MF",Valladolid,La Liga,30,1989,11.2,20,12,11,7,2,9,22,40.9,13,12,2,10,8,28,30,0,Matches
919,Raúl García,ESP,"MF,FW",Athletic Club,La Liga,33,1986,31.9,57,37,19,26,12,16,76,21.1,60,46,6,40,24,81,44,0,Matches
920,Raúl García,ESP,DF,Getafe,La Liga,30,1989,2.7,5,3,2,3,0,3,6,50.0,3,3,1,2,4,9,10,0,Matches
921,Rubén García,ESP,"MF,FW",Osasuna,La Liga,26,1993,24.3,55,30,22,26,7,18,46,39.1,28,34,5,29,11,66,23,1,Matches
922,Unai García,ESP,DF,Osasuna,La Liga,27,1992,6.0,9,6,4,4,1,5,9,55.6,4,13,9,4,8,17,31,0,Matches
923,Víctor García,ESP,"FW,MF",Valladolid,La Liga,21,1997,1.0,0,0,0,0,0,0,1,0.0,1,1,0,1,0,0,1,0,Matches
924,James Garner,ENG,MF,Manchester Utd,Premier League,18,2001,0.1,0,0,0,0,0,0,1,0.0,1,0,0,0,0,0,1,0,Matches
925,Manuel Garrido,ESP,FW,Leganés,La Liga,18,2000,1.3,0,0,0,0,0,0,6,0.0,6,3,1,2,1,1,0,0,Matches
926,Mario Gaspar,ESP,DF,Villarreal,La Liga,28,1990,21.8,35,20,16,16,3,15,31,48.4,16,25,10,15,26,61,69,0,Matches
927,Daniele Gastaldello,ITA,DF,Brescia,Serie A,36,1983,4.3,8,5,5,3,0,2,3,66.7,1,6,3,3,5,13,29,1,Matches
928,Dwight Gayle,ENG,FW,Newcastle Utd,Premier League,28,1990,9.4,12,10,4,6,2,4,8,50.0,4,5,0,5,2,14,9,0,Matches
929,Paulo Gazzaniga,ARG,GK,Tottenham,Premier League,27,1992,17.9,0,0,0,0,0,0,0,,0,0,0,0,1,1,4,1,Matches
930,Jean-Philippe Gbamin,CIV,MF,Everton,Premier League,23,1995,1.5,4,3,1,1,2,1,2,50.0,1,1,0,1,1,5,4,0,Matches
931,Yann Gboho,FRA,FW,Rennes,Ligue 1,18,2001,2.5,2,2,1,0,1,0,2,0.0,2,1,0,1,1,3,0,0,Matches
932,David de Gea,ESP,GK,Manchester Utd,Premier League,28,1990,38.0,0,0,0,0,0,0,0,,0,0,0,0,0,0,7,4,Matches
933,Theodor Gebre Selassie,CZE,"DF,MF",Werder Bremen,Bundesliga,32,1986,27.0,36,27,23,10,3,17,35,48.6,18,26,9,17,63,99,81,0,Matches
934,Dennis Geiger,GER,MF,Hoffenheim,Bundesliga,21,1998,12.6,12,5,4,6,2,2,16,12.5,14,9,2,7,6,18,4,0,Matches
935,Jérémy Gélin,FRA,"DF,MF",Rennes,Ligue 1,22,1997,10.3,14,5,10,2,2,8,13,61.5,5,14,7,7,15,29,33,1,Matches
936,Christian Gentner,GER,MF,Union Berlin,Bundesliga,33,1985,27.1,53,28,16,32,5,22,73,30.1,51,46,8,38,54,107,50,0,Matches
937,Yannick Gerhardt,GER,MF,Wolfsburg,Bundesliga,25,1994,9.2,28,18,7,15,6,8,21,38.1,13,11,3,8,12,40,9,0,Matches
938,Valère Germain,FRA,FW,Marseille,Ligue 1,29,1990,15.0,22,12,6,11,5,6,31,19.4,25,16,3,13,8,30,26,0,Matches
939,Gervinho,CIV,FW,Parma,Serie A,32,1987,25.2,12,6,5,6,1,6,17,35.3,11,4,0,4,5,17,3,0,Matches
940,Anwar El Ghazi,NED,"FW,MF",Aston Villa,Premier League,24,1995,22.8,20,11,12,5,3,8,26,30.8,18,10,1,9,13,33,16,1,Matches
941,Rachid Ghezzal,ALG,"MF,FW",Fiorentina,Serie A,27,1992,9.2,27,15,14,10,3,10,33,30.3,23,6,0,6,11,38,9,0,Matches
942,Andrea Ghezzi,ITA,"FW,MF",Brescia,Serie A,18,2001,0.4,2,0,0,1,1,1,1,100.0,0,0,0,0,0,2,0,0,Matches
943,Paolo Ghiglione,ITA,"DF,FW",Genoa,Serie A,22,1997,19.1,31,16,15,13,3,18,35,51.4,17,17,2,15,9,40,42,1,Matches
944,Andrea Ghion,ITA,"FW,MF",Sassuolo,Serie A,19,2000,0.5,3,1,1,2,0,1,1,100.0,0,0,0,0,0,3,0,0,Matches
945,Saman Ghoddos,IRN,FW,Amiens,Ligue 1,25,1993,2.6,2,2,0,1,1,1,2,50.0,1,5,0,5,2,4,3,0,Matches
946,Faouzi Ghoulam,ALG,DF,Napoli,Serie A,28,1991,4.2,6,4,1,4,1,2,5,40.0,3,3,2,1,4,10,8,0,Matches
947,Morgan Gibbs-White,ENG,"MF,FW",Wolves,Premier League,19,2000,1.4,0,0,0,0,0,0,0,,0,0,0,0,2,2,0,0,Matches
948,Niko Gießelmann,GER,DF,Düsseldorf,Bundesliga,27,1991,22.9,46,31,31,11,4,22,45,48.9,23,23,6,17,27,73,55,1,Matches
949,Rafał Gikiewicz,POL,GK,Union Berlin,Bundesliga,31,1987,33.0,1,0,1,0,0,1,4,25.0,3,0,0,0,2,3,26,4,Matches
950,Bryan Gil,ESP,"MF,FW",Leganés,La Liga,18,2001,6.2,8,4,3,4,1,1,8,12.5,7,6,0,6,3,11,1,0,Matches
951,Bryan Gil,ESP,FW,Sevilla,La Liga,18,2001,0.7,1,1,0,1,0,0,1,0.0,1,0,0,0,0,1,0,0,Matches
952,Billy Gilmour,SCO,MF,Chelsea,Premier League,18,2001,2.2,5,2,3,2,0,2,4,50.0,2,2,0,2,3,8,3,1,Matches
953,Daniel Ginczek,GER,FW,Wolfsburg,Bundesliga,28,1991,8.5,4,3,3,1,0,1,11,9.1,10,3,1,2,1,5,3,0,Matches
954,Matthias Ginter,GER,DF,Gladbach,Bundesliga,25,1994,30.9,34,20,19,14,1,17,31,54.8,14,27,22,5,34,68,125,3,Matches
955,Andrei Girotto,BRA,DF,Nantes,Ligue 1,27,1992,24.2,76,53,45,29,2,39,71,54.9,32,32,17,15,34,110,111,1,Matches
956,Olivier Giroud,FRA,FW,Chelsea,Premier League,32,1986,11.0,8,3,2,5,1,1,11,9.1,10,14,1,13,2,10,13,0,Matches
957,Klaus Gjasula,ALB,MF,Paderborn 07,Bundesliga,29,1989,25.3,69,39,30,35,4,30,61,49.2,31,33,6,27,32,101,50,2,Matches
958,Kamil Glik,POL,DF,Monaco,Ligue 1,31,1988,23.0,26,14,15,11,0,13,21,61.9,8,23,17,6,27,53,118,0,Matches
959,Serge Gnabry,GER,"FW,MF",Bayern Munich,Bundesliga,24,1995,24.4,36,16,4,19,13,9,29,31.0,20,17,0,17,16,52,2,1,Matches
960,Joris Gnagnon,FRA,DF,Rennes,Ligue 1,22,1997,14.2,16,13,14,2,0,10,11,90.9,1,21,17,4,18,34,61,0,Matches
961,Eddy Gnahoré,FRA,MF,Amiens,Ligue 1,25,1993,12.6,24,12,7,15,2,8,28,28.6,20,25,4,21,9,33,25,0,Matches
962,Ben Godfrey,ENG,DF,Norwich City,Premier League,21,1998,29.4,22,14,18,3,1,10,18,55.6,8,41,37,4,25,47,152,3,Matches
963,Diego Godín,URU,DF,Inter,Serie A,33,1986,18.1,38,29,19,16,3,18,32,56.3,14,17,7,10,45,83,60,1,Matches
964,Akaki Gogia,GER,"MF,FW",Union Berlin,Bundesliga,27,1992,1.3,2,1,0,0,2,0,2,0.0,2,2,2,0,0,2,0,0,Matches
965,Mauro Goicoechea,URU,GK,Toulouse,Ligue 1,31,1988,2.0,0,0,0,0,0,0,0,,0,0,0,0,0,0,1,2,Matches
966,Edoardo Goldaniga,ITA,DF,Genoa,Serie A,25,1993,8.7,4,3,3,1,0,2,5,40.0,3,11,6,5,18,22,25,1,Matches
967,Benjamin Goller,GER,"FW,MF",Werder Bremen,Bundesliga,20,1999,3.2,8,3,3,4,1,3,10,30.0,7,3,0,3,1,9,1,0,Matches
968,Pierluigi Gollini,ITA,GK,Atalanta,Serie A,24,1995,32.0,0,0,0,0,0,0,2,0.0,2,0,0,0,0,0,13,2,Matches
969,Aleksandr Golovin,RUS,MF,Monaco,Ligue 1,23,1996,22.9,49,27,17,26,6,14,69,20.3,55,28,0,28,31,80,22,0,Matches
970,André Gomes,POR,MF,Everton,Premier League,26,1993,16.2,22,15,7,11,4,8,62,12.9,54,20,3,17,7,29,7,0,Matches
971,Angel Gomes,ENG,MF,Manchester Utd,Premier League,18,2000,0.2,0,0,0,0,0,0,0,,0,1,0,1,0,0,0,0,Matches
972,Ibai Gómez,ESP,FW,Athletic Club,La Liga,29,1989,7.7,5,3,2,2,1,3,8,37.5,5,4,0,4,3,8,6,0,Matches
973,Joe Gomez,ENG,DF,Liverpool,Premier League,22,1997,22.3,23,16,17,6,0,9,20,45.0,11,15,8,7,38,61,64,2,Matches
974,Maxi Gómez,URU,FW,Valencia,La Liga,22,1996,23.8,9,7,1,6,2,4,8,50.0,4,8,1,7,5,14,14,0,Matches
975,Moi Gómez,ESP,"FW,MF",Villarreal,La Liga,25,1994,25.8,30,22,9,14,7,11,33,33.3,22,22,2,20,25,55,23,0,Matches
976,Papu Gómez,ARG,"MF,FW",Atalanta,Serie A,31,1988,31.6,27,13,5,13,9,13,45,28.9,32,24,0,24,17,44,6,1,Matches
977,Sergi Gómez,ESP,DF,Sevilla,La Liga,27,1992,8.0,9,7,7,2,0,4,4,100.0,0,6,6,0,7,16,30,0,Matches
978,Victor Gomez,ESP,"DF,FW",Espanyol,La Liga,19,2000,14.1,13,5,8,4,1,7,20,35.0,13,10,0,10,21,34,31,0,Matches
979,Alfred Gomis,SEN,GK,Dijon,Ligue 1,25,1993,18.0,1,0,1,0,0,1,2,50.0,1,2,0,2,0,1,14,2,Matches
980,Maxime Gonalons,FRA,MF,Granada,La Liga,30,1989,16.7,62,38,25,35,2,22,54,40.7,32,27,3,24,20,82,20,1,Matches
981,Mathieu Goncalves,FRA,DF,Toulouse,Ligue 1,18,2001,3.5,5,3,5,0,0,2,8,25.0,6,4,3,1,4,9,10,0,Matches
982,Jérôme Gondorf,GER,MF,Freiburg,Bundesliga,31,1988,1.3,9,6,7,1,1,3,6,50.0,3,3,2,1,0,9,2,0,Matches
983,Álvaro González,ESP,DF,Marseille,Ligue 1,29,1990,18.1,19,13,14,4,1,9,13,69.2,4,7,4,3,18,37,65,0,Matches
984,Bruno González,ESP,DF,Getafe,La Liga,29,1990,2.0,3,2,3,0,0,1,1,100.0,0,2,0,2,0,3,3,0,Matches
985,Bruno González,ESP,DF,Levante,La Liga,29,1990,5.1,10,8,7,2,1,2,4,50.0,2,7,4,3,2,12,32,0,Matches
986,Édgar González,ESP,MF,Betis,La Liga,22,1997,7.6,8,3,3,5,0,2,14,14.3,12,4,2,2,10,18,16,0,Matches
987,Gonzalo,ESP,DF,Levante,La Liga,22,1997,0.1,1,0,0,1,0,0,0,,0,0,0,0,0,1,0,0,Matches
988,Anthony Gordon,ENG,"MF,FW",Everton,Premier League,18,2001,4.9,11,7,5,6,0,5,15,33.3,10,6,2,4,8,19,4,0,Matches
989,Leon Goretzka,GER,MF,Bayern Munich,Bundesliga,24,1995,16.8,28,15,7,18,3,10,32,31.3,22,18,2,16,24,52,8,0,Matches
990,Andoni Gorosabel,ESP,DF,Real Sociedad,La Liga,22,1996,7.9,14,8,9,3,2,10,20,50.0,10,13,1,12,13,27,21,0,Matches
991,Robin Gosens,GER,DF,Atalanta,Serie A,25,1994,29.1,53,27,19,26,8,23,51,45.1,28,38,10,28,39,92,40,0,Matches
992,Dan Gosling,ENG,MF,Bournemouth,Premier League,29,1990,14.0,26,10,14,9,3,6,27,22.2,21,31,11,20,20,46,26,0,Matches
993,Mario Götze,GER,FW,Dortmund,Bundesliga,27,1992,5.8,10,7,0,6,4,3,12,25.0,9,3,0,3,2,12,1,0,Matches
994,Prince-Désir Gouano,FRA,DF,Amiens,Ligue 1,25,1993,3.0,3,1,0,3,0,0,0,,0,6,3,3,2,5,15,0,Matches
995,Amine Gouiri,ALG,FW,Lyon,Ligue 1,19,2000,0.0,0,0,0,0,0,0,0,,0,0,0,0,0,0,0,0,Matches
996,Jeffrey Gouweleeuw,NED,DF,Augsburg,Bundesliga,28,1991,18.3,28,16,22,5,1,12,21,57.1,9,15,8,7,37,65,97,0,Matches
997,Max Gradel,CIV,"MF,FW",Toulouse,Ligue 1,31,1987,18.2,36,20,17,14,5,12,47,25.5,35,11,1,10,11,47,23,0,Matches
998,Samuel Grandsir,FRA,"FW,MF",Brest,Ligue 1,22,1996,16.6,34,22,13,16,5,11,30,36.7,19,9,0,9,14,48,5,0,Matches
999,Esteban Granero,ESP,MF,Espanyol,La Liga,32,1987,5.3,10,4,5,3,2,5,11,45.5,6,3,2,1,2,12,5,0,Matches
1000,Alberto Grassi,ITA,MF,Parma,Serie A,24,1995,7.1,10,4,7,3,0,5,13,38.5,8,5,2,3,19,29,9,1,Matches
1001,Andre Gray,JAM,FW,Watford,Premier League,28,1991,8.4,4,3,0,2,2,1,3,33.3,2,4,1,3,1,5,2,0,Matches
1002,Demarai Gray,JAM,"MF,FW",Leicester City,Premier League,23,1996,6.9,12,6,6,6,0,6,12,50.0,6,7,0,7,5,17,4,0,Matches
1003,Jack Grealish,ENG,"FW,MF",Aston Villa,Premier League,23,1995,35.9,29,19,12,12,5,13,34,38.2,21,33,12,21,22,51,22,1,Matches
1004,Mason Greenwood,ENG,FW,Manchester Utd,Premier League,17,2001,14.7,17,11,5,6,6,5,20,25.0,15,9,0,9,6,23,6,1,Matches
1005,Michael Gregoritsch,AUT,"MF,FW",Augsburg,Bundesliga,25,1994,3.4,2,2,0,2,0,0,4,0.0,4,4,1,3,3,5,7,0,Matches
1006,Michael Gregoritsch,AUT,FW,Schalke 04,Bundesliga,25,1994,9.2,8,5,0,6,2,0,9,0.0,9,9,1,8,2,10,10,0,Matches
1007,Clément Grenier,FRA,MF,Rennes,Ligue 1,28,1991,9.3,21,12,6,15,0,11,40,27.5,29,7,2,5,7,28,16,0,Matches
1008,Antoine Griezmann,FRA,FW,Barcelona,La Liga,28,1991,28.3,33,18,12,11,10,9,34,26.5,25,22,3,19,12,45,20,1,Matches
1009,Vincenzo Grifo,ITA,MF,Hoffenheim,Bundesliga,26,1993,0.2,0,0,0,0,0,0,0,,0,0,0,0,0,0,0,0,Matches
1010,Vincenzo Grifo,ITA,"MF,FW",Freiburg,Bundesliga,26,1993,18.0,15,10,9,3,3,6,25,24.0,19,13,1,12,14,29,18,1,Matches
1011,Florian Grillitsch,AUT,"MF,DF",Hoffenheim,Bundesliga,23,1995,26.8,59,29,34,24,1,29,61,47.5,32,33,6,27,49,108,41,1,Matches
1012,Jérémy Grimm,FRA,MF,Strasbourg,Ligue 1,32,1987,0.0,0,0,0,0,0,0,0,,0,0,0,0,0,0,0,0,Matches
1013,Christian Groß,GER,"DF,MF",Werder Bremen,Bundesliga,30,1989,9.7,23,17,16,5,2,9,16,56.3,7,13,7,6,14,37,50,1,Matches
1014,Pascal Groß,GER,"MF,FW",Brighton,Premier League,28,1991,20.0,36,13,8,21,7,14,39,35.9,25,25,3,22,9,45,7,0,Matches
1015,Carlos Gruezo,ECU,MF,Augsburg,Bundesliga,24,1995,9.8,28,12,12,15,1,5,24,20.8,19,5,0,5,6,34,5,0,Matches
1016,Marko Grujić,SRB,MF,Hertha BSC,Bundesliga,23,1996,26.8,56,34,21,30,5,19,63,30.2,44,43,9,34,22,78,69,0,Matches
1017,Vicente Guaita,ESP,GK,Crystal Palace,Premier League,32,1987,35.0,1,1,1,0,0,1,2,50.0,1,0,0,0,0,1,18,3,Matches
1018,Andrés Guardado,MEX,MF,Betis,La Liga,32,1986,22.7,30,14,15,11,4,15,41,36.6,26,15,4,11,18,48,22,1,Matches
1019,Sergi Guardiola,ESP,FW,Valladolid,La Liga,28,1991,29.5,14,6,3,7,4,4,24,16.7,20,23,0,23,6,20,18,1,Matches
1020,Nemanja Gudelj,SRB,"MF,DF",Sevilla,La Liga,27,1991,13.5,20,14,11,8,1,6,19,31.6,13,17,8,9,12,32,35,1,Matches
1021,Gonçalo Guedes,POR,"MF,FW",Valencia,La Liga,22,1996,14.1,19,11,11,7,1,9,32,28.1,23,10,1,9,7,26,1,0,Matches
1022,Mattéo Guendouzi,FRA,MF,Arsenal,Premier League,20,1999,19.4,31,16,14,13,4,14,43,32.6,29,21,7,14,29,60,38,2,Matches
1023,Raphaël Guerreiro,POR,"DF,MF",Dortmund,Bundesliga,25,1993,25.9,44,24,18,21,5,20,32,62.5,12,27,3,24,42,86,26,0,Matches
1024,Adrián Guerrero,ESP,DF,Valencia,La Liga,21,1998,1.4,2,2,1,1,0,2,3,66.7,1,0,0,0,2,4,1,0,Matches
1025,Ander Guevara,ESP,MF,Real Sociedad,La Liga,22,1997,10.4,27,11,9,17,1,12,30,40.0,18,13,3,10,8,35,15,1,Matches
1026,Babacar Guèye,SEN,FW,Paderborn 07,Bundesliga,24,1994,1.2,2,0,0,0,2,0,1,0.0,1,1,1,0,0,2,3,0,Matches
1027,John Guidetti,SWE,"FW,MF",Alavés,La Liga,27,1992,1.1,2,1,0,1,1,0,0,,0,1,0,1,0,2,0,0,Matches
1028,Josuha Guilavogui,FRA,"MF,DF",Wolfsburg,Bundesliga,28,1990,22.9,41,26,17,23,1,10,30,33.3,20,35,9,26,45,86,64,2,Matches
1029,Frederic Guilbert,FRA,"DF,MF",Aston Villa,Premier League,24,1994,22.7,74,43,48,20,6,36,67,53.7,31,33,10,23,49,123,74,2,Matches
1030,Hugo Guillamón,ESP,DF,Valencia,La Liga,19,2000,5.5,8,3,5,2,1,5,10,50.0,5,3,2,1,5,13,29,0,Matches
1031,Bruno Guimarães,BRA,MF,Lyon,Ligue 1,21,1997,3.0,12,7,5,6,1,5,10,50.0,5,1,0,1,4,16,1,0,Matches
1032,Serhou Guirassy,GUI,FW,Amiens,Ligue 1,23,1996,21.3,7,3,1,4,2,2,7,28.6,5,13,6,7,4,11,21,0,Matches
1033,Rafik Guitane,FRA,MF,Rennes,Ligue 1,20,1999,0.2,0,0,0,0,0,0,0,,0,0,0,0,0,0,0,0,Matches
1034,Péter Gulácsi,HUN,GK,RB Leipzig,Bundesliga,29,1990,32.0,0,0,0,0,0,0,0,,0,0,0,0,1,1,18,6,Matches
1035,Manuel Gulde,GER,DF,Freiburg,Bundesliga,28,1991,15.2,28,16,17,9,2,15,24,62.5,9,23,13,10,22,50,80,1,Matches
1036,Sinan Gümüş,,"FW,MF",Genoa,Serie A,25,1994,1.1,0,0,0,0,0,0,4,0.0,4,0,0,0,0,0,1,0,Matches
1037,İlkay Gündoğan,GER,MF,Manchester City,Premier League,28,1990,22.4,27,16,9,11,7,9,41,22.0,32,17,5,12,31,58,13,0,Matches
1038,Angus Gunn,SCO,GK,Southampton,Premier League,23,1996,10.0,1,1,1,0,0,1,3,33.3,2,0,0,0,0,1,1,0,Matches
1039,Christian Günter,GER,DF,Freiburg,Bundesliga,26,1993,33.7,25,11,17,7,1,12,35,34.3,23,29,13,16,14,39,40,0,Matches
1040,Koray Günter,GER,DF,Hellas Verona,Serie A,24,1994,30.4,39,25,22,15,2,19,29,65.5,10,45,39,6,55,94,131,1,Matches
1041,Régis Gurtner,FRA,GK,Amiens,Ligue 1,32,1986,28.0,1,1,1,0,0,1,2,50.0,1,0,0,0,0,1,10,4,Matches
1042,Luiz Gustavo,BRA,MF,Marseille,Ligue 1,32,1987,2.1,6,3,3,3,0,3,5,60.0,2,5,2,3,5,11,6,0,Matches
1043,Jonathan de Guzmán,NED,MF,Eint Frankfurt,Bundesliga,31,1987,1.0,1,1,0,1,0,1,7,14.3,6,2,0,2,1,2,0,0,Matches
1044,Erling Haaland,NOR,FW,Dortmund,Bundesliga,19,2000,11.8,4,2,1,0,3,0,4,0.0,4,7,4,3,4,8,4,0,Matches
1045,Janik Haberer,GER,"MF,FW",Freiburg,Bundesliga,25,1994,19.1,26,18,8,14,4,12,45,26.7,33,25,4,21,25,51,23,0,Matches
1046,Alexander Hack,GER,DF,Mainz 05,Bundesliga,25,1993,8.9,26,10,19,6,1,16,27,59.3,11,20,9,11,23,49,60,1,Matches
1047,Munir El Haddadi,MAR,FW,Sevilla,La Liga,23,1995,13.9,19,17,6,11,2,4,21,19.0,17,8,0,8,7,26,8,0,Matches
1048,André Hahn,GER,"FW,MF",Augsburg,Bundesliga,28,1990,7.8,15,9,7,5,3,5,21,23.8,16,23,5,18,13,28,14,0,Matches
1049,Amadou Haidara,MLI,MF,RB Leipzig,Bundesliga,21,1998,8.4,26,16,7,17,2,10,24,41.7,14,14,2,12,8,34,10,1,Matches
1050,Achraf Hakimi,MAR,"DF,MF",Dortmund,Bundesliga,20,1998,30.2,60,41,38,14,8,27,64,42.2,37,26,2,24,30,90,27,2,Matches
1051,Sébastien Haller,CIV,FW,West Ham,Premier League,25,1994,25.2,22,15,8,10,4,3,30,10.0,27,19,5,14,8,30,27,0,Matches
1052,Marcel Halstenberg,GER,DF,RB Leipzig,Bundesliga,27,1991,28.0,46,31,27,17,2,28,58,48.3,30,37,11,26,46,92,72,2,Matches
1053,Romain Hamouma,FRA,"FW,MF",Saint-Étienne,Ligue 1,32,1987,9.6,12,9,1,5,6,2,12,16.7,10,12,0,12,0,12,4,0,Matches
1054,Samir Handanović,SVN,GK,Inter,Serie A,35,1984,35.0,1,1,1,0,0,0,1,0.0,1,0,0,0,0,1,8,3,Matches
1055,Grant Hanley,SCO,DF,Norwich City,Premier League,27,1991,14.0,24,15,17,7,0,8,14,57.1,6,25,18,7,31,55,77,1,Matches
1056,Lukáš Haraslín,SVK,FW,Sassuolo,Serie A,23,1996,4.3,5,2,1,3,1,2,9,22.2,7,5,0,5,4,9,1,0,Matches
1057,Amine Harit,MAR,"MF,FW",Schalke 04,Bundesliga,22,1997,23.4,16,7,8,5,3,6,25,24.0,19,13,0,13,7,23,2,1,Matches
1058,Martin Harnik,AUT,"MF,FW",Werder Bremen,Bundesliga,32,1987,0.1,0,0,0,0,0,0,0,,0,0,0,0,0,0,0,0,Matches
1059,Makoto Hasebe,JPN,"DF,MF",Eint Frankfurt,Bundesliga,35,1984,21.9,28,20,16,9,3,18,39,46.2,21,38,10,28,26,54,38,0,Matches
1060,Hans Hateboer,NED,DF,Atalanta,Serie A,25,1994,26.2,36,23,20,9,7,18,38,47.4,20,22,7,15,10,46,32,1,Matches
1061,Kortney Hause,ENG,DF,Aston Villa,Premier League,24,1995,17.2,21,9,15,5,1,8,15,53.3,7,27,19,8,20,41,98,4,Matches
1062,Kai Havertz,GER,"MF,FW",Leverkusen,Bundesliga,20,1999,27.3,21,15,5,10,6,6,39,15.4,33,22,0,22,2,23,22,0,Matches
1063,Isaac Hayden,ENG,MF,Newcastle Utd,Premier League,24,1995,24.7,55,27,33,17,5,20,50,40.0,30,24,7,17,38,93,38,0,Matches
1064,Eden Hazard,BEL,"FW,MF",Real Madrid,La Liga,28,1991,12.0,7,3,2,3,2,3,15,20.0,12,5,0,5,6,13,0,0,Matches
1065,Thorgan Hazard,BEL,"FW,MF",Dortmund,Bundesliga,26,1993,26.4,40,27,17,14,9,12,50,24.0,38,29,0,29,13,53,2,1,Matches
1066,Tom Heaton,ENG,GK,Aston Villa,Premier League,33,1986,19.9,3,2,3,0,0,3,4,75.0,1,0,0,0,0,3,6,0,Matches
1067,Jonas Hector,GER,"MF,DF",Köln,Bundesliga,29,1990,27.0,76,49,37,34,5,24,75,32.0,51,44,10,34,46,122,38,1,Matches
1068,Dominique Heintz,GER,DF,Freiburg,Bundesliga,25,1993,27.0,47,30,40,6,1,17,43,39.5,26,38,25,13,41,88,131,1,Matches
1069,Dean Henderson,ENG,GK,Sheffield Utd,Premier League,22,1997,36.0,0,0,0,0,0,0,0,,0,0,0,0,1,1,13,1,Matches
1070,Jordan Henderson,ENG,MF,Liverpool,Premier League,29,1990,24.9,63,41,18,33,12,22,55,40.0,33,22,4,18,30,93,21,2,Matches
1071,Liam Henderson,SCO,MF,Hellas Verona,Serie A,23,1996,2.2,3,2,0,3,0,2,3,66.7,1,1,0,1,0,3,4,0,Matches
1072,Jeff Hendrick,IRL,MF,Burnley,Premier League,27,1992,21.5,18,10,7,8,3,7,27,25.9,20,21,8,13,20,38,20,0,Matches
1073,Wayne Hennessey,WAL,GK,Crystal Palace,Premier League,32,1987,3.0,0,0,0,0,0,0,0,,0,0,0,0,1,1,3,1,Matches
1074,Rouwen Hennings,GER,FW,Düsseldorf,Bundesliga,31,1987,27.3,11,5,2,7,2,3,18,16.7,15,12,0,12,2,13,33,0,Matches
1075,Benjamin Henrichs,GER,"DF,MF",Monaco,Ligue 1,22,1997,9.9,26,20,16,9,1,14,33,42.4,19,19,4,15,14,40,18,0,Matches
1076,Dalbert Henrique,BRA,"DF,MF",Fiorentina,Serie A,25,1993,27.6,52,25,35,12,5,18,51,35.3,33,34,4,30,19,71,65,0,Matches
1077,Christophe Hérelle,MTQ,DF,Nice,Ligue 1,26,1992,12.3,14,11,10,4,0,3,7,42.9,4,14,8,6,17,31,26,1,Matches
1078,Mario Hermoso,ESP,DF,Atlético Madrid,La Liga,24,1995,13.5,15,8,12,2,1,11,20,55.0,9,11,5,6,12,27,61,0,Matches
1079,Aridane Hernández,ESP,DF,Osasuna,La Liga,30,1989,29.0,35,23,22,13,0,15,19,78.9,4,24,15,9,34,69,137,2,Matches
1080,Javier Hernández,MEX,FW,West Ham,Premier League,31,1988,1.2,0,0,0,0,0,0,1,0.0,1,0,0,0,1,1,0,0,Matches
1081,Javier Hernández,MEX,FW,Sevilla,La Liga,31,1988,5.0,6,4,0,4,2,1,6,16.7,5,5,0,5,5,11,1,0,Matches
1082,Juan Hernández,ESP,"FW,MF",Celta Vigo,La Liga,24,1994,1.0,0,0,0,0,0,0,0,,0,0,0,0,1,1,0,0,Matches
1083,Lucas Hernández,FRA,DF,Bayern Munich,Bundesliga,23,1996,10.2,18,9,13,3,2,9,15,60.0,6,6,1,5,15,33,17,0,Matches
1084,Onel Hernández,CUB,"FW,MF",Norwich City,Premier League,26,1993,15.4,27,19,13,11,3,9,31,29.0,22,12,1,11,19,46,10,0,Matches
1085,Theo Hernández,FRA,DF,Milan,Serie A,21,1997,31.3,56,39,32,18,6,33,53,62.3,20,34,6,28,43,99,62,2,Matches
1086,Hernani,BRA,MF,Parma,Serie A,25,1994,26.9,61,31,25,31,5,30,112,26.8,82,53,11,42,50,111,51,1,Matches
1087,Ander Herrera,ESP,"MF,DF",Paris S-G,Ligue 1,29,1989,6.1,19,11,9,9,1,5,14,35.7,9,10,2,8,6,25,4,0,Matches
1088,Héctor Herrera,MEX,MF,Atlético Madrid,La Liga,29,1990,12.5,31,21,9,18,4,13,32,40.6,19,16,7,9,17,48,13,2,Matches
1089,Sergio Herrera,ESP,GK,Osasuna,La Liga,26,1993,18.4,1,1,1,0,0,1,4,25.0,3,0,0,0,1,2,13,3,Matches
1090,Yangel Herrera,VEN,MF,Granada,La Liga,21,1998,26.3,88,49,25,53,10,36,80,45.0,44,38,9,29,34,122,28,0,Matches
1091,Iago Herrerín,ESP,GK,Athletic Club,La Liga,31,1988,4.7,0,0,0,0,0,0,0,,0,0,0,0,0,0,0,0,Matches
1092,Patrick Herrmann,GER,"FW,MF",Gladbach,Bundesliga,28,1991,16.1,24,11,8,10,6,5,16,31.3,11,21,4,17,11,35,8,0,Matches
1093,Pablo Hervías,ESP,"MF,FW",Valladolid,La Liga,26,1993,11.3,24,20,8,14,2,12,22,54.5,10,8,0,8,5,29,0,0,Matches
1094,Son Heung-min,KOR,FW,Tottenham,Premier League,27,1992,27.5,23,15,10,11,2,9,57,15.8,48,23,0,23,19,42,18,1,Matches
1095,Gonzalo Higuaín,ARG,FW,Juventus,Serie A,31,1987,20.7,13,7,2,6,5,4,31,12.9,27,12,0,12,6,19,14,0,Matches
1096,Vitorino Hilton,BRA,DF,Montpellier,Ligue 1,41,1977,27.9,27,17,20,7,0,13,28,46.4,15,22,18,4,49,76,121,1,Matches
1097,Martin Hinteregger,AUT,DF,Eint Frankfurt,Bundesliga,26,1992,30.2,66,51,33,30,3,28,57,49.1,29,41,21,20,36,102,96,0,Matches
1098,George Hirst,ENG,"MF,DF",Leicester City,Premier League,20,1999,0.1,0,0,0,0,0,0,0,,0,0,0,0,0,0,0,0,Matches
1099,Marwin Hitz,SUI,GK,Dortmund,Bundesliga,31,1987,3.2,0,0,0,0,0,0,0,,0,0,0,0,0,0,0,0,Matches
1100,André Hoffmann,GER,DF,Düsseldorf,Bundesliga,26,1993,27.0,48,22,30,18,0,16,50,32.0,34,22,9,13,56,104,90,0,Matches
1101,Nicolas Höfler,GER,MF,Freiburg,Bundesliga,29,1990,30.9,65,40,31,28,6,22,64,34.4,42,58,18,40,71,136,59,3,Matches
1102,Jonas Hofmann,GER,"MF,FW",Gladbach,Bundesliga,27,1992,18.1,43,27,22,12,9,22,76,28.9,54,28,3,25,18,61,14,0,Matches
1103,Jonas Hofmann,GER,MF,Schalke 04,Bundesliga,22,1997,0.0,0,0,0,0,0,0,0,,0,0,0,0,0,0,2,0,Matches
1104,Marco Höger,GER,MF,Köln,Bundesliga,29,1989,7.5,10,6,4,5,1,6,16,37.5,10,14,4,10,6,16,15,0,Matches
1105,Rob Holding,ENG,DF,Arsenal,Premier League,23,1995,6.5,4,2,3,1,0,1,3,33.3,2,10,6,4,5,9,45,1,Matches
1106,José Holebas,GRE,DF,Watford,Premier League,35,1984,11.4,26,15,19,7,0,9,28,32.1,19,11,4,7,3,29,33,0,Matches
1107,Lucas Höler,GER,"FW,MF",Freiburg,Bundesliga,25,1994,27.6,35,15,11,16,8,11,46,23.9,35,30,9,21,12,47,38,0,Matches
1108,Mason Holgate,ENG,DF,Everton,Premier League,22,1996,22.8,44,26,30,13,1,21,31,67.7,10,26,13,13,34,78,97,0,Matches
1109,Nathan Holland,ENG,MF,West Ham,Premier League,21,1998,0.4,3,1,2,1,0,0,0,,0,1,0,1,0,3,0,0,Matches
1110,Gerrit Holtmann,PHI,"MF,DF",Paderborn 07,Bundesliga,24,1995,11.8,24,14,14,6,4,15,37,40.5,22,21,1,20,6,30,8,0,Matches
1111,Josué Homawoo,FRA,DF,Nantes,Ligue 1,21,1997,0.5,6,2,3,3,0,2,2,100.0,0,3,2,1,2,8,2,0,Matches
1112,Franck Honorat,FRA,"FW,DF",Saint-Étienne,Ligue 1,22,1996,9.4,16,11,7,8,1,8,23,34.8,15,12,1,11,5,21,13,1,Matches
1113,Luca Horn,GER,DF,Wolfsburg,Bundesliga,20,1998,0.1,0,0,0,0,0,0,0,,0,0,0,0,0,0,0,0,Matches
1114,Timo Horn,GER,GK,Köln,Bundesliga,26,1993,34.0,0,0,0,0,0,0,5,0.0,5,0,0,0,2,2,15,1,Matches
1115,Krisztofer Horváth,HUN,"FW,DF",SPAL,Serie A,17,2002,0.5,1,1,0,1,0,0,0,,0,0,0,0,0,1,0,0,Matches
1116,Conor Hourihane,IRL,MF,Aston Villa,Premier League,28,1991,17.0,16,10,4,8,4,10,25,40.0,15,19,4,15,9,25,31,0,Matches
1117,Lukáš Hrádecký,FIN,GK,Leverkusen,Bundesliga,29,1989,34.0,0,0,0,0,0,0,1,0.0,1,0,0,0,2,2,19,2,Matches
1118,Benjamin Hübner,GER,DF,Hoffenheim,Bundesliga,30,1989,23.0,42,26,33,9,0,23,45,51.1,22,18,13,5,30,72,98,2,Matches
1119,Florian Hübner,GER,DF,Union Berlin,Bundesliga,28,1991,9.4,16,14,12,4,0,7,17,41.2,10,11,7,4,16,32,39,0,Matches
1120,Callum Hudson-Odoi,ENG,"FW,MF",Chelsea,Premier League,18,2000,9.6,10,4,4,5,1,1,7,14.3,6,9,0,9,5,15,4,1,Matches
1121,Will Hughes,ENG,MF,Watford,Premier League,24,1995,25.0,75,47,24,41,10,25,67,37.3,42,48,8,40,37,112,28,0,Matches
1122,Mats Hummels,GER,DF,Dortmund,Bundesliga,30,1988,28.7,57,30,30,26,1,20,38,52.6,18,41,18,23,59,116,110,1,Matches
1123,Uwe Hünemeier,GER,DF,Paderborn 07,Bundesliga,33,1986,13.4,20,15,9,11,0,10,20,50.0,10,22,12,10,24,44,63,0,Matches
1124,Adrien Hunou,FRA,"FW,MF",Rennes,Ligue 1,25,1994,13.4,21,18,5,11,5,4,21,19.0,17,16,1,15,5,26,5,0,Matches
1125,Jannik Huth,GER,GK,Paderborn 07,Bundesliga,25,1994,6.0,0,0,0,0,0,0,1,0.0,1,0,0,0,0,0,2,0,Matches
1126,Elseid Hysaj,ALB,DF,Napoli,Serie A,25,1994,16.5,18,9,13,4,1,12,26,46.2,14,16,3,13,24,42,26,0,Matches
1127,Suk Hyun-jun,KOR,"FW,MF",Reims,Ligue 1,28,1991,2.9,3,3,1,1,1,1,2,50.0,1,1,0,1,1,4,2,0,Matches
1128,Pierre Højbjerg,DEN,MF,Southampton,Premier League,23,1995,30.6,80,49,34,38,8,39,91,42.9,52,44,5,39,46,126,54,2,Matches
1129,Simone Iacoponi,ITA,DF,Parma,Serie A,32,1987,33.9,49,25,36,12,1,26,42,61.9,16,37,29,8,35,84,140,2,Matches
1130,Iago,BRA,"DF,MF",Augsburg,Bundesliga,22,1997,7.5,19,12,12,7,0,9,18,50.0,9,6,2,4,14,33,27,0,Matches
1131,Robert Ibáñez,ESP,"MF,FW",Osasuna,La Liga,26,1993,6.0,13,8,4,5,4,7,20,35.0,13,7,0,7,5,18,5,0,Matches
1132,Roger Ibanez,BRA,DF,Roma,Serie A,20,1998,6.8,11,8,6,3,2,5,7,71.4,2,9,6,3,18,29,21,1,Matches
1133,Jordon Ibe,ENG,DF,Bournemouth,Premier League,23,1995,0.6,2,2,2,0,0,1,1,100.0,0,0,0,0,0,2,1,0,Matches
1134,Vedad Ibišević,BIH,FW,Hertha BSC,Bundesliga,34,1984,14.0,4,3,0,1,3,0,3,0.0,3,4,0,4,1,5,15,0,Matches
1135,Vicente Iborra,ESP,MF,Villarreal,La Liga,31,1988,29.4,61,42,31,25,5,30,67,44.8,37,35,16,19,40,101,63,1,Matches
1136,Didier Ibrahim Ndong,GAB,MF,Dijon,Ligue 1,25,1994,26.5,62,35,30,31,1,30,59,50.8,29,27,6,21,49,111,31,0,Matches
1137,Zlatan Ibrahimović,SWE,FW,Milan,Serie A,37,1981,15.1,5,1,0,2,3,1,13,7.7,12,4,3,1,5,10,21,0,Matches
1138,Mauro Icardi,ARG,FW,Paris S-G,Ligue 1,26,1993,14.1,4,2,1,3,0,1,10,10.0,9,7,1,6,2,6,11,0,Matches
1139,Adam Idah,IRL,"FW,MF",Norwich City,Premier League,18,2001,2.5,2,2,1,0,1,2,3,66.7,1,4,0,4,0,2,1,0,Matches
1140,Odion Ighalo,NGA,FW,Manchester Utd,Premier League,30,1989,1.1,2,2,0,2,0,1,3,33.3,2,1,1,0,0,2,0,0,Matches
1141,Borja Iglesias,ESP,FW,Betis,La Liga,26,1993,21.4,7,5,1,4,2,0,9,0.0,9,7,4,3,5,12,18,0,Matches
1142,Igor,BRA,DF,SPAL,Serie A,21,1998,14.9,24,16,13,10,1,14,20,70.0,6,17,9,8,24,48,37,1,Matches
1143,Igor,BRA,DF,Fiorentina,Serie A,21,1998,6.8,12,10,8,2,2,6,7,85.7,1,10,4,6,7,19,16,0,Matches
1144,Kelechi Iheanacho,NGA,FW,Leicester City,Premier League,22,1996,10.7,3,1,1,2,0,1,9,11.1,8,8,1,7,3,6,8,0,Matches
1145,Luc Ihorst,GER,FW,Werder Bremen,Bundesliga,19,2000,0.1,1,1,0,0,1,0,0,,0,1,0,1,0,1,0,0,Matches
1146,Jonathan Ikone,FRA,"MF,FW",Lille,Ligue 1,21,1998,22.9,15,7,3,7,5,6,24,25.0,18,26,2,24,5,20,3,0,Matches
1147,Yun Il-lok,KOR,"MF,FW",Montpellier,Ligue 1,27,1992,1.3,1,1,0,1,0,0,4,0.0,4,0,0,0,0,1,0,0,Matches
1148,Josip Iličić,SVN,"FW,MF",Atalanta,Serie A,31,1988,18.5,26,19,7,10,9,7,28,25.0,21,9,0,9,9,35,4,0,Matches
1149,Asier Illarramendi,ESP,MF,Real Sociedad,La Liga,29,1990,2.4,2,2,1,0,1,2,6,33.3,4,2,1,1,5,7,6,0,Matches
1150,Stefan Ilsanker,AUT,DF,RB Leipzig,Bundesliga,30,1989,4.6,3,1,3,0,0,3,6,50.0,3,6,3,3,7,10,21,0,Matches
1151,Stefan Ilsanker,AUT,"DF,MF",Eint Frankfurt,Bundesliga,30,1989,9.3,23,15,16,7,0,10,23,43.5,13,8,1,7,19,42,26,0,Matches
1152,Giannelli Imbula,COD,MF,Lecce,Serie A,26,1992,1.4,2,0,2,0,0,0,1,0.0,1,4,1,3,2,4,0,0,Matches
1153,Ciro Immobile,ITA,FW,Lazio,Serie A,29,1990,35.2,8,6,2,4,2,0,24,0.0,24,10,2,8,11,19,7,0,Matches
1154,Roberto Inglese,ITA,FW,Parma,Serie A,27,1991,8.5,9,6,2,2,5,2,10,20.0,8,8,2,6,2,11,1,0,Matches
1155,Danny Ings,ENG,FW,Southampton,Premier League,27,1992,31.2,42,25,16,16,10,13,67,19.4,54,62,4,58,9,51,30,1,Matches
1156,Marcus Ingvartsen,DEN,"MF,FW",Union Berlin,Bundesliga,23,1996,19.1,20,14,5,7,8,9,28,32.1,19,16,1,15,16,36,16,0,Matches
1157,Lorenzo Insigne,ITA,"FW,MF",Napoli,Serie A,28,1991,31.2,21,15,6,8,7,6,35,17.1,29,13,0,13,30,51,4,1,Matches
1158,Takashi Inui,JPN,"MF,FW",Eibar,La Liga,31,1988,21.8,20,10,7,8,5,11,34,32.4,23,23,4,19,18,38,12,0,Matches
1159,Artur Ioniță,MDA,MF,Cagliari,Serie A,28,1990,21.1,38,23,12,22,4,12,37,32.4,25,32,10,22,18,56,24,2,Matches
1160,Alexander Isak,SWE,FW,Real Sociedad,La Liga,19,1999,16.7,7,2,0,3,4,1,8,12.5,7,8,0,8,3,10,6,0,Matches
1161,Isco,ESP,"FW,MF",Real Madrid,La Liga,27,1992,13.1,13,9,2,10,1,5,14,35.7,9,9,0,9,7,20,4,1,Matches
1162,Nicolas Isimat-Mirin,FRA,DF,Toulouse,Ligue 1,27,1991,14.0,14,8,8,6,0,5,11,45.5,6,18,12,6,22,36,71,0,Matches
1163,Jakub Iskra,POL,DF,SPAL,Serie A,16,2002,0.9,0,0,0,0,0,0,0,,0,0,0,0,1,1,2,0,Matches
1164,Ismael,ESP,MF,Betis,La Liga,18,2000,0.9,2,1,1,1,0,1,2,50.0,1,2,1,1,2,4,2,0,Matches
1165,Gian-Luca Itter,GER,"DF,MF",Freiburg,Bundesliga,20,1999,0.4,1,1,1,0,0,1,1,100.0,0,0,0,0,1,2,4,0,Matches
1166,Ander Iturraspe,ESP,MF,Espanyol,La Liga,30,1989,2.7,2,0,1,1,0,2,5,40.0,3,0,0,0,1,3,7,0,Matches
1167,Alex Iwobi,NGA,"MF,FW",Everton,Premier League,23,1996,17.7,25,17,8,15,2,12,33,36.4,21,18,2,16,14,39,10,1,Matches
1168,Armando Izzo,ITA,DF,Torino,Serie A,27,1992,29.8,42,24,24,14,4,17,35,48.6,18,44,29,15,71,113,121,1,Matches
1169,Jacobo,ESP,"DF,MF",Celta Vigo,La Liga,22,1997,0.9,3,3,2,1,0,1,1,100.0,0,0,0,0,0,3,2,0,Matches
1170,Phil Jagielka,ENG,DF,Sheffield Utd,Premier League,36,1982,2.7,5,4,3,2,0,1,3,33.3,2,5,5,0,4,9,19,0,Matches
1171,Filip Jagiełło,POL,MF,Genoa,Serie A,21,1997,6.1,7,2,0,3,4,3,7,42.9,4,4,0,4,5,12,4,0,Matches
1172,Alireza Jahanbakhsh,IRN,"FW,MF",Brighton,Premier League,25,1993,3.5,8,4,3,2,3,0,2,0.0,2,5,0,5,3,11,2,0,Matches
1173,Mato Jajalo,BIH,MF,Udinese,Serie A,31,1988,18.3,44,19,19,22,3,14,38,36.8,24,20,7,13,19,63,19,2,Matches
1174,Ismail Jakobs,SEN,"FW,DF",Köln,Bundesliga,19,1999,18.6,34,23,18,9,7,10,23,43.5,13,25,3,22,24,58,30,0,Matches
1175,Christophe Jallet,FRA,DF,Amiens,Ligue 1,35,1983,9.5,24,16,14,8,2,14,37,37.8,23,8,2,6,18,42,29,0,Matches
1176,Daniel James,WAL,FW,Manchester Utd,Premier League,21,1997,25.4,20,10,5,10,5,7,45,15.6,38,23,4,19,7,27,12,0,Matches
1177,Matty James,ENG,MF,Leicester City,Premier League,28,1991,0.1,0,0,0,0,0,0,0,,0,0,0,0,0,0,0,0,Matches
1178,Reece James,ENG,DF,Chelsea,Premier League,19,1999,16.8,36,23,18,14,4,11,29,37.9,18,19,8,11,22,58,28,0,Matches
1179,Marko Janković,MNE,"FW,DF",SPAL,Serie A,24,1995,1.3,2,1,0,0,2,1,2,50.0,1,2,1,1,0,2,0,0,Matches
1180,Jakub Jankto,CZE,"MF,FW",Sampdoria,Serie A,23,1996,23.3,27,13,14,10,3,10,42,23.8,32,30,3,27,22,49,22,0,Matches
1181,Daryl Janmaat,NED,DF,Watford,Premier League,30,1989,6.7,14,10,8,6,0,6,13,46.2,7,7,2,5,7,21,23,0,Matches
1182,Laurent Jans,LUX,DF,Paderborn 07,Bundesliga,26,1992,17.5,42,25,30,8,4,22,48,45.8,26,25,10,15,19,61,49,1,Matches
1183,Tony Jantschke,GER,DF,Gladbach,Bundesliga,29,1990,11.2,33,21,23,10,0,15,24,62.5,9,20,11,9,27,60,48,0,Matches
1184,Adnan Januzaj,BEL,"FW,MF",Real Sociedad,La Liga,24,1995,13.0,8,7,3,2,3,3,16,18.8,13,9,1,8,7,15,2,0,Matches
1185,Rune Jarstein,NOR,GK,Hertha BSC,Bundesliga,34,1984,28.3,4,1,4,0,0,2,3,66.7,1,0,0,0,1,5,11,3,Matches
1186,Jason,ESP,MF,Getafe,La Liga,25,1994,13.1,29,20,8,16,5,15,33,45.5,18,18,3,15,18,47,9,0,Matches
1187,Dennis Jastrzembski,POL,"MF,FW",Paderborn 07,Bundesliga,19,2000,2.0,2,0,1,1,0,0,1,0.0,1,3,0,3,3,5,0,0,Matches
1188,Corentin Jean,FRA,DF,Toulouse,Ligue 1,24,1995,0.1,0,0,0,0,0,0,0,,0,0,0,0,0,0,1,0,Matches
1189,Benjamin Jeannot,FRA,"MF,FW",Dijon,Ligue 1,27,1992,1.9,2,1,0,1,1,0,4,0.0,4,2,0,2,2,4,4,0,Matches
1190,Tin Jedvaj,CRO,DF,Augsburg,Bundesliga,23,1995,29.3,44,26,25,19,0,23,47,48.9,24,36,18,18,60,104,123,1,Matches
1191,Jemerson,BRA,"DF,MF",Monaco,Ligue 1,26,1992,11.7,28,17,13,14,1,10,21,47.6,11,8,3,5,16,44,24,0,Matches
1192,Fredrik Jensen,FIN,"MF,FW",Augsburg,Bundesliga,21,1997,5.1,3,1,2,1,0,2,7,28.6,5,7,1,6,1,4,3,0,Matches
1193,Jesé,ESP,FW,Paris S-G,Ligue 1,26,1993,0.0,0,0,0,0,0,0,0,,0,0,0,0,0,0,0,0,Matches
1194,Gabriel Jesus,BRA,FW,Manchester City,Premier League,22,1997,22.6,17,10,4,5,8,7,25,28.0,18,26,1,25,11,28,6,0,Matches
1195,Juan Jesus,BRA,DF,Roma,Serie A,28,1991,1.5,2,1,2,0,0,0,3,0.0,3,1,0,1,1,3,7,0,Matches
1196,Raúl Jiménez,MEX,FW,Wolves,Premier League,28,1991,36.0,20,12,6,10,4,3,31,9.7,28,26,0,26,16,36,34,1,Matches
1197,João Pedro,BRA,"FW,MF",Watford,Premier League,17,2001,0.3,0,0,0,0,0,0,0,,0,0,0,0,0,0,0,0,Matches
1198,Joaquín,ESP,"MF,FW",Betis,La Liga,38,1981,22.9,14,7,4,8,2,4,11,36.4,7,10,2,8,15,29,22,1,Matches
1199,Joelinton,BRA,FW,Newcastle Utd,Premier League,22,1996,29.8,34,20,7,22,5,9,32,28.1,23,32,6,26,11,45,30,0,Matches
1200,Ben Johnson,ENG,DF,West Ham,Premier League,19,2000,3.0,8,4,7,1,0,7,10,70.0,3,5,2,3,3,11,11,0,Matches
1201,Fabian Johnson,USA,"MF,DF",Gladbach,Bundesliga,31,1987,3.0,5,3,2,2,1,2,4,50.0,2,4,1,3,2,7,3,0,Matches
1202,Curtis Jones,ENG,MF,Liverpool,Premier League,18,2001,1.4,4,4,0,1,3,3,4,75.0,1,2,0,2,2,6,1,0,Matches
1203,Phil Jones,ENG,DF,Manchester Utd,Premier League,27,1992,1.5,2,2,1,1,0,1,1,100.0,0,2,0,2,2,4,9,1,Matches
1204,Frenkie de Jong,NED,MF,Barcelona,La Liga,22,1997,23.5,26,19,7,12,7,7,22,31.8,15,17,7,10,21,47,9,0,Matches
1205,Luuk de Jong,NED,FW,Sevilla,La Liga,28,1990,22.9,21,10,4,8,9,6,17,35.3,11,12,1,11,7,28,22,0,Matches
1206,Jony,ESP,"DF,FW",Lazio,Serie A,28,1991,13.1,13,9,7,4,2,5,23,21.7,18,11,2,9,14,27,17,0,Matches
1207,Joan Jordán,ESP,MF,Sevilla,La Liga,25,1994,25.0,64,34,27,31,6,21,76,27.6,55,25,5,20,26,90,20,4,Matches
1208,Bruno Jordão,POR,FW,Wolves,Premier League,20,1998,0.1,0,0,0,0,0,0,0,,0,1,0,1,0,0,0,0,Matches
1209,Jorginho,ITA,MF,Chelsea,Premier League,27,1991,26.4,66,40,24,34,8,35,91,38.5,56,30,5,25,64,130,27,2,Matches
1210,Jesse Joronen,FIN,GK,Brescia,Serie A,26,1993,29.0,3,1,3,0,0,3,3,100.0,0,0,0,0,6,9,22,0,Matches
1211,Willian José,BRA,FW,Real Sociedad,La Liga,27,1991,22.3,5,2,0,4,1,2,8,25.0,6,10,4,6,1,6,16,0,Matches
1212,Joselu,ESP,FW,Alavés,La Liga,29,1990,30.9,26,17,4,12,10,4,32,12.5,28,36,5,31,13,39,46,0,Matches
1213,Jota,ESP,"FW,MF",Aston Villa,Premier League,28,1991,3.7,3,1,2,0,1,2,5,40.0,3,1,0,1,3,6,6,0,Matches
1214,Diogo Jota,POR,FW,Wolves,Premier League,22,1996,25.4,28,15,16,10,2,12,48,25.0,36,17,0,17,9,37,10,2,Matches
1215,Vukašin Jovanović,SRB,DF,Bordeaux,Ligue 1,23,1996,6.4,18,11,12,6,0,14,21,66.7,7,5,3,2,15,33,15,0,Matches
1216,Dejan Joveljić,SRB,FW,Eint Frankfurt,Bundesliga,19,1999,1.7,2,2,1,1,0,0,1,0.0,1,0,0,0,0,2,1,0,Matches
1217,Stevan Jovetić,MNE,"FW,MF",Monaco,Ligue 1,29,1989,5.3,2,1,0,1,1,1,5,20.0,4,1,0,1,1,3,5,0,Matches
1218,Luka Jović,SRB,FW,Real Madrid,La Liga,21,1997,4.8,2,1,0,0,2,1,2,50.0,1,1,0,1,2,4,0,0,Matches
1219,Juanmi,ESP,"FW,MF",Betis,La Liga,26,1993,2.9,4,1,1,2,1,1,4,25.0,3,1,0,1,0,4,0,0,Matches
1220,David Juncà,ESP,DF,Celta Vigo,La Liga,25,1993,2.9,6,5,4,1,1,2,3,66.7,1,4,1,3,2,8,3,0,Matches
1221,Lago Junior,CIV,"MF,FW",Mallorca,La Liga,28,1990,24.3,32,19,12,11,9,12,29,41.4,17,23,5,18,14,46,25,0,Matches
1222,Hamed Junior Traorè,CIV,"MF,FW",Sassuolo,Serie A,19,2000,17.4,31,15,10,15,6,14,39,35.9,25,22,1,21,11,42,7,0,Matches
1223,Vinicius Júnior,BRA,"FW,MF",Real Madrid,La Liga,19,2000,15.2,26,16,13,8,5,8,32,25.0,24,14,0,14,3,29,2,0,Matches
1224,James Justin,ENG,"DF,MF",Leicester City,Premier League,21,1998,11.2,36,17,22,14,0,15,25,60.0,10,15,7,8,11,47,30,0,Matches
1225,Musa Juwara,GAM,"FW,MF",Bologna,Serie A,17,2001,1.7,4,2,1,1,2,1,5,20.0,4,2,1,1,0,4,1,0,Matches
1226,Mathias Jørgensen,DEN,DF,Düsseldorf,Bundesliga,29,1990,5.5,4,3,3,1,0,2,4,50.0,2,7,3,4,13,17,33,0,Matches
1227,Ozan Kabak,TUR,DF,Schalke 04,Bundesliga,19,2000,19.7,37,23,28,9,0,14,21,66.7,7,33,19,14,37,74,97,0,Matches
1228,Christian Kabasele,BEL,DF,Watford,Premier League,28,1991,25.0,37,24,26,11,0,17,32,53.1,15,31,23,8,36,73,127,0,Matches
1229,Abdoul Kader Bamba,FRA,"FW,MF",Nantes,Ligue 1,25,1994,16.3,19,15,5,9,5,9,30,30.0,21,8,2,6,16,35,8,0,Matches
1230,Pavel Kadeřábek,CZE,"DF,FW",Hoffenheim,Bundesliga,27,1992,27.5,32,22,17,13,2,13,30,43.3,17,29,7,22,27,59,55,1,Matches
1231,Florian Kainz,AUT,"FW,MF",Köln,Bundesliga,26,1992,17.3,21,13,12,6,3,15,33,45.5,18,26,2,24,13,34,11,0,Matches
1232,Gaël Kakuta,COD,"MF,FW",Amiens,Ligue 1,28,1991,22.2,46,27,13,27,6,17,48,35.4,31,15,1,14,16,62,8,2,Matches
1233,Lovre Kalinić,CRO,GK,Toulouse,Ligue 1,29,1990,3.4,0,0,0,0,0,0,1,0.0,1,0,0,0,0,0,0,0,Matches
1234,Nikola Kalinić,CRO,FW,Roma,Serie A,31,1988,6.3,2,1,0,2,0,0,0,,0,2,0,2,1,3,1,0,Matches
1235,Salomon Kalou,CIV,"FW,MF",Hertha BSC,Bundesliga,33,1985,1.6,1,0,1,0,0,0,2,0.0,2,2,0,2,0,1,1,0,Matches
1236,Samuel Kalu,NGA,"DF,FW",Bordeaux,Ligue 1,21,1997,15.1,33,17,19,12,2,16,36,44.4,20,13,1,12,24,57,10,0,Matches
1237,Daichi Kamada,JPN,"MF,FW",Eint Frankfurt,Bundesliga,22,1996,21.9,29,20,7,17,5,8,42,19.0,34,16,1,15,10,39,6,0,Matches
1238,François Kamano,GUI,"DF,MF",Bordeaux,Ligue 1,23,1996,7.2,12,6,5,4,3,8,15,53.3,7,5,0,5,3,15,2,0,Matches
1239,Boubacar Kamara,FRA,"DF,MF",Marseille,Ligue 1,19,1999,23.8,67,34,37,27,3,27,57,47.4,30,27,14,13,34,101,53,1,Matches
1240,Hassane Kamara,CIV,"DF,FW",Reims,Ligue 1,25,1994,19.0,58,47,40,14,4,24,35,68.6,11,17,2,15,58,116,58,0,Matches
1241,Kevin Kampl,SVN,MF,RB Leipzig,Bundesliga,28,1990,7.5,17,11,7,10,0,7,23,30.4,16,7,2,5,16,33,6,0,Matches
1242,Harry Kane,ENG,FW,Tottenham,Premier League,26,1993,28.7,18,12,3,12,3,4,17,23.5,13,17,7,10,6,24,30,0,Matches
1243,Lee Kang-in,KOR,"MF,FW",Valencia,La Liga,18,2001,5.0,3,1,0,2,1,3,6,50.0,3,5,0,5,3,6,0,0,Matches
1244,Wilfried Kanga,CIV,FW,Angers,Ligue 1,21,1998,0.8,0,0,0,0,0,0,1,0.0,1,0,0,0,0,0,0,0,Matches
1245,N'Golo Kanté,FRA,MF,Chelsea,Premier League,28,1991,19.2,44,20,22,14,8,17,36,47.2,19,29,5,24,44,88,32,2,Matches
1246,Stefanos Kapino,GRE,GK,Werder Bremen,Bundesliga,25,1994,1.0,0,0,0,0,0,0,0,,0,0,0,0,1,1,0,0,Matches
1247,Wilfrid Kaptoum,CMR,MF,Betis,La Liga,23,1996,2.2,5,2,3,2,0,3,3,100.0,0,4,1,3,1,6,3,0,Matches
1248,Kenan Karaman,TUR,"FW,MF",Düsseldorf,Bundesliga,25,1994,15.0,11,5,2,5,4,4,9,44.4,5,9,4,5,2,13,7,0,Matches
1249,Yann Karamoh,FRA,"FW,MF",Parma,Serie A,21,1998,6.4,10,7,5,4,1,3,9,33.3,6,5,0,5,2,12,3,0,Matches
1250,Mamoudou Karamoko,FRA,MF,Wolfsburg,Bundesliga,19,1999,0.1,0,0,0,0,0,0,0,,0,0,0,0,0,0,0,0,Matches
1251,Florian Kastenmeier,GER,GK,Düsseldorf,Bundesliga,22,1997,17.0,1,1,1,0,0,0,0,,0,0,0,0,2,3,3,1,Matches
1252,Noah Katterbach,GER,DF,Köln,Bundesliga,18,2001,14.6,29,23,21,8,0,11,28,39.3,17,12,1,11,29,58,26,0,Matches
1253,Moise Kean,ITA,FW,Everton,Premier League,19,2000,9.5,6,6,5,1,0,0,0,,0,4,0,4,5,11,1,1,Matches
1254,Michael Keane,ENG,DF,Everton,Premier League,26,1993,28.4,31,16,18,12,1,14,24,58.3,10,35,28,7,44,75,152,0,Matches
1255,Thilo Kehrer,GER,DF,Paris S-G,Ligue 1,22,1996,5.3,10,7,4,5,1,5,10,50.0,5,2,0,2,1,11,2,1,Matches
1256,Jules Keita,GUI,"MF,FW",Dijon,Ligue 1,21,1998,1.8,4,3,2,1,1,1,6,16.7,5,1,0,1,3,7,0,0,Matches
1257,Naby Keïta,GUI,MF,Liverpool,Premier League,24,1995,9.1,30,14,8,16,6,11,26,42.3,15,18,0,18,10,40,4,0,Matches
1258,Yannik Keitel,GER,MF,Freiburg,Bundesliga,19,2000,1.9,2,1,1,1,0,0,6,0.0,6,3,1,2,4,6,4,0,Matches
1259,Lloyd Kelly,ENG,DF,Bournemouth,Premier League,20,1998,7.1,7,3,3,4,0,6,7,85.7,1,9,5,4,6,13,15,1,Matches
1260,Martin Kelly,ENG,DF,Crystal Palace,Premier League,29,1990,17.2,23,18,19,4,0,14,31,45.2,17,18,10,8,16,39,86,1,Matches
1261,Kenedy,BRA,MF,Getafe,La Liga,23,1996,6.5,9,5,3,3,3,2,5,40.0,3,10,0,10,11,20,4,0,Matches
1262,Jonjoe Kenny,ENG,DF,Schalke 04,Bundesliga,22,1997,30.2,49,29,24,19,6,26,51,51.0,25,45,10,35,26,75,79,0,Matches
1263,Franck Kessié,CIV,MF,Milan,Serie A,22,1996,32.3,54,29,28,18,8,16,52,30.8,36,34,5,29,34,88,32,2,Matches
1264,Saîf-Eddine Khaoui,TUN,"MF,FW",Marseille,Ligue 1,24,1995,1.2,3,1,0,3,0,2,5,40.0,3,2,0,2,1,4,4,0,Matches
1265,Wahbi Khazri,TUN,"FW,MF",Saint-Étienne,Ligue 1,28,1991,12.8,17,9,5,7,5,9,27,33.3,18,11,0,11,4,21,0,0,Matches
1266,Rani Khedira,GER,MF,Augsburg,Bundesliga,25,1994,29.4,60,36,21,35,4,18,45,40.0,27,47,12,35,48,108,62,0,Matches
1267,Sami Khedira,GER,MF,Juventus,Serie A,32,1987,7.6,14,7,3,8,3,4,19,21.1,15,12,1,11,3,17,13,0,Matches
1268,Kiké,ESP,FW,Eibar,La Liga,29,1989,19.6,13,7,0,5,8,4,12,33.3,8,15,1,14,1,14,9,0,Matches
1269,Luca Kilian,GER,DF,Paderborn 07,Bundesliga,19,1999,14.0,33,24,27,6,0,22,41,53.7,19,20,9,11,12,45,67,0,Matches
1270,Max Kilman,ENG,DF,Wolves,Premier League,22,1997,2.1,4,2,1,3,0,2,2,100.0,0,1,1,0,4,8,7,0,Matches
1271,Joshua Kimmich,GER,"MF,DF",Bayern Munich,Bundesliga,24,1995,31.3,52,29,21,20,11,22,55,40.0,33,38,9,29,29,81,29,0,Matches
1272,Presnel Kimpembe,FRA,DF,Paris S-G,Ligue 1,23,1995,13.6,33,25,25,8,0,14,20,70.0,6,7,3,4,21,54,33,1,Matches
1273,Joshua King,NOR,"FW,MF",Bournemouth,Premier League,27,1992,22.3,16,6,4,8,4,4,16,25.0,12,20,3,17,8,24,9,0,Matches
1274,Simon Kjær,DEN,DF,Atalanta,Serie A,30,1989,3.2,9,6,1,8,0,3,4,75.0,1,5,4,1,7,16,10,1,Matches
1275,Simon Kjær,DEN,DF,Milan,Serie A,30,1989,13.8,22,13,17,5,0,10,18,55.6,8,20,16,4,15,37,52,0,Matches
1276,Davy Klaassen,NED,MF,Werder Bremen,Bundesliga,26,1993,32.6,55,43,19,23,13,19,57,33.3,38,46,18,28,38,93,45,2,Matches
1277,Felix Klaus,GER,"MF,FW",Wolfsburg,Bundesliga,26,1992,7.4,24,16,4,13,7,7,19,36.8,12,10,2,8,3,27,5,0,Matches
1278,Ragnar Klavan,EST,DF,Cagliari,Serie A,33,1985,26.2,29,16,20,9,0,14,28,50.0,14,29,19,10,25,54,118,1,Matches
1279,Timm Klose,SUI,DF,Norwich City,Premier League,31,1988,6.5,8,2,5,2,1,7,11,63.6,4,6,6,0,7,15,29,0,Matches
1280,Lukas Klostermann,GER,DF,RB Leipzig,Bundesliga,23,1996,29.4,45,26,24,16,5,18,31,58.1,13,34,16,18,26,71,101,2,Matches
1281,Justin Kluivert,NED,FW,Roma,Serie A,20,1999,16.8,17,11,4,8,5,7,16,43.8,9,15,0,15,6,23,7,0,Matches
1282,Lukas Klünter,GER,DF,Hertha BSC,Bundesliga,23,1996,20.9,44,31,26,16,2,20,30,66.7,10,16,4,12,27,71,61,1,Matches
1283,Robin Knoche,GER,DF,Wolfsburg,Bundesliga,27,1992,17.7,29,14,24,5,0,17,30,56.7,13,19,11,8,27,56,77,1,Matches
1284,Robin Koch,GER,"DF,MF",Freiburg,Bundesliga,23,1996,30.1,34,20,20,13,1,11,26,42.3,15,30,22,8,45,79,94,4,Matches
1285,Giorgi Kochorashvili,GEO,MF,Levante,La Liga,20,1999,0.0,0,0,0,0,0,0,0,,0,0,0,0,0,0,0,0,Matches
1286,Jonathan Kodjia,CIV,FW,Aston Villa,Premier League,29,1989,1.3,0,0,0,0,0,0,1,0.0,1,0,0,0,0,0,1,0,Matches
1287,Kenan Kodro,BIH,"FW,MF",Athletic Club,La Liga,25,1993,4.0,1,0,0,0,1,0,2,0.0,2,1,0,1,0,1,4,0,Matches
1288,Dominik Kohr,GER,MF,Eint Frankfurt,Bundesliga,25,1994,16.1,44,35,15,25,4,18,53,34.0,35,31,11,20,30,74,16,0,Matches
1289,Koke,ESP,MF,Atlético Madrid,La Liga,27,1992,30.0,70,42,27,30,13,29,89,32.6,60,33,8,25,29,99,28,2,Matches
1290,Aleksandar Kolarov,SRB,DF,Roma,Serie A,33,1985,30.4,37,28,16,16,5,20,37,54.1,17,20,9,11,31,68,57,0,Matches
1291,Sead Kolašinac,BIH,DF,Arsenal,Premier League,26,1993,18.9,29,16,18,6,5,12,23,52.2,11,14,4,10,25,54,34,1,Matches
1292,Timothée Kolodziejczak,FRA,DF,Saint-Étienne,Ligue 1,27,1991,14.5,17,10,13,4,0,9,21,42.9,12,8,3,5,30,47,44,2,Matches
1293,Ghislain Konan,CIV,DF,Reims,Ligue 1,23,1995,14.8,43,26,28,14,1,19,28,67.9,9,13,3,10,24,67,34,0,Matches
1294,Ibrahima Konaté,FRA,DF,RB Leipzig,Bundesliga,20,1999,6.3,11,6,10,1,0,2,7,28.6,5,9,4,5,5,16,35,1,Matches
1295,Moussa Konaté,SEN,FW,Amiens,Ligue 1,26,1993,6.8,3,0,0,3,0,0,2,0.0,2,2,0,2,1,4,1,0,Matches
1296,Geoffrey Kondogbia,CTA,MF,Valencia,La Liga,26,1993,20.1,63,40,40,18,5,19,51,37.3,32,25,6,19,57,120,36,2,Matches
1297,Lamine Koné,CIV,DF,Strasbourg,Ligue 1,30,1989,16.4,31,21,20,10,1,12,17,70.6,5,8,5,3,25,56,47,1,Matches
1298,Manu Koné,FRA,MF,Toulouse,Ligue 1,18,2001,9.7,35,20,17,14,4,13,30,43.3,17,15,1,14,19,54,10,1,Matches
1299,Moussa Koné,SEN,"FW,MF",Nîmes,Ligue 1,22,1996,1.6,2,0,1,1,0,1,3,33.3,2,1,0,1,1,3,0,0,Matches
1300,Youssouf Koné,MLI,DF,Lyon,Ligue 1,24,1995,9.1,22,14,17,3,2,12,20,60.0,8,2,1,1,8,30,15,0,Matches
1301,Ezri Konsa,ENG,DF,Aston Villa,Premier League,21,1997,22.7,18,9,12,6,0,7,16,43.8,9,34,24,10,25,43,70,2,Matches
1302,Pascal Köpke,GER,FW,Hertha BSC,Bundesliga,23,1995,1.3,0,0,0,0,0,0,0,,0,0,0,0,0,0,0,0,Matches
1303,Laurent Koscielny,FRA,DF,Bordeaux,Ligue 1,33,1985,24.3,28,13,24,4,0,10,20,50.0,10,23,19,4,26,54,104,0,Matches
1304,Filip Kostić,SRB,"DF,FW",Eint Frankfurt,Bundesliga,26,1992,32.9,59,38,30,20,9,22,59,37.3,37,45,2,43,23,82,16,0,Matches
1305,Christian Kouamé,CIV,"FW,MF",Fiorentina,Serie A,21,1997,3.3,3,2,0,3,0,0,1,0.0,1,5,1,4,1,4,1,0,Matches
1306,Christian Kouamé,CIV,FW,Genoa,Serie A,21,1997,10.2,2,1,0,1,1,0,8,0.0,8,8,2,6,1,3,13,0,Matches
1307,Tomáš Koubek,CZE,GK,Augsburg,Bundesliga,26,1992,24.0,3,2,3,0,0,3,11,27.3,8,1,0,1,1,4,23,3,Matches
1308,Kalidou Koulibaly,SEN,DF,Napoli,Serie A,28,1991,23.4,51,33,30,17,4,17,28,60.7,11,28,16,12,31,82,61,1,Matches
1309,Efthimis Koulouris,GRE,FW,Toulouse,Ligue 1,23,1996,17.1,13,8,5,5,3,3,13,23.1,10,8,4,4,3,16,16,0,Matches
1310,Jules Koundé,FRA,DF,Sevilla,La Liga,20,1998,25.7,23,12,14,5,4,10,18,55.6,8,16,12,4,23,46,91,2,Matches
1311,Leonardo Koutris,GRE,DF,Mallorca,La Liga,24,1995,1.0,1,1,0,0,1,1,2,50.0,1,1,1,0,1,2,6,0,Matches
1312,Cheikhou Kouyaté,SEN,"MF,DF",Crystal Palace,Premier League,29,1989,28.1,67,32,43,20,4,26,48,54.2,22,35,11,24,43,110,58,1,Matches
1313,Mateo Kovačić,CRO,MF,Chelsea,Premier League,25,1994,23.0,63,38,29,32,2,26,65,40.0,39,15,1,14,22,85,16,1,Matches
1314,Dawid Kownacki,POL,"FW,MF",Düsseldorf,Bundesliga,22,1997,12.1,13,8,5,7,1,9,20,45.0,11,13,2,11,6,19,8,0,Matches
1315,İsmail Köybaşı,TUR,"DF,FW",Granada,La Liga,30,1989,2.6,4,4,3,1,0,0,2,0.0,2,4,0,4,5,9,2,0,Matches
1316,Thomas Kraft,GER,GK,Hertha BSC,Bundesliga,31,1988,4.0,0,0,0,0,0,0,0,,0,0,0,0,1,1,0,0,Matches
1317,Emil Krafth,SWE,DF,Newcastle Utd,Premier League,24,1994,11.3,18,12,15,2,1,9,20,45.0,11,11,8,3,8,26,45,0,Matches
1318,Andrej Kramarić,CRO,"FW,MF",Hoffenheim,Bundesliga,28,1991,15.8,2,1,1,0,1,1,7,14.3,6,6,0,6,3,5,4,0,Matches
1319,Christoph Kramer,GER,MF,Gladbach,Bundesliga,28,1991,16.3,45,29,19,21,5,19,49,38.8,30,22,3,19,14,59,19,0,Matches
1320,Tom Krauß,GER,MF,RB Leipzig,Bundesliga,18,2001,0.0,1,1,0,1,0,1,2,50.0,1,0,0,0,0,1,0,0,Matches
1321,Ladislav Krejčí,CZE,DF,Bologna,Serie A,27,1992,11.7,15,10,6,7,2,9,19,47.4,10,7,4,3,10,25,23,0,Matches
1322,Rene Krhin,SVN,"DF,MF",Nantes,Ligue 1,29,1990,3.6,4,3,1,3,0,2,2,100.0,0,1,0,1,6,10,17,0,Matches
1323,Felix Kroos,GER,"MF,DF",Union Berlin,Bundesliga,28,1991,4.2,17,9,9,6,2,8,15,53.3,7,6,3,3,3,20,13,1,Matches
1324,Toni Kroos,GER,MF,Real Madrid,La Liga,29,1990,29.5,56,28,18,29,9,18,70,25.7,52,27,0,27,23,79,15,0,Matches
1325,Tim Krul,NED,GK,Norwich City,Premier League,31,1988,36.0,0,0,0,0,0,0,1,0.0,1,2,0,2,1,1,13,1,Matches
1326,Rade Krunić,BIH,"MF,FW",Milan,Serie A,25,1993,6.0,16,8,8,5,3,9,16,56.3,7,5,0,5,9,25,5,0,Matches
1327,Lukas Kübler,GER,DF,Freiburg,Bundesliga,26,1992,2.3,1,1,0,1,0,1,5,20.0,4,2,0,2,1,2,6,0,Matches
1328,Takefusa Kubo,JPN,"MF,FW",Mallorca,La Liga,18,2001,25.7,34,22,16,12,6,15,44,34.1,29,19,1,18,23,57,10,0,Matches
1329,Juraj Kucka,SVK,"MF,FW",Parma,Serie A,32,1987,21.5,43,22,21,16,6,14,61,23.0,47,21,4,17,29,72,36,0,Matches
1330,Dejan Kulusevski,SWE,"FW,MF",Parma,Serie A,19,2000,32.6,41,21,10,24,7,19,64,29.7,45,25,1,24,23,64,17,0,Matches
1331,Marash Kumbulla,ALB,DF,Hellas Verona,Serie A,19,2000,21.7,40,24,21,17,2,19,36,52.8,17,33,24,9,50,90,86,3,Matches
1332,Pierre Kunde,CMR,MF,Mainz 05,Bundesliga,24,1995,20.7,34,17,15,18,1,12,30,40.0,18,16,4,12,26,60,55,0,Matches
1333,Jasmin Kurtić,SVN,MF,SPAL,Serie A,30,1989,15.7,20,7,8,8,4,6,27,22.2,21,14,2,12,10,30,20,1,Matches
1334,Jasmin Kurtić,SVN,"MF,FW",Parma,Serie A,30,1989,18.5,32,23,19,10,3,13,35,37.1,22,19,5,14,15,47,27,2,Matches
1335,Layvin Kurzawa,FRA,DF,Paris S-G,Ligue 1,26,1992,9.5,23,16,5,14,4,11,23,47.8,12,12,1,11,18,41,24,1,Matches
1336,Dereck Kutesa,SUI,"FW,MF",Reims,Ligue 1,21,1997,5.9,6,5,3,2,1,3,9,33.3,6,5,0,5,1,7,1,0,Matches
1337,Ahmed Kutucu,TUR,"FW,MF",Schalke 04,Bundesliga,19,2000,7.5,11,7,3,6,2,4,15,26.7,11,5,0,5,2,13,5,0,Matches
1338,Enock Kwateng,FRA,DF,Bordeaux,Ligue 1,22,1997,10.9,36,22,17,17,2,22,47,46.8,25,16,6,10,22,58,41,0,Matches
1339,Giorgos Kyriakopoulos,GRE,DF,Sassuolo,Serie A,23,1996,18.3,35,18,22,7,6,18,32,56.3,14,19,6,13,18,53,41,0,Matches
1340,Antonino La Gumina,ITA,FW,Sampdoria,Serie A,23,1996,2.1,0,0,0,0,0,0,0,,0,0,0,0,0,0,1,0,Matches
1341,Andrea La Mantia,ITA,FW,Lecce,Serie A,28,1991,6.1,1,0,1,0,0,1,5,20.0,4,3,0,3,7,8,11,0,Matches
1342,Gaëtan Laborde,FRA,FW,Montpellier,Ligue 1,25,1994,24.9,21,12,4,10,7,9,38,23.7,29,21,0,21,7,28,32,1,Matches
1343,Alexandre Lacazette,FRA,FW,Arsenal,Premier League,28,1991,20.8,31,16,8,21,2,9,24,37.5,15,14,0,14,7,38,15,0,Matches
1344,Riccardo Ladinetti,ITA,MF,Cagliari,Serie A,18,2000,1.4,2,2,0,2,0,1,1,100.0,0,0,0,0,4,6,0,1,Matches
1345,Alban Lafont,FRA,GK,Nantes,Ligue 1,20,1999,27.0,1,1,1,0,0,1,1,100.0,0,0,0,0,0,1,12,0,Matches
1346,Víctor Laguardia,ESP,DF,Alavés,La Liga,29,1989,29.5,21,15,15,6,0,16,30,53.3,14,24,18,6,37,58,131,1,Matches
1347,Jack Lahne,SWE,FW,Amiens,Ligue 1,17,2001,0.1,1,1,0,0,1,0,0,,0,0,0,0,0,1,0,0,Matches
1348,Konrad Laimer,AUT,MF,RB Leipzig,Bundesliga,22,1997,23.5,91,45,30,46,15,43,102,42.2,59,51,8,43,34,125,14,0,Matches
1349,Stefan Lainer,AUT,DF,Gladbach,Bundesliga,26,1992,30.1,51,30,25,19,7,24,54,44.4,30,38,7,31,29,80,71,0,Matches
1350,Diego Lainez,MEX,"MF,FW",Betis,La Liga,19,2000,3.9,6,5,2,4,0,5,8,62.5,3,6,0,6,1,7,1,0,Matches
1351,Kenny Lala,MAD,"DF,MF",Strasbourg,Ligue 1,27,1991,22.7,29,16,17,11,1,11,27,40.7,16,14,5,9,20,49,40,1,Matches
1352,Adam Lallana,ENG,"MF,FW",Liverpool,Premier League,31,1988,4.2,19,9,7,9,3,6,21,28.6,15,7,0,7,5,24,3,0,Matches
1353,Érik Lamela,ARG,"MF,FW",Tottenham,Premier League,27,1992,13.5,24,20,9,13,2,2,21,9.5,19,12,3,9,8,32,10,0,Matches
1354,Tariq Lamptey,GHA,DF,Chelsea,Premier League,18,2000,0.4,2,2,1,1,0,2,2,100.0,0,0,0,0,0,2,0,0,Matches
1355,Tariq Lamptey,GHA,DF,Brighton,Premier League,18,2000,6.5,7,6,6,1,0,2,9,22.2,7,6,0,6,16,23,17,0,Matches
1356,Loïck Landre,FRA,DF,Nîmes,Ligue 1,27,1992,10.3,16,9,12,3,1,7,11,63.6,4,12,9,3,17,33,34,0,Matches
1357,Michael Lang,SUI,"DF,FW",Werder Bremen,Bundesliga,28,1991,6.0,8,5,3,5,0,6,12,50.0,6,5,1,4,7,15,22,0,Matches
1358,Sebastian Langkamp,GER,DF,Werder Bremen,Bundesliga,31,1988,3.5,3,2,3,0,0,2,4,50.0,2,5,3,2,3,6,11,1,Matches
1359,Henri Lansbury,ENG,MF,Aston Villa,Premier League,28,1990,2.2,6,2,3,1,2,2,8,25.0,6,4,0,4,0,6,3,0,Matches
1360,Manuel Lanzini,ARG,"MF,FW",West Ham,Premier League,26,1993,15.3,14,9,6,6,2,7,39,17.9,32,9,1,8,10,24,3,0,Matches
1361,Gianluca Lapadula,PER,FW,Lecce,Serie A,29,1990,19.8,15,8,6,8,1,5,16,31.3,11,2,0,2,1,16,14,0,Matches
1362,Aymeric Laporte,ESP,DF,Manchester City,Premier League,25,1994,12.2,13,6,6,7,0,4,9,44.4,5,6,5,1,20,33,26,1,Matches
1363,Danilo Larangeira,BRA,DF,Bologna,Serie A,35,1984,29.3,34,17,19,15,0,16,28,57.1,12,54,39,15,30,64,99,0,Matches
1364,Larra,ESP,"FW,MF",Athletic Club,La Liga,21,1997,2.8,2,2,0,1,1,0,0,,0,1,0,1,0,2,0,0,Matches
1365,Gautier Larsonneur,FRA,GK,Brest,Ligue 1,22,1997,26.6,2,1,2,0,0,2,4,50.0,2,1,0,1,4,6,14,3,Matches
1366,Kevin Lasagna,ITA,FW,Udinese,Serie A,26,1992,28.5,27,14,7,13,7,6,31,19.4,25,23,1,22,10,37,18,1,Matches
1367,Jamaal Lascelles,ENG,DF,Newcastle Utd,Premier League,25,1993,23.1,14,3,10,4,0,4,9,44.4,5,23,20,3,28,42,116,1,Matches
1368,Paul Lasne,FRA,"MF,FW",Brest,Ligue 1,30,1989,13.6,25,13,13,11,1,6,20,30.0,14,7,2,5,7,32,5,0,Matches
1369,Toni Lato,ESP,"DF,MF",Osasuna,La Liga,21,1997,5.2,22,15,11,8,3,9,10,90.0,1,9,1,8,8,30,13,1,Matches
1370,Danny Latza,GER,MF,Mainz 05,Bundesliga,29,1989,15.3,33,19,15,17,1,16,49,32.7,33,22,5,17,17,50,24,0,Matches
1371,Vincent Laurini,FRA,DF,Parma,Serie A,30,1989,9.8,26,22,11,11,4,14,18,77.8,4,10,3,7,11,37,29,0,Matches
1372,Wesley Lautoa,NCL,"MF,DF",Dijon,Ligue 1,31,1987,20.8,54,29,24,28,2,28,63,44.4,35,31,16,15,42,96,48,2,Matches
1373,Diego Laxalt,URU,"DF,MF",Torino,Serie A,26,1993,6.6,19,10,10,6,3,6,20,30.0,14,12,4,8,6,25,20,0,Matches
1374,Diego Laxalt,URU,DF,Milan,Serie A,26,1993,1.9,3,3,3,0,0,1,3,33.3,2,4,0,4,0,3,3,0,Matches
1375,Valentino Lazaro,AUT,"DF,MF",Newcastle Utd,Premier League,23,1996,5.3,13,9,11,2,0,11,18,61.1,7,2,0,2,3,16,4,0,Matches
1376,Valentino Lazaro,AUT,DF,Inter,Serie A,23,1996,3.6,6,5,3,2,1,4,8,50.0,4,5,0,5,1,7,8,1,Matches
1377,Darko Lazović,SRB,DF,Hellas Verona,Serie A,28,1990,36.0,26,16,14,8,4,14,27,51.9,13,15,4,11,23,49,53,0,Matches
1378,Manuel Lazzari,ITA,DF,Lazio,Serie A,25,1993,28.3,20,11,10,7,3,10,31,32.3,21,11,1,10,8,28,34,0,Matches
1379,Mickaël Le Bihan,FRA,"FW,DF",Nice,Ligue 1,29,1990,1.1,0,0,0,0,0,0,2,0.0,2,0,0,0,0,0,2,0,Matches
1380,Robin Le Normand,ESP,DF,Real Sociedad,La Liga,22,1996,26.6,48,27,33,15,0,26,35,74.3,9,20,7,13,20,68,99,0,Matches
1381,Damien Le Tallec,FRA,"MF,DF",Montpellier,Ligue 1,29,1990,27.3,52,27,20,28,4,24,69,34.8,45,38,18,20,38,90,59,0,Matches
1382,James Lea Siliki,CMR,MF,Rennes,Ligue 1,23,1996,12.0,28,16,19,9,0,16,29,55.2,13,15,4,11,12,40,12,0,Matches
1383,Rafael Leão,POR,FW,Milan,Serie A,20,1999,15.6,7,4,2,5,0,3,9,33.3,6,4,0,4,0,7,5,0,Matches
1384,Adrien Lebeau,FRA,"MF,FW",Strasbourg,Ligue 1,20,1999,0.1,1,1,1,0,0,0,1,0.0,1,1,0,1,0,1,0,0,Matches
1385,Mathew Leckie,AUS,"DF,FW",Hertha BSC,Bundesliga,28,1991,2.2,3,1,1,2,0,2,3,66.7,1,6,0,6,2,5,2,1,Matches
1386,Benjamin Lecomte,FRA,GK,Monaco,Ligue 1,28,1991,28.0,0,0,0,0,0,0,1,0.0,1,1,0,1,0,0,10,5,Matches
1387,Pierre Lees-Melou,FRA,MF,Nice,Ligue 1,26,1993,25.0,63,27,34,21,8,31,88,35.2,57,38,12,26,32,95,43,0,Matches
1388,Jordan Lefort,FRA,DF,Amiens,Ligue 1,25,1993,9.4,3,2,2,1,0,3,5,60.0,2,4,1,3,9,12,29,0,Matches
1389,Wu Lei,CHN,"FW,MF",Espanyol,La Liga,27,1991,19.1,13,8,5,6,2,4,38,10.5,34,32,1,31,15,28,19,1,Matches
1390,Toni Leistner,GER,DF,Köln,Bundesliga,28,1990,11.2,19,12,10,9,0,5,13,38.5,8,16,7,9,32,51,57,0,Matches
1391,Moritz Leitner,GER,MF,Norwich City,Premier League,26,1992,7.6,16,9,8,7,1,9,25,36.0,16,14,4,10,9,25,10,1,Matches
1392,Lucas Leiva,BRA,MF,Lazio,Serie A,32,1987,20.1,60,35,25,31,4,28,72,38.9,44,29,6,23,47,107,34,1,Matches
1393,Florian Lejeune,FRA,DF,Newcastle Utd,Premier League,28,1991,4.9,8,2,6,2,0,4,7,57.1,3,6,2,4,10,18,15,2,Matches
1394,Iñigo Lekue,ESP,"FW,DF",Athletic Club,La Liga,26,1993,6.9,22,12,14,6,2,11,14,78.6,3,7,0,7,3,25,11,0,Matches
1395,Nicolas Lemaître,FRA,GK,Reims,Ligue 1,22,1997,1.0,0,0,0,0,0,0,1,0.0,1,0,0,0,1,1,1,1,Matches
1396,Thomas Lemar,FRA,MF,Atlético Madrid,La Liga,23,1995,10.3,12,8,4,5,3,2,11,18.2,9,14,1,13,6,18,6,0,Matches
1397,Tim Lemperle,GER,MF,Köln,Bundesliga,17,2002,0.2,0,0,0,0,0,0,0,,0,0,0,0,0,0,0,0,Matches
1398,Clément Lenglet,FRA,DF,Barcelona,La Liga,24,1995,26.9,44,31,29,15,0,16,32,50.0,16,29,15,14,35,79,79,1,Matches
1399,Aaron Lennon,ENG,MF,Burnley,Premier League,32,1987,5.5,14,8,7,4,3,7,10,70.0,3,6,1,5,8,22,3,0,Matches
1400,Bernd Leno,GER,GK,Arsenal,Premier League,27,1992,29.4,0,0,0,0,0,0,2,0.0,2,0,0,0,0,0,9,2,Matches
1401,Christopher Lenz,GER,"DF,MF",Union Berlin,Bundesliga,24,1994,25.2,63,37,37,20,6,26,49,53.1,23,46,11,35,43,106,65,0,Matches
1402,Donovan Léon,GUF,GK,Brest,Ligue 1,26,1992,1.4,0,0,0,0,0,0,0,,0,1,0,1,0,0,0,0,Matches
1403,Pedro León,ESP,"MF,FW",Eibar,La Liga,32,1986,21.1,28,20,8,9,11,12,25,48.0,13,18,1,17,19,47,7,0,Matches
1404,Sergio León,ESP,FW,Levante,La Liga,30,1989,7.5,3,3,0,3,0,2,4,50.0,2,3,0,3,1,4,2,0,Matches
1405,Lukas Lerager,DEN,MF,Genoa,Serie A,26,1993,15.4,29,19,13,12,4,10,34,29.4,24,20,5,15,8,37,15,1,Matches
1406,Mehdi Léris,ALG,"MF,FW",Sampdoria,Serie A,21,1998,5.7,13,11,4,2,7,7,19,36.8,12,12,4,8,6,19,6,0,Matches
1407,Jefferson Lerma,COL,MF,Bournemouth,Premier League,24,1994,30.0,54,32,17,31,6,22,48,45.8,26,28,12,16,57,111,54,1,Matches
1408,Karlo Letica,CRO,GK,SPAL,Serie A,22,1997,10.0,0,0,0,0,0,0,2,0.0,2,0,0,0,0,0,4,3,Matches
1409,Robert Lewandowski,POL,FW,Bayern Munich,Bundesliga,30,1988,30.7,18,9,3,9,6,3,15,20.0,12,13,1,12,7,25,13,0,Matches
1410,Jamal Lewis,NIR,DF,Norwich City,Premier League,21,1998,25.6,51,35,42,6,3,22,36,61.1,14,27,12,15,25,76,68,0,Matches
1411,Aaron Leya Iseka,BEL,FW,Toulouse,Ligue 1,21,1997,8.6,2,0,0,2,0,0,3,0.0,3,5,0,5,1,3,7,0,Matches
1412,Stephan Lichtsteiner,SUI,DF,Augsburg,Bundesliga,35,1984,14.9,23,14,16,5,2,10,22,45.5,12,15,7,8,16,39,35,0,Matches
1413,Dimitri Liénard,FRA,MF,Strasbourg,Ligue 1,31,1988,16.5,37,24,10,22,5,18,39,46.2,21,18,4,14,17,54,25,0,Matches
1414,Philipp Lienhart,AUT,DF,Freiburg,Bundesliga,23,1996,20.2,11,4,10,1,0,6,13,46.2,7,24,17,7,28,39,86,0,Matches
1415,Matthijs de Ligt,NED,DF,Juventus,Serie A,19,1999,27.2,25,15,14,10,1,13,23,56.5,10,30,23,7,25,50,101,2,Matches
1416,Isaac Lihadji,FRA,MF,Marseille,Ligue 1,17,2002,0.3,0,0,0,0,0,0,0,,0,0,0,0,0,0,0,0,Matches
1417,Lillo,ESP,DF,Osasuna,La Liga,30,1989,2.2,4,2,2,2,0,1,1,100.0,0,2,1,1,2,6,8,0,Matches
1418,Anderson Lima,BRA,"MF,DF",Lazio,Serie A,19,1999,0.7,4,0,3,1,0,1,1,100.0,0,4,0,4,0,4,0,0,Matches
1419,Lucas Lima,BRA,"FW,DF",Nantes,Ligue 1,27,1991,3.0,7,2,4,3,0,2,5,40.0,3,2,0,2,1,8,3,0,Matches
1420,Anthony Limbombe,BEL,"FW,MF",Nantes,Ligue 1,25,1994,1.7,3,2,1,2,0,1,1,100.0,0,1,0,1,0,3,3,0,Matches
1421,Victor Lindelöf,SWE,DF,Manchester Utd,Premier League,25,1994,34.4,29,15,16,12,1,17,20,85.0,3,25,16,9,26,55,129,0,Matches
1422,Karol Linetty,POL,MF,Sampdoria,Serie A,24,1995,22.4,61,32,24,25,12,21,65,32.3,44,26,3,23,26,87,17,0,Matches
1423,Jesse Lingard,ENG,"MF,FW",Manchester Utd,Premier League,26,1992,10.4,15,8,6,4,5,5,18,27.8,13,5,0,5,3,18,0,0,Matches
1424,Pol Lirola,ESP,DF,Fiorentina,Serie A,21,1997,29.4,34,20,18,10,6,21,38,55.3,17,16,4,12,26,60,52,0,Matches
1425,Diego Llorente,ESP,DF,Real Sociedad,La Liga,25,1993,25.9,30,14,20,9,1,16,28,57.1,12,14,7,7,28,58,101,5,Matches
1426,Fernando Llorente,ESP,FW,Napoli,Serie A,34,1985,5.6,0,0,0,0,0,0,1,0.0,1,4,0,4,1,1,3,0,Matches
1427,Marcos Llorente,ESP,"MF,FW",Atlético Madrid,La Liga,24,1995,15.2,29,15,7,16,6,7,21,33.3,14,24,4,20,14,43,9,0,Matches
1428,Gautier Lloris,FRA,DF,Nice,Ligue 1,24,1995,3.0,5,3,5,0,0,4,5,80.0,1,3,3,0,2,7,11,0,Matches
1429,Hugo Lloris,FRA,GK,Tottenham,Premier League,32,1986,20.1,0,0,0,0,0,0,0,,0,0,0,0,1,1,3,2,Matches
1430,Giovani Lo Celso,ARG,"MF,FW",Tottenham,Premier League,23,1996,16.6,51,29,12,33,6,12,59,20.3,47,20,4,16,9,60,19,0,Matches
1431,Stanislav Lobotka,SVK,MF,Napoli,Serie A,24,1994,8.4,11,9,3,5,3,5,12,41.7,7,3,1,2,9,20,2,0,Matches
1432,Stanislav Lobotka,SVK,MF,Celta Vigo,La Liga,24,1994,15.4,19,11,13,5,1,4,19,21.1,15,8,2,6,8,27,7,0,Matches
1433,Jürgen Locadia,CUW,"FW,MF",Brighton,Premier League,25,1993,1.0,0,0,0,0,0,0,0,,0,0,0,0,0,0,0,0,Matches
1434,Jürgen Locadia,CUW,FW,Hoffenheim,Bundesliga,25,1993,5.9,5,4,0,4,1,1,4,25.0,3,1,0,1,0,5,3,0,Matches
1435,Manuel Locatelli,ITA,MF,Sassuolo,Serie A,21,1998,28.7,76,50,35,37,4,33,69,47.8,36,42,14,28,33,109,36,0,Matches
1436,Renan Lodi,BRA,DF,Atlético Madrid,La Liga,21,1998,26.6,73,46,28,35,10,40,65,61.5,25,28,7,21,38,111,56,0,Matches
1437,Ruben Loftus-Cheek,ENG,"MF,FW",Chelsea,Premier League,23,1996,2.3,0,0,0,0,0,0,2,0.0,2,1,1,0,2,2,2,0,Matches
1438,Enzo Loiodice,FRA,MF,Dijon,Ligue 1,18,2000,2.1,6,4,1,4,1,1,3,33.3,2,2,0,2,2,8,1,0,Matches
1439,Kevin Long,IRL,DF,Burnley,Premier League,28,1990,6.3,7,5,6,1,0,4,9,44.4,5,9,7,2,4,11,31,0,Matches
1440,Shane Long,IRL,FW,Southampton,Premier League,32,1987,15.5,19,10,5,8,6,7,19,36.8,12,12,0,12,4,23,16,0,Matches
1441,Matthew Longstaff,ENG,MF,Newcastle Utd,Premier League,19,2000,6.4,3,1,2,1,0,3,14,21.4,11,4,1,3,5,8,3,0,Matches
1442,Sean Longstaff,ENG,MF,Newcastle Utd,Premier League,21,1997,15.3,35,19,17,16,2,20,50,40.0,30,23,5,18,19,54,20,2,Matches
1443,Ademola Lookman,NGA,"FW,MF",RB Leipzig,Bundesliga,21,1997,3.4,6,4,3,1,2,1,1,100.0,0,3,0,3,1,7,0,1,Matches
1444,Anthony Lopes,POR,GK,Lyon,Ligue 1,28,1990,26.0,0,0,0,0,0,0,0,,0,0,0,0,1,1,11,0,Matches
1445,Rony Lopes,POR,FW,Sevilla,La Liga,23,1995,1.5,0,0,0,0,0,0,0,,0,0,0,0,2,2,0,0,Matches
1446,Rony Lopes,POR,FW,Monaco,Ligue 1,23,1995,0.9,1,0,0,1,0,0,0,,0,0,0,0,0,1,0,0,Matches
1447,Adrián López,ESP,FW,Osasuna,La Liga,31,1988,16.0,7,5,1,5,1,2,19,10.5,17,6,2,4,4,11,8,0,Matches
1448,David López,ESP,"DF,MF",Espanyol,La Liga,29,1989,27.3,38,20,15,20,3,13,41,31.7,28,28,13,15,35,73,63,3,Matches
1449,Diego López,ESP,GK,Espanyol,La Liga,37,1981,35.9,2,2,2,0,0,1,2,50.0,1,0,0,0,2,4,8,1,Matches
1450,Javi López,ESP,DF,Alavés,La Liga,17,2002,1.0,6,5,4,2,0,4,5,80.0,1,1,1,0,1,7,5,0,Matches
1451,Javi López,ESP,DF,Espanyol,La Liga,33,1986,15.4,47,34,23,18,6,19,40,47.5,21,12,6,6,21,68,38,2,Matches
1452,Lluis López,ESP,DF,Espanyol,La Liga,22,1997,3.3,4,2,3,1,0,2,2,100.0,0,4,0,4,1,5,6,1,Matches
1453,Maxime Lopez,FRA,"MF,FW",Marseille,Ligue 1,21,1997,12.3,16,10,5,8,3,4,26,15.4,22,8,2,6,8,24,1,0,Matches
1454,Pau López,ESP,GK,Roma,Serie A,24,1994,32.0,1,0,1,0,0,1,5,20.0,4,0,0,0,1,2,10,3,Matches
1455,Roberto López,ESP,"FW,MF",Real Sociedad,La Liga,19,2000,0.6,4,2,1,1,2,2,2,100.0,0,0,0,0,0,4,0,0,Matches
1456,Unai López,ESP,MF,Athletic Club,La Liga,23,1995,19.9,30,22,8,18,4,10,41,24.4,31,13,2,11,18,48,12,1,Matches
1457,Iker Losada,ESP,"MF,FW",Celta Vigo,La Liga,17,2001,0.1,0,0,0,0,0,0,0,,0,0,0,0,0,0,0,0,Matches
1458,Albert Lottin,FRA,MF,Bordeaux,Ligue 1,17,2001,0.5,2,0,2,0,0,1,4,25.0,3,0,0,0,2,4,2,0,Matches
1459,Imran Louza,MAR,"MF,FW",Nantes,Ligue 1,20,1999,22.3,53,27,18,27,8,19,46,41.3,27,18,2,16,17,70,7,0,Matches
1460,Matteo Lovato,ITA,DF,Hellas Verona,Serie A,19,2000,0.1,0,0,0,0,0,0,0,,0,0,0,0,0,0,1,0,Matches
1461,Dejan Lovren,CRO,DF,Liverpool,Premier League,30,1989,8.6,13,8,10,3,0,7,12,58.3,5,9,6,3,10,23,42,0,Matches
1462,Eduard Löwen,GER,MF,Augsburg,Bundesliga,22,1997,7.5,10,8,6,2,2,6,18,33.3,12,11,2,9,5,15,7,0,Matches
1463,Eduard Löwen,GER,MF,Hertha BSC,Bundesliga,22,1997,3.5,9,6,3,6,0,5,11,45.5,6,2,1,1,7,16,2,0,Matches
1464,Matthew Lowton,ENG,DF,Burnley,Premier League,30,1989,17.0,41,22,20,18,3,22,33,66.7,11,20,6,14,27,68,57,1,Matches
1465,Hirving Lozano,MEX,"FW,MF",Napoli,Serie A,24,1995,11.4,6,4,1,5,0,2,15,13.3,13,13,0,13,5,11,5,0,Matches
1466,Pol Lozano,ESP,MF,Espanyol,La Liga,19,1999,1.9,5,3,3,2,0,3,7,42.9,4,3,0,3,1,6,2,0,Matches
1467,Jan Luca Rumpf,GER,DF,Paderborn 07,Bundesliga,20,1999,1.0,0,0,0,0,0,0,0,,0,0,0,0,0,0,2,0,Matches
1468,Jean Lucas,BRA,MF,Lyon,Ligue 1,21,1998,2.2,16,7,8,5,3,2,9,22.2,7,2,2,0,2,18,0,0,Matches
1469,Fabio Lucioni,ITA,DF,Lecce,Serie A,31,1987,34.8,29,13,20,9,0,14,32,43.8,18,48,38,10,36,65,169,5,Matches
1470,José Luis Gayà,ESP,DF,Valencia,La Liga,24,1995,22.1,44,30,29,12,3,28,41,68.3,13,22,9,13,18,62,48,1,Matches
1471,José Luis Morales,ESP,"FW,MF",Levante,La Liga,32,1987,28.0,17,8,5,9,3,6,34,17.6,28,14,1,13,6,23,5,1,Matches
1472,José Luis Palomino,ARG,DF,Atalanta,Serie A,29,1990,27.6,81,44,46,33,2,28,54,51.9,26,39,14,25,61,142,74,2,Matches
1473,José Luis Rodríguez,PAN,FW,Alavés,La Liga,21,1998,0.2,0,0,0,0,0,0,2,0.0,2,0,0,0,0,0,0,0,Matches
1474,David Luiz,BRA,DF,Arsenal,Premier League,32,1987,31.2,28,16,14,14,0,13,24,54.2,11,42,37,5,32,60,133,2,Matches
1475,Douglas Luiz,BRA,MF,Aston Villa,Premier League,21,1998,29.0,46,24,25,17,4,19,65,29.2,46,42,15,27,36,82,54,1,Matches
1476,Jordan Lukaku,BEL,DF,Lazio,Serie A,25,1994,4.4,4,2,1,1,2,2,4,50.0,2,2,1,1,0,4,9,0,Matches
1477,Romelu Lukaku,BEL,FW,Inter,Serie A,26,1993,33.1,13,7,4,7,2,3,10,30.0,7,14,6,8,1,14,28,0,Matches
1478,Dodi Lukebakio,BEL,"FW,MF",Hertha BSC,Bundesliga,21,1997,22.6,25,18,13,8,4,10,28,35.7,18,22,4,18,10,35,14,0,Matches
1479,Saša Lukić,SRB,MF,Torino,Serie A,22,1996,20.7,29,17,8,19,2,10,35,28.6,25,21,7,14,29,58,15,0,Matches
1480,Senad Lulić,BIH,DF,Lazio,Serie A,33,1986,17.5,21,13,10,7,4,11,41,26.8,30,20,4,16,21,42,28,1,Matches
1481,John Lundstram,ENG,MF,Sheffield Utd,Premier League,25,1994,27.3,46,30,18,21,7,21,65,32.3,44,18,4,14,33,79,46,1,Matches
1482,Sebastiano Luperto,ITA,DF,Napoli,Serie A,22,1996,5.9,12,9,7,3,2,6,9,66.7,3,5,3,2,6,18,16,0,Matches
1483,Arnaud Lusamba,COD,"MF,FW",Nice,Ligue 1,22,1997,10.9,20,11,8,10,2,7,23,30.4,16,9,0,9,5,25,6,1,Matches
1484,Andreas Luthe,GER,GK,Augsburg,Bundesliga,32,1987,10.0,1,0,1,0,0,1,2,50.0,1,0,0,0,0,1,5,1,Matches
1485,Lyanco,BRA,DF,Torino,Serie A,22,1997,13.1,23,13,9,12,2,7,13,53.8,6,29,19,10,23,46,54,2,Matches
1486,Charalambos Lykogiannis,GRE,DF,Cagliari,Serie A,25,1993,14.9,14,9,9,3,2,7,18,38.9,11,25,9,16,23,37,71,0,Matches
1487,Yann M'Vila,FRA,"MF,DF",Saint-Étienne,Ligue 1,29,1990,21.6,29,14,12,16,1,12,43,27.9,31,14,4,10,40,69,47,1,Matches
1488,Alexis Mac Allister,ARG,"MF,FW",Brighton,Premier League,20,1998,3.9,9,5,4,3,2,5,9,55.6,4,12,0,12,1,10,2,0,Matches
1489,Darwin Machís,VEN,"FW,MF",Granada,La Liga,26,1993,23.7,23,13,11,8,4,8,23,34.8,15,22,4,18,31,54,9,0,Matches
1490,Yvann Macon,FRA,DF,Saint-Étienne,Ligue 1,20,1998,1.1,0,0,0,0,0,0,1,0.0,1,2,0,2,3,3,4,0,Matches
1491,James Maddison,ENG,MF,Leicester City,Premier League,22,1996,29.2,59,30,13,31,15,23,68,33.8,45,16,0,16,9,68,7,1,Matches
1492,Gabriel Magalhães,BRA,DF,Lille,Ligue 1,21,1997,23.2,41,29,27,11,3,15,22,68.2,7,27,18,9,22,63,86,2,Matches
1493,Lisandro Magallán,ARG,DF,Alavés,La Liga,25,1993,13.3,22,15,10,12,0,8,14,57.1,6,17,6,11,16,38,43,1,Matches
1494,Francesco Magnanelli,ITA,MF,Sassuolo,Serie A,34,1984,15.5,25,13,9,12,4,11,35,31.4,24,12,6,6,19,44,23,1,Matches
1495,Giangiacomo Magnani,ITA,DF,Brescia,Serie A,23,1995,1.3,0,0,0,0,0,0,1,0.0,1,2,2,0,2,2,6,0,Matches
1496,Giangiacomo Magnani,ITA,DF,Sassuolo,Serie A,23,1995,1.6,0,0,0,0,0,0,0,,0,2,1,1,2,2,7,0,Matches
1497,Hugo Magnetti,FRA,MF,Brest,Ligue 1,21,1998,2.6,16,10,7,7,2,5,9,55.6,4,4,0,4,7,23,4,0,Matches
1498,Harry Maguire,ENG,DF,Manchester Utd,Premier League,26,1993,38.0,37,23,23,14,0,18,34,52.9,16,31,22,9,72,109,159,0,Matches
1499,Abdallahi Mahmoud,MTN,MF,Alavés,La Liga,19,2000,1.7,4,4,2,1,1,1,6,16.7,5,0,0,0,5,9,2,0,Matches
1500,Riyad Mahrez,ALG,"FW,MF",Manchester City,Premier League,28,1991,21.6,28,14,11,9,8,11,38,28.9,27,31,1,30,18,46,8,2,Matches
1501,Thiago Maia,BRA,MF,Lille,Ligue 1,22,1997,0.5,4,4,1,3,0,0,1,0.0,1,0,0,0,1,5,1,0,Matches
1502,Arne Maier,GER,MF,Hertha BSC,Bundesliga,20,1999,5.9,9,7,6,1,2,1,10,10.0,9,5,0,5,7,16,2,1,Matches
1503,Habib Maïga,CIV,MF,Metz,Ligue 1,23,1996,25.2,84,50,36,38,10,24,64,37.5,40,39,4,35,34,118,39,2,Matches
1504,Mike Maignan,FRA,GK,Lille,Ligue 1,24,1995,28.0,0,0,0,0,0,0,0,,0,0,0,0,2,2,5,0,Matches
1505,Ainsley Maitland-Niles,ENG,DF,Arsenal,Premier League,21,1997,15.4,41,23,34,5,2,22,43,51.2,21,12,3,9,28,69,38,0,Matches
1506,Josh Maja,NGA,FW,Bordeaux,Ligue 1,20,1998,8.2,5,2,0,2,3,1,10,10.0,9,8,4,4,1,6,3,0,Matches
1507,Abdul Majeed Waris,GHA,FW,Strasbourg,Ligue 1,27,1991,4.1,6,4,4,2,0,3,8,37.5,5,2,0,2,4,10,0,0,Matches
1508,Žan Majer,SVN,MF,Lecce,Serie A,27,1992,18.5,39,18,19,12,8,17,56,30.4,39,27,6,21,26,65,18,1,Matches
1509,Jean-Victor Makengo,FRA,MF,Toulouse,Ligue 1,21,1998,11.0,14,11,3,10,1,4,13,30.8,9,7,1,6,3,17,5,1,Matches
1510,Nemanja Maksimović,SRB,MF,Getafe,La Liga,24,1995,32.2,49,28,12,31,6,10,44,22.7,34,37,7,30,56,105,30,1,Matches
1511,Nikola Maksimović,SRB,DF,Napoli,Serie A,27,1991,20.0,35,24,21,14,0,10,21,47.6,11,19,11,8,30,65,64,1,Matches
1512,Kévin Malcuit,MAR,DF,Napoli,Serie A,28,1991,2.8,8,6,4,3,1,5,6,83.3,1,4,1,3,3,11,2,0,Matches
1513,Daniel Maldini,ITA,"FW,MF",Milan,Serie A,17,2001,0.3,0,0,0,0,0,0,2,0.0,2,1,0,1,1,1,0,0,Matches
1514,Ruslan Malinovskyi,UKR,"MF,FW",Atalanta,Serie A,26,1993,17.1,22,14,2,17,3,9,31,29.0,22,13,2,11,5,27,5,0,Matches
1515,Yunus Mallı,TUR,"MF,FW",Union Berlin,Bundesliga,27,1992,7.5,8,3,1,5,2,5,10,50.0,5,2,0,2,7,15,7,0,Matches
1516,Hugo Mallo,ESP,DF,Celta Vigo,La Liga,28,1991,21.8,62,42,44,16,2,27,48,56.3,21,24,8,16,22,84,97,1,Matches
1517,Streli Mamba,GER,FW,Paderborn 07,Bundesliga,25,1994,16.9,15,9,0,9,6,1,13,7.7,12,12,2,10,6,21,2,0,Matches
1518,Hianga Mananga Mbock,FRA,MF,Brest,Ligue 1,19,1999,1.6,1,1,1,0,0,0,0,,0,0,0,0,4,5,0,0,Matches
1519,Vincent Manceau,FRA,DF,Angers,Ligue 1,30,1989,22.0,34,22,18,13,3,16,36,44.4,20,16,3,13,22,56,51,0,Matches
1520,Gianluca Mancini,ITA,"DF,MF",Roma,Serie A,23,1996,30.4,49,26,26,18,5,22,44,50.0,22,32,15,17,60,109,98,1,Matches
1521,Marco Mancosu,ITA,"MF,FW",Lecce,Serie A,30,1988,27.1,32,18,11,16,5,10,46,21.7,36,34,9,25,16,48,15,1,Matches
1522,Steve Mandanda,FRA,GK,Marseille,Ligue 1,34,1985,26.3,3,1,3,0,0,3,4,75.0,1,0,0,0,1,4,2,4,Matches
1523,Reinildo Mandava,MOZ,"DF,MF",Lille,Ligue 1,25,1994,12.3,37,21,23,11,3,25,41,61.0,16,16,1,15,19,56,20,0,Matches
1524,Aïssa Mandi,ALG,DF,Betis,La Liga,27,1991,28.6,33,15,22,8,3,18,28,64.3,10,29,15,14,38,71,93,0,Matches
1525,Rolando Mandragora,ITA,MF,Udinese,Serie A,22,1997,22.8,47,24,15,25,7,15,55,27.3,40,30,5,25,26,73,25,0,Matches
1526,Sadio Mané,SEN,FW,Liverpool,Premier League,27,1992,30.5,44,32,9,20,15,13,40,32.5,27,19,0,19,13,57,11,2,Matches
1527,Eliaquim Mangala,FRA,DF,Valencia,La Liga,28,1991,7.5,4,4,3,1,0,1,2,50.0,1,7,6,1,7,11,40,0,Matches
1528,Thomas Mangani,FRA,MF,Angers,Ligue 1,32,1987,20.8,33,23,15,16,2,14,47,29.8,33,17,2,15,12,45,20,1,Matches
1529,Massimiliano Mangraviti,ITA,DF,Brescia,Serie A,21,1998,10.8,8,6,1,6,1,3,6,50.0,3,11,6,5,8,16,43,0,Matches
1530,Kostas Manolas,GRE,DF,Napoli,Serie A,28,1991,24.2,23,15,13,10,0,10,17,58.8,7,19,14,5,25,48,76,1,Matches
1531,Javier Manquillo,ESP,DF,Newcastle Utd,Premier League,25,1994,17.8,39,26,27,8,4,24,38,63.2,14,14,2,12,18,57,56,0,Matches
1532,Giacomo Manzari,ITA,"FW,MF",Sassuolo,Serie A,18,2000,0.2,0,0,0,0,0,0,0,,0,0,0,0,0,0,0,0,Matches
1533,Myziane Maolida,COM,"FW,MF",Nice,Ligue 1,20,1999,7.5,14,10,5,6,3,5,12,41.7,7,8,0,8,3,17,3,0,Matches
1534,Faitout Maouassa,FRA,DF,Rennes,Ligue 1,21,1998,20.0,51,33,27,20,4,14,26,53.8,12,13,5,8,23,74,59,0,Matches
1535,Fernando Marçal,BRA,DF,Lyon,Ligue 1,30,1989,9.2,28,18,18,7,3,13,26,50.0,13,7,3,4,26,54,32,0,Matches
1536,Marcelo,BRA,DF,Real Madrid,La Liga,31,1988,14.4,19,11,8,8,3,9,28,32.1,19,19,2,17,18,37,21,0,Matches
1537,Marcelo,BRA,DF,Lyon,Ligue 1,32,1987,16.7,27,18,18,8,1,16,23,69.6,7,12,11,1,22,49,77,0,Matches
1538,Solly March,ENG,"FW,MF",Brighton,Premier League,25,1994,12.7,25,12,16,6,3,9,19,47.4,10,16,4,12,20,45,14,2,Matches
1539,Gian Marco Ferrari,ITA,DF,Sassuolo,Serie A,27,1992,21.1,9,5,6,3,0,4,8,50.0,4,25,22,3,26,35,41,1,Matches
1540,Óscar de Marcos,ESP,"DF,FW",Athletic Club,La Liga,30,1989,6.0,5,3,2,1,2,3,6,50.0,3,6,0,6,8,13,8,0,Matches
1541,Dario Maresic,AUT,DF,Reims,Ligue 1,19,1999,1.0,0,0,0,0,0,0,0,,0,1,1,0,1,1,6,0,Matches
1542,Miguel Marí,ESP,MF,Eibar,La Liga,22,1997,0.1,0,0,0,0,0,0,0,,0,0,0,0,0,0,0,0,Matches
1543,Pablo Marí,ESP,DF,Arsenal,Premier League,25,1993,1.3,2,1,2,0,0,0,0,,0,0,0,0,1,3,10,0,Matches
1544,José María Giménez,URU,DF,Atlético Madrid,La Liga,24,1995,19.5,20,16,18,1,1,7,11,63.6,4,14,7,7,23,43,75,1,Matches
1545,Mariano,DOM,"FW,MF",Real Madrid,La Liga,25,1993,0.5,0,0,0,0,0,0,1,0.0,1,0,0,0,0,0,0,0,Matches
1546,Adrian Mariappa,JAM,DF,Watford,Premier League,32,1986,16.8,20,14,15,4,1,11,30,36.7,19,22,7,15,11,31,73,0,Matches
1547,Jordan Marié,FRA,"MF,FW",Dijon,Ligue 1,27,1991,2.2,7,5,4,3,0,4,9,44.4,5,3,1,2,4,11,2,0,Matches
1548,Federico Marigosu,ITA,MF,Cagliari,Serie A,18,2001,0.3,0,0,0,0,0,0,0,,0,0,0,0,0,0,1,0,Matches
1549,Adrián Marín,ESP,DF,Alavés,La Liga,22,1997,9.5,22,15,14,6,2,13,15,86.7,2,13,4,9,13,35,32,0,Matches
1550,Guillermo Maripán,CHI,DF,Alavés,La Liga,25,1994,1.0,1,1,1,0,0,1,2,50.0,1,0,0,0,2,3,10,0,Matches
1551,Guillermo Maripán,CHI,DF,Monaco,Ligue 1,25,1994,19.5,42,26,28,13,1,24,41,58.5,17,30,13,17,25,67,69,2,Matches
1552,Marlon,BRA,DF,Sassuolo,Serie A,23,1995,20.2,40,23,24,15,1,17,27,63.0,10,20,13,7,35,75,69,0,Matches
1553,Omar Marmoush,EGY,"MF,FW",Wolfsburg,Bundesliga,20,1999,0.9,1,1,1,0,0,0,0,,0,1,0,1,1,2,0,0,Matches
1554,Gonzalo Maroni,ARG,"MF,FW",Sampdoria,Serie A,20,1999,2.0,3,1,1,1,1,3,7,42.9,4,1,0,1,3,6,0,0,Matches
1555,Marquinhos,BRA,"MF,DF",Paris S-G,Ligue 1,25,1994,16.4,39,20,17,18,4,11,26,42.3,15,25,8,17,25,64,31,1,Matches
1556,Bruno Martella,ITA,DF,Brescia,Serie A,26,1992,14.1,18,9,14,3,1,9,16,56.3,7,13,7,6,17,35,48,1,Matches
1557,Roger Martí,ESP,FW,Levante,La Liga,28,1991,25.2,18,11,8,7,3,7,29,24.1,22,14,0,14,6,24,17,0,Matches
1558,Anthony Martial,FRA,FW,Manchester Utd,Premier League,23,1995,29.2,15,12,1,4,10,1,16,6.3,15,18,1,17,5,20,17,0,Matches
1559,Aarón Martín,ESP,DF,Mainz 05,Bundesliga,22,1997,19.9,29,15,17,8,4,9,22,40.9,13,11,5,6,30,59,36,0,Matches
1560,Daniel Martín,ESP,GK,Betis,La Liga,21,1998,5.9,0,0,0,0,0,0,0,,0,0,0,0,0,0,3,0,Matches
1561,David Martin,ENG,GK,West Ham,Premier League,33,1986,4.8,0,0,0,0,0,0,0,,0,0,0,0,0,0,1,1,Matches
1562,Jonas Martin,FRA,MF,Rennes,Ligue 1,29,1990,1.3,6,2,4,0,2,1,1,100.0,0,2,2,0,0,6,0,0,Matches
1563,Jonas Martin,FRA,MF,Strasbourg,Ligue 1,29,1990,2.7,5,3,4,0,1,1,3,33.3,2,3,0,3,1,6,3,0,Matches
1564,Josh Martin,ENG,"FW,MF",Norwich City,Premier League,17,2001,0.4,1,0,0,0,1,0,0,,0,1,0,1,1,2,0,0,Matches
1565,Gabriel Martinelli,BRA,FW,Arsenal,Premier League,18,2001,7.4,20,15,10,6,4,7,20,35.0,13,15,1,14,3,23,8,0,Matches
1566,Álex Martínez,ESP,DF,Granada,La Liga,28,1990,0.2,0,0,0,0,0,0,0,,0,0,0,0,0,0,0,0,Matches
1567,Emiliano Martínez,ARG,GK,Arsenal,Premier League,26,1992,8.6,0,0,0,0,0,0,0,,0,0,0,0,0,0,1,0,Matches
1568,Iñigo Martínez,ESP,DF,Athletic Club,La Liga,28,1991,33.0,48,30,33,13,2,27,47,57.4,20,28,13,15,39,87,140,0,Matches
1569,Javi Martínez,ESP,MF,Osasuna,La Liga,19,1999,0.1,0,0,0,0,0,0,0,,0,0,0,0,0,0,1,0,Matches
1570,Javi Martínez,ESP,"DF,MF",Bayern Munich,Bundesliga,30,1988,7.5,16,12,9,7,0,9,11,81.8,2,9,8,1,18,34,30,0,Matches
1571,José Martínez,ESP,DF,Granada,La Liga,26,1993,13.2,21,16,12,8,1,14,25,56.0,11,6,4,2,18,39,46,0,Matches
1572,Lautaro Martínez,ARG,FW,Inter,Serie A,21,1997,27.2,22,7,2,8,12,4,34,11.8,30,30,2,28,15,37,11,0,Matches
1573,Pablo Martínez,ESP,MF,Levante,La Liga,21,1998,0.4,2,0,1,1,0,0,1,0.0,1,0,0,0,0,2,2,0,Matches
1574,Pablo Martinez,FRA,DF,Nîmes,Ligue 1,30,1989,26.0,42,21,26,15,1,21,40,52.5,19,34,22,12,58,100,97,0,Matches
1575,Gelson Martins,POR,"DF,FW",Monaco,Ligue 1,24,1995,18.6,30,22,11,15,4,17,42,40.5,25,9,2,7,19,49,10,1,Matches
1576,Adam Marušić,MNE,DF,Lazio,Serie A,26,1992,10.5,11,6,7,4,0,4,11,36.4,7,14,2,12,14,25,16,0,Matches
1577,Omar Mascarell,EQG,MF,Schalke 04,Bundesliga,26,1993,22.5,42,23,17,22,3,21,57,36.8,36,46,14,32,62,104,40,0,Matches
1578,Andrea Masiello,ITA,DF,Genoa,Serie A,33,1986,14.7,26,15,17,8,1,16,32,50.0,16,8,2,6,26,52,55,2,Matches
1579,Andrea Masiello,ITA,DF,Atalanta,Serie A,33,1986,6.0,11,4,6,4,1,7,14,50.0,7,6,4,2,10,21,13,0,Matches
1580,Adam Masina,MAR,DF,Watford,Premier League,25,1994,20.2,38,22,24,11,3,14,37,37.8,23,26,12,14,28,66,66,0,Matches
1581,Jordi Masip,ESP,GK,Valladolid,La Liga,30,1989,35.0,1,1,1,0,0,0,2,0.0,2,0,0,0,1,2,7,3,Matches
1582,Arthur Masuaku,COD,DF,West Ham,Premier League,25,1993,10.4,41,23,24,13,4,23,39,59.0,16,19,5,14,14,55,23,0,Matches
1583,Jaime Mata,ESP,FW,Getafe,La Liga,30,1988,30.5,21,13,3,11,7,3,20,15.0,17,16,1,15,7,28,15,0,Matches
1584,Juan Mata,ESP,"MF,FW",Manchester Utd,Premier League,31,1988,8.4,7,3,1,5,1,2,7,28.6,5,5,1,4,0,7,2,0,Matches
1585,Aleš Matějů,CZE,DF,Brescia,Serie A,23,1996,28.3,48,27,33,9,6,23,45,51.1,22,41,24,17,37,85,109,3,Matches
1586,Jean-Philippe Mateta,FRA,FW,Mainz 05,Bundesliga,22,1997,11.7,2,2,0,2,0,0,6,0.0,6,3,2,1,1,3,11,0,Matches
1587,Nemanja Matić,SRB,MF,Manchester Utd,Premier League,30,1988,17.6,46,24,23,19,4,20,43,46.5,23,21,8,13,22,68,28,1,Matches
1588,Joël Matip,CMR,DF,Liverpool,Premier League,27,1991,7.8,13,9,4,7,2,4,11,36.4,7,8,4,4,12,25,38,0,Matches
1589,Rabbi Matondo,WAL,"FW,MF",Schalke 04,Bundesliga,18,2000,12.9,10,3,3,2,5,3,13,23.1,10,4,0,4,5,15,1,0,Matches
1590,Alessandro Matri,ITA,"FW,MF",Brescia,Serie A,34,1984,1.0,1,0,0,0,1,0,0,,0,1,0,1,0,1,1,0,Matches
1591,Federico Mattiello,ITA,DF,Cagliari,Serie A,24,1995,10.3,30,21,19,7,4,11,27,40.7,16,20,7,13,18,48,22,0,Matches
1592,Blaise Matuidi,FRA,MF,Juventus,Serie A,32,1987,24.9,48,27,13,27,8,13,34,38.2,21,35,6,29,22,70,16,0,Matches
1593,Neal Maupay,FRA,FW,Brighton,Premier League,22,1996,30.7,20,12,1,13,6,9,29,31.0,20,24,0,24,4,24,10,0,Matches
1594,Stephy Mavididi,ENG,"FW,MF",Dijon,Ligue 1,21,1998,15.5,18,11,7,8,3,10,26,38.5,16,11,0,11,7,25,5,0,Matches
1595,Philipp Max,GER,DF,Augsburg,Bundesliga,25,1993,30.1,42,29,22,16,4,20,45,44.4,25,19,4,15,26,68,50,0,Matches
1596,Alexandru Maxim,ROU,"MF,DF",Mainz 05,Bundesliga,29,1990,1.3,4,2,1,2,1,1,3,33.3,2,0,0,0,1,5,1,0,Matches
1597,Eric Maxim Choupo-Moting,CMR,"FW,MF",Paris S-G,Ligue 1,30,1989,5.0,12,9,3,4,5,4,8,50.0,4,3,0,3,1,13,3,0,Matches
1598,Kévin Mayi,GAB,"FW,MF",Brest,Ligue 1,26,1993,0.0,0,0,0,0,0,0,0,,0,0,0,0,0,0,0,0,Matches
1599,Borja Mayoral,ESP,FW,Levante,La Liga,22,1997,23.8,12,3,4,6,2,2,13,15.4,11,11,0,11,4,16,6,0,Matches
1600,Luca Mazzitelli,ITA,MF,Sassuolo,Serie A,23,1995,0.1,1,1,0,1,0,1,1,100.0,0,0,0,0,0,1,0,0,Matches
1601,Kevin Mbabu,SUI,DF,Wolfsburg,Bundesliga,24,1995,18.8,69,48,39,24,6,35,54,64.8,19,33,10,23,23,92,53,0,Matches
1602,Kylian Mbappé,FRA,FW,Paris S-G,Ligue 1,20,1998,16.8,7,2,1,5,1,3,10,30.0,7,4,0,4,3,10,0,0,Matches
1603,Ibrahima Mbaye,SEN,DF,Bologna,Serie A,24,1994,16.7,19,10,13,4,2,7,17,41.2,10,22,11,11,15,34,42,0,Matches
1604,Loïc Mbe Soh,FRA,DF,Paris S-G,Ligue 1,18,2001,0.6,2,2,2,0,0,2,2,100.0,0,0,0,0,1,3,0,0,Matches
1605,Isaac Mbenza,BEL,FW,Amiens,Ligue 1,23,1996,0.9,0,0,0,0,0,0,1,0.0,1,0,0,0,0,0,0,0,Matches
1606,Nathanael Mbuku,FRA,"FW,MF",Reims,Ligue 1,17,2002,4.4,4,2,2,2,0,0,3,0.0,3,0,0,0,2,6,1,0,Matches
1607,James McArthur,SCO,MF,Crystal Palace,Premier League,31,1987,34.3,88,51,43,34,11,37,106,34.9,69,69,19,50,60,148,56,0,Matches
1608,Oliver McBurnie,SCO,FW,Sheffield Utd,Premier League,23,1996,23.5,37,22,6,27,4,11,40,27.5,29,25,3,22,15,52,43,0,Matches
1609,Alex McCarthy,ENG,GK,Southampton,Premier League,29,1989,28.0,1,1,1,0,0,1,1,100.0,0,1,0,1,0,1,11,3,Matches
1610,James McCarthy,IRL,MF,Crystal Palace,Premier League,28,1990,18.7,82,47,36,36,10,40,76,52.6,36,24,5,19,24,106,11,0,Matches
1611,John McGinn,SCO,MF,Aston Villa,Premier League,24,1994,25.7,53,35,19,23,11,18,62,29.0,44,25,1,24,25,78,18,0,Matches
1612,David McGoldrick,IRL,FW,Sheffield Utd,Premier League,31,1987,20.2,41,26,9,24,8,5,20,25.0,15,14,2,12,3,44,23,0,Matches
1613,Michael McGovern,NIR,GK,Norwich City,Premier League,35,1984,1.8,0,0,0,0,0,0,0,,0,0,0,0,0,0,1,1,Matches
1614,Weston McKennie,USA,"MF,DF",Schalke 04,Bundesliga,20,1998,23.0,38,20,17,16,5,13,40,32.5,27,38,12,26,46,84,39,0,Matches
1615,Kenny McLean,SCO,MF,Norwich City,Premier League,27,1992,33.0,44,29,20,18,6,14,42,33.3,28,32,7,25,38,82,67,2,Matches
1616,Dwight McNeil,ENG,MF,Burnley,Premier League,19,1999,37.1,47,33,18,22,7,23,71,32.4,48,60,8,52,30,77,34,0,Matches
1617,Scott McTominay,SCO,MF,Manchester Utd,Premier League,22,1996,19.7,43,22,14,25,4,17,32,53.1,15,25,5,20,31,74,34,2,Matches
1618,Biagio Meccariello,ITA,DF,Lecce,Serie A,28,1991,8.5,23,13,15,6,2,12,29,41.4,17,14,2,12,10,33,25,0,Matches
1619,Gary Medel,CHI,MF,Bologna,Serie A,31,1987,19.8,43,22,15,24,4,16,43,37.2,27,24,8,16,34,77,31,2,Matches
1620,Ben Mee,ENG,DF,Burnley,Premier League,29,1989,32.0,41,22,25,16,0,17,29,58.6,12,42,31,11,42,83,165,2,Matches
1621,Joshua Mees,GER,"MF,FW",Union Berlin,Bundesliga,23,1996,3.6,8,5,3,4,1,4,12,33.3,8,3,0,3,2,10,4,0,Matches
1622,Admir Mehmedi,SUI,"MF,FW",Wolfsburg,Bundesliga,28,1991,13.3,14,6,2,9,3,4,15,26.7,11,10,0,10,5,19,4,0,Matches
1623,Soualiho Meïté,FRA,MF,Torino,Serie A,25,1994,24.5,32,18,14,13,5,12,35,34.3,23,31,6,25,24,56,36,0,Matches
1624,Farid El Melali,ALG,"MF,FW",Angers,Ligue 1,22,1997,3.4,7,5,2,2,3,4,14,28.6,10,5,0,5,2,9,4,0,Matches
1625,Óscar Melendo,ESP,"MF,FW",Espanyol,La Liga,21,1997,12.4,10,4,4,4,2,4,12,33.3,8,7,2,5,2,12,3,0,Matches
1626,Gonzalo Melero,ESP,MF,Levante,La Liga,25,1994,13.7,20,13,9,9,2,7,27,25.9,20,12,3,9,9,29,15,1,Matches
1627,Arthur Melo,BRA,MF,Barcelona,La Liga,22,1996,13.1,15,10,4,7,4,4,12,33.3,8,9,0,9,4,19,5,2,Matches
1628,Memphis,NED,"FW,MF",Lyon,Ligue 1,25,1994,11.3,4,3,2,0,2,0,5,0.0,5,0,0,0,2,6,2,0,Matches
1629,Pedro Mendes,POR,DF,Montpellier,Ligue 1,28,1990,15.3,28,17,15,13,0,15,24,62.5,9,19,12,7,28,56,42,1,Matches
1630,Thiago Mendes,BRA,MF,Lyon,Ligue 1,27,1992,20.1,43,29,20,19,4,21,45,46.7,24,21,7,14,46,89,36,0,Matches
1631,Brais Méndez,ESP,"MF,FW",Celta Vigo,La Liga,22,1997,16.4,26,11,14,9,3,12,39,30.8,27,20,0,20,12,38,23,1,Matches
1632,Édgar Méndez,ESP,"MF,FW",Alavés,La Liga,29,1990,9.6,11,7,4,6,1,5,13,38.5,8,10,2,8,5,16,7,0,Matches
1633,Stiven Mendoza,COL,"FW,MF",Amiens,Ligue 1,27,1992,12.2,12,7,4,5,3,4,22,18.2,18,13,2,11,9,21,3,1,Matches
1634,Alexandre Mendy,GNB,FW,Brest,Ligue 1,25,1994,10.0,5,1,1,0,4,1,4,25.0,3,4,1,3,0,5,10,0,Matches
1635,Benjamin Mendy,FRA,DF,Manchester City,Premier League,25,1994,16.6,18,15,7,7,4,9,27,33.3,18,10,2,8,16,34,21,3,Matches
1636,Edouard Mendy,SEN,GK,Rennes,Ligue 1,27,1992,24.0,0,0,0,0,0,0,0,,0,0,0,0,0,0,5,1,Matches
1637,Ferland Mendy,FRA,DF,Real Madrid,La Liga,24,1995,20.1,32,26,20,9,3,14,18,77.8,4,19,5,14,22,54,30,1,Matches
1638,Nampalys Mendy,SEN,MF,Leicester City,Premier League,27,1992,3.2,7,5,4,1,2,4,5,80.0,1,4,1,3,6,13,6,0,Matches
1639,Hamza Mendyl,MAR,DF,Dijon,Ligue 1,21,1997,16.0,49,32,31,14,4,29,46,63.0,17,16,4,12,23,72,47,0,Matches
1640,Chris Mepham,WAL,DF,Bournemouth,Premier League,21,1997,10.1,20,9,13,7,0,11,14,78.6,3,17,11,6,17,37,62,1,Matches
1641,Levent Mercan,GER,"MF,FW",Schalke 04,Bundesliga,18,2000,0.8,0,0,0,0,0,0,0,,0,0,0,0,0,0,2,1,Matches
1642,Jorge Meré,ESP,DF,Köln,Bundesliga,22,1997,6.9,6,5,2,4,0,1,2,50.0,1,13,11,2,14,20,30,0,Matches
1643,Alex Meret,ITA,GK,Napoli,Serie A,22,1997,21.7,0,0,0,0,0,0,2,0.0,2,1,0,1,1,1,7,2,Matches
1644,Fran Mérida,ESP,MF,Osasuna,La Liga,29,1990,12.9,27,15,11,10,6,9,27,33.3,18,15,4,11,25,52,10,0,Matches
1645,Mikel Merino,ESP,MF,Real Sociedad,La Liga,23,1996,34.9,79,52,20,44,15,28,86,32.6,58,46,8,38,51,130,52,0,Matches
1646,Sabin Merino,ESP,FW,Leganés,La Liga,27,1992,0.9,0,0,0,0,0,0,0,,0,0,0,0,0,0,0,0,Matches
1647,Yıldırım Mert Çetin,TUR,DF,Roma,Serie A,22,1997,2.9,5,1,4,1,0,3,5,60.0,2,4,3,1,4,9,8,1,Matches
1648,Dries Mertens,BEL,FW,Napoli,Serie A,32,1987,18.8,13,9,1,8,4,2,27,7.4,25,10,1,9,7,20,4,0,Matches
1649,Roque Mesa,ESP,MF,Leganés,La Liga,30,1989,22.4,40,21,17,18,5,13,44,29.5,31,13,4,9,11,51,8,0,Matches
1650,Lionel Messi,ARG,FW,Barcelona,La Liga,32,1987,32.0,21,10,4,7,10,3,21,14.3,18,9,0,9,7,28,1,0,Matches
1651,Thomas Meunier,BEL,DF,Paris S-G,Ligue 1,27,1991,13.8,27,21,9,12,6,16,26,61.5,10,17,5,12,18,45,19,1,Matches
1652,Mexer,MOZ,DF,Bordeaux,Ligue 1,30,1988,16.5,16,11,14,1,1,10,30,33.3,20,14,13,1,15,31,47,0,Matches
1653,Max Meyer,GER,"MF,FW",Crystal Palace,Premier League,23,1995,7.3,19,11,10,9,0,8,18,44.4,10,6,1,5,7,26,4,0,Matches
1654,Kingsley Michael,NGA,MF,Bologna,Serie A,19,1999,0.8,2,1,0,2,0,0,0,,0,0,0,0,1,3,1,0,Matches
1655,Míchel,ESP,MF,Valladolid,La Liga,31,1988,24.2,50,28,26,19,5,22,75,29.3,53,22,4,18,33,83,41,1,Matches
1656,Sven Michel,GER,FW,Paderborn 07,Bundesliga,29,1990,15.3,14,12,3,5,6,3,20,15.0,17,13,2,11,7,21,7,0,Matches
1657,Miguel,ESP,FW,Valladolid,La Liga,19,1999,2.6,2,1,1,0,1,1,2,50.0,1,3,1,2,0,2,1,0,Matches
1658,Florian Miguel,FRA,DF,Nîmes,Ligue 1,22,1996,22.8,51,25,27,20,4,31,52,59.6,21,19,4,15,33,84,32,0,Matches
1659,Georges Mikautadze,GEO,FW,Metz,Ligue 1,18,2000,0.1,1,0,0,0,1,0,0,,0,0,0,0,0,1,0,0,Matches
1660,Nikola Milenković,SRB,DF,Fiorentina,Serie A,21,1997,36.2,46,25,30,16,0,11,31,35.5,20,39,21,18,29,75,129,1,Matches
1661,Arkadiusz Milik,POL,FW,Napoli,Serie A,25,1994,19.4,12,5,4,1,7,3,11,27.3,8,11,1,10,2,14,12,0,Matches
1662,Sergej Milinković-Savić,SRB,MF,Lazio,Serie A,24,1995,33.7,60,35,25,24,11,15,79,19.0,64,67,16,51,37,97,60,1,Matches
1663,Éder Militão,BRA,DF,Real Madrid,La Liga,21,1998,11.4,25,15,15,9,1,10,17,58.8,7,12,6,6,20,45,42,0,Matches
1664,Luka Milivojević,SRB,MF,Crystal Palace,Premier League,28,1991,27.9,61,32,32,25,4,35,84,41.7,49,30,7,23,42,103,39,4,Matches
1665,Vincenzo Millico,ITA,"MF,FW",Torino,Serie A,18,2000,2.4,1,0,1,0,0,1,3,33.3,2,2,0,2,0,1,1,0,Matches
1666,James Milner,ENG,"MF,DF",Liverpool,Premier League,33,1986,10.4,16,10,3,10,3,6,26,23.1,20,12,3,9,7,23,17,1,Matches
1667,Santi Mina,ESP,"FW,MF",Celta Vigo,La Liga,23,1995,21.6,13,8,8,5,0,5,38,13.2,33,19,2,17,10,23,27,0,Matches
1668,Yerry Mina,COL,DF,Everton,Premier League,24,1994,25.4,39,22,25,12,2,18,24,75.0,6,20,14,6,28,67,102,1,Matches
1669,Takumi Minamino,JPN,"FW,MF",Liverpool,Premier League,24,1995,2.8,3,3,0,2,1,2,10,20.0,8,3,0,3,0,3,3,0,Matches
1670,Tyrone Mings,ENG,DF,Aston Villa,Premier League,26,1993,32.2,15,11,11,3,1,10,13,76.9,3,56,48,8,30,45,190,4,Matches
1671,Jorge Miramón,ESP,DF,Levante,La Liga,30,1989,27.0,52,27,35,13,4,26,45,57.8,19,30,8,22,46,98,61,1,Matches
1672,Juan Miranda,ESP,DF,Schalke 04,Bundesliga,19,2000,8.7,14,10,8,6,0,6,18,33.3,12,12,4,8,10,24,27,1,Matches
1673,Antonio Mirante,ITA,GK,Roma,Serie A,36,1983,5.0,0,0,0,0,0,0,1,0.0,1,0,0,0,0,0,2,1,Matches
1674,Simone Missiroli,ITA,MF,SPAL,Serie A,33,1986,31.1,42,27,18,20,4,13,43,30.2,30,42,27,15,54,96,62,1,Matches
1675,Tyrick Mitchell,ENG,DF,Crystal Palace,Premier League,19,1999,2.2,5,2,2,2,1,1,7,14.3,6,2,0,2,2,7,3,0,Matches
1676,Stefan Mitrović,SRB,DF,Strasbourg,Ligue 1,29,1990,22.8,15,9,10,5,0,6,14,42.9,8,14,9,5,23,38,90,3,Matches
1677,Maximilian Mittelstädt,GER,"DF,FW",Hertha BSC,Bundesliga,22,1997,21.0,61,38,31,25,5,26,54,48.1,28,38,6,32,53,114,64,0,Matches
1678,Henrikh Mkhitaryan,ARM,FW,Arsenal,Premier League,30,1989,1.2,0,0,0,0,0,0,2,0.0,2,3,0,3,0,0,1,0,Matches
1679,Henrikh Mkhitaryan,ARM,"MF,FW",Roma,Serie A,30,1989,17.0,32,22,10,17,5,19,45,42.2,26,27,3,24,11,43,6,0,Matches
1680,Anthony Modeste,FRA,FW,Köln,Bundesliga,31,1988,12.6,10,5,1,5,4,1,10,10.0,9,5,3,2,0,10,19,0,Matches
1681,Luka Modrić,CRO,MF,Real Madrid,La Liga,33,1985,22.2,37,18,9,15,13,16,41,39.0,25,10,2,8,22,59,12,0,Matches
1682,Kevin Möhwald,GER,MF,Werder Bremen,Bundesliga,26,1993,0.8,2,1,1,1,0,1,2,50.0,1,0,0,0,0,2,1,0,Matches
1683,Niklas Moisander,FIN,DF,Werder Bremen,Bundesliga,33,1985,22.0,27,15,19,6,2,11,26,42.3,15,37,19,18,49,76,85,0,Matches
1684,Jorge Molina,ESP,FW,Getafe,La Liga,37,1982,21.0,8,2,0,4,4,0,12,0.0,12,13,2,11,4,12,18,0,Matches
1685,Florent Mollet,FRA,"MF,FW",Montpellier,Ligue 1,27,1991,18.7,13,11,3,8,2,7,28,25.0,21,9,1,8,9,22,2,0,Matches
1686,Jon Moncayola,ESP,"MF,DF",Osasuna,La Liga,21,1998,16.6,52,30,26,22,4,27,54,50.0,27,29,5,24,16,68,23,1,Matches
1687,Gabriele Moncini,ITA,"FW,MF",SPAL,Serie A,23,1996,1.7,1,0,0,1,0,0,0,,0,2,1,1,1,2,0,0,Matches
1688,Thomas Monconduit,FRA,MF,Amiens,Ligue 1,28,1991,15.2,26,12,6,18,2,9,26,34.6,17,11,4,7,10,36,25,3,Matches
1689,Nacho Monreal,ESP,DF,Arsenal,Premier League,33,1986,3.0,1,1,1,0,0,1,3,33.3,2,3,1,2,3,4,10,0,Matches
1690,Nacho Monreal,ESP,DF,Real Sociedad,La Liga,33,1986,26.6,38,16,26,9,3,22,42,52.4,20,20,4,16,43,81,66,0,Matches
1691,Joan Monterde,ESP,MF,Levante,La Liga,21,1997,0.1,0,0,0,0,0,0,0,,0,0,0,0,0,0,0,0,Matches
1692,Ilario Monterisi,ITA,DF,Lecce,Serie A,17,2001,0.0,0,0,0,0,0,0,0,,0,0,0,0,0,0,0,0,Matches
1693,Ángel Montoro,ESP,MF,Granada,La Liga,31,1988,10.8,19,8,8,9,2,3,13,23.1,10,10,1,9,13,32,15,0,Matches
1694,Martín Montoya,ESP,"DF,MF",Brighton,Premier League,28,1991,21.1,57,29,31,20,6,30,56,53.6,26,19,5,14,24,81,40,0,Matches
1695,Simon Moore,ENG,GK,Sheffield Utd,Premier League,29,1990,2.0,1,0,1,0,0,1,1,100.0,0,0,0,0,0,1,0,1,Matches
1696,Aaron Mooy,AUS,"MF,FW",Brighton,Premier League,28,1990,23.2,37,24,9,18,10,6,40,15.0,34,36,7,29,23,60,32,1,Matches
1697,Wesley Moraes,BRA,FW,Aston Villa,Premier League,22,1996,19.8,15,8,3,8,4,0,5,0.0,5,10,2,8,4,19,23,0,Matches
1698,Alfredo Morales,USA,MF,Düsseldorf,Bundesliga,29,1990,19.2,31,15,11,16,4,11,35,31.4,24,17,6,11,18,49,37,0,Matches
1699,Álvaro Morata,ESP,FW,Atlético Madrid,La Liga,26,1992,23.3,17,8,4,9,4,1,13,7.7,12,12,2,10,5,22,23,0,Matches
1700,Jan Morávek,CZE,MF,Augsburg,Bundesliga,29,1989,5.3,23,12,9,14,0,11,24,45.8,13,4,1,3,8,31,11,0,Matches
1701,Steven Moreira,CPV,DF,Toulouse,Ligue 1,24,1994,15.4,37,25,21,15,1,19,31,61.3,12,16,3,13,16,53,29,0,Matches
1702,Jérémy Morel,MAD,DF,Rennes,Ligue 1,35,1984,20.1,15,9,13,1,1,9,20,45.0,11,21,17,4,17,32,59,1,Matches
1703,Alberto Moreno,ESP,DF,Villarreal,La Liga,27,1992,16.3,27,16,15,11,1,9,25,36.0,16,15,3,12,25,52,36,0,Matches
1704,Álex Moreno,ESP,DF,Betis,La Liga,26,1993,25.2,37,20,27,8,2,12,32,37.5,20,21,8,13,23,60,47,1,Matches
1705,Gerard Moreno,ESP,"FW,MF",Villarreal,La Liga,27,1992,30.5,19,8,4,10,5,5,46,10.9,41,19,3,16,10,29,51,0,Matches
1706,Mateu Morey,ESP,"DF,MF",Dortmund,Bundesliga,19,2000,2.2,7,3,2,4,1,4,10,40.0,6,4,0,4,5,12,3,0,Matches
1707,Wes Morgan,JAM,DF,Leicester City,Premier League,35,1984,4.8,4,1,3,1,0,0,3,0.0,3,5,3,2,7,11,19,0,Matches
1708,Manu Morlanes,ESP,MF,Villarreal,La Liga,20,1999,2.8,7,3,3,4,0,2,9,22.2,7,1,1,0,2,9,2,0,Matches
1709,Raúl Moro,ESP,FW,Lazio,Serie A,16,2002,0.0,0,0,0,0,0,0,0,,0,0,0,0,0,0,0,0,Matches
1710,Loren Morón,ESP,FW,Betis,La Liga,25,1993,22.6,18,12,6,7,5,9,23,39.1,14,25,6,19,9,27,13,0,Matches
1711,Leonardo Morosini,ITA,"FW,DF",Brescia,Serie A,23,1995,0.3,1,1,1,0,0,0,0,,0,1,0,1,1,2,1,0,Matches
1712,Ravel Morrison,JAM,MF,Sheffield Utd,Premier League,26,1993,0.1,0,0,0,0,0,0,0,,0,0,0,0,0,0,0,0,Matches
1713,Victor Moses,NGA,DF,Inter,Serie A,28,1990,4.7,4,3,1,2,1,2,8,25.0,6,4,0,4,0,4,4,0,Matches
1714,Lebo Mothiba,RSA,FW,Strasbourg,Ligue 1,23,1996,11.6,4,3,1,1,2,1,6,16.7,5,5,0,5,3,7,1,0,Matches
1715,Harold Moukoudi,CMR,DF,Saint-Étienne,Ligue 1,21,1997,11.0,28,19,20,7,1,11,14,78.6,3,16,10,6,16,44,42,2,Matches
1716,Jessy Moulin,FRA,GK,Saint-Étienne,Ligue 1,33,1986,5.0,0,0,0,0,0,0,0,,0,0,0,0,1,1,2,0,Matches
1717,Mason Mount,ENG,"MF,FW",Chelsea,Premier League,20,1999,31.9,37,17,8,19,10,9,42,21.4,33,25,3,22,16,53,18,0,Matches
1718,Lucas Moura,BRA,"FW,MF",Tottenham,Premier League,26,1992,24.9,57,33,25,22,10,16,58,27.6,42,29,2,27,15,72,27,0,Matches
1719,Lys Mousset,FRA,FW,Sheffield Utd,Premier League,23,1996,13.8,9,5,0,5,4,3,7,42.9,4,3,0,3,4,13,2,0,Matches
1720,Wesley Moustache,FRA,DF,Nantes,Ligue 1,20,1999,0.5,0,0,0,0,0,0,0,,0,1,0,1,0,0,2,0,Matches
1721,João Moutinho,POR,MF,Wolves,Premier League,32,1986,34.5,93,50,43,41,9,46,139,33.1,93,43,13,30,50,143,18,1,Matches
1722,Samuel Moutoussamy,COD,"DF,MF",Nantes,Ligue 1,22,1996,5.8,4,1,2,1,1,2,7,28.6,5,2,0,2,4,8,7,0,Matches
1723,Toni Moya,ESP,MF,Atlético Madrid,La Liga,21,1998,0.0,0,0,0,0,0,0,0,,0,0,0,0,0,0,0,0,Matches
1724,Javi Moyano,ESP,DF,Valladolid,La Liga,33,1986,24.7,19,8,11,8,0,8,20,40.0,12,18,5,13,27,46,63,0,Matches
1725,Nordi Mukiele,FRA,"DF,FW",RB Leipzig,Bundesliga,21,1997,19.8,61,39,39,12,10,25,38,65.8,13,26,4,22,47,108,57,0,Matches
1726,Mert Müldür,TUR,DF,Sassuolo,Serie A,20,1999,14.1,47,27,33,8,6,27,42,64.3,15,10,0,10,22,69,42,0,Matches
1727,Florian Müller,GER,GK,Mainz 05,Bundesliga,21,1997,12.5,0,0,0,0,0,0,0,,0,0,0,0,2,2,3,1,Matches
1728,Thomas Müller,GER,"MF,FW",Bayern Munich,Bundesliga,29,1989,25.1,45,27,7,26,12,22,69,31.9,47,27,3,24,12,57,8,0,Matches
1729,Marshall Munetsi,ZIM,MF,Reims,Ligue 1,23,1996,9.3,27,19,12,12,3,6,12,50.0,6,13,7,6,12,39,20,1,Matches
1730,Iker Muniain,ESP,"FW,MF",Athletic Club,La Liga,26,1992,26.5,26,19,11,10,5,4,24,16.7,20,9,0,9,12,38,7,0,Matches
1731,Aihen Muñoz,ESP,DF,Real Sociedad,La Liga,21,1997,10.9,28,18,13,12,3,18,27,66.7,9,13,2,11,2,30,19,0,Matches
1732,Javier Muñoz,ESP,"FW,MF",Alavés,La Liga,24,1995,0.6,0,0,0,0,0,0,0,,0,1,1,0,0,0,0,0,Matches
1733,Simone Muratore,ITA,MF,Juventus,Serie A,21,1998,1.8,2,0,0,1,1,1,3,33.3,2,1,0,1,3,5,0,0,Matches
1734,Alessandro Murgia,ITA,MF,SPAL,Serie A,22,1996,19.4,27,17,16,8,3,14,34,41.2,20,10,3,7,18,45,15,0,Matches
1735,Luis Muriel,COL,FW,Atalanta,Serie A,28,1991,14.0,15,9,3,8,4,3,14,21.4,11,12,0,12,4,19,0,0,Matches
1736,Jeison Murillo,COL,DF,Sampdoria,Serie A,27,1992,7.4,18,6,14,4,0,10,19,52.6,9,8,4,4,10,28,28,0,Matches
1737,Jeison Murillo,COL,DF,Celta Vigo,La Liga,27,1992,17.0,37,20,30,6,1,18,27,66.7,9,13,9,4,20,57,74,2,Matches
1738,Glenn Murray,ENG,FW,Brighton,Premier League,35,1983,8.9,5,2,0,3,2,2,9,22.2,7,6,2,4,1,6,12,0,Matches
1739,Nicola Murru,ITA,DF,Sampdoria,Serie A,24,1994,25.1,40,22,24,8,8,21,41,51.2,20,22,4,18,27,67,58,0,Matches
1740,Mateo Musacchio,ARG,DF,Milan,Serie A,28,1990,16.3,15,8,11,4,0,7,20,35.0,13,10,7,3,22,37,50,0,Matches
1741,Torben Müsel,GER,FW,Gladbach,Bundesliga,20,1999,0.0,0,0,0,0,0,0,0,,0,0,0,0,1,1,0,0,Matches
1742,Jamal Musiala,GER,MF,Bayern Munich,Bundesliga,16,2003,0.0,0,0,0,0,0,0,0,,0,0,0,0,0,0,0,0,Matches
1743,Juan Musso,ARG,GK,Udinese,Serie A,25,1994,38.0,0,0,0,0,0,0,1,0.0,1,0,0,0,1,1,18,2,Matches
1744,Shkodran Mustafi,GER,DF,Arsenal,Premier League,27,1992,13.4,17,10,11,5,1,6,12,50.0,6,10,6,4,18,35,72,0,Matches
1745,Yoshinori Mutō,JPN,"MF,FW",Newcastle Utd,Premier League,27,1992,2.4,3,2,1,2,0,1,2,50.0,1,0,0,0,0,3,0,0,Matches
1746,Yvon Mvogo,SUI,GK,RB Leipzig,Bundesliga,25,1994,2.0,0,0,0,0,0,0,0,,0,0,0,0,0,0,0,1,Matches
1747,Phillipp Mwene,AUT,DF,Mainz 05,Bundesliga,25,1994,3.5,11,5,9,2,0,7,12,58.3,5,10,1,9,3,14,11,0,Matches
1748,Obite N'Dicka,CIV,DF,Eint Frankfurt,Bundesliga,19,1999,19.1,27,13,13,11,3,15,28,53.6,13,28,6,22,29,56,57,0,Matches
1749,Kévin N'Doram,FRA,MF,Metz,Ligue 1,23,1996,18.3,43,28,19,21,3,17,40,42.5,23,20,8,12,26,69,23,0,Matches
1750,Abdallah N'dour,SEN,DF,Strasbourg,Ligue 1,25,1993,4.1,5,4,2,3,0,5,10,50.0,5,4,1,3,4,9,5,1,Matches
1751,Ferris N'Goma,FRA,"MF,FW",Brest,Ligue 1,26,1993,0.3,0,0,0,0,0,0,0,,0,1,0,1,0,0,0,0,Matches
1752,Nathan N'Goumou,FRA,FW,Toulouse,Ligue 1,19,2000,0.1,0,0,0,0,0,0,0,,0,0,0,0,0,0,1,0,Matches
1753,Georges-Kévin N'Koudou,CMR,FW,Tottenham,Premier League,24,1995,0.0,0,0,0,0,0,0,1,0.0,1,0,0,0,0,0,0,0,Matches
1754,Stanley N'Soki,FRA,DF,Nice,Ligue 1,20,1999,14.1,40,29,24,16,0,23,42,54.8,19,14,6,8,32,72,37,0,Matches
1755,Nacho,ESP,DF,Valladolid,La Liga,30,1989,21.0,43,22,24,15,4,17,48,35.4,31,36,8,28,25,68,61,0,Matches
1756,Nacho,ESP,DF,Real Madrid,La Liga,29,1990,4.9,11,6,6,3,2,6,10,60.0,4,5,3,2,12,23,18,1,Matches
1757,Radja Nainggolan,BEL,MF,Cagliari,Serie A,31,1988,23.0,30,18,9,12,9,9,29,31.0,20,25,6,19,13,43,30,0,Matches
1758,Marvelous Nakamba,ZIM,MF,Aston Villa,Premier League,25,1994,20.4,55,28,28,20,7,24,67,35.8,43,50,11,39,39,94,38,3,Matches
1759,Naldo,BRA,DF,Espanyol,La Liga,30,1988,14.8,24,13,15,9,0,7,15,46.7,8,11,7,4,21,45,50,1,Matches
1760,Nahitan Nández,URU,"MF,DF",Cagliari,Serie A,23,1995,32.2,58,38,37,17,4,25,69,36.2,44,30,1,29,25,83,26,0,Matches
1761,Matija Nastasić,SRB,DF,Schalke 04,Bundesliga,26,1993,15.2,26,16,17,9,0,14,17,82.4,3,28,16,12,22,48,79,0,Matches
1762,Marc Navarro,ESP,"FW,DF",Leganés,La Liga,24,1995,2.4,3,3,2,1,0,1,1,100.0,0,2,1,1,0,3,3,0,Matches
1763,Ximo Navarro,ESP,DF,Alavés,La Liga,29,1990,21.1,34,19,17,15,2,16,28,57.1,12,20,7,13,52,86,76,2,Matches
1764,Jesús Navas,ESP,DF,Sevilla,La Liga,33,1985,37.4,27,15,16,7,4,15,32,46.9,17,20,7,13,31,58,70,0,Matches
1765,Keylor Navas,CRC,GK,Paris S-G,Ligue 1,32,1986,21.0,0,0,0,0,0,0,0,,0,1,0,1,0,0,4,2,Matches
1766,Raúl Navas,ESP,DF,Osasuna,La Liga,31,1988,7.9,10,5,4,6,0,4,13,30.8,9,10,4,6,18,28,30,0,Matches
1767,Michel Ndary Adopo,FRA,"DF,MF",Torino,Serie A,19,2000,0.0,0,0,0,0,0,0,0,,0,1,1,0,0,0,0,0,Matches
1768,Papa Ndiaga Yade,MTN,FW,Metz,Ligue 1,19,2000,0.0,0,0,0,0,0,0,0,,0,0,0,0,0,0,0,0,Matches
1769,Wilfred Ndidi,NGA,MF,Leicester City,Premier League,22,1996,29.7,128,67,56,61,11,45,91,49.5,46,52,6,46,80,208,69,3,Matches
1770,Emanuele Ndoj,ALB,MF,Brescia,Serie A,22,1996,6.2,9,6,2,6,1,3,13,23.1,10,7,0,7,5,14,5,0,Matches
1771,Tanguy Ndombele,FRA,MF,Tottenham,Premier League,22,1996,11.2,24,16,10,13,1,9,22,40.9,13,20,3,17,14,38,7,0,Matches
1772,Reiss Nelson,ENG,FW,Arsenal,Premier League,19,1999,7.0,11,8,5,4,2,7,17,41.2,10,13,2,11,3,14,3,0,Matches
1773,Ilija Nestorovski,MKD,FW,Udinese,Serie A,29,1990,13.9,10,7,5,5,0,6,21,28.6,15,13,2,11,4,14,12,0,Matches
1774,Neto,BRA,GK,Barcelona,La Liga,30,1989,2.0,0,0,0,0,0,0,0,,0,0,0,0,0,0,1,0,Matches
1775,Pedro Neto,POR,"FW,MF",Wolves,Premier League,19,2000,10.4,9,4,3,6,0,4,15,26.7,11,2,0,2,6,15,4,0,Matches
1776,Manuel Neuer,GER,GK,Bayern Munich,Bundesliga,33,1986,33.0,2,1,1,0,1,2,4,50.0,2,0,0,0,0,2,15,4,Matches
1777,Florian Neuhaus,GER,MF,Gladbach,Bundesliga,22,1997,26.2,42,23,13,22,7,12,54,22.2,42,24,4,20,27,69,8,0,Matches
1778,Carlos Neva,ESP,DF,Granada,La Liga,23,1996,24.5,16,11,12,3,1,9,21,42.9,12,15,2,13,28,44,60,0,Matches
1779,Rúben Neves,POR,MF,Wolves,Premier League,22,1997,34.0,62,33,27,32,3,34,86,39.5,52,38,9,29,56,118,34,1,Matches
1780,Neymar,BRA,"MF,FW",Paris S-G,Ligue 1,27,1992,14.6,12,7,1,9,2,3,21,14.3,18,10,0,10,4,16,1,0,Matches
1781,Jeremy Ngakia,ENG,DF,West Ham,Premier League,18,2000,4.9,15,7,10,5,0,9,21,42.9,12,6,1,5,7,22,16,0,Matches
1782,Jessic Ngankam,GER,"FW,MF",Hertha BSC,Bundesliga,19,2000,0.9,2,2,1,1,0,2,2,100.0,0,2,0,2,0,2,1,0,Matches
1783,Muzinga Ngonda,COD,DF,Dijon,Ligue 1,24,1994,6.0,15,6,10,3,2,7,10,70.0,3,5,4,1,11,26,23,0,Matches
1784,Ahmad Ngouyamsa,CMR,DF,Dijon,Ligue 1,18,2000,0.6,1,0,1,0,0,0,3,0.0,3,1,1,0,1,2,5,0,Matches
1785,Opa Nguette,SEN,FW,Metz,Ligue 1,25,1994,20.3,44,28,23,15,6,11,39,28.2,28,17,3,14,12,56,12,0,Matches
1786,Moussa Niakhate,SEN,DF,Mainz 05,Bundesliga,23,1996,33.0,35,22,29,6,0,16,29,55.2,13,40,26,14,40,75,124,4,Matches
1787,Ibrahima Niane,SEN,FW,Metz,Ligue 1,20,1999,10.6,8,7,2,5,1,5,16,31.3,11,5,1,4,10,18,11,1,Matches
1788,M'Baye Niang,SEN,FW,Rennes,Ligue 1,24,1994,23.6,17,10,3,11,3,6,21,28.6,15,10,1,9,5,22,20,0,Matches
1789,Tanguy Nianzou,FRA,"DF,MF",Paris S-G,Ligue 1,17,2002,5.0,2,1,0,1,1,1,3,33.3,2,4,2,2,3,5,6,0,Matches
1790,Cheikh Niasse,SEN,MF,Lille,Ligue 1,19,2000,0.2,0,0,0,0,0,0,0,,0,0,0,0,0,0,0,0,Matches
1791,Oumar Niasse,SEN,FW,Everton,Premier League,29,1990,0.2,4,0,0,2,2,0,0,,0,0,0,0,1,5,0,0,Matches
1792,Moritz Nicolas,GER,GK,Union Berlin,Bundesliga,21,1997,1.0,0,0,0,0,0,0,0,,0,0,0,0,0,0,0,0,Matches
1793,Florian Niederlechner,GER,"FW,MF",Augsburg,Bundesliga,28,1990,30.2,21,13,7,9,5,4,21,19.0,17,21,5,16,8,29,38,0,Matches
1794,Saúl Ñíguez,ESP,"MF,DF",Atlético Madrid,La Liga,24,1994,34.1,95,59,44,42,9,39,88,44.3,49,58,13,45,55,150,68,1,Matches
1795,Casimir Ninga,CHA,"MF,FW",Angers,Ligue 1,26,1993,7.6,5,5,4,0,1,1,5,20.0,4,5,0,5,3,8,2,0,Matches
1796,Fernando Niño,ESP,FW,Villarreal,La Liga,18,2000,0.9,1,0,0,1,0,1,2,50.0,1,0,0,0,0,1,2,0,Matches
1797,Timothée Nkada,FRA,FW,Reims,Ligue 1,20,1999,1.6,1,0,1,0,0,0,1,0.0,1,0,0,0,0,1,1,0,Matches
1798,Eddie Nketiah,ENG,FW,Arsenal,Premier League,20,1999,7.0,7,5,3,4,0,2,6,33.3,4,9,0,9,2,9,5,0,Matches
1799,Nicolas Nkoulou,CMR,DF,Torino,Serie A,29,1990,29.9,34,24,21,11,2,16,22,72.7,6,40,18,22,70,104,138,2,Matches
1800,Christopher Nkunku,FRA,"MF,FW",RB Leipzig,Bundesliga,21,1997,21.4,21,13,4,11,6,9,33,27.3,24,25,2,23,20,41,8,0,Matches
1801,Lukas Nmecha,GER,"MF,FW",Wolfsburg,Bundesliga,20,1998,1.5,0,0,0,0,0,0,0,,0,0,0,0,0,0,0,0,Matches
1802,Mark Noble,ENG,MF,West Ham,Premier League,32,1987,29.7,52,30,19,28,5,22,64,34.4,42,20,6,14,20,72,10,1,Matches
1803,Nolito,ESP,FW,Sevilla,La Liga,32,1986,10.0,21,12,5,11,5,7,20,35.0,13,7,0,7,1,22,1,0,Matches
1804,Nolito,ESP,"MF,FW",Celta Vigo,La Liga,32,1986,3.6,7,5,5,2,0,3,8,37.5,5,4,1,3,1,8,4,0,Matches
1805,Arnaud Nordin,FRA,"FW,MF",Saint-Étienne,Ligue 1,21,1998,10.1,7,3,3,3,1,4,13,30.8,9,11,1,10,4,11,6,0,Matches
1806,Håvard Nordtveit,NOR,DF,Hoffenheim,Bundesliga,29,1990,7.8,4,1,3,1,0,3,7,42.9,4,17,12,5,13,17,45,0,Matches
1807,Oliver Norwood,NIR,MF,Sheffield Utd,Premier League,28,1991,34.3,66,37,35,24,7,28,97,28.9,69,34,12,22,47,113,40,1,Matches
1808,Alexander Nübel,GER,GK,Schalke 04,Bundesliga,22,1996,25.7,0,0,0,0,0,0,0,,0,0,0,0,2,2,9,6,Matches
1809,Kasim Nuhu,GHA,DF,Düsseldorf,Bundesliga,24,1995,11.1,14,7,12,1,1,9,19,47.4,10,16,12,4,25,39,54,0,Matches
1810,Unai Núñez,ESP,DF,Athletic Club,La Liga,22,1997,17.5,13,10,10,2,1,6,16,37.5,10,25,17,8,23,36,71,0,Matches
1811,Bram Nuytinck,NED,DF,Udinese,Serie A,29,1990,24.7,46,32,30,13,3,17,27,63.0,10,50,32,18,27,73,96,1,Matches
1812,Gerzino Nyamsi,FRA,DF,Rennes,Ligue 1,22,1997,1.3,1,0,1,0,0,0,0,,0,1,0,1,1,2,5,0,Matches
1813,Ørjan Nyland,NOR,GK,Aston Villa,Premier League,28,1990,6.0,0,0,0,0,0,0,0,,0,0,0,0,0,0,1,1,Matches
1814,Allan Nyom,CMR,"DF,MF",Getafe,La Liga,31,1988,26.9,45,25,26,15,4,20,37,54.1,17,24,5,19,14,59,50,1,Matches
1815,Steven Nzonzi,FRA,MF,Rennes,Ligue 1,30,1988,4.3,5,4,3,1,1,1,2,50.0,1,2,2,0,4,9,18,0,Matches
1816,Jack O'Connell,ENG,DF,Sheffield Utd,Premier League,25,1994,32.4,23,14,15,6,2,10,20,50.0,10,38,17,21,42,65,154,1,Matches
1817,Michael Obafemi,IRL,FW,Southampton,Premier League,19,2000,7.4,7,3,1,3,3,2,14,14.3,12,3,0,3,6,13,0,0,Matches
1818,Pedro Obiang,EQG,MF,Sassuolo,Serie A,27,1992,18.6,46,31,21,19,6,19,40,47.5,21,24,10,14,21,67,31,1,Matches
1819,Jan Oblak,SVN,GK,Atlético Madrid,La Liga,26,1993,37.7,0,0,0,0,0,0,0,,0,0,0,0,1,1,4,2,Matches
1820,Rafel Obrador,ESP,DF,Mallorca,La Liga,15,2004,0.0,0,0,0,0,0,0,1,0.0,1,0,0,0,0,0,1,0,Matches
1821,Lucas Ocampos,ARG,"FW,MF",Sevilla,La Liga,25,1994,30.5,54,31,30,19,5,30,72,41.7,42,33,2,31,22,76,27,0,Matches
1822,Bastian Oczipka,GER,DF,Schalke 04,Bundesliga,30,1989,33.5,72,50,42,21,9,36,62,58.1,26,35,6,29,37,109,68,0,Matches
1823,Álvaro Odriozola,ESP,DF,Real Madrid,La Liga,23,1995,3.8,5,2,4,0,1,5,8,62.5,3,4,0,4,2,7,8,0,Matches
1824,Álvaro Odriozola,ESP,DF,Bayern Munich,Bundesliga,23,1995,1.7,2,2,1,0,1,2,3,66.7,1,1,0,1,1,3,2,0,Matches
1825,Kelvin Ofori,GHA,MF,Düsseldorf,Bundesliga,18,2001,0.4,0,0,0,0,0,0,0,,0,0,0,0,0,0,0,0,Matches
1826,Angelo Ogbonna,ITA,DF,West Ham,Premier League,31,1988,31.0,38,24,20,14,4,18,32,56.3,14,50,32,18,27,65,134,1,Matches
1827,Stefano Okaka,ITA,FW,Udinese,Serie A,29,1989,26.8,19,11,6,8,5,7,27,25.9,20,23,2,21,8,27,28,0,Matches
1828,Kwasi Okyere Wriedt,GHA,FW,Bayern Munich,Bundesliga,25,1994,0.2,0,0,0,0,0,0,0,,0,0,0,0,0,0,0,0,Matches
1829,Lucas Olaza,URU,DF,Celta Vigo,La Liga,25,1994,34.9,56,39,36,17,3,39,59,66.1,20,37,10,27,31,87,60,1,Matches
1830,Oier Olazábal,ESP,GK,Espanyol,La Liga,29,1989,2.0,0,0,0,0,0,0,0,,0,1,0,1,0,0,0,0,Matches
1831,Christian Oliva,URU,MF,Cagliari,Serie A,23,1996,5.2,13,7,9,4,0,5,15,33.3,10,5,0,5,7,20,14,0,Matches
1832,Kiko Olivas,ESP,DF,Valladolid,La Liga,30,1988,32.7,33,16,25,7,1,13,35,37.1,22,30,16,14,61,94,112,2,Matches
1833,Paulo Oliveira,POR,DF,Eibar,La Liga,27,1992,23.2,31,19,22,8,1,18,30,60.0,12,23,13,10,42,73,107,1,Matches
1834,Cauly Oliveira Souza,BRA,"MF,FW",Paderborn 07,Bundesliga,23,1995,8.0,11,7,5,5,1,3,11,27.3,8,9,0,9,6,17,1,0,Matches
1835,Mathías Olivera,URU,DF,Getafe,La Liga,21,1997,20.8,64,40,34,16,14,27,45,60.0,18,32,3,29,23,87,44,0,Matches
1836,Maximiliano Olivera,URU,MF,Fiorentina,Serie A,27,1992,0.1,1,0,1,0,0,0,0,,0,0,0,0,0,1,0,0,Matches
1837,Marco Olivieri,ITA,FW,Juventus,Serie A,20,1999,0.3,1,1,1,0,0,1,2,50.0,1,0,0,0,0,1,0,0,Matches
1838,Dani Olmo,ESP,"MF,FW",RB Leipzig,Bundesliga,21,1998,8.3,20,14,5,10,5,1,13,7.7,12,7,1,6,4,24,6,0,Matches
1839,Robin Olsen,SWE,GK,Cagliari,Serie A,29,1990,16.9,0,0,0,0,0,0,1,0.0,1,0,0,0,0,0,8,0,Matches
1840,Kenneth Omeruo,NGA,DF,Leganés,La Liga,25,1993,20.8,28,17,25,3,0,11,18,61.1,7,21,12,9,36,64,112,2,Matches
1841,Jean Onana,CMR,MF,Lille,Ligue 1,19,2000,0.9,0,0,0,0,0,0,2,0.0,2,1,0,1,1,1,0,0,Matches
1842,Karim Onisiwo,AUT,FW,Mainz 05,Bundesliga,27,1992,19.2,27,19,6,10,11,5,13,38.5,8,20,3,17,7,34,11,0,Matches
1843,Javier Ontiveros,ESP,"FW,MF",Villarreal,La Liga,21,1997,9.9,29,14,13,14,2,8,35,22.9,27,13,1,12,5,34,7,0,Matches
1844,Henry Onyekuru,NGA,"MF,FW",Monaco,Ligue 1,22,1997,1.8,1,1,1,0,0,0,0,,0,1,0,1,1,2,0,0,Matches
1845,Nicholas Opoku,GHA,DF,Udinese,Serie A,21,1997,5.3,13,8,8,3,2,6,11,54.5,5,6,4,2,4,17,19,0,Matches
1846,Nicholas Opoku,GHA,DF,Amiens,Ligue 1,21,1997,7.0,7,5,6,1,0,7,14,50.0,7,6,2,4,7,14,32,0,Matches
1847,Willi Orban,HUN,DF,RB Leipzig,Bundesliga,26,1992,9.5,20,12,13,7,0,12,20,60.0,8,14,3,11,16,36,52,1,Matches
1848,Fabián Orellana,CHI,"MF,FW",Eibar,La Liga,33,1986,26.6,29,18,10,6,13,14,52,26.9,38,9,0,9,20,49,2,0,Matches
1849,Divock Origi,BEL,FW,Liverpool,Premier League,24,1995,8.0,12,9,2,5,5,4,9,44.4,5,2,0,2,4,16,5,0,Matches
1850,Aimar Oroz,ESP,FW,Osasuna,La Liga,17,2001,0.1,0,0,0,0,0,0,0,,0,1,0,1,0,0,0,0,Matches
1851,Riccardo Orsolini,ITA,"FW,MF",Bologna,Serie A,22,1997,29.8,36,22,21,10,5,12,47,25.5,35,23,1,22,16,52,20,0,Matches
1852,Yuya Osako,JPN,"FW,MF",Werder Bremen,Bundesliga,29,1990,20.5,29,16,5,19,5,3,29,10.3,26,10,1,9,6,35,13,1,Matches
1853,Ben Osborn,ENG,"MF,DF",Sheffield Utd,Premier League,24,1994,6.6,15,10,11,3,1,3,16,18.8,13,6,1,5,6,21,7,0,Matches
1854,Victor Osimhen,NGA,FW,Lille,Ligue 1,20,1998,25.4,8,4,1,0,7,1,11,9.1,10,8,0,8,11,19,32,0,Matches
1855,David Ospina,COL,GK,Napoli,Serie A,30,1988,16.3,0,0,0,0,0,0,0,,0,0,0,0,0,0,2,1,Matches
1856,Nicolás Otamendi,ARG,DF,Manchester City,Premier League,31,1988,19.1,28,14,21,6,1,16,33,48.5,17,15,9,6,21,49,76,2,Matches
1857,Otávio,BRA,MF,Bordeaux,Ligue 1,25,1994,24.6,80,45,23,52,5,35,82,42.7,47,26,9,17,41,121,40,6,Matches
1858,Paulo Otávio,BRA,DF,Wolfsburg,Bundesliga,24,1994,4.2,21,16,11,9,1,10,13,76.9,3,12,2,10,9,30,11,0,Matches
1859,Abou Ouattara,BFA,FW,Lille,Ligue 1,19,1999,0.1,0,0,0,0,0,0,0,,0,0,0,0,0,0,1,0,Matches
1860,Remi Oudin,FRA,"FW,MF",Bordeaux,Ligue 1,22,1996,6.2,9,6,4,4,1,4,14,28.6,10,7,1,6,9,18,5,0,Matches
1861,Remi Oudin,FRA,"FW,MF",Reims,Ligue 1,22,1996,15.5,15,7,8,5,2,6,19,31.6,13,16,1,15,18,33,18,1,Matches
1862,Alexandre Oukidja,ALG,GK,Metz,Ligue 1,31,1988,26.5,0,0,0,0,0,0,1,0.0,1,1,0,1,0,0,15,1,Matches
1863,Zinédine Ould Khaled,FRA,MF,Angers,Ligue 1,19,2000,0.7,2,1,0,2,0,2,4,50.0,2,0,0,0,4,6,0,0,Matches
1864,Adam Ounas,ALG,"FW,MF",Nice,Ligue 1,22,1996,12.5,10,5,2,6,2,5,13,38.5,8,9,1,8,11,21,8,1,Matches
1865,Reece Oxford,ENG,MF,Augsburg,Bundesliga,20,1998,4.2,7,4,2,4,1,2,8,25.0,6,8,5,3,5,12,10,1,Matches
1866,Alex Oxlade-Chamberlain,ENG,"MF,FW",Liverpool,Premier League,25,1993,16.5,18,9,4,6,8,5,21,23.8,16,26,1,25,22,40,10,0,Matches
1867,Mikel Oyarzabal,ESP,"FW,MF",Real Sociedad,La Liga,22,1997,33.9,36,15,13,15,8,16,46,34.8,30,32,2,30,13,49,19,1,Matches
1868,Ambroise Oyongo,CMR,"DF,FW",Montpellier,Ligue 1,28,1991,20.2,25,10,16,6,3,16,28,57.1,12,8,0,8,17,42,35,0,Matches
1869,Mesut Özil,GER,MF,Arsenal,Premier League,30,1988,16.0,17,8,9,7,1,4,23,17.4,19,4,0,4,5,22,1,0,Matches
1870,Levin Öztunalı,GER,"MF,FW",Mainz 05,Bundesliga,23,1996,19.8,28,19,13,12,3,12,35,34.3,23,27,1,26,9,37,14,2,Matches
1871,Pablo,BRA,DF,Bordeaux,Ligue 1,28,1991,24.1,27,15,22,5,0,16,31,51.6,15,25,14,11,40,67,130,2,Matches
1872,Fernando Pacheco,ESP,GK,Alavés,La Liga,27,1992,26.2,1,0,1,0,0,1,3,33.3,2,0,0,0,0,1,10,0,Matches
1873,Jon Pacheco,ESP,DF,Real Sociedad,La Liga,18,2001,0.9,0,0,0,0,0,0,0,,0,1,0,1,0,0,2,0,Matches
1874,Gonçalo Paciência,POR,FW,Eint Frankfurt,Bundesliga,24,1994,14.3,9,5,1,4,4,3,13,23.1,10,9,1,8,1,10,11,0,Matches
1875,Daniele Padelli,ITA,GK,Inter,Serie A,33,1985,3.0,0,0,0,0,0,0,0,,0,0,0,0,0,0,1,1,Matches
1876,Marko Pajač,CRO,"DF,FW",Genoa,Serie A,26,1993,8.4,8,4,4,3,1,7,16,43.8,9,6,0,6,8,16,9,0,Matches
1877,Vincent Pajot,FRA,MF,Angers,Ligue 1,28,1990,1.3,2,2,1,1,0,1,1,100.0,0,3,0,3,5,7,0,0,Matches
1878,Vincent Pajot,FRA,MF,Metz,Ligue 1,28,1990,5.8,16,11,8,7,1,2,4,50.0,2,5,1,4,9,25,13,0,Matches
1879,Rodrigo Palacio,ARG,FW,Bologna,Serie A,37,1982,28.0,19,11,0,9,10,4,27,14.8,23,17,3,14,5,24,38,2,Matches
1880,Exequiel Palacios,ARG,MF,Leverkusen,Bundesliga,20,1998,2.0,8,7,4,4,0,2,5,40.0,3,2,0,2,1,9,0,0,Matches
1881,Sergi Palencia,ESP,DF,Saint-Étienne,Ligue 1,23,1996,5.2,16,10,6,10,0,5,7,71.4,2,6,1,5,8,24,4,0,Matches
1882,Nicolas Pallois,FRA,DF,Nantes,Ligue 1,31,1987,21.0,47,36,28,17,2,31,55,56.4,24,18,13,5,40,87,77,1,Matches
1883,Emerson Palmieri,ITA,DF,Chelsea,Premier League,24,1994,11.4,23,12,8,11,4,10,15,66.7,5,13,1,12,18,41,19,0,Matches
1884,Alberto Paloschi,ITA,FW,SPAL,Serie A,29,1990,4.9,3,0,3,0,0,2,8,25.0,6,3,0,3,0,3,2,0,Matches
1885,Alberto Paloschi,ITA,"FW,MF",Cagliari,Serie A,29,1990,2.3,0,0,0,0,0,0,1,0.0,1,1,0,1,1,1,3,0,Matches
1886,Martin Palumbo,NOR,MF,Udinese,Serie A,17,2002,0.0,0,0,0,0,0,0,0,,0,0,0,0,0,0,0,0,Matches
1887,Goran Pandev,MKD,"FW,MF",Genoa,Serie A,36,1983,18.7,12,8,2,7,3,3,25,12.0,22,4,1,3,0,12,5,1,Matches
1888,Jonathan Panzo,ENG,DF,Monaco,Ligue 1,18,2000,1.2,2,2,2,0,0,1,1,100.0,0,3,1,2,3,5,7,0,Matches
1889,Sokratis Papastathopoulos,GRE,DF,Arsenal,Premier League,31,1988,18.8,25,16,17,7,1,10,21,47.6,11,30,24,6,17,42,68,1,Matches
1890,Andrea Papetti,ITA,DF,Brescia,Serie A,17,2002,10.2,9,7,8,1,0,4,14,28.6,10,15,11,4,15,24,39,0,Matches
1891,Lucas Paquetá,BRA,"MF,FW",Milan,Serie A,21,1997,12.3,33,19,12,17,4,14,37,37.8,23,17,2,15,8,41,9,0,Matches
1892,Gaëtan Paquiez,FRA,DF,Nîmes,Ligue 1,25,1994,17.0,36,25,14,13,9,17,47,36.2,30,18,5,13,33,69,43,0,Matches
1893,Rubén Pardo,ESP,MF,Bordeaux,Ligue 1,26,1992,2.1,3,2,2,1,0,2,3,66.7,1,0,0,0,1,4,2,1,Matches
1894,Leandro Paredes,ARG,MF,Paris S-G,Ligue 1,25,1994,9.0,22,14,7,14,1,13,29,44.8,16,7,1,6,15,37,7,0,Matches
1895,Daniel Parejo,ESP,MF,Valencia,La Liga,30,1989,33.6,67,41,29,32,6,32,101,31.7,69,38,11,27,22,89,20,2,Matches
1896,Michael Parensen,GER,DF,Union Berlin,Bundesliga,33,1986,7.0,11,6,5,6,0,5,10,50.0,5,14,8,6,12,23,17,0,Matches
1897,Miquel Parera,ESP,GK,Mallorca,La Liga,23,1996,1.0,0,0,0,0,0,0,0,,0,0,0,0,0,0,0,0,Matches
1898,Marco Parolo,ITA,MF,Lazio,Serie A,34,1985,18.9,54,26,19,27,8,18,46,39.1,28,44,15,29,26,80,49,0,Matches
1899,Troy Parrott,IRL,FW,Tottenham,Premier League,17,2002,0.1,0,0,0,0,0,0,0,,0,0,0,0,0,0,0,0,Matches
1900,Thomas Partey,GHA,MF,Atlético Madrid,La Liga,26,1993,28.3,70,41,34,30,6,26,58,44.8,32,32,8,24,48,118,41,7,Matches
1901,Mario Pašalić,CRO,MF,Atalanta,Serie A,24,1995,26.9,47,21,17,18,12,16,52,30.8,36,27,7,20,27,74,22,2,Matches
1902,Javier Pastore,ARG,MF,Roma,Serie A,30,1989,5.7,14,10,3,5,6,5,12,41.7,7,4,0,4,5,19,5,0,Matches
1903,Patric,ESP,DF,Lazio,Serie A,26,1993,18.6,34,20,24,7,3,18,25,72.0,7,19,9,10,15,49,45,0,Matches
1904,Rui Patrício,POR,GK,Wolves,Premier League,31,1988,38.0,0,0,0,0,0,0,2,0.0,2,2,0,2,2,2,5,2,Matches
1905,Paulinho,BRA,"MF,FW",Leverkusen,Bundesliga,19,2000,3.4,4,3,3,1,0,1,2,50.0,1,5,1,4,1,5,0,0,Matches
1906,Paulino,ESP,"FW,MF",Alavés,La Liga,22,1997,0.8,0,0,0,0,0,0,1,0.0,1,1,0,1,1,1,0,0,Matches
1907,Gabriel Paulista,BRA,DF,Valencia,La Liga,28,1990,31.1,22,14,17,2,3,15,25,60.0,10,36,29,7,48,70,151,3,Matches
1908,Benjamin Pavard,FRA,DF,Bayern Munich,Bundesliga,23,1996,31.0,34,22,15,10,9,16,28,57.1,12,28,10,18,52,86,60,0,Matches
1909,Jiří Pavlenka,CZE,GK,Werder Bremen,Bundesliga,27,1992,33.0,1,0,1,0,0,1,2,50.0,1,1,0,1,5,6,11,3,Matches
1910,Mateo Pavlović,BIH,DF,Angers,Ligue 1,29,1990,9.0,8,2,6,2,0,5,7,71.4,2,4,2,2,5,13,38,1,Matches
1911,Leonardo Pavoletti,ITA,FW,Cagliari,Serie A,30,1988,0.5,0,0,0,0,0,0,0,,0,0,0,0,1,1,3,0,Matches
1912,Dimitri Payet,FRA,"FW,MF",Marseille,Ligue 1,32,1987,21.4,22,12,8,8,6,10,26,38.5,16,8,1,7,8,30,12,0,Matches
1913,Nehuén Paz,ARG,DF,Bologna,Serie A,26,1993,1.3,1,1,0,1,0,0,2,0.0,2,3,3,0,5,6,12,0,Matches
1914,Nehuén Paz,ARG,DF,Lecce,Serie A,26,1993,9.4,14,5,11,3,0,10,12,83.3,2,12,6,6,20,34,38,1,Matches
1915,Giampaolo Pazzini,ITA,"FW,MF",Hellas Verona,Serie A,34,1984,3.4,1,0,0,1,0,0,4,0.0,4,2,0,2,1,2,4,0,Matches
1916,Mads Pedersen,DEN,DF,Augsburg,Bundesliga,22,1996,1.1,4,2,3,0,1,2,6,33.3,4,3,1,2,2,6,0,0,Matches
1917,Alfonso Pedraza,ESP,DF,Betis,La Liga,23,1996,15.0,30,19,16,11,3,19,33,57.6,14,18,6,12,16,46,26,1,Matches
1918,Marc Pedraza,ESP,MF,Mallorca,La Liga,32,1987,1.4,1,1,1,0,0,1,5,20.0,4,0,0,0,4,5,1,0,Matches
1919,Pedro,ESP,"FW,MF",Chelsea,Premier League,32,1987,7.3,15,7,5,9,1,3,15,20.0,12,9,0,9,9,24,1,0,Matches
1920,Pedro,BRA,FW,Fiorentina,Serie A,22,1997,0.7,1,1,0,0,1,0,0,,0,1,0,1,0,1,0,0,Matches
1921,João Pedro,ITA,"FW,MF",Cagliari,Serie A,27,1992,35.0,17,11,5,7,5,4,24,16.7,20,35,8,27,9,26,39,0,Matches
1922,Adrià Pedrosa,ESP,"DF,MF",Espanyol,La Liga,21,1998,12.1,19,13,8,9,2,7,25,28.0,18,12,1,11,11,30,32,0,Matches
1923,Daouda Peeters,BEL,MF,Juventus,Serie A,20,1999,0.2,1,0,0,1,0,1,1,100.0,0,0,0,0,0,1,0,0,Matches
1924,Jordan Pefok,USA,FW,Rennes,Ligue 1,23,1996,4.9,7,6,1,4,2,0,2,0.0,2,3,0,3,1,8,2,0,Matches
1925,Gianluca Pegolo,ITA,GK,Sassuolo,Serie A,38,1981,5.0,0,0,0,0,0,0,0,,0,0,0,0,0,0,4,0,Matches
1926,Peter Pekarík,SVK,"DF,FW",Hertha BSC,Bundesliga,32,1986,8.5,14,7,7,3,4,8,20,40.0,12,11,4,7,7,21,31,0,Matches
1927,Yohann Pelé,FRA,GK,Marseille,Ligue 1,36,1982,1.7,0,0,0,0,0,0,0,,0,0,0,0,0,0,0,0,Matches
1928,Lorenzo Pellegrini,ITA,MF,Roma,Serie A,23,1996,23.3,30,13,9,13,8,12,33,36.4,21,28,0,28,15,45,18,0,Matches
1929,Luca Pellegrini,ITA,DF,Cagliari,Serie A,20,1999,21.2,31,15,20,7,4,15,38,39.5,23,19,2,17,21,52,45,2,Matches
1930,Théo Pellenard,FRA,DF,Angers,Ligue 1,25,1994,5.1,11,8,6,3,2,6,13,46.2,7,4,0,4,5,16,8,0,Matches
1931,Andy Pelmard,FRA,DF,Nice,Ligue 1,19,2000,8.5,22,14,13,9,0,9,11,81.8,2,12,4,8,15,37,28,1,Matches
1932,Federico Peluso,ITA,DF,Sassuolo,Serie A,35,1984,16.8,19,16,8,8,3,8,9,88.9,1,14,9,5,22,41,58,1,Matches
1933,Rubén Peña,ESP,DF,Villarreal,La Liga,28,1991,21.2,42,24,23,19,0,17,50,34.0,33,25,8,17,35,77,58,2,Matches
1934,Philipp Pentke,GER,GK,Hoffenheim,Bundesliga,34,1985,4.0,0,0,0,0,0,0,0,,0,0,0,0,0,0,2,0,Matches
1935,Nicolas Pépé,CIV,FW,Arsenal,Premier League,24,1995,22.3,32,17,15,13,4,8,16,50.0,8,15,2,13,8,40,5,0,Matches
1936,Luis Perea,ESP,FW,Osasuna,La Liga,21,1997,0.2,0,0,0,0,0,0,0,,0,0,0,0,0,0,1,0,Matches
1937,Andreas Pereira,BRA,"MF,FW",Manchester Utd,Premier League,23,1996,16.5,24,13,8,9,7,10,39,25.6,29,13,0,13,7,31,7,0,Matches
1938,Mathias Pereira Lage,POR,MF,Angers,Ligue 1,22,1996,17.1,30,18,16,13,1,12,37,32.4,25,19,0,19,17,47,9,0,Matches
1939,Ricardo Pereira,POR,DF,Leicester City,Premier League,25,1993,28.0,119,68,65,36,18,53,106,50.0,53,38,6,32,49,168,86,0,Matches
1940,Gastón Pereiro,URU,"MF,FW",Cagliari,Serie A,24,1995,3.9,2,2,2,0,0,1,4,25.0,3,1,0,1,0,2,1,1,Matches
1941,Bruno Peres,BRA,DF,Roma,Serie A,29,1990,11.7,14,10,10,3,1,8,21,38.1,13,12,3,9,15,29,19,2,Matches
1942,Roberto Pereyra,ARG,"FW,MF",Watford,Premier League,28,1991,18.3,20,8,11,7,2,9,28,32.1,19,21,0,21,14,34,12,1,Matches
1943,Ayoze Pérez,ESP,"MF,FW",Leicester City,Premier League,26,1993,22.3,45,28,14,26,5,8,54,14.8,46,33,1,32,14,59,9,1,Matches
1944,Carles Pérez,ESP,"FW,MF",Roma,Serie A,21,1998,6.3,12,8,4,6,2,3,10,30.0,7,6,1,5,3,15,1,0,Matches
1945,Carles Pérez,ESP,FW,Barcelona,La Liga,21,1998,5.3,7,4,2,2,3,3,15,20.0,12,5,2,3,1,8,1,0,Matches
1946,Iñigo Pérez,ESP,MF,Osasuna,La Liga,31,1988,12.0,15,11,3,7,5,8,22,36.4,14,7,1,6,12,27,6,0,Matches
1947,Juan Pérez,ESP,GK,Osasuna,La Liga,23,1996,2.0,1,1,1,0,0,1,2,50.0,1,0,0,0,0,1,0,0,Matches
1948,Kike Pérez,ESP,"MF,FW",Valladolid,La Liga,22,1997,2.4,6,1,1,3,2,3,7,42.9,4,1,0,1,10,16,4,0,Matches
1949,Lucas Pérez,ESP,FW,Alavés,La Liga,30,1988,27.7,12,6,2,8,2,3,13,23.1,10,13,2,11,2,14,0,0,Matches
1950,Rubén Pérez,ESP,MF,Leganés,La Liga,30,1989,24.4,50,27,21,23,6,16,47,34.0,31,21,4,17,38,88,33,0,Matches
1951,Samu Pérez,ESP,GK,Valladolid,La Liga,22,1997,0.3,0,0,0,0,0,0,0,,0,0,0,0,0,0,0,0,Matches
1952,Mattia Perin,ITA,GK,Genoa,Serie A,26,1992,21.0,1,1,1,0,0,1,1,100.0,0,1,0,1,0,1,5,1,Matches
1953,Ivan Perišić,CRO,"FW,MF",Bayern Munich,Bundesliga,30,1989,13.4,16,12,5,6,5,8,33,24.2,25,14,3,11,4,20,8,0,Matches
1954,Diego Perotti,ARG,"FW,MF",Roma,Serie A,31,1988,9.7,16,13,5,8,3,5,20,25.0,15,14,0,14,3,19,6,0,Matches
1955,Romain Perraud,FRA,DF,Brest,Ligue 1,21,1997,18.6,29,14,18,9,2,14,28,50.0,14,24,9,15,27,56,50,0,Matches
1956,Loïc Perrin,FRA,DF,Saint-Étienne,Ligue 1,33,1985,19.0,27,20,16,11,0,11,14,78.6,3,23,17,6,39,66,59,0,Matches
1957,Lucas Perrin,FRA,DF,Marseille,Ligue 1,20,1998,4.0,5,2,3,2,0,2,7,28.6,5,3,2,1,10,15,17,0,Matches
1958,Pavao Pervan,AUT,GK,Wolfsburg,Bundesliga,31,1987,8.0,0,0,0,0,0,0,1,0.0,1,0,0,0,0,0,4,0,Matches
1959,Matteo Pessina,ITA,MF,Hellas Verona,Serie A,22,1997,27.7,35,21,9,20,6,12,33,36.4,21,28,8,20,25,60,40,2,Matches
1960,Andrea Petagna,ITA,FW,SPAL,Serie A,24,1995,33.7,9,4,2,7,0,3,17,17.6,14,11,5,6,1,10,27,0,Matches
1961,Nils Petersen,GER,"FW,MF",Freiburg,Bundesliga,30,1988,27.1,19,14,7,9,3,10,28,35.7,18,32,6,26,10,29,67,0,Matches
1962,Danijel Petković,MNE,GK,Angers,Ligue 1,26,1993,2.0,0,0,0,0,0,0,0,,0,0,0,0,0,0,2,0,Matches
1963,Denis Petrić,SRB,GK,Nantes,Ligue 1,31,1988,1.0,1,1,1,0,0,1,1,100.0,0,0,0,0,0,1,0,0,Matches
1964,Jacopo Petriccione,ITA,MF,Lecce,Serie A,24,1995,23.8,38,20,29,9,0,15,57,26.3,42,20,7,13,28,66,25,2,Matches
1965,Germán Pezzella,ARG,DF,Fiorentina,Serie A,28,1991,31.4,36,18,26,9,1,14,32,43.8,18,31,20,11,55,91,134,1,Matches
1966,Giuseppe Pezzella,ITA,DF,Udinese,Serie A,21,1997,0.9,0,0,0,0,0,0,0,,0,0,0,0,1,1,4,0,Matches
1967,Giuseppe Pezzella,ITA,DF,Parma,Serie A,21,1997,10.5,20,12,17,3,0,11,19,57.9,8,13,9,4,6,26,30,0,Matches
1968,Rayan Philippe,FRA,FW,Dijon,Ligue 1,18,2000,0.3,0,0,0,0,0,0,1,0.0,1,0,0,0,1,1,1,1,Matches
1969,Romain Philippoteaux,FRA,"FW,MF",Nîmes,Ligue 1,31,1988,22.2,23,12,11,11,1,9,43,20.9,34,22,1,21,13,36,10,0,Matches
1970,Krzysztof Piątek,POL,FW,Milan,Serie A,24,1995,13.1,9,4,0,7,2,3,11,27.3,8,5,2,3,3,12,10,0,Matches
1971,Krzysztof Piątek,POL,FW,Hertha BSC,Bundesliga,24,1995,10.1,5,4,1,1,3,0,11,0.0,11,7,0,7,5,10,3,0,Matches
1972,Pablo Piatti,ARG,"DF,MF",Espanyol,La Liga,30,1989,0.6,2,2,1,1,0,1,2,50.0,1,1,0,1,0,2,1,0,Matches
1973,Cristiano Piccini,ITA,DF,Valencia,La Liga,26,1992,0.8,5,4,1,0,4,4,4,100.0,0,0,0,0,2,7,1,0,Matches
1974,Stefano Piccinini,ITA,DF,Sassuolo,Serie A,16,2002,0.1,0,0,0,0,0,0,0,,0,0,0,0,0,0,0,0,Matches
1975,Roberto Piccoli,ITA,FW,Atalanta,Serie A,18,2001,0.2,0,0,0,0,0,0,0,,0,1,0,1,0,0,0,0,Matches
1976,Jordan Pickford,ENG,GK,Everton,Premier League,25,1994,38.0,0,0,0,0,0,0,4,0.0,4,0,0,0,3,3,12,6,Matches
1977,Jérémy Pied,FRA,DF,Lille,Ligue 1,30,1989,5.0,18,10,6,11,1,11,16,68.8,5,8,0,8,7,25,10,0,Matches
1978,Ronaël Pierre-Gabriel,FRA,DF,Mainz 05,Bundesliga,21,1998,6.4,16,10,9,6,1,7,13,53.8,6,7,0,7,8,24,31,1,Matches
1979,Brandon Pierrick,ENG,"MF,FW",Crystal Palace,Premier League,17,2001,0.2,0,0,0,0,0,0,0,,0,0,0,0,0,0,1,0,Matches
1980,Erik Pieters,NED,"DF,MF",Burnley,Premier League,30,1988,20.9,54,32,18,29,7,28,69,40.6,41,30,4,26,28,82,60,1,Matches
1981,Tomás Pina Isla,ESP,MF,Alavés,La Liga,31,1987,14.9,37,22,13,21,3,12,24,50.0,12,15,5,10,16,53,31,0,Matches
1982,Andrea Pinamonti,ITA,FW,Genoa,Serie A,20,1999,24.8,19,12,1,7,11,5,25,20.0,20,19,2,17,9,28,25,0,Matches
1983,Simone Pinna,ITA,DF,Cagliari,Serie A,21,1997,1.0,1,1,0,1,0,0,0,,0,3,1,2,5,6,4,1,Matches
1984,Carlo Pinsoglio,ITA,GK,Juventus,Serie A,29,1990,0.2,0,0,0,0,0,0,0,,0,0,0,0,0,0,0,0,Matches
1985,Pipa,ESP,"DF,FW",Espanyol,La Liga,21,1998,5.3,9,8,5,4,0,4,6,66.7,2,8,0,8,6,15,17,0,Matches
1986,Gerard Piqué,ESP,DF,Barcelona,La Liga,32,1987,34.4,32,23,20,11,1,16,26,61.5,10,39,24,15,36,68,157,0,Matches
1987,Lorenzo Pirola,ITA,DF,Inter,Serie A,17,2002,0.1,0,0,0,0,0,0,0,,0,0,0,0,1,1,0,0,Matches
1988,Fabio Pisacane,ITA,DF,Cagliari,Serie A,33,1986,27.1,32,21,22,10,0,21,37,56.8,16,36,28,8,27,59,110,2,Matches
1989,Łukasz Piszczek,POL,DF,Dortmund,Bundesliga,34,1985,23.4,45,32,27,16,2,28,50,56.0,22,27,11,16,26,71,47,1,Matches
1990,Claudio Pizarro,PER,"FW,MF",Werder Bremen,Bundesliga,40,1978,2.6,2,1,0,1,1,0,1,0.0,1,2,0,2,2,4,2,0,Matches
1991,Miralem Pjanić,BIH,MF,Juventus,Serie A,29,1990,25.3,46,21,16,23,7,21,63,33.3,42,29,12,17,32,78,30,0,Matches
1992,Óscar Plano,ESP,MF,Valladolid,La Liga,28,1991,27.8,48,30,25,19,4,20,61,32.8,41,36,3,33,35,83,29,0,Matches
1993,Marvin Plattenhardt,GER,DF,Hertha BSC,Bundesliga,27,1992,15.5,18,12,13,4,1,12,17,70.6,5,18,7,11,11,29,47,0,Matches
1994,Alassane Pléa,FRA,FW,Gladbach,Bundesliga,26,1993,23.8,16,7,5,6,5,8,28,28.6,20,21,2,19,9,25,7,0,Matches
1995,Thomas Pledl,GER,"MF,FW",Düsseldorf,Bundesliga,25,1994,1.0,4,2,2,2,0,0,1,0.0,1,0,0,0,0,4,1,0,Matches
1996,Daniel Podence,POR,"FW,MF",Wolves,Premier League,23,1995,3.2,3,3,2,0,1,0,2,0.0,2,4,1,3,2,5,1,0,Matches
1997,Paul Pogba,FRA,MF,Manchester Utd,Premier League,26,1993,13.4,20,9,8,8,4,8,16,50.0,8,12,4,8,7,27,10,2,Matches
1998,Joel Pohjanpalo,FIN,MF,Leverkusen,Bundesliga,24,1994,0.0,0,0,0,0,0,0,0,,0,0,0,0,0,0,0,0,Matches
1999,Andrea Poli,ITA,MF,Bologna,Serie A,29,1989,21.3,44,24,19,21,4,16,52,30.8,36,19,3,16,40,84,11,0,Matches
2000,Matteo Politano,ITA,FW,Napoli,Serie A,25,1993,8.3,12,6,8,2,2,5,14,35.7,9,6,0,6,5,17,3,0,Matches
2001,Matteo Politano,ITA,"FW,MF",Inter,Serie A,25,1993,2.9,0,0,0,0,0,0,2,0.0,2,1,0,1,0,0,1,0,Matches
2002,Sebastian Polter,GER,FW,Union Berlin,Bundesliga,28,1991,3.7,2,2,0,1,1,1,3,33.3,2,2,0,2,1,3,1,0,Matches
2003,Marin Pongračić,CRO,DF,Wolfsburg,Bundesliga,21,1997,10.3,14,9,11,2,1,9,10,90.0,1,11,7,4,19,33,21,1,Matches
2004,Pere Pons,ESP,MF,Alavés,La Liga,26,1993,12.1,28,16,14,12,2,12,26,46.2,14,16,3,13,12,40,8,1,Matches
2005,Nick Pope,ENG,GK,Burnley,Premier League,27,1992,38.0,1,1,1,0,0,1,2,50.0,1,0,0,0,3,4,15,3,Matches
2006,Pedro Porro,ESP,"DF,MF",Valladolid,La Liga,19,1999,8.2,18,10,11,7,0,10,18,55.6,8,3,0,3,7,25,19,1,Matches
2007,Francisco Portillo,ESP,MF,Getafe,La Liga,29,1990,4.2,11,6,3,6,2,4,12,33.3,8,2,0,2,2,13,3,0,Matches
2008,Portu,ESP,"FW,MF",Real Sociedad,La Liga,27,1992,26.6,32,21,10,15,7,13,33,39.4,20,28,3,25,13,45,5,0,Matches
2009,Stefan Posch,AUT,DF,Hoffenheim,Bundesliga,22,1997,25.6,63,34,35,27,1,35,63,55.6,28,57,25,32,40,103,101,1,Matches
2010,Sergio Postigo,ESP,DF,Levante,La Liga,30,1988,26.4,32,15,23,7,2,11,18,61.1,7,24,15,9,34,66,132,1,Matches
2011,Florent Poulolo,MTQ,DF,Getafe,La Liga,22,1997,0.0,0,0,0,0,0,0,0,,0,0,0,0,0,0,1,0,Matches
2012,Yussuf Poulsen,DEN,FW,RB Leipzig,Bundesliga,25,1994,13.6,14,10,2,10,2,4,21,19.0,17,12,0,12,4,18,15,0,Matches
2013,Maxime Poundjé,FRA,DF,Bordeaux,Ligue 1,26,1992,0.0,0,0,0,0,0,0,0,,0,0,0,0,0,0,0,0,Matches
2014,Darío Poveda,ESP,MF,Atlético Madrid,La Liga,22,1997,0.1,1,0,0,1,0,0,0,,0,0,0,0,0,1,0,0,Matches
2015,Alejandro Pozo Pozo,ESP,DF,Mallorca,La Liga,20,1999,16.6,38,24,30,6,2,19,38,50.0,19,23,2,21,23,61,29,1,Matches
2016,Alejandro Pozo Pozo,ESP,"MF,FW",Sevilla,La Liga,20,1999,0.4,1,1,1,0,0,1,1,100.0,0,0,0,0,0,1,1,0,Matches
2017,Percy Prado,PER,DF,Nantes,Ligue 1,23,1996,2.1,6,5,3,2,1,5,9,55.6,4,1,0,1,1,7,5,0,Matches
2018,Dennis Praet,BEL,MF,Leicester City,Premier League,25,1994,12.6,33,18,8,21,4,9,29,31.0,20,19,1,18,17,50,12,0,Matches
2019,Abdón Prats,ESP,FW,Mallorca,La Liga,26,1992,3.1,1,1,0,0,1,0,1,0.0,1,1,0,1,0,1,1,0,Matches
2020,Sanjin Prcić,BIH,"MF,FW",Strasbourg,Ligue 1,25,1993,0.9,1,0,0,0,1,1,2,50.0,1,1,1,0,1,2,0,0,Matches
2021,Nicolas de Préville,FRA,"MF,FW",Bordeaux,Ligue 1,28,1991,22.2,35,21,9,22,4,18,56,32.1,38,15,3,12,6,41,19,0,Matches
2022,Sebastian Prödl,AUT,DF,Watford,Premier League,32,1987,0.6,0,0,0,0,0,0,0,,0,0,0,0,0,0,4,0,Matches
2023,Kai Pröger,GER,"MF,FW",Paderborn 07,Bundesliga,27,1992,23.1,43,22,21,17,5,17,58,29.3,41,34,6,28,14,57,20,1,Matches
2024,Grischa Prömel,GER,MF,Union Berlin,Bundesliga,24,1995,10.3,14,11,6,6,2,7,19,36.8,12,10,2,8,14,28,9,0,Matches
2025,Davy Pröpper,NED,MF,Brighton,Premier League,27,1991,31.4,64,35,28,28,8,23,74,31.1,51,27,8,19,38,102,36,4,Matches
2026,Antonio Puertas,ESP,"FW,MF",Granada,La Liga,27,1992,28.5,37,24,8,18,11,16,53,30.2,37,21,3,18,12,49,21,0,Matches
2027,Riqui Puig,ESP,MF,Barcelona,La Liga,19,1999,5.7,11,7,1,9,1,5,17,29.4,12,2,0,2,5,16,1,0,Matches
2028,Teemu Pukki,FIN,FW,Norwich City,Premier League,29,1990,32.1,12,6,3,5,4,1,23,4.3,22,13,0,13,6,18,7,0,Matches
2029,Erick Pulgar,CHI,MF,Fiorentina,Serie A,25,1994,32.8,73,46,25,41,7,22,96,22.9,74,45,15,30,49,122,53,1,Matches
2030,Christian Pulisic,USA,FW,Chelsea,Premier League,20,1998,19.1,23,11,13,4,6,7,24,29.2,17,15,0,15,6,29,11,0,Matches
2031,Ignacio Pussetto,ARG,"FW,MF",Watford,Premier League,23,1995,0.8,7,4,4,2,1,3,8,37.5,5,2,1,1,3,10,4,0,Matches
2032,Ignacio Pussetto,ARG,"FW,MF",Udinese,Serie A,23,1995,3.8,8,4,4,3,1,1,4,25.0,3,3,0,3,4,12,7,0,Matches
2033,Fabio Quagliarella,ITA,FW,Sampdoria,Serie A,36,1983,25.3,9,5,0,6,3,2,30,6.7,28,13,0,13,8,17,15,0,Matches
2034,Robin Quaison,SWE,"FW,MF",Mainz 05,Bundesliga,25,1993,28.9,25,17,15,7,3,11,32,34.4,21,27,5,22,11,36,8,0,Matches
2035,Domingos Quina,POR,"MF,FW",Watford,Premier League,19,1999,0.2,2,0,1,1,0,1,2,50.0,1,3,0,3,0,2,0,0,Matches
2036,Quini,ESP,DF,Granada,La Liga,29,1989,8.0,25,14,16,7,2,13,22,59.1,9,5,1,4,10,35,14,0,Matches
2037,Xavi Quintillà,ESP,DF,Villarreal,La Liga,22,1996,17.5,22,12,14,4,4,10,20,50.0,10,11,4,7,12,34,35,0,Matches
2038,Quique,ESP,"FW,MF",Eibar,La Liga,29,1990,5.4,2,1,1,0,1,0,0,,0,3,0,3,0,2,3,0,Matches
2039,Adrien Rabiot,FRA,MF,Juventus,Serie A,24,1995,21.2,47,31,16,19,12,15,41,36.6,26,36,6,30,32,79,19,0,Matches
2040,Nemanja Radoja,SRB,MF,Levante,La Liga,26,1993,22.1,43,19,27,16,0,15,46,32.6,31,21,4,17,23,66,24,0,Matches
2041,Nemanja Radonjić,SRB,"FW,MF",Marseille,Ligue 1,23,1996,9.8,10,3,4,3,3,6,17,35.3,11,7,0,7,2,12,7,0,Matches
2042,Ivan Radovanović,SRB,MF,Genoa,Serie A,30,1988,14.6,27,14,18,9,0,10,26,38.5,16,17,3,14,8,35,39,0,Matches
2043,Ionuț Radu,ROU,GK,Genoa,Serie A,22,1997,17.0,0,0,0,0,0,0,2,0.0,2,0,0,0,1,1,7,1,Matches
2044,Ștefan Radu,ROU,DF,Lazio,Serie A,32,1986,25.6,43,25,24,15,4,28,43,65.1,15,19,9,10,34,77,85,0,Matches
2045,Boris Radunović,SRB,GK,Hellas Verona,Serie A,23,1996,3.0,0,0,0,0,0,0,0,,0,0,0,0,0,0,1,0,Matches
2046,Rafael,BRA,GK,Cagliari,Serie A,37,1982,5.0,0,0,0,0,0,0,0,,0,0,0,0,0,0,3,0,Matches
2047,Rafael,BRA,DF,Lyon,Ligue 1,29,1990,7.8,24,16,12,8,4,10,18,55.6,8,6,3,3,10,34,14,0,Matches
2048,Raffael,BRA,"MF,FW",Gladbach,Bundesliga,34,1985,0.7,0,0,0,0,0,0,2,0.0,2,2,0,2,0,0,0,0,Matches
2049,Rafinha,BRA,"FW,MF",Barcelona,La Liga,26,1993,2.1,3,2,1,1,1,1,2,50.0,1,0,0,0,1,4,0,0,Matches
2050,Rafinha,BRA,MF,Celta Vigo,La Liga,26,1993,23.5,71,37,29,37,5,20,62,32.3,42,37,4,33,33,104,25,0,Matches
2051,Daniele Ragatzu,ITA,"MF,FW",Cagliari,Serie A,27,1991,3.5,3,2,0,2,1,1,3,33.3,2,1,0,1,1,4,5,0,Matches
2052,Baba Rahman,GHA,DF,Mallorca,La Liga,25,1994,1.2,3,2,2,0,1,0,0,,0,2,1,1,1,4,2,0,Matches
2053,Antonio Raillo,ESP,DF,Mallorca,La Liga,27,1991,30.8,31,21,24,7,0,13,19,68.4,6,31,26,5,22,53,112,1,Matches
2054,Predrag Rajković,SRB,GK,Reims,Ligue 1,23,1995,27.0,1,1,1,0,0,1,1,100.0,0,0,0,0,1,2,9,0,Matches
2055,Ivan Rakitić,CRO,MF,Barcelona,La Liga,31,1988,17.7,27,14,8,15,4,10,28,35.7,18,19,6,13,15,42,18,1,Matches
2056,Benito Raman,BEL,FW,Schalke 04,Bundesliga,24,1994,17.8,18,9,4,9,5,7,24,29.2,17,11,1,10,7,25,1,0,Matches
2057,Gastón Ramírez,URU,"MF,FW",Sampdoria,Serie A,28,1990,15.5,32,21,7,16,9,8,30,26.7,22,28,2,26,11,43,10,0,Matches
2058,Sandro Ramírez,ESP,"FW,MF",Valladolid,La Liga,24,1995,14.5,12,10,2,6,4,2,20,10.0,18,11,1,10,7,19,2,0,Matches
2059,Iván Ramis,ESP,DF,Eibar,La Liga,34,1984,5.1,3,2,2,1,0,1,4,25.0,3,2,0,2,4,7,23,2,Matches
2060,Adrián Ramos,COL,"FW,MF",Granada,La Liga,33,1986,2.5,6,2,0,2,4,2,3,66.7,1,2,0,2,1,7,1,0,Matches
2061,Sergio Ramos,ESP,DF,Real Madrid,La Liga,33,1986,33.5,46,31,26,17,3,20,42,47.6,22,22,9,13,49,95,102,4,Matches
2062,Aaron Ramsdale,ENG,GK,Bournemouth,Premier League,21,1998,37.0,4,3,4,0,0,3,3,100.0,0,0,0,0,0,4,25,1,Matches
2063,Aaron Ramsey,WAL,MF,Juventus,Serie A,28,1990,11.7,20,15,6,8,6,6,24,25.0,18,18,3,15,11,31,12,0,Matches
2064,Darren Randolph,IRL,GK,West Ham,Premier League,32,1987,2.0,0,0,0,0,0,0,0,,0,0,0,0,0,0,2,0,Matches
2065,Luca Ranieri,ITA,DF,Fiorentina,Serie A,20,1999,2.6,2,2,2,0,0,2,3,66.7,1,1,0,1,2,4,7,0,Matches
2066,Andrea Ranocchia,ITA,DF,Inter,Serie A,31,1988,5.8,17,10,10,7,0,5,8,62.5,3,11,6,5,8,25,18,0,Matches
2067,Raphinha,BRA,"MF,FW",Rennes,Ligue 1,22,1996,18.8,22,18,5,12,5,10,32,31.3,22,23,1,22,17,39,14,1,Matches
2068,Tobias Raschl,GER,MF,Dortmund,Bundesliga,19,2000,0.3,0,0,0,0,0,0,1,0.0,1,1,0,1,0,0,0,0,Matches
2069,Marcus Rashford,ENG,FW,Manchester Utd,Premier League,21,1997,29.4,13,9,1,6,6,9,23,39.1,14,23,0,23,10,23,19,0,Matches
2070,Milot Rashica,KVX,FW,Werder Bremen,Bundesliga,23,1996,25.2,21,14,13,6,2,9,33,27.3,24,15,2,13,6,27,16,1,Matches
2071,Giacomo Raspadori,ITA,"MF,FW",Sassuolo,Serie A,19,2000,2.9,8,6,5,2,1,3,4,75.0,1,5,0,5,1,9,0,0,Matches
2072,Raúl,ESP,"FW,MF",Betis,La Liga,18,2000,0.2,0,0,0,0,0,0,2,0.0,2,0,0,0,0,0,0,0,Matches
2073,Ante Rebić,CRO,"FW,MF",Milan,Serie A,25,1993,15.5,16,11,4,9,3,7,34,20.6,27,14,1,13,3,19,12,0,Matches
2074,Ante Rebić,CRO,"FW,MF",Eint Frankfurt,Bundesliga,25,1993,1.0,1,0,0,1,0,0,0,,0,0,0,0,0,1,1,0,Matches
2075,Arkadiusz Reca,POL,DF,SPAL,Serie A,24,1995,21.4,38,23,22,10,6,13,39,33.3,26,15,2,13,32,70,48,1,Matches
2076,Recio,ESP,MF,Leganés,La Liga,28,1991,17.4,30,19,13,12,5,10,40,25.0,30,14,3,11,22,52,9,0,Matches
2077,Daishawn Redan,NED,MF,Hertha BSC,Bundesliga,18,2001,0.2,0,0,0,0,0,0,1,0.0,1,0,0,0,0,0,0,0,Matches
2078,Nathan Redmond,ENG,"MF,FW",Southampton,Premier League,25,1994,30.7,49,29,17,23,9,21,57,36.8,36,39,2,37,16,65,16,0,Matches
2079,Fabian Reese,GER,FW,Schalke 04,Bundesliga,21,1997,1.0,1,1,1,0,0,0,0,,0,1,1,0,0,1,1,0,Matches
2080,Vasco Regini,ITA,DF,Sampdoria,Serie A,28,1990,1.9,4,2,3,1,0,0,0,,0,4,2,2,1,5,6,0,Matches
2081,Vasco Regini,ITA,DF,Parma,Serie A,28,1990,0.6,0,0,0,0,0,0,0,,0,0,0,0,0,0,3,0,Matches
2082,Sergio Reguilón,ESP,DF,Sevilla,La Liga,22,1996,27.9,57,30,28,25,4,27,64,42.2,37,25,5,20,33,90,53,0,Matches
2083,Ken Reichel,GER,DF,Union Berlin,Bundesliga,32,1986,5.9,6,3,2,3,1,3,13,23.1,10,8,1,7,9,15,12,0,Matches
2084,Manolo Reina,ESP,GK,Mallorca,La Liga,34,1985,36.0,0,0,0,0,0,0,1,0.0,1,2,0,2,5,5,9,1,Matches
2085,Pepe Reina,ESP,GK,Aston Villa,Premier League,36,1982,12.0,0,0,0,0,0,0,2,0.0,2,0,0,0,0,0,9,1,Matches
2086,Pepe Reina,ESP,GK,Milan,Serie A,36,1982,1.0,0,0,0,0,0,0,0,,0,0,0,0,0,0,0,1,Matches
2087,Jeff Reine-Adélaïde,FRA,MF,Angers,Ligue 1,21,1998,0.9,3,1,1,2,0,1,1,100.0,0,1,0,1,0,3,1,0,Matches
2088,Jeff Reine-Adélaïde,FRA,"MF,FW",Lyon,Ligue 1,21,1998,8.7,10,8,3,3,4,5,13,38.5,8,3,1,2,7,17,4,0,Matches
2089,Karim Rekik,NED,DF,Hertha BSC,Bundesliga,24,1994,14.0,16,10,10,6,0,3,6,50.0,3,23,15,8,18,34,44,0,Matches
2090,Álex Remiro,ESP,GK,Real Sociedad,La Liga,24,1995,25.0,0,0,0,0,0,0,1,0.0,1,0,0,0,0,0,25,1,Matches
2091,Loïc Rémy,FRA,FW,Lille,Ligue 1,32,1987,10.7,4,1,0,3,1,0,4,0.0,4,1,1,0,0,4,7,0,Matches
2092,Panagiotis Retsos,GRE,DF,Leverkusen,Bundesliga,20,1998,1.3,6,3,4,2,0,1,4,25.0,3,2,0,2,2,8,2,0,Matches
2093,Marco Reus,GER,"MF,FW",Dortmund,Bundesliga,30,1989,16.6,26,16,5,11,10,3,19,15.8,16,17,2,15,9,35,11,0,Matches
2094,Elvis Rexhbeçaj,GER,MF,Köln,Bundesliga,21,1997,6.9,16,12,9,5,2,5,13,38.5,8,7,0,7,3,19,4,0,Matches
2095,Gio Reyna,USA,"MF,FW",Dortmund,Bundesliga,16,2002,3.9,6,2,1,5,0,1,4,25.0,3,3,0,3,0,6,2,0,Matches
2096,Baptiste Reynet,FRA,GK,Toulouse,Ligue 1,28,1990,22.6,1,1,1,0,0,1,3,33.3,2,0,0,0,0,1,12,0,Matches
2097,Nico Ribaudo,ESP,"FW,MF",Espanyol,La Liga,18,2001,2.0,3,1,1,0,2,2,6,33.3,4,1,0,1,1,4,0,0,Matches
2098,Lucas Ribeiro,BRA,MF,Hoffenheim,Bundesliga,20,1999,0.7,1,0,1,0,0,0,3,0.0,3,1,0,1,1,2,1,0,Matches
2099,Franck Ribéry,FRA,FW,Fiorentina,Serie A,36,1983,15.7,20,14,7,10,3,4,20,20.0,16,9,0,9,3,23,3,0,Matches
2100,Davide Riccardi,ITA,DF,Lecce,Serie A,23,1996,0.2,0,0,0,0,0,0,1,0.0,1,0,0,0,0,0,1,0,Matches
2101,Declan Rice,ENG,MF,West Ham,Premier League,20,1999,38.0,116,60,64,48,4,47,98,48.0,51,41,9,32,77,193,55,0,Matches
2102,Chris Richards,USA,DF,Bayern Munich,Bundesliga,19,2000,0.1,0,0,0,0,0,0,0,,0,0,0,0,0,0,1,0,Matches
2103,Richarlison,BRA,"FW,MF",Everton,Premier League,22,1997,34.1,70,47,28,28,14,27,56,48.2,29,34,4,30,12,82,42,0,Matches
2104,Marco Richter,GER,"MF,FW",Augsburg,Bundesliga,21,1997,25.3,21,16,7,9,5,14,51,27.5,37,15,0,15,24,45,17,0,Matches
2105,Diego Rico,ESP,DF,Bournemouth,Premier League,26,1993,25.9,61,39,32,24,5,29,59,49.2,30,31,7,24,84,145,91,0,Matches
2106,Sergio Rico,ESP,GK,Paris S-G,Ligue 1,25,1993,2.0,0,0,0,0,0,0,0,,0,0,0,0,0,0,1,2,Matches
2107,Jaïro Riedewald,NED,"DF,MF",Crystal Palace,Premier League,22,1996,8.5,14,10,4,10,0,7,11,63.6,4,7,2,5,17,31,23,1,Matches
2108,Emiliano Rigoni,ARG,"MF,FW",Sampdoria,Serie A,26,1993,4.8,5,4,2,1,2,3,10,30.0,7,5,1,4,3,8,1,0,Matches
2109,Tomás Rincón,VEN,MF,Torino,Serie A,31,1988,30.0,56,25,23,25,8,23,65,35.4,42,20,3,17,36,92,62,0,Matches
2110,Luis Rioja,ESP,MF,Alavés,La Liga,25,1993,18.2,18,12,11,6,1,8,25,32.0,17,21,0,21,16,34,6,0,Matches
2111,Renaud Ripart,FRA,"FW,DF",Nîmes,Ligue 1,26,1993,22.5,39,23,17,20,2,18,46,39.1,28,17,2,15,12,51,37,0,Matches
2112,Rodrigo Riquelme,ESP,"FW,MF",Atlético Madrid,La Liga,19,2000,0.1,0,0,0,0,0,0,0,,0,0,0,0,0,0,0,0,Matches
2113,Andrea Rispoli,ITA,DF,Lecce,Serie A,30,1988,21.2,24,18,14,9,1,15,30,50.0,15,28,7,21,32,56,62,1,Matches
2114,Marcel Risse,GER,"MF,FW",Köln,Bundesliga,29,1989,1.5,3,2,3,0,0,1,1,100.0,0,1,0,1,1,4,1,0,Matches
2115,Mihailo Ristić,SRB,"DF,MF",Montpellier,Ligue 1,23,1995,9.0,18,14,7,11,0,9,20,45.0,11,7,2,5,7,25,18,0,Matches
2116,Matt Ritchie,SCO,"DF,MF",Newcastle Utd,Premier League,29,1989,14.6,22,15,9,10,3,3,15,20.0,12,20,5,15,14,36,31,1,Matches
2117,Marlon Ritter,GER,MF,Paderborn 07,Bundesliga,24,1994,4.8,7,5,5,2,0,4,9,44.4,5,7,0,7,8,15,3,0,Matches
2118,Cristian Rivera,ESP,MF,Leganés,La Liga,22,1997,3.5,6,4,3,2,1,2,4,50.0,2,4,3,1,4,10,7,0,Matches
2119,Maxence Rivera,FRA,"MF,FW",Saint-Étienne,Ligue 1,17,2002,0.3,0,0,0,0,0,0,1,0.0,1,1,0,1,0,0,0,0,Matches
2120,Rober,ESP,DF,Levante,La Liga,24,1995,2.1,3,1,2,0,1,2,2,100.0,0,0,0,0,3,6,2,0,Matches
2121,Roberto,ESP,GK,West Ham,Premier League,33,1986,7.6,0,0,0,0,0,0,0,,0,0,0,0,0,0,2,2,Matches
2122,Roberto,ESP,GK,Alavés,La Liga,33,1986,8.8,1,1,1,0,0,1,1,100.0,0,0,0,0,0,1,2,0,Matches
2123,Sergi Roberto,ESP,"DF,MF",Barcelona,La Liga,27,1992,26.0,35,22,16,11,8,15,25,60.0,10,12,3,9,33,68,36,0,Matches
2124,Patrick Roberts,ENG,"FW,MF",Norwich City,Premier League,22,1997,0.3,0,0,0,0,0,0,0,,0,0,0,0,0,0,0,0,Matches
2125,Andrew Robertson,SCO,DF,Liverpool,Premier League,25,1994,34.6,54,31,17,25,12,27,61,44.3,34,29,7,22,38,92,72,1,Matches
2126,Callum Robinson,IRL,"FW,MF",Sheffield Utd,Premier League,24,1995,7.5,6,3,2,2,2,2,7,28.6,5,3,0,3,7,13,3,0,Matches
2127,Jack Robinson,ENG,DF,Sheffield Utd,Premier League,25,1993,5.6,10,5,5,5,0,1,6,16.7,5,12,5,7,8,18,24,0,Matches
2128,Joel Robles,ESP,GK,Betis,La Liga,29,1990,32.1,0,0,0,0,0,0,2,0.0,2,0,0,0,0,0,13,2,Matches
2129,Marc Roca,ESP,MF,Espanyol,La Liga,22,1996,33.4,82,52,29,44,9,29,82,35.4,53,28,10,18,31,113,53,2,Matches
2130,Rubén Rochina,ESP,MF,Levante,La Liga,28,1991,20.8,41,26,22,9,10,19,52,36.5,33,16,0,16,12,53,19,1,Matches
2131,Sebastian Rode,GER,MF,Eint Frankfurt,Bundesliga,28,1990,21.5,58,33,27,27,4,17,59,28.8,42,32,5,27,34,92,13,0,Matches
2132,Rodri,ESP,MF,Manchester City,Premier League,23,1996,27.6,50,30,17,25,8,23,63,36.5,40,19,5,14,26,76,35,0,Matches
2133,Rodrigo,ESP,FW,Valencia,La Liga,28,1991,20.9,10,6,4,5,1,2,23,8.7,21,9,1,8,9,19,13,0,Matches
2134,Kévin Rodrigues,POR,"DF,MF",Leganés,La Liga,25,1994,21.5,56,31,31,17,8,25,46,54.3,21,30,3,27,31,87,26,1,Matches
2135,Kévin Rodrigues,POR,DF,Real Sociedad,La Liga,25,1994,0.1,1,0,1,0,0,1,1,100.0,0,0,0,0,0,1,0,0,Matches
2136,Ángel Rodríguez,ESP,FW,Getafe,La Liga,32,1987,15.6,14,8,2,8,4,2,18,11.1,16,10,1,9,3,17,10,0,Matches
2137,Óscar Rodríguez Arnaiz,ESP,"MF,FW",Leganés,La Liga,21,1998,21.3,23,10,11,7,5,13,41,31.7,28,19,0,19,14,37,13,0,Matches
2138,Dani Rodríguez,ESP,"MF,FW",Mallorca,La Liga,31,1988,33.8,59,32,24,28,7,18,61,29.5,43,35,3,32,38,97,27,1,Matches
2139,Guido Rodríguez,ARG,MF,Betis,La Liga,25,1994,10.4,24,16,11,11,2,15,25,60.0,10,13,4,9,10,34,21,0,Matches
2140,James Rodríguez,COL,"MF,FW",Real Madrid,La Liga,28,1991,4.7,17,13,6,8,3,6,12,50.0,6,3,0,3,3,20,1,0,Matches
2141,Jay Rodriguez,ENG,FW,Burnley,Premier League,30,1989,22.4,29,19,4,13,12,8,33,24.2,25,33,6,27,5,34,12,0,Matches
2142,Mario Rodriguez,ESP,MF,Granada,La Liga,22,1997,0.0,0,0,0,0,0,0,0,,0,0,0,0,0,0,0,0,Matches
2143,Ricardo Rodríguez,SUI,DF,Milan,Serie A,26,1992,4.3,6,1,2,2,2,2,6,33.3,4,3,2,1,5,11,17,0,Matches
2144,Rodrygo,BRA,FW,Real Madrid,La Liga,18,2001,11.3,6,1,2,3,1,2,21,9.5,19,13,0,13,10,16,5,0,Matches
2145,Jack Rodwell,ENG,MF,Sheffield Utd,Premier League,28,1991,0.2,0,0,0,0,0,0,0,,0,0,0,0,0,0,1,0,Matches
2146,Marko Rog,CRO,MF,Cagliari,Serie A,24,1995,25.7,69,47,31,29,9,22,84,26.2,62,40,12,28,22,91,23,0,Matches
2147,Agustín Rogel,URU,DF,Toulouse,Ligue 1,21,1997,9.5,15,8,12,3,0,7,13,53.8,6,13,10,3,11,26,35,2,Matches
2148,Rogério,BRA,DF,Sassuolo,Serie A,21,1998,11.3,22,14,12,8,2,16,23,69.6,7,13,3,10,9,31,34,0,Matches
2149,Marcos Rojo,ARG,DF,Manchester Utd,Premier League,29,1990,1.4,3,1,2,1,0,1,2,50.0,1,2,1,1,0,3,6,0,Matches
2150,Filippo Romagna,ITA,DF,Sassuolo,Serie A,22,1997,16.4,7,6,2,5,0,5,6,83.3,1,24,17,7,10,17,69,0,Matches
2151,Alessio Romagnoli,ITA,DF,Milan,Serie A,24,1995,34.3,46,25,28,15,3,16,27,59.3,11,32,18,14,56,102,157,1,Matches
2152,Alaixys Romao,TOG,MF,Reims,Ligue 1,35,1984,19.8,46,29,31,14,1,17,57,29.8,40,12,3,9,26,72,38,3,Matches
2153,Cristian Romero,ARG,DF,Genoa,Serie A,21,1998,28.6,52,35,36,12,4,12,41,29.3,29,59,33,26,75,127,116,2,Matches
2154,Luka Romero,ARG,FW,Mallorca,La Liga,14,2004,0.1,0,0,0,0,0,0,0,,0,0,0,0,0,0,0,0,Matches
2155,Oriol Romeu,ESP,MF,Southampton,Premier League,27,1991,20.7,55,35,23,30,2,27,75,36.0,48,35,13,22,34,89,32,0,Matches
2156,Rômulo,ITA,MF,Brescia,Serie A,32,1987,19.1,30,19,12,14,4,12,34,35.3,22,18,1,17,8,38,12,1,Matches
2157,Rômulo,ITA,DF,Genoa,Serie A,32,1987,0.2,2,1,1,1,0,0,0,,0,0,0,0,0,2,1,0,Matches
2158,Cristiano Ronaldo,POR,FW,Juventus,Serie A,34,1985,32.4,14,10,3,3,8,4,20,20.0,16,10,3,7,6,20,21,1,Matches
2159,Facundo Roncaglia,ARG,DF,Osasuna,La Liga,32,1987,14.2,24,20,12,10,2,11,20,55.0,9,18,3,15,22,46,46,0,Matches
2160,Valentin Rongier,FRA,MF,Marseille,Ligue 1,24,1994,19.9,76,51,25,41,10,22,63,34.9,41,30,4,26,36,112,16,2,Matches
2161,Valentin Rongier,FRA,MF,Nantes,Ligue 1,24,1994,3.0,5,4,0,2,3,3,5,60.0,2,4,0,4,2,7,0,0,Matches
2162,Marten de Roon,NED,"MF,DF",Atalanta,Serie A,28,1991,30.2,77,43,36,29,12,34,75,45.3,41,32,8,24,46,123,45,0,Matches
2163,Roberto Rosales,VEN,DF,Leganés,La Liga,30,1988,20.8,42,23,23,17,2,19,43,44.2,24,17,4,13,30,72,48,0,Matches
2164,Antonio Rosati,ITA,GK,Torino,Serie A,36,1983,1.0,0,0,0,0,0,0,0,,0,0,0,0,0,0,0,1,Matches
2165,Danny Rose,ENG,DF,Tottenham,Premier League,29,1990,9.9,18,11,6,10,2,9,20,45.0,11,14,6,8,8,26,34,2,Matches
2166,Danny Rose,ENG,DF,Newcastle Utd,Premier League,29,1990,9.6,21,12,11,8,2,12,21,57.1,9,11,4,7,10,31,14,1,Matches
2167,Luca Rossettini,ITA,DF,Lecce,Serie A,34,1985,25.1,25,14,18,7,0,17,34,50.0,17,31,22,9,35,60,126,1,Matches
2168,Francesco Rossi,ITA,GK,Atalanta,Serie A,28,1991,0.1,0,0,0,0,0,0,0,,0,0,0,0,0,0,0,0,Matches
2169,Jérôme Roussillon,FRA,DF,Wolfsburg,Bundesliga,26,1993,26.3,48,29,26,18,4,15,29,51.7,14,33,5,28,30,78,58,0,Matches
2170,Nolan Roux,FRA,FW,Nîmes,Ligue 1,31,1988,6.5,5,2,1,3,1,1,3,33.3,2,2,0,2,4,9,5,0,Matches
2171,Nicolò Rovella,ITA,MF,Genoa,Serie A,17,2001,1.2,0,0,0,0,0,0,1,0.0,1,0,0,0,4,4,0,0,Matches
2172,Amir Rrahmani,KVX,DF,Hellas Verona,Serie A,25,1994,35.9,50,31,26,19,5,26,46,56.5,20,50,31,19,30,80,151,1,Matches
2173,Rubén,ESP,GK,Osasuna,La Liga,35,1984,17.6,1,1,1,0,0,1,1,100.0,0,0,0,0,0,1,9,1,Matches
2174,Waldo Rubio,ESP,"MF,FW",Valladolid,La Liga,23,1995,9.8,13,8,10,3,0,5,31,16.1,26,12,0,12,7,20,7,0,Matches
2175,Antonio Rüdiger,GER,DF,Chelsea,Premier League,26,1993,19.0,28,18,19,7,2,16,25,64.0,9,15,9,6,16,44,59,1,Matches
2176,Sebastian Rudy,GER,"MF,DF",Hoffenheim,Bundesliga,29,1990,30.4,73,49,31,29,13,28,75,37.3,47,26,5,21,27,100,38,0,Matches
2177,Stéphane Ruffier,FRA,GK,Saint-Étienne,Ligue 1,32,1986,22.0,0,0,0,0,0,0,0,,0,0,0,0,0,0,5,3,Matches
2178,Dion Ruffo Luci,ITA,MF,Bologna,Serie A,18,2001,0.0,0,0,0,0,0,0,0,,0,0,0,0,0,0,0,0,Matches
2179,Daniele Rugani,ITA,DF,Juventus,Serie A,25,1994,7.7,8,6,4,4,0,4,5,80.0,1,4,4,0,11,19,18,0,Matches
2180,Mário Rui,POR,DF,Napoli,Serie A,28,1991,21.8,31,17,12,12,7,11,29,37.9,18,24,5,19,21,52,43,0,Matches
2181,Aitor Ruibal,ESP,"DF,MF",Leganés,La Liga,23,1996,13.6,27,17,14,11,2,16,39,41.0,23,18,1,17,8,35,11,0,Matches
2182,Fabián Ruiz Peña,ESP,MF,Napoli,Serie A,23,1996,29.8,43,26,19,18,6,24,65,36.9,41,32,4,28,32,75,18,2,Matches
2183,Gerónimo Rulli,ARG,GK,Montpellier,Ligue 1,27,1992,25.0,3,1,3,0,0,3,4,75.0,1,1,0,1,2,5,9,1,Matches
2184,Lukas Rupp,GER,"FW,MF",Norwich City,Premier League,28,1991,7.7,15,9,7,5,3,5,17,29.4,12,11,0,11,15,30,4,0,Matches
2185,Lukas Rupp,GER,MF,Hoffenheim,Bundesliga,28,1991,3.8,9,4,3,5,1,3,6,50.0,3,5,0,5,5,14,3,0,Matches
2186,Mathew Ryan,AUS,GK,Brighton,Premier League,27,1992,38.0,1,1,1,0,0,1,4,25.0,3,0,0,0,2,3,13,2,Matches
2187,Julian Ryerson,NOR,"DF,MF",Union Berlin,Bundesliga,21,1997,4.1,7,5,2,1,4,3,6,50.0,3,5,3,2,5,12,9,0,Matches
2188,Frederik Rønnow,DEN,GK,Eint Frankfurt,Bundesliga,26,1992,9.0,0,0,0,0,0,0,1,0.0,1,0,0,0,0,0,1,0,Matches
2189,João Victor Santos Sá,BRA,"MF,FW",Wolfsburg,Bundesliga,25,1994,18.1,35,22,12,17,6,10,38,26.3,28,31,1,30,9,44,9,0,Matches
2190,Roli Pereira de Sa,FRA,MF,Nantes,Ligue 1,22,1996,0.1,0,0,0,0,0,0,0,,0,0,0,0,0,0,0,0,Matches
2191,Youssouf Sabaly,SEN,DF,Bordeaux,Ligue 1,26,1993,10.1,18,11,9,4,5,6,22,27.3,16,8,1,7,18,36,23,0,Matches
2192,Stefano Sabelli,ITA,DF,Brescia,Serie A,26,1993,35.2,83,44,51,28,4,50,106,47.2,56,40,13,27,58,141,107,0,Matches
2193,Abdelhamid Sabiri,MAR,MF,Paderborn 07,Bundesliga,22,1996,11.6,20,16,6,11,3,9,27,33.3,18,9,2,7,8,28,18,1,Matches
2194,Marcel Sabitzer,AUT,"MF,FW",RB Leipzig,Bundesliga,25,1994,27.8,39,25,15,18,6,19,56,33.9,37,27,4,23,23,62,25,0,Matches
2195,Ihsan Sacko,FRA,FW,Nice,Ligue 1,22,1997,1.6,1,1,1,0,0,0,1,0.0,1,0,0,0,0,1,0,0,Matches
2196,Alexis Saelemaekers,BEL,"FW,DF",Milan,Serie A,20,1999,7.6,14,8,5,7,2,6,20,30.0,14,13,1,12,8,22,1,0,Matches
2197,Jorge Sáenz,ESP,DF,Celta Vigo,La Liga,22,1996,4.1,6,1,4,2,0,3,5,60.0,2,5,2,3,10,16,15,0,Matches
2198,Nuri Şahin,TUR,MF,Werder Bremen,Bundesliga,30,1988,13.9,27,16,10,14,3,11,35,31.4,24,15,7,8,37,64,38,0,Matches
2199,Wesley Saïd,FRA,"MF,FW",Toulouse,Ligue 1,24,1995,12.9,20,9,8,10,2,2,13,15.4,11,6,0,6,9,29,8,0,Matches
2200,Allan Saint-Maximin,FRA,"MF,FW",Newcastle Utd,Premier League,22,1997,20.7,13,8,7,4,2,4,18,22.2,14,5,2,3,9,22,6,0,Matches
2201,Théo Sainte-Luce,FRA,"MF,DF",Nîmes,Ligue 1,20,1998,0.2,0,0,0,0,0,0,0,,0,0,0,0,0,0,0,0,Matches
2202,Borja Sainz,ESP,"MF,FW",Alavés,La Liga,18,2001,6.4,16,9,4,9,3,8,26,30.8,18,14,0,14,3,19,0,0,Matches
2203,Romain Saïss,MAR,DF,Wolves,Premier League,29,1990,30.1,55,38,37,15,3,32,46,69.6,14,31,16,15,55,110,127,3,Matches
2204,Bukayo Saka,ENG,"DF,FW",Arsenal,Premier League,17,2001,19.5,36,21,21,8,7,19,37,51.4,18,12,3,9,12,48,19,0,Matches
2205,Hiroki Sakai,JPN,DF,Marseille,Ligue 1,29,1990,18.0,57,36,26,24,7,25,40,62.5,15,20,5,15,23,80,34,1,Matches
2206,Mamadou Sakho,FRA,DF,Crystal Palace,Premier League,29,1990,10.3,7,5,5,1,1,2,5,40.0,3,12,5,7,20,27,46,2,Matches
2207,Jacopo Sala,ITA,DF,SPAL,Serie A,27,1991,9.5,29,24,17,11,1,17,31,54.8,14,4,0,4,13,42,15,1,Matches
2208,Mohamed Salah,EGY,FW,Liverpool,Premier League,27,1992,32.0,16,6,1,4,11,5,22,22.7,17,3,1,2,8,24,2,1,Matches
2209,Bartosz Salamon,POL,DF,SPAL,Serie A,28,1991,3.8,2,1,2,0,0,1,2,50.0,1,4,4,0,6,8,14,0,Matches
2210,Eddie Salcedo,ITA,"FW,MF",Hellas Verona,Serie A,17,2001,7.6,3,1,2,0,1,0,5,0.0,5,4,0,4,1,4,2,0,Matches
2211,William Saliba,FRA,DF,Saint-Étienne,Ligue 1,18,2001,11.0,19,9,15,3,1,5,10,50.0,5,13,4,9,21,40,36,1,Matches
2212,Yannis Salibur,FRA,"MF,FW",Mallorca,La Liga,28,1991,0.9,0,0,0,0,0,0,4,0.0,4,0,0,0,1,1,1,0,Matches
2213,Romain Salin,FRA,GK,Rennes,Ligue 1,35,1984,4.0,0,0,0,0,0,0,1,0.0,1,0,0,0,0,0,3,0,Matches
2214,Mohammed Salisu,GHA,DF,Valladolid,La Liga,20,1999,30.3,41,24,28,13,0,21,34,61.8,13,32,26,6,35,76,158,3,Matches
2215,Roland Sallai,HUN,"MF,FW",Freiburg,Bundesliga,22,1997,12.9,17,10,4,9,4,7,20,35.0,13,12,2,10,7,24,4,0,Matches
2216,Lazar Samardzic,SRB,"MF,FW",Hertha BSC,Bundesliga,17,2002,0.4,4,4,2,2,0,1,4,25.0,3,2,1,1,0,4,0,0,Matches
2217,Diadie Samassékou,MLI,MF,Hoffenheim,Bundesliga,23,1996,14.6,37,18,14,17,6,12,34,35.3,22,25,8,17,40,77,27,1,Matches
2218,Mbwana Samatta,TAN,FW,Aston Villa,Premier League,26,1992,10.5,6,4,0,3,3,1,8,12.5,7,7,0,7,1,7,6,0,Matches
2219,Mama Samba Baldé,GNB,"FW,MF",Dijon,Ligue 1,23,1995,18.6,24,13,9,8,7,7,30,23.3,23,17,0,17,7,31,24,0,Matches
2220,Junior Sambia,FRA,"DF,MF",Montpellier,Ligue 1,22,1996,6.5,8,6,4,2,2,3,13,23.1,10,4,0,4,8,16,6,0,Matches
2221,Frédéric Sammaritano,FRA,"MF,FW",Dijon,Ligue 1,33,1986,5.8,9,7,4,4,1,4,11,36.4,7,6,1,5,2,11,3,1,Matches
2222,Fede San Emeterio,ESP,MF,Valladolid,La Liga,22,1997,19.5,26,13,18,6,2,7,29,24.1,22,20,8,12,28,54,13,1,Matches
2223,Mikel San José,ESP,MF,Athletic Club,La Liga,30,1989,4.0,9,4,2,4,3,2,10,20.0,8,3,1,2,9,18,12,0,Matches
2224,Antonio Sanabria,PAR,FW,Genoa,Serie A,23,1996,15.4,14,11,2,7,5,3,14,21.4,11,13,1,12,5,19,12,1,Matches
2225,Oihan Sancet,ESP,"MF,FW",Athletic Club,La Liga,19,2000,8.2,11,7,5,4,2,4,11,36.4,7,6,0,6,2,13,2,0,Matches
2226,Renato Sanches,POR,"MF,FW",Lille,Ligue 1,21,1997,16.5,28,15,9,15,4,8,33,24.2,25,19,1,18,15,43,10,1,Matches
2227,Renato Sanches,POR,MF,Bayern Munich,Bundesliga,21,1997,0.1,0,0,0,0,0,0,0,,0,0,0,0,0,0,0,0,Matches
2228,Alexis Sánchez,CHI,FW,Inter,Serie A,30,1988,10.3,9,7,1,4,4,5,13,38.5,8,7,0,7,3,12,1,0,Matches
2229,Carlos Sánchez,COL,MF,West Ham,Premier League,33,1986,1.3,1,0,0,1,0,1,1,100.0,0,1,0,1,2,3,1,0,Matches
2230,Davinson Sánchez,COL,DF,Tottenham,Premier League,23,1996,27.0,44,27,32,12,0,22,44,50.0,22,40,28,12,34,78,128,5,Matches
2231,Germán Sánchez,ESP,DF,Granada,La Liga,32,1986,25.5,16,10,12,4,0,6,16,37.5,10,29,23,6,33,49,115,2,Matches
2232,Javi Sánchez,ESP,DF,Valladolid,La Liga,22,1997,5.5,5,4,3,2,0,1,3,33.3,2,4,2,2,4,9,24,0,Matches
2233,Manu Sánchez,ESP,DF,Atlético Madrid,La Liga,18,2000,3.6,13,7,2,7,4,8,15,53.3,7,3,0,3,7,20,1,0,Matches
2234,Víctor Sánchez,ESP,MF,Espanyol,La Liga,31,1987,18.8,66,36,36,23,7,30,71,42.3,41,31,8,23,27,93,23,1,Matches
2235,Jadon Sancho,ENG,"FW,MF",Dortmund,Bundesliga,19,2000,25.4,14,11,6,6,2,8,24,33.3,16,8,0,8,14,28,6,0,Matches
2236,Alex Sandro,BRA,DF,Juventus,Serie A,28,1991,26.5,44,26,23,14,7,12,33,36.4,21,26,6,20,47,91,46,3,Matches
2237,Leroy Sané,GER,FW,Manchester City,Premier League,23,1996,0.1,0,0,0,0,0,0,0,,0,0,0,0,0,0,0,0,Matches
2238,Salif Sané,SEN,DF,Schalke 04,Bundesliga,28,1990,12.5,16,9,12,4,0,11,19,57.9,8,19,7,12,21,37,50,0,Matches
2239,Luca Sangalli,ESP,MF,Real Sociedad,La Liga,24,1995,4.1,1,0,0,1,0,1,8,12.5,7,3,0,3,1,2,0,0,Matches
2240,Ibrahim Sangaré,CIV,MF,Toulouse,Ligue 1,21,1997,24.2,84,54,37,42,5,33,74,44.6,41,28,10,18,39,123,49,4,Matches
2241,Oier Sanjurjo,ESP,MF,Osasuna,La Liga,33,1986,25.8,65,34,21,34,10,28,64,43.8,36,33,8,25,35,100,39,1,Matches
2242,Yaya Sanogo,FRA,FW,Toulouse,Ligue 1,26,1993,10.1,6,3,2,3,1,1,2,50.0,1,4,1,3,7,13,14,0,Matches
2243,Morgan Sanson,FRA,MF,Marseille,Ligue 1,24,1994,24.1,60,28,20,29,11,13,52,25.0,39,39,5,34,23,83,9,0,Matches
2244,Nicola Sansone,ITA,"FW,MF",Bologna,Serie A,27,1991,25.2,34,20,12,18,4,15,59,25.4,44,21,0,21,11,45,9,0,Matches
2245,Baptiste Santamaria,FRA,MF,Angers,Ligue 1,24,1995,27.8,91,53,39,43,9,35,79,44.3,44,27,5,22,43,134,36,0,Matches
2246,Federico Santander,PAR,FW,Bologna,Serie A,28,1991,8.6,13,8,3,0,10,1,4,25.0,3,3,0,3,7,20,12,0,Matches
2247,Davide Santon,ITA,DF,Roma,Serie A,28,1991,6.9,11,6,6,5,0,6,17,35.3,11,2,1,1,11,22,13,0,Matches
2248,Samir Santos,BRA,DF,Udinese,Serie A,24,1994,17.2,35,27,24,8,3,12,23,52.2,11,16,6,10,33,68,64,1,Matches
2249,Riccardo Saponara,ITA,"MF,FW",Genoa,Serie A,27,1991,1.9,4,3,2,2,0,0,2,0.0,2,2,1,1,0,4,2,0,Matches
2250,Riccardo Saponara,ITA,"MF,FW",Lecce,Serie A,27,1991,10.5,12,8,4,8,0,6,13,46.2,7,2,0,2,5,17,7,0,Matches
2251,Ivan Šaponjić,SRB,"DF,FW",Atlético Madrid,La Liga,21,1997,0.1,0,0,0,0,0,0,0,,0,0,0,0,0,0,0,0,Matches
2252,Pablo Sarabia,ESP,"FW,MF",Paris S-G,Ligue 1,27,1992,12.9,12,7,3,6,3,4,25,16.0,21,19,1,18,10,22,5,0,Matches
2253,Marcelo Saracchi,URU,DF,RB Leipzig,Bundesliga,21,1998,2.0,8,6,2,5,1,5,6,83.3,1,3,1,2,1,9,5,0,Matches
2254,Josh Sargent,USA,FW,Werder Bremen,Bundesliga,19,2000,15.7,11,6,5,4,2,2,12,16.7,10,17,1,16,14,25,21,0,Matches
2255,Bouna Sarr,SEN,"DF,FW",Marseille,Ligue 1,27,1992,24.0,60,37,30,19,11,30,53,56.6,23,17,1,16,32,92,38,0,Matches
2256,Ismaila Sarr,SEN,"FW,MF",Watford,Premier League,21,1998,22.5,11,10,5,2,4,5,23,21.7,18,9,1,8,18,29,10,0,Matches
2257,Malang Sarr,FRA,DF,Nice,Ligue 1,20,1999,16.2,19,11,13,6,0,9,22,40.9,13,10,4,6,38,57,31,4,Matches
2258,Sidy Sarr,SEN,MF,Nîmes,Ligue 1,23,1996,12.9,35,18,15,16,4,11,34,32.4,23,13,3,10,15,50,18,0,Matches
2259,Joan Sastre Vanrell,ESP,DF,Mallorca,La Liga,22,1997,15.1,30,17,26,3,1,17,39,43.6,22,8,2,6,23,53,27,1,Matches
2260,Téji Savanier,FRA,MF,Montpellier,Ligue 1,27,1991,16.9,52,39,16,30,6,25,77,32.5,52,10,0,10,35,87,21,1,Matches
2261,Stefan Savić,MNE,DF,Atlético Madrid,La Liga,28,1991,22.0,22,17,11,10,1,11,18,61.1,7,16,9,7,24,46,91,1,Matches
2262,Fabian Schär,SUI,"DF,MF",Newcastle Utd,Premier League,27,1991,18.6,39,21,25,14,0,19,40,47.5,21,35,18,17,47,86,74,2,Matches
2263,Louis Schaub,AUT,MF,Köln,Bundesliga,24,1994,6.9,15,12,2,9,4,5,14,35.7,9,10,1,9,3,18,2,0,Matches
2264,Ezequiel Schelotto,ITA,DF,Brighton,Premier League,30,1989,4.0,4,3,1,2,1,2,8,25.0,6,3,0,3,7,11,14,0,Matches
2265,Patrik Schick,CZE,FW,RB Leipzig,Bundesliga,23,1996,14.4,7,3,1,3,3,2,9,22.2,7,8,2,6,2,9,17,0,Matches
2266,Julian Schieber,GER,FW,Augsburg,Bundesliga,30,1989,0.5,1,1,0,1,0,0,0,,0,0,0,0,0,1,0,0,Matches
2267,Kingsley Schindler,GHA,"FW,MF",Köln,Bundesliga,26,1993,9.4,8,5,3,5,0,4,12,33.3,8,6,1,5,6,14,17,0,Matches
2268,Xaver Schlager,AUT,MF,Wolfsburg,Bundesliga,21,1997,19.1,47,29,13,30,4,14,44,31.8,30,16,2,14,17,64,12,0,Matches
2269,Keven Schlotterbeck,GER,DF,Union Berlin,Bundesliga,22,1997,21.5,52,27,36,15,1,17,29,58.6,12,40,21,19,40,92,113,1,Matches
2270,Nico Schlotterbeck,GER,DF,Freiburg,Bundesliga,19,1999,4.1,6,3,4,2,0,2,5,40.0,3,7,5,2,3,9,20,1,Matches
2271,Jeffrey Schlupp,GHA,"FW,MF",Crystal Palace,Premier League,26,1992,11.5,18,9,10,7,1,6,16,37.5,10,11,3,8,13,31,15,0,Matches
2272,Kasper Schmeichel,DEN,GK,Leicester City,Premier League,32,1986,38.0,1,1,1,0,0,1,2,50.0,1,0,0,0,1,2,4,2,Matches
2273,Marcel Schmelzer,GER,DF,Dortmund,Bundesliga,31,1988,0.7,2,1,1,1,0,1,1,100.0,0,0,0,0,1,3,2,0,Matches
2274,Jonathan Schmid,FRA,DF,Freiburg,Bundesliga,29,1990,31.5,42,27,19,19,4,19,37,51.4,18,23,8,15,35,77,84,0,Matches
2275,Manuel Schmiedebach,GER,MF,Union Berlin,Bundesliga,30,1988,2.0,4,1,0,3,1,1,7,14.3,6,1,1,0,3,7,3,0,Matches
2276,Benno Schmitz,GER,DF,Köln,Bundesliga,24,1994,12.9,28,17,13,11,4,16,36,44.4,20,11,1,10,16,44,27,0,Matches
2277,Morgan Schneiderlin,FRA,MF,Everton,Premier League,29,1989,11.1,31,22,13,16,2,8,24,33.3,16,13,3,10,21,52,20,1,Matches
2278,Lasse Schöne,DEN,MF,Genoa,Serie A,33,1986,27.0,42,26,16,22,4,15,48,31.3,33,22,6,16,37,79,25,2,Matches
2279,Sebastian Schonlau,GER,DF,Paderborn 07,Bundesliga,24,1994,23.0,64,43,50,14,0,41,66,62.1,25,36,15,21,40,104,138,1,Matches
2280,Alessandro Schöpf,AUT,MF,Schalke 04,Bundesliga,25,1994,15.9,29,16,11,10,8,12,33,36.4,21,17,1,16,26,55,8,0,Matches
2281,Jerdy Schouten,NED,MF,Bologna,Serie A,22,1997,12.0,26,16,13,11,2,10,26,38.5,16,19,7,12,26,52,22,0,Matches
2282,Markus Schubert,GER,GK,Schalke 04,Bundesliga,21,1998,8.2,0,0,0,0,0,0,1,0.0,1,0,0,0,0,0,9,4,Matches
2283,Nico Schulz,GER,"DF,MF",Dortmund,Bundesliga,26,1993,6.6,11,7,3,6,2,8,13,61.5,5,14,4,10,9,20,9,0,Matches
2284,Alexander Schwolow,GER,GK,Freiburg,Bundesliga,27,1992,23.2,0,0,0,0,0,0,0,,0,2,0,2,1,1,8,3,Matches
2285,Matteo Scozzarella,ITA,MF,Parma,Serie A,31,1988,10.2,23,15,8,13,2,14,29,48.3,15,19,14,5,27,50,28,0,Matches
2286,Aleksandar Sedlar,SRB,DF,Mallorca,La Liga,27,1991,9.0,13,6,10,2,1,7,11,63.6,4,17,11,6,16,29,31,0,Matches
2287,Davie Selke,GER,FW,Hertha BSC,Bundesliga,24,1995,10.7,6,3,2,2,2,4,7,57.1,3,7,1,6,1,7,11,0,Matches
2288,Davie Selke,GER,FW,Werder Bremen,Bundesliga,24,1995,5.1,2,0,1,1,0,0,2,0.0,2,1,0,1,0,2,2,0,Matches
2289,Matz Sels,BEL,GK,Strasbourg,Ligue 1,27,1992,27.0,0,0,0,0,0,0,1,0.0,1,0,0,0,1,1,6,0,Matches
2290,Ken Sema,SWE,"DF,MF",Udinese,Serie A,25,1993,27.3,59,41,43,15,1,36,68,52.9,32,26,6,20,17,76,41,1,Matches
2291,Nélson Semedo,POR,DF,Barcelona,La Liga,25,1993,23.3,51,30,27,18,6,21,36,58.3,15,18,3,15,22,73,30,0,Matches
2292,Alessandro Semprini,ITA,DF,Brescia,Serie A,21,1998,7.0,10,4,7,3,0,7,9,77.8,2,10,3,7,9,19,16,0,Matches
2293,Josep Señé,ESP,MF,Mallorca,La Liga,27,1991,1.7,2,1,2,0,0,2,5,40.0,3,2,1,1,0,2,2,0,Matches
2294,Stefano Sensi,ITA,MF,Inter,Serie A,23,1995,8.0,18,10,10,7,1,6,22,27.3,16,15,1,14,9,27,4,0,Matches
2295,Luigi Sepe,ITA,GK,Parma,Serie A,28,1991,34.0,1,0,1,0,0,1,2,50.0,1,0,0,0,0,1,6,2,Matches
2296,Suat Serdar,GER,MF,Schalke 04,Bundesliga,22,1997,17.8,56,37,16,33,7,18,61,29.5,43,39,7,32,24,80,7,0,Matches
2297,Ryan Sessegnon,ENG,"DF,FW",Tottenham,Premier League,19,2000,3.8,6,4,2,4,0,3,6,50.0,3,0,0,0,3,9,12,0,Matches
2298,Salva Sevilla,ESP,MF,Mallorca,La Liga,35,1984,28.5,27,21,11,16,0,9,30,30.0,21,17,5,12,29,56,17,1,Matches
2299,Yevhen Shakhov,UKR,"MF,FW",Lecce,Serie A,28,1990,12.1,28,16,12,13,3,8,27,29.6,19,11,3,8,14,42,9,1,Matches
2300,Xherdan Shaqiri,SUI,"FW,MF",Liverpool,Premier League,27,1991,2.1,1,0,0,1,0,0,1,0.0,1,0,0,0,0,1,0,0,Matches
2301,Billy Sharp,ENG,FW,Sheffield Utd,Premier League,33,1986,11.7,6,5,2,1,3,1,6,16.7,5,2,0,2,1,7,2,0,Matches
2302,Luke Shaw,ENG,DF,Manchester Utd,Premier League,24,1995,19.3,34,18,19,11,4,19,33,57.6,14,26,6,20,24,58,56,1,Matches
2303,Khiry Shelton,USA,FW,Paderborn 07,Bundesliga,26,1993,0.4,1,1,1,0,0,0,0,,0,0,0,0,0,1,0,0,Matches
2304,Jonjo Shelvey,ENG,MF,Newcastle Utd,Premier League,27,1992,23.5,29,19,17,12,0,11,42,26.2,31,14,5,9,23,52,38,0,Matches
2305,Gen Shoji,JPN,DF,Toulouse,Ligue 1,26,1992,0.5,2,2,2,0,0,1,1,100.0,0,0,0,0,0,2,2,0,Matches
2306,Djibril Sidibé,FRA,"DF,MF",Everton,Premier League,27,1992,20.3,83,44,48,25,10,43,72,59.7,29,19,3,16,40,123,41,0,Matches
2307,Kalidou Sidibé,FRA,MF,Toulouse,Ligue 1,20,1999,1.0,3,3,0,3,0,2,5,40.0,3,0,0,0,1,4,0,0,Matches
2308,Sidnei,BRA,DF,Betis,La Liga,29,1989,13.1,23,19,17,6,0,9,14,64.3,5,15,12,3,21,44,57,0,Matches
2309,Kaj Sierhuis,NED,FW,Reims,Ligue 1,21,1998,0.1,0,0,0,0,0,0,0,,0,0,0,0,0,0,0,0,Matches
2310,Gylfi Sigurðsson,ISL,MF,Everton,Premier League,29,1989,28.4,50,26,15,24,11,19,70,27.1,51,30,4,26,37,87,17,1,Matches
2311,Luca Siligardi,ITA,"MF,FW",Parma,Serie A,31,1988,3.7,6,2,3,2,1,4,8,50.0,4,3,0,3,3,9,5,0,Matches
2312,Adrien Silva,POR,MF,Monaco,Ligue 1,30,1989,13.6,37,22,14,19,4,10,37,27.0,27,19,6,13,12,49,14,2,Matches
2313,André Silva,POR,FW,Milan,Serie A,23,1995,0.7,2,1,0,0,2,0,1,0.0,1,0,0,0,0,2,0,0,Matches
2314,André Silva,POR,FW,Eint Frankfurt,Bundesliga,23,1995,17.5,7,2,0,5,2,2,14,14.3,12,9,0,9,8,15,4,0,Matches
2315,Bernardo Silva,POR,"FW,MF",Manchester City,Premier League,24,1994,22.6,36,18,8,21,7,13,44,29.5,31,25,1,24,24,60,13,0,Matches
2316,David Silva,ESP,MF,Manchester City,Premier League,33,1986,20.3,26,14,3,15,8,10,28,35.7,18,18,3,15,13,39,5,0,Matches
2317,Gabriel Silva,BRA,DF,Saint-Étienne,Ligue 1,28,1991,2.6,4,1,1,2,1,2,3,66.7,1,2,0,2,4,8,8,0,Matches
2318,Jonathan Silva,ARG,DF,Leganés,La Liga,25,1994,30.9,60,34,32,22,6,27,52,51.9,25,12,4,8,34,94,46,0,Matches
2319,Matheus Pereira da Silva,BRA,"MF,FW",Dijon,Ligue 1,21,1998,5.2,10,6,1,6,3,4,10,40.0,6,11,0,11,6,16,5,0,Matches
2320,Rui Silva,POR,GK,Granada,La Liga,25,1994,35.0,2,1,2,0,0,2,2,100.0,0,0,0,0,2,4,22,3,Matches
2321,Thiago Silva,BRA,DF,Paris S-G,Ligue 1,34,1984,17.5,28,16,15,13,0,13,16,81.3,3,18,15,3,26,54,54,0,Matches
2322,Marco Silvestri,ITA,GK,Hellas Verona,Serie A,28,1991,35.0,1,0,1,0,0,1,2,50.0,1,0,0,0,4,5,11,1,Matches
2323,Mohamed Simakan,FRA,DF,Strasbourg,Ligue 1,19,2000,16.7,54,32,35,16,3,22,34,64.7,12,14,3,11,31,85,25,0,Matches
2324,Giovanni Simeone,ARG,FW,Cagliari,Serie A,24,1995,32.5,24,13,9,10,5,5,32,15.6,27,24,7,17,11,35,16,1,Matches
2325,Moses Simon,NGA,"FW,MF",Nantes,Ligue 1,24,1995,24.2,15,7,5,4,6,6,21,28.6,15,6,0,6,8,23,6,0,Matches
2326,Unai Simón,ESP,GK,Athletic Club,La Liga,22,1997,33.2,0,0,0,0,0,0,1,0.0,1,1,0,1,1,1,10,1,Matches
2327,Jack Simpson,ENG,DF,Bournemouth,Premier League,22,1996,2.7,5,2,4,1,0,2,8,25.0,6,1,0,1,2,7,12,1,Matches
2328,Sarpreet Singh,NZL,"FW,MF",Bayern Munich,Bundesliga,20,1999,0.8,1,0,0,1,0,0,1,0.0,1,0,0,0,0,1,0,0,Matches
2329,Wilfried Singo,CIV,DF,Torino,Serie A,18,2000,1.5,1,0,0,1,0,0,0,,0,0,0,0,1,2,2,0,Matches
2330,Daley Sinkgraven,NED,"DF,MF",Leverkusen,Bundesliga,24,1995,10.1,20,16,11,6,3,8,24,33.3,16,12,3,9,10,30,16,0,Matches
2331,Dimitris Siovas,GRE,DF,Leganés,La Liga,30,1988,21.3,42,31,24,15,3,19,28,67.9,9,14,1,13,46,88,69,0,Matches
2332,Salvatore Sirigu,ITA,GK,Torino,Serie A,32,1987,36.0,0,0,0,0,0,0,0,,0,0,0,0,2,2,12,0,Matches
2333,Ibrahima Sissoko,MLI,MF,Strasbourg,Ligue 1,21,1997,17.8,46,27,21,21,4,16,48,33.3,32,14,5,9,20,66,25,0,Matches
2334,Moussa Sissoko,FRA,MF,Tottenham,Premier League,29,1989,27.2,39,25,25,12,2,20,48,41.7,28,19,4,15,27,66,43,2,Matches
2335,Sambou Sissoko,FRA,"MF,FW",Reims,Ligue 1,20,1999,0.4,0,0,0,0,0,0,0,,0,0,0,0,1,1,2,0,Matches
2336,Pione Sisto,DEN,"FW,MF",Celta Vigo,La Liga,24,1995,9.9,17,8,5,6,6,4,19,21.1,15,18,0,18,6,23,4,1,Matches
2337,Antonio Sivera,ESP,GK,Alavés,La Liga,22,1996,3.0,0,0,0,0,0,0,0,,0,0,0,0,0,0,2,0,Matches
2338,Ellyes Skhiri,TUN,MF,Köln,Bundesliga,24,1995,29.7,74,52,30,37,7,29,77,37.7,48,47,9,38,67,141,33,0,Matches
2339,Oliver Skipp,ENG,MF,Tottenham,Premier League,18,2000,0.9,2,2,0,2,0,1,4,25.0,3,3,2,1,0,2,0,0,Matches
2340,Łukasz Skorupski,POL,GK,Bologna,Serie A,28,1991,37.0,1,0,1,0,0,0,1,0.0,1,0,0,0,2,3,15,5,Matches
2341,Andreas Skov Olsen,DEN,"FW,MF",Bologna,Serie A,19,1999,8.4,11,8,5,5,1,4,12,33.3,8,10,1,9,8,19,5,0,Matches
2342,Robert Skov,DEN,"DF,FW",Hoffenheim,Bundesliga,23,1996,29.0,41,28,30,9,2,26,50,52.0,24,26,6,20,20,61,40,0,Matches
2343,Simon Skrabb,FIN,"FW,MF",Brescia,Serie A,24,1995,2.9,7,6,2,4,1,6,12,50.0,6,4,1,3,0,7,3,0,Matches
2344,Milan Škriniar,SVK,DF,Inter,Serie A,24,1995,29.2,39,20,24,14,1,14,33,42.4,19,19,11,8,28,67,85,1,Matches
2345,Steven Skrzybski,GER,"FW,MF",Düsseldorf,Bundesliga,26,1992,5.9,4,4,2,1,1,0,16,0.0,16,10,0,10,10,14,4,0,Matches
2346,Petar Škuletić,SRB,"FW,MF",Montpellier,Ligue 1,29,1990,1.2,6,4,2,2,2,2,4,50.0,2,0,0,0,0,6,1,0,Matches
2347,Islam Slimani,ALG,FW,Monaco,Ligue 1,31,1988,14.3,8,4,0,2,6,4,15,26.7,11,5,0,5,1,9,11,1,Matches
2348,William Smallbone,IRL,MF,Southampton,Premier League,19,2000,4.4,10,5,2,8,0,5,10,50.0,5,7,1,6,1,11,2,0,Matches
2349,Chris Smalling,ENG,DF,Roma,Serie A,29,1989,28.5,25,16,15,9,1,10,13,76.9,3,44,35,9,56,81,126,2,Matches
2350,Dennis Smarsch,GER,GK,Hertha BSC,Bundesliga,20,1999,1.7,0,0,0,0,0,0,0,,0,0,0,0,0,0,1,0,Matches
2351,Adam Smith,ENG,DF,Bournemouth,Premier League,28,1991,22.8,47,32,29,16,2,23,50,46.0,27,27,6,21,25,72,64,1,Matches
2352,Emile Smith Rowe,ENG,MF,Arsenal,Premier League,19,2000,1.1,1,1,1,0,0,1,3,33.3,2,0,0,0,1,2,2,0,Matches
2353,Fyodor Smolov,RUS,FW,Celta Vigo,La Liga,29,1990,8.3,2,1,0,2,0,1,9,11.1,8,6,0,6,7,9,9,0,Matches
2354,Robert Snodgrass,SCO,"MF,FW",West Ham,Premier League,31,1987,16.8,29,16,17,10,2,13,44,29.5,31,12,1,11,4,33,11,0,Matches
2355,Cédric Soares,POR,"MF,DF",Arsenal,Premier League,27,1991,2.8,8,6,2,6,0,1,3,33.3,2,3,0,3,3,11,4,0,Matches
2356,Cédric Soares,POR,DF,Southampton,Premier League,27,1991,14.5,45,26,19,24,2,25,41,61.0,16,18,4,14,19,64,51,0,Matches
2357,Rafa Soares,POR,DF,Eibar,La Liga,24,1995,4.8,6,5,5,0,1,5,11,45.5,6,1,0,1,2,8,6,0,Matches
2358,Lasse Sobiech,GER,DF,Köln,Bundesliga,28,1991,1.0,1,0,0,0,1,0,0,,0,0,0,0,4,5,6,0,Matches
2359,Marcel Sobottka,GER,MF,Düsseldorf,Bundesliga,25,1994,7.8,15,10,6,8,1,4,13,30.8,9,9,1,8,9,24,12,0,Matches
2360,Rubén Sobrino,ESP,"FW,MF",Valencia,La Liga,27,1992,1.9,7,5,3,2,2,2,3,66.7,1,1,0,1,0,7,1,0,Matches
2361,Dominic Solanke,ENG,FW,Bournemouth,Premier League,21,1997,18.3,8,4,2,5,1,5,33,15.2,28,9,1,8,8,16,18,1,Matches
2362,Roberto Soldado,ESP,FW,Granada,La Liga,34,1985,26.1,16,9,2,7,7,7,24,29.2,17,16,4,12,4,20,16,0,Matches
2363,Carlos Soler,ESP,MF,Valencia,La Liga,22,1997,23.0,21,10,10,10,1,9,39,23.1,30,16,6,10,9,30,14,0,Matches
2364,Oumar Solet,FRA,DF,Lyon,Ligue 1,19,2000,0.1,0,0,0,0,0,0,0,,0,1,1,0,0,0,1,0,Matches
2365,Yann Sommer,SUI,GK,Gladbach,Bundesliga,30,1988,34.0,0,0,0,0,0,0,1,0.0,1,0,0,0,1,1,11,6,Matches
2366,Kévin Soni,CMR,FW,Espanyol,La Liga,21,1998,0.0,0,0,0,0,0,0,0,,0,0,0,0,0,0,0,0,Matches
2367,David Soria,ESP,GK,Getafe,La Liga,26,1993,38.0,2,1,2,0,0,2,4,50.0,2,0,0,0,3,5,17,5,Matches
2368,Bruno Soriano,ESP,"MF,FW",Villarreal,La Liga,35,1984,2.9,4,0,1,2,1,1,1,100.0,0,4,0,4,1,5,7,0,Matches
2369,Juan Soriano,ESP,GK,Leganés,La Liga,21,1997,11.0,0,0,0,0,0,0,0,,0,0,0,0,0,0,1,1,Matches
2370,Roberto Soriano,ITA,MF,Bologna,Serie A,28,1991,27.4,43,25,15,21,7,10,46,21.7,36,19,0,19,17,60,23,1,Matches
2371,Riccardo Sottil,ITA,"FW,DF",Fiorentina,Serie A,20,1999,5.7,6,4,4,2,0,3,10,30.0,7,4,0,4,0,6,0,0,Matches
2372,Tomáš Souček,CZE,MF,West Ham,Premier League,24,1995,11.6,29,15,13,15,1,10,23,43.5,13,7,1,6,22,51,35,0,Matches
2373,Adama Soumaoro,FRA,DF,Genoa,Serie A,27,1992,7.1,3,2,3,0,0,1,3,33.3,2,12,12,0,11,14,32,0,Matches
2374,Adama Soumaoro,FRA,DF,Lille,Ligue 1,27,1992,4.6,1,1,0,1,0,0,0,,0,6,5,1,4,5,17,0,Matches
2375,Boubakary Soumaré,FRA,MF,Lille,Ligue 1,20,1999,13.5,19,12,6,13,0,9,19,47.4,10,6,0,6,16,35,9,0,Matches
2376,Bryan Soumaré,FRA,"MF,FW",Dijon,Ligue 1,20,1999,4.3,12,1,6,5,1,6,9,66.7,3,1,0,1,2,14,1,0,Matches
2377,Arnaud Souquet,FRA,"DF,FW",Montpellier,Ligue 1,27,1992,22.4,62,40,45,13,4,30,67,44.8,37,20,6,14,17,79,44,0,Matches
2378,Djibril Sow,SUI,MF,Eint Frankfurt,Bundesliga,22,1997,19.4,56,33,26,17,13,16,47,34.0,31,15,3,12,30,86,9,0,Matches
2379,Çağlar Söyüncü,TUR,DF,Leicester City,Premier League,23,1996,33.7,60,40,41,18,1,27,46,58.7,19,35,19,16,43,103,156,1,Matches
2380,Nikolas Špalek,SVK,"MF,FW",Brescia,Serie A,22,1997,17.5,24,10,6,11,7,7,31,22.6,24,15,1,14,6,30,10,0,Matches
2381,Leonardo Spinazzola,ITA,DF,Roma,Serie A,26,1993,17.2,24,12,11,8,5,12,21,57.1,9,13,5,8,20,44,41,0,Matches
2382,Marco Sportiello,ITA,GK,Atalanta,Serie A,27,1992,5.8,0,0,0,0,0,0,0,,0,0,0,0,0,0,3,0,Matches
2383,Mattia Sprocati,ITA,"FW,MF",Parma,Serie A,26,1993,6.6,4,2,3,1,0,0,1,0.0,1,5,1,4,2,6,2,0,Matches
2384,Bassem Srarfi,TUN,"FW,MF",Nice,Ligue 1,22,1997,1.5,0,0,0,0,0,0,2,0.0,2,0,0,0,2,2,0,0,Matches
2385,Dennis Srbeny,GER,"MF,FW",Norwich City,Premier League,25,1994,0.5,5,5,3,2,0,1,3,33.3,2,1,0,1,0,5,1,0,Matches
2386,Dennis Srbeny,GER,"FW,MF",Paderborn 07,Bundesliga,25,1994,12.4,11,6,4,4,3,5,18,27.8,13,11,1,10,3,14,9,0,Matches
2387,Jerry St. Juste,NED,DF,Mainz 05,Bundesliga,22,1996,23.5,46,25,34,10,2,14,34,41.2,20,35,19,16,52,98,86,1,Matches
2388,Jack Stacey,ENG,DF,Bournemouth,Premier League,23,1996,17.2,21,11,9,11,1,8,22,36.4,14,27,11,16,18,39,64,1,Matches
2389,Kostas Stafylidis,GRE,DF,Hoffenheim,Bundesliga,25,1993,4.4,10,3,7,2,1,4,10,40.0,6,10,3,7,2,12,17,0,Matches
2390,Benjamin Stambouli,FRA,DF,Schalke 04,Bundesliga,28,1990,9.0,31,19,14,15,2,11,21,52.4,10,16,6,10,12,43,28,1,Matches
2391,Junior Stanislas,ENG,"MF,FW",Bournemouth,Premier League,29,1989,7.9,10,7,2,3,5,3,8,37.5,5,6,0,6,4,14,6,0,Matches
2392,Niklas Stark,GER,DF,Hertha BSC,Bundesliga,24,1995,19.2,36,20,24,10,2,9,21,42.9,12,27,12,15,21,57,97,2,Matches
2393,Jed Steer,ENG,GK,Aston Villa,Premier League,26,1992,0.1,0,0,0,0,0,0,0,,0,0,0,0,0,0,0,0,Matches
2394,Renato Steffen,SUI,"MF,FW",Wolfsburg,Bundesliga,27,1991,17.6,25,18,4,14,7,14,39,35.9,25,25,2,23,23,48,10,0,Matches
2395,Zack Steffen,USA,GK,Düsseldorf,Bundesliga,24,1995,17.0,0,0,0,0,0,0,0,,0,0,0,0,0,0,5,4,Matches
2396,Dale Stephens,ENG,MF,Brighton,Premier League,30,1989,28.1,73,44,30,37,6,25,75,33.3,50,31,11,20,58,131,42,2,Matches
2397,Jack Stephens,ENG,DF,Southampton,Premier League,25,1994,27.2,44,27,30,13,1,24,46,52.2,22,38,22,16,31,75,120,2,Matches
2398,Mariusz Stępiński,POL,"FW,MF",Hellas Verona,Serie A,24,1995,7.8,5,3,2,1,2,1,2,50.0,1,3,1,2,1,6,7,0,Matches
2399,Raheem Sterling,ENG,FW,Manchester City,Premier League,24,1994,29.5,27,15,8,10,9,6,28,21.4,22,16,2,14,15,42,4,0,Matches
2400,Enda Stevens,IRL,DF,Sheffield Utd,Premier League,29,1990,37.2,81,46,48,26,7,42,96,43.8,54,27,8,19,35,116,71,3,Matches
2401,Marco Stiepermann,GER,MF,Norwich City,Premier League,28,1991,13.1,20,8,8,9,3,5,21,23.8,16,11,3,8,5,25,16,0,Matches
2402,Lars Stindl,GER,"MF,FW",Gladbach,Bundesliga,30,1988,15.9,27,16,4,15,8,10,28,35.7,18,18,2,16,10,37,7,0,Matches
2403,Kevin Stöger,AUT,MF,Düsseldorf,Bundesliga,25,1993,14.1,21,15,10,7,4,6,24,25.0,18,24,2,22,26,47,7,1,Matches
2404,Vlatko Stojanovski,MKD,FW,Nîmes,Ligue 1,22,1997,1.4,3,3,0,3,0,1,1,100.0,0,0,0,0,0,3,1,0,Matches
2405,John Stones,ENG,DF,Manchester City,Premier League,25,1994,12.5,16,10,8,7,1,3,5,60.0,2,5,3,2,9,25,32,2,Matches
2406,Thomas Strakosha,ALB,GK,Lazio,Serie A,24,1995,38.0,0,0,0,0,0,0,1,0.0,1,0,0,0,0,0,7,2,Matches
2407,Gabriel Strefezza,BRA,"DF,MF",SPAL,Serie A,22,1997,23.4,64,40,28,26,10,22,54,40.7,32,29,3,26,21,85,17,0,Matches
2408,Tobias Strobl,GER,"MF,DF",Gladbach,Bundesliga,29,1990,6.8,9,6,5,4,0,3,8,37.5,5,8,4,4,11,20,5,0,Matches
2409,Christian Strohdiek,GER,DF,Paderborn 07,Bundesliga,31,1988,15.1,26,22,21,5,0,20,42,47.6,22,16,10,6,25,51,92,0,Matches
2410,Kevin Strootman,NED,MF,Marseille,Ligue 1,29,1990,15.7,39,27,13,23,3,20,49,40.8,29,16,1,15,17,56,24,0,Matches
2411,Jens Stryger Larsen,DEN,DF,Udinese,Serie A,28,1991,31.0,27,19,15,9,3,17,30,56.7,13,20,5,15,20,47,52,0,Matches
2412,Stefano Sturaro,ITA,MF,Genoa,Serie A,26,1993,13.9,38,22,14,19,5,15,39,38.5,24,16,4,12,10,48,26,1,Matches
2413,Damián Suárez,URU,DF,Getafe,La Liga,31,1988,28.8,62,32,32,21,9,38,72,52.8,34,25,2,23,27,89,41,0,Matches
2414,Denis Suárez,ESP,"MF,FW",Celta Vigo,La Liga,25,1994,18.1,22,15,14,7,1,10,37,27.0,27,9,1,8,14,36,12,1,Matches
2415,Luis Suárez,URU,FW,Barcelona,La Liga,32,1987,22.2,4,0,0,1,3,2,12,16.7,10,6,1,5,1,5,11,0,Matches
2416,Mathías Suárez,URU,DF,Montpellier,Ligue 1,23,1996,0.7,2,2,2,0,0,2,3,66.7,1,0,0,0,1,3,3,0,Matches
2417,Neven Subotić,SRB,DF,Union Berlin,Bundesliga,30,1988,21.8,30,18,12,16,2,8,32,25.0,24,21,8,13,34,64,89,0,Matches
2418,Isaac Success,NGA,"FW,MF",Watford,Premier League,23,1996,0.8,0,0,0,0,0,0,0,,0,0,0,0,1,1,0,0,Matches
2419,Marek Suchý,CZE,DF,Augsburg,Bundesliga,31,1988,4.4,7,5,7,0,0,4,6,66.7,2,4,1,3,6,13,15,0,Matches
2420,Niklas Süle,GER,DF,Bayern Munich,Bundesliga,23,1995,7.1,10,6,8,2,0,4,5,80.0,1,8,6,2,8,18,22,1,Matches
2421,Ki Sung-yueng,KOR,MF,Newcastle Utd,Premier League,30,1989,1.5,1,1,0,1,0,1,3,33.3,2,1,0,1,3,4,2,0,Matches
2422,Ki Sung-yueng,KOR,MF,Mallorca,La Liga,30,1989,0.1,0,0,0,0,0,0,1,0.0,1,0,0,0,0,0,0,0,Matches
2423,Stoppila Sunzu,ZAM,DF,Metz,Ligue 1,30,1989,15.0,16,8,12,4,0,10,15,66.7,5,22,15,7,24,40,63,0,Matches
2424,Andrew Surman,ENG,MF,Bournemouth,Premier League,32,1986,2.6,4,2,2,2,0,1,3,33.3,2,1,0,1,1,5,5,1,Matches
2425,Sam Surridge,ENG,"FW,MF",Bournemouth,Premier League,21,1998,0.3,0,0,0,0,0,0,0,,0,1,0,1,1,1,0,0,Matches
2426,Suso,ESP,"FW,MF",Milan,Serie A,25,1993,15.1,7,3,2,3,2,2,10,20.0,8,5,0,5,8,15,3,0,Matches
2427,Suso,ESP,"FW,MF",Sevilla,La Liga,25,1993,8.7,9,4,4,4,1,7,16,43.8,9,6,0,6,2,11,0,0,Matches
2428,Bosko Sutalo,CRO,DF,Atalanta,Serie A,19,2000,3.1,3,2,2,1,0,0,2,0.0,2,4,0,4,6,9,6,1,Matches
2429,Markus Suttner,AUT,DF,Düsseldorf,Bundesliga,32,1987,14.9,21,16,11,9,1,11,24,45.8,13,22,7,15,13,34,33,0,Matches
2430,Mattias Svanberg,SWE,MF,Bologna,Serie A,20,1999,11.7,13,8,9,4,0,6,31,19.4,25,15,4,11,13,26,10,0,Matches
2431,Issiaga Sylla,GUI,DF,Toulouse,Ligue 1,25,1994,28.0,73,49,44,21,8,40,69,58.0,29,31,7,24,67,140,90,2,Matches
2432,Moussa Sylla,MLI,FW,Monaco,Ligue 1,19,1999,0.1,0,0,0,0,0,0,0,,0,0,0,0,0,0,0,0,Matches
2433,Eddy Sylvestre,FRA,MF,Nice,Ligue 1,19,1999,0.4,0,0,0,0,0,0,1,0.0,1,0,0,0,0,0,0,0,Matches
2434,Ádám Szalai,HUN,FW,Mainz 05,Bundesliga,31,1987,12.7,8,4,0,6,2,1,11,9.1,10,9,0,9,2,10,14,0,Matches
2435,Wojciech Szczęsny,POL,GK,Juventus,Serie A,29,1990,28.8,0,0,0,0,0,0,0,,0,0,0,0,1,1,10,1,Matches
2436,Andrea Tabanelli,ITA,MF,Lecce,Serie A,29,1990,10.7,22,13,10,9,3,8,28,28.6,20,13,2,11,11,33,19,0,Matches
2437,Tachi,ESP,DF,Alavés,La Liga,21,1997,2.6,2,1,2,0,0,1,4,25.0,3,5,4,1,4,6,12,0,Matches
2438,Panagiotis Tachtsidis,GRE,MF,Lecce,Serie A,28,1991,22.3,52,27,26,20,6,20,56,35.7,36,27,11,16,35,87,32,2,Matches
2439,Jonathan Tah,GER,DF,Leverkusen,Bundesliga,23,1996,23.2,36,26,23,11,2,18,29,62.1,11,25,13,12,27,63,98,2,Matches
2440,Flavien Tait,FRA,"MF,FW",Rennes,Ligue 1,26,1993,9.8,20,13,12,6,2,9,28,32.1,19,7,0,7,9,29,5,1,Matches
2441,Madih Talal,FRA,FW,Amiens,Ligue 1,21,1997,0.2,0,0,0,0,0,0,1,0.0,1,1,0,1,0,0,2,0,Matches
2442,Adrien Tameze,CMR,MF,Atalanta,Serie A,25,1994,2.3,4,3,1,1,2,1,2,50.0,1,3,1,2,3,7,4,1,Matches
2443,Adrien Tameze,CMR,MF,Nice,Ligue 1,25,1994,5.8,6,2,2,3,1,4,16,25.0,12,7,2,5,7,13,1,1,Matches
2444,Japhet Tanganga,ENG,DF,Tottenham,Premier League,20,1999,5.8,17,9,10,6,1,10,17,58.8,7,7,6,1,11,28,31,2,Matches
2445,Adil Taoui,FRA,MF,Toulouse,Ligue 1,17,2001,0.3,2,2,0,2,0,0,2,0.0,2,0,0,0,2,4,0,0,Matches
2446,Edmond Tapsoba,BFA,DF,Leverkusen,Bundesliga,20,1999,11.8,24,15,17,5,2,15,25,60.0,10,9,5,4,9,33,44,0,Matches
2447,Matt Targett,ENG,"DF,MF",Aston Villa,Premier League,23,1995,25.5,52,29,37,11,4,22,53,41.5,31,28,8,20,56,108,82,0,Matches
2448,Rodrigo Tarín,ESP,DF,Leganés,La Liga,23,1996,10.6,10,7,8,2,0,9,14,64.3,5,7,3,4,9,19,51,0,Matches
2449,James Tarkowski,ENG,DF,Burnley,Premier League,26,1992,38.0,66,43,47,19,0,31,54,57.4,23,63,47,16,63,129,204,4,Matches
2450,Ciprian Tătărușanu,ROU,GK,Lyon,Ligue 1,33,1986,2.0,0,0,0,0,0,0,0,,0,0,0,0,0,0,0,1,Matches
2451,Júlio Tavares,CPV,FW,Dijon,Ligue 1,30,1988,22.2,12,8,1,6,5,4,17,23.5,13,9,2,7,8,20,29,0,Matches
2452,Charlie Taylor,ENG,DF,Burnley,Premier League,25,1993,21.6,39,24,26,9,4,19,39,48.7,20,29,9,20,29,68,78,1,Matches
2453,Neil Taylor,WAL,DF,Aston Villa,Premier League,30,1989,12.1,16,11,12,4,0,11,20,55.0,9,15,5,10,20,36,43,0,Matches
2454,Aurélien Tchouaméni,FRA,MF,Bordeaux,Ligue 1,19,2000,12.3,30,14,15,13,2,11,27,40.7,16,11,3,8,13,43,19,1,Matches
2455,Aurélien Tchouaméni,FRA,MF,Monaco,Ligue 1,19,2000,0.7,0,0,0,0,0,0,2,0.0,2,0,0,0,0,0,2,1,Matches
2456,Georg Teigl,AUT,"DF,MF",Augsburg,Bundesliga,28,1991,1.2,3,1,1,2,0,2,4,50.0,2,0,0,0,3,6,1,0,Matches
2457,Álvaro Tejero,ESP,DF,Eibar,La Liga,23,1996,16.1,30,18,17,10,3,14,23,60.9,9,17,4,13,28,58,38,0,Matches
2458,Bernard Tekpetey,GHA,"FW,MF",Düsseldorf,Bundesliga,21,1997,5.0,4,4,1,2,1,0,2,0.0,2,5,0,5,2,6,0,0,Matches
2459,Nathan Tella,NGA,FW,Southampton,Premier League,20,1999,0.0,0,0,0,0,0,0,0,,0,0,0,0,0,0,0,0,Matches
2460,Cristian Tello,ESP,"MF,FW",Betis,La Liga,27,1991,8.7,8,5,2,2,4,4,8,50.0,4,5,0,5,4,12,0,0,Matches
2461,Lino Tempelmann,GER,MF,Freiburg,Bundesliga,20,1999,0.4,1,0,1,0,0,1,1,100.0,0,1,1,0,0,1,0,0,Matches
2462,Łukasz Teodorczyk,POL,FW,Udinese,Serie A,28,1991,2.5,7,5,1,5,1,3,7,42.9,4,2,0,2,0,7,1,0,Matches
2463,Hidde ter Avest,NED,DF,Udinese,Serie A,22,1997,7.6,18,9,13,3,2,14,17,82.4,3,6,1,5,9,27,27,0,Matches
2464,Marc-André ter Stegen,GER,GK,Barcelona,La Liga,27,1992,36.0,2,2,2,0,0,2,3,66.7,1,0,0,0,2,4,17,6,Matches
2465,Simon Terodde,GER,FW,Köln,Bundesliga,31,1988,9.0,8,5,4,3,1,3,13,23.1,10,14,3,11,2,10,14,0,Matches
2466,Pietro Terracciano,ITA,GK,Fiorentina,Serie A,29,1990,6.9,0,0,0,0,0,0,0,,0,0,0,0,0,0,4,0,Matches
2467,Martin Terrier,FRA,"FW,MF",Lyon,Ligue 1,22,1997,13.3,20,15,7,10,3,3,14,21.4,11,14,1,13,10,30,11,0,Matches
2468,Aleksa Terzić,SRB,MF,Fiorentina,Serie A,19,1999,0.1,0,0,0,0,0,0,0,,0,0,0,0,0,0,0,0,Matches
2469,Kenny Tete,NED,DF,Lyon,Ligue 1,23,1995,11.9,33,21,12,16,5,15,23,65.2,8,12,3,9,19,52,34,0,Matches
2470,Alexander Tettey,NOR,"MF,DF",Norwich City,Premier League,33,1986,26.0,23,18,7,16,0,11,39,28.2,28,20,9,11,43,66,72,1,Matches
2471,Florian Thauvin,FRA,FW,Marseille,Ligue 1,26,1993,0.2,1,0,0,1,0,0,1,0.0,1,0,0,0,0,1,0,0,Matches
2472,Demba Thiam,SEN,GK,SPAL,Serie A,21,1998,2.0,0,0,0,0,0,0,0,,0,0,0,0,1,1,0,0,Matches
2473,Malick Thiaw,GER,DF,Schalke 04,Bundesliga,17,2001,0.8,2,0,1,1,0,1,2,50.0,1,2,2,0,2,4,4,1,Matches
2474,Niclas Thiede,GER,GK,Freiburg,Bundesliga,20,1999,0.8,0,0,0,0,0,0,0,,0,0,0,0,0,0,1,0,Matches
2475,Jan Thielmann,GER,"FW,MF",Köln,Bundesliga,17,2002,6.2,9,6,2,6,1,5,12,41.7,7,8,0,8,8,17,6,0,Matches
2476,Sada Thioub,SEN,"MF,FW",Angers,Ligue 1,24,1995,16.8,20,12,8,9,3,5,18,27.8,13,9,1,8,4,24,5,0,Matches
2477,Jordan Thomas,ENG,FW,Norwich City,Premier League,18,2001,0.0,0,0,0,0,0,0,0,,0,0,0,0,0,0,0,0,Matches
2478,Luke Thomas,ENG,"MF,DF",Leicester City,Premier League,18,2001,3.0,1,0,0,1,0,0,3,0.0,3,2,0,2,3,4,7,0,Matches
2479,Romain Thomas,FRA,DF,Angers,Ligue 1,31,1988,26.0,24,17,16,7,1,8,18,44.4,10,35,18,17,39,63,118,1,Matches
2480,Adrien Thomasson,FRA,"MF,FW",Strasbourg,Ligue 1,25,1993,23.0,36,21,11,16,9,15,47,31.9,32,21,1,20,9,45,9,0,Matches
2481,Erik Thommy,GER,"MF,FW",Düsseldorf,Bundesliga,24,1994,25.1,40,23,16,16,8,15,39,38.5,24,23,2,21,16,56,20,1,Matches
2482,Max Thompson,ENG,FW,Burnley,Premier League,17,2002,0.0,0,0,0,0,0,0,0,,0,0,0,0,0,0,0,0,Matches
2483,Morten Thorsby,NOR,"MF,DF",Sampdoria,Serie A,23,1996,20.7,53,34,17,23,13,27,52,51.9,25,24,6,18,17,70,34,0,Matches
2484,Khéphren Thuram,FRA,MF,Nice,Ligue 1,18,2001,6.6,22,7,14,8,0,6,17,35.3,11,12,2,10,7,29,13,0,Matches
2485,Marcus Thuram,FRA,FW,Gladbach,Bundesliga,21,1997,24.5,26,18,7,8,11,11,29,37.9,18,20,1,19,12,38,18,0,Matches
2486,Youri Tielemans,BEL,MF,Leicester City,Premier League,22,1997,31.4,52,29,17,30,5,24,74,32.4,50,43,4,39,22,74,18,0,Matches
2487,Kieran Tierney,SCO,"DF,MF",Arsenal,Premier League,22,1997,11.0,20,16,13,6,1,11,15,73.3,4,10,4,6,9,29,37,1,Matches
2488,Cheick Timite,CIV,"MF,FW",Amiens,Ligue 1,21,1997,1.3,1,0,0,1,0,0,1,0.0,1,0,0,0,2,3,1,0,Matches
2489,David Timor,ESP,"MF,DF",Getafe,La Liga,29,1989,10.5,9,6,4,5,0,5,16,31.3,11,8,3,5,18,27,23,0,Matches
2490,Marcel Tisserand,COD,DF,Wolfsburg,Bundesliga,26,1993,13.4,21,10,14,5,2,7,12,58.3,5,13,4,9,32,53,49,2,Matches
2491,Jean-Clair Todibo,FRA,DF,Barcelona,La Liga,19,1999,0.9,1,0,1,0,0,0,1,0.0,1,0,0,0,0,1,6,0,Matches
2492,Jean-Clair Todibo,FRA,DF,Schalke 04,Bundesliga,19,1999,4.1,15,10,10,5,0,8,9,88.9,1,2,0,2,15,30,24,0,Matches
2493,Karl Toko Ekambi,CMR,FW,Villarreal,La Liga,26,1992,11.0,5,3,0,3,2,1,4,25.0,3,2,0,2,3,8,2,0,Matches
2494,Karl Toko Ekambi,CMR,"FW,MF",Lyon,Ligue 1,26,1992,6.0,5,2,0,1,4,3,5,60.0,2,2,0,2,5,10,1,0,Matches
2495,Corentin Tolisso,FRA,MF,Bayern Munich,Bundesliga,24,1994,7.1,9,4,4,3,2,1,9,11.1,8,9,3,6,4,13,2,1,Matches
2496,Jeremy Toljan,GER,DF,Sassuolo,Serie A,24,1994,24.3,37,21,24,10,3,18,35,51.4,17,23,12,11,18,55,58,1,Matches
2497,Rafael Tolói,ITA,DF,Atalanta,Serie A,28,1990,29.0,56,29,28,23,5,33,76,43.4,43,31,17,14,45,101,80,0,Matches
2498,Raúl de Tomás,ESP,FW,Espanyol,La Liga,24,1994,11.9,9,7,3,4,2,4,13,30.8,9,8,1,7,10,19,4,0,Matches
2499,Takehiro Tomiyasu,JPN,DF,Bologna,Serie A,20,1998,28.1,42,24,25,13,4,22,41,53.7,19,34,9,25,49,91,78,1,Matches
2500,James Tomkins,ENG,DF,Crystal Palace,Premier League,30,1989,17.6,29,17,21,8,0,18,25,72.0,7,17,15,2,21,50,103,0,Matches
2501,Fikayo Tomori,ENG,DF,Chelsea,Premier League,21,1997,14.3,29,16,21,8,0,10,15,66.7,5,13,7,6,22,51,48,2,Matches
2502,Nenad Tomović,SRB,DF,SPAL,Serie A,31,1987,19.5,26,19,18,6,2,10,21,47.6,11,32,23,9,30,56,65,1,Matches
2503,Sandro Tonali,ITA,MF,Brescia,Serie A,19,2000,33.5,39,25,16,20,3,16,55,29.1,39,36,14,22,41,80,42,0,Matches
2504,Lorenzo Tonelli,ITA,DF,Sampdoria,Serie A,29,1990,7.8,13,9,13,0,0,4,10,40.0,6,10,7,3,4,17,23,0,Matches
2505,Toño,ESP,DF,Levante,La Liga,29,1989,17.7,26,19,18,7,1,15,28,53.6,13,11,3,8,13,39,34,1,Matches
2506,Ömer Toprak,TUR,DF,Werder Bremen,Bundesliga,30,1989,7.9,7,2,4,2,1,3,6,50.0,3,6,4,2,12,19,41,0,Matches
2507,Ernesto Torregrossa,VEN,FW,Brescia,Serie A,27,1992,20.5,17,7,5,10,2,6,22,27.3,16,10,2,8,5,22,22,0,Matches
2508,Lucas Torreira,URU,MF,Arsenal,Premier League,23,1996,16.8,31,16,11,15,5,16,39,41.0,23,24,8,16,34,65,24,0,Matches
2509,Ferrán Torres,ESP,"MF,FW",Valencia,La Liga,19,2000,25.0,23,15,6,16,1,8,30,26.7,22,20,3,17,14,37,12,0,Matches
2510,Óliver Torres,ESP,"MF,FW",Sevilla,La Liga,24,1994,17.7,45,27,12,26,7,23,60,38.3,37,23,1,22,13,58,9,1,Matches
2511,Pau Torres,ESP,DF,Villarreal,La Liga,22,1997,33.0,34,21,24,10,0,16,24,66.7,8,39,23,16,27,61,153,1,Matches
2512,Roberto Torres,ESP,"MF,FW",Osasuna,La Liga,30,1989,30.2,33,16,12,18,3,21,49,42.9,28,41,2,39,31,64,37,0,Matches
2513,Lucas Torró,ESP,MF,Eint Frankfurt,Bundesliga,25,1994,3.7,12,7,6,6,0,8,16,50.0,8,2,1,1,8,20,3,0,Matches
2514,Jordan Torunarigha,GER,DF,Hertha BSC,Bundesliga,21,1997,16.2,32,19,21,11,0,18,27,66.7,9,33,18,15,31,63,75,0,Matches
2515,Cenk Tosun,TUR,FW,Crystal Palace,Premier League,28,1991,2.0,2,2,2,0,0,0,2,0.0,2,0,0,0,0,2,1,0,Matches
2516,Cenk Tosun,TUR,FW,Everton,Premier League,28,1991,3.2,2,0,0,0,2,0,1,0.0,1,1,0,1,0,2,1,0,Matches
2517,Abdoulaye Touré,GUI,MF,Nantes,Ligue 1,25,1994,24.7,32,21,10,21,1,10,30,33.3,20,31,11,20,29,61,18,1,Matches
2518,Almamy Touré,MLI,DF,Eint Frankfurt,Bundesliga,23,1996,16.6,32,19,18,11,3,11,22,50.0,11,18,7,11,23,55,54,1,Matches
2519,Lucas Tousart,FRA,MF,Lyon,Ligue 1,22,1997,19.6,58,32,19,34,5,17,56,30.4,39,19,7,12,31,89,27,1,Matches
2520,Andros Townsend,ENG,"FW,MF",Crystal Palace,Premier League,28,1991,14.4,34,21,12,17,5,15,37,40.5,22,18,0,18,15,49,10,1,Matches
2521,Aleksandar Trajkovski,MKD,"MF,FW",Mallorca,La Liga,26,1992,3.7,2,0,1,1,0,1,7,14.3,6,2,0,2,3,5,1,0,Matches
2522,Adama Traoré,ESP,"FW,DF",Wolves,Premier League,23,1996,28.9,33,21,6,14,13,8,23,34.8,15,19,3,16,13,46,14,2,Matches
2523,Adama Traoré,MLI,"FW,MF",Metz,Ligue 1,24,1995,11.2,3,1,1,2,0,3,12,25.0,9,7,2,5,3,6,5,0,Matches
2524,Adama Traoré,MLI,MF,Monaco,Ligue 1,24,1995,0.3,0,0,0,0,0,0,0,,0,0,0,0,1,1,0,0,Matches
2525,Bertrand Traoré,BFA,"FW,MF",Lyon,Ligue 1,23,1995,13.9,27,14,8,12,7,8,19,42.1,11,17,2,15,21,48,16,0,Matches
2526,Charles Traore,MLI,DF,Nantes,Ligue 1,27,1992,19.3,48,35,27,19,2,36,61,59.0,25,21,4,17,39,87,64,0,Matches
2527,Hamari Traoré,MLI,DF,Rennes,Ligue 1,27,1992,26.8,55,26,34,18,3,32,64,50.0,32,22,5,17,48,103,59,1,Matches
2528,Ibrahima Traoré,GUI,"FW,MF",Gladbach,Bundesliga,31,1988,1.7,4,3,1,1,2,1,7,14.3,6,1,0,1,1,5,3,0,Matches
2529,Ismaël Traoré,CIV,DF,Angers,Ligue 1,32,1986,22.8,23,12,14,7,2,10,17,58.8,7,23,13,10,27,50,85,1,Matches
2530,Kevin Trapp,GER,GK,Eint Frankfurt,Bundesliga,29,1990,22.0,0,0,0,0,0,0,1,0.0,1,0,0,0,3,3,5,0,Matches
2531,Miguel Trauco,PER,DF,Saint-Étienne,Ligue 1,26,1992,16.4,32,20,16,12,4,19,44,43.2,25,8,1,7,23,55,25,0,Matches
2532,Mark Travers,IRL,GK,Bournemouth,Premier League,20,1999,1.0,0,0,0,0,0,0,0,,0,0,0,0,0,0,1,1,Matches
2533,Luca Tremolada,ITA,MF,Brescia,Serie A,27,1991,0.2,0,0,0,0,0,0,0,,0,0,0,0,0,0,0,0,Matches
2534,Trézéguet,EGY,"FW,MF",Aston Villa,Premier League,24,1994,21.7,38,16,18,15,5,9,44,20.5,35,23,2,21,25,63,18,0,Matches
2535,Manu Trigueros,ESP,MF,Villarreal,La Liga,27,1991,17.2,34,21,10,17,7,12,45,26.7,33,23,12,11,4,38,21,0,Matches
2536,Christopher Trimmel,AUT,"DF,MF",Union Berlin,Bundesliga,32,1987,31.8,71,41,35,32,4,32,54,59.3,22,31,10,21,51,122,88,1,Matches
2537,Alessandro Tripaldelli,ITA,DF,Sassuolo,Serie A,20,1999,1.5,4,4,1,3,0,1,3,33.3,2,1,0,1,3,7,3,0,Matches
2538,Kieran Trippier,ENG,DF,Atlético Madrid,La Liga,28,1990,22.0,52,34,24,21,7,34,53,64.2,19,33,7,26,24,76,46,0,Matches
2539,William Troost-Ekong,NGA,DF,Udinese,Serie A,25,1993,28.6,37,19,25,12,0,10,18,55.6,8,41,29,12,31,68,135,2,Matches
2540,Leandro Trossard,BEL,"FW,MF",Brighton,Premier League,24,1994,22.3,22,17,7,12,3,6,38,15.8,32,16,1,15,9,31,8,0,Matches
2541,Tom Trybull,GER,MF,Norwich City,Premier League,26,1993,12.6,39,25,15,18,6,16,60,26.7,44,20,5,15,16,55,35,0,Matches
2542,Axel Tuanzebe,COD,DF,Manchester Utd,Premier League,21,1997,2.1,2,2,0,2,0,1,2,50.0,1,1,0,1,5,7,5,1,Matches
2543,Georgi Tunjov,EST,MF,SPAL,Serie A,18,2001,3.2,4,4,3,1,0,1,11,9.1,10,3,1,2,1,5,0,0,Matches
2544,Stefano Turati,ITA,GK,Sassuolo,Serie A,17,2001,2.0,0,0,0,0,0,0,0,,0,0,0,0,0,0,1,0,Matches
2545,Gennaro Tutino,ITA,"FW,MF",Hellas Verona,Serie A,22,1996,2.5,0,0,0,0,0,0,0,,0,0,0,0,2,2,1,0,Matches
2546,Matthieu Udol,FRA,DF,Metz,Ligue 1,23,1996,12.2,29,19,19,8,2,13,24,54.2,11,21,4,17,23,52,43,0,Matches
2547,Hwang Ui-jo,KOR,"FW,MF",Bordeaux,Ligue 1,26,1992,18.1,9,7,2,5,2,4,20,20.0,16,7,0,7,5,14,5,0,Matches
2548,Anthony Ujah,NGA,"FW,MF",Union Berlin,Bundesliga,28,1990,10.5,8,6,4,2,2,1,6,16.7,5,0,0,0,3,11,10,0,Matches
2549,Samir Ujkani,KVX,GK,Torino,Serie A,31,1988,1.0,0,0,0,0,0,0,0,,0,0,0,0,0,0,1,0,Matches
2550,Sven Ulreich,GER,GK,Bayern Munich,Bundesliga,30,1988,1.0,0,0,0,0,0,0,0,,0,0,0,0,0,0,0,0,Matches
2551,Samuel Umtiti,FRA,DF,Barcelona,La Liga,25,1993,10.5,11,5,5,5,1,5,8,62.5,3,4,2,2,22,33,32,0,Matches
2552,Enes Ünal,TUR,FW,Valladolid,La Liga,22,1997,26.0,20,12,6,11,3,6,28,21.4,22,17,5,12,6,26,13,0,Matches
2553,Cengiz Ünder,TUR,FW,Roma,Serie A,22,1997,9.7,10,6,4,4,2,2,9,22.2,7,7,2,5,8,18,7,0,Matches
2554,Dayot Upamecano,FRA,DF,RB Leipzig,Bundesliga,20,1998,26.2,52,31,37,15,0,23,43,53.5,20,31,17,14,43,95,88,1,Matches
2555,Mark Uth,GER,"MF,FW",Köln,Bundesliga,27,1991,12.9,19,12,4,10,5,9,32,28.1,23,15,0,15,7,26,3,0,Matches
2556,Mark Uth,GER,"FW,MF",Schalke 04,Bundesliga,27,1991,3.9,3,2,1,1,1,0,3,0.0,3,4,0,4,1,4,0,0,Matches
2557,Tomáš Vaclík,CZE,GK,Sevilla,La Liga,30,1989,32.5,0,0,0,0,0,0,1,0.0,1,0,0,0,0,0,7,0,Matches
2558,Álvaro Vadillo,ESP,"FW,MF",Granada,La Liga,24,1994,13.5,16,11,6,8,2,9,16,56.3,7,12,0,12,7,23,2,0,Matches
2559,William Vainqueur,FRA,MF,Toulouse,Ligue 1,30,1988,19.1,68,36,30,32,6,22,60,36.7,38,21,5,16,29,97,23,0,Matches
2560,Mirko Valdifiori,ITA,MF,SPAL,Serie A,33,1986,15.6,31,15,14,17,0,16,33,48.5,17,8,3,5,4,35,25,0,Matches
2561,Pierrick Valdivia,FRA,MF,Nîmes,Ligue 1,31,1988,0.8,1,1,0,0,1,0,1,0.0,1,0,0,0,0,1,0,0,Matches
2562,Germán Valera,ESP,FW,Atlético Madrid,La Liga,17,2002,0.0,0,0,0,0,0,0,0,,0,1,0,1,0,0,0,0,Matches
2563,Antoine Valerio,FRA,MF,Nîmes,Ligue 1,19,1999,1.0,1,1,0,1,0,0,2,0.0,2,2,0,2,3,4,1,0,Matches
2564,Borja Valero,ESP,MF,Inter,Serie A,34,1985,10.3,18,7,9,3,6,6,24,25.0,18,12,3,9,8,26,9,0,Matches
2565,Yan Valery,TUN,DF,Southampton,Premier League,20,1999,8.7,20,7,9,7,4,11,19,57.9,8,9,1,8,13,33,32,2,Matches
2566,Martin Valjent,SVK,DF,Mallorca,La Liga,23,1995,35.4,25,17,14,10,1,13,25,52.0,12,39,27,12,37,62,146,1,Matches
2567,Jesús Vallejo,ESP,DF,Wolves,Premier League,22,1997,1.8,1,1,1,0,0,1,2,50.0,1,4,3,1,2,3,8,1,Matches
2568,Jesús Vallejo,ESP,DF,Granada,La Liga,22,1997,7.0,6,5,4,2,0,3,4,75.0,1,7,4,3,5,11,28,0,Matches
2569,Manu Vallejo,ESP,"MF,FW",Valencia,La Liga,22,1997,4.6,7,3,0,3,4,5,9,55.6,4,4,0,4,2,9,2,0,Matches
2570,Luca Valls,FRA,MF,Nîmes,Ligue 1,20,1998,0.1,1,0,1,0,0,1,1,100.0,0,1,0,1,0,1,0,0,Matches
2571,Theo Valls,FRA,MF,Nîmes,Ligue 1,23,1995,18.1,39,16,12,26,1,16,50,32.0,34,17,0,17,13,52,6,0,Matches
2572,Mattia Valoti,ITA,"MF,FW",SPAL,Serie A,25,1993,17.0,48,30,21,25,2,16,43,37.2,27,27,6,21,16,64,18,0,Matches
2573,Federico Valverde,URU,MF,Real Madrid,La Liga,21,1998,21.2,38,19,9,19,10,12,36,33.3,24,38,4,34,21,59,12,2,Matches
2574,Virgil van Dijk,NED,DF,Liverpool,Premier League,28,1991,38.0,23,12,18,5,0,6,13,46.2,7,20,15,5,40,63,166,2,Matches
2575,Raphaël Varane,FRA,DF,Real Madrid,La Liga,26,1993,31.4,30,17,15,14,1,12,23,52.2,11,32,16,16,31,61,124,0,Matches
2576,Jamie Vardy,ENG,FW,Leicester City,Premier League,32,1987,33.7,15,12,0,9,6,2,4,50.0,2,22,4,18,2,17,22,0,Matches
2577,Matías Vargas,ARG,"FW,MF",Espanyol,La Liga,22,1997,11.4,13,5,7,3,3,4,23,17.4,19,12,2,10,3,16,5,0,Matches
2578,Ruben Vargas,SUI,"FW,MF",Augsburg,Bundesliga,20,1998,28.1,32,16,18,7,7,8,36,22.2,28,26,1,25,26,58,35,0,Matches
2579,Thibaut Vargas,FRA,"DF,MF",Montpellier,Ligue 1,19,2000,1.7,3,1,3,0,0,2,5,40.0,3,1,1,0,0,3,3,0,Matches
2580,Sebastian Vasiliadis,GRE,MF,Paderborn 07,Bundesliga,21,1997,31.2,73,45,34,31,8,28,81,34.6,53,47,6,41,34,107,50,0,Matches
2581,Indiana Vassilev,USA,"FW,MF",Aston Villa,Premier League,18,2001,0.6,0,0,0,0,0,0,0,,0,0,0,0,0,0,0,0,Matches
2582,Denis Vavro,SVK,DF,Lazio,Serie A,23,1996,3.6,3,3,2,1,0,1,3,33.3,2,8,6,2,5,8,10,0,Matches
2583,Franco Vázquez,ARG,"MF,FW",Sevilla,La Liga,30,1989,12.2,25,17,9,14,2,6,36,16.7,30,13,0,13,10,35,10,0,Matches
2584,Kevin Vázquez,ESP,DF,Celta Vigo,La Liga,26,1993,14.7,26,15,16,6,4,15,28,53.6,13,18,1,17,26,52,28,0,Matches
2585,Lucas Vázquez,ESP,"MF,FW",Real Madrid,La Liga,28,1991,9.4,23,17,10,13,0,11,26,42.3,15,10,0,10,10,33,8,1,Matches
2586,Matías Vecino,URU,MF,Inter,Serie A,27,1991,14.2,31,20,14,11,6,9,36,25.0,27,20,3,17,15,46,26,0,Matches
2587,Koke Vegas,ESP,GK,Levante,La Liga,23,1995,2.0,0,0,0,0,0,0,1,0.0,1,0,0,0,0,0,3,0,Matches
2588,Miloš Veljković,SRB,DF,Werder Bremen,Bundesliga,23,1995,22.8,55,33,36,18,1,33,53,62.3,20,25,11,14,26,81,92,1,Matches
2589,Miguel Veloso,POR,MF,Hellas Verona,Serie A,33,1986,31.2,52,29,20,28,4,18,60,30.0,42,36,12,24,32,84,46,1,Matches
2590,Unai Vencedor Paris,ESP,MF,Athletic Club,La Liga,18,2000,0.8,0,0,0,0,0,0,0,,0,0,0,0,0,0,0,0,Matches
2591,Lorenzo Venuti,ITA,"DF,MF",Fiorentina,Serie A,24,1995,9.5,20,10,12,6,2,13,19,68.4,6,5,1,4,11,31,15,0,Matches
2592,Brayan Vera,COL,"DF,FW",Lecce,Serie A,20,1999,1.7,4,1,2,1,1,3,7,42.9,4,1,0,1,1,5,4,0,Matches
2593,Simone Verdi,ITA,"MF,FW",Torino,Serie A,27,1992,23.0,19,10,4,12,3,9,38,23.7,29,14,0,14,7,26,1,0,Matches
2594,Jordan Veretout,FRA,MF,Roma,Serie A,26,1993,29.2,36,18,13,16,7,14,43,32.6,29,35,5,30,18,54,31,1,Matches
2595,Marco Verratti,ITA,MF,Paris S-G,Ligue 1,26,1992,16.5,54,32,22,22,10,20,56,35.7,36,23,3,20,19,73,9,0,Matches
2596,Valerio Verre,ITA,"MF,FW",Hellas Verona,Serie A,25,1994,19.7,25,15,4,11,10,9,23,39.1,14,5,0,5,13,38,9,0,Matches
2597,Birger Verstraete,BEL,MF,Köln,Bundesliga,25,1994,7.4,20,11,9,10,1,11,21,52.4,10,8,1,7,4,24,10,1,Matches
2598,Jan Vertonghen,BEL,DF,Tottenham,Premier League,32,1987,18.3,40,24,25,14,1,20,31,64.5,11,18,10,8,33,73,68,0,Matches
2599,Mikel Vesga,ESP,MF,Athletic Club,La Liga,26,1993,14.1,25,17,7,12,6,9,45,20.0,36,18,7,11,31,56,24,1,Matches
2600,Jannik Vestergaard,DEN,DF,Southampton,Premier League,26,1992,16.6,19,12,14,5,0,11,28,39.3,17,15,9,6,26,45,99,2,Matches
2601,Rúben Vezo,POR,DF,Levante,La Liga,25,1994,29.0,41,24,28,13,0,19,35,54.3,16,37,29,8,42,83,144,2,Matches
2602,Francesco Vicari,ITA,DF,SPAL,Serie A,24,1994,32.2,27,13,20,6,1,12,25,48.0,13,48,37,11,38,65,145,1,Matches
2603,Fede Vico,ESP,"MF,FW",Granada,La Liga,25,1994,9.7,5,1,2,3,0,2,11,18.2,9,12,1,11,5,10,2,0,Matches
2604,Aleix Vidal,ESP,MF,Alavés,La Liga,29,1989,24.1,21,14,8,11,2,8,37,21.6,29,14,1,13,23,44,18,0,Matches
2605,Arturo Vidal,CHI,MF,Barcelona,La Liga,32,1987,18.6,63,38,22,30,11,24,58,41.4,34,31,7,24,17,80,16,1,Matches
2606,Clément Vidal,FRA,DF,Montpellier,Ligue 1,19,2000,1.0,0,0,0,0,0,0,2,0.0,2,1,1,0,0,0,6,0,Matches
2607,Nacho Vidal,ESP,DF,Osasuna,La Liga,24,1995,25.9,45,29,26,13,6,21,38,55.3,17,24,6,18,44,89,70,1,Matches
2608,Ronaldo Vieira,ENG,MF,Sampdoria,Serie A,21,1998,20.2,33,19,13,17,3,6,28,21.4,22,14,2,12,21,54,31,0,Matches
2609,Mauro Vigorito,ITA,GK,Lecce,Serie A,29,1990,4.7,0,0,0,0,0,0,0,,0,0,0,0,0,0,3,1,Matches
2610,Dídac Vilà,ESP,DF,Espanyol,La Liga,30,1989,27.7,73,42,44,23,6,25,61,41.0,36,31,5,26,40,113,63,0,Matches
2611,Toni Villa,ESP,MF,Valladolid,La Liga,24,1995,15.0,31,16,13,14,4,13,50,26.0,37,16,1,15,8,39,11,0,Matches
2612,Asier Villalibre,ESP,FW,Athletic Club,La Liga,21,1997,5.9,0,0,0,0,0,0,3,0.0,3,3,0,3,1,1,4,0,Matches
2613,Gonzalo Villar,ESP,MF,Roma,Serie A,21,1998,3.3,5,3,4,0,1,2,4,50.0,2,2,0,2,2,7,3,0,Matches
2614,Iván Villar,ESP,GK,Celta Vigo,La Liga,22,1997,3.1,0,0,0,0,0,0,0,,0,0,0,0,0,0,5,0,Matches
2615,Juan Villar,ESP,FW,Osasuna,La Liga,31,1988,2.7,1,0,0,1,0,0,2,0.0,2,4,1,3,1,2,0,0,Matches
2616,Rúben Vinagre,POR,"MF,DF",Wolves,Premier League,20,1999,7.2,23,13,15,6,2,12,15,80.0,3,7,2,5,11,34,22,0,Matches
2617,Luigi Vitale,ITA,DF,Hellas Verona,Serie A,31,1987,0.5,1,0,0,1,0,0,0,,0,1,0,1,0,1,0,0,Matches
2618,Vitolo,ESP,"FW,MF",Atlético Madrid,La Liga,29,1989,13.6,15,12,7,7,1,5,17,29.4,12,9,0,9,10,25,9,0,Matches
2619,Mattia Viviani,ITA,MF,Brescia,Serie A,18,2000,3.8,3,1,0,3,0,1,8,12.5,7,3,3,0,9,12,2,1,Matches
2620,Dušan Vlahović,SRB,FW,Fiorentina,Serie A,19,2000,16.7,6,2,1,4,1,4,13,30.8,9,5,2,3,7,13,6,0,Matches
2621,Kevin Vogt,GER,DF,Hoffenheim,Bundesliga,27,1991,10.7,7,5,4,3,0,3,9,33.3,6,12,6,6,8,15,52,1,Matches
2622,Kevin Vogt,GER,"DF,MF",Werder Bremen,Bundesliga,27,1991,12.3,14,10,8,6,0,8,16,50.0,8,15,12,3,25,39,37,1,Matches
2623,Jake Vokins,ENG,DF,Southampton,Premier League,19,2000,1.0,2,2,0,0,2,1,1,100.0,0,0,0,0,0,2,1,0,Matches
2624,Kevin Volland,GER,FW,Leverkusen,Bundesliga,27,1992,22.7,16,6,5,6,5,5,16,31.3,11,14,2,12,5,21,7,0,Matches
2625,Mario Vrančić,BIH,MF,Norwich City,Premier League,30,1989,7.1,27,16,14,11,2,16,27,59.3,11,9,0,9,10,37,4,2,Matches
2626,Stefan de Vrij,NED,DF,Inter,Serie A,27,1992,31.4,33,18,20,12,1,14,27,51.9,13,34,24,10,52,85,121,1,Matches
2627,Giacomo Vrioni,ALB,FW,Juventus,Serie A,20,1998,0.1,0,0,0,0,0,0,0,,0,0,0,0,0,0,0,0,Matches
2628,Šime Vrsaljko,CRO,DF,Atlético Madrid,La Liga,27,1992,4.0,6,5,6,0,0,5,6,83.3,1,5,3,2,8,14,11,0,Matches
2629,Nikola Vukčević,MNE,MF,Levante,La Liga,27,1991,17.4,41,26,17,17,7,15,40,37.5,25,19,7,12,12,53,16,0,Matches
2630,Matěj Vydra,CZE,FW,Burnley,Premier League,27,1992,9.1,4,3,0,3,1,3,6,50.0,3,7,3,4,1,5,6,0,Matches
2631,Molla Wagué,MLI,DF,Nantes,Ligue 1,28,1991,7.6,15,12,11,4,0,7,7,100.0,0,10,8,2,15,30,42,0,Matches
2632,Moussa Wagué,SEN,DF,Barcelona,La Liga,20,1998,1.0,2,1,1,0,1,1,1,100.0,0,0,0,0,1,3,0,0,Matches
2633,Moussa Wagué,SEN,"DF,MF",Nice,Ligue 1,20,1998,2.2,6,4,3,3,0,2,3,66.7,1,2,1,1,2,8,2,0,Matches
2634,Wakaso,GHA,MF,Alavés,La Liga,29,1990,14.3,54,31,25,24,5,16,33,48.5,17,23,5,18,17,71,17,1,Matches
2635,Walace,BRA,MF,Udinese,Serie A,24,1995,12.7,28,9,19,6,3,13,42,31.0,29,14,6,8,33,61,19,0,Matches
2636,Theo Walcott,ENG,"MF,FW",Everton,Premier League,30,1989,14.3,13,8,6,5,2,3,15,20.0,12,13,0,13,8,21,1,0,Matches
2637,Luca Waldschmidt,GER,"FW,MF",Freiburg,Bundesliga,23,1996,14.1,10,7,3,5,2,2,18,11.1,16,11,2,9,4,14,4,0,Matches
2638,Kyle Walker,ENG,DF,Manchester City,Premier League,29,1990,26.6,28,18,12,15,1,12,29,41.4,17,15,6,9,28,56,42,1,Matches
2639,Kyle Walker-Peters,ENG,DF,Southampton,Premier League,22,1997,7.8,13,8,5,6,2,6,16,37.5,10,10,3,7,14,27,21,1,Matches
2640,Kyle Walker-Peters,ENG,DF,Tottenham,Premier League,22,1997,2.7,8,5,8,0,0,5,9,55.6,4,4,2,2,3,11,5,1,Matches
2641,Rémi Walter,FRA,MF,Nice,Ligue 1,24,1995,0.6,1,1,0,1,0,1,1,100.0,0,0,0,0,0,1,0,0,Matches
2642,Sebastian Walukiewicz,POL,DF,Cagliari,Serie A,19,2000,12.9,25,11,17,8,0,14,22,63.6,8,21,14,7,14,39,41,0,Matches
2643,Aaron Wan-Bissaka,ENG,DF,Manchester Utd,Premier League,21,1997,34.1,129,80,71,50,8,64,86,74.4,22,46,13,33,66,195,83,0,Matches
2644,Victor Wanyama,KEN,MF,Tottenham,Premier League,28,1991,0.3,0,0,0,0,0,0,0,,0,0,0,0,0,0,0,0,Matches
2645,Joel Ward,ENG,DF,Crystal Palace,Premier League,29,1989,26.5,69,42,48,16,5,39,56,69.6,17,13,6,7,48,117,93,1,Matches
2646,James Ward-Prowse,ENG,"MF,DF",Southampton,Premier League,24,1994,38.0,92,48,39,39,14,39,94,41.5,55,48,14,34,60,152,75,1,Matches
2647,Daniel Wass,DEN,"DF,MF",Valencia,La Liga,30,1989,30.4,44,25,25,13,6,25,57,43.9,32,22,5,17,31,75,91,1,Matches
2648,Kelland Watts,ENG,DF,Newcastle Utd,Premier League,19,1999,0.2,1,0,1,0,0,1,1,100.0,0,0,0,0,0,1,0,0,Matches
2649,Timothy Weah,USA,"MF,FW",Lille,Ligue 1,19,2000,0.9,0,0,0,0,0,0,1,0.0,1,0,0,0,0,0,1,0,Matches
2650,Adam Webster,ENG,DF,Brighton,Premier League,24,1995,29.6,30,17,21,8,1,14,32,43.8,18,43,26,17,45,75,110,2,Matches
2651,Wout Weghorst,NED,FW,Wolfsburg,Bundesliga,26,1992,30.4,15,8,4,5,6,1,17,5.9,16,17,4,13,2,17,30,0,Matches
2652,Julian Weigl,GER,"MF,DF",Dortmund,Bundesliga,23,1995,11.3,16,9,12,3,1,9,16,56.3,7,10,0,10,8,24,21,0,Matches
2653,Mitchell Weiser,GER,"DF,MF",Leverkusen,Bundesliga,25,1994,13.0,41,29,20,17,4,18,30,60.0,12,19,2,17,24,65,22,1,Matches
2654,Danny Welbeck,ENG,"FW,MF",Watford,Premier League,28,1990,9.1,14,6,6,5,3,3,11,27.3,8,12,1,11,5,19,7,0,Matches
2655,Wendell,BRA,"DF,MF",Leverkusen,Bundesliga,26,1993,21.1,64,42,26,26,12,41,66,62.1,25,30,4,26,36,100,36,0,Matches
2656,Oscar Wendt,SWE,DF,Gladbach,Bundesliga,33,1985,18.7,26,14,16,8,2,12,31,38.7,19,27,6,21,20,46,45,0,Matches
2657,Timo Werner,GER,FW,RB Leipzig,Bundesliga,23,1996,31.1,20,9,6,7,7,3,16,18.8,13,16,0,16,5,25,2,0,Matches
2658,Ashley Westwood,ENG,MF,Burnley,Premier League,29,1990,35.0,54,33,15,32,7,17,48,35.4,31,23,11,12,32,86,32,3,Matches
2659,Connor Wickham,ENG,"FW,MF",Crystal Palace,Premier League,26,1993,1.1,1,1,1,0,0,0,0,,0,1,0,1,1,2,0,0,Matches
2660,Felix Wiedwald,GER,GK,Eint Frankfurt,Bundesliga,29,1990,3.0,0,0,0,0,0,0,0,,0,0,0,0,0,0,2,1,Matches
2661,Georginio Wijnaldum,NED,MF,Liverpool,Premier League,28,1990,32.6,38,20,12,21,5,10,40,25.0,30,18,4,14,17,55,34,3,Matches
2662,Jetro Willems,NED,DF,Newcastle Utd,Premier League,25,1994,16.6,37,19,29,6,2,18,39,46.2,21,20,5,15,17,54,42,1,Matches
2663,William,BRA,DF,Wolfsburg,Bundesliga,24,1995,15.2,55,26,34,14,7,27,59,45.8,32,10,3,7,24,79,38,1,Matches
2664,Brandon Williams,ENG,DF,Manchester Utd,Premier League,18,2000,11.2,21,15,11,6,4,9,29,31.0,20,9,4,5,16,37,27,0,Matches
2665,Iñaki Williams,GHA,FW,Athletic Club,La Liga,25,1994,32.7,15,5,0,7,8,5,18,27.8,13,18,2,16,5,20,29,0,Matches
2666,Neco Williams,WAL,DF,Liverpool,Premier League,18,2001,2.6,5,3,1,3,1,4,5,80.0,1,3,1,2,9,14,6,0,Matches
2667,Willian,BRA,"FW,MF",Chelsea,Premier League,30,1988,28.9,45,27,14,24,7,14,43,32.6,29,15,0,15,20,65,7,0,Matches
2668,Joe Willock,ENG,"MF,FW",Arsenal,Premier League,19,1999,9.5,25,16,9,12,4,8,21,38.1,13,16,2,14,4,29,11,2,Matches
2669,Jack Wilshere,ENG,MF,West Ham,Premier League,27,1992,2.4,1,0,1,0,0,0,4,0.0,4,3,0,3,1,2,0,0,Matches
2670,Callum Wilson,ENG,FW,Bournemouth,Premier League,27,1992,32.3,12,9,3,6,3,2,17,11.8,15,16,2,14,4,16,16,0,Matches
2671,Harry Wilson,WAL,"MF,FW",Bournemouth,Premier League,22,1997,18.3,23,13,8,10,5,11,34,32.4,23,26,2,24,11,34,15,1,Matches
2672,Harry Winks,ENG,MF,Tottenham,Premier League,23,1996,24.7,40,24,18,20,2,17,54,31.5,37,27,8,19,36,76,32,1,Matches
2673,Florian Wirtz,GER,FW,Leverkusen,Bundesliga,16,2003,4.1,4,2,0,4,0,2,4,50.0,2,4,0,4,2,6,1,0,Matches
2674,Axel Witsel,BEL,MF,Dortmund,Bundesliga,30,1989,24.9,28,20,10,17,1,14,33,42.4,19,26,7,19,31,59,19,1,Matches
2675,Hannes Wolf,AUT,"FW,MF",RB Leipzig,Bundesliga,20,1999,0.6,3,0,0,1,2,1,4,25.0,3,0,0,0,0,3,0,0,Matches
2676,Marius Wolf,GER,"FW,MF",Hertha BSC,Bundesliga,24,1995,15.7,19,11,9,7,3,10,27,37.0,17,14,1,13,17,36,13,0,Matches
2677,Nick Woltemade,GER,"FW,MF",Werder Bremen,Bundesliga,17,2002,1.0,2,1,0,2,0,0,1,0.0,1,1,0,1,0,2,2,0,Matches
2678,Chris Wood,NZL,FW,Burnley,Premier League,27,1991,27.1,7,4,2,4,1,5,15,33.3,10,15,2,13,4,11,18,0,Matches
2679,Xeka,POR,MF,Lille,Ligue 1,24,1994,7.9,18,10,3,13,2,9,29,31.0,20,11,1,10,4,22,7,1,Matches
2680,Granit Xhaka,SUI,MF,Arsenal,Premier League,26,1992,28.7,45,25,20,19,6,25,55,45.5,30,32,16,16,21,66,59,3,Matches
2681,Jawad El Yamiq,MAR,DF,Genoa,Serie A,27,1992,2.2,3,2,3,0,0,1,4,25.0,3,3,2,1,1,4,3,0,Matches
2682,Andriy Yarmolenko,UKR,"MF,FW",West Ham,Premier League,29,1989,11.0,13,8,5,6,2,5,20,25.0,15,3,1,2,6,19,4,0,Matches
2683,Yusuf Yazıcı,TUR,"MF,FW",Lille,Ligue 1,22,1997,9.4,17,8,2,11,4,5,13,38.5,8,6,1,5,5,22,1,1,Matches
2684,DeAndre Yedlin,USA,DF,Newcastle Utd,Premier League,26,1993,10.4,18,13,10,6,2,8,16,50.0,8,13,7,6,10,28,20,0,Matches
2685,Yoel,ESP,GK,Eibar,La Liga,30,1988,3.0,0,0,0,0,0,0,0,,0,0,0,0,1,1,1,0,Matches
2686,Okay Yokuşlu,TUR,MF,Celta Vigo,La Liga,25,1994,21.9,41,27,18,21,2,20,42,47.6,22,12,5,7,28,69,71,1,Matches
2687,Maya Yoshida,JPN,DF,Southampton,Premier League,30,1988,6.2,8,5,4,1,3,3,7,42.9,4,6,2,4,4,12,27,1,Matches
2688,Maya Yoshida,JPN,DF,Sampdoria,Serie A,30,1988,13.2,4,3,2,2,0,2,6,33.3,4,15,12,3,27,31,72,0,Matches
2689,Elie Youan,FRA,"FW,MF",Nantes,Ligue 1,20,1999,1.8,0,0,0,0,0,0,7,0.0,7,2,0,2,0,0,3,0,Matches
2690,Amin Younes,GER,"FW,MF",Napoli,Serie A,25,1993,2.0,3,2,1,2,0,2,4,50.0,2,2,0,2,0,3,1,0,Matches
2691,Ashley Young,ENG,DF,Manchester Utd,Premier League,34,1985,10.6,14,7,7,4,3,5,17,29.4,12,8,2,6,11,25,29,0,Matches
2692,Ashley Young,ENG,DF,Inter,Serie A,34,1985,13.2,11,5,3,5,3,6,19,31.6,13,11,3,8,14,25,24,0,Matches
2693,Zaydou Youssouf,FRA,MF,Saint-Étienne,Ligue 1,20,1999,12.0,40,22,12,26,2,15,35,42.9,20,7,1,6,16,56,13,0,Matches
2694,Pablo Zabaleta,ARG,DF,West Ham,Premier League,34,1985,6.6,18,10,12,5,1,6,13,46.2,7,5,3,2,14,32,21,0,Matches
2695,Mattia Zaccagni,ITA,"MF,FW",Hellas Verona,Serie A,24,1995,23.5,20,11,10,5,5,3,15,20.0,12,14,3,11,20,40,21,0,Matches
2696,Dan-Axel Zagadou,FRA,DF,Dortmund,Bundesliga,20,1999,10.9,16,10,12,4,0,6,8,75.0,2,12,8,4,15,31,38,0,Matches
2697,Arthur Zagre,FRA,MF,Paris S-G,Ligue 1,17,2001,0.3,1,0,1,0,0,0,0,,0,1,0,1,1,2,0,0,Matches
2698,Wilfried Zaha,CIV,"FW,MF",Crystal Palace,Premier League,26,1992,36.4,43,19,18,12,13,12,49,24.5,37,22,2,20,18,61,4,0,Matches
2699,Denis Zakaria,SUI,"MF,DF",Gladbach,Bundesliga,22,1996,21.6,49,30,23,23,3,20,39,51.3,19,39,12,27,37,86,31,1,Matches
2700,Joseba Zaldúa,ESP,DF,Real Sociedad,La Liga,27,1992,28.3,62,43,39,18,5,31,59,52.5,28,31,7,24,37,99,71,0,Matches
2701,Andre-Frank Zambo Anguissa,CMR,MF,Villarreal,La Liga,23,1995,28.7,76,49,29,40,7,26,78,33.3,52,42,6,36,44,120,30,0,Matches
2702,Luca Zanimacchia,ITA,"FW,MF",Juventus,Serie A,21,1998,1.3,5,1,1,2,2,1,2,50.0,1,1,0,1,0,5,0,0,Matches
2703,Nicolò Zaniolo,ITA,"FW,MF",Roma,Serie A,20,1999,16.7,15,11,4,7,4,3,24,12.5,21,14,0,14,5,20,5,0,Matches
2704,Cristián Zapata,COL,DF,Genoa,Serie A,32,1986,19.1,23,17,16,7,0,8,16,50.0,8,29,17,12,24,47,75,0,Matches
2705,Duván Zapata,COL,FW,Atalanta,Serie A,28,1991,22.5,7,3,1,2,4,1,6,16.7,5,18,7,11,2,9,11,0,Matches
2706,Davide Zappacosta,ITA,DF,Roma,Serie A,27,1992,5.0,7,3,2,3,2,4,8,50.0,4,3,1,2,6,13,8,1,Matches
2707,Simone Zaza,ITA,FW,Torino,Serie A,28,1991,18.2,15,10,6,4,5,3,10,30.0,7,11,0,11,9,24,13,1,Matches
2708,Marvin Zeegelaar,NED,DF,Udinese,Serie A,28,1990,6.6,15,9,8,4,3,6,11,54.5,5,9,2,7,5,20,10,0,Matches
2709,Mootaz Zemzemi,TUN,MF,Strasbourg,Ligue 1,19,1999,0.3,0,0,0,0,0,0,0,,0,0,0,0,1,1,0,0,Matches
2710,Arber Zeneli,KVX,MF,Reims,Ligue 1,24,1995,0.1,0,0,0,0,0,0,0,,0,0,0,0,0,0,0,0,Matches
2711,Robin Zentner,GER,GK,Mainz 05,Bundesliga,24,1994,21.5,1,1,1,0,0,1,1,100.0,0,0,0,0,0,1,11,0,Matches
2712,Piotr Zieliński,POL,MF,Napoli,Serie A,25,1994,32.5,26,16,10,11,5,12,30,40.0,18,28,5,23,21,47,15,0,Matches
2713,Jean Zimmer,GER,"DF,FW",Düsseldorf,Bundesliga,25,1993,8.0,11,6,5,5,1,5,10,50.0,5,3,1,2,3,14,0,0,Matches
2714,Christoph Zimmermann,GER,DF,Norwich City,Premier League,26,1993,15.9,32,21,26,6,0,21,30,70.0,9,22,18,4,19,51,87,2,Matches
2715,Matthias Zimmermann,GER,"DF,MF",Düsseldorf,Bundesliga,27,1992,32.5,62,47,26,27,9,31,64,48.4,33,41,15,26,43,105,59,0,Matches
2716,Oleksandr Zinchenko,UKR,DF,Manchester City,Premier League,22,1996,14.2,31,19,16,11,4,17,32,53.1,15,9,0,9,17,48,21,1,Matches
2717,Leopold Zingerle,GER,GK,Paderborn 07,Bundesliga,25,1994,28.0,3,1,3,0,0,2,4,50.0,2,0,0,0,0,3,7,2,Matches
2718,Joshua Zirkzee,NED,FW,Bayern Munich,Bundesliga,18,2001,3.3,5,2,0,2,3,2,4,50.0,2,2,0,2,1,6,0,0,Matches
2719,Richairo Živković,CUW,FW,Sheffield Utd,Premier League,22,1996,1.2,2,2,0,2,0,1,2,50.0,1,1,0,1,0,2,0,0,Matches
2720,Jaromír Zmrhal,CZE,MF,Brescia,Serie A,25,1993,12.5,10,4,2,5,3,5,18,27.8,13,8,1,7,4,14,11,0,Matches
2721,Kévin Zohi,MLI,"FW,MF",Strasbourg,Ligue 1,22,1996,5.9,8,6,3,3,2,3,6,50.0,3,1,0,1,4,12,2,0,Matches
2722,Ben Zolinski,GER,"FW,MF",Paderborn 07,Bundesliga,27,1992,13.4,17,9,7,9,1,7,27,25.9,20,12,0,12,8,25,4,0,Matches
2723,Kurt Zouma,FRA,DF,Chelsea,Premier League,24,1994,26.0,23,14,17,6,0,9,16,56.3,7,22,14,8,58,81,116,2,Matches
2724,Igor Zubeldia,ESP,"MF,DF",Real Sociedad,La Liga,22,1997,29.3,42,21,18,19,5,17,35,48.6,18,38,21,17,26,68,82,2,Matches
2725,Steven Zuber,SUI,"DF,FW",Hoffenheim,Bundesliga,27,1991,8.3,11,10,7,2,2,9,19,47.4,10,4,1,3,9,20,12,0,Matches
2726,Martín Zubimendi,ESP,MF,Real Sociedad,La Liga,20,1999,5.8,16,12,9,7,0,6,12,50.0,6,7,0,7,9,25,2,0,Matches
2727,Ervin Zukanović,BIH,DF,SPAL,Serie A,32,1987,2.3,1,0,0,0,1,1,1,100.0,0,3,1,2,3,4,15,0,Matches
2728,Bongani Zungu,RSA,MF,Amiens,Ligue 1,26,1992,11.0,27,11,10,13,4,18,31,58.1,13,8,2,6,16,43,21,0,Matches
2729,Szymon Żurkowski,POL,MF,Fiorentina,Serie A,21,1997,0.1,1,0,0,0,1,0,2,0.0,2,0,0,0,0,1,1,0,Matches
2730,David Zurutuza,ESP,MF,Real Sociedad,La Liga,33,1986,1.7,4,3,0,3,1,1,2,50.0,1,1,0,1,4,8,3,0,Matches
2731,Martin Ødegaard,NOR,MF,Real Sociedad,La Liga,20,1998,28.1,27,19,5,14,8,7,34,20.6,27,13,0,13,17,44,5,0,Matches
2732,Filip Đuričić,SRB,"MF,FW",Sassuolo,Serie A,27,1992,18.1,23,14,2,10,11,3,19,15.8,16,20,3,17,8,31,14,0,Matches
1,Ismael Aaneba,FRA,DF,Strasbourg,Ligue 1,21,1999,0.1,0,0,0,0,0,0,0,,0,0,0,0,1,1,1,0,Matches
2,Patrick van Aanholt,NED,DF,Crystal Palace,Premier League,29,1990,19.7,35,22,18,17,0,19,43,44.2,24,18,6,12,30,65,40,2,Matches
3,Yunis Abdelhamid,MAR,DF,Reims,Ligue 1,32,1987,32.1,59,37,36,23,0,26,42,61.9,16,34,15,19,61,120,132,0,Matches
4,Sabit Abdulai,GHA,MF,Getafe,La Liga,21,1999,0.7,2,0,1,1,0,1,3,33.3,2,0,0,0,0,2,0,0,Matches
5,Mehdi Abeid,ALG,MF,Nantes,Ligue 1,27,1992,14.7,34,19,16,14,4,15,30,50.0,15,9,2,7,20,54,10,0,Matches
6,Laurent Abergel,FRA,MF,Lorient,Ligue 1,27,1993,32.9,145,84,64,69,12,54,162,33.3,108,64,6,58,46,191,12,0,Matches
7,Charles Abi,FRA,"FW,MF",Saint-Étienne,Ligue 1,20,2000,10.1,8,2,5,0,3,3,12,25.0,9,6,2,4,4,12,5,0,Matches
8,Matthis Abline,FRA,FW,Rennes,Ligue 1,17,2003,0.0,0,0,0,0,0,0,0,,0,0,0,0,0,0,0,0,Matches
9,Pape Abou Cissé,SEN,DF,Saint-Étienne,Ligue 1,24,1995,14.0,15,13,10,5,0,6,10,60.0,4,7,4,3,27,42,87,0,Matches
10,David Abraham,ARG,DF,Eint Frankfurt,Bundesliga,34,1986,13.6,18,12,13,3,2,11,17,64.7,6,13,4,9,17,35,34,0,Matches
11,Tammy Abraham,ENG,FW,Chelsea,Premier League,22,1997,11.6,7,5,3,3,1,1,7,14.3,6,6,0,6,5,12,17,0,Matches
12,Amir Abrashi,ALB,"MF,DF",Freiburg,Bundesliga,30,1990,0.7,1,1,1,0,0,0,0,,0,1,1,0,2,3,1,0,Matches
13,Gennaro Acampora,ITA,"MF,FW",Spezia,Serie A,26,1994,4.9,6,4,1,4,1,2,7,28.6,5,4,1,3,4,10,4,0,Matches
14,Francesco Acerbi,ITA,DF,Lazio,Serie A,32,1988,31.3,51,32,34,13,4,18,40,45.0,22,24,15,9,76,127,121,2,Matches
15,Ragnar Ache,GER,"FW,DF",Eint Frankfurt,Bundesliga,22,1998,1.1,2,0,0,1,1,0,0,,0,1,0,1,1,3,1,0,Matches
16,Marcos Acuña,ARG,DF,Sevilla,La Liga,28,1991,25.9,62,42,34,20,8,23,41,56.1,18,23,2,21,23,85,30,1,Matches
17,Che Adams,SCO,FW,Southampton,Premier League,24,1996,29.6,25,16,4,15,6,6,17,35.3,11,20,2,18,4,29,19,1,Matches
18,Tyler Adams,USA,"MF,DF",RB Leipzig,Bundesliga,21,1999,20.6,35,24,12,15,8,17,31,54.8,14,22,5,17,29,64,30,0,Matches
19,Sargis Adamyan,ARM,"FW,MF",Hoffenheim,Bundesliga,27,1993,5.3,9,4,4,3,2,7,14,50.0,7,2,0,2,6,15,1,0,Matches
20,Tosin Adarabioyo,ENG,DF,Fulham,Premier League,22,1997,32.8,37,19,30,6,1,19,40,47.5,21,26,20,6,42,79,197,2,Matches
21,Bobby Adekanye,NED,"FW,MF",Cádiz,La Liga,21,1999,0.4,0,0,0,0,0,0,1,0.0,1,0,0,0,0,0,1,0,Matches
22,Yacine Adli,FRA,MF,Bordeaux,Ligue 1,20,2000,26.9,74,37,30,33,11,35,92,38.0,57,27,2,25,39,113,17,2,Matches
23,Andrea Adorante,ITA,FW,Parma,Serie A,20,2000,0.1,0,0,0,0,0,0,0,,0,0,0,0,0,0,0,0,Matches
24,Adrián,ESP,GK,Liverpool,Premier League,33,1987,3.0,0,0,0,0,0,0,0,,0,0,0,0,0,0,3,1,Matches
25,Martin Agirregabiria,ESP,"DF,MF",Alavés,La Liga,24,1996,17.3,32,18,17,12,3,17,33,51.5,16,9,3,6,27,59,36,0,Matches
26,Lucien Agoume,FRA,MF,Spezia,Serie A,18,2002,8.9,18,10,11,7,0,6,19,31.6,13,10,5,5,15,33,10,0,Matches
27,Felix Agu,GER,DF,Werder Bremen,Bundesliga,20,1999,7.8,20,9,10,9,1,10,18,55.6,8,14,3,11,12,32,18,0,Matches
28,Kevin Agudelo,COL,FW,Spezia,Serie A,21,1998,15.1,39,28,9,15,15,12,34,35.3,22,30,0,30,10,49,2,0,Matches
29,Nayef Aguerd,MAR,DF,Rennes,Ligue 1,24,1996,35.0,37,30,28,9,0,21,33,63.6,12,34,22,12,47,84,102,0,Matches
30,Sergio Agüero,ARG,FW,Manchester City,Premier League,32,1988,6.2,4,1,0,2,2,2,11,18.2,9,2,0,2,2,6,0,0,Matches
31,Ruben Aguilar,FRA,"DF,MF",Monaco,Ligue 1,27,1993,24.7,63,37,32,21,10,32,52,61.5,20,30,3,27,47,110,43,1,Matches
32,Naouirou Ahamada,FRA,MF,Stuttgart,Bundesliga,18,2002,2.8,4,1,3,1,0,1,1,100.0,0,2,0,2,1,5,1,0,Matches
33,Matteo Ahlinvi,BEN,MF,Nîmes,Ligue 1,21,1999,10.0,26,20,10,14,2,11,39,28.2,28,6,0,6,2,28,8,0,Matches
34,Jean-Eudes Aholou,CIV,MF,Strasbourg,Ligue 1,26,1994,23.8,46,25,18,25,3,19,48,39.6,29,17,5,12,53,99,32,0,Matches
35,Jean-Eudes Aholou,CIV,MF,Monaco,Ligue 1,26,1994,0.4,1,0,0,1,0,1,3,33.3,2,0,0,0,1,2,1,0,Matches
36,Joseph Aidoo,GHA,DF,Celta Vigo,La Liga,24,1995,14.3,26,17,17,9,0,12,21,57.1,9,7,4,3,25,51,88,1,Matches
37,Ola Aina,NGA,DF,Fulham,Premier League,23,1996,29.6,37,20,22,7,8,21,43,48.8,22,22,6,16,45,82,94,2,Matches
38,Rayan Aït-Nouri,ALG,DF,Wolves,Premier League,19,2001,15.6,29,16,18,10,1,13,27,48.1,14,14,1,13,15,44,25,0,Matches
39,Rayan Aït-Nouri,ALG,DF,Angers,Ligue 1,19,2001,2.1,3,2,1,2,0,3,5,60.0,2,2,1,1,4,7,1,0,Matches
40,Semi Ajayi,NGA,DF,West Brom,Premier League,26,1993,30.9,40,14,34,6,0,23,41,56.1,18,51,32,19,42,82,122,2,Matches
41,Ludovic Ajorque,FRA,FW,Strasbourg,Ligue 1,26,1994,33.0,30,18,6,18,6,7,31,22.6,24,14,5,9,11,41,54,0,Matches
42,Manuel Akanji,SUI,DF,Dortmund,Bundesliga,25,1995,26.1,41,22,23,12,6,19,31,61.3,12,23,10,13,49,90,70,1,Matches
43,Carlos Akapo,EQG,DF,Cádiz,La Liga,27,1993,9.6,18,14,14,4,0,10,18,55.6,8,16,3,13,19,37,33,0,Matches
44,Marley Aké,FRA,FW,Marseille,Ligue 1,19,2001,1.6,3,3,1,0,2,0,1,0.0,1,2,0,2,0,3,1,0,Matches
45,Nathan Aké,NED,DF,Manchester City,Premier League,25,1995,8.9,10,5,3,6,1,3,4,75.0,1,2,1,1,9,19,23,0,Matches
46,Paul Akouokou,CIV,MF,Betis,La Liga,22,1997,4.2,11,8,2,8,1,5,8,62.5,3,3,1,2,6,17,7,0,Matches
47,Jean-Daniel Akpa-Akpro,CIV,MF,Lazio,Serie A,27,1992,11.7,38,25,13,22,3,8,27,29.6,19,24,6,18,18,56,13,0,Matches
48,Kevin Akpoguma,NGA,DF,Hoffenheim,Bundesliga,25,1995,13.2,18,12,11,6,1,8,14,57.1,6,28,15,13,13,31,32,2,Matches
49,David Alaba,AUT,"DF,MF",Bayern Munich,Bundesliga,28,1992,29.7,37,21,14,19,4,17,32,53.1,15,29,13,16,43,80,60,0,Matches
50,Sofiane Alakouch,MAR,DF,Nîmes,Ligue 1,22,1998,16.7,53,33,30,16,7,29,45,64.4,16,17,2,15,21,74,38,0,Matches
51,Jony Álamo,ESP,MF,Elche,La Liga,18,2001,0.8,2,1,1,0,1,0,1,0.0,1,0,0,0,1,3,0,0,Matches
52,Lucas Alario,ARG,FW,Leverkusen,Bundesliga,27,1992,13.8,8,2,2,5,1,2,4,50.0,2,9,1,8,2,10,10,0,Matches
53,Jordi Alba,ESP,"DF,FW",Barcelona,La Liga,31,1989,33.6,45,30,22,16,7,24,52,46.2,28,21,2,19,49,94,48,0,Matches
54,Luis Alberto,ESP,MF,Lazio,Serie A,27,1992,29.1,43,24,15,19,9,15,73,20.5,58,41,2,39,13,56,11,1,Matches
55,Raúl Albiol,ESP,DF,Villarreal,La Liga,34,1985,34.6,22,15,19,3,0,13,18,72.2,5,32,22,10,22,44,146,2,Matches
56,Marc Albrighton,ENG,"DF,FW",Leicester City,Premier League,30,1989,19.4,33,19,14,15,4,16,45,35.6,29,29,3,26,17,50,27,1,Matches
57,Paco Alcácer,ESP,FW,Villarreal,La Liga,26,1993,17.2,6,3,1,2,3,3,7,42.9,4,8,0,8,9,15,6,0,Matches
58,Pedro Alcalá,ESP,DF,Cádiz,La Liga,31,1989,10.1,8,4,6,2,0,3,5,60.0,2,19,13,6,16,24,50,0,Matches
59,Thiago Alcántara,ESP,MF,Liverpool,Premier League,29,1991,20.6,61,36,20,30,11,17,49,34.7,32,26,0,26,30,91,14,0,Matches
60,Rubén Alcaraz,ESP,MF,Valladolid,La Liga,29,1991,24.1,54,29,32,21,1,30,80,37.5,50,35,8,27,31,85,28,0,Matches
61,Omar Alderete,PAR,DF,Hertha BSC,Bundesliga,23,1996,14.4,16,10,11,5,0,7,16,43.8,9,14,10,4,21,37,61,1,Matches
62,Toby Alderweireld,BEL,DF,Tottenham,Premier League,31,1989,24.9,35,22,22,11,2,18,30,60.0,12,40,28,12,10,45,121,0,Matches
63,Iván Alejo,ESP,"MF,FW",Cádiz,La Liga,25,1995,9.2,14,10,8,4,2,4,23,17.4,19,14,1,13,3,17,10,0,Matches
64,Carles Aleñá,ESP,MF,Barcelona,La Liga,22,1998,0.5,1,0,1,0,0,0,0,,0,0,0,0,0,1,0,0,Matches
65,Carles Aleñá,ESP,"MF,FW",Getafe,La Liga,22,1998,15.2,15,10,3,9,3,7,25,28.0,18,14,1,13,2,17,2,0,Matches
66,Rúnar Alex Rúnarsson,ISL,GK,Arsenal,Premier League,25,1995,0.2,0,0,0,0,0,0,0,,0,0,0,0,0,0,0,0,Matches
67,Trent Alexander-Arnold,ENG,DF,Liverpool,Premier League,21,1998,33.7,56,33,31,18,7,36,56,64.3,20,24,3,21,49,105,50,3,Matches
68,Alfon,ESP,MF,Celta Vigo,La Liga,21,1999,0.4,0,0,0,0,0,0,0,,0,0,0,0,0,0,0,0,Matches
69,Mohamed Ali Cho,FRA,"FW,MF",Angers,Ligue 1,16,2004,3.9,9,7,2,6,1,4,9,44.4,5,4,0,4,3,12,0,0,Matches
70,Ezgjan Alioski,MKD,"DF,MF",Leeds United,Premier League,28,1992,27.3,74,31,38,28,8,32,74,43.2,42,17,2,15,23,97,50,2,Matches
71,Rachid Alioui,MAR,FW,Angers,Ligue 1,28,1992,0.2,0,0,0,0,0,0,1,0.0,1,0,0,0,0,0,0,0,Matches
72,Alisson,BRA,GK,Liverpool,Premier League,27,1992,33.0,3,2,3,0,0,3,4,75.0,1,0,0,0,2,5,26,7,Matches
73,Saturnin Allagbé,BEN,GK,Dijon,Ligue 1,26,1993,12.0,0,0,0,0,0,0,1,0.0,1,0,0,0,0,0,9,3,Matches
74,Allan,BRA,MF,Everton,Premier League,29,1991,22.8,80,45,39,37,4,28,95,29.5,67,31,12,19,19,99,25,1,Matches
75,Dele Alli,ENG,MF,Tottenham,Premier League,24,1996,6.9,18,11,8,6,4,7,19,36.8,12,9,0,9,7,25,3,0,Matches
76,Miguel Almirón,PAR,"MF,FW",Newcastle Utd,Premier League,26,1994,27.0,49,29,21,25,3,14,56,25.0,42,23,4,19,25,74,20,1,Matches
77,Marcos Alonso,ESP,DF,Chelsea,Premier League,29,1990,10.7,13,3,6,4,3,7,14,50.0,7,12,1,11,12,25,30,0,Matches
78,Sergio Álvarez,ESP,"MF,DF",Eibar,La Liga,28,1992,17.4,42,25,13,26,3,8,22,36.4,14,22,5,17,22,64,24,2,Matches
79,Yeray Álvarez,ESP,DF,Athletic Club,La Liga,25,1995,21.6,19,12,11,8,0,9,21,42.9,12,12,5,7,53,72,73,0,Matches
80,Bruno Alves,POR,DF,Parma,Serie A,38,1981,18.1,13,10,10,3,0,7,9,77.8,2,17,12,5,26,39,81,0,Matches
81,Steven Alzate,COL,MF,Brighton,Premier League,21,1998,10.0,17,8,10,4,3,6,15,40.0,9,8,1,7,8,25,10,0,Matches
82,Ibrahim Amadou,FRA,MF,Angers,Ligue 1,27,1993,16.7,39,26,18,19,2,15,38,39.5,23,14,4,10,23,62,25,0,Matches
83,Romain Amalfitano,FRA,"FW,DF",Dijon,Ligue 1,30,1989,1.3,4,2,3,1,0,1,3,33.3,2,2,1,1,1,5,1,0,Matches
84,Emmanuel Amankwaa Akurugu,GHA,DF,Getafe,La Liga,18,2001,0.5,0,0,0,0,0,0,1,0.0,1,1,0,1,2,2,1,0,Matches
85,Daniel Amartey,GHA,DF,Leicester City,Premier League,25,1994,8.0,11,7,6,4,1,8,12,66.7,4,8,4,4,12,23,26,0,Matches
86,Jordan Amavi,FRA,DF,Marseille,Ligue 1,26,1994,9.0,11,9,9,1,1,9,12,75.0,3,12,2,10,27,38,33,1,Matches
87,Thierry Ambrose,GLP,FW,Metz,Ligue 1,23,1997,8.4,7,4,1,1,5,2,12,16.7,10,2,0,2,2,9,4,0,Matches
88,Wisdom Amey,ITA,DF,Bologna,Serie A,14,2005,0.0,0,0,0,0,0,0,0,,0,0,0,0,0,0,0,0,Matches
89,Nadiem Amiri,GER,MF,Leverkusen,Bundesliga,23,1996,21.0,12,7,4,8,0,7,33,21.2,26,18,3,15,12,24,7,0,Matches
90,Ethan Ampadu,WAL,"DF,MF",Sheffield Utd,Premier League,19,2000,23.2,57,36,31,24,2,20,46,43.5,26,40,19,21,49,106,87,3,Matches
91,Sofyan Amrabat,MAR,MF,Fiorentina,Serie A,23,1996,27.1,39,22,11,24,4,18,48,37.5,30,30,5,25,23,62,12,0,Matches
92,Jon Ander Garrido,ESP,MF,Cádiz,La Liga,30,1989,8.9,18,10,8,7,3,10,26,38.5,16,12,4,8,14,32,13,0,Matches
93,Joachim Andersen,DEN,DF,Fulham,Premier League,24,1996,30.3,33,19,18,11,4,15,28,53.6,13,24,13,11,44,77,151,1,Matches
94,Joachim Andersen,DEN,DF,Lyon,Ligue 1,24,1996,2.1,2,1,1,1,0,2,2,100.0,0,1,1,0,2,4,6,0,Matches
95,Djavan Anderson,NED,DF,Lazio,Serie A,25,1995,0.8,0,0,0,0,0,0,1,0.0,1,1,0,1,1,1,0,0,Matches
96,Elliot Anderson,SCO,MF,Newcastle Utd,Premier League,17,2002,0.0,0,0,0,0,0,0,0,,0,0,0,0,0,0,0,0,Matches
97,Felipe Anderson,BRA,"FW,MF",West Ham,Premier League,27,1993,0.0,1,1,0,1,0,0,0,,0,0,0,0,0,1,0,0,Matches
98,Sebastian Andersson,SWE,FW,Köln,Bundesliga,29,1991,12.5,3,2,0,3,0,1,8,12.5,7,10,3,7,2,5,9,0,Matches
99,Nícolas Andrade,BRA,GK,Udinese,Serie A,32,1988,2.0,0,0,0,0,0,0,0,,0,0,0,0,0,0,0,0,Matches
100,Benjamin André,FRA,MF,Lille,Ligue 1,29,1990,32.1,114,68,47,61,6,53,122,43.4,69,39,10,29,76,190,49,0,Matches
101,Marcos André,BRA,FW,Valladolid,La Liga,23,1996,13.1,8,2,2,2,4,0,8,0.0,8,15,2,13,2,10,9,0,Matches
102,Robert Andrich,GER,MF,Union Berlin,Bundesliga,25,1994,28.1,51,24,22,27,2,24,53,45.3,29,40,6,34,51,102,31,2,Matches
103,Victorien Angban,CIV,MF,Metz,Ligue 1,23,1996,18.6,36,24,17,15,4,17,42,40.5,25,17,4,13,19,55,9,1,Matches
104,Ángel,ESP,GK,Granada,La Liga,18,2002,1.0,0,0,0,0,0,0,0,,0,0,0,0,0,0,1,0,Matches
105,José Ángel,ESP,DF,Eibar,La Liga,30,1989,10.0,15,8,9,4,2,8,12,66.7,4,7,0,7,13,28,17,1,Matches
106,Miguel Ángel Rubio,ESP,DF,Valladolid,La Liga,22,1998,1.5,0,0,0,0,0,0,0,,0,2,2,0,3,3,11,0,Matches
107,Angeliño,ESP,"DF,FW",RB Leipzig,Bundesliga,23,1997,24.0,31,19,10,18,3,13,24,54.2,11,22,1,21,30,61,40,0,Matches
108,Davide Angelo Ghislandi,ITA,DF,Atalanta,Serie A,19,2001,0.1,0,0,0,0,0,0,0,,0,0,0,0,0,0,1,0,Matches
109,Philip Ankhrah,GHA,MF,Hellas Verona,Serie A,17,2002,0.1,0,0,0,0,0,0,0,,0,1,0,1,0,0,0,0,Matches
110,Cristian Ansaldi,ARG,"DF,FW",Torino,Serie A,33,1986,21.6,48,33,25,14,9,24,38,63.2,14,21,7,14,16,64,38,0,Matches
111,Waldemar Anton,GER,DF,Stuttgart,Bundesliga,24,1996,30.1,31,20,17,14,0,12,31,38.7,19,28,18,10,47,78,114,0,Matches
112,Michail Antonio,JAM,FW,West Ham,Premier League,30,1990,21.9,7,4,1,5,1,1,7,14.3,6,20,3,17,7,14,7,0,Matches
113,José Antonio Miranda,EQG,"MF,DF",Getafe,La Liga,22,1998,0.3,0,0,0,0,0,0,1,0.0,1,1,0,1,0,0,0,0,Matches
114,Valentin Antov,BUL,DF,Bologna,Serie A,19,2000,2.6,4,2,3,1,0,3,10,30.0,7,6,5,1,4,8,13,0,Matches
115,Houssem Aouar,ALG,"MF,FW",Lyon,Ligue 1,22,1998,19.8,17,12,0,13,4,8,25,32.0,17,17,1,16,17,34,4,0,Matches
116,Adil Aouchiche,FRA,"MF,FW",Saint-Étienne,Ligue 1,18,2002,19.2,38,20,12,17,9,13,49,26.5,36,15,1,14,10,48,6,0,Matches
117,Dennis Appiah,FRA,DF,Nantes,Ligue 1,28,1992,17.3,55,34,33,15,7,32,59,54.2,27,23,6,17,25,80,43,0,Matches
118,Aritz Arambarri,ESP,DF,Real Sociedad,La Liga,22,1998,0.3,1,1,0,1,0,1,2,50.0,1,0,0,0,0,1,0,0,Matches
119,Mauro Arambarri,URU,MF,Getafe,La Liga,24,1995,33.1,64,39,22,35,7,23,80,28.8,57,40,5,35,42,106,28,0,Matches
120,Charles Aránguiz,CHI,MF,Leverkusen,Bundesliga,31,1989,18.5,41,23,16,21,4,17,43,39.5,26,32,4,28,33,74,17,0,Matches
121,Luiz Araújo,BRA,MF,Lille,Ligue 1,24,1996,16.6,38,25,12,18,8,8,28,28.6,20,23,1,22,11,49,3,0,Matches
122,Néstor Araujo,MEX,DF,Celta Vigo,La Liga,28,1991,27.0,24,16,14,9,1,7,15,46.7,8,23,18,5,43,67,89,2,Matches
123,Ronald Araújo,URU,DF,Barcelona,La Liga,21,1999,16.8,22,11,12,8,2,9,9,100.0,0,24,15,9,20,42,47,1,Matches
124,Anaitz Arbilla,ESP,DF,Eibar,La Liga,33,1987,31.2,45,26,31,11,3,27,54,50.0,27,36,11,25,69,114,73,1,Matches
125,Alphonse Areola,FRA,GK,Fulham,Premier League,27,1993,36.0,1,0,1,0,0,1,5,20.0,4,0,0,0,1,2,13,3,Matches
126,Santiago Arias,COL,DF,Leverkusen,Bundesliga,28,1992,1.0,2,1,0,1,1,1,1,100.0,0,0,0,0,1,3,4,0,Matches
127,Karim Aribi,ALG,FW,Nîmes,Ligue 1,26,1994,3.3,2,2,0,1,1,0,5,0.0,5,1,0,1,0,2,3,0,Matches
128,Unai Arietaleanizbeaskoa,ESP,"FW,MF",Eibar,La Liga,21,1999,0.5,1,0,0,0,1,0,0,,0,0,0,0,0,1,0,0,Matches
129,Nicolò Armini,ITA,DF,Lazio,Serie A,19,2001,0.1,0,0,0,0,0,0,0,,0,0,0,0,0,0,0,0,Matches
130,Stuart Armstrong,SCO,MF,Southampton,Premier League,28,1992,30.7,60,41,19,32,9,27,75,36.0,48,26,1,25,24,84,19,0,Matches
131,Maximilian Arnold,GER,MF,Wolfsburg,Bundesliga,26,1994,28.7,47,32,20,26,1,18,49,36.7,31,24,3,21,49,96,57,0,Matches
132,Tolu Arokodare,NGA,"FW,MF",Köln,Bundesliga,19,2000,1.2,1,1,0,0,1,0,0,,0,1,0,1,1,2,0,0,Matches
133,Sergio Arribas,ESP,"MF,FW",Real Madrid,La Liga,18,2001,1.5,3,1,2,1,0,1,3,33.3,2,2,0,2,4,7,2,0,Matches
134,Kepa Arrizabalaga,ESP,GK,Chelsea,Premier League,25,1994,6.5,0,0,0,0,0,0,1,0.0,1,0,0,0,0,0,0,3,Matches
135,Tolgay Arslan,GER,MF,Udinese,Serie A,29,1990,20.2,52,32,24,24,4,25,54,46.3,29,22,2,20,22,74,15,1,Matches
136,Kwadwo Asamoah,GHA,"DF,MF",Cagliari,Serie A,31,1988,2.5,4,3,2,2,0,2,3,66.7,1,5,1,4,4,8,2,1,Matches
137,Santiago Ascacíbar,ARG,MF,Hertha BSC,Bundesliga,23,1997,8.5,30,15,15,14,1,15,28,53.6,13,23,2,21,13,43,14,0,Matches
138,Sergio Asenjo,ESP,GK,Villarreal,La Liga,31,1989,36.0,0,0,0,0,0,0,1,0.0,1,0,0,0,0,0,13,2,Matches
139,Marco Asensio,ESP,"FW,MF",Real Madrid,La Liga,24,1996,20.8,12,6,7,4,1,3,24,12.5,21,15,0,15,11,23,10,0,Matches
140,Kristoffer Askildsen,NOR,MF,Sampdoria,Serie A,19,2001,1.1,0,0,0,0,0,0,0,,0,2,0,2,3,3,3,0,Matches
141,Iago Aspas,ESP,FW,Celta Vigo,La Liga,32,1987,31.8,11,3,2,7,2,2,23,8.7,21,25,2,23,16,27,21,0,Matches
142,Roger Assalé,CIV,"FW,MF",Dijon,Ligue 1,26,1993,9.2,10,8,3,5,2,4,12,33.3,8,7,3,4,2,12,2,0,Matches
143,Youcef Atal,ALG,"DF,FW",Nice,Ligue 1,24,1996,10.6,25,12,11,14,0,13,26,50.0,13,10,2,8,26,51,12,0,Matches
144,Miguel Atienza,ESP,MF,Eibar,La Liga,21,1999,9.3,20,9,5,15,0,8,23,34.8,15,14,1,13,9,29,12,0,Matches
145,Pierre-Emerick Aubameyang,GAB,FW,Arsenal,Premier League,31,1989,25.9,12,8,7,4,1,3,20,15.0,17,18,0,18,7,19,17,0,Matches
146,Emil Audero,ITA,GK,Sampdoria,Serie A,23,1997,37.0,1,1,1,0,0,1,2,50.0,1,0,0,0,1,2,16,0,Matches
147,Tommaso Augello,ITA,DF,Sampdoria,Serie A,25,1994,35.7,42,30,27,10,5,23,39,59.0,16,22,2,20,32,74,76,1,Matches
148,Jean-Kévin Augustin,FRA,FW,Nantes,Ligue 1,23,1997,0.4,2,0,0,2,0,2,2,100.0,0,0,0,0,0,2,0,0,Matches
149,Ludwig Augustinsson,SWE,"DF,FW",Werder Bremen,Bundesliga,26,1994,21.7,37,20,19,14,4,17,29,58.6,12,21,7,14,20,57,62,0,Matches
150,Serge Aurier,CIV,DF,Tottenham,Premier League,27,1992,17.8,55,33,33,17,5,15,40,37.5,25,28,5,23,19,74,44,3,Matches
151,Charlie Austin,ENG,"FW,MF",West Brom,Premier League,31,1989,1.5,4,2,1,2,1,1,3,33.3,2,0,0,0,3,7,4,0,Matches
152,Ezequiel Ávila,ARG,"FW,MF",Osasuna,La Liga,26,1994,2.2,6,2,3,1,2,2,4,50.0,2,1,0,1,1,7,0,0,Matches
153,Taiwo Awoniyi,NGA,FW,Union Berlin,Bundesliga,22,1997,15.1,5,3,2,3,0,1,14,7.1,13,9,0,9,3,8,4,0,Matches
154,Mehmet Aydin,GER,DF,Schalke 04,Bundesliga,18,2002,5.6,15,7,9,6,0,4,10,40.0,6,6,1,5,6,21,16,0,Matches
155,Jordan Ayew,GHA,"FW,MF",Crystal Palace,Premier League,28,1991,23.3,38,26,8,16,14,16,44,36.4,28,28,2,26,16,54,12,0,Matches
156,Kaan Ayhan,TUR,DF,Sassuolo,Serie A,25,1994,8.8,15,9,8,5,2,8,13,61.5,5,9,5,4,16,31,33,0,Matches
157,Luke Ayling,ENG,DF,Leeds United,Premier League,28,1991,37.8,108,61,69,30,9,49,87,56.3,38,53,36,17,36,144,96,5,Matches
158,Ramon Azeez,NGA,MF,Granada,La Liga,27,1992,1.1,1,1,0,1,0,0,0,,0,0,0,0,1,2,1,0,Matches
159,César Azpilicueta,ESP,DF,Chelsea,Premier League,30,1989,24.3,53,28,22,24,7,19,37,51.4,18,30,5,25,28,81,62,2,Matches
160,Ludovic Baal,GUF,"DF,MF",Brest,Ligue 1,34,1986,3.3,6,5,4,1,1,2,5,40.0,3,4,1,3,5,11,5,0,Matches
161,Carlos Bacca,COL,FW,Villarreal,La Liga,33,1986,8.7,9,5,5,3,1,3,5,60.0,2,5,0,5,3,12,2,0,Matches
162,Loïc Bade,FRA,DF,Lens,Ligue 1,20,2000,29.0,57,34,47,10,0,30,55,54.5,25,43,17,26,74,131,135,2,Matches
163,Milan Badelj,CRO,MF,Genoa,Serie A,31,1989,26.8,56,27,27,22,7,26,84,31.0,58,51,10,41,87,143,45,1,Matches
164,Édgar Badía,ESP,GK,Elche,La Liga,28,1992,30.0,1,0,1,0,0,1,3,33.3,2,0,0,0,0,1,17,3,Matches
165,Benoît Badiashile,FRA,DF,Monaco,Ligue 1,19,2001,31.9,24,17,15,9,0,13,28,46.4,15,21,12,9,58,82,102,4,Matches
166,Alex Baena,ESP,MF,Villarreal,La Liga,19,2001,1.5,4,3,1,2,1,1,3,33.3,2,1,1,0,1,5,1,0,Matches
167,Miguel Baeza,ESP,"MF,FW",Celta Vigo,La Liga,20,2000,6.0,7,6,5,2,0,5,13,38.5,8,3,0,3,3,10,2,0,Matches
168,Stéphane Bahoken,CMR,FW,Angers,Ligue 1,28,1992,18.0,9,6,1,7,1,4,12,33.3,8,9,0,9,9,18,9,0,Matches
169,Leon Bailey,JAM,"FW,MF",Leverkusen,Bundesliga,22,1997,23.8,14,8,3,7,4,4,15,26.7,11,13,0,13,9,23,3,0,Matches
170,Eric Bailly,CIV,DF,Manchester Utd,Premier League,26,1994,10.2,5,5,3,1,1,0,1,0.0,1,13,11,2,13,18,36,2,Matches
171,Stefan Bajic,FRA,GK,Saint-Étienne,Ligue 1,18,2001,1.0,0,0,0,0,0,0,0,,0,0,0,0,0,0,1,0,Matches
172,Tiemoué Bakayoko,FRA,MF,Napoli,Serie A,25,1994,21.8,69,41,21,41,7,23,40,57.5,17,24,2,22,36,105,13,2,Matches
173,Mitchel Bakker,NED,DF,Paris S-G,Ligue 1,20,2000,18.8,38,30,15,14,9,17,26,65.4,9,22,2,20,22,60,20,0,Matches
174,Ridle Baku,GER,"FW,DF",Wolfsburg,Bundesliga,22,1998,29.8,50,31,20,20,10,22,53,41.5,31,54,4,50,40,90,33,1,Matches
175,Ridle Baku,GER,DF,Mainz 05,Bundesliga,22,1998,2.0,4,2,3,1,0,2,6,33.3,4,3,1,2,3,7,6,0,Matches
176,Dilane Bakwa,FRA,"FW,MF",Bordeaux,Ligue 1,17,2002,0.6,2,2,1,1,0,0,1,0.0,1,2,0,2,1,3,0,0,Matches
177,Fabián Balbuena,PAR,DF,West Ham,Premier League,28,1991,13.3,24,12,23,1,0,14,23,60.9,9,23,6,17,25,49,63,0,Matches
178,Keita Baldé,SEN,FW,Sampdoria,Serie A,25,1995,13.3,9,6,2,6,1,4,10,40.0,6,10,1,9,0,9,3,0,Matches
179,George Baldock,GRE,DF,Sheffield Utd,Premier League,27,1993,31.0,47,34,28,14,5,21,50,42.0,29,26,7,19,25,72,70,1,Matches
180,Gareth Bale,WAL,FW,Tottenham,Premier League,31,1989,10.2,17,10,4,9,4,7,14,50.0,7,13,2,11,8,25,16,0,Matches
181,Mikel Balenziaga,ESP,DF,Athletic Club,La Liga,32,1988,18.8,26,15,11,12,3,9,18,50.0,9,22,7,15,7,33,46,0,Matches
182,Leonardo Balerdi,ARG,DF,Marseille,Ligue 1,21,1999,18.2,29,18,19,7,3,14,31,45.2,17,17,9,8,28,57,65,3,Matches
183,Fodé Ballo-Touré,SEN,DF,Monaco,Ligue 1,23,1997,7.4,21,17,9,11,1,6,13,46.2,7,7,0,7,6,27,11,1,Matches
184,Botond Balogh,HUN,DF,Parma,Serie A,18,2002,1.8,9,7,9,0,0,2,5,40.0,3,4,3,1,2,11,8,0,Matches
185,Abdoulaye Bamba,CIV,DF,Angers,Ligue 1,30,1990,15.0,27,17,19,7,1,19,28,67.9,9,7,1,6,19,46,34,0,Matches
186,Jonathan Bamba,CIV,MF,Lille,Ligue 1,24,1996,33.2,45,23,15,19,11,24,84,28.6,60,24,2,22,24,69,15,0,Matches
187,Robson Bambu,BRA,DF,Nice,Ligue 1,22,1997,11.6,16,11,14,2,0,11,14,78.6,3,8,7,1,10,26,57,0,Matches
188,Patrick Bamford,ENG,FW,Leeds United,Premier League,26,1993,33.9,21,9,2,11,8,8,27,29.6,19,14,4,10,10,31,37,0,Matches
189,Mattia Bani,ITA,DF,Genoa,Serie A,26,1993,10.2,10,5,5,5,0,5,12,41.7,7,16,11,5,27,37,44,0,Matches
190,Mattia Bani,ITA,DF,Parma,Serie A,26,1993,12.7,20,11,15,4,1,4,8,50.0,4,10,6,4,33,53,50,0,Matches
191,Simon Banza,COD,FW,Lens,Ligue 1,23,1996,15.2,13,6,0,4,9,1,14,7.1,13,16,1,15,7,20,15,0,Matches
192,Antonín Barák,CZE,MF,Hellas Verona,Serie A,25,1994,30.7,30,19,8,16,6,14,47,29.8,33,26,7,19,12,42,38,1,Matches
193,Federico Barba,ITA,DF,Benevento,Serie A,26,1993,29.5,31,16,22,8,1,21,35,60.0,14,39,18,21,48,79,94,4,Matches
194,Danilo Barbosa,BRA,DF,Nice,Ligue 1,24,1996,2.8,6,3,5,1,0,4,6,66.7,2,2,1,1,2,8,11,2,Matches
195,Barcia,ESP,DF,Granada,La Liga,19,2000,1.0,1,1,1,0,0,0,0,,0,1,1,0,3,4,9,0,Matches
196,Melvin Bard,FRA,DF,Lyon,Ligue 1,19,2000,4.8,12,8,7,4,1,6,11,54.5,5,10,2,8,6,18,14,0,Matches
197,Enis Bardhi,MKD,MF,Levante,La Liga,25,1995,18.7,28,12,8,16,4,10,36,27.8,26,8,2,6,21,49,14,0,Matches
198,Phil Bardsley,SCO,DF,Burnley,Premier League,35,1985,3.0,6,5,4,2,0,3,6,50.0,3,3,1,2,6,12,12,0,Matches
199,Nicolò Barella,ITA,MF,Inter,Serie A,23,1997,32.2,58,31,23,29,6,23,72,31.9,49,29,4,25,26,84,14,0,Matches
200,Philipp Bargfrede,GER,MF,Werder Bremen,Bundesliga,31,1989,0.3,0,0,0,0,0,0,0,,0,0,0,0,0,0,3,0,Matches
201,Kike Barja,ESP,"MF,FW",Osasuna,La Liga,23,1997,15.9,10,5,6,1,3,5,24,20.8,19,10,1,9,16,26,8,0,Matches
202,Ross Barkley,ENG,MF,Aston Villa,Premier League,26,1993,17.0,6,2,2,4,0,3,15,20.0,12,9,1,8,5,11,6,1,Matches
203,Ross Barkley,ENG,"FW,MF",Chelsea,Premier League,26,1993,0.5,0,0,0,0,0,0,0,,0,0,0,0,0,0,0,0,Matches
204,Aymen Barkok,MAR,"MF,DF",Eint Frankfurt,Bundesliga,22,1998,10.9,29,15,11,9,9,10,31,32.3,21,15,1,14,10,39,9,1,Matches
205,Ashley Barnes,ENG,FW,Burnley,Premier League,30,1989,14.8,12,6,2,6,4,3,13,23.1,10,14,2,12,5,17,11,0,Matches
206,Harvey Barnes,ENG,"FW,MF",Leicester City,Premier League,22,1997,21.6,19,9,11,3,5,5,22,22.7,17,16,3,13,8,27,11,0,Matches
207,Marc Baró,ESP,DF,Cádiz,La Liga,20,1999,1.0,2,1,2,0,0,0,2,0.0,2,1,0,1,2,4,2,1,Matches
208,Antonio Barragán,ESP,DF,Elche,La Liga,33,1987,24.8,28,14,21,5,2,12,21,57.1,9,22,8,14,33,61,67,1,Matches
209,Antonio Barreca,ITA,DF,Fiorentina,Serie A,25,1995,0.9,1,0,0,1,0,1,1,100.0,0,0,0,0,0,1,1,0,Matches
210,Leandro Barreiro Martins,LUX,MF,Mainz 05,Bundesliga,20,2000,25.6,58,32,19,26,13,20,50,40.0,30,34,9,25,57,115,55,0,Matches
211,Ander Barrenetxea,ESP,"MF,FW",Real Sociedad,La Liga,18,2001,14.5,29,19,5,18,6,9,24,37.5,15,20,0,20,6,35,8,0,Matches
212,Jacob Barrett Laursen,DEN,DF,Arminia,Bundesliga,25,1994,12.3,23,12,13,8,2,10,16,62.5,6,14,4,10,24,47,37,0,Matches
213,Musa Barrow,GAM,"FW,MF",Bologna,Serie A,21,1998,32.5,26,10,8,10,8,10,25,40.0,15,37,2,35,11,37,15,0,Matches
214,Kyle Bartley,ENG,DF,West Brom,Premier League,29,1991,28.7,27,16,14,10,3,11,23,47.8,12,50,35,15,38,65,159,1,Matches
215,Paolo Bartolomei,ITA,MF,Spezia,Serie A,30,1989,3.6,6,2,3,1,2,4,7,57.1,3,1,0,1,1,7,2,0,Matches
216,Marc Bartra,ESP,DF,Betis,La Liga,29,1991,18.8,27,16,18,8,1,12,22,54.5,10,19,5,14,40,67,74,3,Matches
217,Daniele Baselli,ITA,MF,Torino,Serie A,28,1992,4.4,12,7,3,6,3,6,10,60.0,4,2,0,2,9,21,5,0,Matches
218,Chris Basham,ENG,"DF,MF",Sheffield Utd,Premier League,32,1988,28.6,69,42,41,23,5,41,67,61.2,26,36,15,21,49,118,105,1,Matches
219,Toma Bašić,CRO,MF,Bordeaux,Ligue 1,23,1996,28.9,33,22,15,16,2,16,58,27.6,42,21,5,16,32,65,42,1,Matches
220,Álvaro Bastida,ESP,MF,Cádiz,La Liga,16,2004,0.4,0,0,0,0,0,0,0,,0,0,0,0,0,0,0,0,Matches
221,Alessandro Bastoni,ITA,DF,Inter,Serie A,21,1999,32.5,36,22,13,21,2,17,27,63.0,10,34,16,18,40,76,75,0,Matches
222,Simone Bastoni,ITA,DF,Spezia,Serie A,23,1996,16.9,50,29,26,22,2,27,52,51.9,25,19,1,18,16,66,31,0,Matches
223,Bastos,ANG,DF,Lazio,Serie A,29,1991,0.7,3,1,2,0,1,3,5,60.0,2,1,0,1,0,3,3,0,Matches
224,Michy Batshuayi,BEL,FW,Crystal Palace,Premier League,26,1993,8.1,5,3,1,2,2,1,9,11.1,8,5,1,4,4,9,5,0,Matches
225,Rodrigo Battaglia,ARG,MF,Alavés,La Liga,29,1991,27.7,38,16,21,14,3,16,50,32.0,34,30,14,16,29,67,40,1,Matches
226,Cristian Battocchio,ITA,MF,Brest,Ligue 1,28,1992,3.9,5,2,1,4,0,2,9,22.2,7,0,0,0,4,9,5,0,Matches
227,Oliver Baumann,GER,GK,Hoffenheim,Bundesliga,30,1990,31.0,0,0,0,0,0,0,1,0.0,1,0,0,0,2,2,14,0,Matches
228,Julian Baumgartlinger,AUT,MF,Leverkusen,Bundesliga,32,1988,11.9,43,20,14,26,3,16,31,51.6,15,12,0,12,12,55,10,1,Matches
229,Christoph Baumgartner,AUT,"MF,FW",Hoffenheim,Bundesliga,20,1999,26.3,44,31,13,24,7,14,51,27.5,37,40,8,32,24,68,24,0,Matches
230,Jon Bautista,ESP,FW,Real Sociedad,La Liga,25,1995,4.1,5,3,0,2,3,0,3,0.0,3,3,1,2,2,7,4,0,Matches
231,Paul Baysse,FRA,DF,Bordeaux,Ligue 1,32,1988,29.0,35,18,21,13,1,16,21,76.2,5,33,24,9,52,87,123,1,Matches
232,Noah Joel Sarenren Bazee,NGA,"FW,MF",Augsburg,Bundesliga,23,1996,0.4,0,0,0,0,0,0,1,0.0,1,0,0,0,1,1,0,0,Matches
233,Ihlas Bebou,TOG,"FW,MF",Hoffenheim,Bundesliga,26,1994,24.4,24,9,5,10,9,8,14,57.1,6,18,4,14,17,41,16,0,Matches
234,Rodrigo Becão,BRA,DF,Udinese,Serie A,24,1996,30.9,59,33,36,20,3,27,49,55.1,22,48,27,21,68,127,94,2,Matches
235,Sheraldo Becker,SUR,"FW,MF",Union Berlin,Bundesliga,25,1995,12.3,5,4,2,2,1,3,5,60.0,2,4,0,4,6,11,7,0,Matches
236,Timo Becker,GER,DF,Schalke 04,Bundesliga,23,1997,18.2,34,23,28,6,0,16,25,64.0,9,18,4,14,22,56,58,0,Matches
237,Jan Bednarek,POL,DF,Southampton,Premier League,24,1996,34.4,37,19,25,11,1,25,49,51.0,24,44,27,17,84,121,132,0,Matches
238,Donny van de Beek,NED,"MF,FW",Manchester Utd,Premier League,23,1997,5.8,15,10,2,11,2,7,15,46.7,8,10,1,9,6,21,7,0,Matches
239,Valon Behrami,SUI,MF,Genoa,Serie A,35,1985,9.9,21,9,9,10,2,9,26,34.6,17,13,5,8,9,30,13,0,Matches
240,Brian Behrendt,GER,DF,Arminia,Bundesliga,28,1991,0.9,0,0,0,0,0,0,1,0.0,1,0,0,0,0,0,1,0,Matches
241,Maximilian Beier,GER,"FW,DF",Hoffenheim,Bundesliga,17,2002,0.1,0,0,0,0,0,0,1,0.0,1,0,0,0,0,0,0,0,Matches
242,Ishak Belfodil,ALG,"FW,MF",Hoffenheim,Bundesliga,28,1992,6.6,3,2,0,0,3,0,2,0.0,2,1,0,1,1,4,3,0,Matches
243,Erwan Belhadji,FRA,MF,Dijon,Ligue 1,19,2001,0.3,3,0,3,0,0,3,5,60.0,2,1,0,1,0,3,0,0,Matches
244,Haris Belkebla,ALG,MF,Brest,Ligue 1,26,1994,30.3,69,39,32,28,9,31,66,47.0,35,26,5,21,57,126,34,0,Matches
245,Stefan Bell,GER,DF,Mainz 05,Bundesliga,28,1991,14.1,24,18,15,9,0,14,23,60.9,9,19,11,8,27,51,76,1,Matches
246,Karim Bellarabi,GER,"FW,MF",Leverkusen,Bundesliga,30,1990,8.9,12,10,3,4,5,4,17,23.5,13,12,0,12,12,24,4,0,Matches
247,Jean-Ricner Bellegarde,FRA,"MF,FW",Strasbourg,Ligue 1,22,1998,23.2,56,39,22,25,9,14,23,60.9,9,20,2,18,19,75,16,0,Matches
248,Héctor Bellerín,ESP,"DF,MF",Arsenal,Premier League,25,1995,23.2,29,19,14,12,3,12,41,29.3,29,26,8,18,33,62,33,0,Matches
249,Jude Bellingham,ENG,MF,Dortmund,Bundesliga,17,2003,18.9,49,31,11,29,9,19,46,41.3,27,37,5,32,24,73,13,0,Matches
250,Andrea Belotti,ITA,FW,Torino,Serie A,26,1993,32.1,30,18,4,16,10,11,35,31.4,24,27,4,23,12,42,21,0,Matches
251,Fran Beltrán,ESP,"MF,FW",Celta Vigo,La Liga,21,1999,15.5,30,22,15,12,3,8,24,33.3,16,14,1,13,16,46,24,0,Matches
252,Sami Ben Amar,MAR,MF,Nîmes,Ligue 1,22,1998,0.1,0,0,0,0,0,0,0,,0,1,0,1,0,0,0,0,Matches
253,Hatem Ben Arfa,FRA,"MF,FW",Bordeaux,Ligue 1,33,1987,18.9,11,7,1,7,3,2,9,22.2,7,3,0,3,2,13,0,0,Matches
254,Salim Ben Seghir,FRA,DF,Nice,Ligue 1,17,2003,0.1,0,0,0,0,0,0,0,,0,0,0,0,0,0,0,0,Matches
255,Wissam Ben Yedder,FRA,FW,Monaco,Ligue 1,29,1990,29.0,18,9,2,10,6,3,13,23.1,10,16,0,16,13,31,3,0,Matches
256,Ahmad Benali,LBY,MF,Crotone,Serie A,28,1992,13.5,19,11,10,9,0,11,38,28.9,27,15,2,13,6,25,15,0,Matches
257,Samy Benchamma,FRA,"DF,MF",Montpellier,Ligue 1,20,2000,0.5,1,1,1,0,0,0,0,,0,0,0,0,0,1,1,0,Matches
258,Lars Bender,GER,DF,Leverkusen,Bundesliga,31,1989,10.4,19,13,12,6,1,9,21,42.9,12,19,5,14,16,35,19,0,Matches
259,Sven Bender,GER,DF,Leverkusen,Bundesliga,31,1989,13.0,17,9,8,8,1,7,20,35.0,13,20,9,11,21,38,41,1,Matches
260,Darío Benedetto,ARG,FW,Marseille,Ligue 1,30,1990,17.5,6,4,1,4,1,5,13,38.5,8,9,2,7,3,9,17,0,Matches
261,László Bénes,SVK,MF,Augsburg,Bundesliga,22,1997,7.3,8,6,4,4,0,2,8,25.0,6,6,2,4,7,15,1,1,Matches
262,László Bénes,SVK,MF,Gladbach,Bundesliga,22,1997,1.7,6,2,5,1,0,2,4,50.0,2,0,0,0,2,8,1,0,Matches
263,Walter Benítez,ARG,GK,Nice,Ligue 1,27,1993,38.0,1,1,1,0,0,1,3,33.3,2,1,0,1,1,2,7,2,Matches
264,Loris Benito,SUI,DF,Bordeaux,Ligue 1,28,1992,29.5,42,26,27,12,3,22,48,45.8,26,33,10,23,42,84,70,0,Matches
265,Sergio Benito,ESP,FW,Valladolid,La Liga,21,1999,0.0,0,0,0,0,0,0,0,,0,0,0,0,0,0,0,0,Matches
266,Bilal Benkhedim,FRA,FW,Saint-Étienne,Ligue 1,19,2001,0.8,0,0,0,0,0,0,1,0.0,1,1,0,1,0,0,0,0,Matches
267,Djamel Benlamri,ALG,DF,Lyon,Ligue 1,30,1989,1.7,5,3,5,0,0,3,6,50.0,3,3,2,1,6,11,11,0,Matches
268,Ismaël Bennacer,ALG,MF,Milan,Serie A,22,1997,14.7,39,18,17,21,1,15,32,46.9,17,10,1,9,20,59,12,0,Matches
269,Saïd Benrahma,ALG,"FW,MF",West Ham,Premier League,24,1995,15.5,24,15,8,11,5,8,28,28.6,20,10,0,10,8,32,8,0,Matches
270,Yassine Benrahou,FRA,MF,Nîmes,Ligue 1,21,1999,13.8,16,9,8,6,2,7,25,28.0,18,9,0,9,4,20,5,1,Matches
271,Ramy Bensebaini,ALG,DF,Gladbach,Bundesliga,25,1995,20.1,43,24,27,13,3,26,42,61.9,16,39,7,32,47,90,66,0,Matches
272,Josh Benson,ENG,MF,Burnley,Premier League,20,1999,2.9,5,1,3,0,2,1,6,16.7,5,3,0,3,3,8,2,0,Matches
273,Nabil Bentaleb,ALG,MF,Schalke 04,Bundesliga,25,1994,6.1,14,8,7,6,1,4,15,26.7,11,5,2,3,6,20,8,0,Matches
274,Rodrigo Bentancur,URU,MF,Juventus,Serie A,23,1997,25.8,63,33,21,37,5,20,59,33.9,39,35,12,23,47,110,46,1,Matches
275,Christian Benteke,BEL,FW,Crystal Palace,Premier League,29,1990,20.2,15,7,1,7,7,2,9,22.2,7,17,6,11,4,19,39,0,Matches
276,Karim Benzema,FRA,FW,Real Madrid,La Liga,32,1987,32.2,8,6,4,2,2,5,15,33.3,10,9,2,7,8,16,24,0,Matches
277,Yassine Benzia,ALG,"MF,FW",Dijon,Ligue 1,25,1994,4.5,10,5,5,3,2,2,10,20.0,8,3,0,3,6,16,2,0,Matches
278,Alessandro Berardi,ITA,GK,Hellas Verona,Serie A,29,1991,0.3,0,0,0,0,0,0,0,,0,0,0,0,0,0,0,0,Matches
279,Domenico Berardi,ITA,FW,Sassuolo,Serie A,25,1994,27.5,42,22,17,11,14,21,62,33.9,41,23,1,22,26,68,34,0,Matches
280,Gaetano Berardi,SUI,DF,Leeds United,Premier League,31,1988,1.3,2,2,1,0,1,0,0,,0,2,1,1,1,3,2,0,Matches
281,Yuri Berchiche,ESP,DF,Athletic Club,La Liga,30,1990,18.7,24,19,14,5,5,10,24,41.7,14,14,0,14,11,35,29,0,Matches
282,Álex Berenguer,ESP,MF,Torino,Serie A,25,1995,1.5,2,0,0,0,2,2,5,40.0,3,2,0,2,0,2,1,0,Matches
283,Álex Berenguer,ESP,"MF,FW",Athletic Club,La Liga,25,1995,25.3,47,31,21,20,6,9,51,17.6,42,48,3,45,18,65,27,0,Matches
284,Bartosz Bereszyński,POL,DF,Sampdoria,Serie A,28,1992,29.0,66,44,37,22,7,41,73,56.2,32,40,20,20,42,108,88,0,Matches
285,Jóhann Berg Guðmundsson,ISL,MF,Burnley,Premier League,29,1990,15.1,19,11,6,9,4,11,23,47.8,12,11,2,9,17,36,19,0,Matches
286,Sander Berge,NOR,MF,Sheffield Utd,Premier League,22,1998,12.4,16,7,8,5,3,7,15,46.7,8,11,2,9,4,20,18,0,Matches
287,Steven Bergwijn,NED,"FW,MF",Tottenham,Premier League,22,1997,13.4,15,7,8,3,4,7,20,35.0,13,7,1,6,5,20,9,0,Matches
288,Valon Berisha,KVX,MF,Reims,Ligue 1,27,1993,18.3,40,23,19,17,4,11,47,23.4,36,14,2,12,25,65,21,1,Matches
289,Bernard,BRA,"MF,FW",Everton,Premier League,27,1992,5.1,8,3,3,3,2,7,15,46.7,8,5,0,5,8,16,6,0,Matches
290,Federico Bernardeschi,ITA,"MF,DF",Juventus,Serie A,26,1994,10.8,9,4,3,5,1,4,20,20.0,16,6,2,4,14,23,7,1,Matches
291,Bernardo,BRA,"DF,MF",Brighton,Premier League,25,1995,2.3,10,8,8,1,1,4,6,66.7,2,2,0,2,1,11,1,0,Matches
292,Paul Bernardoni,FRA,GK,Angers,Ligue 1,23,1997,38.0,1,1,1,0,0,1,2,50.0,1,0,0,0,2,3,23,1,Matches
293,Juan Bernat,ESP,DF,Paris S-G,Ligue 1,27,1993,2.2,5,3,0,4,1,3,5,60.0,2,4,0,4,1,6,6,0,Matches
294,Dimitry Bertaud,COD,GK,Montpellier,Ligue 1,22,1998,8.3,0,0,0,0,0,0,0,,0,0,0,0,1,1,2,0,Matches
295,Marco Bertini,ITA,MF,Lazio,Serie A,17,2002,0.1,1,0,1,0,0,0,0,,0,0,0,0,0,1,0,0,Matches
296,Ryan Bertrand,ENG,DF,Southampton,Premier League,30,1989,28.9,60,32,26,27,7,30,48,62.5,18,19,1,18,30,90,41,1,Matches
297,Daniel Bessa,ITA,MF,Hellas Verona,Serie A,27,1993,6.8,15,8,3,11,1,6,14,42.9,8,5,1,4,2,17,0,0,Matches
298,Loïc Bessile,TOG,DF,Bordeaux,Ligue 1,21,1999,1.0,0,0,0,0,0,0,0,,0,2,1,1,1,1,3,0,Matches
299,Jordan Beyer,GER,DF,Gladbach,Bundesliga,20,2000,2.1,2,1,2,0,0,1,2,50.0,1,5,4,1,5,7,5,0,Matches
300,Giulian Biancone,FRA,"DF,MF",Monaco,Ligue 1,20,2000,1.0,3,3,1,1,1,2,3,66.7,1,1,0,1,1,4,4,0,Matches
301,Bartosz Białek,POL,"FW,MF",Wolfsburg,Bundesliga,18,2001,3.0,6,5,1,4,1,4,4,100.0,0,5,1,4,3,9,4,0,Matches
302,Ermin Bičakčić,BIH,DF,Hoffenheim,Bundesliga,30,1990,1.4,1,1,0,1,0,1,1,100.0,0,1,1,0,3,4,9,0,Matches
303,Pedro Bigas,ESP,DF,Eibar,La Liga,29,1990,17.0,11,9,7,4,0,7,14,50.0,7,12,6,6,23,34,54,0,Matches
304,El Bilal Touré,MLI,FW,Reims,Ligue 1,18,2001,13.8,22,12,3,16,3,8,18,44.4,10,8,3,5,6,28,10,1,Matches
305,Cristiano Biraghi,ITA,DF,Fiorentina,Serie A,27,1992,31.1,42,23,19,15,8,27,45,60.0,18,23,9,14,27,69,56,3,Matches
306,Davide Biraschi,ITA,DF,Genoa,Serie A,26,1994,10.2,17,9,12,5,0,5,10,50.0,5,12,6,6,21,38,26,0,Matches
307,Yves Bissouma,MLI,MF,Brighton,Premier League,23,1996,34.6,104,68,50,48,6,33,67,49.3,34,42,6,36,64,168,67,0,Matches
308,Leonardo Bittencourt,GER,"MF,FW",Werder Bremen,Bundesliga,26,1993,16.8,58,32,24,28,6,16,51,31.4,35,29,2,27,13,71,10,0,Matches
309,Alejandro Blanco,ESP,MF,Valencia,La Liga,21,1998,6.4,8,4,4,4,0,3,18,16.7,15,5,0,5,8,16,9,0,Matches
310,Antonio Blanco,ESP,"MF,FW",Real Madrid,La Liga,20,2000,2.4,7,2,4,2,1,3,7,42.9,4,6,2,4,3,10,5,0,Matches
311,Rubén Blanco,ESP,GK,Celta Vigo,La Liga,25,1995,18.2,0,0,0,0,0,0,0,,0,0,0,0,0,0,7,3,Matches
312,Ludovic Blas,FRA,"MF,FW",Nantes,Ligue 1,22,1997,31.0,58,30,18,37,3,23,54,42.6,31,33,4,29,21,79,19,0,Matches
313,Alejandro Blesa,ESP,MF,Levante,La Liga,18,2002,0.1,0,0,0,0,0,0,0,,0,0,0,0,0,0,0,0,Matches
314,Jérôme Boateng,GER,DF,Bayern Munich,Bundesliga,31,1988,26.3,26,16,17,8,1,14,32,43.8,18,24,17,7,40,66,63,1,Matches
315,Antonin Bobichon,FRA,"MF,FW",Angers,Ligue 1,24,1995,10.1,23,14,10,8,5,9,15,60.0,6,4,1,3,2,25,1,0,Matches
316,Yann Bodiger,FRA,MF,Cádiz,La Liga,25,1995,2.8,2,2,1,1,0,1,6,16.7,5,7,3,4,8,10,4,0,Matches
317,Jean-Paul Boëtius,NED,"MF,FW",Mainz 05,Bundesliga,26,1994,22.9,42,28,13,15,14,17,47,36.2,30,37,3,34,33,75,14,0,Matches
318,Sacha Boey,FRA,DF,Dijon,Ligue 1,19,2000,20.7,54,40,30,23,1,27,55,49.1,28,25,5,20,41,95,62,0,Matches
319,Sacha Boey,FRA,DF,Rennes,Ligue 1,19,2000,1.4,3,3,2,1,0,3,4,75.0,1,0,0,0,2,5,2,0,Matches
320,Jeremie Boga,CIV,"FW,MF",Sassuolo,Serie A,23,1997,19.8,11,9,5,0,6,3,11,27.3,8,10,0,10,8,19,7,0,Matches
321,Melayro Bogarde,NED,"DF,MF",Hoffenheim,Bundesliga,18,2002,3.1,7,3,3,3,1,5,9,55.6,4,0,0,0,5,12,1,0,Matches
322,Jayden Bogle,ENG,"DF,MF",Sheffield Utd,Premier League,20,2000,12.3,33,23,21,10,2,20,39,51.3,19,14,4,10,14,47,22,0,Matches
323,Quentin Boisgard,FRA,"MF,FW",Lorient,Ligue 1,23,1997,14.6,24,17,3,15,6,11,24,45.8,13,17,2,15,15,39,1,0,Matches
324,Willy Boly,CIV,DF,Wolves,Premier League,29,1991,20.9,33,20,26,7,0,13,24,54.2,11,18,12,6,32,65,84,1,Matches
325,Giacomo Bonaventura,ITA,MF,Fiorentina,Serie A,30,1989,25.1,34,19,16,13,5,16,53,30.2,37,26,2,24,39,73,12,0,Matches
326,Federico Bonazzoli,ITA,FW,Torino,Serie A,23,1997,6.3,6,4,0,4,2,2,13,15.4,11,3,0,3,2,8,3,0,Matches
327,Federico Bonazzoli,ITA,FW,Sampdoria,Serie A,23,1997,1.5,0,0,0,0,0,0,0,,0,1,0,1,0,0,0,0,Matches
328,Kevin Bonifazi,ITA,DF,Udinese,Serie A,24,1996,27.4,32,21,24,6,2,8,23,34.8,15,33,20,13,50,82,85,1,Matches
329,Leonardo Bonucci,ITA,DF,Juventus,Serie A,33,1987,22.5,19,14,10,8,1,6,14,42.9,8,24,13,11,33,52,67,0,Matches
330,Elias Bördner,GER,GK,Eint Frankfurt,Bundesliga,18,2002,1.0,1,0,1,0,0,1,1,100.0,0,0,0,0,2,3,1,0,Matches
331,Dennis Borkowski,GER,"MF,FW",RB Leipzig,Bundesliga,18,2002,0.1,0,0,0,0,0,0,0,,0,1,0,1,0,0,0,0,Matches
332,Sebastiaan Bornauw,BEL,DF,Köln,Bundesliga,21,1999,23.1,29,20,25,4,0,14,25,56.0,11,33,26,7,40,69,104,0,Matches
333,Sven Botman,NED,DF,Lille,Ligue 1,20,2000,36.8,31,21,18,12,1,14,26,53.8,12,31,21,10,57,88,126,2,Matches
334,Denis Bouanga,GAB,"MF,FW",Saint-Étienne,Ligue 1,25,1994,30.2,52,28,22,24,6,16,58,27.6,42,32,3,29,20,72,36,0,Matches
335,Hicham Boudaoui,ALG,MF,Nice,Ligue 1,20,1999,19.3,52,35,20,24,8,26,68,38.2,42,14,4,10,23,75,26,1,Matches
336,Ryad Boudebouz,ALG,"MF,FW",Saint-Étienne,Ligue 1,30,1990,7.2,9,4,1,7,1,4,8,50.0,4,3,0,3,5,14,5,0,Matches
337,Sofiane Boufal,MAR,"FW,MF",Angers,Ligue 1,26,1993,8.1,17,11,8,6,3,8,28,28.6,20,8,0,8,3,20,1,0,Matches
338,Nassim Boujellab,MAR,"MF,FW",Schalke 04,Bundesliga,21,1999,6.7,13,9,2,10,1,2,12,16.7,10,10,3,7,7,20,9,0,Matches
339,Farid Boulaya,ALG,"MF,FW",Metz,Ligue 1,27,1993,31.3,24,16,4,17,3,13,51,25.5,38,19,3,16,12,36,7,0,Matches
340,Yassine Bounou,MAR,GK,Sevilla,La Liga,29,1991,33.0,1,1,1,0,0,0,2,0.0,2,0,0,0,0,1,12,2,Matches
341,Ismaëlben Boura,COM,DF,Lens,Ligue 1,19,2000,9.1,11,7,8,2,1,3,9,33.3,6,7,2,5,21,32,12,0,Matches
342,Mehdi Bourabia,MAR,MF,Sassuolo,Serie A,28,1991,5.9,6,5,1,4,1,2,7,28.6,5,14,6,8,12,18,8,0,Matches
343,Benjamin Bourigeaud,FRA,"MF,FW",Rennes,Ligue 1,26,1994,28.4,40,23,17,16,7,21,71,29.6,50,37,1,36,19,59,25,0,Matches
344,Edoardo Bove,ITA,MF,Roma,Serie A,18,2002,0.1,0,0,0,0,0,0,1,0.0,1,0,0,0,0,0,0,0,Matches
345,Jarrod Bowen,ENG,"FW,MF",West Ham,Premier League,23,1996,28.5,26,15,12,7,7,10,29,34.5,19,19,1,18,22,48,10,0,Matches
346,Dedryck Boyata,BEL,DF,Hertha BSC,Bundesliga,29,1990,17.2,14,7,10,3,1,7,15,46.7,8,23,20,3,26,40,68,1,Matches
347,John Boye,GHA,DF,Metz,Ligue 1,33,1987,33.8,58,34,43,13,2,31,54,57.4,23,36,20,16,80,138,146,1,Matches
348,Lucas Boyé,ARG,FW,Elche,La Liga,24,1996,29.9,47,31,13,27,7,10,49,20.4,39,37,2,35,19,66,21,0,Matches
349,Can Bozdogan,GER,"MF,FW",Schalke 04,Bundesliga,19,2001,7.2,13,5,6,6,1,4,15,26.7,11,10,2,8,7,20,5,0,Matches
350,Umut Bozok,TUR,"MF,FW",Lorient,Ligue 1,23,1996,0.7,0,0,0,0,0,0,2,0.0,2,0,0,0,0,0,0,0,Matches
351,Jayden Braaf,NED,FW,Udinese,Serie A,17,2002,1.3,0,0,0,0,0,0,1,0.0,1,0,0,0,0,0,0,0,Matches
352,Domagoj Bradarić,CRO,DF,Lille,Ligue 1,20,1999,14.0,28,18,11,13,4,12,27,44.4,15,14,4,10,26,54,21,0,Matches
353,Robbie Brady,IRL,MF,Burnley,Premier League,28,1992,11.7,22,15,12,6,4,12,35,34.3,23,16,0,16,9,31,29,1,Matches
354,Martin Braithwaite,DEN,FW,Barcelona,La Liga,29,1991,13.1,8,4,2,3,3,1,6,16.7,5,2,0,2,6,14,7,0,Matches
355,Julian Brandt,GER,"FW,MF",Dortmund,Bundesliga,24,1996,16.6,27,14,13,9,5,12,43,27.9,31,25,1,24,17,44,7,1,Matches
356,Darko Brašanac,SRB,MF,Osasuna,La Liga,28,1992,10.1,10,6,6,4,0,5,16,31.3,11,8,1,7,7,17,10,0,Matches
357,Lilian Brassier,FRA,DF,Brest,Ligue 1,20,1999,10.7,19,10,12,4,3,7,11,63.6,4,13,6,7,23,42,38,1,Matches
358,Álvaro Bravo,ESP,MF,Granada,La Liga,22,1998,0.2,1,1,1,0,0,1,2,50.0,1,0,0,0,1,2,0,0,Matches
359,Claudio Bravo,CHI,GK,Betis,La Liga,37,1983,20.0,0,0,0,0,0,0,1,0.0,1,0,0,0,0,0,11,0,Matches
360,Fabian Bredlow,GER,GK,Stuttgart,Bundesliga,25,1995,1.0,0,0,0,0,0,0,0,,0,0,0,0,0,0,0,0,Matches
361,Josip Brekalo,CRO,FW,Wolfsburg,Bundesliga,22,1998,20.2,22,10,10,7,5,8,29,27.6,21,18,0,18,17,39,3,1,Matches
362,Gleison Bremer,BRA,DF,Torino,Serie A,23,1997,32.6,51,34,36,14,1,21,36,58.3,15,54,21,33,70,121,142,1,Matches
363,Joshua Brenet,CUW,DF,Hoffenheim,Bundesliga,26,1994,0.0,0,0,0,0,0,0,0,,0,0,0,0,0,0,0,0,Matches
364,Rhian Brewster,ENG,"FW,MF",Sheffield Utd,Premier League,20,2000,12.5,8,5,1,4,3,1,13,7.7,12,15,2,13,5,13,5,0,Matches
365,Anthony Briançon,FRA,DF,Nîmes,Ligue 1,25,1994,13.6,12,7,9,3,0,9,19,47.4,10,19,12,7,33,45,57,2,Matches
366,Jimmy Briand,FRA,FW,Bordeaux,Ligue 1,34,1985,6.3,7,3,3,2,2,1,1,100.0,0,2,0,2,1,8,3,0,Matches
367,Yan Brice Eteki,CMR,MF,Granada,La Liga,22,1997,14.7,23,15,10,12,1,8,19,42.1,11,13,3,10,13,36,16,1,Matches
368,Nathan Broadhead,WAL,FW,Everton,Premier League,22,1998,0.0,1,1,0,1,0,0,0,,0,0,0,0,0,1,0,0,Matches
369,Dylan Bronn,TUN,DF,Metz,Ligue 1,25,1995,37.9,57,37,38,19,0,24,44,54.5,20,31,14,17,44,101,112,0,Matches
370,John Brooks,USA,DF,Wolfsburg,Bundesliga,27,1993,30.8,47,29,33,14,0,30,54,55.6,24,35,10,25,55,102,134,0,Matches
371,Daniel Brosinski,GER,"DF,FW",Mainz 05,Bundesliga,32,1988,15.9,19,14,10,7,2,12,31,38.7,19,18,1,17,14,33,33,0,Matches
372,Josh Brownhill,ENG,MF,Burnley,Premier League,24,1995,31.3,45,27,9,29,7,15,44,34.1,29,33,11,22,69,114,39,0,Matches
373,Marcelo Brozović,CRO,MF,Inter,Serie A,27,1992,28.7,54,29,23,24,7,20,61,32.8,41,43,17,26,40,94,38,0,Matches
374,Gastón Brugman,URU,MF,Parma,Serie A,27,1992,18.0,35,19,18,15,2,11,44,25.0,33,33,4,29,45,80,34,0,Matches
375,Juan Brunet,ARG,MF,Granada,La Liga,22,1998,0.3,0,0,0,0,0,0,0,,0,0,0,0,0,0,1,0,Matches
376,Juan Brunetta,ARG,"FW,MF",Parma,Serie A,23,1997,5.3,2,2,0,2,0,1,6,16.7,5,5,0,5,1,3,2,0,Matches
377,Cédric Brunner,SUI,DF,Arminia,Bundesliga,26,1994,29.5,42,22,24,15,3,27,40,67.5,13,30,10,20,42,84,96,0,Matches
378,Jacob Bruun Larsen,DEN,"MF,FW",Hoffenheim,Bundesliga,21,1998,1.0,0,0,0,0,0,0,0,,0,0,0,0,0,0,0,0,Matches
379,Joe Bryan,ENG,"DF,MF",Fulham,Premier League,26,1993,7.4,15,8,7,5,3,7,12,58.3,5,8,2,6,14,29,16,0,Matches
380,Kean Bryan,ENG,DF,Sheffield Utd,Premier League,23,1996,11.2,20,10,9,11,0,9,19,47.4,10,16,10,6,13,33,39,1,Matches
381,Lucas Buadés,FRA,MF,Nîmes,Ligue 1,22,1997,0.2,1,0,0,1,0,0,0,,0,0,0,0,0,1,0,0,Matches
382,Ante Budimir,CRO,FW,Osasuna,La Liga,29,1991,18.1,20,12,2,11,7,4,15,26.7,11,17,4,13,2,22,17,1,Matches
383,Gianluigi Buffon,ITA,GK,Juventus,Serie A,42,1978,8.0,0,0,0,0,0,0,0,,0,0,0,0,0,0,3,1,Matches
384,Marius Bülter,GER,"FW,MF",Union Berlin,Bundesliga,27,1993,10.9,15,8,6,6,3,5,17,29.4,12,17,2,15,12,27,11,0,Matches
385,Alessandro Buongiorno,ITA,DF,Torino,Serie A,21,1999,9.5,12,5,8,4,0,7,12,58.3,5,15,9,6,11,23,44,1,Matches
386,Esteban Burgos,ARG,DF,Eibar,La Liga,28,1992,12.3,7,6,4,3,0,1,5,20.0,4,8,7,1,23,30,54,2,Matches
387,Burgui,ESP,MF,Alavés,La Liga,26,1993,0.2,3,1,2,1,0,1,1,100.0,0,0,0,0,0,3,0,0,Matches
388,Jonathan Burkardt,GER,"FW,MF",Mainz 05,Bundesliga,20,2000,15.3,27,13,15,10,2,11,19,57.9,8,20,3,17,8,35,15,0,Matches
389,Nishan Burkart,SUI,MF,Freiburg,Bundesliga,20,2000,0.2,0,0,0,0,0,0,1,0.0,1,0,0,0,0,0,0,0,Matches
390,Oliver Burke,SCO,FW,Sheffield Utd,Premier League,23,1997,14.1,16,8,6,9,1,5,24,20.8,19,24,0,24,2,18,6,0,Matches
391,Roman Bürki,SUI,GK,Dortmund,Bundesliga,29,1990,18.5,0,0,0,0,0,0,0,,0,0,0,0,0,0,5,1,Matches
392,Dan Burn,ENG,DF,Brighton,Premier League,28,1992,22.9,50,26,33,14,3,27,53,50.9,26,30,7,23,31,81,75,0,Matches
393,Patrick Burner,MTQ,DF,Nice,Ligue 1,24,1996,0.0,0,0,0,0,0,0,0,,0,0,0,0,0,0,0,0,Matches
394,Patrick Burner,MTQ,DF,Nîmes,Ligue 1,24,1996,14.6,25,11,14,10,1,13,26,50.0,13,10,3,7,24,49,41,1,Matches
395,Maxime Busi,BEL,DF,Parma,Serie A,20,1999,13.3,23,13,19,3,1,11,28,39.3,17,14,1,13,16,39,32,0,Matches
396,Sergio Busquets,ESP,MF,Barcelona,La Liga,32,1988,28.0,63,35,21,29,13,27,76,35.5,49,27,4,23,53,116,18,2,Matches
397,Jack Butland,ENG,GK,Crystal Palace,Premier League,27,1993,1.0,0,0,0,0,0,0,0,,0,0,0,0,0,0,0,0,Matches
398,David Button,ENG,GK,West Brom,Premier League,31,1989,1.0,0,0,0,0,0,0,0,,0,0,0,0,0,0,0,0,Matches
399,Oskar Buur,DEN,DF,Wolves,Premier League,22,1998,0.2,0,0,0,0,0,0,2,0.0,2,0,0,0,0,0,0,0,Matches
400,Marcin Bułka,POL,GK,Paris S-G,Ligue 1,20,1999,1.0,0,0,0,0,0,0,0,,0,0,0,0,0,0,0,1,Matches
401,Erick Cabaco,URU,DF,Getafe,La Liga,25,1995,14.7,24,14,11,12,1,12,22,54.5,10,8,6,2,13,37,51,1,Matches
402,Willy Caballero,ARG,GK,Chelsea,Premier League,38,1981,1.0,0,0,0,0,0,0,0,,0,0,0,0,0,0,0,0,Matches
403,Jimmy Cabot,FRA,"FW,MF",Angers,Ligue 1,26,1994,10.5,26,13,8,14,4,11,36,30.6,25,8,0,8,12,38,6,0,Matches
404,Martín Cáceres,URU,DF,Fiorentina,Serie A,33,1987,24.9,28,12,16,11,1,15,35,42.9,20,20,14,6,14,42,52,1,Matches
405,Anthony Caci,FRA,DF,Strasbourg,Ligue 1,23,1997,31.1,80,46,47,27,6,35,69,50.7,34,30,4,26,55,135,65,1,Matches
406,Mathieu Cafaro,FRA,"MF,FW",Reims,Ligue 1,23,1997,23.0,40,17,15,19,6,13,43,30.2,30,11,0,11,17,57,12,0,Matches
407,Gary Cahill,ENG,DF,Crystal Palace,Premier League,34,1985,20.0,13,9,10,3,0,7,11,63.6,4,27,22,5,13,26,88,0,Matches
408,Yannick Cahuzac,FRA,MF,Lens,Ligue 1,35,1985,25.0,26,12,12,10,4,9,27,33.3,18,18,5,13,33,59,72,0,Matches
409,Felipe Caicedo,ECU,FW,Lazio,Serie A,31,1988,10.3,10,7,4,4,2,1,8,12.5,7,7,0,7,4,14,2,0,Matches
410,Marc-Aurèle Caillard,FRA,GK,Metz,Ligue 1,26,1994,4.0,0,0,0,0,0,0,0,,0,0,0,0,0,0,2,0,Matches
411,Tom Cairney,SCO,MF,Fulham,Premier League,29,1991,8.4,9,3,1,4,4,1,4,25.0,3,6,0,6,0,9,3,0,Matches
412,Cala,ESP,DF,Cádiz,La Liga,30,1989,25.2,21,12,15,6,0,11,21,52.4,10,18,8,10,35,56,91,0,Matches
413,Arturo Calabresi,ITA,"DF,FW",Bologna,Serie A,24,1996,0.2,0,0,0,0,0,0,0,,0,0,0,0,0,0,2,0,Matches
414,Arturo Calabresi,ITA,DF,Cagliari,Serie A,24,1996,0.2,0,0,0,0,0,0,1,0.0,1,0,0,0,0,0,0,0,Matches
415,Davide Calabria,ITA,DF,Milan,Serie A,23,1996,29.4,101,64,61,32,8,54,90,60.0,36,42,9,33,37,138,82,1,Matches
416,Riccardo Calafiori,ITA,DF,Roma,Serie A,18,2002,0.7,1,0,1,0,0,1,4,25.0,3,1,0,1,0,1,0,0,Matches
417,Mattia Caldara,ITA,DF,Atalanta,Serie A,26,1994,1.2,1,0,0,1,0,1,1,100.0,0,3,2,1,4,5,3,0,Matches
418,Luca Caldirola,ITA,DF,Benevento,Serie A,29,1991,17.5,21,13,13,6,2,10,22,45.5,12,20,15,5,20,41,56,0,Matches
419,Duje Ćaleta-Car,CRO,DF,Marseille,Ligue 1,23,1996,31.3,29,17,19,9,1,17,30,56.7,13,29,22,7,44,73,130,0,Matches
420,Hakan Çalhanoğlu,TUR,"MF,FW",Milan,Serie A,26,1994,29.0,26,7,3,17,6,7,28,25.0,21,21,6,15,15,41,24,1,Matches
421,Kerim Calhanoglu,GER,DF,Schalke 04,Bundesliga,17,2002,3.3,3,3,1,1,1,0,3,0.0,3,4,0,4,7,10,6,0,Matches
422,Fabrizio Caligara,ITA,"MF,FW",Cagliari,Serie A,20,2000,2.0,6,4,2,2,2,6,9,66.7,3,9,2,7,3,9,3,0,Matches
423,Daniel Caligiuri,ITA,"MF,FW",Augsburg,Bundesliga,32,1988,29.6,71,46,29,31,11,29,92,31.5,63,45,6,39,38,109,41,0,Matches
424,José Callejón,ESP,"FW,MF",Fiorentina,Serie A,33,1987,7.4,10,7,0,6,4,5,9,55.6,4,4,1,3,4,14,5,0,Matches
425,Jonathan Calleri,ARG,FW,Osasuna,La Liga,26,1993,17.2,15,6,2,4,9,3,17,17.6,14,18,2,16,1,16,10,1,Matches
426,Dominic Calvert-Lewin,ENG,FW,Everton,Premier League,23,1997,31.9,17,8,1,8,8,6,12,50.0,6,22,6,16,6,23,33,0,Matches
427,Dani Calvo,ESP,DF,Elche,La Liga,26,1994,19.8,20,13,13,7,0,7,10,70.0,3,18,12,6,11,31,71,0,Matches
428,Drissa Camara,CIV,MF,Parma,Serie A,18,2002,0.2,0,0,0,0,0,0,0,,0,0,0,0,0,0,0,0,Matches
429,Mahdi Camara,FRA,"MF,DF",Saint-Étienne,Ligue 1,22,1998,36.6,99,67,43,46,10,33,60,55.0,27,50,12,38,78,177,51,0,Matches
430,Eduardo Camavinga,FRA,MF,Rennes,Ligue 1,17,2002,26.7,98,58,39,48,11,38,77,49.4,39,36,2,34,23,121,15,1,Matches
431,José Campaña,ESP,MF,Levante,La Liga,27,1993,8.3,14,6,3,6,5,5,14,35.7,9,2,0,2,13,27,4,0,Matches
432,Emre Can,GER,"DF,MF",Dortmund,Bundesliga,26,1994,23.7,43,34,20,20,3,20,37,54.1,17,35,10,25,48,91,52,0,Matches
433,Sergio Canales,ESP,"MF,FW",Betis,La Liga,29,1991,27.8,16,9,9,6,1,3,21,14.3,18,18,0,18,13,29,5,0,Matches
434,João Cancelo,POR,"DF,MF",Manchester City,Premier League,26,1994,25.5,68,41,42,19,7,43,83,51.8,40,23,2,21,41,109,33,2,Matches
435,Antonio Candreva,ITA,MF,Sampdoria,Serie A,33,1987,27.8,28,19,17,9,2,21,53,39.6,32,24,3,21,9,37,27,1,Matches
436,Álex Cantero,ESP,FW,Levante,La Liga,20,2000,2.6,2,1,0,2,0,1,2,50.0,1,1,0,1,0,2,3,0,Matches
437,Ander Capa,ESP,DF,Athletic Club,La Liga,28,1992,23.7,37,18,22,13,2,18,37,48.6,19,21,8,13,25,62,57,0,Matches
438,Pierrick Capelle,FRA,"MF,DF",Angers,Ligue 1,33,1987,22.8,53,28,24,17,12,31,79,39.2,48,25,1,24,47,100,32,0,Matches
439,Étienne Capoue,FRA,MF,Villarreal,La Liga,32,1988,13.2,20,10,14,6,0,8,18,44.4,10,7,1,6,20,40,23,0,Matches
440,Elio Capradossi,UGA,DF,Spezia,Serie A,24,1996,1.0,2,1,2,0,0,2,2,100.0,0,0,0,0,1,3,5,0,Matches
441,Gianluca Caprari,ITA,"MF,FW",Benevento,Serie A,27,1993,20.7,16,11,5,5,6,6,31,19.4,25,19,1,18,18,34,8,0,Matches
442,Francesco Caputo,ITA,FW,Sassuolo,Serie A,32,1987,18.9,0,0,0,0,0,0,2,0.0,2,4,0,4,1,1,3,0,Matches
443,Maxence Caqueret,FRA,MF,Lyon,Ligue 1,20,2000,19.6,72,45,17,39,16,35,106,33.0,71,35,3,32,23,95,5,2,Matches
444,Andrea Carboni,ITA,DF,Cagliari,Serie A,19,2001,12.1,34,23,23,11,0,15,28,53.6,13,15,4,11,14,48,52,0,Matches
445,Isaac Carcelen,ESP,DF,Cádiz,La Liga,27,1993,28.7,68,43,36,25,7,33,60,55.0,27,37,12,25,49,117,89,0,Matches
446,Cárdenas,ESP,GK,Levante,La Liga,23,1997,8.0,0,0,0,0,0,0,1,0.0,1,0,0,0,3,3,5,1,Matches
447,Irvin Cardona,FRA,FW,Brest,Ligue 1,22,1997,22.5,10,5,3,6,1,4,22,18.2,18,17,3,14,9,19,23,2,Matches
448,Marc Cardona,ESP,"FW,DF",Osasuna,La Liga,25,1995,0.6,1,0,1,0,0,1,1,100.0,0,0,0,0,0,1,0,0,Matches
449,Diego Carlos,BRA,DF,Sevilla,La Liga,27,1993,31.0,22,13,17,4,1,8,16,50.0,8,35,27,8,31,53,114,1,Matches
450,Juan Carlos,ESP,"MF,FW",Huesca,La Liga,29,1991,3.2,5,3,4,1,0,2,15,13.3,13,7,0,7,1,6,1,0,Matches
451,Lionel Carole,FRA,DF,Strasbourg,Ligue 1,29,1991,14.9,37,25,18,14,5,16,29,55.2,13,3,1,2,38,75,28,0,Matches
452,Yannick Carrasco,BEL,"DF,MF",Atlético Madrid,La Liga,26,1993,24.2,27,15,14,6,7,15,34,44.1,19,24,0,24,17,44,16,1,Matches
453,Sergio Carreira,ESP,DF,Celta Vigo,La Liga,19,2000,2.9,3,0,2,1,0,1,1,100.0,0,2,0,2,1,4,7,0,Matches
454,Guido Carrillo,ARG,FW,Elche,La Liga,29,1991,11.1,9,8,1,7,1,2,8,25.0,6,2,1,1,4,13,14,0,Matches
455,Andy Carroll,ENG,FW,Newcastle Utd,Premier League,31,1989,4.4,3,1,1,1,1,1,8,12.5,7,1,0,1,0,3,14,0,Matches
456,Scott Carson,ENG,GK,Manchester City,Premier League,34,1985,1.0,0,0,0,0,0,0,0,,0,0,0,0,0,0,0,0,Matches
457,Dani Carvajal,ESP,DF,Real Madrid,La Liga,28,1992,10.6,27,20,12,10,5,11,20,55.0,9,19,1,18,13,40,27,0,Matches
458,Fabio Carvalho,POR,"MF,FW",Fulham,Premier League,17,2002,2.8,9,6,4,4,1,5,9,55.6,4,2,0,2,1,10,1,1,Matches
459,William Carvalho,POR,MF,Betis,La Liga,28,1992,13.6,19,12,7,11,1,5,21,23.8,16,11,3,8,11,30,14,1,Matches
460,Casemiro,BRA,MF,Real Madrid,La Liga,28,1992,32.2,84,49,50,30,4,33,73,45.2,40,50,17,33,70,154,62,0,Matches
461,Matty Cash,POL,DF,Aston Villa,Premier League,22,1997,26.4,71,40,43,22,6,41,74,55.4,33,50,11,39,60,131,95,0,Matches
462,Kiko Casilla,ESP,GK,Leeds United,Premier League,33,1986,3.0,0,0,0,0,0,0,0,,0,0,0,0,0,0,0,0,Matches
463,Giuseppe Caso,ITA,"DF,FW",Genoa,Serie A,21,1998,0.6,0,0,0,0,0,0,0,,0,0,0,0,0,0,0,0,Matches
464,Moreto Cassamã,GNB,MF,Reims,Ligue 1,22,1998,22.6,49,36,24,23,2,27,49,55.1,22,19,6,13,36,85,33,4,Matches
465,Francesco Cassata,ITA,"DF,FW",Genoa,Serie A,23,1997,2.5,7,6,7,0,0,4,7,57.1,3,0,0,0,3,10,1,0,Matches
466,Timothy Castagne,BEL,DF,Leicester City,Premier League,24,1995,26.1,52,32,29,18,5,24,44,54.5,20,29,5,24,29,81,62,1,Matches
467,Koen Casteels,BEL,GK,Wolfsburg,Bundesliga,28,1992,32.0,0,0,0,0,0,0,1,0.0,1,1,0,1,2,2,9,2,Matches
468,Jean-Charles Castelletto,CMR,DF,Nantes,Ligue 1,25,1995,21.6,32,18,20,11,1,18,31,58.1,13,25,19,6,42,74,79,0,Matches
469,Samu Castillejo,ESP,FW,Milan,Serie A,25,1995,13.1,24,12,9,14,1,14,40,35.0,26,21,0,21,6,30,9,0,Matches
470,Gonzalo Castro,GER,MF,Stuttgart,Bundesliga,33,1987,19.2,21,7,6,9,6,8,23,34.8,15,16,3,13,8,29,12,0,Matches
471,Jonny Castro,ESP,"MF,DF",Wolves,Premier League,26,1994,5.5,11,5,6,4,1,6,13,46.2,7,9,3,6,9,20,7,0,Matches
472,Gaetano Castrovilli,ITA,MF,Fiorentina,Serie A,23,1997,25.9,33,19,15,11,7,11,42,26.2,31,25,2,23,34,67,14,0,Matches
473,Danilo Cataldi,ITA,MF,Lazio,Serie A,25,1994,6.3,7,2,1,5,1,4,18,22.2,14,3,1,2,9,16,7,0,Matches
474,Ivan Cavaleiro,POR,FW,Fulham,Premier League,26,1993,27.5,23,14,9,11,3,12,34,35.3,22,25,1,24,19,42,14,0,Matches
475,Edinson Cavani,URU,FW,Manchester Utd,Premier League,33,1987,15.3,12,8,1,8,3,2,13,15.4,11,2,0,2,6,18,11,0,Matches
476,Dani Ceballos,ESP,MF,Arsenal,Premier League,23,1996,17.9,37,22,20,11,6,21,51,41.2,30,23,6,17,35,72,14,1,Matches
477,Federico Ceccherini,ITA,DF,Hellas Verona,Serie A,28,1992,19.3,16,12,10,6,0,2,7,28.6,5,15,8,7,40,56,60,0,Matches
478,Federico Ceccherini,ITA,DF,Fiorentina,Serie A,28,1992,3.0,4,1,1,3,0,1,1,100.0,0,6,5,1,7,11,15,0,Matches
479,Zeki Çelik,TUR,DF,Lille,Ligue 1,23,1997,26.5,72,33,30,30,12,44,81,54.3,37,32,6,26,38,110,52,0,Matches
480,Bersant Celina,KVX,"MF,FW",Dijon,Ligue 1,23,1996,25.5,20,12,8,8,4,7,38,18.4,31,20,2,18,8,28,10,0,Matches
481,Fabien Centonze,FRA,DF,Metz,Ligue 1,24,1996,35.8,104,68,64,30,10,43,73,58.9,30,62,17,45,112,216,119,1,Matches
482,Luca Ceppitelli,ITA,DF,Cagliari,Serie A,30,1989,16.3,25,19,13,10,2,14,26,53.8,12,23,12,11,25,50,58,1,Matches
483,Alberto Cerri,ITA,FW,Cagliari,Serie A,24,1996,4.1,3,2,0,2,1,0,5,0.0,5,4,2,2,2,5,6,0,Matches
484,Sava Cestic,SRB,DF,Köln,Bundesliga,19,2001,10.0,20,9,12,6,2,8,17,47.1,9,13,4,9,18,38,40,0,Matches
485,Julian Chabot,GER,DF,Spezia,Serie A,22,1998,18.4,48,34,28,16,4,23,37,62.2,14,25,13,12,37,85,43,1,Matches
486,Nassim Chadli,FRA,"FW,MF",Nîmes,Ligue 1,19,2001,0.3,2,1,2,0,0,0,1,0.0,1,1,0,1,0,2,0,0,Matches
487,Fouad Chafik,MAR,DF,Dijon,Ligue 1,33,1986,18.0,39,24,29,8,2,16,35,45.7,19,19,10,9,21,60,41,0,Matches
488,Mehdi Chahiri,MAR,"FW,MF",Strasbourg,Ligue 1,24,1996,8.9,18,8,7,5,6,8,20,40.0,12,9,0,9,6,24,5,0,Matches
489,Sofian Chakla,MAR,DF,Villarreal,La Liga,26,1993,0.1,0,0,0,0,0,0,0,,0,0,0,0,0,0,0,0,Matches
490,Sofian Chakla,MAR,DF,Getafe,La Liga,26,1993,10.0,12,8,10,1,1,5,7,71.4,2,3,2,1,14,26,48,1,Matches
491,Aníbal Chalá,ECU,DF,Dijon,Ligue 1,24,1996,8.3,10,7,6,3,1,6,12,50.0,6,5,3,2,14,24,15,1,Matches
492,Trevoh Chalobah,ENG,"DF,MF",Lorient,Ligue 1,21,1999,24.9,45,26,32,13,0,24,50,48.0,26,20,7,13,69,114,56,0,Matches
493,Calum Chambers,ENG,DF,Arsenal,Premier League,25,1995,8.4,7,3,3,2,2,3,8,37.5,5,6,2,4,10,17,37,0,Matches
494,Timothy Chandler,USA,DF,Eint Frankfurt,Bundesliga,30,1990,4.8,4,0,2,1,1,1,4,25.0,3,5,2,3,3,7,5,0,Matches
495,Kwon Chang-hoon,KOR,"MF,FW",Freiburg,Bundesliga,26,1994,2.4,3,1,1,0,2,1,3,33.3,2,3,1,2,7,10,2,1,Matches
496,Gaëtan Charbonnier,FRA,"MF,FW",Brest,Ligue 1,31,1988,17.4,24,15,6,11,7,12,32,37.5,20,15,1,14,9,33,19,0,Matches
497,Brendan Chardonnet,FRA,DF,Brest,Ligue 1,25,1994,30.2,51,29,31,19,1,27,41,65.9,14,54,41,13,64,115,151,0,Matches
498,Xavier Chavalerin,FRA,MF,Reims,Ligue 1,29,1991,28.3,92,50,47,38,7,26,74,35.1,48,43,9,34,43,135,29,1,Matches
499,Pape Cheikh Diop,SEN,MF,Dijon,Ligue 1,22,1997,12.1,24,14,15,6,3,13,33,39.4,20,14,2,12,6,30,6,0,Matches
500,Chema,ESP,"DF,MF",Getafe,La Liga,28,1992,6.2,11,5,6,5,0,5,7,71.4,2,1,0,1,10,21,23,0,Matches
501,Rayan Cherki,FRA,"FW,MF",Lyon,Ligue 1,16,2003,7.8,5,3,0,3,2,1,11,9.1,10,3,0,3,4,9,0,0,Matches
502,Denis Cheryshev,RUS,MF,Valencia,La Liga,29,1990,12.2,19,15,6,7,6,6,26,23.1,20,15,1,14,12,31,15,0,Matches
503,Giorgio Chiellini,ITA,DF,Juventus,Serie A,35,1984,15.4,12,9,9,3,0,5,11,45.5,6,18,13,5,27,39,56,0,Matches
504,Federico Chiesa,ITA,DF,Fiorentina,Serie A,22,1997,2.7,6,2,2,2,2,3,8,37.5,5,3,1,2,1,7,3,0,Matches
505,Federico Chiesa,ITA,"MF,DF",Juventus,Serie A,22,1997,24.6,47,26,21,14,12,19,50,38.0,31,23,1,22,12,59,16,0,Matches
506,Ben Chilwell,ENG,DF,Chelsea,Premier League,23,1996,25.4,42,22,16,22,4,15,33,45.5,18,28,3,25,24,66,58,0,Matches
507,Vlad Chiricheș,ROU,DF,Sassuolo,Serie A,30,1989,20.4,38,23,34,3,1,21,35,60.0,14,31,21,10,50,88,59,2,Matches
508,Pedro Chirivella,ESP,MF,Nantes,Ligue 1,23,1997,25.3,26,8,7,13,6,14,49,28.6,35,23,4,19,41,67,19,0,Matches
509,Tahith Chong,NED,"MF,FW",Werder Bremen,Bundesliga,20,1999,4.3,11,6,1,9,1,4,8,50.0,4,4,0,4,5,16,1,0,Matches
510,Joris Chotard,FRA,MF,Montpellier,Ligue 1,18,2001,12.9,12,8,5,6,1,6,31,19.4,25,12,3,9,11,23,15,0,Matches
511,Hamza Choudhury,ENG,MF,Leicester City,Premier League,22,1997,3.5,8,7,3,5,0,4,10,40.0,6,4,1,3,4,12,9,1,Matches
512,Mounir Chouiar,FRA,"FW,MF",Dijon,Ligue 1,21,1999,14.3,22,12,10,9,3,6,18,33.3,12,10,0,10,11,33,8,0,Matches
513,Andreas Christensen,DEN,DF,Chelsea,Premier League,24,1996,15.2,11,6,8,3,0,0,8,0.0,8,19,14,5,20,31,51,1,Matches
514,Carney Chukwuemeka,ENG,"MF,FW",Aston Villa,Premier League,16,2003,0.2,2,2,1,0,1,1,3,33.3,2,0,0,0,0,2,0,0,Matches
515,Samuel Chukwueze,NGA,"MF,FW",Villarreal,La Liga,21,1999,15.2,12,7,4,4,4,3,17,17.6,14,8,0,8,10,22,3,0,Matches
516,Darko Churlinov,MKD,"DF,MF",Stuttgart,Bundesliga,20,2000,2.4,2,2,2,0,0,1,3,33.3,2,5,1,4,0,2,2,0,Matches
517,Víctor Chust,ESP,DF,Real Madrid,La Liga,20,2000,1.1,1,1,0,1,0,0,2,0.0,2,2,2,0,1,2,5,0,Matches
518,Sébastien Cibois,FRA,GK,Brest,Ligue 1,22,1998,3.0,0,0,0,0,0,0,0,,0,0,0,0,0,0,0,1,Matches
519,Cifu,ESP,DF,Elche,La Liga,29,1990,5.0,10,7,7,3,0,7,13,53.8,6,5,1,4,8,18,10,0,Matches
520,Alberto Cifuentes,ESP,GK,Cádiz,La Liga,41,1979,2.0,0,0,0,0,0,0,0,,0,0,0,0,0,0,0,0,Matches
521,Luca Cigarini,ITA,MF,Crotone,Serie A,34,1986,10.3,26,14,11,12,3,12,28,42.9,16,10,1,9,12,38,9,0,Matches
522,Jasper Cillessen,NED,GK,Valencia,La Liga,31,1989,10.0,0,0,0,0,0,0,0,,0,0,0,0,0,0,0,0,Matches
523,Antonio Cioffi,ITA,FW,Napoli,Serie A,17,2002,0.1,0,0,0,0,0,0,0,,0,1,0,1,1,1,0,0,Matches
524,Tim Civeja,ALB,MF,Augsburg,Bundesliga,18,2002,0.4,0,0,0,0,0,0,1,0.0,1,0,0,0,3,3,0,0,Matches
525,Ciaran Clark,IRL,DF,Newcastle Utd,Premier League,30,1989,21.0,24,14,15,6,3,6,13,46.2,7,27,20,7,29,53,104,1,Matches
526,Alexis Claude-Maurice,FRA,"MF,FW",Nice,Ligue 1,22,1998,21.2,40,19,17,14,9,14,48,29.2,34,16,2,14,14,54,3,0,Matches
527,Jonathan Clauss,FRA,DF,Lens,Ligue 1,27,1992,28.0,43,20,12,20,11,17,38,44.7,21,24,1,23,45,88,46,0,Matches
528,Carlos Clerc,ESP,DF,Levante,La Liga,28,1992,30.9,56,29,33,16,7,22,39,56.4,17,26,4,22,37,93,55,1,Matches
529,Nathaniel Clyne,ENG,DF,Crystal Palace,Premier League,29,1991,12.7,17,10,8,8,1,9,16,56.3,7,7,2,5,18,35,25,1,Matches
530,Conor Coady,ENG,DF,Wolves,Premier League,27,1993,36.7,35,23,25,10,0,19,35,54.3,16,40,32,8,27,62,134,2,Matches
531,Marcus Coco,FRA,"MF,FW",Nantes,Ligue 1,24,1996,16.4,36,21,17,15,4,16,36,44.4,20,16,3,13,20,56,17,0,Matches
532,Coke,ESP,DF,Levante,La Liga,33,1987,9.3,24,10,14,7,3,14,27,51.9,13,13,1,12,14,38,27,0,Matches
533,Séamus Coleman,IRL,"DF,MF",Everton,Premier League,31,1988,17.9,39,26,21,14,4,21,30,70.0,9,22,6,16,13,52,37,2,Matches
534,Ebrima Colley,GAM,"MF,FW",Hellas Verona,Serie A,20,2000,8.2,11,4,2,6,3,3,11,27.3,8,6,0,6,6,17,1,0,Matches
535,Omar Colley,GAM,DF,Sampdoria,Serie A,27,1992,28.8,28,16,19,8,1,13,23,56.5,10,43,29,14,68,96,133,1,Matches
536,Simone Colombi,ITA,GK,Parma,Serie A,29,1991,2.0,0,0,0,0,0,0,0,,0,0,0,0,0,0,2,0,Matches
537,Lorenzo Colombo,ITA,FW,Milan,Serie A,18,2002,1.0,2,1,1,1,0,0,3,0.0,3,0,0,0,0,2,3,0,Matches
538,Racine Coly,SEN,MF,Nice,Ligue 1,24,1995,0.2,0,0,0,0,0,0,0,,0,0,0,0,0,0,0,0,Matches
539,Kingsley Coman,FRA,"FW,MF",Bayern Munich,Bundesliga,24,1996,19.5,14,8,6,7,1,2,21,9.5,19,22,0,22,4,18,3,0,Matches
540,Daniel Congré,FRA,DF,Montpellier,Ligue 1,35,1985,36.6,59,35,45,12,2,36,70,51.4,34,50,33,17,69,128,144,3,Matches
541,Aaron Connolly,IRL,FW,Brighton,Premier League,20,2000,8.8,6,3,1,3,2,0,2,0.0,2,4,0,4,0,6,2,0,Matches
542,Andrea Consigli,ITA,GK,Sassuolo,Serie A,33,1987,37.0,2,2,2,0,0,2,2,100.0,0,0,0,0,0,2,14,4,Matches
543,Andrea Conti,ITA,DF,Milan,Serie A,26,1994,0.3,1,1,1,0,0,0,1,0.0,1,0,0,0,1,2,0,0,Matches
544,Andrea Conti,ITA,DF,Parma,Serie A,26,1994,9.0,21,10,16,4,1,13,26,50.0,13,13,4,9,16,37,23,0,Matches
545,Liam Cooper,SCO,DF,Leeds United,Premier League,28,1991,24.3,68,45,39,27,2,37,59,62.7,22,39,32,7,61,129,70,1,Matches
546,Francis Coquelin,FRA,MF,Villarreal,La Liga,29,1991,8.2,19,14,4,12,3,8,19,42.1,11,8,2,6,21,40,11,1,Matches
547,Theo Corbeanu,CAN,FW,Wolves,Premier League,18,2002,0.1,2,1,0,2,0,1,1,100.0,0,0,0,0,1,3,0,0,Matches
548,Sébastien Corchia,FRA,DF,Nantes,Ligue 1,29,1990,23.0,55,30,29,17,9,33,60,55.0,27,28,10,18,38,93,40,1,Matches
549,Alex Cordaz,ITA,GK,Crotone,Serie A,37,1983,36.0,0,0,0,0,0,0,0,,0,0,0,0,1,1,7,2,Matches
550,Iñigo Córdoba,ESP,"FW,MF",Athletic Club,La Liga,23,1997,1.1,0,0,0,0,0,0,3,0.0,3,4,0,4,2,2,1,0,Matches
551,Iñigo Córdoba,ESP,MF,Alavés,La Liga,23,1997,2.4,6,4,1,3,2,2,10,20.0,8,7,0,7,3,9,2,0,Matches
552,Jhon Córdoba,COL,FW,Hertha BSC,Bundesliga,27,1993,17.1,9,4,1,5,3,2,4,50.0,2,13,2,11,6,15,4,0,Matches
553,Sergio Córdova,VEN,"FW,MF",Arminia,Bundesliga,22,1997,12.1,16,8,0,10,6,2,15,13.3,13,14,3,11,9,25,9,0,Matches
554,Jack Cork,ENG,MF,Burnley,Premier League,31,1989,15.0,26,10,5,17,4,11,31,35.5,20,15,4,11,16,42,20,0,Matches
555,Andreas Cornelius,DEN,FW,Parma,Serie A,27,1993,21.1,11,4,1,5,5,2,12,16.7,10,9,2,7,1,12,25,1,Matches
556,Maxwel Cornet,CIV,"DF,FW",Lyon,Ligue 1,23,1996,27.2,70,41,39,24,7,33,58,56.9,25,23,5,18,43,113,47,2,Matches
557,Ángel Correa,ARG,"FW,MF",Atlético Madrid,La Liga,25,1995,26.6,38,21,10,23,5,15,45,33.3,30,18,1,17,22,60,16,0,Matches
558,Joaquín Correa,ARG,FW,Lazio,Serie A,25,1994,21.5,21,12,6,11,4,7,25,28.0,18,14,0,14,7,28,12,0,Matches
559,Rober Correa,ESP,DF,Eibar,La Liga,27,1992,12.6,16,9,8,6,2,8,12,66.7,4,9,1,8,20,36,31,0,Matches
560,Félix Correia,POR,MF,Juventus,Serie A,19,2001,0.1,0,0,0,0,0,0,0,,0,0,0,0,0,0,1,0,Matches
561,Thierry Correia,POR,DF,Valencia,La Liga,21,1999,23.7,47,27,32,10,5,21,43,48.8,22,24,6,18,42,89,63,1,Matches
562,Danny da Costa,GER,"DF,FW",Mainz 05,Bundesliga,27,1993,13.4,22,16,6,9,7,13,27,48.1,14,17,2,15,17,39,27,0,Matches
563,Danny da Costa,GER,DF,Eint Frankfurt,Bundesliga,27,1993,1.2,0,0,0,0,0,0,1,0.0,1,3,1,2,0,0,4,0,Matches
564,David Pereira da Costa,POR,"MF,FW",Lens,Ligue 1,19,2001,1.8,4,4,1,2,1,2,3,66.7,1,2,0,2,0,4,4,0,Matches
565,Diego Costa,ESP,FW,Atlético Madrid,La Liga,31,1988,2.3,1,0,1,0,0,1,3,33.3,2,0,0,0,0,1,2,0,Matches
566,Douglas Costa,BRA,"MF,FW",Juventus,Serie A,29,1990,0.5,1,0,1,0,0,1,3,33.3,2,0,0,0,0,1,0,0,Matches
567,Douglas Costa,BRA,"FW,MF",Bayern Munich,Bundesliga,29,1990,3.6,2,1,1,1,0,1,3,33.3,2,7,0,7,2,4,1,0,Matches
568,Hélder Costa,ANG,"MF,FW",Leeds United,Premier League,26,1994,12.8,25,11,12,5,8,11,32,34.4,21,11,0,11,3,28,5,1,Matches
569,Jaume Costa,ESP,"DF,MF",Villarreal,La Liga,32,1988,3.9,10,6,4,6,0,7,9,77.8,2,7,1,6,6,16,8,0,Matches
570,Angelo da Costa Júnior,BRA,GK,Bologna,Serie A,36,1983,6.0,0,0,0,0,0,0,0,,0,0,0,0,0,0,2,3,Matches
571,Charles Costes,FRA,MF,Dijon,Ligue 1,17,2002,0.0,0,0,0,0,0,0,0,,0,0,0,0,0,0,0,0,Matches
572,Benoît Costil,FRA,GK,Bordeaux,Ligue 1,33,1987,38.0,1,1,1,0,0,1,3,33.3,2,1,0,1,1,2,17,0,Matches
573,Vladimír Coufal,CZE,DF,West Ham,Premier League,27,1992,33.9,73,36,50,15,8,52,89,58.4,37,41,7,34,41,114,102,1,Matches
574,Kalifa Coulibaly,MLI,FW,Nantes,Ligue 1,28,1991,10.9,3,1,0,1,2,2,8,25.0,6,3,1,2,2,5,12,0,Matches
575,Lassana Coulibaly,MLI,MF,Angers,Ligue 1,24,1996,18.7,78,41,33,34,11,39,75,52.0,36,29,4,25,33,111,17,0,Matches
576,Mamadou Coulibaly,SEN,MF,Udinese,Serie A,21,1999,2.0,10,8,5,5,0,0,0,,0,2,0,2,1,11,0,0,Matches
577,Senou Coulibaly,MLI,DF,Dijon,Ligue 1,25,1994,21.5,33,21,23,10,0,12,24,50.0,12,18,12,6,30,63,89,0,Matches
578,Tanguy Coulibaly,FRA,"DF,FW",Stuttgart,Bundesliga,19,2001,16.7,26,15,10,7,9,11,23,47.8,12,20,0,20,10,36,11,0,Matches
579,Thibaut Courtois,BEL,GK,Real Madrid,La Liga,28,1992,38.0,0,0,0,0,0,0,1,0.0,1,1,0,1,1,1,17,2,Matches
580,Philippe Coutinho,BRA,"MF,FW",Barcelona,La Liga,28,1992,7.3,8,6,2,5,1,3,9,33.3,6,7,0,7,2,10,1,0,Matches
581,Nicolas Cozza,FRA,DF,Montpellier,Ligue 1,21,1999,15.2,39,30,27,11,1,20,40,50.0,20,20,11,9,26,65,62,0,Matches
582,Alessio Cragno,ITA,GK,Cagliari,Serie A,26,1994,34.0,0,0,0,0,0,0,1,0.0,1,0,0,0,1,1,10,0,Matches
583,Gian Crespi,ITA,GK,Crotone,Serie A,19,2001,1.0,0,0,0,0,0,0,0,,0,0,0,0,0,0,0,0,Matches
584,Aaron Cresswell,ENG,DF,West Ham,Premier League,30,1989,35.2,32,13,15,15,2,18,32,56.3,14,29,14,15,32,64,79,2,Matches
585,Domenico Criscito,ITA,DF,Genoa,Serie A,33,1986,19.2,43,22,29,11,3,22,39,56.4,17,27,14,13,44,87,51,0,Matches
586,Bryan Cristante,ITA,"DF,MF",Roma,Serie A,25,1995,23.9,27,20,10,14,3,10,28,35.7,18,21,7,14,40,67,61,1,Matches
587,Giovanni Crociata,ITA,DF,Crotone,Serie A,22,1997,0.3,1,0,0,1,0,0,1,0.0,1,1,0,1,0,1,0,0,Matches
588,Juan Cruz Armada,ESP,DF,Osasuna,La Liga,28,1992,21.8,36,22,17,16,3,19,35,54.3,16,19,5,14,15,51,50,0,Matches
589,Juan Cuadrado,COL,"DF,MF",Juventus,Serie A,32,1988,24.2,43,25,22,15,6,29,60,48.3,31,16,2,14,43,86,22,2,Matches
590,Andrés Cubas,PAR,MF,Nîmes,Ligue 1,24,1996,24.9,80,47,30,44,6,33,74,44.6,41,37,10,27,50,130,29,3,Matches
591,Sergio Cubero Ezcurra,ESP,MF,Eibar,La Liga,20,1999,0.0,0,0,0,0,0,0,0,,0,0,0,0,0,0,0,0,Matches
592,Cucho,COL,"FW,MF",Getafe,La Liga,21,1999,16.3,19,10,1,14,4,2,23,8.7,21,18,1,17,6,25,8,0,Matches
593,Marc Cucurella,ESP,MF,Getafe,La Liga,22,1998,36.0,64,51,19,40,5,25,66,37.9,41,45,4,41,40,104,27,0,Matches
594,Mickaël Cuisance,FRA,MF,Marseille,Ligue 1,20,1999,11.4,24,11,2,15,7,10,33,30.3,23,13,1,12,3,27,4,0,Matches
595,Mickaël Cuisance,FRA,FW,Bayern Munich,Bundesliga,20,1999,0.2,0,0,0,0,0,0,0,,0,1,0,1,0,0,0,0,Matches
596,Matheus Cunha,BRA,"FW,MF",Hertha BSC,Bundesliga,21,1999,23.9,36,16,10,19,7,13,49,26.5,36,29,2,27,31,67,9,0,Matches
597,Giuseppe Cuomo,ITA,DF,Crotone,Serie A,22,1998,8.9,26,19,17,9,0,9,14,64.3,5,10,2,8,18,44,19,1,Matches
598,Patrick Cutrone,ITA,FW,Wolves,Premier League,22,1998,0.3,0,0,0,0,0,0,0,,0,0,0,0,0,0,0,0,Matches
599,Patrick Cutrone,ITA,FW,Fiorentina,Serie A,22,1998,2.2,4,3,1,2,1,1,2,50.0,1,1,0,1,1,5,0,0,Matches
600,Patrick Cutrone,ITA,FW,Valencia,La Liga,22,1998,1.2,0,0,0,0,0,0,1,0.0,1,0,0,0,1,1,0,0,Matches
601,Wylan Cyprien,FRA,MF,Parma,Serie A,25,1995,4.6,9,4,5,3,1,2,4,50.0,2,13,8,5,5,14,6,1,Matches
602,Rafael Czichos,GER,DF,Köln,Bundesliga,30,1990,25.1,48,24,33,13,2,23,42,54.8,19,25,9,16,53,101,109,0,Matches
603,Lennart-Marten Czyborra,GER,DF,Genoa,Serie A,21,1999,13.0,19,10,7,7,5,11,19,57.9,8,6,1,5,17,36,27,0,Matches
604,Danilo D'Ambrosio,ITA,DF,Inter,Serie A,31,1988,7.8,15,9,6,7,2,6,15,40.0,9,9,7,2,4,19,15,0,Matches
605,Damien Da Silva,FRA,DF,Rennes,Ligue 1,32,1988,29.6,22,13,13,8,1,12,18,66.7,6,17,13,4,44,66,99,1,Matches
606,Moanes Dabbur,ISR,"FW,MF",Hoffenheim,Bundesliga,28,1992,11.1,6,3,3,1,2,1,13,7.7,12,6,0,6,9,15,7,0,Matches
607,Bryan Dabo,BFA,MF,Benevento,Serie A,28,1992,12.4,11,8,5,3,3,5,16,31.3,11,7,1,6,13,24,16,0,Matches
608,Colin Dagba,FRA,DF,Paris S-G,Ligue 1,21,1998,15.1,23,11,4,17,2,14,19,73.7,5,18,5,13,16,39,18,1,Matches
609,Finn Dahmen,GER,GK,Mainz 05,Bundesliga,22,1998,3.0,0,0,0,0,0,0,1,0.0,1,0,0,0,0,0,1,0,Matches
610,Mahmoud Dahoud,GER,MF,Dortmund,Bundesliga,24,1996,14.0,30,18,9,20,1,14,38,36.8,24,23,5,18,18,48,11,1,Matches
611,Leon Dajaku,GER,FW,Union Berlin,Bundesliga,19,2001,0.4,0,0,0,0,0,0,0,,0,0,0,0,0,0,0,0,Matches
612,Stuart Dallas,NIR,"MF,DF",Leeds United,Premier League,29,1991,37.9,74,45,46,22,6,30,88,34.1,58,41,3,38,44,118,52,1,Matches
613,Diogo Dalot,POR,DF,Milan,Serie A,21,1999,12.1,32,17,23,6,3,17,34,50.0,17,18,5,13,25,57,42,0,Matches
614,Mikkel Damsgaard,DEN,"MF,FW",Sampdoria,Serie A,20,2000,19.7,42,21,14,20,8,22,70,31.4,48,40,4,36,24,66,17,0,Matches
615,Flavius Daniliuc,AUT,DF,Nice,Ligue 1,19,2001,16.4,23,15,15,5,3,10,21,47.6,11,17,6,11,14,37,32,0,Matches
616,Danilo,BRA,"DF,MF",Juventus,Serie A,29,1991,32.4,62,31,37,16,9,35,66,53.0,31,32,12,20,66,128,68,2,Matches
617,Scott Dann,ENG,DF,Crystal Palace,Premier League,33,1987,15.0,6,4,5,1,0,4,11,36.4,7,16,14,2,18,24,59,1,Matches
618,Tiago Dantas,POR,MF,Bayern Munich,Bundesliga,19,2000,0.8,1,1,0,0,1,0,0,,0,0,0,0,0,1,0,0,Matches
619,Dante,BRA,DF,Nice,Ligue 1,36,1983,8.6,10,5,6,4,0,3,7,42.9,4,6,4,2,10,20,20,0,Matches
620,Andrea Danzi,ITA,DF,Hellas Verona,Serie A,21,1999,1.2,0,0,0,0,0,0,1,0.0,1,0,0,0,3,3,1,0,Matches
621,Ebrima Darboe,GAM,MF,Roma,Serie A,19,2001,3.6,5,2,3,1,1,3,10,30.0,7,3,0,3,8,13,0,1,Matches
622,Márton Dárdai,HUN,"DF,MF",Hertha BSC,Bundesliga,18,2002,9.1,17,10,10,6,1,9,16,56.3,7,7,3,4,16,33,31,0,Matches
623,Vladimír Darida,CZE,MF,Hertha BSC,Bundesliga,29,1990,21.1,34,19,11,19,4,9,31,29.0,22,34,2,32,27,61,18,0,Matches
624,Karl Darlow,ENG,GK,Newcastle Utd,Premier League,29,1990,25.0,0,0,0,0,0,0,0,,0,0,0,0,0,0,17,0,Matches
625,Matteo Darmian,ITA,DF,Parma,Serie A,30,1989,2.3,6,5,3,3,0,4,7,57.1,3,2,0,2,6,12,7,0,Matches
626,Matteo Darmian,ITA,DF,Inter,Serie A,30,1989,12.9,30,16,12,7,11,16,28,57.1,12,9,2,7,17,47,35,0,Matches
627,Jonathan David,CAN,FW,Lille,Ligue 1,20,2000,26.2,17,10,5,5,7,9,24,37.5,15,19,1,18,3,20,9,0,Matches
628,Alphonso Davies,CAN,DF,Bayern Munich,Bundesliga,19,2000,19.6,39,27,16,17,6,28,40,70.0,12,21,1,20,28,67,33,1,Matches
629,Ben Davies,WAL,DF,Tottenham,Premier League,27,1993,15.0,27,17,10,11,6,13,30,43.3,17,10,5,5,18,45,49,2,Matches
630,Tom Davies,ENG,MF,Everton,Premier League,22,1998,15.8,31,18,17,12,2,16,39,41.0,23,15,9,6,34,65,21,2,Matches
631,Keinan Davis,ENG,"FW,MF",Aston Villa,Premier League,22,1998,3.1,2,1,1,0,1,0,1,0.0,1,1,0,1,0,2,2,0,Matches
632,Leif Davis,ENG,DF,Leeds United,Premier League,20,2000,0.4,0,0,0,0,0,0,3,0.0,3,1,0,1,1,1,0,0,Matches
633,Paweł Dawidowicz,POL,DF,Hellas Verona,Serie A,25,1995,20.7,42,28,30,10,2,14,24,58.3,10,28,19,9,27,69,62,1,Matches
634,Craig Dawson,ENG,DF,West Ham,Premier League,30,1990,21.4,11,8,7,4,0,5,12,41.7,7,26,22,4,32,43,88,3,Matches
635,Kevin De Bruyne,BEL,MF,Manchester City,Premier League,29,1991,22.2,34,21,6,18,10,13,48,27.1,35,26,1,25,9,43,10,0,Matches
636,Sebastien De Maio,FRA,DF,Udinese,Serie A,33,1987,9.5,15,10,6,9,0,4,5,80.0,1,16,9,7,18,33,41,0,Matches
637,Rodrigo De Paul,ARG,MF,Udinese,Serie A,26,1994,35.6,41,24,17,22,2,15,60,25.0,45,32,1,31,17,58,20,1,Matches
638,Mattia De Sciglio,ITA,DF,Juventus,Serie A,27,1992,0.3,0,0,0,0,0,0,0,,0,0,0,0,0,0,1,0,Matches
639,Mattia De Sciglio,ITA,DF,Lyon,Ligue 1,27,1992,16.3,29,17,15,11,3,18,27,66.7,9,13,4,9,27,56,44,0,Matches
640,Lorenzo De Silvestri,ITA,DF,Bologna,Serie A,32,1988,23.8,34,24,18,13,3,16,37,43.2,21,37,10,27,30,64,62,3,Matches
641,Thibault De Smet,BEL,DF,Reims,Ligue 1,22,1998,5.5,11,6,8,3,0,6,15,40.0,9,8,1,7,6,17,16,0,Matches
642,Lucas Deaux,FRA,"MF,DF",Nîmes,Ligue 1,31,1988,19.5,47,32,20,22,5,16,49,32.7,33,20,3,17,20,67,30,4,Matches
643,Mathieu Debuchy,FRA,DF,Saint-Étienne,Ligue 1,35,1985,23.4,58,33,37,17,4,40,62,64.5,22,27,9,18,45,103,61,0,Matches
644,Grégoire Defrel,MTQ,"MF,FW",Sassuolo,Serie A,29,1991,14.8,13,8,5,5,3,5,13,38.5,8,9,0,9,7,20,5,0,Matches
645,Alessandro Deiola,ITA,MF,Spezia,Serie A,24,1995,4.0,6,3,2,3,1,5,13,38.5,8,3,1,2,3,9,1,0,Matches
646,Alessandro Deiola,ITA,MF,Cagliari,Serie A,24,1995,6.8,13,5,5,4,4,8,23,34.8,15,7,2,5,11,24,11,0,Matches
647,Romain Del Castillo,FRA,"MF,FW",Rennes,Ligue 1,24,1996,7.2,30,11,5,14,11,5,25,20.0,20,6,0,6,3,33,4,1,Matches
648,Lorenzo Del Pinto,ITA,MF,Benevento,Serie A,30,1990,0.1,0,0,0,0,0,0,2,0.0,2,0,0,0,0,0,0,0,Matches
649,Thomas Delaine,FRA,"DF,FW",Metz,Ligue 1,28,1992,19.8,32,18,19,11,2,20,35,57.1,15,22,5,17,24,56,30,1,Matches
650,Thomas Delaney,DEN,MF,Dortmund,Bundesliga,28,1991,14.3,40,30,15,20,5,11,31,35.5,20,28,10,18,22,62,15,1,Matches
651,Liam Delap,ENG,FW,Manchester City,Premier League,17,2003,0.4,0,0,0,0,0,0,0,,0,0,0,0,0,0,0,0,Matches
652,Jonathan Delaplace,FRA,DF,Lorient,Ligue 1,34,1986,10.1,8,5,5,1,2,7,13,53.8,6,12,5,7,17,25,19,1,Matches
653,Sacha Delaye,FRA,MF,Montpellier,Ligue 1,18,2002,0.1,0,0,0,0,0,0,1,0.0,1,0,0,0,1,1,1,0,Matches
654,Cristian Dell'Orco,ITA,DF,Spezia,Serie A,26,1994,2.9,1,0,1,0,0,1,3,33.3,2,8,5,3,7,8,9,1,Matches
655,Andy Delort,ALG,FW,Montpellier,Ligue 1,28,1991,27.6,12,7,1,9,2,8,18,44.4,10,11,1,10,4,16,34,0,Matches
656,Fabian Delph,ENG,"MF,DF",Everton,Premier League,30,1989,3.0,5,2,3,2,0,1,3,33.3,2,2,0,2,4,9,8,1,Matches
657,Moussa Dembélé,FRA,FW,Atlético Madrid,La Liga,24,1996,1.1,0,0,0,0,0,0,1,0.0,1,0,0,0,1,1,0,0,Matches
658,Moussa Dembélé,FRA,FW,Lyon,Ligue 1,24,1996,7.5,2,2,0,1,1,0,4,0.0,4,4,2,2,5,7,9,0,Matches
659,Ousmane Dembélé,FRA,FW,Barcelona,La Liga,23,1997,19.7,14,9,4,9,1,6,17,35.3,11,10,0,10,9,23,3,1,Matches
660,Merih Demiral,TUR,DF,Juventus,Serie A,22,1998,10.4,12,9,8,4,0,5,13,38.5,8,16,9,7,21,33,40,0,Matches
661,Kerem Demirbay,GER,MF,Leverkusen,Bundesliga,27,1993,19.4,46,31,15,26,5,19,38,50.0,19,21,4,17,8,54,6,1,Matches
662,Ermedin Demirović,BIH,FW,Freiburg,Bundesliga,22,1998,16.6,15,9,4,6,5,2,16,12.5,14,29,5,24,0,15,27,0,Matches
663,Diego Demme,GER,MF,Napoli,Serie A,28,1991,17.7,56,32,26,22,8,23,63,36.5,40,14,1,13,11,67,15,1,Matches
664,Jason Denayer,BEL,DF,Lyon,Ligue 1,25,1995,29.0,25,16,16,9,0,6,13,46.2,7,36,25,11,27,52,91,1,Matches
665,Leander Dendoncker,BEL,"MF,DF",Wolves,Premier League,25,1995,27.8,54,29,29,22,3,31,60,51.7,29,38,15,23,27,81,52,2,Matches
666,Kévin Denkey,TOG,FW,Nîmes,Ligue 1,19,2000,5.8,4,2,0,3,1,0,3,0.0,3,2,0,2,1,5,2,0,Matches
667,Emmanuel Dennis,NGA,FW,Köln,Bundesliga,22,1997,5.3,13,7,6,5,2,1,6,16.7,5,6,0,6,0,13,0,1,Matches
668,Stefano Denswil,SUR,DF,Bologna,Serie A,27,1993,1.3,2,1,1,1,0,0,1,0.0,1,1,0,1,1,3,1,0,Matches
669,Fabio Depaoli,ITA,DF,Benevento,Serie A,23,1997,12.4,25,13,15,6,4,15,32,46.9,17,16,4,12,12,37,38,0,Matches
670,Fabio Depaoli,ITA,MF,Sampdoria,Serie A,23,1997,0.9,1,0,0,1,0,0,2,0.0,2,0,0,0,1,2,1,0,Matches
671,Fabio Depaoli,ITA,DF,Atalanta,Serie A,23,1997,2.1,3,2,0,1,2,1,2,50.0,1,4,0,4,3,6,2,0,Matches
672,Clément Depres,FRA,FW,Nîmes,Ligue 1,25,1994,0.2,0,0,0,0,0,0,0,,0,0,0,0,0,0,0,0,Matches
673,Mike van der Hoorn,NED,DF,Arminia,Bundesliga,27,1992,15.1,8,4,3,5,0,1,3,33.3,2,12,8,4,27,35,73,0,Matches
674,Kastriot Dermaku,ALB,DF,Parma,Serie A,28,1992,1.1,1,1,1,0,0,0,0,,0,2,1,1,2,3,8,0,Matches
675,Kiril Despodov,BUL,FW,Cagliari,Serie A,23,1996,0.1,1,1,0,1,0,1,1,100.0,0,0,0,0,0,1,0,0,Matches
676,Sergiño Dest,USA,"DF,FW",Barcelona,La Liga,19,2000,21.2,31,16,23,6,2,18,32,56.3,14,25,4,21,10,41,24,1,Matches
677,Mattia Destro,ITA,FW,Genoa,Serie A,29,1991,17.8,6,3,0,3,3,2,9,22.2,7,11,0,11,4,10,8,0,Matches
678,Gerard Deulofeu,ESP,"FW,MF",Udinese,Serie A,26,1994,6.6,2,2,1,1,0,2,12,16.7,10,2,0,2,3,5,0,0,Matches
679,Deyverson,BRA,FW,Alavés,La Liga,29,1991,9.7,6,4,3,1,2,2,13,15.4,11,9,0,9,9,15,13,0,Matches
680,Jacopo Dezi,ITA,"FW,MF",Parma,Serie A,28,1992,0.9,4,3,0,2,2,3,6,50.0,3,2,0,2,0,4,0,0,Matches
681,Samuel Di Carmine,ITA,FW,Hellas Verona,Serie A,31,1988,5.6,1,2,0,1,0,0,3,0.0,3,1,0,1,0,1,5,0,Matches
682,Samuel Di Carmine,ITA,FW,Crotone,Serie A,31,1988,5.3,2,2,1,0,1,1,3,33.3,2,2,0,2,0,2,5,0,Matches
683,Giovanni Di Lorenzo,ITA,DF,Napoli,Serie A,26,1993,36.0,79,50,54,21,4,43,75,57.3,32,37,13,24,35,114,64,1,Matches
684,Ángel Di María,ARG,"FW,MF",Paris S-G,Ligue 1,32,1988,20.6,26,17,6,8,12,11,45,24.4,34,14,1,13,6,32,7,0,Matches
685,Alessandro Di Pardo,ITA,"FW,DF",Juventus,Serie A,21,1999,0.2,0,0,0,0,0,0,0,,0,1,1,0,0,0,0,0,Matches
686,Giuseppe Di Serio,ITA,"FW,MF",Benevento,Serie A,19,2001,3.2,2,2,1,1,0,0,4,0.0,4,5,0,5,0,2,4,0,Matches
687,Boulaye Dia,SEN,"FW,MF",Reims,Ligue 1,23,1996,32.6,23,12,3,11,9,4,22,18.2,18,19,5,14,12,35,37,1,Matches
688,Abdoulay Diaby,MLI,DF,Getafe,La Liga,29,1991,0.2,2,0,0,2,0,0,0,,0,2,0,2,0,2,0,0,Matches
689,Moussa Diaby,FRA,"FW,MF",Leverkusen,Bundesliga,21,1999,26.5,10,6,4,5,1,6,20,30.0,14,11,0,11,12,22,5,0,Matches
690,Mbaye Diagne,SEN,FW,West Brom,Premier League,28,1991,13.2,4,3,3,0,1,1,4,25.0,3,2,1,1,1,5,16,0,Matches
691,Mouctar Diakhaby,GUI,DF,Valencia,La Liga,23,1996,23.1,16,8,10,6,0,8,12,66.7,4,28,21,7,27,43,102,1,Matches
692,Abdou Diallo,SEN,DF,Paris S-G,Ligue 1,24,1996,16.6,16,11,9,5,2,8,13,61.5,5,15,8,7,25,41,36,0,Matches
693,Amad Diallo,CIV,FW,Manchester Utd,Premier League,18,2002,1.8,3,3,1,2,0,0,0,,0,2,1,1,0,3,1,0,Matches
694,Amad Diallo,CIV,MF,Atalanta,Serie A,18,2002,0.2,0,0,0,0,0,0,0,,0,0,0,0,0,0,0,0,Matches
695,Habib Diallo,SEN,FW,Strasbourg,Ligue 1,25,1995,25.8,11,6,3,6,2,7,18,38.9,11,12,2,10,13,24,12,0,Matches
696,Habib Diallo,SEN,"FW,MF",Metz,Ligue 1,25,1995,1.6,1,1,0,1,0,1,1,100.0,0,0,0,0,0,1,5,0,Matches
697,Ibrahima Diallo,FRA,MF,Southampton,Premier League,21,1999,11.3,29,16,11,17,1,9,16,56.3,7,10,1,9,10,39,12,2,Matches
698,Ibrahima Diallo,FRA,MF,Brest,Ligue 1,21,1999,4.9,14,9,2,9,3,4,8,50.0,4,4,0,4,3,17,3,0,Matches
699,Amadou Diambo,GHA,FW,Benevento,Serie A,19,2001,0.0,0,0,0,0,0,0,0,,0,0,0,0,0,0,0,0,Matches
700,Grady Diangana,COD,"MF,FW",West Brom,Premier League,22,1998,13.7,35,19,19,9,7,19,43,44.2,24,16,2,14,16,51,9,0,Matches
701,Stéphane Diarra,FRA,"MF,FW",Lorient,Ligue 1,21,1998,2.2,0,0,0,0,0,0,7,0.0,7,6,1,5,4,4,1,0,Matches
702,Rúben Dias,POR,DF,Manchester City,Premier League,23,1997,31.6,24,13,13,8,3,4,16,25.0,12,31,23,8,35,59,92,0,Matches
703,Krépin Diatta,SEN,"MF,DF",Monaco,Ligue 1,21,1999,4.3,4,3,1,1,2,1,3,33.3,2,5,1,4,4,8,1,0,Matches
704,Amadou Diawara,GUI,MF,Roma,Serie A,23,1997,7.3,10,8,4,6,0,2,8,25.0,6,11,2,9,12,22,4,0,Matches
705,Brahim Díaz,MAR,"MF,FW",Milan,Serie A,20,1999,13.6,18,10,7,7,4,10,23,43.5,13,10,0,10,2,20,2,0,Matches
706,Víctor Díaz,ESP,DF,Granada,La Liga,32,1988,9.2,21,10,13,6,2,10,19,52.6,9,14,8,6,16,37,39,0,Matches
707,Daniel Didavi,GER,"MF,FW",Stuttgart,Bundesliga,30,1990,10.8,16,6,2,9,5,7,12,58.3,5,10,0,10,3,19,8,0,Matches
708,Bamba Dieng,SEN,"FW,DF",Marseille,Ligue 1,20,2000,1.4,5,3,3,2,0,2,4,50.0,2,2,0,2,0,5,0,0,Matches
709,Eric Dier,ENG,DF,Tottenham,Premier League,26,1994,28.0,23,14,13,10,0,11,18,61.1,7,37,31,6,23,46,123,3,Matches
710,Daan Dierckx,BEL,DF,Parma,Serie A,17,2003,5.2,5,4,5,0,0,3,5,60.0,2,10,6,4,13,18,21,0,Matches
711,Lucas Digne,FRA,"DF,MF",Everton,Premier League,27,1993,29.8,63,38,40,16,7,29,54,53.7,25,42,4,38,31,94,87,0,Matches
712,Mitchell Dijks,NED,DF,Bologna,Serie A,27,1993,16.5,21,14,15,5,1,12,21,57.1,9,17,2,15,17,38,35,0,Matches
713,Javairô Dilrosun,NED,"FW,MF",Hertha BSC,Bundesliga,22,1998,5.9,5,3,2,2,1,1,6,16.7,5,5,0,5,4,9,3,0,Matches
714,Federico Dimarco,ITA,DF,Hellas Verona,Serie A,22,1997,29.0,32,19,23,7,2,13,28,46.4,15,18,9,9,47,79,50,1,Matches
715,Junior Dina Ebimbe,FRA,"FW,MF",Dijon,Ligue 1,19,2000,23.8,38,25,14,19,5,15,45,33.3,30,17,1,16,14,52,9,0,Matches
716,Tristan Dingomé,CMR,MF,Reims,Ligue 1,29,1991,0.2,0,0,0,0,0,0,1,0.0,1,0,0,0,0,0,0,0,Matches
717,Eren Dinkçi,GER,"MF,FW",Werder Bremen,Bundesliga,18,2001,1.2,1,1,1,0,0,0,1,0.0,1,4,0,4,2,3,1,0,Matches
718,Sinaly Diomande,CIV,DF,Lyon,Ligue 1,19,2001,12.6,10,7,8,1,1,5,14,35.7,9,19,15,4,33,43,53,1,Matches
719,Lois Diony,FRA,FW,Angers,Ligue 1,27,1992,19.4,15,10,3,9,3,4,18,22.2,14,6,3,3,5,20,16,0,Matches
720,Issa Diop,FRA,DF,West Ham,Premier League,23,1997,15.3,20,14,12,8,0,7,18,38.9,11,32,22,10,22,42,59,0,Matches
721,Papakouli Diop,SEN,MF,Eibar,La Liga,34,1986,25.8,43,29,15,22,6,12,41,29.3,29,23,5,18,39,82,34,1,Matches
722,Sofiane Diop,FRA,"MF,FW",Monaco,Ligue 1,20,2000,22.5,49,34,17,25,7,18,53,34.0,35,25,1,24,31,80,15,0,Matches
723,Andy Diouf,FRA,FW,Rennes,Ligue 1,17,2003,0.1,0,0,0,0,0,0,0,,0,0,0,0,0,0,0,0,Matches
724,Yehvann Diouf,FRA,GK,Reims,Ligue 1,20,1999,1.5,0,0,0,0,0,0,0,,0,0,0,0,0,0,0,0,Matches
725,Assane Dioussé,SEN,DF,Saint-Étienne,Ligue 1,22,1997,0.0,0,0,0,0,0,0,0,,0,0,0,0,0,0,0,0,Matches
726,Jonas Dirkner,GER,MF,Hertha BSC,Bundesliga,18,2002,0.2,0,0,0,0,0,0,0,,0,0,0,0,0,0,0,0,Matches
727,Axel Disasi,FRA,DF,Monaco,Ligue 1,22,1998,22.3,29,20,17,12,0,20,35,57.1,15,18,11,7,26,55,66,1,Matches
728,Tiago Djaló,POR,DF,Lille,Ligue 1,20,2000,9.7,22,13,14,5,3,15,23,65.2,8,10,4,6,9,31,23,0,Matches
729,Djené,TOG,DF,Getafe,La Liga,28,1991,32.7,61,39,31,26,4,26,34,76.5,8,24,11,13,42,103,96,0,Matches
730,Moussa Djenepo,MLI,MF,Southampton,Premier League,22,1998,13.8,52,27,27,17,8,28,63,44.4,35,24,2,22,10,62,14,0,Matches
731,Koffi Djidji,CIV,DF,Crotone,Serie A,27,1992,16.9,39,28,30,8,1,10,20,50.0,10,35,20,15,28,67,73,0,Matches
732,Alexander Djiku,GHA,"DF,MF",Strasbourg,Ligue 1,25,1994,28.4,60,41,45,13,2,32,52,61.5,20,28,10,18,91,151,104,0,Matches
733,Berat Djimsiti,ALB,DF,Atalanta,Serie A,27,1993,29.2,41,29,27,12,2,17,34,50.0,17,34,20,14,62,103,89,1,Matches
734,Marko Dmitrović,SRB,GK,Eibar,La Liga,28,1992,34.7,4,3,4,0,0,2,4,50.0,2,0,0,0,0,4,16,2,Matches
735,Ritsu Doan,JPN,"MF,FW",Arminia,Bundesliga,22,1998,30.8,53,31,22,19,12,19,52,36.5,33,42,1,41,31,84,11,0,Matches
736,Mihai Dobre,ROU,FW,Dijon,Ligue 1,21,1998,5.9,12,5,6,2,4,7,14,50.0,7,5,0,5,10,22,3,0,Matches
737,Matt Doherty,IRL,DF,Tottenham,Premier League,28,1992,13.8,29,15,15,10,4,13,33,39.4,20,20,5,15,23,52,46,0,Matches
738,Jeremy Doku,BEL,"MF,FW",Rennes,Ligue 1,18,2002,25.7,44,25,9,24,11,11,26,42.3,15,18,1,17,11,55,1,0,Matches
739,Kasper Dolberg,DEN,FW,Nice,Ligue 1,22,1997,21.4,6,2,1,3,2,2,11,18.2,9,11,2,9,6,12,19,1,Matches
740,Keagan Dolly,RSA,MF,Montpellier,Ligue 1,27,1993,5.0,7,2,6,0,1,4,8,50.0,4,3,0,3,5,12,2,0,Matches
741,Jaume Doménech,ESP,GK,Valencia,La Liga,29,1990,28.0,1,1,1,0,0,1,2,50.0,1,1,0,1,0,1,16,2,Matches
742,Carlos Dominguez,ESP,DF,Celta Vigo,La Liga,19,2001,4.0,5,4,4,1,0,3,6,50.0,3,5,3,2,6,11,24,0,Matches
743,Nicolás Domínguez,ARG,MF,Bologna,Serie A,22,1998,13.9,48,28,26,17,5,15,37,40.5,22,26,7,19,24,72,20,0,Matches
744,John Donald,ESP,"DF,MF",Elche,La Liga,19,2000,0.6,0,0,0,0,0,0,0,,0,0,0,0,0,0,1,0,Matches
745,Ji Dong-won,KOR,FW,Mainz 05,Bundesliga,29,1991,0.7,1,1,1,0,0,0,0,,0,1,0,1,2,3,0,0,Matches
746,Anastasios Donis,GRE,MF,Reims,Ligue 1,23,1996,1.1,4,1,2,0,2,1,1,100.0,0,0,0,0,0,4,0,0,Matches
747,Gianluigi Donnarumma,ITA,GK,Milan,Serie A,21,1999,37.0,0,0,0,0,0,0,1,0.0,1,1,0,1,1,1,23,2,Matches
748,Bas Dost,NED,FW,Eint Frankfurt,Bundesliga,31,1989,9.1,3,2,1,1,1,2,5,40.0,3,5,1,4,2,5,8,0,Matches
749,Abdoulaye Doucouré,MLI,MF,Everton,Premier League,27,1993,27.1,52,32,25,19,8,14,43,32.6,29,24,7,17,39,91,31,1,Matches
750,Cheick Doucouré,MLI,MF,Lens,Ligue 1,20,2000,29.2,87,47,40,42,5,32,65,49.2,33,20,4,16,52,139,26,1,Matches
751,Fodé Doucouré,MLI,DF,Reims,Ligue 1,19,2001,3.7,11,8,7,4,0,4,9,44.4,5,2,0,2,4,15,11,0,Matches
752,Mahamadou Doucouré,MLI,"FW,MF",Nîmes,Ligue 1,20,2000,0.5,1,1,1,0,0,1,1,100.0,0,0,0,0,0,1,0,0,Matches
753,Cheick Doukouré,CIV,"MF,FW",Levante,La Liga,27,1992,1.1,5,4,2,1,2,3,4,75.0,1,2,0,2,3,8,0,0,Matches
754,Idrissa Doumbia,CIV,MF,Huesca,La Liga,22,1998,8.7,15,8,6,7,2,5,13,38.5,8,6,3,3,7,22,9,0,Matches
755,Moussa Doumbia,MLI,"MF,FW",Reims,Ligue 1,25,1994,10.0,10,6,4,4,2,4,22,18.2,18,5,1,4,10,20,4,0,Matches
756,Souleyman Doumbia,CIV,DF,Angers,Ligue 1,23,1996,24.7,48,33,25,19,4,22,36,61.1,14,18,4,14,42,90,50,0,Matches
757,Aleksandar Dragović,AUT,DF,Leverkusen,Bundesliga,29,1991,12.6,11,7,5,5,1,9,13,69.2,4,17,5,12,13,24,33,0,Matches
758,Bartłomiej Drągowski,POL,GK,Fiorentina,Serie A,22,1997,35.0,1,0,1,0,0,1,1,100.0,0,0,0,0,1,2,13,1,Matches
759,Denis Drăguș,ROU,"FW,MF",Crotone,Serie A,21,1999,2.0,3,1,0,0,3,0,4,0.0,4,4,0,4,1,4,0,0,Matches
760,Radu Drăgușin,ROU,DF,Juventus,Serie A,18,2002,0.0,0,0,0,0,0,0,0,,0,0,0,0,0,0,0,0,Matches
761,Mouhamadou Drammeh,FRA,MF,Reims,Ligue 1,21,1999,1.9,0,0,0,0,0,0,2,0.0,2,0,0,0,2,2,7,0,Matches
762,Julian Draxler,GER,"MF,FW",Paris S-G,Ligue 1,26,1993,11.8,13,6,5,6,2,5,20,25.0,15,4,0,4,14,27,0,0,Matches
763,Dominick Drexler,GER,"MF,FW",Köln,Bundesliga,30,1990,13.7,36,26,15,18,3,12,30,40.0,18,5,1,4,14,50,15,0,Matches
764,Matthieu Dreyer,FRA,GK,Lorient,Ligue 1,31,1989,15.0,0,0,0,0,0,0,0,,0,0,0,0,0,0,4,2,Matches
765,Domingos Duarte,POR,DF,Granada,La Liga,25,1995,26.3,32,20,18,12,2,14,21,66.7,7,29,20,9,29,61,86,0,Matches
766,Léo Duarte,BRA,DF,Milan,Serie A,24,1996,0.2,1,1,0,1,0,0,0,,0,0,0,0,1,2,0,0,Matches
767,Óscar Duarte,CRC,DF,Levante,La Liga,31,1989,22.9,22,13,17,5,0,10,18,55.6,8,23,15,8,36,58,97,1,Matches
768,Rubén Duarte,ESP,DF,Alavés,La Liga,24,1995,28.3,55,30,28,21,6,23,52,44.2,29,44,6,38,66,121,72,0,Matches
769,Leo Dubois,FRA,DF,Lyon,Ligue 1,25,1994,32.3,38,26,19,16,3,18,36,50.0,18,27,9,18,31,69,69,2,Matches
770,Martin Dúbravka,SVK,GK,Newcastle Utd,Premier League,31,1989,13.0,0,0,0,0,0,0,0,,0,0,0,0,0,0,3,0,Matches
771,Ondrej Duda,SVK,"FW,MF",Köln,Bundesliga,25,1994,28.2,36,14,13,18,5,8,39,20.5,31,28,2,26,19,55,20,0,Matches
772,Unai Dufur,ESP,DF,Eibar,La Liga,21,1999,0.7,2,2,2,0,0,2,4,50.0,2,0,0,0,1,3,0,0,Matches
773,Haris Duljević,BIH,"MF,FW",Nîmes,Ligue 1,26,1993,8.6,15,9,4,7,4,6,22,27.3,16,3,0,3,8,23,1,0,Matches
774,Paul Dummett,WAL,DF,Newcastle Utd,Premier League,28,1991,13.9,16,7,11,5,0,13,21,61.9,8,12,7,5,16,32,74,0,Matches
775,Alfred Duncan,GHA,MF,Fiorentina,Serie A,27,1993,1.8,3,0,1,1,1,0,2,0.0,2,2,0,2,2,5,0,0,Matches
776,Alfred Duncan,GHA,MF,Cagliari,Serie A,27,1993,11.9,18,10,8,9,1,4,21,19.0,17,8,0,8,16,34,8,1,Matches
777,Lewis Dunk,ENG,DF,Brighton,Premier League,28,1991,32.6,30,15,20,8,2,16,23,69.6,7,29,20,9,32,62,106,0,Matches
778,Jimmy Dunne,IRL,DF,Burnley,Premier League,22,1997,3.0,3,3,2,1,0,1,2,50.0,1,3,2,1,6,9,16,1,Matches
779,Erik Durm,GER,DF,Eint Frankfurt,Bundesliga,28,1992,16.4,17,13,7,9,1,8,21,38.1,13,19,5,14,29,46,26,0,Matches
780,Hugo Duro,ESP,FW,Real Madrid,La Liga,20,1999,0.6,0,0,0,0,0,0,0,,0,1,0,1,0,0,0,0,Matches
781,Jean-Kevin Duverne,HAI,DF,Brest,Ligue 1,23,1997,22.5,38,21,24,14,0,15,32,46.9,17,24,16,8,30,68,70,0,Matches
782,Paulo Dybala,ARG,FW,Juventus,Serie A,26,1993,12.6,14,8,3,4,7,2,14,14.3,12,15,0,15,1,15,1,0,Matches
783,Edin Džeko,BIH,FW,Roma,Serie A,34,1986,20.3,8,6,2,3,3,3,9,33.3,6,9,4,5,1,9,11,0,Matches
784,Steeve-Mike Ebongue,FRA,MF,Genoa,Serie A,19,2001,0.6,2,1,1,0,1,0,3,0.0,3,1,0,1,0,2,0,0,Matches
785,Enzo Ebosse,CMR,DF,Angers,Ligue 1,21,1999,2.9,5,3,5,0,0,3,4,75.0,1,1,1,0,2,7,13,0,Matches
786,Bruno Ecuele Manga,GAB,DF,Dijon,Ligue 1,32,1988,38.0,52,38,46,6,0,29,40,72.5,11,50,33,17,57,109,165,3,Matches
787,Simone Edera,ITA,"DF,MF",Torino,Serie A,23,1997,0.6,3,1,2,1,0,3,4,75.0,1,0,0,0,1,4,1,0,Matches
788,Ederson,BRA,GK,Manchester City,Premier League,26,1993,36.0,3,1,3,0,0,3,4,75.0,1,0,0,0,0,3,11,4,Matches
789,Kyle Edwards,ENG,"MF,FW",West Brom,Premier League,22,1998,1.3,3,2,1,1,1,0,0,,0,2,0,2,1,4,0,0,Matches
790,John Egan,IRL,DF,Sheffield Utd,Premier League,27,1992,29.2,41,21,29,12,0,22,39,56.4,17,43,31,12,41,82,131,0,Matches
791,Johannes Eggestein,GER,"FW,MF",Werder Bremen,Bundesliga,22,1998,0.4,0,0,0,0,0,0,1,0.0,1,0,0,0,1,1,2,0,Matches
792,Maximilian Eggestein,GER,MF,Werder Bremen,Bundesliga,23,1996,32.7,57,42,22,29,6,21,46,45.7,25,30,5,25,43,100,36,0,Matches
793,Lilian Egloff,GER,MF,Stuttgart,Bundesliga,17,2002,0.2,0,0,0,0,0,0,0,,0,0,0,0,0,0,0,0,Matches
794,Kingsley Ehizibue,NED,DF,Köln,Bundesliga,25,1995,12.6,32,19,22,9,1,10,17,58.8,7,19,5,14,18,50,42,0,Matches
795,Albin Ekdal,SWE,MF,Sampdoria,Serie A,31,1989,25.5,56,29,21,32,3,23,65,35.4,42,31,12,19,49,105,35,0,Matches
796,Hugo Ekitike,FRA,"FW,MF",Reims,Ligue 1,18,2002,1.0,1,1,0,0,1,0,1,0.0,1,0,0,0,0,1,0,0,Matches
797,Anthony Elanga,SWE,FW,Manchester Utd,Premier League,18,2002,1.7,4,2,3,1,0,4,5,80.0,1,1,1,0,1,5,1,0,Matches
798,Niclas Eliasson,SWE,"MF,FW",Nîmes,Ligue 1,24,1995,20.0,28,14,9,12,7,11,24,45.8,13,20,1,19,23,51,16,0,Matches
799,Elif Elmas,MKD,"MF,FW",Napoli,Serie A,20,1999,8.2,15,4,3,6,6,7,12,58.3,5,11,1,10,2,17,10,0,Matches
800,Ahmed Elmohamady,EGY,DF,Aston Villa,Premier League,32,1987,9.3,17,13,12,4,1,9,14,64.3,5,6,3,3,17,34,26,0,Matches
801,Mohamed Elneny,EGY,MF,Arsenal,Premier League,28,1992,17.2,14,6,7,7,0,7,28,25.0,21,11,4,7,24,38,20,2,Matches
802,Aritz Elustondo,ESP,DF,Real Sociedad,La Liga,26,1994,20.9,30,16,21,7,2,18,22,81.8,4,12,5,7,15,45,63,0,Matches
803,Nico Elvedi,SUI,DF,Gladbach,Bundesliga,23,1996,28.2,49,35,36,12,1,25,37,67.6,12,38,22,16,65,114,123,0,Matches
804,Rodrigo Ely,BRA,DF,Alavés,La Liga,26,1993,5.2,5,2,3,2,0,3,4,75.0,1,2,1,1,7,12,23,1,Matches
805,Breel Embolo,SUI,"FW,MF",Gladbach,Bundesliga,23,1997,16.0,15,10,1,13,1,0,6,0.0,6,16,1,15,8,23,8,0,Matches
806,Emerson,BRA,DF,Betis,La Liga,21,1999,33.2,91,52,62,25,4,43,78,55.1,35,33,6,27,61,152,102,2,Matches
807,Renaud Emond,BEL,"FW,MF",Nantes,Ligue 1,28,1991,3.9,0,0,0,0,0,0,1,0.0,1,2,0,2,0,0,1,0,Matches
808,Alan Empereur,BRA,DF,Hellas Verona,Serie A,26,1994,2.4,0,0,0,0,0,0,0,,0,1,1,0,6,6,7,1,Matches
809,Youssef En-Nesyri,MAR,FW,Sevilla,La Liga,23,1997,25.7,17,11,2,9,6,4,21,19.0,17,15,0,15,8,25,23,0,Matches
810,Keita Endo,JPN,"MF,FW",Union Berlin,Bundesliga,22,1997,5.1,8,3,1,5,2,3,9,33.3,6,5,2,3,6,14,4,0,Matches
811,Wataru Endo,JPN,MF,Stuttgart,Bundesliga,27,1993,32.8,65,44,25,34,6,29,71,40.8,42,53,14,39,51,116,59,0,Matches
812,Sergi Enrich,ESP,FW,Eibar,La Liga,30,1990,15.6,21,15,6,7,8,9,22,40.9,13,11,0,11,6,27,5,0,Matches
813,Christian Eriksen,DEN,MF,Inter,Serie A,28,1992,15.4,12,6,6,4,2,7,20,35.0,13,16,1,15,9,21,13,1,Matches
814,Martin Erlic,CRO,DF,Spezia,Serie A,22,1998,20.0,23,14,16,6,1,11,20,55.0,9,22,16,6,41,64,71,2,Matches
815,Patrick Erras,GER,"FW,MF",Werder Bremen,Bundesliga,25,1995,0.3,0,0,0,0,0,0,1,0.0,1,0,0,0,0,0,0,0,Matches
816,Gonzalo Escalante,ARG,MF,Lazio,Serie A,27,1993,8.1,26,13,11,14,1,8,28,28.6,20,10,3,7,19,45,13,0,Matches
817,Aarón Escandell,ESP,GK,Granada,La Liga,24,1995,5.0,1,1,1,0,0,1,1,100.0,0,0,0,0,0,1,6,0,Matches
818,Dani Escriche,ESP,"FW,MF",Huesca,La Liga,22,1998,9.5,9,7,5,2,2,3,10,30.0,7,11,0,11,8,17,5,0,Matches
819,Sergio Escudero,ESP,DF,Sevilla,La Liga,30,1989,6.3,12,8,6,5,1,6,12,50.0,6,5,2,3,9,21,7,0,Matches
820,Alfonso Espino,URU,DF,Cádiz,La Liga,28,1992,28.9,92,48,63,28,1,43,85,50.6,42,30,5,25,41,133,74,0,Matches
821,Vicente Esquerdo,ESP,MF,Valencia,La Liga,21,1999,2.6,7,4,5,2,0,4,6,66.7,2,4,2,2,8,15,1,0,Matches
822,Nahuel Estévez,ARG,MF,Spezia,Serie A,24,1995,19.6,13,5,4,6,3,5,32,15.6,27,23,5,18,20,33,22,1,Matches
823,Pervis Estupiñán,ECU,DF,Villarreal,La Liga,22,1998,13.0,37,17,23,12,2,14,23,60.9,9,10,2,8,35,72,14,2,Matches
824,Yoann Etienne,FRA,DF,Lorient,Ligue 1,23,1997,1.0,2,0,1,1,0,1,1,100.0,0,1,0,1,1,3,2,0,Matches
825,Xabier Etxeita,ESP,DF,Getafe,La Liga,32,1987,9.8,8,4,5,3,0,7,14,50.0,7,6,3,3,13,21,38,0,Matches
826,Jonny Evans,NIR,DF,Leicester City,Premier League,32,1988,27.5,25,12,22,2,1,14,20,70.0,6,8,3,5,46,71,98,1,Matches
827,Edu Expósito,ESP,MF,Eibar,La Liga,23,1996,27.3,51,30,16,31,4,20,66,30.3,46,25,4,21,22,73,17,0,Matches
828,Valentin Eysseric,FRA,"MF,FW",Fiorentina,Serie A,28,1992,8.1,14,8,6,7,1,5,11,45.5,6,11,0,11,7,21,8,0,Matches
829,Eberechi Eze,ENG,MF,Crystal Palace,Premier League,22,1998,28.4,27,14,11,13,3,16,35,45.7,19,19,3,16,24,51,9,1,Matches
830,Jokin Ezkieta,ESP,GK,Athletic Club,La Liga,23,1996,1.0,0,0,0,0,0,0,0,,0,0,0,0,0,0,0,0,Matches
831,Łukasz Fabiański,POL,GK,West Ham,Premier League,35,1985,35.0,1,0,1,0,0,1,1,100.0,0,1,0,1,1,2,12,3,Matches
832,Fabinho,BRA,"DF,MF",Liverpool,Premier League,26,1993,28.5,58,31,21,29,8,27,54,50.0,27,28,10,18,44,102,66,1,Matches
833,Fábio,BRA,DF,Nantes,Ligue 1,30,1990,16.7,62,37,37,23,2,35,61,57.4,26,29,8,21,37,99,49,0,Matches
834,Cesc Fàbregas,ESP,"MF,FW",Monaco,Ligue 1,33,1987,9.7,20,12,6,9,5,9,22,40.9,13,11,1,10,13,33,3,0,Matches
835,Bandiougou Fadiga,FRA,"FW,MF",Paris S-G,Ligue 1,19,2001,0.7,1,0,1,0,0,0,0,,0,0,0,0,0,1,0,0,Matches
836,Bandiougou Fadiga,FRA,"MF,FW",Brest,Ligue 1,19,2001,0.5,0,0,0,0,0,0,2,0.0,2,0,0,0,0,0,0,0,Matches
837,Wout Faes,BEL,DF,Reims,Ligue 1,22,1998,32.2,35,22,26,9,0,20,39,51.3,19,40,31,9,68,103,144,1,Matches
838,Nicolò Fagioli,ITA,MF,Juventus,Serie A,19,2001,0.2,0,0,0,0,0,0,0,,0,0,0,0,0,0,1,0,Matches
839,Ralf Fährmann,GER,GK,Schalke 04,Bundesliga,31,1988,20.8,2,1,2,0,0,1,2,50.0,1,0,0,0,1,3,9,3,Matches
840,Romain Faivre,FRA,"MF,FW",Brest,Ligue 1,22,1998,32.1,54,27,26,23,5,21,54,38.9,33,30,0,30,30,84,18,0,Matches
841,Fali,ESP,"DF,MF",Cádiz,La Liga,26,1993,29.3,42,25,24,15,3,16,37,43.2,21,28,15,13,32,74,119,0,Matches
842,Iago Falque,ESP,"MF,FW",Benevento,Serie A,30,1990,4.0,4,2,2,2,0,1,6,16.7,5,4,1,3,0,4,1,0,Matches
843,Andri Fannar Baldursson,ISL,MF,Bologna,Serie A,18,2002,2.4,6,6,1,2,3,1,3,33.3,2,3,1,2,3,9,7,0,Matches
844,Paolo Faragò,ITA,DF,Bologna,Serie A,27,1993,0.3,1,1,1,0,0,1,2,50.0,1,1,0,1,0,1,0,0,Matches
845,Paolo Faragò,ITA,DF,Cagliari,Serie A,27,1993,4.1,13,9,10,3,0,9,20,45.0,11,3,2,1,6,19,15,0,Matches
846,Davide Faraoni,ITA,DF,Hellas Verona,Serie A,28,1991,32.1,62,33,36,19,7,28,51,54.9,23,48,17,31,49,111,83,1,Matches
847,Mohamed Fares,ALG,DF,Lazio,Serie A,24,1996,12.7,20,15,9,7,4,11,19,57.9,8,14,1,13,16,36,21,0,Matches
848,Diego Farias,BRA,FW,Spezia,Serie A,30,1990,16.8,9,5,4,1,4,4,21,19.0,17,12,0,12,13,22,3,0,Matches
849,Wuilker Faríñez,VEN,GK,Lens,Ligue 1,22,1998,1.2,0,0,0,0,0,0,0,,0,0,0,0,0,0,1,0,Matches
850,Noah Fatar,FRA,"FW,MF",Angers,Ligue 1,18,2002,0.2,1,0,0,0,1,0,0,,0,0,0,0,0,1,0,0,Matches
851,Ansu Fati,ESP,FW,Barcelona,La Liga,17,2002,4.8,9,4,2,4,3,2,10,20.0,8,4,0,4,3,12,1,0,Matches
852,Julien Faussurier,FRA,DF,Brest,Ligue 1,33,1987,10.6,16,11,6,8,2,11,25,44.0,14,12,4,8,9,25,10,0,Matches
853,Andrea Favilli,ITA,FW,Hellas Verona,Serie A,23,1997,3.8,3,1,0,1,2,2,3,66.7,1,2,0,2,0,3,2,0,Matches
854,Federico Fazio,ARG,DF,Roma,Serie A,33,1987,4.5,3,2,3,0,0,3,4,75.0,1,3,3,0,7,10,18,1,Matches
855,Nabil Fekir,FRA,"MF,FW",Betis,La Liga,27,1993,29.1,45,23,9,22,14,7,43,16.3,36,31,2,29,8,53,2,0,Matches
856,Felipe,BRA,DF,Atlético Madrid,La Liga,31,1989,22.9,29,17,19,10,0,18,23,78.3,5,30,15,15,36,65,128,2,Matches
857,Luiz Felipe,ITA,DF,Lazio,Serie A,23,1997,10.1,32,20,19,11,2,16,24,66.7,8,20,9,11,21,53,29,1,Matches
858,João Félix,POR,"FW,MF",Atlético Madrid,La Liga,20,1999,17.5,8,4,1,6,1,4,17,23.5,13,3,0,3,5,13,2,0,Matches
859,Ohis Felix Uduokhai,GER,DF,Augsburg,Bundesliga,22,1997,29.0,33,24,19,10,4,18,27,66.7,9,48,25,23,54,87,164,2,Matches
860,Zinedine Ferhat,ALG,"FW,MF",Nîmes,Ligue 1,27,1993,32.9,36,21,18,9,9,18,39,46.2,21,22,0,22,32,68,38,0,Matches
861,Bruno Fernandes,POR,MF,Manchester Utd,Premier League,25,1994,34.4,57,30,16,29,12,26,100,26.0,74,38,0,38,26,83,29,0,Matches
862,Edimilson Fernandes,SUI,"MF,FW",Mainz 05,Bundesliga,24,1996,9.3,8,4,4,4,0,4,7,57.1,3,12,4,8,29,37,25,0,Matches
863,Aitor Fernández,ESP,GK,Levante,La Liga,29,1991,29.0,0,0,0,0,0,0,0,,0,0,0,0,2,2,17,1,Matches
864,Álex Fernández,ESP,MF,Cádiz,La Liga,27,1992,21.6,19,9,8,8,3,8,30,26.7,22,14,1,13,22,41,15,0,Matches
865,Álvaro Fernández,ESP,GK,Huesca,La Liga,22,1998,22.0,1,1,0,1,0,1,3,33.3,2,0,0,0,2,3,7,0,Matches
866,Andrés Fernández,ESP,GK,Huesca,La Liga,33,1986,16.0,0,0,0,0,0,0,0,,0,0,0,0,0,0,3,2,Matches
867,Augusto Fernández,ARG,MF,Cádiz,La Liga,34,1986,4.1,11,3,5,6,0,2,13,15.4,11,5,1,4,9,20,5,0,Matches
868,Carlos Fernández,ESP,FW,Sevilla,La Liga,24,1996,1.6,1,0,1,0,0,0,2,0.0,2,3,1,2,1,2,0,0,Matches
869,Carlos Fernández,ESP,"FW,MF",Real Sociedad,La Liga,24,1996,4.3,3,2,0,2,1,1,8,12.5,7,6,1,5,0,3,6,0,Matches
870,Federico Fernández,ARG,DF,Newcastle Utd,Premier League,31,1989,23.1,29,22,23,5,1,17,21,81.0,4,41,31,10,17,46,147,0,Matches
871,Joaquín Fernández,ESP,DF,Valladolid,La Liga,24,1996,23.0,30,16,21,8,1,12,21,57.1,9,24,15,9,43,73,113,0,Matches
872,Fernandinho,BRA,MF,Manchester City,Premier League,35,1985,13.2,31,17,8,14,9,20,43,46.5,23,11,2,9,23,54,17,0,Matches
873,Fernando,BRA,MF,Sevilla,La Liga,33,1987,28.3,54,28,24,25,5,23,43,53.5,20,25,11,14,41,95,70,0,Matches
874,Alex Ferrari,ITA,DF,Sampdoria,Serie A,26,1994,9.8,27,15,16,9,2,15,24,62.5,9,18,6,12,23,50,26,0,Matches
875,David Ferreiro,ESP,"MF,FW",Huesca,La Liga,32,1988,28.1,25,12,12,8,5,8,49,16.3,41,21,1,20,25,50,15,0,Matches
876,Salvador Ferrer,ESP,DF,Spezia,Serie A,22,1998,13.2,20,10,10,8,2,8,22,36.4,14,13,4,9,24,44,37,1,Matches
877,Facundo Ferreyra,ARG,FW,Celta Vigo,La Liga,29,1991,3.3,4,3,1,2,1,0,2,0.0,2,5,0,5,2,6,2,0,Matches
878,Jordan Ferri,FRA,MF,Montpellier,Ligue 1,28,1992,28.6,58,40,34,22,2,31,103,30.1,72,30,5,25,8,66,18,1,Matches
879,Marco Festa,ITA,GK,Crotone,Serie A,28,1992,1.0,0,0,0,0,0,0,0,,0,0,0,0,0,0,0,0,Matches
880,Fidel,ESP,"MF,DF",Elche,La Liga,30,1989,26.6,46,30,28,15,3,25,64,39.1,39,22,2,20,16,62,14,0,Matches
881,Sam Field,ENG,MF,West Brom,Premier League,22,1998,0.7,5,5,3,2,0,0,0,,0,4,1,3,2,7,4,0,Matches
882,Alfreð Finnbogason,ISL,FW,Augsburg,Bundesliga,31,1989,6.0,2,1,0,1,1,0,1,0.0,1,7,1,6,1,3,4,0,Matches
883,Roberto Firmino,BRA,FW,Liverpool,Premier League,28,1991,31.5,33,15,3,17,13,6,32,18.8,26,42,5,37,11,44,12,0,Matches
884,Junior Firpo,DOM,"DF,MF",Barcelona,La Liga,23,1996,3.2,1,1,1,0,0,0,1,0.0,1,5,3,2,4,5,7,0,Matches
885,Will Fish,ENG,FW,Manchester Utd,Premier League,17,2003,0.0,0,0,0,0,0,0,0,,0,0,0,0,0,0,0,0,Matches
886,John Fleck,SCO,MF,Sheffield Utd,Premier League,28,1991,28.6,51,33,28,18,5,26,83,31.3,57,26,4,22,28,79,12,1,Matches
887,Mark Flekken,NED,GK,Freiburg,Bundesliga,27,1993,3.0,0,0,0,0,0,0,0,,0,0,0,0,0,0,1,0,Matches
888,Florian Flick,GER,MF,Schalke 04,Bundesliga,20,2000,4.0,10,7,4,6,0,7,16,43.8,9,4,3,1,7,17,5,1,Matches
889,Alexis Flips,FRA,"MF,FW",Reims,Ligue 1,20,2000,0.5,0,0,0,0,0,0,2,0.0,2,0,0,0,0,0,1,0,Matches
890,Alessandro Florenzi,ITA,DF,Paris S-G,Ligue 1,29,1991,17.1,24,16,9,9,6,12,29,41.4,17,7,1,6,17,41,25,0,Matches
891,Kingsley Fobi,GHA,DF,Granada,La Liga,21,1998,0.5,0,0,0,0,0,0,0,,0,0,0,0,1,1,1,0,Matches
892,Phil Foden,ENG,"FW,MF",Manchester City,Premier League,20,2000,18.0,22,11,12,8,2,9,23,39.1,14,9,0,9,11,33,11,0,Matches
893,Mamadou Fofana,MLI,"MF,DF",Metz,Ligue 1,22,1998,11.9,25,11,17,8,0,7,31,22.6,24,14,2,12,18,43,36,0,Matches
894,Seko Fofana,CIV,MF,Lens,Ligue 1,25,1995,25.7,16,8,3,10,3,4,26,15.4,22,16,5,11,34,50,23,1,Matches
895,Wesley Fofana,FRA,DF,Leicester City,Premier League,19,2000,25.1,51,37,27,22,2,31,46,67.4,15,28,16,12,61,112,94,0,Matches
896,Wesley Fofana,FRA,DF,Saint-Étienne,Ligue 1,19,2000,3.5,6,4,6,0,0,3,4,75.0,1,3,3,0,8,14,14,1,Matches
897,Youssouf Fofana,FRA,MF,Monaco,Ligue 1,21,1999,31.9,90,51,31,51,8,42,82,51.2,40,43,7,36,34,124,14,2,Matches
898,Thomas Foket,BEL,DF,Reims,Ligue 1,25,1994,36.9,77,43,50,20,7,40,69,58.0,29,28,7,21,69,146,92,2,Matches
899,Ramón Folch,ESP,MF,Elche,La Liga,30,1989,0.0,0,0,0,0,0,0,0,,0,0,0,0,0,0,0,0,Matches
900,Lamine Fomba,FRA,MF,Nîmes,Ligue 1,22,1998,24.2,66,36,30,25,11,30,65,46.2,35,48,19,29,59,125,39,2,Matches
901,Thomas Fontaine,MAD,DF,Lorient,Ligue 1,29,1991,3.6,5,2,5,0,0,2,2,100.0,0,3,2,1,5,10,14,0,Matches
902,José Fontán,ESP,DF,Celta Vigo,La Liga,20,2000,7.2,12,9,8,4,0,5,11,45.5,6,4,3,1,13,25,27,0,Matches
903,José Fonte,POR,DF,Lille,Ligue 1,36,1983,35.4,40,29,28,10,2,27,33,81.8,6,36,23,13,36,76,137,1,Matches
904,Fernando Forestieri,ITA,"FW,MF",Udinese,Serie A,30,1990,6.1,9,7,4,4,1,3,7,42.9,4,7,0,7,2,11,0,0,Matches
905,Pablo Fornals,ESP,"FW,MF",West Ham,Premier League,24,1996,28.6,44,26,14,24,6,11,73,15.1,62,43,1,42,36,80,9,0,Matches
906,Emil Forsberg,SWE,"FW,MF",RB Leipzig,Bundesliga,28,1991,17.1,11,6,1,6,4,5,27,18.5,22,10,1,9,11,22,4,0,Matches
907,Fraser Forster,ENG,GK,Southampton,Premier League,32,1988,8.0,1,0,1,0,0,1,2,50.0,1,0,0,0,0,1,9,0,Matches
908,Philipp Förster,GER,MF,Stuttgart,Bundesliga,25,1995,16.8,22,13,7,12,3,6,25,24.0,19,18,1,17,15,37,2,0,Matches
909,Steven Fortes,CPV,DF,Lens,Ligue 1,28,1992,15.9,33,20,20,10,3,16,22,72.7,6,25,10,15,27,60,52,0,Matches
910,Yassin Fortune,FRA,FW,Angers,Ligue 1,21,1999,0.2,0,0,0,0,0,0,0,,0,0,0,0,0,0,0,0,Matches
911,Timothy Fosu-Mensah,NED,DF,Manchester Utd,Premier League,22,1998,0.9,2,0,1,1,0,1,1,100.0,0,0,0,0,3,5,1,0,Matches
912,Timothy Fosu-Mensah,NED,DF,Leverkusen,Bundesliga,22,1998,4.5,4,2,1,2,1,2,4,50.0,2,7,3,4,7,11,4,0,Matches
913,Daam Foulon,BEL,DF,Benevento,Serie A,21,1999,11.3,26,15,21,5,0,16,28,57.1,12,12,3,9,14,40,34,0,Matches
914,Dimitri Foulquier,FRA,DF,Granada,La Liga,27,1993,29.6,35,21,20,12,3,15,26,57.7,11,24,7,17,26,61,60,0,Matches
915,Juan Foyth,ARG,"DF,MF",Villarreal,La Liga,22,1998,13.0,40,22,22,14,4,12,29,41.4,17,21,6,15,19,59,24,1,Matches
916,Gianluca Frabotta,ITA,"DF,MF",Juventus,Serie A,21,1999,7.7,7,4,5,0,2,5,12,41.7,7,9,1,8,14,21,15,0,Matches
917,Raphael Framberger,GER,DF,Augsburg,Bundesliga,24,1995,17.1,42,23,26,11,5,19,25,76.0,6,24,2,22,36,78,62,1,Matches
918,Tyrese Francois,AUS,DF,Fulham,Premier League,20,2000,0.2,0,0,0,0,0,0,0,,0,0,0,0,0,0,0,0,Matches
919,Ryan Fraser,SCO,"FW,MF",Newcastle Utd,Premier League,26,1994,10.3,4,1,3,1,0,2,5,40.0,3,1,0,1,6,10,7,0,Matches
920,Fred,BRA,MF,Manchester Utd,Premier League,27,1993,26.6,81,39,39,38,4,29,89,32.6,60,49,9,40,45,126,26,1,Matches
921,Ryan Fredericks,ENG,"DF,FW",West Ham,Premier League,27,1992,6.3,9,5,5,4,0,3,7,42.9,4,6,2,4,11,20,20,0,Matches
922,Remo Freuler,SUI,MF,Atalanta,Serie A,28,1992,30.1,63,39,17,38,8,32,76,42.1,44,52,4,48,39,102,27,2,Matches
923,Marco Friedl,AUT,DF,Werder Bremen,Bundesliga,22,1998,30.9,50,34,31,17,2,30,62,48.4,32,38,17,21,55,105,118,1,Matches
924,Marvin Friedrich,GER,DF,Union Berlin,Bundesliga,24,1995,34.0,47,29,35,11,1,18,32,56.3,14,38,18,20,52,99,109,0,Matches
925,Jeremie Frimpong,NED,"DF,FW",Leverkusen,Bundesliga,19,2000,4.8,7,4,4,3,0,4,8,50.0,4,4,0,4,1,8,7,0,Matches
926,Jorge de Frutos,ESP,MF,Levante,La Liga,23,1997,24.3,48,24,21,21,6,11,41,26.8,30,25,2,23,16,64,18,0,Matches
927,Christian Fuchs,AUT,DF,Leicester City,Premier League,34,1986,7.8,18,7,15,2,1,8,15,53.3,7,6,4,2,16,34,34,1,Matches
928,Angelo Fulgini,FRA,MF,Angers,Ligue 1,23,1996,30.3,22,13,4,12,6,12,34,35.3,22,17,0,17,15,37,9,0,Matches
929,Niclas Füllkrug,GER,FW,Werder Bremen,Bundesliga,27,1993,9.7,7,3,2,4,1,1,13,7.7,12,10,4,6,3,10,13,0,Matches
930,Ramiro Funes Mori,ARG,DF,Villarreal,La Liga,29,1991,8.1,12,8,7,5,0,7,11,63.6,4,7,5,2,8,20,42,1,Matches
931,Darnell Furlong,ENG,DF,West Brom,Premier League,24,1995,32.6,45,27,27,12,6,21,44,47.7,23,39,16,23,49,94,90,0,Matches
932,Daniel Fuzato,BRA,GK,Roma,Serie A,23,1997,5.0,0,0,0,0,0,0,0,,0,1,0,1,0,0,1,1,Matches
933,Baptiste Gabard,FRA,MF,Saint-Étienne,Ligue 1,20,2000,1.5,4,3,1,3,0,1,5,20.0,4,4,0,4,1,5,0,0,Matches
934,Matteo Gabbia,ITA,DF,Milan,Serie A,20,1999,6.2,9,5,3,6,0,2,2,100.0,0,8,6,2,3,12,21,0,Matches
935,Manolo Gabbiadini,ITA,FW,Sampdoria,Serie A,28,1991,9.7,2,2,0,2,0,0,1,0.0,1,3,1,2,3,5,5,0,Matches
936,Mijat Gaćinović,SRB,"DF,MF",Hoffenheim,Bundesliga,25,1995,9.1,18,10,6,11,1,9,24,37.5,15,13,0,13,18,36,15,0,Matches
937,Roberto Gagliardini,ITA,MF,Inter,Serie A,26,1994,13.7,30,17,17,8,5,5,28,17.9,23,15,3,12,19,49,16,0,Matches
938,Riccardo Gagliolo,SWE,DF,Parma,Serie A,30,1990,21.7,45,18,35,8,2,28,45,62.2,17,34,7,27,36,81,64,1,Matches
939,Adolfo Gaich,ARG,FW,Benevento,Serie A,21,1999,8.5,9,4,1,7,1,1,13,7.7,12,4,0,4,2,11,4,0,Matches
940,Andrey Galabinov,BUL,FW,Spezia,Serie A,31,1988,4.8,2,1,1,1,0,1,3,33.3,2,2,0,2,0,2,5,0,Matches
941,Javi Galán,ESP,DF,Huesca,La Liga,25,1994,34.1,88,54,47,35,6,46,72,63.9,26,30,4,26,39,127,61,0,Matches
942,Conor Gallagher,ENG,MF,West Brom,Premier League,20,2000,28.1,81,41,30,39,12,29,97,29.9,68,47,8,39,27,108,31,0,Matches
943,Enric Gallego,ESP,FW,Osasuna,La Liga,33,1986,9.0,6,3,2,2,2,2,14,14.3,12,5,1,4,1,7,9,0,Matches
944,Kévin Gameiro,FRA,FW,Valencia,La Liga,33,1987,12.0,7,4,3,2,2,3,11,27.3,8,10,0,10,0,7,3,0,Matches
945,Idrissa Gana Gueye,SEN,MF,Paris S-G,Ligue 1,30,1989,17.6,63,35,20,34,9,26,50,52.0,24,26,7,19,20,83,9,3,Matches
946,Ignatius Ganago,CMR,FW,Lens,Ligue 1,21,1999,14.5,4,3,0,2,2,3,12,25.0,9,7,1,6,6,10,3,0,Matches
947,Aleix García,ESP,MF,Eibar,La Liga,23,1997,4.9,5,4,2,2,1,1,10,10.0,9,5,0,5,8,13,2,0,Matches
948,Borja García,ESP,"MF,FW",Huesca,La Liga,29,1990,12.4,13,7,4,6,3,6,12,50.0,6,12,0,12,10,23,4,1,Matches
949,Dani García,ESP,MF,Athletic Club,La Liga,30,1990,21.3,39,19,10,23,6,15,46,32.6,31,20,7,13,33,72,34,0,Matches
950,David García,ESP,DF,Osasuna,La Liga,26,1994,35.0,26,17,13,13,0,13,24,54.2,11,36,19,17,59,85,171,0,Matches
951,Eric García,ESP,DF,Manchester City,Premier League,19,2001,4.3,8,7,5,3,0,5,7,71.4,2,4,1,3,4,12,10,0,Matches
952,Manu García,ESP,MF,Alavés,La Liga,34,1986,12.5,24,13,10,13,1,8,35,22.9,27,16,1,15,12,36,21,0,Matches
953,Raúl García,ESP,"DF,MF",Valladolid,La Liga,31,1989,5.6,10,8,5,5,0,6,20,30.0,14,5,1,4,9,19,10,0,Matches
954,Raúl García,ESP,"FW,MF",Athletic Club,La Liga,34,1986,19.4,34,19,9,19,6,7,22,31.8,15,30,1,29,15,49,20,0,Matches
955,Rubén García,ESP,"MF,FW",Osasuna,La Liga,27,1993,30.2,50,29,21,22,7,14,45,31.1,31,28,2,26,29,79,20,0,Matches
956,Sergi García,ESP,MF,Alavés,La Liga,21,1999,0.2,1,1,0,1,0,0,1,0.0,1,0,0,0,0,1,0,0,Matches
957,Unai García,ESP,DF,Osasuna,La Liga,28,1992,13.8,19,9,14,4,1,9,15,60.0,6,16,8,8,14,33,40,0,Matches
958,Mario Gaspar,ESP,DF,Villarreal,La Liga,29,1990,20.6,55,34,22,24,9,21,40,52.5,19,26,4,22,30,85,47,1,Matches
959,Manuel Gasparini,ITA,GK,Udinese,Serie A,18,2002,0.0,0,0,0,0,0,0,0,,0,0,0,0,0,0,0,0,Matches
960,Dwight Gayle,ENG,"FW,MF",Newcastle Utd,Premier League,29,1990,5.7,2,0,1,1,0,0,7,0.0,7,3,1,2,1,3,2,0,Matches
961,Paulo Gazzaniga,ARG,GK,Elche,La Liga,28,1992,8.0,1,1,1,0,0,0,0,,0,0,0,0,1,2,4,0,Matches
962,Jean-Philippe Gbamin,CIV,MF,Everton,Premier League,24,1995,0.1,1,0,0,1,0,0,0,,0,1,0,1,0,1,1,0,Matches
963,Yann Gboho,FRA,"MF,FW",Rennes,Ligue 1,19,2001,3.4,6,3,3,1,2,3,8,37.5,5,1,0,1,1,7,3,1,Matches
964,David de Gea,ESP,GK,Manchester Utd,Premier League,29,1990,25.5,0,0,0,0,0,0,0,,0,0,0,0,0,0,8,3,Matches
965,Christian Gebauer,AUT,"MF,FW",Arminia,Bundesliga,26,1993,7.6,9,4,2,5,2,4,11,36.4,7,4,1,3,6,15,14,0,Matches
966,Theodor Gebre Selassie,CZE,DF,Werder Bremen,Bundesliga,33,1986,33.7,61,35,39,17,5,28,64,43.8,36,33,11,22,58,119,98,1,Matches
967,Emrehan Gedikli,GER,FW,Leverkusen,Bundesliga,17,2003,0.3,0,0,0,0,0,0,0,,0,0,0,0,0,0,0,0,Matches
968,Dennis Geiger,GER,MF,Hoffenheim,Bundesliga,22,1998,7.3,13,10,3,8,2,5,8,62.5,3,10,0,10,3,16,0,0,Matches
969,Christian Gentner,GER,MF,Union Berlin,Bundesliga,34,1985,11.5,17,8,9,5,3,5,18,27.8,13,13,1,12,17,34,16,0,Matches
970,Yannick Gerhardt,GER,"MF,FW",Wolfsburg,Bundesliga,26,1994,21.5,52,32,14,32,6,21,52,40.4,31,34,4,30,21,73,30,0,Matches
971,Valère Germain,FRA,"FW,MF",Marseille,Ligue 1,30,1990,9.5,8,6,2,4,2,3,11,27.3,8,7,2,5,11,19,22,0,Matches
972,Gervinho,CIV,FW,Parma,Serie A,33,1987,22.5,5,1,2,2,1,1,14,7.1,13,11,1,10,10,15,3,0,Matches
973,Willem Geubbels,FRA,"MF,FW",Monaco,Ligue 1,18,2001,3.3,12,8,5,7,0,5,13,38.5,8,9,0,9,3,15,5,0,Matches
974,Hamadi Al Ghaddioui,MAR,FW,Stuttgart,Bundesliga,29,1990,0.5,0,0,0,0,0,0,1,0.0,1,0,0,0,0,0,0,0,Matches
975,Anwar El Ghazi,NED,FW,Aston Villa,Premier League,25,1995,17.9,16,13,6,7,3,7,23,30.4,16,11,0,11,6,22,11,0,Matches
976,Paolo Ghiglione,ITA,"DF,MF",Genoa,Serie A,23,1997,15.1,27,15,17,8,2,13,28,46.4,15,14,2,12,13,40,25,0,Matches
977,Faouzi Ghoulam,ALG,"DF,FW",Napoli,Serie A,29,1991,3.2,6,5,3,2,1,0,1,0.0,1,4,2,2,3,9,1,0,Matches
978,Kieran Gibbs,ENG,DF,West Brom,Premier League,30,1989,9.0,15,11,11,3,1,8,10,80.0,2,8,6,2,16,31,30,1,Matches
979,Morgan Gibbs-White,ENG,"MF,FW",Wolves,Premier League,20,2000,4.6,9,7,3,4,2,5,12,41.7,7,6,0,6,3,12,1,0,Matches
980,Niko Gießelmann,GER,DF,Union Berlin,Bundesliga,28,1991,4.8,12,9,7,4,1,5,8,62.5,3,9,3,6,8,20,13,1,Matches
981,Rafał Gikiewicz,POL,GK,Augsburg,Bundesliga,32,1987,34.0,0,0,0,0,0,0,3,0.0,3,0,0,0,3,3,9,1,Matches
982,Bryan Gil,ESP,FW,Sevilla,La Liga,19,2001,0.1,1,1,0,1,0,0,0,,0,0,0,0,0,1,0,0,Matches
983,Bryan Gil,ESP,"MF,FW",Eibar,La Liga,19,2001,25.2,28,18,12,11,5,6,23,26.1,17,20,0,20,17,45,6,0,Matches
984,David Gil,ESP,GK,Cádiz,La Liga,26,1994,4.0,0,0,0,0,0,0,1,0.0,1,0,0,0,0,0,2,0,Matches
985,Billy Gilmour,SCO,MF,Chelsea,Premier League,19,2001,2.9,4,2,1,2,1,2,7,28.6,5,3,2,1,3,7,1,0,Matches
986,Álvaro Giménez,ESP,FW,Cádiz,La Liga,29,1991,4.5,4,2,2,2,0,0,3,0.0,3,2,0,2,2,6,3,0,Matches
987,Daniel Ginczek,GER,"FW,MF",Wolfsburg,Bundesliga,29,1991,2.4,2,2,1,1,0,2,8,25.0,6,2,0,2,1,3,2,0,Matches
988,Matthias Ginter,GER,DF,Gladbach,Bundesliga,26,1994,34.0,26,16,15,10,1,14,24,58.3,10,43,32,11,51,77,121,0,Matches
989,Andrei Girotto,BRA,"DF,MF",Nantes,Ligue 1,28,1992,29.6,65,41,50,15,0,39,70,55.7,31,34,15,19,59,124,103,0,Matches
990,Olivier Giroud,FRA,FW,Chelsea,Premier League,33,1986,8.3,4,2,0,1,3,1,7,14.3,6,4,1,3,5,9,10,0,Matches
991,Robert Glatzel,GER,FW,Mainz 05,Bundesliga,26,1994,4.0,1,0,1,0,0,0,2,0.0,2,2,0,2,0,1,2,0,Matches
992,Kamil Glik,POL,DF,Benevento,Serie A,32,1988,35.6,44,24,33,10,1,25,53,47.2,28,37,31,6,62,106,153,0,Matches
993,Serge Gnabry,GER,"FW,MF",Bayern Munich,Bundesliga,25,1995,18.3,39,19,7,19,13,12,32,37.5,20,17,0,17,26,65,3,0,Matches
994,Ben Godfrey,ENG,DF,Everton,Premier League,22,1998,29.8,55,33,37,15,3,27,41,65.9,14,56,37,19,33,88,120,0,Matches
995,Diego Godín,URU,DF,Cagliari,Serie A,34,1986,27.9,60,32,51,9,0,24,39,61.5,15,41,24,17,56,116,117,0,Matches
996,Akaki Gogia,GER,"FW,MF",Union Berlin,Bundesliga,28,1992,1.6,1,0,0,1,0,0,2,0.0,2,0,0,0,1,2,0,0,Matches
997,Amer Gojak,BIH,"MF,FW",Torino,Serie A,23,1997,5.3,1,0,1,0,0,1,7,14.3,6,5,0,5,3,4,1,0,Matches
998,Edoardo Goldaniga,ITA,DF,Genoa,Serie A,26,1993,20.6,28,18,21,7,0,14,23,60.9,9,17,7,10,38,66,62,1,Matches
999,Vladimir Golemić,SVN,DF,Crotone,Serie A,29,1991,26.0,33,16,17,13,3,14,19,73.7,5,38,26,12,40,73,97,2,Matches
1000,Pierluigi Gollini,ITA,GK,Atalanta,Serie A,25,1995,24.0,1,0,1,0,0,1,2,50.0,1,1,0,1,1,2,11,0,Matches
1001,Aleksandr Golovin,RUS,"MF,FW",Monaco,Ligue 1,24,1996,11.9,28,16,6,18,4,8,39,20.5,31,21,0,21,11,39,3,0,Matches
1002,Tomislav Gomelt,CRO,MF,Crotone,Serie A,25,1995,0.2,1,1,0,1,0,0,0,,0,0,0,0,1,2,0,0,Matches
1003,André Gomes,POR,MF,Everton,Premier League,27,1993,17.4,35,23,16,16,3,17,58,29.3,41,19,1,18,10,45,12,1,Matches
1004,Dani Gómez,ESP,FW,Levante,La Liga,22,1998,18.5,4,3,2,1,1,0,11,0.0,11,3,0,3,2,6,4,0,Matches
1005,Ibai Gómez,ESP,MF,Athletic Club,La Liga,30,1989,4.7,6,4,2,3,1,4,7,57.1,3,3,0,3,2,8,4,0,Matches
1006,Joe Gomez,ENG,DF,Liverpool,Premier League,23,1997,6.6,3,2,1,1,1,0,4,0.0,4,3,2,1,4,7,29,0,Matches
1007,Maxi Gómez,URU,FW,Valencia,La Liga,23,1996,29.9,11,9,3,7,1,3,14,21.4,11,13,3,10,2,13,34,0,Matches
1008,Moi Gómez,ESP,"MF,FW",Villarreal,La Liga,26,1994,28.5,21,12,6,8,7,14,35,40.0,21,20,3,17,11,32,16,0,Matches
1009,Papu Gómez,ARG,"MF,FW",Atalanta,Serie A,32,1988,7.4,3,2,2,1,0,2,8,25.0,6,8,1,7,1,4,1,0,Matches
1010,Papu Gómez,ARG,"MF,FW",Sevilla,La Liga,32,1988,10.2,9,6,2,4,3,2,12,16.7,10,13,2,11,7,16,6,0,Matches
1011,Sergi Gómez,ESP,DF,Sevilla,La Liga,28,1992,8.0,4,3,2,2,0,1,1,100.0,0,5,4,1,6,10,34,0,Matches
1012,Sergio Gómez,ESP,"MF,FW",Huesca,La Liga,19,2000,8.8,29,10,17,9,3,11,22,50.0,11,15,0,15,14,43,9,0,Matches
1013,Alfred Gomis,SEN,GK,Dijon,Ligue 1,26,1993,5.0,1,0,1,0,0,1,2,50.0,1,0,0,0,1,2,7,0,Matches
1014,Alfred Gomis,SEN,GK,Rennes,Ligue 1,26,1993,22.0,1,1,1,0,0,1,1,100.0,0,0,0,0,3,4,10,1,Matches
1015,Maxime Gonalons,FRA,MF,Granada,La Liga,31,1989,16.4,53,37,18,33,2,15,37,40.5,22,17,0,17,25,78,21,1,Matches
1016,Vagner Gonçalves,CPV,"FW,MF",Metz,Ligue 1,24,1996,10.7,16,9,5,5,6,2,15,13.3,13,6,0,6,4,20,1,1,Matches
1017,Álvaro González,ESP,DF,Marseille,Ligue 1,30,1990,31.5,26,17,20,6,0,19,31,61.3,12,30,18,12,33,59,119,1,Matches
1018,Bruno González,ESP,DF,Valladolid,La Liga,30,1990,25.1,26,17,18,8,0,17,31,54.8,14,22,14,8,37,63,112,1,Matches
1019,Diego González,ESP,DF,Elche,La Liga,25,1995,14.2,11,7,7,3,1,5,11,45.5,6,16,9,7,20,31,49,1,Matches
1020,Nicolás González,ARG,"FW,MF",Stuttgart,Bundesliga,22,1998,10.4,5,5,1,2,2,0,6,0.0,6,10,3,7,4,9,6,0,Matches
1021,Sergio González,ESP,"MF,DF",Cádiz,La Liga,23,1997,1.0,1,0,0,1,0,1,2,50.0,1,0,0,0,2,3,0,0,Matches
1022,Urko González,ESP,MF,Real Sociedad,La Liga,19,2001,0.5,0,0,0,0,0,0,1,0.0,1,1,1,0,0,0,1,0,Matches
1023,Anthony Gordon,ENG,"FW,MF",Everton,Premier League,19,2001,1.0,3,3,3,0,0,0,2,0.0,2,1,0,1,1,4,3,0,Matches
1024,Leon Goretzka,GER,MF,Bayern Munich,Bundesliga,25,1995,18.9,37,23,12,21,4,16,39,41.0,23,30,2,28,44,81,11,0,Matches
1025,Andoni Gorosabel,ESP,DF,Real Sociedad,La Liga,23,1996,26.5,76,43,45,20,11,27,64,42.2,37,25,4,21,23,99,42,0,Matches
1026,Robin Gosens,GER,DF,Atalanta,Serie A,26,1994,28.0,46,35,20,15,11,17,41,41.5,24,50,7,43,41,87,34,0,Matches
1027,Amine Gouiri,ALG,"FW,MF",Nice,Ligue 1,20,2000,30.5,31,18,7,16,8,10,41,24.4,31,22,6,16,17,48,23,0,Matches
1028,Lucas Gourna-Douath,FRA,MF,Saint-Étienne,Ligue 1,16,2003,14.7,32,22,18,11,3,15,28,53.6,13,10,0,10,24,56,18,0,Matches
1029,Jeffrey Gouweleeuw,NED,DF,Augsburg,Bundesliga,29,1991,31.5,36,20,24,11,1,16,33,48.5,17,37,18,19,69,105,149,2,Matches
1030,Jonathan Gradit,FRA,DF,Lens,Ligue 1,27,1992,31.4,60,39,26,28,6,22,38,57.9,16,37,19,18,56,116,81,1,Matches
1031,Karlan Grant,ENG,"FW,MF",West Brom,Premier League,22,1997,12.5,5,3,3,2,0,2,4,50.0,2,7,0,7,5,10,17,0,Matches
1032,Alberto Grassi,ITA,"MF,DF",Parma,Serie A,25,1995,13.1,30,11,14,13,3,8,29,27.6,21,22,9,13,26,56,32,0,Matches
1033,Andrew Gravillon,GLP,DF,Lorient,Ligue 1,22,1998,25.2,26,17,17,9,0,13,28,46.4,15,44,31,13,59,85,118,4,Matches
1034,Demarai Gray,JAM,FW,Leicester City,Premier League,24,1996,0.2,1,1,1,0,0,0,0,,0,0,0,0,0,1,0,0,Matches
1035,Demarai Gray,JAM,FW,Leverkusen,Bundesliga,24,1996,4.9,3,2,1,2,0,1,1,100.0,0,3,0,3,4,7,3,0,Matches
1036,Adrian Grbić,AUT,FW,Lorient,Ligue 1,23,1996,10.7,6,4,2,2,2,1,7,14.3,6,6,0,6,5,11,7,0,Matches
1037,Jack Grealish,ENG,"FW,MF",Aston Villa,Premier League,24,1995,24.3,31,14,8,16,7,15,24,62.5,9,20,3,17,12,43,5,3,Matches
1038,Etienne Green,ENG,GK,Saint-Étienne,Ligue 1,20,2000,8.0,0,0,0,0,0,0,0,,0,0,0,0,0,0,3,0,Matches
1039,Mason Greenwood,ENG,FW,Manchester Utd,Premier League,18,2001,20.2,13,10,6,4,3,5,22,22.7,17,9,0,9,5,18,1,0,Matches
1040,Michael Gregoritsch,AUT,"FW,MF",Augsburg,Bundesliga,26,1994,9.3,13,10,6,7,0,3,10,30.0,7,2,0,2,3,16,17,0,Matches
1041,Clément Grenier,FRA,"MF,FW",Rennes,Ligue 1,29,1991,12.0,20,8,9,8,3,7,31,22.6,24,7,0,7,5,25,3,0,Matches
1042,Sebastian Griesbeck,GER,MF,Union Berlin,Bundesliga,29,1990,9.9,20,9,8,11,1,8,19,42.1,11,13,3,10,5,25,8,0,Matches
1043,Antoine Griezmann,FRA,"FW,MF",Barcelona,La Liga,29,1991,28.9,37,22,10,18,9,12,40,30.0,28,20,1,19,12,49,11,0,Matches
1044,Vincenzo Grifo,ITA,"MF,FW",Freiburg,Bundesliga,27,1993,25.7,18,7,6,7,5,14,34,41.2,20,13,0,13,27,45,18,1,Matches
1045,Lennart Grill,GER,GK,Leverkusen,Bundesliga,21,1999,4.0,0,0,0,0,0,0,0,,0,0,0,0,0,0,2,0,Matches
1046,Florian Grillitsch,AUT,"MF,DF",Hoffenheim,Bundesliga,24,1995,20.9,37,21,21,13,3,19,52,36.5,33,38,7,31,51,88,47,1,Matches
1047,Christian Groß,GER,"MF,DF",Werder Bremen,Bundesliga,31,1989,16.3,44,28,17,25,2,15,37,40.5,22,12,2,10,24,68,37,0,Matches
1048,Pascal Groß,GER,"MF,DF",Brighton,Premier League,29,1991,27.6,45,24,24,15,6,24,53,45.3,29,25,4,21,23,68,18,1,Matches
1049,Kamil Grosicki,POL,"MF,FW",West Brom,Premier League,32,1988,1.6,2,1,2,0,0,2,8,25.0,6,1,0,1,2,4,1,0,Matches
1050,Ilia Gruev,BUL,FW,Werder Bremen,Bundesliga,20,2000,0.0,0,0,0,0,0,0,0,,0,0,0,0,0,0,0,0,Matches
1051,Carlos Gruezo,ECU,MF,Augsburg,Bundesliga,25,1995,23.2,57,32,20,32,5,20,52,38.5,32,32,5,27,35,92,29,1,Matches
1052,Vicente Guaita,ESP,GK,Crystal Palace,Premier League,33,1987,37.0,1,1,1,0,0,1,1,100.0,0,0,0,0,1,2,11,1,Matches
1053,Andrés Guardado,MEX,MF,Betis,La Liga,33,1986,14.6,25,12,10,11,4,10,25,40.0,15,13,3,10,18,43,19,0,Matches
1054,Sergi Guardiola,ESP,FW,Valladolid,La Liga,29,1991,19.9,11,5,1,5,5,2,27,7.4,25,12,1,11,7,18,16,3,Matches
1055,Nemanja Gudelj,SRB,"MF,DF",Sevilla,La Liga,28,1991,11.6,23,12,16,5,2,4,10,40.0,6,10,6,4,24,47,24,2,Matches
1056,Gonçalo Guedes,POR,"MF,FW",Valencia,La Liga,23,1996,25.4,18,12,8,7,3,10,45,22.2,35,24,1,23,8,26,7,0,Matches
1057,Mattéo Guendouzi,FRA,MF,Hertha BSC,Bundesliga,21,1999,20.2,24,13,10,12,2,9,25,36.0,16,15,4,11,21,45,24,1,Matches
1058,Raphaël Guerreiro,POR,DF,Dortmund,Bundesliga,26,1993,24.6,30,13,14,8,8,16,31,51.6,15,21,4,17,28,58,31,1,Matches
1059,Evann Guessand,CIV,FW,Nice,Ligue 1,19,2001,0.3,0,0,0,0,0,0,1,0.0,1,1,1,0,1,1,1,0,Matches
1060,Kelyan Guessoum,FRA,DF,Nîmes,Ligue 1,21,1999,12.5,13,7,11,1,1,11,16,68.8,5,8,6,2,24,37,51,0,Matches
1061,Ander Guevara,ESP,MF,Real Sociedad,La Liga,23,1997,23.1,35,23,15,16,4,15,30,50.0,15,19,5,14,25,60,35,1,Matches
1062,Lamine Gueye,SEN,"FW,MF",Metz,Ligue 1,22,1998,16.2,18,9,4,11,3,7,24,29.2,17,7,2,5,21,39,5,0,Matches
1063,Pape Gueye,SEN,MF,Marseille,Ligue 1,21,1999,22.9,49,21,25,19,5,15,45,33.3,30,25,6,19,47,96,34,0,Matches
1064,John Guidetti,SWE,FW,Alavés,La Liga,28,1992,2.3,2,2,0,2,0,0,2,0.0,2,0,0,0,1,3,2,0,Matches
1065,Josuha Guilavogui,FRA,"MF,DF",Wolfsburg,Bundesliga,29,1990,8.3,17,9,9,8,0,5,12,41.7,7,12,5,7,29,46,25,0,Matches
1066,Frederic Guilbert,FRA,DF,Strasbourg,Ligue 1,25,1994,12.4,37,19,23,11,3,21,34,61.8,13,14,1,13,33,70,32,0,Matches
1067,Hugo Guillamón,ESP,DF,Valencia,La Liga,20,2000,22.1,23,13,17,6,0,8,20,40.0,12,19,14,5,27,50,102,3,Matches
1068,Bruno Guimarães,BRA,MF,Lyon,Ligue 1,22,1997,19.5,76,34,26,41,9,30,64,46.9,34,24,4,20,14,90,13,0,Matches
1069,Serhou Guirassy,GUI,FW,Rennes,Ligue 1,24,1996,19.6,4,1,1,3,0,1,3,33.3,2,10,1,9,5,9,17,0,Matches
1070,Péter Gulácsi,HUN,GK,RB Leipzig,Bundesliga,30,1990,33.0,1,0,1,0,0,1,2,50.0,1,0,0,0,2,3,7,0,Matches
1071,Manuel Gulde,GER,DF,Freiburg,Bundesliga,29,1991,21.7,27,15,12,12,3,5,21,23.8,16,25,15,10,37,64,64,0,Matches
1072,Robert Gumny,POL,DF,Augsburg,Bundesliga,22,1998,15.3,24,15,12,9,3,15,23,65.2,8,12,2,10,18,42,31,0,Matches
1073,İlkay Gündoğan,GER,MF,Manchester City,Premier League,29,1990,22.5,25,15,8,12,5,10,39,25.6,29,13,4,9,20,45,9,0,Matches
1074,Christian Günter,GER,"DF,MF",Freiburg,Bundesliga,27,1993,34.0,34,19,18,13,3,15,43,34.9,28,38,9,29,29,63,40,0,Matches
1075,Koray Günter,GER,DF,Hellas Verona,Serie A,25,1994,19.6,20,10,10,9,1,4,9,44.4,5,27,21,6,70,90,87,0,Matches
1076,Jon Guridi,ESP,MF,Real Sociedad,La Liga,25,1995,9.2,19,9,10,6,3,8,22,36.4,14,8,1,7,10,29,9,0,Matches
1077,Malo Gusto,FRA,"DF,MF",Lyon,Ligue 1,17,2003,0.0,0,0,0,0,0,0,0,,0,0,0,0,0,0,0,0,Matches
1078,Raúl Guti,ESP,MF,Elche,La Liga,23,1996,31.8,48,28,21,22,5,16,52,30.8,36,25,3,22,49,97,25,0,Matches
1079,Marcos Mauro López Gutiérrez,ARG,DF,Cádiz,La Liga,29,1991,20.3,23,15,15,8,0,15,24,62.5,9,18,12,6,22,45,78,0,Matches
1080,Miguel Gutiérrez,ESP,DF,Real Madrid,La Liga,19,2001,3.5,4,0,0,3,1,1,7,14.3,6,3,0,3,5,9,5,0,Matches
1081,Manu Gyabuaa,ITA,MF,Atalanta,Serie A,18,2001,0.0,0,0,0,0,0,0,0,,0,0,0,0,0,0,0,0,Matches
1082,Emmanuel Gyasi,GHA,FW,Spezia,Serie A,26,1994,31.7,30,16,16,10,4,9,31,29.0,22,13,2,11,14,44,8,0,Matches
1083,Erling Haaland,NOR,FW,Dortmund,Bundesliga,20,2000,26.7,7,2,1,3,3,1,4,25.0,3,19,4,15,4,11,16,0,Matches
1084,Janik Haberer,GER,"MF,FW",Freiburg,Bundesliga,26,1994,5.4,7,4,4,3,0,3,15,20.0,12,4,1,3,7,14,9,0,Matches
1085,Alexander Hack,GER,DF,Mainz 05,Bundesliga,26,1993,15.2,32,21,23,8,1,18,31,58.1,13,26,17,9,41,73,91,2,Matches
1086,Antwoine Hackford,ENG,DF,Sheffield Utd,Premier League,16,2004,0.1,0,0,0,0,0,0,0,,0,0,0,0,0,0,0,0,Matches
1087,Munir El Haddadi,MAR,FW,Sevilla,La Liga,24,1995,9.4,12,8,5,5,2,2,12,16.7,10,6,0,6,5,17,6,0,Matches
1088,André Hahn,GER,"FW,MF",Augsburg,Bundesliga,29,1990,22.6,31,17,14,13,4,9,44,20.5,35,35,3,32,14,45,24,0,Matches
1089,Amadou Haidara,MLI,"MF,FW",RB Leipzig,Bundesliga,22,1998,21.2,50,28,20,21,9,11,36,30.6,25,33,1,32,30,80,24,0,Matches
1090,Massadio Haïdara,MLI,DF,Lens,Ligue 1,27,1992,23.7,48,32,21,21,6,23,37,62.2,14,29,6,23,35,83,60,0,Matches
1091,Achraf Hakimi,MAR,DF,Inter,Serie A,21,1998,29.6,53,32,23,19,11,23,48,47.9,25,31,1,30,22,75,23,1,Matches
1092,Sébastien Haller,CIV,FW,West Ham,Premier League,26,1994,10.4,14,9,1,6,7,4,20,20.0,16,7,1,6,5,19,7,0,Matches
1093,Marcel Halstenberg,GER,DF,RB Leipzig,Bundesliga,28,1991,18.3,29,18,20,8,1,19,41,46.3,22,15,3,12,16,45,35,0,Matches
1094,Pierre-Yves Hamel,FRA,FW,Lorient,Ligue 1,26,1994,9.4,15,8,3,9,3,1,6,16.7,5,12,1,11,10,25,6,0,Matches
1095,Romain Hamouma,FRA,"FW,MF",Saint-Étienne,Ligue 1,33,1987,19.7,12,7,5,6,1,4,24,16.7,20,17,1,16,7,19,11,0,Matches
1096,Samir Handanović,SVN,GK,Inter,Serie A,36,1984,36.0,1,0,1,0,0,1,1,100.0,0,0,0,0,0,1,6,3,Matches
1097,Lukáš Haraslín,SVK,"FW,MF",Sassuolo,Serie A,24,1996,3.7,8,4,2,5,1,2,5,40.0,3,1,0,1,0,8,2,0,Matches
1098,Amine Harit,MAR,"MF,FW",Schalke 04,Bundesliga,23,1997,23.3,22,13,8,11,3,10,23,43.5,13,9,1,8,17,39,7,1,Matches
1099,Rekeem Harper,ENG,MF,West Brom,Premier League,20,2000,0.4,0,0,0,0,0,0,0,,0,2,0,2,1,1,0,0,Matches
1100,Jack Harrison,ENG,"MF,FW",Leeds United,Premier League,23,1996,31.6,63,38,20,30,13,26,59,44.1,33,30,2,28,15,78,21,0,Matches
1101,Marcel Hartel,GER,MF,Arminia,Bundesliga,24,1996,18.7,35,19,15,18,2,20,40,50.0,20,17,4,13,26,61,16,1,Matches
1102,Makoto Hasebe,JPN,"DF,MF",Eint Frankfurt,Bundesliga,36,1984,25.4,43,29,21,20,2,25,51,49.0,26,31,12,19,31,74,68,2,Matches
1103,Hans Hateboer,NED,DF,Atalanta,Serie A,26,1994,19.6,28,17,12,14,2,13,23,56.5,10,8,1,7,17,45,9,0,Matches
1104,Kortney Hause,ENG,DF,Aston Villa,Premier League,25,1995,7.0,4,2,3,1,0,0,3,0.0,3,4,2,2,8,12,53,0,Matches
1105,Kai Havertz,GER,"MF,FW",Chelsea,Premier League,21,1999,16.9,18,9,6,10,2,6,27,22.2,21,25,0,25,4,22,22,1,Matches
1106,Isaac Hayden,ENG,"MF,DF",Newcastle Utd,Premier League,25,1995,21.6,52,29,23,22,7,14,35,40.0,21,32,9,23,43,95,47,0,Matches
1107,Eden Hazard,BEL,"FW,MF",Real Madrid,La Liga,29,1991,5.9,3,2,1,2,0,0,3,0.0,3,3,0,3,3,6,0,0,Matches
1108,Thorgan Hazard,BEL,"MF,FW",Dortmund,Bundesliga,27,1993,7.3,8,2,6,1,1,3,13,23.1,10,4,0,4,10,18,1,0,Matches
1109,Jonas Hector,GER,"MF,FW",Köln,Bundesliga,30,1990,14.3,34,22,8,21,5,15,35,42.9,20,24,5,19,19,53,20,1,Matches
1110,Michael Hector,JAM,DF,Fulham,Premier League,28,1992,2.9,3,2,1,2,0,1,6,16.7,5,4,2,2,0,3,6,0,Matches
1111,Hwang Hee-chan,KOR,"FW,MF",RB Leipzig,Bundesliga,24,1996,5.1,3,2,1,0,2,1,7,14.3,6,4,0,4,1,4,1,0,Matches
1112,Ahmed Hegazi,EGY,DF,West Brom,Premier League,29,1991,1.0,0,0,0,0,0,0,0,,0,2,0,2,1,1,7,0,Matches
1113,Dominique Heintz,GER,DF,Freiburg,Bundesliga,26,1993,15.2,22,11,19,3,0,10,19,52.6,9,10,8,2,35,57,49,0,Matches
1114,Dean Henderson,ENG,GK,Manchester Utd,Premier League,23,1997,12.5,1,1,1,0,0,1,2,50.0,1,0,0,0,0,1,3,2,Matches
1115,Jordan Henderson,ENG,"MF,DF",Liverpool,Premier League,30,1990,18.9,24,15,12,9,3,10,26,38.5,16,12,1,11,34,58,30,0,Matches
1116,Jeff Hendrick,IRL,MF,Newcastle Utd,Premier League,28,1992,15.8,8,3,5,3,0,1,13,7.7,12,14,9,5,19,27,18,0,Matches
1117,Benjamin Henrichs,GER,"DF,MF",RB Leipzig,Bundesliga,23,1997,6.0,12,7,4,5,3,2,9,22.2,7,9,1,8,8,20,8,0,Matches
1118,Dalbert Henrique,BRA,DF,Rennes,Ligue 1,26,1993,4.1,7,6,4,2,1,6,8,75.0,2,8,2,6,5,12,8,0,Matches
1119,Eduardo Henrique,BRA,MF,Crotone,Serie A,25,1995,10.3,5,2,1,4,0,3,12,25.0,9,6,1,5,7,12,7,1,Matches
1120,Luis Henrique,BRA,"FW,DF",Marseille,Ligue 1,18,2001,7.5,5,4,3,1,1,4,9,44.4,5,5,1,4,7,12,4,0,Matches
1121,Christophe Hérelle,MTQ,DF,Brest,Ligue 1,27,1992,15.3,19,13,12,6,1,10,12,83.3,2,13,9,4,31,50,41,2,Matches
1122,Jérôme Hergault,FRA,"DF,MF",Lorient,Ligue 1,34,1986,18.1,38,23,22,10,6,17,31,54.8,14,16,2,14,22,60,34,0,Matches
1123,Mario Hermoso,ESP,DF,Atlético Madrid,La Liga,25,1995,28.6,55,31,40,11,4,37,61,60.7,24,23,10,13,36,91,73,0,Matches
1124,Aridane Hernández,ESP,DF,Osasuna,La Liga,31,1989,22.5,20,11,13,6,1,7,12,58.3,5,22,19,3,34,54,127,1,Matches
1125,Lucas Hernández,FRA,DF,Bayern Munich,Bundesliga,24,1996,17.7,41,31,16,17,8,17,31,54.8,14,24,6,18,19,60,38,0,Matches
1126,Pablo Hernández,ESP,MF,Leeds United,Premier League,35,1985,4.7,5,3,2,1,2,5,16,31.3,11,2,0,2,0,5,0,1,Matches
1127,Theo Hernández,FRA,DF,Milan,Serie A,22,1997,32.6,48,29,22,21,5,19,38,50.0,19,29,6,23,34,82,64,5,Matches
1128,Hernani,BRA,MF,Parma,Serie A,26,1994,24.3,51,25,21,27,3,29,66,43.9,37,35,4,31,31,82,40,1,Matches
1129,Ander Herrera,ESP,MF,Paris S-G,Ligue 1,30,1989,20.6,53,35,17,26,10,30,77,39.0,47,31,5,26,31,84,22,1,Matches
1130,Héctor Herrera,MEX,MF,Atlético Madrid,La Liga,30,1990,7.6,12,7,5,6,1,7,13,53.8,6,7,2,5,14,26,8,0,Matches
1131,Sergio Herrera,ESP,GK,Osasuna,La Liga,27,1993,32.9,0,0,0,0,0,0,2,0.0,2,0,0,0,3,3,29,3,Matches
1132,Yangel Herrera,VEN,MF,Granada,La Liga,22,1998,25.7,59,26,19,32,8,11,41,26.8,30,53,17,36,26,85,32,1,Matches
1133,Patrick Herrmann,GER,"FW,MF",Gladbach,Bundesliga,29,1991,9.7,9,6,4,3,2,2,14,14.3,12,16,0,16,10,19,8,0,Matches
1134,Pablo Hervías,ESP,"DF,MF",Valladolid,La Liga,27,1993,13.4,19,12,7,9,3,9,26,34.6,17,6,0,6,11,30,8,0,Matches
1135,Përparim Hetemaj,FIN,MF,Benevento,Serie A,33,1986,24.6,44,27,21,18,5,26,61,42.6,35,41,5,36,22,66,24,1,Matches
1136,Son Heung-min,KOR,FW,Tottenham,Premier League,28,1992,34.6,32,18,11,14,7,18,72,25.0,54,28,3,25,14,46,8,0,Matches
1137,Aaron Hickey,SCO,DF,Bologna,Serie A,18,2002,8.4,12,8,10,2,0,7,17,41.2,10,6,1,5,15,27,15,1,Matches
1138,Vitorino Hilton,BRA,DF,Montpellier,Ligue 1,42,1977,23.5,15,10,10,4,1,3,14,21.4,11,34,26,8,38,53,104,3,Matches
1139,Martin Hinteregger,AUT,DF,Eint Frankfurt,Bundesliga,27,1992,28.1,77,49,53,22,2,37,63,58.7,26,31,12,19,44,121,92,0,Matches
1140,Marwin Hitz,SUI,GK,Dortmund,Bundesliga,32,1987,15.5,1,1,1,0,0,1,1,100.0,0,0,0,0,0,1,7,1,Matches
1141,Wesley Hoedt,NED,DF,Lazio,Serie A,26,1994,10.6,22,16,18,4,0,10,17,58.8,7,9,5,4,17,39,48,1,Matches
1142,Ki-Jana Hoever,NED,"DF,MF",Wolves,Premier League,18,2002,6.4,14,6,11,2,1,10,22,45.5,12,2,0,2,9,23,23,0,Matches
1143,Nicolas Höfler,GER,MF,Freiburg,Bundesliga,30,1990,30.3,54,28,16,31,7,23,59,39.0,36,34,10,24,66,120,41,2,Matches
1144,Jonas Hofmann,GER,"FW,MF",Gladbach,Bundesliga,28,1992,20.2,26,20,12,12,2,10,53,18.9,43,27,2,25,27,53,9,0,Matches
1145,Marco Höger,GER,"DF,MF",Köln,Bundesliga,30,1989,0.6,1,0,0,1,0,1,2,50.0,1,2,0,2,2,3,1,0,Matches
1146,Rob Holding,ENG,DF,Arsenal,Premier League,24,1995,28.4,43,20,28,13,2,17,35,48.6,18,37,27,10,24,67,120,0,Matches
1147,Lucas Höler,GER,"FW,MF",Freiburg,Bundesliga,26,1994,23.2,36,24,13,19,4,12,32,37.5,20,19,2,17,16,52,14,0,Matches
1148,Mason Holgate,ENG,DF,Everton,Premier League,23,1996,25.4,56,36,31,18,7,20,50,40.0,30,37,13,24,35,91,90,3,Matches
1149,Jordan Holsgrove,SCO,MF,Celta Vigo,La Liga,20,1999,1.6,6,4,4,1,1,5,8,62.5,3,2,0,2,2,8,1,0,Matches
1150,Franck Honorat,FRA,"MF,FW",Brest,Ligue 1,23,1996,27.3,28,13,12,10,6,14,37,37.8,23,15,3,12,11,39,24,0,Matches
1151,Matthew Hoppe,USA,FW,Schalke 04,Bundesliga,19,2001,14.5,6,6,1,3,2,2,12,16.7,10,8,2,6,4,10,15,0,Matches
1152,Jannes Horn,GER,DF,Köln,Bundesliga,23,1997,19.6,35,19,23,11,1,23,31,74.2,8,19,2,17,10,45,45,0,Matches
1153,Timo Horn,GER,GK,Köln,Bundesliga,27,1993,33.4,1,0,1,0,0,1,4,25.0,3,1,0,1,0,1,11,2,Matches
1154,Fraser Hornby,SCO,"FW,MF",Reims,Ligue 1,20,1999,0.4,0,0,0,0,0,0,0,,0,0,0,0,1,1,0,0,Matches
1155,Conor Hourihane,IRL,MF,Aston Villa,Premier League,29,1991,2.5,0,0,0,0,0,0,2,0.0,2,3,0,3,0,0,2,0,Matches
1156,Lukáš Hrádecký,FIN,GK,Leverkusen,Bundesliga,30,1989,28.5,0,0,0,0,0,0,1,0.0,1,0,0,0,1,1,11,3,Matches
1157,Ajdin Hrustic,AUS,"MF,DF",Eint Frankfurt,Bundesliga,24,1996,3.0,6,5,2,3,1,3,10,30.0,7,2,0,2,4,10,3,0,Matches
1158,Florian Hübner,GER,DF,Union Berlin,Bundesliga,29,1991,5.8,10,5,7,3,0,7,15,46.7,8,7,3,4,13,23,21,0,Matches
1159,Callum Hudson-Odoi,ENG,"FW,DF",Chelsea,Premier League,19,2000,11.8,23,15,11,7,5,8,21,38.1,13,15,1,14,6,29,6,0,Matches
1160,Niall Huggins,WAL,DF,Leeds United,Premier League,19,2000,0.4,0,0,0,0,0,0,1,0.0,1,0,0,0,0,0,1,0,Matches
1161,Mats Hummels,GER,DF,Dortmund,Bundesliga,31,1988,31.3,58,40,34,18,6,26,42,61.9,16,31,22,9,73,131,122,2,Matches
1162,Adrien Hunou,FRA,"FW,MF",Rennes,Ligue 1,26,1994,6.5,6,3,2,2,2,2,8,25.0,6,7,0,7,1,7,2,0,Matches
1163,Klaas-Jan Huntelaar,NED,FW,Schalke 04,Bundesliga,36,1983,6.5,4,2,0,2,2,0,2,0.0,2,3,1,2,2,6,3,0,Matches
1164,Elseid Hysaj,ALB,DF,Napoli,Serie A,26,1994,19.6,29,17,16,11,2,17,33,51.5,16,18,4,14,30,59,52,0,Matches
1165,Pierre Højbjerg,DEN,MF,Tottenham,Premier League,24,1995,38.0,98,51,45,42,11,54,129,41.9,75,51,9,42,48,146,66,0,Matches
1166,Simone Iacoponi,ITA,DF,Parma,Serie A,33,1987,13.3,22,12,16,5,1,13,26,50.0,13,9,4,5,11,33,42,1,Matches
1167,Iago,BRA,DF,Augsburg,Bundesliga,23,1997,17.3,37,27,21,13,3,17,29,58.6,12,17,5,12,22,59,55,0,Matches
1168,Roger Ibanez,BRA,DF,Roma,Serie A,21,1998,26.6,59,37,28,25,6,25,45,55.6,20,38,17,21,68,127,78,3,Matches
1169,Vedad Ibišević,BIH,FW,Schalke 04,Bundesliga,35,1984,1.7,0,0,0,0,0,0,0,,0,1,0,1,1,1,1,0,Matches
1170,Vicente Iborra,ESP,MF,Villarreal,La Liga,32,1988,10.3,18,8,8,7,3,8,24,33.3,16,14,7,7,14,32,25,1,Matches
1171,Didier Ibrahim Ndong,GAB,MF,Dijon,Ligue 1,26,1994,29.0,53,32,22,30,1,25,70,35.7,45,35,7,28,37,90,40,0,Matches
1172,Zlatan Ibrahimović,SWE,FW,Milan,Serie A,38,1981,16.6,5,4,0,4,1,3,6,50.0,3,5,3,2,6,11,27,1,Matches
1173,Mauro Icardi,ARG,FW,Paris S-G,Ligue 1,27,1993,12.0,6,2,1,2,3,4,13,30.8,9,3,1,2,3,9,7,0,Matches
1174,Oussama Idrissi,MAR,"FW,MF",Sevilla,La Liga,24,1996,0.3,1,1,0,1,0,1,2,50.0,1,2,0,2,1,2,0,0,Matches
1175,Blendi Idrizi,KVX,MF,Schalke 04,Bundesliga,22,1998,2.6,8,4,1,6,1,1,1,100.0,0,6,2,4,3,11,1,0,Matches
1176,Odion Ighalo,NGA,FW,Manchester Utd,Premier League,31,1989,0.1,0,0,0,0,0,0,1,0.0,1,0,0,0,0,0,0,0,Matches
1177,Iglesias,ESP,"DF,MF",Getafe,La Liga,22,1998,6.7,27,15,14,10,3,11,19,57.9,8,11,1,10,17,44,19,0,Matches
1178,Borja Iglesias,ESP,FW,Betis,La Liga,27,1993,15.7,1,1,0,0,1,1,8,12.5,7,7,2,5,3,4,9,0,Matches
1179,Igor,BRA,DF,Fiorentina,Serie A,22,1998,13.0,15,9,9,6,0,7,12,58.3,5,17,9,8,23,38,34,0,Matches
1180,Kelechi Iheanacho,NGA,FW,Leicester City,Premier League,23,1996,16.2,12,5,2,4,6,4,17,23.5,13,14,0,14,2,14,1,1,Matches
1181,Jonathan Ikone,FRA,"MF,FW",Lille,Ligue 1,22,1998,24.2,18,12,3,8,7,9,22,40.9,13,16,1,15,7,25,9,0,Matches
1182,Yun Il-lok,KOR,"MF,FW",Montpellier,Ligue 1,28,1992,3.5,0,0,0,0,0,0,4,0.0,4,0,0,0,5,5,1,0,Matches
1183,Ivan Ilić,SRB,MF,Hellas Verona,Serie A,19,2001,20.4,26,14,11,11,4,7,21,33.3,14,17,5,12,27,53,26,0,Matches
1184,Josip Iličić,SVN,"MF,FW",Atalanta,Serie A,32,1988,17.0,9,4,1,5,3,5,21,23.8,16,12,0,12,2,11,0,1,Matches
1185,Asier Illarramendi,ESP,MF,Real Sociedad,La Liga,30,1990,3.7,5,2,1,4,0,1,5,20.0,4,2,0,2,5,10,7,0,Matches
1186,Stefan Ilsanker,AUT,"MF,DF",Eint Frankfurt,Bundesliga,31,1989,17.5,33,20,17,15,1,21,42,50.0,21,30,8,22,30,63,51,2,Matches
1187,Ciro Immobile,ITA,FW,Lazio,Serie A,30,1990,31.7,14,13,4,6,4,7,22,31.8,15,13,1,12,6,20,9,0,Matches
1188,Riccardo Improta,ITA,"DF,MF",Benevento,Serie A,26,1993,25.9,39,23,25,8,6,21,45,46.7,24,23,4,19,28,67,47,0,Matches
1189,Roberto Inglese,ITA,FW,Parma,Serie A,28,1991,6.4,5,2,1,2,2,2,11,18.2,9,10,0,10,0,5,3,0,Matches
1190,Danny Ings,ENG,FW,Southampton,Premier League,28,1992,24.1,22,13,3,16,3,12,28,42.9,16,39,2,37,3,25,27,1,Matches
1191,Marcus Ingvartsen,DEN,"MF,FW",Union Berlin,Bundesliga,24,1996,21.8,17,11,5,6,6,8,26,30.8,18,22,0,22,18,35,10,0,Matches
1192,Lorenzo Insigne,ITA,FW,Napoli,Serie A,29,1991,31.8,26,18,8,12,6,13,72,18.1,59,30,1,29,37,63,6,1,Matches
1193,Roberto Insigne,ITA,"MF,FW",Benevento,Serie A,26,1994,17.8,16,10,8,3,5,7,27,25.9,20,10,0,10,7,23,9,0,Matches
1194,Pablo Insua,ESP,DF,Huesca,La Liga,26,1993,17.6,37,18,26,9,2,14,31,45.2,17,14,8,6,24,61,68,0,Matches
1195,Takashi Inui,JPN,"MF,FW",Eibar,La Liga,32,1988,20.2,13,8,6,3,4,3,12,25.0,9,19,0,19,12,25,7,0,Matches
1196,Artur Ioniță,MDA,MF,Benevento,Serie A,29,1990,31.5,47,22,11,31,5,17,63,27.0,46,38,14,24,19,66,28,0,Matches
1197,Alexander Isak,SWE,FW,Real Sociedad,La Liga,20,1999,26.0,9,5,0,3,6,3,8,37.5,5,17,1,16,3,12,7,0,Matches
1198,Isco,ESP,MF,Real Madrid,La Liga,28,1992,10.1,13,9,5,5,3,2,14,14.3,12,7,1,6,2,15,2,0,Matches
1199,Ardian Ismajli,ALB,DF,Spezia,Serie A,23,1996,14.4,19,9,10,8,1,8,13,61.5,5,10,7,3,23,42,52,1,Matches
1200,Abass Issah,GHA,"DF,FW",Mainz 05,Bundesliga,21,1998,0.2,0,0,0,0,0,0,0,,0,0,0,0,0,0,0,0,Matches
1201,Branislav Ivanović,SRB,DF,West Brom,Premier League,36,1984,8.5,14,5,11,3,0,7,13,53.8,6,11,5,6,8,22,25,0,Matches
1202,Alex Iwobi,NGA,"FW,MF",Everton,Premier League,24,1996,17.1,27,10,10,14,3,13,25,52.0,12,20,1,19,16,43,14,0,Matches
1203,Jairo Izquierdo,ESP,"MF,DF",Cádiz,La Liga,26,1993,14.2,21,13,13,8,0,12,31,38.7,19,7,1,6,14,35,12,0,Matches
1204,José Izquierdo,COL,DF,Brighton,Premier League,28,1992,0.1,0,0,0,0,0,0,0,,0,0,0,0,0,0,0,0,Matches
1205,Armando Izzo,ITA,DF,Torino,Serie A,28,1992,22.3,30,16,13,13,4,13,33,39.4,20,22,9,13,53,83,62,0,Matches
1206,Phil Jagielka,ENG,DF,Sheffield Utd,Premier League,37,1982,5.8,5,4,4,0,1,2,7,28.6,5,11,5,6,10,15,26,2,Matches
1207,Alireza Jahanbakhsh,IRN,"FW,MF",Brighton,Premier League,26,1993,5.9,9,7,3,5,1,2,12,16.7,10,8,0,8,8,17,1,0,Matches
1208,Mato Jajalo,BIH,MF,Udinese,Serie A,32,1988,0.4,1,1,1,0,0,1,1,100.0,0,1,0,1,2,3,0,0,Matches
1209,Ismail Jakobs,SEN,"MF,FW",Köln,Bundesliga,20,1999,19.2,25,10,17,4,4,11,21,52.4,10,18,1,17,16,41,36,0,Matches
1210,Daniel James,WAL,FW,Manchester Utd,Premier League,22,1997,10.1,15,9,4,7,4,3,18,16.7,15,10,1,9,0,15,6,0,Matches
1211,Reece James,ENG,DF,Chelsea,Premier League,20,1999,26.4,55,35,24,22,9,21,44,47.7,23,36,7,29,17,72,52,0,Matches
1212,Alexandre Jankewitz,SUI,MF,Southampton,Premier League,18,2001,0.0,2,1,2,0,0,1,1,100.0,0,0,0,0,0,2,0,0,Matches
1213,Saidy Janko,GAM,DF,Valladolid,La Liga,24,1995,13.6,19,10,12,5,2,8,14,57.1,6,9,1,8,18,37,47,0,Matches
1214,Jakub Jankto,CZE,MF,Sampdoria,Serie A,24,1996,26.8,28,17,14,7,7,11,35,31.4,24,16,1,15,24,52,34,0,Matches
1215,Tony Jantschke,GER,DF,Gladbach,Bundesliga,30,1990,3.0,2,2,1,1,0,1,3,33.3,2,6,4,2,4,6,7,0,Matches
1216,Adnan Januzaj,BEL,"FW,MF",Real Sociedad,La Liga,25,1995,11.3,9,8,0,6,3,3,8,37.5,5,7,2,5,3,12,4,0,Matches
1217,Rune Jarstein,NOR,GK,Hertha BSC,Bundesliga,35,1984,8.0,0,0,0,0,0,0,0,,0,0,0,0,0,0,7,1,Matches
1218,Jason,ESP,"MF,DF",Valencia,La Liga,26,1994,4.9,9,3,5,2,2,4,16,25.0,12,6,1,5,10,19,4,0,Matches
1219,Luis Javier Suárez,COL,"FW,MF",Granada,La Liga,22,1997,18.5,19,11,5,7,7,6,17,35.3,11,10,1,9,8,27,11,0,Matches
1220,Corentin Jean,FRA,"FW,MF",Lens,Ligue 1,25,1995,6.4,4,3,1,1,2,0,5,0.0,5,4,0,4,2,6,2,0,Matches
1221,Daniel Jebbison,ENG,FW,Sheffield Utd,Premier League,16,2003,3.2,6,2,1,3,2,3,7,42.9,4,6,1,5,1,7,0,0,Matches
1222,Tin Jedvaj,CRO,DF,Leverkusen,Bundesliga,24,1995,1.7,5,2,2,3,0,1,3,33.3,2,2,1,1,2,7,9,0,Matches
1223,Fredrik Jensen,FIN,"FW,MF",Augsburg,Bundesliga,22,1997,4.2,3,2,1,2,0,3,6,50.0,3,4,1,3,2,5,6,0,Matches
1224,Jesé,ESP,FW,Paris S-G,Ligue 1,27,1993,0.3,0,0,0,0,0,0,1,0.0,1,0,0,0,0,0,0,0,Matches
1225,Gabriel Jesus,BRA,FW,Manchester City,Premier League,23,1997,22.9,17,6,5,5,7,11,28,39.3,17,16,0,16,15,32,5,0,Matches
1226,Juan Jesus,BRA,DF,Roma,Serie A,29,1991,1.7,3,1,2,1,0,2,4,50.0,2,1,0,1,2,5,5,0,Matches
1227,Raúl Jiménez,MEX,FW,Wolves,Premier League,29,1991,9.1,3,2,1,2,0,0,7,0.0,7,2,0,2,8,11,12,0,Matches
1228,Joaquín,ESP,"FW,MF",Betis,La Liga,39,1981,14.3,9,3,1,5,3,4,12,33.3,8,8,0,8,17,26,11,0,Matches
1229,John Joe,IRL,"MF,FW",Getafe,La Liga,16,2003,0.7,2,0,0,2,0,0,0,,0,0,0,0,0,2,0,0,Matches
1230,Joelinton,BRA,"FW,MF",Newcastle Utd,Premier League,23,1996,22.0,33,21,7,21,5,14,37,37.8,23,30,2,28,9,42,24,0,Matches
1231,Marco John,GER,DF,Hoffenheim,Bundesliga,18,2002,11.1,21,15,9,5,7,10,22,45.5,12,18,1,17,16,37,21,0,Matches
1232,Ben Johnson,ENG,"DF,FW",West Ham,Premier League,20,2000,5.8,11,5,5,3,3,7,9,77.8,2,5,1,4,11,22,9,0,Matches
1233,Sam Johnstone,ENG,GK,West Brom,Premier League,27,1993,37.0,0,0,0,0,0,0,0,,0,0,0,0,2,2,15,2,Matches
1234,Curtis Jones,ENG,MF,Liverpool,Premier League,19,2001,13.1,16,6,6,7,3,12,25,48.0,13,13,0,13,19,35,11,1,Matches
1235,Frenkie de Jong,NED,"MF,DF",Barcelona,La Liga,23,1997,35.0,44,27,21,19,4,15,35,42.9,20,20,4,16,38,82,29,2,Matches
1236,Luuk de Jong,NED,FW,Sevilla,La Liga,29,1990,14.1,9,5,3,2,4,1,7,14.3,6,11,3,8,5,14,15,0,Matches
1237,Jony,ESP,"MF,FW",Osasuna,La Liga,29,1991,9.7,7,3,1,2,4,5,20,25.0,15,5,0,5,14,21,3,0,Matches
1238,Joan Jordán,ESP,MF,Sevilla,La Liga,26,1994,26.7,52,28,17,29,6,17,76,22.4,59,22,3,19,27,79,25,0,Matches
1239,Jorginho,ITA,MF,Chelsea,Premier League,28,1991,22.3,57,30,22,31,4,31,76,40.8,45,33,5,28,40,97,21,3,Matches
1240,Josan,ESP,"MF,DF",Elche,La Liga,30,1989,21.4,34,18,23,11,0,13,39,33.3,26,24,1,23,21,55,26,1,Matches
1241,Willian José,BRA,FW,Wolves,Premier League,28,1991,12.3,2,1,1,1,0,1,4,25.0,3,6,1,5,1,3,12,0,Matches
1242,Willian José,BRA,FW,Real Sociedad,La Liga,28,1991,7.7,3,1,0,3,0,1,3,33.3,2,3,1,2,0,3,8,0,Matches
1243,Joselu,ESP,FW,Alavés,La Liga,30,1990,33.6,27,14,6,15,6,8,28,28.6,20,26,3,23,15,42,58,1,Matches
1244,Josema,ESP,DF,Elche,La Liga,24,1996,21.8,43,28,33,10,0,10,18,55.6,8,17,7,10,37,80,92,0,Matches
1245,Jota,POR,"MF,FW",Valladolid,La Liga,21,1999,7.4,7,3,1,4,2,5,10,50.0,5,4,0,4,6,13,5,1,Matches
1246,Jota,ESP,MF,Alavés,La Liga,29,1991,15.5,19,14,6,7,6,3,29,10.3,26,12,0,12,9,28,9,0,Matches
1247,Diogo Jota,POR,FW,Liverpool,Premier League,23,1996,12.4,12,6,4,7,1,2,29,6.9,27,9,0,9,5,17,3,0,Matches
1248,Stevan Jovetić,MNE,"FW,MF",Monaco,Ligue 1,30,1989,8.9,8,4,2,3,3,3,13,23.1,10,1,0,1,3,11,3,0,Matches
1249,Luka Jović,SRB,FW,Real Madrid,La Liga,22,1997,1.7,0,0,0,0,0,0,0,,0,0,0,0,0,0,0,0,Matches
1250,Luka Jović,SRB,FW,Eint Frankfurt,Bundesliga,22,1997,9.9,2,0,0,2,0,0,4,0.0,4,3,0,3,1,3,7,0,Matches
1251,Juanmi,ESP,"FW,MF",Betis,La Liga,27,1993,6.7,13,9,3,5,5,4,18,22.2,14,4,0,4,2,15,4,0,Matches
1252,Hamed Junior Traorè,CIV,"MF,FW",Sassuolo,Serie A,20,2000,19.9,29,17,10,10,9,14,35,40.0,21,27,3,24,18,47,9,0,Matches
1253,Vinicius Júnior,BRA,FW,Real Madrid,La Liga,20,2000,21.9,32,22,14,10,8,11,43,25.6,32,28,0,28,7,39,4,0,Matches
1254,James Justin,ENG,DF,Leicester City,Premier League,22,1998,23.0,61,37,38,18,5,20,41,48.8,21,36,10,26,30,91,58,1,Matches
1255,Musa Juwara,GAM,"MF,DF",Bologna,Serie A,18,2001,0.5,2,2,2,0,0,1,3,33.3,2,1,0,1,0,2,0,0,Matches
1256,Jens Jønsson,DEN,MF,Cádiz,La Liga,27,1993,29.1,55,29,25,25,5,22,52,42.3,30,39,7,32,51,106,45,0,Matches
1257,Ozan Kabak,TUR,DF,Liverpool,Premier League,20,2000,8.9,19,10,11,4,4,6,9,66.7,3,2,2,0,12,31,28,1,Matches
1258,Ozan Kabak,TUR,DF,Schalke 04,Bundesliga,20,2000,13.8,17,9,11,5,1,6,13,46.2,7,20,11,9,13,30,57,0,Matches
1259,Abdoul Kader Bamba,FRA,"FW,MF",Nantes,Ligue 1,26,1994,10.2,18,3,7,8,3,11,18,61.1,7,10,0,10,7,25,4,1,Matches
1260,Pavel Kadeřábek,CZE,"DF,FW",Hoffenheim,Bundesliga,28,1992,17.6,15,12,7,6,2,6,15,40.0,9,12,3,9,18,33,31,0,Matches
1261,Tino Kadewere,ZIM,FW,Lyon,Ligue 1,24,1996,22.3,35,22,12,16,7,17,49,34.7,32,16,3,13,21,56,31,0,Matches
1262,Damian Kądzior,POL,"FW,MF",Eibar,La Liga,28,1992,2.2,1,0,0,1,0,1,5,20.0,4,1,0,1,0,1,0,0,Matches
1263,Florian Kainz,AUT,"MF,FW",Köln,Bundesliga,27,1992,5.0,4,2,0,4,0,2,8,25.0,6,7,0,7,3,7,3,0,Matches
1264,Gaël Kakuta,COD,"MF,FW",Lens,Ligue 1,29,1991,26.6,38,23,10,18,10,8,44,18.2,36,24,3,21,17,55,4,0,Matches
1265,Sasa Kalajdzic,AUT,FW,Stuttgart,Bundesliga,23,1997,23.7,16,12,4,5,7,2,17,11.8,15,10,1,9,9,25,21,0,Matches
1266,Arnaud Kalimuendo,FRA,FW,Paris S-G,Ligue 1,18,2002,0.8,0,0,0,0,0,0,0,,0,0,0,0,0,0,0,0,Matches
1267,Arnaud Kalimuendo,FRA,"FW,MF",Lens,Ligue 1,18,2002,13.5,8,2,2,2,4,1,7,14.3,6,11,0,11,2,10,2,0,Matches
1268,Nikola Kalinić,CRO,FW,Hellas Verona,Serie A,32,1988,11.8,5,1,2,2,1,0,3,0.0,3,6,0,6,1,6,7,0,Matches
1269,Yayah Kallon,SLE,FW,Genoa,Serie A,19,2001,0.5,0,0,0,0,0,0,0,,0,0,0,0,0,0,0,0,Matches
1270,Samuel Kalu,NGA,"FW,MF",Bordeaux,Ligue 1,22,1997,10.7,21,12,11,8,2,4,13,30.8,9,14,0,14,9,30,2,0,Matches
1271,Pierre Kalulu,FRA,DF,Milan,Serie A,20,2000,8.1,18,14,11,6,1,10,14,71.4,4,9,3,6,19,37,20,0,Matches
1272,Daichi Kamada,JPN,MF,Eint Frankfurt,Bundesliga,23,1996,26.2,48,28,21,16,11,16,49,32.7,33,18,1,17,14,62,22,0,Matches
1273,Aboubakar Kamara,MTN,"FW,MF",Fulham,Premier League,25,1995,3.5,2,2,1,1,0,0,5,0.0,5,6,0,6,1,3,0,0,Matches
1274,Aboubakar Kamara,MTN,"FW,MF",Dijon,Ligue 1,25,1995,6.2,3,1,0,2,1,1,7,14.3,6,1,0,1,0,3,2,0,Matches
1275,Bingourou Kamara,SEN,GK,Strasbourg,Ligue 1,23,1996,8.0,1,1,1,0,0,1,3,33.3,2,0,0,0,1,2,2,1,Matches
1276,Boubacar Kamara,FRA,MF,Marseille,Ligue 1,20,1999,32.2,88,51,31,49,8,40,74,54.1,34,36,13,23,34,122,51,0,Matches
1277,Hassane Kamara,CIV,"DF,FW",Nice,Ligue 1,26,1994,32.9,65,39,40,16,9,27,49,55.1,22,39,12,27,55,120,61,1,Matches
1278,Marcin Kamiński,POL,DF,Stuttgart,Bundesliga,28,1992,2.4,1,1,0,0,1,0,0,,0,2,1,1,1,2,10,0,Matches
1279,Kevin Kampl,SVN,MF,RB Leipzig,Bundesliga,29,1990,21.5,38,26,9,24,5,18,35,51.4,17,20,2,18,29,67,14,0,Matches
1280,Harry Kane,ENG,FW,Tottenham,Premier League,27,1993,34.2,22,12,1,17,4,8,26,30.8,18,28,11,17,11,33,40,0,Matches
1281,Lee Kang-in,KOR,"FW,MF",Valencia,La Liga,19,2001,14.0,15,11,8,4,3,3,31,9.7,28,12,0,12,2,17,0,0,Matches
1282,Wilfried Kanga,CIV,FW,Angers,Ligue 1,22,1998,1.5,0,0,0,0,0,0,1,0.0,1,1,0,1,0,0,2,0,Matches
1283,N'Golo Kanté,FRA,MF,Chelsea,Premier League,29,1991,23.8,79,42,39,35,5,27,56,48.2,29,42,4,38,59,138,34,0,Matches
1284,Jimmy Kaparos,GER,MF,Schalke 04,Bundesliga,18,2001,0.2,0,0,0,0,0,0,1,0.0,1,0,0,0,0,0,0,0,Matches
1285,Yann Karamoh,FRA,"FW,MF",Parma,Serie A,22,1998,14.4,27,17,8,12,7,11,31,35.5,20,6,0,6,4,31,11,0,Matches
1286,Isaac Karamoko,FRA,DF,Sassuolo,Serie A,18,2002,0.0,1,0,0,0,1,1,1,100.0,0,0,0,0,0,1,0,0,Matches
1287,Atakan Karazor,GER,"DF,MF",Stuttgart,Bundesliga,23,1996,11.5,20,12,12,7,1,13,22,59.1,9,18,8,10,21,41,50,2,Matches
1288,Augustus Kargbo,SLE,FW,Crotone,Serie A,20,1999,0.4,0,0,0,0,0,0,0,,0,0,0,0,0,0,0,0,Matches
1289,Loris Karius,GER,GK,Union Berlin,Bundesliga,27,1993,3.2,0,0,0,0,0,0,0,,0,0,0,0,0,0,2,0,Matches
1290,Rick Karsdorp,NED,DF,Roma,Serie A,25,1995,28.3,36,23,19,12,5,21,48,43.8,27,18,1,17,30,66,32,0,Matches
1291,Silas Katompa,COD,"DF,FW",Stuttgart,Bundesliga,21,1998,21.3,48,29,19,19,10,21,44,47.7,23,29,1,28,22,70,11,2,Matches
1292,Noah Katterbach,GER,"DF,MF",Köln,Bundesliga,19,2001,12.3,18,11,11,6,1,13,21,61.9,8,7,3,4,23,41,22,0,Matches
1293,Eiji Kawashima,JPN,GK,Strasbourg,Ligue 1,37,1983,24.0,1,0,1,0,0,1,1,100.0,0,0,0,0,0,1,4,2,Matches
1294,Moise Kean,ITA,"FW,MF",Everton,Premier League,20,2000,0.2,0,0,0,0,0,0,0,,0,0,0,0,0,0,0,0,Matches
1295,Moise Kean,ITA,FW,Paris S-G,Ligue 1,20,2000,18.9,11,8,2,6,3,3,12,25.0,9,7,1,6,8,19,10,0,Matches
1296,Michael Keane,ENG,DF,Everton,Premier League,27,1993,33.2,28,15,20,8,0,14,31,45.2,17,46,33,13,51,79,161,0,Matches
1297,Neeskens Kebano,COD,"FW,MF",Fulham,Premier League,28,1992,1.3,0,0,0,0,0,0,1,0.0,1,3,0,3,0,0,0,0,Matches
1298,Thilo Kehrer,GER,DF,Paris S-G,Ligue 1,23,1996,18.0,31,26,17,11,3,10,26,38.5,16,16,4,12,15,46,37,1,Matches
1299,Habib Keita,MLI,MF,Lyon,Ligue 1,18,2002,0.1,0,0,0,0,0,0,0,,0,0,0,0,0,0,0,0,Matches
1300,Naby Keïta,GUI,MF,Liverpool,Premier League,25,1995,5.8,11,5,1,8,2,7,17,41.2,10,10,0,10,9,20,6,0,Matches
1301,Yannik Keitel,GER,MF,Freiburg,Bundesliga,20,2000,5.5,12,8,7,4,1,7,9,77.8,2,9,3,6,10,22,8,0,Matches
1302,Caoimhín Kelleher,IRL,GK,Liverpool,Premier League,21,1998,2.0,0,0,0,0,0,0,0,,0,0,0,0,0,0,2,0,Matches
1303,Stephane Keller,CMR,DF,Alavés,La Liga,18,2001,0.2,1,0,1,0,0,1,1,100.0,0,0,0,0,0,1,0,0,Matches
1304,Martin Kelly,ENG,DF,Crystal Palace,Premier League,30,1990,0.0,1,0,1,0,0,1,1,100.0,0,0,0,0,0,1,0,0,Matches
1305,Marc-Oliver Kempf,GER,DF,Stuttgart,Bundesliga,25,1995,30.3,49,26,28,18,3,29,49,59.2,20,40,25,15,68,117,103,1,Matches
1306,Kenedy,BRA,"FW,MF",Granada,La Liga,24,1996,16.3,22,12,10,7,5,5,25,20.0,20,21,4,17,26,48,15,1,Matches
1307,Jonjoe Kenny,ENG,DF,Everton,Premier League,23,1997,0.9,2,1,1,0,1,2,2,100.0,0,0,0,0,1,3,3,0,Matches
1308,Franck Kessié,CIV,MF,Milan,Serie A,23,1996,35.8,53,30,28,19,6,20,38,52.6,18,47,15,32,46,99,51,0,Matches
1309,Reda Khadra,GER,MF,Brighton,Premier League,19,2001,0.1,0,0,0,0,0,0,0,,0,0,0,0,0,0,0,0,Matches
1310,Omar Khailoti,ITA,DF,Bologna,Serie A,18,2001,0.3,0,0,0,0,0,0,0,,0,2,0,2,1,1,0,0,Matches
1311,Saîf-Eddine Khaoui,TUN,"FW,DF",Marseille,Ligue 1,25,1995,6.7,19,11,7,6,6,7,16,43.8,9,8,0,8,12,31,1,0,Matches
1312,Wahbi Khazri,TUN,FW,Saint-Étienne,Ligue 1,29,1991,13.1,24,15,12,7,5,12,24,50.0,12,10,1,9,4,28,11,0,Matches
1313,Rani Khedira,GER,MF,Augsburg,Bundesliga,26,1994,20.2,29,10,13,15,1,10,20,50.0,10,14,5,9,31,60,47,0,Matches
1314,Sami Khedira,GER,MF,Hertha BSC,Bundesliga,33,1987,4.4,11,6,3,7,1,6,12,50.0,6,4,0,4,9,20,7,0,Matches
1315,Kiké,ESP,FW,Eibar,La Liga,30,1989,34.3,24,18,5,7,12,6,22,27.3,16,24,1,23,7,31,29,0,Matches
1316,Luca Kilian,GER,DF,Mainz 05,Bundesliga,20,1999,4.2,14,7,10,4,0,9,17,52.9,8,3,1,2,13,27,12,0,Matches
1317,Max Kilman,ENG,DF,Wolves,Premier League,23,1997,14.6,21,14,13,4,4,8,14,57.1,6,17,8,9,19,40,46,0,Matches
1318,Joshua Kimmich,GER,MF,Bayern Munich,Bundesliga,25,1995,24.4,40,28,16,19,5,10,53,18.9,43,25,5,20,36,76,19,0,Matches
1319,Presnel Kimpembe,FRA,DF,Paris S-G,Ligue 1,24,1995,25.6,46,28,23,19,4,24,34,70.6,10,19,11,8,30,76,61,4,Matches
1320,Joshua King,NOR,"MF,FW",Everton,Premier League,28,1992,1.6,4,1,2,1,1,0,0,,0,3,0,3,1,5,1,0,Matches
1321,Simon Kjær,DEN,DF,Milan,Serie A,31,1989,26.6,45,26,23,20,2,18,30,60.0,12,42,26,16,42,87,125,0,Matches
1322,Davy Klaassen,NED,MF,Werder Bremen,Bundesliga,27,1993,2.5,3,1,0,1,2,0,5,0.0,5,5,1,4,3,6,4,0,Matches
1323,Felix Klaus,GER,"DF,MF",Wolfsburg,Bundesliga,27,1992,1.5,7,4,3,4,0,4,5,80.0,1,4,0,4,2,9,4,0,Matches
1324,Klauss,BRA,"MF,FW",Hoffenheim,Bundesliga,23,1997,0.6,1,0,0,0,1,0,1,0.0,1,0,0,0,0,1,0,0,Matches
1325,Ragnar Klavan,EST,DF,Cagliari,Serie A,34,1985,8.6,15,9,9,5,1,7,11,63.6,4,9,4,5,8,23,34,0,Matches
1326,Philipp Klement,GER,"MF,FW",Stuttgart,Bundesliga,27,1992,4.7,7,3,6,0,1,3,7,42.9,4,9,2,7,6,13,7,0,Matches
1327,Mateusz Klich,POL,MF,Leeds United,Premier League,30,1990,26.6,38,20,14,20,4,14,61,23.0,47,13,4,9,11,49,16,0,Matches
1328,Mateo Klimowicz,GER,"MF,FW",Stuttgart,Bundesliga,20,2000,13.3,20,15,6,10,4,5,18,27.8,13,5,1,4,2,22,2,0,Matches
1329,Fabian Klos,GER,FW,Arminia,Bundesliga,32,1987,30.1,24,13,9,11,4,7,26,26.9,19,20,6,14,4,28,29,0,Matches
1330,Lukas Klostermann,GER,DF,RB Leipzig,Bundesliga,24,1996,16.1,23,19,8,12,3,11,18,61.1,7,16,6,10,18,41,44,1,Matches
1331,Justin Kluivert,NED,MF,Roma,Serie A,21,1999,0.2,0,0,0,0,0,0,0,,0,0,0,0,0,0,0,0,Matches
1332,Justin Kluivert,NED,"FW,MF",RB Leipzig,Bundesliga,21,1999,9.0,2,1,1,1,0,0,2,0.0,2,4,0,4,5,7,3,0,Matches
1333,Lukas Klünter,GER,DF,Hertha BSC,Bundesliga,24,1996,11.0,10,5,6,4,0,5,10,50.0,5,3,1,2,11,21,29,1,Matches
1334,Ansgar Knauff,GER,"MF,FW",Dortmund,Bundesliga,18,2002,0.8,0,0,0,0,0,0,1,0.0,1,3,1,2,0,0,0,0,Matches
1335,Robin Knoche,GER,DF,Union Berlin,Bundesliga,28,1992,33.8,44,29,30,12,2,23,39,59.0,16,43,27,16,49,93,118,2,Matches
1336,Gregor Kobel,SUI,GK,Stuttgart,Bundesliga,22,1997,33.0,2,2,2,0,0,2,2,100.0,0,0,0,0,2,4,8,1,Matches
1337,Robin Koch,GER,"DF,MF",Leeds United,Premier League,24,1996,12.6,27,16,17,10,0,10,19,52.6,9,18,12,6,27,54,34,2,Matches
1338,Giorgi Kochorashvili,GEO,MF,Levante,La Liga,21,1999,0.3,1,0,1,0,0,0,0,,0,0,0,0,0,1,0,0,Matches
1339,Kenan Kodro,BIH,"FW,MF",Valladolid,La Liga,26,1993,5.1,0,0,0,0,0,0,2,0.0,2,2,1,1,2,2,6,0,Matches
1340,Kenan Kodro,BIH,"FW,MF",Athletic Club,La Liga,26,1993,0.5,0,0,0,0,0,0,1,0.0,1,0,0,0,0,0,0,0,Matches
1341,Dominik Kohr,GER,MF,Mainz 05,Bundesliga,26,1994,14.1,47,31,14,26,7,20,39,51.3,19,18,5,13,27,74,15,0,Matches
1342,Dominik Kohr,GER,"MF,DF",Eint Frankfurt,Bundesliga,26,1994,2.9,11,7,0,7,4,4,9,44.4,5,5,1,4,9,20,9,0,Matches
1343,Koba Koindredi,FRA,MF,Valencia,La Liga,18,2001,0.2,1,1,1,0,0,0,1,0.0,1,0,0,0,0,1,0,0,Matches
1344,Koke,ESP,MF,Atlético Madrid,La Liga,28,1992,33.6,64,42,22,31,11,28,98,28.6,70,35,6,29,36,100,40,0,Matches
1345,Aleksandr Kokorin,RUS,"FW,MF",Fiorentina,Serie A,29,1991,1.0,1,0,0,1,0,0,1,0.0,1,1,0,1,0,1,0,0,Matches
1346,Aleksandar Kolarov,SRB,DF,Inter,Serie A,34,1985,4.3,4,4,0,4,0,1,2,50.0,1,2,0,2,7,11,8,0,Matches
1347,Sead Kolašinac,BIH,DF,Arsenal,Premier League,27,1993,1.0,0,0,0,0,0,0,0,,0,0,0,0,1,1,0,0,Matches
1348,Sead Kolašinac,BIH,"DF,MF",Schalke 04,Bundesliga,27,1993,15.8,20,17,10,7,3,8,18,44.4,10,17,5,12,20,40,17,0,Matches
1349,Randal Kolo Muani,FRA,FW,Nantes,Ligue 1,21,1998,33.7,22,14,1,13,8,7,27,25.9,20,15,2,13,8,30,26,0,Matches
1350,Timothée Kolodziejczak,FRA,DF,Saint-Étienne,Ligue 1,28,1991,22.6,28,15,23,5,0,19,27,70.4,8,24,15,9,36,64,80,1,Matches
1351,Ghislain Konan,CIV,DF,Reims,Ligue 1,24,1995,29.0,57,32,35,17,5,32,56,57.1,24,25,11,14,30,87,67,0,Matches
1352,Ibrahima Konaté,FRA,DF,RB Leipzig,Bundesliga,21,1999,7.7,6,4,2,3,1,2,8,25.0,6,6,3,3,8,14,24,0,Matches
1353,Moussa Konaté,SEN,FW,Dijon,Ligue 1,27,1993,13.3,5,3,1,2,2,2,11,18.2,9,4,1,3,5,10,8,0,Matches
1354,Geoffrey Kondogbia,CTA,MF,Valencia,La Liga,27,1993,4.9,16,9,9,4,3,7,19,36.8,12,6,1,5,8,24,8,0,Matches
1355,Geoffrey Kondogbia,CTA,MF,Atlético Madrid,La Liga,27,1993,6.8,30,20,12,16,2,11,20,55.0,9,11,5,6,11,41,8,1,Matches
1356,Lamine Koné,CIV,DF,Strasbourg,Ligue 1,31,1989,11.6,9,6,5,4,0,5,8,62.5,3,4,3,1,15,24,36,0,Matches
1357,Moussa Koné,SEN,FW,Nîmes,Ligue 1,23,1996,19.5,13,6,1,8,4,2,9,22.2,7,7,1,6,2,15,7,0,Matches
1358,Youssouf Koné,MLI,"DF,MF",Elche,La Liga,25,1995,0.8,2,0,1,0,1,0,1,0.0,1,0,0,0,0,2,0,0,Matches
1359,Terence Kongolo,NED,DF,Fulham,Premier League,26,1994,1.0,3,2,1,2,0,1,1,100.0,0,0,0,0,2,5,3,0,Matches
1360,Ezri Konsa,ENG,DF,Aston Villa,Premier League,22,1997,35.5,25,13,18,6,1,9,13,69.2,4,53,47,6,29,54,162,1,Matches
1361,Laurent Koscielny,FRA,DF,Bordeaux,Ligue 1,34,1985,24.6,29,17,18,11,0,16,24,66.7,8,44,34,10,54,83,115,1,Matches
1362,Filip Kostić,SRB,DF,Eint Frankfurt,Bundesliga,27,1992,28.2,54,31,22,23,9,22,54,40.7,32,43,6,37,26,80,28,2,Matches
1363,Márk Kosznovszky,HUN,MF,Parma,Serie A,18,2002,1.0,2,2,1,1,0,1,4,25.0,3,2,0,2,1,3,1,0,Matches
1364,Christian Kouamé,CIV,FW,Fiorentina,Serie A,22,1997,11.1,9,4,2,4,3,4,12,33.3,8,9,1,8,5,14,4,0,Matches
1365,Kalidou Koulibaly,SEN,DF,Napoli,Serie A,29,1991,24.5,36,24,25,7,4,19,32,59.4,13,46,26,20,29,65,64,2,Matches
1366,Jules Koundé,FRA,DF,Sevilla,La Liga,21,1998,33.1,27,15,14,11,2,10,24,41.7,14,24,16,8,40,67,104,0,Matches
1367,Boubakar Kouyaté,MLI,DF,Metz,Ligue 1,23,1997,21.8,60,35,45,15,0,32,58,55.2,26,44,27,17,60,120,132,1,Matches
1368,Cheikhou Kouyaté,SEN,DF,Crystal Palace,Premier League,30,1989,34.7,58,37,44,12,2,25,43,58.1,18,42,26,16,32,90,125,2,Matches
1369,Mateo Kovačić,CRO,MF,Chelsea,Premier League,26,1994,20.2,46,28,19,24,3,17,32,53.1,15,18,1,17,15,61,11,2,Matches
1370,Viktor Kovalenko,UKR,FW,Atalanta,Serie A,24,1996,0.0,0,0,0,0,0,0,0,,0,0,0,0,0,0,1,0,Matches
1371,Emil Krafth,SWE,DF,Newcastle Utd,Premier League,25,1994,14.3,19,8,9,9,1,12,25,48.0,13,15,9,6,15,34,52,2,Matches
1372,Andrej Kramarić,CRO,"FW,MF",Hoffenheim,Bundesliga,29,1991,26.4,7,4,4,0,3,3,8,37.5,5,8,1,7,7,14,5,1,Matches
1373,Christoph Kramer,GER,MF,Gladbach,Bundesliga,29,1991,22.6,55,37,22,28,5,28,58,48.3,30,32,11,21,34,89,39,0,Matches
1374,Jean-Philippe Krasso,CIV,FW,Saint-Étienne,Ligue 1,23,1997,2.5,5,3,1,4,0,2,4,50.0,2,5,0,5,1,6,3,0,Matches
1375,Toni Kroos,GER,MF,Real Madrid,La Liga,30,1990,23.5,42,22,15,15,12,11,44,25.0,33,26,6,20,15,57,10,3,Matches
1376,Filip Krovinović,CRO,MF,West Brom,Premier League,24,1995,6.1,13,10,6,5,2,6,18,33.3,12,2,0,2,4,17,2,0,Matches
1377,Rade Krunić,BIH,"MF,FW",Milan,Serie A,26,1993,8.0,15,12,6,6,3,7,17,41.2,10,12,2,10,10,25,9,0,Matches
1378,Max Kruse,GER,"FW,MF",Union Berlin,Bundesliga,32,1988,18.1,7,3,1,5,1,2,9,22.2,7,11,0,11,3,10,3,0,Matches
1379,Lukas Kübler,GER,"DF,MF",Freiburg,Bundesliga,27,1992,9.8,15,8,9,5,1,9,14,64.3,5,9,3,6,21,36,31,0,Matches
1380,Takefusa Kubo,JPN,"MF,FW",Villarreal,La Liga,19,2001,3.3,1,1,0,0,1,1,5,20.0,4,2,0,2,1,2,2,0,Matches
1381,Takefusa Kubo,JPN,"MF,FW",Getafe,La Liga,19,2001,8.9,7,4,2,3,2,1,14,7.1,13,14,0,14,14,21,4,0,Matches
1382,Juraj Kucka,SVK,"MF,FW",Parma,Serie A,33,1987,25.9,67,36,21,37,9,26,74,35.1,48,25,3,22,28,95,25,0,Matches
1383,Kuki,ESP,MF,Valladolid,La Liga,22,1998,0.3,1,1,0,0,1,0,1,0.0,1,0,0,0,0,1,0,0,Matches
1384,Dejan Kulusevski,SWE,"MF,FW",Juventus,Serie A,20,2000,21.4,33,19,12,10,11,14,43,32.6,29,22,0,22,9,42,2,1,Matches
1385,Marash Kumbulla,ALB,DF,Roma,Serie A,20,2000,15.1,16,11,8,7,1,5,17,29.4,12,12,5,7,24,40,38,1,Matches
1386,Pierre Kunde,CMR,MF,Mainz 05,Bundesliga,25,1995,5.7,8,4,1,5,2,2,9,22.2,7,6,0,6,10,18,9,0,Matches
1387,Fabian Kunze,GER,MF,Arminia,Bundesliga,22,1998,14.1,38,26,19,15,4,19,42,45.2,23,19,3,16,18,56,22,1,Matches
1388,Jasmin Kurtić,SVN,MF,Parma,Serie A,31,1989,30.4,46,28,22,21,3,21,70,30.0,49,22,2,20,33,79,57,1,Matches
1389,Layvin Kurzawa,FRA,DF,Paris S-G,Ligue 1,27,1992,14.2,26,19,10,10,6,9,28,32.1,19,20,5,15,28,54,26,1,Matches
1390,Dereck Kutesa,SUI,"MF,FW",Reims,Ligue 1,22,1997,7.6,15,7,7,3,5,5,14,35.7,9,7,1,6,7,22,3,0,Matches
1391,Ahmed Kutucu,TUR,"FW,MF",Schalke 04,Bundesliga,20,2000,1.2,1,0,0,0,1,1,2,50.0,1,1,0,1,0,1,0,0,Matches
1392,Enock Kwateng,FRA,DF,Bordeaux,Ligue 1,23,1997,11.5,21,12,15,4,2,14,27,51.9,13,15,3,12,26,47,27,0,Matches
1393,Giorgos Kyriakopoulos,GRE,DF,Sassuolo,Serie A,24,1996,16.2,35,18,17,12,6,8,28,28.6,20,16,5,11,15,50,42,0,Matches
1394,Antonino La Gumina,ITA,FW,Sampdoria,Serie A,24,1996,3.8,3,2,0,1,2,0,3,0.0,3,5,1,4,3,6,5,0,Matches
1395,Gaëtan Laborde,FRA,"FW,MF",Montpellier,Ligue 1,26,1994,36.2,43,22,21,17,5,16,60,26.7,44,29,3,26,16,59,25,1,Matches
1396,Alexandre Lacazette,FRA,FW,Arsenal,Premier League,29,1991,21.4,18,10,4,11,3,4,22,18.2,18,20,1,19,12,30,13,0,Matches
1397,Tom Lacoux,FRA,MF,Bordeaux,Ligue 1,18,2002,5.8,22,14,10,11,1,9,21,42.9,12,12,3,9,12,34,7,0,Matches
1398,Maxence Lacroix,FRA,DF,Wolfsburg,Bundesliga,20,2000,28.8,49,29,37,12,0,24,45,53.3,21,51,21,30,65,114,140,1,Matches
1399,Alban Lafont,FRA,GK,Nantes,Ligue 1,21,1999,38.0,1,0,1,0,0,1,1,100.0,0,1,0,1,0,1,14,0,Matches
1400,Víctor Laguardia,ESP,DF,Alavés,La Liga,30,1989,29.2,20,12,13,6,1,14,31,45.2,17,25,13,12,37,57,104,0,Matches
1401,Konrad Laimer,AUT,"DF,MF",RB Leipzig,Bundesliga,23,1997,0.9,2,0,0,1,1,0,4,0.0,4,2,0,2,1,3,0,0,Matches
1402,Stefan Lainer,AUT,DF,Gladbach,Bundesliga,27,1992,30.8,62,37,30,22,10,27,60,45.0,33,34,5,29,35,97,85,1,Matches
1403,Diego Lainez,MEX,"FW,MF",Betis,La Liga,20,2000,9.6,9,4,3,5,1,6,16,37.5,10,15,0,15,11,20,6,0,Matches
1404,Kenny Lala,MAD,DF,Strasbourg,Ligue 1,28,1991,20.4,22,13,13,8,1,11,22,50.0,11,12,6,6,23,45,33,1,Matches
1405,Adam Lallana,ENG,"MF,FW",Brighton,Premier League,32,1988,17.7,28,13,11,13,4,8,39,20.5,31,18,3,15,15,43,13,0,Matches
1406,Érik Lamela,ARG,"FW,MF",Tottenham,Premier League,28,1992,8.0,17,9,1,11,5,8,21,38.1,13,11,1,10,6,23,2,0,Matches
1407,Sam Lammers,NED,"FW,MF",Atalanta,Serie A,23,1997,3.2,2,0,0,2,0,0,6,0.0,6,0,0,0,0,2,3,0,Matches
1408,Tariq Lamptey,GHA,"DF,MF",Brighton,Premier League,19,2000,9.8,17,9,7,6,4,6,13,46.2,7,8,1,7,19,36,12,1,Matches
1409,Loïck Landre,FRA,DF,Nîmes,Ligue 1,28,1992,18.1,14,7,9,5,0,13,28,46.4,15,22,19,3,31,45,52,0,Matches
1410,Michael Langer,AUT,GK,Schalke 04,Bundesliga,35,1985,2.7,0,0,0,0,0,0,0,,0,0,0,0,0,0,3,0,Matches
1411,Manuel Lanzini,ARG,"MF,FW",West Ham,Premier League,27,1993,6.3,9,2,3,4,2,3,10,30.0,7,9,0,9,7,16,5,0,Matches
1412,Gianluca Lapadula,PER,FW,Benevento,Serie A,30,1990,28.5,22,12,3,13,6,6,25,24.0,19,18,3,15,5,27,16,0,Matches
1413,Aymeric Laporte,ESP,DF,Manchester City,Premier League,26,1994,14.9,13,6,10,3,0,7,11,63.6,4,12,7,5,11,24,28,0,Matches
1414,Julien Laporte,FRA,DF,Lorient,Ligue 1,26,1993,29.5,65,39,48,16,1,42,74,56.8,32,34,23,11,65,130,125,0,Matches
1415,Danilo Larangeira,BRA,DF,Bologna,Serie A,36,1984,34.8,33,24,23,10,0,8,29,27.6,21,58,36,22,51,84,127,2,Matches
1416,Gautier Larsonneur,FRA,GK,Brest,Ligue 1,23,1997,35.0,1,1,1,0,0,1,1,100.0,0,2,0,2,0,1,16,3,Matches
1417,Kevin Lasagna,ITA,FW,Udinese,Serie A,27,1992,12.3,6,1,2,3,1,3,14,21.4,11,11,0,11,6,12,7,0,Matches
1418,Kevin Lasagna,ITA,FW,Hellas Verona,Serie A,27,1992,14.1,7,3,0,5,2,1,5,20.0,4,12,1,11,1,8,11,0,Matches
1419,Jamaal Lascelles,ENG,DF,Newcastle Utd,Premier League,26,1993,18.1,14,7,5,9,0,3,6,50.0,3,27,17,10,12,26,86,0,Matches
1420,Paul Lasne,FRA,MF,Brest,Ligue 1,31,1989,18.7,46,26,25,19,2,17,40,42.5,23,25,5,20,47,93,17,2,Matches
1421,Toni Lato,ESP,DF,Valencia,La Liga,22,1997,8.1,13,6,7,3,3,6,13,46.2,7,12,1,11,10,23,21,0,Matches
1422,Danny Latza,GER,MF,Mainz 05,Bundesliga,30,1989,20.0,43,26,12,19,12,23,70,32.9,47,39,3,36,27,70,23,0,Matches
1423,Armand Lauriente,FRA,"MF,FW",Lorient,Ligue 1,21,1998,18.0,30,10,10,19,1,7,26,26.9,19,21,0,21,15,45,4,0,Matches
1424,Vincent Laurini,FRA,DF,Parma,Serie A,31,1989,9.7,16,11,8,6,2,7,9,77.8,2,8,4,4,17,33,22,1,Matches
1425,Lauti,URU,MF,Celta Vigo,La Liga,19,2001,0.2,0,0,0,0,0,0,0,,0,0,0,0,0,0,1,0,Matches
1426,Wesley Lautoa,NCL,"MF,DF",Dijon,Ligue 1,32,1987,17.9,36,20,20,13,3,11,37,29.7,26,17,8,9,29,65,33,1,Matches
1427,Valentino Lazaro,AUT,"DF,FW",Gladbach,Bundesliga,24,1996,13.8,17,11,7,5,5,12,19,63.2,7,18,1,17,15,32,20,0,Matches
1428,Darko Lazović,SRB,"DF,MF",Hellas Verona,Serie A,29,1990,27.8,29,17,8,17,4,20,42,47.6,22,17,7,10,20,49,29,0,Matches
1429,Manuel Lazzari,ITA,DF,Lazio,Serie A,26,1993,29.0,24,14,15,4,5,14,39,35.9,25,22,3,19,18,42,28,0,Matches
1430,Jérémy Le Douaron,FRA,"FW,MF",Brest,Ligue 1,22,1998,9.1,15,10,9,4,2,7,21,33.3,14,14,1,13,8,23,11,0,Matches
1431,Enzo Le Fée,FRA,MF,Lorient,Ligue 1,20,2000,20.2,51,28,23,23,5,27,73,37.0,46,30,6,24,25,76,10,0,Matches
1432,Vincent Le Goff,FRA,DF,Lorient,Ligue 1,30,1989,25.6,42,29,16,24,2,18,49,36.7,31,27,5,22,44,86,44,0,Matches
1433,Maxime Le Marchand,FRA,DF,Fulham,Premier League,30,1989,1.4,2,2,2,0,0,2,2,100.0,0,0,0,0,0,2,3,0,Matches
1434,Robin Le Normand,ESP,DF,Real Sociedad,La Liga,23,1996,30.5,34,20,25,8,1,9,19,47.4,10,35,24,11,36,70,87,1,Matches
1435,Damien Le Tallec,FRA,"MF,DF",Montpellier,Ligue 1,30,1990,13.6,16,10,10,4,2,10,30,33.3,20,15,8,7,25,41,21,2,Matches
1436,James Lea Siliki,CMR,MF,Rennes,Ligue 1,24,1996,2.8,5,2,1,3,1,2,2,100.0,0,3,0,3,1,6,1,1,Matches
1437,Rafael Leão,POR,FW,Milan,Serie A,21,1999,21.4,13,6,4,7,2,6,15,40.0,9,17,0,17,4,17,14,1,Matches
1438,Jean-Louis Leca,FRA,GK,Lens,Ligue 1,34,1985,36.8,3,2,3,0,0,3,5,60.0,2,0,0,0,1,4,14,4,Matches
1439,Mathew Leckie,AUS,"FW,DF",Hertha BSC,Bundesliga,29,1991,5.6,12,3,5,5,2,4,11,36.4,7,8,0,8,13,25,9,0,Matches
1440,Benjamin Lecomte,FRA,GK,Monaco,Ligue 1,29,1991,28.0,0,0,0,0,0,0,2,0.0,2,1,0,1,2,2,20,1,Matches
1441,Jeremías Ledesma,ARG,GK,Cádiz,La Liga,27,1993,32.0,1,0,1,0,0,1,1,100.0,0,1,0,1,0,1,22,6,Matches
1442,Pierre Lees-Melou,FRA,MF,Nice,Ligue 1,27,1993,22.9,67,39,33,31,3,25,83,30.1,58,50,14,36,29,96,31,1,Matches
1443,Lucas Leiva,BRA,MF,Lazio,Serie A,33,1987,23.7,68,32,38,28,2,30,86,34.9,56,21,0,21,57,125,21,0,Matches
1444,Florian Lejeune,FRA,DF,Alavés,La Liga,29,1991,33.5,43,32,36,7,0,21,35,60.0,14,38,24,14,51,94,149,1,Matches
1445,Iñigo Lekue,ESP,DF,Athletic Club,La Liga,27,1993,7.2,9,7,6,3,0,3,8,37.5,5,8,1,7,4,13,24,0,Matches
1446,Thomas Lemar,FRA,MF,Atlético Madrid,La Liga,24,1995,15.2,30,17,9,17,4,11,24,45.8,13,22,1,21,11,41,10,0,Matches
1447,Mario Lemina,GAB,MF,Fulham,Premier League,26,1993,18.9,62,35,25,30,7,23,44,52.3,21,26,5,21,30,92,21,0,Matches
1448,Fabien Lemoine,FRA,MF,Lorient,Ligue 1,33,1987,21.5,74,45,39,33,2,36,89,40.4,53,25,1,24,27,101,35,0,Matches
1449,Clément Lenglet,FRA,DF,Barcelona,La Liga,25,1995,27.5,36,21,23,10,3,19,28,67.9,9,26,12,14,33,69,71,1,Matches
1450,Bernd Leno,GER,GK,Arsenal,Premier League,28,1992,34.8,1,0,1,0,0,1,1,100.0,0,1,0,1,0,1,11,2,Matches
1451,Christopher Lenz,GER,"DF,FW",Union Berlin,Bundesliga,25,1994,25.0,74,41,39,30,5,35,71,49.3,36,34,5,29,35,109,50,0,Matches
1452,Pedro León,ESP,"MF,FW",Eibar,La Liga,33,1986,10.4,9,8,3,3,3,3,17,17.6,14,11,0,11,7,16,2,0,Matches
1453,Sergio León,ESP,FW,Levante,La Liga,31,1989,8.3,6,2,0,4,2,2,8,25.0,6,4,0,4,3,9,2,0,Matches
1454,Lukas Lerager,DEN,MF,Genoa,Serie A,27,1993,12.9,24,13,14,9,1,11,30,36.7,19,13,3,10,14,38,25,1,Matches
1455,Mehdi Léris,ALG,"DF,MF",Sampdoria,Serie A,22,1998,4.3,11,5,6,4,1,6,16,37.5,10,12,2,10,12,23,15,0,Matches
1456,Khanya Leshabela,RSA,MF,Leicester City,Premier League,20,1999,0.1,0,0,0,0,0,0,0,,0,0,0,0,0,0,0,0,Matches
1457,Karlo Letica,CRO,GK,Sampdoria,Serie A,23,1997,1.0,0,0,0,0,0,0,0,,0,0,0,0,0,0,2,0,Matches
1458,Gaetano Letizia,ITA,DF,Benevento,Serie A,30,1990,17.4,36,25,19,13,4,17,36,47.2,19,15,3,12,20,56,42,1,Matches
1459,Robert Lewandowski,POL,FW,Bayern Munich,Bundesliga,31,1988,27.3,15,9,0,7,8,2,13,15.4,11,9,1,8,3,18,11,0,Matches
1460,Jamal Lewis,NIR,DF,Newcastle Utd,Premier League,22,1998,20.4,37,20,23,13,1,16,38,42.1,22,21,7,14,11,48,44,1,Matches
1461,Aaron Leya Iseka,BEL,FW,Metz,Ligue 1,22,1997,11.2,6,4,2,3,1,0,4,0.0,4,4,2,2,0,6,6,0,Matches
1462,Yanis Lhery,FRA,MF,Saint-Étienne,Ligue 1,17,2003,0.3,0,0,0,0,0,0,0,,0,0,0,0,0,0,0,0,Matches
1463,Dimitri Liénard,FRA,MF,Strasbourg,Ligue 1,32,1988,20.3,39,27,17,19,3,24,55,43.6,31,23,1,22,18,57,10,0,Matches
1464,Philipp Lienhart,AUT,DF,Freiburg,Bundesliga,24,1996,33.3,21,13,12,7,2,9,20,45.0,11,30,21,9,42,63,100,0,Matches
1465,Matthijs de Ligt,NED,DF,Juventus,Serie A,20,1999,24.7,37,19,20,16,1,18,28,64.3,10,42,21,21,31,68,64,0,Matches
1466,Isaac Lihadji,FRA,"MF,FW",Lille,Ligue 1,18,2002,2.2,11,4,2,6,3,4,5,80.0,1,5,1,4,1,12,0,1,Matches
1467,Dimitris Limnios,GRE,"MF,FW",Köln,Bundesliga,22,1998,4.2,9,6,3,5,1,5,6,83.3,1,5,0,5,2,11,1,0,Matches
1468,Victor Lindelöf,SWE,DF,Manchester Utd,Premier League,26,1994,28.7,22,10,12,10,0,12,24,50.0,12,22,14,8,30,52,95,1,Matches
1469,Karol Linetty,POL,MF,Torino,Serie A,25,1995,20.4,38,28,13,19,6,16,45,35.6,29,19,5,14,15,53,7,0,Matches
1470,Jesse Lingard,ENG,"MF,FW",West Ham,Premier League,27,1992,15.8,12,6,4,8,0,5,14,35.7,9,7,1,6,4,16,0,0,Matches
1471,Pol Lirola,ESP,"DF,FW",Fiorentina,Serie A,22,1997,5.5,13,8,8,2,3,6,12,50.0,6,6,3,3,6,19,9,0,Matches
1472,Pol Lirola,ESP,"DF,FW",Marseille,Ligue 1,22,1997,17.3,28,16,11,15,2,16,28,57.1,12,18,5,13,25,53,26,0,Matches
1473,Jake Livermore,ENG,MF,West Brom,Premier League,30,1989,13.8,33,18,14,16,3,14,31,45.2,17,21,6,15,16,49,26,0,Matches
1474,Diego Llorente,ESP,DF,Leeds United,Premier League,26,1993,13.4,34,21,21,13,0,19,32,59.4,13,18,13,5,20,54,40,2,Matches
1475,Diego Llorente,ESP,DF,Real Sociedad,La Liga,26,1993,1.0,1,0,1,0,0,1,2,50.0,1,1,1,0,2,3,5,0,Matches
1476,Fernando Llorente,ESP,FW,Udinese,Serie A,35,1985,7.9,4,1,2,2,0,2,5,40.0,3,3,0,3,2,6,17,0,Matches
1477,Fernando Llorente,ESP,"FW,MF",Napoli,Serie A,35,1985,0.6,0,0,0,0,0,0,0,,0,0,0,0,0,0,0,0,Matches
1478,Marcos Llorente,ESP,"MF,FW",Atlético Madrid,La Liga,25,1995,32.8,71,42,21,40,10,26,62,41.9,36,40,3,37,29,100,28,0,Matches
1479,Hugo Lloris,FRA,GK,Tottenham,Premier League,33,1986,38.0,0,0,0,0,0,0,1,0.0,1,0,0,0,0,0,10,1,Matches
1480,Giovani Lo Celso,ARG,MF,Tottenham,Premier League,24,1996,10.5,28,22,12,11,5,10,29,34.5,19,12,1,11,7,35,5,0,Matches
1481,Stanislav Lobotka,SVK,MF,Napoli,Serie A,25,1994,1.7,1,1,0,1,0,0,1,0.0,1,1,1,0,0,1,1,1,Matches
1482,Manuel Locatelli,ITA,MF,Sassuolo,Serie A,22,1998,32.0,81,47,43,28,10,29,56,51.8,27,35,15,20,51,132,65,1,Matches
1483,Renan Lodi,BRA,"DF,FW",Atlético Madrid,La Liga,22,1998,12.5,30,17,13,12,5,17,26,65.4,9,15,0,15,16,46,18,0,Matches
1484,Ruben Loftus-Cheek,ENG,FW,Chelsea,Premier League,24,1996,0.7,0,0,0,0,0,0,0,,0,0,0,0,0,0,0,0,Matches
1485,Ruben Loftus-Cheek,ENG,"MF,FW",Fulham,Premier League,24,1996,21.2,25,14,7,15,3,7,23,30.4,16,20,2,18,7,32,18,0,Matches
1486,Niklas Lomb,GER,GK,Leverkusen,Bundesliga,27,1993,1.5,0,0,0,0,0,0,0,,0,0,0,0,0,0,0,2,Matches
1487,Kevin Long,IRL,DF,Burnley,Premier League,29,1990,7.1,11,6,9,2,0,7,9,77.8,2,11,7,4,6,17,24,0,Matches
1488,Shane Long,IRL,FW,Southampton,Premier League,33,1987,2.3,2,1,0,0,2,2,3,66.7,1,0,0,0,3,5,1,0,Matches
1489,Matthew Longstaff,ENG,MF,Newcastle Utd,Premier League,20,2000,4.2,3,2,2,1,0,2,8,25.0,6,7,0,7,7,10,2,0,Matches
1490,Sean Longstaff,ENG,MF,Newcastle Utd,Premier League,22,1997,15.7,31,14,13,15,3,18,42,42.9,24,26,5,21,19,50,14,2,Matches
1491,Ademola Lookman,NGA,"FW,MF",Fulham,Premier League,22,1997,30.5,35,11,18,9,8,13,44,29.5,31,31,1,30,20,55,9,0,Matches
1492,Anthony Lopes,POR,GK,Lyon,Ligue 1,29,1990,38.0,1,1,1,0,0,1,2,50.0,1,1,0,1,1,2,20,1,Matches
1493,Rony Lopes,POR,"FW,MF",Nice,Ligue 1,24,1995,19.8,20,14,4,13,3,6,27,22.2,21,14,3,11,8,28,6,0,Matches
1494,Adrián López,ESP,"FW,MF",Osasuna,La Liga,32,1988,5.3,3,3,0,1,2,1,5,20.0,4,3,0,3,0,3,3,0,Matches
1495,Javi López,ESP,"DF,MF",Alavés,La Liga,18,2002,2.8,5,5,3,2,0,2,3,66.7,1,2,0,2,3,8,3,1,Matches
1496,Maxime Lopez,FRA,MF,Sassuolo,Serie A,22,1997,20.7,24,13,15,6,3,14,41,34.1,27,9,0,9,16,40,10,1,Matches
1497,Maxime Lopez,FRA,"FW,MF",Marseille,Ligue 1,22,1997,1.5,1,1,1,0,0,0,2,0.0,2,0,0,0,2,3,2,0,Matches
1498,Pedro López Muñoz,ESP,DF,Huesca,La Liga,36,1983,11.9,23,15,10,8,5,15,22,68.2,7,10,4,6,16,39,23,1,Matches
1499,Pau López,ESP,GK,Roma,Serie A,25,1994,20.2,2,0,2,0,0,2,2,100.0,0,1,0,1,0,2,7,4,Matches
1500,Roberto López,ESP,"MF,FW",Real Sociedad,La Liga,20,2000,5.6,5,1,1,2,2,2,5,40.0,3,2,0,2,4,9,6,0,Matches
1501,Unai López,ESP,MF,Athletic Club,La Liga,24,1995,15.8,27,17,13,13,1,10,29,34.5,19,20,5,15,18,45,9,1,Matches
1502,Dion Lopy,SEN,MF,Reims,Ligue 1,18,2002,2.8,1,1,0,1,0,0,0,,0,0,0,0,2,3,1,0,Matches
1503,Jordan Lotomba,SUI,"DF,MF",Nice,Ligue 1,21,1998,23.6,35,25,19,11,5,20,34,58.8,14,19,7,12,33,68,52,1,Matches
1504,Adrien Louveau,FRA,MF,Lens,Ligue 1,20,2000,0.1,0,0,0,0,0,0,0,,0,0,0,0,0,0,1,0,Matches
1505,Imran Louza,MAR,MF,Nantes,Ligue 1,21,1999,26.4,55,28,25,26,4,21,69,30.4,48,20,4,16,33,88,15,2,Matches
1506,Matteo Lovato,ITA,DF,Hellas Verona,Serie A,20,2000,15.4,21,12,14,5,2,10,21,47.6,11,20,10,10,37,58,48,1,Matches
1507,Max Lowe,ENG,DF,Sheffield Utd,Premier League,23,1997,6.1,26,11,18,6,2,9,21,42.9,12,12,4,8,5,31,11,0,Matches
1508,Eduard Löwen,GER,"MF,DF",Hertha BSC,Bundesliga,23,1997,0.9,5,1,3,1,1,2,5,40.0,3,1,0,1,1,6,1,0,Matches
1509,Matthew Lowton,ENG,DF,Burnley,Premier League,31,1989,34.0,54,32,31,22,1,32,73,43.8,41,36,13,23,56,110,91,1,Matches
1510,Anthony Lozano,HON,FW,Cádiz,La Liga,27,1993,16.9,12,4,1,5,6,2,13,15.4,11,3,1,2,3,15,8,0,Matches
1511,Hirving Lozano,MEX,FW,Napoli,Serie A,25,1995,21.8,29,18,10,13,6,10,36,27.8,26,37,1,36,18,47,14,0,Matches
1512,Jan Luca Schuler,GER,FW,Schalke 04,Bundesliga,21,1999,0.4,2,2,1,1,0,0,1,0.0,1,1,0,1,0,2,0,0,Matches
1513,Jean Lucas,BRA,MF,Lyon,Ligue 1,22,1998,1.9,3,2,2,1,0,1,4,25.0,3,3,1,2,2,5,1,0,Matches
1514,Jean Lucas,BRA,"MF,FW",Brest,Ligue 1,22,1998,11.2,19,13,10,9,0,8,29,27.6,21,7,0,7,8,27,10,1,Matches
1515,Anderson Lucoqui,ANG,DF,Arminia,Bundesliga,23,1997,17.8,40,25,23,17,0,20,40,50.0,20,30,7,23,27,67,53,0,Matches
1516,Jeison Lucumí,COL,MF,Elche,La Liga,25,1995,0.5,1,1,0,1,0,0,0,,0,1,0,1,0,1,0,0,Matches
1517,Kilian Ludewig,GER,"DF,FW",Schalke 04,Bundesliga,20,2000,5.8,16,6,10,5,1,8,25,32.0,17,7,0,7,3,19,14,0,Matches
1518,Florentino Luís,POR,MF,Monaco,Ligue 1,20,1999,2.7,7,2,4,2,1,6,10,60.0,4,1,0,1,6,13,2,1,Matches
1519,José Luis Gayà,ESP,DF,Valencia,La Liga,25,1995,31.6,59,33,40,13,6,33,68,48.5,35,22,3,19,38,97,62,1,Matches
1520,José Luis Morales,ESP,"MF,FW",Levante,La Liga,33,1987,27.1,18,10,7,9,2,8,36,22.2,28,17,0,17,11,29,11,0,Matches
1521,José Luis Palomino,ARG,DF,Atalanta,Serie A,30,1990,27.0,67,33,41,19,7,24,48,50.0,24,30,16,14,79,146,60,2,Matches
1522,Luisinho,POR,DF,Huesca,La Liga,35,1985,2.0,3,3,2,1,0,1,3,33.3,2,3,0,3,4,7,7,0,Matches
1523,Luismi,ESP,"MF,DF",Elche,La Liga,28,1992,1.9,4,2,1,3,0,1,2,50.0,1,2,0,2,4,8,0,0,Matches
1524,David Luiz,BRA,DF,Arsenal,Premier League,33,1987,15.5,12,9,5,7,0,4,4,100.0,0,16,9,7,16,28,50,2,Matches
1525,Douglas Luiz,BRA,MF,Aston Villa,Premier League,22,1998,30.9,49,18,22,26,1,20,58,34.5,38,52,17,35,43,92,44,2,Matches
1526,Romelu Lukaku,BEL,FW,Inter,Serie A,27,1993,32.0,11,1,1,6,4,6,14,42.9,8,11,1,10,3,14,34,0,Matches
1527,Dodi Lukebakio,BEL,"FW,MF",Hertha BSC,Bundesliga,22,1997,20.6,21,14,13,5,3,9,20,45.0,11,14,1,13,12,33,8,0,Matches
1528,Saša Lukić,SRB,MF,Torino,Serie A,23,1996,23.4,32,13,11,18,3,15,50,30.0,35,23,5,18,17,49,17,0,Matches
1529,Senad Lulić,BIH,DF,Lazio,Serie A,34,1986,8.0,14,7,6,5,3,7,15,46.7,8,10,1,9,4,18,13,0,Matches
1530,John Lundstram,ENG,MF,Sheffield Utd,Premier League,26,1994,22.6,25,16,12,11,2,13,47,27.7,34,26,8,18,14,39,29,1,Matches
1531,Sebastiano Luperto,ITA,DF,Crotone,Serie A,23,1996,20.9,38,20,28,8,2,16,27,59.3,11,17,7,10,27,65,74,1,Matches
1532,Andreas Luthe,GER,GK,Union Berlin,Bundesliga,33,1987,30.8,1,1,1,0,0,1,3,33.3,2,1,0,1,0,1,8,3,Matches
1533,Lyanco,BRA,DF,Torino,Serie A,23,1997,21.8,21,14,13,6,2,8,14,57.1,6,36,26,10,46,67,76,0,Matches
1534,Charalambos Lykogiannis,GRE,DF,Cagliari,Serie A,26,1993,26.9,34,21,22,9,3,22,38,57.9,16,34,13,21,32,66,94,0,Matches
1535,Yann M'Vila,FRA,MF,Saint-Étienne,Ligue 1,30,1990,0.2,0,0,0,0,0,0,2,0.0,2,0,0,0,1,1,0,0,Matches
1536,Alexis Mac Allister,ARG,"MF,FW",Brighton,Premier League,21,1998,12.4,26,12,6,16,4,11,38,28.9,27,25,4,21,9,35,4,0,Matches
1537,Darwin Machís,VEN,"FW,MF",Granada,La Liga,27,1993,22.5,30,17,12,10,8,6,19,31.6,13,21,2,19,22,52,13,0,Matches
1538,Tim Maciejewski,GER,FW,Union Berlin,Bundesliga,19,2001,0.1,0,0,0,0,0,0,0,,0,0,0,0,0,0,0,0,Matches
1539,Luca Mack,GER,MF,Stuttgart,Bundesliga,20,2000,0.1,0,0,0,0,0,0,0,,0,0,0,0,0,0,1,0,Matches
1540,Yvann Macon,FRA,DF,Saint-Étienne,Ligue 1,21,1998,6.0,30,20,20,8,2,7,19,36.8,12,6,2,4,9,39,13,0,Matches
1541,James Maddison,ENG,MF,Leicester City,Premier League,23,1996,23.3,32,16,5,16,11,14,41,34.1,27,14,1,13,9,41,5,0,Matches
1542,Mikail Maden,NOR,FW,Schalke 04,Bundesliga,18,2002,0.1,0,0,0,0,0,0,0,,0,0,0,0,0,0,0,0,Matches
1543,Pablo Maffeo,ESP,DF,Huesca,La Liga,23,1997,21.8,26,17,21,4,1,12,26,46.2,14,18,6,12,35,61,27,0,Matches
1544,Gabriel Magalhães,BRA,DF,Arsenal,Premier League,22,1997,22.2,25,15,19,5,1,13,19,68.4,6,27,19,8,26,51,74,2,Matches
1545,Lisandro Magallán,ARG,DF,Crotone,Serie A,26,1993,24.2,54,31,28,24,2,17,42,40.5,25,29,15,14,44,98,78,1,Matches
1546,Christian Maggio,ITA,DF,Benevento,Serie A,38,1982,3.3,9,4,2,7,0,3,9,33.3,6,4,1,3,2,11,6,0,Matches
1547,Giulio Maggiore,ITA,MF,Spezia,Serie A,22,1998,24.6,61,36,26,28,7,21,53,39.6,32,33,6,27,19,80,25,1,Matches
1548,Francesco Magnanelli,ITA,MF,Sassuolo,Serie A,35,1984,4.9,7,5,2,5,0,3,10,30.0,7,6,2,4,13,20,10,0,Matches
1549,Giangiacomo Magnani,ITA,DF,Hellas Verona,Serie A,24,1995,16.8,26,15,14,9,3,9,16,56.3,7,25,16,9,44,70,105,1,Matches
1550,Hugo Magnetti,FRA,MF,Brest,Ligue 1,22,1998,6.7,24,12,10,13,1,20,40,50.0,20,6,1,5,14,38,8,0,Matches
1551,Harry Maguire,ENG,DF,Manchester Utd,Premier League,27,1993,33.9,29,17,19,10,0,18,29,62.1,11,28,23,5,60,89,122,4,Matches
1552,Abdallahi Mahmoud,MTN,MF,Alavés,La Liga,20,2000,0.7,2,2,1,1,0,0,1,0.0,1,0,0,0,1,3,0,0,Matches
1553,Hicham Mahou,FRA,FW,Nice,Ligue 1,21,1999,0.4,1,1,1,0,0,1,2,50.0,1,2,0,2,1,2,0,0,Matches
1554,Riyad Mahrez,ALG,FW,Manchester City,Premier League,29,1991,21.7,20,5,2,10,8,6,30,20.0,24,19,0,19,8,28,4,0,Matches
1555,Arne Maier,GER,MF,Arminia,Bundesliga,21,1999,11.5,13,9,5,7,1,4,11,36.4,7,10,3,7,8,21,11,1,Matches
1556,Arne Maier,GER,MF,Hertha BSC,Bundesliga,21,1999,0.3,1,1,0,1,0,0,1,0.0,1,0,0,0,0,1,0,0,Matches
1557,Habib Maïga,CIV,MF,Metz,Ligue 1,24,1996,29.9,81,52,36,40,5,42,85,49.4,43,37,6,31,49,130,36,0,Matches
1558,Mike Maignan,FRA,GK,Lille,Ligue 1,25,1995,38.0,0,0,0,0,0,0,0,,0,0,0,0,0,0,7,2,Matches
1559,Ainsley Maitland-Niles,ENG,"MF,DF",Arsenal,Premier League,22,1997,5.4,11,7,6,5,0,8,12,66.7,4,12,2,10,14,25,7,1,Matches
1560,Ainsley Maitland-Niles,ENG,MF,West Brom,Premier League,22,1997,13.7,22,10,7,8,7,9,28,32.1,19,12,1,11,17,39,24,0,Matches
1561,Josh Maja,NGA,FW,Fulham,Premier League,21,1998,9.0,7,4,0,3,4,4,10,40.0,6,3,1,2,4,11,1,0,Matches
1562,Josh Maja,NGA,FW,Bordeaux,Ligue 1,21,1998,8.9,8,2,3,3,2,3,14,21.4,11,3,0,3,6,14,9,0,Matches
1563,Radosław Majecki,POL,GK,Monaco,Ligue 1,20,1999,1.0,0,0,0,0,0,0,0,,0,0,0,0,0,0,1,0,Matches
1564,Abdul Majeed Waris,GHA,"FW,MF",Strasbourg,Ligue 1,28,1991,6.1,1,1,1,0,0,1,6,16.7,5,0,0,0,2,3,2,0,Matches
1565,Marco Majouga,CTA,"FW,MF",Nîmes,Ligue 1,19,2001,1.4,1,1,1,0,0,1,3,33.3,2,0,0,0,0,1,0,0,Matches
1566,Jean-Victor Makengo,FRA,MF,Udinese,Serie A,22,1998,5.8,8,7,5,3,0,3,13,23.1,10,7,1,6,5,13,7,0,Matches
1567,Nemanja Maksimović,SRB,MF,Getafe,La Liga,25,1995,30.3,50,28,22,24,4,19,46,41.3,27,40,9,31,57,107,46,1,Matches
1568,Nikola Maksimović,SRB,DF,Napoli,Serie A,28,1991,13.4,18,9,11,6,1,9,18,50.0,9,15,6,9,21,39,49,3,Matches
1569,Filip Malbašić,SRB,"FW,MF",Cádiz,La Liga,27,1992,9.6,12,7,4,5,3,6,18,33.3,12,10,0,10,4,16,2,0,Matches
1570,Kévin Malcuit,MAR,DF,Fiorentina,Serie A,29,1991,2.3,5,3,2,2,1,0,1,0.0,1,5,0,5,3,8,6,0,Matches
1571,Kévin Malcuit,MAR,"FW,MF",Napoli,Serie A,29,1991,0.4,2,1,2,0,0,0,1,0.0,1,0,0,0,2,4,2,0,Matches
1572,Daniel Maldini,ITA,"FW,DF",Milan,Serie A,18,2001,0.3,1,0,0,1,0,0,2,0.0,2,0,0,0,0,1,0,0,Matches
1573,Ruslan Malinovskyi,UKR,"MF,FW",Atalanta,Serie A,27,1993,20.8,19,8,2,13,4,8,23,34.8,15,16,1,15,2,21,4,0,Matches
1574,Yunus Mallı,TUR,MF,Wolfsburg,Bundesliga,28,1992,0.6,1,0,0,1,0,1,1,100.0,0,0,0,0,0,1,0,0,Matches
1575,Hugo Mallo,ESP,DF,Celta Vigo,La Liga,29,1991,28.9,58,40,34,23,1,24,52,46.2,28,42,11,31,37,95,77,0,Matches
1576,Mickael Malsa,MTQ,MF,Levante,La Liga,24,1995,26.0,55,26,28,24,3,23,51,45.1,28,38,9,29,43,98,36,2,Matches
1577,Dennis Man,ROU,"FW,MF",Parma,Serie A,21,1998,7.8,12,6,6,4,2,6,21,28.6,15,5,0,5,2,14,6,0,Matches
1578,Hianga Mananga Mbock,FRA,"MF,FW",Brest,Ligue 1,20,1999,5.1,4,3,2,2,0,2,9,22.2,7,2,0,2,3,7,6,0,Matches
1579,Vincent Manceau,FRA,DF,Angers,Ligue 1,31,1989,25.7,42,27,23,17,2,30,63,47.6,33,23,2,21,35,77,61,0,Matches
1580,Gianluca Mancini,ITA,DF,Roma,Serie A,24,1996,31.7,50,29,29,19,2,18,31,58.1,13,38,18,20,72,122,77,3,Matches
1581,Steve Mandanda,FRA,GK,Marseille,Ligue 1,35,1985,37.0,0,0,0,0,0,0,1,0.0,1,0,0,0,2,2,8,6,Matches
1582,Reinildo Mandava,MOZ,DF,Lille,Ligue 1,26,1994,24.2,79,43,39,32,8,35,58,60.3,23,26,3,23,45,124,53,0,Matches
1583,Aïssa Mandi,ALG,DF,Betis,La Liga,28,1991,26.6,30,17,20,10,0,10,16,62.5,6,21,13,8,39,69,90,0,Matches
1584,Rolando Mandragora,ITA,MF,Udinese,Serie A,23,1997,4.4,8,5,3,4,1,3,10,30.0,7,10,3,7,6,14,5,0,Matches
1585,Rolando Mandragora,ITA,MF,Torino,Serie A,23,1997,16.9,19,4,4,9,6,7,30,23.3,23,19,6,13,20,39,19,0,Matches
1586,Mario Mandžukić,CRO,FW,Milan,Serie A,34,1986,2.4,7,6,2,4,1,2,3,66.7,1,0,0,0,2,9,3,0,Matches
1587,Sadio Mané,SEN,FW,Liverpool,Premier League,28,1992,31.2,48,30,6,22,20,12,33,36.4,21,30,0,30,15,63,11,0,Matches
1588,Niccolò Manfredini,ITA,GK,Benevento,Serie A,32,1988,1.0,0,0,0,0,0,0,0,,0,0,0,0,0,0,2,1,Matches
1589,Eliaquim Mangala,FRA,DF,Valencia,La Liga,29,1991,3.6,0,0,0,0,0,0,1,0.0,1,8,6,2,6,6,12,0,Matches
1590,Orel Mangala,BEL,MF,Stuttgart,Bundesliga,22,1998,23.4,27,15,13,11,3,17,28,60.7,11,27,10,17,26,53,30,0,Matches
1591,Thomas Mangani,FRA,MF,Angers,Ligue 1,33,1987,29.9,54,37,25,26,3,30,90,33.3,60,31,8,23,38,92,39,0,Matches
1592,Vito Mannone,ITA,GK,Monaco,Ligue 1,32,1988,9.0,0,0,0,0,0,0,0,,0,0,0,0,0,0,3,1,Matches
1593,Kostas Manolas,GRE,DF,Napoli,Serie A,29,1991,25.5,31,18,24,7,0,17,24,70.8,7,22,13,9,23,54,82,2,Matches
1594,Javier Manquillo,ESP,DF,Newcastle Utd,Premier League,26,1994,9.2,24,14,8,14,2,11,17,64.7,6,8,1,7,9,33,15,1,Matches
1595,Juan Manuel Ramos,URU,DF,Spezia,Serie A,23,1996,3.3,5,0,3,0,2,4,7,57.1,3,1,0,1,2,7,6,0,Matches
1596,Myziane Maolida,COM,"FW,MF",Nice,Ligue 1,21,1999,12.0,13,8,4,4,5,4,11,36.4,7,6,1,5,6,19,4,0,Matches
1597,Faitout Maouassa,FRA,DF,Rennes,Ligue 1,22,1998,13.0,20,11,10,8,2,11,19,57.9,8,9,1,8,17,37,36,0,Matches
1598,Sekou Mara,FRA,"FW,MF",Bordeaux,Ligue 1,18,2002,2.5,5,3,1,3,1,2,10,20.0,8,0,0,0,1,6,1,0,Matches
1599,Fernando Marçal,BRA,"DF,MF",Wolves,Premier League,31,1989,6.9,13,5,6,7,0,6,11,54.5,5,11,2,9,12,25,25,0,Matches
1600,Fernando Marçal,BRA,DF,Lyon,Ligue 1,31,1989,0.9,1,0,0,1,0,0,0,,0,0,0,0,2,3,0,0,Matches
1601,Marcelo,BRA,"DF,MF",Real Madrid,La Liga,32,1988,11.7,25,21,11,6,8,11,24,45.8,13,13,1,12,10,35,15,0,Matches
1602,Marcelo,BRA,DF,Lyon,Ligue 1,33,1987,32.3,44,29,30,12,2,26,37,70.3,11,35,25,10,49,93,122,2,Matches
1603,Solly March,ENG,"DF,MF",Brighton,Premier League,26,1994,18.6,49,23,24,15,10,18,34,52.9,16,30,5,25,22,71,30,0,Matches
1604,Federico Marchetti,ITA,GK,Genoa,Serie A,37,1983,3.7,1,0,1,0,0,1,1,100.0,0,0,0,0,0,1,2,1,Matches
1605,Riccardo Marchizza,ITA,DF,Spezia,Serie A,22,1998,17.3,20,11,12,5,3,12,21,57.1,9,13,4,9,11,31,27,0,Matches
1606,Gian Marco Ferrari,ITA,DF,Sassuolo,Serie A,28,1992,33.5,32,20,15,14,3,10,23,43.5,13,46,37,9,50,82,100,1,Matches
1607,Iván Marcone,ARG,MF,Elche,La Liga,30,1990,29.4,64,41,42,17,5,35,84,41.7,49,27,8,19,36,100,33,3,Matches
1608,Óscar de Marcos,ESP,"DF,MF",Athletic Club,La Liga,31,1989,16.9,28,17,12,10,6,10,25,40.0,15,12,1,11,12,40,38,0,Matches
1609,Dario Maresic,AUT,DF,Reims,Ligue 1,20,1999,5.7,12,7,8,4,0,8,14,57.1,6,7,2,5,10,22,17,1,Matches
1610,José Mari,ESP,MF,Cádiz,La Liga,32,1987,16.1,32,17,13,18,1,14,31,45.2,17,16,7,9,27,59,33,1,Matches
1611,Pablo Marí,ESP,DF,Arsenal,Premier League,26,1993,10.0,15,9,12,3,0,5,10,50.0,5,8,7,1,9,24,30,2,Matches
1612,José María Giménez,URU,DF,Atlético Madrid,La Liga,25,1995,19.6,20,7,14,5,1,12,17,70.6,5,17,11,6,21,41,65,0,Matches
1613,Mariano,DOM,FW,Real Madrid,La Liga,26,1993,5.7,4,2,2,1,1,0,9,0.0,9,3,1,2,0,4,3,0,Matches
1614,Jordan Marié,FRA,MF,Dijon,Ligue 1,28,1991,15.9,34,17,9,23,2,23,56,41.1,33,14,5,9,23,57,12,2,Matches
1615,Adrián Marín,ESP,"DF,MF",Alavés,La Liga,23,1997,1.0,1,1,0,1,0,0,2,0.0,2,1,0,1,2,3,2,0,Matches
1616,Adrián Marín,ESP,"DF,MF",Granada,La Liga,23,1997,3.0,5,2,1,3,1,2,3,66.7,1,5,2,3,4,9,9,0,Matches
1617,Răzvan Marin,ROU,MF,Cagliari,Serie A,24,1996,32.9,54,33,26,22,6,27,53,50.9,26,29,10,19,29,83,15,0,Matches
1618,Guillermo Maripán,CHI,DF,Monaco,Ligue 1,26,1994,23.2,26,11,17,9,0,15,27,55.6,12,18,11,7,27,53,66,1,Matches
1619,Marlon,BRA,DF,Sassuolo,Serie A,24,1995,19.4,19,13,13,6,0,13,18,72.2,5,23,17,6,27,46,44,2,Matches
1620,Omar Marmoush,EGY,FW,Wolfsburg,Bundesliga,21,1999,0.0,0,0,0,0,0,0,0,,0,0,0,0,0,0,0,0,Matches
1621,Marquinhos,BRA,DF,Paris S-G,Ligue 1,26,1994,23.6,27,21,14,10,3,15,26,57.7,11,21,9,12,27,54,75,2,Matches
1622,Luca Marrone,ITA,DF,Crotone,Serie A,30,1990,17.6,25,18,16,9,0,13,21,61.9,8,22,11,11,26,51,56,1,Matches
1623,Roger Martí,ESP,FW,Levante,La Liga,29,1991,24.4,11,7,5,4,2,6,23,26.1,17,10,3,7,4,15,6,0,Matches
1624,Anthony Martial,FRA,FW,Manchester Utd,Premier League,24,1995,16.4,2,1,1,1,0,0,10,0.0,10,17,3,14,1,3,8,0,Matches
1625,Aarón Martín,ESP,DF,Celta Vigo,La Liga,23,1997,17.1,34,20,15,16,3,10,33,30.3,23,15,4,11,13,47,37,0,Matches
1626,Aarón Martín,ESP,"DF,FW",Mainz 05,Bundesliga,23,1997,2.9,3,2,2,1,0,2,4,50.0,2,1,0,1,2,5,2,0,Matches
1627,Álex Martín,ESP,DF,Cádiz,La Liga,22,1998,1.1,2,0,1,1,0,2,4,50.0,2,1,1,0,0,2,6,0,Matches
1628,Jonas Martin,FRA,MF,Rennes,Ligue 1,30,1990,5.4,11,9,5,4,2,5,14,35.7,9,11,2,9,13,24,2,1,Matches
1629,Gabriel Martinelli,BRA,FW,Arsenal,Premier League,19,2001,6.5,7,1,2,3,2,4,10,40.0,6,6,0,6,8,15,4,0,Matches
1630,Emiliano Martínez,ARG,GK,Aston Villa,Premier League,27,1992,38.0,3,3,3,0,0,3,4,75.0,1,0,0,0,2,5,10,2,Matches
1631,Iñigo Martínez,ESP,DF,Athletic Club,La Liga,29,1991,28.0,22,15,16,6,0,9,27,33.3,18,17,7,10,28,50,96,0,Matches
1632,Javi Martínez,ESP,"MF,FW",Osasuna,La Liga,20,1999,5.1,9,4,1,6,2,5,12,41.7,7,9,0,9,5,14,4,0,Matches
1633,Javi Martínez,ESP,"DF,MF",Bayern Munich,Bundesliga,31,1988,5.2,10,5,4,4,2,7,9,77.8,2,8,4,4,13,23,19,0,Matches
1634,Josep Martinez,ESP,GK,RB Leipzig,Bundesliga,22,1998,1.0,0,0,0,0,0,0,0,,0,0,0,0,0,0,0,0,Matches
1635,Lautaro Martínez,ARG,FW,Inter,Serie A,22,1997,28.5,25,12,5,11,9,7,24,29.2,17,31,1,30,27,52,16,0,Matches
1636,Pablo Martinez,FRA,DF,Nîmes,Ligue 1,31,1989,6.0,10,7,7,3,0,7,7,100.0,0,6,4,2,11,21,28,0,Matches
1637,Lucas Martínez Quarta,ARG,DF,Fiorentina,Serie A,24,1996,16.5,32,20,17,11,4,18,41,43.9,23,27,9,18,39,71,48,0,Matches
1638,Gelson Martins,POR,"MF,FW",Monaco,Ligue 1,25,1995,17.2,41,26,12,16,13,15,37,40.5,22,20,0,20,13,54,8,0,Matches
1639,Adam Marušić,MNE,DF,Lazio,Serie A,27,1992,33.0,38,22,22,15,1,20,40,50.0,20,38,6,32,40,78,54,0,Matches
1640,Sylvain Marveaux,FRA,"MF,FW",Lorient,Ligue 1,34,1986,2.2,6,3,1,4,1,3,3,100.0,0,2,0,2,1,7,2,0,Matches
1641,Marvin,ESP,"DF,MF",Real Madrid,La Liga,20,2000,1.5,3,2,0,3,0,1,2,50.0,1,1,0,1,2,5,3,0,Matches
1642,Omar Mascarell,EQG,MF,Schalke 04,Bundesliga,27,1993,19.6,41,24,15,19,7,21,54,38.9,33,40,14,26,37,78,32,1,Matches
1643,Andrea Masiello,ITA,DF,Genoa,Serie A,34,1986,28.5,38,22,29,6,3,23,48,47.9,25,32,13,19,53,91,107,3,Matches
1644,Jordi Masip,ESP,GK,Valladolid,La Liga,31,1989,25.0,0,0,0,0,0,0,2,0.0,2,2,0,2,2,2,8,1,Matches
1645,Roberto Massimo,GER,"DF,FW",Stuttgart,Bundesliga,19,2000,8.4,21,11,13,5,3,11,24,45.8,13,5,1,4,11,32,13,0,Matches
1646,Giuseppe Mastinu,ITA,FW,Spezia,Serie A,28,1991,0.4,1,1,0,0,1,1,1,100.0,0,1,0,1,0,1,0,0,Matches
1647,Arthur Masuaku,COD,"DF,MF",West Ham,Premier League,26,1993,11.2,20,12,14,6,0,11,34,32.4,23,12,0,12,8,28,28,2,Matches
1648,Jaime Mata,ESP,FW,Getafe,La Liga,31,1988,22.6,12,7,1,3,8,3,18,16.7,15,13,2,11,6,18,16,0,Matches
1649,Juan Mata,ESP,"FW,MF",Manchester Utd,Premier League,32,1988,5.7,1,0,1,0,0,0,7,0.0,7,3,0,3,3,4,3,0,Matches
1650,Pape Matar Sarr,SEN,MF,Metz,Ligue 1,17,2002,17.7,45,29,19,21,5,20,38,52.6,18,24,4,20,27,72,16,0,Matches
1651,Eliot Matazo,BEL,MF,Monaco,Ligue 1,18,2002,3.5,11,5,6,5,0,3,7,42.9,4,1,0,1,1,12,2,0,Matches
1652,Jean-Philippe Mateta,FRA,FW,Crystal Palace,Premier League,23,1997,2.5,1,1,0,1,0,1,3,33.3,2,1,0,1,0,1,2,0,Matches
1653,Jean-Philippe Mateta,FRA,FW,Mainz 05,Bundesliga,23,1997,11.1,6,3,1,3,2,0,3,0.0,3,3,1,2,4,10,6,0,Matches
1654,Nemanja Matić,SRB,MF,Manchester Utd,Premier League,31,1988,12.3,25,11,13,12,0,13,31,41.9,18,19,5,14,22,47,10,3,Matches
1655,Joël Matip,CMR,DF,Liverpool,Premier League,28,1991,7.7,14,9,7,7,0,7,8,87.5,1,6,0,6,7,21,22,0,Matches
1656,Rabbi Matondo,WAL,"FW,MF",Schalke 04,Bundesliga,19,2000,2.4,3,2,0,3,0,2,3,66.7,1,1,0,1,1,4,1,0,Matches
1657,Ryder Matos,BRA,MF,Udinese,Serie A,27,1993,0.1,0,0,0,0,0,0,0,,0,0,0,0,0,0,0,0,Matches
1658,Henning Matriciani,GER,DF,Schalke 04,Bundesliga,20,2000,0.3,1,1,1,0,0,1,1,100.0,0,1,0,1,0,1,1,0,Matches
1659,Chrislain Matsima,FRA,"DF,FW",Monaco,Ligue 1,18,2002,3.9,5,4,3,2,0,4,7,57.1,3,3,0,3,4,9,12,0,Matches
1660,Federico Mattiello,ITA,DF,Spezia,Serie A,25,1995,0.4,0,0,0,0,0,0,0,,0,0,0,0,0,0,0,0,Matches
1661,Neal Maupay,FRA,"FW,MF",Brighton,Premier League,23,1996,27.9,20,8,9,7,4,4,24,16.7,20,20,0,20,13,33,6,0,Matches
1662,Tony Mauricio,FRA,MF,Lens,Ligue 1,26,1994,5.6,19,12,7,8,4,11,17,64.7,6,8,1,7,3,22,4,0,Matches
1663,Stephy Mavididi,ENG,"FW,MF",Montpellier,Ligue 1,22,1998,22.6,18,5,7,10,1,8,23,34.8,15,12,0,12,14,32,6,0,Matches
1664,Konstantinos Mavropanos,GRE,DF,Stuttgart,Bundesliga,22,1997,16.3,42,29,29,12,1,27,46,58.7,19,25,10,15,59,101,66,1,Matches
1665,Eric Maxim Choupo-Moting,CMR,"FW,MF",Bayern Munich,Bundesliga,31,1989,9.1,8,2,0,5,3,1,4,25.0,3,6,0,6,2,10,7,0,Matches
1666,Borja Mayoral,ESP,FW,Roma,Serie A,23,1997,17.2,3,2,0,0,3,1,10,10.0,9,5,0,5,0,3,5,2,Matches
1667,Borja Mayoral,ESP,FW,Real Madrid,La Liga,23,1997,0.3,0,0,0,0,0,0,1,0.0,1,0,0,0,0,0,0,0,Matches
1668,Youssef Maziz,FRA,"MF,FW",Metz,Ligue 1,22,1998,2.9,2,0,1,1,0,1,5,20.0,4,1,0,1,6,8,1,0,Matches
1669,Antonio Mazzotta,ITA,DF,Crotone,Serie A,30,1989,0.6,1,1,0,1,0,0,0,,0,0,0,0,0,1,1,0,Matches
1670,Kevin Mbabu,SUI,DF,Wolfsburg,Bundesliga,25,1995,18.2,51,33,27,17,7,24,35,68.6,11,28,7,21,22,73,59,1,Matches
1671,Kylian Mbappé,FRA,FW,Paris S-G,Ligue 1,21,1998,26.4,4,2,0,1,3,2,9,22.2,7,7,1,6,3,7,4,1,Matches
1672,Ibrahima Mbaye,SEN,DF,Bologna,Serie A,25,1994,4.8,6,5,5,1,0,3,5,60.0,2,5,3,2,1,7,10,0,Matches
1673,Jean-Manuel Mbom,GER,"MF,DF",Werder Bremen,Bundesliga,20,2000,12.9,19,13,14,3,2,8,27,29.6,19,17,6,11,13,32,27,0,Matches
1674,Nathanael Mbuku,FRA,"MF,FW",Reims,Ligue 1,18,2002,24.6,33,19,9,13,11,8,28,28.6,20,17,0,17,14,47,10,0,Matches
1675,James McArthur,SCO,MF,Crystal Palace,Premier League,32,1987,16.3,57,32,25,27,5,15,39,38.5,24,28,3,25,23,80,31,0,Matches
1676,Oliver McBurnie,SCO,FW,Sheffield Utd,Premier League,24,1996,14.7,15,7,7,7,1,5,17,29.4,12,10,3,7,6,21,30,0,Matches
1677,Alex McCarthy,ENG,GK,Southampton,Premier League,30,1989,30.0,1,0,1,0,0,1,4,25.0,3,0,0,0,0,1,11,1,Matches
1678,James McCarthy,IRL,MF,Crystal Palace,Premier League,29,1990,9.1,16,12,9,7,0,8,21,38.1,13,15,7,8,8,24,12,0,Matches
1679,John McGinn,SCO,MF,Aston Villa,Premier League,25,1994,37.0,61,37,23,31,7,27,84,32.1,57,38,6,32,43,104,23,2,Matches
1680,David McGoldrick,IRL,"FW,MF",Sheffield Utd,Premier League,32,1987,26.6,33,21,8,15,10,13,31,41.9,18,19,3,16,2,35,25,0,Matches
1681,Weston McKennie,USA,MF,Juventus,Serie A,21,1998,18.9,34,19,9,20,5,12,33,36.4,21,21,3,18,28,62,26,0,Matches
1682,Dwight McNeil,ENG,MF,Burnley,Premier League,20,1999,34.1,47,24,24,18,5,18,56,32.1,38,44,6,38,32,79,32,1,Matches
1683,Scott McTominay,SCO,MF,Manchester Utd,Premier League,23,1996,23.7,51,24,23,25,3,23,36,63.9,13,35,10,25,29,80,46,0,Matches
1684,Gary Medel,CHI,"DF,MF",Bologna,Serie A,32,1987,5.7,12,9,6,5,1,4,10,40.0,6,8,6,2,7,19,10,0,Matches
1685,Facundo Medina,ARG,DF,Lens,Ligue 1,21,1999,22.3,39,22,22,15,2,24,38,63.2,14,25,9,16,39,78,51,3,Matches
1686,Nathan de Medina,BEL,DF,Arminia,Bundesliga,22,1997,7.1,16,10,9,6,1,3,10,30.0,7,12,2,10,11,27,22,0,Matches
1687,Ben Mee,ENG,DF,Burnley,Premier League,30,1989,29.9,32,15,16,14,2,14,29,48.3,15,54,45,9,43,75,148,2,Matches
1688,Joshua Mees,GER,FW,Union Berlin,Bundesliga,24,1996,0.1,0,0,0,0,0,0,0,,0,0,0,0,0,0,0,0,Matches
1689,Admir Mehmedi,SUI,"MF,FW",Wolfsburg,Bundesliga,29,1991,9.1,17,9,6,7,4,6,16,37.5,10,7,0,7,5,22,1,0,Matches
1690,Soualiho Meïté,FRA,MF,Torino,Serie A,26,1994,10.2,11,7,6,4,1,5,16,31.3,11,18,1,17,10,21,9,1,Matches
1691,Soualiho Meïté,FRA,MF,Milan,Serie A,26,1994,6.5,18,10,10,6,2,8,17,47.1,9,9,2,7,8,26,16,0,Matches
1692,Hannibal Mejbri,TUN,MF,Manchester Utd,Premier League,17,2003,0.1,0,0,0,0,0,0,0,,0,0,0,0,0,0,0,0,Matches
1693,Farid El Melali,ALG,"FW,MF",Angers,Ligue 1,23,1997,4.6,9,5,5,4,0,2,13,15.4,11,12,0,12,6,15,2,0,Matches
1694,Filippo Melegoni,ITA,"MF,DF",Genoa,Serie A,21,1999,4.3,7,6,2,5,0,3,6,50.0,3,5,0,5,5,12,8,0,Matches
1695,Gonzalo Melero,ESP,"MF,FW",Levante,La Liga,26,1994,20.6,24,15,11,6,7,10,39,25.6,29,14,5,9,18,42,22,1,Matches
1696,Birger Meling,NOR,DF,Nîmes,Ligue 1,25,1994,25.9,49,31,27,15,7,33,50,66.0,17,43,9,34,36,85,70,0,Matches
1697,Arthur Melo,BRA,MF,Juventus,Serie A,23,1996,12.9,17,9,7,10,0,12,31,38.7,19,6,1,5,18,35,9,1,Matches
1698,Memphis,NED,FW,Lyon,Ligue 1,26,1994,32.5,4,3,0,3,1,1,20,5.0,19,11,1,10,5,9,3,0,Matches
1699,Houboulang Mendes,GNB,DF,Lorient,Ligue 1,22,1998,14.4,28,19,19,5,4,16,28,57.1,12,14,2,12,14,42,35,0,Matches
1700,Pedro Mendes,POR,DF,Montpellier,Ligue 1,29,1990,18.1,21,19,16,5,0,14,21,66.7,7,23,13,10,34,55,58,0,Matches
1701,Thiago Mendes,BRA,MF,Lyon,Ligue 1,28,1992,24.9,37,22,13,20,4,18,38,47.4,20,33,7,26,39,76,21,2,Matches
1702,Brais Méndez,ESP,"MF,FW",Celta Vigo,La Liga,23,1997,29.7,59,31,23,27,9,16,65,24.6,49,27,2,25,32,91,34,0,Matches
1703,Édgar Méndez,ESP,"MF,FW",Alavés,La Liga,30,1990,23.2,39,29,18,13,8,15,48,31.3,33,20,3,17,19,58,14,0,Matches
1704,Eñaut Mendía,ESP,FW,Eibar,La Liga,21,1999,0.7,2,1,2,0,0,1,2,50.0,1,1,1,0,0,2,0,0,Matches
1705,Batista Mendy,FRA,MF,Nantes,Ligue 1,20,2000,0.8,1,1,0,1,0,0,1,0.0,1,3,1,2,1,2,1,0,Matches
1706,Benjamin Mendy,FRA,DF,Manchester City,Premier League,26,1994,10.6,13,9,1,8,4,5,21,23.8,16,12,5,7,5,18,14,1,Matches
1707,Edouard Mendy,SEN,GK,Chelsea,Premier League,28,1992,30.5,0,0,0,0,0,0,1,0.0,1,0,0,0,1,1,9,3,Matches
1708,Edouard Mendy,SEN,GK,Rennes,Ligue 1,28,1992,1.0,0,0,0,0,0,0,0,,0,0,0,0,0,0,0,0,Matches
1709,Ferland Mendy,FRA,DF,Real Madrid,La Liga,25,1995,24.5,26,16,17,6,3,12,24,50.0,12,16,4,12,26,52,32,1,Matches
1710,Nampalys Mendy,SEN,MF,Leicester City,Premier League,28,1992,16.2,26,17,18,6,2,7,20,35.0,13,12,1,11,14,40,8,0,Matches
1711,Hamza Mendyl,MAR,"FW,DF",Schalke 04,Bundesliga,22,1997,1.1,2,2,2,0,0,0,2,0.0,2,2,0,2,0,2,2,0,Matches
1712,Levent Mercan,GER,FW,Schalke 04,Bundesliga,19,2000,0.1,0,0,0,0,0,0,0,,0,0,0,0,0,0,0,0,Matches
1713,Jorge Meré,ESP,DF,Köln,Bundesliga,23,1997,14.4,13,6,9,3,1,6,13,46.2,7,14,11,3,15,28,63,0,Matches
1714,Alex Meret,ITA,GK,Napoli,Serie A,23,1997,22.0,0,0,0,0,0,0,1,0.0,1,0,0,0,0,0,5,0,Matches
1715,Mikel Merino,ESP,MF,Real Sociedad,La Liga,24,1996,23.9,61,36,14,36,11,18,45,40.0,27,36,8,28,32,93,26,0,Matches
1716,Martín Merquelanz,ESP,"MF,FW",Real Sociedad,La Liga,25,1995,6.1,9,3,3,2,4,2,7,28.6,5,7,1,6,3,12,4,0,Matches
1717,Yıldırım Mert Çetin,TUR,DF,Hellas Verona,Serie A,23,1997,4.6,8,4,3,5,0,2,6,33.3,4,7,5,2,14,22,11,1,Matches
1718,Dries Mertens,BEL,"FW,MF",Napoli,Serie A,33,1987,16.2,16,14,4,7,5,5,25,20.0,20,7,1,6,9,25,3,1,Matches
1719,Roque Mesa,ESP,MF,Valladolid,La Liga,31,1989,19.6,46,29,18,24,4,20,47,42.6,27,11,2,9,14,60,23,1,Matches
1720,Illan Meslier,FRA,GK,Leeds United,Premier League,20,2000,35.0,0,0,0,0,0,0,1,0.0,1,0,0,0,0,0,17,8,Matches
1721,Lionel Messi,ARG,"FW,MF",Barcelona,La Liga,33,1987,33.6,18,10,3,9,6,6,17,35.3,11,12,0,12,6,24,0,2,Matches
1722,Junior Messias,BRA,"MF,FW",Crotone,Serie A,29,1991,35.7,60,35,26,24,10,22,70,31.4,48,32,12,20,35,95,40,0,Matches
1723,Thomas Meunier,BEL,DF,Dortmund,Bundesliga,28,1991,16.4,30,21,19,6,5,20,29,69.0,9,16,6,10,18,48,29,2,Matches
1724,Mexer,MOZ,DF,Bordeaux,Ligue 1,31,1988,7.9,9,6,8,0,1,5,10,50.0,5,8,5,3,17,26,22,0,Matches
1725,Max Meyer,GER,MF,Köln,Bundesliga,24,1995,3.9,7,4,3,3,1,4,8,50.0,4,4,1,3,3,10,1,0,Matches
1726,Omenuke Mfulu,COD,MF,Elche,La Liga,26,1994,8.8,18,12,10,8,0,5,15,33.3,10,7,1,6,11,29,18,0,Matches
1727,Míchel,ESP,MF,Valladolid,La Liga,32,1988,10.5,18,11,10,3,5,5,22,22.7,17,10,1,9,9,27,12,1,Matches
1728,Jonas Michelbrink,GER,MF,Hertha BSC,Bundesliga,19,2001,0.4,0,0,0,0,0,0,0,,0,0,0,0,0,0,0,0,Matches
1729,Clément Michelin,FRA,DF,Lens,Ligue 1,23,1997,12.8,25,19,13,9,3,9,16,56.3,7,13,4,9,25,50,32,0,Matches
1730,Edouard Michut,FRA,MF,Paris S-G,Ligue 1,17,2003,0.0,0,0,0,0,0,0,0,,0,0,0,0,0,0,0,0,Matches
1731,Petar Mićin,SRB,MF,Udinese,Serie A,21,1998,0.2,0,0,0,0,0,0,0,,0,0,0,0,0,0,0,0,Matches
1732,Florian Miguel,FRA,DF,Nîmes,Ligue 1,23,1996,17.1,14,13,12,2,0,9,17,52.9,8,21,13,8,45,59,66,1,Matches
1733,Valentin Mihaila,ROU,"FW,MF",Parma,Serie A,20,2000,7.8,2,1,1,1,0,0,10,0.0,10,8,1,7,5,7,8,0,Matches
1734,Nikola Milenković,SRB,DF,Fiorentina,Serie A,22,1997,33.7,49,29,33,14,2,21,33,63.6,12,42,33,9,44,93,122,1,Matches
1735,Arkadiusz Milik,POL,FW,Marseille,Ligue 1,26,1994,13.6,14,9,0,7,7,2,12,16.7,10,5,1,4,2,16,9,0,Matches
1736,Sergej Milinković-Savić,SRB,MF,Lazio,Serie A,25,1995,30.5,59,40,20,30,9,27,84,32.1,57,52,12,40,33,92,47,0,Matches
1737,Vanja Milinković-Savić,SRB,GK,Torino,Serie A,23,1997,5.0,1,1,1,0,0,1,1,100.0,0,0,0,0,0,1,1,3,Matches
1738,Éder Militão,BRA,DF,Real Madrid,La Liga,22,1998,12.6,20,8,13,6,1,8,14,57.1,6,19,6,13,19,39,42,0,Matches
1739,Luka Milivojević,SRB,MF,Crystal Palace,Premier League,29,1991,26.2,65,34,25,31,9,42,77,54.5,35,29,6,23,35,100,47,2,Matches
1740,Luis Milla,ESP,MF,Granada,La Liga,25,1994,13.9,22,11,11,10,1,6,28,21.4,22,10,0,10,24,46,16,1,Matches
1741,Pere Milla,ESP,"FW,MF",Elche,La Liga,27,1992,22.0,24,17,12,10,2,8,37,21.6,29,17,5,12,13,37,17,1,Matches
1742,Álex Millán,ESP,FW,Villarreal,La Liga,20,1999,0.0,0,0,0,0,0,0,0,,0,0,0,0,0,0,0,0,Matches
1743,Vincenzo Millico,ITA,"FW,MF",Torino,Serie A,19,2000,0.2,0,0,0,0,0,0,0,,0,0,0,0,0,0,0,0,Matches
1744,Enzo Millot,FRA,MF,Monaco,Ligue 1,18,2002,0.5,2,0,0,1,1,1,1,100.0,0,0,0,0,2,4,0,0,Matches
1745,James Milner,ENG,"MF,DF",Liverpool,Premier League,34,1986,11.9,26,19,9,14,3,11,33,33.3,22,30,3,27,14,40,16,1,Matches
1746,Santi Mina,ESP,FW,Celta Vigo,La Liga,24,1995,26.8,31,13,9,12,10,6,37,16.2,31,15,3,12,6,37,17,0,Matches
1747,Yerry Mina,COL,DF,Everton,Premier League,25,1994,21.5,21,14,17,4,0,8,12,66.7,4,30,23,7,24,45,110,1,Matches
1748,Takumi Minamino,JPN,MF,Southampton,Premier League,25,1995,7.9,7,3,2,5,0,2,19,10.5,17,13,1,12,4,11,9,0,Matches
1749,Takumi Minamino,JPN,"MF,FW",Liverpool,Premier League,25,1995,3.3,4,3,1,2,1,0,12,0.0,12,1,0,1,2,6,3,0,Matches
1750,Tyrone Mings,ENG,DF,Aston Villa,Premier League,27,1993,35.5,32,16,23,7,2,16,24,66.7,8,59,40,19,41,73,172,3,Matches
1751,Óscar Mingueza,ESP,DF,Barcelona,La Liga,21,1999,21.1,52,33,28,17,7,30,53,56.6,23,19,6,13,20,72,48,2,Matches
1752,Rafa Mir,ESP,FW,Huesca,La Liga,23,1997,32.0,15,9,4,4,7,7,22,31.8,15,14,2,12,15,30,25,0,Matches
1753,Jorge Miramón,ESP,DF,Levante,La Liga,31,1989,19.2,32,22,26,6,0,21,35,60.0,14,22,2,20,27,59,54,0,Matches
1754,Aleksei Miranchuk,RUS,"MF,FW",Atalanta,Serie A,24,1995,7.5,24,13,8,9,7,6,9,66.7,3,1,0,1,3,27,1,0,Matches
1755,Juan Miranda,ESP,DF,Betis,La Liga,20,2000,18.4,27,11,16,9,2,16,32,50.0,16,18,2,16,29,56,58,1,Matches
1756,Antonio Mirante,ITA,GK,Roma,Serie A,37,1983,12.8,0,0,0,0,0,0,1,0.0,1,1,0,1,0,0,7,2,Matches
1757,Tyrick Mitchell,ENG,DF,Crystal Palace,Premier League,20,1999,19.0,64,35,48,9,7,23,40,57.5,17,29,10,19,21,85,62,1,Matches
1758,Aleksandar Mitrović,SRB,FW,Fulham,Premier League,25,1994,15.6,7,4,0,3,4,2,8,25.0,6,12,3,9,3,10,8,0,Matches
1759,Stefan Mitrović,SRB,DF,Strasbourg,Ligue 1,30,1990,30.9,36,27,29,7,0,24,37,64.9,13,23,13,10,31,67,108,5,Matches
1760,Maximilian Mittelstädt,GER,"DF,FW",Hertha BSC,Bundesliga,23,1997,20.0,66,39,42,21,3,35,72,48.6,37,34,5,29,55,121,61,1,Matches
1761,Henrikh Mkhitaryan,ARM,"MF,FW",Roma,Serie A,31,1989,30.5,58,24,13,27,18,13,62,21.0,49,34,0,34,39,97,10,0,Matches
1762,Jakub Moder,POL,"DF,MF",Brighton,Premier League,21,1999,7.2,15,7,5,7,3,7,20,35.0,13,12,1,11,3,18,9,0,Matches
1763,Anthony Modeste,FRA,"FW,MF",Saint-Étienne,Ligue 1,32,1988,3.3,2,1,0,2,0,1,4,25.0,3,3,1,2,0,2,3,0,Matches
1764,Anthony Modeste,FRA,FW,Köln,Bundesliga,32,1988,2.5,2,0,0,2,0,0,1,0.0,1,0,0,0,0,2,2,0,Matches
1765,Luka Modrić,CRO,MF,Real Madrid,La Liga,34,1985,30.4,37,23,18,16,3,13,36,36.1,23,14,2,12,48,85,14,1,Matches
1766,Terem Moffi,NGA,FW,Lorient,Ligue 1,21,1999,23.0,13,8,0,8,5,4,19,21.1,15,5,2,3,4,17,8,0,Matches
1767,Kevin Möhwald,GER,MF,Werder Bremen,Bundesliga,27,1993,17.3,15,9,9,5,1,4,18,22.2,14,10,3,7,32,47,19,2,Matches
1768,Niklas Moisander,FIN,DF,Werder Bremen,Bundesliga,34,1985,13.6,14,11,11,3,0,8,14,57.1,6,15,8,7,22,36,61,0,Matches
1769,Dion Moise Sahi,CIV,"FW,MF",Strasbourg,Ligue 1,18,2001,1.0,1,0,0,1,0,1,1,100.0,0,1,0,1,0,1,0,0,Matches
1770,Johan Mojica,COL,DF,Atalanta,Serie A,27,1992,3.3,4,4,3,1,0,2,3,66.7,1,3,0,3,7,11,6,0,Matches
1771,Johan Mojica,COL,DF,Elche,La Liga,27,1992,13.4,21,10,15,5,1,8,18,44.4,10,15,4,11,15,36,27,0,Matches
1772,Guillem Molina,ESP,DF,Valencia,La Liga,20,2000,1.7,1,0,1,0,0,0,5,0.0,5,1,1,0,4,5,5,0,Matches
1773,Jorge Molina,ESP,FW,Granada,La Liga,38,1982,17.9,11,4,3,5,3,8,22,36.4,14,5,1,4,3,14,19,0,Matches
1774,Nahuel Molina,ARG,DF,Udinese,Serie A,22,1998,20.3,27,18,13,10,4,16,42,38.1,26,26,4,22,21,48,49,1,Matches
1775,Salvatore Molina,ITA,"MF,DF",Crotone,Serie A,28,1992,25.7,39,22,18,14,7,29,45,64.4,16,30,8,22,17,56,41,0,Matches
1776,Victor Mollejo,ESP,"MF,DF",Getafe,La Liga,19,2001,0.8,2,1,1,0,1,0,1,0.0,1,0,0,0,0,2,0,0,Matches
1777,Florent Mollet,FRA,MF,Montpellier,Ligue 1,28,1991,26.2,20,15,7,11,2,12,47,25.5,35,18,4,14,32,52,9,1,Matches
1778,Jayson Molumby,IRL,MF,Brighton,Premier League,20,1999,0.0,0,0,0,0,0,0,0,,0,0,0,0,0,0,0,0,Matches
1779,Alkhaly Momo Cissé,GUI,"FW,DF",Stuttgart,Bundesliga,17,2002,0.4,1,1,1,0,0,0,0,,0,1,0,1,0,1,0,0,Matches
1780,Jon Moncayola,ESP,MF,Osasuna,La Liga,22,1998,29.6,61,36,27,23,11,24,67,35.8,43,27,9,18,23,84,38,0,Matches
1781,Gabriele Moncini,ITA,"FW,MF",Benevento,Serie A,24,1996,4.0,2,1,2,0,0,0,1,0.0,1,2,0,2,2,4,4,0,Matches
1782,Thomas Monconduit,FRA,MF,Lorient,Ligue 1,29,1991,12.8,28,15,9,16,3,15,41,36.6,26,10,3,7,13,41,21,1,Matches
1783,Kévin Monnet-Paquet,FRA,"MF,FW",Saint-Étienne,Ligue 1,31,1988,6.3,11,7,7,2,2,5,10,50.0,5,5,0,5,6,17,7,0,Matches
1784,Nacho Monreal,ESP,DF,Real Sociedad,La Liga,34,1986,23.1,31,19,17,11,3,7,20,35.0,13,14,3,11,31,62,43,0,Matches
1785,Cristóbal Montiel,ESP,"MF,FW",Fiorentina,Serie A,20,2000,0.0,0,0,0,0,0,0,1,0.0,1,0,0,0,0,0,0,0,Matches
1786,Lorenzo Montipò,ITA,GK,Benevento,Serie A,24,1996,37.0,0,0,0,0,0,0,0,,0,1,0,1,0,0,16,3,Matches
1787,Ángel Montoro,ESP,MF,Granada,La Liga,32,1988,15.1,15,9,7,7,1,4,16,25.0,12,13,3,10,22,37,21,0,Matches
1788,Martín Montoya,ESP,DF,Betis,La Liga,29,1991,2.7,6,3,2,2,2,1,3,33.3,2,1,1,0,2,8,6,0,Matches
1789,Emre Mor,TUR,"FW,MF",Celta Vigo,La Liga,23,1997,5.6,8,4,1,3,4,0,3,0.0,3,5,0,5,5,13,0,0,Matches
1790,Luca Mora,ITA,MF,Spezia,Serie A,32,1988,1.3,3,1,1,2,0,2,4,50.0,2,2,1,1,0,3,2,0,Matches
1791,Wesley Moraes,BRA,FW,Aston Villa,Premier League,23,1996,0.2,0,0,0,0,0,0,1,0.0,1,0,0,0,0,0,0,0,Matches
1792,Álvaro Morata,ESP,FW,Juventus,Serie A,27,1992,22.4,17,12,2,10,5,4,28,14.3,24,22,2,20,5,22,21,0,Matches
1793,Jan Morávek,CZE,MF,Augsburg,Bundesliga,30,1989,3.0,5,3,4,1,0,1,8,12.5,7,3,0,3,7,12,2,0,Matches
1794,Jon Morcillo,ESP,"MF,FW",Athletic Club,La Liga,21,1998,15.1,16,9,3,6,7,7,30,23.3,23,9,0,9,15,31,11,0,Matches
1795,Jérémy Morel,MAD,DF,Lorient,Ligue 1,36,1984,27.7,31,19,21,10,0,20,39,51.3,19,26,11,15,44,75,81,1,Matches
1796,Alberto Moreno,ESP,DF,Villarreal,La Liga,28,1992,2.1,7,4,7,0,0,2,5,40.0,3,2,1,1,3,10,2,0,Matches
1797,Álex Moreno,ESP,DF,Betis,La Liga,27,1993,19.8,42,26,25,12,5,20,43,46.5,23,18,4,14,35,77,48,0,Matches
1798,Gerard Moreno,ESP,FW,Villarreal,La Liga,28,1992,29.7,24,15,8,10,6,7,34,20.6,27,17,4,13,15,39,26,0,Matches
1799,Tete Morente,ESP,"MF,FW",Elche,La Liga,23,1996,22.4,31,17,17,9,5,9,39,23.1,30,20,0,20,13,44,28,0,Matches
1800,Mateu Morey,ESP,DF,Dortmund,Bundesliga,20,2000,9.2,13,7,4,7,2,9,12,75.0,3,6,1,5,18,31,7,1,Matches
1801,Wes Morgan,JAM,DF,Leicester City,Premier League,36,1984,0.2,0,0,0,0,0,0,0,,0,0,0,0,0,0,1,0,Matches
1802,Ilaix Moriba,GUI,MF,Barcelona,La Liga,17,2003,6.0,14,6,5,7,2,5,10,50.0,5,16,1,15,5,19,4,1,Matches
1803,Raúl Moro,ESP,FW,Lazio,Serie A,17,2002,0.1,0,0,0,0,0,0,1,0.0,1,0,0,0,0,0,0,0,Matches
1804,Loren Morón,ESP,FW,Betis,La Liga,26,1993,11.0,11,7,2,6,3,1,16,6.3,15,11,0,11,3,14,14,0,Matches
1805,Pedro Mosquera,ESP,MF,Huesca,La Liga,32,1988,22.8,38,18,19,18,1,13,53,24.5,40,23,6,17,31,69,38,1,Matches
1806,Aimen Moueffek,FRA,"DF,MF",Saint-Étienne,Ligue 1,19,2001,8.3,25,15,16,6,3,13,32,40.6,19,17,2,15,9,34,18,0,Matches
1807,Youssoufa Moukoko,GER,"FW,MF",Dortmund,Bundesliga,15,2004,4.7,3,2,1,1,1,0,0,,0,3,0,3,0,3,2,0,Matches
1808,Harold Moukoudi,CMR,DF,Saint-Étienne,Ligue 1,22,1997,25.3,46,27,37,8,1,28,38,73.7,10,24,10,14,42,88,78,1,Matches
1809,Jessy Moulin,FRA,GK,Saint-Étienne,Ligue 1,34,1986,29.0,2,1,2,0,0,2,3,66.7,1,0,0,0,2,4,9,2,Matches
1810,Steve Mounié,BEN,FW,Brest,Ligue 1,25,1994,29.8,15,11,3,11,1,3,28,10.7,25,18,3,15,12,27,40,0,Matches
1811,Mason Mount,ENG,MF,Chelsea,Premier League,21,1999,32.1,75,35,22,38,15,25,69,36.2,44,40,2,38,31,106,14,0,Matches
1812,Lucas Moura,BRA,"FW,MF",Tottenham,Premier League,27,1992,15.7,32,16,12,16,4,8,29,27.6,21,12,0,12,18,50,10,0,Matches
1813,Lys Mousset,FRA,"FW,MF",Sheffield Utd,Premier League,24,1996,3.3,1,0,0,0,1,0,2,0.0,2,1,0,1,0,1,1,1,Matches
1814,João Moutinho,POR,MF,Wolves,Premier League,33,1986,28.1,75,40,34,35,6,35,91,38.5,56,18,3,15,47,122,28,0,Matches
1815,Samuel Moutoussamy,COD,FW,Nantes,Ligue 1,23,1996,0.9,0,0,0,0,0,0,1,0.0,1,1,0,1,0,0,0,0,Matches
1816,Loris Mouyokolo,FRA,DF,Lorient,Ligue 1,19,2001,0.2,1,1,1,0,0,1,1,100.0,0,1,1,0,0,1,1,0,Matches
1817,Javi Moyano,ESP,DF,Valladolid,La Liga,34,1986,1.1,0,0,0,0,0,0,0,,0,2,0,2,0,0,2,0,Matches
1818,Nordi Mukiele,FRA,DF,RB Leipzig,Bundesliga,22,1997,18.6,44,30,14,28,2,21,37,56.8,16,33,1,32,23,67,33,2,Matches
1819,Mert Müldür,TUR,DF,Sassuolo,Serie A,21,1999,18.6,43,20,26,9,8,27,53,50.9,26,17,1,16,36,79,41,0,Matches
1820,Florian Müller,GER,GK,Freiburg,Bundesliga,22,1997,31.0,0,0,0,0,0,0,3,0.0,3,1,0,1,2,2,10,1,Matches
1821,Sebastian Müller,GER,"MF,DF",Arminia,Bundesliga,19,2001,0.0,0,0,0,0,0,0,0,,0,0,0,0,0,0,0,0,Matches
1822,Thomas Müller,GER,MF,Bayern Munich,Bundesliga,30,1989,29.7,49,22,11,23,15,24,73,32.9,49,43,3,40,21,70,18,1,Matches
1823,Joel Mumbongo,SWE,FW,Burnley,Premier League,21,1999,0.4,0,0,0,0,0,0,0,,0,1,0,1,0,0,0,0,Matches
1824,Marshall Munetsi,ZIM,"MF,DF",Reims,Ligue 1,24,1996,21.4,35,19,19,14,2,21,41,51.2,20,33,25,8,57,92,85,3,Matches
1825,Iker Muniain,ESP,"MF,FW",Athletic Club,La Liga,27,1992,21.6,20,7,4,10,6,6,24,25.0,18,15,0,15,11,31,4,0,Matches
1826,Aihen Muñoz,ESP,DF,Real Sociedad,La Liga,22,1997,13.4,23,16,15,5,3,11,19,57.9,8,12,2,10,10,33,31,0,Matches
1827,Joaquín Muñoz,ESP,FW,Huesca,La Liga,21,1999,0.5,0,0,0,0,0,0,2,0.0,2,0,0,0,1,1,0,0,Matches
1828,Luis Muriel,COL,FW,Atalanta,Serie A,29,1991,16.0,20,9,4,8,8,9,26,34.6,17,17,0,17,7,27,4,0,Matches
1829,Jeison Murillo,COL,DF,Celta Vigo,La Liga,28,1992,30.0,45,21,35,9,1,24,44,54.5,20,29,17,12,36,81,100,2,Matches
1830,Vedat Muriqi,KVX,FW,Lazio,Serie A,26,1994,9.2,3,1,0,2,1,0,8,0.0,8,9,2,7,3,6,20,0,Matches
1831,Jacob Murphy,ENG,"DF,MF",Newcastle Utd,Premier League,25,1995,18.1,39,24,25,12,2,24,49,49.0,25,27,3,24,14,53,29,0,Matches
1832,Nicola Murru,ITA,DF,Torino,Serie A,25,1994,6.3,9,6,1,5,3,3,5,60.0,2,11,1,10,12,21,24,0,Matches
1833,Petar Musa,CRO,FW,Union Berlin,Bundesliga,22,1998,7.9,12,8,3,6,3,4,8,50.0,4,10,0,10,4,16,5,0,Matches
1834,Mateo Musacchio,ARG,DF,Lazio,Serie A,29,1990,2.5,1,1,1,0,0,0,0,,0,5,2,3,2,3,5,0,Matches
1835,Mateo Musacchio,ARG,DF,Milan,Serie A,29,1990,0.4,2,1,2,0,0,2,3,66.7,1,1,0,1,3,5,0,0,Matches
1836,Yunus Musah,USA,MF,Valencia,La Liga,17,2002,17.0,21,18,12,3,6,8,24,33.3,16,20,0,20,15,36,12,1,Matches
1837,Jamal Musiala,GER,"FW,MF",Bayern Munich,Bundesliga,17,2003,9.8,20,12,5,7,8,7,22,31.8,15,17,2,15,14,34,3,0,Matches
1838,Juan Musso,ARG,GK,Udinese,Serie A,26,1994,35.0,1,1,1,0,0,1,1,100.0,0,0,0,0,1,2,8,1,Matches
1839,Shkodran Mustafi,GER,DF,Arsenal,Premier League,28,1992,0.5,1,1,1,0,0,1,1,100.0,0,1,0,1,0,1,3,0,Matches
1840,Shkodran Mustafi,GER,DF,Schalke 04,Bundesliga,28,1992,11.5,16,5,15,1,0,3,12,25.0,9,20,15,5,32,48,76,1,Matches
1841,Yoshinori Mutō,JPN,"FW,MF",Eibar,La Liga,28,1992,12.5,12,7,1,4,7,3,8,37.5,5,5,0,5,3,15,2,0,Matches
1842,Phillipp Mwene,AUT,"DF,MF",Mainz 05,Bundesliga,26,1994,18.6,36,23,21,11,4,19,38,50.0,19,26,3,23,24,60,33,0,Matches
1843,Joakim Mæhle,DEN,DF,Atalanta,Serie A,23,1997,13.5,18,10,7,5,6,8,19,42.1,11,17,2,15,11,29,5,0,Matches
1844,Obite N'Dicka,CIV,DF,Eint Frankfurt,Bundesliga,20,1999,22.7,31,23,16,15,0,16,28,57.1,12,27,6,21,47,78,85,0,Matches
1845,Kévin N'Doram,FRA,MF,Metz,Ligue 1,24,1996,3.4,3,2,0,3,0,1,3,33.3,2,0,0,0,6,9,2,0,Matches
1846,Stanley N'Soki,FRA,DF,Nice,Ligue 1,21,1999,13.8,27,19,15,9,3,13,22,59.1,9,17,4,13,26,53,38,2,Matches
1847,Nacho,ESP,DF,Valladolid,La Liga,31,1989,20.1,43,21,29,10,4,24,52,46.2,28,21,1,20,29,72,47,0,Matches
1848,Nacho,ESP,DF,Real Madrid,La Liga,30,1990,22.2,27,14,13,11,3,12,35,34.3,23,19,9,10,40,67,58,0,Matches
1849,Yuto Nagatomo,JPN,DF,Marseille,Ligue 1,33,1986,17.7,23,16,12,8,3,9,18,50.0,9,14,3,11,29,52,43,0,Matches
1850,Kenny Nagera,FRA,FW,Paris S-G,Ligue 1,18,2002,0.0,0,0,0,0,0,0,0,,0,0,0,0,0,0,0,0,Matches
1851,Radja Nainggolan,BEL,MF,Cagliari,Serie A,32,1988,20.5,41,26,22,14,5,19,34,55.9,15,18,0,18,15,56,15,1,Matches
1852,Radja Nainggolan,BEL,MF,Inter,Serie A,32,1988,0.5,0,0,0,0,0,0,0,,0,0,0,0,1,1,0,0,Matches
1853,Marvelous Nakamba,ZIM,MF,Aston Villa,Premier League,26,1994,8.3,22,14,10,11,1,7,12,58.3,5,16,5,11,17,39,9,1,Matches
1854,Nahitan Nández,URU,"MF,DF",Cagliari,Serie A,24,1995,30.4,56,28,23,23,10,25,68,36.8,43,26,4,22,23,79,49,0,Matches
1855,Nano,ESP,FW,Cádiz,La Liga,25,1995,0.1,0,0,0,0,0,0,0,,0,0,0,0,0,0,0,0,Matches
1856,Paul Nardi,FRA,GK,Lorient,Ligue 1,26,1994,23.0,0,0,0,0,0,0,1,0.0,1,1,0,1,0,0,15,2,Matches
1857,Matija Nastasić,SRB,DF,Schalke 04,Bundesliga,27,1993,13.6,11,7,9,2,0,9,16,56.3,7,22,18,4,26,37,51,1,Matches
1858,Roberto Navarro,ESP,MF,Real Sociedad,La Liga,18,2002,0.4,1,1,1,0,0,0,2,0.0,2,0,0,0,1,2,0,0,Matches
1859,Ximo Navarro,ESP,DF,Alavés,La Liga,30,1990,26.4,54,30,36,17,1,14,30,46.7,16,14,4,10,47,101,75,3,Matches
1860,Jesús Navas,ESP,DF,Sevilla,La Liga,34,1985,31.4,27,21,15,11,1,15,22,68.2,7,10,3,7,37,64,62,1,Matches
1861,Keylor Navas,CRC,GK,Paris S-G,Ligue 1,33,1986,28.0,0,0,0,0,0,0,0,,0,0,0,0,0,0,10,0,Matches
1862,Raúl Navas,ESP,DF,Osasuna,La Liga,32,1988,1.9,6,3,5,1,0,4,6,66.7,2,0,0,0,3,9,13,0,Matches
1863,Papa Ndiaga Yade,MTN,"FW,MF",Metz,Ligue 1,20,2000,11.1,15,8,9,2,4,7,20,35.0,13,9,0,9,4,19,6,0,Matches
1864,Iliman Ndiaye,SEN,MF,Sheffield Utd,Premier League,20,2000,0.1,1,1,0,1,0,1,1,100.0,0,0,0,0,0,1,0,0,Matches
1865,Wilfred Ndidi,NGA,"MF,DF",Leicester City,Premier League,23,1996,24.2,96,63,45,44,7,26,66,39.4,40,38,11,27,61,157,55,0,Matches
1866,Bridge Ndilu,FRA,"FW,MF",Nantes,Ligue 1,20,2000,0.5,0,0,0,0,0,0,2,0.0,2,2,0,2,0,0,0,0,Matches
1867,Tanguy Ndombele,FRA,MF,Tottenham,Premier League,23,1996,23.2,41,20,11,21,9,18,44,40.9,26,28,4,24,19,60,15,0,Matches
1868,Dan Ndoye,SUI,"FW,MF",Nice,Ligue 1,19,2000,6.1,7,6,3,4,0,1,8,12.5,7,4,0,4,7,14,4,0,Matches
1869,Paul Nebel,GER,"MF,FW",Mainz 05,Bundesliga,17,2002,0.6,1,1,0,1,0,0,1,0.0,1,0,0,0,2,3,0,0,Matches
1870,Álvaro Negredo,ESP,FW,Cádiz,La Liga,34,1985,24.4,11,5,3,4,4,5,11,45.5,6,7,2,5,3,14,19,0,Matches
1871,Reiss Nelson,ENG,"FW,MF",Arsenal,Premier League,20,1999,0.8,1,0,0,0,1,0,0,,0,0,0,0,1,2,1,0,Matches
1872,Ilija Nestorovski,MKD,"FW,MF",Udinese,Serie A,30,1990,7.8,6,4,2,3,1,2,13,15.4,11,5,0,5,1,7,7,0,Matches
1873,Neto,BRA,GK,Barcelona,La Liga,31,1989,7.0,0,0,0,0,0,0,1,0.0,1,0,0,0,0,0,3,1,Matches
1874,Pedro Neto,POR,"FW,MF",Wolves,Premier League,20,2000,28.3,16,9,4,6,6,6,28,21.4,22,18,2,16,31,47,8,0,Matches
1875,Luca Netz,GER,"DF,FW",Hertha BSC,Bundesliga,17,2003,3.4,14,8,12,2,0,6,17,35.3,11,3,0,3,6,20,8,0,Matches
1876,Manuel Neuer,GER,GK,Bayern Munich,Bundesliga,34,1986,33.0,0,0,0,0,0,0,1,0.0,1,0,0,0,2,2,12,3,Matches
1877,Florian Neuhaus,GER,MF,Gladbach,Bundesliga,23,1997,29.1,48,28,19,26,3,19,63,30.2,44,35,7,28,50,98,20,1,Matches
1878,Carlos Neva,ESP,DF,Granada,La Liga,24,1996,20.0,12,6,6,6,0,6,11,54.5,5,16,4,12,27,39,58,0,Matches
1879,Rúben Neves,POR,MF,Wolves,Premier League,23,1997,29.7,86,46,42,38,6,36,88,40.9,52,55,11,44,65,151,46,2,Matches
1880,Neymar,BRA,"MF,FW",Paris S-G,Ligue 1,28,1992,15.7,14,11,1,6,7,8,37,21.6,29,8,0,8,9,23,0,0,Matches
1881,Yvan Neyou,CMR,MF,Saint-Étienne,Ligue 1,23,1997,27.1,58,31,24,33,1,25,60,41.7,35,34,5,29,31,89,13,1,Matches
1882,Jessic Ngankam,GER,FW,Hertha BSC,Bundesliga,20,2000,3.3,5,2,1,2,2,1,3,33.3,2,6,1,5,0,5,1,0,Matches
1883,Muzinga Ngonda,COD,DF,Dijon,Ligue 1,25,1994,25.6,59,40,37,21,1,30,50,60.0,20,28,3,25,72,131,58,0,Matches
1884,Ahmad Ngouyamsa,CMR,DF,Dijon,Ligue 1,19,2000,1.7,6,4,5,1,0,4,8,50.0,4,2,1,1,2,8,8,0,Matches
1885,Opa Nguette,SEN,"FW,MF",Metz,Ligue 1,26,1994,12.6,15,8,2,8,5,3,10,30.0,7,14,2,12,1,16,1,0,Matches
1886,Moussa Niakhate,SEN,DF,Mainz 05,Bundesliga,24,1996,31.8,42,22,28,13,1,14,29,48.3,15,31,15,16,49,91,79,0,Matches
1887,Ibrahima Niane,SEN,FW,Metz,Ligue 1,21,1999,7.4,1,1,0,0,1,1,2,50.0,1,3,0,3,0,1,8,0,Matches
1888,M'Baye Niang,SEN,FW,Rennes,Ligue 1,25,1994,4.7,3,2,2,1,0,0,0,,0,2,0,2,1,4,2,0,Matches
1889,Mamor Niang,SEN,"MF,FW",Getafe,La Liga,18,2002,0.2,1,1,0,1,0,0,0,,0,1,0,1,0,1,0,0,Matches
1890,Tanguy Nianzou,FRA,"DF,FW",Bayern Munich,Bundesliga,18,2002,1.3,3,1,3,0,0,1,1,100.0,0,0,0,0,3,6,1,0,Matches
1891,Florian Niederlechner,GER,FW,Augsburg,Bundesliga,29,1990,19.3,7,5,1,4,2,0,10,0.0,10,8,3,5,10,17,18,0,Matches
1892,Nieto,ESP,"FW,DF",Cádiz,La Liga,22,1998,0.2,1,1,0,1,0,0,0,,0,0,0,0,0,1,1,0,Matches
1893,Saúl Ñíguez,ESP,"MF,DF",Atlético Madrid,La Liga,25,1994,22.6,57,34,27,23,7,30,59,50.8,29,35,2,33,19,76,43,0,Matches
1894,Joakim Nilsson,SWE,DF,Arminia,Bundesliga,26,1994,24.0,36,24,23,12,1,14,23,60.9,9,29,22,7,39,75,111,0,Matches
1895,Casimir Ninga,CHA,FW,Angers,Ligue 1,27,1993,0.3,0,0,0,0,0,0,0,,0,0,0,0,0,0,1,0,Matches
1896,Nino,ESP,"FW,MF",Elche,La Liga,40,1980,3.2,0,0,0,0,0,0,1,0.0,1,1,0,1,0,0,0,0,Matches
1897,Fernando Niño,ESP,FW,Villarreal,La Liga,19,2000,6.6,8,3,0,4,4,2,9,22.2,7,1,0,1,2,10,2,0,Matches
1898,Eddie Nketiah,ENG,FW,Arsenal,Premier League,21,1999,4.7,3,1,0,2,1,0,2,0.0,2,6,0,6,0,3,5,0,Matches
1899,Nicolas Nkoulou,CMR,DF,Torino,Serie A,30,1990,15.1,14,9,11,3,0,7,12,58.3,5,28,14,14,33,47,71,1,Matches
1900,Niels Nkounkou,FRA,"DF,FW",Everton,Premier League,19,2000,0.9,4,3,1,2,1,3,8,37.5,5,4,0,4,0,4,4,0,Matches
1901,Christopher Nkunku,FRA,"FW,MF",RB Leipzig,Bundesliga,22,1997,21.0,16,11,3,7,6,8,18,44.4,10,27,1,26,9,25,14,0,Matches
1902,Dan Nlundulu,ENG,"FW,MF",Southampton,Premier League,21,1999,1.2,0,0,0,0,0,0,1,0.0,1,2,0,2,0,0,2,0,Matches
1903,Mark Noble,ENG,MF,West Ham,Premier League,33,1987,7.9,8,4,2,5,1,4,14,28.6,10,7,3,4,13,21,3,0,Matches
1904,Nolito,ESP,"MF,FW",Celta Vigo,La Liga,33,1986,28.9,70,36,30,30,10,32,92,34.8,60,46,2,44,22,92,19,0,Matches
1905,Arnaud Nordin,FRA,"MF,FW",Saint-Étienne,Ligue 1,22,1998,19.7,14,8,5,5,4,6,21,28.6,15,13,2,11,9,23,10,0,Matches
1906,Håvard Nordtveit,NOR,DF,Hoffenheim,Bundesliga,30,1990,7.8,6,2,5,1,0,6,8,75.0,2,4,2,2,13,19,42,0,Matches
1907,Will Norris,ENG,GK,Burnley,Premier League,26,1993,2.0,0,0,0,0,0,0,0,,0,0,0,0,0,0,0,0,Matches
1908,Oliver Norwood,NIR,MF,Sheffield Utd,Premier League,29,1991,24.7,49,22,16,28,5,21,72,29.2,51,29,12,17,36,85,51,1,Matches
1909,Olivier Ntcham,CMR,MF,Marseille,Ligue 1,24,1996,1.3,1,0,0,1,0,1,3,33.3,2,3,1,2,2,3,3,0,Matches
1910,Alexander Nübel,GER,GK,Bayern Munich,Bundesliga,23,1996,1.0,0,0,0,0,0,0,0,,0,0,0,0,0,0,1,0,Matches
1911,Kasim Nuhu,GHA,DF,Hoffenheim,Bundesliga,25,1995,11.0,13,7,9,4,0,6,10,60.0,4,8,3,5,15,28,38,0,Matches
1912,Unai Núñez,ESP,DF,Athletic Club,La Liga,23,1997,23.4,23,12,16,7,0,10,15,66.7,5,19,14,5,32,55,110,0,Matches
1913,Bram Nuytinck,NED,DF,Udinese,Serie A,30,1990,18.2,21,15,10,9,2,13,20,65.0,7,30,17,13,25,46,77,0,Matches
1914,Kelechi Nwakali,NGA,"MF,FW",Huesca,La Liga,22,1998,1.6,4,3,1,2,1,0,4,0.0,4,1,0,1,1,5,1,0,Matches
1915,Simeon Nwankwo,NGA,FW,Crotone,Serie A,28,1992,32.7,9,2,2,6,1,3,22,13.6,19,21,5,16,6,15,51,0,Matches
1916,Gerzino Nyamsi,FRA,DF,Rennes,Ligue 1,23,1997,9.7,12,10,2,8,2,4,6,66.7,2,8,5,3,10,22,32,1,Matches
1917,Allan Nyom,CMR,"MF,DF",Getafe,La Liga,32,1988,25.8,38,23,14,19,5,15,30,50.0,15,16,2,14,22,60,42,0,Matches
1918,M'Bala Nzola,ANG,FW,Spezia,Serie A,23,1996,21.1,12,5,2,6,4,4,7,57.1,3,15,1,14,3,15,20,0,Matches
1919,Steven Nzonzi,FRA,MF,Rennes,Ligue 1,31,1988,32.3,34,16,15,16,3,12,31,38.7,19,24,10,14,16,50,26,0,Matches
1920,Jack O'Connell,ENG,DF,Sheffield Utd,Premier League,26,1994,2.0,3,1,1,1,1,0,1,0.0,1,4,3,1,2,5,7,0,Matches
1921,Dara O'Shea,IRL,DF,West Brom,Premier League,21,1999,23.4,45,25,30,13,2,21,45,46.7,24,32,17,15,45,90,108,0,Matches
1922,Michael Obafemi,IRL,FW,Southampton,Premier League,20,2000,0.7,1,0,0,1,0,0,1,0.0,1,1,0,1,0,1,0,0,Matches
1923,Pedro Obiang,EQG,MF,Sassuolo,Serie A,28,1992,16.3,35,22,17,15,3,12,35,34.3,23,26,7,19,22,57,27,0,Matches
1924,Jan Oblak,SVN,GK,Atlético Madrid,La Liga,27,1993,38.0,0,0,0,0,0,0,0,,0,0,0,0,0,0,6,2,Matches
1925,Lucas Ocampos,ARG,FW,Sevilla,La Liga,26,1994,29.2,36,24,12,16,8,13,37,35.1,24,33,1,32,19,55,30,1,Matches
1926,Bastian Oczipka,GER,"DF,FW",Schalke 04,Bundesliga,31,1989,21.4,33,20,22,10,1,7,21,33.3,14,22,4,18,24,57,41,0,Matches
1927,Brian Oddei,ITA,"FW,MF",Sassuolo,Serie A,17,2002,0.5,2,1,1,1,0,2,3,66.7,1,1,0,1,0,2,1,0,Matches
1928,Denis Odoi,GHA,DF,Fulham,Premier League,32,1988,3.0,3,3,2,1,0,1,4,25.0,3,3,1,2,5,8,5,0,Matches
1929,Álvaro Odriozola,ESP,DF,Real Madrid,La Liga,24,1995,9.2,14,7,5,8,1,3,5,60.0,2,6,3,3,6,20,12,1,Matches
1930,Angelo Ogbonna,ITA,DF,West Ham,Premier League,32,1988,27.7,26,13,20,5,1,9,17,52.9,8,25,11,14,30,56,119,0,Matches
1931,Stefano Okaka,ITA,FW,Udinese,Serie A,30,1989,16.5,10,7,2,5,3,2,10,20.0,8,7,1,6,2,12,19,0,Matches
1932,Shinji Okazaki,JPN,"FW,MF",Huesca,La Liga,34,1986,12.5,7,5,5,0,2,0,5,0.0,5,5,0,5,4,11,6,0,Matches
1933,Masaya Okugawa,JPN,MF,Arminia,Bundesliga,24,1996,10.2,17,8,5,11,1,6,14,42.9,8,17,2,15,8,25,5,0,Matches
1934,Lucas Olaza,URU,DF,Valladolid,La Liga,26,1994,14.0,20,9,11,7,2,9,17,52.9,8,15,7,8,15,35,38,0,Matches
1935,Lucas Olaza,URU,DF,Celta Vigo,La Liga,26,1994,17.9,25,16,12,12,1,10,18,55.6,8,15,1,14,24,49,34,0,Matches
1936,Christian Oliva,URU,MF,Cagliari,Serie A,24,1996,4.3,10,4,6,3,1,6,17,35.3,11,11,1,10,8,18,7,0,Matches
1937,Christian Oliva,URU,MF,Valencia,La Liga,24,1996,2.2,2,0,1,1,0,1,6,16.7,5,1,0,1,6,8,0,0,Matches
1938,Kiko Olivas,ESP,DF,Valladolid,La Liga,31,1988,2.0,3,2,2,1,0,3,5,60.0,2,2,2,0,7,10,3,0,Matches
1939,Paulo Oliveira,POR,DF,Eibar,La Liga,28,1992,29.3,42,21,32,8,2,19,36,52.8,17,39,14,25,59,101,112,0,Matches
1940,Mathías Olivera,URU,DF,Getafe,La Liga,22,1997,29.0,61,33,31,21,9,32,56,57.1,24,33,3,30,31,92,55,0,Matches
1941,Maximiliano Olivera,URU,DF,Fiorentina,Serie A,28,1992,1.0,2,0,1,1,0,1,1,100.0,0,3,1,2,0,2,8,0,Matches
1942,Dani Olmo,ESP,MF,RB Leipzig,Bundesliga,22,1998,24.4,23,14,6,13,4,4,23,17.4,19,15,0,15,13,36,21,0,Matches
1943,Robin Olsen,SWE,GK,Everton,Premier League,30,1990,7.0,0,0,0,0,0,0,0,,0,0,0,0,0,0,4,1,Matches
1944,Jonas Omlin,SUI,GK,Montpellier,Ligue 1,26,1994,29.7,1,1,1,0,0,1,4,25.0,3,0,0,0,0,1,9,1,Matches
1945,Jérôme Onguéné,CMR,DF,Genoa,Serie A,22,1997,2.0,2,1,2,0,0,2,7,28.6,5,2,0,2,2,4,8,0,Matches
1946,Karim Onisiwo,AUT,"FW,MF",Mainz 05,Bundesliga,28,1992,20.5,31,20,7,15,9,14,23,60.9,9,20,1,19,5,36,12,0,Matches
1947,Josh Onomah,ENG,MF,Fulham,Premier League,23,1997,4.2,11,8,1,6,4,0,5,0.0,5,4,2,2,2,13,1,0,Matches
1948,Javier Ontiveros,ESP,"FW,MF",Huesca,La Liga,22,1997,10.2,21,14,10,10,1,9,26,34.6,17,12,0,12,9,30,6,0,Matches
1949,Henry Onyekuru,NGA,FW,Monaco,Ligue 1,23,1997,1.6,1,0,1,0,0,1,4,25.0,3,1,0,1,0,1,0,0,Matches
1950,Willi Orban,HUN,DF,RB Leipzig,Bundesliga,27,1992,26.3,40,26,19,15,6,23,37,62.2,14,29,20,9,40,80,74,0,Matches
1951,Fabián Orellana,CHI,"MF,FW",Valladolid,La Liga,34,1986,23.8,33,19,12,14,7,12,55,21.8,43,18,0,18,15,48,9,0,Matches
1952,Divock Origi,BEL,FW,Liverpool,Premier League,25,1995,2.1,3,2,0,2,1,1,3,33.3,2,5,1,4,1,4,2,0,Matches
1953,Riccardo Orsolini,ITA,"FW,MF",Bologna,Serie A,23,1997,19.5,37,18,13,12,12,16,39,41.0,23,22,3,19,10,47,22,0,Matches
1954,Stefan Ortega,GER,GK,Arminia,Bundesliga,27,1992,34.0,2,1,2,0,0,2,6,33.3,4,0,0,0,0,2,12,3,Matches
1955,Yuya Osako,JPN,"MF,FW",Werder Bremen,Bundesliga,30,1990,8.5,12,8,2,5,5,2,9,22.2,7,6,1,5,5,17,7,0,Matches
1956,Ben Osborn,ENG,"MF,DF",Sheffield Utd,Premier League,25,1994,17.8,33,18,15,10,8,13,40,32.5,27,20,3,17,12,45,17,0,Matches
1957,Victor Osimhen,NGA,FW,Napoli,Serie A,21,1998,17.5,22,15,2,6,14,3,15,20.0,12,6,0,6,7,29,10,0,Matches
1958,Yordan Osorio,VEN,DF,Parma,Serie A,26,1994,20.1,22,14,13,9,0,9,24,37.5,15,30,18,12,53,75,77,1,Matches
1959,David Ospina,COL,GK,Napoli,Serie A,31,1988,16.0,0,0,0,0,0,0,0,,0,0,0,0,0,0,4,0,Matches
1960,Owen Otasowie,USA,"MF,FW",Wolves,Premier League,19,2001,2.1,5,5,3,2,0,1,2,50.0,1,1,1,0,3,8,4,0,Matches
1961,Otávio,BRA,MF,Bordeaux,Ligue 1,26,1994,17.3,54,31,33,19,2,26,55,47.3,29,20,5,15,26,80,36,0,Matches
1962,Paulo Otávio,BRA,DF,Wolfsburg,Bundesliga,25,1994,19.3,60,40,32,22,6,34,62,54.8,28,51,7,44,42,102,59,0,Matches
1963,Remi Oudin,FRA,"FW,MF",Bordeaux,Ligue 1,23,1996,26.9,34,16,22,7,5,15,36,41.7,21,22,2,20,51,85,40,1,Matches
1964,Alexandre Oukidja,ALG,GK,Metz,Ligue 1,32,1988,34.0,0,0,0,0,0,0,1,0.0,1,1,0,1,0,0,17,3,Matches
1965,Zinédine Ould Khaled,FRA,MF,Angers,Ligue 1,20,2000,0.4,0,0,0,0,0,0,0,,0,0,0,0,1,1,0,0,Matches
1966,Adam Ounas,ALG,"FW,MF",Crotone,Serie A,23,1996,13.3,9,4,4,4,1,0,7,0.0,7,12,1,11,3,12,4,0,Matches
1967,Adam Ounas,ALG,"MF,FW",Cagliari,Serie A,23,1996,3.4,3,2,3,0,0,0,11,0.0,11,5,0,5,3,6,0,0,Matches
1968,Thomas Ouwejan,NED,DF,Udinese,Serie A,23,1996,4.6,4,1,0,3,1,2,9,22.2,7,4,0,4,5,9,6,0,Matches
1969,Reece Oxford,ENG,DF,Augsburg,Bundesliga,21,1998,15.1,26,18,15,11,0,10,17,58.8,7,28,22,6,29,55,89,0,Matches
1970,Alex Oxlade-Chamberlain,ENG,"MF,FW",Liverpool,Premier League,26,1993,2.8,4,0,0,3,1,0,2,0.0,2,1,0,1,2,6,0,0,Matches
1971,Mikel Oyarzabal,ESP,"FW,MF",Real Sociedad,La Liga,23,1997,26.8,30,17,14,12,4,10,31,32.3,21,30,5,25,15,45,17,0,Matches
1972,Ambroise Oyongo,CMR,DF,Montpellier,Ligue 1,29,1991,6.2,13,6,10,3,0,9,15,60.0,6,3,2,1,8,21,26,1,Matches
1973,Salih Özcan,TUR,MF,Köln,Bundesliga,22,1998,15.2,21,13,11,10,0,12,33,36.4,21,11,2,9,20,41,14,1,Matches
1974,Levin Öztunalı,GER,"DF,FW",Mainz 05,Bundesliga,24,1996,8.4,24,18,14,8,2,8,17,47.1,9,15,0,15,15,39,16,0,Matches
1975,Pablo,BRA,DF,Bordeaux,Ligue 1,29,1991,12.0,17,11,13,4,0,8,14,57.1,6,17,12,5,25,42,46,1,Matches
1976,Fernando Pacheco,ESP,GK,Alavés,La Liga,28,1992,37.2,2,0,2,0,0,2,4,50.0,2,0,0,0,2,4,19,0,Matches
1977,Jon Pacheco,ESP,DF,Real Sociedad,La Liga,19,2001,0.4,0,0,0,0,0,0,0,,0,0,0,0,1,1,0,0,Matches
1978,Gonçalo Paciência,POR,FW,Schalke 04,Bundesliga,25,1994,8.3,8,3,4,1,3,4,16,25.0,12,4,1,3,1,9,3,0,Matches
1979,Daniele Padelli,ITA,GK,Inter,Serie A,34,1985,0.5,0,0,0,0,0,0,0,,0,0,0,0,0,0,0,0,Matches
1980,Mattia Pagliuca,ITA,MF,Bologna,Serie A,18,2002,0.1,0,0,0,0,0,0,0,,0,0,0,0,1,1,0,0,Matches
1981,Vincent Pajot,FRA,MF,Metz,Ligue 1,29,1990,10.2,35,20,19,11,5,10,18,55.6,8,9,2,7,42,77,11,0,Matches
1982,Rodrigo Palacio,ARG,FW,Bologna,Serie A,38,1982,27.8,13,6,2,3,8,1,15,6.7,14,18,0,18,7,20,29,0,Matches
1983,Exequiel Palacios,ARG,MF,Leverkusen,Bundesliga,21,1998,6.4,31,17,12,16,3,17,30,56.7,13,13,0,13,12,43,7,0,Matches
1984,Helibelton Palacios,COL,DF,Elche,La Liga,27,1993,8.3,20,10,16,3,1,8,13,61.5,5,9,1,8,5,25,21,0,Matches
1985,Ante Palaversa,CRO,MF,Getafe,La Liga,20,2000,0.1,0,0,0,0,0,0,1,0.0,1,0,0,0,0,0,0,0,Matches
1986,Alberto Paleari,ITA,GK,Genoa,Serie A,27,1992,2.3,0,0,0,0,0,0,0,,0,0,0,0,0,0,1,0,Matches
1987,Nicolas Pallois,FRA,DF,Nantes,Ligue 1,32,1987,30.8,58,36,42,14,2,38,72,52.8,34,44,20,24,37,95,155,1,Matches
1988,Emerson Palmieri,ITA,DF,Chelsea,Premier League,25,1994,1.0,3,3,2,0,1,1,3,33.3,2,0,0,0,1,4,6,0,Matches
1989,Antonio Palumbo,ITA,MF,Sampdoria,Serie A,23,1996,0.1,0,0,0,0,0,0,1,0.0,1,0,0,0,0,0,0,0,Matches
1990,Martin Palumbo,NOR,MF,Udinese,Serie A,18,2002,0.7,0,0,0,0,0,0,0,,0,5,0,5,1,1,0,0,Matches
1991,Goran Pandev,MKD,"FW,MF",Genoa,Serie A,37,1983,15.6,9,5,1,6,2,4,10,40.0,6,6,0,6,2,11,7,1,Matches
1992,Ivor Pandur,CRO,GK,Hellas Verona,Serie A,20,2000,3.7,0,0,0,0,0,0,0,,0,0,0,0,0,0,0,0,Matches
1993,Jonathan Panzo,ENG,DF,Dijon,Ligue 1,19,2000,20.0,17,12,13,4,0,8,11,72.7,3,27,13,14,59,76,91,2,Matches
1994,Merveille Papela,GER,DF,Mainz 05,Bundesliga,19,2001,0.0,0,0,0,0,0,0,1,0.0,1,0,0,0,0,0,0,0,Matches
1995,Lucas Paquetá,BRA,MF,Lyon,Ligue 1,22,1997,25.3,70,36,30,28,12,23,66,34.8,43,28,3,25,20,90,16,1,Matches
1996,Gaëtan Paquiez,FRA,DF,Nîmes,Ligue 1,26,1994,11.6,21,12,12,7,2,12,29,41.4,17,10,3,7,16,37,28,0,Matches
1997,Rubén Pardo,ESP,MF,Bordeaux,Ligue 1,27,1992,0.3,0,0,0,0,0,0,0,,0,0,0,0,1,1,0,0,Matches
1998,Leandro Paredes,ARG,MF,Paris S-G,Ligue 1,26,1994,14.5,30,18,12,15,3,19,39,48.7,20,17,5,12,17,47,13,1,Matches
1999,Daniel Parejo,ESP,MF,Villarreal,La Liga,31,1989,34.6,65,40,32,23,10,33,81,40.7,48,35,8,27,45,110,21,3,Matches
2000,Vittorio Parigini,ITA,"MF,DF",Genoa,Serie A,24,1996,0.6,5,2,4,0,1,0,1,0.0,1,0,0,0,0,5,0,0,Matches
2001,Marco Parolo,ITA,"DF,MF",Lazio,Serie A,35,1985,7.3,21,8,8,11,2,8,20,40.0,12,20,6,14,14,35,31,0,Matches
2002,Thomas Partey,GHA,MF,Arsenal,Premier League,27,1993,17.0,44,21,16,24,4,24,56,42.9,32,17,5,12,23,67,18,0,Matches
2003,Thomas Partey,GHA,MF,Atlético Madrid,La Liga,27,1993,2.2,7,4,4,3,0,5,8,62.5,3,4,1,3,2,9,1,0,Matches
2004,Mario Pašalić,CRO,MF,Atalanta,Serie A,25,1995,12.5,26,15,5,17,4,12,19,63.2,7,12,1,11,8,34,6,0,Matches
2005,Felix Passlack,GER,DF,Dortmund,Bundesliga,22,1998,4.0,9,6,4,2,3,4,8,50.0,4,11,1,10,3,12,2,0,Matches
2006,Christian Pastina,ITA,DF,Benevento,Serie A,19,2001,1.3,0,0,0,0,0,0,1,0.0,1,1,0,1,1,1,8,0,Matches
2007,Javier Pastore,ARG,"MF,FW",Roma,Serie A,31,1989,0.9,2,2,2,0,0,2,2,100.0,0,0,0,0,0,2,0,0,Matches
2008,Patric,ESP,DF,Lazio,Serie A,27,1993,17.7,30,16,15,11,4,13,24,54.2,11,13,3,10,18,48,51,1,Matches
2009,Rui Patrício,POR,GK,Wolves,Premier League,32,1988,37.0,0,0,0,0,0,0,1,0.0,1,0,0,0,1,1,3,3,Matches
2010,Paulinho,BRA,FW,Leverkusen,Bundesliga,20,2000,0.7,0,0,0,0,0,0,0,,0,0,0,0,0,0,0,0,Matches
2011,Gabriel Paulista,BRA,DF,Valencia,La Liga,29,1990,30.2,17,11,9,5,3,6,17,35.3,11,32,27,5,59,76,132,3,Matches
2012,Benjamin Pavard,FRA,DF,Bayern Munich,Bundesliga,24,1996,21.6,44,27,20,16,8,23,40,57.5,17,29,5,24,48,92,31,1,Matches
2013,Jiří Pavlenka,CZE,GK,Werder Bremen,Bundesliga,28,1992,34.0,2,0,2,0,0,2,2,100.0,0,0,0,0,1,3,17,4,Matches
2014,Vasileios Pavlidis,GRE,FW,Schalke 04,Bundesliga,17,2002,0.0,0,0,0,0,0,0,0,,0,0,0,0,0,0,0,0,Matches
2015,Mateo Pavlović,BIH,DF,Angers,Ligue 1,30,1990,12.3,11,6,8,3,0,8,23,34.8,15,13,11,2,21,32,40,0,Matches
2016,Strahinja Pavlović,SRB,DF,Monaco,Ligue 1,19,2001,0.0,0,0,0,0,0,0,0,,0,0,0,0,0,0,0,0,Matches
2017,Leonardo Pavoletti,ITA,FW,Cagliari,Serie A,31,1988,17.6,7,3,2,5,0,1,20,5.0,19,4,2,2,4,11,32,0,Matches
2018,Dimitri Payet,FRA,"FW,MF",Marseille,Ligue 1,33,1987,26.9,27,17,4,16,7,17,40,42.5,23,19,2,17,8,35,10,0,Matches
2019,Nehuén Paz,ARG,DF,Bologna,Serie A,27,1993,4.0,9,4,4,5,0,6,7,85.7,1,4,2,2,11,20,16,0,Matches
2020,Bailey Peacock-Farrell,NIR,GK,Burnley,Premier League,23,1996,4.0,0,0,0,0,0,0,0,,0,0,0,0,0,0,0,0,Matches
2021,Mads Pedersen,DEN,DF,Augsburg,Bundesliga,23,1996,9.9,25,16,20,3,2,10,22,45.5,12,13,3,10,15,40,32,0,Matches
2022,Alfonso Pedraza,ESP,DF,Villarreal,La Liga,24,1996,23.3,35,19,16,11,8,11,31,35.5,20,21,5,16,34,69,47,1,Matches
2023,Pedri,ESP,MF,Barcelona,La Liga,17,2002,26.8,44,27,16,16,12,17,71,23.9,54,46,1,45,33,77,7,0,Matches
2024,Pedro,ESP,"MF,FW",Roma,Serie A,33,1987,17.7,22,14,6,11,5,7,35,20.0,28,10,0,10,9,31,2,1,Matches
2025,João Pedro,ITA,"FW,MF",Cagliari,Serie A,28,1992,36.1,13,6,2,6,5,2,27,7.4,25,32,6,26,13,26,28,0,Matches
2026,Gianluca Pegolo,ITA,GK,Sassuolo,Serie A,39,1981,1.0,0,0,0,0,0,0,0,,0,0,0,0,0,0,1,0,Matches
2027,Peter Pekarík,SVK,DF,Hertha BSC,Bundesliga,33,1986,18.8,24,18,17,7,0,17,31,54.8,14,19,8,11,27,51,41,0,Matches
2028,Yohann Pelé,FRA,GK,Marseille,Ligue 1,37,1982,1.0,0,0,0,0,0,0,0,,0,0,0,0,0,0,0,0,Matches
2029,Graziano Pellè,ITA,FW,Parma,Serie A,35,1985,6.8,2,2,0,1,1,1,8,12.5,7,3,0,3,2,4,8,0,Matches
2030,Pietro Pellegri,ITA,"FW,MF",Monaco,Ligue 1,19,2001,2.6,2,1,0,2,0,0,0,,0,1,0,1,0,2,0,0,Matches
2031,Lorenzo Pellegrini,ITA,MF,Roma,Serie A,24,1996,28.9,40,24,13,20,7,21,60,35.0,39,37,2,35,42,82,23,1,Matches
2032,Luca Pellegrini,ITA,"DF,MF",Genoa,Serie A,21,1999,7.1,9,6,6,2,1,4,10,40.0,6,11,2,9,8,17,13,1,Matches
2033,Facundo Pellistri,URU,"MF,FW",Alavés,La Liga,18,2001,6.0,8,5,2,4,2,3,13,23.1,10,0,0,0,4,12,3,0,Matches
2034,Andy Pelmard,FRA,DF,Nice,Ligue 1,20,2000,13.4,18,12,12,5,1,9,12,75.0,3,11,3,8,20,38,35,0,Matches
2035,Lee Peltier,ENG,DF,West Brom,Premier League,33,1986,2.5,9,4,8,1,0,4,4,100.0,0,1,1,0,1,10,11,0,Matches
2036,Federico Peluso,ITA,DF,Sassuolo,Serie A,36,1984,2.3,1,1,1,0,0,1,2,50.0,1,2,2,0,3,4,12,0,Matches
2037,Timothee Pembele,FRA,DF,Paris S-G,Ligue 1,17,2002,4.3,8,7,4,4,0,5,14,35.7,9,4,0,4,5,13,8,1,Matches
2038,Rubén Peña,ESP,DF,Villarreal,La Liga,29,1991,12.4,25,14,8,15,2,19,33,57.6,14,20,1,19,13,38,19,0,Matches
2039,Philipp Pentke,GER,GK,Hoffenheim,Bundesliga,35,1985,3.0,0,0,0,0,0,0,0,,0,0,0,0,0,0,0,0,Matches
2040,Nicolas Pépé,CIV,FW,Arsenal,Premier League,25,1995,18.0,20,15,8,6,6,8,23,34.8,15,16,1,15,12,32,19,0,Matches
2041,Alberto Perea,ESP,MF,Cádiz,La Liga,29,1990,17.2,28,17,12,10,6,9,35,25.7,26,26,1,25,21,49,9,0,Matches
2042,Andreas Pereira,BRA,"FW,MF",Lazio,Serie A,24,1996,6.0,5,0,1,3,1,2,12,16.7,10,6,0,6,1,6,4,0,Matches
2043,Danilo Pereira,POR,"MF,DF",Paris S-G,Ligue 1,28,1991,15.9,21,11,6,11,4,6,14,42.9,8,14,6,8,29,50,33,4,Matches
2044,Mathias Pereira Lage,POR,"FW,MF",Angers,Ligue 1,23,1996,16.3,29,17,12,15,2,10,40,25.0,30,21,4,17,15,44,16,0,Matches
2045,Matheus Pereira,POR,"MF,FW",West Brom,Premier League,24,1996,28.6,26,15,14,10,2,12,54,22.2,42,18,0,18,29,55,16,0,Matches
2046,Pedro Pereira,POR,DF,Crotone,Serie A,22,1998,28.3,50,32,29,17,4,21,40,52.5,19,33,11,22,19,69,61,0,Matches
2047,Ricardo Pereira,POR,"DF,FW",Leicester City,Premier League,26,1993,10.7,31,22,16,8,7,14,35,40.0,21,24,1,23,15,46,23,0,Matches
2048,Gastón Pereiro,URU,"MF,DF",Cagliari,Serie A,25,1995,3.0,3,1,2,1,0,1,2,50.0,1,2,0,2,1,4,2,1,Matches
2049,Bruno Peres,BRA,DF,Roma,Serie A,30,1990,15.9,21,11,11,7,3,13,24,54.2,11,18,4,14,27,48,11,0,Matches
2050,Roberto Pereyra,ARG,"MF,FW",Udinese,Serie A,29,1991,32.5,18,11,7,8,3,7,23,30.4,16,24,5,19,27,45,24,0,Matches
2051,Ayoze Pérez,ESP,"MF,FW",Leicester City,Premier League,27,1993,14.8,32,15,6,20,6,13,48,27.1,35,28,0,28,10,42,7,0,Matches
2052,Carles Pérez,ESP,"MF,FW",Roma,Serie A,22,1998,8.6,9,4,3,6,0,6,31,19.4,25,9,0,9,6,15,1,0,Matches
2053,Iñigo Pérez,ESP,"MF,DF",Osasuna,La Liga,32,1988,15.0,20,10,9,6,5,10,16,62.5,6,12,0,12,15,35,8,1,Matches
2054,Juan Pérez,ESP,GK,Osasuna,La Liga,24,1996,3.0,0,0,0,0,0,0,0,,0,0,0,0,0,0,1,0,Matches
2055,Kike Pérez,ESP,MF,Valladolid,La Liga,23,1997,12.9,26,19,8,14,4,7,33,21.2,26,10,1,9,17,43,18,0,Matches
2056,Lucas Pérez,ESP,FW,Alavés,La Liga,31,1988,19.5,6,2,3,3,0,2,10,20.0,8,6,1,5,2,8,5,0,Matches
2057,Luis Pérez,ESP,DF,Valladolid,La Liga,25,1995,14.4,33,17,16,17,0,18,30,60.0,12,26,8,18,14,47,54,1,Matches
2058,Manuel Perez,FRA,"MF,FW",Lens,Ligue 1,29,1991,1.4,1,0,1,0,0,0,8,0.0,8,2,0,2,2,3,2,0,Matches
2059,Nehuén Pérez,ARG,DF,Granada,La Liga,20,2000,8.2,6,3,6,0,0,4,6,66.7,2,5,4,1,12,18,33,0,Matches
2060,Mattia Perin,ITA,GK,Genoa,Serie A,27,1992,32.0,0,0,0,0,0,0,0,,0,0,0,0,1,1,6,0,Matches
2061,Ivan Perišić,CRO,"DF,FW",Inter,Serie A,31,1989,19.9,22,13,11,6,5,12,33,36.4,21,33,4,29,19,41,36,1,Matches
2062,Romain Perraud,FRA,DF,Brest,Ligue 1,22,1997,34.9,60,34,42,16,2,24,45,53.3,21,36,3,33,45,105,76,0,Matches
2063,Lucas Perrin,FRA,DF,Marseille,Ligue 1,21,1998,3.4,7,4,4,3,0,5,12,41.7,7,5,4,1,8,15,16,0,Matches
2064,Pavao Pervan,AUT,GK,Wolfsburg,Bundesliga,32,1987,2.0,0,0,0,0,0,0,0,,0,0,0,0,0,0,1,0,Matches
2065,Matteo Pessina,ITA,MF,Atalanta,Serie A,23,1997,18.3,14,7,4,6,4,7,24,29.2,17,17,2,15,17,31,7,1,Matches
2066,Andrea Petagna,ITA,FW,Napoli,Serie A,25,1995,10.7,2,0,0,2,0,2,7,28.6,5,4,0,4,1,3,7,0,Matches
2067,Nils Petersen,GER,FW,Freiburg,Bundesliga,31,1988,14.5,11,7,2,6,3,3,21,14.3,18,25,1,24,9,20,28,0,Matches
2068,Lukas Petkov,BUL,MF,Augsburg,Bundesliga,19,2000,0.0,0,0,0,0,0,0,0,,0,0,0,0,0,0,0,0,Matches
2069,Jacopo Petriccione,ITA,MF,Crotone,Serie A,25,1995,10.6,14,8,6,7,1,9,24,37.5,15,11,2,9,8,22,11,0,Matches
2070,Jens Petter Hauge,NOR,FW,Milan,Serie A,20,1999,5.9,7,4,3,3,1,6,10,60.0,4,4,0,4,1,8,3,0,Matches
2071,Germán Pezzella,ARG,DF,Fiorentina,Serie A,29,1991,30.5,34,20,22,12,0,18,32,56.3,14,26,14,12,36,70,109,1,Matches
2072,Giuseppe Pezzella,ITA,DF,Parma,Serie A,22,1997,20.3,34,19,23,9,2,22,41,53.7,19,22,9,13,12,46,52,3,Matches
2073,Maximilian Philipp,GER,MF,Wolfsburg,Bundesliga,26,1994,12.3,15,6,3,6,6,5,21,23.8,16,17,0,17,6,21,3,0,Matches
2074,Rayan Philippe,FRA,FW,Dijon,Ligue 1,19,2000,1.0,3,1,1,1,1,2,2,100.0,0,0,0,0,0,3,0,0,Matches
2075,Romain Philippoteaux,FRA,"FW,MF",Nîmes,Ligue 1,32,1988,2.4,1,1,1,0,0,1,5,20.0,4,2,0,2,2,3,1,0,Matches
2076,Romain Philippoteaux,FRA,"MF,FW",Brest,Ligue 1,32,1988,6.5,11,6,6,3,2,6,9,66.7,3,4,0,4,10,21,2,0,Matches
2077,Kalvin Phillips,ENG,MF,Leeds United,Premier League,24,1995,27.0,74,38,38,29,7,26,62,41.9,36,49,14,35,45,119,53,3,Matches
2078,Matt Phillips,SCO,MF,West Brom,Premier League,29,1991,20.3,15,8,4,11,0,7,23,30.4,16,32,4,28,10,25,32,1,Matches
2079,Nathaniel Phillips,ENG,DF,Liverpool,Premier League,23,1997,16.2,22,14,15,7,0,11,24,45.8,13,17,14,3,20,42,81,0,Matches
2080,Jaden Philogene Bidace,ENG,FW,Aston Villa,Premier League,18,2002,0.0,0,0,0,0,0,0,0,,0,0,0,0,0,0,0,0,Matches
2081,Krzysztof Piątek,POL,FW,Hertha BSC,Bundesliga,25,1995,18.1,9,4,1,7,1,3,22,13.6,19,11,0,11,6,15,14,0,Matches
2082,Pablo Piatti,ARG,"MF,FW",Elche,La Liga,31,1989,4.0,8,6,3,3,2,3,12,25.0,9,5,0,5,2,10,1,0,Matches
2083,Cristiano Piccini,ITA,DF,Atalanta,Serie A,27,1992,0.7,1,1,1,0,0,0,1,0.0,1,1,0,1,0,1,0,0,Matches
2084,Cristiano Piccini,ITA,DF,Valencia,La Liga,27,1992,0.7,1,1,1,0,0,1,2,50.0,1,0,0,0,0,1,3,0,Matches
2085,Roberto Piccoli,ITA,FW,Spezia,Serie A,19,2001,7.8,7,3,0,4,3,2,4,50.0,2,4,0,4,2,9,5,0,Matches
2086,Jordan Pickford,ENG,GK,Everton,Premier League,26,1994,30.5,0,0,0,0,0,0,2,0.0,2,2,0,2,3,3,16,4,Matches
2087,Jérémy Pied,FRA,DF,Lille,Ligue 1,31,1989,3.5,7,0,3,3,1,4,9,44.4,5,3,1,2,6,13,8,0,Matches
2088,Amos Pieper,GER,DF,Arminia,Bundesliga,22,1998,29.8,58,32,39,17,2,20,33,60.6,13,48,35,13,66,124,160,3,Matches
2089,Ronaël Pierre-Gabriel,FRA,DF,Brest,Ligue 1,22,1998,25.6,60,40,42,16,2,35,52,67.3,17,17,7,10,30,90,57,0,Matches
2090,Erik Pieters,NED,"DF,MF",Burnley,Premier League,31,1988,14.1,30,21,18,9,3,19,39,48.7,20,30,9,21,12,42,34,0,Matches
2091,Tomás Pina Isla,ESP,MF,Alavés,La Liga,32,1987,28.6,39,18,18,16,5,16,42,38.1,26,28,8,20,37,76,42,0,Matches
2092,Andrea Pinamonti,ITA,FW,Inter,Serie A,21,1999,1.9,0,0,0,0,0,0,0,,0,1,0,1,1,1,2,0,Matches
2093,Yeremi Pino,ESP,"FW,MF",Villarreal,La Liga,17,2002,8.9,19,11,10,7,2,8,28,28.6,20,20,1,19,9,28,8,0,Matches
2094,Carlo Pinsoglio,ITA,GK,Juventus,Serie A,30,1990,0.3,0,0,0,0,0,0,0,,0,0,0,0,0,0,0,0,Matches
2095,Gerard Piqué,ESP,DF,Barcelona,La Liga,33,1987,16.5,16,11,11,5,0,9,12,75.0,3,9,4,5,26,42,46,0,Matches
2096,Fabio Pisacane,ITA,DF,Cagliari,Serie A,34,1986,2.5,3,2,2,1,0,3,7,42.9,4,8,5,3,1,4,9,1,Matches
2097,Łukasz Piszczek,POL,DF,Dortmund,Bundesliga,35,1985,5.1,10,7,6,4,0,5,12,41.7,7,5,1,4,5,15,12,0,Matches
2098,Marko Pjaca,CRO,"FW,MF",Genoa,Serie A,25,1995,15.8,13,6,6,3,4,4,16,25.0,12,7,2,5,7,20,12,0,Matches
2099,Miralem Pjanić,BIH,MF,Barcelona,La Liga,30,1990,7.0,13,8,7,4,2,7,13,53.8,6,5,1,4,11,24,5,0,Matches
2100,Óscar Plano,ESP,"MF,FW",Valladolid,La Liga,29,1991,28.0,42,24,24,12,6,14,46,30.4,32,35,6,29,34,76,43,0,Matches
2101,Marvin Plattenhardt,GER,DF,Hertha BSC,Bundesliga,28,1992,11.9,15,10,6,7,2,5,9,55.6,4,9,1,8,1,16,19,1,Matches
2102,Alassane Pléa,FRA,FW,Gladbach,Bundesliga,27,1993,20.0,19,9,4,10,5,5,20,25.0,15,1,0,1,5,24,7,0,Matches
2103,Dani Plomer,ESP,FW,Granada,La Liga,21,1998,0.5,0,0,0,0,0,0,1,0.0,1,0,0,0,0,0,1,0,Matches
2104,Tommaso Pobega,ITA,MF,Spezia,Serie A,21,1999,13.7,24,13,7,13,4,11,31,35.5,20,10,2,8,9,33,22,0,Matches
2105,Daniel Podence,POR,"MF,FW",Wolves,Premier League,24,1995,18.5,12,6,5,5,2,2,19,10.5,17,5,1,4,13,25,2,0,Matches
2106,Paul Pogba,FRA,"MF,FW",Manchester Utd,Premier League,27,1993,21.1,36,26,15,16,5,11,33,33.3,22,24,2,22,26,62,37,0,Matches
2107,Joel Pohjanpalo,FIN,FW,Union Berlin,Bundesliga,25,1994,9.5,5,1,0,3,2,1,6,16.7,5,1,0,1,1,6,12,0,Matches
2108,Joel Pohjanpalo,FIN,MF,Leverkusen,Bundesliga,25,1994,0.1,0,0,0,0,0,0,0,,0,0,0,0,0,0,0,0,Matches
2109,Andrea Poli,ITA,MF,Bologna,Serie A,30,1989,4.3,9,7,4,2,3,6,12,50.0,6,7,1,6,7,16,7,0,Matches
2110,Matteo Politano,ITA,"FW,MF",Napoli,Serie A,26,1993,21.2,24,16,13,9,2,11,47,23.4,36,14,1,13,14,38,18,0,Matches
2111,Jorge Pombo,ESP,"FW,MF",Cádiz,La Liga,26,1994,5.8,7,3,3,2,2,1,8,12.5,7,2,0,2,2,9,3,0,Matches
2112,Marin Pongračić,CRO,DF,Wolfsburg,Bundesliga,22,1997,6.4,13,9,9,3,1,6,8,75.0,2,12,5,7,11,24,27,0,Matches
2113,Pere Pons,ESP,MF,Alavés,La Liga,27,1993,13.2,20,10,8,8,4,5,16,31.3,11,15,2,13,7,27,10,0,Matches
2114,Nick Pope,ENG,GK,Burnley,Premier League,28,1992,32.0,1,1,1,0,0,0,1,0.0,1,0,0,0,2,3,29,2,Matches
2115,Manolo Portanova,ITA,"MF,FW",Genoa,Serie A,20,2000,0.7,3,3,1,1,1,0,2,0.0,2,3,1,2,1,4,2,0,Matches
2116,Manolo Portanova,ITA,MF,Juventus,Serie A,20,2000,0.8,2,0,2,0,0,0,2,0.0,2,4,1,3,0,2,1,0,Matches
2117,Francisco Portillo,ESP,"MF,FW",Getafe,La Liga,30,1990,4.6,5,3,1,4,0,2,14,14.3,12,3,0,3,5,10,1,0,Matches
2118,Portu,ESP,"FW,MF",Real Sociedad,La Liga,28,1992,24.3,18,8,4,10,4,7,36,19.4,29,24,2,22,8,26,5,0,Matches
2119,Stefan Posch,AUT,DF,Hoffenheim,Bundesliga,23,1997,23.5,52,24,29,17,6,27,47,57.4,20,27,8,19,37,89,73,1,Matches
2120,Sergio Postigo,ESP,DF,Levante,La Liga,31,1988,18.0,16,12,12,3,1,7,18,38.9,11,21,10,11,33,49,84,1,Matches
2121,Yussuf Poulsen,DEN,FW,RB Leipzig,Bundesliga,26,1994,15.0,10,6,1,6,3,1,17,5.9,16,16,0,16,6,16,13,0,Matches
2122,Maxime Poundjé,FRA,DF,Bordeaux,Ligue 1,27,1992,5.5,10,7,9,1,0,2,6,33.3,4,7,3,4,11,21,5,0,Matches
2123,Darío Poveda,ESP,FW,Getafe,La Liga,23,1997,0.1,0,0,0,0,0,0,0,,0,1,0,1,0,0,0,0,Matches
2124,Ian Poveda,ENG,MF,Leeds United,Premier League,20,2000,3.9,5,4,3,0,2,1,7,14.3,6,5,1,4,1,6,2,0,Matches
2125,Alejandro Pozo Pozo,ESP,"DF,MF",Eibar,La Liga,21,1999,24.3,38,22,17,15,6,17,38,44.7,21,35,2,33,27,65,40,1,Matches
2126,Dennis Praet,BEL,MF,Leicester City,Premier League,26,1994,8.0,14,7,4,7,3,6,15,40.0,9,12,2,10,7,21,3,0,Matches
2127,Sanjin Prcić,BIH,MF,Strasbourg,Ligue 1,26,1993,3.9,3,2,0,3,0,2,5,40.0,3,4,3,1,4,7,2,1,Matches
2128,Nicolas de Préville,FRA,"FW,MF",Bordeaux,Ligue 1,29,1991,17.9,19,14,7,6,6,9,42,21.4,33,15,0,15,13,32,7,0,Matches
2129,Manuel Prietl,AUT,MF,Arminia,Bundesliga,28,1991,28.0,65,44,33,28,4,12,73,16.4,61,34,7,27,45,110,24,0,Matches
2130,Grischa Prömel,GER,MF,Union Berlin,Bundesliga,25,1995,20.2,39,23,14,23,2,18,34,52.9,16,20,2,18,24,63,22,0,Matches
2131,Davy Pröpper,NED,MF,Brighton,Premier League,28,1991,2.4,6,5,0,6,0,2,5,40.0,3,3,0,3,1,7,0,0,Matches
2132,Ivan Provedel,ITA,GK,Spezia,Serie A,26,1994,29.0,2,0,2,0,0,2,6,33.3,4,0,0,0,2,4,20,1,Matches
2133,Antonio Puertas,ESP,"FW,MF",Granada,La Liga,28,1992,24.1,27,13,9,12,6,10,32,31.3,22,24,5,19,12,39,25,0,Matches
2134,Riqui Puig,ESP,"MF,FW",Barcelona,La Liga,20,1999,3.2,5,3,1,3,1,4,8,50.0,4,0,0,0,1,6,0,0,Matches
2135,Erick Pulgar,CHI,MF,Fiorentina,Serie A,26,1994,22.2,41,18,17,23,1,22,49,44.9,27,24,10,14,41,82,45,1,Matches
2136,Jorge Pulido,ESP,DF,Huesca,La Liga,29,1991,32.1,39,24,31,8,0,17,29,58.6,12,32,18,14,52,91,98,0,Matches
2137,Christian Pulisic,USA,"FW,MF",Chelsea,Premier League,21,1998,19.3,19,11,8,10,1,8,21,38.1,13,25,2,23,12,31,9,0,Matches
2138,Ignacio Pussetto,ARG,FW,Udinese,Serie A,24,1995,8.4,16,8,5,6,5,6,17,35.3,11,14,0,14,13,29,6,0,Matches
2139,Fabio Quagliarella,ITA,FW,Sampdoria,Serie A,37,1983,24.5,12,8,4,4,4,2,19,10.5,17,14,1,13,7,19,10,0,Matches
2140,Robin Quaison,SWE,"FW,MF",Mainz 05,Bundesliga,26,1993,16.4,14,6,3,6,5,7,14,50.0,7,10,0,10,13,27,10,0,Matches
2141,Domingos Quina,POR,MF,Granada,La Liga,20,1999,3.8,5,5,1,3,1,3,6,50.0,3,8,0,8,2,7,0,0,Matches
2142,Quini,ESP,DF,Granada,La Liga,30,1989,13.2,33,22,23,7,3,19,36,52.8,17,15,6,9,15,48,39,0,Matches
2143,Quique,ESP,"FW,MF",Eibar,La Liga,30,1990,1.9,0,0,0,0,0,0,1,0.0,1,2,0,2,0,0,0,0,Matches
2144,Dani Raba,ESP,"MF,FW",Villarreal,La Liga,24,1995,1.7,2,1,0,1,1,2,8,25.0,6,1,0,1,0,2,0,0,Matches
2145,Simone Rabbi,ITA,"FW,DF",Bologna,Serie A,18,2001,0.4,0,0,0,0,0,0,1,0.0,1,0,0,0,0,0,0,0,Matches
2146,Adrien Rabiot,FRA,MF,Juventus,Serie A,25,1995,25.7,72,42,24,41,7,28,60,46.7,32,32,11,21,43,115,29,1,Matches
2147,Uroš Račić,SRB,MF,Valencia,La Liga,22,1998,24.3,38,22,16,16,6,16,54,29.6,38,33,11,22,26,64,54,0,Matches
2148,Anthony Racioppi,SUI,GK,Dijon,Ligue 1,21,1998,21.0,0,0,0,0,0,0,2,0.0,2,0,0,0,2,2,12,4,Matches
2149,Nemanja Radoja,SRB,MF,Levante,La Liga,27,1993,12.5,23,15,12,10,1,5,19,26.3,14,9,3,6,19,42,12,1,Matches
2150,Nemanja Radonjić,SRB,FW,Marseille,Ligue 1,24,1996,4.4,6,5,1,2,3,2,12,16.7,10,8,0,8,3,9,1,0,Matches
2151,Nemanja Radonjić,SRB,"FW,MF",Hertha BSC,Bundesliga,24,1996,6.8,5,3,2,2,1,1,5,20.0,4,1,0,1,2,7,1,0,Matches
2152,Aleksandar Radovanović,SRB,DF,Lens,Ligue 1,26,1993,1.0,1,1,0,1,0,0,0,,0,2,1,1,0,1,2,0,Matches
2153,Ivan Radovanović,SRB,"DF,MF",Genoa,Serie A,31,1988,24.8,18,15,13,5,0,12,31,38.7,19,39,21,18,37,55,114,2,Matches
2154,Ionuț Radu,ROU,GK,Inter,Serie A,23,1997,1.5,0,0,0,0,0,0,0,,0,0,0,0,0,0,1,0,Matches
2155,Ștefan Radu,ROU,DF,Lazio,Serie A,33,1986,27.3,43,24,20,19,4,25,40,62.5,15,27,14,13,45,88,73,1,Matches
2156,Rafael,BRA,GK,Spezia,Serie A,38,1982,2.3,0,0,0,0,0,0,0,,0,0,0,0,0,0,0,0,Matches
2157,Rafinha,BRA,"MF,FW",Paris S-G,Ligue 1,27,1993,15.1,54,26,18,28,8,28,49,57.1,21,18,3,15,13,67,6,0,Matches
2158,Antonio Raimondo,ITA,FW,Bologna,Serie A,16,2004,0.0,0,0,0,0,0,0,0,,0,0,0,0,0,0,0,0,Matches
2159,Predrag Rajković,SRB,GK,Reims,Ligue 1,24,1995,36.5,2,1,2,0,0,2,5,40.0,3,1,0,1,2,4,17,3,Matches
2160,Ivan Rakitić,CRO,MF,Sevilla,La Liga,32,1988,24.8,32,18,18,10,4,12,41,29.3,29,19,4,15,26,58,29,1,Matches
2161,Jonás Ramalho,ESP,DF,Osasuna,La Liga,27,1993,3.4,5,4,4,0,1,1,3,33.3,2,3,0,3,2,7,7,0,Matches
2162,Benito Raman,BEL,"FW,MF",Schalke 04,Bundesliga,25,1994,13.8,19,13,11,6,2,6,29,20.7,23,11,0,11,5,24,5,0,Matches
2163,Gastón Ramírez,URU,"FW,MF",Sampdoria,Serie A,29,1990,10.8,31,15,10,17,4,8,27,29.6,19,19,3,16,4,35,13,0,Matches
2164,Sandro Ramírez,ESP,FW,Huesca,La Liga,25,1995,14.3,13,9,3,8,2,4,11,36.4,7,11,1,10,10,23,2,0,Matches
2165,Sergio Ramos,ESP,DF,Real Madrid,La Liga,34,1986,14.2,15,12,8,6,1,6,10,60.0,4,9,5,4,19,34,39,1,Matches
2166,Aaron Ramsdale,ENG,GK,Sheffield Utd,Premier League,22,1998,38.0,1,1,1,0,0,1,1,100.0,0,0,0,0,2,3,22,6,Matches
2167,Aaron Ramsey,WAL,MF,Juventus,Serie A,29,1990,12.1,22,14,8,13,1,8,25,32.0,17,13,2,11,7,29,8,2,Matches
2168,Jacob Ramsey,ENG,MF,Aston Villa,Premier League,19,2001,7.0,10,5,3,4,3,2,12,16.7,10,13,6,7,4,14,5,0,Matches
2169,Kayne Ramsey,ENG,DF,Southampton,Premier League,19,2000,1.0,5,2,4,1,0,3,3,100.0,0,0,0,0,0,5,3,0,Matches
2170,Darren Randolph,IRL,GK,West Ham,Premier League,33,1987,3.0,0,0,0,0,0,0,0,,0,0,0,0,0,0,1,0,Matches
2171,Andrea Ranocchia,ITA,DF,Inter,Serie A,32,1988,7.8,13,10,6,6,1,7,8,87.5,1,5,3,2,12,25,19,0,Matches
2172,Raphinha,BRA,"MF,FW",Leeds United,Premier League,23,1996,26.2,34,17,13,16,5,12,58,20.7,46,31,1,30,29,63,27,0,Matches
2173,Raphinha,BRA,"FW,MF",Rennes,Ligue 1,23,1996,4.5,5,2,1,3,1,1,4,25.0,3,5,0,5,3,8,4,0,Matches
2174,Marcus Rashford,ENG,FW,Manchester Utd,Premier League,22,1997,32.4,18,9,2,8,8,7,27,25.9,20,22,2,20,8,26,10,0,Matches
2175,Milot Rashica,KVX,"FW,MF",Werder Bremen,Bundesliga,24,1996,16.2,24,12,11,11,2,12,23,52.2,11,7,0,7,4,28,6,0,Matches
2176,Giacomo Raspadori,ITA,"FW,MF",Sassuolo,Serie A,20,2000,13.7,5,3,1,1,3,0,4,0.0,4,13,5,8,2,7,9,0,Matches
2177,Federico Ravaglia,ITA,GK,Bologna,Serie A,20,1999,4.0,0,0,0,0,0,0,1,0.0,1,0,0,0,0,0,2,0,Matches
2178,Tim Ream,USA,DF,Fulham,Premier League,32,1987,7.0,12,5,9,3,0,8,11,72.7,3,8,5,3,6,18,26,1,Matches
2179,Ante Rebić,CRO,FW,Milan,Serie A,26,1993,19.7,26,9,4,8,14,8,37,21.6,29,21,1,20,7,33,17,0,Matches
2180,Arkadiusz Reca,POL,DF,Crotone,Serie A,25,1995,25.7,34,16,15,11,8,10,45,22.2,35,30,3,27,50,84,64,0,Matches
2181,Recio,ESP,MF,Eibar,La Liga,29,1991,8.2,17,5,4,8,5,8,18,44.4,10,6,0,6,4,21,1,0,Matches
2182,Daishawn Redan,NED,"FW,MF",Hertha BSC,Bundesliga,19,2001,1.1,0,0,0,0,0,0,0,,0,1,0,1,0,0,0,0,Matches
2183,Nathan Redmond,ENG,"MF,FW",Southampton,Premier League,26,1994,19.3,30,17,14,12,4,8,24,33.3,16,24,2,22,11,41,9,0,Matches
2184,Harrison Reed,ENG,MF,Fulham,Premier League,25,1995,25.0,63,38,28,28,7,29,73,39.7,44,34,11,23,50,113,31,1,Matches
2185,Vasco Regini,ITA,DF,Sampdoria,Serie A,29,1990,1.0,2,2,2,0,0,2,2,100.0,0,1,1,0,1,3,5,0,Matches
2186,Sergio Reguilón,ESP,DF,Tottenham,Premier League,23,1996,24.9,47,25,30,13,4,23,48,47.9,25,39,7,32,32,79,50,1,Matches
2187,Bobby Reid,JAM,"MF,FW",Fulham,Premier League,27,1993,26.4,31,15,17,10,4,18,39,46.2,21,19,5,14,21,52,39,0,Matches
2188,Pepe Reina,ESP,GK,Lazio,Serie A,37,1982,29.0,0,0,0,0,0,0,1,0.0,1,0,0,0,1,1,6,0,Matches
2189,Jeff Reine-Adélaïde,FRA,"MF,FW",Nice,Ligue 1,22,1998,11.8,7,4,1,4,2,2,9,22.2,7,10,1,9,4,11,6,0,Matches
2190,Jeff Reine-Adélaïde,FRA,FW,Lyon,Ligue 1,22,1998,0.3,0,0,0,0,0,0,0,,0,0,0,0,0,0,0,0,Matches
2191,Reinier,BRA,"MF,FW",Dortmund,Bundesliga,18,2002,2.9,9,4,6,1,2,2,4,50.0,2,4,1,3,2,11,0,0,Matches
2192,Francisco Reis Ferreira,POR,DF,Valencia,La Liga,23,1997,2.0,1,1,1,0,0,0,3,0.0,3,0,0,0,0,1,6,0,Matches
2193,Rocco Reitz,GER,MF,Gladbach,Bundesliga,18,2002,0.7,3,2,0,3,0,2,2,100.0,0,3,1,2,1,4,1,0,Matches
2194,Karim Rekik,NED,DF,Sevilla,La Liga,25,1994,7.3,7,5,2,5,0,1,4,25.0,3,8,3,5,6,13,17,0,Matches
2195,Álex Remiro,ESP,GK,Real Sociedad,La Liga,25,1995,38.0,0,0,0,0,0,0,1,0.0,1,0,0,0,3,3,14,0,Matches
2196,Panagiotis Retsos,GRE,DF,Saint-Étienne,Ligue 1,21,1998,3.0,5,3,5,0,0,3,7,42.9,4,1,1,0,3,8,12,0,Matches
2197,Marco Reus,GER,"MF,FW",Dortmund,Bundesliga,31,1989,25.3,33,16,9,16,8,9,33,27.3,24,22,2,20,14,47,13,0,Matches
2198,Elvis Rexhbeçaj,GER,"MF,FW",Köln,Bundesliga,22,1997,20.4,53,32,17,27,9,19,53,35.8,34,32,7,25,26,79,18,0,Matches
2199,Oriol Rey,ESP,MF,Valladolid,La Liga,22,1998,0.2,0,0,0,0,0,0,0,,0,0,0,0,1,1,0,0,Matches
2200,Gio Reyna,USA,"MF,FW",Dortmund,Bundesliga,17,2002,22.0,24,13,9,8,7,9,25,36.0,16,14,1,13,10,34,11,0,Matches
2201,Baptiste Reynet,FRA,GK,Nîmes,Ligue 1,29,1990,38.0,2,1,2,0,0,2,4,50.0,2,1,0,1,1,3,9,2,Matches
2202,Bryan Reynolds,USA,DF,Roma,Serie A,19,2001,3.1,4,2,1,1,2,1,5,20.0,4,4,0,4,6,10,4,0,Matches
2203,Franck Ribéry,FRA,FW,Fiorentina,Serie A,37,1983,23.9,24,11,4,9,11,5,29,17.2,24,11,2,9,3,27,1,0,Matches
2204,Federico Ricci,ITA,FW,Sassuolo,Serie A,26,1994,0.0,0,0,0,0,0,0,0,,0,0,0,0,0,0,0,0,Matches
2205,Giacomo Ricci,ITA,DF,Parma,Serie A,23,1996,0.7,3,1,1,2,0,0,0,,0,2,2,0,1,4,4,0,Matches
2206,Matteo Ricci,ITA,MF,Spezia,Serie A,26,1994,24.8,40,23,14,24,2,27,52,51.9,25,24,4,20,34,74,13,0,Matches
2207,Declan Rice,ENG,MF,West Ham,Premier League,21,1999,32.0,59,35,33,25,1,21,51,41.2,30,39,11,28,59,118,41,0,Matches
2208,Chris Richards,USA,DF,Hoffenheim,Bundesliga,20,2000,10.5,19,8,12,6,1,10,16,62.5,6,13,4,9,21,40,40,1,Matches
2209,Chris Richards,USA,DF,Bayern Munich,Bundesliga,20,2000,1.0,0,0,0,0,0,0,0,,0,0,0,0,1,1,1,0,Matches
2210,Lewis Richardson,ENG,"FW,MF",Burnley,Premier League,17,2003,0.0,0,0,0,0,0,0,0,,0,0,0,0,0,0,0,0,Matches
2211,Richarlison,BRA,FW,Everton,Premier League,23,1997,31.8,50,32,21,22,7,16,51,31.4,35,28,3,25,14,64,36,1,Matches
2212,Marco Richter,GER,"FW,MF",Augsburg,Bundesliga,22,1997,15.7,17,9,3,12,2,7,23,30.4,16,10,0,10,6,23,9,0,Matches
2213,Mikel Rico,ESP,MF,Huesca,La Liga,35,1984,24.3,24,12,14,8,2,11,34,32.4,23,20,3,17,23,47,22,0,Matches
2214,Sergio Rico,ESP,GK,Paris S-G,Ligue 1,26,1993,9.0,0,0,0,0,0,0,0,,0,0,0,0,0,0,1,0,Matches
2215,Jaïro Riedewald,NED,MF,Crystal Palace,Premier League,23,1996,20.2,34,15,13,17,4,16,36,44.4,20,39,7,32,29,63,25,0,Matches
2216,Emiliano Rigoni,ARG,MF,Elche,La Liga,27,1993,12.7,12,7,3,8,1,3,15,20.0,12,16,1,15,6,18,9,0,Matches
2217,Tomás Rincón,VEN,MF,Torino,Serie A,32,1988,31.6,68,38,27,33,8,36,71,50.7,35,32,7,25,31,99,44,0,Matches
2218,Luis Rioja,ESP,"MF,FW",Alavés,La Liga,26,1993,23.2,21,14,11,7,3,7,39,17.9,32,23,1,22,20,41,30,0,Matches
2219,Renaud Ripart,FRA,"MF,FW",Nîmes,Ligue 1,27,1993,33.9,52,30,25,19,8,26,84,31.0,58,58,12,46,36,88,53,0,Matches
2220,Andrea Rispoli,ITA,DF,Crotone,Serie A,31,1988,7.2,6,3,2,3,1,2,7,28.6,5,12,3,9,5,11,15,1,Matches
2221,Mihailo Ristić,SRB,DF,Montpellier,Ligue 1,24,1995,24.8,45,22,25,13,7,28,44,63.6,16,30,9,21,26,71,57,0,Matches
2222,Matt Ritchie,SCO,"DF,MF",Newcastle Utd,Premier League,30,1989,15.0,10,3,5,3,2,3,17,17.6,14,17,2,15,12,22,47,0,Matches
2223,Maxence Rivera,FRA,"MF,FW",Saint-Étienne,Ligue 1,18,2002,2.7,12,10,6,4,2,4,10,40.0,6,5,0,5,1,13,0,0,Matches
2224,Emmanuel Rivière,FRA,FW,Crotone,Serie A,30,1990,7.1,2,1,2,0,0,0,3,0.0,3,5,1,4,1,3,0,0,Matches
2225,Rober,ESP,"DF,MF",Levante,La Liga,25,1995,15.8,14,7,8,3,3,8,18,44.4,10,24,16,8,35,49,52,1,Matches
2226,Roberto,ESP,GK,Valladolid,La Liga,34,1986,13.0,0,0,0,0,0,0,1,0.0,1,0,0,0,0,0,7,0,Matches
2227,Sergi Roberto,ESP,"DF,FW",Barcelona,La Liga,28,1992,10.5,9,6,5,2,2,7,13,53.8,6,12,6,6,10,19,20,0,Matches
2228,Tyler Roberts,WAL,"MF,FW",Leeds United,Premier League,21,1999,14.9,15,13,1,11,3,5,22,22.7,17,17,2,15,9,24,12,0,Matches
2229,Andrew Robertson,SCO,DF,Liverpool,Premier League,26,1994,37.6,46,34,23,18,5,28,57,49.1,29,39,9,30,21,67,79,1,Matches
2230,Antonee Robinson,USA,DF,Fulham,Premier League,22,1997,24.0,45,28,24,16,5,27,44,61.4,17,21,4,17,37,82,68,0,Matches
2231,Callum Robinson,IRL,"FW,MF",West Brom,Premier League,25,1995,17.3,7,5,5,1,1,3,19,15.8,16,9,0,9,7,14,8,0,Matches
2232,Jack Robinson,ENG,DF,Sheffield Utd,Premier League,26,1993,9.7,14,6,8,5,1,6,11,54.5,5,10,4,6,9,23,42,0,Matches
2233,Joel Robles,ESP,GK,Betis,La Liga,30,1990,18.0,0,0,0,0,0,0,1,0.0,1,1,0,1,0,0,11,2,Matches
2234,Hal Robson-Kanu,WAL,FW,West Brom,Premier League,31,1989,6.2,2,1,1,0,1,0,1,0.0,1,2,0,2,2,4,7,0,Matches
2235,Marc Roca,ESP,MF,Bayern Munich,Bundesliga,23,1996,2.0,2,2,0,0,2,0,4,0.0,4,4,1,3,2,4,1,0,Matches
2236,Christopher Rocchia,FRA,"DF,FW",Marseille,Ligue 1,22,1998,0.2,1,0,1,0,0,0,2,0.0,2,0,0,0,0,1,1,0,Matches
2237,Rubén Rochina,ESP,MF,Levante,La Liga,29,1991,15.6,38,28,12,23,3,12,35,34.3,23,22,2,20,22,60,7,0,Matches
2238,Marek Rodák,SVK,GK,Fulham,Premier League,23,1996,2.0,0,0,0,0,0,0,0,,0,0,0,0,0,0,0,0,Matches
2239,Sebastian Rode,GER,MF,Eint Frankfurt,Bundesliga,29,1990,18.1,44,25,21,16,7,14,46,30.4,32,30,3,27,47,91,18,0,Matches
2240,Joe Rodon,WAL,DF,Tottenham,Premier League,22,1997,8.1,14,9,11,2,1,3,4,75.0,1,10,8,2,21,35,36,2,Matches
2241,Rodri,ESP,MF,Manchester City,Premier League,24,1996,30.5,72,40,24,40,8,33,66,50.0,33,23,9,14,36,108,54,3,Matches
2242,Rodri,ESP,"FW,MF",Betis,La Liga,20,2000,6.0,3,3,1,2,0,1,6,16.7,5,7,0,7,2,5,0,0,Matches
2243,Rodrigo,ESP,"MF,FW",Leeds United,Premier League,29,1991,14.3,14,7,8,3,3,4,22,18.2,18,7,0,7,5,19,16,0,Matches
2244,Kévin Rodrigues,POR,"DF,MF",Eibar,La Liga,26,1994,12.2,16,8,8,5,3,7,23,30.4,16,10,1,9,20,36,15,1,Matches
2245,Ángel Rodríguez,ESP,"FW,MF",Getafe,La Liga,33,1987,15.3,7,4,1,4,2,1,16,6.3,15,7,0,7,2,9,8,0,Matches
2246,Óscar Rodríguez Arnaiz,ESP,"MF,FW",Sevilla,La Liga,22,1998,5.7,15,9,3,8,4,6,13,46.2,7,2,0,2,10,25,1,0,Matches
2247,Guido Rodríguez,ARG,MF,Betis,La Liga,26,1994,31.8,98,56,52,40,6,40,85,47.1,45,52,14,38,68,166,58,2,Matches
2248,James Rodríguez,COL,"FW,MF",Everton,Premier League,29,1991,19.6,28,17,8,15,5,11,46,23.9,35,17,0,17,15,43,3,0,Matches
2249,Jay Rodriguez,ENG,FW,Burnley,Premier League,31,1989,14.1,25,16,5,15,5,13,28,46.4,15,25,4,21,2,27,7,0,Matches
2250,Miguel Rodríguez,ESP,"FW,DF",Celta Vigo,La Liga,17,2003,0.3,1,1,0,1,0,0,0,,0,0,0,0,0,1,0,0,Matches
2251,Ricardo Rodríguez,SUI,DF,Torino,Serie A,27,1992,13.8,21,14,11,8,2,13,22,59.1,9,16,5,11,20,41,43,0,Matches
2252,Víctor Rodríguez,ESP,MF,Elche,La Liga,31,1989,4.7,4,3,3,1,0,0,9,0.0,9,5,1,4,5,9,4,0,Matches
2253,Rodrygo,BRA,FW,Real Madrid,La Liga,19,2001,10.9,15,6,10,4,1,2,17,11.8,15,15,0,15,7,22,4,0,Matches
2254,Marko Rog,CRO,MF,Cagliari,Serie A,25,1995,12.9,40,24,15,22,3,16,37,43.2,21,17,6,11,19,59,15,0,Matches
2255,Rogério,BRA,DF,Sassuolo,Serie A,22,1998,20.9,26,13,19,5,2,19,27,70.4,8,26,5,21,31,57,53,0,Matches
2256,Luis Rojas,CHI,"MF,FW",Crotone,Serie A,18,2002,1.2,1,0,0,1,0,1,2,50.0,1,2,0,2,1,2,0,0,Matches
2257,Alessio Romagnoli,ITA,DF,Milan,Serie A,25,1995,21.2,17,7,8,7,2,8,19,42.1,11,29,22,7,24,41,80,0,Matches
2258,Cristian Romero,ARG,DF,Atalanta,Serie A,22,1998,28.3,63,32,41,19,3,27,49,55.1,22,31,13,18,96,159,71,2,Matches
2259,Oriol Romeu,ESP,MF,Southampton,Premier League,28,1991,19.6,69,35,25,39,5,26,68,38.2,42,28,7,21,30,99,18,0,Matches
2260,Cristiano Ronaldo,POR,FW,Juventus,Serie A,35,1985,31.1,6,3,1,3,2,3,15,20.0,12,11,3,8,5,11,15,1,Matches
2261,Facundo Roncaglia,ARG,DF,Osasuna,La Liga,33,1987,13.7,25,14,14,11,0,11,20,55.0,9,11,6,5,25,50,26,0,Matches
2262,Valentin Rongier,FRA,MF,Marseille,Ligue 1,25,1994,21.0,93,59,31,55,7,43,85,50.6,42,32,2,30,28,121,21,1,Matches
2263,Marten de Roon,NED,MF,Atalanta,Serie A,29,1991,33.6,80,48,30,36,14,36,84,42.9,48,44,9,35,69,149,40,0,Matches
2264,Jérôme Roussillon,FRA,DF,Wolfsburg,Bundesliga,27,1993,13.7,24,12,14,8,2,11,20,55.0,9,10,1,9,19,43,28,0,Matches
2265,Nolan Roux,FRA,FW,Nîmes,Ligue 1,32,1988,7.2,7,3,1,4,2,3,8,37.5,5,6,0,6,5,12,4,0,Matches
2266,Nicolò Rovella,ITA,MF,Genoa,Serie A,18,2001,13.2,29,16,15,11,3,9,32,28.1,23,11,0,11,20,49,19,1,Matches
2267,Amir Rrahmani,KVX,DF,Napoli,Serie A,26,1994,12.2,13,8,7,6,0,6,9,66.7,3,17,14,3,8,21,39,1,Matches
2268,Rubén,ESP,GK,Osasuna,La Liga,36,1984,2.1,0,0,0,0,0,0,0,,0,0,0,0,0,0,1,0,Matches
2269,Waldo Rubio,ESP,"FW,MF",Valladolid,La Liga,24,1995,4.2,6,4,2,2,2,1,14,7.1,13,6,0,6,3,9,3,0,Matches
2270,John Ruddy,ENG,GK,Wolves,Premier League,33,1986,1.0,0,0,0,0,0,0,0,,0,0,0,0,0,0,0,0,Matches
2271,Antonio Rüdiger,GER,DF,Chelsea,Premier League,27,1993,19.0,31,23,16,14,1,12,15,80.0,3,17,10,7,18,49,51,0,Matches
2272,Sebastian Rudy,GER,"MF,FW",Hoffenheim,Bundesliga,30,1990,18.6,35,26,15,15,5,16,45,35.6,29,24,4,20,13,48,21,1,Matches
2273,Sebastian Rudy,GER,DF,Schalke 04,Bundesliga,30,1990,2.0,4,2,2,0,2,4,7,57.1,3,6,4,2,1,5,4,0,Matches
2274,Kevin Rüegg,SUI,"DF,MF",Hellas Verona,Serie A,21,1998,2.3,0,0,0,0,0,0,0,,0,3,0,3,2,2,3,0,Matches
2275,Daniele Rugani,ITA,DF,Cagliari,Serie A,26,1994,11.1,24,11,10,12,2,10,20,50.0,10,15,10,5,15,39,46,0,Matches
2276,Daniele Rugani,ITA,DF,Rennes,Ligue 1,26,1994,1.0,0,0,0,0,0,0,1,0.0,1,1,1,0,1,1,1,0,Matches
2277,Matteo Ruggeri,ITA,DF,Atalanta,Serie A,18,2002,2.3,3,0,1,2,0,2,3,66.7,1,2,0,2,4,7,2,0,Matches
2278,Mário Rui,POR,DF,Napoli,Serie A,29,1991,18.5,24,13,17,6,1,17,33,51.5,16,17,4,13,28,52,29,1,Matches
2279,Aitor Ruibal,ESP,"FW,MF",Betis,La Liga,24,1996,17.7,32,18,14,14,4,10,35,28.6,25,26,0,26,11,43,8,0,Matches
2280,Kays Ruiz Atil,FRA,"FW,MF",Paris S-G,Ligue 1,17,2002,2.1,1,1,0,1,0,0,4,0.0,4,1,0,1,3,4,2,0,Matches
2281,Isma Ruiz,ESP,MF,Granada,La Liga,19,2001,0.7,1,0,0,1,0,0,1,0.0,1,0,0,0,0,1,3,0,Matches
2282,Fabián Ruiz Peña,ESP,MF,Napoli,Serie A,24,1996,28.5,58,31,26,21,11,25,70,35.7,45,33,3,30,36,94,32,1,Matches
2283,Víctor Ruiz,ESP,DF,Betis,La Liga,31,1989,24.0,11,7,7,4,0,4,13,30.8,9,17,13,4,44,55,85,0,Matches
2284,Gerónimo Rulli,ARG,GK,Villarreal,La Liga,28,1992,2.0,0,0,0,0,0,0,0,,0,0,0,0,0,0,0,1,Matches
2285,Georginio Rutter,FRA,"FW,MF",Rennes,Ligue 1,18,2002,0.5,2,2,0,1,1,1,3,33.3,2,2,0,2,0,2,0,0,Matches
2286,Georginio Rutter,FRA,FW,Hoffenheim,Bundesliga,18,2002,2.7,4,4,2,2,0,1,2,50.0,1,2,0,2,0,4,2,0,Matches
2287,Mathew Ryan,AUS,GK,Arsenal,Premier League,28,1992,3.0,0,0,0,0,0,0,0,,0,0,0,0,0,0,1,0,Matches
2288,Mathew Ryan,AUS,GK,Brighton,Premier League,28,1992,11.0,1,0,1,0,0,0,0,,0,0,0,0,0,1,4,0,Matches
2289,Julian Ryerson,NOR,"DF,MF",Union Berlin,Bundesliga,22,1997,11.9,22,15,4,14,4,12,15,80.0,3,13,0,13,11,33,17,0,Matches
2290,Frederik Rønnow,DEN,GK,Schalke 04,Bundesliga,27,1992,10.5,0,0,0,0,0,0,0,,0,0,0,0,1,1,9,1,Matches
2291,João Victor Santos Sá,BRA,FW,Wolfsburg,Bundesliga,26,1994,5.2,9,6,2,6,1,6,11,54.5,5,11,0,11,8,17,2,0,Matches
2292,Roli Pereira de Sa,FRA,"FW,MF",Nantes,Ligue 1,23,1996,0.6,4,3,1,3,0,3,4,75.0,1,2,0,2,0,4,0,0,Matches
2293,Idriss Saadi,ALG,"MF,FW",Strasbourg,Ligue 1,28,1992,1.4,0,0,0,0,0,0,2,0.0,2,0,0,0,0,0,0,0,Matches
2294,Youssouf Sabaly,SEN,DF,Bordeaux,Ligue 1,27,1993,32.3,47,33,24,17,6,27,45,60.0,18,31,8,23,49,96,57,2,Matches
2295,Mathys Saban,FRA,FW,Saint-Étienne,Ligue 1,18,2002,0.1,0,0,0,0,0,0,0,,0,0,0,0,0,0,0,0,Matches
2296,Marcel Sabitzer,AUT,MF,RB Leipzig,Bundesliga,26,1994,22.5,29,21,12,16,1,12,37,32.4,25,7,2,5,35,64,27,0,Matches
2297,Alexis Saelemaekers,BEL,FW,Milan,Serie A,21,1999,22.4,43,26,20,18,5,19,60,31.7,41,29,1,28,25,68,6,0,Matches
2298,Modibo Sagnan,MLI,DF,Real Sociedad,La Liga,21,1999,6.9,12,7,6,6,0,4,6,66.7,2,7,2,5,6,18,25,1,Matches
2299,Allan Saint-Maximin,FRA,"FW,MF",Newcastle Utd,Premier League,23,1997,17.3,16,9,6,9,1,4,9,44.4,5,10,0,10,4,20,2,0,Matches
2300,Borja Sainz,ESP,"MF,FW",Alavés,La Liga,19,2001,5.0,7,3,3,2,2,4,16,25.0,12,4,0,4,6,13,1,0,Matches
2301,Romain Saïss,MAR,DF,Wolves,Premier League,30,1990,26.7,35,24,23,12,0,19,33,57.6,14,28,13,15,52,87,115,1,Matches
2302,Bukayo Saka,ENG,"FW,MF",Arsenal,Premier League,18,2001,28.4,25,16,10,13,2,11,40,27.5,29,21,2,19,25,50,24,0,Matches
2303,Hiroki Sakai,JPN,DF,Marseille,Ligue 1,30,1990,26.5,81,48,34,35,12,39,51,76.5,12,21,5,16,54,135,65,0,Matches
2304,Moïse Sakava,CMR,MF,Reims,Ligue 1,19,2000,0.1,0,0,0,0,0,0,0,,0,0,0,0,0,0,0,0,Matches
2305,Mamadou Sakho,FRA,DF,Crystal Palace,Premier League,30,1990,3.1,3,2,1,2,0,3,3,100.0,0,3,2,1,3,6,11,0,Matches
2306,Jacopo Sala,ITA,DF,Spezia,Serie A,28,1991,4.2,17,9,14,1,2,8,22,36.4,14,5,2,3,5,22,6,0,Matches
2307,Mohamed Salah,EGY,FW,Liverpool,Premier League,28,1992,34.2,18,9,4,4,10,7,16,43.8,9,10,0,10,1,19,10,1,Matches
2308,Eddie Salcedo,ITA,"MF,FW",Hellas Verona,Serie A,18,2001,8.4,6,2,3,2,1,3,3,100.0,0,6,0,6,6,12,6,0,Matches
2309,William Saliba,FRA,DF,Nice,Ligue 1,19,2001,20.0,15,9,8,5,2,5,6,83.3,1,17,16,1,26,41,80,2,Matches
2310,Romain Salin,FRA,GK,Rennes,Ligue 1,36,1984,15.0,0,0,0,0,0,0,1,0.0,1,0,0,0,1,1,6,3,Matches
2311,Mohammed Salisu,GHA,DF,Southampton,Premier League,21,1999,9.4,38,21,20,16,2,25,34,73.5,9,22,5,17,17,55,30,0,Matches
2312,Roland Sallai,HUN,"MF,FW",Freiburg,Bundesliga,23,1997,18.5,18,14,7,9,2,5,13,38.5,8,11,1,10,11,29,8,0,Matches
2313,Salvi,ESP,"MF,FW",Cádiz,La Liga,29,1991,21.5,18,10,14,3,1,8,26,30.8,18,14,1,13,20,38,24,0,Matches
2314,Lazar Samardzic,SRB,MF,RB Leipzig,Bundesliga,18,2002,2.2,10,7,4,6,0,5,13,38.5,8,6,0,6,2,12,1,0,Matches
2315,Diadie Samassékou,MLI,MF,Hoffenheim,Bundesliga,24,1996,28.5,71,41,22,42,7,33,90,36.7,57,41,12,29,78,149,50,0,Matches
2316,Mama Samba Baldé,GNB,FW,Dijon,Ligue 1,24,1995,24.0,23,9,4,13,6,9,22,40.9,13,16,1,15,4,27,26,0,Matches
2317,Junior Sambia,FRA,"DF,MF",Montpellier,Ligue 1,23,1996,27.2,41,29,20,14,7,26,38,68.4,12,27,14,13,39,80,46,0,Matches
2318,Frédéric Sammaritano,FRA,"FW,MF",Dijon,Ligue 1,34,1986,12.6,15,10,9,5,1,9,26,34.6,17,6,0,6,9,24,3,0,Matches
2319,Fede San Emeterio,ESP,MF,Valladolid,La Liga,23,1997,16.2,25,14,15,7,3,11,31,35.5,20,23,8,15,28,53,33,0,Matches
2320,Antonio Sanabria,PAR,FW,Torino,Serie A,24,1996,10.9,8,3,0,4,4,2,9,22.2,7,5,0,5,5,13,8,0,Matches
2321,Antonio Sanabria,PAR,FW,Betis,La Liga,24,1996,10.4,5,5,0,4,1,0,2,0.0,2,8,1,7,3,8,9,0,Matches
2322,Oihan Sancet,ESP,"FW,MF",Athletic Club,La Liga,20,2000,11.5,8,2,3,4,1,2,7,28.6,5,4,0,4,5,13,7,0,Matches
2323,Renato Sanches,POR,MF,Lille,Ligue 1,22,1997,14.1,13,7,4,8,1,5,25,20.0,20,13,2,11,13,26,8,0,Matches
2324,Ricard Sánchez,ESP,DF,Atlético Madrid,La Liga,20,2000,0.3,1,1,0,0,1,0,0,,0,1,0,1,0,1,1,0,Matches
2325,Alexis Sánchez,CHI,FW,Inter,Serie A,31,1988,12.7,14,8,4,4,6,5,18,27.8,13,11,0,11,7,21,1,1,Matches
2326,Davinson Sánchez,COL,DF,Tottenham,Premier League,24,1996,16.5,40,20,31,9,0,21,32,65.6,11,18,13,5,14,54,85,2,Matches
2327,Germán Sánchez,ESP,DF,Granada,La Liga,33,1986,29.3,24,11,13,9,2,11,23,47.8,12,28,26,2,38,62,130,1,Matches
2328,Javi Sánchez,ESP,DF,Valladolid,La Liga,23,1997,10.2,15,10,10,4,1,9,10,90.0,1,15,7,8,15,30,37,0,Matches
2329,Manu Sánchez,ESP,DF,Osasuna,La Liga,19,2000,10.8,27,15,10,10,7,11,25,44.0,14,8,0,8,8,35,14,0,Matches
2330,Manu Sánchez,ESP,DF,Atlético Madrid,La Liga,19,2000,0.5,0,0,0,0,0,0,1,0.0,1,1,0,1,0,0,1,0,Matches
2331,Juan Sánchez Miño,ARG,"DF,MF",Elche,La Liga,30,1990,5.5,8,5,5,3,0,6,14,42.9,8,4,0,4,4,12,7,0,Matches
2332,Pepe Sánchez,ESP,DF,Granada,La Liga,20,2000,2.8,4,2,2,2,0,3,4,75.0,1,5,2,3,4,8,9,0,Matches
2333,Robert Sánchez,ESP,GK,Brighton,Premier League,22,1997,27.0,1,0,1,0,0,1,1,100.0,0,1,0,1,1,2,11,2,Matches
2334,Jadon Sancho,ENG,"FW,MF",Dortmund,Bundesliga,20,2000,22.9,18,11,4,10,4,7,16,43.8,9,20,1,19,16,34,9,0,Matches
2335,Alex Sandro,BRA,DF,Juventus,Serie A,29,1991,20.6,37,23,19,13,5,13,25,52.0,12,20,4,16,31,68,57,0,Matches
2336,Leroy Sané,GER,"FW,MF",Bayern Munich,Bundesliga,24,1996,20.1,18,10,2,10,6,13,30,43.3,17,23,1,22,9,27,8,1,Matches
2337,Salif Sané,SEN,DF,Schalke 04,Bundesliga,29,1990,11.9,17,9,9,7,1,13,23,56.5,10,25,13,12,25,42,66,0,Matches
2338,Oier Sanjurjo,ESP,MF,Osasuna,La Liga,34,1986,23.2,39,16,8,27,4,17,60,28.3,43,24,6,18,29,68,41,0,Matches
2339,Mohamed Sankoh,NED,MF,Stuttgart,Bundesliga,16,2003,0.2,0,0,0,0,0,0,0,,0,1,0,1,0,0,0,0,Matches
2340,Siriki Sanogo,CIV,MF,Benevento,Serie A,18,2001,0.1,0,0,0,0,0,0,0,,0,0,0,0,0,0,0,0,Matches
2341,Morgan Sanson,FRA,MF,Aston Villa,Premier League,25,1994,3.3,7,4,4,2,1,1,4,25.0,3,5,0,5,4,11,1,0,Matches
2342,Morgan Sanson,FRA,MF,Marseille,Ligue 1,25,1994,9.2,21,12,6,12,3,9,28,32.1,19,12,0,12,9,30,5,0,Matches
2343,Nicola Sansone,ITA,"FW,MF",Bologna,Serie A,28,1991,13.0,22,11,7,12,3,10,31,32.3,21,15,0,15,9,31,7,0,Matches
2344,Baptiste Santamaria,FRA,MF,Angers,Ligue 1,25,1995,3.0,9,6,3,5,1,2,7,28.6,5,4,0,4,7,16,8,0,Matches
2345,Baptiste Santamaria,FRA,MF,Freiburg,Bundesliga,25,1995,24.5,51,38,19,24,8,20,54,37.0,34,36,7,29,52,103,34,1,Matches
2346,Federico Santander,PAR,FW,Bologna,Serie A,29,1991,0.4,0,0,0,0,0,0,0,,0,0,0,0,0,0,0,0,Matches
2347,Davide Santon,ITA,DF,Roma,Serie A,29,1991,6.5,4,3,2,2,0,3,7,42.9,4,10,1,9,4,8,12,0,Matches
2348,Samir Santos,BRA,DF,Udinese,Serie A,25,1994,24.6,40,23,26,12,2,13,29,44.8,16,33,17,16,58,98,60,1,Matches
2349,Riccardo Saponara,ITA,MF,Fiorentina,Serie A,28,1991,0.6,2,1,0,2,0,1,3,33.3,2,0,0,0,1,3,0,0,Matches
2350,Riccardo Saponara,ITA,"FW,MF",Spezia,Serie A,28,1991,4.3,4,1,1,0,3,1,3,33.3,2,1,0,1,1,5,4,0,Matches
2351,Ivan Šaponjić,SRB,FW,Cádiz,La Liga,22,1997,4.3,1,0,0,1,0,0,2,0.0,2,2,0,2,1,2,4,0,Matches
2352,Pablo Sarabia,ESP,"FW,MF",Paris S-G,Ligue 1,28,1992,14.7,15,11,6,6,3,10,38,26.3,28,9,1,8,5,20,8,0,Matches
2353,Josh Sargent,USA,"FW,MF",Werder Bremen,Bundesliga,20,2000,27.8,32,19,13,13,6,13,27,48.1,14,39,4,35,17,49,36,0,Matches
2354,Bouna Sarr,SEN,DF,Marseille,Ligue 1,28,1992,0.8,1,1,0,0,1,1,1,100.0,0,1,1,0,1,2,1,0,Matches
2355,Bouna Sarr,SEN,DF,Bayern Munich,Bundesliga,28,1992,5.0,9,8,4,3,2,3,6,50.0,3,7,0,7,10,19,7,1,Matches
2356,Sidy Sarr,SEN,MF,Nîmes,Ligue 1,24,1996,5.1,10,6,4,6,0,2,5,40.0,3,1,1,0,7,17,4,0,Matches
2357,Marco Sau,ITA,"MF,FW",Benevento,Serie A,32,1987,8.7,6,2,0,6,0,1,16,6.3,15,7,0,7,5,11,3,0,Matches
2358,Téji Savanier,FRA,MF,Montpellier,Ligue 1,28,1991,24.1,49,33,16,25,8,22,73,30.1,51,28,6,22,38,87,15,0,Matches
2359,Stefan Savić,MNE,DF,Atlético Madrid,La Liga,29,1991,32.8,40,25,32,7,1,21,34,61.8,13,33,19,14,42,82,110,0,Matches
2360,Romaine Sawyers,SKN,MF,West Brom,Premier League,28,1991,16.5,30,18,16,12,2,14,43,32.6,29,20,4,16,18,48,12,3,Matches
2361,Gianluca Scamacca,ITA,FW,Genoa,Serie A,21,1999,15.0,19,10,6,7,6,7,19,36.8,12,21,4,17,9,28,12,0,Matches
2362,Dane Scarlett,ENG,FW,Tottenham,Premier League,16,2004,0.0,0,0,0,0,0,0,0,,0,0,0,0,0,0,0,0,Matches
2363,Fabian Schär,SUI,DF,Newcastle Utd,Premier League,28,1991,13.8,13,4,8,5,0,7,19,36.8,12,19,12,7,27,40,52,1,Matches
2364,Aurélien Scheidler,FRA,FW,Dijon,Ligue 1,22,1998,3.8,2,0,0,2,0,0,2,0.0,2,0,0,0,1,3,5,0,Matches
2365,Nicolás Schiappacasse,URU,MF,Sassuolo,Serie A,21,1999,0.2,0,0,0,0,0,0,0,,0,0,0,0,0,0,0,0,Matches
2366,Pasquale Schiattarella,ITA,MF,Benevento,Serie A,33,1987,25.0,37,22,25,12,0,19,47,40.4,28,19,5,14,32,69,29,2,Matches
2367,Patrik Schick,CZE,FW,Leverkusen,Bundesliga,24,1996,20.7,7,2,0,5,2,1,4,25.0,3,5,2,3,3,10,20,0,Matches
2368,Sven Schipplock,GER,"FW,MF",Arminia,Bundesliga,31,1988,8.3,15,8,7,6,2,6,27,22.2,21,13,2,11,6,21,8,0,Matches
2369,Xaver Schlager,AUT,MF,Wolfsburg,Bundesliga,22,1997,29.2,66,40,20,38,8,22,68,32.4,46,50,6,44,54,120,38,0,Matches
2370,Keven Schlotterbeck,GER,DF,Freiburg,Bundesliga,23,1997,18.4,31,10,16,15,0,10,23,43.5,13,26,18,8,36,67,89,2,Matches
2371,Nico Schlotterbeck,GER,DF,Union Berlin,Bundesliga,20,1999,14.3,34,19,14,19,1,18,28,64.3,10,13,6,7,31,65,29,1,Matches
2372,Jeffrey Schlupp,GHA,MF,Crystal Palace,Premier League,27,1992,15.9,29,16,14,12,3,6,23,26.1,17,24,8,16,22,51,16,0,Matches
2373,Kasper Schmeichel,DEN,GK,Leicester City,Premier League,33,1986,38.0,0,0,0,0,0,0,0,,0,0,0,0,0,0,10,0,Matches
2374,Jonathan Schmid,FRA,"MF,DF",Freiburg,Bundesliga,30,1990,26.6,37,19,17,13,7,16,30,53.3,14,26,10,16,28,65,38,0,Matches
2375,Romano Schmid,AUT,"MF,FW",Werder Bremen,Bundesliga,20,2000,13.1,22,16,8,10,4,8,35,22.9,27,21,0,21,8,30,6,0,Matches
2376,Benno Schmitz,GER,DF,Köln,Bundesliga,25,1994,4.6,14,7,6,7,1,7,13,53.8,6,8,2,6,6,20,7,0,Matches
2377,Morgan Schneiderlin,FRA,MF,Nice,Ligue 1,30,1989,24.4,51,31,21,24,6,20,54,37.0,34,21,11,10,53,104,46,0,Matches
2378,Alessandro Schöpf,AUT,"FW,MF",Schalke 04,Bundesliga,26,1994,10.5,11,9,3,7,1,1,6,16.7,5,15,1,14,6,17,6,0,Matches
2379,Jerdy Schouten,NED,MF,Bologna,Serie A,23,1997,27.9,50,25,23,25,2,16,37,43.2,21,36,13,23,79,129,37,6,Matches
2380,Nico Schulz,GER,DF,Dortmund,Bundesliga,27,1993,6.8,9,6,4,3,2,2,11,18.2,9,12,4,8,6,15,10,0,Matches
2381,Alexander Schwolow,GER,GK,Hertha BSC,Bundesliga,28,1992,26.0,0,0,0,0,0,0,0,,0,1,0,1,0,0,6,0,Matches
2382,Christopher Scott,GER,"MF,FW",Bayern Munich,Bundesliga,18,2002,0.4,2,1,0,1,1,2,2,100.0,0,0,0,0,0,2,1,0,Matches
2383,Matteo Scozzarella,ITA,MF,Parma,Serie A,32,1988,1.7,4,0,3,1,0,2,3,66.7,1,3,1,2,6,10,0,0,Matches
2384,Simone Scuffet,ITA,GK,Udinese,Serie A,24,1996,1.0,0,0,0,0,0,0,0,,0,0,0,0,0,0,0,0,Matches
2385,Jacopo Segre,ITA,MF,Torino,Serie A,23,1997,2.1,5,2,2,1,2,2,5,40.0,3,0,0,0,0,5,1,0,Matches
2386,Davie Selke,GER,FW,Werder Bremen,Bundesliga,25,1995,9.0,3,2,1,1,1,0,6,0.0,6,3,2,1,1,4,7,0,Matches
2387,Malik Sellouki,FRA,"FW,MF",Nice,Ligue 1,20,2000,0.7,0,0,0,0,0,0,1,0.0,1,2,0,2,2,2,0,0,Matches
2388,Matz Sels,BEL,GK,Strasbourg,Ligue 1,28,1992,6.0,0,0,0,0,0,0,0,,0,0,0,0,0,0,4,0,Matches
2389,Nélson Semedo,POR,"DF,MF",Wolves,Premier League,26,1993,33.1,85,48,53,23,9,42,72,58.3,30,30,10,20,41,126,78,2,Matches
2390,Léo Sena,BRA,MF,Spezia,Serie A,24,1995,9.8,22,12,7,10,5,12,26,46.2,14,19,4,15,11,33,5,0,Matches
2391,Stefano Sensi,ITA,MF,Inter,Serie A,24,1995,6.7,9,6,3,5,1,4,11,36.4,7,6,1,5,7,16,1,0,Matches
2392,Jaime Seoane,ESP,MF,Huesca,La Liga,23,1997,22.9,50,30,20,23,7,24,65,36.9,41,27,6,21,17,67,14,0,Matches
2393,Luigi Sepe,ITA,GK,Parma,Serie A,29,1991,36.0,0,0,0,0,0,0,2,0.0,2,0,0,0,2,2,13,2,Matches
2394,Suat Serdar,GER,MF,Schalke 04,Bundesliga,23,1997,21.7,55,35,18,33,4,17,52,32.7,35,29,4,25,23,78,21,0,Matches
2395,Jean Seri,CIV,MF,Bordeaux,Ligue 1,29,1991,7.9,17,9,3,12,2,4,15,26.7,11,8,2,6,12,29,7,0,Matches
2396,Femi Seriki,ENG,MF,Sheffield Utd,Premier League,18,2002,0.0,0,0,0,0,0,0,0,,0,0,0,0,0,0,0,0,Matches
2397,Ryan Sessegnon,ENG,"DF,FW",Hoffenheim,Bundesliga,20,2000,17.5,47,25,26,13,8,15,34,44.1,19,26,3,23,30,77,46,0,Matches
2398,Nils Seufert,GER,"MF,FW",Arminia,Bundesliga,23,1997,3.8,12,9,2,5,5,2,8,25.0,6,3,1,2,5,17,6,0,Matches
2399,Edgar Sevikyan,ARM,MF,Levante,La Liga,18,2001,0.1,0,0,0,0,0,0,0,,0,0,0,0,0,0,0,0,Matches
2400,Stephan El Shaarawy,ITA,"MF,FW",Roma,Serie A,27,1992,6.4,4,3,0,3,1,2,9,22.2,7,3,1,2,3,7,2,0,Matches
2401,Jamie Shackleton,ENG,"MF,DF",Leeds United,Premier League,20,1999,5.1,10,6,6,4,0,4,11,36.4,7,3,1,2,9,19,3,0,Matches
2402,Xherdan Shaqiri,SUI,"MF,FW",Liverpool,Premier League,28,1991,6.2,7,4,3,1,3,2,7,28.6,5,4,0,4,2,9,0,0,Matches
2403,Billy Sharp,ENG,FW,Sheffield Utd,Premier League,34,1986,8.2,5,1,0,3,2,2,9,22.2,7,2,0,2,0,5,2,0,Matches
2404,Luke Shaw,ENG,DF,Manchester Utd,Premier League,25,1995,29.5,44,28,21,16,7,21,36,58.3,15,34,9,25,20,64,44,2,Matches
2405,Jonjo Shelvey,ENG,MF,Newcastle Utd,Premier League,28,1992,29.1,39,14,18,19,2,10,37,27.0,27,26,14,12,36,75,42,0,Matches
2406,Eldor Shomurodov,UZB,FW,Genoa,Serie A,25,1995,18.6,28,14,7,13,8,9,37,24.3,28,17,2,15,6,34,11,0,Matches
2407,Shola Shoretire,ENG,FW,Manchester Utd,Premier League,16,2004,0.1,0,0,0,0,0,0,0,,0,0,0,0,0,0,0,0,Matches
2408,Mahame Siby,MLI,MF,Strasbourg,Ligue 1,24,1996,0.2,0,0,0,0,0,0,1,0.0,1,0,0,0,0,0,1,0,Matches
2409,Abdoulaye Sidibé,FRA,MF,Saint-Étienne,Ligue 1,18,2002,0.1,1,1,1,0,0,1,2,50.0,1,0,0,0,0,1,0,0,Matches
2410,Djibril Sidibé,FRA,DF,Monaco,Ligue 1,28,1992,22.0,58,34,26,29,3,37,52,71.2,15,20,5,15,50,108,37,2,Matches
2411,Sidnei,BRA,DF,Betis,La Liga,30,1989,7.7,9,3,6,3,0,4,9,44.4,5,6,4,2,16,25,28,0,Matches
2412,Kaj Sierhuis,NED,"FW,MF",Reims,Ligue 1,22,1998,7.2,7,2,1,2,4,2,9,22.2,7,2,1,1,2,9,5,0,Matches
2413,Tim Siersleben,GER,DF,Wolfsburg,Bundesliga,20,2000,0.4,2,2,2,0,0,1,1,100.0,0,1,0,1,0,2,0,0,Matches
2414,Gylfi Sigurðsson,ISL,"MF,FW",Everton,Premier League,30,1989,25.0,30,20,9,14,7,13,44,29.5,31,31,2,29,34,64,21,1,Matches
2415,Luca Siligardi,ITA,"MF,FW",Crotone,Serie A,32,1988,0.5,4,2,0,3,1,1,5,20.0,4,0,0,0,0,4,0,0,Matches
2416,Luca Siligardi,ITA,"FW,MF",Parma,Serie A,32,1988,0.4,0,0,0,0,0,0,2,0.0,2,0,0,0,0,0,0,0,Matches
2417,Adrien Silva,POR,MF,Sampdoria,Serie A,31,1989,17.8,49,22,21,22,6,18,54,33.3,36,34,1,33,30,79,10,1,Matches
2418,André Silva,POR,FW,Eint Frankfurt,Bundesliga,24,1995,30.7,11,2,0,7,4,6,13,46.2,7,11,1,10,3,14,15,0,Matches
2419,Bernardo Silva,POR,"MF,FW",Manchester City,Premier League,25,1994,22.9,26,14,7,12,7,11,52,21.2,41,17,1,16,17,43,8,0,Matches
2420,Caio Henrique Oliveira Silva,BRA,DF,Monaco,Ligue 1,23,1997,26.3,50,34,25,20,5,31,51,60.8,20,20,3,17,16,66,37,0,Matches
2421,David Silva,ESP,MF,Real Sociedad,La Liga,34,1986,15.5,19,12,2,14,3,8,21,38.1,13,14,1,13,13,32,8,2,Matches
2422,Fábio Silva,POR,FW,Wolves,Premier League,18,2002,15.2,6,4,1,4,1,4,12,33.3,8,12,1,11,4,10,5,1,Matches
2423,Florent da Silva,FRA,FW,Lyon,Ligue 1,17,2003,0.0,0,0,0,0,0,0,0,,0,0,0,0,0,0,0,0,Matches
2424,Gabriel Silva,BRA,DF,Saint-Étienne,Ligue 1,29,1991,3.9,7,6,7,0,0,1,2,50.0,1,4,1,3,6,13,8,0,Matches
2425,Gastón Silva,URU,DF,Huesca,La Liga,26,1994,6.7,16,12,11,5,0,8,14,57.1,6,10,4,6,11,27,16,0,Matches
2426,Rui Silva,POR,GK,Granada,La Liga,26,1994,32.0,1,0,1,0,0,1,3,33.3,2,0,0,0,2,3,14,0,Matches
2427,Thiago Silva,BRA,DF,Chelsea,Premier League,35,1984,21.5,20,12,11,8,1,14,21,66.7,7,21,13,8,33,53,86,1,Matches
2428,Marco Silvestri,ITA,GK,Hellas Verona,Serie A,29,1991,34.0,0,0,0,0,0,0,0,,0,0,0,0,0,0,14,1,Matches
2429,Mohamed Simakan,FRA,DF,Strasbourg,Ligue 1,20,2000,17.9,32,22,21,6,5,9,18,50.0,9,17,11,6,31,63,41,0,Matches
2430,Giovanni Simeone,ARG,FW,Cagliari,Serie A,25,1995,19.3,24,11,2,15,7,7,31,22.6,24,23,1,22,10,34,18,0,Matches
2431,Moses Simon,NGA,"FW,MF",Nantes,Ligue 1,25,1995,25.8,27,14,11,9,7,17,36,47.2,19,24,1,23,15,42,15,1,Matches
2432,Unai Simón,ESP,GK,Athletic Club,La Liga,23,1997,37.0,1,0,1,0,0,1,2,50.0,1,0,0,0,0,1,7,7,Matches
2433,Xavi Simons,NED,MF,Paris S-G,Ligue 1,17,2003,0.0,0,0,0,0,0,0,0,,0,0,0,0,0,0,0,0,Matches
2434,Jóan Símun Edmundsson,FRO,"FW,MF",Arminia,Bundesliga,29,1991,0.6,0,0,0,0,0,0,0,,0,1,0,1,1,1,0,0,Matches
2435,Wilfried Singo,CIV,DF,Torino,Serie A,19,2000,20.6,29,14,16,6,7,17,33,51.5,16,13,3,10,29,58,40,0,Matches
2436,Daley Sinkgraven,NED,DF,Leverkusen,Bundesliga,25,1995,17.4,32,17,13,16,3,18,35,51.4,17,22,5,17,23,55,23,0,Matches
2437,Dimitris Siovas,GRE,DF,Huesca,La Liga,31,1988,34.1,46,24,34,10,2,20,30,66.7,10,38,17,21,62,108,125,2,Matches
2438,Tobias Sippel,GER,GK,Gladbach,Bundesliga,32,1988,3.8,0,0,0,0,0,0,0,,0,0,0,0,1,1,4,0,Matches
2439,Salvatore Sirigu,ITA,GK,Torino,Serie A,33,1987,32.0,1,0,1,0,0,1,2,50.0,1,0,0,0,0,1,6,2,Matches
2440,Issouf Sissokho,MLI,"MF,DF",Bordeaux,Ligue 1,18,2002,0.9,6,4,4,2,0,3,6,50.0,3,2,0,2,1,7,0,0,Matches
2441,Ibrahima Sissoko,MLI,MF,Strasbourg,Ligue 1,22,1997,28.7,68,48,25,35,8,28,68,41.2,40,22,5,17,48,116,44,0,Matches
2442,Moussa Sissoko,FRA,MF,Tottenham,Premier League,30,1989,17.6,22,16,19,3,0,8,20,40.0,12,11,4,7,23,45,25,0,Matches
2443,Nelson Sissoko,FRA,DF,Saint-Étienne,Ligue 1,23,1997,5.3,12,6,6,3,3,7,12,58.3,5,2,1,1,12,24,16,1,Matches
2444,Antonio Sivera,ESP,GK,Alavés,La Liga,23,1996,0.8,0,0,0,0,0,0,0,,0,0,0,0,0,0,0,0,Matches
2445,Jacques Siwe,FRA,FW,Dijon,Ligue 1,19,2001,1.9,4,1,1,1,2,0,1,0.0,1,1,0,1,1,5,1,0,Matches
2446,Ellyes Skhiri,TUN,MF,Köln,Bundesliga,25,1995,30.9,83,48,44,31,8,33,65,50.8,32,49,13,36,82,165,38,2,Matches
2447,Łukasz Skorupski,POL,GK,Bologna,Serie A,29,1991,28.0,1,1,1,0,0,1,4,25.0,3,0,0,0,0,1,23,5,Matches
2448,Andreas Skov Olsen,DEN,"FW,DF",Bologna,Serie A,20,1999,13.1,19,10,11,4,4,11,21,52.4,10,15,0,15,3,22,25,0,Matches
2449,Robert Skov,DEN,"FW,MF",Hoffenheim,Bundesliga,24,1996,12.9,19,10,9,7,3,7,16,43.8,9,9,2,7,15,34,10,1,Matches
2450,Milan Škriniar,SVK,DF,Inter,Serie A,25,1995,30.9,48,32,29,16,3,23,34,67.6,11,30,19,11,30,78,89,1,Matches
2451,Steven Skrzybski,GER,"FW,DF",Schalke 04,Bundesliga,27,1992,4.7,5,4,0,5,0,1,7,14.3,6,13,1,12,5,10,1,1,Matches
2452,Petar Škuletić,SRB,"FW,MF",Montpellier,Ligue 1,30,1990,2.6,3,2,1,2,0,0,5,0.0,5,4,2,2,0,3,4,0,Matches
2453,Islam Slimani,ALG,FW,Leicester City,Premier League,32,1988,0.2,0,0,0,0,0,0,0,,0,0,0,0,0,0,0,0,Matches
2454,Islam Slimani,ALG,FW,Lyon,Ligue 1,32,1988,6.4,7,5,3,1,3,3,12,25.0,9,4,1,3,1,8,6,0,Matches
2455,William Smallbone,IRL,MF,Southampton,Premier League,20,2000,1.9,6,3,2,4,0,1,3,33.3,2,5,0,5,2,8,1,0,Matches
2456,Chris Smalling,ENG,DF,Roma,Serie A,30,1989,12.3,14,8,5,7,2,6,10,60.0,4,17,11,6,28,42,46,1,Matches
2457,Emile Smith Rowe,ENG,"MF,FW",Arsenal,Premier League,20,2000,16.0,14,7,5,5,4,6,17,35.3,11,15,1,14,10,24,12,0,Matches
2458,Robert Snodgrass,SCO,"MF,FW",West Brom,Premier League,32,1987,5.8,17,12,12,4,1,10,16,62.5,6,11,2,9,1,18,12,0,Matches
2459,Robert Snodgrass,SCO,"FW,MF",West Ham,Premier League,32,1987,0.1,0,0,0,0,0,0,0,,0,0,0,0,0,0,0,0,Matches
2460,Cédric Soares,POR,DF,Arsenal,Premier League,28,1991,8.3,12,8,6,4,2,6,21,28.6,15,6,1,5,8,20,16,1,Matches
2461,Rafa Soares,POR,DF,Eibar,La Liga,25,1995,12.6,28,17,16,8,4,15,21,71.4,6,14,4,10,20,48,32,0,Matches
2462,Rubén Sobrino,ESP,"MF,FW",Valencia,La Liga,28,1992,0.5,1,1,1,0,0,0,1,0.0,1,0,0,0,0,1,1,0,Matches
2463,Rubén Sobrino,ESP,"FW,MF",Cádiz,La Liga,28,1992,12.4,29,13,8,16,5,8,18,44.4,10,19,0,19,15,44,11,0,Matches
2464,Simon Sohm,SUI,MF,Parma,Serie A,19,2001,10.0,18,12,11,6,1,11,26,42.3,15,8,0,8,5,23,7,0,Matches
2465,Augusto Solari,ARG,MF,Celta Vigo,La Liga,28,1992,5.4,18,13,9,8,1,6,26,23.1,20,13,1,12,6,24,5,0,Matches
2466,Roberto Soldado,ESP,FW,Granada,La Liga,35,1985,16.0,7,4,1,4,2,2,11,18.2,9,8,0,8,4,11,13,1,Matches
2467,Carlos Soler,ESP,MF,Valencia,La Liga,23,1997,30.4,41,24,14,24,3,19,52,36.5,33,35,11,24,23,64,41,0,Matches
2468,Yann Sommer,SUI,GK,Gladbach,Bundesliga,31,1988,30.1,1,1,1,0,0,1,1,100.0,0,0,0,0,2,3,9,2,Matches
2469,Son,ESP,"DF,MF",Levante,La Liga,26,1994,12.3,18,10,11,6,1,9,19,47.4,10,11,2,9,12,30,20,0,Matches
2470,Brandon Soppy,FRA,DF,Rennes,Ligue 1,18,2002,6.2,21,15,16,5,0,10,16,62.5,6,3,0,3,6,27,12,0,Matches
2471,David Soria,ESP,GK,Getafe,La Liga,27,1993,28.0,2,2,2,0,0,1,3,33.3,2,0,0,0,1,3,12,0,Matches
2472,Roberto Soriano,ITA,MF,Bologna,Serie A,29,1991,36.1,48,26,15,20,13,15,64,23.4,49,31,8,23,18,66,43,0,Matches
2473,Alberto Soro,ESP,"FW,MF",Granada,La Liga,21,1999,4.4,7,2,2,4,1,4,10,40.0,6,7,0,7,1,8,2,0,Matches
2474,Borna Sosa,CRO,"DF,FW",Stuttgart,Bundesliga,22,1998,22.7,14,10,6,6,2,8,25,32.0,17,23,4,19,31,45,74,0,Matches
2475,Hugo Sotelo,ESP,MF,Celta Vigo,La Liga,16,2003,0.0,0,0,0,0,0,0,0,,0,0,0,0,0,0,0,0,Matches
2476,Florian Sotoca,FRA,FW,Lens,Ligue 1,29,1990,26.8,31,20,3,20,8,6,22,27.3,16,27,0,27,9,40,24,0,Matches
2477,Riccardo Sottil,ITA,"FW,MF",Cagliari,Serie A,21,1999,13.2,7,3,2,3,2,0,7,0.0,7,4,0,4,5,12,3,0,Matches
2478,Cheick Souaré,FRA,MF,Marseille,Ligue 1,17,2002,0.1,0,0,0,0,0,0,0,,0,1,1,0,1,1,0,0,Matches
2479,Tomáš Souček,CZE,MF,West Ham,Premier League,25,1995,38.0,78,41,37,36,5,28,77,36.4,49,43,18,25,62,140,107,0,Matches
2480,Rayan Souici,FRA,DF,Saint-Étienne,Ligue 1,22,1998,0.1,0,0,0,0,0,0,0,,0,0,0,0,0,0,0,0,Matches
2481,Cebio Soukou,BEN,"FW,MF",Arminia,Bundesliga,27,1992,5.1,12,8,5,5,2,6,11,54.5,5,3,0,3,3,15,4,0,Matches
2482,Adama Soumaoro,FRA,DF,Bologna,Serie A,28,1992,19.5,24,14,17,7,0,6,12,50.0,6,28,23,5,20,44,72,0,Matches
2483,Adama Soumaoro,FRA,DF,Lille,Ligue 1,28,1992,1.6,1,0,0,0,1,0,0,,0,1,1,0,2,3,2,0,Matches
2484,Boubakary Soumaré,FRA,MF,Lille,Ligue 1,21,1999,21.3,44,29,16,25,3,14,29,48.3,15,14,6,8,39,83,21,0,Matches
2485,Yaya Soumaré,MLI,FW,Lyon,Ligue 1,20,2000,0.0,1,1,1,0,0,1,2,50.0,1,0,0,0,2,3,0,0,Matches
2486,Arnaud Souquet,FRA,DF,Montpellier,Ligue 1,28,1992,13.6,50,33,35,13,2,27,48,56.3,21,15,6,9,17,67,34,0,Matches
2487,Ansou Sow,SEN,MF,Lens,Ligue 1,20,2000,0.1,0,0,0,0,0,0,0,,0,1,0,1,0,0,0,0,Matches
2488,Djibril Sow,SUI,MF,Eint Frankfurt,Bundesliga,23,1997,24.2,58,33,19,32,7,18,41,43.9,23,31,8,23,51,109,17,0,Matches
2489,Saidou Sow,GUI,DF,Saint-Étienne,Ligue 1,18,2002,11.1,23,12,17,6,0,13,19,68.4,6,12,8,4,14,37,39,1,Matches
2490,Çağlar Söyüncü,TUR,DF,Leicester City,Premier League,24,1996,20.2,27,17,13,14,0,17,30,56.7,13,12,9,3,28,55,80,1,Matches
2491,Leonardo Spinazzola,ITA,DF,Roma,Serie A,27,1993,23.6,12,6,3,9,0,8,20,40.0,12,16,1,15,25,37,31,0,Matches
2492,Marco Sportiello,ITA,GK,Atalanta,Serie A,28,1992,14.0,2,2,2,0,0,1,3,33.3,2,0,0,0,2,4,5,1,Matches
2493,Mattia Sprocati,ITA,"MF,FW",Parma,Serie A,27,1993,0.2,1,0,0,1,0,1,1,100.0,0,0,0,0,1,2,0,0,Matches
2494,Jerry St. Juste,NED,DF,Mainz 05,Bundesliga,23,1996,32.0,65,38,37,26,2,20,36,55.6,16,46,27,19,64,129,82,1,Matches
2495,Benjamin Stambouli,FRA,"DF,MF",Schalke 04,Bundesliga,29,1990,21.7,45,29,24,18,3,15,37,40.5,22,42,14,28,49,94,45,1,Matches
2496,Josip Stanišić,CRO,DF,Bayern Munich,Bundesliga,20,2000,1.0,2,2,1,1,0,1,1,100.0,0,3,0,3,2,4,2,0,Matches
2497,Niklas Stark,GER,"DF,MF",Hertha BSC,Bundesliga,25,1995,31.0,49,28,20,27,2,13,31,41.9,18,43,16,27,42,91,101,0,Matches
2498,Renato Steffen,SUI,"FW,MF",Wolfsburg,Bundesliga,28,1991,17.4,24,15,6,12,6,13,24,54.2,11,21,2,19,22,46,15,0,Matches
2499,Zack Steffen,USA,GK,Manchester City,Premier League,25,1995,1.0,0,0,0,0,0,0,0,,0,0,0,0,0,0,0,0,Matches
2500,Pascal Stenzel,GER,DF,Stuttgart,Bundesliga,24,1996,14.2,33,14,15,17,1,22,50,44.0,28,19,4,15,26,59,39,1,Matches
2501,Dale Stephens,ENG,MF,Burnley,Premier League,31,1989,2.9,11,6,2,7,2,3,6,50.0,3,3,0,3,8,19,2,0,Matches
2502,Jack Stephens,ENG,DF,Southampton,Premier League,26,1994,17.1,34,19,19,15,0,17,38,44.7,21,25,14,11,28,62,64,2,Matches
2503,Raheem Sterling,ENG,FW,Manchester City,Premier League,25,1994,28.2,21,10,5,12,4,5,12,41.7,7,15,0,15,15,36,4,0,Matches
2504,Enda Stevens,IRL,DF,Sheffield Utd,Premier League,30,1990,30.0,59,26,32,19,8,33,58,56.9,25,41,12,29,22,81,81,1,Matches
2505,Lars Stindl,GER,"MF,FW",Gladbach,Bundesliga,31,1988,21.8,24,17,3,16,5,7,32,21.9,25,26,3,23,13,37,14,0,Matches
2506,Kevin Stöger,AUT,"MF,FW",Mainz 05,Bundesliga,26,1993,6.0,12,6,2,9,1,5,16,31.3,11,5,0,5,6,18,4,0,Matches
2507,John Stones,ENG,DF,Manchester City,Premier League,26,1994,21.5,21,10,13,5,3,9,14,64.3,5,23,15,8,18,39,56,1,Matches
2508,Thomas Strakosha,ALB,GK,Lazio,Serie A,25,1995,9.0,1,1,1,0,0,0,0,,0,0,0,0,1,2,4,0,Matches
2509,Tobias Strobl,GER,MF,Augsburg,Bundesliga,30,1990,20.5,21,10,12,9,0,10,30,33.3,20,21,8,13,28,49,27,0,Matches
2510,Kevin Strootman,NED,MF,Genoa,Serie A,30,1990,14.6,30,18,13,15,2,14,32,43.8,18,35,3,32,25,55,18,0,Matches
2511,Kevin Strootman,NED,"MF,FW",Marseille,Ligue 1,30,1990,2.6,9,6,5,4,0,4,8,50.0,4,5,2,3,5,14,7,0,Matches
2512,Pascal Struijk,NED,"DF,MF",Leeds United,Premier League,20,1999,23.1,49,30,28,19,2,17,28,60.7,11,35,21,14,47,96,92,0,Matches
2513,Jens Stryger Larsen,DEN,DF,Udinese,Serie A,29,1991,29.3,17,11,14,3,0,8,25,32.0,17,26,11,15,24,41,65,0,Matches
2514,Stefano Sturaro,ITA,MF,Hellas Verona,Serie A,27,1993,4.7,4,3,3,0,1,2,8,25.0,6,5,1,4,5,9,10,0,Matches
2515,Stefano Sturaro,ITA,MF,Genoa,Serie A,27,1993,4.9,11,5,3,6,2,3,15,20.0,12,5,0,5,7,18,2,0,Matches
2516,Damián Suárez,URU,DF,Getafe,La Liga,32,1988,27.0,59,39,29,23,7,30,81,37.0,51,43,2,41,31,90,42,0,Matches
2517,Denis Suárez,ESP,MF,Celta Vigo,La Liga,26,1994,31.7,64,32,22,30,12,21,94,22.3,73,30,2,28,22,86,15,2,Matches
2518,Luis Suárez,URU,FW,Atlético Madrid,La Liga,33,1987,27.9,11,7,0,4,7,3,12,25.0,9,7,0,7,5,16,13,0,Matches
2519,Marek Suchý,CZE,DF,Augsburg,Bundesliga,32,1988,3.4,4,2,1,3,0,1,2,50.0,1,3,3,0,4,8,9,0,Matches
2520,Niklas Süle,GER,DF,Bayern Munich,Bundesliga,24,1995,16.7,32,21,15,14,3,13,21,61.9,8,24,12,12,21,53,36,1,Matches
2521,Suso,ESP,FW,Sevilla,La Liga,26,1993,24.6,20,10,8,6,6,10,41,24.4,31,12,0,12,8,28,8,0,Matches
2522,Bosko Sutalo,CRO,DF,Atalanta,Serie A,20,2000,2.6,5,5,0,3,2,4,5,80.0,1,2,1,1,2,7,7,1,Matches
2523,Mattias Svanberg,SWE,MF,Bologna,Serie A,21,1999,20.6,38,17,21,9,8,16,45,35.6,29,25,4,21,30,68,25,1,Matches
2524,Abdoulaye Sylla,GUI,DF,Nantes,Ligue 1,20,2000,0.1,2,1,2,0,0,1,1,100.0,0,1,0,1,0,2,1,0,Matches
2525,Issiaga Sylla,GUI,"DF,MF",Lens,Ligue 1,26,1994,12.4,28,20,11,17,0,11,21,52.4,10,13,3,10,16,44,21,0,Matches
2526,Eddy Sylvestre,FRA,"FW,MF",Nice,Ligue 1,20,1999,1.1,1,1,1,0,0,0,1,0.0,1,1,0,1,1,2,0,0,Matches
2527,Ádám Szalai,HUN,FW,Mainz 05,Bundesliga,32,1987,8.1,7,6,3,2,2,2,8,25.0,6,4,1,3,2,9,4,0,Matches
2528,Wojciech Szczęsny,POL,GK,Juventus,Serie A,30,1990,29.7,0,0,0,0,0,0,0,,0,2,0,2,3,3,5,1,Matches
2529,Frederik Sørensen,DEN,DF,Köln,Bundesliga,28,1992,1.1,2,1,0,2,0,1,1,100.0,0,2,0,2,0,2,0,0,Matches
2530,Alexander Sørloth,NOR,FW,RB Leipzig,Bundesliga,24,1995,16.0,7,5,0,5,2,2,14,14.3,12,13,2,11,3,10,13,0,Matches
2531,Tachi,ESP,DF,Alavés,La Liga,22,1997,9.4,11,9,9,2,0,6,14,42.9,8,9,6,3,11,22,32,0,Matches
2532,Jonathan Tah,GER,DF,Leverkusen,Bundesliga,24,1996,24.7,30,17,19,9,2,11,21,52.4,10,19,12,7,33,63,89,1,Matches
2533,Waniss Taibi,FRA,MF,Angers,Ligue 1,18,2002,0.4,0,0,0,0,0,0,2,0.0,2,1,0,1,0,0,0,0,Matches
2534,Flavien Tait,FRA,"MF,FW",Rennes,Ligue 1,27,1993,15.2,26,11,11,12,3,10,32,31.3,22,17,3,14,13,39,2,0,Matches
2535,Adrien Tameze,CMR,MF,Hellas Verona,Serie A,26,1994,25.6,39,25,23,15,1,11,27,40.7,16,31,8,23,32,71,46,2,Matches
2536,Japhet Tanganga,ENG,DF,Tottenham,Premier League,21,1999,5.4,5,4,3,2,0,1,3,33.3,2,6,5,1,3,8,15,0,Matches
2537,Renato Tapia,PER,MF,Celta Vigo,La Liga,25,1995,30.0,93,44,50,34,9,32,83,38.6,51,56,13,43,53,146,75,2,Matches
2538,Edmond Tapsoba,BFA,DF,Leverkusen,Bundesliga,21,1999,29.5,54,28,35,18,1,21,45,46.7,24,55,29,26,48,102,96,0,Matches
2539,Matt Targett,ENG,DF,Aston Villa,Premier League,24,1995,37.8,83,39,52,20,11,56,88,63.6,32,40,14,26,55,138,102,1,Matches
2540,James Tarkowski,ENG,DF,Burnley,Premier League,27,1992,36.0,66,39,52,11,3,25,49,51.0,24,54,42,12,44,110,163,1,Matches
2541,Ciprian Tătărușanu,ROU,GK,Milan,Serie A,34,1986,1.0,0,0,0,0,0,0,0,,0,0,0,0,0,0,0,1,Matches
2542,Percy Tau,RSA,FW,Brighton,Premier League,26,1994,1.1,1,1,1,0,0,0,2,0.0,2,1,0,1,0,1,1,0,Matches
2543,Niklas Tauer,GER,"MF,DF",Mainz 05,Bundesliga,19,2001,0.8,1,1,0,1,0,1,2,50.0,1,3,1,2,3,4,1,0,Matches
2544,Heriberto Tavares,POR,"FW,MF",Brest,Ligue 1,23,1997,0.5,2,0,0,0,2,1,3,33.3,2,0,0,0,1,3,1,0,Matches
2545,Sidnei Tavares,POR,MF,Leicester City,Premier League,18,2001,0.9,1,1,0,1,0,0,0,,0,1,1,0,0,1,0,0,Matches
2546,Tomás Tavares,POR,"MF,DF",Alavés,La Liga,19,2001,0.7,2,1,2,0,0,2,2,100.0,0,1,0,1,0,2,1,0,Matches
2547,Charlie Taylor,ENG,DF,Burnley,Premier League,26,1993,27.0,48,28,30,15,3,25,46,54.3,21,36,19,17,29,77,87,2,Matches
2548,Neil Taylor,WAL,DF,Aston Villa,Premier League,31,1989,0.2,1,1,1,0,0,0,0,,0,1,0,1,0,1,0,0,Matches
2549,Allan Tchaptchet,FRA,DF,Southampton,Premier League,18,2001,0.1,0,0,0,0,0,0,0,,0,0,0,0,0,0,0,0,Matches
2550,Warren Tchimbembé,CGO,"MF,FW",Metz,Ligue 1,22,1998,5.5,7,4,4,3,0,3,9,33.3,6,6,1,5,2,9,3,0,Matches
2551,Aurélien Tchouaméni,FRA,MF,Monaco,Ligue 1,20,2000,34.0,127,68,47,62,18,48,92,52.2,44,39,11,28,60,187,47,0,Matches
2552,Álvaro Tejero,ESP,DF,Eibar,La Liga,24,1996,1.2,1,1,0,0,1,1,3,33.3,2,1,0,1,3,4,6,0,Matches
2553,Nathan Tella,NGA,"FW,MF",Southampton,Premier League,21,1999,8.3,8,5,1,4,3,6,15,40.0,9,13,0,13,3,11,2,0,Matches
2554,Alex Telles,BRA,DF,Manchester Utd,Premier League,27,1992,7.7,14,7,10,3,1,8,17,47.1,9,7,2,5,16,30,20,0,Matches
2555,Andrés Tello,COL,"DF,MF",Benevento,Serie A,23,1996,4.6,9,6,8,0,1,5,20,25.0,15,8,1,7,6,15,6,0,Matches
2556,Cristian Tello,ESP,"FW,MF",Betis,La Liga,28,1991,14.3,16,10,5,9,2,4,22,18.2,18,14,0,14,11,27,8,0,Matches
2557,Lino Tempelmann,GER,MF,Freiburg,Bundesliga,21,1999,3.0,5,3,2,2,1,0,4,0.0,4,6,1,5,2,7,6,0,Matches
2558,Hidde ter Avest,NED,DF,Udinese,Serie A,23,1997,3.9,5,2,3,2,0,2,5,40.0,3,3,1,2,2,7,5,0,Matches
2559,Marc-André ter Stegen,GER,GK,Barcelona,La Liga,28,1992,31.0,0,0,0,0,0,0,2,0.0,2,0,0,0,0,0,12,2,Matches
2560,Pietro Terracciano,ITA,GK,Fiorentina,Serie A,30,1990,3.0,0,0,0,0,0,0,0,,0,0,0,0,0,0,1,0,Matches
2561,Martin Terrier,FRA,"FW,MF",Rennes,Ligue 1,23,1997,27.1,33,15,5,15,13,10,36,27.8,26,23,0,23,16,49,7,0,Matches
2562,Claudio Terzi,ITA,DF,Spezia,Serie A,36,1984,20.8,34,21,19,14,1,19,28,67.9,9,23,12,11,35,69,55,1,Matches
2563,Kenny Tete,NED,"DF,MF",Fulham,Premier League,24,1995,16.5,48,30,27,16,5,10,18,55.6,8,14,5,9,27,75,49,0,Matches
2564,Kenny Tete,NED,DF,Lyon,Ligue 1,24,1995,0.2,2,0,1,1,0,0,0,,0,0,0,0,2,4,0,0,Matches
2565,Cedric Teuchert,GER,"FW,MF",Union Berlin,Bundesliga,23,1997,8.4,7,5,2,4,1,3,16,18.8,13,12,0,12,5,12,6,0,Matches
2566,Florian Thauvin,FRA,"FW,MF",Marseille,Ligue 1,27,1993,30.4,40,22,14,21,5,20,54,37.0,34,26,2,24,14,54,11,0,Matches
2567,Malick Thiaw,GER,DF,Schalke 04,Bundesliga,18,2001,16.1,42,27,24,17,1,15,26,57.7,11,17,12,5,33,75,70,0,Matches
2568,Jan Thielmann,GER,"FW,MF",Köln,Bundesliga,18,2002,11.4,11,6,1,8,2,5,9,55.6,4,10,1,9,9,20,2,0,Matches
2569,Sada Thioub,SEN,"FW,MF",Angers,Ligue 1,25,1995,14.0,17,14,7,6,4,7,23,30.4,16,10,0,10,9,26,3,0,Matches
2570,Luke Thomas,ENG,DF,Leicester City,Premier League,19,2001,10.8,23,14,11,5,7,14,21,66.7,7,15,2,13,17,40,21,0,Matches
2571,Romain Thomas,FRA,DF,Angers,Ligue 1,32,1988,33.6,47,25,34,11,2,20,35,57.1,15,35,20,15,50,97,138,0,Matches
2572,Adrien Thomasson,FRA,"MF,FW",Strasbourg,Ligue 1,26,1993,29.2,36,17,8,16,12,12,58,20.7,46,44,5,39,22,58,2,0,Matches
2573,Erik Thommy,GER,"MF,DF",Stuttgart,Bundesliga,25,1994,3.5,3,1,0,3,0,0,3,0.0,3,3,0,3,3,6,4,0,Matches
2574,Morten Thorsby,NOR,MF,Sampdoria,Serie A,24,1996,29.4,76,42,32,36,8,20,60,33.3,40,51,16,35,25,101,30,0,Matches
2575,Khéphren Thuram,FRA,MF,Nice,Ligue 1,19,2001,16.6,32,16,5,21,6,9,27,33.3,18,21,9,12,18,50,22,1,Matches
2576,Marcus Thuram,FRA,"FW,MF",Gladbach,Bundesliga,22,1997,19.2,24,14,9,10,5,10,23,43.5,13,27,4,23,15,39,13,1,Matches
2577,Cheikh Tidiane Sabaly,SEN,FW,Metz,Ligue 1,21,1999,0.1,0,0,0,0,0,0,0,,0,0,0,0,0,0,0,0,Matches
2578,Youri Tielemans,BEL,MF,Leicester City,Premier League,23,1997,37.3,86,45,32,38,16,45,108,41.7,63,35,8,27,46,132,20,1,Matches
2579,Kieran Tierney,SCO,DF,Arsenal,Premier League,23,1997,25.5,27,15,5,14,8,11,31,35.5,20,31,10,21,16,43,63,0,Matches
2580,Steffen Tigges,GER,"FW,DF",Dortmund,Bundesliga,22,1998,0.6,4,4,0,1,3,2,3,66.7,1,1,0,1,0,4,1,0,Matches
2581,Guus Til,NED,FW,Freiburg,Bundesliga,22,1997,1.4,4,3,2,1,1,2,3,66.7,1,2,0,2,2,6,2,0,Matches
2582,David Timor,ESP,"MF,DF",Getafe,La Liga,30,1989,15.5,13,9,5,6,2,9,21,42.9,12,5,1,4,19,32,32,1,Matches
2583,Jean-Clair Todibo,FRA,DF,Nice,Ligue 1,20,1999,14.8,25,15,16,9,0,16,31,51.6,15,13,7,6,19,44,48,1,Matches
2584,Karl Toko Ekambi,CMR,FW,Lyon,Ligue 1,27,1992,31.2,16,10,5,3,8,8,32,25.0,24,20,1,19,26,42,8,0,Matches
2585,Corentin Tolisso,FRA,MF,Bayern Munich,Bundesliga,25,1994,8.7,19,19,4,11,4,9,29,31.0,20,15,2,13,6,25,8,0,Matches
2586,Jeremy Toljan,GER,DF,Sassuolo,Serie A,25,1994,16.6,21,12,16,3,2,12,27,44.4,15,15,7,8,13,34,28,0,Matches
2587,Rafael Tolói,ITA,DF,Atalanta,Serie A,29,1990,28.2,51,23,21,26,4,26,48,54.2,22,37,7,30,33,84,66,0,Matches
2588,Takehiro Tomiyasu,JPN,DF,Bologna,Serie A,21,1998,30.2,47,31,27,14,6,21,34,61.8,13,37,19,18,54,101,106,0,Matches
2589,James Tomkins,ENG,DF,Crystal Palace,Premier League,31,1989,6.1,4,2,4,0,0,3,4,75.0,1,4,3,1,4,8,45,0,Matches
2590,Fikayo Tomori,ENG,DF,Chelsea,Premier League,22,1997,0.5,2,1,2,0,0,0,0,,0,1,1,0,2,4,8,0,Matches
2591,Fikayo Tomori,ENG,DF,Milan,Serie A,22,1997,16.3,28,18,17,9,2,8,14,57.1,6,32,20,12,18,46,61,1,Matches
2592,Sandro Tonali,ITA,MF,Milan,Serie A,20,2000,14.8,28,19,14,13,1,13,28,46.4,15,18,5,13,22,50,18,0,Matches
2593,Lorenzo Tonelli,ITA,DF,Sampdoria,Serie A,30,1990,19.8,33,18,20,11,2,10,21,47.6,11,21,14,7,25,58,94,1,Matches
2594,Toño,ESP,"DF,FW",Levante,La Liga,30,1989,8.1,4,0,4,0,0,0,2,0.0,2,10,1,9,7,11,12,0,Matches
2595,Ömer Toprak,TUR,DF,Werder Bremen,Bundesliga,31,1989,21.6,23,16,15,6,2,12,24,50.0,12,27,16,11,36,59,115,1,Matches
2596,Tyron Tormin,FRA,"FW,MF",Saint-Étienne,Ligue 1,19,2001,0.2,0,0,0,0,0,0,0,,0,0,0,0,0,0,0,0,Matches
2597,Ernesto Torregrossa,VEN,FW,Sampdoria,Serie A,28,1992,1.9,1,1,0,0,1,0,2,0.0,2,4,0,4,1,2,1,0,Matches
2598,Lucas Torreira,URU,MF,Atlético Madrid,La Liga,24,1996,5.8,8,4,2,3,3,0,3,0.0,3,5,3,2,12,20,8,0,Matches
2599,Ferrán Torres,ESP,"FW,MF",Manchester City,Premier League,20,2000,14.5,12,5,4,6,2,5,16,31.3,11,16,0,16,3,15,8,0,Matches
2600,Óliver Torres,ESP,"MF,FW",Sevilla,La Liga,25,1994,15.6,34,22,13,15,6,19,53,35.8,34,15,0,15,15,49,9,0,Matches
2601,Pau Torres,ESP,DF,Villarreal,La Liga,23,1997,33.0,17,11,10,5,2,11,18,61.1,7,33,25,8,23,40,111,1,Matches
2602,Roberto Torres,ESP,"MF,FW",Osasuna,La Liga,31,1989,21.0,15,8,6,5,4,8,29,27.6,21,12,0,12,16,31,13,0,Matches
2603,Lucas Torró,ESP,MF,Osasuna,La Liga,26,1994,17.2,32,15,11,19,2,21,34,61.8,13,16,7,9,27,59,43,0,Matches
2604,Jordan Torunarigha,GER,DF,Hertha BSC,Bundesliga,22,1997,10.8,7,4,7,0,0,5,8,62.5,3,8,2,6,15,22,54,1,Matches
2605,Cenk Tosun,TUR,FW,Everton,Premier League,29,1991,0.5,0,0,0,0,0,0,1,0.0,1,0,0,0,0,0,0,0,Matches
2606,Abdoulaye Touré,GUI,MF,Nantes,Ligue 1,26,1994,18.7,28,12,10,16,2,14,31,45.2,17,17,2,15,22,50,19,0,Matches
2607,Almamy Touré,MLI,DF,Eint Frankfurt,Bundesliga,24,1996,7.8,18,12,8,7,3,10,14,71.4,4,5,1,4,8,26,22,0,Matches
2608,Lucas Tousart,FRA,MF,Hertha BSC,Bundesliga,23,1997,23.2,33,18,16,15,2,13,27,48.1,14,33,6,27,40,73,52,0,Matches
2609,Andros Townsend,ENG,"MF,FW",Crystal Palace,Premier League,29,1991,25.1,78,41,45,20,13,30,79,38.0,49,48,2,46,41,119,19,0,Matches
2610,Conor Townsend,ENG,DF,West Brom,Premier League,27,1993,24.8,44,28,32,9,3,30,49,61.2,19,38,15,23,36,80,55,2,Matches
2611,Mattéo Tramoni,FRA,"MF,FW",Cagliari,Serie A,20,2000,0.8,4,2,2,1,1,1,2,50.0,1,5,0,5,1,5,2,0,Matches
2612,Adama Traoré,ESP,"FW,MF",Wolves,Premier League,24,1996,29.4,28,16,11,13,4,13,21,61.9,8,23,1,22,7,35,12,1,Matches
2613,Amadou Traore,FRA,"FW,MF",Bordeaux,Ligue 1,18,2002,3.4,6,1,2,2,2,2,9,22.2,7,9,0,9,1,7,2,0,Matches
2614,Bertrand Traoré,BFA,FW,Aston Villa,Premier League,24,1995,25.7,26,10,8,10,8,10,34,29.4,24,23,1,22,15,41,14,1,Matches
2615,Boubacar Traoré,MLI,MF,Metz,Ligue 1,18,2001,0.6,3,2,1,2,0,1,1,100.0,0,1,0,1,0,3,0,0,Matches
2616,Chaka Traorè,CIV,"FW,DF",Parma,Serie A,15,2004,0.2,0,0,0,0,0,0,0,,0,0,0,0,0,0,1,1,Matches
2617,Charles Traore,MLI,DF,Nantes,Ligue 1,28,1992,18.9,53,34,30,17,6,27,54,50.0,27,26,5,21,36,89,65,0,Matches
2618,Cheick Traoré,MLI,DF,Lens,Ligue 1,25,1995,0.4,2,2,1,1,0,2,4,50.0,2,1,0,1,2,4,1,0,Matches
2619,Hamari Traoré,MLI,DF,Rennes,Ligue 1,28,1992,33.3,56,38,23,27,6,22,59,37.3,37,31,5,26,76,132,50,0,Matches
2620,Ibrahima Traoré,GUI,"FW,DF",Gladbach,Bundesliga,32,1988,1.1,4,1,1,2,1,0,0,,0,2,0,2,0,4,0,0,Matches
2621,Ismaël Traoré,CIV,DF,Angers,Ligue 1,33,1986,33.3,32,14,23,9,0,20,37,54.1,17,27,13,14,40,72,107,0,Matches
2622,Kevin Trapp,GER,GK,Eint Frankfurt,Bundesliga,30,1990,33.0,0,0,0,0,0,0,1,0.0,1,1,0,1,3,3,11,3,Matches
2623,Miguel Trauco,PER,DF,Saint-Étienne,Ligue 1,27,1992,22.6,47,29,25,14,8,23,43,53.5,20,19,4,15,30,77,34,1,Matches
2624,Trézéguet,EGY,FW,Aston Villa,Premier League,25,1994,13.0,33,18,14,15,4,13,45,28.9,32,13,1,12,19,52,17,0,Matches
2625,Manu Trigueros,ESP,MF,Villarreal,La Liga,28,1991,28.1,51,30,25,21,5,21,77,27.3,56,32,2,30,17,68,19,0,Matches
2626,Christopher Trimmel,AUT,"DF,FW",Union Berlin,Bundesliga,33,1987,28.6,50,25,28,18,4,28,54,51.9,26,32,7,25,50,100,99,0,Matches
2627,Francisco Trincão,POR,"FW,MF",Barcelona,La Liga,20,1999,7.8,4,2,0,3,1,2,5,40.0,3,4,0,4,1,5,2,0,Matches
2628,Alessandro Tripaldelli,ITA,DF,Cagliari,Serie A,21,1999,3.3,13,6,5,6,2,5,6,83.3,1,6,1,5,3,16,15,0,Matches
2629,Kieran Trippier,ENG,DF,Atlético Madrid,La Liga,29,1990,27.5,61,39,30,25,6,26,52,50.0,26,22,4,18,40,101,58,1,Matches
2630,Leandro Trossard,BEL,"MF,FW",Brighton,Premier League,25,1994,29.0,33,14,11,16,6,10,36,27.8,26,34,2,32,26,59,7,1,Matches
2631,Alexis Trouillet,FRA,"MF,FW",Nice,Ligue 1,19,2000,1.2,5,4,1,4,0,4,5,80.0,1,0,0,0,3,8,0,0,Matches
2632,Adrien Truffert,FRA,"DF,MF",Rennes,Ligue 1,18,2001,21.7,38,18,18,12,8,13,24,54.2,11,26,5,21,18,56,38,1,Matches
2633,Marvin Tshibuabua,FRA,DF,Saint-Étienne,Ligue 1,18,2002,0.5,1,0,1,0,0,0,0,,0,0,0,0,1,2,1,0,Matches
2634,Kostas Tsimikas,GRE,"DF,FW",Liverpool,Premier League,24,1996,0.1,0,0,0,0,0,0,0,,0,0,0,0,0,0,0,0,Matches
2635,Axel Tuanzebe,COD,DF,Manchester Utd,Premier League,22,1997,4.5,13,7,5,7,1,8,9,88.9,1,7,5,2,3,16,18,0,Matches
2636,Alessandro Tuia,ITA,DF,Benevento,Serie A,30,1990,19.6,39,17,34,4,1,15,25,60.0,10,22,10,12,36,75,91,1,Matches
2637,Ľubomír Tupta,SVK,FW,Hellas Verona,Serie A,22,1998,0.6,0,0,0,0,0,0,0,,0,0,0,0,0,0,0,0,Matches
2638,Tuta,BRA,DF,Eint Frankfurt,Bundesliga,21,1999,16.2,35,20,22,13,0,24,43,55.8,19,19,2,17,29,64,53,0,Matches
2639,Destiny Udogie,ITA,"DF,MF",Hellas Verona,Serie A,17,2002,1.9,6,4,2,2,2,2,2,100.0,0,3,0,3,2,8,4,0,Matches
2640,Matthieu Udol,FRA,DF,Metz,Ligue 1,24,1996,19.2,34,21,18,12,4,17,39,43.6,22,25,5,20,39,73,30,0,Matches
2641,Naomichi Ueda,JPN,DF,Nîmes,Ligue 1,25,1994,7.9,4,2,3,1,0,4,6,66.7,2,5,4,1,6,10,30,1,Matches
2642,Lesley Ugochukwu,FRA,MF,Rennes,Ligue 1,16,2004,0.7,3,1,0,3,0,2,3,66.7,1,1,0,1,0,3,0,0,Matches
2643,Hwang Ui-jo,KOR,"FW,MF",Bordeaux,Ligue 1,27,1992,27.8,14,6,5,8,1,6,25,24.0,19,17,2,15,8,22,14,0,Matches
2644,Samir Ujkani,KVX,GK,Torino,Serie A,32,1988,1.0,0,0,0,0,0,0,0,,0,0,0,0,0,0,1,0,Matches
2645,Samuel Umtiti,FRA,DF,Barcelona,La Liga,26,1993,7.2,5,1,3,2,0,1,2,50.0,1,11,6,5,9,14,15,0,Matches
2646,Enes Ünal,TUR,FW,Getafe,La Liga,23,1997,14.6,11,3,0,8,3,4,15,26.7,11,11,0,11,2,13,14,0,Matches
2647,Cengiz Ünder,TUR,"FW,MF",Leicester City,Premier League,23,1997,3.1,4,1,0,3,1,3,5,60.0,2,3,0,3,2,6,0,0,Matches
2648,Dayot Upamecano,FRA,DF,RB Leipzig,Bundesliga,21,1998,25.9,37,30,18,19,0,14,20,70.0,6,25,14,11,33,70,74,2,Matches
2649,Kacper Urbanski,POL,FW,Bologna,Serie A,15,2004,0.0,0,0,0,0,0,0,0,,0,0,0,0,0,0,0,0,Matches
2650,Mark Uth,GER,"FW,MF",Schalke 04,Bundesliga,28,1991,16.6,25,13,13,10,2,5,23,21.7,18,21,0,21,5,30,10,0,Matches
2651,Tomáš Vaclík,CZE,GK,Sevilla,La Liga,31,1989,5.0,0,0,0,0,0,0,1,0.0,1,0,0,0,0,0,0,1,Matches
2652,Eugeni Valderrama,ESP,"MF,FW",Huesca,La Liga,26,1994,1.3,2,2,1,0,1,0,1,0.0,1,0,0,0,5,7,3,0,Matches
2653,Lautaro Valenti,ARG,DF,Parma,Serie A,21,1999,5.5,10,4,7,2,1,6,15,40.0,9,11,3,8,11,21,30,0,Matches
2654,Antoine Valerio,FRA,MF,Nîmes,Ligue 1,20,1999,0.8,0,0,0,0,0,0,1,0.0,1,1,0,1,2,2,0,0,Matches
2655,Borja Valero,ESP,"MF,FW",Fiorentina,Serie A,35,1985,5.5,13,9,7,4,2,3,15,20.0,12,6,1,5,6,19,2,0,Matches
2656,Yan Valery,TUN,"DF,MF",Southampton,Premier League,21,1999,1.1,5,3,2,3,0,1,5,20.0,4,2,0,2,2,7,5,0,Matches
2657,Jesús Vallejo,ESP,DF,Granada,La Liga,23,1997,15.0,11,6,7,3,1,7,18,38.9,11,21,11,10,13,24,55,0,Matches
2658,Manu Vallejo,ESP,"FW,MF",Valencia,La Liga,23,1997,10.6,18,8,5,8,5,5,26,19.2,21,8,0,8,3,21,3,0,Matches
2659,Federico Valverde,URU,MF,Real Madrid,La Liga,22,1998,14.8,25,16,9,8,8,10,26,38.5,16,16,2,14,22,47,4,0,Matches
2660,Virgil van Dijk,NED,DF,Liverpool,Premier League,29,1991,4.1,3,2,1,2,0,0,0,,0,1,1,0,5,8,8,1,Matches
2661,Raphaël Varane,FRA,DF,Real Madrid,La Liga,27,1993,30.2,22,14,16,5,1,10,19,52.6,9,26,18,8,36,58,114,2,Matches
2662,Jamie Vardy,ENG,FW,Leicester City,Premier League,33,1987,31.6,18,12,1,8,9,2,15,13.3,13,14,5,9,4,22,32,0,Matches
2663,Ruben Vargas,SUI,"MF,FW",Augsburg,Bundesliga,21,1998,17.9,18,12,6,9,3,1,16,6.3,15,26,2,24,18,36,27,0,Matches
2664,Denis Vavro,SVK,DF,Lazio,Serie A,24,1996,0.4,0,0,0,0,0,0,1,0.0,1,0,0,0,1,1,3,0,Matches
2665,Denis Vavro,SVK,DF,Huesca,La Liga,24,1996,6.8,7,4,2,4,1,2,5,40.0,3,2,0,2,11,18,21,0,Matches
2666,Franco Vázquez,ARG,"FW,MF",Sevilla,La Liga,31,1989,1.8,5,1,0,3,2,1,5,20.0,4,2,1,1,1,6,1,0,Matches
2667,Kevin Vázquez,ESP,DF,Celta Vigo,La Liga,27,1993,6.2,11,5,9,2,0,3,9,33.3,6,8,0,8,9,20,18,0,Matches
2668,Lucas Vázquez,ESP,"DF,FW",Real Madrid,La Liga,29,1991,20.5,61,37,30,22,9,22,52,42.3,30,14,1,13,19,80,31,1,Matches
2669,Matías Vecino,URU,MF,Inter,Serie A,28,1991,3.1,1,1,0,0,1,0,5,0.0,5,7,1,6,4,5,3,0,Matches
2670,Koke Vegas,ESP,GK,Levante,La Liga,24,1995,1.0,0,0,0,0,0,0,0,,0,0,0,0,0,0,1,1,Matches
2671,Gabriel Veiga,ESP,"MF,DF",Celta Vigo,La Liga,18,2002,1.3,3,0,3,0,0,1,4,25.0,3,3,0,3,3,6,0,0,Matches
2672,Miloš Veljković,SRB,DF,Werder Bremen,Bundesliga,24,1995,19.1,24,14,17,6,1,15,31,48.4,16,22,9,13,29,53,94,1,Matches
2673,Miguel Veloso,POR,MF,Hellas Verona,Serie A,34,1986,14.6,24,17,10,10,4,12,34,35.3,22,12,1,11,12,36,25,0,Matches
2674,Joël Veltman,NED,DF,Brighton,Premier League,28,1992,25.3,67,33,34,25,8,29,57,50.9,28,24,5,19,33,100,64,0,Matches
2675,Unai Vencedor Paris,ESP,MF,Athletic Club,La Liga,19,2000,18.9,31,21,10,15,6,11,42,26.2,31,17,6,11,18,49,14,0,Matches
2676,Lorenzo Venuti,ITA,DF,Fiorentina,Serie A,25,1995,19.5,24,11,14,7,3,14,28,50.0,14,18,3,15,17,41,24,0,Matches
2677,Daniele Verde,ITA,FW,Spezia,Serie A,24,1996,10.9,5,4,2,2,1,4,10,40.0,6,5,0,5,9,14,7,0,Matches
2678,Simone Verdi,ITA,"MF,FW",Torino,Serie A,28,1992,18.0,19,12,10,6,3,6,19,31.6,13,8,0,8,8,27,2,2,Matches
2679,Gonzalo Verdú,ESP,DF,Elche,La Liga,31,1988,32.7,34,19,26,8,0,16,28,57.1,12,40,30,10,52,86,113,0,Matches
2680,Jordan Veretout,FRA,MF,Roma,Serie A,27,1993,22.8,20,12,8,12,0,9,33,27.3,24,14,3,11,14,34,21,3,Matches
2681,Edoardo Vergani,ITA,FW,Bologna,Serie A,19,2001,0.1,0,0,0,0,0,0,0,,0,0,0,0,0,0,0,0,Matches
2682,Marco Verratti,ITA,MF,Paris S-G,Ligue 1,27,1992,16.6,53,30,17,25,11,24,72,33.3,48,22,5,17,26,79,4,1,Matches
2683,Valerio Verre,ITA,"FW,MF",Sampdoria,Serie A,26,1994,11.1,11,7,2,7,2,4,19,21.1,15,14,2,12,9,20,3,0,Matches
2684,Mikel Vesga,ESP,MF,Athletic Club,La Liga,27,1993,19.1,28,14,8,16,4,12,50,24.0,38,28,8,20,27,55,35,1,Matches
2685,Jannik Vestergaard,DEN,DF,Southampton,Premier League,27,1992,28.6,50,31,31,15,4,35,52,67.3,17,29,16,13,42,92,122,0,Matches
2686,Rúben Vezo,POR,DF,Levante,La Liga,26,1994,25.7,34,19,26,7,1,12,29,41.4,17,22,11,11,46,80,106,3,Matches
2687,Guglielmo Vicario,ITA,GK,Cagliari,Serie A,23,1996,4.0,0,0,0,0,0,0,0,,0,0,0,0,0,0,1,0,Matches
2688,Iñigo Vicente,ESP,"FW,MF",Athletic Club,La Liga,22,1998,0.6,1,1,1,0,0,1,1,100.0,0,0,0,0,0,1,0,0,Matches
2689,Fede Vico,ESP,"MF,FW",Granada,La Liga,26,1994,8.5,10,6,5,5,0,3,10,30.0,7,15,1,14,12,22,5,0,Matches
2690,Aleix Vidal,ESP,DF,Sevilla,La Liga,30,1989,6.6,9,5,5,3,1,5,12,41.7,7,10,1,9,12,21,9,0,Matches
2691,Arturo Vidal,CHI,MF,Inter,Serie A,33,1987,12.6,27,14,8,13,6,12,41,29.3,29,23,3,20,29,56,11,0,Matches
2692,Clément Vidal,FRA,DF,Montpellier,Ligue 1,20,2000,1.0,2,1,1,1,0,2,4,50.0,2,4,4,0,1,3,6,1,Matches
2693,Nacho Vidal,ESP,DF,Osasuna,La Liga,25,1995,26.1,56,28,27,22,7,22,31,71.0,9,39,10,29,43,99,68,0,Matches
2694,Ronaldo Vieira,ENG,"MF,DF",Hellas Verona,Serie A,22,1998,2.5,5,3,1,3,1,0,2,0.0,2,4,3,1,0,5,2,0,Matches
2695,Luca Vignali,ITA,DF,Spezia,Serie A,24,1996,17.7,19,9,10,6,3,7,25,28.0,18,13,5,8,22,41,25,0,Matches
2696,Emanuel Vignato,ITA,"FW,MF",Bologna,Serie A,19,2000,13.4,18,9,9,6,3,3,15,20.0,12,6,1,5,10,28,7,0,Matches
2697,Toni Villa,ESP,"MF,FW",Valladolid,La Liga,25,1995,10.8,31,16,11,14,6,15,42,35.7,27,15,1,14,5,36,3,0,Matches
2698,Asier Villalibre,ESP,FW,Athletic Club,La Liga,22,1997,17.7,3,2,0,2,1,2,8,25.0,6,4,0,4,2,5,16,0,Matches
2699,Gonzalo Villar,ESP,MF,Roma,Serie A,22,1998,20.7,44,18,14,24,6,18,61,29.5,43,25,3,22,22,66,14,1,Matches
2700,Iván Villar,ESP,GK,Celta Vigo,La Liga,23,1997,19.8,0,0,0,0,0,0,1,0.0,1,0,0,0,0,0,18,0,Matches
2701,Rúben Vinagre,POR,"MF,DF",Wolves,Premier League,21,1999,1.9,7,5,5,2,0,3,4,75.0,1,3,0,3,2,9,4,0,Matches
2702,Carlos Vinícius,BRA,FW,Tottenham,Premier League,25,1995,3.4,3,1,2,1,0,1,1,100.0,0,0,0,0,2,5,5,0,Matches
2703,Nicolas Viola,ITA,MF,Benevento,Serie A,30,1989,11.5,16,9,2,11,3,6,28,21.4,22,10,3,7,9,25,7,0,Matches
2704,João Virgínia,POR,GK,Everton,Premier League,20,1999,0.5,0,0,0,0,0,0,0,,0,0,0,0,0,0,0,0,Matches
2705,Vitinha,POR,MF,Wolves,Premier League,20,2000,5.8,7,3,2,5,0,3,8,37.5,5,3,0,3,3,10,1,0,Matches
2706,Vitolo,ESP,"MF,FW",Atlético Madrid,La Liga,30,1989,3.3,4,1,2,0,2,1,6,16.7,5,3,0,3,3,7,2,0,Matches
2707,Dušan Vlahović,SRB,FW,Fiorentina,Serie A,20,2000,32.5,13,4,3,4,6,5,16,31.3,11,16,2,14,4,17,15,0,Matches
2708,Michel Vlap,NED,"MF,FW",Arminia,Bundesliga,23,1997,4.1,1,1,0,1,0,0,8,0.0,8,4,0,4,5,6,3,0,Matches
2709,Andreas Voglsammer,GER,"FW,MF",Arminia,Bundesliga,28,1992,11.1,12,8,6,6,0,8,17,47.1,9,11,0,11,3,15,11,0,Matches
2710,Kevin Vogt,GER,DF,Hoffenheim,Bundesliga,28,1991,20.5,18,12,11,6,1,12,21,57.1,9,21,12,9,16,34,71,0,Matches
2711,Mërgim Vojvoda,KVX,"DF,FW",Torino,Serie A,25,1995,15.1,24,14,18,5,1,12,22,54.5,10,19,4,15,18,42,35,1,Matches
2712,Jake Vokins,ENG,DF,Southampton,Premier League,20,2000,0.7,0,0,0,0,0,0,1,0.0,1,0,0,0,0,0,0,0,Matches
2713,Kevin Volland,GER,"FW,MF",Monaco,Ligue 1,28,1992,30.8,33,16,11,19,3,8,34,23.5,26,23,0,23,4,37,4,0,Matches
2714,Stefan de Vrij,NED,DF,Inter,Serie A,28,1992,30.4,28,16,15,12,1,15,24,62.5,9,24,18,6,41,69,95,0,Matches
2715,Giacomo Vrioni,ALB,FW,Juventus,Serie A,21,1998,0.0,0,0,0,0,0,0,0,,0,0,0,0,0,0,0,0,Matches
2716,Šime Vrsaljko,CRO,"FW,DF",Atlético Madrid,La Liga,28,1992,5.8,18,12,13,5,0,8,12,66.7,4,5,0,5,8,26,14,0,Matches
2717,Nikola Vukčević,MNE,MF,Levante,La Liga,28,1991,9.0,14,7,5,8,1,9,18,50.0,9,8,5,3,8,22,12,1,Matches
2718,Miloš Vulić,SRB,MF,Crotone,Serie A,23,1996,14.5,15,8,9,1,5,8,21,38.1,13,10,1,9,8,23,8,0,Matches
2719,Matěj Vydra,CZE,FW,Burnley,Premier League,28,1992,15.2,9,5,2,4,3,1,8,12.5,7,8,1,7,6,15,5,0,Matches
2720,Franklin Wadja,CMR,"MF,FW",Lorient,Ligue 1,25,1995,0.4,4,2,0,2,2,2,2,100.0,0,0,0,0,2,6,1,0,Matches
2721,Elye Wahi,FRA,FW,Montpellier,Ligue 1,17,2003,6.2,4,3,2,1,1,1,6,16.7,5,4,0,4,2,6,5,0,Matches
2722,Walace,BRA,MF,Udinese,Serie A,25,1995,22.8,50,23,28,19,3,21,60,35.0,39,36,3,33,34,84,23,0,Matches
2723,Theo Walcott,ENG,"MF,FW",Southampton,Premier League,31,1989,18.0,23,11,8,9,6,11,32,34.4,21,16,0,16,14,37,5,0,Matches
2724,Theo Walcott,ENG,FW,Everton,Premier League,31,1989,0.1,0,0,0,0,0,0,0,,0,0,0,0,0,0,0,0,Matches
2725,Kyle Walker,ENG,DF,Manchester City,Premier League,30,1990,21.6,29,19,15,12,2,16,24,66.7,8,19,7,12,14,43,28,0,Matches
2726,Kyle Walker-Peters,ENG,DF,Southampton,Premier League,23,1997,29.4,83,53,56,25,2,34,57,59.6,23,41,10,31,38,121,66,2,Matches
2727,Sebastian Walukiewicz,POL,DF,Cagliari,Serie A,20,2000,18.0,27,19,11,13,3,12,30,40.0,18,22,14,8,36,63,60,0,Matches
2728,Aaron Wan-Bissaka,ENG,DF,Manchester Utd,Premier League,22,1997,34.0,88,54,53,29,6,32,45,71.1,13,65,17,48,62,150,84,2,Matches
2729,Joel Ward,ENG,DF,Crystal Palace,Premier League,30,1989,25.1,43,25,29,14,0,24,42,57.1,18,27,8,19,41,84,87,2,Matches
2730,James Ward-Prowse,ENG,MF,Southampton,Premier League,25,1994,38.0,75,49,30,41,4,29,70,41.4,41,36,4,32,42,117,60,0,Matches
2731,Daniel Wass,DEN,"MF,DF",Valencia,La Liga,31,1989,33.1,52,31,21,29,2,22,55,40.0,33,33,13,20,47,99,69,0,Matches
2732,Ollie Watkins,ENG,FW,Aston Villa,Premier League,24,1995,37.0,29,17,5,16,8,10,33,30.3,23,21,2,19,7,36,24,0,Matches
2733,Caleb Watts,AUS,MF,Southampton,Premier League,18,2002,0.4,2,1,2,0,0,1,2,50.0,1,0,0,0,0,2,0,0,Matches
2734,Timothy Weah,USA,"FW,MF",Lille,Ligue 1,20,2000,9.8,15,7,3,9,3,7,14,50.0,7,7,0,7,4,19,5,0,Matches
2735,Adam Webster,ENG,DF,Brighton,Premier League,25,1995,28.8,29,16,15,10,4,12,25,48.0,13,29,16,13,47,76,92,3,Matches
2736,Wout Weghorst,NED,FW,Wolfsburg,Bundesliga,27,1992,32.7,13,8,2,8,3,4,20,20.0,16,17,3,14,4,17,26,0,Matches
2737,Mitchell Weiser,GER,DF,Leverkusen,Bundesliga,26,1994,2.5,4,1,1,2,1,2,4,50.0,2,1,0,1,3,7,4,0,Matches
2738,Shon Weissman,ISR,FW,Valladolid,La Liga,24,1996,23.7,12,9,4,5,3,2,23,8.7,21,17,3,14,8,20,7,0,Matches
2739,Danny Welbeck,ENG,FW,Brighton,Premier League,29,1990,17.2,12,6,2,6,4,7,19,36.8,12,17,0,17,7,19,13,0,Matches
2740,Wendell,BRA,DF,Leverkusen,Bundesliga,27,1993,16.2,53,35,27,18,8,23,49,46.9,26,26,3,23,25,78,39,1,Matches
2741,Oscar Wendt,SWE,DF,Gladbach,Bundesliga,34,1985,13.9,12,6,2,9,1,4,12,33.3,8,18,4,14,14,26,23,0,Matches
2742,Timo Werner,GER,"FW,MF",Chelsea,Premier League,24,1996,28.9,20,9,6,11,3,7,43,16.3,36,23,1,22,8,28,8,0,Matches
2743,Ashley Westwood,ENG,MF,Burnley,Premier League,30,1990,37.9,23,15,6,12,5,10,42,23.8,32,26,9,17,44,67,33,0,Matches
2744,Ben White,ENG,"DF,MF",Brighton,Premier League,22,1997,35.5,49,26,21,24,4,24,57,42.1,33,46,22,24,62,111,56,0,Matches
2745,Georginio Wijnaldum,NED,MF,Liverpool,Premier League,29,1990,32.7,23,7,6,14,3,7,31,22.6,24,18,3,15,26,49,18,1,Matches
2746,William,BRA,"MF,FW",Wolfsburg,Bundesliga,25,1995,0.0,0,0,0,0,0,0,0,,0,0,0,0,0,0,0,0,Matches
2747,William,BRA,"DF,FW",Schalke 04,Bundesliga,25,1995,5.3,14,10,10,4,0,5,15,33.3,10,16,5,11,11,25,15,1,Matches
2748,Brandon Williams,ENG,DF,Manchester Utd,Premier League,19,2000,2.1,0,0,0,0,0,0,1,0.0,1,1,0,1,1,1,7,0,Matches
2749,Iñaki Williams,GHA,FW,Athletic Club,La Liga,26,1994,26.5,11,7,0,4,7,2,14,14.3,12,13,1,12,5,16,22,0,Matches
2750,Neco Williams,WAL,DF,Liverpool,Premier League,19,2001,2.8,6,5,4,2,0,5,9,55.6,4,3,1,2,6,12,6,0,Matches
2751,Nico Williams,ESP,MF,Athletic Club,La Liga,18,2002,0.6,1,0,1,0,0,0,2,0.0,2,0,0,0,1,2,0,0,Matches
2752,Rhys Williams,ENG,DF,Liverpool,Premier League,19,2001,7.3,6,4,3,3,0,3,3,100.0,0,4,3,1,6,12,27,1,Matches
2753,Willian,BRA,FW,Arsenal,Premier League,31,1988,15.6,13,7,6,6,1,6,16,37.5,10,13,0,13,8,21,8,0,Matches
2754,Joe Willock,ENG,MF,Arsenal,Premier League,20,1999,2.6,6,3,1,4,1,3,7,42.9,4,6,1,5,3,9,0,0,Matches
2755,Joe Willock,ENG,MF,Newcastle Utd,Premier League,20,1999,10.9,26,13,16,7,3,9,42,21.4,33,21,3,18,17,43,15,1,Matches
2756,Callum Wilson,ENG,FW,Newcastle Utd,Premier League,28,1992,23.2,12,5,1,6,5,2,12,16.7,10,10,3,7,7,19,14,0,Matches
2757,Marten Winkler,GER,FW,Hertha BSC,Bundesliga,17,2002,0.0,0,0,0,0,0,0,0,,0,0,0,0,0,0,0,0,Matches
2758,Harry Winks,ENG,MF,Tottenham,Premier League,24,1996,9.6,16,9,11,5,0,5,20,25.0,15,16,4,12,11,27,12,1,Matches
2759,Florian Wirtz,GER,MF,Leverkusen,Bundesliga,17,2003,24.7,35,18,8,22,5,11,37,29.7,26,27,1,26,9,44,8,0,Matches
2760,Yoane Wissa,COD,"MF,FW",Lorient,Ligue 1,23,1996,29.7,35,20,12,14,9,11,34,32.4,23,25,3,22,20,55,14,0,Matches
2761,Axel Witsel,BEL,MF,Dortmund,Bundesliga,31,1989,12.6,18,12,6,11,1,8,16,50.0,8,13,3,10,22,40,13,0,Matches
2762,Hannes Wolf,AUT,"MF,FW",Gladbach,Bundesliga,21,1999,15.3,26,13,8,10,8,8,36,22.2,28,18,1,17,9,35,4,0,Matches
2763,Marius Wolf,GER,"MF,DF",Köln,Bundesliga,25,1995,28.3,35,19,19,13,3,13,38,34.2,25,29,3,26,28,63,47,1,Matches
2764,Nick Woltemade,GER,"MF,FW",Werder Bremen,Bundesliga,18,2002,1.6,3,2,1,1,1,2,4,50.0,2,1,0,1,0,3,0,0,Matches
2765,Jeong Woo-yeong,KOR,"FW,MF",Freiburg,Bundesliga,20,1999,9.1,9,5,1,6,2,2,11,18.2,9,8,1,7,11,20,11,0,Matches
2766,Chris Wood,NZL,FW,Burnley,Premier League,28,1991,30.5,12,7,2,4,6,5,18,27.8,13,14,3,11,1,13,21,0,Matches
2767,Joscha Wosz,GER,DF,RB Leipzig,Bundesliga,18,2002,0.4,1,1,1,0,0,0,0,,0,1,0,1,1,2,0,0,Matches
2768,Xeka,POR,MF,Lille,Ligue 1,25,1994,13.3,33,17,14,15,4,16,43,37.2,27,14,2,12,20,53,18,0,Matches
2769,Granit Xhaka,SUI,"MF,DF",Arsenal,Premier League,27,1992,28.0,50,26,18,17,15,30,58,51.7,28,23,7,16,24,74,38,3,Matches
2770,Reinhold Yabo,GER,"MF,FW",Arminia,Bundesliga,28,1992,7.2,5,2,2,2,1,2,9,22.2,7,6,1,5,4,9,1,0,Matches
2771,Jawad El Yamiq,MAR,DF,Valladolid,La Liga,28,1992,15.3,21,14,14,7,0,8,11,72.7,3,15,10,5,46,67,100,0,Matches
2772,Rubén Yáñez,ESP,GK,Getafe,La Liga,26,1993,10.0,0,0,0,0,0,0,1,0.0,1,0,0,0,2,2,2,0,Matches
2773,Andriy Yarmolenko,UKR,"FW,MF",West Ham,Premier League,30,1989,4.2,5,4,2,2,1,2,8,25.0,6,1,0,1,1,6,2,0,Matches
2774,Yusuf Yazıcı,TUR,"FW,MF",Lille,Ligue 1,23,1997,12.1,12,5,6,2,4,1,24,4.2,23,5,1,4,2,14,2,0,Matches
2775,DeAndre Yedlin,USA,DF,Newcastle Utd,Premier League,27,1993,4.8,9,4,8,1,0,4,10,40.0,6,5,1,4,7,16,17,0,Matches
2776,Burak Yılmaz,TUR,FW,Lille,Ligue 1,35,1985,22.8,13,6,3,7,3,4,30,13.3,26,7,0,7,5,18,22,0,Matches
2777,Yoel,ESP,GK,Eibar,La Liga,31,1988,3.3,0,0,0,0,0,0,0,,0,0,0,0,0,0,2,0,Matches
2778,Okay Yokuşlu,TUR,MF,West Brom,Premier League,26,1994,14.6,38,25,21,13,4,17,35,48.6,18,15,3,12,35,73,33,1,Matches
2779,Okay Yokuşlu,TUR,MF,Celta Vigo,La Liga,26,1994,5.1,14,8,8,4,2,5,9,55.6,4,5,2,3,10,24,9,0,Matches
2780,Maya Yoshida,JPN,DF,Sampdoria,Serie A,31,1988,25.3,17,4,10,7,0,7,13,53.8,6,45,34,11,57,74,93,1,Matches
2781,Amin Younes,GER,MF,Eint Frankfurt,Bundesliga,26,1993,15.5,25,14,8,10,7,6,32,18.8,26,19,1,18,13,38,4,0,Matches
2782,Ashley Young,ENG,DF,Inter,Serie A,35,1985,15.8,15,7,8,4,3,3,13,23.1,10,13,0,13,6,21,31,0,Matches
2783,Wilitty Younoussa,CMR,MF,Dijon,Ligue 1,18,2001,0.9,6,3,3,3,0,3,7,42.9,4,3,0,3,2,8,0,0,Matches
2784,Zaydou Youssouf,FRA,MF,Saint-Étienne,Ligue 1,21,1999,13.7,30,15,19,10,1,16,40,40.0,24,15,0,15,25,55,12,1,Matches
2785,Mattia Zaccagni,ITA,MF,Hellas Verona,Serie A,25,1995,29.0,27,13,8,11,8,8,25,32.0,17,28,4,24,27,54,13,1,Matches
2786,Dan-Axel Zagadou,FRA,DF,Dortmund,Bundesliga,21,1999,3.1,2,2,2,0,0,0,0,,0,3,2,1,6,8,13,0,Matches
2787,Vasilios Zagaritis,GRE,DF,Parma,Serie A,19,2001,0.7,0,0,0,0,0,0,0,,0,1,0,1,0,0,0,0,Matches
2788,Arthur Zagre,FRA,"DF,MF",Dijon,Ligue 1,18,2001,1.4,3,1,2,1,0,2,2,100.0,0,1,1,0,3,6,1,0,Matches
2789,Wilfried Zaha,CIV,FW,Crystal Palace,Premier League,27,1992,29.0,26,18,8,15,3,11,30,36.7,19,21,0,21,9,35,4,0,Matches
2790,Miha Zajc,SVN,MF,Genoa,Serie A,26,1994,20.7,22,14,9,10,3,13,39,33.3,26,30,4,26,27,49,19,0,Matches
2791,Denis Zakaria,SUI,"MF,DF",Gladbach,Bundesliga,23,1996,15.8,30,15,12,15,3,11,20,55.0,9,20,7,13,23,53,29,1,Matches
2792,Joseba Zaldúa,ESP,DF,Real Sociedad,La Liga,28,1992,7.1,15,12,7,5,3,6,18,33.3,12,6,2,4,6,21,13,0,Matches
2793,Nicola Zalewski,POL,MF,Roma,Serie A,18,2002,0.1,1,1,0,1,0,1,1,100.0,0,0,0,0,0,1,0,0,Matches
2794,Andre-Frank Zambo Anguissa,CMR,MF,Fulham,Premier League,24,1995,28.7,78,37,27,38,13,27,68,39.7,41,35,6,29,56,134,17,2,Matches
2795,Niccolò Zanellato,ITA,MF,Crotone,Serie A,22,1998,18.2,24,14,16,6,2,13,36,36.1,23,19,5,14,16,40,12,2,Matches
2796,Cristián Zapata,COL,DF,Genoa,Serie A,33,1986,10.8,18,12,11,7,0,10,14,71.4,4,15,11,4,15,33,56,0,Matches
2797,Duván Zapata,COL,FW,Atalanta,Serie A,29,1991,26.4,12,5,2,3,7,4,13,30.8,9,19,5,14,6,18,19,0,Matches
2798,Gabriele Zappa,ITA,DF,Cagliari,Serie A,20,1999,26.6,34,17,16,15,3,22,49,44.9,27,36,4,32,24,58,50,0,Matches
2799,Davide Zappacosta,ITA,DF,Genoa,Serie A,28,1992,22.7,33,16,15,13,5,15,30,50.0,15,17,1,16,18,51,41,0,Matches
2800,Oier Zarraga,ESP,MF,Athletic Club,La Liga,21,1999,1.1,1,1,0,1,0,1,2,50.0,1,1,0,1,0,1,0,0,Matches
2801,Simone Zaza,ITA,FW,Torino,Serie A,29,1991,16.6,15,9,4,6,5,6,20,30.0,14,14,0,14,3,18,5,1,Matches
2802,Deyovaisio Zeefuik,NED,"DF,FW",Hertha BSC,Bundesliga,22,1998,10.1,13,9,8,3,2,8,19,42.1,11,15,3,12,12,25,36,0,Matches
2803,Marvin Zeegelaar,NED,DF,Udinese,Serie A,29,1990,19.3,40,18,23,16,1,20,39,51.3,19,21,9,12,24,64,43,0,Matches
2804,Arber Zeneli,KVX,"MF,FW",Reims,Ligue 1,25,1995,14.3,20,10,11,1,8,8,22,36.4,14,12,1,11,3,23,8,0,Matches
2805,Robin Zentner,GER,GK,Mainz 05,Bundesliga,25,1994,31.0,1,1,1,0,0,1,3,33.3,2,0,0,0,3,4,9,2,Matches
2806,Andi Zeqiri,SUI,"FW,DF",Brighton,Premier League,21,1999,1.9,3,2,0,2,1,1,2,50.0,1,1,0,1,0,3,2,0,Matches
2807,Mehdi Zerkane,ALG,"MF,FW",Bordeaux,Ligue 1,21,1999,13.2,23,15,7,10,6,5,18,27.8,13,15,2,13,9,32,5,0,Matches
2808,Ron-Robert Zieler,GER,GK,Köln,Bundesliga,31,1989,0.6,0,0,0,0,0,0,0,,0,0,0,0,0,0,0,0,Matches
2809,Piotr Zieliński,POL,MF,Napoli,Serie A,26,1994,28.0,18,10,8,7,3,7,20,35.0,13,23,4,19,18,36,12,0,Matches
2810,Oleksandr Zinchenko,UKR,DF,Manchester City,Premier League,23,1996,16.4,25,15,12,9,4,14,24,58.3,10,17,4,13,23,48,28,0,Matches
2811,Joshua Zirkzee,NED,"FW,MF",Parma,Serie A,19,2001,1.3,2,2,1,1,0,1,3,33.3,2,1,1,0,0,2,1,0,Matches
2812,Joshua Zirkzee,NED,FW,Bayern Munich,Bundesliga,19,2001,1.0,1,0,0,1,0,1,2,50.0,1,0,0,0,0,1,0,0,Matches
2813,Hakim Ziyech,MAR,"MF,FW",Chelsea,Premier League,27,1993,13.0,14,10,5,7,2,5,19,26.3,14,9,1,8,10,24,2,0,Matches
2814,Jeroen Zoet,NED,GK,Spezia,Serie A,29,1991,6.7,0,0,0,0,0,0,1,0.0,1,0,0,0,0,0,4,2,Matches
2815,Kévin Zohi,MLI,"FW,MF",Strasbourg,Ligue 1,23,1996,4.8,9,5,3,4,2,2,6,33.3,4,6,0,6,6,15,3,0,Matches
2816,Kurt Zouma,FRA,DF,Chelsea,Premier League,25,1994,22.5,16,10,8,6,2,4,8,50.0,4,13,9,4,28,44,93,0,Matches
2817,Igor Zubeldia,ESP,DF,Real Sociedad,La Liga,23,1997,21.8,23,16,15,8,0,8,14,57.1,6,20,13,7,12,35,46,0,Matches
2818,Steven Zuber,SUI,"DF,MF",Eint Frankfurt,Bundesliga,28,1991,6.5,24,12,8,13,3,8,16,50.0,8,4,1,3,4,28,1,0,Matches
2819,Martín Zubimendi,ESP,MF,Real Sociedad,La Liga,21,1999,20.9,41,22,18,20,3,20,34,58.8,14,22,10,12,40,81,39,0,Matches
2820,Martin Ødegaard,NOR,MF,Arsenal,Premier League,21,1998,9.6,9,3,2,6,1,4,14,28.6,10,2,0,2,2,11,5,0,Matches
2821,Martin Ødegaard,NOR,MF,Real Madrid,La Liga,21,1998,2.6,1,0,0,1,0,1,2,50.0,1,1,0,1,1,2,0,0,Matches
2822,Filip Đuričić,SRB,"MF,FW",Sassuolo,Serie A,28,1992,23.1,32,23,6,16,10,12,30,40.0,18,20,2,18,9,41,12,0,Matches
1,Max Aarons,ENG,DF,Norwich City,Premier League,21,2000,32.0,64,44,49,15,0,37,55,67.3,18,39,19,20,28,92,96,1,Matches
2,Yunis Abdelhamid,MAR,DF,Reims,Ligue 1,33,1987,33.1,48,27,34,14,0,16,32,50.0,16,50,25,25,68,116,104,0,Matches
3,Salis Abdul Samed,GHA,MF,Clermont Foot,Ligue 1,21,2000,27.4,43,23,25,16,2,20,57,35.1,37,18,1,17,42,85,15,0,Matches
4,Laurent Abergel,FRA,MF,Lorient,Ligue 1,28,1993,32.8,110,60,44,53,13,71,166,42.8,95,58,1,57,55,165,13,0,Matches
5,Charles Abi,FRA,FW,Saint-Étienne,Ligue 1,21,2000,0.5,0,0,0,0,0,0,1,0.0,1,2,0,2,0,0,0,0,Matches
6,Dickson Abiama,NGA,FW,Greuther Fürth,Bundesliga,22,1998,8.1,11,7,4,5,2,2,10,20.0,8,12,1,11,4,15,8,0,Matches
7,Matthis Abline,FRA,FW,Rennes,Ligue 1,18,2003,1.1,0,0,0,0,0,0,0,,0,2,0,2,0,0,1,0,Matches
8,Tammy Abraham,ENG,FW,Roma,Serie A,23,1997,34.3,27,13,7,14,6,9,22,40.9,13,17,3,14,5,32,27,0,Matches
9,Luis Abram,PER,DF,Granada,La Liga,25,1996,6.2,6,3,3,3,0,2,4,50.0,2,6,5,1,5,11,37,1,Matches
10,Francesco Acerbi,ITA,DF,Lazio,Serie A,33,1988,28.2,25,12,15,9,1,12,19,63.2,7,37,28,9,34,59,92,0,Matches
11,Ragnar Ache,GER,"MF,FW",Eint Frankfurt,Bundesliga,23,1998,2.9,2,0,0,1,1,1,4,25.0,3,3,0,3,0,2,1,0,Matches
12,Mohamed Achi,FRA,MF,Nantes,Ligue 1,19,2002,0.1,0,0,0,0,0,0,0,,0,0,0,0,0,0,0,0,Matches
13,Marcos Acuña,ARG,DF,Sevilla,La Liga,29,1991,25.1,50,29,27,14,9,30,46,65.2,16,22,5,17,14,64,25,1,Matches
14,Che Adams,SCO,FW,Southampton,Premier League,25,1996,22.7,13,6,5,5,3,2,16,12.5,14,18,2,16,8,21,18,0,Matches
15,Tyler Adams,USA,MF,RB Leipzig,Bundesliga,22,1999,15.0,23,7,5,16,2,7,25,28.0,18,24,1,23,16,39,19,2,Matches
16,Sargis Adamyan,ARM,"FW,MF",Hoffenheim,Bundesliga,28,1993,3.7,8,6,3,4,1,3,11,27.3,8,4,0,4,1,9,2,0,Matches
17,Martin Adeline,FRA,"MF,FW",Reims,Ligue 1,17,2003,3.9,15,11,5,8,2,8,16,50.0,8,0,0,0,11,26,6,0,Matches
18,Amine Adli,MAR,"FW,MF",Leverkusen,Bundesliga,21,2000,14.0,27,14,10,14,3,8,15,53.3,7,26,2,24,11,38,12,0,Matches
19,Yacine Adli,FRA,"MF,FW",Bordeaux,Ligue 1,21,2000,25.1,43,27,22,14,7,19,68,27.9,49,33,3,30,37,80,11,2,Matches
20,Michel Aebischer,SUI,MF,Bologna,Serie A,24,1997,4.9,14,5,5,8,1,6,11,54.5,5,4,1,3,6,20,3,0,Matches
21,Felix Afena-Gyan,GHA,"FW,MF",Roma,Serie A,18,2003,7.4,10,3,1,6,3,4,7,57.1,3,4,0,4,3,13,0,0,Matches
22,Martin Agirregabiria,ESP,DF,Alavés,La Liga,25,1996,18.0,34,22,17,11,6,18,37,48.6,19,20,3,17,25,59,38,0,Matches
23,Julen Agirrezabala,ESP,GK,Athletic Club,La Liga,20,2000,4.0,0,0,0,0,0,0,0,,0,0,0,0,0,0,2,0,Matches
24,Lucien Agoume,FRA,MF,Brest,Ligue 1,19,2002,20.8,51,31,24,20,7,23,45,51.1,22,30,9,21,52,103,27,1,Matches
25,Kevin Agudelo,COL,"MF,FW",Spezia,Serie A,22,1998,13.7,44,26,13,26,5,7,20,35.0,13,22,0,22,8,52,6,0,Matches
26,Nayef Aguerd,MAR,DF,Rennes,Ligue 1,25,1996,30.4,27,18,16,11,0,14,24,58.3,10,24,14,10,24,51,127,1,Matches
27,Sergio Agüero,ARG,FW,Barcelona,La Liga,33,1988,1.7,1,1,0,0,1,0,2,0.0,2,0,0,0,0,1,0,0,Matches
28,Ruben Aguilar,FRA,DF,Monaco,Ligue 1,28,1993,23.8,78,53,39,32,7,43,68,63.2,25,19,4,15,44,122,57,0,Matches
29,Álvaro Aguirre,ESP,FW,Rayo Vallecano,La Liga,21,2000,0.1,0,0,0,0,0,0,0,,0,0,0,0,0,0,0,0,Matches
30,Naouirou Ahamada,FRA,"MF,DF",Stuttgart,Bundesliga,19,2002,0.7,1,0,1,0,0,1,3,33.3,2,0,0,0,0,1,0,0,Matches
31,Anel Ahmedhodžić,BIH,DF,Bordeaux,Ligue 1,22,1999,15.0,38,26,27,9,2,20,31,64.5,11,16,8,8,22,60,44,0,Matches
32,Jean-Eudes Aholou,CIV,MF,Strasbourg,Ligue 1,27,1994,11.2,16,9,4,9,3,5,19,26.3,14,8,1,7,19,35,7,0,Matches
33,Joseph Aidoo,GHA,DF,Celta Vigo,La Liga,25,1995,29.3,39,26,28,10,1,17,31,54.8,14,23,13,10,38,77,96,3,Matches
34,Ola Aina,NGA,DF,Torino,Serie A,24,1996,16.0,27,19,11,10,6,15,23,65.2,8,17,3,14,28,55,30,0,Matches
35,Rayan Aït-Nouri,ALG,"DF,MF",Wolves,Premier League,20,2001,20.3,64,36,46,15,3,22,44,50.0,22,24,2,22,22,86,39,1,Matches
36,Kristoffer Ajer,NOR,DF,Brentford,Premier League,23,1998,22.2,29,18,21,6,2,13,21,61.9,8,19,11,8,26,55,74,0,Matches
37,Ludovic Ajorque,FRA,FW,Strasbourg,Ligue 1,27,1994,30.4,36,25,5,19,12,7,40,17.5,33,28,3,25,8,44,31,1,Matches
38,Manuel Akanji,SUI,DF,Dortmund,Bundesliga,26,1995,25.1,33,23,20,11,2,22,32,68.8,10,26,15,11,35,68,58,0,Matches
39,Carlos Akapo,EQG,DF,Cádiz,La Liga,28,1993,20.5,43,31,26,15,2,21,37,56.8,16,26,7,19,51,94,61,0,Matches
40,Marley Aké,FRA,"FW,MF",Juventus,Serie A,20,2001,0.9,0,0,0,0,0,0,2,0.0,2,0,0,0,1,1,0,0,Matches
41,Nathan Aké,NED,DF,Manchester City,Premier League,26,1995,10.3,16,9,7,8,1,6,8,75.0,2,7,5,2,8,24,23,0,Matches
42,Ilias Akhomach,MAR,FW,Barcelona,La Liga,17,2004,1.4,2,0,0,1,1,0,0,,0,0,0,0,0,2,0,0,Matches
43,Maghnes Akliouche,FRA,"MF,FW",Monaco,Ligue 1,19,2002,0.6,2,0,0,2,0,0,1,0.0,1,2,0,2,0,2,0,0,Matches
44,Paul Akouokou,CIV,MF,Betis,La Liga,23,1997,5.7,14,9,5,7,2,8,12,66.7,4,6,0,6,11,25,6,0,Matches
45,Jean-Daniel Akpa-Akpro,CIV,MF,Lazio,Serie A,28,1992,3.5,17,10,7,9,1,7,12,58.3,5,4,2,2,2,19,6,0,Matches
46,Kevin Akpoguma,NGA,"DF,FW",Hoffenheim,Bundesliga,26,1995,17.0,33,19,16,11,6,16,28,57.1,12,32,2,30,20,53,29,2,Matches
47,David Alaba,AUT,DF,Real Madrid,La Liga,29,1992,29.4,23,13,15,6,2,9,19,47.4,10,26,15,11,22,45,70,1,Matches
48,Sofiane Alakouch,MAR,"DF,MF",Metz,Ligue 1,23,1998,1.8,7,4,3,4,0,2,5,40.0,3,4,0,4,1,8,4,0,Matches
49,Tomás Alarcón,CHI,MF,Cádiz,La Liga,22,1999,15.8,31,20,17,10,4,10,31,32.3,21,19,7,12,30,61,31,0,Matches
50,Lucas Alario,ARG,FW,Leverkusen,Bundesliga,28,1992,7.3,6,5,0,2,4,2,5,40.0,3,5,0,5,1,7,6,0,Matches
51,Jordi Alba,ESP,DF,Barcelona,La Liga,32,1989,29.4,47,34,12,26,9,27,47,57.4,20,26,6,20,33,80,41,1,Matches
52,Josué Albert,GUF,DF,Clermont Foot,Ligue 1,29,1992,0.2,0,0,0,0,0,0,0,,0,0,0,0,1,1,2,0,Matches
53,Luis Alberto,ESP,MF,Lazio,Serie A,28,1992,26.1,29,17,8,11,10,8,52,15.4,44,32,4,28,13,42,7,0,Matches
54,Raúl Albiol,ESP,DF,Villarreal,La Liga,35,1985,27.4,26,15,20,5,1,14,18,77.8,4,24,15,9,21,47,126,1,Matches
55,Marc Albrighton,ENG,"FW,DF",Leicester City,Premier League,31,1989,12.6,31,19,16,9,6,10,47,21.3,37,15,3,12,14,45,20,0,Matches
56,Paco Alcácer,ESP,FW,Villarreal,La Liga,27,1993,8.7,9,3,2,4,3,1,5,20.0,4,7,0,7,6,15,1,0,Matches
57,Thiago Alcántara,ESP,MF,Liverpool,Premier League,30,1991,17.0,48,29,14,24,10,10,42,23.8,32,22,2,20,26,74,13,2,Matches
58,Rubén Alcaraz,ESP,MF,Cádiz,La Liga,30,1991,12.3,41,20,14,24,3,22,45,48.9,23,10,2,8,13,54,14,0,Matches
59,Omar Alderete,PAR,DF,Valencia,La Liga,24,1996,26.7,53,34,34,17,2,34,53,64.2,19,30,18,12,35,88,153,0,Matches
60,Iván Alejo,ESP,"MF,FW",Cádiz,La Liga,26,1995,11.8,33,15,21,10,2,15,44,34.1,29,12,0,12,8,41,17,0,Matches
61,Doğan Alemdar,TUR,GK,Rennes,Ligue 1,18,2002,12.0,0,0,0,0,0,0,0,,0,0,0,0,0,0,9,1,Matches
62,Carles Aleñá,ESP,MF,Getafe,La Liga,23,1998,25.8,27,19,11,13,3,9,48,18.8,39,21,2,19,15,42,16,0,Matches
63,Trent Alexander-Arnold,ENG,DF,Liverpool,Premier League,22,1998,31.7,40,23,19,13,8,27,60,45.0,33,22,4,18,43,83,40,0,Matches
64,Mohamed Ali Cho,FRA,FW,Angers,Ligue 1,17,2004,20.4,10,5,1,4,5,5,17,29.4,12,17,1,16,8,18,0,1,Matches
65,Alisson,BRA,GK,Liverpool,Premier League,28,1992,36.0,3,1,3,0,0,3,5,60.0,2,1,0,1,0,3,28,1,Matches
66,Allan,BRA,MF,Everton,Premier League,30,1991,24.3,74,44,28,39,7,34,105,32.4,71,40,9,31,23,97,39,1,Matches
67,Jim Allevinah,GAB,FW,Clermont Foot,Ligue 1,26,1995,16.5,18,13,8,8,2,5,18,27.8,13,11,0,11,6,24,4,0,Matches
68,Dele Alli,ENG,MF,Tottenham,Premier League,25,1996,7.3,14,8,10,3,1,5,17,29.4,12,22,5,17,6,20,16,0,Matches
69,Dele Alli,ENG,"MF,FW",Everton,Premier League,25,1996,3.8,7,2,3,4,0,0,4,0.0,4,7,2,5,6,13,10,0,Matches
70,Miguel Almirón,PAR,"MF,FW",Newcastle Utd,Premier League,27,1994,19.1,47,29,23,17,7,11,44,25.0,33,14,1,13,20,67,13,0,Matches
71,Marcos Alonso,ESP,DF,Chelsea,Premier League,30,1990,24.1,41,29,20,12,9,17,36,47.2,19,29,5,24,43,84,53,0,Matches
72,Giorgio Altare,ITA,DF,Cagliari,Serie A,22,1998,16.3,39,28,18,18,3,21,26,80.8,5,17,5,12,30,69,70,0,Matches
73,Hugo Álvarez,ESP,FW,Celta Vigo,La Liga,18,2003,0.1,1,0,1,0,0,0,0,,0,0,0,0,0,1,1,0,Matches
74,Yeray Álvarez,ESP,DF,Athletic Club,La Liga,26,1995,20.7,24,14,15,8,1,10,18,55.6,8,21,16,5,45,69,97,0,Matches
75,Dani Alves,BRA,DF,Barcelona,La Liga,38,1983,12.2,30,19,13,13,4,14,26,53.8,12,10,3,7,11,41,10,2,Matches
76,Steven Alzate,COL,MF,Brighton,Premier League,22,1998,4.5,10,4,4,5,1,4,7,57.1,3,2,1,1,10,20,10,0,Matches
77,Ibrahim Amadou,FRA,"DF,MF",Metz,Ligue 1,28,1993,9.0,16,8,10,6,0,8,15,53.3,7,4,2,2,14,30,26,0,Matches
78,Emmanuel Amankwaa Akurugu,GHA,DF,Getafe,La Liga,19,2001,0.9,0,0,0,0,0,0,2,0.0,2,1,0,1,0,0,0,0,Matches
79,Daniel Amartey,GHA,DF,Leicester City,Premier League,26,1994,23.6,26,13,19,7,0,19,29,65.5,10,30,22,8,21,47,93,4,Matches
80,Amath,SEN,"FW,MF",Mallorca,La Liga,25,1996,9.8,21,11,11,6,4,7,17,41.2,10,12,0,12,7,28,7,0,Matches
81,Jordan Amavi,FRA,DF,Nice,Ligue 1,27,1994,4.6,16,10,8,7,1,10,17,58.8,7,3,1,2,15,31,7,0,Matches
82,Jordan Amavi,FRA,"DF,FW",Marseille,Ligue 1,27,1994,1.4,6,5,3,1,2,5,10,50.0,5,1,0,1,1,7,3,0,Matches
83,Wisdom Amey,ITA,DF,Bologna,Serie A,15,2005,0.8,3,2,1,1,1,2,3,66.7,1,2,0,2,3,6,1,0,Matches
84,Kelvin Amian,FRA,DF,Spezia,Serie A,23,1998,29.4,66,42,43,18,5,30,41,73.2,11,39,21,18,32,98,75,0,Matches
85,Nadiem Amiri,GER,"MF,FW",Genoa,Serie A,24,1996,7.6,6,4,2,2,2,2,9,22.2,7,7,0,7,0,6,0,0,Matches
86,Nadiem Amiri,GER,"MF,FW",Leverkusen,Bundesliga,24,1996,4.1,8,4,3,2,3,4,8,50.0,4,4,2,2,5,13,0,0,Matches
87,Ethan Ampadu,WAL,"MF,DF",Venezia,Serie A,20,2000,25.4,67,43,37,27,3,24,58,41.4,34,49,19,30,51,118,76,0,Matches
88,Sofyan Amrabat,MAR,MF,Fiorentina,Serie A,24,1996,10.5,24,13,9,13,2,11,19,57.9,8,25,8,17,5,29,6,1,Matches
89,Joachim Andersen,DEN,DF,Crystal Palace,Premier League,25,1996,32.4,30,23,21,9,0,16,27,59.3,11,29,19,10,37,67,125,3,Matches
90,Felipe Anderson,BRA,FW,Lazio,Serie A,28,1993,32.1,71,45,30,33,8,27,99,27.3,72,65,6,59,20,91,16,0,Matches
91,Sebastian Andersson,SWE,FW,Köln,Bundesliga,30,1991,14.0,11,7,0,3,8,3,9,33.3,6,8,0,8,3,14,14,0,Matches
92,Florin Andone,ROU,FW,Cádiz,La Liga,28,1993,2.0,1,1,1,0,0,0,1,0.0,1,2,0,2,0,1,1,0,Matches
93,Andrés Andrade Cedeño,PAN,DF,Arminia,Bundesliga,22,1998,11.6,27,16,18,8,1,17,35,48.6,18,16,7,9,19,46,44,0,Matches
94,Benjamin André,FRA,MF,Lille,Ligue 1,30,1990,30.6,123,69,49,65,9,51,113,45.1,62,49,11,38,50,173,56,0,Matches
95,Fredrik André Bjørkan,NOR,DF,Hertha BSC,Bundesliga,22,1998,3.9,12,10,7,4,1,7,9,77.8,2,6,2,4,6,18,8,0,Matches
96,Marcos André,BRA,"FW,MF",Valencia,La Liga,24,1996,10.8,15,11,4,6,5,5,16,31.3,11,15,0,15,7,22,13,0,Matches
97,Robert Andrich,GER,MF,Leverkusen,Bundesliga,26,1994,20.2,33,17,18,14,1,14,28,50.0,14,19,7,12,31,64,46,0,Matches
98,José Ángel,ESP,DF,Osasuna,La Liga,31,1989,12.0,20,13,9,9,2,9,14,64.3,5,6,1,5,10,30,21,0,Matches
99,Angeliño,ESP,DF,RB Leipzig,Bundesliga,24,1997,25.5,28,21,14,13,1,14,30,46.7,16,24,3,21,29,57,40,0,Matches
100,Ebenezer Annan,GHA,DF,Bologna,Serie A,18,2002,0.3,1,1,1,0,0,0,0,,0,0,0,0,1,2,1,0,Matches
101,Cristian Ansaldi,ARG,DF,Torino,Serie A,34,1986,7.7,20,9,11,7,2,10,13,76.9,3,9,1,8,6,26,10,0,Matches
102,Janis Antiste,FRA,FW,Spezia,Serie A,18,2002,8.8,18,11,6,6,6,5,13,38.5,8,7,1,6,4,22,6,0,Matches
103,Waldemar Anton,GER,DF,Stuttgart,Bundesliga,25,1996,28.8,40,26,22,15,3,19,32,59.4,13,27,16,11,32,72,116,1,Matches
104,Josep Antoni Gayá,ESP,DF,Mallorca,La Liga,21,2000,0.6,0,0,0,0,0,0,0,,0,1,0,1,1,1,3,1,Matches
105,Michail Antonio,JAM,FW,West Ham,Premier League,31,1990,33.0,23,17,5,9,9,7,18,38.9,11,19,1,18,3,26,13,0,Matches
106,Christopher Antwi-Adjei,GHA,"FW,MF",Bochum,Bundesliga,27,1994,12.6,21,18,7,8,6,6,26,23.1,20,12,0,12,1,22,8,0,Matches
107,Houssem Aouar,ALG,"MF,FW",Lyon,Ligue 1,23,1998,27.8,46,30,9,25,12,27,54,50.0,27,26,1,25,20,66,5,0,Matches
108,Adil Aouchiche,FRA,"MF,FW",Saint-Étienne,Ligue 1,19,2002,12.0,13,6,5,5,3,5,33,15.2,28,18,1,17,17,30,4,0,Matches
109,Dennis Appiah,FRA,DF,Nantes,Ligue 1,29,1992,23.3,55,34,35,18,2,28,48,58.3,20,30,13,17,27,82,74,0,Matches
110,Mauro Arambarri,URU,MF,Getafe,La Liga,25,1995,29.6,62,37,19,32,11,20,68,29.4,48,35,5,30,32,94,18,0,Matches
111,Mattia Aramu,ITA,"MF,FW",Venezia,Serie A,26,1995,23.3,20,15,5,9,6,8,33,24.2,25,20,2,18,8,28,19,0,Matches
112,Charles Aránguiz,CHI,MF,Leverkusen,Bundesliga,32,1989,17.5,45,25,18,21,6,22,52,42.3,30,24,4,20,33,78,21,0,Matches
113,Néstor Araujo,MEX,DF,Celta Vigo,La Liga,29,1991,29.1,22,14,17,5,0,9,21,42.9,12,17,10,7,27,49,105,2,Matches
114,Ronald Araújo,URU,DF,Barcelona,La Liga,22,1999,25.2,41,23,29,12,0,21,25,84.0,4,37,20,17,23,64,66,1,Matches
115,Cameron Archer,ENG,"FW,MF",Aston Villa,Premier League,20,2001,0.3,0,0,0,0,0,0,0,,0,0,0,0,0,0,0,0,Matches
116,Alphonse Areola,FRA,GK,West Ham,Premier League,28,1993,1.0,0,0,0,0,0,0,0,,0,0,0,0,0,0,1,0,Matches
117,Jesús Areso,ESP,DF,Osasuna,La Liga,22,1999,2.1,3,3,2,1,0,0,2,0.0,2,0,0,0,0,3,2,1,Matches
118,Matias Arezo,URU,"FW,MF",Granada,La Liga,18,2002,1.8,5,3,2,1,2,4,9,44.4,5,1,0,1,1,6,1,0,Matches
119,Santiago Arias,COL,DF,Granada,La Liga,29,1992,4.9,12,5,8,3,1,4,9,44.4,5,8,4,4,5,17,10,0,Matches
120,Adam Armstrong,ENG,FW,Southampton,Premier League,24,1997,15.7,10,4,2,2,6,0,6,0.0,6,13,1,12,3,13,6,0,Matches
121,Stuart Armstrong,SCO,MF,Southampton,Premier League,29,1992,16.4,27,19,15,6,6,9,23,39.1,14,10,1,9,8,35,15,0,Matches
122,Marko Arnautović,AUT,FW,Bologna,Serie A,32,1989,29.9,17,9,1,11,5,7,30,23.3,23,13,2,11,7,24,17,0,Matches
123,Maximilian Arnold,GER,MF,Wolfsburg,Bundesliga,27,1994,33.3,37,20,19,16,2,20,50,40.0,30,43,15,28,37,74,55,0,Matches
124,Kepa Arrizabalaga,ESP,GK,Chelsea,Premier League,26,1994,4.0,0,0,0,0,0,0,0,,0,0,0,0,0,0,4,0,Matches
125,Tolgay Arslan,GER,MF,Udinese,Serie A,30,1990,18.4,35,20,15,16,4,19,50,38.0,31,17,4,13,13,48,23,1,Matches
126,Santiago Arzamendia,PAR,MF,Cádiz,La Liga,23,1998,5.2,14,6,6,5,3,6,13,46.2,7,6,0,6,4,18,7,0,Matches
127,Takuma Asano,JPN,"FW,MF",Bochum,Bundesliga,26,1994,17.9,11,6,3,6,2,5,19,26.3,14,14,1,13,7,18,7,0,Matches
128,Santiago Ascacíbar,ARG,MF,Hertha BSC,Bundesliga,24,1997,26.4,93,54,50,37,6,38,89,42.7,51,31,6,25,41,134,42,0,Matches
129,Sergio Asenjo,ESP,GK,Villarreal,La Liga,32,1989,6.0,0,0,0,0,0,0,1,0.0,1,0,0,0,1,1,6,0,Matches
130,Alejandro Asensio,ESP,FW,Rayo Vallecano,La Liga,20,2000,0.1,0,0,0,0,0,0,0,,0,0,0,0,0,0,0,0,Matches
131,Marco Asensio,ESP,"FW,MF",Real Madrid,La Liga,25,1996,19.2,12,8,6,4,2,4,18,22.2,14,8,1,7,12,24,6,1,Matches
132,Harrison Ashby,SCO,DF,West Ham,Premier League,19,2001,0.1,0,0,0,0,0,0,0,,0,1,0,1,1,1,1,0,Matches
133,Kristoffer Askildsen,NOR,MF,Sampdoria,Serie A,20,2001,8.4,18,6,7,11,0,9,19,47.4,10,14,7,7,15,33,15,0,Matches
134,Fisnik Asllani,KVX,"MF,FW",Hoffenheim,Bundesliga,18,2002,0.1,0,0,0,0,0,0,1,0.0,1,0,0,0,0,0,0,0,Matches
135,Kristjan Asllani,ALB,MF,Empoli,Serie A,19,2002,15.0,18,9,9,8,1,11,29,37.9,18,16,7,9,19,37,15,1,Matches
136,Iago Aspas,ESP,FW,Celta Vigo,La Liga,33,1987,34.3,14,7,1,5,8,4,24,16.7,20,23,2,21,11,25,19,0,Matches
137,Lorenz Assignon,TOG,DF,Rennes,Ligue 1,21,2000,6.8,15,10,11,3,1,5,9,55.6,4,3,1,2,11,26,19,0,Matches
138,Simon Asta,GER,DF,Greuther Fürth,Bundesliga,20,2001,8.7,13,6,4,5,4,4,8,50.0,4,14,2,12,8,21,16,0,Matches
139,Youcef Atal,ALG,DF,Nice,Ligue 1,25,1996,12.7,29,19,17,10,2,14,25,56.0,11,13,2,11,32,61,21,0,Matches
140,Pierre-Emerick Aubameyang,GAB,FW,Arsenal,Premier League,32,1989,11.5,11,5,6,4,1,3,10,30.0,7,12,1,11,0,11,4,0,Matches
141,Pierre-Emerick Aubameyang,GAB,FW,Barcelona,La Liga,32,1989,12.0,2,2,0,1,1,0,5,0.0,5,9,1,8,2,4,4,0,Matches
142,Emil Audero,ITA,GK,Sampdoria,Serie A,24,1997,28.4,3,1,3,0,0,3,5,60.0,2,0,0,0,2,5,17,2,Matches
143,Tommaso Augello,ITA,DF,Sampdoria,Serie A,26,1994,26.6,36,20,22,8,6,17,29,58.6,12,19,4,15,29,65,68,1,Matches
144,Jean-Kévin Augustin,FRA,"FW,MF",Nantes,Ligue 1,24,1997,0.9,1,0,0,0,1,0,3,0.0,3,1,0,1,0,1,0,0,Matches
145,Ludwig Augustinsson,SWE,"DF,FW",Sevilla,La Liga,27,1994,8.8,18,14,11,3,4,8,13,61.5,5,10,3,7,5,23,21,0,Matches
146,Serge Aurier,CIV,DF,Villarreal,La Liga,28,1992,11.2,14,9,11,2,1,4,7,57.1,3,14,7,7,11,25,25,0,Matches
147,Ezequiel Ávila,ARG,"FW,MF",Osasuna,La Liga,27,1994,20.8,17,7,6,7,4,7,21,33.3,14,14,2,12,13,30,15,1,Matches
148,Taiwo Awoniyi,NGA,FW,Union Berlin,Bundesliga,23,1997,24.2,11,7,3,6,2,1,9,11.1,8,11,2,9,2,13,29,0,Matches
149,Ramzi Aya,ITA,DF,Salernitana,Serie A,30,1990,1.5,1,1,1,0,0,1,1,100.0,0,0,0,0,0,1,4,0,Matches
150,Jordan Ayew,GHA,FW,Crystal Palace,Premier League,29,1991,22.4,47,30,20,20,7,17,31,54.8,14,33,3,30,15,62,15,0,Matches
151,Kaan Ayhan,TUR,DF,Sassuolo,Serie A,26,1994,15.0,20,12,14,6,0,7,15,46.7,8,20,14,6,13,33,57,0,Matches
152,Luke Ayling,ENG,DF,Leeds United,Premier League,29,1991,25.2,74,42,46,23,5,51,97,52.6,46,46,25,21,28,102,52,1,Matches
153,Karim Azamoum,FRA,DF,Troyes,Ligue 1,31,1990,4.3,6,5,4,2,0,3,5,60.0,2,4,2,2,1,7,10,0,Matches
154,Sardar Azmoun,IRN,"FW,MF",Leverkusen,Bundesliga,26,1995,4.0,3,1,0,2,1,0,5,0.0,5,2,0,2,0,3,8,0,Matches
155,César Azpilicueta,ESP,DF,Chelsea,Premier League,31,1989,23.0,51,28,18,27,6,16,35,45.7,19,32,9,23,23,74,65,1,Matches
156,Iddrisu Baba,GHA,MF,Mallorca,La Liga,25,1996,21.5,57,30,31,23,3,25,43,58.1,18,19,5,14,24,81,34,1,Matches
157,Carlos Bacca,COL,FW,Granada,La Liga,34,1986,5.7,4,4,2,0,2,0,3,0.0,3,5,0,5,1,5,5,0,Matches
158,Daniel Bachmann,AUT,GK,Watford,Premier League,27,1994,12.0,0,0,0,0,0,0,0,,0,0,0,0,1,1,5,0,Matches
159,Loïc Bade,FRA,DF,Rennes,Ligue 1,21,2000,10.9,6,5,4,2,0,3,5,60.0,2,12,10,2,12,18,48,0,Matches
160,Milan Badelj,CRO,MF,Genoa,Serie A,32,1989,31.6,64,37,25,30,9,34,80,42.5,46,39,7,32,85,149,43,0,Matches
161,Édgar Badía,ESP,GK,Elche,La Liga,29,1992,24.0,0,0,0,0,0,0,0,,0,0,0,0,0,0,16,2,Matches
162,Benoît Badiashile,FRA,DF,Monaco,Ligue 1,20,2001,20.4,36,19,21,15,0,14,23,60.9,9,18,12,6,28,64,68,1,Matches
163,Youssouph Badji,SEN,"FW,MF",Brest,Ligue 1,19,2001,1.5,1,0,0,1,0,0,1,0.0,1,0,0,0,0,1,0,0,Matches
164,Miguel Baeza,ESP,DF,Celta Vigo,La Liga,21,2000,0.0,0,0,0,0,0,0,0,,0,0,0,0,0,0,0,0,Matches
165,Nicola Bagnolini,ITA,GK,Bologna,Serie A,17,2004,0.0,0,0,0,0,0,0,0,,0,0,0,0,0,0,0,0,Matches
166,Issa Bah,LUX,FW,Venezia,Serie A,19,2002,0.1,0,0,0,0,0,0,0,,0,0,0,0,0,0,0,0,Matches
167,Stéphane Bahoken,CMR,FW,Angers,Ligue 1,29,1992,12.2,13,8,2,7,4,1,9,11.1,8,15,0,15,3,16,3,0,Matches
168,Leon Bailey,JAM,"FW,MF",Aston Villa,Premier League,23,1997,8.5,17,11,6,8,3,6,13,46.2,7,10,1,9,1,18,2,0,Matches
169,Eric Bailly,CIV,DF,Manchester Utd,Premier League,27,1994,2.4,5,4,4,0,1,3,4,75.0,1,4,2,2,3,8,11,0,Matches
170,Dénys Bain,FRA,DF,Brest,Ligue 1,28,1993,2.0,3,3,1,2,0,1,1,100.0,0,3,1,2,3,6,5,0,Matches
171,Stefan Bajic,FRA,GK,Saint-Étienne,Ligue 1,19,2001,5.7,0,0,0,0,0,0,0,,0,0,0,0,0,0,4,0,Matches
172,Nedim Bajrami,ALB,"MF,FW",Empoli,Serie A,22,1999,22.8,21,14,5,13,3,4,14,28.6,10,11,0,11,3,24,8,0,Matches
173,Cédric Bakambu,COD,FW,Marseille,Ligue 1,30,1991,4.0,2,0,1,0,1,0,3,0.0,3,2,0,2,0,2,1,0,Matches
174,Abdoulaye Bakayoko,FRA,DF,Saint-Étienne,Ligue 1,18,2002,3.4,15,9,13,2,0,8,12,66.7,4,5,4,1,12,27,15,0,Matches
175,Tiemoué Bakayoko,FRA,MF,Milan,Serie A,26,1994,5.6,19,13,9,7,3,5,16,31.3,11,8,1,7,9,28,10,2,Matches
176,Mitchel Bakker,NED,DF,Leverkusen,Bundesliga,21,2000,20.2,33,22,16,12,5,20,34,58.8,14,13,2,11,23,56,42,3,Matches
177,Ridle Baku,GER,"DF,FW",Wolfsburg,Bundesliga,23,1998,27.2,62,37,30,24,8,25,65,38.5,40,43,1,42,21,83,52,1,Matches
178,Dilane Bakwa,FRA,"FW,MF",Bordeaux,Ligue 1,18,2002,0.5,1,1,0,1,0,1,2,50.0,1,0,0,0,0,1,1,0,Matches
179,Tommaso Baldanzi,ITA,FW,Empoli,Serie A,18,2003,0.2,0,0,0,0,0,0,0,,0,1,0,1,0,0,0,0,Matches
180,Alejandro Balde,ESP,"DF,FW",Barcelona,La Liga,17,2003,2.1,2,1,1,0,1,0,0,,0,2,2,0,1,3,1,0,Matches
181,Ibrahima Baldé,FRA,"FW,MF",Lens,Ligue 1,18,2003,0.6,0,0,0,0,0,0,0,,0,0,0,0,0,0,0,0,Matches
182,Keita Baldé,SEN,FW,Cagliari,Serie A,26,1995,13.7,8,4,1,5,2,1,10,10.0,9,6,0,6,4,12,6,0,Matches
183,Gareth Bale,WAL,FW,Real Madrid,La Liga,32,1989,3.1,2,1,1,0,1,1,4,25.0,3,2,0,2,2,4,1,0,Matches
184,Mikel Balenziaga,ESP,DF,Athletic Club,La Liga,33,1988,22.5,33,24,15,15,3,25,43,58.1,18,27,4,23,21,54,79,0,Matches
185,Leonardo Balerdi,ARG,DF,Marseille,Ligue 1,22,1999,10.6,9,6,9,0,0,5,14,35.7,9,11,4,7,19,28,30,0,Matches
186,Iván Balliu,ALB,DF,Rayo Vallecano,La Liga,29,1992,35.0,45,22,25,11,9,19,31,61.3,12,24,5,19,39,84,64,0,Matches
187,Fodé Ballo-Touré,SEN,DF,Milan,Serie A,24,1997,5.0,18,14,5,13,0,4,9,44.4,5,6,2,4,3,21,5,0,Matches
188,Folarin Balogun,USA,FW,Arsenal,Premier League,20,2001,0.8,1,1,0,0,1,0,0,,0,1,0,1,0,1,1,0,Matches
189,Abdoulaye Bamba,CIV,"DF,FW",Angers,Ligue 1,31,1990,5.1,6,5,6,0,0,4,11,36.4,7,5,1,4,9,15,13,0,Matches
190,Jonathan Bamba,CIV,"MF,FW",Lille,Ligue 1,25,1996,27.0,30,12,13,9,8,13,36,36.1,23,24,1,23,21,51,10,0,Matches
191,Patrick Bamford,ENG,FW,Leeds United,Premier League,27,1993,6.2,1,0,0,1,0,0,3,0.0,3,8,2,6,2,3,8,0,Matches
192,Filippo Bandinelli,ITA,MF,Empoli,Serie A,26,1995,21.7,33,20,10,17,6,15,31,48.4,16,22,5,17,10,43,37,2,Matches
193,Mattia Bani,ITA,DF,Genoa,Serie A,27,1993,13.5,23,13,17,6,0,14,18,77.8,4,19,11,8,20,43,76,0,Matches
194,Simon Banza,COD,FW,Lens,Ligue 1,24,1996,1.4,2,1,0,0,2,0,2,0.0,2,1,0,1,1,3,2,0,Matches
195,Shandon Baptiste,GRN,MF,Brentford,Premier League,23,1998,10.1,14,4,9,4,1,6,15,40.0,9,10,0,10,11,25,12,0,Matches
196,Antonín Barák,CZE,"MF,FW",Hellas Verona,Serie A,26,1994,26.0,18,8,9,8,1,5,17,29.4,12,32,5,27,6,24,26,0,Matches
197,Barbero,ESP,"FW,MF",Osasuna,La Liga,22,1998,0.2,0,0,0,0,0,0,0,,0,0,0,0,0,0,1,0,Matches
198,Danilo Barbosa,BRA,DF,Nice,Ligue 1,25,1996,1.0,0,0,0,0,0,0,0,,0,1,1,0,2,2,10,0,Matches
199,Barcia,ESP,DF,Granada,La Liga,20,2000,0.8,0,0,0,0,0,0,0,,0,1,1,0,1,1,0,1,Matches
200,Bradley Barcola,FRA,"FW,MF",Lyon,Ligue 1,18,2002,2.9,7,4,2,3,2,1,8,12.5,7,7,1,6,2,9,1,0,Matches
201,Melvin Bard,FRA,DF,Nice,Ligue 1,20,2000,28.8,59,37,38,17,4,41,63,65.1,22,33,10,23,51,110,56,0,Matches
202,Enis Bardhi,MKD,"MF,FW",Levante,La Liga,26,1995,18.9,29,12,12,14,3,12,35,34.3,23,13,2,11,10,39,7,0,Matches
203,Francesco Bardi,ITA,GK,Bologna,Serie A,29,1992,2.0,0,0,0,0,0,0,0,,0,0,0,0,0,0,0,0,Matches
204,Keidi Bare,ALB,MF,Espanyol,La Liga,23,1997,16.5,27,17,14,12,1,11,31,35.5,20,20,10,10,15,42,26,1,Matches
205,Nicolò Barella,ITA,MF,Inter,Serie A,24,1997,32.4,63,42,17,35,11,29,55,52.7,26,26,2,24,21,84,8,2,Matches
206,Kike Barja,ESP,"MF,FW",Osasuna,La Liga,24,1997,9.6,15,11,4,7,4,8,22,36.4,14,10,1,9,9,24,4,0,Matches
207,Ross Barkley,ENG,"MF,FW",Chelsea,Premier League,27,1993,2.0,0,0,0,0,0,0,1,0.0,1,1,0,1,1,1,0,0,Matches
208,Aymen Barkok,MAR,"MF,DF",Eint Frankfurt,Bundesliga,23,1998,1.8,6,2,2,3,1,2,7,28.6,5,4,1,3,5,11,6,0,Matches
209,Ashley Barnes,ENG,FW,Burnley,Premier League,31,1989,9.0,11,2,2,7,2,2,9,22.2,7,8,1,7,2,13,5,0,Matches
210,Harvey Barnes,ENG,"FW,MF",Leicester City,Premier League,23,1997,23.3,31,16,9,11,11,7,23,30.4,16,24,1,23,5,36,7,0,Matches
211,Antonio Barragán,ESP,DF,Elche,La Liga,34,1987,11.3,21,14,13,7,1,11,17,64.7,6,5,3,2,17,38,34,0,Matches
212,Leandro Barreiro Martins,LUX,MF,Mainz 05,Bundesliga,21,2000,19.9,63,32,23,27,13,29,50,58.0,21,23,6,17,32,95,23,0,Matches
213,Ander Barrenetxea,ESP,"FW,MF",Real Sociedad,La Liga,19,2001,6.1,15,10,9,6,0,8,18,44.4,10,7,0,7,2,17,2,0,Matches
214,Jacob Barrett Laursen,DEN,DF,Arminia,Bundesliga,26,1994,18.1,16,12,10,6,0,8,21,38.1,13,19,7,12,28,44,43,0,Matches
215,Musa Barrow,GAM,"FW,MF",Bologna,Serie A,22,1998,23.7,12,4,4,4,4,6,20,30.0,14,20,1,19,6,18,8,0,Matches
216,Abdourahmane Barry,GUI,DF,Greuther Fürth,Bundesliga,21,2000,2.3,6,4,3,3,0,5,7,71.4,2,5,2,3,4,10,1,0,Matches
217,Marc Bartra,ESP,DF,Betis,La Liga,30,1991,22.1,39,14,18,17,4,19,35,54.3,16,39,22,17,33,72,105,1,Matches
218,Daniele Baselli,ITA,"MF,FW",Torino,Serie A,29,1992,1.7,3,3,2,0,1,2,6,33.3,4,0,0,0,1,4,2,0,Matches
219,Daniele Baselli,ITA,MF,Cagliari,Serie A,29,1992,3.2,6,5,3,1,2,1,5,20.0,4,2,0,2,2,8,5,0,Matches
220,Toma Bašić,CRO,MF,Lazio,Serie A,24,1996,10.9,12,8,3,9,0,5,17,29.4,12,13,4,9,4,16,21,0,Matches
221,Toma Bašić,CRO,MF,Bordeaux,Ligue 1,24,1996,2.3,2,2,1,0,1,0,4,0.0,4,4,1,3,2,4,0,0,Matches
222,Amine Bassi,FRA,"MF,FW",Metz,Ligue 1,23,1997,2.0,6,3,2,3,1,1,3,33.3,2,5,0,5,0,6,0,0,Matches
223,Álvaro Bastida,ESP,MF,Cádiz,La Liga,17,2004,2.2,7,4,2,4,1,4,5,80.0,1,1,0,1,3,10,1,0,Matches
224,Alessandro Bastoni,ITA,DF,Inter,Serie A,22,1999,25.7,44,25,28,13,3,17,34,50.0,17,22,12,10,35,79,59,1,Matches
225,Simone Bastoni,ITA,"MF,DF",Spezia,Serie A,24,1996,25.4,52,34,28,17,7,21,65,32.3,44,38,11,27,30,82,31,0,Matches
226,Lewis Bate,ENG,MF,Leeds United,Premier League,18,2002,1.6,1,0,0,0,1,0,8,0.0,8,1,0,1,1,2,1,0,Matches
227,Rodrigo Battaglia,ARG,MF,Mallorca,La Liga,30,1991,13.1,32,16,13,19,0,15,30,50.0,15,21,10,11,10,42,36,0,Matches
228,Maximilian Bauer,GER,DF,Greuther Fürth,Bundesliga,21,2000,18.8,28,15,17,10,1,11,28,39.3,17,24,14,10,29,57,99,0,Matches
229,Oliver Baumann,GER,GK,Hoffenheim,Bundesliga,31,1990,33.0,0,0,0,0,0,0,3,0.0,3,0,0,0,0,0,19,1,Matches
230,Timo Baumgartl,GER,DF,Union Berlin,Bundesliga,25,1996,24.1,59,28,34,21,4,31,47,66.0,16,27,11,16,37,96,58,0,Matches
231,Julian Baumgartlinger,AUT,"MF,FW",Leverkusen,Bundesliga,33,1988,1.0,3,1,2,1,0,1,2,50.0,1,1,0,1,2,5,0,0,Matches
232,Christoph Baumgartner,AUT,"MF,FW",Hoffenheim,Bundesliga,21,1999,21.0,28,15,14,7,7,13,32,40.6,19,24,3,21,8,36,16,0,Matches
233,Jon Bautista,ESP,MF,Real Sociedad,La Liga,26,1995,0.5,3,0,0,3,0,0,1,0.0,1,1,0,1,1,4,1,0,Matches
234,Paul Baysse,FRA,"MF,DF",Bordeaux,Ligue 1,33,1988,0.1,1,1,0,1,0,0,0,,0,0,0,0,0,1,1,0,Matches
235,Noah Joel Sarenren Bazee,NGA,"MF,FW",Augsburg,Bundesliga,24,1996,2.7,5,2,2,2,1,3,4,75.0,1,8,2,6,1,6,4,0,Matches
236,Bebé,CPV,FW,Rayo Vallecano,La Liga,31,1990,9.6,6,5,1,3,2,4,16,25.0,12,18,0,18,3,9,6,0,Matches
237,Ihlas Bebou,TOG,"FW,DF",Hoffenheim,Bundesliga,27,1994,23.2,22,14,5,12,5,7,21,33.3,14,20,3,17,12,34,25,0,Matches
238,Rodrigo Becão,BRA,DF,Udinese,Serie A,25,1996,34.8,81,46,49,30,2,34,60,56.7,26,45,20,25,42,123,89,3,Matches
239,Mads Bech Sørensen,DEN,DF,Brentford,Premier League,22,1999,9.3,8,7,6,2,0,6,7,85.7,1,9,6,3,6,14,25,0,Matches
240,Sheraldo Becker,SUR,"FW,MF",Union Berlin,Bundesliga,26,1995,19.5,9,6,3,4,2,6,18,33.3,12,11,0,11,2,11,4,0,Matches
241,Jan Bednarek,POL,DF,Southampton,Premier League,25,1996,29.2,32,15,18,13,1,19,33,57.6,14,48,27,21,72,104,141,0,Matches
242,Donny van de Beek,NED,MF,Manchester Utd,Premier League,24,1997,0.8,6,4,4,1,1,1,2,50.0,1,5,1,4,2,8,1,0,Matches
243,Donny van de Beek,NED,MF,Everton,Premier League,24,1997,5.4,15,7,8,6,1,6,13,46.2,7,6,2,4,6,21,4,0,Matches
244,Asmir Begović,BIH,GK,Everton,Premier League,34,1987,3.0,0,0,0,0,0,0,0,,0,0,0,0,0,0,3,0,Matches
245,Valon Behrami,SUI,"MF,FW",Genoa,Serie A,36,1985,3.5,3,1,0,2,1,0,7,0.0,7,4,1,3,1,4,4,0,Matches
246,Kevin Behrens,GER,FW,Union Berlin,Bundesliga,30,1991,5.5,3,2,1,1,1,0,4,0.0,4,3,0,3,3,6,7,0,Matches
247,Youcef Belaïli,ALG,"MF,FW",Brest,Ligue 1,29,1992,9.2,2,1,0,0,2,2,9,22.2,7,5,1,4,7,9,4,0,Matches
248,Vid Belec,SVN,GK,Salernitana,Serie A,31,1990,21.5,0,0,0,0,0,0,0,,0,0,0,0,0,0,9,1,Matches
249,Ishak Belfodil,ALG,FW,Hertha BSC,Bundesliga,29,1992,18.2,9,6,4,4,1,4,8,50.0,4,9,1,8,5,14,16,0,Matches
250,Haris Belkebla,ALG,MF,Brest,Ligue 1,27,1994,25.7,46,23,21,21,4,18,39,46.2,21,26,6,20,48,94,30,1,Matches
251,Stefan Bell,GER,DF,Mainz 05,Bundesliga,29,1991,31.8,54,23,37,16,1,30,63,47.6,33,26,15,11,41,95,112,1,Matches
252,Armel Bella Kotchap,GER,DF,Bochum,Bundesliga,19,2001,19.6,34,20,25,9,0,18,28,64.3,10,21,16,5,42,76,84,2,Matches
253,Raoul Bellanova,ITA,"DF,FW",Cagliari,Serie A,21,2000,27.7,29,15,14,12,3,6,27,22.2,21,39,8,31,21,50,51,0,Matches
254,Karim Bellarabi,GER,"FW,MF",Leverkusen,Bundesliga,31,1990,7.6,9,4,4,4,1,3,13,23.1,10,5,0,5,9,18,4,0,Matches
255,Jean-Ricner Bellegarde,FRA,MF,Strasbourg,Ligue 1,23,1998,25.9,51,32,21,21,9,17,41,41.5,24,29,4,25,27,78,19,0,Matches
256,Héctor Bellerín,ESP,DF,Betis,La Liga,26,1995,22.0,52,32,29,20,3,31,44,70.5,13,11,2,9,23,75,57,1,Matches
257,Jude Bellingham,ENG,MF,Dortmund,Bundesliga,18,2003,31.0,52,34,15,31,6,21,53,39.6,32,50,4,46,42,94,32,0,Matches
258,George Bello,USA,DF,Arminia,Bundesliga,19,2002,4.8,7,7,7,0,0,4,4,100.0,0,5,4,1,6,13,11,0,Matches
259,Jeanuël Belocian,FRA,DF,Rennes,Ligue 1,16,2005,0.1,0,0,0,0,0,0,0,,0,0,0,0,0,0,0,0,Matches
260,Andrea Belotti,ITA,FW,Torino,Serie A,27,1993,15.2,7,3,2,2,3,3,12,25.0,9,12,4,8,2,9,9,0,Matches
261,Fran Beltrán,ESP,MF,Celta Vigo,La Liga,22,1999,28.9,56,41,27,23,6,28,68,41.2,40,29,5,24,32,88,39,0,Matches
262,Hatem Ben Arfa,FRA,"FW,MF",Lille,Ligue 1,34,1987,3.5,4,2,2,1,1,2,4,50.0,2,3,0,3,0,4,1,0,Matches
263,Salim Ben Seghir,FRA,MF,Marseille,Ligue 1,18,2003,0.0,0,0,0,0,0,0,0,,0,0,0,0,0,0,0,0,Matches
264,Wissam Ben Yedder,FRA,FW,Monaco,Ligue 1,30,1990,28.1,18,8,1,11,6,6,15,40.0,9,12,1,11,0,18,1,0,Matches
265,Marco Benassi,ITA,"DF,MF",Fiorentina,Serie A,26,1994,1.8,1,0,1,0,0,1,2,50.0,1,3,0,3,3,4,3,0,Matches
266,Marco Benassi,ITA,MF,Empoli,Serie A,26,1994,4.2,6,3,3,2,1,1,10,10.0,9,4,0,4,3,9,6,0,Matches
267,Darío Benedetto,ARG,"FW,MF",Elche,La Liga,31,1990,6.6,5,1,2,2,1,3,6,50.0,3,4,0,4,1,6,1,0,Matches
268,Darío Benedetto,ARG,"FW,MF",Marseille,Ligue 1,31,1990,0.6,0,0,0,0,0,0,0,,0,2,0,2,0,0,0,0,Matches
269,László Bénes,SVK,MF,Gladbach,Bundesliga,23,1997,2.7,5,3,1,3,1,1,6,16.7,5,5,2,3,2,7,5,0,Matches
270,Walter Benítez,ARG,GK,Nice,Ligue 1,28,1993,37.0,0,0,0,0,0,0,2,0.0,2,1,0,1,0,0,12,2,Matches
271,Iker Benito,ESP,"FW,MF",Osasuna,La Liga,18,2002,1.3,2,1,1,0,1,0,1,0.0,1,2,0,2,0,2,2,0,Matches
272,Loris Benito,SUI,DF,Bordeaux,Ligue 1,29,1992,0.7,0,0,0,0,0,0,0,,0,0,0,0,1,1,3,1,Matches
273,Pedro Benito,ESP,FW,Cádiz,La Liga,21,2000,0.3,0,0,0,0,0,0,1,0.0,1,0,0,0,0,0,0,0,Matches
274,Filip Benković,CRO,"DF,FW",Udinese,Serie A,24,1997,0.1,0,0,0,0,0,0,0,,0,0,0,0,0,0,0,0,Matches
275,Ismaël Bennacer,ALG,MF,Milan,Serie A,23,1997,16.9,44,30,22,15,7,21,50,42.0,29,20,4,16,25,69,15,0,Matches
276,Keanan Bennetts,ENG,"FW,DF",Gladbach,Bundesliga,22,1999,0.6,2,0,1,1,0,1,1,100.0,0,1,0,1,0,2,0,0,Matches
277,Saïd Benrahma,ALG,"FW,MF",West Ham,Premier League,25,1995,24.1,28,17,16,9,3,15,38,39.5,23,17,1,16,9,37,8,0,Matches
278,Ramy Bensebaini,ALG,DF,Gladbach,Bundesliga,26,1995,22.4,42,30,24,15,3,27,44,61.4,17,33,7,26,39,81,77,1,Matches
279,Nabil Bentaleb,ALG,MF,Angers,Ligue 1,26,1994,16.8,42,24,15,20,7,16,29,55.2,13,24,9,15,28,70,13,0,Matches
280,Rodrigo Bentancur,URU,MF,Tottenham,Premier League,24,1997,15.1,36,18,14,14,8,16,32,50.0,16,24,9,15,20,56,35,0,Matches
281,Rodrigo Bentancur,URU,MF,Juventus,Serie A,24,1997,12.8,32,18,11,18,3,7,20,35.0,13,15,2,13,26,58,15,1,Matches
282,Christian Benteke,BEL,FW,Crystal Palace,Premier League,30,1990,12.7,3,2,1,2,0,2,6,33.3,4,7,3,4,2,5,33,0,Matches
283,Karim Benzema,FRA,FW,Real Madrid,La Liga,33,1987,28.8,11,9,5,3,3,2,9,22.2,7,10,0,10,4,15,13,0,Matches
284,Alessandro Berardi,ITA,GK,Hellas Verona,Serie A,30,1991,1.0,0,0,0,0,0,0,0,,0,0,0,0,0,0,0,0,Matches
285,Domenico Berardi,ITA,FW,Sassuolo,Serie A,26,1994,31.3,32,19,9,16,7,15,57,26.3,42,39,2,37,31,63,23,0,Matches
286,Yuri Berchiche,ESP,DF,Athletic Club,La Liga,31,1990,11.3,25,11,10,11,4,7,14,50.0,7,19,6,13,13,38,25,0,Matches
287,Álex Berenguer,ESP,MF,Athletic Club,La Liga,26,1995,24.1,45,26,23,14,8,11,51,21.6,40,40,2,38,16,61,20,0,Matches
288,Bartosz Bereszyński,POL,DF,Sampdoria,Serie A,29,1992,32.7,64,38,34,25,5,37,80,46.3,43,38,12,26,42,106,73,1,Matches
289,Jóhann Berg Guðmundsson,ISL,MF,Burnley,Premier League,30,1990,12.2,16,6,7,7,2,5,20,25.0,15,11,2,9,12,28,22,0,Matches
290,Patrick Berg,NOR,MF,Lens,Ligue 1,23,1997,3.4,14,6,6,8,0,0,4,0.0,4,2,1,1,4,18,3,0,Matches
291,Mitchell van Bergen,NED,"FW,MF",Reims,Ligue 1,21,1999,10.9,8,5,7,0,1,6,15,40.0,9,9,0,9,4,12,7,0,Matches
292,Steven Bergwijn,NED,"FW,MF",Tottenham,Premier League,23,1997,6.3,3,2,2,1,0,1,10,10.0,9,3,0,3,1,4,8,0,Matches
293,Etrit Berisha,ALB,GK,Torino,Serie A,32,1989,10.0,0,0,0,0,0,0,0,,0,0,0,0,0,0,4,0,Matches
294,Valon Berisha,KVX,"MF,FW",Reims,Ligue 1,28,1993,5.1,10,7,2,5,3,2,10,20.0,8,9,0,9,4,14,3,0,Matches
295,Federico Bernardeschi,ITA,"MF,FW",Juventus,Serie A,27,1994,16.4,16,10,7,4,5,6,13,46.2,7,12,4,8,5,21,15,0,Matches
296,Paul Bernardoni,FRA,GK,Angers,Ligue 1,24,1997,13.0,3,2,3,0,0,3,4,75.0,1,0,0,0,0,3,8,1,Matches
297,Paul Bernardoni,FRA,GK,Saint-Étienne,Ligue 1,24,1997,19.0,0,0,0,0,0,0,0,,0,0,0,0,0,0,14,2,Matches
298,Juan Bernat,ESP,"DF,MF",Paris S-G,Ligue 1,28,1993,10.6,24,14,10,10,4,13,18,72.2,5,8,0,8,8,32,16,0,Matches
299,Dimitry Bertaud,COD,GK,Montpellier,Ligue 1,23,1998,9.3,0,0,0,0,0,0,1,0.0,1,0,0,0,0,0,5,1,Matches
300,Jason Berthomier,FRA,MF,Clermont Foot,Ligue 1,31,1990,19.2,29,14,5,17,7,12,34,35.3,22,14,2,12,8,37,4,1,Matches
301,Nicolò Bertola,ITA,"MF,DF",Spezia,Serie A,18,2003,0.4,3,2,3,0,0,3,4,75.0,1,0,0,0,3,6,1,0,Matches
302,Ryan Bertrand,ENG,DF,Leicester City,Premier League,31,1989,3.7,8,5,3,4,1,2,5,40.0,3,8,3,5,1,9,7,0,Matches
303,Daniel Bessa,ITA,MF,Hellas Verona,Serie A,28,1993,8.5,7,2,3,3,1,4,15,26.7,11,13,3,10,5,12,11,0,Matches
304,Beto,GNB,FW,Udinese,Serie A,23,1998,24.1,21,6,2,14,5,9,19,47.4,10,16,1,15,5,26,25,1,Matches
305,Jordan Beyer,GER,DF,Gladbach,Bundesliga,21,2000,15.4,46,27,32,13,1,23,39,59.0,16,18,5,13,15,61,52,2,Matches
306,Giulian Biancone,FRA,"DF,MF",Troyes,Ligue 1,21,2000,25.5,70,42,44,22,4,40,69,58.0,29,23,8,15,53,123,71,1,Matches
307,Bartosz Białek,POL,"FW,DF",Wolfsburg,Bundesliga,19,2001,2.0,0,0,0,0,0,0,1,0.0,1,1,0,1,0,0,2,0,Matches
308,Ermin Bičakčić,BIH,DF,Hoffenheim,Bundesliga,31,1990,0.1,0,0,0,0,0,0,0,,0,0,0,0,0,0,0,0,Matches
309,Mads Bidstrup,DEN,MF,Brentford,Premier League,20,2001,0.5,1,0,0,1,0,0,3,0.0,3,0,0,0,1,2,2,0,Matches
310,Pedro Bigas,ESP,DF,Elche,La Liga,30,1990,17.2,24,10,16,8,0,9,20,45.0,11,21,16,5,18,42,77,1,Matches
311,El Bilal Touré,MLI,FW,Reims,Ligue 1,19,2001,13.3,13,6,4,6,3,2,7,28.6,5,10,3,7,6,19,19,0,Matches
312,Jean-Claude Billong,CMR,DF,Clermont Foot,Ligue 1,27,1993,10.9,17,8,14,1,2,8,11,72.7,3,9,1,8,10,27,35,0,Matches
313,Luis Binks,ENG,DF,Bologna,Serie A,19,2001,7.2,8,4,7,1,0,4,6,66.7,2,6,5,1,17,25,33,1,Matches
314,Cristiano Biraghi,ITA,DF,Fiorentina,Serie A,28,1992,35.0,37,24,17,15,5,22,53,41.5,31,28,10,18,19,56,31,1,Matches
315,Davide Biraschi,ITA,DF,Genoa,Serie A,27,1994,10.3,31,16,19,9,3,17,24,70.8,7,16,9,7,16,47,26,0,Matches
316,Tom Bischof,GER,MF,Hoffenheim,Bundesliga,16,2005,0.2,0,0,0,0,0,0,0,,0,1,0,1,0,0,1,0,Matches
317,Yves Bissouma,MLI,MF,Brighton,Premier League,24,1996,23.5,76,49,35,37,4,21,37,56.8,16,33,3,30,50,126,49,0,Matches
318,Nathan Bitu Mazala,FRA,DF,Paris S-G,Ligue 1,18,2002,0.1,0,0,0,0,0,0,0,,0,1,0,1,0,0,0,0,Matches
319,Marco Bizot,NED,GK,Brest,Ligue 1,30,1991,38.0,3,1,3,0,0,3,5,60.0,2,1,0,1,0,3,24,1,Matches
320,Bjarki Bjarkason,ISL,MF,Venezia,Serie A,21,2000,0.0,0,0,0,0,0,0,0,,0,0,0,0,0,0,0,0,Matches
321,Antonio Blanco,ESP,MF,Real Madrid,La Liga,21,2000,0.3,2,0,1,1,0,0,0,,0,1,1,0,1,3,0,0,Matches
322,Ludovic Blas,FRA,"MF,FW",Nantes,Ligue 1,23,1997,32.9,33,18,7,20,6,15,44,34.1,29,33,3,30,31,64,6,1,Matches
323,Danny Blum,GER,FW,Bochum,Bundesliga,30,1991,3.8,2,1,0,0,2,0,2,0.0,2,4,0,4,2,4,1,0,Matches
324,Myron Boadu,NED,FW,Monaco,Ligue 1,20,2001,10.7,9,7,2,3,4,1,5,20.0,4,6,0,6,2,11,1,0,Matches
325,Jérôme Boateng,GER,DF,Lyon,Ligue 1,32,1988,18.0,20,15,11,9,0,9,17,52.9,8,20,10,10,20,40,73,0,Matches
326,Kevin-Prince Boateng,GHA,"MF,FW",Hertha BSC,Bundesliga,34,1987,7.7,6,5,1,4,1,3,9,33.3,6,7,2,5,6,12,11,0,Matches
327,Antonin Bobichon,FRA,"MF,FW",Angers,Ligue 1,25,1995,0.4,1,0,0,1,0,0,0,,0,0,0,0,1,2,0,0,Matches
328,Herbert Bockhorn,GER,DF,Bochum,Bundesliga,26,1995,9.4,20,14,13,4,3,12,20,60.0,8,10,1,9,14,34,18,0,Matches
329,Jean-Paul Boëtius,NED,MF,Mainz 05,Bundesliga,27,1994,20.0,40,23,18,17,5,22,53,41.5,31,41,3,38,25,65,11,0,Matches
330,Jeremie Boga,CIV,"FW,MF",Atalanta,Serie A,24,1997,8.5,7,3,0,4,3,4,6,66.7,2,6,0,6,1,8,3,1,Matches
331,Jeremie Boga,CIV,"FW,MF",Sassuolo,Serie A,24,1997,7.4,7,4,1,2,4,2,3,66.7,1,3,0,3,2,9,1,1,Matches
332,Luka Bogdan,CRO,DF,Salernitana,Serie A,25,1996,4.4,6,3,6,0,0,4,8,50.0,4,3,2,1,6,12,21,0,Matches
333,Emil Bohinen,NOR,MF,Salernitana,Serie A,22,1999,7.8,15,9,4,9,2,10,20,50.0,10,17,3,14,12,27,14,0,Matches
334,Quentin Boisgard,FRA,"MF,FW",Lorient,Ligue 1,24,1997,10.6,19,11,6,10,3,8,17,47.1,9,15,0,15,6,25,5,0,Matches
335,Charles Boli,FRA,"MF,DF",Lens,Ligue 1,22,1998,0.4,2,1,0,2,0,0,0,,0,0,0,0,0,2,0,0,Matches
336,Willy Boly,CIV,DF,Wolves,Premier League,30,1991,10.0,25,19,18,7,0,8,15,53.3,7,14,6,8,14,39,35,0,Matches
337,Giacomo Bonaventura,ITA,MF,Fiorentina,Serie A,31,1989,25.2,33,17,12,16,5,21,46,45.7,25,20,2,18,14,47,9,1,Matches
338,Federico Bonazzoli,ITA,"FW,MF",Salernitana,Serie A,24,1997,20.7,24,12,9,8,7,6,25,24.0,19,17,1,16,6,30,7,0,Matches
339,Tarsis Bonga,GER,"MF,FW",Bochum,Bundesliga,24,1997,0.2,0,0,0,0,0,0,0,,0,0,0,0,0,0,0,0,Matches
340,Kevin Bonifazi,ITA,DF,Bologna,Serie A,25,1996,13.4,25,16,16,7,2,13,14,92.9,1,22,7,15,16,41,35,0,Matches
341,Solomon Bonnah,NED,DF,RB Leipzig,Bundesliga,17,2003,0.1,0,0,0,0,0,0,0,,0,1,0,1,1,1,0,0,Matches
342,Leonardo Bonucci,ITA,DF,Juventus,Serie A,34,1987,22.3,14,5,4,10,0,8,13,61.5,5,22,17,5,26,40,82,0,Matches
343,Sebastiaan Bornauw,BEL,DF,Wolfsburg,Bundesliga,22,1999,22.3,30,19,23,5,2,16,25,64.0,9,29,8,21,42,72,97,1,Matches
344,Rafael Borré,COL,FW,Eint Frankfurt,Bundesliga,25,1995,26.4,31,22,4,13,14,7,33,21.2,26,24,4,20,5,36,9,0,Matches
345,Sven Botman,NED,DF,Lille,Ligue 1,21,2000,25.0,24,11,13,11,0,12,18,66.7,6,32,21,11,26,50,116,0,Matches
346,Denis Bouanga,GAB,"FW,MF",Saint-Étienne,Ligue 1,26,1994,27.1,46,25,14,13,19,22,63,34.9,41,30,0,30,8,54,34,1,Matches
347,Hicham Boudaoui,ALG,MF,Nice,Ligue 1,21,1999,18.0,31,18,15,10,6,13,36,36.1,23,17,4,13,18,49,15,0,Matches
348,Ryad Boudebouz,ALG,"MF,FW",Saint-Étienne,Ligue 1,31,1990,25.0,27,15,11,12,4,12,29,41.4,17,17,2,15,10,37,5,0,Matches
349,Sofiane Boufal,MAR,"FW,MF",Angers,Ligue 1,27,1993,25.9,44,29,19,16,9,18,38,47.4,20,19,2,17,7,51,1,0,Matches
350,Farid Boulaya,ALG,"MF,FW",Metz,Ligue 1,28,1993,17.0,18,10,7,9,2,14,38,36.8,24,8,2,6,12,30,5,0,Matches
351,Yassine Bounou,MAR,GK,Sevilla,La Liga,30,1991,31.0,0,0,0,0,0,0,0,,0,0,0,0,0,0,11,1,Matches
352,Ismaëlben Boura,COM,DF,Lens,Ligue 1,20,2000,1.1,2,2,1,1,0,0,0,,0,1,1,0,2,4,5,0,Matches
353,Mehdi Bourabia,MAR,MF,Spezia,Serie A,29,1991,3.1,5,1,2,3,0,3,11,27.3,8,7,6,1,3,8,10,0,Matches
354,Benjamin Bourigeaud,FRA,"FW,MF",Rennes,Ligue 1,27,1994,35.5,46,24,16,18,12,24,67,35.8,43,33,3,30,30,76,44,0,Matches
355,Redwan Bourles,FRA,"MF,FW",Lorient,Ligue 1,18,2003,0.2,0,0,0,0,0,0,0,,0,0,0,0,0,0,0,0,Matches
356,Edoardo Bove,ITA,"MF,DF",Roma,Serie A,19,2002,0.8,1,1,1,0,0,0,2,0.0,2,1,0,1,1,2,0,0,Matches
357,Jarrod Bowen,ENG,FW,West Ham,Premier League,24,1996,33.1,36,20,20,11,5,17,44,38.6,27,29,2,27,21,57,14,0,Matches
358,Dedryck Boyata,BEL,DF,Hertha BSC,Bundesliga,30,1990,21.1,15,13,11,3,1,8,11,72.7,3,17,13,4,17,32,134,1,Matches
359,Lucas Boyé,ARG,FW,Elche,La Liga,25,1996,19.0,27,13,5,15,7,9,24,37.5,15,24,1,23,2,29,23,0,Matches
360,Domagoj Bradarić,CRO,DF,Lille,Ligue 1,21,1999,4.6,11,9,8,2,1,7,12,58.3,5,5,2,3,10,21,7,1,Matches
361,Bilal Brahimi,ALG,MF,Nice,Ligue 1,21,2000,4.2,1,1,0,1,0,0,2,0.0,2,1,0,1,2,3,1,0,Matches
362,Bilal Brahimi,ALG,FW,Angers,Ligue 1,21,2000,3.8,1,1,0,1,0,0,3,0.0,3,0,0,0,1,2,1,0,Matches
363,Martin Braithwaite,DEN,FW,Barcelona,La Liga,30,1991,2.6,1,1,0,0,1,0,0,,0,2,0,2,1,2,1,0,Matches
364,Julian Brandt,GER,"MF,FW",Dortmund,Bundesliga,25,1996,23.1,37,19,13,20,4,17,54,31.5,37,19,2,17,24,61,14,1,Matches
365,Jarrad Branthwaite,ENG,DF,Everton,Premier League,19,2002,4.3,4,1,3,1,0,3,8,37.5,5,3,2,1,1,5,20,0,Matches
366,Darko Brašanac,SRB,MF,Osasuna,La Liga,29,1992,26.7,35,22,19,14,2,14,40,35.0,26,25,8,17,25,60,15,0,Matches
367,Lilian Brassier,FRA,DF,Brest,Ligue 1,21,1999,25.1,40,24,23,13,4,10,21,47.6,11,31,21,10,32,72,86,0,Matches
368,Claudio Bravo,CHI,GK,Betis,La Liga,38,1983,16.2,0,0,0,0,0,0,0,,0,0,0,0,0,0,6,2,Matches
369,Iker Bravo,ESP,FW,Leverkusen,Bundesliga,16,2005,0.1,1,1,0,1,0,0,0,,0,0,0,0,0,1,0,0,Matches
370,Fabian Bredlow,GER,GK,Stuttgart,Bundesliga,26,1995,4.0,0,0,0,0,0,0,0,,0,0,0,0,0,0,1,0,Matches
371,Josip Brekalo,CRO,MF,Torino,Serie A,23,1998,25.4,9,5,5,1,3,3,21,14.3,18,16,1,15,4,13,7,1,Matches
372,Josip Brekalo,CRO,FW,Wolfsburg,Bundesliga,23,1998,0.2,0,0,0,0,0,0,0,,0,0,0,0,0,0,0,0,Matches
373,Gleison Bremer,BRA,DF,Torino,Serie A,24,1997,32.1,49,24,27,22,0,18,28,64.3,10,54,23,31,105,154,137,0,Matches
374,Jimmy Briand,FRA,"FW,MF",Bordeaux,Ligue 1,35,1985,2.5,2,0,2,0,0,0,2,0.0,2,0,0,0,1,3,2,0,Matches
375,Yan Brice Eteki,CMR,MF,Granada,La Liga,23,1997,3.8,6,3,3,2,1,3,7,42.9,4,7,3,4,4,10,6,1,Matches
376,Brian Brobbey,NED,"FW,MF",RB Leipzig,Bundesliga,19,2002,1.5,1,0,0,1,0,1,1,100.0,0,1,0,1,0,1,0,0,Matches
377,Armando Broja,ALB,FW,Southampton,Premier League,19,2001,21.9,12,5,2,7,3,2,9,22.2,7,17,1,16,3,15,11,0,Matches
378,Dylan Bronn,TUN,DF,Metz,Ligue 1,26,1995,28.3,47,29,33,13,1,20,31,64.5,11,32,19,13,40,87,78,1,Matches
379,John Brooks,USA,DF,Wolfsburg,Bundesliga,28,1993,29.1,47,25,25,18,4,36,60,60.0,24,33,19,14,41,88,125,1,Matches
380,Daniel Brosinski,GER,DF,Mainz 05,Bundesliga,33,1988,4.3,2,1,1,1,0,1,1,100.0,0,6,0,6,3,5,9,0,Matches
381,Josh Brownhill,ENG,MF,Burnley,Premier League,25,1995,32.8,73,37,25,42,6,21,53,39.6,32,37,12,25,68,141,42,1,Matches
382,Marcelo Brozović,CRO,MF,Inter,Serie A,28,1992,32.6,77,45,34,35,8,34,68,50.0,34,28,10,18,37,114,36,2,Matches
383,Cédric Brunner,SUI,DF,Arminia,Bundesliga,27,1994,24.3,51,35,29,20,2,25,49,51.0,24,27,10,17,43,94,84,0,Matches
384,Lewis Brunt,ENG,MF,Leicester City,Premier League,20,2000,0.3,0,0,0,0,0,0,0,,0,1,0,1,0,0,0,0,Matches
385,Jacob Bruun Larsen,DEN,"FW,MF",Hoffenheim,Bundesliga,22,1998,9.0,2,1,1,1,0,0,5,0.0,5,14,3,11,5,7,5,2,Matches
386,Ante Budimir,CRO,FW,Osasuna,La Liga,30,1991,19.3,24,10,3,15,6,6,19,31.6,13,22,4,18,3,27,16,0,Matches
387,Emi Buendía,ARG,"MF,FW",Aston Villa,Premier League,24,1996,21.1,38,18,16,13,9,21,51,41.2,30,21,3,18,9,47,11,0,Matches
388,Osman Bukari,GHA,"FW,MF",Nantes,Ligue 1,22,1998,11.2,18,8,7,6,5,8,22,36.4,14,8,0,8,8,26,1,0,Matches
389,Aleksander Buksa,POL,FW,Genoa,Serie A,18,2003,0.7,0,0,0,0,0,0,1,0.0,1,0,0,0,0,0,1,0,Matches
390,Alessandro Buongiorno,ITA,DF,Torino,Serie A,22,1999,13.1,20,9,9,8,3,9,13,69.2,4,12,6,6,31,51,44,0,Matches
391,Sascha Burchert,GER,GK,Greuther Fürth,Bundesliga,31,1989,14.0,1,1,1,0,0,1,2,50.0,1,0,0,0,0,1,11,1,Matches
392,Delano Burgzorg,NED,MF,Mainz 05,Bundesliga,22,1998,0.3,1,1,1,0,0,0,1,0.0,1,0,0,0,0,1,0,0,Matches
393,Jonathan Burkardt,GER,"FW,MF",Mainz 05,Bundesliga,21,2000,29.0,17,8,0,10,7,6,25,24.0,19,31,5,26,8,25,16,0,Matches
394,Roman Bürki,SUI,GK,Dortmund,Bundesliga,30,1990,1.0,0,0,0,0,0,0,0,,0,0,0,0,0,0,0,0,Matches
395,Dan Burn,ENG,DF,Newcastle Utd,Premier League,29,1992,16.0,16,11,11,4,1,7,11,63.6,4,22,14,8,20,36,101,0,Matches
396,Dan Burn,ENG,DF,Brighton,Premier League,29,1992,11.4,22,12,13,8,1,6,15,40.0,9,14,10,4,24,46,51,0,Matches
397,Maxime Busi,BEL,DF,Reims,Ligue 1,21,1999,14.4,26,15,20,5,1,19,36,52.8,17,19,5,14,17,43,28,0,Matches
398,Gianluca Busio,USA,MF,Venezia,Serie A,19,2002,21.7,53,28,27,20,6,28,63,44.4,35,45,13,32,21,74,30,1,Matches
399,Oriol Busquets,ESP,MF,Clermont Foot,Ligue 1,22,1999,2.2,3,3,0,3,0,2,6,33.3,4,7,4,3,1,4,2,0,Matches
400,Sergio Busquets,ESP,MF,Barcelona,La Liga,33,1988,35.5,93,49,31,48,14,46,83,55.4,37,44,8,36,45,138,31,0,Matches
401,Jack Butland,ENG,GK,Crystal Palace,Premier League,28,1993,8.5,0,0,0,0,0,0,0,,0,0,0,0,0,0,1,0,Matches
402,Adrián Butzke,ESP,FW,Granada,La Liga,22,1999,0.0,0,0,0,0,0,0,0,,0,0,0,0,0,0,0,0,Matches
403,Marcin Bułka,POL,GK,Nice,Ligue 1,21,1999,1.0,0,0,0,0,0,0,0,,0,0,0,0,0,0,0,0,Matches
404,Sam Byram,ENG,DF,Norwich City,Premier League,27,1993,11.4,24,15,17,6,1,19,27,70.4,8,21,11,10,22,46,48,0,Matches
405,Erick Cabaco,URU,DF,Getafe,La Liga,26,1995,4.5,2,1,1,1,0,2,5,40.0,3,5,2,3,4,6,10,0,Matches
406,Willy Caballero,ARG,GK,Southampton,Premier League,39,1981,2.0,0,0,0,0,0,0,0,,0,0,0,0,0,0,2,1,Matches
407,Rémy Cabella,FRA,"MF,FW",Montpellier,Ligue 1,31,1990,3.5,15,7,4,8,3,5,15,33.3,10,7,0,7,5,20,1,0,Matches
408,Jimmy Cabot,FRA,DF,Angers,Ligue 1,27,1994,22.3,81,44,59,15,7,47,83,56.6,36,29,0,29,32,113,30,0,Matches
409,Arthur Cabral,BRA,FW,Fiorentina,Serie A,23,1998,8.3,9,5,2,5,2,4,7,57.1,3,4,1,3,1,10,8,0,Matches
410,Jovane Cabral,CPV,FW,Lazio,Serie A,23,1998,2.1,2,1,1,0,1,0,0,,0,1,1,0,1,3,1,0,Matches
411,Leandro Cabrera,URU,DF,Espanyol,La Liga,30,1991,37.0,37,24,27,10,0,21,34,61.8,13,32,23,9,44,81,222,2,Matches
412,Liberato Cacace,NZL,DF,Empoli,Serie A,20,2000,5.2,15,6,8,4,3,8,8,100.0,0,7,2,5,8,23,9,0,Matches
413,Martín Cáceres,URU,DF,Cagliari,Serie A,34,1987,9.2,13,7,5,5,3,4,12,33.3,8,12,3,9,14,27,21,0,Matches
414,Martín Cáceres,URU,DF,Levante,La Liga,34,1987,7.4,2,2,2,0,0,1,5,20.0,4,2,2,0,11,13,16,1,Matches
415,Anthony Caci,FRA,DF,Strasbourg,Ligue 1,24,1997,26.6,65,34,35,24,6,33,55,60.0,22,22,3,19,33,98,49,1,Matches
416,Mathieu Cafaro,FRA,"MF,FW",Reims,Ligue 1,24,1997,2.1,4,2,3,1,0,0,7,0.0,7,2,0,2,3,7,1,0,Matches
417,Yannick Cahuzac,FRA,MF,Lens,Ligue 1,36,1985,6.9,5,2,2,3,0,0,5,0.0,5,8,2,6,9,14,12,0,Matches
418,Felipe Caicedo,ECU,FW,Genoa,Serie A,32,1988,3.2,3,3,0,2,1,0,1,0.0,1,1,0,1,0,3,4,0,Matches
419,Felipe Caicedo,ECU,"FW,DF",Inter,Serie A,32,1988,0.3,0,0,0,0,0,0,0,,0,1,0,1,0,0,0,0,Matches
420,Moisés Caicedo,ECU,MF,Brighton,Premier League,19,2001,7.3,16,10,7,7,2,5,12,41.7,7,18,4,14,10,26,7,0,Matches
421,Marc-Aurèle Caillard,FRA,GK,Metz,Ligue 1,27,1994,17.1,0,0,0,0,0,0,2,0.0,2,0,0,0,2,2,9,1,Matches
422,Jens Cajuste,SWE,"MF,FW",Reims,Ligue 1,21,1999,4.0,10,6,6,2,2,6,17,35.3,11,7,2,5,5,15,6,0,Matches
423,Cala,ESP,DF,Cádiz,La Liga,31,1989,10.5,9,4,9,0,0,8,17,47.1,9,12,6,6,12,21,56,0,Matches
424,Davide Calabria,ITA,DF,Milan,Serie A,24,1996,23.5,62,37,31,23,8,37,72,51.4,35,25,5,20,23,85,40,1,Matches
425,Riccardo Calafiori,ITA,DF,Genoa,Serie A,19,2002,0.9,1,0,0,0,1,1,2,50.0,1,2,1,1,2,3,4,0,Matches
426,Riccardo Calafiori,ITA,DF,Roma,Serie A,19,2002,1.9,5,4,2,2,1,1,5,20.0,4,3,0,3,3,8,1,0,Matches
427,Mattia Caldara,ITA,DF,Venezia,Serie A,27,1994,30.0,48,28,30,15,3,20,34,58.8,14,49,37,12,62,110,147,1,Matches
428,Calderón,ESP,DF,Betis,La Liga,21,2000,0.7,2,0,1,0,1,1,3,33.3,2,0,0,0,0,2,2,0,Matches
429,Fernando Calero,ESP,DF,Espanyol,La Liga,25,1995,12.1,17,10,12,5,0,8,13,61.5,5,7,2,5,16,33,63,1,Matches
430,Duje Ćaleta-Car,CRO,DF,Marseille,Ligue 1,24,1996,22.9,21,8,15,6,0,11,14,78.6,3,11,7,4,24,45,55,2,Matches
431,Hakan Çalhanoğlu,TUR,MF,Inter,Serie A,27,1994,27.6,41,23,16,19,6,11,40,27.5,29,29,5,24,25,66,12,0,Matches
432,Daniel Caligiuri,ITA,"DF,MF",Augsburg,Bundesliga,33,1988,22.3,46,30,17,26,3,27,72,37.5,45,36,5,31,18,64,33,0,Matches
433,José Callejón,ESP,FW,Fiorentina,Serie A,34,1987,14.4,15,6,6,6,3,13,31,41.9,18,6,0,6,3,18,1,1,Matches
434,Lucas Calodat,FRA,DF,Saint-Étienne,Ligue 1,19,2002,0.0,0,0,0,0,0,0,0,,0,0,0,0,0,0,0,0,Matches
435,Dominic Calvert-Lewin,ENG,FW,Everton,Premier League,24,1997,14.3,11,8,1,6,4,3,8,37.5,5,5,2,3,3,14,12,0,Matches
436,Mahdi Camara,FRA,"MF,DF",Saint-Étienne,Ligue 1,23,1998,34.1,101,57,39,50,12,39,70,55.7,31,44,8,36,57,158,35,1,Matches
437,Mamadou Camara,MLI,FW,Troyes,Ligue 1,20,2001,0.4,1,1,1,0,0,0,0,,0,0,0,0,0,1,0,0,Matches
438,Víctor Camarasa,ESP,"MF,FW",Betis,La Liga,27,1994,1.2,2,1,1,1,0,0,1,0.0,1,2,1,1,2,4,2,0,Matches
439,Eduardo Camavinga,FRA,MF,Real Madrid,La Liga,18,2002,13.7,52,35,22,20,10,20,38,52.6,18,20,2,18,17,69,14,1,Matches
440,Eduardo Camavinga,FRA,MF,Rennes,Ligue 1,18,2002,1.6,4,1,2,1,1,2,5,40.0,3,1,1,0,1,5,3,0,Matches
441,Andrea Cambiaso,ITA,DF,Genoa,Serie A,21,2000,19.9,46,20,28,14,4,18,32,56.3,14,33,8,25,23,69,37,1,Matches
442,José Campaña,ESP,MF,Levante,La Liga,28,1993,15.8,27,16,13,10,4,12,32,37.5,20,13,2,11,21,48,19,1,Matches
443,Chem Campbell,WAL,MF,Wolves,Premier League,18,2002,0.1,1,1,0,1,0,0,0,,0,0,0,0,0,1,0,0,Matches
444,Emre Can,GER,"DF,MF",Dortmund,Bundesliga,27,1994,18.8,36,22,20,16,0,15,30,50.0,15,26,10,16,36,72,40,2,Matches
445,Sergio Canales,ESP,"FW,MF",Betis,La Liga,30,1991,31.0,24,14,8,12,4,10,35,28.6,25,16,1,15,10,34,12,0,Matches
446,Matteo Cancellieri,ITA,"MF,DF",Hellas Verona,Serie A,19,2002,2.5,4,4,2,2,0,0,5,0.0,5,2,0,2,1,5,0,0,Matches
447,João Cancelo,POR,DF,Manchester City,Premier League,27,1994,35.9,83,54,33,35,15,46,91,50.5,45,25,3,22,59,142,45,1,Matches
448,Fali Candé,GNB,DF,Metz,Ligue 1,23,1998,10.8,30,18,13,15,2,13,31,41.9,18,11,2,9,6,36,21,0,Matches
449,Antonio Candreva,ITA,"MF,FW",Sampdoria,Serie A,34,1987,34.7,27,16,9,11,7,19,55,34.5,36,23,2,21,33,60,19,0,Matches
450,Sergi Canós,ESP,"DF,FW",Brentford,Premier League,24,1997,23.1,56,25,32,15,9,33,60,55.0,27,32,3,29,22,78,38,0,Matches
451,Álex Cantero,ESP,"FW,MF",Levante,La Liga,21,2000,6.8,6,4,2,3,1,1,8,12.5,7,2,0,2,1,7,0,0,Matches
452,Todd Cantwell,ENG,"FW,MF",Norwich City,Premier League,23,1998,4.9,15,13,8,6,1,6,17,35.3,11,2,0,2,3,18,2,0,Matches
453,Ander Capa,ESP,DF,Athletic Club,La Liga,29,1992,0.0,0,0,0,0,0,0,0,,0,0,0,0,0,0,0,0,Matches
454,Pierrick Capelle,FRA,"MF,DF",Angers,Ligue 1,34,1987,13.3,36,24,16,17,3,18,52,34.6,34,12,1,11,16,52,20,0,Matches
455,Leonardo Capezzi,ITA,MF,Salernitana,Serie A,26,1995,1.9,3,1,0,3,0,1,4,25.0,3,8,4,4,0,3,2,0,Matches
456,Étienne Capoue,FRA,MF,Villarreal,La Liga,33,1988,25.4,44,26,18,23,3,15,28,53.6,13,17,5,12,35,79,51,0,Matches
457,Gianluca Caprari,ITA,"MF,FW",Hellas Verona,Serie A,28,1993,30.4,43,25,10,22,11,17,51,33.3,34,32,0,32,4,47,7,0,Matches
458,Francesco Caputo,ITA,FW,Sampdoria,Serie A,33,1987,31.0,5,2,1,3,1,1,6,16.7,5,5,0,5,2,7,10,0,Matches
459,Francesco Caputo,ITA,FW,Sassuolo,Serie A,33,1987,1.7,0,0,0,0,0,0,0,,0,0,0,0,0,0,0,0,Matches
460,Maxence Caqueret,FRA,MF,Lyon,Ligue 1,21,2000,25.9,73,40,29,36,8,30,80,37.5,50,38,10,28,43,116,26,2,Matches
461,Andrea Carboni,ITA,DF,Cagliari,Serie A,20,2001,24.6,53,24,33,16,4,19,42,45.2,23,42,15,27,27,80,87,0,Matches
462,Isaac Carcelen,ESP,"DF,MF",Cádiz,La Liga,28,1993,17.2,43,29,29,12,2,28,56,50.0,28,25,6,19,34,77,42,0,Matches
463,Cárdenas,ESP,GK,Levante,La Liga,24,1997,24.0,1,1,1,0,0,0,3,0.0,3,0,0,0,1,2,19,0,Matches
464,Irvin Cardona,FRA,"FW,MF",Brest,Ligue 1,23,1997,14.8,13,7,5,4,4,3,16,18.8,13,10,0,10,5,18,17,0,Matches
465,Igor Carioca,BRA,DF,Lorient,Ligue 1,24,1996,17.5,27,16,16,8,3,15,43,34.9,28,17,2,15,25,52,28,0,Matches
466,Carlo,ESP,MF,Villarreal,La Liga,20,2001,0.1,0,0,0,0,0,0,0,,0,0,0,0,0,0,0,0,Matches
467,Diego Carlos,BRA,DF,Sevilla,La Liga,28,1993,32.9,35,24,20,13,2,16,24,66.7,8,48,33,15,24,59,120,5,Matches
468,Carmona,ESP,DF,Sevilla,La Liga,19,2002,0.3,0,0,0,0,0,0,0,,0,0,0,0,1,1,0,0,Matches
469,Yannick Carrasco,BEL,"FW,MF",Atlético Madrid,La Liga,27,1993,28.7,34,19,16,12,6,19,44,43.2,25,26,5,21,19,53,12,2,Matches
470,Guido Carrillo,ARG,FW,Elche,La Liga,30,1991,13.0,7,4,2,4,1,3,13,23.1,10,9,2,7,1,8,27,0,Matches
471,Dani Carvajal,ESP,DF,Real Madrid,La Liga,29,1992,17.2,43,28,21,15,7,15,26,57.7,11,22,8,14,20,63,38,2,Matches
472,William Carvalho,POR,MF,Betis,La Liga,29,1992,20.1,49,33,20,25,4,15,40,37.5,25,18,7,11,16,65,20,0,Matches
473,Nicolò Casale,ITA,DF,Hellas Verona,Serie A,23,1998,28.7,46,30,25,19,2,21,37,56.8,16,31,12,19,49,95,95,0,Matches
474,Casemiro,BRA,MF,Real Madrid,La Liga,29,1992,28.5,79,51,45,30,4,30,67,44.8,37,65,19,46,38,117,65,3,Matches
475,Matty Cash,POL,DF,Aston Villa,Premier League,23,1997,37.5,89,50,52,34,3,47,78,60.3,31,54,16,38,49,138,100,2,Matches
476,Kiko Casilla,ESP,GK,Elche,La Liga,34,1986,14.0,0,0,0,0,0,0,1,0.0,1,0,0,0,1,1,2,2,Matches
477,Moreto Cassamã,GNB,MF,Reims,Ligue 1,23,1998,8.9,12,6,7,4,1,3,19,15.8,16,10,5,5,9,21,5,0,Matches
478,Francesco Cassata,ITA,MF,Genoa,Serie A,24,1997,0.1,0,0,0,0,0,0,0,,0,0,0,0,0,0,0,0,Matches
479,Timothy Castagne,BEL,DF,Leicester City,Premier League,25,1995,23.6,67,31,38,22,7,27,43,62.8,16,28,9,19,29,96,54,1,Matches
480,Koen Casteels,BEL,GK,Wolfsburg,Bundesliga,29,1992,28.0,0,0,0,0,0,0,1,0.0,1,0,0,0,0,0,9,2,Matches
481,Jean-Charles Castelletto,CMR,DF,Nantes,Ligue 1,26,1995,27.9,45,24,27,17,1,25,35,71.4,10,38,27,11,30,75,73,0,Matches
482,Samu Castillejo,ESP,"FW,MF",Milan,Serie A,26,1995,1.4,4,2,0,2,2,1,8,12.5,7,4,1,3,2,6,1,0,Matches
483,Gonzalo Castro,GER,"MF,FW",Arminia,Bundesliga,34,1987,4.8,8,3,4,4,0,1,5,20.0,4,3,0,3,3,11,3,0,Matches
484,Jonny Castro,ESP,DF,Wolves,Premier League,27,1994,11.4,25,15,13,11,1,11,20,55.0,9,14,3,11,13,38,11,0,Matches
485,Gaetano Castrovilli,ITA,MF,Fiorentina,Serie A,24,1997,15.5,25,17,15,6,4,12,23,52.2,11,18,4,14,11,36,6,0,Matches
486,Danilo Cataldi,ITA,MF,Lazio,Serie A,26,1994,19.0,36,17,15,17,4,12,38,31.6,26,24,12,12,17,53,19,1,Matches
487,Catena,ESP,DF,Rayo Vallecano,La Liga,26,1994,36.0,39,23,24,15,0,25,42,59.5,17,26,19,7,30,69,168,3,Matches
488,Craig Cathcart,NIR,DF,Watford,Premier League,32,1989,26.6,32,15,25,6,1,16,30,53.3,14,39,29,10,28,60,132,3,Matches
489,Edinson Cavani,URU,FW,Manchester Utd,Premier League,34,1987,8.5,4,1,0,3,1,2,8,25.0,6,6,0,6,2,6,8,0,Matches
490,Dani Ceballos,ESP,MF,Real Madrid,La Liga,24,1996,3.1,7,5,4,3,0,1,5,20.0,4,8,2,6,4,11,2,0,Matches
491,Pietro Ceccaroni,ITA,DF,Venezia,Serie A,25,1995,34.7,55,31,33,18,4,25,36,69.4,11,45,32,13,30,85,143,0,Matches
492,Federico Ceccherini,ITA,DF,Hellas Verona,Serie A,29,1992,26.2,32,16,19,10,3,19,33,57.6,14,13,8,5,50,82,76,1,Matches
493,Emil Ceide,NOR,"FW,MF",Sassuolo,Serie A,19,2001,0.6,1,1,0,1,0,1,2,50.0,1,1,0,1,0,1,0,0,Matches
494,Zeki Çelik,TUR,DF,Lille,Ligue 1,24,1997,30.0,64,37,43,17,4,36,63,57.1,27,32,9,23,43,107,62,2,Matches
495,Fabien Centonze,FRA,DF,Metz,Ligue 1,25,1996,17.6,33,21,22,9,2,13,32,40.6,19,37,8,29,32,65,51,0,Matches
496,Luca Ceppitelli,ITA,DF,Cagliari,Serie A,31,1989,16.1,23,12,13,10,0,16,27,59.3,11,21,14,7,25,48,54,0,Matches
497,Franco Cervi,ARG,MF,Celta Vigo,La Liga,27,1994,20.0,73,41,35,22,16,33,77,42.9,44,38,2,36,21,94,19,0,Matches
498,Damir Ceter,COL,FW,Cagliari,Serie A,23,1997,0.1,0,0,0,0,0,0,0,,0,0,0,0,0,0,0,0,Matches
499,Julian Chabot,GER,DF,Sampdoria,Serie A,23,1998,5.4,12,10,8,4,0,8,10,80.0,2,7,4,3,9,21,28,1,Matches
500,Julian Chabot,GER,DF,Köln,Bundesliga,23,1998,2.3,8,3,4,4,0,2,5,40.0,3,4,2,2,3,11,5,1,Matches
501,El Chadaille Bitshiabu,FRA,DF,Paris S-G,Ligue 1,16,2005,0.1,0,0,0,0,0,0,0,,0,0,0,0,0,0,2,0,Matches
502,Nassim Chadli,FRA,"MF,DF",Troyes,Ligue 1,20,2001,1.1,5,3,3,0,2,2,4,50.0,2,1,0,1,0,5,0,0,Matches
503,Kayky Chagas,BRA,FW,Manchester City,Premier League,18,2003,0.1,0,0,0,0,0,0,0,,0,0,0,0,0,0,0,0,Matches
504,Mehdi Chahiri,MAR,DF,Strasbourg,Ligue 1,25,1996,0.2,1,1,1,0,0,1,1,100.0,0,0,0,0,0,1,0,0,Matches
505,Trevoh Chalobah,ENG,DF,Chelsea,Premier League,22,1999,16.1,40,27,22,18,0,24,31,77.4,7,16,6,10,19,59,43,2,Matches
506,Calum Chambers,ENG,DF,Arsenal,Premier League,26,1995,1.9,5,3,3,1,1,3,4,75.0,1,6,3,3,0,5,10,0,Matches
507,Calum Chambers,ENG,DF,Aston Villa,Premier League,26,1995,9.2,16,8,10,6,0,4,6,66.7,2,14,8,6,5,21,42,0,Matches
508,Dylan Chambost,FRA,"MF,FW",Troyes,Ligue 1,23,1997,8.4,16,11,6,9,1,4,25,16.0,21,9,2,7,8,24,4,0,Matches
509,Timothy Chandler,USA,DF,Eint Frankfurt,Bundesliga,31,1990,13.5,18,12,10,8,0,11,24,45.8,13,10,3,7,19,37,28,1,Matches
510,Chapela,ESP,"MF,FW",Cádiz,La Liga,22,1999,4.4,4,2,1,0,3,2,4,50.0,2,6,1,5,4,8,5,0,Matches
511,Brendan Chardonnet,FRA,DF,Brest,Ligue 1,26,1994,29.8,44,25,32,11,1,29,40,72.5,11,42,29,13,55,99,141,0,Matches
512,Xavier Chavalerin,FRA,MF,Troyes,Ligue 1,30,1991,30.2,49,26,19,25,5,12,55,21.8,43,32,5,27,39,88,36,0,Matches
513,Xavier Chavalerin,FRA,MF,Reims,Ligue 1,30,1991,2.4,4,4,2,1,1,1,3,33.3,2,2,0,2,5,9,2,1,Matches
514,Justin Che,USA,"FW,DF",Hoffenheim,Bundesliga,17,2003,0.5,2,0,1,0,1,1,2,50.0,1,0,0,0,1,3,0,0,Matches
515,Chema,ESP,MF,Getafe,La Liga,29,1992,0.5,0,0,0,0,0,0,1,0.0,1,0,0,0,0,0,0,0,Matches
516,Rayan Cherki,FRA,"FW,MF",Lyon,Ligue 1,17,2003,4.9,6,2,1,3,2,4,9,44.4,5,2,0,2,1,7,0,0,Matches
517,Denis Cheryshev,RUS,"MF,FW",Valencia,La Liga,30,1990,6.3,14,5,6,1,7,6,15,40.0,9,9,1,8,9,23,9,0,Matches
518,Daniel Chesters,ENG,MF,West Ham,Premier League,19,2002,0.0,0,0,0,0,0,0,0,,0,0,0,0,0,0,0,0,Matches
519,Giorgio Chiellini,ITA,DF,Juventus,Serie A,36,1984,15.0,22,13,17,4,1,7,13,53.8,6,24,18,6,22,44,59,0,Matches
520,Federico Chiesa,ITA,"MF,FW",Juventus,Serie A,23,1997,9.6,26,19,9,9,8,12,26,46.2,14,7,0,7,4,30,3,0,Matches
521,Ben Chilwell,ENG,DF,Chelsea,Premier League,24,1996,6.0,8,3,2,6,0,2,5,40.0,3,7,0,7,4,12,14,1,Matches
522,Chiquinho,POR,"DF,FW",Wolves,Premier League,21,2000,2.3,9,6,4,5,0,4,5,80.0,1,5,0,5,2,11,1,0,Matches
523,Vlad Chiricheș,ROU,DF,Sassuolo,Serie A,31,1989,25.6,28,15,19,9,0,10,21,47.6,11,34,21,13,41,69,71,4,Matches
524,Pedro Chirivella,ESP,MF,Nantes,Ligue 1,24,1997,29.3,49,31,14,26,9,25,70,35.7,45,23,2,21,37,86,11,0,Matches
525,Joris Chotard,FRA,MF,Montpellier,Ligue 1,19,2001,32.6,59,30,33,23,3,36,78,46.2,42,27,15,12,42,101,56,0,Matches
526,Hamza Choudhury,ENG,"DF,MF",Leicester City,Premier League,23,1997,3.2,9,3,4,4,1,3,5,60.0,2,0,0,0,12,21,10,0,Matches
527,Andreas Christensen,DEN,DF,Chelsea,Premier League,25,1996,16.6,14,8,9,4,1,4,7,57.1,3,14,6,8,29,43,57,1,Matches
528,Max Christiansen,GER,MF,Greuther Fürth,Bundesliga,24,1996,22.8,46,25,19,22,5,18,43,41.9,25,52,16,36,68,114,56,0,Matches
529,Carney Chukwuemeka,ENG,"MF,FW",Aston Villa,Premier League,17,2003,3.3,7,1,2,5,0,3,5,60.0,2,3,0,3,1,8,2,1,Matches
530,Samuel Chukwueze,NGA,"MF,FW",Villarreal,La Liga,22,1999,14.8,13,9,6,5,2,3,6,50.0,3,7,0,7,5,18,4,0,Matches
531,Víctor Chust,ESP,DF,Cádiz,La Liga,21,2000,20.3,19,10,14,4,1,11,17,64.7,6,20,8,12,16,35,87,0,Matches
532,Riccardo Ciervo,ITA,"MF,DF",Sampdoria,Serie A,19,2002,2.5,8,3,4,3,1,2,6,33.3,4,1,0,1,2,10,2,0,Matches
533,Jasper Cillessen,NED,GK,Valencia,La Liga,32,1989,16.2,0,0,0,0,0,0,1,0.0,1,0,0,0,1,1,6,0,Matches
534,Pathé Ciss,SEN,MF,Rayo Vallecano,La Liga,27,1994,12.2,31,15,20,8,3,12,26,46.2,14,16,6,10,30,61,27,0,Matches
535,Moustapha Cissé,GUI,FW,Atalanta,Serie A,17,2003,0.4,1,0,0,1,0,0,3,0.0,3,0,0,0,0,1,0,0,Matches
536,Giorgio Cittadini,ITA,DF,Atalanta,Serie A,19,2002,0.0,0,0,0,0,0,0,0,,0,0,0,0,1,1,0,0,Matches
537,Ciaran Clark,IRL,DF,Newcastle Utd,Premier League,31,1989,11.3,13,10,4,7,2,9,14,64.3,5,14,11,3,13,26,43,1,Matches
538,Alexis Claude-Maurice,FRA,MF,Nice,Ligue 1,23,1998,2.3,2,0,1,0,1,1,4,25.0,3,7,0,7,3,5,1,0,Matches
539,Jonathan Clauss,FRA,DF,Lens,Ligue 1,28,1992,33.8,63,34,33,20,10,22,55,40.0,33,43,1,42,73,136,51,0,Matches
540,Carlos Clerc,ESP,DF,Levante,La Liga,29,1992,16.8,35,17,21,10,4,7,19,36.8,12,8,3,5,26,61,32,1,Matches
541,Tom Cleverley,ENG,MF,Watford,Premier League,31,1989,18.0,37,20,19,17,1,18,33,54.5,15,23,6,17,18,55,19,3,Matches
542,Nathaniel Clyne,ENG,DF,Crystal Palace,Premier League,30,1991,15.0,21,10,11,9,1,10,20,50.0,10,7,2,5,15,36,32,0,Matches
543,Conor Coady,ENG,DF,Wolves,Premier League,28,1993,37.3,31,14,23,7,1,16,28,57.1,12,46,40,6,28,59,140,0,Matches
544,Marcus Coco,FRA,"MF,FW",Nantes,Ligue 1,25,1996,10.3,34,14,17,11,6,8,18,44.4,10,11,1,10,10,44,15,0,Matches
545,Coke,ESP,DF,Levante,La Liga,34,1987,1.3,3,2,1,1,1,3,4,75.0,1,1,0,1,2,5,7,0,Matches
546,Séamus Coleman,IRL,DF,Everton,Premier League,32,1988,29.5,61,36,35,16,10,33,51,64.7,18,30,11,19,32,93,80,2,Matches
547,Álex Collado,ESP,"MF,FW",Granada,La Liga,22,1999,11.3,27,12,6,16,5,12,31,38.7,19,28,2,26,6,33,11,0,Matches
548,Ebrima Colley,GAM,"FW,MF",Spezia,Serie A,21,2000,4.4,6,1,3,2,1,1,7,14.3,6,8,0,8,3,9,2,0,Matches
549,Omar Colley,GAM,DF,Sampdoria,Serie A,28,1992,30.5,47,36,32,14,1,22,32,68.8,10,31,19,12,80,127,135,2,Matches
550,Nathan Collins,IRL,DF,Burnley,Premier League,20,2001,18.6,37,15,27,8,2,17,27,63.0,10,38,25,13,24,61,83,2,Matches
551,Kingsley Coman,FRA,"FW,DF",Bayern Munich,Bundesliga,25,1996,15.1,14,8,1,9,4,5,16,31.3,11,14,0,14,8,22,5,0,Matches
552,Eray Cömert,SUI,DF,Valencia,La Liga,23,1998,4.5,5,3,4,1,0,3,6,50.0,3,3,2,1,2,7,6,0,Matches
553,Santi Comesaña,ESP,MF,Rayo Vallecano,La Liga,24,1996,29.8,87,56,45,33,9,40,104,38.5,64,46,6,40,33,120,30,0,Matches
554,Diego Conde,ESP,GK,Getafe,La Liga,22,1998,0.1,0,0,0,0,0,0,0,,0,0,0,0,0,0,0,0,Matches
555,Aaron Connolly,IRL,"FW,MF",Brighton,Premier League,21,2000,1.7,0,0,0,0,0,0,1,0.0,1,2,0,2,0,0,0,0,Matches
556,Andrea Consigli,ITA,GK,Sassuolo,Serie A,34,1987,36.9,0,0,0,0,0,0,2,0.0,2,0,0,0,0,0,23,3,Matches
557,Abdu Conté,POR,DF,Troyes,Ligue 1,23,1998,15.0,22,12,16,5,1,12,24,50.0,12,12,2,10,4,26,10,0,Matches
558,Andrea Conti,ITA,"DF,MF",Sampdoria,Serie A,27,1994,2.6,4,2,2,1,1,3,6,50.0,3,4,0,4,7,11,4,0,Matches
559,Andrea Conti,ITA,DF,Milan,Serie A,27,1994,0.1,0,0,0,0,0,0,0,,0,0,0,0,0,0,0,0,Matches
560,Liam Cooper,SCO,DF,Leeds United,Premier League,29,1991,20.2,41,23,27,13,1,23,33,69.7,10,29,18,11,43,84,72,2,Matches
561,Lucas Copado,GER,FW,Bayern Munich,Bundesliga,17,2004,0.2,1,0,1,0,0,1,1,100.0,0,0,0,0,0,1,0,0,Matches
562,Diego Coppola,ITA,DF,Hellas Verona,Serie A,17,2003,2.8,8,4,4,4,0,3,3,100.0,0,5,1,4,4,12,5,0,Matches
563,Francis Coquelin,FRA,MF,Villarreal,La Liga,30,1991,9.2,26,17,9,11,6,11,20,55.0,9,15,5,10,19,45,11,0,Matches
564,Sébastien Corchia,FRA,DF,Nantes,Ligue 1,30,1990,14.7,33,20,17,11,5,24,42,57.1,18,24,3,21,13,46,36,0,Matches
565,Sergio Córdova,VEN,"FW,MF",Augsburg,Bundesliga,23,1997,3.6,4,3,2,2,0,1,2,50.0,1,4,0,4,0,4,4,0,Matches
566,Jack Cork,ENG,MF,Burnley,Premier League,32,1989,18.6,20,6,6,11,3,7,20,35.0,13,17,4,13,17,37,29,1,Matches
567,Maxwel Cornet,CIV,"FW,MF",Burnley,Premier League,24,1996,19.6,16,9,7,5,4,7,15,46.7,8,13,4,9,10,26,14,0,Matches
568,Maxwel Cornet,CIV,DF,Lyon,Ligue 1,24,1996,0.7,3,1,1,0,2,3,4,75.0,1,0,0,0,1,4,1,0,Matches
569,Jesús Corona,MEX,"FW,DF",Sevilla,La Liga,28,1993,12.9,12,7,7,5,0,3,6,50.0,3,4,0,4,8,20,6,0,Matches
570,Ángel Correa,ARG,"FW,MF",Atlético Madrid,La Liga,26,1995,20.6,16,8,5,10,1,7,29,24.1,22,25,2,23,10,26,4,0,Matches
571,Joaquín Correa,ARG,FW,Inter,Serie A,26,1994,11.4,11,5,2,6,3,1,13,7.7,12,8,1,7,3,14,2,0,Matches
572,Thierry Correia,POR,DF,Valencia,La Liga,22,1999,15.7,35,23,26,6,3,14,29,48.3,15,20,5,15,19,54,27,0,Matches
573,Danny da Costa,GER,"DF,MF",Eint Frankfurt,Bundesliga,28,1993,8.1,15,4,6,7,2,6,18,33.3,12,14,1,13,11,26,18,1,Matches
574,David Pereira da Costa,POR,"MF,FW",Lens,Ligue 1,20,2001,16.3,22,12,9,6,7,11,26,42.3,15,12,0,12,13,35,5,0,Matches
575,Hélder Costa,ANG,MF,Leeds United,Premier League,27,1994,0.2,0,0,0,0,0,0,0,,0,1,0,1,0,0,0,0,Matches
576,Hélder Costa,ANG,"MF,FW",Valencia,La Liga,27,1994,12.4,27,16,11,9,7,14,41,34.1,27,12,1,11,3,30,9,0,Matches
577,Jaume Costa,ESP,DF,Mallorca,La Liga,33,1988,20.3,35,26,23,7,5,23,31,74.2,8,22,7,15,23,58,55,0,Matches
578,Benoît Costil,FRA,GK,Bordeaux,Ligue 1,34,1987,25.0,1,0,1,0,0,1,2,50.0,1,0,0,0,0,1,6,3,Matches
579,Vladimír Coufal,CZE,DF,West Ham,Premier League,28,1992,24.5,45,25,24,14,7,18,36,50.0,18,31,9,22,22,67,64,1,Matches
580,Kalifa Coulibaly,MLI,FW,Nantes,Ligue 1,29,1991,9.4,5,1,1,1,3,0,4,0.0,4,2,2,0,0,5,11,0,Matches
581,Lassana Coulibaly,MLI,MF,Salernitana,Serie A,25,1996,25.9,58,32,29,26,3,24,62,38.7,38,40,13,27,22,80,27,0,Matches
582,Mamadou Coulibaly,SEN,MF,Salernitana,Serie A,22,1999,9.0,15,12,8,5,2,7,20,35.0,13,9,0,9,11,26,9,0,Matches
583,Tanguy Coulibaly,FRA,"FW,MF",Stuttgart,Bundesliga,20,2001,12.0,27,15,14,11,2,9,19,47.4,10,14,2,12,4,31,10,0,Matches
584,Thibaut Courtois,BEL,GK,Real Madrid,La Liga,29,1992,36.0,1,0,1,0,0,1,2,50.0,1,0,0,0,0,1,9,1,Matches
585,Philippe Coutinho,BRA,"MF,FW",Aston Villa,Premier League,29,1992,14.8,17,12,4,11,2,6,21,28.6,15,11,1,10,7,24,4,0,Matches
586,Philippe Coutinho,BRA,"MF,FW",Barcelona,La Liga,29,1992,5.6,6,3,3,3,0,3,11,27.3,8,3,0,3,4,10,3,0,Matches
587,Nicolas Cozza,FRA,DF,Montpellier,Ligue 1,22,1999,30.8,80,47,50,23,7,35,65,53.8,30,35,19,16,38,118,82,1,Matches
588,Alessio Cragno,ITA,GK,Cagliari,Serie A,27,1994,35.0,3,3,2,1,0,3,3,100.0,0,0,0,0,1,4,14,1,Matches
589,Aaron Cresswell,ENG,DF,West Ham,Premier League,31,1989,30.3,28,18,18,6,4,13,25,52.0,12,31,18,13,35,63,66,0,Matches
590,Charlie Cresswell,ENG,DF,Leeds United,Premier League,18,2002,1.6,5,2,1,4,0,3,3,100.0,0,1,1,0,2,7,6,0,Matches
591,Domenico Criscito,ITA,DF,Genoa,Serie A,34,1986,18.0,37,21,19,14,4,16,25,64.0,9,22,12,10,39,76,57,0,Matches
592,Bryan Cristante,ITA,MF,Roma,Serie A,26,1995,29.8,79,39,31,39,9,37,69,53.6,32,31,5,26,40,119,45,0,Matches
593,Cristo,ESP,DF,Real Sociedad,La Liga,21,2000,0.2,0,0,0,0,0,0,0,,0,0,0,0,0,0,0,0,Matches
594,Enzo Crivelli,FRA,"FW,MF",Saint-Étienne,Ligue 1,26,1995,1.1,1,0,0,0,1,0,0,,0,0,0,0,0,1,1,0,Matches
595,Domen Črnigoj,SVN,MF,Venezia,Serie A,25,1995,20.9,21,13,7,11,3,11,29,37.9,18,27,8,19,24,45,42,0,Matches
596,Giovanni Crociata,ITA,FW,Empoli,Serie A,23,1997,0.2,0,0,0,0,0,0,1,0.0,1,0,0,0,0,0,0,0,Matches
597,Juan Cruz Armada,ESP,DF,Osasuna,La Liga,29,1992,21.5,28,21,15,12,1,8,16,50.0,8,15,12,3,16,44,58,1,Matches
598,Juan Cuadrado,COL,"DF,MF",Juventus,Serie A,33,1988,27.6,48,23,30,13,5,30,55,54.5,25,23,5,18,29,77,34,0,Matches
599,Cucho,COL,"FW,MF",Watford,Premier League,22,1999,12.7,13,5,5,5,3,5,27,18.5,22,13,1,12,5,18,9,0,Matches
600,Marc Cucurella,ESP,DF,Brighton,Premier League,23,1998,34.3,93,62,43,32,18,44,71,62.0,27,42,14,28,30,123,74,0,Matches
601,Marc Cucurella,ESP,"MF,DF",Getafe,La Liga,23,1998,0.3,0,0,0,0,0,0,0,,0,0,0,0,0,0,0,0,Matches
602,Jorge Cuenca,ESP,DF,Getafe,La Liga,21,1999,29.8,46,32,30,15,1,21,28,75.0,7,29,14,15,39,85,155,0,Matches
603,Mickaël Cuisance,FRA,MF,Venezia,Serie A,21,1999,10.2,23,9,7,12,4,10,28,35.7,18,14,0,14,12,35,5,0,Matches
604,Mickaël Cuisance,FRA,MF,Bayern Munich,Bundesliga,21,1999,0.1,1,1,0,1,0,0,0,,0,0,0,0,0,1,0,0,Matches
605,Luke Cundle,ENG,MF,Wolves,Premier League,19,2002,2.0,4,3,0,4,0,1,1,100.0,0,0,0,0,1,5,1,0,Matches
606,Matheus Cunha,BRA,FW,Atlético Madrid,La Liga,22,1999,11.8,19,12,3,11,5,5,20,25.0,15,18,2,16,6,25,9,0,Matches
607,Matheus Cunha,BRA,FW,Hertha BSC,Bundesliga,22,1999,0.7,0,0,0,0,0,0,0,,0,0,0,0,0,0,0,0,Matches
608,Patrick Cutrone,ITA,FW,Empoli,Serie A,23,1998,15.6,5,2,0,3,2,1,9,11.1,8,11,1,10,5,10,1,0,Matches
609,Wylan Cyprien,FRA,MF,Nantes,Ligue 1,26,1995,16.6,33,17,12,18,3,13,32,40.6,19,16,6,10,10,43,14,2,Matches
610,Rafael Czichos,GER,DF,Köln,Bundesliga,31,1990,15.6,29,18,18,9,2,14,28,50.0,14,23,13,10,19,48,53,2,Matches
611,Lennart-Marten Czyborra,GER,DF,Arminia,Bundesliga,22,1999,1.5,0,0,0,0,0,0,2,0.0,2,0,0,0,3,3,3,1,Matches
612,Danilo D'Ambrosio,ITA,DF,Inter,Serie A,32,1988,11.1,30,15,21,8,1,11,22,50.0,11,21,10,11,8,38,20,0,Matches
613,Lucas Da Cunha,FRA,MF,Nice,Ligue 1,20,2001,4.4,13,7,2,7,4,6,11,54.5,5,2,0,2,1,14,2,0,Matches
614,Lucas Da Cunha,FRA,"FW,MF",Clermont Foot,Ligue 1,20,2001,9.3,17,11,5,8,4,9,18,50.0,9,13,0,13,1,18,3,0,Matches
615,Damien Da Silva,FRA,DF,Lyon,Ligue 1,33,1988,12.5,13,9,7,5,1,5,9,55.6,4,15,10,5,22,35,53,1,Matches
616,Moanes Dabbur,ISR,"FW,MF",Hoffenheim,Bundesliga,29,1992,14.6,18,10,3,5,10,4,17,23.5,13,10,0,10,5,23,4,0,Matches
617,Colin Dagba,FRA,DF,Paris S-G,Ligue 1,22,1998,1.8,4,2,2,2,0,3,6,50.0,3,4,2,2,2,6,1,0,Matches
618,Finn Dahmen,GER,GK,Mainz 05,Bundesliga,23,1998,2.0,0,0,0,0,0,0,0,,0,0,0,0,0,0,2,0,Matches
619,Mahmoud Dahoud,GER,MF,Dortmund,Bundesliga,25,1996,18.4,42,19,10,24,8,20,46,43.5,26,18,3,15,17,59,16,0,Matches
620,Patson Daka,ZAM,FW,Leicester City,Premier League,22,1998,12.9,15,10,2,8,5,2,19,10.5,17,7,0,7,2,17,8,0,Matches
621,Stuart Dallas,NIR,"DF,MF",Leeds United,Premier League,30,1991,32.4,93,55,58,31,4,56,105,53.3,49,45,14,31,57,150,63,2,Matches
622,Diogo Dalot,POR,DF,Manchester Utd,Premier League,22,1999,20.0,55,41,35,12,8,31,57,54.4,26,24,13,11,29,84,59,0,Matches
623,Mikkel Damsgaard,DEN,"MF,FW",Sampdoria,Serie A,21,2000,6.4,27,13,12,11,4,20,36,55.6,16,16,1,15,7,34,7,0,Matches
624,Flavius Daniliuc,AUT,DF,Nice,Ligue 1,20,2001,14.4,46,31,26,17,3,34,43,79.1,9,13,7,6,14,60,34,1,Matches
625,Danilo,BRA,"DF,MF",Juventus,Serie A,30,1991,21.0,37,26,20,13,4,18,28,64.3,10,21,12,9,32,69,53,1,Matches
626,Arnaut Danjuma,NED,FW,Villarreal,La Liga,24,1997,16.4,7,6,3,0,4,2,4,50.0,2,5,0,5,2,9,3,0,Matches
627,Kevin Danso,AUT,DF,Lens,Ligue 1,22,1998,31.0,41,29,29,12,0,23,34,67.6,11,38,25,13,40,81,111,0,Matches
628,Dante,BRA,DF,Nice,Ligue 1,37,1983,31.9,42,29,30,12,0,23,33,69.7,10,43,27,16,49,91,96,1,Matches
629,Ebrima Darboe,GAM,MF,Roma,Serie A,20,2001,0.7,1,1,0,1,0,0,0,,0,0,0,0,1,2,0,1,Matches
630,Márton Dárdai,HUN,DF,Hertha BSC,Bundesliga,19,2002,8.4,10,4,8,2,0,8,18,44.4,10,16,6,10,20,30,33,2,Matches
631,Sergi Darder,ESP,MF,Espanyol,La Liga,27,1993,34.7,45,22,16,19,10,18,54,33.3,36,16,1,15,26,71,32,1,Matches
632,Vladimír Darida,CZE,MF,Hertha BSC,Bundesliga,30,1990,19.8,32,18,15,13,4,13,32,40.6,19,22,3,19,20,52,17,2,Matches
633,Karl Darlow,ENG,GK,Newcastle Utd,Premier League,30,1990,8.0,0,0,0,0,0,0,0,,0,0,0,0,0,0,5,1,Matches
634,Matteo Darmian,ITA,DF,Inter,Serie A,31,1989,16.7,32,16,17,9,6,16,41,39.0,25,16,1,15,19,51,25,0,Matches
635,Josh Dasilva,ENG,"MF,FW",Brentford,Premier League,22,1998,2.9,2,1,0,1,1,1,2,50.0,1,3,0,3,1,3,7,0,Matches
636,Jonathan David,CAN,FW,Lille,Ligue 1,21,2000,31.2,24,9,7,11,6,9,30,30.0,21,14,4,10,5,29,15,0,Matches
637,Alphonso Davies,CAN,DF,Bayern Munich,Bundesliga,20,2000,19.3,34,17,17,8,9,13,31,41.9,18,27,1,26,23,57,26,1,Matches
638,Ben Davies,WAL,DF,Tottenham,Premier League,28,1993,28.2,36,21,20,12,4,13,26,50.0,13,32,19,13,30,66,75,1,Matches
639,Tom Davies,ENG,MF,Everton,Premier League,23,1998,2.6,3,1,1,1,1,2,5,40.0,3,2,1,1,2,5,9,0,Matches
640,Keinan Davis,ENG,FW,Aston Villa,Premier League,23,1998,0.1,0,0,0,0,0,0,0,,0,0,0,0,0,0,0,0,Matches
641,Paweł Dawidowicz,POL,DF,Hellas Verona,Serie A,26,1995,13.3,30,18,16,10,4,16,25,64.0,9,14,11,3,21,51,53,0,Matches
642,Craig Dawson,ENG,DF,West Ham,Premier League,31,1990,30.6,29,17,20,8,1,14,25,56.0,11,59,52,7,29,58,139,0,Matches
643,Kevin De Bruyne,BEL,MF,Manchester City,Premier League,30,1991,24.5,32,16,4,15,13,12,37,32.4,25,32,2,30,6,38,16,0,Matches
644,Konrad De La Fuente,USA,"FW,MF",Marseille,Ligue 1,20,2001,8.7,11,7,8,2,1,7,11,63.6,4,5,0,5,2,13,4,0,Matches
645,Sebastien De Maio,FRA,DF,Udinese,Serie A,34,1987,2.0,5,1,4,1,0,1,9,11.1,8,6,5,1,1,6,9,0,Matches
646,Tommaso De Nipoti,ITA,FW,Atalanta,Serie A,18,2003,0.1,0,0,0,0,0,0,0,,0,0,0,0,0,0,0,0,Matches
647,Rodrigo De Paul,ARG,MF,Atlético Madrid,La Liga,27,1994,23.9,55,30,22,25,8,30,60,50.0,30,24,3,21,21,76,17,2,Matches
648,Mattia De Sciglio,ITA,DF,Juventus,Serie A,28,1992,13.0,24,12,7,9,8,11,24,45.8,13,10,0,10,10,34,30,0,Matches
649,Lorenzo De Silvestri,ITA,DF,Bologna,Serie A,33,1988,25.5,23,14,13,8,2,9,31,29.0,22,25,7,18,26,49,52,0,Matches
650,Saulo Decarli,SUI,DF,Bochum,Bundesliga,29,1992,0.1,0,0,0,0,0,0,0,,0,0,0,0,0,0,0,0,Matches
651,Troy Deeney,ENG,FW,Watford,Premier League,33,1988,0.3,0,0,0,0,0,0,1,0.0,1,0,0,0,0,0,2,0,Matches
652,Grégoire Defrel,MTQ,FW,Sassuolo,Serie A,30,1991,15.1,15,9,4,8,3,6,16,37.5,10,11,1,10,4,19,11,0,Matches
653,Alessandro Deiola,ITA,MF,Cagliari,Serie A,25,1995,23.7,47,22,15,25,7,23,58,39.7,35,28,10,18,26,73,45,0,Matches
654,Romain Del Castillo,FRA,"MF,FW",Rennes,Ligue 1,25,1996,0.3,2,1,0,1,1,2,2,100.0,0,0,0,0,1,3,0,0,Matches
655,Romain Del Castillo,FRA,"MF,FW",Brest,Ligue 1,25,1996,10.8,27,16,3,17,7,12,31,38.7,19,12,0,12,7,34,3,0,Matches
656,Thomas Delaine,FRA,DF,Metz,Ligue 1,29,1992,25.7,48,35,34,12,2,22,42,52.4,20,20,7,13,27,75,31,0,Matches
657,Thomas Delaney,DEN,MF,Sevilla,La Liga,29,1991,17.2,41,24,17,21,3,16,30,53.3,14,19,10,9,13,54,35,0,Matches
658,Thomas Delaney,DEN,MF,Dortmund,Bundesliga,29,1991,0.2,0,0,0,0,0,0,0,,0,0,0,0,0,0,0,0,Matches
659,Liam Delap,ENG,FW,Manchester City,Premier League,18,2003,0.1,0,0,0,0,0,0,0,,0,0,0,0,0,0,0,0,Matches
660,Sacha Delaye,FRA,"MF,FW",Montpellier,Ligue 1,19,2002,2.9,8,6,3,2,3,2,8,25.0,6,1,0,1,1,9,1,1,Matches
661,Filippo Delli Carri,ITA,DF,Salernitana,Serie A,22,1999,3.7,6,4,4,2,0,5,14,35.7,9,6,2,4,4,10,14,0,Matches
662,Andy Delort,ALG,FW,Nice,Ligue 1,29,1991,27.2,15,9,3,5,7,7,12,58.3,5,13,4,9,9,24,14,0,Matches
663,Andy Delort,ALG,FW,Montpellier,Ligue 1,29,1991,3.0,2,0,0,1,1,0,1,0.0,1,1,0,1,0,2,4,0,Matches
664,Fabian Delph,ENG,MF,Everton,Premier League,31,1989,7.4,18,15,10,7,1,8,21,38.1,13,12,5,7,14,32,10,0,Matches
665,Moussa Dembélé,FRA,FW,Lyon,Ligue 1,25,1996,24.5,18,9,5,5,8,6,15,40.0,9,13,0,13,8,26,30,1,Matches
666,Ousmane Dembélé,FRA,FW,Barcelona,La Liga,24,1997,15.7,24,16,6,10,8,7,23,30.4,16,8,0,8,8,32,3,0,Matches
667,Yusuf Demir,AUT,FW,Barcelona,La Liga,18,2003,2.1,3,1,1,1,1,2,5,40.0,3,1,0,1,2,5,1,0,Matches
668,Merih Demiral,TUR,DF,Atalanta,Serie A,23,1998,21.3,31,17,18,12,1,15,28,53.6,13,26,14,12,58,89,68,1,Matches
669,Kerem Demirbay,GER,MF,Leverkusen,Bundesliga,28,1993,22.8,52,31,19,30,3,16,41,39.0,25,32,9,23,33,85,21,0,Matches
670,Ermedin Demirović,BIH,FW,Freiburg,Bundesliga,23,1998,9.7,12,6,4,4,4,1,10,10.0,9,14,1,13,1,13,7,0,Matches
671,Diego Demme,GER,MF,Napoli,Serie A,29,1991,7.7,21,12,4,13,4,10,21,47.6,11,11,2,9,9,30,2,0,Matches
672,Jason Denayer,BEL,DF,Lyon,Ligue 1,26,1995,11.1,11,4,8,3,0,6,7,85.7,1,8,7,1,16,27,52,0,Matches
673,Leander Dendoncker,BEL,MF,Wolves,Premier League,26,1995,21.7,42,17,25,14,3,22,50,44.0,28,37,10,27,9,51,38,1,Matches
674,Emmanuel Dennis,NGA,"FW,MF",Watford,Premier League,23,1997,28.7,51,35,20,22,9,17,52,32.7,35,36,2,34,15,66,13,0,Matches
675,Fabio Depaoli,ITA,DF,Hellas Verona,Serie A,24,1997,7.8,12,7,6,4,2,1,7,14.3,6,9,2,7,8,20,14,0,Matches
676,Fabio Depaoli,ITA,"MF,DF",Sampdoria,Serie A,24,1997,1.2,3,1,1,2,0,0,2,0.0,2,2,1,1,1,4,2,0,Matches
677,Mike van der Hoorn,NED,DF,Arminia,Bundesliga,28,1992,0.2,1,0,1,0,0,0,0,,0,0,0,0,1,2,2,0,Matches
678,Arthur Desmas,FRA,GK,Clermont Foot,Ligue 1,27,1994,14.5,0,0,0,0,0,0,3,0.0,3,0,0,0,0,0,1,3,Matches
679,Sergiño Dest,USA,"DF,FW",Barcelona,La Liga,20,2000,16.8,32,15,21,10,1,13,18,72.2,5,22,4,18,2,34,18,0,Matches
680,Mattia Destro,ITA,FW,Genoa,Serie A,30,1991,19.4,9,4,1,4,4,1,6,16.7,5,14,1,13,2,11,16,0,Matches
681,Gerard Deulofeu,ESP,"FW,MF",Udinese,Serie A,27,1994,29.1,11,6,2,3,6,7,29,24.1,22,14,0,14,9,20,4,0,Matches
682,Kiernan Dewsbury-Hall,ENG,MF,Leicester City,Premier League,22,1998,23.4,39,24,20,14,5,19,40,47.5,21,37,8,29,21,60,26,1,Matches
683,Jacopo Dezi,ITA,MF,Venezia,Serie A,29,1992,0.2,0,0,0,0,0,0,1,0.0,1,0,0,0,1,1,0,0,Matches
684,Samuel Di Carmine,ITA,FW,Hellas Verona,Serie A,32,1988,0.4,0,0,0,0,0,0,0,,0,0,0,0,0,0,0,0,Matches
685,Federico Di Francesco,ITA,"FW,MF",Empoli,Serie A,27,1994,15.2,16,5,2,8,6,9,23,39.1,14,17,1,16,9,25,11,0,Matches
686,Giovanni Di Lorenzo,ITA,DF,Napoli,Serie A,27,1993,31.9,58,36,30,20,8,33,58,56.9,25,28,10,18,38,96,46,1,Matches
687,Ángel Di María,ARG,FW,Paris S-G,Ligue 1,33,1988,18.3,29,18,6,13,10,14,37,37.8,23,17,0,17,6,35,3,0,Matches
688,Francesco Di Mariano,ITA,FW,Venezia,Serie A,25,1996,0.7,1,1,0,1,0,0,0,,0,2,1,1,0,1,0,0,Matches
689,Francesco Di Tacchio,ITA,MF,Salernitana,Serie A,31,1990,13.9,17,7,5,10,2,9,25,36.0,16,16,8,8,22,39,25,0,Matches
690,Boulaye Dia,SEN,FW,Villarreal,La Liga,24,1996,14.1,8,6,3,4,1,2,5,40.0,3,6,1,5,5,13,4,0,Matches
691,Moussa Diaby,FRA,"FW,MF",Leverkusen,Bundesliga,22,1999,30.7,20,11,8,9,3,5,38,13.2,33,11,0,11,8,28,2,0,Matches
692,Yadaly Diaby,GUI,"FW,MF",Clermont Foot,Ligue 1,20,2000,0.7,0,0,0,0,0,0,1,0.0,1,0,0,0,2,2,2,0,Matches
693,Mouctar Diakhaby,GUI,DF,Valencia,La Liga,24,1996,21.6,35,24,18,15,2,13,23,56.5,10,29,17,12,30,65,87,3,Matches
694,Ibrahim Diakité,GUI,MF,Reims,Ligue 1,17,2003,0.0,0,0,0,0,0,0,1,0.0,1,0,0,0,0,0,0,0,Matches
695,Abdou Diallo,SEN,DF,Paris S-G,Ligue 1,25,1996,9.7,22,14,10,9,3,8,14,57.1,6,6,2,4,10,32,19,1,Matches
696,Habib Diallo,SEN,FW,Strasbourg,Ligue 1,26,1995,17.1,9,5,0,8,1,0,8,0.0,8,13,4,9,4,13,11,0,Matches
697,Ibrahima Diallo,FRA,MF,Southampton,Premier League,22,1999,11.4,22,11,10,9,3,10,24,41.7,14,7,0,7,9,31,10,0,Matches
698,Habib Diarra,SEN,MF,Strasbourg,Ligue 1,17,2004,1.2,2,1,1,1,0,1,1,100.0,0,0,0,0,0,2,0,0,Matches
699,Stéphane Diarra,FRA,"MF,FW",Lorient,Ligue 1,22,1998,5.8,11,9,7,3,1,5,10,50.0,5,4,0,4,7,18,1,0,Matches
700,Rúben Dias,POR,DF,Manchester City,Premier League,24,1997,26.7,26,19,11,12,3,8,15,53.3,7,19,13,6,23,49,66,0,Matches
701,Krépin Diatta,SEN,"MF,DF",Monaco,Ligue 1,22,1999,3.2,3,2,1,0,2,1,3,33.3,2,2,0,2,1,4,0,0,Matches
702,Amadou Diawara,GUI,MF,Roma,Serie A,24,1997,1.9,7,2,5,2,0,1,3,33.3,2,2,0,2,0,7,1,0,Matches
703,Brahim Díaz,MAR,MF,Milan,Serie A,21,1999,20.6,23,17,3,11,9,8,22,36.4,14,11,0,11,8,31,4,0,Matches
704,Javier Díaz,ESP,GK,Sevilla,La Liga,24,1997,1.0,0,0,0,0,0,0,0,,0,0,0,0,0,0,0,0,Matches
705,Luis Díaz,COL,FW,Liverpool,Premier League,24,1997,10.6,9,7,3,5,1,2,8,25.0,6,7,0,7,4,13,2,0,Matches
706,Víctor Díaz,ESP,DF,Granada,La Liga,33,1988,16.7,23,15,14,9,0,12,25,48.0,13,19,11,8,17,40,71,1,Matches
707,Daniel Didavi,GER,"MF,FW",Stuttgart,Bundesliga,31,1990,3.1,6,2,0,4,2,4,7,57.1,3,4,1,3,1,7,1,0,Matches
708,Bamba Dieng,SEN,FW,Marseille,Ligue 1,21,2000,10.8,17,11,5,5,7,4,14,28.6,10,7,0,7,5,22,8,0,Matches
709,Eric Dier,ENG,DF,Tottenham,Premier League,27,1994,34.1,15,9,6,8,1,7,14,50.0,7,37,32,5,27,42,142,1,Matches
710,Elhadji Dieye,SEN,"FW,MF",Saint-Étienne,Ligue 1,19,2002,0.4,3,2,2,1,0,0,1,0.0,1,2,0,2,1,4,0,0,Matches
711,Lucas Digne,FRA,DF,Aston Villa,Premier League,28,1993,14.1,13,10,8,3,2,9,19,47.4,10,15,8,7,23,36,40,0,Matches
712,Lucas Digne,FRA,DF,Everton,Premier League,28,1993,13.0,33,19,26,4,3,21,28,75.0,7,16,5,11,14,47,30,0,Matches
713,Mitchell Dijks,NED,"DF,FW",Bologna,Serie A,28,1993,7.7,15,6,6,6,3,5,12,41.7,7,11,2,9,3,18,10,1,Matches
714,Javairô Dilrosun,NED,"MF,FW",Bordeaux,Ligue 1,23,1998,19.2,13,4,2,8,3,7,24,29.2,17,14,1,13,11,24,5,0,Matches
715,Javairô Dilrosun,NED,FW,Hertha BSC,Bundesliga,23,1998,1.5,3,1,1,2,0,1,1,100.0,0,1,0,1,0,3,0,0,Matches
716,Federico Dimarco,ITA,DF,Inter,Serie A,23,1997,15.9,28,15,10,15,3,13,24,54.2,11,6,1,5,19,47,19,0,Matches
717,Landry Dimata,BEL,"FW,MF",Espanyol,La Liga,23,1997,6.0,2,2,1,1,0,1,4,25.0,3,0,0,0,1,3,7,0,Matches
718,Stole Dimitrievski,MKD,GK,Rayo Vallecano,La Liga,27,1993,30.8,0,0,0,0,0,0,0,,0,0,0,0,1,1,14,3,Matches
719,Junior Dina Ebimbe,FRA,MF,Paris S-G,Ligue 1,20,2000,3.5,9,4,3,4,2,2,3,66.7,1,5,3,2,2,11,1,0,Matches
720,Tristan Dingomé,CMR,"MF,FW",Troyes,Ligue 1,30,1991,12.0,23,11,10,12,1,10,18,55.6,8,7,1,6,9,32,3,0,Matches
721,Sinaly Diomande,CIV,DF,Lyon,Ligue 1,20,2001,6.4,6,3,4,2,0,5,6,83.3,1,6,6,0,12,18,26,0,Matches
722,Issa Diop,FRA,DF,West Ham,Premier League,24,1997,10.7,10,8,5,5,0,4,11,36.4,7,14,13,1,7,17,44,0,Matches
723,Sofiane Diop,FRA,"MF,FW",Monaco,Ligue 1,21,2000,21.6,38,20,12,19,7,15,47,31.9,32,10,0,10,23,61,4,0,Matches
724,Andy Diouf,FRA,MF,Rennes,Ligue 1,18,2003,0.2,1,1,1,0,0,1,1,100.0,0,1,0,1,0,1,0,0,Matches
725,Assane Dioussé,SEN,MF,Saint-Étienne,Ligue 1,23,1997,0.3,1,1,1,0,0,1,1,100.0,0,0,0,0,0,1,0,0,Matches
726,Axel Disasi,FRA,DF,Monaco,Ligue 1,23,1998,30.2,42,27,20,21,1,23,39,59.0,16,40,30,10,26,68,75,0,Matches
727,Filippo Distefano,ITA,FW,Fiorentina,Serie A,17,2003,0.0,0,0,0,0,0,0,0,,0,0,0,0,0,0,0,0,Matches
728,Matías Dituro,ARG,GK,Celta Vigo,La Liga,34,1987,38.0,0,0,0,0,0,0,0,,0,0,0,0,0,0,10,5,Matches
729,Tiago Djaló,POR,DF,Lille,Ligue 1,21,2000,25.9,60,39,39,19,2,26,39,66.7,13,26,10,16,24,84,71,0,Matches
730,Djené,TOG,DF,Getafe,La Liga,29,1991,34.6,44,26,24,16,4,23,34,67.6,11,24,5,19,59,103,109,2,Matches
731,Moussa Djenepo,MLI,MF,Southampton,Premier League,23,1998,5.1,9,3,3,5,1,3,11,27.3,8,6,1,5,2,11,6,1,Matches
732,Koffi Djidji,CIV,DF,Torino,Serie A,28,1992,19.3,48,29,21,23,4,14,18,77.8,4,20,9,11,34,82,60,0,Matches
733,Alexander Djiku,GHA,DF,Strasbourg,Ligue 1,26,1994,29.9,50,37,33,13,4,18,35,51.4,17,30,13,17,61,111,90,2,Matches
734,Bryan Djile Nokoué,CMR,"DF,MF",Saint-Étienne,Ligue 1,19,2002,0.6,3,3,1,2,0,2,2,100.0,0,1,0,1,1,4,2,0,Matches
735,Berat Djimsiti,ALB,DF,Atalanta,Serie A,28,1993,25.1,43,24,21,20,2,29,46,63.0,17,21,11,10,31,74,56,0,Matches
736,Ouparine Djoco,GNB,GK,Clermont Foot,Ligue 1,23,1998,23.5,0,0,0,0,0,0,0,,0,0,0,0,1,1,14,2,Matches
737,Naïs Djouahra,FRA,"FW,MF",Real Sociedad,La Liga,21,1999,2.4,7,3,2,2,3,4,8,50.0,4,3,0,3,2,9,2,0,Matches
738,Marko Dmitrović,SRB,GK,Sevilla,La Liga,29,1992,6.0,0,0,0,0,0,0,0,,0,0,0,0,0,0,3,1,Matches
739,Lewis Dobbin,ENG,"FW,MF",Everton,Premier League,18,2003,0.4,2,1,0,1,1,1,2,50.0,1,0,0,0,0,2,0,0,Matches
740,Matt Doherty,IRL,DF,Tottenham,Premier League,29,1992,9.7,18,12,5,11,2,8,14,57.1,6,11,2,9,13,31,20,0,Matches
741,Jeremy Doku,BEL,"FW,MF",Rennes,Ligue 1,19,2002,5.2,10,5,3,5,2,3,6,50.0,3,4,0,4,3,13,0,0,Matches
742,Kasper Dolberg,DEN,FW,Nice,Ligue 1,23,1997,16.6,9,4,4,3,2,3,9,33.3,6,15,1,14,6,15,17,0,Matches
743,Jaume Doménech,ESP,GK,Valencia,La Liga,30,1990,3.8,0,0,0,0,0,0,0,,0,0,0,0,0,0,3,1,Matches
744,Brandon Domingues,FRA,"MF,FW",Troyes,Ligue 1,21,2000,2.6,6,2,2,4,0,2,3,66.7,1,3,0,3,3,9,0,0,Matches
745,Carlos Dominguez,ESP,DF,Celta Vigo,La Liga,20,2001,3.8,4,1,4,0,0,4,6,66.7,2,2,1,1,4,8,21,0,Matches
746,Mario Dominguez,ESP,FW,Valencia,La Liga,17,2004,0.3,0,0,0,0,0,0,0,,0,0,0,0,0,0,1,0,Matches
747,Nicolás Domínguez,ARG,MF,Bologna,Serie A,23,1998,22.4,76,45,36,32,8,32,76,42.1,44,38,9,29,32,108,34,1,Matches
748,John Donald,ESP,DF,Elche,La Liga,20,2000,2.0,7,4,4,2,1,5,8,62.5,3,5,3,2,3,10,3,0,Matches
749,Lee Dongjun,KOR,"MF,FW",Hertha BSC,Bundesliga,24,1997,1.3,2,1,0,2,0,1,3,33.3,2,2,0,2,2,4,1,0,Matches
750,Anastasios Donis,GRE,"FW,MF",Reims,Ligue 1,24,1996,4.1,8,7,4,2,2,2,6,33.3,4,3,0,3,0,8,1,0,Matches
751,Gianluigi Donnarumma,ITA,GK,Paris S-G,Ligue 1,22,1999,17.0,0,0,0,0,0,0,0,,0,0,0,0,0,0,9,2,Matches
752,Niklas Dorsch,GER,MF,Augsburg,Bundesliga,23,1998,25.8,76,47,47,23,6,30,60,50.0,30,34,12,22,35,111,36,3,Matches
753,Jodel Dossou,BEN,FW,Clermont Foot,Ligue 1,29,1992,22.3,36,17,15,14,7,15,43,34.9,28,14,0,14,5,41,7,0,Matches
754,Lohann Doucet,FRA,"MF,DF",Nantes,Ligue 1,18,2002,0.1,0,0,0,0,0,0,0,,0,0,0,0,1,1,0,0,Matches
755,Abdoulaye Doucouré,MLI,MF,Everton,Premier League,28,1993,28.2,75,43,30,37,8,32,71,45.1,39,33,8,25,28,103,32,0,Matches
756,Cheick Doucouré,MLI,MF,Lens,Ligue 1,21,2000,32.7,75,43,34,34,7,35,79,44.3,44,30,7,23,68,143,24,0,Matches
757,Fodé Doucouré,MLI,"DF,FW",Reims,Ligue 1,20,2001,1.7,12,9,9,3,0,9,11,81.8,2,1,0,1,4,16,6,0,Matches
758,Ismaël Doukouré,FRA,DF,Strasbourg,Ligue 1,18,2003,0.2,0,0,0,0,0,0,0,,0,0,0,0,0,0,1,0,Matches
759,Kamory Doumbia,MLI,"MF,FW",Reims,Ligue 1,18,2003,3.9,8,2,2,5,1,5,13,38.5,8,9,3,6,3,11,3,0,Matches
760,Moussa Doumbia,MLI,FW,Reims,Ligue 1,26,1994,1.0,0,0,0,0,0,0,1,0.0,1,0,0,0,0,0,0,0,Matches
761,Souleyman Doumbia,CIV,"DF,FW",Angers,Ligue 1,24,1996,24.7,30,20,16,9,5,13,27,48.1,14,25,4,21,39,69,51,0,Matches
762,Kieran Dowell,ENG,"FW,MF",Norwich City,Premier League,23,1997,10.1,18,7,8,7,3,9,32,28.1,23,10,1,9,7,25,4,0,Matches
763,Bartłomiej Drągowski,POL,GK,Fiorentina,Serie A,23,1997,6.2,0,0,0,0,0,0,0,,0,0,0,0,1,1,5,2,Matches
764,Radu Drăgușin,ROU,DF,Sampdoria,Serie A,19,2002,6.9,4,3,2,2,0,2,6,33.3,4,8,4,4,10,14,33,0,Matches
765,Radu Drăgușin,ROU,DF,Salernitana,Serie A,19,2002,5.4,5,4,2,3,0,4,10,40.0,6,7,3,4,13,18,17,0,Matches
766,Cody Drameh,ENG,"DF,MF",Leeds United,Premier League,19,2001,1.4,4,2,3,1,0,1,3,33.3,2,0,0,0,1,5,4,0,Matches
767,Julian Draxler,GER,"FW,MF",Paris S-G,Ligue 1,27,1993,6.1,3,2,0,3,0,0,4,0.0,4,3,0,3,5,8,3,0,Matches
768,Matthieu Dreyer,FRA,GK,Lorient,Ligue 1,32,1989,16.0,1,1,1,0,0,1,1,100.0,0,0,0,0,0,1,9,0,Matches
769,Domingos Duarte,POR,DF,Granada,La Liga,26,1995,18.7,18,14,9,9,0,6,11,54.5,5,27,20,7,22,40,82,0,Matches
770,Óscar Duarte,CRC,DF,Levante,La Liga,32,1989,19.7,18,8,12,6,0,8,23,34.8,15,18,9,9,24,42,102,0,Matches
771,Rubén Duarte,ESP,DF,Alavés,La Liga,25,1995,29.1,76,47,43,27,6,43,85,50.6,42,40,6,34,57,133,82,0,Matches
772,Leo Dubois,FRA,DF,Lyon,Ligue 1,26,1994,19.4,43,27,22,14,7,27,46,58.7,19,27,3,24,22,65,35,1,Matches
773,Martin Dúbravka,SVK,GK,Newcastle Utd,Premier League,32,1989,26.0,1,1,1,0,0,0,1,0.0,1,0,0,0,0,1,8,2,Matches
774,Ondrej Duda,SVK,"MF,FW",Köln,Bundesliga,26,1994,17.9,23,16,4,12,7,6,23,26.1,17,14,2,12,17,40,9,0,Matches
775,Jeremy Dudziak,TUN,"MF,FW",Greuther Fürth,Bundesliga,25,1995,12.6,17,6,5,8,4,3,14,21.4,11,8,0,8,10,27,4,0,Matches
776,Shane Duffy,IRL,DF,Brighton,Premier League,29,1992,16.0,15,12,12,3,0,8,14,57.1,6,24,18,6,16,31,76,1,Matches
777,Unai Dufur,ESP,DF,Osasuna,La Liga,22,1999,1.0,0,0,0,0,0,0,0,,0,1,0,1,4,4,4,0,Matches
778,Denzel Dumfries,NED,DF,Inter,Serie A,25,1996,22.5,32,12,9,14,9,16,32,50.0,16,15,6,9,9,41,26,0,Matches
779,Paul Dummett,WAL,DF,Newcastle Utd,Premier League,29,1991,2.2,7,3,3,4,0,5,8,62.5,3,5,0,5,3,10,5,0,Matches
780,Alfred Duncan,GHA,MF,Fiorentina,Serie A,28,1993,21.5,34,19,13,16,5,11,32,34.4,21,32,3,29,10,44,7,0,Matches
781,Lewis Dunk,ENG,DF,Brighton,Premier League,29,1991,28.6,10,8,5,5,0,5,11,45.5,6,32,28,4,27,37,113,3,Matches
782,Erik Durm,GER,DF,Eint Frankfurt,Bundesliga,29,1992,5.3,13,7,6,5,2,10,13,76.9,3,8,1,7,10,23,7,0,Matches
783,Hugo Duro,ESP,"DF,MF",Getafe,La Liga,21,1999,0.1,0,0,0,0,0,0,0,,0,0,0,0,0,0,0,0,Matches
784,Hugo Duro,ESP,"FW,MF",Valencia,La Liga,21,1999,20.4,25,19,11,13,1,15,38,39.5,23,24,2,22,4,29,20,1,Matches
785,Jean-Kevin Duverne,HAI,DF,Brest,Ligue 1,24,1997,33.4,71,44,43,21,7,42,90,46.7,48,40,5,35,53,124,92,0,Matches
786,Paulo Dybala,ARG,"FW,MF",Juventus,Serie A,27,1993,22.9,30,13,7,14,9,8,35,22.9,27,19,0,19,9,39,4,3,Matches
787,Edin Džeko,BIH,FW,Inter,Serie A,35,1986,27.4,14,8,7,4,3,8,25,32.0,17,22,5,17,4,18,35,0,Matches
788,Enzo Ebosse,CMR,DF,Angers,Ligue 1,22,1999,21.0,25,14,19,6,0,11,19,57.9,8,19,9,10,15,40,42,0,Matches
789,Tyronne Ebuehi,NGA,DF,Venezia,Serie A,25,1995,12.6,28,12,16,8,4,10,18,55.6,8,13,3,10,16,44,38,1,Matches
790,Ederson,BRA,GK,Manchester City,Premier League,27,1993,37.0,2,1,2,0,0,0,2,0.0,2,0,0,0,0,2,12,0,Matches
791,Éderson,BRA,MF,Salernitana,Serie A,22,1999,12.7,29,18,11,14,4,14,26,53.8,12,11,2,9,19,48,8,0,Matches
792,Odsonne Édouard,FRA,FW,Crystal Palace,Premier League,23,1998,17.4,16,10,2,7,7,7,21,33.3,14,20,5,15,0,16,18,0,Matches
793,CJ Egan-Riley,ENG,DF,Manchester City,Premier League,18,2003,0.0,1,1,1,0,0,1,1,100.0,0,0,0,0,0,1,0,0,Matches
794,Maximilian Eggestein,GER,MF,Freiburg,Bundesliga,24,1996,24.4,48,28,17,25,6,22,50,44.0,28,35,11,24,30,78,32,1,Matches
795,Lilian Egloff,GER,"MF,DF",Stuttgart,Bundesliga,18,2002,0.3,1,0,0,1,0,0,0,,0,1,0,1,0,1,0,0,Matches
796,Kingsley Ehizibue,NED,DF,Köln,Bundesliga,26,1995,7.6,32,18,27,5,0,15,24,62.5,9,13,4,9,9,41,26,0,Matches
797,Julian Eitschberger,GER,DF,Hertha BSC,Bundesliga,17,2004,0.5,0,0,0,0,0,0,1,0.0,1,1,1,0,2,2,2,0,Matches
798,Albin Ekdal,SWE,MF,Sampdoria,Serie A,32,1989,18.2,43,28,17,21,5,26,56,46.4,30,27,7,20,29,72,25,0,Matches
799,Hugo Ekitike,FRA,FW,Reims,Ligue 1,19,2002,14.1,18,10,8,6,4,4,11,36.4,7,9,2,7,6,24,15,0,Matches
800,Jurgen Ekkelenkamp,NED,"MF,FW",Hertha BSC,Bundesliga,21,2000,8.0,8,3,2,6,0,2,7,28.6,5,9,2,7,4,12,5,0,Matches
801,Caleb Ekuban,GHA,"FW,MF",Genoa,Serie A,27,1994,19.1,19,12,2,12,5,7,23,30.4,16,19,5,14,9,28,6,0,Matches
802,Anthony Elanga,SWE,FW,Manchester Utd,Premier League,19,2002,13.5,26,20,12,12,2,15,29,51.7,14,17,1,16,9,35,7,0,Matches
803,Alberth Elis,HON,"FW,MF",Bordeaux,Ligue 1,25,1996,15.7,19,10,5,5,9,11,25,44.0,14,9,0,9,7,26,10,0,Matches
804,Harvey Elliott,ENG,MF,Liverpool,Premier League,18,2003,3.8,3,0,1,1,1,0,6,0.0,6,8,1,7,4,7,2,0,Matches
805,Elif Elmas,MKD,"FW,MF",Napoli,Serie A,21,1999,18.0,25,15,10,10,5,12,28,42.9,16,13,2,11,8,33,17,0,Matches
806,Mohamed Elneny,EGY,MF,Arsenal,Premier League,29,1992,9.0,16,8,10,5,1,7,12,58.3,5,7,1,6,14,30,13,0,Matches
807,Aritz Elustondo,ESP,DF,Real Sociedad,La Liga,27,1994,23.4,21,14,16,5,0,10,20,50.0,10,19,13,6,29,50,86,0,Matches
808,Nico Elvedi,SUI,DF,Gladbach,Bundesliga,24,1996,27.0,40,24,23,17,0,22,36,61.1,14,33,22,11,34,74,83,1,Matches
809,Mohamed Elyounoussi,NOR,"MF,FW",Southampton,Premier League,26,1994,22.7,36,17,14,15,7,11,39,28.2,28,23,2,21,12,48,28,0,Matches
810,Adri Embarba,ESP,"FW,MF",Espanyol,La Liga,29,1992,22.1,44,29,22,15,7,26,69,37.7,43,35,3,32,19,63,30,0,Matches
811,Breel Embolo,SUI,FW,Gladbach,Bundesliga,24,1997,24.1,16,11,1,12,3,3,8,37.5,5,14,2,12,6,22,7,0,Matches
812,Emerson,BRA,"DF,MF",Tottenham,Premier League,22,1999,25.4,72,47,50,16,6,36,67,53.7,31,25,2,23,22,94,92,1,Matches
813,Emerson,BRA,DF,Barcelona,La Liga,22,1999,1.0,3,3,2,1,0,1,2,50.0,1,1,0,1,2,5,1,0,Matches
814,Renaud Emond,BEL,"FW,MF",Nantes,Ligue 1,29,1991,2.1,1,0,0,1,0,0,4,0.0,4,2,1,1,0,1,1,0,Matches
815,Youssef En-Nesyri,MAR,FW,Sevilla,La Liga,24,1997,14.2,10,5,5,2,3,4,11,36.4,7,9,1,8,4,14,18,0,Matches
816,Keita Endo,JPN,MF,Union Berlin,Bundesliga,23,1997,0.6,1,1,1,0,0,0,0,,0,1,0,1,0,1,0,0,Matches
817,Wataru Endo,JPN,MF,Stuttgart,Bundesliga,28,1993,32.2,73,41,34,34,5,31,72,43.1,41,43,12,31,30,103,64,0,Matches
818,Christian Eriksen,DEN,MF,Brentford,Premier League,29,1992,10.4,13,6,4,5,4,8,17,47.1,9,9,1,8,9,22,14,0,Matches
819,Martin Erlic,CRO,DF,Spezia,Serie A,23,1998,28.6,28,16,18,10,0,10,18,55.6,8,54,39,15,28,56,122,1,Matches
820,Gonzalo Escalante,ARG,MF,Lazio,Serie A,28,1993,0.1,1,0,1,0,0,1,1,100.0,0,2,1,1,1,2,0,0,Matches
821,Gonzalo Escalante,ARG,MF,Alavés,La Liga,28,1993,14.4,30,14,9,20,1,13,34,38.2,21,27,2,25,21,51,28,0,Matches
822,Aarón Escandell,ESP,GK,Granada,La Liga,25,1995,3.2,0,0,0,0,0,0,1,0.0,1,0,0,0,0,0,4,0,Matches
823,Sergio Escudero,ESP,"DF,MF",Granada,La Liga,31,1989,15.9,46,24,25,17,4,26,54,48.1,28,18,3,15,26,72,35,0,Matches
824,Alfonso Espino,URU,DF,Cádiz,La Liga,29,1992,37.0,107,63,58,39,10,44,112,39.3,68,45,10,35,54,161,87,1,Matches
825,Michael Esser,GER,GK,Bochum,Bundesliga,33,1987,3.0,0,0,0,0,0,0,1,0.0,1,0,0,0,0,0,2,0,Matches
826,Estanis,ESP,FW,Barcelona,La Liga,17,2003,0.1,1,1,0,1,0,1,1,100.0,0,0,0,0,0,1,0,0,Matches
827,Maxime Estève,FRA,DF,Montpellier,Ligue 1,19,2002,20.6,27,18,22,4,1,15,27,55.6,12,31,24,7,22,49,69,1,Matches
828,Pervis Estupiñán,ECU,DF,Villarreal,La Liga,23,1998,17.5,36,22,20,11,5,17,24,70.8,7,13,5,8,25,61,29,2,Matches
829,Oghenekaro Etebo,NGA,MF,Watford,Premier League,25,1995,4.5,11,8,7,4,0,3,8,37.5,5,3,1,2,5,16,5,0,Matches
830,Jonny Evans,NIR,DF,Leicester City,Premier League,33,1988,15.0,24,14,14,8,2,14,22,63.6,8,17,13,4,20,44,59,0,Matches
831,Eberechi Eze,ENG,"MF,FW",Crystal Palace,Premier League,23,1998,6.7,10,6,5,2,3,6,11,54.5,5,4,1,3,5,15,1,0,Matches
832,Abde Ezzalzouli,MAR,FW,Barcelona,La Liga,19,2001,6.4,17,9,9,5,3,5,8,62.5,3,3,0,3,9,26,0,0,Matches
833,Łukasz Fabiański,POL,GK,West Ham,Premier League,36,1985,37.0,0,0,0,0,0,0,0,,0,0,0,0,0,0,11,0,Matches
834,Fabinho,BRA,MF,Liverpool,Premier League,27,1993,25.7,46,25,17,23,6,24,70,34.3,46,33,10,23,39,85,25,1,Matches
835,Fábio,BRA,DF,Nantes,Ligue 1,31,1990,18.5,61,40,31,23,7,36,74,48.6,38,29,7,22,35,96,31,1,Matches
836,Cesc Fàbregas,ESP,MF,Monaco,Ligue 1,34,1987,0.4,1,0,0,1,0,1,1,100.0,0,0,0,0,1,2,0,0,Matches
837,Wout Faes,BEL,DF,Reims,Ligue 1,23,1998,37.0,40,24,30,9,1,25,33,75.8,8,47,37,10,53,93,169,2,Matches
838,Wahid Faghir,DEN,FW,Stuttgart,Bundesliga,18,2003,1.4,0,0,0,0,0,0,1,0.0,1,2,0,2,0,0,0,0,Matches
839,Romain Faivre,FRA,"FW,MF",Lyon,Ligue 1,23,1998,9.9,10,4,2,6,2,4,13,30.8,9,4,0,4,3,13,2,0,Matches
840,Romain Faivre,FRA,MF,Brest,Ligue 1,23,1998,19.9,30,18,12,13,5,12,30,40.0,18,11,0,11,13,43,10,0,Matches
841,Radamel Falcao,COL,FW,Rayo Vallecano,La Liga,35,1986,9.3,2,1,0,1,1,1,4,25.0,3,4,1,3,2,4,11,0,Matches
842,Diego Falcinelli,ITA,FW,Bologna,Serie A,30,1991,0.7,2,2,2,0,0,0,0,,0,0,0,0,1,3,1,0,Matches
843,Wladimiro Falcone,ITA,GK,Sampdoria,Serie A,26,1995,9.5,0,0,0,0,0,0,0,,0,0,0,0,1,1,5,0,Matches
844,Fali,ESP,"DF,MF",Cádiz,La Liga,27,1993,20.0,32,19,24,8,0,17,32,53.1,15,26,16,10,24,56,82,0,Matches
845,Paolo Faragò,ITA,MF,Cagliari,Serie A,28,1993,0.2,1,1,1,0,0,0,0,,0,2,0,2,0,1,0,0,Matches
846,Omar Faraj,PLE,FW,Levante,La Liga,19,2002,0.0,1,0,1,0,0,1,1,100.0,0,0,0,0,0,1,0,0,Matches
847,Davide Faraoni,ITA,DF,Hellas Verona,Serie A,29,1991,28.6,62,40,38,21,3,29,62,46.8,33,38,5,33,23,85,62,1,Matches
848,Mohamed Fares,ALG,"DF,FW",Genoa,Serie A,25,1996,6.5,4,2,1,3,0,0,4,0.0,4,8,3,5,8,12,11,0,Matches
849,Diego Farias,BRA,"MF,FW",Cagliari,Serie A,31,1990,0.7,1,1,0,1,0,1,3,33.3,2,0,0,0,0,1,0,0,Matches
850,Wuilker Faríñez,VEN,GK,Lens,Ligue 1,23,1998,12.3,0,0,0,0,0,0,0,,0,0,0,0,0,0,4,0,Matches
851,Ömer Faruk Beyaz,TUR,"DF,MF",Stuttgart,Bundesliga,17,2003,0.8,4,3,1,3,0,1,5,20.0,4,0,0,0,2,6,0,0,Matches
852,Noah Fatar,FRA,"DF,MF",Angers,Ligue 1,19,2002,0.1,1,0,0,0,1,0,1,0.0,1,0,0,0,1,2,0,0,Matches
853,Ansu Fati,ESP,FW,Barcelona,La Liga,18,2002,3.7,3,2,0,2,1,1,1,100.0,0,4,0,4,1,4,0,0,Matches
854,Julien Faussurier,FRA,"MF,DF",Brest,Ligue 1,34,1987,5.4,10,6,3,3,4,6,13,46.2,7,12,1,11,5,15,6,0,Matches
855,Andrea Favilli,ITA,FW,Genoa,Serie A,24,1997,0.4,1,1,0,0,1,0,0,,0,0,0,0,0,1,2,0,Matches
856,Federico Fazio,ARG,DF,Salernitana,Serie A,34,1987,15.9,17,11,10,6,1,9,12,75.0,3,21,16,5,27,44,67,1,Matches
857,Aleix Febas,ESP,MF,Mallorca,La Liga,25,1996,1.3,4,1,0,4,0,2,4,50.0,2,0,0,0,0,4,0,0,Matches
858,Peter Federico,DOM,"MF,DF",Real Madrid,La Liga,19,2002,0.3,0,0,0,0,0,0,0,,0,0,0,0,1,1,0,0,Matches
859,Adrian Fein,GER,MF,Greuther Fürth,Bundesliga,22,1999,0.4,0,0,0,0,0,0,1,0.0,1,0,0,0,2,2,0,0,Matches
860,Nabil Fekir,FRA,MF,Betis,La Liga,28,1993,31.0,43,29,5,25,13,7,36,19.4,29,14,0,14,7,50,7,0,Matches
861,Felipe,BRA,DF,Atlético Madrid,La Liga,32,1989,16.7,20,15,11,8,1,8,18,44.4,10,17,11,6,28,48,77,0,Matches
862,Luiz Felipe,ITA,DF,Lazio,Serie A,24,1997,27.7,41,23,21,16,4,20,34,58.8,14,40,33,7,33,74,102,1,Matches
863,João Félix,POR,"FW,MF",Atlético Madrid,La Liga,21,1999,14.0,5,2,1,4,0,1,5,20.0,4,4,1,3,7,12,8,0,Matches
864,Ohis Felix Uduokhai,GER,DF,Augsburg,Bundesliga,23,1997,8.7,9,6,6,3,0,6,11,54.5,5,13,8,5,9,18,33,0,Matches
865,Kiko Femenía,ESP,DF,Watford,Premier League,30,1991,23.8,35,22,23,10,2,21,37,56.8,16,24,8,16,37,72,51,0,Matches
866,Evan Ferguson,IRL,MF,Brighton,Premier League,16,2004,0.3,0,0,0,0,0,0,0,,0,0,0,0,0,0,0,0,Matches
867,Nathan Ferguson,ENG,DF,Crystal Palace,Premier League,20,2000,0.1,0,0,0,0,0,0,0,,0,0,0,0,0,0,0,0,Matches
868,Bruno Fernandes,POR,MF,Manchester Utd,Premier League,26,1994,34.6,54,28,26,22,6,26,91,28.6,65,36,0,36,17,71,42,2,Matches
869,Edimilson Fernandes,SUI,"MF,FW",Arminia,Bundesliga,25,1996,3.1,2,0,1,1,0,1,4,25.0,3,2,2,0,2,4,6,0,Matches
870,Aitor Fernández,ESP,GK,Levante,La Liga,30,1991,13.0,2,1,2,0,0,2,2,100.0,0,0,0,0,0,2,7,0,Matches
871,Álex Fernández,ESP,MF,Cádiz,La Liga,28,1992,22.8,47,31,22,17,8,21,61,34.4,40,30,7,23,30,77,31,0,Matches
872,Álvaro Fernández,ESP,GK,Brentford,Premier League,23,1998,12.0,0,0,0,0,0,0,0,,0,0,0,0,0,0,5,2,Matches
873,Federico Fernández,ARG,DF,Newcastle Utd,Premier League,32,1989,5.8,3,0,3,0,0,2,5,40.0,3,10,10,0,4,7,28,0,Matches
874,Fernandinho,BRA,"MF,DF",Manchester City,Premier League,36,1985,10.7,21,10,7,10,4,9,27,33.3,18,8,2,6,8,29,13,1,Matches
875,Fernando,BRA,"MF,DF",Sevilla,La Liga,34,1987,20.6,24,17,14,9,1,12,33,36.4,21,21,13,8,29,53,32,2,Matches
876,Alex Ferrari,ITA,DF,Sampdoria,Serie A,27,1994,18.3,40,22,28,9,3,19,33,57.6,14,31,22,9,39,79,63,1,Matches
877,Salvador Ferrer,ESP,"DF,MF",Spezia,Serie A,23,1998,16.6,32,18,15,9,8,12,25,48.0,13,24,12,12,18,50,46,0,Matches
878,Jordan Ferri,FRA,MF,Montpellier,Ligue 1,29,1992,32.3,55,35,28,23,4,29,87,33.3,58,21,5,16,30,85,35,0,Matches
879,Riccardo Fiamozzi,ITA,DF,Empoli,Serie A,28,1993,6.9,7,5,2,2,3,2,4,50.0,2,6,5,1,7,14,12,0,Matches
880,Fidel,ESP,MF,Elche,La Liga,31,1989,25.1,44,23,18,17,9,14,57,24.6,43,9,1,8,7,51,20,0,Matches
881,Karol Fila,POL,DF,Strasbourg,Ligue 1,23,1998,6.2,10,8,5,4,1,4,8,50.0,4,7,2,5,4,14,6,0,Matches
882,Alfreð Finnbogason,ISL,FW,Augsburg,Bundesliga,32,1989,3.2,3,1,0,2,1,2,4,50.0,2,5,1,4,2,5,8,0,Matches
883,Luca Fiordilino,ITA,MF,Venezia,Serie A,25,1996,7.3,21,13,11,6,4,13,27,48.1,14,14,4,10,11,32,12,0,Matches
884,Vincenzo Fiorillo,ITA,GK,Salernitana,Serie A,31,1990,1.0,0,0,0,0,0,0,0,,0,0,0,0,0,0,1,0,Matches
885,Roberto Firmino,BRA,FW,Liverpool,Premier League,29,1991,11.0,23,14,5,8,10,3,16,18.8,13,20,0,20,4,27,3,0,Matches
886,Junior Firpo,DOM,"DF,MF",Leeds United,Premier League,24,1996,19.0,61,29,30,26,5,31,59,52.5,28,22,6,16,24,85,37,0,Matches
887,Mark Flekken,NED,GK,Freiburg,Bundesliga,28,1993,32.0,0,0,0,0,0,0,2,0.0,2,1,0,1,2,2,10,1,Matches
888,Ashley Fletcher,ENG,FW,Watford,Premier League,25,1995,0.3,2,1,1,1,0,1,1,100.0,0,1,1,0,0,2,0,0,Matches
889,Alexis Flips,FRA,"MF,DF",Reims,Ligue 1,21,2000,11.7,37,21,21,9,7,22,45,48.9,23,21,0,21,24,61,17,0,Matches
890,Alessandro Florenzi,ITA,"DF,FW",Milan,Serie A,30,1991,12.8,28,14,14,7,7,14,32,43.8,18,9,2,7,27,55,10,1,Matches
891,Phil Foden,ENG,FW,Manchester City,Premier League,21,2000,23.6,16,8,10,4,2,7,17,41.2,10,9,0,9,11,27,5,0,Matches
892,Mamadou Fofana,MLI,DF,Metz,Ligue 1,23,1998,0.4,1,1,0,1,0,1,2,50.0,1,2,1,1,1,2,2,0,Matches
893,Seko Fofana,CIV,MF,Lens,Ligue 1,26,1995,37.3,27,19,11,13,3,12,58,20.7,46,24,2,22,26,53,17,1,Matches
894,Wesley Fofana,FRA,DF,Leicester City,Premier League,20,2000,7.0,12,8,11,1,0,7,11,63.6,4,5,2,3,12,24,26,1,Matches
895,Youssouf Fofana,FRA,MF,Monaco,Ligue 1,22,1999,24.3,69,43,19,41,9,29,56,51.8,27,29,7,22,32,101,22,2,Matches
896,Thomas Foket,BEL,"DF,FW",Reims,Ligue 1,26,1994,24.8,28,19,12,13,3,18,40,45.0,22,26,4,22,33,61,35,0,Matches
897,Thomas Fontaine,MAD,DF,Lorient,Ligue 1,30,1991,1.9,2,0,1,0,1,0,1,0.0,1,3,3,0,2,4,4,0,Matches
898,José Fontán,ESP,DF,Celta Vigo,La Liga,21,2000,3.1,5,3,3,2,0,1,5,20.0,4,3,1,2,10,15,10,0,Matches
899,José Fonte,POR,DF,Lille,Ligue 1,37,1983,38.0,23,12,14,7,2,11,25,44.0,14,39,32,7,44,67,159,1,Matches
900,Fernando Forestieri,ITA,"FW,MF",Udinese,Serie A,31,1990,0.6,0,0,0,0,0,0,1,0.0,1,1,0,1,0,0,1,0,Matches
901,Pablo Fornals,ESP,"FW,MF",West Ham,Premier League,25,1996,31.1,54,28,21,21,12,22,84,26.2,62,49,2,47,27,81,16,1,Matches
902,Emil Forsberg,SWE,MF,RB Leipzig,Bundesliga,29,1991,19.0,21,12,2,11,8,7,22,31.8,15,18,0,18,2,23,2,1,Matches
903,Adam Forshaw,ENG,MF,Leeds United,Premier League,29,1991,17.0,53,23,21,27,5,21,54,38.9,33,17,1,16,19,72,12,2,Matches
904,Marcus Forss,FIN,"FW,MF",Brentford,Premier League,22,1999,2.3,3,3,0,2,1,2,4,50.0,2,5,0,5,1,4,0,0,Matches
905,Fraser Forster,ENG,GK,Southampton,Premier League,33,1988,19.0,1,0,1,0,0,0,1,0.0,1,0,0,0,0,1,23,2,Matches
906,Philipp Förster,GER,"MF,FW",Stuttgart,Bundesliga,26,1995,10.7,20,13,4,12,4,11,26,42.3,15,12,1,11,3,23,2,0,Matches
907,Francesco Forte,ITA,FW,Venezia,Serie A,28,1993,4.7,3,2,0,2,1,2,5,40.0,3,1,0,1,0,3,2,0,Matches
908,Steven Fortes,CPV,DF,Lens,Ligue 1,29,1992,1.0,2,0,2,0,0,1,2,50.0,1,2,1,1,0,2,4,0,Matches
909,Ben Foster,ENG,GK,Watford,Premier League,38,1983,26.0,0,0,0,0,0,0,3,0.0,3,0,0,0,0,0,9,4,Matches
910,Tariqe Fosu,GHA,DF,Brentford,Premier League,25,1995,0.2,0,0,0,0,0,0,0,,0,1,0,1,0,0,0,0,Matches
911,Timothy Fosu-Mensah,NED,DF,Leverkusen,Bundesliga,23,1998,1.6,5,3,3,1,1,4,4,100.0,0,1,0,1,2,7,2,0,Matches
912,Dimitri Foulquier,FRA,DF,Granada,La Liga,28,1993,2.0,0,0,0,0,0,0,1,0.0,1,2,1,1,1,1,2,0,Matches
913,Dimitri Foulquier,FRA,DF,Valencia,La Liga,28,1993,26.0,36,17,17,15,4,21,34,61.8,13,19,3,16,29,65,49,0,Matches
914,Juan Foyth,ARG,DF,Villarreal,La Liga,23,1998,21.4,69,49,35,28,6,35,47,74.5,12,29,7,22,20,89,50,0,Matches
915,Gianluca Frabotta,ITA,"DF,MF",Hellas Verona,Serie A,22,1999,0.2,0,0,0,0,0,0,1,0.0,1,1,0,1,1,1,0,0,Matches
916,Raphael Framberger,GER,DF,Augsburg,Bundesliga,25,1995,9.4,26,19,12,10,4,13,27,48.1,14,8,2,6,9,35,25,0,Matches
917,Przemysław Frankowski,POL,DF,Lens,Ligue 1,26,1995,27.2,57,39,22,27,8,36,74,48.6,38,27,0,27,28,85,52,0,Matches
918,Enric Franquesa,ESP,"DF,FW",Levante,La Liga,24,1997,6.9,5,3,4,0,1,0,1,0.0,1,4,0,4,7,12,11,0,Matches
919,Fransérgio,BRA,MF,Bordeaux,Ligue 1,30,1990,14.0,24,10,8,12,4,12,43,27.9,31,18,6,12,23,47,23,0,Matches
920,Ryan Fraser,SCO,"FW,MF",Newcastle Utd,Premier League,27,1994,16.3,10,3,5,3,2,5,13,38.5,8,11,1,10,11,21,11,0,Matches
921,Davide Frattesi,ITA,MF,Sassuolo,Serie A,21,1999,31.7,46,16,26,18,2,26,52,50.0,26,44,12,32,29,75,62,1,Matches
922,Fred,BRA,MF,Manchester Utd,Premier League,28,1993,22.5,63,27,32,24,7,22,79,27.8,57,38,11,27,32,95,24,0,Matches
923,Ryan Fredericks,ENG,DF,West Ham,Premier League,28,1992,3.4,2,2,2,0,0,0,1,0.0,1,2,1,1,4,6,6,0,Matches
924,Morten Frendrup,DEN,"DF,MF",Genoa,Serie A,20,2001,7.7,40,24,19,13,8,13,29,44.8,16,19,2,17,17,57,7,1,Matches
925,Remo Freuler,SUI,MF,Atalanta,Serie A,29,1992,26.3,69,39,22,33,14,30,70,42.9,40,48,8,40,35,104,26,1,Matches
926,Marvin Friedrich,GER,DF,Gladbach,Bundesliga,25,1995,6.7,14,8,10,4,0,9,11,81.8,2,5,3,2,5,19,26,0,Matches
927,Marvin Friedrich,GER,DF,Union Berlin,Bundesliga,25,1995,13.0,17,5,14,3,0,10,16,62.5,6,13,7,6,23,40,47,0,Matches
928,Jeremie Frimpong,NED,DF,Leverkusen,Bundesliga,20,2000,22.8,32,18,19,12,1,12,23,52.2,11,24,6,18,17,49,40,2,Matches
929,Christian Früchtl,GER,GK,Bayern Munich,Bundesliga,21,2000,0.1,0,0,0,0,0,0,0,,0,0,0,0,0,0,0,0,Matches
930,Jorge de Frutos,ESP,"MF,FW",Levante,La Liga,24,1997,19.6,33,15,14,11,8,10,51,19.6,41,11,1,10,12,45,13,0,Matches
931,Leo Fuhr Hjelde,NOR,"MF,DF",Leeds United,Premier League,17,2003,1.7,5,4,3,2,0,3,3,100.0,0,3,3,0,4,9,7,0,Matches
932,Chris Führich,GER,"FW,MF",Stuttgart,Bundesliga,23,1998,19.0,28,16,10,10,8,18,39,46.2,21,31,2,29,8,36,9,0,Matches
933,Angelo Fulgini,FRA,"MF,FW",Angers,Ligue 1,24,1996,32.5,35,25,8,18,9,14,44,31.8,30,21,5,16,22,57,5,1,Matches
934,Marius Funk,GER,GK,Greuther Fürth,Bundesliga,25,1996,8.0,0,0,0,0,0,0,0,,0,0,0,0,0,0,8,1,Matches
935,Stephan Fürstner,GER,MF,Mainz 05,Bundesliga,33,1987,0.1,0,0,0,0,0,0,2,0.0,2,0,0,0,0,0,1,0,Matches
936,Matteo Gabbia,ITA,DF,Milan,Serie A,21,1999,6.0,4,3,1,3,0,0,4,0.0,4,2,2,0,8,12,12,0,Matches
937,Manolo Gabbiadini,ITA,"FW,MF",Sampdoria,Serie A,29,1991,12.7,6,4,3,2,1,1,7,14.3,6,5,2,3,3,9,10,0,Matches
938,Mijat Gaćinović,SRB,"FW,MF",Hoffenheim,Bundesliga,26,1995,1.2,3,3,1,1,1,3,3,100.0,0,1,0,1,1,4,2,0,Matches
939,Gianluca Gaetano,ITA,MF,Napoli,Serie A,21,2000,0.2,1,1,1,0,0,1,2,50.0,1,0,0,0,2,3,0,0,Matches
940,Luca Gagliano,ITA,"FW,DF",Cagliari,Serie A,21,2000,0.1,0,0,0,0,0,0,0,,0,1,0,1,0,0,1,0,Matches
941,Roberto Gagliardini,ITA,MF,Inter,Serie A,27,1994,7.2,12,6,7,4,1,1,13,7.7,12,14,5,9,9,21,7,0,Matches
942,Riccardo Gagliolo,SWE,DF,Salernitana,Serie A,31,1990,12.6,23,12,16,4,3,16,27,59.3,11,15,8,7,28,51,52,0,Matches
943,Javi Galán,ESP,DF,Celta Vigo,La Liga,26,1994,36.6,108,66,60,37,11,42,99,42.4,57,48,8,40,45,153,52,0,Matches
944,Iñigo Ruiz de Galarreta,ESP,MF,Mallorca,La Liga,27,1993,15.3,40,21,14,21,5,14,30,46.7,16,16,2,14,20,60,21,0,Matches
945,Nicolas Galazzi,ITA,MF,Venezia,Serie A,20,2000,0.2,2,1,1,0,1,0,1,0.0,1,0,0,0,0,2,0,0,Matches
946,Pablo Galdames Millán,CHI,MF,Genoa,Serie A,24,1996,11.4,28,12,6,16,6,12,35,34.3,23,16,2,14,8,36,9,1,Matches
947,Thiago Galhardo,BRA,"FW,MF",Celta Vigo,La Liga,32,1989,12.8,12,6,3,3,6,2,12,16.7,10,15,2,13,6,18,9,0,Matches
948,Conor Gallagher,ENG,MF,Crystal Palace,Premier League,21,2000,31.6,69,38,35,20,14,21,69,30.4,48,58,9,49,29,98,26,0,Matches
949,Gauthier Gallon,FRA,GK,Troyes,Ligue 1,28,1993,31.0,3,0,3,0,0,1,1,100.0,0,0,0,0,2,5,12,1,Matches
950,Cristian Gamboa,CRC,DF,Bochum,Bundesliga,31,1989,19.1,59,36,40,16,3,30,61,49.2,31,22,7,15,32,91,35,1,Matches
951,Kévin Gameiro,FRA,FW,Strasbourg,Ligue 1,34,1987,26.5,19,10,5,9,5,6,18,33.3,12,22,1,21,6,25,1,0,Matches
952,Idrissa Gana Gueye,SEN,MF,Paris S-G,Ligue 1,31,1989,18.2,60,36,24,24,12,18,44,40.9,26,23,4,19,24,84,13,0,Matches
953,Ignatius Ganago,CMR,FW,Lens,Ligue 1,22,1999,11.4,3,2,1,2,0,2,6,33.3,4,4,0,4,2,5,3,0,Matches
954,Silvère Ganvoula M'Boussy,CGO,FW,Bochum,Bundesliga,25,1996,1.7,0,0,0,0,0,0,1,0.0,1,0,0,0,0,0,1,0,Matches
955,Álvaro García,ESP,"FW,MF",Rayo Vallecano,La Liga,28,1992,33.3,42,23,15,18,9,8,35,22.9,27,27,3,24,42,84,24,0,Matches
956,Dani García,ESP,MF,Athletic Club,La Liga,31,1990,24.2,36,22,15,17,4,14,47,29.8,33,27,10,17,24,60,41,1,Matches
957,David García,ESP,DF,Osasuna,La Liga,27,1994,34.5,28,14,15,11,2,12,22,54.5,10,27,21,6,52,80,168,0,Matches
958,Eric García,ESP,DF,Barcelona,La Liga,20,2001,22.7,27,18,13,13,1,11,26,42.3,15,22,12,10,44,71,53,3,Matches
959,Fran Garcia,ESP,DF,Rayo Vallecano,La Liga,21,1999,33.6,60,35,44,12,4,39,73,53.4,34,34,8,26,45,105,53,0,Matches
960,Joan García,ESP,GK,Espanyol,La Liga,20,2001,1.2,0,0,0,0,0,0,0,,0,0,0,0,1,1,1,2,Matches
961,Manu García,ESP,MF,Alavés,La Liga,23,1998,12.0,18,9,6,9,3,9,27,33.3,18,8,2,6,13,31,4,0,Matches
962,Raúl García,ESP,FW,Athletic Club,La Liga,35,1986,20.0,27,17,6,11,10,8,36,22.2,28,30,4,26,9,36,21,0,Matches
963,Rubén García,ESP,"MF,FW",Osasuna,La Liga,28,1993,26.4,43,26,12,23,8,16,49,32.7,33,31,4,27,24,67,16,0,Matches
964,Saúl García,ESP,MF,Alavés,La Liga,26,1994,0.0,1,1,1,0,0,0,0,,0,0,0,0,0,1,0,0,Matches
965,Unai García,ESP,DF,Osasuna,La Liga,29,1992,15.6,21,12,14,6,1,14,17,82.4,3,19,11,8,22,43,78,0,Matches
966,Alejandro Garnacho,ARG,"FW,MF",Manchester Utd,Premier League,17,2004,0.1,0,0,0,0,0,0,1,0.0,1,0,0,0,0,0,0,0,Matches
967,Mario Gaspar,ESP,DF,Villarreal,La Liga,30,1990,6.9,10,4,2,5,3,6,10,60.0,4,6,3,3,6,16,15,0,Matches
968,Djeidi Gassama,FRA,FW,Paris S-G,Ligue 1,17,2003,0.0,0,0,0,0,0,0,0,,0,1,1,0,0,0,0,0,Matches
969,Johan Gastien,FRA,MF,Clermont Foot,Ligue 1,33,1988,30.5,56,34,26,25,5,27,74,36.5,47,45,11,34,53,109,49,1,Matches
970,Gavi,ESP,"MF,FW",Barcelona,La Liga,16,2004,25.7,38,18,13,18,7,9,33,27.3,24,36,0,36,25,63,13,0,Matches
971,Dwight Gayle,ENG,"FW,DF",Newcastle Utd,Premier League,30,1990,0.4,1,0,0,1,0,0,1,0.0,1,0,0,0,1,2,0,0,Matches
972,Jean-Philippe Gbamin,CIV,MF,Everton,Premier League,25,1995,0.7,1,1,1,0,0,0,2,0.0,2,0,0,0,1,2,1,0,Matches
973,David de Gea,ESP,GK,Manchester Utd,Premier League,30,1990,38.0,0,0,0,0,0,0,0,,0,0,0,0,0,0,11,2,Matches
974,Linus Gechter,GER,DF,Hertha BSC,Bundesliga,17,2004,8.0,15,8,13,2,0,7,14,50.0,7,12,7,5,11,26,29,0,Matches
975,Dennis Geiger,GER,MF,Hoffenheim,Bundesliga,23,1998,15.3,34,23,9,20,5,17,30,56.7,13,15,1,14,14,48,7,1,Matches
976,Joe Gelhardt,ENG,"FW,MF",Leeds United,Premier League,19,2002,8.3,4,3,1,0,3,2,10,20.0,8,9,0,9,0,4,3,0,Matches
977,Luca Gemello,ITA,GK,Torino,Serie A,21,2000,1.0,0,0,0,0,0,0,0,,0,0,0,0,0,0,0,0,Matches
978,Yannick Gerhardt,GER,"MF,DF",Wolfsburg,Bundesliga,27,1994,17.5,42,20,18,17,7,22,36,61.1,14,24,1,23,25,67,25,1,Matches
979,Valère Germain,FRA,FW,Montpellier,Ligue 1,31,1990,21.9,23,14,6,11,6,8,31,25.8,23,13,1,12,9,32,27,0,Matches
980,Gerson,BRA,"MF,FW",Marseille,Ligue 1,24,1997,28.3,42,17,16,20,6,8,35,22.9,27,26,4,22,16,58,16,2,Matches
981,Willem Geubbels,FRA,"FW,MF",Nantes,Ligue 1,19,2001,6.0,8,5,4,2,2,5,12,41.7,7,5,0,5,6,14,5,0,Matches
982,Hamadi Al Ghaddioui,MAR,FW,Stuttgart,Bundesliga,30,1990,5.5,5,4,2,1,2,0,4,0.0,4,3,1,2,0,5,4,0,Matches
983,Ismaël Gharbi,ESP,FW,Paris S-G,Ligue 1,17,2004,0.0,0,0,0,0,0,0,0,,0,0,0,0,0,0,0,0,Matches
984,Anwar El Ghazi,NED,"FW,MF",Aston Villa,Premier League,26,1995,4.3,4,4,2,2,0,2,7,28.6,5,6,0,6,1,5,2,0,Matches
985,Anwar El Ghazi,NED,"FW,MF",Everton,Premier League,26,1995,0.1,1,1,1,0,0,1,1,100.0,0,3,0,3,0,1,0,0,Matches
986,Lamine Ghezali,FRA,DF,Saint-Étienne,Ligue 1,22,1999,0.0,0,0,0,0,0,0,0,,0,1,0,1,0,0,0,0,Matches
987,Paolo Ghiglione,ITA,DF,Genoa,Serie A,24,1997,6.7,17,12,8,6,3,9,14,64.3,5,11,5,6,10,27,12,1,Matches
988,Saman Ghoddos,IRN,"MF,DF",Brentford,Premier League,27,1993,6.0,17,10,8,6,3,9,15,60.0,6,2,0,2,3,20,16,0,Matches
989,Faouzi Ghoulam,ALG,DF,Napoli,Serie A,30,1991,3.7,3,1,1,2,0,0,3,0.0,3,2,1,1,3,6,10,0,Matches
990,Dimitris Giannoulis,GRE,DF,Norwich City,Premier League,25,1995,13.0,36,21,17,17,2,24,36,66.7,12,22,6,16,19,55,41,1,Matches
991,Morgan Gibbs-White,ENG,"DF,FW",Wolves,Premier League,21,2000,0.1,0,0,0,0,0,0,0,,0,1,0,1,0,0,0,0,Matches
992,Ben Gibson,ENG,DF,Norwich City,Premier League,28,1993,27.7,23,16,17,6,0,7,12,58.3,5,36,30,6,27,50,139,2,Matches
993,Niko Gießelmann,GER,"DF,FW",Union Berlin,Bundesliga,29,1991,23.1,24,17,10,11,3,15,38,39.5,23,26,4,22,18,42,29,1,Matches
994,Rafał Gikiewicz,POL,GK,Augsburg,Bundesliga,33,1987,34.0,2,0,2,0,0,2,7,28.6,5,0,0,0,3,5,11,5,Matches
995,Bryan Gil,ESP,"FW,MF",Tottenham,Premier League,20,2001,1.0,3,0,1,0,2,1,2,50.0,1,2,0,2,0,3,0,0,Matches
996,Bryan Gil,ESP,"MF,FW",Valencia,La Liga,20,2001,8.4,13,8,6,3,4,2,13,15.4,11,13,0,13,1,14,4,0,Matches
997,Óscar Gil,ESP,DF,Espanyol,La Liga,24,1997,18.8,52,35,27,20,5,25,46,54.3,21,33,9,24,19,71,33,2,Matches
998,Mario Gila,ESP,DF,Real Madrid,La Liga,20,2000,0.3,1,0,1,0,0,0,1,0.0,1,0,0,0,1,2,1,0,Matches
999,Billy Gilmour,SCO,MF,Norwich City,Premier League,20,2001,20.6,41,21,16,21,4,14,52,26.9,38,21,4,17,17,58,29,0,Matches
1000,Daniel Ginczek,GER,"MF,FW",Wolfsburg,Bundesliga,30,1991,0.1,0,0,0,0,0,0,0,,0,0,0,0,0,0,0,0,Matches
1001,Matthias Ginter,GER,DF,Gladbach,Bundesliga,27,1994,26.2,36,22,20,13,3,27,40,67.5,13,21,10,11,33,69,76,0,Matches
1002,Nicholas Gioacchini,USA,"FW,MF",Montpellier,Ligue 1,21,2000,5.5,7,5,3,2,2,4,10,40.0,6,8,0,8,4,11,5,0,Matches
1003,Sebastian Giovinco,ITA,MF,Sampdoria,Serie A,34,1987,0.4,0,0,0,0,0,0,1,0.0,1,0,0,0,0,0,0,0,Matches
1004,Jimmy Giraudon,FRA,DF,Troyes,Ligue 1,29,1992,18.0,14,6,10,4,0,7,22,31.8,15,24,14,10,37,51,68,1,Matches
1005,Andrei Girotto,BRA,"DF,MF",Nantes,Ligue 1,29,1992,35.0,85,52,49,32,4,52,103,50.5,51,67,33,34,69,154,143,0,Matches
1006,Olivier Giroud,FRA,FW,Milan,Serie A,34,1986,21.0,15,11,4,6,5,3,17,17.6,14,13,4,9,3,18,19,0,Matches
1007,Jamie Gittens,ENG,FW,Dortmund,Bundesliga,16,2004,1.5,3,2,0,2,1,2,5,40.0,3,4,1,3,1,4,1,0,Matches
1008,Serge Gnabry,GER,"FW,DF",Bayern Munich,Bundesliga,26,1995,24.3,47,31,16,20,11,22,57,38.6,35,26,0,26,14,61,3,0,Matches
1009,Ben Godfrey,ENG,DF,Everton,Premier League,23,1998,22.5,47,32,29,14,4,24,39,61.5,15,41,19,22,15,62,100,2,Matches
1010,Diego Godín,URU,DF,Cagliari,Serie A,35,1986,9.1,18,7,13,3,2,10,15,66.7,5,7,5,2,13,31,46,0,Matches
1011,Edoardo Goldaniga,ITA,DF,Cagliari,Serie A,27,1993,10.4,12,5,7,5,0,4,11,36.4,7,8,5,3,22,34,23,0,Matches
1012,Edoardo Goldaniga,ITA,"DF,MF",Sassuolo,Serie A,27,1993,0.0,0,0,0,0,0,0,0,,0,0,0,0,0,0,0,0,Matches
1013,Aleksandr Golovin,RUS,"FW,MF",Monaco,Ligue 1,25,1996,16.7,40,22,10,18,12,18,41,43.9,23,26,1,25,12,52,8,0,Matches
1014,André Gomes,POR,MF,Everton,Premier League,28,1993,6.9,16,4,6,6,4,8,32,25.0,24,8,2,6,1,17,7,1,Matches
1015,Angel Gomes,ENG,"MF,FW",Lille,Ligue 1,20,2000,10.6,23,13,6,12,5,10,15,66.7,5,4,0,4,3,26,4,0,Matches
1016,Toti Gomes,POR,DF,Wolves,Premier League,22,1999,4.0,11,7,10,1,0,7,9,77.8,2,6,3,3,8,19,15,0,Matches
1017,Dani Gómez,ESP,FW,Levante,La Liga,23,1998,11.8,7,4,3,2,2,4,12,33.3,8,3,0,3,3,10,5,0,Matches
1018,Joe Gomez,ENG,DF,Liverpool,Premier League,24,1997,3.7,10,6,5,2,3,5,9,55.6,4,4,1,3,5,15,6,0,Matches
1019,Maxi Gómez,URU,FW,Valencia,La Liga,24,1996,21.7,5,3,1,2,2,5,8,62.5,3,5,1,4,3,8,22,0,Matches
1020,Moi Gómez,ESP,"MF,FW",Villarreal,La Liga,27,1994,14.3,15,7,8,3,4,5,17,29.4,12,5,0,5,6,21,6,0,Matches
1021,Papu Gómez,ARG,"FW,MF",Sevilla,La Liga,33,1988,19.8,19,11,9,5,5,9,35,25.7,26,15,2,13,7,26,12,2,Matches
1022,Sergi Gómez,ESP,DF,Espanyol,La Liga,29,1992,30.2,33,24,29,3,1,18,27,66.7,9,33,23,10,40,73,125,2,Matches
1023,Victor Gomez,ESP,DF,Espanyol,La Liga,21,2000,0.0,0,0,0,0,0,0,0,,0,0,0,0,0,0,0,0,Matches
1024,Alfred Gomis,SEN,GK,Rennes,Ligue 1,27,1993,25.0,1,0,1,0,0,1,2,50.0,1,0,0,0,1,2,8,2,Matches
1025,Maxime Gonalons,FRA,MF,Granada,La Liga,32,1989,17.2,43,28,17,22,4,14,39,35.9,25,33,10,23,18,61,29,0,Matches
1026,Vagner Gonçalves,CPV,FW,Metz,Ligue 1,25,1996,1.0,2,1,0,2,0,1,1,100.0,0,0,0,0,1,3,0,0,Matches
1027,Cedric Gondo,CIV,FW,Salernitana,Serie A,24,1996,7.8,5,2,2,2,1,2,5,40.0,3,2,0,2,3,8,2,0,Matches
1028,Álvaro González,ESP,DF,Marseille,Ligue 1,31,1990,5.0,1,1,1,0,0,1,1,100.0,0,0,0,0,1,2,9,0,Matches
1029,Diego González,ESP,DF,Elche,La Liga,26,1995,19.9,25,16,18,7,0,9,16,56.3,7,21,13,8,19,44,87,0,Matches
1030,Édgar González,ESP,DF,Betis,La Liga,24,1997,16.3,25,19,15,8,2,17,24,70.8,7,17,11,6,23,48,82,0,Matches
1031,Giovanni González,URU,DF,Mallorca,La Liga,26,1994,4.1,9,3,4,4,1,3,5,60.0,2,7,2,5,4,13,14,0,Matches
1032,Nicolás González,ARG,FW,Fiorentina,Serie A,23,1998,26.2,21,16,6,8,7,9,28,32.1,19,26,2,24,21,42,4,1,Matches
1033,Nicolás González,ESP,MF,Barcelona,La Liga,19,2002,12.4,31,20,5,23,3,11,27,40.7,16,12,0,12,6,37,12,0,Matches
1034,Roberto González,ESP,"FW,MF",Betis,La Liga,20,2001,1.5,5,4,3,2,0,4,6,66.7,2,5,0,5,1,6,1,0,Matches
1035,Charlie Goode,ENG,DF,Brentford,Premier League,25,1995,5.0,7,5,5,2,0,4,4,100.0,0,4,2,2,2,9,8,0,Matches
1036,Anthony Gordon,ENG,"MF,FW",Everton,Premier League,20,2001,25.4,54,32,20,30,4,21,59,35.6,38,49,3,46,22,76,17,0,Matches
1037,Kaide Gordon,ENG,FW,Liverpool,Premier League,16,2004,0.1,1,0,0,0,1,0,0,,0,0,0,0,0,1,0,0,Matches
1038,Leon Goretzka,GER,MF,Bayern Munich,Bundesliga,26,1995,15.5,25,15,12,9,4,11,26,42.3,15,11,1,10,17,42,23,2,Matches
1039,Gori,ESP,MF,Espanyol,La Liga,19,2002,0.1,0,0,0,0,0,0,0,,0,2,0,2,0,0,0,0,Matches
1040,Andoni Gorosabel,ESP,DF,Real Sociedad,La Liga,24,1996,25.4,47,31,32,9,6,25,47,53.2,22,16,3,13,18,65,49,0,Matches
1041,Robin Gosens,GER,DF,Atalanta,Serie A,27,1994,5.1,7,3,3,4,0,4,8,50.0,4,4,0,4,9,16,1,0,Matches
1042,Robin Gosens,GER,DF,Inter,Serie A,27,1994,1.9,3,1,1,2,0,0,0,,0,5,2,3,3,6,3,0,Matches
1043,Dan Gosling,ENG,MF,Watford,Premier League,31,1990,1.8,2,1,1,1,0,2,6,33.3,4,2,0,2,0,2,3,0,Matches
1044,Amine Gouiri,ALG,"FW,MF",Nice,Ligue 1,21,2000,30.6,22,13,2,13,7,10,32,31.3,22,22,5,17,11,33,17,1,Matches
1045,Lucas Gourna-Douath,FRA,MF,Saint-Étienne,Ligue 1,17,2003,20.0,45,26,22,18,5,21,36,58.3,15,22,3,19,13,58,9,2,Matches
1046,Jeffrey Gouweleeuw,NED,DF,Augsburg,Bundesliga,30,1991,28.6,50,27,33,17,0,22,36,61.1,14,35,18,17,49,99,116,0,Matches
1047,Jonathan Gradit,FRA,DF,Lens,Ligue 1,28,1992,34.1,60,28,24,28,8,25,45,55.6,20,39,27,12,65,125,106,0,Matches
1048,Jens Grahl,GER,GK,Eint Frankfurt,Bundesliga,32,1988,1.0,0,0,0,0,0,0,0,,0,0,0,0,0,0,1,0,Matches
1049,Alberto Grassi,ITA,MF,Cagliari,Serie A,26,1995,24.2,47,26,13,30,4,16,38,42.1,22,27,9,18,63,110,33,1,Matches
1050,Jaume Grau,ESP,MF,Osasuna,La Liga,24,1997,0.0,1,1,1,0,0,0,1,0.0,1,0,0,0,0,1,0,0,Matches
1051,Andrew Gravillon,GLP,DF,Reims,Ligue 1,23,1998,23.7,32,24,19,13,0,17,27,63.0,10,25,15,10,33,65,83,1,Matches
1052,Demarai Gray,JAM,"MF,FW",Everton,Premier League,25,1996,26.0,30,19,13,10,7,10,22,45.5,12,30,2,28,15,45,21,1,Matches
1053,Adrian Grbić,AUT,"FW,MF",Lorient,Ligue 1,24,1996,5.8,2,1,0,2,0,2,6,33.3,4,3,1,2,0,2,7,0,Matches
1054,Ivo Grbić,CRO,GK,Lille,Ligue 1,25,1996,21.0,0,0,0,0,0,0,0,,0,0,0,0,0,0,14,1,Matches
1055,Jack Grealish,ENG,FW,Manchester City,Premier League,25,1995,21.3,18,17,4,10,4,5,13,38.5,8,11,1,10,8,26,7,0,Matches
1056,Etienne Green,ENG,GK,Saint-Étienne,Ligue 1,21,2000,13.3,1,1,1,0,0,0,0,,0,0,0,0,1,2,9,0,Matches
1057,Julian Green,USA,MF,Greuther Fürth,Bundesliga,26,1995,11.7,9,5,0,8,1,2,8,25.0,6,10,2,8,7,16,10,0,Matches
1058,Mason Greenwood,ENG,"FW,MF",Manchester Utd,Premier League,19,2001,14.1,15,9,9,1,5,3,9,33.3,6,5,0,5,1,16,6,0,Matches
1059,Sam Greenwood,ENG,"MF,FW",Leeds United,Premier League,19,2002,2.6,8,5,0,5,3,4,7,57.1,3,3,0,3,2,10,1,0,Matches
1060,Michael Gregoritsch,AUT,"FW,MF",Augsburg,Bundesliga,27,1994,15.5,19,8,4,10,5,2,15,13.3,13,18,2,16,6,25,29,0,Matches
1061,Dominik Greif,SVK,GK,Mallorca,La Liga,24,1997,1.0,0,0,0,0,0,0,0,,0,0,0,0,0,0,0,0,Matches
1062,Clément Grenier,FRA,MF,Mallorca,La Liga,30,1991,0.7,0,0,0,0,0,0,0,,0,1,1,0,0,0,1,0,Matches
1063,Sebastian Griesbeck,GER,"DF,MF",Greuther Fürth,Bundesliga,30,1990,27.1,60,31,38,19,3,39,62,62.9,23,38,13,25,43,103,100,1,Matches
1064,Sebastian Griesbeck,GER,MF,Union Berlin,Bundesliga,30,1990,0.1,1,1,0,1,0,1,1,100.0,0,0,0,0,0,1,0,0,Matches
1065,Antoine Griezmann,FRA,FW,Barcelona,La Liga,30,1991,2.9,13,5,3,10,0,2,6,33.3,4,4,0,4,3,16,5,0,Matches
1066,Antoine Griezmann,FRA,"FW,MF",Atlético Madrid,La Liga,30,1991,18.8,30,14,11,15,4,12,32,37.5,20,18,1,17,7,37,18,0,Matches
1067,Vincenzo Grifo,ITA,"MF,FW",Freiburg,Bundesliga,28,1993,30.8,27,15,9,13,5,9,26,34.6,17,12,2,10,13,40,28,0,Matches
1068,Lennart Grill,GER,GK,Leverkusen,Bundesliga,22,1999,1.0,0,0,0,0,0,0,0,,0,0,0,0,0,0,0,0,Matches
1069,Florian Grillitsch,AUT,"DF,MF",Hoffenheim,Bundesliga,25,1995,16.6,37,19,15,21,1,17,31,54.8,14,18,7,11,29,66,36,1,Matches
1070,Pascal Groß,GER,"MF,DF",Brighton,Premier League,30,1991,22.6,28,15,15,11,2,12,33,36.4,21,34,8,26,18,46,23,0,Matches
1071,Carlos Gruezo,ECU,MF,Augsburg,Bundesliga,26,1995,10.8,22,11,10,10,2,8,21,38.1,13,11,2,9,9,31,15,0,Matches
1072,Vicente Guaita,ESP,GK,Crystal Palace,Premier League,34,1987,29.5,1,0,1,0,0,1,1,100.0,0,0,0,0,1,2,8,1,Matches
1073,Andrés Guardado,MEX,MF,Betis,La Liga,34,1986,15.5,30,13,12,17,1,13,34,38.2,21,18,4,14,21,51,29,1,Matches
1074,Sergi Guardiola,ESP,FW,Rayo Vallecano,La Liga,30,1991,19.0,10,9,3,5,2,1,21,4.8,20,14,2,12,4,14,17,0,Matches
1075,Nemanja Gudelj,SRB,"DF,MF",Sevilla,La Liga,29,1991,11.6,16,7,10,4,2,5,8,62.5,3,14,9,5,22,38,37,0,Matches
1076,Gabriel Gudmundsson,SWE,"DF,MF",Lille,Ligue 1,22,1999,14.9,43,31,24,16,3,17,35,48.6,18,15,3,12,20,63,13,0,Matches
1077,Noah Guede-Nadje,FRA,MF,Angers,Ligue 1,17,2003,0.0,0,0,0,0,0,0,0,,0,0,0,0,0,0,0,0,Matches
1078,Gonçalo Guedes,POR,"FW,MF",Valencia,La Liga,24,1996,29.0,21,14,6,7,8,2,22,9.1,20,14,0,14,9,30,1,0,Matches
1079,Marc Guéhi,ENG,DF,Crystal Palace,Premier League,21,2000,35.8,35,17,24,10,1,15,16,93.8,1,34,26,8,30,65,127,0,Matches
1080,Mattéo Guendouzi,FRA,MF,Marseille,Ligue 1,22,1999,35.0,45,30,10,26,9,13,47,27.7,34,15,1,14,16,61,18,0,Matches
1081,Yanis Guermouche,FRA,"MF,FW",Montpellier,Ligue 1,20,2001,0.1,2,1,0,1,1,1,1,100.0,0,0,0,0,0,2,0,0,Matches
1082,Raphaël Guerreiro,POR,DF,Dortmund,Bundesliga,27,1993,19.9,35,19,19,12,4,16,31,51.6,15,18,2,16,25,60,14,1,Matches
1083,Evann Guessand,CIV,FW,Nice,Ligue 1,20,2001,4.9,9,8,2,5,2,3,8,37.5,5,4,0,4,0,9,1,0,Matches
1084,Ander Guevara,ESP,MF,Real Sociedad,La Liga,24,1997,9.6,18,13,6,10,2,10,17,58.8,7,12,6,6,12,30,8,0,Matches
1085,Lamine Gueye,SEN,"FW,MF",Metz,Ligue 1,23,1998,6.2,5,5,1,1,3,3,7,42.9,4,4,0,4,6,11,1,0,Matches
1086,Pape Gueye,SEN,MF,Marseille,Ligue 1,22,1999,17.0,38,19,15,22,1,16,31,51.6,15,15,3,12,24,62,16,0,Matches
1087,John Guidetti,SWE,"FW,MF",Alavés,La Liga,29,1992,3.1,2,1,0,0,2,0,1,0.0,1,1,0,1,0,2,0,0,Matches
1088,Josuha Guilavogui,FRA,"MF,DF",Bordeaux,Ligue 1,30,1990,14.8,39,16,18,17,4,14,29,48.3,15,16,8,8,36,75,23,0,Matches
1089,Josuha Guilavogui,FRA,"MF,DF",Wolfsburg,Bundesliga,30,1990,10.5,23,14,13,9,1,7,18,38.9,11,11,6,5,25,48,42,0,Matches
1090,Frederic Guilbert,FRA,DF,Strasbourg,Ligue 1,26,1994,28.0,69,39,33,24,12,32,62,51.6,30,37,11,26,55,124,39,0,Matches
1091,Hugo Guillamón,ESP,"MF,DF",Valencia,La Liga,21,2000,26.2,43,27,20,16,7,18,44,40.9,26,26,10,16,30,73,53,1,Matches
1092,Bruno Guimarães,BRA,MF,Newcastle Utd,Premier League,23,1997,11.5,44,23,18,22,4,21,38,55.3,17,25,6,19,9,53,13,0,Matches
1093,Bruno Guimarães,BRA,MF,Lyon,Ligue 1,23,1997,18.2,50,31,20,25,5,23,59,39.0,36,21,4,17,21,71,11,1,Matches
1094,Serhou Guirassy,GUI,FW,Rennes,Ligue 1,25,1996,11.3,4,2,1,2,1,1,7,14.3,6,4,0,4,1,5,8,0,Matches
1095,Péter Gulácsi,HUN,GK,RB Leipzig,Bundesliga,31,1990,33.0,0,0,0,0,0,0,0,,0,0,0,0,1,1,15,1,Matches
1096,Manuel Gulde,GER,DF,Freiburg,Bundesliga,30,1991,13.6,18,10,14,3,1,8,11,72.7,3,16,8,8,17,35,37,0,Matches
1097,Gerard Gumbau,ESP,MF,Elche,La Liga,26,1994,21.0,46,19,22,19,5,22,51,43.1,29,18,4,14,23,69,25,0,Matches
1098,Robert Gumny,POL,DF,Augsburg,Bundesliga,23,1998,25.2,48,29,25,20,3,25,43,58.1,18,24,7,17,28,76,57,3,Matches
1099,İlkay Gündoğan,GER,MF,Manchester City,Premier League,30,1990,20.6,23,9,10,12,1,12,31,38.7,19,11,1,10,15,38,10,0,Matches
1100,Angus Gunn,SCO,GK,Norwich City,Premier League,25,1996,9.0,0,0,0,0,0,0,0,,0,0,0,0,0,0,11,0,Matches
1101,Christian Günter,GER,"DF,MF",Freiburg,Bundesliga,28,1993,34.0,34,20,16,15,3,18,50,36.0,32,23,6,17,17,51,49,2,Matches
1102,Koray Günter,GER,DF,Hellas Verona,Serie A,26,1994,26.8,32,18,19,11,2,16,32,50.0,16,27,21,6,69,101,110,1,Matches
1103,Lasse Günther,GER,DF,Augsburg,Bundesliga,18,2003,1.8,8,5,4,3,1,5,9,55.6,4,0,0,0,2,10,2,0,Matches
1104,Jon Guridi,ESP,MF,Real Sociedad,La Liga,26,1995,2.3,5,3,2,3,0,1,4,25.0,3,3,1,2,3,8,4,0,Matches
1105,Malo Gusto,FRA,DF,Lyon,Ligue 1,18,2003,20.9,55,35,29,21,5,24,40,60.0,16,21,6,15,33,88,41,1,Matches
1106,Raúl Guti,ESP,MF,Elche,La Liga,24,1996,18.1,25,15,7,14,4,10,30,33.3,20,9,3,6,25,50,7,0,Matches
1107,Marcos Mauro López Gutiérrez,ARG,DF,Cádiz,La Liga,30,1991,1.5,1,0,0,1,0,0,2,0.0,2,2,1,1,1,2,9,0,Matches
1108,Miguel Gutiérrez,ESP,DF,Real Madrid,La Liga,20,2001,2.9,7,5,5,0,2,3,5,60.0,2,0,0,0,2,9,2,0,Matches
1109,Albert Guðmundsson,ISL,"FW,MF",Genoa,Serie A,24,1997,6.7,5,3,2,1,2,3,8,37.5,5,2,0,2,5,10,4,0,Matches
1110,Joško Gvardiol,CRO,DF,RB Leipzig,Bundesliga,19,2002,26.8,47,31,28,17,2,22,39,56.4,17,30,11,19,51,98,62,2,Matches
1111,Emmanuel Gyasi,GHA,"FW,MF",Spezia,Serie A,27,1994,33.7,47,30,31,9,7,21,41,51.2,20,22,4,18,16,63,43,1,Matches
1112,Norbert Gyömbér,SVK,DF,Salernitana,Serie A,29,1992,28.5,53,32,40,11,2,33,50,66.0,17,38,24,14,44,97,126,1,Matches
1113,Erling Haaland,NOR,FW,Dortmund,Bundesliga,21,2000,21.2,2,1,0,1,1,0,1,0.0,1,8,1,7,1,3,31,0,Matches
1114,Nicolas Haas,SUI,MF,Empoli,Serie A,25,1996,11.1,35,22,15,10,10,17,39,43.6,22,24,4,20,9,44,17,1,Matches
1115,Janik Haberer,GER,MF,Freiburg,Bundesliga,27,1994,9.1,14,8,5,6,3,7,19,36.8,12,11,4,7,16,30,11,0,Matches
1116,Alexander Hack,GER,DF,Mainz 05,Bundesliga,27,1993,23.0,52,26,35,17,0,29,46,63.0,17,31,14,17,51,103,95,1,Matches
1117,Robin Hack,GER,"FW,MF",Arminia,Bundesliga,22,1998,15.2,14,8,6,5,3,3,21,14.3,18,18,1,17,5,19,4,0,Matches
1118,Munir El Haddadi,MAR,"FW,MF",Sevilla,La Liga,25,1995,5.3,8,4,1,6,1,2,8,25.0,6,7,1,6,5,13,2,0,Matches
1119,André Hahn,GER,"MF,FW",Augsburg,Bundesliga,30,1990,23.3,36,20,9,15,12,17,50,34.0,33,38,5,33,15,51,43,0,Matches
1120,Amadou Haidara,MLI,MF,RB Leipzig,Bundesliga,23,1998,14.7,30,14,11,19,0,17,37,45.9,20,22,6,16,16,46,8,1,Matches
1121,Massadio Haïdara,MLI,DF,Lens,Ligue 1,28,1992,12.0,28,21,18,7,3,15,24,62.5,9,18,4,14,22,50,31,0,Matches
1122,Oualid El Hajjam,MAR,DF,Troyes,Ligue 1,30,1991,11.9,22,11,12,6,4,15,23,65.2,8,12,6,6,22,44,28,0,Matches
1123,Achraf Hakimi,MAR,DF,Paris S-G,Ligue 1,22,1998,27.5,74,51,38,27,9,40,72,55.6,32,26,5,21,28,102,23,2,Matches
1124,Marcel Halstenberg,GER,DF,RB Leipzig,Bundesliga,29,1991,5.6,10,7,6,4,0,6,11,54.5,5,6,0,6,7,17,11,0,Matches
1125,Pierre-Yves Hamel,FRA,"FW,MF",Lorient,Ligue 1,27,1994,0.3,0,0,0,0,0,0,1,0.0,1,0,0,0,2,2,0,0,Matches
1126,Pierre-Yves Hamel,FRA,FW,Clermont Foot,Ligue 1,27,1994,5.8,11,6,0,5,6,5,6,83.3,1,2,1,1,0,11,0,0,Matches
1127,Romain Hamouma,FRA,"FW,MF",Saint-Étienne,Ligue 1,34,1987,9.8,10,7,1,5,4,2,13,15.4,11,8,0,8,4,14,1,0,Matches
1128,Samir Handanović,SVN,GK,Inter,Serie A,37,1984,37.0,1,0,1,0,0,1,2,50.0,1,1,0,1,0,1,6,3,Matches
1129,Grant Hanley,SCO,DF,Norwich City,Premier League,29,1991,32.2,44,25,28,14,2,18,35,51.4,17,56,45,11,56,100,176,2,Matches
1130,Ridgeciano Haps,SUR,DF,Venezia,Serie A,28,1993,22.8,36,20,26,4,6,11,21,52.4,10,34,12,22,29,65,57,1,Matches
1131,Genki Haraguchi,JPN,MF,Union Berlin,Bundesliga,30,1991,19.5,37,20,12,22,3,15,48,31.3,33,25,3,22,26,63,15,0,Matches
1132,Amine Harit,MAR,"FW,MF",Marseille,Ligue 1,24,1997,12.9,18,11,9,9,0,9,17,52.9,8,10,0,10,4,22,2,0,Matches
1133,Varazdat Haroyan,ARM,DF,Cádiz,La Liga,28,1992,16.0,31,21,20,10,1,19,29,65.5,10,22,12,10,15,46,62,0,Matches
1134,Jack Harrison,ENG,"FW,MF",Leeds United,Premier League,24,1996,29.3,57,37,22,22,13,31,76,40.8,45,35,1,34,21,78,19,0,Matches
1135,Abdou Harroui,NED,MF,Sassuolo,Serie A,23,1998,5.0,11,4,4,7,0,8,11,72.7,3,14,0,14,4,15,5,0,Matches
1136,Luis Hartwig,GER,FW,Bochum,Bundesliga,18,2002,0.0,0,0,0,0,0,0,0,,0,0,0,0,0,0,0,0,Matches
1137,Makoto Hasebe,JPN,DF,Eint Frankfurt,Bundesliga,37,1984,13.2,27,12,15,11,1,13,29,44.8,16,24,8,16,22,49,36,0,Matches
1138,Hans Hateboer,NED,"DF,MF",Atalanta,Serie A,27,1994,15.4,22,14,10,8,4,11,26,42.3,15,11,1,10,7,29,20,0,Matches
1139,Kortney Hause,ENG,DF,Aston Villa,Premier League,26,1995,4.4,3,3,2,0,1,3,4,75.0,1,8,5,3,6,9,13,0,Matches
1140,Kai Havertz,GER,"FW,MF",Chelsea,Premier League,22,1999,20.1,17,8,5,7,5,4,14,28.6,10,28,1,27,4,21,32,1,Matches
1141,Isaac Hayden,ENG,"MF,DF",Newcastle Utd,Premier League,26,1995,11.1,28,14,11,14,3,12,29,41.4,17,17,8,9,14,42,24,0,Matches
1142,Eden Hazard,BEL,"FW,MF",Real Madrid,La Liga,30,1991,8.0,6,3,3,2,1,3,7,42.9,4,3,0,3,2,8,0,0,Matches
1143,Thorgan Hazard,BEL,"FW,DF",Dortmund,Bundesliga,28,1993,14.9,23,13,8,10,5,15,40,37.5,25,23,1,22,6,29,4,0,Matches
1144,Jonas Hector,GER,DF,Köln,Bundesliga,31,1990,28.4,76,39,36,26,14,29,74,39.2,45,59,8,51,50,126,68,1,Matches
1145,Hwang Hee-chan,KOR,"FW,MF",Wolves,Premier League,25,1996,20.2,27,13,9,16,2,14,44,31.8,30,10,0,10,13,40,7,1,Matches
1146,Hwang Hee-chan,KOR,FW,RB Leipzig,Bundesliga,25,1996,0.5,0,0,0,0,0,0,0,,0,0,0,0,1,1,0,0,Matches
1147,Silvan Hefti,SUI,DF,Genoa,Serie A,23,1997,14.3,50,30,23,22,5,32,58,55.2,26,20,4,16,20,70,34,1,Matches
1148,Dominique Heintz,GER,DF,Union Berlin,Bundesliga,27,1993,5.2,8,5,5,3,0,3,6,50.0,3,7,4,3,7,15,14,0,Matches
1149,Dominique Heintz,GER,DF,Freiburg,Bundesliga,27,1993,0.3,0,0,0,0,0,0,0,,0,0,0,0,1,1,0,0,Matches
1150,Jordan Henderson,ENG,MF,Liverpool,Premier League,31,1990,28.9,36,20,9,25,2,17,44,38.6,27,25,1,24,23,59,14,0,Matches
1151,Liam Henderson,SCO,MF,Empoli,Serie A,25,1996,22.4,22,13,7,8,7,9,31,29.0,22,14,4,10,9,31,13,0,Matches
1152,Jeff Hendrick,IRL,MF,Newcastle Utd,Premier League,29,1992,0.8,1,1,0,1,0,1,1,100.0,0,0,0,0,0,1,1,0,Matches
1153,Wayne Hennessey,WAL,GK,Burnley,Premier League,34,1987,2.0,0,0,0,0,0,0,0,,0,0,0,0,1,1,0,1,Matches
1154,Benjamin Henrichs,GER,DF,RB Leipzig,Bundesliga,24,1997,12.7,30,21,18,6,6,12,22,54.5,10,16,1,15,19,49,14,0,Matches
1155,Henrique,BRA,DF,Lyon,Ligue 1,27,1994,12.3,13,7,10,1,2,5,16,31.3,11,13,1,12,22,35,14,0,Matches
1156,Dalbert Henrique,BRA,"DF,MF",Cagliari,Serie A,27,1993,23.1,43,23,23,16,4,11,35,31.4,24,28,5,23,24,67,34,0,Matches
1157,Luis Henrique,BRA,"FW,MF",Marseille,Ligue 1,19,2001,7.8,4,3,2,1,1,2,5,40.0,3,2,0,2,5,9,1,0,Matches
1158,Matheus Henrique,BRA,MF,Sassuolo,Serie A,23,1997,12.0,10,3,6,3,1,6,24,25.0,18,14,2,12,7,17,12,1,Matches
1159,Rico Henry,ENG,DF,Brentford,Premier League,24,1997,30.8,28,20,18,8,2,12,34,35.3,22,31,10,21,26,54,76,1,Matches
1160,Thomas Henry,FRA,FW,Venezia,Serie A,26,1994,23.5,9,4,2,3,4,5,13,38.5,8,11,5,6,2,11,25,0,Matches
1161,Christophe Hérelle,MTQ,DF,Brest,Ligue 1,28,1992,21.5,48,28,30,16,2,17,26,65.4,9,20,15,5,44,92,84,1,Matches
1162,Jérôme Hergault,FRA,DF,Lorient,Ligue 1,35,1986,3.9,3,1,1,2,0,2,5,40.0,3,4,1,3,4,7,7,0,Matches
1163,Kike Hermoso,ESP,DF,Betis,La Liga,21,1999,1.0,2,1,2,0,0,2,2,100.0,0,2,1,1,0,2,5,1,Matches
1164,Mario Hermoso,ESP,DF,Atlético Madrid,La Liga,26,1995,20.7,30,15,23,4,3,20,38,52.6,18,18,3,15,29,59,49,2,Matches
1165,Aridane Hernández,ESP,DF,Osasuna,La Liga,32,1989,12.9,12,9,10,2,0,3,13,23.1,10,11,9,2,20,32,71,0,Matches
1166,Lucas Hernández,FRA,DF,Bayern Munich,Bundesliga,25,1996,22.6,50,31,20,24,6,26,42,61.9,16,22,11,11,28,78,54,1,Matches
1167,Luis Hernández,ESP,DF,Cádiz,La Liga,32,1989,15.2,9,5,9,0,0,5,8,62.5,3,5,3,2,16,25,34,0,Matches
1168,Mario Hernández,ESP,"DF,FW",Rayo Vallecano,La Liga,22,1999,4.4,10,4,7,3,0,5,9,55.6,4,1,0,1,4,14,7,0,Matches
1169,Theo Hernández,FRA,DF,Milan,Serie A,23,1997,30.1,53,35,34,14,5,29,40,72.5,11,16,3,13,23,76,29,3,Matches
1170,Hernani,BRA,"MF,FW",Genoa,Serie A,27,1994,7.6,20,10,8,9,3,13,32,40.6,19,17,4,13,13,33,5,1,Matches
1171,Ander Herrera,ESP,MF,Paris S-G,Ligue 1,31,1989,12.1,29,17,7,16,6,14,39,35.9,25,22,8,14,14,43,8,0,Matches
1172,Héctor Herrera,MEX,MF,Atlético Madrid,La Liga,31,1990,9.5,16,8,11,4,1,7,20,35.0,13,13,2,11,12,28,16,0,Matches
1173,Sergio Herrera,ESP,GK,Osasuna,La Liga,28,1993,36.0,3,2,3,0,0,3,6,50.0,3,1,0,1,1,4,18,0,Matches
1174,Yangel Herrera,VEN,MF,Espanyol,La Liga,23,1998,18.3,41,31,19,19,3,18,39,46.2,21,27,5,22,19,60,33,1,Matches
1175,Patrick Herrmann,GER,"DF,FW",Gladbach,Bundesliga,30,1991,8.4,15,7,5,6,4,9,24,37.5,15,10,1,9,6,21,8,0,Matches
1176,Son Heung-min,KOR,"MF,FW",Tottenham,Premier League,29,1992,33.4,15,6,5,7,3,5,23,21.7,18,27,6,21,13,28,8,0,Matches
1177,Daan Heymans,BEL,"MF,FW",Venezia,Serie A,22,1999,2.8,3,1,1,2,0,1,5,20.0,4,7,3,4,4,7,3,0,Matches
1178,Aaron Hickey,SCO,DF,Bologna,Serie A,19,2002,31.3,46,29,24,15,7,20,30,66.7,10,36,13,23,29,75,44,0,Matches
1179,Piero Hincapié,ECU,DF,Leverkusen,Bundesliga,19,2002,19.5,33,23,23,8,2,19,25,76.0,6,34,15,19,33,66,56,2,Matches
1180,Martin Hinteregger,AUT,DF,Eint Frankfurt,Bundesliga,28,1992,24.7,45,28,28,16,1,28,43,65.1,15,36,16,20,42,87,78,3,Matches
1181,Marwin Hitz,SUI,GK,Dortmund,Bundesliga,33,1987,4.5,0,0,0,0,0,0,0,,0,0,0,0,0,0,2,0,Matches
1182,Ki-Jana Hoever,NED,"DF,MF",Wolves,Premier League,19,2002,3.4,10,6,5,5,0,7,12,58.3,5,6,0,6,6,16,8,0,Matches
1183,Nicolas Höfler,GER,MF,Freiburg,Bundesliga,31,1990,28.9,73,42,37,29,7,28,62,45.2,34,50,21,29,46,119,42,0,Matches
1184,Jonas Hofmann,GER,"MF,FW",Gladbach,Bundesliga,29,1992,23.1,30,20,6,17,7,17,42,40.5,25,23,0,23,12,42,10,0,Matches
1185,Rob Holding,ENG,DF,Arsenal,Premier League,25,1995,9.4,13,9,11,1,1,5,6,83.3,1,23,18,5,10,23,42,1,Matches
1186,Lucas Höler,GER,FW,Freiburg,Bundesliga,27,1994,28.7,41,25,10,17,14,13,28,46.4,15,25,4,21,17,58,39,2,Matches
1187,Mason Holgate,ENG,DF,Everton,Premier League,24,1996,23.7,35,18,26,9,0,11,26,42.3,15,25,17,8,26,61,95,1,Matches
1188,Gerrit Holtmann,PHI,"FW,MF",Bochum,Bundesliga,26,1995,20.4,15,9,5,3,7,6,22,27.3,16,26,2,24,8,23,6,0,Matches
1189,Martin Hongla,CMR,MF,Hellas Verona,Serie A,23,1998,7.2,14,8,5,6,3,4,8,50.0,4,6,2,4,4,18,16,1,Matches
1190,Franck Honorat,FRA,"FW,MF",Brest,Ligue 1,24,1996,32.2,54,38,25,13,16,27,47,57.4,20,24,2,22,15,69,25,0,Matches
1191,Justin Hoogma,NED,DF,Greuther Fürth,Bundesliga,23,1998,3.0,6,5,4,2,0,4,6,66.7,2,5,5,0,4,10,4,0,Matches
1192,Sydney van Hooijdonk,NED,"FW,MF",Bologna,Serie A,21,2000,0.4,0,0,0,0,0,0,1,0.0,1,1,0,1,0,0,0,0,Matches
1193,Matthew Hoppe,USA,"FW,MF",Mallorca,La Liga,20,2001,1.5,1,0,0,0,1,0,3,0.0,3,0,0,0,0,1,0,0,Matches
1194,Jannes Horn,GER,DF,Köln,Bundesliga,24,1997,5.3,6,4,4,2,0,4,8,50.0,4,1,1,0,3,9,9,0,Matches
1195,Timo Horn,GER,GK,Köln,Bundesliga,28,1993,13.0,0,0,0,0,0,0,1,0.0,1,0,0,0,0,0,5,0,Matches
1196,Fraser Hornby,SCO,"FW,MF",Reims,Ligue 1,21,1999,3.9,3,1,1,2,0,0,2,0.0,2,3,0,3,4,7,5,0,Matches
1197,Cédric Hountondji,BEN,DF,Clermont Foot,Ligue 1,27,1994,22.6,33,17,20,12,1,16,24,66.7,8,23,12,11,34,67,76,0,Matches
1198,Lukáš Hrádecký,FIN,GK,Leverkusen,Bundesliga,31,1989,32.0,1,1,1,0,0,1,1,100.0,0,0,0,0,0,1,10,1,Matches
1199,Branimir Hrgota,SWE,FW,Greuther Fürth,Bundesliga,28,1993,30.9,46,29,10,31,5,21,72,29.2,51,27,1,26,11,57,3,1,Matches
1200,Petko Hristov,BUL,DF,Spezia,Serie A,22,1999,13.9,17,10,11,6,0,10,16,62.5,6,29,23,6,19,36,47,0,Matches
1201,Ajdin Hrustic,AUS,MF,Eint Frankfurt,Bundesliga,25,1996,10.7,16,11,5,7,4,11,32,34.4,21,18,1,17,10,26,7,0,Matches
1202,Timo Hübers,GER,DF,Köln,Bundesliga,25,1996,19.3,45,27,28,17,0,27,45,60.0,18,31,19,12,52,97,95,0,Matches
1203,Benjamin Hübner,GER,DF,Hoffenheim,Bundesliga,32,1989,4.2,9,5,0,7,2,3,5,60.0,2,2,2,0,9,18,7,0,Matches
1204,Callum Hudson-Odoi,ENG,"MF,FW",Chelsea,Premier League,20,2000,10.7,14,10,5,6,3,8,23,34.8,15,8,0,8,2,16,6,1,Matches
1205,Will Hughes,ENG,MF,Crystal Palace,Premier League,26,1995,11.7,29,14,10,16,3,7,16,43.8,9,13,7,6,8,37,10,0,Matches
1206,Mats Hummels,GER,DF,Dortmund,Bundesliga,32,1988,19.6,34,22,20,13,1,20,36,55.6,16,18,13,5,32,66,66,1,Matches
1207,Elseid Hysaj,ALB,DF,Lazio,Serie A,27,1994,22.5,46,30,25,17,4,29,45,64.4,16,18,6,12,24,70,34,1,Matches
1208,Suk Hyun-jun,KOR,"FW,MF",Troyes,Ligue 1,30,1991,1.7,0,0,0,0,0,0,0,,0,2,0,2,0,0,2,0,Matches
1209,Pierre Højbjerg,DEN,MF,Tottenham,Premier League,25,1995,35.5,78,45,31,38,9,38,85,44.7,47,61,13,48,48,126,54,0,Matches
1210,Iago,BRA,DF,Augsburg,Bundesliga,24,1997,24.2,49,29,25,19,5,15,34,44.1,19,28,6,22,27,76,62,0,Matches
1211,Robert Ibáñez,ESP,"MF,FW",Osasuna,La Liga,28,1993,1.0,3,3,2,0,1,1,2,50.0,1,1,0,1,1,4,1,0,Matches
1212,Roger Ibanez,BRA,DF,Roma,Serie A,22,1998,32.1,54,32,31,19,4,26,43,60.5,17,26,7,19,62,116,104,2,Matches
1213,Vicente Iborra,ESP,MF,Villarreal,La Liga,33,1988,11.5,19,10,9,7,3,12,24,50.0,12,11,5,6,11,30,27,1,Matches
1214,Zlatan Ibrahimović,SWE,FW,Milan,Serie A,39,1981,11.3,0,0,0,0,0,0,2,0.0,2,2,1,1,3,3,9,0,Matches
1215,Mauro Icardi,ARG,FW,Paris S-G,Ligue 1,28,1993,11.4,5,3,1,3,1,3,7,42.9,4,3,0,3,5,10,12,0,Matches
1216,Adam Idah,IRL,"FW,MF",Norwich City,Premier League,20,2001,6.9,9,6,2,5,2,2,3,66.7,1,4,2,2,3,12,7,0,Matches
1217,Oussama Idrissi,MAR,"MF,FW",Sevilla,La Liga,25,1996,1.4,1,0,0,1,0,0,1,0.0,1,1,0,1,1,2,1,0,Matches
1218,Oussama Idrissi,MAR,MF,Cádiz,La Liga,25,1996,10.0,8,4,3,4,1,4,15,26.7,11,8,0,8,3,11,5,0,Matches
1219,Iglesias,ESP,DF,Getafe,La Liga,23,1998,8.0,19,10,11,8,0,7,17,41.2,10,8,2,6,10,29,28,0,Matches
1220,Borja Iglesias,ESP,FW,Betis,La Liga,28,1993,17.5,6,4,1,2,3,0,8,0.0,8,11,1,10,4,10,7,0,Matches
1221,Jonathan Iglesias,URU,MF,Clermont Foot,Ligue 1,32,1988,6.4,18,11,6,10,2,10,18,55.6,8,8,2,6,5,23,2,1,Matches
1222,Juan Ignacio Ramírez,URU,FW,Saint-Étienne,Ligue 1,24,1997,1.4,2,1,0,1,1,0,0,,0,0,0,0,0,2,0,0,Matches
1223,Igor,BRA,DF,Fiorentina,Serie A,23,1998,24.9,53,31,34,16,3,30,40,75.0,10,37,19,18,31,84,46,4,Matches
1224,Kelechi Iheanacho,NGA,FW,Leicester City,Premier League,24,1996,14.0,10,7,2,5,3,3,14,21.4,11,19,0,19,4,14,10,0,Matches
1225,Danylo Ihnatenko,UKR,MF,Bordeaux,Ligue 1,24,1997,7.7,17,9,8,7,2,10,24,41.7,14,9,2,7,6,23,17,1,Matches
1226,Jonathan Ikone,FRA,FW,Fiorentina,Serie A,23,1998,7.2,7,3,2,3,2,3,10,30.0,7,10,2,8,1,8,2,0,Matches
1227,Jonathan Ikone,FRA,"MF,FW",Lille,Ligue 1,23,1998,11.8,11,3,6,4,1,4,11,36.4,7,13,1,12,5,16,4,0,Matches
1228,Ivan Ilić,SRB,MF,Hellas Verona,Serie A,20,2001,28.1,39,18,16,19,4,20,54,37.0,34,34,12,22,22,61,55,0,Matches
1229,Josip Iličić,SVN,"MF,FW",Atalanta,Serie A,33,1988,9.3,7,7,3,2,2,4,17,23.5,13,6,1,5,3,10,1,0,Matches
1230,Asier Illarramendi,ESP,MF,Real Sociedad,La Liga,31,1990,4.2,9,5,5,3,1,1,10,10.0,9,5,1,4,4,13,12,0,Matches
1231,Stefan Ilsanker,AUT,"DF,MF",Eint Frankfurt,Bundesliga,32,1989,3.0,14,8,7,6,1,5,10,50.0,5,6,2,4,6,20,15,1,Matches
1232,Ciro Immobile,ITA,FW,Lazio,Serie A,31,1990,30.1,10,5,4,4,2,1,15,6.7,14,7,1,6,3,13,16,0,Matches
1233,Burak İnce,TUR,FW,Arminia,Bundesliga,17,2004,1.5,1,1,1,0,0,1,2,50.0,1,1,0,1,0,1,0,0,Matches
1234,Danny Ings,ENG,FW,Aston Villa,Premier League,29,1992,21.1,23,16,2,16,5,13,37,35.1,24,31,2,29,6,29,22,0,Matches
1235,Marcus Ingvartsen,DEN,MF,Union Berlin,Bundesliga,25,1996,1.4,0,0,0,0,0,0,2,0.0,2,0,0,0,2,2,1,0,Matches
1236,Marcus Ingvartsen,DEN,"FW,MF",Mainz 05,Bundesliga,25,1996,7.6,3,2,2,0,1,3,9,33.3,6,6,0,6,6,9,7,1,Matches
1237,Bonke Innocent,NGA,MF,Lorient,Ligue 1,25,1996,9.7,27,16,10,16,1,11,26,42.3,15,11,3,8,16,43,14,0,Matches
1238,Lorenzo Insigne,ITA,FW,Napoli,Serie A,30,1991,25.4,23,14,8,12,3,8,44,18.2,36,30,1,29,20,43,3,1,Matches
1239,Nikita Iosifov,RUS,MF,Villarreal,La Liga,20,2001,0.0,0,0,0,0,0,0,0,,0,0,0,0,0,0,0,0,Matches
1240,Tim Iroegbunam,ENG,MF,Aston Villa,Premier League,18,2003,1.0,5,4,2,3,0,1,1,100.0,0,0,0,0,2,7,1,0,Matches
1241,Alexander Isak,SWE,FW,Real Sociedad,La Liga,21,1999,23.8,7,4,1,3,3,2,12,16.7,10,14,2,12,3,10,10,0,Matches
1242,Isco,ESP,"MF,FW",Real Madrid,La Liga,29,1992,3.7,9,5,4,4,1,5,12,41.7,7,1,0,1,2,11,1,0,Matches
1243,Wilson Isidor,FRA,"FW,MF",Monaco,Ligue 1,20,2000,0.6,0,0,0,0,0,0,4,0.0,4,1,0,1,0,0,0,0,Matches
1244,Ardian Ismajli,ALB,DF,Empoli,Serie A,24,1996,14.1,13,9,8,4,1,5,14,35.7,9,21,11,10,24,37,80,0,Matches
1245,Hiroki Ito,JPN,DF,Stuttgart,Bundesliga,22,1999,26.1,43,31,21,19,3,25,43,58.1,18,40,19,21,53,96,95,0,Matches
1246,Cedric Itten,SUI,FW,Greuther Fürth,Bundesliga,24,1996,7.1,5,2,1,2,2,1,6,16.7,5,3,0,3,2,7,4,0,Matches
1247,Gian-Luca Itter,GER,DF,Greuther Fürth,Bundesliga,22,1999,16.2,44,26,30,11,3,21,38,55.3,17,24,9,15,13,57,51,0,Matches
1248,Alex Iwobi,NGA,"MF,DF",Everton,Premier League,25,1996,22.6,40,19,23,12,5,21,52,40.4,31,39,3,36,20,60,25,2,Matches
1249,Armando Izzo,ITA,DF,Torino,Serie A,29,1992,5.8,16,9,14,2,0,9,11,81.8,2,5,4,1,17,33,21,0,Matches
1250,Nicolas Jackson,SEN,"FW,MF",Villarreal,La Liga,20,2001,1.8,2,0,1,0,1,0,0,,0,0,0,0,1,3,1,0,Matches
1251,Lee Jae-sung,KOR,"MF,FW",Mainz 05,Bundesliga,28,1992,16.0,30,12,8,14,8,6,27,22.2,21,20,2,18,18,48,18,0,Matches
1252,Paul Jaeckel,GER,DF,Union Berlin,Bundesliga,23,1998,22.7,51,29,27,24,0,29,51,56.9,22,34,10,24,57,108,81,0,Matches
1253,Mato Jajalo,BIH,MF,Udinese,Serie A,33,1988,7.0,24,14,14,7,3,11,23,47.8,12,7,0,7,11,35,5,0,Matches
1254,Kristijan Jakić,CRO,MF,Eint Frankfurt,Bundesliga,24,1997,20.9,37,22,10,21,6,15,62,24.2,47,33,3,30,21,58,25,1,Matches
1255,Ismail Jakobs,SEN,"DF,FW",Monaco,Ligue 1,21,1999,13.4,32,16,14,15,3,16,35,45.7,19,16,1,15,17,49,31,0,Matches
1256,Marin Jakoliš,CRO,FW,Angers,Ligue 1,24,1996,2.5,2,1,0,1,1,0,6,0.0,6,0,0,0,1,3,0,0,Matches
1257,Abdel Jalil Medioub,ALG,DF,Bordeaux,Ligue 1,23,1997,6.9,9,5,5,3,1,3,4,75.0,1,8,4,4,12,21,34,0,Matches
1258,Daniel James,WAL,FW,Manchester Utd,Premier League,23,1997,1.4,2,1,0,2,0,0,0,,0,2,0,2,0,2,1,0,Matches
1259,Daniel James,WAL,"FW,MF",Leeds United,Premier League,23,1997,26.3,24,14,8,8,8,10,23,43.5,13,18,1,17,8,32,12,0,Matches
1260,Reece James,ENG,DF,Chelsea,Premier League,21,1999,20.7,33,25,14,18,1,9,22,40.9,13,20,2,18,17,50,22,0,Matches
1261,Vitaly Janelt,GER,MF,Brentford,Premier League,23,1998,25.5,61,32,26,27,8,27,53,50.9,26,23,7,16,28,89,35,0,Matches
1262,Jakub Jankto,CZE,"DF,MF",Getafe,La Liga,25,1996,6.5,11,7,5,5,1,10,17,58.8,7,4,0,4,4,15,7,0,Matches
1263,Pontus Jansson,SWE,DF,Brentford,Premier League,30,1991,36.9,40,21,32,8,0,22,34,64.7,12,37,27,10,52,92,187,0,Matches
1264,Tony Jantschke,GER,DF,Gladbach,Bundesliga,31,1990,2.5,6,5,2,4,0,3,6,50.0,3,3,2,1,5,11,8,0,Matches
1265,Adnan Januzaj,BEL,"FW,MF",Real Sociedad,La Liga,26,1995,18.1,17,11,5,8,4,9,24,37.5,15,15,3,12,12,29,15,0,Matches
1266,Léo Jardim,BRA,GK,Lille,Ligue 1,26,1995,17.0,0,0,0,0,0,0,0,,0,0,0,0,1,1,10,0,Matches
1267,Paweł Jaroszyński,POL,DF,Salernitana,Serie A,26,1994,5.7,10,5,7,3,0,5,7,71.4,2,4,0,4,10,20,19,0,Matches
1268,Jason,ESP,"MF,FW",Alavés,La Liga,27,1994,7.5,11,7,6,4,1,7,20,35.0,13,7,0,7,7,18,5,0,Matches
1269,Jason,ESP,"MF,DF",Valencia,La Liga,27,1994,0.8,4,1,2,1,1,0,1,0.0,1,2,0,2,1,5,1,0,Matches
1270,Dennis Jastrzembski,POL,"DF,FW",Hertha BSC,Bundesliga,21,2000,2.5,2,1,1,1,0,2,8,25.0,6,1,0,1,5,7,3,0,Matches
1271,Luis Javier Suárez,COL,FW,Granada,La Liga,23,1997,31.6,26,14,9,9,8,8,27,29.6,19,25,3,22,6,32,23,0,Matches
1272,Corentin Jean,FRA,"FW,MF",Lens,Ligue 1,26,1995,2.8,9,6,4,4,1,3,6,50.0,3,5,0,5,1,10,0,0,Matches
1273,Jemerson,BRA,DF,Metz,Ligue 1,28,1992,13.4,37,25,30,7,0,18,26,69.2,8,23,8,15,25,62,33,1,Matches
1274,Fredrik Jensen,FIN,"MF,FW",Augsburg,Bundesliga,23,1997,4.6,5,4,1,3,1,4,7,57.1,3,5,1,4,2,7,4,0,Matches
1275,Mathias Jensen,DEN,MF,Brentford,Premier League,25,1996,17.8,33,18,12,16,5,22,63,34.9,41,32,3,29,22,55,13,0,Matches
1276,Moritz Jenz,GER,DF,Lorient,Ligue 1,22,1999,15.3,26,12,18,6,2,11,24,45.8,13,19,11,8,28,54,55,0,Matches
1277,Gabriel Jesus,BRA,FW,Manchester City,Premier League,24,1997,20.9,18,12,2,4,12,6,26,23.1,20,18,0,18,15,33,8,0,Matches
1278,Juan Jesus,BRA,DF,Napoli,Serie A,30,1991,14.2,25,17,14,11,0,12,18,66.7,6,21,16,5,9,34,34,0,Matches
1279,Álvaro Jiménez,ESP,"MF,FW",Cádiz,La Liga,26,1995,2.6,6,3,3,2,1,4,7,57.1,3,3,0,3,3,9,0,0,Matches
1280,Raúl Jiménez,MEX,FW,Wolves,Premier League,30,1991,29.2,29,14,6,16,7,6,30,20.0,24,31,5,26,13,42,26,0,Matches
1281,João Pedro,BRA,"FW,MF",Watford,Premier League,19,2001,18.3,20,14,7,8,5,6,23,26.1,17,23,3,20,15,35,17,0,Matches
1282,Joaquín,ESP,"FW,MF",Betis,La Liga,40,1981,5.2,6,2,4,2,0,3,8,37.5,5,5,2,3,3,9,10,0,Matches
1283,Joelinton,BRA,"MF,FW",Newcastle Utd,Premier League,24,1996,28.4,72,38,30,33,9,26,61,42.6,35,46,11,35,34,106,50,2,Matches
1284,Jofre,ESP,"MF,DF",Espanyol,La Liga,20,2001,0.2,1,1,0,0,1,1,1,100.0,0,0,0,0,0,1,0,0,Matches
1285,Marco John,GER,DF,Hoffenheim,Bundesliga,19,2002,0.5,0,0,0,0,0,0,1,0.0,1,1,0,1,1,1,1,0,Matches
1286,Dennis Johnsen,NOR,"FW,MF",Venezia,Serie A,23,1998,16.1,14,10,8,4,2,6,18,33.3,12,14,1,13,5,19,3,0,Matches
1287,Ben Johnson,ENG,DF,West Ham,Premier League,21,2000,15.5,33,16,15,15,3,21,28,75.0,7,16,8,8,22,55,55,0,Matches
1288,Curtis Jones,ENG,MF,Liverpool,Premier League,20,2001,9.5,11,9,3,6,2,1,10,10.0,9,4,0,4,6,17,4,0,Matches
1289,Phil Jones,ENG,DF,Manchester Utd,Premier League,29,1992,1.8,5,5,3,1,1,2,3,66.7,1,4,4,0,3,8,8,0,Matches
1290,Frenkie de Jong,NED,MF,Barcelona,La Liga,24,1997,27.5,35,19,12,18,5,12,23,52.2,11,19,5,14,20,55,16,0,Matches
1291,Luuk de Jong,NED,FW,Barcelona,La Liga,30,1990,7.3,9,7,1,5,3,1,2,50.0,1,4,0,4,0,9,12,0,Matches
1292,Joan Jordán,ESP,MF,Sevilla,La Liga,27,1994,27.9,61,30,22,31,8,28,65,43.1,37,27,6,21,30,91,18,1,Matches
1293,Kaio Jorge,BRA,"MF,FW",Juventus,Serie A,19,2002,1.3,2,1,0,2,0,1,3,33.3,2,1,0,1,0,2,2,0,Matches
1294,Jorginho,ITA,MF,Chelsea,Premier League,29,1991,25.3,64,33,27,31,6,29,83,34.9,54,27,4,23,36,100,21,1,Matches
1295,Josan,ESP,"DF,MF",Elche,La Liga,31,1989,13.5,36,22,23,9,4,26,44,59.1,18,11,4,7,10,46,21,0,Matches
1296,Willian José,BRA,FW,Betis,La Liga,29,1991,17.8,15,13,2,10,3,2,8,25.0,6,10,2,8,3,18,16,0,Matches
1297,Joselu,ESP,FW,Alavés,La Liga,31,1990,34.7,16,11,1,9,6,7,25,28.0,18,21,4,17,7,23,45,0,Matches
1298,Josema,ESP,DF,Elche,La Liga,25,1996,2.0,3,2,1,1,1,0,2,0.0,2,1,1,0,0,3,11,0,Matches
1299,Lenny Joseph,FRA,"FW,MF",Metz,Ligue 1,20,2000,1.7,2,1,1,1,0,0,0,,0,3,0,3,0,2,0,0,Matches
1300,Diogo Jota,POR,FW,Liverpool,Premier League,24,1996,26.3,39,18,12,18,9,13,55,23.6,42,19,2,17,6,45,6,0,Matches
1301,Stevan Jovetić,MNE,"FW,MF",Hertha BSC,Bundesliga,31,1989,11.3,5,2,0,2,3,1,6,16.7,5,3,0,3,1,6,6,0,Matches
1302,Luka Jović,SRB,FW,Real Madrid,La Liga,23,1997,4.1,1,1,0,1,0,0,1,0.0,1,3,0,3,1,2,4,0,Matches
1303,Miguel Juan Llambrich,ESP,DF,Espanyol,La Liga,25,1996,0.8,2,2,1,1,0,0,0,,0,1,0,1,0,2,5,0,Matches
1304,José Juan Macías,MEX,"FW,MF",Getafe,La Liga,21,1999,2.2,1,0,0,0,1,0,1,0.0,1,1,0,1,1,2,0,0,Matches
1305,Juanmi,ESP,FW,Betis,La Liga,28,1993,23.7,39,25,11,19,9,19,49,38.8,30,24,1,23,9,48,10,1,Matches
1306,Gideon Jung,GER,DF,Greuther Fürth,Bundesliga,26,1994,1.6,3,1,1,2,0,2,4,50.0,2,1,1,0,2,5,5,0,Matches
1307,Flavio Junior Bianchi,ITA,"FW,MF",Genoa,Serie A,21,2000,3.5,2,2,1,0,1,0,2,0.0,2,0,0,0,0,2,0,0,Matches
1308,Lago Junior,CIV,"FW,MF",Mallorca,La Liga,30,1990,2.0,3,2,3,0,0,3,5,60.0,2,0,0,0,2,5,2,0,Matches
1309,Hamed Junior Traorè,CIV,"FW,MF",Sassuolo,Serie A,21,2000,19.7,32,18,8,14,10,10,46,21.7,36,22,2,20,12,44,6,1,Matches
1310,Vinicius Júnior,BRA,FW,Real Madrid,La Liga,21,2000,29.9,46,24,23,19,4,15,50,30.0,35,25,0,25,6,52,6,0,Matches
1311,James Justin,ENG,DF,Leicester City,Premier League,23,1998,11.1,22,13,11,8,3,7,15,46.7,8,16,4,12,17,39,34,0,Matches
1312,Ferran Jutglà,ESP,FW,Barcelona,La Liga,22,1999,3.3,2,1,0,1,1,0,1,0.0,1,2,0,2,1,3,1,0,Matches
1313,Jens Jønsson,DEN,MF,Cádiz,La Liga,28,1993,14.5,40,29,22,17,1,17,35,48.6,18,17,7,10,34,74,32,0,Matches
1314,Mathias Jørgensen,DEN,DF,Brentford,Premier League,31,1990,5.8,10,4,3,5,2,7,10,70.0,3,6,1,5,10,20,13,0,Matches
1315,Ozan Kabak,TUR,DF,Norwich City,Premier League,21,2000,10.2,10,5,4,6,0,5,9,55.6,4,19,11,8,16,26,26,0,Matches
1316,Christian Kabasele,BEL,DF,Watford,Premier League,30,1991,13.3,11,5,10,1,0,7,10,70.0,3,20,16,4,14,25,67,1,Matches
1317,Issa Kaboré,BFA,"DF,MF",Troyes,Ligue 1,20,2001,25.0,45,22,22,14,9,20,38,52.6,18,27,2,25,20,65,38,1,Matches
1318,Anton Kade,GER,"FW,MF",Hertha BSC,Bundesliga,17,2004,0.9,4,2,3,1,0,2,8,25.0,6,3,0,3,3,7,1,0,Matches
1319,Pavel Kadeřábek,CZE,"DF,MF",Hoffenheim,Bundesliga,29,1992,13.3,11,10,6,3,2,5,16,31.3,11,18,6,12,13,24,22,0,Matches
1320,Tino Kadewere,ZIM,FW,Lyon,Ligue 1,25,1996,5.6,7,5,2,2,3,4,13,30.8,9,7,0,7,4,11,1,1,Matches
1321,Florian Kainz,AUT,"MF,FW",Köln,Bundesliga,28,1992,25.8,41,26,9,25,7,23,51,45.1,28,27,3,24,32,73,24,0,Matches
1322,Gaël Kakuta,COD,"MF,FW",Lens,Ligue 1,30,1991,18.6,22,14,2,13,7,4,20,20.0,16,10,0,10,4,26,3,0,Matches
1323,Sasa Kalajdzic,AUT,FW,Stuttgart,Bundesliga,24,1997,13.6,10,6,2,5,3,3,11,27.3,8,5,0,5,2,12,14,0,Matches
1324,Arnaud Kalimuendo,FRA,FW,Lens,Ligue 1,19,2002,23.9,9,8,1,3,5,2,7,28.6,5,6,1,5,8,17,0,0,Matches
1325,Arnaud Kalimuendo,FRA,FW,Paris S-G,Ligue 1,19,2002,0.1,0,0,0,0,0,0,0,,0,0,0,0,0,0,0,0,Matches
1326,Nikola Kalinić,CRO,FW,Hellas Verona,Serie A,33,1988,4.5,2,0,0,1,1,1,2,50.0,1,2,0,2,0,2,2,0,Matches
1327,Yayah Kallon,SLE,"FW,MF",Genoa,Serie A,20,2001,7.1,15,11,5,6,4,3,11,27.3,8,7,1,6,1,16,5,0,Matches
1328,Samuel Kalu,NGA,FW,Watford,Premier League,23,1997,2.5,2,2,0,2,0,1,1,100.0,0,2,0,2,3,5,3,0,Matches
1329,Samuel Kalu,NGA,"FW,MF",Bordeaux,Ligue 1,23,1997,3.6,8,5,3,4,1,2,5,40.0,3,2,0,2,3,11,1,0,Matches
1330,Pierre Kalulu,FRA,DF,Milan,Serie A,21,2000,21.6,61,36,36,21,4,17,22,77.3,5,36,15,21,26,87,54,0,Matches
1331,Daichi Kamada,JPN,MF,Eint Frankfurt,Bundesliga,24,1996,23.8,40,21,7,26,7,11,40,27.5,29,18,0,18,8,48,10,0,Matches
1332,Boubacar Kamara,FRA,"MF,DF",Marseille,Ligue 1,21,1999,30.9,68,38,27,36,5,26,47,55.3,21,29,10,19,46,114,44,1,Matches
1333,Hassane Kamara,CIV,DF,Watford,Premier League,27,1994,18.0,53,34,31,16,6,27,43,62.8,16,20,4,16,69,122,67,0,Matches
1334,Hassane Kamara,CIV,"MF,DF",Nice,Ligue 1,27,1994,6.0,13,10,4,6,3,5,8,62.5,3,10,2,8,9,22,4,0,Matches
1335,Dimitrije Kamenović,SRB,DF,Lazio,Serie A,21,2000,0.5,1,1,1,0,0,1,1,100.0,0,0,0,0,2,3,1,0,Matches
1336,Kevin Kampl,SVN,MF,RB Leipzig,Bundesliga,30,1990,21.1,41,19,16,20,5,10,42,23.8,32,24,5,19,24,65,17,0,Matches
1337,Jean-Armel Kana-Biyik,CMR,DF,Metz,Ligue 1,32,1989,7.4,10,6,8,2,0,4,9,44.4,5,11,4,7,16,26,22,1,Matches
1338,Nordine Kandil,FRA,"MF,FW",Strasbourg,Ligue 1,19,2001,1.0,2,1,2,0,0,1,1,100.0,0,1,1,0,0,2,0,0,Matches
1339,Harry Kane,ENG,FW,Tottenham,Premier League,28,1993,35.9,15,5,2,10,3,7,18,38.9,11,26,8,18,3,18,39,0,Matches
1340,Lee Kang-in,KOR,"MF,FW",Mallorca,La Liga,20,2001,15.7,13,6,2,9,2,5,29,17.2,24,11,1,10,5,18,7,0,Matches
1341,N'Golo Kanté,FRA,MF,Chelsea,Premier League,30,1991,19.7,59,31,20,27,12,25,40,62.5,15,37,2,35,31,90,8,0,Matches
1342,Stefanos Kapino,GRE,GK,Arminia,Bundesliga,27,1994,1.0,0,0,0,0,0,0,0,,0,0,0,0,0,0,0,0,Matches
1343,Atakan Karazor,GER,MF,Stuttgart,Bundesliga,24,1996,21.1,48,24,18,27,3,18,36,50.0,18,37,14,23,34,82,47,0,Matches
1344,Rick Karsdorp,NED,"DF,FW",Roma,Serie A,26,1995,32.0,53,38,33,13,7,28,50,56.0,22,22,5,17,34,87,26,1,Matches
1345,Denso Kasius,NED,"DF,FW",Bologna,Serie A,18,2002,2.0,9,7,5,3,1,2,5,40.0,3,4,0,4,3,12,4,0,Matches
1346,Grigoris Kastanos,CYP,"MF,FW",Salernitana,Serie A,23,1998,15.0,30,19,9,19,2,7,23,30.4,16,21,5,16,22,52,8,0,Matches
1347,Silas Katompa,COD,"FW,MF",Stuttgart,Bundesliga,22,1998,3.1,5,4,4,0,1,3,7,42.9,4,5,0,5,2,7,1,0,Matches
1348,Noah Katterbach,GER,DF,Köln,Bundesliga,20,2001,0.2,1,1,1,0,0,1,1,100.0,0,0,0,0,0,1,1,0,Matches
1349,Eiji Kawashima,JPN,GK,Strasbourg,Ligue 1,38,1983,1.0,0,0,0,0,0,0,0,,0,0,0,0,0,0,0,0,Matches
1350,Edo Kayembe,COD,MF,Watford,Premier League,23,1998,8.9,21,13,11,9,1,8,16,50.0,8,6,1,5,9,30,13,0,Matches
1351,Moise Kean,ITA,FW,Everton,Premier League,21,2000,0.0,0,0,0,0,0,0,0,,0,0,0,0,0,0,0,0,Matches
1352,Moise Kean,ITA,FW,Juventus,Serie A,21,2000,12.2,9,4,2,5,2,6,16,37.5,10,5,0,5,3,12,8,1,Matches
1353,Michael Keane,ENG,DF,Everton,Premier League,28,1993,31.0,46,25,32,13,1,28,45,62.2,17,33,28,5,62,108,128,2,Matches
1354,Ilan Kebbal,ALG,"MF,FW",Reims,Ligue 1,23,1998,19.7,31,15,13,10,8,12,44,27.3,32,16,0,16,13,44,3,0,Matches
1355,Wajdi Kechrida,TUN,"DF,MF",Salernitana,Serie A,25,1995,10.6,9,6,6,3,0,8,13,61.5,5,10,2,8,8,17,15,0,Matches
1356,Thilo Kehrer,GER,DF,Paris S-G,Ligue 1,24,1996,16.8,21,14,9,11,1,9,21,42.9,12,19,11,8,24,45,29,0,Matches
1357,Habib Keita,MLI,"MF,FW",Lyon,Ligue 1,19,2002,0.1,0,0,0,0,0,0,0,,0,0,0,0,0,0,0,0,Matches
1358,Naby Keïta,GUI,MF,Liverpool,Premier League,26,1995,13.0,46,23,17,19,10,26,42,61.9,16,33,2,31,14,60,8,0,Matches
1359,Yannik Keitel,GER,MF,Freiburg,Bundesliga,21,2000,5.6,11,4,5,4,2,5,15,33.3,10,7,1,6,1,12,8,0,Matches
1360,Caoimhín Kelleher,IRL,GK,Liverpool,Premier League,22,1998,2.0,1,1,1,0,0,1,1,100.0,0,0,0,0,0,1,1,0,Matches
1361,Marc-Oliver Kempf,GER,DF,Hertha BSC,Bundesliga,26,1995,11.7,10,9,9,1,0,5,14,35.7,9,14,7,7,25,35,49,1,Matches
1362,Marc-Oliver Kempf,GER,DF,Stuttgart,Bundesliga,26,1995,9.3,13,8,7,4,2,3,10,30.0,7,16,14,2,16,29,26,2,Matches
1363,Kenedy,BRA,DF,Chelsea,Premier League,25,1996,0.6,5,2,1,2,2,2,3,66.7,1,0,0,0,0,5,0,0,Matches
1364,Jonjoe Kenny,ENG,DF,Everton,Premier League,24,1997,11.3,17,7,11,6,0,13,21,61.9,8,8,1,7,20,37,31,0,Matches
1365,Dimitrios Keramitsis,GRE,MF,Roma,Serie A,17,2004,0.0,0,0,0,0,0,0,0,,0,0,0,0,0,0,0,0,Matches
1366,Franck Kessié,CIV,MF,Milan,Serie A,24,1996,25.6,41,23,12,24,5,17,26,65.4,9,39,10,29,23,64,22,0,Matches
1367,Saîf-Eddine Khaoui,TUN,"MF,FW",Clermont Foot,Ligue 1,26,1995,10.3,19,10,5,10,4,9,18,50.0,9,9,0,9,14,33,5,0,Matches
1368,Wahbi Khazri,TUN,"FW,MF",Saint-Étienne,Ligue 1,30,1991,24.7,33,18,7,17,9,9,34,26.5,25,21,0,21,12,45,7,0,Matches
1369,Rani Khedira,GER,MF,Union Berlin,Bundesliga,27,1994,30.6,75,38,25,42,8,32,66,48.5,34,21,8,13,50,125,27,1,Matches
1370,Kiké,ESP,FW,Osasuna,La Liga,31,1989,20.7,11,7,3,4,4,3,23,13.0,20,10,1,9,3,14,12,0,Matches
1371,Luca Kilian,GER,FW,Mainz 05,Bundesliga,21,1999,0.0,0,0,0,0,0,0,0,,0,0,0,0,0,0,0,0,Matches
1372,Luca Kilian,GER,DF,Köln,Bundesliga,21,1999,25.3,42,24,30,9,3,21,41,51.2,20,31,13,18,46,88,109,3,Matches
1373,Max Kilman,ENG,DF,Wolves,Premier League,24,1997,29.9,50,26,38,10,2,24,37,64.9,13,36,21,15,45,95,113,3,Matches
1374,Joshua Kimmich,GER,MF,Bayern Munich,Bundesliga,26,1995,27.5,39,20,14,17,8,18,58,31.0,40,34,8,26,52,91,29,1,Matches
1375,Presnel Kimpembe,FRA,DF,Paris S-G,Ligue 1,25,1995,28.6,34,19,18,15,1,14,23,60.9,9,20,14,6,38,72,73,1,Matches
1376,Joshua King,NOR,FW,Watford,Premier League,29,1992,25.0,19,15,7,6,6,4,17,23.5,13,15,4,11,8,27,31,0,Matches
1377,Jakub Kiwior,POL,MF,Spezia,Serie A,21,2000,21.8,50,27,25,19,6,26,57,45.6,31,38,15,23,40,90,53,0,Matches
1378,Sofian Kiyine,MAR,"MF,FW",Venezia,Serie A,23,1997,13.8,24,14,9,11,4,12,32,37.5,20,15,1,14,10,34,9,0,Matches
1379,Simon Kjær,DEN,DF,Milan,Serie A,32,1989,8.9,20,12,9,8,3,6,12,50.0,6,17,13,4,9,29,39,0,Matches
1380,Kristoffer Klaesson,NOR,GK,Leeds United,Premier League,20,2000,0.4,0,0,0,0,0,0,0,,0,0,0,0,0,0,0,0,Matches
1381,Philipp Klement,GER,MF,Stuttgart,Bundesliga,28,1992,3.8,7,3,1,4,2,3,3,100.0,0,6,1,5,1,8,0,0,Matches
1382,Mateusz Klich,POL,MF,Leeds United,Premier League,31,1990,23.0,47,25,18,23,6,25,66,37.9,41,22,4,18,11,58,20,0,Matches
1383,Thibault Klidje,TOG,"MF,FW",Bordeaux,Ligue 1,20,2001,1.0,0,0,0,0,0,0,1,0.0,1,1,1,0,2,2,0,0,Matches
1384,Mateo Klimowicz,GER,"MF,FW",Stuttgart,Bundesliga,21,2000,6.7,13,6,6,7,0,5,16,31.3,11,2,0,2,4,17,3,0,Matches
1385,Fabian Klos,GER,FW,Arminia,Bundesliga,33,1987,15.8,7,5,0,5,2,2,10,20.0,8,17,4,13,0,7,31,0,Matches
1386,Lukas Klostermann,GER,DF,RB Leipzig,Bundesliga,25,1996,18.3,29,16,11,15,3,13,19,68.4,6,16,3,13,26,55,58,0,Matches
1387,Justin Kluivert,NED,MF,Nice,Ligue 1,22,1999,20.8,19,9,6,12,1,5,21,23.8,16,13,1,12,14,33,6,0,Matches
1388,Lukas Klünter,GER,DF,Hertha BSC,Bundesliga,25,1996,2.2,1,1,1,0,0,1,5,20.0,4,1,0,1,2,3,2,0,Matches
1389,Ansgar Knauff,GER,"FW,MF",Dortmund,Bundesliga,19,2002,1.3,3,1,1,1,1,0,4,0.0,4,2,0,2,0,3,4,0,Matches
1390,Ansgar Knauff,GER,"DF,MF",Eint Frankfurt,Bundesliga,19,2002,8.4,18,14,8,5,5,8,15,53.3,7,11,1,10,8,26,6,0,Matches
1391,Robin Knoche,GER,DF,Union Berlin,Bundesliga,29,1992,33.0,50,24,38,12,0,30,53,56.6,23,45,26,19,49,99,151,1,Matches
1392,Gregor Kobel,SUI,GK,Dortmund,Bundesliga,23,1997,28.5,0,0,0,0,0,0,2,0.0,2,0,0,0,1,1,20,0,Matches
1393,Robin Koch,GER,"MF,DF",Leeds United,Premier League,25,1996,17.5,21,13,9,10,2,9,34,26.5,25,26,10,16,20,41,44,0,Matches
1394,Samuel Koeberlé,FRA,FW,Reims,Ligue 1,16,2004,0.0,0,0,0,0,0,0,0,,0,0,0,0,0,0,0,0,Matches
1395,Philippe Koffi,CIV,FW,Reims,Ligue 1,19,2002,4.2,4,0,0,3,1,0,2,0.0,2,2,1,1,3,7,3,0,Matches
1396,Dominik Kohr,GER,MF,Mainz 05,Bundesliga,27,1994,17.9,40,20,18,19,3,16,42,38.1,26,21,2,19,35,75,22,0,Matches
1397,Koba Koindredi,FRA,MF,Valencia,La Liga,19,2001,2.0,4,3,2,1,1,2,6,33.3,4,3,0,3,4,8,5,0,Matches
1398,Koke,ESP,MF,Atlético Madrid,La Liga,29,1992,27.9,55,30,19,29,7,26,63,41.3,37,21,5,16,24,79,31,1,Matches
1399,Aleksandr Kokorin,RUS,"FW,MF",Fiorentina,Serie A,30,1991,0.6,1,1,1,0,0,0,0,,0,1,0,1,0,1,0,0,Matches
1400,Aleksandar Kolarov,SRB,DF,Inter,Serie A,35,1985,0.5,1,1,1,0,0,1,1,100.0,0,0,0,0,1,2,2,0,Matches
1401,Sead Kolašinac,BIH,DF,Arsenal,Premier League,28,1993,1.0,0,0,0,0,0,0,0,,0,0,0,0,4,4,1,0,Matches
1402,Sead Kolašinac,BIH,DF,Marseille,Ligue 1,28,1993,4.9,7,6,2,3,2,5,8,62.5,3,4,0,4,0,7,7,1,Matches
1403,Luca Koleosho,ITA,FW,Espanyol,La Liga,16,2004,0.0,0,0,0,0,0,0,0,,0,0,0,0,0,0,0,0,Matches
1404,Randal Kolo Muani,FRA,"FW,MF",Nantes,Ligue 1,22,1998,32.8,28,14,7,10,11,10,25,40.0,15,14,3,11,6,34,31,0,Matches
1405,Timothée Kolodziejczak,FRA,DF,Saint-Étienne,Ligue 1,29,1991,28.5,43,24,22,14,7,20,36,55.6,16,29,7,22,60,103,72,1,Matches
1406,Ghislain Konan,CIV,DF,Reims,Ligue 1,25,1995,26.9,35,19,19,15,1,16,30,53.3,14,35,8,27,28,63,45,0,Matches
1407,Ibrahima Konaté,FRA,DF,Liverpool,Premier League,22,1999,11.0,16,10,9,6,1,7,10,70.0,3,13,9,4,16,32,37,1,Matches
1408,Geoffrey Kondogbia,CTA,"MF,DF",Atlético Madrid,La Liga,28,1993,20.9,74,44,25,40,9,21,49,42.9,28,16,5,11,44,118,24,0,Matches
1409,Ibrahima Koné,MLI,FW,Lorient,Ligue 1,22,1999,8.1,7,4,0,3,4,2,3,66.7,1,8,3,5,1,8,3,0,Matches
1410,Manu Koné,FRA,MF,Gladbach,Bundesliga,20,2001,24.3,60,37,29,28,3,25,42,59.5,17,27,4,23,34,94,12,0,Matches
1411,Youssouf Koné,MLI,DF,Troyes,Ligue 1,26,1995,10.9,30,18,21,8,1,19,30,63.3,11,8,3,5,10,40,25,0,Matches
1412,Ezri Konsa,ENG,DF,Aston Villa,Premier League,23,1997,27.5,25,15,13,11,1,10,13,76.9,3,31,22,9,15,40,86,2,Matches
1413,Teun Koopmeiners,NED,MF,Atalanta,Serie A,23,1998,23.6,40,24,10,19,11,22,54,40.7,32,31,2,29,15,55,19,0,Matches
1414,Laurent Koscielny,FRA,DF,Bordeaux,Ligue 1,35,1985,10.4,14,9,10,3,1,8,13,61.5,5,17,12,5,12,26,39,0,Matches
1415,Odilon Kossonou,CIV,DF,Leverkusen,Bundesliga,20,2001,19.9,23,17,16,6,1,15,25,60.0,10,36,14,22,26,49,66,0,Matches
1416,Filip Kostić,SRB,"DF,FW",Eint Frankfurt,Bundesliga,28,1992,28.0,44,17,26,9,9,20,53,37.7,33,24,1,23,15,59,24,0,Matches
1417,Rominigue Kouamé,MLI,MF,Troyes,Ligue 1,24,1996,33.0,47,22,24,20,3,19,58,32.8,39,33,5,28,46,93,22,2,Matches
1418,Kalidou Koulibaly,SEN,DF,Napoli,Serie A,30,1991,26.7,39,23,31,6,2,25,38,65.8,13,41,25,16,29,68,90,1,Matches
1419,Jules Koundé,FRA,DF,Sevilla,La Liga,22,1998,30.4,40,17,27,10,3,18,28,64.3,10,33,18,15,21,61,101,2,Matches
1420,Christos Kourfalidis,GRE,"MF,FW",Cagliari,Serie A,18,2002,0.2,0,0,0,0,0,0,1,0.0,1,1,0,1,0,0,0,0,Matches
1421,Boubakar Kouyaté,MLI,DF,Metz,Ligue 1,24,1997,29.6,84,50,56,28,0,48,77,62.3,29,63,33,30,79,163,217,3,Matches
1422,Cheikhou Kouyaté,SEN,MF,Crystal Palace,Premier League,31,1989,21.9,52,38,28,22,2,18,39,46.2,21,40,14,26,38,90,39,0,Matches
1423,Mateo Kovačić,CRO,MF,Chelsea,Premier League,27,1994,17.3,51,31,14,26,11,17,35,48.6,18,19,4,15,7,58,9,1,Matches
1424,Viktor Kovalenko,UKR,MF,Spezia,Serie A,25,1996,14.7,16,10,7,8,1,9,21,42.9,12,16,3,13,13,29,8,0,Matches
1425,Emil Krafth,SWE,DF,Newcastle Utd,Premier League,26,1994,18.2,37,16,25,11,1,27,36,75.0,9,16,10,6,25,62,56,0,Matches
1426,Alex Král,CZE,MF,West Ham,Premier League,23,1998,0.0,0,0,0,0,0,0,0,,0,0,0,0,0,0,0,0,Matches
1427,Andrej Kramarić,CRO,"FW,MF",Hoffenheim,Bundesliga,30,1991,30.1,8,4,1,5,2,7,17,41.2,10,10,0,10,9,17,7,1,Matches
1428,Christoph Kramer,GER,MF,Gladbach,Bundesliga,30,1991,8.3,28,11,15,10,3,12,28,42.9,16,18,5,13,12,40,9,0,Matches
1429,Jean-Philippe Krasso,CIV,FW,Saint-Étienne,Ligue 1,24,1997,5.0,7,5,0,5,2,2,10,20.0,8,7,1,6,0,7,1,0,Matches
1430,Julian Kristoffersen,NOR,FW,Salernitana,Serie A,24,1997,0.1,0,0,0,0,0,0,0,,0,0,0,0,0,0,0,0,Matches
1431,Toni Kroos,GER,MF,Real Madrid,La Liga,31,1990,23.4,34,26,13,17,4,14,36,38.9,22,16,3,13,12,46,13,1,Matches
1432,Florian Krüger,GER,"FW,MF",Arminia,Bundesliga,22,1999,12.5,3,1,0,3,0,2,10,20.0,8,12,1,11,2,5,13,0,Matches
1433,Tim Krul,NED,GK,Norwich City,Premier League,33,1988,29.0,1,1,1,0,0,1,4,25.0,3,0,0,0,0,1,10,4,Matches
1434,Rade Krunić,BIH,"MF,FW",Milan,Serie A,27,1993,15.7,33,18,16,14,3,15,31,48.4,16,19,2,17,16,49,17,0,Matches
1435,Max Kruse,GER,"MF,FW",Wolfsburg,Bundesliga,33,1988,12.5,9,3,4,4,1,5,12,41.7,7,2,0,2,3,12,4,0,Matches
1436,Max Kruse,GER,"FW,MF",Union Berlin,Bundesliga,33,1988,14.1,4,1,0,3,1,2,16,12.5,14,12,0,12,3,7,2,0,Matches
1437,Lukas Kübler,GER,"DF,MF",Freiburg,Bundesliga,28,1992,25.9,62,35,38,16,8,28,49,57.1,21,24,8,16,44,106,70,0,Matches
1438,Takefusa Kubo,JPN,"FW,MF",Mallorca,La Liga,20,2001,17.8,31,19,12,14,5,10,24,41.7,14,24,3,21,8,39,4,0,Matches
1439,Juraj Kucka,SVK,MF,Watford,Premier League,34,1987,21.3,59,39,32,25,2,27,73,37.0,46,30,9,21,27,86,46,2,Matches
1440,Mykola Kukharevych,UKR,FW,Troyes,Ligue 1,20,2001,0.2,0,0,0,0,0,0,0,,0,0,0,0,0,0,0,0,Matches
1441,Dejan Kulusevski,SWE,"MF,FW",Tottenham,Premier League,21,2000,14.0,19,13,7,10,2,5,23,21.7,18,14,0,14,13,32,3,0,Matches
1442,Dejan Kulusevski,SWE,"FW,MF",Juventus,Serie A,21,2000,8.6,15,12,9,6,0,8,21,38.1,13,14,0,14,5,20,5,0,Matches
1443,Marash Kumbulla,ALB,DF,Roma,Serie A,21,2000,11.4,21,13,13,7,1,8,15,53.3,7,17,8,9,16,37,26,0,Matches
1444,Fabian Kunze,GER,MF,Arminia,Bundesliga,23,1998,14.0,35,21,14,20,1,15,32,46.9,17,17,2,15,19,54,27,1,Matches
1445,Enock Kwateng,FRA,DF,Bordeaux,Ligue 1,24,1997,22.2,54,35,31,19,4,33,72,45.8,39,17,4,13,43,97,48,1,Matches
1446,Grejohn Kyei,FRA,FW,Clermont Foot,Ligue 1,25,1995,4.4,3,2,1,1,1,0,6,0.0,6,6,0,6,0,3,1,0,Matches
1447,Giorgos Kyriakopoulos,GRE,"DF,FW",Sassuolo,Serie A,25,1996,21.9,30,14,19,7,4,19,38,50.0,19,32,9,23,11,41,52,0,Matches
1448,Andrea La Mantia,ITA,"FW,MF",Empoli,Serie A,30,1991,5.4,2,0,0,0,2,1,2,50.0,1,3,1,2,1,3,6,0,Matches
1449,Gaëtan Laborde,FRA,FW,Montpellier,Ligue 1,27,1994,3.8,2,2,1,1,0,2,4,50.0,2,3,0,3,5,7,5,0,Matches
1450,Gaëtan Laborde,FRA,FW,Rennes,Ligue 1,27,1994,30.3,19,7,5,8,6,3,22,13.6,19,29,3,26,8,27,16,0,Matches
1451,Alexandre Lacazette,FRA,FW,Arsenal,Premier League,30,1991,19.8,27,10,8,13,6,7,21,33.3,14,12,1,11,5,32,6,0,Matches
1452,Tom Lacoux,FRA,"DF,MF",Bordeaux,Ligue 1,19,2002,10.1,18,13,11,5,2,9,24,37.5,15,14,4,10,9,27,20,1,Matches
1453,Lenny Lacroix,FRA,DF,Metz,Ligue 1,18,2003,2.2,9,7,8,1,0,5,8,62.5,3,5,1,4,10,19,5,0,Matches
1454,Maxence Lacroix,FRA,DF,Wolfsburg,Bundesliga,21,2000,27.7,59,33,41,16,2,29,40,72.5,11,35,16,19,60,119,144,0,Matches
1455,Alban Lafont,FRA,GK,Nantes,Ligue 1,22,1999,38.0,3,3,3,0,0,3,8,37.5,5,1,0,1,1,4,25,2,Matches
1456,Víctor Laguardia,ESP,DF,Alavés,La Liga,31,1989,33.8,29,16,21,8,0,19,30,63.3,11,36,24,12,27,56,151,1,Matches
1457,Konrad Laimer,AUT,MF,RB Leipzig,Bundesliga,24,1997,13.8,38,24,11,22,5,24,53,45.3,29,29,3,26,4,42,9,0,Matches
1458,Stefan Lainer,AUT,DF,Gladbach,Bundesliga,28,1992,16.3,19,11,9,7,3,12,28,42.9,16,24,5,19,14,33,31,0,Matches
1459,Diego Lainez,MEX,FW,Betis,La Liga,21,2000,1.6,1,1,0,1,0,0,3,0.0,3,3,0,3,1,2,0,0,Matches
1460,Adam Lallana,ENG,MF,Brighton,Premier League,33,1988,17.3,34,17,14,14,6,12,41,29.3,29,16,6,10,16,50,13,1,Matches
1461,Vassilis Lambropoulos,GRE,DF,Bochum,Bundesliga,31,1990,13.0,18,12,13,3,2,11,25,44.0,14,21,10,11,17,35,56,0,Matches
1462,Érik Lamela,ARG,"FW,MF",Sevilla,La Liga,29,1992,11.3,31,18,12,14,5,10,29,34.5,19,11,0,11,5,36,3,0,Matches
1463,Mohamed Lamine Bayo,GUI,FW,Clermont Foot,Ligue 1,23,1998,26.8,12,5,4,3,5,3,24,12.5,21,7,1,6,7,19,14,0,Matches
1464,Didier Lamkel Zé,CMR,FW,Metz,Ligue 1,24,1996,6.7,3,1,1,0,2,1,3,33.3,2,3,1,2,1,4,7,0,Matches
1465,Sam Lammers,NED,"FW,MF",Atalanta,Serie A,24,1997,0.4,1,0,0,0,1,0,0,,0,0,0,0,0,1,0,0,Matches
1466,Sam Lammers,NED,"FW,MF",Eint Frankfurt,Bundesliga,24,1997,5.7,4,4,0,2,2,2,6,33.3,4,9,2,7,2,6,4,0,Matches
1467,Tariq Lamptey,GHA,"DF,FW",Brighton,Premier League,20,2000,17.3,36,25,14,17,5,15,25,60.0,10,13,3,10,21,57,23,0,Matches
1468,Manuel Lanzini,ARG,"MF,FW",West Ham,Premier League,28,1993,19.8,28,15,10,11,7,10,35,28.6,25,16,0,16,19,47,10,0,Matches
1469,Aymeric Laporte,ESP,DF,Manchester City,Premier League,27,1994,31.4,33,15,22,10,1,14,20,70.0,6,15,10,5,20,53,64,2,Matches
1470,Julien Laporte,FRA,DF,Lorient,Ligue 1,27,1993,32.1,63,45,35,26,2,32,64,50.0,32,37,22,15,54,117,174,0,Matches
1471,Yasser Larouci,ALG,DF,Troyes,Ligue 1,20,2001,3.8,6,5,2,4,0,3,3,100.0,0,1,0,1,7,13,5,0,Matches
1472,Kevin Lasagna,ITA,"MF,FW",Hellas Verona,Serie A,28,1992,13.2,13,7,4,5,4,4,15,26.7,11,16,0,16,3,16,7,0,Matches
1473,Jamaal Lascelles,ENG,DF,Newcastle Utd,Premier League,27,1993,22.9,15,7,9,5,1,4,12,33.3,8,38,28,10,22,37,121,1,Matches
1474,Bryan Lasme,FRA,FW,Arminia,Bundesliga,22,1998,9.7,6,6,1,2,3,0,3,0.0,3,7,0,7,1,7,9,0,Matches
1475,Paul Lasne,FRA,MF,Brest,Ligue 1,32,1989,9.4,26,12,6,16,4,8,18,44.4,10,11,2,9,24,50,10,0,Matches
1476,Juanmi Latasa,ESP,FW,Real Madrid,La Liga,20,2001,0.1,0,0,0,0,0,0,0,,0,0,0,0,0,0,0,0,Matches
1477,Toni Lato,ESP,DF,Valencia,La Liga,23,1997,6.6,17,12,12,3,2,9,16,56.3,7,6,0,6,8,25,14,0,Matches
1478,Armand Lauriente,FRA,"FW,MF",Lorient,Ligue 1,22,1998,27.5,33,18,9,16,8,11,30,36.7,19,27,2,25,15,48,3,0,Matches
1479,Darko Lazović,SRB,DF,Hellas Verona,Serie A,30,1990,30.7,36,23,20,8,8,21,39,53.8,18,28,4,24,19,55,49,1,Matches
1480,Manuel Lazzari,ITA,DF,Lazio,Serie A,27,1993,18.5,28,14,13,15,0,16,26,61.5,10,10,2,8,12,40,16,1,Matches
1481,Théo Le Bris,FRA,MF,Lorient,Ligue 1,18,2002,0.7,2,1,1,1,0,1,2,50.0,1,2,0,2,0,2,1,0,Matches
1482,Jérémy Le Douaron,FRA,"FW,MF",Brest,Ligue 1,23,1998,16.1,11,5,4,4,3,1,17,5.9,16,15,0,15,4,15,14,0,Matches
1483,Enzo Le Fée,FRA,"MF,FW",Lorient,Ligue 1,21,2000,24.4,70,44,25,36,9,41,90,45.6,49,25,1,24,29,99,18,0,Matches
1484,Vincent Le Goff,FRA,DF,Lorient,Ligue 1,31,1989,34.0,61,38,38,19,4,37,62,59.7,25,18,3,15,37,98,50,0,Matches
1485,Maxime Le Marchand,FRA,DF,Strasbourg,Ligue 1,31,1989,9.6,17,8,16,1,0,8,10,80.0,2,9,5,4,14,31,32,0,Matches
1486,Robin Le Normand,ESP,DF,Real Sociedad,La Liga,24,1996,37.0,49,32,36,8,5,28,36,77.8,8,34,22,12,48,97,125,0,Matches
1487,Patrick Leal,USA,FW,Venezia,Serie A,18,2003,0.0,0,0,0,0,0,0,1,0.0,1,0,0,0,0,0,0,0,Matches
1488,Rafael Leão,POR,FW,Milan,Serie A,22,1999,28.9,17,7,3,9,5,10,20,50.0,10,12,1,11,12,29,8,0,Matches
1489,Jean-Louis Leca,FRA,GK,Lens,Ligue 1,35,1985,25.7,0,0,0,0,0,0,0,,0,1,0,1,1,1,11,1,Matches
1490,Jeremías Ledesma,ARG,GK,Cádiz,La Liga,28,1993,38.0,3,1,3,0,0,3,4,75.0,1,0,0,0,1,4,21,4,Matches
1491,Pierre Lees-Melou,FRA,MF,Norwich City,Premier League,28,1993,25.2,58,36,23,29,6,25,92,27.2,67,37,11,26,25,83,23,0,Matches
1492,Wu Lei,CHN,"FW,MF",Espanyol,La Liga,29,1991,5.3,3,2,1,2,0,3,8,37.5,5,4,0,4,4,7,3,0,Matches
1493,Maxim Leitsch,GER,DF,Bochum,Bundesliga,23,1998,17.1,18,10,9,7,2,10,15,66.7,5,31,19,12,31,49,74,1,Matches
1494,Lucas Leiva,BRA,MF,Lazio,Serie A,34,1987,18.9,55,30,26,25,4,15,53,28.3,38,27,10,17,28,83,37,0,Matches
1495,Florian Lejeune,FRA,DF,Alavés,La Liga,30,1991,30.0,33,24,22,10,1,12,20,60.0,8,30,19,11,31,64,158,0,Matches
1496,Iñigo Lekue,ESP,DF,Athletic Club,La Liga,28,1993,21.4,32,23,16,12,4,22,44,50.0,22,37,12,25,23,55,63,0,Matches
1497,Thomas Lemar,FRA,MF,Atlético Madrid,La Liga,25,1995,16.0,24,14,9,12,3,8,23,34.8,15,18,0,18,8,32,11,0,Matches
1498,Félix Lemaréchal,FRA,MF,Monaco,Ligue 1,17,2003,0.1,0,0,0,0,0,0,1,0.0,1,0,0,0,0,0,0,0,Matches
1499,Mario Lemina,GAB,MF,Nice,Ligue 1,27,1993,21.9,62,35,25,33,4,28,38,73.7,10,32,9,23,48,110,37,0,Matches
1500,Fabien Lemoine,FRA,MF,Lorient,Ligue 1,34,1987,12.4,35,22,20,14,1,17,41,41.5,24,21,4,17,14,49,24,1,Matches
1501,Tim Lemperle,GER,"FW,MF",Köln,Bundesliga,19,2002,1.7,4,1,2,1,1,1,3,33.3,2,1,0,1,2,6,2,0,Matches
1502,Ruben Lendinez,ESP,DF,Valencia,La Liga,18,2003,1.5,3,3,1,2,0,3,8,37.5,5,4,0,4,2,5,6,0,Matches
1503,Clément Lenglet,FRA,DF,Barcelona,La Liga,26,1995,9.2,20,11,11,7,2,8,13,61.5,5,7,3,4,13,33,21,0,Matches
1504,Aaron Lennon,ENG,"MF,FW",Burnley,Premier League,34,1987,17.2,33,17,10,13,10,10,34,29.4,24,26,4,22,9,42,14,0,Matches
1505,Bernd Leno,GER,GK,Arsenal,Premier League,29,1992,4.0,1,1,1,0,0,1,1,100.0,0,0,0,0,0,1,1,0,Matches
1506,Christopher Lenz,GER,DF,Eint Frankfurt,Bundesliga,26,1994,7.4,29,15,22,6,1,12,21,57.1,9,9,4,5,7,36,21,0,Matches
1507,Léo Leroy,FRA,MF,Montpellier,Ligue 1,21,2000,7.0,31,21,17,11,3,12,34,35.3,22,20,4,16,8,39,8,0,Matches
1508,Alexandre Letellier,FRA,GK,Paris S-G,Ligue 1,30,1990,0.1,0,0,0,0,0,0,0,,0,0,0,0,0,0,0,0,Matches
1509,Robert Lewandowski,POL,FW,Bayern Munich,Bundesliga,32,1988,32.7,10,3,0,6,4,5,17,29.4,12,17,2,15,6,16,8,0,Matches
1510,Jamie Leweling,GER,"FW,MF",Greuther Fürth,Bundesliga,20,2001,21.8,13,8,3,7,3,3,16,18.8,13,9,0,9,13,26,5,0,Matches
1511,Jamal Lewis,NIR,DF,Newcastle Utd,Premier League,23,1998,2.9,8,6,6,1,1,3,4,75.0,1,3,2,1,3,11,8,0,Matches
1512,Luca Lezzerini,ITA,GK,Venezia,Serie A,26,1995,5.5,0,0,0,0,0,0,0,,0,1,0,1,0,0,0,0,Matches
1513,Ben Lhassine Kone,CIV,MF,Torino,Serie A,21,2000,0.9,3,3,1,2,0,1,2,50.0,1,0,0,0,1,4,1,0,Matches
1514,Yanis Lhery,FRA,"FW,MF",Saint-Étienne,Ligue 1,18,2003,0.8,0,0,0,0,0,0,0,,0,4,0,4,0,0,0,0,Matches
1515,Dimitri Liénard,FRA,"DF,MF",Strasbourg,Ligue 1,33,1988,22.7,71,43,40,21,10,46,77,59.7,31,12,0,12,21,92,28,0,Matches
1516,Philipp Lienhart,AUT,DF,Freiburg,Bundesliga,25,1996,31.9,24,13,17,6,1,13,24,54.2,11,33,23,10,50,74,158,1,Matches
1517,Matthijs de Ligt,NED,DF,Juventus,Serie A,21,1999,29.7,34,19,21,13,0,15,18,83.3,3,31,21,10,26,60,103,0,Matches
1518,Isaac Lihadji,FRA,"MF,FW",Lille,Ligue 1,19,2002,2.6,3,3,1,1,1,1,5,20.0,4,1,0,1,2,5,0,0,Matches
1519,Anderson Lima,BRA,MF,Lazio,Serie A,21,1999,0.7,2,0,1,1,0,0,2,0.0,2,1,0,1,2,4,1,0,Matches
1520,Andreas Linde,SWE,GK,Greuther Fürth,Bundesliga,28,1993,12.0,0,0,0,0,0,0,0,,0,0,0,0,1,1,1,1,Matches
1521,Victor Lindelöf,SWE,DF,Manchester Utd,Premier League,27,1994,26.2,16,11,9,7,0,9,14,64.3,5,26,17,9,25,41,96,0,Matches
1522,Jesper Lindstrøm,DEN,"MF,FW",Eint Frankfurt,Bundesliga,21,2000,22.0,28,13,6,13,9,12,36,33.3,24,30,0,30,24,52,11,1,Matches
1523,Karol Linetty,POL,"MF,FW",Torino,Serie A,26,1995,10.0,14,8,3,4,7,6,18,33.3,12,8,0,8,3,17,2,0,Matches
1524,Jesse Lingard,ENG,"FW,MF",Manchester Utd,Premier League,28,1992,4.1,9,7,4,3,2,2,6,33.3,4,4,0,4,0,9,1,0,Matches
1525,Pol Lirola,ESP,"DF,FW",Marseille,Ligue 1,23,1997,19.7,28,16,15,9,4,13,28,46.4,15,15,0,15,13,41,22,0,Matches
1526,Valentino Livramento,ENG,DF,Southampton,Premier League,18,2002,24.5,54,28,30,18,6,27,45,60.0,18,23,9,14,47,101,50,1,Matches
1527,Dejan Ljubicic,AUT,"MF,FW",Köln,Bundesliga,23,1997,21.9,33,19,12,13,8,13,49,26.5,36,19,1,18,15,48,11,0,Matches
1528,Javier Llabrés,ESP,"FW,MF",Mallorca,La Liga,18,2002,1.5,2,1,0,1,1,1,2,50.0,1,1,0,1,0,2,0,0,Matches
1529,Diego Llorente,ESP,DF,Leeds United,Premier League,27,1993,26.0,53,31,32,19,2,33,47,70.2,14,35,17,18,40,93,77,2,Matches
1530,Marcos Llorente,ESP,"MF,DF",Atlético Madrid,La Liga,26,1995,27.2,51,23,25,22,4,28,43,65.1,15,33,10,23,27,78,44,0,Matches
1531,Hugo Lloris,FRA,GK,Tottenham,Premier League,34,1986,38.0,1,1,1,0,0,1,2,50.0,1,0,0,0,1,2,24,3,Matches
1532,Giovani Lo Celso,ARG,"MF,FW",Tottenham,Premier League,25,1996,2.6,8,4,4,2,2,4,10,40.0,6,6,1,5,1,9,0,1,Matches
1533,Giovani Lo Celso,ARG,"FW,MF",Villarreal,La Liga,25,1996,11.0,22,12,8,10,4,9,22,40.9,13,4,0,4,5,27,3,0,Matches
1534,Julen Lobete,ESP,"FW,MF",Real Sociedad,La Liga,20,2000,3.2,4,3,3,0,1,1,2,50.0,1,6,1,5,1,5,1,0,Matches
1535,Stanislav Lobotka,SVK,MF,Napoli,Serie A,26,1994,18.7,39,24,16,20,3,14,36,38.9,22,9,1,8,12,51,13,1,Matches
1536,Jürgen Locadia,CUW,"MF,FW",Brighton,Premier League,27,1993,0.3,0,0,0,0,0,0,0,,0,0,0,0,0,0,0,0,Matches
1537,Jürgen Locadia,CUW,"FW,MF",Bochum,Bundesliga,27,1993,4.9,4,2,1,0,3,1,1,100.0,0,1,0,1,1,5,2,0,Matches
1538,Manuel Locatelli,ITA,MF,Juventus,Serie A,23,1998,24.0,44,25,21,16,7,21,47,44.7,26,43,21,22,22,66,33,0,Matches
1539,Bradley Locko,FRA,"MF,DF",Reims,Ligue 1,19,2002,11.2,28,19,13,11,4,14,24,58.3,10,20,8,12,14,42,15,0,Matches
1540,Renan Lodi,BRA,DF,Atlético Madrid,La Liga,23,1998,13.1,31,18,14,13,4,11,27,40.7,16,22,4,18,13,44,19,1,Matches
1541,Ruben Loftus-Cheek,ENG,"MF,DF",Chelsea,Premier League,25,1996,15.5,29,10,16,11,2,10,19,52.6,9,15,6,9,11,40,17,0,Matches
1542,Kevin Long,IRL,DF,Burnley,Premier League,30,1990,4.6,3,2,1,2,0,1,2,50.0,1,4,1,3,1,4,20,0,Matches
1543,Shane Long,IRL,FW,Southampton,Premier League,34,1987,3.4,9,5,2,4,3,1,1,100.0,0,4,0,4,0,9,2,0,Matches
1544,Sean Longstaff,ENG,MF,Newcastle Utd,Premier League,23,1997,16.3,54,34,18,31,5,24,65,36.9,41,18,6,12,9,63,18,0,Matches
1545,Ademola Lookman,NGA,"FW,MF",Leicester City,Premier League,23,1997,16.1,32,14,10,13,9,10,28,35.7,18,19,1,18,10,42,4,0,Matches
1546,Anthony Lopes,POR,GK,Lyon,Ligue 1,30,1990,33.1,0,0,0,0,0,0,0,,0,0,0,0,3,3,12,3,Matches
1547,David López,ESP,"MF,DF",Espanyol,La Liga,31,1989,8.3,18,13,9,8,1,9,16,56.3,7,10,8,2,10,28,25,2,Matches
1548,Diego López,ESP,GK,Espanyol,La Liga,39,1981,35.3,0,0,0,0,0,0,2,0.0,2,0,0,0,1,1,21,1,Matches
1549,Javi López,ESP,DF,Alavés,La Liga,19,2002,5.1,8,6,6,2,0,4,6,66.7,2,7,1,6,4,12,15,0,Matches
1550,Maxime Lopez,FRA,MF,Sassuolo,Serie A,23,1997,32.6,69,36,40,27,2,35,87,40.2,52,33,7,26,42,111,38,1,Matches
1551,Pau López,ESP,GK,Marseille,Ligue 1,26,1994,29.0,0,0,0,0,0,0,1,0.0,1,0,0,0,0,0,12,1,Matches
1552,Unai López,ESP,MF,Rayo Vallecano,La Liga,25,1995,12.9,19,9,6,10,3,10,33,30.3,23,7,0,7,10,29,8,1,Matches
1553,Dion Lopy,SEN,MF,Reims,Ligue 1,19,2002,18.2,53,29,22,24,7,21,53,39.6,32,20,4,16,22,75,17,0,Matches
1554,Samuel Loric,FRA,DF,Lorient,Ligue 1,21,2000,3.0,7,5,2,3,2,5,8,62.5,3,2,0,2,5,12,9,0,Matches
1555,Anthony Losilla,FRA,MF,Bochum,Bundesliga,35,1986,32.6,65,39,29,30,6,34,69,49.3,35,32,9,23,70,135,53,1,Matches
1556,Jonas Lössl,DEN,GK,Brentford,Premier League,32,1989,2.0,0,0,0,0,0,0,0,,0,0,0,0,0,0,1,0,Matches
1557,Marcel Lotka,POL,GK,Hertha BSC,Bundesliga,20,2001,9.8,1,0,1,0,0,1,1,100.0,0,0,0,0,1,2,3,3,Matches
1558,Jordan Lotomba,SUI,DF,Nice,Ligue 1,22,1998,19.8,33,17,21,9,3,16,30,53.3,14,17,4,13,12,45,28,0,Matches
1559,Johaneko Louisjean,FRA,DF,Bordeaux,Ligue 1,17,2004,0.1,0,0,0,0,0,0,0,,0,0,0,0,0,0,0,0,Matches
1560,Mamadou Loum,SEN,MF,Alavés,La Liga,24,1996,25.7,49,22,26,22,1,17,45,37.8,28,30,11,19,37,86,68,1,Matches
1561,Imran Louza,MAR,MF,Watford,Premier League,22,1999,15.7,41,21,18,20,3,16,38,42.1,22,28,6,22,42,83,20,1,Matches
1562,Matteo Lovato,ITA,DF,Atalanta,Serie A,21,2000,3.4,5,4,4,1,0,0,1,0.0,1,4,2,2,7,12,8,0,Matches
1563,Matteo Lovato,ITA,DF,Cagliari,Serie A,21,2000,13.8,23,15,13,10,0,8,20,40.0,12,21,10,11,28,51,43,0,Matches
1564,Eduard Löwen,GER,MF,Bochum,Bundesliga,24,1997,15.7,28,22,12,11,5,10,43,23.3,33,17,2,15,9,37,15,1,Matches
1565,Matthew Lowton,ENG,DF,Burnley,Premier League,32,1989,19.7,38,24,20,10,8,20,37,54.1,17,25,11,14,26,64,68,0,Matches
1566,Anthony Lozano,HON,"FW,MF",Cádiz,La Liga,28,1993,18.6,8,4,2,3,3,5,18,27.8,13,16,2,14,2,10,7,0,Matches
1567,Hirving Lozano,MEX,FW,Napoli,Serie A,26,1995,17.9,28,20,12,11,5,8,30,26.7,22,24,0,24,9,37,9,0,Matches
1568,Jean Lucas,BRA,MF,Monaco,Ligue 1,23,1998,16.1,43,25,14,24,5,17,40,42.5,23,15,5,10,13,56,4,1,Matches
1569,Anderson Lucoqui,ANG,DF,Mainz 05,Bundesliga,24,1997,8.3,22,10,11,6,5,11,22,50.0,11,15,3,12,11,33,10,0,Matches
1570,Florentino Luís,POR,MF,Getafe,La Liga,21,1999,11.0,42,25,22,17,3,17,35,48.6,18,21,2,19,21,63,11,1,Matches
1571,José Luis Gayà,ESP,DF,Valencia,La Liga,26,1995,20.8,35,21,24,10,1,16,34,47.1,18,17,3,14,19,54,37,0,Matches
1572,José Luis Morales,ESP,"FW,MF",Levante,La Liga,34,1987,30.2,27,17,6,9,12,12,42,28.6,30,29,0,29,4,31,7,0,Matches
1573,José Luis Palomino,ARG,DF,Atalanta,Serie A,31,1990,29.7,78,40,42,33,3,32,50,64.0,18,43,21,22,100,178,80,2,Matches
1574,Luismi,ESP,"FW,MF",Sevilla,La Liga,20,2001,0.1,0,0,0,0,0,0,0,,0,0,0,0,0,0,0,0,Matches
1575,Douglas Luiz,BRA,MF,Aston Villa,Premier League,23,1998,30.2,59,39,30,24,5,21,72,29.2,51,30,7,23,34,93,28,1,Matches
1576,Romelu Lukaku,BEL,FW,Chelsea,Premier League,28,1993,17.7,2,1,0,1,1,1,5,20.0,4,11,1,10,0,2,20,0,Matches
1577,Castello Lukeba,FRA,DF,Lyon,Ligue 1,18,2002,23.3,34,19,27,7,0,15,23,65.2,8,18,9,9,38,72,64,2,Matches
1578,Dodi Lukebakio,BEL,FW,Hertha BSC,Bundesliga,23,1997,2.0,2,1,2,0,0,1,3,33.3,2,2,0,2,2,4,0,0,Matches
1579,Dodi Lukebakio,BEL,"FW,MF",Wolfsburg,Bundesliga,23,1997,9.8,7,4,3,2,2,1,10,10.0,9,5,0,5,13,20,4,0,Matches
1580,Saša Lukić,SRB,MF,Torino,Serie A,24,1996,33.1,51,34,17,27,7,19,43,44.2,24,34,6,28,24,75,41,0,Matches
1581,Levi Lumeka,ENG,"DF,FW",Troyes,Ligue 1,22,1998,0.7,0,0,0,0,0,0,2,0.0,2,0,0,0,0,0,2,0,Matches
1582,Andriy Lunin,UKR,GK,Real Madrid,La Liga,22,1999,2.0,0,0,0,0,0,0,0,,0,0,0,0,0,0,2,0,Matches
1583,Andrey Lunyov,RUS,GK,Leverkusen,Bundesliga,29,1991,1.0,0,0,0,0,0,0,0,,0,0,0,0,0,0,0,0,Matches
1584,Sebastiano Luperto,ITA,DF,Empoli,Serie A,24,1996,21.8,29,17,17,10,2,10,20,50.0,10,32,26,6,45,74,132,0,Matches
1585,Andreas Luthe,GER,GK,Union Berlin,Bundesliga,34,1987,27.0,0,0,0,0,0,0,1,0.0,1,0,0,0,0,0,11,4,Matches
1586,Lyanco,BRA,DF,Southampton,Premier League,24,1997,10.1,18,15,11,7,0,10,18,55.6,8,18,13,5,13,31,50,1,Matches
1587,Charalambos Lykogiannis,GRE,"DF,FW",Cagliari,Serie A,27,1993,20.2,19,12,16,1,2,11,20,55.0,9,18,8,10,31,50,73,0,Matches
1588,Yannis M'Bemba,GAB,"DF,FW",Nantes,Ligue 1,20,2001,0.1,0,0,0,0,0,0,0,,0,0,0,0,0,0,1,0,Matches
1589,Alexis Mac Allister,ARG,"MF,FW",Brighton,Premier League,22,1998,23.6,65,40,23,30,12,29,68,42.6,39,37,7,30,13,78,22,0,Matches
1590,Deiver Machado,COL,"DF,MF",Lens,Ligue 1,27,1993,5.8,16,14,11,1,4,12,14,85.7,2,9,1,8,3,19,12,1,Matches
1591,Darwin Machís,VEN,"MF,FW",Granada,La Liga,28,1993,15.3,23,13,11,8,4,9,23,39.1,14,10,0,10,15,38,17,0,Matches
1592,Yvann Macon,FRA,DF,Saint-Étienne,Ligue 1,22,1998,17.0,41,22,24,14,3,16,42,38.1,26,18,4,14,18,59,27,0,Matches
1593,James Maddison,ENG,"MF,FW",Leicester City,Premier League,24,1996,27.3,40,20,8,24,8,14,46,30.4,32,18,3,15,11,51,12,0,Matches
1594,Niki Mäenpää,FIN,GK,Venezia,Serie A,36,1985,16.5,0,0,0,0,0,0,0,,0,0,0,0,0,0,8,2,Matches
1595,Pablo Maffeo,ESP,DF,Mallorca,La Liga,24,1997,32.7,84,47,48,28,8,38,69,55.1,31,30,13,17,46,130,74,0,Matches
1596,Louis Mafouta,CTA,FW,Metz,Ligue 1,27,1994,5.8,0,0,0,0,0,0,5,0.0,5,1,0,1,0,0,4,0,Matches
1597,Gabriel Magalhães,BRA,DF,Arsenal,Premier League,23,1997,34.0,50,30,36,12,2,30,41,73.2,11,34,26,8,13,63,112,4,Matches
1598,Giulio Maggiore,ITA,MF,Spezia,Serie A,23,1998,31.3,58,32,20,32,6,31,77,40.3,46,30,5,25,29,87,33,0,Matches
1599,Matej Maglica,CRO,MF,Stuttgart,Bundesliga,22,1998,0.1,0,0,0,0,0,0,1,0.0,1,0,0,0,0,0,0,0,Matches
1600,Francesco Magnanelli,ITA,MF,Sassuolo,Serie A,36,1984,3.0,5,4,4,1,0,1,9,11.1,8,3,1,2,1,6,3,0,Matches
1601,Giangiacomo Magnani,ITA,DF,Hellas Verona,Serie A,25,1995,5.9,10,7,5,5,0,8,16,50.0,8,5,3,2,10,20,46,0,Matches
1602,Giangiacomo Magnani,ITA,DF,Sampdoria,Serie A,25,1995,2.7,4,2,4,0,0,1,1,100.0,0,2,2,0,7,11,12,0,Matches
1603,Hugo Magnetti,FRA,MF,Brest,Ligue 1,23,1998,16.3,50,34,27,20,3,22,50,44.0,28,14,3,11,25,75,13,0,Matches
1604,Yohann Magnin,FRA,"MF,DF",Clermont Foot,Ligue 1,24,1997,19.1,53,31,22,26,5,24,42,57.1,18,17,7,10,20,73,36,0,Matches
1605,Harry Maguire,ENG,DF,Manchester Utd,Premier League,28,1993,27.9,34,21,22,8,4,19,31,61.3,12,36,29,7,32,66,101,3,Matches
1606,Riyad Mahrez,ALG,FW,Manchester City,Premier League,30,1991,16.6,11,3,5,4,2,5,19,26.3,14,15,1,14,6,17,6,0,Matches
1607,Arne Maier,GER,MF,Augsburg,Bundesliga,22,1999,20.7,20,13,6,10,4,8,26,30.8,18,18,1,17,15,35,13,0,Matches
1608,Habib Maïga,CIV,MF,Metz,Ligue 1,25,1996,14.1,47,28,29,13,5,24,48,50.0,24,20,7,13,14,61,18,0,Matches
1609,Mike Maignan,FRA,GK,Milan,Serie A,26,1995,32.0,2,1,2,0,0,2,2,100.0,0,0,0,0,1,3,4,2,Matches
1610,Ainsley Maitland-Niles,ENG,MF,Arsenal,Premier League,23,1997,3.0,8,4,5,3,0,2,4,50.0,2,2,0,2,4,12,4,0,Matches
1611,Ainsley Maitland-Niles,ENG,DF,Roma,Serie A,23,1997,5.4,8,6,5,0,3,5,14,35.7,9,7,0,7,6,14,7,0,Matches
1612,Josh Maja,NGA,FW,Bordeaux,Ligue 1,22,1998,0.1,0,0,0,0,0,0,0,,0,1,0,1,0,0,0,0,Matches
1613,Abdul Majeed Waris,GHA,"FW,MF",Strasbourg,Ligue 1,29,1991,3.6,5,3,2,3,0,5,10,50.0,5,2,0,2,0,5,1,0,Matches
1614,Lovro Majer,CRO,"MF,FW",Rennes,Ligue 1,23,1998,20.4,32,21,9,14,9,11,42,26.2,31,26,2,24,11,43,9,0,Matches
1615,Jean-Victor Makengo,FRA,MF,Udinese,Serie A,23,1998,26.1,30,21,7,17,6,15,29,51.7,14,26,6,20,19,49,17,0,Matches
1616,Béni Makouana,CGO,"FW,MF",Montpellier,Ligue 1,18,2002,3.6,2,2,0,0,2,0,1,0.0,1,1,0,1,3,5,2,0,Matches
1617,Nemanja Maksimović,SRB,MF,Getafe,La Liga,26,1995,32.6,56,32,24,26,6,18,49,36.7,31,42,13,29,71,127,41,0,Matches
1618,Nikola Maksimović,SRB,DF,Genoa,Serie A,29,1991,12.4,14,6,10,4,0,7,9,77.8,2,17,11,6,12,26,61,1,Matches
1619,Kévin Malcuit,MAR,"DF,MF",Napoli,Serie A,30,1991,3.2,4,2,4,0,0,2,2,100.0,0,3,0,3,8,12,6,0,Matches
1620,Daniel Maldini,ITA,MF,Milan,Serie A,19,2001,1.6,8,3,4,3,1,2,6,33.3,4,4,0,4,1,9,0,0,Matches
1621,Youssef Maleh,MAR,MF,Fiorentina,Serie A,22,1998,11.3,27,16,8,13,6,12,25,48.0,13,14,1,13,6,33,2,0,Matches
1622,Donyell Malen,NED,FW,Dortmund,Bundesliga,22,1999,18.7,13,10,4,5,4,7,13,53.8,6,10,0,10,10,23,11,0,Matches
1623,Ruslan Malinovskyi,UKR,"MF,FW",Atalanta,Serie A,28,1993,17.7,18,10,3,10,5,5,19,26.3,14,27,3,24,5,23,1,0,Matches
1624,Hugo Mallo,ESP,DF,Celta Vigo,La Liga,30,1991,20.3,45,25,24,19,2,16,31,51.6,15,23,9,14,20,65,53,0,Matches
1625,Lennard Maloney,USA,DF,Dortmund,Bundesliga,21,1999,0.1,1,0,1,0,0,1,1,100.0,0,0,0,0,0,1,0,0,Matches
1626,Mickael Malsa,MTQ,MF,Levante,La Liga,25,1995,12.7,37,17,16,18,3,15,42,35.7,27,20,8,12,18,55,15,0,Matches
1627,Giorgi Mamardashvili,GEO,GK,Valencia,La Liga,20,2000,18.0,0,0,0,0,0,0,0,,0,0,0,0,0,0,6,1,Matches
1628,Rey Manaj,ALB,FW,Spezia,Serie A,24,1997,19.6,19,12,3,11,5,6,26,23.1,20,16,0,16,4,23,13,0,Matches
1629,Hianga Mananga Mbock,FRA,MF,Brest,Ligue 1,21,1999,8.9,18,12,8,7,3,9,21,42.9,12,5,2,3,5,23,6,0,Matches
1630,Vincent Manceau,FRA,DF,Angers,Ligue 1,32,1989,26.2,32,19,18,13,1,14,37,37.8,23,23,6,17,32,64,72,0,Matches
1631,Gianluca Mancini,ITA,DF,Roma,Serie A,25,1996,32.0,41,25,22,18,1,18,33,54.5,15,38,19,19,39,80,69,0,Matches
1632,Leonardo Mancuso,ITA,FW,Empoli,Serie A,29,1992,4.7,1,1,0,1,0,0,6,0.0,6,2,0,2,1,2,2,0,Matches
1633,Steve Mandanda,FRA,GK,Marseille,Ligue 1,36,1985,9.0,0,0,0,0,0,0,1,0.0,1,1,0,1,1,1,4,1,Matches
1634,Reinildo Mandava,MOZ,DF,Atlético Madrid,La Liga,27,1994,14.4,45,25,30,14,1,22,30,73.3,8,18,9,9,21,66,38,0,Matches
1635,Reinildo Mandava,MOZ,DF,Lille,Ligue 1,27,1994,16.9,43,23,29,11,3,32,51,62.7,19,13,4,9,37,80,55,0,Matches
1636,Aïssa Mandi,ALG,DF,Villarreal,La Liga,29,1991,15.3,11,5,2,8,1,3,6,50.0,3,17,14,3,13,24,49,3,Matches
1637,Rolando Mandragora,ITA,MF,Torino,Serie A,24,1997,14.7,21,10,3,16,2,12,21,57.1,9,18,4,14,10,31,13,0,Matches
1638,Anthony Mandrea,ALG,GK,Angers,Ligue 1,24,1996,10.0,0,0,0,0,0,0,0,,0,0,0,0,0,0,9,0,Matches
1639,Sadio Mané,SEN,FW,Liverpool,Premier League,29,1992,31.3,33,20,7,14,12,8,26,30.8,18,30,1,29,8,41,15,0,Matches
1640,Eliaquim Mangala,FRA,DF,Saint-Étienne,Ligue 1,30,1991,13.1,17,12,12,5,0,8,12,66.7,4,11,8,3,17,34,61,1,Matches
1641,Orel Mangala,BEL,MF,Stuttgart,Bundesliga,23,1998,20.6,17,10,5,7,5,11,22,50.0,11,11,4,7,12,29,19,1,Matches
1642,Thomas Mangani,FRA,MF,Angers,Ligue 1,34,1987,24.4,58,30,23,34,1,31,68,45.6,37,38,11,27,36,94,29,0,Matches
1643,Ricardo Mangas,POR,DF,Bordeaux,Ligue 1,23,1998,26.1,35,22,22,8,5,26,41,63.4,15,18,4,14,25,60,47,3,Matches
1644,Kostas Manolas,GRE,DF,Napoli,Serie A,30,1991,3.5,2,2,1,1,0,2,3,66.7,1,2,1,1,4,6,10,1,Matches
1645,Javier Manquillo,ESP,DF,Newcastle Utd,Premier League,27,1994,14.0,39,29,28,10,1,21,36,58.3,15,15,6,9,10,49,32,0,Matches
1646,Myziane Maolida,COM,MF,Nice,Ligue 1,22,1999,0.4,1,0,0,1,0,0,0,,0,1,0,1,0,1,0,0,Matches
1647,Myziane Maolida,COM,"FW,MF",Hertha BSC,Bundesliga,22,1999,8.6,7,4,5,1,1,3,9,33.3,6,5,0,5,1,8,6,0,Matches
1648,Sekou Mara,FRA,"FW,MF",Bordeaux,Ligue 1,19,2002,10.1,8,4,1,1,6,1,8,12.5,7,7,0,7,2,10,6,0,Matches
1649,Nikola Maraš,SRB,DF,Rayo Vallecano,La Liga,25,1995,11.6,13,9,12,1,0,9,15,60.0,6,17,13,4,15,28,51,0,Matches
1650,Fernando Marçal,BRA,"MF,DF",Wolves,Premier League,32,1989,16.1,42,22,27,14,1,21,37,56.8,16,25,4,21,28,70,52,0,Matches
1651,Marcelo,BRA,DF,Real Madrid,La Liga,33,1988,5.8,8,4,2,3,3,5,10,50.0,5,7,2,5,1,9,11,0,Matches
1652,Marcelo,BRA,DF,Bordeaux,Ligue 1,34,1987,10.0,9,5,7,2,0,4,6,66.7,2,4,3,1,13,22,46,1,Matches
1653,Marcelo,BRA,DF,Lyon,Ligue 1,34,1987,2.0,4,3,0,4,0,4,6,66.7,2,3,2,1,4,8,10,0,Matches
1654,Solly March,ENG,"DF,FW",Brighton,Premier League,27,1994,19.4,30,17,11,9,10,7,22,31.8,15,22,3,19,17,47,25,0,Matches
1655,Riccardo Marchizza,ITA,DF,Empoli,Serie A,23,1998,15.0,21,15,11,8,2,11,16,68.8,5,15,6,9,10,31,24,0,Matches
1656,Gian Marco Ferrari,ITA,DF,Sassuolo,Serie A,29,1992,34.7,16,11,10,6,0,10,23,43.5,13,37,27,10,43,59,114,2,Matches
1657,Iván Marcone,ARG,MF,Elche,La Liga,31,1990,9.0,24,14,17,6,1,12,24,50.0,12,8,3,5,12,36,13,0,Matches
1658,Óscar de Marcos,ESP,DF,Athletic Club,La Liga,32,1989,18.7,50,37,24,19,7,28,43,65.1,15,20,3,17,19,69,27,0,Matches
1659,Davide Marfella,ITA,GK,Napoli,Serie A,21,1999,0.1,0,0,0,0,0,0,0,,0,0,0,0,0,0,0,0,Matches
1660,José Mari,ESP,MF,Cádiz,La Liga,33,1987,4.3,14,7,3,10,1,7,8,87.5,1,4,1,3,7,21,2,0,Matches
1661,Pablo Marí,ESP,DF,Arsenal,Premier League,27,1993,2.0,5,3,1,3,1,3,6,50.0,3,5,4,1,3,8,10,0,Matches
1662,Pablo Marí,ESP,DF,Udinese,Serie A,27,1993,14.9,16,8,8,6,2,8,16,50.0,8,18,12,6,21,37,72,0,Matches
1663,José María Giménez,URU,DF,Atlético Madrid,La Liga,26,1995,22.7,18,12,12,6,0,8,16,50.0,8,25,19,6,25,43,96,1,Matches
1664,Mariano,DOM,FW,Real Madrid,La Liga,27,1993,3.8,2,0,2,0,0,0,0,,0,2,0,2,1,3,3,0,Matches
1665,Răzvan Marin,ROU,MF,Cagliari,Serie A,25,1996,31.3,42,21,16,22,4,24,54,44.4,30,23,5,18,10,52,17,1,Matches
1666,Guillermo Maripán,CHI,DF,Monaco,Ligue 1,27,1994,20.4,36,24,27,9,0,20,40,50.0,20,21,14,7,25,61,66,1,Matches
1667,Mika Màrmol,ESP,DF,Barcelona,La Liga,19,2002,0.0,0,0,0,0,0,0,0,,0,0,0,0,0,0,0,0,Matches
1668,Omar Marmoush,EGY,FW,Wolfsburg,Bundesliga,22,1999,0.3,0,0,0,0,0,0,0,,0,0,0,0,0,0,0,0,Matches
1669,Omar Marmoush,EGY,FW,Stuttgart,Bundesliga,22,1999,17.5,26,17,6,14,6,4,20,20.0,16,9,1,8,7,33,6,0,Matches
1670,Marquinhos,BRA,DF,Paris S-G,Ligue 1,27,1994,31.8,37,14,25,11,1,20,35,57.1,15,35,19,16,16,53,102,0,Matches
1671,Roger Martí,ESP,FW,Levante,La Liga,30,1991,23.5,23,14,3,13,7,8,30,26.7,22,14,0,14,2,25,8,0,Matches
1672,Anthony Martial,FRA,FW,Manchester Utd,Premier League,25,1995,2.4,0,0,0,0,0,0,1,0.0,1,1,0,1,0,0,1,0,Matches
1673,Anthony Martial,FRA,"FW,MF",Sevilla,La Liga,25,1995,5.4,2,1,0,0,2,2,6,33.3,4,4,0,4,0,2,3,0,Matches
1674,Martín,ESP,MF,Cádiz,La Liga,22,1999,1.3,2,2,0,2,0,0,0,,0,1,0,1,1,3,3,0,Matches
1675,Aarón Martín,ESP,DF,Mainz 05,Bundesliga,24,1997,25.5,54,33,32,18,4,24,55,43.6,31,24,4,20,20,74,35,0,Matches
1676,Ander Martin,ESP,"FW,MF",Real Sociedad,La Liga,20,2000,1.0,1,0,0,1,0,1,1,100.0,0,0,0,0,3,4,1,0,Matches
1677,Andrés Martín,ESP,"FW,MF",Rayo Vallecano,La Liga,22,1999,2.1,0,0,0,0,0,0,1,0.0,1,1,0,1,0,0,0,0,Matches
1678,Carlos Martín,ESP,DF,Atlético Madrid,La Liga,19,2002,0.1,0,0,0,0,0,0,0,,0,0,0,0,0,0,1,0,Matches
1679,Iván Martín,ESP,"MF,FW",Alavés,La Liga,22,1999,1.8,1,1,1,0,0,0,1,0.0,1,2,0,2,1,2,1,0,Matches
1680,Jonas Martin,FRA,MF,Rennes,Ligue 1,31,1990,23.4,35,20,12,21,2,19,53,35.8,34,17,3,14,22,57,28,1,Matches
1681,Gabriel Martinelli,BRA,"FW,MF",Arsenal,Premier League,20,2001,20.7,27,19,7,14,6,10,29,34.5,19,26,1,25,20,47,15,0,Matches
1682,Emiliano Martínez,ARG,GK,Aston Villa,Premier League,28,1992,36.0,1,1,1,0,0,1,3,33.3,2,0,0,0,0,1,6,1,Matches
1683,Iñigo Martínez,ESP,DF,Athletic Club,La Liga,30,1991,26.0,28,13,18,7,3,14,23,60.9,9,22,10,12,39,67,143,0,Matches
1684,Javi Martínez,ESP,"MF,FW",Osasuna,La Liga,21,1999,9.8,21,14,8,11,2,10,29,34.5,19,6,0,6,9,30,10,0,Matches
1685,Josep Martinez,ESP,GK,RB Leipzig,Bundesliga,23,1998,1.0,0,0,0,0,0,0,0,,0,0,0,0,0,0,0,0,Matches
1686,Lautaro Martínez,ARG,FW,Inter,Serie A,23,1997,25.4,20,10,3,10,7,6,11,54.5,5,21,1,20,18,38,6,0,Matches
1687,Pablo Martínez,ESP,MF,Levante,La Liga,23,1998,7.3,15,8,7,8,0,4,13,30.8,9,6,3,3,15,30,5,0,Matches
1688,Lucas Martínez Quarta,ARG,DF,Fiorentina,Serie A,25,1996,15.9,36,25,23,11,2,21,34,61.8,13,22,9,13,19,55,46,0,Matches
1689,Gelson Martins,POR,"MF,FW",Monaco,Ligue 1,26,1995,21.2,42,27,10,26,6,21,59,35.6,38,26,1,25,17,59,4,0,Matches
1690,Adam Marušić,MNE,DF,Lazio,Serie A,28,1992,30.2,30,18,16,12,2,13,32,40.6,19,19,8,11,41,71,71,0,Matches
1691,Omar Mascarell,EQG,MF,Elche,La Liga,28,1993,27.7,46,26,16,23,7,24,60,40.0,36,42,14,28,48,94,52,2,Matches
1692,Andrea Masiello,ITA,DF,Genoa,Serie A,35,1986,5.7,5,3,4,1,0,4,7,57.1,3,8,4,4,11,16,20,1,Matches
1693,Adam Masina,MAR,DF,Watford,Premier League,27,1994,12.0,24,13,11,10,3,12,29,41.4,17,18,6,12,18,42,45,0,Matches
1694,Erhan Mašović,SRB,DF,Bochum,Bundesliga,22,1998,17.2,35,20,21,13,1,21,33,63.6,12,28,19,9,34,69,64,1,Matches
1695,Roberto Massimo,GER,"DF,FW",Stuttgart,Bundesliga,20,2000,9.7,14,5,6,7,1,4,16,25.0,12,9,0,9,3,17,6,0,Matches
1696,Arthur Masuaku,COD,"DF,FW",West Ham,Premier League,27,1993,7.2,31,23,19,11,1,14,23,60.9,9,9,1,8,9,40,17,0,Matches
1697,Jaime Mata,ESP,FW,Getafe,La Liga,32,1988,7.5,7,5,3,1,3,1,9,11.1,8,4,1,3,1,8,5,0,Matches
1698,Juan Mata,ESP,MF,Manchester Utd,Premier League,33,1988,2.6,6,4,2,3,1,3,5,60.0,2,1,0,1,1,7,1,0,Matches
1699,Pape Matar Sarr,SEN,MF,Metz,Ligue 1,18,2002,23.7,45,26,21,23,1,18,39,46.2,21,33,3,30,29,74,22,0,Matches
1700,Eliot Matazo,BEL,MF,Monaco,Ligue 1,19,2002,8.8,8,7,4,4,0,2,11,18.2,9,11,3,8,13,21,9,0,Matches
1701,Aleš Matějů,CZE,DF,Venezia,Serie A,25,1996,8.1,16,12,10,5,1,13,29,44.8,16,10,6,4,9,25,15,0,Matches
1702,Jean-Philippe Mateta,FRA,FW,Crystal Palace,Premier League,24,1997,12.7,8,4,2,5,1,3,18,16.7,15,11,3,8,4,12,13,0,Matches
1703,Nemanja Matić,SRB,MF,Manchester Utd,Premier League,32,1988,15.4,31,18,19,11,1,15,31,48.4,16,21,6,15,31,62,21,3,Matches
1704,Joël Matip,CMR,DF,Liverpool,Premier League,29,1991,31.0,47,34,23,19,5,20,31,64.5,11,26,14,12,44,91,93,1,Matches
1705,Chrislain Matsima,FRA,DF,Monaco,Ligue 1,19,2002,1.5,3,2,1,2,0,2,7,28.6,5,3,3,0,1,4,6,1,Matches
1706,Azor Matusiwa,NED,MF,Reims,Ligue 1,23,1998,27.4,58,32,28,26,4,26,55,47.3,29,49,19,30,62,120,43,0,Matches
1707,Neal Maupay,FRA,FW,Brighton,Premier League,24,1996,25.3,17,10,2,6,9,4,18,22.2,14,21,2,19,2,19,2,0,Matches
1708,Stephy Mavididi,ENG,"FW,MF",Montpellier,Ligue 1,23,1998,25.5,24,13,11,7,6,14,39,35.9,25,23,2,21,8,32,11,0,Matches
1709,Konstantinos Mavropanos,GRE,DF,Stuttgart,Bundesliga,23,1997,30.1,57,39,35,21,1,30,51,58.8,21,46,23,23,69,126,174,2,Matches
1710,Eric Maxim Choupo-Moting,CMR,"FW,MF",Bayern Munich,Bundesliga,32,1989,4.2,10,9,3,6,1,3,10,30.0,7,1,0,1,5,15,2,0,Matches
1711,Luís Maximiano,POR,GK,Granada,La Liga,22,1999,34.8,3,1,3,0,0,3,6,50.0,3,0,0,0,1,4,16,2,Matches
1712,Borja Mayoral,ESP,"FW,DF",Roma,Serie A,24,1997,1.1,0,0,0,0,0,0,0,,0,0,0,0,0,0,0,0,Matches
1713,Borja Mayoral,ESP,FW,Getafe,La Liga,24,1997,11.6,7,5,2,3,2,1,2,50.0,1,10,4,6,4,11,3,0,Matches
1714,Derek Mazou-Sacko,FRA,"FW,DF",Troyes,Ligue 1,16,2004,0.0,1,0,0,0,1,1,1,100.0,0,0,0,0,0,1,1,0,Matches
1715,Pasquale Mazzocchi,ITA,DF,Venezia,Serie A,26,1995,13.8,18,8,11,4,3,10,26,38.5,16,11,8,3,21,39,31,1,Matches
1716,Pasquale Mazzocchi,ITA,DF,Salernitana,Serie A,26,1995,14.1,28,19,15,11,2,14,34,41.2,20,5,0,5,11,39,31,0,Matches
1717,Kevin Mbabu,SUI,DF,Wolfsburg,Bundesliga,26,1995,15.5,31,20,21,5,5,12,23,52.2,11,25,8,17,35,66,35,0,Matches
1718,Kylian Mbappé,FRA,FW,Paris S-G,Ligue 1,22,1998,33.6,11,8,1,4,6,7,13,53.8,6,6,0,6,5,16,13,0,Matches
1719,Ibrahima Mbaye,SEN,DF,Bologna,Serie A,26,1994,1.2,1,1,1,0,0,1,2,50.0,1,1,1,0,1,2,6,0,Matches
1720,Amadou Mbengue,SEN,"DF,MF",Metz,Ligue 1,19,2002,6.8,19,10,10,9,0,11,22,50.0,11,7,2,5,10,29,19,0,Matches
1721,Bryan Mbeumo,CMR,FW,Brentford,Premier League,21,1999,32.3,28,16,1,12,15,6,20,30.0,14,21,6,15,11,39,20,0,Matches
1722,Jason Mbock,FRA,FW,Angers,Ligue 1,21,1999,0.2,0,0,0,0,0,0,0,,0,0,0,0,0,0,0,0,Matches
1723,Jordi Mboula,ESP,FW,Mallorca,La Liga,22,1999,4.8,8,2,3,3,2,5,9,55.6,4,7,1,6,3,11,3,0,Matches
1724,Moustapha Mbow,SEN,DF,Reims,Ligue 1,21,2000,1.0,6,6,3,2,1,3,3,100.0,0,0,0,0,1,7,6,0,Matches
1725,Nathanael Mbuku,FRA,"FW,MF",Reims,Ligue 1,19,2002,15.8,14,13,4,7,3,2,8,25.0,6,14,0,14,11,25,4,0,Matches
1726,James McArthur,SCO,MF,Crystal Palace,Premier League,33,1987,16.0,33,23,13,19,1,16,44,36.4,28,23,9,14,30,63,27,0,Matches
1727,James Mcatee,ENG,"MF,FW",Manchester City,Premier League,18,2002,0.2,0,0,0,0,0,0,2,0.0,2,0,0,0,0,0,0,0,Matches
1728,Kasey McAteer,ENG,FW,Leicester City,Premier League,19,2001,0.0,0,0,0,0,0,0,0,,0,0,0,0,0,0,0,0,Matches
1729,Liam McCarron,SCO,FW,Leeds United,Premier League,20,2001,0.1,0,0,0,0,0,0,0,,0,1,0,1,0,0,0,0,Matches
1730,Alex McCarthy,ENG,GK,Southampton,Premier League,31,1989,17.0,0,0,0,0,0,0,0,,0,0,0,0,0,0,4,0,Matches
1731,John McGinn,SCO,MF,Aston Villa,Premier League,26,1994,34.3,106,64,35,55,16,54,104,51.9,50,53,6,47,35,141,34,0,Matches
1732,Weston McKennie,USA,MF,Juventus,Serie A,22,1998,15.2,20,11,11,7,2,8,26,30.8,18,17,8,9,23,43,20,0,Matches
1733,Stuart McKinstry,SCO,MF,Leeds United,Premier League,18,2002,0.0,0,0,0,0,0,0,0,,0,0,0,0,0,0,0,0,Matches
1734,Kenny McLean,SCO,MF,Norwich City,Premier League,29,1992,30.1,42,22,18,20,4,17,59,28.8,42,29,7,22,34,76,54,0,Matches
1735,Dwight McNeil,ENG,MF,Burnley,Premier League,21,1999,34.5,78,49,27,38,13,33,73,45.2,40,64,11,53,35,113,31,1,Matches
1736,Scott McTominay,SCO,MF,Manchester Utd,Premier League,24,1996,26.5,65,33,32,24,9,30,61,49.2,31,45,10,35,31,96,60,1,Matches
1737,Gary Medel,CHI,DF,Bologna,Serie A,33,1987,31.4,39,23,27,11,1,16,36,44.4,20,30,21,9,44,83,112,0,Matches
1738,Facundo Medina,ARG,DF,Lens,Ligue 1,22,1999,28.8,61,42,34,23,4,38,62,61.3,24,24,8,16,37,98,78,3,Matches
1739,Nathan de Medina,BEL,DF,Arminia,Bundesliga,23,1997,8.6,17,10,11,6,0,6,10,60.0,4,14,3,11,10,27,28,0,Matches
1740,Ben Mee,ENG,DF,Burnley,Premier League,31,1989,20.4,26,12,16,7,3,12,19,63.2,7,28,22,6,24,50,94,1,Matches
1741,Admir Mehmedi,SUI,DF,Wolfsburg,Bundesliga,30,1991,0.0,0,0,0,0,0,0,0,,0,0,0,0,0,0,0,0,Matches
1742,Hannibal Mejbri,TUN,FW,Manchester Utd,Premier League,18,2003,0.8,2,1,1,1,0,1,1,100.0,0,0,0,0,0,2,0,0,Matches
1743,Farid El Melali,ALG,FW,Angers,Ligue 1,24,1997,0.2,0,0,0,0,0,0,1,0.0,1,1,0,1,0,0,1,0,Matches
1744,Filippo Melegoni,ITA,"MF,FW",Genoa,Serie A,22,1999,10.9,20,12,5,8,7,8,16,50.0,8,10,1,9,11,31,8,1,Matches
1745,Óscar Melendo,ESP,"MF,FW",Espanyol,La Liga,23,1997,11.0,11,5,4,4,3,3,13,23.1,10,4,1,3,1,12,10,0,Matches
1746,Gonzalo Melero,ESP,MF,Levante,La Liga,27,1994,18.8,29,16,10,15,4,16,36,44.4,20,21,8,13,7,36,22,0,Matches
1747,Birger Meling,NOR,DF,Rennes,Ligue 1,26,1994,20.3,43,27,25,11,7,23,31,74.2,8,23,7,16,22,65,40,0,Matches
1748,Arthur Melo,BRA,MF,Juventus,Serie A,24,1996,10.7,25,12,10,14,1,13,24,54.2,11,11,2,9,7,32,8,1,Matches
1749,Memphis,NED,FW,Barcelona,La Liga,27,1994,20.6,10,4,2,4,4,3,13,23.1,10,9,1,8,3,13,4,0,Matches
1750,Houboulang Mendes,GNB,DF,Lorient,Ligue 1,23,1998,35.8,58,28,37,18,3,40,57,70.2,17,41,21,20,41,99,128,4,Matches
1751,Nuno Mendes,POR,DF,Paris S-G,Ligue 1,19,2002,18.4,48,29,23,18,7,25,47,53.2,22,27,5,22,21,69,17,1,Matches
1752,Pedro Mendes,POR,DF,Montpellier,Ligue 1,30,1990,0.2,1,1,1,0,0,0,0,,0,1,1,0,0,1,2,0,Matches
1753,Thiago Mendes,BRA,"MF,DF",Lyon,Ligue 1,29,1992,20.7,36,22,18,16,2,12,30,40.0,18,24,5,19,34,70,56,1,Matches
1754,Tomás Mendes,ESP,MF,Alavés,La Liga,16,2004,0.1,0,0,0,0,0,0,0,,0,0,0,0,0,0,1,0,Matches
1755,Brais Méndez,ESP,MF,Celta Vigo,La Liga,24,1997,33.6,68,35,24,35,9,26,87,29.9,61,52,6,46,37,105,30,0,Matches
1756,Édgar Méndez,ESP,"FW,MF",Alavés,La Liga,31,1990,17.9,25,14,11,10,4,11,34,32.4,23,16,0,16,4,29,17,0,Matches
1757,Arial Mendy,SEN,"DF,FW",Clermont Foot,Ligue 1,26,1994,8.8,6,4,4,2,0,2,11,18.2,9,6,1,5,7,13,17,0,Matches
1758,Batista Mendy,FRA,"MF,DF",Angers,Ligue 1,21,2000,26.8,49,28,21,22,6,23,45,51.1,22,37,6,31,34,83,40,0,Matches
1759,Benjamin Mendy,FRA,DF,Manchester City,Premier League,27,1994,0.9,2,2,1,1,0,2,6,33.3,4,0,0,0,0,2,0,0,Matches
1760,Edouard Mendy,SEN,GK,Chelsea,Premier League,29,1992,34.0,1,0,1,0,0,1,3,33.3,2,0,0,0,0,1,13,4,Matches
1761,Ferland Mendy,FRA,DF,Real Madrid,La Liga,26,1995,19.3,24,14,11,10,3,8,14,57.1,6,8,2,6,18,42,27,3,Matches
1762,Nampalys Mendy,SEN,MF,Leicester City,Premier League,29,1992,11.5,12,6,8,4,0,6,17,35.3,11,7,4,3,11,23,11,1,Matches
1763,Gideon Mensah,GHA,DF,Bordeaux,Ligue 1,23,1998,13.4,37,24,19,12,6,18,38,47.4,20,11,2,9,16,53,21,0,Matches
1764,Jorge Meré,ESP,DF,Köln,Bundesliga,24,1997,5.4,9,6,3,6,0,4,7,57.1,3,6,4,2,10,19,19,0,Matches
1765,Alex Meret,ITA,GK,Napoli,Serie A,24,1997,6.9,0,0,0,0,0,0,0,,0,0,0,0,0,0,3,1,Matches
1766,Fran Mérida,ESP,MF,Espanyol,La Liga,31,1990,3.0,7,3,5,2,0,4,10,40.0,6,1,0,1,6,13,1,0,Matches
1767,Mikel Merino,ESP,MF,Real Sociedad,La Liga,25,1996,32.1,71,38,21,40,10,26,67,38.8,41,50,10,40,21,92,56,2,Matches
1768,Quentin Merlin,FRA,"DF,MF",Nantes,Ligue 1,19,2002,21.4,45,28,19,20,6,26,49,53.1,23,25,4,21,27,72,29,2,Matches
1769,Martín Merquelanz,ESP,"FW,MF",Rayo Vallecano,La Liga,26,1995,1.9,2,1,2,0,0,2,6,33.3,4,2,0,2,0,2,1,0,Matches
1770,Yıldırım Mert Çetin,TUR,MF,Hellas Verona,Serie A,24,1997,0.5,1,0,1,0,0,1,1,100.0,0,0,0,0,0,1,2,0,Matches
1771,Dries Mertens,BEL,"FW,MF",Napoli,Serie A,34,1987,15.4,16,7,1,11,4,3,16,18.8,13,8,2,6,9,25,2,0,Matches
1772,Illan Meslier,FRA,GK,Leeds United,Premier League,21,2000,37.6,1,1,1,0,0,1,1,100.0,0,0,0,0,0,1,27,1,Matches
1773,Lionel Messi,ARG,"FW,MF",Paris S-G,Ligue 1,34,1987,23.9,10,3,1,5,4,3,13,23.1,10,5,0,5,4,14,0,0,Matches
1774,Junior Messias,BRA,"FW,MF",Milan,Serie A,30,1991,15.9,34,18,11,14,9,15,34,44.1,19,11,1,10,17,51,17,0,Matches
1775,Thomas Meunier,BEL,DF,Dortmund,Bundesliga,29,1991,15.6,29,19,13,12,4,16,33,48.5,17,10,2,8,12,41,25,1,Matches
1776,Mexer,MOZ,DF,Bordeaux,Ligue 1,32,1988,13.6,14,10,11,3,0,11,17,64.7,6,12,7,5,21,35,60,2,Matches
1777,Marco Meyerhöfer,GER,DF,Greuther Fürth,Bundesliga,25,1995,25.3,53,35,22,22,9,24,37,64.9,13,38,19,19,47,100,64,1,Matches
1778,Matt Miazga,USA,DF,Alavés,La Liga,26,1995,9.3,7,7,3,4,0,2,7,28.6,5,14,12,2,11,18,55,1,Matches
1779,Kingsley Michael,NGA,MF,Bologna,Serie A,21,1999,0.8,4,1,2,2,0,1,2,50.0,1,2,1,1,1,5,1,1,Matches
1780,Sven Michel,GER,FW,Union Berlin,Bundesliga,31,1990,3.8,10,6,5,3,2,2,8,25.0,6,3,0,3,1,11,1,0,Matches
1781,Edouard Michut,FRA,MF,Paris S-G,Ligue 1,18,2003,0.8,0,0,0,0,0,0,2,0.0,2,2,0,2,1,1,2,0,Matches
1782,Miguel,ESP,"FW,MF",Alavés,La Liga,21,1999,9.2,7,3,1,5,1,2,15,13.3,13,6,0,6,1,8,7,0,Matches
1783,Valentin Mihaila,ROU,"MF,FW",Atalanta,Serie A,21,2000,0.8,1,1,0,1,0,0,1,0.0,1,2,0,2,0,1,0,0,Matches
1784,Mikael,BRA,"FW,MF",Salernitana,Serie A,22,1999,1.0,1,1,0,1,0,0,0,,0,0,0,0,0,1,1,0,Matches
1785,Hilmir Mikaelsson,ISL,FW,Venezia,Serie A,17,2004,0.2,2,0,0,1,1,0,0,,0,0,0,0,0,2,0,0,Matches
1786,Georges Mikautadze,GEO,FW,Metz,Ligue 1,20,2000,0.0,0,0,0,0,0,0,0,,0,0,0,0,0,0,0,0,Matches
1787,William Mikelbrencis,FRA,DF,Metz,Ligue 1,17,2004,6.8,11,5,6,4,1,6,9,66.7,3,6,3,3,5,16,9,0,Matches
1788,Nikola Milenković,SRB,DF,Fiorentina,Serie A,23,1997,32.5,54,32,31,20,3,29,34,85.3,5,30,15,15,39,93,94,0,Matches
1789,Arkadiusz Milik,POL,FW,Marseille,Ligue 1,27,1994,15.7,9,2,0,5,4,4,18,22.2,14,9,1,8,3,12,10,1,Matches
1790,Sergej Milinković-Savić,SRB,MF,Lazio,Serie A,26,1995,34.4,67,44,20,32,15,29,67,43.3,38,50,9,41,34,101,43,1,Matches
1791,Vanja Milinković-Savić,SRB,GK,Torino,Serie A,24,1997,27.0,0,0,0,0,0,0,1,0.0,1,0,0,0,0,0,7,2,Matches
1792,Éder Militão,BRA,DF,Real Madrid,La Liga,23,1998,33.7,50,32,30,12,8,20,39,51.3,19,42,20,22,52,102,107,3,Matches
1793,Luka Milivojević,SRB,MF,Crystal Palace,Premier League,30,1991,8.6,18,9,9,6,3,10,16,62.5,6,6,1,5,11,29,15,0,Matches
1794,Luis Milla,ESP,MF,Granada,La Liga,26,1994,30.8,59,29,25,30,4,25,64,39.1,39,28,4,24,25,84,34,0,Matches
1795,Pere Milla,ESP,"MF,FW",Elche,La Liga,28,1992,18.3,20,15,14,5,1,8,44,18.2,36,21,1,20,5,25,21,0,Matches
1796,Enzo Millot,FRA,MF,Stuttgart,Bundesliga,19,2002,0.6,2,0,0,2,0,0,1,0.0,1,0,0,0,1,3,1,0,Matches
1797,James Milner,ENG,"MF,DF",Liverpool,Premier League,35,1986,9.5,28,16,12,11,5,12,29,41.4,17,19,5,14,17,45,20,0,Matches
1798,Santi Mina,ESP,FW,Celta Vigo,La Liga,25,1995,26.3,27,17,8,15,4,5,32,15.6,27,28,2,26,6,33,22,0,Matches
1799,Yerry Mina,COL,DF,Everton,Premier League,26,1994,9.4,12,10,12,0,0,10,13,76.9,3,13,9,4,11,23,38,1,Matches
1800,Takumi Minamino,JPN,"FW,MF",Liverpool,Premier League,26,1995,2.1,3,2,1,1,1,2,8,25.0,6,2,0,2,1,4,2,0,Matches
1801,Tyrone Mings,ENG,DF,Aston Villa,Premier League,28,1993,35.4,23,12,17,3,3,14,22,63.6,8,47,30,17,46,69,153,2,Matches
1802,Óscar Mingueza,ESP,DF,Barcelona,La Liga,22,1999,9.9,25,11,12,11,2,16,23,69.6,7,5,0,5,9,34,22,1,Matches
1803,Rafa Mir,ESP,FW,Sevilla,La Liga,24,1997,20.1,4,3,1,1,2,0,11,0.0,11,4,3,1,0,4,17,0,Matches
1804,Jorge Miramón,ESP,DF,Levante,La Liga,32,1989,22.0,36,19,16,12,8,15,44,34.1,29,15,3,12,35,71,58,0,Matches
1805,Aleksei Miranchuk,RUS,"MF,FW",Atalanta,Serie A,25,1995,8.6,11,7,3,7,1,4,12,33.3,8,3,0,3,1,12,7,0,Matches
1806,Juan Miranda,ESP,DF,Betis,La Liga,21,2000,8.7,21,11,16,4,1,12,22,54.5,10,10,4,6,15,36,22,0,Matches
1807,Fabio Miretti,ITA,MF,Juventus,Serie A,17,2003,3.6,4,2,2,2,0,2,9,22.2,7,3,1,2,2,6,3,0,Matches
1808,Tyrick Mitchell,ENG,DF,Crystal Palace,Premier League,21,1999,34.5,104,57,67,26,11,46,67,68.7,21,47,5,42,41,145,101,0,Matches
1809,Stefan Mitrović,SRB,DF,Getafe,La Liga,31,1990,29.6,16,8,12,4,0,8,13,61.5,5,28,18,10,22,38,114,1,Matches
1810,Maximilian Mittelstädt,GER,"DF,FW",Hertha BSC,Bundesliga,24,1997,16.6,52,33,30,12,10,26,50,52.0,24,28,5,23,46,98,37,0,Matches
1811,Henrikh Mkhitaryan,ARM,"MF,FW",Roma,Serie A,32,1989,27.7,45,29,11,27,7,17,52,32.7,35,33,2,31,22,67,33,0,Matches
1812,Jakub Moder,POL,MF,Brighton,Premier League,22,1999,18.9,42,25,18,17,7,23,42,54.8,19,25,2,23,10,52,22,1,Matches
1813,Anthony Modeste,FRA,FW,Köln,Bundesliga,33,1988,29.0,10,6,4,5,1,3,18,16.7,15,11,2,9,4,14,29,0,Matches
1814,Marco Modolo,ITA,DF,Venezia,Serie A,32,1989,4.4,6,3,4,2,0,2,5,40.0,3,6,6,0,4,10,26,0,Matches
1815,Luka Modrić,CRO,MF,Real Madrid,La Liga,35,1985,22.6,18,10,8,7,3,6,27,22.2,21,10,4,6,20,38,9,0,Matches
1816,Terem Moffi,NGA,FW,Lorient,Ligue 1,22,1999,30.1,17,10,3,12,2,9,32,28.1,23,11,2,9,4,21,22,0,Matches
1817,Kevin Möhwald,GER,MF,Union Berlin,Bundesliga,28,1993,3.9,7,1,3,3,1,1,7,14.3,6,3,0,3,3,10,6,0,Matches
1818,Dion Moise Sahi,CIV,"FW,MF",Strasbourg,Ligue 1,19,2001,1.4,0,0,0,0,0,0,0,,0,1,0,1,1,1,1,0,Matches
1819,Johan Mojica,COL,DF,Elche,La Liga,28,1992,31.7,46,25,34,7,5,23,31,74.2,8,22,3,19,25,71,61,3,Matches
1820,Clinton Mola,ENG,DF,Stuttgart,Bundesliga,20,2001,1.3,3,1,2,1,0,2,4,50.0,2,5,5,0,3,6,2,0,Matches
1821,Jorge Molina,ESP,FW,Granada,La Liga,39,1982,21.8,4,2,2,1,1,2,18,11.1,16,13,2,11,6,10,11,0,Matches
1822,Nahuel Molina,ARG,DF,Udinese,Serie A,23,1998,29.3,41,24,17,21,3,16,48,33.3,32,24,3,21,22,63,44,2,Matches
1823,Cristian Molinaro,ITA,DF,Venezia,Serie A,38,1983,6.1,12,9,10,2,0,5,7,71.4,2,7,2,5,6,18,20,0,Matches
1824,Florent Mollet,FRA,"FW,MF",Montpellier,Ligue 1,29,1991,29.2,31,22,14,12,5,14,57,24.6,43,27,4,23,24,55,13,0,Matches
1825,Jon Moncayola,ESP,MF,Osasuna,La Liga,23,1998,32.4,40,20,18,18,4,17,44,38.6,27,26,9,17,20,60,43,0,Matches
1826,Monchu,ESP,MF,Granada,La Liga,21,1999,7.4,15,6,5,9,1,5,10,50.0,5,8,3,5,4,19,4,0,Matches
1827,Thomas Monconduit,FRA,MF,Lorient,Ligue 1,30,1991,25.0,41,25,19,17,5,20,57,35.1,37,21,10,11,22,63,51,1,Matches
1828,Gonzalo Montiel,ARG,DF,Sevilla,La Liga,24,1997,11.8,15,4,8,5,2,12,24,50.0,12,8,2,6,10,25,22,0,Matches
1829,Lorenzo Montipò,ITA,GK,Hellas Verona,Serie A,25,1996,34.0,0,0,0,0,0,0,0,,0,0,0,0,1,1,16,3,Matches
1830,Ángel Montoro,ESP,MF,Granada,La Liga,33,1988,14.8,26,13,16,7,3,17,27,63.0,10,11,1,10,11,37,29,1,Matches
1831,Martín Montoya,ESP,DF,Betis,La Liga,30,1991,5.8,20,12,11,7,2,15,26,57.7,11,6,0,6,11,31,20,0,Matches
1832,Wesley Moraes,BRA,FW,Aston Villa,Premier League,24,1996,0.0,0,0,0,0,0,0,0,,0,0,0,0,0,0,0,0,Matches
1833,Álvaro Morata,ESP,FW,Juventus,Serie A,28,1992,25.6,18,9,4,9,5,8,31,25.8,23,26,1,25,5,23,24,0,Matches
1834,Jan Morávek,CZE,MF,Augsburg,Bundesliga,31,1989,5.2,11,6,3,7,1,6,18,33.3,12,11,2,9,6,17,8,0,Matches
1835,Jon Morcillo,ESP,"MF,FW",Athletic Club,La Liga,22,1998,0.6,3,0,1,2,0,3,4,75.0,1,1,0,1,0,3,0,0,Matches
1836,Jérémy Morel,MAD,DF,Lorient,Ligue 1,37,1984,6.7,13,9,8,4,1,6,6,100.0,0,9,7,2,7,20,31,0,Matches
1837,Alberto Moreno,ESP,"MF,DF",Villarreal,La Liga,29,1992,13.6,13,7,5,7,1,5,18,27.8,13,13,1,12,27,40,15,0,Matches
1838,Álex Moreno,ESP,DF,Betis,La Liga,28,1993,26.7,76,40,53,15,8,33,60,55.0,27,28,6,22,34,110,82,1,Matches
1839,Gerard Moreno,ESP,FW,Villarreal,La Liga,29,1992,13.2,5,2,2,2,1,1,7,14.3,6,6,1,5,6,11,14,0,Matches
1840,Tete Morente,ESP,MF,Elche,La Liga,24,1996,18.1,21,14,13,7,1,7,28,25.0,21,30,1,29,12,33,12,0,Matches
1841,Ilaix Moriba,GUI,MF,Valencia,La Liga,18,2003,9.1,26,18,10,13,3,14,35,40.0,21,15,0,15,12,38,14,0,Matches
1842,Ilaix Moriba,GUI,MF,RB Leipzig,Bundesliga,18,2003,0.4,0,0,0,0,0,0,4,0.0,4,2,0,2,1,1,0,0,Matches
1843,Manu Morlanes,ESP,MF,Espanyol,La Liga,22,1999,12.7,36,15,16,17,3,18,43,41.9,25,24,5,19,13,49,17,0,Matches
1844,Raúl Moro,ESP,FW,Lazio,Serie A,18,2002,2.2,3,3,0,2,1,1,5,20.0,4,2,0,2,0,3,0,0,Matches
1845,Loren Morón,ESP,"FW,MF",Espanyol,La Liga,27,1993,6.3,6,4,1,3,2,0,12,0.0,12,11,1,10,2,8,9,0,Matches
1846,Loren Morón,ESP,FW,Betis,La Liga,27,1993,0.0,1,1,1,0,0,1,1,100.0,0,0,0,0,0,1,0,0,Matches
1847,Tyler Morton,ENG,MF,Liverpool,Premier League,18,2002,0.7,0,0,0,0,0,0,2,0.0,2,0,0,0,3,3,0,0,Matches
1848,Cristhian Mosquera,ESP,DF,Valencia,La Liga,17,2004,2.4,4,2,3,0,1,3,6,50.0,3,1,0,1,3,7,1,1,Matches
1849,Lebo Mothiba,RSA,"FW,MF",Troyes,Ligue 1,25,1996,5.8,8,4,4,3,1,2,5,40.0,3,3,0,3,2,10,0,0,Matches
1850,Lebo Mothiba,RSA,FW,Strasbourg,Ligue 1,25,1996,0.0,0,0,0,0,0,0,0,,0,0,0,0,0,0,0,0,Matches
1851,Andrei Motoc,ROU,DF,Salernitana,Serie A,19,2002,1.0,1,1,0,1,0,0,0,,0,2,2,0,2,3,1,0,Matches
1852,Baptiste Mouazan,FRA,MF,Lorient,Ligue 1,19,2001,1.1,4,3,2,2,0,1,3,33.3,2,3,0,3,1,5,1,0,Matches
1853,Aimen Moueffek,FRA,MF,Saint-Étienne,Ligue 1,20,2001,4.8,7,4,2,3,2,2,8,25.0,6,3,0,3,2,9,4,0,Matches
1854,Youssoufa Moukoko,GER,"FW,MF",Dortmund,Bundesliga,16,2004,2.5,1,0,0,1,0,0,1,0.0,1,5,0,5,3,4,0,0,Matches
1855,Harold Moukoudi,CMR,DF,Saint-Étienne,Ligue 1,23,1997,18.5,25,12,17,8,0,14,25,56.0,11,27,14,13,35,60,48,0,Matches
1856,Jessy Moulin,FRA,GK,Troyes,Ligue 1,35,1986,7.0,0,0,0,0,0,0,0,,0,0,0,0,1,1,7,0,Matches
1857,Steve Mounié,BEN,FW,Brest,Ligue 1,26,1994,25.7,17,6,3,12,2,4,27,14.8,23,13,1,12,6,23,12,0,Matches
1858,Mason Mount,ENG,MF,Chelsea,Premier League,22,1999,26.3,41,16,10,17,14,10,34,29.4,24,18,1,17,13,54,12,0,Matches
1859,Lucas Moura,BRA,"FW,MF",Tottenham,Premier League,28,1992,19.7,25,10,7,14,4,8,35,22.9,27,19,0,19,18,43,19,0,Matches
1860,Lys Mousset,FRA,"MF,FW",Salernitana,Serie A,25,1996,1.8,1,0,0,1,0,0,0,,0,2,0,2,0,1,0,0,Matches
1861,João Moutinho,POR,MF,Wolves,Premier League,34,1986,33.0,74,39,34,27,13,30,106,28.3,76,48,8,40,34,108,36,2,Matches
1862,Samuel Moutoussamy,COD,MF,Nantes,Ligue 1,24,1996,16.8,48,32,20,20,8,23,62,37.1,39,14,2,12,17,65,16,0,Matches
1863,Toni Moya,ESP,MF,Alavés,La Liga,23,1998,15.4,23,10,7,13,3,13,43,30.2,30,18,5,13,20,43,18,0,Matches
1864,Samuel Mráz,SVK,FW,Spezia,Serie A,24,1997,0.6,0,0,0,0,0,0,0,,0,1,0,1,0,0,0,0,Matches
1865,Nordi Mukiele,FRA,"DF,FW",RB Leipzig,Bundesliga,23,1997,20.5,35,22,23,9,3,14,27,51.9,13,31,5,26,31,66,44,2,Matches
1866,Mert Müldür,TUR,DF,Sassuolo,Serie A,22,1999,22.7,52,35,43,7,2,27,49,55.1,22,25,6,19,24,76,44,1,Matches
1867,Florian Müller,GER,GK,Stuttgart,Bundesliga,23,1997,30.0,0,0,0,0,0,0,1,0.0,1,1,0,1,0,0,13,2,Matches
1868,Thomas Müller,GER,MF,Bayern Munich,Bundesliga,31,1989,28.4,35,20,7,16,12,16,54,29.6,38,32,1,31,15,50,12,0,Matches
1869,Bali Mumba,ENG,DF,Norwich City,Premier League,19,2001,0.5,1,1,1,0,0,0,0,,0,0,0,0,0,1,5,0,Matches
1870,Marshall Munetsi,ZIM,"MF,DF",Reims,Ligue 1,25,1996,20.9,34,17,21,11,2,17,39,43.6,22,39,13,26,43,77,72,2,Matches
1871,Iker Muniain,ESP,MF,Athletic Club,La Liga,28,1992,30.9,32,10,8,19,5,12,40,30.0,28,20,1,19,17,49,8,1,Matches
1872,Aihen Muñoz,ESP,DF,Real Sociedad,La Liga,23,1997,14.9,28,17,14,13,1,18,29,62.1,11,11,1,10,17,45,34,0,Matches
1873,Luis Muriel,COL,"FW,MF",Atalanta,Serie A,30,1991,17.1,15,4,2,7,6,3,19,15.8,16,12,0,12,4,19,5,0,Matches
1874,Jeison Murillo,COL,DF,Celta Vigo,La Liga,29,1992,12.4,15,10,13,2,0,9,13,69.2,4,11,8,3,17,32,37,0,Matches
1875,Vedat Muriqi,KVX,FW,Lazio,Serie A,27,1994,2.4,1,0,1,0,0,0,5,0.0,5,0,0,0,0,1,2,0,Matches
1876,Vedat Muriqi,KVX,FW,Mallorca,La Liga,27,1994,16.0,6,3,1,3,2,1,7,14.3,6,12,0,12,6,12,29,0,Matches
1877,Jacob Murphy,ENG,"FW,DF",Newcastle Utd,Premier League,26,1995,16.4,49,26,34,11,4,26,41,63.4,15,20,2,18,23,72,17,0,Matches
1878,Nicola Murru,ITA,DF,Sampdoria,Serie A,26,1994,10.9,22,17,10,11,1,8,13,61.5,5,17,3,14,7,29,20,1,Matches
1879,Yunus Musah,USA,"MF,FW",Valencia,La Liga,18,2002,14.0,23,13,8,8,7,6,20,30.0,14,19,1,18,14,37,11,0,Matches
1880,Torben Müsel,GER,MF,Gladbach,Bundesliga,22,1999,0.1,0,0,0,0,0,0,0,,0,0,0,0,0,0,0,0,Matches
1881,Jamal Musiala,GER,"MF,FW",Bayern Munich,Bundesliga,18,2003,16.3,40,26,11,16,13,15,36,41.7,21,25,0,25,19,59,2,1,Matches
1882,Juan Musso,ARG,GK,Atalanta,Serie A,27,1994,32.6,1,1,1,0,0,0,0,,0,0,0,0,0,1,17,1,Matches
1883,Shkodran Mustafi,GER,DF,Levante,La Liga,29,1992,7.3,9,6,6,3,0,5,9,55.6,4,6,3,3,15,24,40,0,Matches
1884,Junior Mwanga,FRA,DF,Bordeaux,Ligue 1,18,2003,1.0,5,2,4,1,0,3,3,100.0,0,1,0,1,0,5,1,0,Matches
1885,Enock Mwepu,ZAM,MF,Brighton,Premier League,23,1998,11.1,22,12,10,10,2,5,27,18.5,22,20,2,18,12,34,19,0,Matches
1886,Vitaliy Mykolenko,UKR,DF,Everton,Premier League,22,1999,11.7,25,15,15,7,3,12,21,57.1,9,15,2,13,16,41,37,0,Matches
1887,Joakim Mæhle,DEN,"DF,MF",Atalanta,Serie A,24,1997,16.3,21,11,6,9,6,12,27,44.4,15,18,2,16,14,35,13,0,Matches
1888,Obite N'Dicka,CIV,DF,Eint Frankfurt,Bundesliga,21,1999,31.7,60,34,29,27,4,44,59,74.6,15,46,20,26,48,108,137,0,Matches
1889,Kévin N'Doram,FRA,MF,Metz,Ligue 1,25,1996,13.7,10,8,3,5,2,3,20,15.0,17,24,5,19,19,29,21,0,Matches
1890,Eric N'Jo,FRA,DF,Troyes,Ligue 1,17,2004,1.1,0,0,0,0,0,0,1,0.0,1,1,1,0,2,2,1,0,Matches
1891,Vital N'Simba,COD,DF,Clermont Foot,Ligue 1,28,1993,31.0,66,45,38,23,5,36,63,57.1,27,28,7,21,29,95,30,0,Matches
1892,Nacho,ESP,DF,Real Madrid,La Liga,31,1990,17.3,18,14,9,9,0,12,22,54.5,10,22,15,7,34,52,50,0,Matches
1893,Mickael Nade,FRA,DF,Saint-Étienne,Ligue 1,22,1999,28.5,57,35,37,18,2,23,38,60.5,15,29,15,14,60,117,84,0,Matches
1894,Marvelous Nakamba,ZIM,MF,Aston Villa,Premier League,27,1994,10.0,32,19,18,14,0,12,34,35.3,22,14,4,10,12,44,17,1,Matches
1895,Nahitan Nández,URU,"MF,DF",Cagliari,Serie A,25,1995,16.9,39,21,16,15,8,18,33,54.5,15,16,1,15,9,48,15,1,Matches
1896,Nani,POR,"MF,FW",Venezia,Serie A,34,1986,3.2,2,1,1,1,0,0,1,0.0,1,1,0,1,2,4,0,1,Matches
1897,Paul Nardi,FRA,GK,Lorient,Ligue 1,27,1994,22.0,1,0,1,0,0,1,2,50.0,1,0,0,0,0,1,10,2,Matches
1898,Nikolas Nartey,DEN,"MF,DF",Stuttgart,Bundesliga,21,2000,4.5,6,3,0,5,1,3,9,33.3,6,4,2,2,7,13,5,0,Matches
1899,Matija Nastasić,SRB,DF,Fiorentina,Serie A,28,1993,2.4,1,1,1,0,0,1,1,100.0,0,1,1,0,5,6,11,0,Matches
1900,Roberto Navarro,ESP,"MF,FW",Real Sociedad,La Liga,19,2002,2.2,5,3,1,1,3,3,5,60.0,2,2,0,2,2,7,2,0,Matches
1901,Ximo Navarro,ESP,DF,Alavés,La Liga,31,1990,15.0,28,19,21,6,1,13,27,48.1,14,11,5,6,22,50,56,2,Matches
1902,Jesús Navas,ESP,DF,Sevilla,La Liga,35,1985,19.8,18,13,11,5,2,9,17,52.9,8,15,2,13,17,35,26,1,Matches
1903,Keylor Navas,CRC,GK,Paris S-G,Ligue 1,34,1986,20.6,0,0,0,0,0,0,0,,0,0,0,0,0,0,5,1,Matches
1904,Papa Ndiaga Yade,MTN,"DF,FW",Metz,Ligue 1,21,2000,7.7,15,10,8,7,0,8,18,44.4,10,4,1,3,10,25,9,0,Matches
1905,Wilfred Ndidi,NGA,"MF,DF",Leicester City,Premier League,24,1996,18.0,60,32,32,27,1,22,55,40.0,33,36,8,28,42,102,54,1,Matches
1906,Tanguy Ndombele,FRA,MF,Tottenham,Premier League,24,1996,5.4,10,7,3,5,2,1,8,12.5,7,5,0,5,1,11,1,0,Matches
1907,Tanguy Ndombele,FRA,MF,Lyon,Ligue 1,24,1996,7.8,25,14,5,17,3,12,19,63.2,7,8,3,5,3,28,6,2,Matches
1908,Dan Ndoye,SUI,"FW,MF",Nice,Ligue 1,20,2000,2.3,0,0,0,0,0,0,2,0.0,2,4,0,4,0,0,0,0,Matches
1909,Paul Nebel,GER,"MF,FW",Mainz 05,Bundesliga,18,2002,2.5,5,3,3,1,1,2,3,66.7,1,0,0,0,0,5,1,0,Matches
1910,Álvaro Negredo,ESP,FW,Cádiz,La Liga,35,1985,24.0,5,3,1,4,0,3,6,50.0,3,11,5,6,2,7,23,0,Matches
1911,Reiss Nelson,ENG,FW,Arsenal,Premier League,21,1999,0.2,1,0,0,0,1,0,1,0.0,1,1,0,1,0,1,0,0,Matches
1912,David Nemeth,AUT,DF,Mainz 05,Bundesliga,20,2001,3.5,3,2,2,1,0,1,3,33.3,2,5,1,4,6,9,11,1,Matches
1913,Ilija Nestorovski,MKD,FW,Udinese,Serie A,31,1990,2.1,0,0,0,0,0,0,3,0.0,3,0,0,0,0,0,4,0,Matches
1914,Neto,BRA,GK,Barcelona,La Liga,32,1989,3.0,0,0,0,0,0,0,0,,0,0,0,0,0,0,2,1,Matches
1915,Pedro Neto,POR,"FW,MF",Wolves,Premier League,21,2000,5.2,4,4,2,0,2,0,9,0.0,9,0,0,0,6,10,1,0,Matches
1916,Luca Netz,GER,"DF,FW",Gladbach,Bundesliga,18,2003,15.5,24,11,12,10,2,11,40,27.5,29,24,4,20,13,37,33,1,Matches
1917,Manuel Neuer,GER,GK,Bayern Munich,Bundesliga,35,1986,27.9,2,1,2,0,0,1,2,50.0,1,0,0,0,0,2,7,1,Matches
1918,Florian Neuhaus,GER,MF,Gladbach,Bundesliga,24,1997,23.6,55,28,24,26,5,27,64,42.2,37,38,6,32,31,86,19,4,Matches
1919,Carlos Neva,ESP,DF,Granada,La Liga,25,1996,23.4,31,19,24,7,0,16,28,57.1,12,27,9,18,32,63,81,0,Matches
1920,Rúben Neves,POR,MF,Wolves,Premier League,24,1997,29.6,68,37,23,41,4,24,87,27.6,63,39,5,34,41,109,49,3,Matches
1921,Neymar,BRA,"FW,MF",Paris S-G,Ligue 1,29,1992,20.6,29,19,5,12,12,12,36,33.3,24,9,1,8,4,33,2,1,Matches
1922,Yvan Neyou,CMR,MF,Saint-Étienne,Ligue 1,24,1997,10.4,29,13,14,12,3,9,27,33.3,18,8,3,5,23,52,13,0,Matches
1923,Jeremy Ngakia,ENG,DF,Watford,Premier League,20,2000,10.0,31,18,23,5,3,11,26,42.3,15,11,4,7,12,43,32,0,Matches
1924,Jessic Ngankam,GER,FW,Greuther Fürth,Bundesliga,21,2000,3.8,3,1,1,1,1,1,2,50.0,1,3,0,3,0,3,1,0,Matches
1925,Opa Nguette,SEN,"FW,MF",Metz,Ligue 1,27,1994,11.6,21,14,9,6,6,5,14,35.7,9,13,3,10,2,23,9,0,Matches
1926,Aurélien Nguiamba,FRA,MF,Spezia,Serie A,22,1999,0.6,3,2,1,2,0,2,3,66.7,1,2,1,1,0,3,1,0,Matches
1927,Sikou Niakaté,MLI,DF,Metz,Ligue 1,22,1999,7.3,8,7,8,0,0,4,11,36.4,7,5,3,2,27,35,34,0,Matches
1928,Moussa Niakhate,SEN,DF,Mainz 05,Bundesliga,25,1996,28.5,40,23,25,13,2,20,33,60.6,13,37,11,26,50,90,69,1,Matches
1929,Ibrahima Niane,SEN,FW,Metz,Ligue 1,22,1999,17.6,1,1,0,1,0,0,5,0.0,5,6,1,5,3,4,16,0,Matches
1930,M'Baye Niang,SEN,FW,Bordeaux,Ligue 1,26,1994,8.6,4,0,0,2,2,0,4,0.0,4,9,1,8,1,5,4,0,Matches
1931,Tanguy Nianzou,FRA,DF,Bayern Munich,Bundesliga,19,2002,6.5,11,7,7,3,1,7,11,63.6,4,7,2,5,7,18,17,0,Matches
1932,Cheikh Niasse,SEN,"FW,MF",Lille,Ligue 1,21,2000,0.5,2,2,0,2,0,2,3,66.7,1,1,1,0,1,3,2,0,Matches
1933,Florian Niederlechner,GER,FW,Augsburg,Bundesliga,30,1990,12.9,6,5,1,3,2,4,13,30.8,9,9,0,9,4,10,7,0,Matches
1934,Håvard Nielsen,NOR,"MF,FW",Greuther Fürth,Bundesliga,28,1993,15.2,17,12,5,11,1,8,21,38.1,13,18,1,17,7,24,22,0,Matches
1935,Saúl Ñíguez,ESP,"DF,MF",Chelsea,Premier League,26,1994,5.3,20,9,11,9,0,9,16,56.3,7,14,3,11,7,27,10,1,Matches
1936,Saúl Ñíguez,ESP,"FW,MF",Atlético Madrid,La Liga,26,1994,2.2,7,2,0,6,1,3,4,75.0,1,7,1,6,0,7,3,0,Matches
1937,Dimitris Nikolaou,GRE,DF,Spezia,Serie A,22,1998,36.0,39,26,29,7,3,22,34,64.7,12,48,24,24,49,88,132,1,Matches
1938,Joakim Nilsson,SWE,DF,Arminia,Bundesliga,27,1994,30.4,37,19,24,13,0,20,26,76.9,6,36,23,13,56,93,143,1,Matches
1939,Casimir Ninga,CHA,FW,Angers,Ligue 1,28,1993,4.5,5,1,1,4,0,2,5,40.0,3,2,0,2,1,6,0,0,Matches
1940,Fernando Niño,ESP,FW,Mallorca,La Liga,20,2000,9.8,10,4,3,2,5,2,12,16.7,10,9,2,7,3,13,15,0,Matches
1941,Eddie Nketiah,ENG,FW,Arsenal,Premier League,22,1999,9.3,9,4,1,4,4,1,4,25.0,3,9,2,7,4,13,5,0,Matches
1942,Nicolas Nkoulou,CMR,DF,Watford,Premier League,31,1990,1.9,1,0,0,1,0,0,0,,0,2,1,1,2,3,8,0,Matches
1943,Christopher Nkunku,FRA,"FW,MF",RB Leipzig,Bundesliga,23,1997,30.3,23,10,10,11,2,9,35,25.7,26,23,2,21,15,38,15,0,Matches
1944,Felix Nmecha,GER,"MF,FW",Wolfsburg,Bundesliga,20,2000,3.6,3,1,1,1,1,0,2,0.0,2,2,0,2,7,10,6,0,Matches
1945,Lukas Nmecha,GER,"FW,MF",Wolfsburg,Bundesliga,22,1998,18.1,12,5,5,5,2,5,19,26.3,14,9,1,8,4,16,10,0,Matches
1946,Mark Noble,ENG,MF,West Ham,Premier League,34,1987,3.7,8,2,7,1,0,5,11,45.5,6,4,1,3,4,12,2,1,Matches
1947,Peru Nolaskoain,ESP,DF,Athletic Club,La Liga,22,1998,0.0,0,0,0,0,0,0,0,,0,0,0,0,0,0,0,0,Matches
1948,Nolito,ESP,MF,Celta Vigo,La Liga,34,1986,15.4,25,15,14,7,4,13,47,27.7,34,20,1,19,9,34,5,0,Matches
1949,Arnaud Nordin,FRA,"FW,MF",Saint-Étienne,Ligue 1,23,1998,20.8,21,11,8,8,5,8,22,36.4,14,19,0,19,6,27,8,0,Matches
1950,Håvard Nordtveit,NOR,DF,Hoffenheim,Bundesliga,31,1990,3.4,7,6,2,4,1,4,4,100.0,0,2,1,1,10,17,11,0,Matches
1951,Mathias Normann,NOR,MF,Norwich City,Premier League,25,1996,18.3,34,21,19,14,1,17,46,37.0,29,17,8,9,19,53,43,1,Matches
1952,Connor Noß,IRL,MF,Gladbach,Bundesliga,20,2001,0.6,1,0,0,1,0,0,1,0.0,1,1,1,0,0,1,0,0,Matches
1953,Hugo Novoa,ESP,"MF,FW",RB Leipzig,Bundesliga,18,2003,1.5,4,4,2,0,2,2,7,28.6,5,2,0,2,1,5,0,0,Matches
1954,Soma Novothny,HUN,"FW,MF",Bochum,Bundesliga,27,1994,0.9,1,1,1,0,0,0,1,0.0,1,1,0,1,0,1,2,0,Matches
1955,Jean-Pierre Nsame,CMR,FW,Venezia,Serie A,28,1993,2.7,1,1,0,0,1,0,0,,0,0,0,0,0,1,1,0,Matches
1956,Randy Nteka,ANG,"FW,MF",Rayo Vallecano,La Liga,23,1997,16.2,24,13,9,11,4,8,19,42.1,11,21,1,20,8,32,12,0,Matches
1957,Alexander Nübel,GER,GK,Monaco,Ligue 1,24,1996,38.0,0,0,0,0,0,0,1,0.0,1,0,0,0,0,0,11,1,Matches
1958,Kasim Nuhu,GHA,DF,Hoffenheim,Bundesliga,26,1995,0.1,0,0,0,0,0,0,1,0.0,1,0,0,0,0,0,1,0,Matches
1959,Unai Núñez,ESP,DF,Athletic Club,La Liga,24,1997,6.9,4,4,2,2,0,3,6,50.0,3,9,8,1,8,12,26,2,Matches
1960,Hans Nunoo Sarpei,GHA,"DF,MF",Greuther Fürth,Bundesliga,22,1998,7.1,16,11,9,7,0,10,14,71.4,4,8,5,3,14,30,21,0,Matches
1961,Bram Nuytinck,NED,DF,Udinese,Serie A,31,1990,22.6,38,24,24,13,1,15,34,44.1,19,42,31,11,22,60,101,0,Matches
1962,Simeon Nwankwo,NGA,FW,Salernitana,Serie A,29,1992,9.4,5,5,0,4,1,4,10,40.0,6,8,3,5,3,8,10,0,Matches
1963,Gerzino Nyamsi,FRA,DF,Strasbourg,Ligue 1,24,1997,33.2,35,21,24,9,2,20,27,74.1,7,25,16,9,25,60,90,1,Matches
1964,Allan Nyom,CMR,DF,Getafe,La Liga,33,1988,2.7,3,1,2,1,0,2,2,100.0,0,2,1,1,2,5,7,0,Matches
1965,M'Bala Nzola,ANG,FW,Spezia,Serie A,24,1996,11.9,2,2,0,0,2,1,6,16.7,5,8,0,8,0,2,13,0,Matches
1966,Christian Nørgaard,DEN,MF,Brentford,Premier League,27,1994,33.9,109,60,42,58,9,52,101,51.5,49,48,9,39,64,173,58,1,Matches
1967,Adam Obert,SVK,"DF,MF",Cagliari,Serie A,18,2002,3.0,8,5,6,2,0,5,6,83.3,1,6,4,2,4,12,11,0,Matches
1968,Joel Obi,NGA,"MF,DF",Salernitana,Serie A,30,1991,12.7,23,14,5,14,4,5,12,41.7,7,17,6,11,10,33,7,0,Matches
1969,Jan Oblak,SVN,GK,Atlético Madrid,La Liga,28,1993,38.0,0,0,0,0,0,0,0,,0,0,0,0,1,1,10,4,Matches
1970,Lucas Ocampos,ARG,FW,Sevilla,La Liga,27,1994,23.6,45,24,23,18,4,23,55,41.8,32,35,1,34,9,54,24,1,Matches
1971,Bastian Oczipka,GER,DF,Union Berlin,Bundesliga,32,1989,10.4,24,15,15,7,2,10,13,76.9,3,10,2,8,12,36,21,0,Matches
1972,Brian Oddei,ITA,FW,Sassuolo,Serie A,18,2002,0.1,0,0,0,0,0,0,0,,0,0,0,0,0,0,0,0,Matches
1973,Álvaro Odriozola,ESP,DF,Fiorentina,Serie A,25,1995,19.3,25,15,12,6,7,15,32,46.9,17,17,6,11,8,33,25,2,Matches
1974,Angelo Ogbonna,ITA,DF,West Ham,Premier League,33,1988,10.2,7,4,5,2,0,3,7,42.9,4,5,4,1,11,18,29,0,Matches
1975,Florent Ogier,FRA,DF,Clermont Foot,Ligue 1,32,1989,27.0,31,17,18,12,1,17,31,54.8,14,41,27,14,37,68,89,0,Matches
1976,Stefano Okaka,ITA,FW,Udinese,Serie A,31,1989,0.2,0,0,0,0,0,0,0,,0,2,0,2,0,0,1,0,Matches
1977,David Okereke,NGA,"FW,MF",Venezia,Serie A,23,1997,22.8,16,10,4,9,3,3,20,15.0,17,19,3,16,10,26,20,0,Matches
1978,Masaya Okugawa,JPN,"MF,FW",Arminia,Bundesliga,25,1996,28.1,46,25,18,22,6,12,37,32.4,25,29,1,28,20,66,13,0,Matches
1979,Lucas Olaza,URU,DF,Elche,La Liga,27,1994,3.3,5,3,3,1,1,1,1,100.0,0,5,1,4,4,9,6,0,Matches
1980,Oier Olazábal,ESP,GK,Espanyol,La Liga,31,1989,1.5,0,0,0,0,0,0,0,,0,0,0,0,0,0,0,0,Matches
1981,Mathias Olesen,LUX,"MF,FW",Köln,Bundesliga,20,2001,0.2,0,0,0,0,0,0,0,,0,0,0,0,1,1,0,0,Matches
1982,Michael Olise,FRA,"FW,MF",Crystal Palace,Premier League,19,2001,12.7,22,18,8,11,3,7,24,29.2,17,17,0,17,6,28,6,0,Matches
1983,Christian Oliva,URU,MF,Cagliari,Serie A,25,1996,0.5,2,2,2,0,0,1,4,25.0,3,0,0,0,0,2,0,0,Matches
1984,Brian Oliván,ESP,DF,Mallorca,La Liga,27,1994,24.3,33,20,22,9,2,12,23,52.2,11,17,7,10,28,61,63,0,Matches
1985,Sérgio Oliveira,POR,MF,Roma,Serie A,29,1992,9.9,27,14,11,14,2,15,30,50.0,15,13,0,13,10,37,7,0,Matches
1986,Mathías Olivera,URU,DF,Getafe,La Liga,23,1997,31.1,79,47,39,34,6,40,69,58.0,29,45,4,41,55,134,67,1,Matches
1987,Dani Olmo,ESP,"MF,FW",RB Leipzig,Bundesliga,23,1998,8.3,14,6,5,7,2,5,18,27.8,13,5,1,4,4,18,1,0,Matches
1988,Robin Olsen,SWE,GK,Aston Villa,Premier League,31,1990,1.0,0,0,0,0,0,0,0,,0,0,0,0,0,0,0,0,Matches
1989,Warmed Omari,FRA,DF,Rennes,Ligue 1,21,2000,31.1,33,17,22,10,1,15,23,65.2,8,20,13,7,31,64,94,5,Matches
1990,Jonas Omlin,SUI,GK,Montpellier,Ligue 1,27,1994,28.7,2,1,2,0,0,2,3,66.7,1,0,0,0,0,2,12,3,Matches
1991,Andrew Omobamidele,IRL,DF,Norwich City,Premier League,19,2002,4.2,8,6,5,3,0,5,11,45.5,6,8,8,0,5,13,13,0,Matches
1992,Amadou Onana,BEL,MF,Lille,Ligue 1,19,2001,15.1,48,31,17,27,4,18,25,72.0,7,10,3,7,30,78,19,0,Matches
1993,Jean Onana,CMR,MF,Bordeaux,Ligue 1,21,2000,20.4,70,49,33,33,4,35,86,40.7,51,37,5,32,36,106,23,1,Matches
1994,Karim Onisiwo,AUT,FW,Mainz 05,Bundesliga,29,1992,26.2,18,10,4,6,8,7,22,31.8,15,27,2,25,7,25,8,0,Matches
1995,Javier Ontiveros,ESP,"FW,MF",Osasuna,La Liga,23,1997,0.4,0,0,0,0,0,0,2,0.0,2,0,0,0,1,1,0,1,Matches
1996,Tyler Onyango,ENG,MF,Everton,Premier League,18,2003,0.3,0,0,0,0,0,0,0,,0,0,0,0,0,0,1,0,Matches
1997,Frank Onyeka,NGA,MF,Brentford,Premier League,23,1998,11.6,25,17,13,9,3,8,27,29.6,19,16,2,14,14,39,13,0,Matches
1998,Willi Orban,HUN,DF,RB Leipzig,Bundesliga,28,1992,29.4,32,22,20,11,1,13,25,52.0,12,40,24,16,44,76,123,2,Matches
1999,Divock Origi,BEL,FW,Liverpool,Premier League,26,1995,1.5,0,0,0,0,0,0,2,0.0,2,1,0,1,1,1,2,0,Matches
2000,Riccardo Orsolini,ITA,"FW,MF",Bologna,Serie A,24,1997,19.8,21,13,9,11,1,13,29,44.8,16,9,4,5,5,26,14,0,Matches
2001,Stefan Ortega,GER,GK,Arminia,Bundesliga,28,1992,33.0,1,0,1,0,0,1,2,50.0,1,2,0,2,0,1,5,1,Matches
2002,Pedro Ortiz,ESP,MF,Sevilla,La Liga,20,2000,0.1,0,0,0,0,0,0,0,,0,0,0,0,0,0,1,0,Matches
2003,Victor Osimhen,NGA,FW,Napoli,Serie A,22,1998,22.0,10,5,1,2,7,2,6,33.3,4,16,3,13,3,13,17,0,Matches
2004,Milutin Osmajić,MNE,"FW,MF",Cádiz,La Liga,22,1999,2.9,1,1,0,1,0,0,0,,0,0,0,0,1,2,3,0,Matches
2005,David Ospina,COL,GK,Napoli,Serie A,32,1988,31.0,0,0,0,0,0,0,0,,0,0,0,0,1,1,11,1,Matches
2006,Patrick Osterhage,GER,MF,Bochum,Bundesliga,21,2000,6.7,9,6,3,5,1,3,7,42.9,4,7,1,6,11,20,8,0,Matches
2007,Tomáš Ostrák,CZE,"MF,FW",Köln,Bundesliga,21,2000,0.3,1,0,0,0,1,1,3,33.3,2,0,0,0,1,2,0,0,Matches
2008,Otávio,BRA,MF,Bordeaux,Ligue 1,27,1994,12.7,36,23,13,21,2,16,39,41.0,23,9,3,6,18,54,11,0,Matches
2009,Paulo Otávio,BRA,"DF,MF",Wolfsburg,Bundesliga,26,1994,4.0,14,10,7,4,3,8,15,53.3,7,11,6,5,4,18,9,0,Matches
2010,Dango Ouattara,BFA,"MF,FW",Lorient,Ligue 1,19,2002,9.0,21,15,9,11,1,11,23,47.8,12,10,1,9,14,35,15,1,Matches
2011,Remi Oudin,FRA,"MF,FW",Bordeaux,Ligue 1,24,1996,19.3,34,18,19,13,2,18,32,56.3,14,14,3,11,27,61,21,0,Matches
2012,Alexandre Oukidja,ALG,GK,Metz,Ligue 1,33,1988,20.8,0,0,0,0,0,0,1,0.0,1,1,0,1,1,1,17,2,Matches
2013,Azzedine Ounahi,MAR,MF,Angers,Ligue 1,21,2000,18.1,39,22,16,22,1,11,40,27.5,29,19,1,18,26,65,13,0,Matches
2014,Adam Ounas,ALG,"MF,FW",Napoli,Serie A,24,1996,3.6,6,1,0,3,3,3,7,42.9,4,3,0,3,2,8,3,0,Matches
2015,Jesús Owono,EQG,GK,Alavés,La Liga,20,2001,1.0,0,0,0,0,0,0,0,,0,0,0,0,0,0,1,0,Matches
2016,Reece Oxford,ENG,DF,Augsburg,Bundesliga,22,1998,29.9,27,14,16,9,2,15,31,48.4,16,42,33,9,72,99,172,1,Matches
2017,Alex Oxlade-Chamberlain,ENG,"MF,FW",Liverpool,Premier League,27,1993,8.7,15,11,2,8,5,3,14,21.4,11,12,2,10,6,21,5,0,Matches
2018,Mikel Oyarzabal,ESP,"FW,MF",Real Sociedad,La Liga,24,1997,18.6,18,10,7,7,4,7,21,33.3,14,18,2,16,10,28,16,1,Matches
2019,Ambroise Oyongo,CMR,DF,Montpellier,Ligue 1,30,1991,7.3,13,4,7,4,2,9,15,60.0,6,5,1,4,6,19,17,0,Matches
2020,Salih Özcan,TUR,MF,Köln,Bundesliga,23,1998,25.7,42,30,14,23,5,22,51,43.1,29,37,5,32,51,93,35,1,Matches
2021,Levin Öztunalı,GER,MF,Union Berlin,Bundesliga,25,1996,6.4,14,11,6,5,3,7,17,41.2,10,3,0,3,4,18,12,0,Matches
2022,Fernando Pacheco,ESP,GK,Alavés,La Liga,29,1992,33.9,2,1,2,0,0,2,2,100.0,0,0,0,0,0,2,18,1,Matches
2023,Jon Pacheco,ESP,DF,Real Sociedad,La Liga,20,2001,4.2,6,4,4,2,0,3,3,100.0,0,6,4,2,6,12,18,0,Matches
2024,Gonçalo Paciência,POR,FW,Eint Frankfurt,Bundesliga,26,1994,5.7,4,2,2,1,1,1,3,33.3,2,2,0,2,1,5,4,0,Matches
2025,Daniele Padelli,ITA,GK,Udinese,Serie A,35,1985,3.0,0,0,0,0,0,0,0,,0,0,0,0,0,0,2,1,Matches
2026,Simone Pafundi,ITA,FW,Udinese,Serie A,15,2006,0.3,0,0,0,0,0,0,1,0.0,1,0,0,0,0,0,0,0,Matches
2027,Vincent Pajot,FRA,MF,Metz,Ligue 1,30,1990,25.7,86,56,35,47,4,20,46,43.5,26,33,6,27,51,137,38,0,Matches
2028,Exequiel Palacios,ARG,MF,Leverkusen,Bundesliga,22,1998,12.2,30,19,12,14,4,15,38,39.5,23,20,1,19,28,58,11,2,Matches
2029,Helibelton Palacios,COL,DF,Elche,La Liga,28,1993,21.5,69,38,56,10,3,37,55,67.3,18,21,8,13,18,87,61,0,Matches
2030,Isaac Palazón Camacho,ESP,"FW,MF",Rayo Vallecano,La Liga,26,1994,25.4,42,28,20,19,3,18,59,30.5,41,31,3,28,13,55,22,0,Matches
2031,Nicolas Pallois,FRA,DF,Nantes,Ligue 1,33,1987,27.2,51,33,40,11,0,34,59,57.6,25,40,19,21,53,104,116,1,Matches
2032,Cole Palmer,ENG,"FW,MF",Manchester City,Premier League,19,2002,1.4,2,1,1,1,0,0,2,0.0,2,3,0,3,1,3,0,0,Matches
2033,Erik Palmer-Brown,USA,DF,Troyes,Ligue 1,24,1997,19.3,37,22,29,8,0,20,26,76.9,6,26,18,8,34,71,87,1,Matches
2034,Emerson Palmieri,ITA,DF,Chelsea,Premier League,26,1994,0.1,0,0,0,0,0,0,0,,0,0,0,0,0,0,0,0,Matches
2035,Emerson Palmieri,ITA,DF,Lyon,Ligue 1,26,1994,25.2,46,25,16,22,8,22,34,64.7,12,23,8,15,27,73,66,0,Matches
2036,Martin Palumbo,NOR,FW,Juventus,Serie A,19,2002,0.1,0,0,0,0,0,0,1,0.0,1,0,0,0,0,0,0,0,Matches
2037,Goran Pandev,MKD,"FW,MF",Genoa,Serie A,38,1983,9.4,2,0,1,0,1,0,9,0.0,9,3,1,2,2,4,0,0,Matches
2038,Ivor Pandur,CRO,GK,Hellas Verona,Serie A,21,2000,3.0,0,0,0,0,0,0,0,,0,0,0,0,0,0,2,0,Matches
2039,Miloš Pantović,SRB,"MF,FW",Bochum,Bundesliga,25,1996,17.0,19,10,8,7,4,6,25,24.0,19,26,4,22,18,37,14,0,Matches
2040,Antonios Papadopoulos,GER,"DF,MF",Dortmund,Bundesliga,21,1999,0.2,0,0,0,0,0,0,0,,0,1,0,1,0,0,0,0,Matches
2041,Merveille Papela,GER,MF,Mainz 05,Bundesliga,20,2001,0.9,3,2,2,1,0,2,3,66.7,1,2,0,2,2,5,0,0,Matches
2042,Lucas Paquetá,BRA,"MF,FW",Lyon,Ligue 1,23,1997,30.0,68,38,24,26,18,17,51,33.3,34,43,5,38,9,77,22,0,Matches
2043,Rubén Pardo,ESP,MF,Bordeaux,Ligue 1,28,1992,0.1,0,0,0,0,0,0,0,,0,0,0,0,0,0,0,0,Matches
2044,Kevin Paredes,USA,"FW,DF",Wolfsburg,Bundesliga,18,2003,0.2,1,0,0,0,1,0,0,,0,1,0,1,0,1,0,0,Matches
2045,Leandro Paredes,ARG,MF,Paris S-G,Ligue 1,27,1994,9.3,23,13,9,11,3,12,24,50.0,12,10,6,4,10,33,5,2,Matches
2046,Daniel Parejo,ESP,MF,Villarreal,La Liga,32,1989,30.0,43,29,15,15,13,20,52,38.5,32,32,7,25,29,72,19,1,Matches
2047,Fabiano Parisi,ITA,DF,Empoli,Serie A,20,2000,16.4,35,19,25,5,5,13,31,41.9,18,30,10,20,22,57,42,0,Matches
2048,Raúl Parra,ESP,DF,Cádiz,La Liga,21,1999,1.0,2,1,2,0,0,1,3,33.3,2,0,0,0,0,2,5,0,Matches
2049,Thomas Partey,GHA,MF,Arsenal,Premier League,28,1993,22.5,43,29,22,17,4,18,44,40.9,26,22,4,18,23,66,35,2,Matches
2050,Mario Pašalić,CRO,"MF,FW",Atalanta,Serie A,26,1995,22.2,27,12,8,13,6,12,30,40.0,18,27,6,21,20,47,14,0,Matches
2051,Felix Passlack,GER,DF,Dortmund,Bundesliga,23,1998,5.2,13,9,8,4,1,6,12,50.0,6,5,1,4,4,17,7,0,Matches
2052,Javier Pastore,ARG,"MF,FW",Elche,La Liga,32,1989,5.8,7,3,3,2,2,3,12,25.0,9,5,1,4,4,11,2,0,Matches
2053,Patric,ESP,DF,Lazio,Serie A,28,1993,18.3,21,15,17,4,0,9,20,45.0,11,22,11,11,12,33,44,2,Matches
2054,Rui Patrício,POR,GK,Roma,Serie A,33,1988,38.0,0,0,0,0,0,0,0,,0,1,0,1,0,0,10,3,Matches
2055,Paulinho,BRA,"FW,MF",Leverkusen,Bundesliga,21,2000,13.5,22,13,6,13,3,13,27,48.1,14,14,1,13,6,28,7,0,Matches
2056,Gabriel Paulista,BRA,DF,Valencia,La Liga,30,1990,17.7,21,12,16,5,0,14,20,70.0,6,18,12,6,39,60,88,0,Matches
2057,Benjamin Pavard,FRA,DF,Bayern Munich,Bundesliga,25,1996,23.1,35,20,21,13,1,19,29,65.5,10,28,16,12,36,71,50,1,Matches
2058,Strahinja Pavlović,SRB,DF,Monaco,Ligue 1,20,2001,5.0,23,16,8,13,2,8,12,66.7,4,5,3,2,9,32,15,0,Matches
2059,Leonardo Pavoletti,ITA,FW,Cagliari,Serie A,32,1988,16.9,10,6,2,5,3,3,9,33.3,6,9,5,4,2,12,12,0,Matches
2060,Dimitri Payet,FRA,"FW,MF",Marseille,Ligue 1,34,1987,28.8,16,8,4,10,2,7,31,22.6,24,9,0,9,9,25,3,0,Matches
2061,Mads Pedersen,DEN,"MF,DF",Augsburg,Bundesliga,24,1996,15.5,28,21,8,15,5,12,27,44.4,15,13,4,9,15,43,30,0,Matches
2062,Alfonso Pedraza,ESP,DF,Villarreal,La Liga,25,1996,18.9,34,16,17,12,5,10,28,35.7,18,12,3,9,31,65,32,0,Matches
2063,Pedri,ESP,MF,Barcelona,La Liga,18,2002,9.8,20,12,9,8,3,7,20,35.0,13,13,0,13,5,25,7,1,Matches
2064,Pedro,ESP,FW,Lazio,Serie A,34,1987,22.6,36,23,8,19,9,16,47,34.0,31,18,2,16,6,42,8,0,Matches
2065,João Pedro,ITA,FW,Cagliari,Serie A,29,1992,36.9,15,12,2,8,5,4,18,22.2,14,23,5,18,8,23,18,1,Matches
2066,Adrià Pedrosa,ESP,DF,Espanyol,La Liga,23,1998,30.2,58,30,38,14,6,26,57,45.6,31,25,7,18,25,83,92,2,Matches
2067,Gianluca Pegolo,ITA,GK,Sassuolo,Serie A,40,1981,1.0,0,0,0,0,0,0,0,,0,0,0,0,0,0,0,1,Matches
2068,Peter Pekarík,SVK,DF,Hertha BSC,Bundesliga,34,1986,24.8,45,29,33,11,1,32,46,69.6,14,28,10,18,29,74,58,0,Matches
2069,Pietro Pellegri,ITA,FW,Torino,Serie A,20,2001,2.4,1,1,0,1,0,0,4,0.0,4,0,0,0,0,1,5,0,Matches
2070,Pietro Pellegri,ITA,FW,Milan,Serie A,20,2001,1.5,2,2,0,1,1,0,1,0.0,1,0,0,0,0,2,1,0,Matches
2071,Lorenzo Pellegrini,ITA,MF,Roma,Serie A,25,1996,25.4,35,14,10,17,8,16,60,26.7,44,29,1,28,27,62,20,0,Matches
2072,Luca Pellegrini,ITA,DF,Juventus,Serie A,22,1999,12.3,23,10,13,5,5,12,19,63.2,7,9,1,8,5,28,23,0,Matches
2073,Facundo Pellistri,URU,"MF,FW",Alavés,La Liga,19,2001,7.5,9,5,4,3,2,1,10,10.0,9,13,2,11,6,15,7,0,Matches
2074,Federico Peluso,ITA,DF,Sassuolo,Serie A,37,1984,0.1,1,1,0,1,0,1,1,100.0,0,0,0,0,0,1,0,0,Matches
2075,Timothee Pembele,FRA,DF,Bordeaux,Ligue 1,18,2002,15.7,20,8,8,10,2,10,29,34.5,19,12,3,9,16,36,24,0,Matches
2076,Rubén Peña,ESP,"MF,FW",Villarreal,La Liga,30,1991,1.5,2,0,1,1,0,2,6,33.3,4,1,0,1,5,7,2,0,Matches
2077,Philipp Pentke,GER,GK,Hoffenheim,Bundesliga,36,1985,1.0,0,0,0,0,0,0,0,,0,0,0,0,0,0,0,0,Matches
2078,Nicolas Pépé,CIV,"FW,MF",Arsenal,Premier League,26,1995,7.7,8,5,3,5,0,3,9,33.3,6,9,1,8,8,16,2,0,Matches
2079,Ricardo Pepi,USA,"FW,MF",Augsburg,Bundesliga,18,2003,5.3,4,2,1,3,0,1,8,12.5,7,7,0,7,3,7,8,0,Matches
2080,Alberto Perea,ESP,MF,Cádiz,La Liga,30,1990,8.6,19,9,7,9,3,6,20,30.0,14,15,1,14,9,28,4,0,Matches
2081,Brayann Pereira,FRA,"DF,MF",Lens,Ligue 1,18,2003,0.2,1,1,1,0,0,1,1,100.0,0,0,0,0,0,1,1,0,Matches
2082,Danilo Pereira,POR,MF,Paris S-G,Ligue 1,29,1991,22.6,33,17,10,20,3,14,28,50.0,14,19,10,9,37,70,29,1,Matches
2083,Mathias Pereira Lage,POR,DF,Angers,Ligue 1,24,1996,11.6,21,7,10,7,4,8,30,26.7,22,18,7,11,21,42,22,0,Matches
2084,Ricardo Pereira,POR,DF,Leicester City,Premier League,27,1993,11.0,37,20,19,13,5,21,40,52.5,19,13,1,12,17,54,39,0,Matches
2085,Gastón Pereiro,URU,"FW,MF",Cagliari,Serie A,26,1995,10.8,13,5,7,4,2,5,18,27.8,13,12,1,11,1,14,8,0,Matches
2086,Luan Peres Petroni,BRA,DF,Marseille,Ligue 1,27,1994,29.8,65,35,33,25,7,36,52,69.2,16,26,12,14,43,108,64,1,Matches
2087,Dor Peretz,ISR,MF,Venezia,Serie A,26,1995,6.5,27,18,8,16,3,13,25,52.0,12,8,4,4,8,35,11,0,Matches
2088,Roberto Pereyra,ARG,"MF,FW",Udinese,Serie A,30,1991,19.9,18,12,7,6,5,7,23,30.4,16,26,5,21,12,30,11,0,Matches
2089,Ayoze Pérez,ESP,"MF,FW",Leicester City,Premier League,28,1993,4.9,4,2,0,3,1,0,13,0.0,13,11,1,10,2,6,5,0,Matches
2090,Carles Pérez,ESP,"MF,FW",Roma,Serie A,23,1998,6.2,8,3,3,1,4,3,12,25.0,9,10,0,10,2,10,2,0,Matches
2091,Iñigo Pérez,ESP,MF,Osasuna,La Liga,33,1988,3.8,3,2,2,1,0,2,4,50.0,2,1,0,1,0,3,3,0,Matches
2092,Juan Pérez,ESP,GK,Osasuna,La Liga,25,1996,2.0,0,0,0,0,0,0,1,0.0,1,0,0,0,0,0,1,1,Matches
2093,Kike Pérez,ESP,"MF,FW",Elche,La Liga,24,1997,5.8,8,6,1,3,4,0,10,0.0,10,6,1,5,3,11,4,0,Matches
2094,Lucas Pérez,ESP,FW,Elche,La Liga,32,1988,14.1,4,1,2,1,1,3,10,30.0,7,2,0,2,3,7,4,0,Matches
2095,Lucas Pérez,ESP,"FW,MF",Cádiz,La Liga,32,1988,11.8,3,3,2,1,0,0,10,0.0,10,3,1,2,0,3,1,0,Matches
2096,Nehuén Pérez,ARG,DF,Udinese,Serie A,21,2000,18.8,44,21,21,21,2,16,25,64.0,9,27,9,18,21,65,47,0,Matches
2097,Mattia Perin,ITA,GK,Juventus,Serie A,28,1992,4.5,0,0,0,0,0,0,0,,0,0,0,0,0,0,3,0,Matches
2098,Ivan Perišić,CRO,DF,Inter,Serie A,32,1989,31.3,38,22,18,11,9,28,50,56.0,22,39,7,32,47,85,42,0,Matches
2099,Sonny Perkins,ENG,MF,West Ham,Premier League,17,2004,0.0,0,0,0,0,0,0,0,,0,0,0,0,0,0,0,0,Matches
2100,Diego Perotti,ARG,"MF,FW",Salernitana,Serie A,33,1988,3.2,11,5,7,1,3,4,13,30.8,9,1,0,1,2,13,6,0,Matches
2101,Romain Perraud,FRA,DF,Southampton,Premier League,23,1997,18.0,34,22,18,14,2,16,29,55.2,13,24,6,18,17,51,42,0,Matches
2102,Lucas Perrin,FRA,DF,Strasbourg,Ligue 1,22,1998,27.8,43,32,24,17,2,26,45,57.8,19,28,11,17,42,85,67,0,Matches
2103,Mario Perrone,ITA,DF,Salernitana,Serie A,18,2003,0.2,0,0,0,0,0,0,0,,0,0,0,0,0,0,0,0,Matches
2104,Pavao Pervan,AUT,GK,Wolfsburg,Bundesliga,33,1987,6.0,0,0,0,0,0,0,0,,0,0,0,0,0,0,3,0,Matches
2105,Matteo Pessina,ITA,"MF,FW",Atalanta,Serie A,24,1997,16.0,27,14,10,11,6,14,33,42.4,19,22,3,19,13,40,7,0,Matches
2106,Andrea Petagna,ITA,FW,Napoli,Serie A,26,1995,6.5,3,3,0,3,0,1,4,25.0,3,1,0,1,0,3,5,0,Matches
2107,Nils Petersen,GER,FW,Freiburg,Bundesliga,32,1988,6.4,5,3,2,3,0,1,13,7.7,12,7,0,7,2,7,17,0,Matches
2108,Danijel Petković,MNE,GK,Angers,Ligue 1,28,1993,15.0,0,0,0,0,0,0,1,0.0,1,0,0,0,1,1,9,5,Matches
2109,Léo Pétrot,FRA,DF,Lorient,Ligue 1,24,1997,20.2,31,17,23,8,0,21,29,72.4,8,33,17,16,22,53,86,0,Matches
2110,Njegoš Petrović,SRB,MF,Granada,La Liga,22,1999,10.2,24,11,4,19,1,8,14,57.1,6,16,4,12,9,33,11,0,Matches
2111,Jens Petter Hauge,NOR,"MF,FW",Eint Frankfurt,Bundesliga,21,1999,11.6,14,5,6,7,1,7,23,30.4,16,7,0,7,3,17,5,0,Matches
2112,Alex Petxa,ESP,"DF,MF",Athletic Club,La Liga,24,1997,4.6,12,9,4,7,1,4,8,50.0,4,8,2,6,4,16,6,0,Matches
2113,Germán Pezzella,ARG,DF,Betis,La Liga,30,1991,22.1,21,9,16,5,0,16,29,55.2,13,29,18,11,39,60,106,0,Matches
2114,Giuseppe Pezzella,ITA,"DF,MF",Atalanta,Serie A,23,1997,11.9,28,13,15,7,6,8,18,44.4,10,13,5,8,9,37,16,0,Matches
2115,Immanuel Pherai,SUR,MF,Dortmund,Bundesliga,20,2001,0.0,0,0,0,0,0,0,0,,0,0,0,0,0,0,0,0,Matches
2116,Maximilian Philipp,GER,MF,Wolfsburg,Bundesliga,27,1994,10.7,15,11,6,7,2,5,21,23.8,16,12,1,11,4,19,5,0,Matches
2117,Romain Philippoteaux,FRA,MF,Brest,Ligue 1,33,1988,0.3,1,1,0,1,0,0,0,,0,0,0,0,0,1,0,0,Matches
2118,Kalvin Phillips,ENG,MF,Leeds United,Premier League,25,1995,17.7,54,25,24,25,5,24,57,42.1,33,37,9,28,24,78,18,0,Matches
2119,Jaden Philogene Bidace,ENG,FW,Aston Villa,Premier League,19,2002,0.1,0,0,0,0,0,0,0,,0,0,0,0,0,0,0,0,Matches
2120,Jérôme Phojo,FRA,DF,Clermont Foot,Ligue 1,28,1993,0.1,0,0,0,0,0,0,0,,0,0,0,0,0,0,1,0,Matches
2121,Krzysztof Piątek,POL,FW,Fiorentina,Serie A,26,1995,8.1,5,4,1,1,3,2,3,66.7,1,6,0,6,2,7,8,0,Matches
2122,Krzysztof Piątek,POL,FW,Hertha BSC,Bundesliga,26,1995,3.9,2,2,0,1,1,0,1,0.0,1,0,0,0,0,2,6,0,Matches
2123,Pablo Piatti,ARG,"MF,FW",Elche,La Liga,32,1989,3.5,9,4,5,3,1,3,8,37.5,5,5,1,4,2,11,3,0,Matches
2124,Cristiano Piccini,ITA,DF,Valencia,La Liga,28,1992,3.6,14,8,9,5,0,5,7,71.4,2,3,2,1,1,15,11,0,Matches
2125,Roberto Piccoli,ITA,FW,Genoa,Serie A,20,2001,2.4,1,1,0,1,0,0,0,,0,0,0,0,1,2,1,1,Matches
2126,Roberto Piccoli,ITA,FW,Atalanta,Serie A,20,2001,2.2,2,0,0,0,2,0,2,0.0,2,1,0,1,0,2,0,0,Matches
2127,Jordan Pickford,ENG,GK,Everton,Premier League,27,1994,35.0,1,1,1,0,0,0,1,0.0,1,1,0,1,1,2,14,1,Matches
2128,Jérémy Pied,FRA,"DF,FW",Lille,Ligue 1,32,1989,0.1,0,0,0,0,0,0,0,,0,0,0,0,1,1,0,0,Matches
2129,Amos Pieper,GER,DF,Arminia,Bundesliga,23,1998,26.4,58,29,38,19,1,32,51,62.7,19,37,23,14,50,108,132,1,Matches
2130,Ronaël Pierre-Gabriel,FRA,DF,Brest,Ligue 1,23,1998,28.3,79,45,52,21,6,42,73,57.5,31,22,7,15,48,127,74,0,Matches
2131,Erik Pieters,NED,DF,Burnley,Premier League,32,1988,8.1,28,15,15,11,2,17,28,60.7,11,18,7,11,10,38,38,0,Matches
2132,Tomás Pina Isla,ESP,MF,Alavés,La Liga,33,1987,16.0,28,16,13,11,4,14,29,48.3,15,12,3,9,22,50,23,0,Matches
2133,Andrea Pinamonti,ITA,FW,Empoli,Serie A,22,1999,31.9,11,6,0,7,4,2,18,11.1,16,24,3,21,7,18,23,0,Matches
2134,Orbelín Pineda,MEX,"MF,FW",Celta Vigo,La Liga,25,1996,1.1,4,1,4,0,0,1,2,50.0,1,0,0,0,0,4,1,0,Matches
2135,Ethan Pinnock,JAM,DF,Brentford,Premier League,28,1993,29.9,51,35,37,12,2,25,38,65.8,13,30,11,19,44,95,154,1,Matches
2136,Yeremi Pino,ESP,"MF,FW",Villarreal,La Liga,18,2002,18.6,32,14,14,8,10,10,24,41.7,14,33,4,29,6,38,12,1,Matches
2137,Carlo Pinsoglio,ITA,GK,Juventus,Serie A,31,1990,0.5,0,0,0,0,0,0,0,,0,0,0,0,0,0,0,0,Matches
2138,Riccardo Pinzi,ITA,FW,Udinese,Serie A,17,2003,0.0,0,0,0,0,0,0,0,,0,0,0,0,0,0,0,0,Matches
2139,Gerard Piqué,ESP,DF,Barcelona,La Liga,34,1987,23.2,22,12,18,4,0,11,14,78.6,3,19,16,3,34,56,86,1,Matches
2140,Marko Pjaca,CRO,MF,Torino,Serie A,26,1995,12.8,7,4,1,4,2,3,8,37.5,5,10,2,8,4,11,2,0,Matches
2141,Marvin Plattenhardt,GER,DF,Hertha BSC,Bundesliga,29,1992,18.2,25,11,18,6,1,15,27,55.6,12,18,3,15,17,42,52,0,Matches
2142,Alassane Pléa,FRA,"MF,FW",Gladbach,Bundesliga,28,1993,23.0,18,14,6,9,3,7,20,35.0,13,9,1,8,4,22,9,0,Matches
2143,Tommaso Pobega,ITA,MF,Torino,Serie A,22,1999,24.9,48,30,17,20,11,21,40,52.5,19,32,3,29,25,73,38,0,Matches
2144,Daniel Podence,POR,"FW,MF",Wolves,Premier League,25,1995,16.5,18,11,10,5,3,4,17,23.5,13,8,1,7,10,28,1,0,Matches
2145,Suf Podgoreanu,ISR,FW,Spezia,Serie A,19,2002,1.3,2,0,1,1,0,1,4,25.0,3,2,0,2,1,3,3,0,Matches
2146,Paul Pogba,FRA,"MF,FW",Manchester Utd,Premier League,28,1993,15.0,13,9,5,7,1,6,28,21.4,22,11,0,11,13,26,16,0,Matches
2147,Joel Pohjanpalo,FIN,FW,Leverkusen,Bundesliga,26,1994,0.1,0,0,0,0,0,0,0,,0,0,0,0,0,0,0,0,Matches
2148,Matteo Politano,ITA,FW,Napoli,Serie A,27,1993,18.3,24,12,8,11,5,15,54,27.8,39,11,2,9,13,37,5,0,Matches
2149,Julian Pollersbeck,GER,GK,Lyon,Ligue 1,26,1994,4.8,0,0,0,0,0,0,0,,0,0,0,0,1,1,1,0,Matches
2150,Sebastian Polter,GER,FW,Bochum,Bundesliga,30,1991,26.0,9,3,1,4,4,2,11,18.2,9,15,5,10,2,11,24,0,Matches
2151,Ezequiel Ponce,ARG,FW,Elche,La Liga,24,1997,7.4,5,4,1,3,1,3,10,30.0,7,5,0,5,1,6,7,0,Matches
2152,Marin Pongračić,CRO,DF,Dortmund,Bundesliga,23,1997,9.2,17,10,13,4,0,6,10,60.0,4,11,5,6,17,34,32,2,Matches
2153,Pere Pons,ESP,MF,Alavés,La Liga,28,1993,15.2,26,18,4,20,2,7,21,33.3,14,10,1,9,6,32,11,0,Matches
2154,Nick Pope,ENG,GK,Burnley,Premier League,29,1992,36.0,0,0,0,0,0,0,2,0.0,2,0,0,0,2,2,30,3,Matches
2155,Manolo Portanova,ITA,"FW,MF",Genoa,Serie A,21,2000,14.7,46,28,9,26,11,14,34,41.2,20,26,2,24,17,63,22,0,Matches
2156,Portu,ESP,"FW,MF",Real Sociedad,La Liga,29,1992,17.7,16,7,2,6,8,3,19,15.8,16,21,3,18,7,23,8,0,Matches
2157,Stefan Posch,AUT,DF,Hoffenheim,Bundesliga,24,1997,24.4,48,30,20,26,2,22,39,56.4,17,43,18,25,28,76,71,2,Matches
2158,Sergio Postigo,ESP,DF,Levante,La Liga,32,1988,9.4,11,7,8,2,1,4,8,50.0,4,7,5,2,7,18,45,1,Matches
2159,Yussuf Poulsen,DEN,"FW,MF",RB Leipzig,Bundesliga,27,1994,12.0,13,4,3,6,4,3,13,23.1,10,13,0,13,3,16,9,0,Matches
2160,Gaëtan Poussin,FRA,GK,Bordeaux,Ligue 1,22,1999,13.0,1,1,1,0,0,1,1,100.0,0,0,0,0,0,1,15,1,Matches
2161,Darío Poveda,ESP,"FW,MF",Getafe,La Liga,24,1997,4.2,2,0,1,0,1,0,5,0.0,5,7,1,6,1,3,1,0,Matches
2162,José Pozo,ESP,"MF,DF",Rayo Vallecano,La Liga,25,1996,0.8,2,2,0,2,0,2,3,66.7,1,1,0,1,0,2,1,0,Matches
2163,Dennis Praet,BEL,MF,Torino,Serie A,27,1994,17.1,19,10,6,8,5,8,22,36.4,14,12,1,11,3,22,4,0,Matches
2164,Mateusz Praszelik,POL,MF,Hellas Verona,Serie A,20,2000,0.3,0,0,0,0,0,0,0,,0,0,0,0,0,0,0,0,Matches
2165,Abdón Prats,ESP,FW,Mallorca,La Liga,28,1992,7.1,2,2,1,0,1,1,5,20.0,4,5,0,5,1,3,6,0,Matches
2166,Sanjin Prcić,BIH,MF,Strasbourg,Ligue 1,27,1993,24.3,47,28,14,27,6,14,29,48.3,15,18,3,15,47,94,19,0,Matches
2167,Nicolas de Préville,FRA,"FW,MF",Metz,Ligue 1,30,1991,21.9,17,8,7,8,2,3,19,15.8,16,12,4,8,5,22,11,0,Matches
2168,Isaac Price,NIR,MF,Everton,Premier League,17,2003,0.2,0,0,0,0,0,0,0,,0,1,0,1,0,0,0,0,Matches
2169,Manuel Prietl,AUT,MF,Arminia,Bundesliga,29,1991,23.6,59,26,23,31,5,23,60,38.3,37,28,3,25,39,98,33,0,Matches
2170,Alejandro Primo,ESP,GK,Levante,La Liga,17,2004,1.0,0,0,0,0,0,0,0,,0,0,0,0,0,0,0,0,Matches
2171,Grischa Prömel,GER,MF,Union Berlin,Bundesliga,26,1995,26.9,36,22,14,17,5,22,52,42.3,30,18,3,15,23,59,22,0,Matches
2172,Nick Proschwitz,GER,FW,Hoffenheim,Bundesliga,34,1986,0.3,0,0,0,0,0,0,0,,0,0,0,0,0,0,0,0,Matches
2173,Ivan Provedel,ITA,GK,Spezia,Serie A,27,1994,30.7,0,0,0,0,0,0,1,0.0,1,0,0,0,2,2,10,2,Matches
2174,Javi Puado,ESP,"MF,FW",Espanyol,La Liga,23,1998,24.9,24,14,18,5,1,12,37,32.4,25,18,2,16,11,35,24,0,Matches
2175,Marc Pubill,ESP,"DF,MF",Levante,La Liga,18,2003,5.7,12,6,10,2,0,4,8,50.0,4,7,2,5,4,16,8,2,Matches
2176,Antonio Puertas,ESP,"MF,FW",Granada,La Liga,29,1992,25.1,34,20,18,12,4,17,44,38.6,27,33,3,30,11,45,36,0,Matches
2177,Riqui Puig,ESP,MF,Barcelona,La Liga,21,1999,5.4,6,3,2,4,0,2,14,14.3,12,5,0,5,3,9,0,0,Matches
2178,Teemu Pukki,FIN,FW,Norwich City,Premier League,31,1990,36.1,23,11,2,14,7,6,29,20.7,23,21,1,20,4,27,3,0,Matches
2179,Erick Pulgar,CHI,MF,Fiorentina,Serie A,27,1994,3.8,6,6,4,2,0,4,9,44.4,5,5,1,4,5,11,2,1,Matches
2180,Christian Pulisic,USA,"MF,FW",Chelsea,Premier League,22,1998,14.3,10,7,6,3,1,3,17,17.6,14,12,0,12,5,15,10,0,Matches
2181,Afimico Pululu,FRA,"FW,MF",Greuther Fürth,Bundesliga,22,1999,0.8,1,0,1,0,0,1,2,50.0,1,1,0,1,0,1,0,0,Matches
2182,Ignacio Pussetto,ARG,"FW,MF",Udinese,Serie A,25,1995,13.4,17,9,2,9,6,2,10,20.0,8,18,2,16,4,21,13,0,Matches
2183,Niklas Pyyhtiä,FIN,MF,Bologna,Serie A,17,2003,0.2,0,0,0,0,0,0,1,0.0,1,0,0,0,0,0,0,0,Matches
2184,Przemysław Płacheta,POL,"FW,MF",Norwich City,Premier League,23,1998,5.6,4,3,3,1,0,2,7,28.6,5,3,1,2,2,6,5,1,Matches
2185,Yacine Qasmi,MAR,FW,Rayo Vallecano,La Liga,30,1991,0.0,0,0,0,0,0,0,0,,0,0,0,0,0,0,0,0,Matches
2186,Fabio Quagliarella,ITA,FW,Sampdoria,Serie A,38,1983,18.5,6,2,2,2,2,2,15,13.3,13,14,1,13,3,9,12,0,Matches
2187,Quini,ESP,DF,Granada,La Liga,31,1989,25.6,73,34,48,21,4,42,79,53.2,37,28,10,18,36,109,62,0,Matches
2188,Dani Raba,ESP,"MF,FW",Villarreal,La Liga,25,1995,1.0,1,0,0,1,0,1,2,50.0,1,2,0,2,0,1,2,0,Matches
2189,Dani Raba,ESP,"MF,FW",Granada,La Liga,25,1995,0.3,2,2,1,0,1,2,3,66.7,1,0,0,0,1,3,0,0,Matches
2190,Adrien Rabiot,FRA,MF,Juventus,Serie A,26,1995,25.4,64,43,32,24,8,15,34,44.1,19,34,8,26,20,84,41,1,Matches
2191,Uroš Račić,SRB,MF,Valencia,La Liga,23,1998,13.4,32,18,9,19,4,12,33,36.4,21,16,6,10,16,48,21,0,Matches
2192,Nemanja Radoja,SRB,MF,Levante,La Liga,28,1993,13.5,25,8,9,13,3,8,20,40.0,12,16,9,7,22,47,16,2,Matches
2193,Nemanja Radonjić,SRB,FW,Marseille,Ligue 1,25,1996,0.2,0,0,0,0,0,0,0,,0,0,0,0,0,0,0,0,Matches
2194,Ivan Radovanović,SRB,"DF,MF",Salernitana,Serie A,32,1988,11.7,11,7,8,3,0,7,19,36.8,12,14,7,7,7,18,29,0,Matches
2195,Ionuț Radu,ROU,GK,Inter,Serie A,24,1997,1.0,0,0,0,0,0,0,0,,0,0,0,0,0,0,0,1,Matches
2196,Ștefan Radu,ROU,DF,Lazio,Serie A,34,1986,6.2,9,6,3,6,0,5,9,55.6,4,7,2,5,5,14,15,0,Matches
2197,Boris Radunović,SRB,GK,Cagliari,Serie A,25,1996,3.0,0,0,0,0,0,0,0,,0,0,0,0,0,0,0,0,Matches
2198,Sidney Raebiger,GER,MF,RB Leipzig,Bundesliga,16,2005,0.0,0,0,0,0,0,0,0,,0,0,0,0,0,0,0,0,Matches
2199,Rafinha,BRA,MF,Real Sociedad,La Liga,28,1993,11.7,43,27,17,20,6,16,28,57.1,12,21,2,19,12,55,4,0,Matches
2200,Rafinha,BRA,"FW,MF",Paris S-G,Ligue 1,28,1993,2.4,14,8,3,9,2,7,11,63.6,4,3,0,3,4,18,0,0,Matches
2201,Antonio Raillo,ESP,DF,Mallorca,La Liga,29,1991,17.0,16,7,10,4,2,5,6,83.3,1,17,14,3,18,34,81,0,Matches
2202,Antonio Raimondo,ITA,FW,Bologna,Serie A,17,2004,0.8,0,0,0,0,0,0,1,0.0,1,1,0,1,0,0,1,0,Matches
2203,Predrag Rajković,SRB,GK,Reims,Ligue 1,25,1995,38.0,2,2,2,0,0,2,3,66.7,1,1,0,1,1,3,21,1,Matches
2204,Jesurun Rak Sakyi,ENG,"FW,MF",Crystal Palace,Premier League,18,2002,0.9,0,0,0,0,0,0,1,0.0,1,3,0,3,1,1,0,0,Matches
2205,Ivan Rakitić,CRO,MF,Sevilla,La Liga,33,1988,24.2,40,22,12,23,5,13,40,32.5,27,31,8,23,23,63,35,0,Matches
2206,Diant Ramaj,GER,GK,Eint Frankfurt,Bundesliga,19,2001,1.0,0,0,0,0,0,0,0,,0,0,0,0,0,0,3,0,Matches
2207,Jonás Ramalho,ESP,DF,Osasuna,La Liga,28,1993,2.7,4,2,2,2,0,2,3,66.7,1,4,1,3,3,7,9,0,Matches
2208,Adil Rami,FRA,DF,Troyes,Ligue 1,35,1985,13.0,10,9,6,4,0,7,8,87.5,1,17,9,8,16,26,43,0,Matches
2209,Sandro Ramírez,ESP,FW,Getafe,La Liga,26,1995,16.2,7,3,1,3,3,1,12,8.3,11,14,3,11,2,9,3,0,Matches
2210,Guilherme Ramos,POR,DF,Arminia,Bundesliga,23,1997,10.1,25,15,17,8,0,12,19,63.2,7,21,8,13,27,52,52,0,Matches
2211,Sergio Ramos,ESP,DF,Paris S-G,Ligue 1,35,1986,8.9,12,5,6,6,0,8,15,53.3,7,4,2,2,8,20,27,0,Matches
2212,Aaron Ramsdale,ENG,GK,Arsenal,Premier League,23,1998,34.0,2,1,2,0,0,1,2,50.0,1,0,0,0,0,2,26,3,Matches
2213,Aaron Ramsey,WAL,MF,Juventus,Serie A,30,1990,1.1,0,0,0,0,0,0,0,,0,0,0,0,1,1,0,0,Matches
2214,Jacob Ramsey,ENG,MF,Aston Villa,Premier League,20,2001,27.4,67,44,31,28,8,30,69,43.5,39,36,7,29,24,91,28,0,Matches
2215,Luca Ranieri,ITA,DF,Salernitana,Serie A,22,1999,23.4,38,21,23,11,4,19,33,57.6,14,18,8,10,22,60,67,0,Matches
2216,Andrea Ranocchia,ITA,DF,Inter,Serie A,33,1988,3.8,8,4,5,1,2,1,3,33.3,2,4,3,1,4,12,16,0,Matches
2217,Raphinha,BRA,"FW,MF",Leeds United,Premier League,24,1996,32.4,51,29,25,14,12,22,71,31.0,49,43,0,43,29,80,28,1,Matches
2218,Tobias Raschl,GER,MF,Greuther Fürth,Bundesliga,21,2000,6.6,12,9,4,8,0,5,7,71.4,2,10,1,9,3,15,1,0,Matches
2219,Elba Rashani,KVX,"FW,MF",Clermont Foot,Ligue 1,28,1993,19.5,40,21,15,21,4,17,55,30.9,38,34,3,31,11,51,20,0,Matches
2220,Marcus Rashford,ENG,"FW,MF",Manchester Utd,Premier League,23,1997,13.7,6,5,1,4,1,2,13,15.4,11,10,1,9,5,11,5,1,Matches
2221,Milot Rashica,KVX,"FW,MF",Norwich City,Premier League,25,1996,24.8,31,19,12,12,7,11,30,36.7,19,22,3,19,15,46,23,0,Matches
2222,Giacomo Raspadori,ITA,"MF,FW",Sassuolo,Serie A,21,2000,30.4,29,18,5,15,9,11,38,28.9,27,29,3,26,9,38,11,0,Matches
2223,Raúl,ESP,"FW,DF",Betis,La Liga,20,2000,0.0,0,0,0,0,0,0,0,,0,0,0,0,0,0,0,0,Matches
2224,David Raum,GER,"DF,FW",Hoffenheim,Bundesliga,23,1998,30.6,52,29,30,10,12,30,64,46.9,34,38,5,33,27,79,39,1,Matches
2225,Nicola Ravaglia,ITA,GK,Sampdoria,Serie A,32,1988,0.1,0,0,0,0,0,0,0,,0,0,0,0,0,0,0,0,Matches
2226,David Raya,ESP,GK,Brentford,Premier League,25,1995,24.0,0,0,0,0,0,0,0,,0,1,0,1,0,0,10,1,Matches
2227,Ante Rebić,CRO,FW,Milan,Serie A,27,1993,9.9,14,8,3,6,5,7,20,35.0,13,14,0,14,3,17,3,1,Matches
2228,Arkadiusz Reca,POL,DF,Spezia,Serie A,26,1995,19.7,31,19,21,3,7,20,30,66.7,10,20,7,13,32,63,47,2,Matches
2229,Lluís Recasens,ESP,DF,Espanyol,La Liga,19,2002,0.5,2,0,2,0,0,1,1,100.0,0,0,0,0,2,4,2,0,Matches
2230,Nathan Redmond,ENG,"MF,FW",Southampton,Premier League,27,1994,20.4,22,14,9,9,4,7,30,23.3,23,21,2,19,8,30,16,0,Matches
2231,Sergio Reguilón,ESP,"DF,MF",Tottenham,Premier League,24,1996,21.3,40,24,15,18,7,22,43,51.2,21,20,8,12,31,71,45,1,Matches
2232,Manolo Reina,ESP,GK,Mallorca,La Liga,36,1985,21.0,0,0,0,0,0,0,0,,0,0,0,0,1,1,6,2,Matches
2233,Pepe Reina,ESP,GK,Lazio,Serie A,38,1982,15.0,0,0,0,0,0,0,1,0.0,1,0,0,0,0,0,1,1,Matches
2234,Jeff Reine-Adélaïde,FRA,"MF,DF",Lyon,Ligue 1,23,1998,2.2,5,3,4,1,0,4,5,80.0,1,2,0,2,0,5,0,1,Matches
2235,Reinier,BRA,"FW,MF",Dortmund,Bundesliga,19,2002,1.8,5,3,4,0,1,1,1,100.0,0,3,0,3,0,5,0,0,Matches
2236,Karim Rekik,NED,DF,Sevilla,La Liga,26,1994,12.2,11,8,4,6,1,2,9,22.2,7,11,6,5,9,20,19,0,Matches
2237,Álex Remiro,ESP,GK,Real Sociedad,La Liga,26,1995,35.0,0,0,0,0,0,0,0,,0,0,0,0,1,1,24,2,Matches
2238,Panagiotis Retsos,GRE,DF,Hellas Verona,Serie A,22,1998,0.6,0,0,0,0,0,0,2,0.0,2,0,0,0,2,2,3,0,Matches
2239,Panagiotis Retsos,GRE,"DF,FW",Leverkusen,Bundesliga,22,1998,0.4,0,0,0,0,0,0,0,,0,0,0,0,1,1,0,1,Matches
2240,Marco Reus,GER,"MF,FW",Dortmund,Bundesliga,32,1989,27.8,45,30,13,21,11,16,42,38.1,26,23,6,17,12,57,41,1,Matches
2241,Elvis Rexhbeçaj,GER,MF,Bochum,Bundesliga,23,1997,28.2,41,20,17,19,5,19,40,47.5,21,41,6,35,27,68,15,0,Matches
2242,Gio Reyna,USA,MF,Dortmund,Bundesliga,18,2002,4.9,7,4,2,4,1,3,9,33.3,6,6,0,6,1,8,3,0,Matches
2243,Bryan Reynolds,USA,DF,Roma,Serie A,20,2001,0.0,0,0,0,0,0,0,1,0.0,1,0,0,0,0,0,1,0,Matches
2244,Nico Ribaudo,ESP,"MF,FW",Espanyol,La Liga,20,2001,12.4,15,6,9,5,1,11,34,32.4,23,14,2,12,7,22,3,0,Matches
2245,Tiago Ribeiro,POR,FW,Monaco,Ligue 1,19,2002,0.0,0,0,0,0,0,0,0,,0,0,0,0,0,0,0,0,Matches
2246,Franck Ribéry,FRA,"MF,FW",Salernitana,Serie A,38,1983,15.8,17,10,6,6,5,8,13,61.5,5,12,0,12,3,20,1,0,Matches
2247,Samuele Ricci,ITA,MF,Torino,Serie A,19,2001,8.0,8,4,4,2,2,2,5,40.0,3,7,1,6,14,22,9,0,Matches
2248,Samuele Ricci,ITA,MF,Empoli,Serie A,19,2001,17.0,33,19,17,13,3,20,34,58.8,14,24,5,19,31,64,18,0,Matches
2249,Declan Rice,ENG,MF,West Ham,Premier League,22,1999,35.3,80,42,45,32,3,38,71,53.5,33,45,21,24,63,143,52,1,Matches
2250,Chris Richards,USA,DF,Hoffenheim,Bundesliga,21,2000,14.5,26,15,10,15,1,11,18,61.1,7,21,9,12,22,48,50,1,Matches
2251,Chris Richards,USA,DF,Bayern Munich,Bundesliga,21,2000,0.0,0,0,0,0,0,0,0,,0,1,0,1,0,0,0,0,Matches
2252,Omar Richards,ENG,DF,Bayern Munich,Bundesliga,23,1998,4.9,19,12,11,5,3,11,16,68.8,5,7,1,6,4,23,7,0,Matches
2253,Taylor Richards,ENG,MF,Brighton,Premier League,20,2000,0.3,1,0,0,1,0,1,2,50.0,1,0,0,0,0,1,0,0,Matches
2254,Richarlison,BRA,FW,Everton,Premier League,24,1997,28.0,40,23,18,15,7,15,31,48.4,16,42,4,38,12,52,34,0,Matches
2255,Marco Richter,GER,"FW,MF",Hertha BSC,Bundesliga,23,1997,18.9,30,16,14,10,6,13,36,36.1,23,30,4,26,16,46,24,0,Matches
2256,Diego Rico,ESP,DF,Real Sociedad,La Liga,28,1993,18.3,41,20,19,17,5,22,45,48.9,23,29,4,25,30,71,54,0,Matches
2257,Sergio Rico,ESP,GK,Mallorca,La Liga,27,1993,14.0,0,0,0,0,0,0,0,,0,0,0,0,0,0,5,2,Matches
2258,Sergio Rico,ESP,GK,Paris S-G,Ligue 1,27,1993,0.3,0,0,0,0,0,0,0,,0,0,0,0,0,0,1,0,Matches
2259,Jaïro Riedewald,NED,MF,Crystal Palace,Premier League,24,1996,1.3,1,1,0,1,0,1,2,50.0,1,1,0,1,1,2,2,0,Matches
2260,Manuel Riemann,GER,GK,Bochum,Bundesliga,32,1988,31.0,1,0,1,0,0,1,4,25.0,3,0,0,0,1,2,12,3,Matches
2261,Tomás Rincón,VEN,MF,Torino,Serie A,33,1988,1.8,2,2,2,0,0,0,3,0.0,3,3,1,2,2,4,4,0,Matches
2262,Tomás Rincón,VEN,MF,Sampdoria,Serie A,33,1988,13.0,22,13,9,10,3,13,34,38.2,21,15,2,13,18,40,11,0,Matches
2263,Luis Rioja,ESP,"MF,FW",Alavés,La Liga,27,1993,34.6,28,15,11,10,7,14,58,24.1,44,22,1,21,25,53,20,0,Matches
2264,Renaud Ripart,FRA,"MF,FW",Troyes,Ligue 1,28,1993,21.0,38,21,18,15,5,18,50,36.0,32,21,1,20,19,57,21,1,Matches
2265,Mihailo Ristić,SRB,DF,Montpellier,Ligue 1,25,1995,20.0,44,32,26,16,2,25,43,58.1,18,16,6,10,17,61,48,0,Matches
2266,Matt Ritchie,SCO,DF,Newcastle Utd,Premier League,31,1989,14.9,22,15,10,10,2,10,27,37.0,17,10,2,8,13,35,26,0,Matches
2267,Maxence Rivera,FRA,FW,Saint-Étienne,Ligue 1,19,2002,0.1,0,0,0,0,0,0,0,,0,0,0,0,0,0,0,0,Matches
2268,Rober,ESP,DF,Levante,La Liga,26,1995,22.3,36,20,27,7,2,23,39,59.0,16,25,15,10,30,66,90,1,Matches
2269,Sergi Roberto,ESP,"MF,DF",Barcelona,La Liga,29,1992,4.4,5,1,2,3,0,3,5,60.0,2,2,0,2,4,9,6,0,Matches
2270,Connor Roberts,WAL,DF,Burnley,Premier League,25,1995,18.8,20,13,10,7,3,10,15,66.7,5,25,5,20,22,42,62,1,Matches
2271,Patrick Roberts,ENG,MF,Troyes,Ligue 1,24,1997,0.2,0,0,0,0,0,0,0,,0,0,0,0,0,0,0,0,Matches
2272,Tyler Roberts,WAL,"MF,FW",Leeds United,Premier League,22,1999,11.0,16,7,6,7,3,9,16,56.3,7,11,1,10,5,21,11,0,Matches
2273,Andrew Robertson,SCO,DF,Liverpool,Premier League,27,1994,28.2,36,21,16,15,5,20,35,57.1,15,24,3,21,23,59,61,0,Matches
2274,Marc Roca,ESP,MF,Bayern Munich,Bundesliga,24,1996,4.2,9,7,2,4,3,2,8,25.0,6,6,0,6,6,15,4,0,Matches
2275,Rubén Rochina,ESP,"MF,FW",Granada,La Liga,30,1991,8.3,21,13,7,8,6,8,28,28.6,20,11,1,10,6,27,5,1,Matches
2276,Cimo Röcker,GER,DF,Hertha BSC,Bundesliga,27,1994,0.2,0,0,0,0,0,0,0,,0,0,0,0,2,2,0,0,Matches
2277,Enzo Roco,CHI,DF,Elche,La Liga,28,1992,28.4,36,20,24,11,1,15,24,62.5,9,38,27,11,28,64,110,3,Matches
2278,Stian Rode Gregersen,NOR,DF,Bordeaux,Ligue 1,26,1995,21.7,39,26,23,12,4,18,33,54.5,15,26,16,10,38,77,103,2,Matches
2279,Sebastian Rode,GER,MF,Eint Frankfurt,Bundesliga,30,1990,8.4,15,7,5,8,2,5,17,29.4,12,11,1,10,13,28,8,0,Matches
2280,Joe Rodon,WAL,DF,Tottenham,Premier League,23,1997,1.0,0,0,0,0,0,0,0,,0,2,1,1,0,0,7,0,Matches
2281,Rodri,ESP,MF,Manchester City,Premier League,25,1996,32.0,72,43,24,38,10,32,59,54.2,27,28,5,23,28,100,45,0,Matches
2282,Rodri,ESP,FW,Betis,La Liga,21,2000,9.8,10,7,4,5,1,5,22,22.7,17,11,0,11,3,13,4,0,Matches
2283,Rodrigo,ESP,"MF,FW",Leeds United,Premier League,30,1991,25.2,20,9,7,6,7,4,32,12.5,28,12,0,12,11,31,27,1,Matches
2284,Gerson Rodrigues,LUX,"FW,MF",Troyes,Ligue 1,26,1995,9.4,12,9,2,6,4,1,17,5.9,16,8,1,7,0,12,2,0,Matches
2285,Kévin Rodrigues,POR,"DF,FW",Rayo Vallecano,La Liga,27,1994,4.8,15,11,8,7,0,6,10,60.0,4,10,1,9,7,22,6,0,Matches
2286,Ángel Rodríguez,ESP,"FW,MF",Mallorca,La Liga,34,1987,17.2,15,9,6,7,2,4,21,19.0,17,15,1,14,3,18,13,0,Matches
2287,Óscar Rodríguez Arnaiz,ESP,"MF,FW",Getafe,La Liga,23,1998,10.5,16,11,6,8,2,4,12,33.3,8,7,1,6,11,27,6,0,Matches
2288,Óscar Rodríguez Arnaiz,ESP,"FW,MF",Sevilla,La Liga,23,1998,4.6,4,3,1,3,0,2,3,66.7,1,2,0,2,5,9,7,1,Matches
2289,Dani Rodríguez,ESP,"MF,FW",Mallorca,La Liga,33,1988,31.5,53,31,20,24,9,15,46,32.6,31,28,3,25,20,73,27,0,Matches
2290,Guido Rodríguez,ARG,MF,Betis,La Liga,27,1994,28.1,97,53,46,45,6,54,98,55.1,44,55,12,43,31,128,56,0,Matches
2291,Jay Rodriguez,ENG,FW,Burnley,Premier League,32,1989,15.4,20,12,8,8,4,4,14,28.6,10,19,1,18,4,24,12,0,Matches
2292,Ricardo Rodríguez,SUI,DF,Torino,Serie A,28,1992,27.5,36,21,11,23,2,18,33,54.5,15,22,8,14,41,77,48,1,Matches
2293,Rodrygo,BRA,FW,Real Madrid,La Liga,20,2001,16.9,18,14,7,4,7,3,18,16.7,15,21,0,21,11,29,3,0,Matches
2294,Mads Roerslev,DEN,DF,Brentford,Premier League,22,1999,13.8,23,12,19,2,2,14,32,43.8,18,14,5,9,16,39,29,0,Matches
2295,Marko Rog,CRO,MF,Cagliari,Serie A,26,1995,3.5,5,3,1,2,2,1,8,12.5,7,6,1,5,1,6,3,0,Matches
2296,Rogério,BRA,DF,Sassuolo,Serie A,23,1998,19.2,21,13,12,5,4,15,22,68.2,7,20,8,12,18,39,42,1,Matches
2297,Alessio Romagnoli,ITA,DF,Milan,Serie A,26,1995,15.7,24,14,14,10,0,14,18,77.8,4,21,12,9,19,43,45,0,Matches
2298,Simone Romagnoli,ITA,DF,Empoli,Serie A,31,1990,16.6,28,12,14,12,2,15,20,75.0,5,34,28,6,9,37,86,0,Matches
2299,Leo Román,ESP,GK,Mallorca,La Liga,21,2000,2.0,0,0,0,0,0,0,0,,0,0,0,0,0,0,2,0,Matches
2300,Cristian Romero,ARG,DF,Tottenham,Premier League,23,1998,20.5,62,39,39,21,2,22,34,64.7,12,46,21,25,33,95,74,1,Matches
2301,Iván Romero,ESP,FW,Sevilla,La Liga,20,2001,2.0,2,2,0,2,0,0,0,,0,1,0,1,2,4,0,0,Matches
2302,Luka Romero,ARG,FW,Lazio,Serie A,16,2004,0.9,2,1,0,1,1,0,2,0.0,2,0,0,0,1,3,0,0,Matches
2303,Sergio Romero,ARG,GK,Venezia,Serie A,34,1987,16.0,2,2,2,0,0,2,2,100.0,0,0,0,0,1,3,10,0,Matches
2304,Oriol Romeu,ESP,MF,Southampton,Premier League,29,1991,32.1,77,39,25,45,7,28,73,38.4,45,39,8,31,51,128,43,0,Matches
2305,Cristiano Ronaldo,POR,FW,Manchester Utd,Premier League,36,1985,27.3,8,6,1,5,2,2,6,33.3,4,8,0,8,2,10,29,0,Matches
2306,Cristiano Ronaldo,POR,FW,Juventus,Serie A,36,1985,0.3,1,0,0,1,0,1,1,100.0,0,0,0,0,0,1,0,0,Matches
2307,Salomón Rondón,VEN,FW,Everton,Premier League,31,1989,8.8,6,1,1,2,3,4,14,28.6,10,5,0,5,0,6,10,0,Matches
2308,Valentin Rongier,FRA,"MF,DF",Marseille,Ligue 1,26,1994,24.4,77,51,36,36,5,28,60,46.7,32,26,5,21,33,110,14,0,Matches
2309,Marten de Roon,NED,"MF,DF",Atalanta,Serie A,30,1991,28.3,69,42,33,29,7,34,62,54.8,28,36,2,34,45,114,41,0,Matches
2310,Unai Ropero,ESP,MF,Alavés,La Liga,19,2001,0.1,0,0,0,0,0,0,0,,0,0,0,0,1,1,0,0,Matches
2311,Pablo Rosario,NED,MF,Nice,Ligue 1,24,1997,30.3,59,37,18,32,9,26,66,39.4,40,33,7,26,38,97,43,0,Matches
2312,Romario Rösch,GER,MF,Mainz 05,Bundesliga,22,1999,0.0,0,0,0,0,0,0,0,,0,0,0,0,0,0,0,0,Matches
2313,Danny Rose,ENG,DF,Watford,Premier League,31,1990,7.7,16,10,11,4,1,10,24,41.7,14,8,5,3,14,30,11,1,Matches
2314,Francesco Rossi,ITA,GK,Atalanta,Serie A,30,1991,0.4,0,0,0,0,0,0,0,,0,0,0,0,0,0,0,0,Matches
2315,Tom Rothe,GER,DF,Dortmund,Bundesliga,16,2004,1.0,4,3,2,2,0,3,6,50.0,3,2,0,2,2,6,3,0,Matches
2316,Jérôme Roussillon,FRA,DF,Wolfsburg,Bundesliga,28,1993,19.7,14,9,8,6,0,10,16,62.5,6,24,5,19,14,28,34,2,Matches
2317,Nicolò Rovella,ITA,MF,Genoa,Serie A,19,2001,16.3,37,26,16,14,7,15,40,37.5,25,21,1,20,20,57,20,0,Matches
2318,Jon Rowe,ENG,"FW,MF",Norwich City,Premier League,18,2003,2.5,3,2,2,1,0,2,3,66.7,1,7,0,7,3,6,1,0,Matches
2319,Amir Rrahmani,KVX,DF,Napoli,Serie A,27,1994,32.5,21,11,15,5,1,15,19,78.9,4,36,25,11,19,40,89,0,Matches
2320,Ruan,BRA,DF,Sassuolo,Serie A,22,1999,2.4,7,4,7,0,0,3,4,75.0,1,6,5,1,2,9,24,1,Matches
2321,Rubén,ESP,DF,Espanyol,La Liga,20,2001,1.7,6,1,4,2,0,4,7,57.1,3,0,0,0,2,8,4,0,Matches
2322,John Ruddy,ENG,GK,Wolves,Premier League,34,1986,1.5,0,0,0,0,0,0,0,,0,0,0,0,0,0,3,0,Matches
2323,Antonio Rüdiger,GER,DF,Chelsea,Premier League,28,1993,33.7,48,28,29,15,4,36,48,75.0,12,20,11,9,28,76,91,1,Matches
2324,Sebastian Rudy,GER,MF,Hoffenheim,Bundesliga,31,1990,8.6,22,12,9,13,0,11,21,52.4,10,8,3,5,11,33,8,1,Matches
2325,Daniele Rugani,ITA,DF,Juventus,Serie A,27,1994,9.8,8,5,4,4,0,4,7,57.1,3,9,4,5,11,19,47,0,Matches
2326,Matteo Ruggeri,ITA,DF,Salernitana,Serie A,19,2002,7.5,8,4,5,2,1,7,10,70.0,3,6,1,5,2,10,25,0,Matches
2327,Mário Rui,POR,DF,Napoli,Serie A,30,1991,33.2,68,43,32,28,8,39,84,46.4,45,31,7,24,40,108,50,0,Matches
2328,Aitor Ruibal,ESP,"FW,DF",Betis,La Liga,25,1996,9.5,21,15,13,3,5,10,34,29.4,24,8,0,8,8,29,6,0,Matches
2329,Isma Ruiz,ESP,MF,Granada,La Liga,20,2001,3.1,3,1,3,0,0,1,9,11.1,8,5,2,3,3,6,2,0,Matches
2330,Fabián Ruiz Peña,ESP,MF,Napoli,Serie A,25,1996,26.5,55,33,22,29,4,29,67,43.3,38,34,1,33,22,77,32,0,Matches
2331,Víctor Ruiz,ESP,DF,Betis,La Liga,32,1989,15.8,11,9,7,2,2,6,9,66.7,3,18,13,5,29,40,71,1,Matches
2332,Gerónimo Rulli,ARG,GK,Villarreal,La Liga,29,1992,32.0,0,0,0,0,0,0,4,0.0,4,0,0,0,1,1,15,5,Matches
2333,Lukas Rupp,GER,MF,Norwich City,Premier League,30,1991,8.5,9,4,5,3,1,4,15,26.7,11,11,1,10,9,18,7,0,Matches
2334,Alessandro Russo,ITA,MF,Salernitana,Serie A,17,2003,0.3,1,0,1,0,0,0,1,0.0,1,0,0,0,0,1,1,0,Matches
2335,Franco Russo,ARG,DF,Mallorca,La Liga,26,1994,16.3,19,10,10,9,0,13,31,41.9,18,14,9,5,27,46,73,1,Matches
2336,Georginio Rutter,FRA,"FW,MF",Hoffenheim,Bundesliga,19,2002,17.9,18,13,4,8,6,6,17,35.3,11,29,1,28,6,24,11,1,Matches
2337,Mathew Ryan,AUS,GK,Real Sociedad,La Liga,29,1992,3.0,0,0,0,0,0,0,0,,0,0,0,0,0,0,2,0,Matches
2338,Julian Ryerson,NOR,DF,Union Berlin,Bundesliga,23,1997,15.9,27,15,11,12,4,17,25,68.0,8,12,4,8,16,43,32,0,Matches
2339,Frederik Rønnow,DEN,GK,Union Berlin,Bundesliga,28,1992,7.0,0,0,0,0,0,0,0,,0,0,0,0,0,0,1,0,Matches
2340,José Sá,POR,GK,Wolves,Premier League,28,1993,36.5,2,1,2,0,0,2,4,50.0,2,0,0,0,2,4,19,5,Matches
2341,Roli Pereira de Sa,FRA,MF,Nantes,Ligue 1,24,1996,6.4,12,4,3,5,4,3,20,15.0,17,6,0,6,6,18,3,0,Matches
2342,Youssouf Sabaly,SEN,DF,Betis,La Liga,28,1993,8.8,12,10,11,0,1,7,13,53.8,6,11,4,7,13,25,16,1,Matches
2343,Mathys Saban,FRA,"FW,MF",Saint-Étienne,Ligue 1,19,2002,0.8,4,2,2,2,0,1,1,100.0,0,1,0,1,0,4,0,0,Matches
2344,Stefano Sabelli,ITA,DF,Genoa,Serie A,28,1993,3.9,6,3,3,2,1,3,9,33.3,6,5,1,4,3,9,12,0,Matches
2345,Abdelhamid Sabiri,MAR,"MF,FW",Sampdoria,Serie A,24,1996,9.9,34,18,10,15,9,7,25,28.0,18,10,2,8,7,41,3,0,Matches
2346,Marcel Sabitzer,AUT,"MF,FW",RB Leipzig,Bundesliga,27,1994,0.5,2,1,1,1,0,1,1,100.0,0,0,0,0,1,3,0,0,Matches
2347,Marcel Sabitzer,AUT,"MF,DF",Bayern Munich,Bundesliga,27,1994,10.1,18,7,8,8,2,9,19,47.4,10,7,0,7,9,27,10,1,Matches
2348,Falaye Sacko,MLI,DF,Saint-Étienne,Ligue 1,26,1995,7.4,15,10,14,1,0,13,16,81.3,3,11,7,4,4,19,18,2,Matches
2349,Alexis Saelemaekers,BEL,FW,Milan,Serie A,22,1999,20.7,43,22,12,17,14,15,51,29.4,36,19,0,19,15,58,8,0,Matches
2350,Rafiki Said,COM,"MF,FW",Brest,Ligue 1,21,2000,1.4,4,3,1,2,1,3,4,75.0,1,2,0,2,0,4,0,0,Matches
2351,Wesley Saïd,FRA,"FW,MF",Lens,Ligue 1,26,1995,7.3,10,5,1,8,1,1,9,11.1,8,4,0,4,2,12,0,0,Matches
2352,Allan Saint-Maximin,FRA,"FW,MF",Newcastle Utd,Premier League,24,1997,31.2,13,8,6,4,3,3,17,17.6,14,13,2,11,11,24,3,0,Matches
2353,Romain Saïss,MAR,DF,Wolves,Premier League,31,1990,30.1,40,27,28,11,1,19,33,57.6,14,41,21,20,58,98,158,2,Matches
2354,Bukayo Saka,ENG,"FW,MF",Arsenal,Premier League,19,2001,33.1,40,21,12,17,11,13,39,33.3,26,28,2,26,22,62,23,0,Matches
2355,Mamadou Sakho,FRA,DF,Montpellier,Ligue 1,31,1990,28.6,34,22,26,8,0,16,26,61.5,10,41,34,7,41,75,134,4,Matches
2356,Bakary Sako,MLI,"FW,MF",Saint-Étienne,Ligue 1,33,1988,1.7,0,0,0,0,0,0,1,0.0,1,3,1,2,0,0,0,0,Matches
2357,Jacopo Sala,ITA,MF,Spezia,Serie A,29,1991,9.8,22,11,10,10,2,13,30,43.3,17,6,0,6,14,36,11,0,Matches
2358,Mohamed Salah,EGY,FW,Liverpool,Premier League,29,1992,30.7,17,8,5,9,3,6,19,31.6,13,7,1,6,6,23,5,0,Matches
2359,Eddie Salcedo,ITA,"MF,FW",Spezia,Serie A,19,2001,4.8,1,1,0,0,1,0,1,0.0,1,2,1,1,0,1,7,1,Matches
2360,William Saliba,FRA,DF,Marseille,Ligue 1,20,2001,36.0,54,32,36,16,2,27,35,77.1,8,24,16,8,48,102,85,0,Matches
2361,Romain Salin,FRA,GK,Rennes,Ligue 1,37,1984,1.0,0,0,0,0,0,0,0,,0,0,0,0,0,0,0,0,Matches
2362,Mohammed Salisu,GHA,DF,Southampton,Premier League,22,1999,33.0,80,47,54,22,4,40,65,61.5,25,49,26,23,78,158,158,4,Matches
2363,Roland Sallai,HUN,"MF,FW",Freiburg,Bundesliga,24,1997,17.2,22,16,8,11,3,7,23,30.4,16,12,0,12,11,33,12,0,Matches
2364,Yoann Salmier,GUF,DF,Troyes,Ligue 1,28,1992,29.6,58,33,44,11,3,26,34,76.5,8,30,14,16,40,98,94,0,Matches
2365,Salvi,ESP,"MF,FW",Cádiz,La Liga,30,1991,15.5,20,10,9,8,3,8,20,40.0,12,17,2,15,6,26,11,0,Matches
2366,Lazar Samardzic,SRB,"MF,FW",Udinese,Serie A,19,2002,5.4,13,9,4,7,2,7,26,26.9,19,6,0,6,2,15,2,0,Matches
2367,Diadie Samassékou,MLI,MF,Hoffenheim,Bundesliga,25,1996,18.4,41,26,14,21,6,21,44,47.7,23,27,11,16,28,69,26,0,Matches
2368,Mama Samba Baldé,GNB,"MF,FW",Troyes,Ligue 1,25,1995,19.1,40,28,16,14,10,8,26,30.8,18,32,1,31,5,45,9,0,Matches
2369,Albert Sambi Lokonga,BEL,MF,Arsenal,Premier League,21,1999,12.6,22,18,11,9,2,12,14,85.7,2,12,7,5,13,35,12,4,Matches
2370,Junior Sambia,FRA,"DF,FW",Montpellier,Ligue 1,24,1996,17.0,22,13,12,7,3,13,22,59.1,9,22,3,19,21,43,31,0,Matches
2371,Luigi Samele,ITA,FW,Sassuolo,Serie A,19,2002,0.1,0,0,0,0,0,0,0,,0,0,0,0,0,0,1,0,Matches
2372,Fede San Emeterio,ESP,MF,Cádiz,La Liga,24,1997,9.2,16,5,5,8,3,5,15,33.3,10,5,0,5,8,24,6,0,Matches
2373,Antonio Sanabria,PAR,FW,Torino,Serie A,25,1996,20.0,3,2,0,1,2,1,4,25.0,3,11,4,7,2,5,10,0,Matches
2374,Oihan Sancet,ESP,FW,Athletic Club,La Liga,21,2000,15.8,12,7,2,8,2,5,20,25.0,15,2,0,2,5,17,13,0,Matches
2375,Renato Sanches,POR,"MF,FW",Lille,Ligue 1,23,1997,18.3,19,7,8,10,1,9,26,34.6,17,14,3,11,14,33,7,0,Matches
2376,Alexis Sánchez,CHI,FW,Inter,Serie A,32,1988,9.8,9,8,0,6,3,2,11,18.2,9,4,0,4,2,11,3,0,Matches
2377,Antonio Sánchez,ESP,"MF,FW",Mallorca,La Liga,24,1997,18.0,53,24,29,17,7,19,49,38.8,30,32,2,30,32,85,32,1,Matches
2378,Davinson Sánchez,COL,DF,Tottenham,Premier League,25,1996,18.1,41,22,25,14,2,19,28,67.9,9,24,16,8,30,71,54,3,Matches
2379,Germán Sánchez,ESP,DF,Granada,La Liga,34,1986,25.5,27,19,18,9,0,11,20,55.0,9,19,16,3,28,55,137,0,Matches
2380,Manu Sánchez,ESP,DF,Osasuna,La Liga,20,2000,25.1,72,34,41,22,9,43,79,54.4,36,28,3,25,18,90,43,0,Matches
2381,Robert Sánchez,ESP,GK,Brighton,Premier League,23,1997,37.0,2,1,2,0,0,1,1,100.0,0,1,0,1,0,2,11,4,Matches
2382,Jadon Sancho,ENG,"FW,MF",Manchester Utd,Premier League,21,2000,21.1,14,8,9,4,1,8,22,36.4,14,19,0,19,15,29,5,3,Matches
2383,Philippe Sandler,NED,DF,Troyes,Ligue 1,24,1997,0.8,0,0,0,0,0,0,0,,0,1,1,0,3,3,6,0,Matches
2384,Alex Sandro,BRA,DF,Juventus,Serie A,30,1991,19.8,27,16,15,9,3,11,25,44.0,14,17,6,11,27,54,40,0,Matches
2385,Leroy Sané,GER,"FW,MF",Bayern Munich,Bundesliga,25,1996,22.0,28,16,5,19,4,9,24,37.5,15,18,0,18,12,40,2,1,Matches
2386,Oier Sanjurjo,ESP,MF,Osasuna,La Liga,35,1986,8.4,10,6,3,7,0,2,19,10.5,17,8,3,5,1,11,9,0,Matches
2387,Mohamed Sankoh,NED,FW,Stuttgart,Bundesliga,17,2003,0.0,0,0,0,0,0,0,0,,0,0,0,0,0,0,0,0,Matches
2388,Morgan Sanson,FRA,MF,Aston Villa,Premier League,26,1994,4.0,12,8,7,2,3,3,7,42.9,4,13,0,13,10,22,2,1,Matches
2389,Nicola Sansone,ITA,"FW,MF",Bologna,Serie A,29,1991,10.0,13,7,5,6,2,3,15,20.0,12,1,0,1,4,17,2,0,Matches
2390,Baptiste Santamaria,FRA,"MF,DF",Rennes,Ligue 1,26,1995,28.0,52,27,15,31,6,24,44,54.5,20,33,12,21,33,85,42,0,Matches
2391,Baptiste Santamaria,FRA,MF,Freiburg,Bundesliga,26,1995,0.2,0,0,0,0,0,0,1,0.0,1,0,0,0,1,1,1,0,Matches
2392,Federico Santander,PAR,"FW,DF",Bologna,Serie A,30,1991,0.7,2,1,1,1,0,1,1,100.0,0,0,0,0,0,2,0,0,Matches
2393,Jesús Santiago,ESP,MF,Valencia,La Liga,17,2004,0.9,2,2,1,1,0,0,2,0.0,2,1,0,1,0,2,1,0,Matches
2394,Samir Santos,BRA,DF,Watford,Premier League,26,1994,18.6,24,11,18,6,0,8,19,42.1,11,21,11,10,43,67,85,3,Matches
2395,Samir Santos,BRA,DF,Udinese,Serie A,26,1994,15.8,36,16,22,13,1,15,25,60.0,10,21,7,14,42,78,62,0,Matches
2396,Sergio Santos,ESP,DF,Real Madrid,La Liga,20,2001,0.1,0,0,0,0,0,0,0,,0,0,0,0,0,0,0,0,Matches
2397,Alvaro Sanz,ESP,MF,Barcelona,La Liga,20,2001,0.3,0,0,0,0,0,0,1,0.0,1,0,0,0,0,0,0,0,Matches
2398,Riccardo Saponara,ITA,FW,Fiorentina,Serie A,29,1991,14.3,10,2,1,6,3,6,16,37.5,10,5,0,5,1,11,3,0,Matches
2399,Pablo Sarabia,ESP,FW,Paris S-G,Ligue 1,29,1992,0.2,0,0,0,0,0,0,1,0.0,1,0,0,0,0,0,0,0,Matches
2400,Marcelo Saracchi,URU,DF,Levante,La Liga,23,1998,2.1,8,5,6,1,1,2,4,50.0,2,3,0,3,4,12,7,1,Matches
2401,Josh Sargent,USA,"FW,MF",Norwich City,Premier League,21,2000,17.5,26,14,15,7,4,14,39,35.9,25,29,2,27,11,37,18,2,Matches
2402,Jeremy Sarmiento,ECU,"FW,MF",Brighton,Premier League,19,2002,0.5,1,1,0,0,1,0,2,0.0,2,2,0,2,0,1,0,0,Matches
2403,Bouna Sarr,SEN,DF,Bayern Munich,Bundesliga,29,1992,0.7,4,4,2,1,1,4,5,80.0,1,2,1,1,6,10,1,0,Matches
2404,Ismaila Sarr,SEN,"FW,MF",Watford,Premier League,23,1998,20.7,12,7,4,3,5,5,19,26.3,14,10,1,9,9,21,10,0,Matches
2405,Malang Sarr,FRA,DF,Chelsea,Premier League,22,1999,6.1,14,7,10,2,2,7,12,58.3,5,6,3,3,11,25,20,0,Matches
2406,Joan Sastre Vanrell,ESP,DF,Mallorca,La Liga,24,1997,2.9,6,3,5,0,1,3,4,75.0,1,3,0,3,2,8,10,0,Matches
2407,Giacomo Satalino,ITA,GK,Sassuolo,Serie A,22,1999,0.1,0,0,0,0,0,0,0,,0,0,0,0,0,0,0,0,Matches
2408,Martin Satriano,URU,"FW,MF",Inter,Serie A,20,2001,0.4,1,0,0,0,1,1,1,100.0,0,0,0,0,0,1,0,0,Matches
2409,Martin Satriano,URU,FW,Brest,Ligue 1,20,2001,10.4,5,2,1,1,3,2,7,28.6,5,8,0,8,2,7,3,0,Matches
2410,Téji Savanier,FRA,MF,Montpellier,Ligue 1,29,1991,26.8,46,27,18,19,9,21,59,35.6,38,23,1,22,25,71,12,1,Matches
2411,Esteban Saveljich,MNE,DF,Rayo Vallecano,La Liga,30,1991,18.9,18,11,11,7,0,9,15,60.0,6,20,12,8,16,34,69,0,Matches
2412,Stefan Savić,MNE,DF,Atlético Madrid,La Liga,30,1991,27.1,46,20,25,20,1,29,43,67.4,14,19,12,7,37,83,102,1,Matches
2413,Joe Scally,USA,DF,Gladbach,Bundesliga,18,2002,21.2,40,30,21,14,5,17,41,41.5,24,27,4,23,22,62,38,0,Matches
2414,Giorgio Scalvini,ITA,"DF,MF",Atalanta,Serie A,17,2003,8.5,22,11,13,8,1,9,19,47.4,10,12,1,11,22,44,16,0,Matches
2415,Gianluca Scamacca,ITA,FW,Sassuolo,Serie A,22,1999,23.8,19,14,2,5,12,5,21,23.8,16,16,1,15,5,24,22,1,Matches
2416,Dane Scarlett,ENG,MF,Tottenham,Premier League,17,2004,0.0,0,0,0,0,0,0,0,,0,0,0,0,0,0,0,0,Matches
2417,Kevin Schade,GER,"MF,FW",Freiburg,Bundesliga,19,2001,9.2,9,7,6,2,1,3,10,30.0,7,15,3,12,3,12,16,0,Matches
2418,András Schäfer,HUN,MF,Union Berlin,Bundesliga,22,1999,2.7,4,1,3,1,0,0,5,0.0,5,7,1,6,2,6,4,0,Matches
2419,Fabian Schär,SUI,DF,Newcastle Utd,Premier League,29,1991,24.0,16,11,11,3,2,8,16,50.0,8,27,18,9,32,48,95,2,Matches
2420,Louis Schaub,AUT,"MF,FW",Köln,Bundesliga,26,1994,7.3,16,10,7,7,2,11,20,55.0,9,17,3,14,3,19,3,0,Matches
2421,Andrea Schiavone,ITA,MF,Salernitana,Serie A,28,1993,6.3,14,8,5,9,0,10,23,43.5,13,13,3,10,8,22,12,0,Matches
2422,Patrik Schick,CZE,FW,Leverkusen,Bundesliga,25,1996,23.1,5,2,2,2,1,1,9,11.1,8,6,1,5,3,8,28,0,Matches
2423,Kingsley Schindler,GHA,"DF,FW",Köln,Bundesliga,28,1993,3.9,1,0,0,0,1,1,5,20.0,4,5,1,4,5,6,5,0,Matches
2424,Xaver Schlager,AUT,MF,Wolfsburg,Bundesliga,23,1997,11.6,43,20,20,20,3,20,49,40.8,29,25,2,23,9,52,14,0,Matches
2425,Keven Schlotterbeck,GER,"DF,FW",Freiburg,Bundesliga,24,1997,3.5,11,5,6,5,0,5,6,83.3,1,7,4,3,11,22,24,1,Matches
2426,Nico Schlotterbeck,GER,DF,Freiburg,Bundesliga,21,1999,30.9,72,43,36,34,2,33,48,68.8,15,41,32,9,56,128,154,1,Matches
2427,Jeffrey Schlupp,GHA,"MF,FW",Crystal Palace,Premier League,28,1992,20.6,46,25,16,23,7,24,50,48.0,26,39,9,30,18,64,32,0,Matches
2428,Kasper Schmeichel,DEN,GK,Leicester City,Premier League,34,1986,37.0,0,0,0,0,0,0,2,0.0,2,0,0,0,1,1,15,2,Matches
2429,Jonathan Schmid,FRA,DF,Freiburg,Bundesliga,31,1990,6.5,12,6,6,3,3,5,7,71.4,2,7,1,6,6,18,15,0,Matches
2430,Benno Schmitz,GER,DF,Köln,Bundesliga,26,1994,26.9,57,37,21,27,9,42,86,48.8,44,44,8,36,39,96,39,0,Matches
2431,David Schnegg,AUT,DF,Venezia,Serie A,22,1998,1.6,2,0,1,1,0,1,3,33.3,2,4,0,4,3,5,6,0,Matches
2432,Morgan Schneiderlin,FRA,MF,Nice,Ligue 1,31,1989,7.2,21,12,9,11,1,6,13,46.2,7,8,2,6,20,41,18,0,Matches
2433,Alessandro Schöpf,AUT,MF,Arminia,Bundesliga,27,1994,26.6,40,22,19,16,5,14,30,46.7,16,31,5,26,30,70,21,1,Matches
2434,Jerdy Schouten,NED,MF,Bologna,Serie A,24,1997,15.5,25,17,10,12,3,9,22,40.9,13,22,5,17,33,58,29,1,Matches
2435,Nico Schulz,GER,DF,Dortmund,Bundesliga,28,1993,9.3,21,12,9,7,5,9,21,42.9,12,8,1,7,11,32,8,0,Matches
2436,Marvin Schwäbe,GER,GK,Köln,Bundesliga,26,1995,21.0,0,0,0,0,0,0,0,,0,0,0,0,0,0,8,1,Matches
2437,Alexander Schwolow,GER,GK,Hertha BSC,Bundesliga,29,1992,24.2,0,0,0,0,0,0,1,0.0,1,0,0,0,2,2,18,3,Matches
2438,Valentino Scotta,ESP,DF,Sevilla,La Liga,19,2001,0.0,0,0,0,0,0,0,0,,0,0,0,0,0,0,0,0,Matches
2439,Demba Seck,SEN,"MF,FW",Torino,Serie A,20,2001,1.6,2,1,0,2,0,0,0,,0,0,0,0,0,2,0,0,Matches
2440,Aleksandar Sedlar,SRB,"DF,MF",Mallorca,La Liga,29,1991,4.5,5,3,4,1,0,3,5,60.0,2,4,4,0,5,10,19,0,Matches
2441,Paul Seguin,GER,MF,Greuther Fürth,Bundesliga,26,1995,23.4,50,31,15,32,3,26,56,46.4,30,27,3,24,19,69,30,1,Matches
2442,Alidu Seidu,GHA,DF,Clermont Foot,Ligue 1,21,2000,15.7,34,20,20,13,1,16,27,59.3,11,25,11,14,34,68,49,1,Matches
2443,Davie Selke,GER,FW,Hertha BSC,Bundesliga,26,1995,11.2,5,4,1,3,1,1,3,33.3,2,6,1,5,1,6,11,0,Matches
2444,Matz Sels,BEL,GK,Strasbourg,Ligue 1,29,1992,37.0,1,1,1,0,0,0,0,,0,0,0,0,1,2,22,0,Matches
2445,Ken Sema,SWE,"MF,FW",Watford,Premier League,27,1993,9.5,16,6,11,4,1,9,20,45.0,11,10,0,10,5,21,11,0,Matches
2446,Nélson Semedo,POR,"MF,DF",Wolves,Premier League,27,1993,23.7,58,39,39,17,2,25,49,51.0,24,23,4,19,21,79,64,1,Matches
2447,Lion Semić,GER,DF,Dortmund,Bundesliga,17,2003,0.0,0,0,0,0,0,0,0,,0,0,0,0,0,0,0,0,Matches
2448,Adrian Šemper,CRO,GK,Genoa,Serie A,23,1998,1.0,0,0,0,0,0,0,0,,0,0,0,0,0,0,0,0,Matches
2449,Stefano Sensi,ITA,"MF,FW",Sampdoria,Serie A,25,1995,8.4,18,9,10,6,2,10,23,43.5,13,2,0,2,6,24,4,0,Matches
2450,Stefano Sensi,ITA,"MF,FW",Inter,Serie A,25,1995,1.9,4,3,1,3,0,2,4,50.0,2,2,0,2,0,4,2,0,Matches
2451,Luigi Sepe,ITA,GK,Salernitana,Serie A,30,1991,15.5,0,0,0,0,0,0,0,,0,0,0,0,1,1,3,0,Matches
2452,Suat Serdar,GER,"MF,FW",Hertha BSC,Bundesliga,24,1997,24.6,64,30,24,29,11,25,55,45.5,30,32,3,29,20,84,14,0,Matches
2453,Laurens Serpe,ITA,DF,Genoa,Serie A,20,2001,0.5,1,0,1,0,0,1,2,50.0,1,0,0,0,0,1,1,0,Matches
2454,Janni Serra,GER,FW,Arminia,Bundesliga,23,1998,12.4,4,2,2,0,2,2,7,28.6,5,8,3,5,5,9,19,0,Matches
2455,Javier Serrano,ESP,MF,Atlético Madrid,La Liga,18,2003,0.8,3,1,0,3,0,2,4,50.0,2,0,0,0,3,6,2,0,Matches
2456,Nicolás Serrano,ESP,"MF,FW",Athletic Club,La Liga,18,2003,3.5,9,6,3,5,1,3,10,30.0,7,5,1,4,2,11,3,0,Matches
2457,Zidan Sertdemir,DEN,"MF,FW",Leverkusen,Bundesliga,16,2005,0.2,2,2,2,0,0,0,0,,0,0,0,0,0,2,0,0,Matches
2458,Ryan Sessegnon,ENG,"DF,MF",Tottenham,Premier League,21,2000,11.6,25,19,14,7,4,11,22,50.0,11,18,3,15,7,32,26,0,Matches
2459,Nils Seufert,GER,MF,Greuther Fürth,Bundesliga,24,1997,1.1,3,2,1,1,1,0,1,0.0,1,0,0,0,0,3,0,0,Matches
2460,Salva Sevilla,ESP,MF,Mallorca,La Liga,37,1984,16.7,18,12,8,8,2,6,17,35.3,11,12,6,6,14,32,11,0,Matches
2461,Stephan El Shaarawy,ITA,"FW,DF",Roma,Serie A,28,1992,11.7,13,8,4,9,0,4,6,66.7,2,10,2,8,11,24,8,0,Matches
2462,Jamie Shackleton,ENG,"DF,MF",Leeds United,Premier League,21,1999,7.9,27,16,19,7,1,13,25,52.0,12,11,7,4,8,35,12,1,Matches
2463,Xherdan Shaqiri,SUI,"FW,MF",Lyon,Ligue 1,29,1991,7.5,7,3,0,5,2,2,10,20.0,8,2,0,2,2,9,2,0,Matches
2464,Luke Shaw,ENG,DF,Manchester Utd,Premier League,26,1995,17.8,21,13,9,9,3,12,21,57.1,9,22,11,11,9,30,22,2,Matches
2465,Jonjo Shelvey,ENG,MF,Newcastle Utd,Premier League,29,1992,22.0,30,17,12,18,0,14,34,41.2,20,22,7,15,22,52,20,2,Matches
2466,Aimar Sher,SWE,MF,Spezia,Serie A,18,2002,0.5,2,1,1,1,0,0,1,0.0,1,1,0,1,3,5,1,0,Matches
2467,Eldor Shomurodov,UZB,"FW,MF",Roma,Serie A,26,1995,8.7,5,4,0,4,1,1,10,10.0,9,8,0,8,2,7,5,0,Matches
2468,Shola Shoretire,ENG,MF,Manchester Utd,Premier League,17,2004,0.2,0,0,0,0,0,0,0,,0,0,0,0,0,0,0,0,Matches
2469,Mahame Siby,MLI,DF,Strasbourg,Ligue 1,25,1996,0.2,0,0,0,0,0,0,0,,0,0,0,0,1,1,2,0,Matches
2470,Aboubakar Sidibé,FRA,DF,Clermont Foot,Ligue 1,25,1996,0.1,0,0,0,0,0,0,0,,0,0,0,0,0,0,0,0,Matches
2471,Alassane Sidibe,CIV,MF,Atalanta,Serie A,19,2002,0.1,1,1,1,0,0,0,0,,0,0,0,0,0,1,0,0,Matches
2472,Djibril Sidibé,FRA,DF,Monaco,Ligue 1,29,1992,10.5,24,13,13,8,3,9,24,37.5,15,10,1,9,16,40,13,0,Matches
2473,Kaj Sierhuis,NED,FW,Reims,Ligue 1,23,1998,0.9,1,1,1,0,0,1,3,33.3,2,0,0,0,0,1,1,0,Matches
2474,Francisco Sierralta,CHI,DF,Watford,Premier League,24,1997,4.7,7,3,7,0,0,5,8,62.5,3,7,2,5,6,13,35,0,Matches
2475,Arnór Sigurðsson,ISL,"FW,MF",Venezia,Serie A,22,1999,2.0,1,1,0,1,0,1,2,50.0,1,2,0,2,1,2,0,0,Matches
2476,Kiliann Sildillia,FRA,"DF,MF",Freiburg,Bundesliga,19,2002,1.9,7,3,3,4,0,3,6,50.0,3,1,0,1,2,9,7,1,Matches
2477,Adrien Silva,POR,MF,Sampdoria,Serie A,32,1989,12.0,24,12,14,5,5,9,33,27.3,24,15,5,10,23,47,23,0,Matches
2478,André Silva,POR,FW,RB Leipzig,Bundesliga,25,1995,23.1,13,9,2,3,8,4,13,30.8,9,20,2,18,2,15,15,0,Matches
2479,Bernardo Silva,POR,"MF,FW",Manchester City,Premier League,26,1994,31.7,57,29,19,19,19,31,67,46.3,36,24,2,22,20,77,19,0,Matches
2480,Caio Henrique Oliveira Silva,BRA,DF,Monaco,Ligue 1,24,1997,29.6,53,30,31,18,4,28,59,47.5,31,30,6,24,27,80,37,3,Matches
2481,David Silva,ESP,MF,Real Sociedad,La Liga,35,1986,19.1,28,17,10,11,7,3,20,15.0,17,13,3,10,7,35,12,0,Matches
2482,Fábio Silva,POR,FW,Wolves,Premier League,19,2002,6.4,3,2,0,2,1,0,8,0.0,8,2,0,2,1,4,1,0,Matches
2483,Gabriel Silva,BRA,"DF,MF",Saint-Étienne,Ligue 1,30,1991,7.9,12,7,7,2,3,9,13,69.2,4,9,3,6,18,30,13,0,Matches
2484,Jonathan Silva,ARG,"DF,FW",Getafe,La Liga,27,1994,2.5,10,8,4,4,2,7,12,58.3,5,4,0,4,3,13,7,0,Matches
2485,Rui Silva,POR,GK,Betis,La Liga,27,1994,21.8,1,0,1,0,0,1,2,50.0,1,0,0,0,1,2,11,1,Matches
2486,Thiago Silva,BRA,DF,Chelsea,Premier League,36,1984,29.4,32,21,19,12,1,11,22,50.0,11,54,31,23,44,76,100,0,Matches
2487,Marco Silvestri,ITA,GK,Udinese,Serie A,30,1991,35.0,0,0,0,0,0,0,1,0.0,1,0,0,0,1,1,11,1,Matches
2488,Mohamed Simakan,FRA,DF,RB Leipzig,Bundesliga,21,2000,22.3,48,27,25,21,2,27,41,65.9,14,22,11,11,40,88,46,1,Matches
2489,Giovanni Simeone,ARG,FW,Hellas Verona,Serie A,26,1995,29.5,27,15,6,12,9,9,39,23.1,30,37,3,34,6,33,23,0,Matches
2490,Giovanni Simeone,ARG,FW,Cagliari,Serie A,26,1995,0.1,0,0,0,0,0,0,0,,0,0,0,0,0,0,0,0,Matches
2491,Giuliano Simeone,ARG,MF,Atlético Madrid,La Liga,18,2002,0.0,0,0,0,0,0,0,0,,0,0,0,0,0,0,0,0,Matches
2492,Ellis Simms,ENG,FW,Everton,Premier League,20,2001,0.7,0,0,0,0,0,0,0,,0,1,1,0,0,0,1,0,Matches
2493,Moses Simon,NGA,"FW,MF",Nantes,Ligue 1,26,1995,25.9,17,11,6,5,6,11,23,47.8,12,14,3,11,12,29,5,0,Matches
2494,Unai Simón,ESP,GK,Athletic Club,La Liga,24,1997,34.0,0,0,0,0,0,0,0,,0,0,0,0,1,1,5,1,Matches
2495,Xavi Simons,NED,"MF,FW",Paris S-G,Ligue 1,18,2003,1.5,1,1,0,1,0,1,2,50.0,1,3,0,3,0,1,0,0,Matches
2496,Wilfried Singo,CIV,DF,Torino,Serie A,20,2000,29.0,55,35,24,24,7,24,34,70.6,10,26,6,20,23,78,47,0,Matches
2497,Daley Sinkgraven,NED,DF,Leverkusen,Bundesliga,26,1995,3.9,6,2,4,0,2,3,7,42.9,4,3,1,2,3,9,6,0,Matches
2498,Tobias Sippel,GER,GK,Gladbach,Bundesliga,33,1988,1.0,0,0,0,0,0,0,0,,0,0,0,0,0,0,0,0,Matches
2499,Hugo Siquet,BEL,DF,Freiburg,Bundesliga,19,2002,0.2,0,0,0,0,0,0,0,,0,0,0,0,0,0,0,0,Matches
2500,Salvatore Sirigu,ITA,GK,Genoa,Serie A,34,1987,37.0,1,1,1,0,0,1,2,50.0,1,0,0,0,0,1,19,2,Matches
2501,Issouf Sissokho,MLI,MF,Bordeaux,Ligue 1,19,2002,4.8,17,8,2,13,2,8,17,47.1,9,8,1,7,7,24,0,0,Matches
2502,Ibrahima Sissoko,MLI,"MF,DF",Strasbourg,Ligue 1,23,1997,25.6,47,23,18,20,9,19,46,41.3,27,32,11,21,35,82,31,0,Matches
2503,Moussa Sissoko,FRA,MF,Watford,Premier League,31,1989,35.8,53,27,27,20,6,28,42,66.7,14,42,13,29,30,83,64,0,Matches
2504,Nelson Sissoko,FRA,DF,Saint-Étienne,Ligue 1,24,1997,0.5,2,0,2,0,0,1,1,100.0,0,0,0,0,0,2,2,0,Matches
2505,Sambou Sissoko,FRA,"MF,DF",Reims,Ligue 1,22,1999,2.0,12,6,6,4,2,6,8,75.0,2,2,0,2,2,14,7,0,Matches
2506,Antonio Sivera,ESP,GK,Alavés,La Liga,24,1996,3.1,0,0,0,0,0,0,1,0.0,1,0,0,0,0,0,0,0,Matches
2507,Ellyes Skhiri,TUN,MF,Köln,Bundesliga,26,1995,20.2,55,33,25,26,4,22,41,53.7,19,41,7,34,37,92,35,1,Matches
2508,Oliver Skipp,ENG,MF,Tottenham,Premier League,20,2000,15.0,33,19,14,18,1,15,31,48.4,16,19,7,12,12,45,10,1,Matches
2509,Leo Skiri Østigård,NOR,DF,Genoa,Serie A,21,1999,13.0,16,9,8,7,1,9,11,81.8,2,17,10,7,8,24,55,1,Matches
2510,Łukasz Skorupski,POL,GK,Bologna,Serie A,30,1991,36.0,0,0,0,0,0,0,1,0.0,1,0,0,0,0,0,17,0,Matches
2511,Andreas Skov Olsen,DEN,"FW,DF",Bologna,Serie A,21,1999,8.3,12,10,4,4,4,5,11,45.5,6,9,1,8,3,15,11,0,Matches
2512,Robert Skov,DEN,"FW,DF",Hoffenheim,Bundesliga,25,1996,4.1,3,2,1,1,1,2,9,22.2,7,2,0,2,3,6,3,0,Matches
2513,Milan Škriniar,SVK,DF,Inter,Serie A,26,1995,35.0,47,27,26,17,4,24,42,57.1,18,36,25,11,25,72,90,1,Matches
2514,Islam Slimani,ALG,FW,Lyon,Ligue 1,33,1988,6.4,3,2,0,1,2,1,6,16.7,5,4,0,4,2,5,5,0,Matches
2515,William Smallbone,IRL,"MF,FW",Southampton,Premier League,21,2000,1.5,4,4,2,2,0,1,3,33.3,2,4,0,4,2,6,0,0,Matches
2516,Chris Smalling,ENG,DF,Roma,Serie A,31,1989,23.2,36,23,28,8,0,18,25,72.0,7,32,24,8,26,62,92,1,Matches
2517,Emile Smith Rowe,ENG,"MF,FW",Arsenal,Premier League,21,2000,21.3,14,7,7,7,0,4,20,20.0,16,18,1,17,15,29,10,1,Matches
2518,Cédric Soares,POR,DF,Arsenal,Premier League,29,1991,16.5,38,26,23,9,6,16,25,64.0,9,18,7,11,16,54,31,1,Matches
2519,Danilo Soares,BRA,DF,Bochum,Bundesliga,29,1991,28.5,109,71,61,39,9,56,84,66.7,28,63,9,54,62,171,65,2,Matches
2520,Rubén Sobrino,ESP,MF,Valencia,La Liga,29,1992,0.2,1,1,1,0,0,1,1,100.0,0,1,0,1,2,3,0,0,Matches
2521,Rubén Sobrino,ESP,"FW,MF",Cádiz,La Liga,29,1992,20.7,28,17,11,10,7,5,35,14.3,30,21,1,20,21,49,18,0,Matches
2522,Alex Sola,ESP,"DF,FW",Real Sociedad,La Liga,22,1999,0.5,1,1,1,0,0,1,3,33.3,2,1,0,1,2,3,3,0,Matches
2523,Augusto Solari,ARG,"MF,DF",Celta Vigo,La Liga,29,1992,7.9,24,12,9,12,3,12,32,37.5,20,14,4,10,7,31,10,1,Matches
2524,Roberto Soldado,ESP,FW,Levante,La Liga,36,1985,7.4,3,1,0,1,2,1,3,33.3,2,4,0,4,1,4,7,0,Matches
2525,Carlos Soler,ESP,MF,Valencia,La Liga,24,1997,27.5,29,19,10,15,4,11,37,29.7,26,19,4,15,14,43,28,0,Matches
2526,Yann Sommer,SUI,GK,Gladbach,Bundesliga,32,1988,33.0,0,0,0,0,0,0,2,0.0,2,0,0,0,3,3,8,3,Matches
2527,Son,ESP,DF,Levante,La Liga,27,1994,21.9,28,18,16,7,5,17,34,50.0,17,11,5,6,19,47,33,1,Matches
2528,Brandon Soppy,FRA,"DF,MF",Udinese,Serie A,19,2002,8.6,20,9,8,10,2,11,16,68.8,5,10,2,8,5,25,9,1,Matches
2529,David Soria,ESP,GK,Getafe,La Liga,28,1993,37.9,1,0,1,0,0,1,2,50.0,1,0,0,0,0,1,22,2,Matches
2530,Roberto Soriano,ITA,MF,Bologna,Serie A,30,1991,29.1,57,30,27,22,8,17,56,30.4,39,37,3,34,22,79,32,0,Matches
2531,Alberto Soro,ESP,"MF,FW",Granada,La Liga,22,1999,6.4,12,10,3,6,3,1,7,14.3,6,21,2,19,3,15,4,0,Matches
2532,Borna Sosa,CRO,"DF,FW",Stuttgart,Bundesliga,23,1998,27.8,22,12,14,5,3,12,26,46.2,14,30,3,27,26,48,61,0,Matches
2533,Hugo Sotelo,ESP,FW,Celta Vigo,La Liga,17,2003,0.0,0,0,0,0,0,0,0,,0,0,0,0,0,0,0,0,Matches
2534,Florian Sotoca,FRA,"FW,MF",Lens,Ligue 1,30,1990,27.6,31,19,7,20,4,12,51,23.5,39,31,4,27,25,56,41,0,Matches
2535,Riccardo Sottil,ITA,FW,Fiorentina,Serie A,22,1999,13.8,9,4,4,4,1,3,9,33.3,6,3,0,3,1,10,2,0,Matches
2536,Tomáš Souček,CZE,MF,West Ham,Premier League,26,1995,34.0,66,32,27,33,6,28,65,43.1,37,34,13,21,52,118,98,1,Matches
2537,Matìas Soulé,ARG,FW,Juventus,Serie A,18,2003,0.1,0,0,0,0,0,0,1,0.0,1,0,0,0,0,0,0,0,Matches
2538,Sambou Soumano,SEN,"FW,MF",Lorient,Ligue 1,20,2001,5.0,4,1,1,2,1,2,2,100.0,0,3,0,3,1,5,7,0,Matches
2539,Adama Soumaoro,FRA,DF,Bologna,Serie A,29,1992,25.2,15,5,5,8,2,4,9,44.4,5,22,16,6,34,49,95,0,Matches
2540,Boubakary Soumaré,FRA,MF,Leicester City,Premier League,22,1999,12.2,19,13,10,8,1,8,17,47.1,9,13,1,12,14,33,18,0,Matches
2541,Arnaud Souquet,FRA,DF,Montpellier,Ligue 1,29,1992,25.9,56,35,30,17,9,32,65,49.2,33,21,7,14,34,90,60,1,Matches
2542,Djibril Sow,SUI,MF,Eint Frankfurt,Bundesliga,24,1997,26.8,57,33,28,25,4,22,60,36.7,38,35,8,27,50,107,20,1,Matches
2543,Saidou Sow,GUI,DF,Saint-Étienne,Ligue 1,19,2002,11.0,28,17,21,6,1,16,21,76.2,5,15,5,10,23,51,34,0,Matches
2544,Çağlar Söyüncü,TUR,DF,Leicester City,Premier League,25,1996,27.7,47,30,32,12,3,26,42,61.9,16,44,27,17,32,79,115,1,Matches
2545,Leonardo Spinazzola,ITA,DF,Roma,Serie A,28,1993,1.4,0,0,0,0,0,0,1,0.0,1,4,1,3,0,0,3,0,Matches
2546,Marco Sportiello,ITA,GK,Atalanta,Serie A,29,1992,5.0,0,0,0,0,0,0,0,,0,0,0,0,0,0,2,0,Matches
2547,Tony Springett,IRL,"MF,FW",Norwich City,Premier League,18,2002,1.6,2,1,1,1,0,1,4,25.0,3,0,0,0,0,2,2,0,Matches
2548,Jerry St. Juste,NED,DF,Mainz 05,Bundesliga,24,1996,6.7,13,9,7,6,0,7,8,87.5,1,7,3,4,14,27,14,0,Matches
2549,Anton Stach,GER,MF,Mainz 05,Bundesliga,22,1998,20.7,28,19,14,13,1,15,38,39.5,23,24,5,19,51,79,25,0,Matches
2550,Kostas Stafylidis,GRE,"DF,MF",Bochum,Bundesliga,27,1993,15.4,37,27,22,13,2,20,26,76.9,6,19,6,13,31,68,43,0,Matches
2551,Luca Stanga,ITA,DF,Milan,Serie A,19,2002,0.0,1,0,0,1,0,0,0,,0,0,0,0,0,1,0,0,Matches
2552,Josip Stanišić,CRO,DF,Bayern Munich,Bundesliga,21,2000,7.2,21,10,7,12,2,12,18,66.7,6,7,0,7,11,32,10,2,Matches
2553,Niklas Stark,GER,DF,Hertha BSC,Bundesliga,26,1995,22.6,28,16,18,10,0,12,17,70.6,5,27,17,10,36,64,122,2,Matches
2554,Jason Steele,ENG,GK,Brighton,Premier League,30,1990,1.0,0,0,0,0,0,0,0,,0,0,0,0,0,0,0,0,Matches
2555,Jed Steer,ENG,GK,Aston Villa,Premier League,28,1992,1.0,0,0,0,0,0,0,0,,0,0,0,0,0,0,0,0,Matches
2556,Renato Steffen,SUI,"FW,MF",Wolfsburg,Bundesliga,29,1991,10.7,20,16,10,10,0,9,16,56.3,7,7,0,7,13,33,14,0,Matches
2557,Zack Steffen,USA,GK,Manchester City,Premier League,26,1995,1.0,0,0,0,0,0,0,0,,0,0,0,0,0,0,2,0,Matches
2558,Calvin Stengs,NED,MF,Nice,Ligue 1,22,1998,11.9,16,7,6,9,1,7,20,35.0,13,10,0,10,8,24,6,0,Matches
2559,Pascal Stenzel,GER,DF,Stuttgart,Bundesliga,25,1996,10.0,24,11,15,5,4,17,33,51.5,16,13,3,10,11,35,25,0,Matches
2560,Dale Stephens,ENG,MF,Burnley,Premier League,32,1989,1.4,4,1,0,3,1,3,8,37.5,5,4,1,3,1,5,1,0,Matches
2561,Jack Stephens,ENG,DF,Southampton,Premier League,27,1994,9.0,19,12,13,5,1,6,16,37.5,10,12,7,5,19,38,42,0,Matches
2562,Raheem Sterling,ENG,FW,Manchester City,Premier League,26,1994,23.6,23,10,3,11,9,10,23,43.5,13,12,0,12,12,35,3,0,Matches
2563,Finley Stevens,WAL,DF,Brentford,Premier League,18,2003,0.2,3,1,0,3,0,1,1,100.0,0,0,0,0,0,3,0,0,Matches
2564,Angelo Stiller,GER,MF,Hoffenheim,Bundesliga,20,2001,18.8,30,17,11,15,4,9,23,39.1,14,32,6,26,9,39,16,2,Matches
2565,Lars Stindl,GER,"MF,FW",Gladbach,Bundesliga,32,1988,18.1,23,15,6,14,3,9,33,27.3,24,28,2,26,10,33,14,0,Matches
2566,Riccardo Stivanello,ITA,DF,Bologna,Serie A,17,2004,0.5,1,1,1,0,0,1,1,100.0,0,2,2,0,0,1,6,0,Matches
2567,Kevin Stöger,AUT,MF,Mainz 05,Bundesliga,27,1993,4.7,10,5,5,5,0,4,10,40.0,6,6,0,6,5,15,1,1,Matches
2568,Petar Stojanović,SVN,DF,Empoli,Serie A,25,1995,30.4,96,63,55,32,9,59,114,51.8,55,39,13,26,27,123,65,1,Matches
2569,John Stones,ENG,DF,Manchester City,Premier League,27,1994,12.4,5,3,3,2,0,2,3,66.7,1,3,3,0,11,16,27,1,Matches
2570,Thomas Strakosha,ALB,GK,Lazio,Serie A,26,1995,23.0,0,0,0,0,0,0,0,,0,0,0,0,0,0,7,2,Matches
2571,Stefan Strandberg,NOR,DF,Salernitana,Serie A,31,1990,10.4,13,8,10,3,0,8,11,72.7,3,15,13,2,9,22,49,0,Matches
2572,Dávid Strelec,SVK,"FW,MF",Spezia,Serie A,20,2001,5.6,4,4,1,2,1,2,9,22.2,7,8,1,7,2,6,1,0,Matches
2573,Tobias Strobl,GER,"MF,DF",Augsburg,Bundesliga,31,1990,3.6,8,3,3,5,0,3,11,27.3,8,7,2,5,7,15,3,0,Matches
2574,Kevin Strootman,NED,MF,Cagliari,Serie A,31,1990,7.1,8,4,2,4,2,5,12,41.7,7,11,2,9,10,18,15,0,Matches
2575,Pascal Struijk,NED,"DF,MF",Leeds United,Premier League,21,1999,22.8,61,39,34,23,4,30,50,60.0,20,35,23,12,33,94,60,2,Matches
2576,Jens Stryger Larsen,DEN,DF,Udinese,Serie A,30,1991,7.6,5,2,3,1,1,2,3,66.7,1,2,0,2,4,9,17,0,Matches
2577,Leo Štulac,SVN,MF,Empoli,Serie A,26,1994,9.3,13,6,5,6,2,7,19,36.8,12,6,2,4,8,21,15,0,Matches
2578,Stefano Sturaro,ITA,MF,Genoa,Serie A,28,1993,19.6,43,26,16,16,11,22,48,45.8,26,25,1,24,15,58,29,2,Matches
2579,Damián Suárez,URU,DF,Getafe,La Liga,33,1988,30.1,74,47,34,30,10,42,91,46.2,49,46,5,41,31,105,30,0,Matches
2580,Denis Suárez,ESP,MF,Celta Vigo,La Liga,27,1994,31.3,61,29,20,33,8,25,82,30.5,57,32,4,28,16,77,11,0,Matches
2581,Luis Suárez,URU,FW,Atlético Madrid,La Liga,34,1987,20.4,8,5,2,4,2,2,10,20.0,8,8,1,7,1,9,14,0,Matches
2582,Mario Suárez,ESP,DF,Rayo Vallecano,La Liga,34,1987,7.9,9,4,7,2,0,3,9,33.3,6,6,4,2,7,16,37,1,Matches
2583,Isaac Success,NGA,"FW,MF",Udinese,Serie A,25,1996,10.1,5,2,0,3,2,1,5,20.0,4,2,0,2,2,7,6,0,Matches
2584,Niklas Süle,GER,DF,Bayern Munich,Bundesliga,25,1995,20.4,29,23,21,7,1,18,24,75.0,6,16,12,4,28,57,49,0,Matches
2585,Kamaldeen Sulemana,GHA,"MF,FW",Rennes,Ligue 1,19,2002,11.3,23,12,7,9,7,10,17,58.8,7,10,1,9,4,27,5,0,Matches
2586,Crysencio Summerville,NED,"MF,FW",Leeds United,Premier League,19,2001,1.4,5,3,1,1,3,2,3,66.7,1,2,0,2,2,7,0,0,Matches
2587,Vladyslav Supriaha,UKR,FW,Sampdoria,Serie A,21,2000,0.2,0,0,0,0,0,0,1,0.0,1,0,0,0,0,0,0,0,Matches
2588,Suso,ESP,FW,Sevilla,La Liga,27,1993,4.3,4,3,1,3,0,3,13,23.1,10,4,0,4,0,4,0,0,Matches
2589,Bosko Sutalo,CRO,DF,Hellas Verona,Serie A,21,2000,10.2,20,13,11,6,3,8,16,50.0,8,10,5,5,17,37,39,0,Matches
2590,Mattias Svanberg,SWE,MF,Bologna,Serie A,22,1999,28.5,39,15,15,16,8,16,54,29.6,38,31,9,22,28,67,34,0,Matches
2591,Michael Svoboda,AUT,DF,Venezia,Serie A,22,1998,13.7,33,17,26,6,1,18,32,56.3,14,27,15,12,10,43,61,5,Matches
2592,Abdoulaye Sylla,GUI,DF,Nantes,Ligue 1,21,2000,1.7,4,4,2,1,1,2,4,50.0,2,5,3,2,1,5,3,0,Matches
2593,Mamadou Sylla,SEN,"FW,MF",Alavés,La Liga,27,1994,4.4,2,2,0,1,1,0,1,0.0,1,0,0,0,1,3,5,0,Matches
2594,Mamadou Sylla,SEN,FW,Rayo Vallecano,La Liga,27,1994,2.8,1,1,1,0,0,0,1,0.0,1,2,0,2,4,5,3,0,Matches
2595,Ádám Szalai,HUN,FW,Mainz 05,Bundesliga,33,1987,2.9,3,2,0,2,1,0,2,0.0,2,2,0,2,0,3,0,0,Matches
2596,Wojciech Szczęsny,POL,GK,Juventus,Serie A,31,1990,33.0,1,1,1,0,0,1,2,50.0,1,0,0,0,0,1,8,1,Matches
2597,Dominik Szoboszlai,HUN,"MF,FW",RB Leipzig,Bundesliga,20,2000,17.1,17,12,5,9,3,8,27,29.6,19,30,3,27,10,27,15,0,Matches
2598,Jakob Sørensen,DEN,"MF,DF",Norwich City,Premier League,23,1998,6.7,22,11,6,14,2,10,20,50.0,10,7,3,4,10,32,19,0,Matches
2599,Alexander Sørloth,NOR,FW,Real Sociedad,La Liga,25,1995,19.6,20,7,4,10,6,7,17,41.2,10,14,1,13,4,24,15,0,Matches
2600,Tachi,ESP,DF,Alavés,La Liga,23,1997,2.7,6,3,3,3,0,5,7,71.4,2,4,3,1,1,7,9,0,Matches
2601,Jonathan Tah,GER,DF,Leverkusen,Bundesliga,25,1996,32.0,25,18,19,5,1,17,33,51.5,16,31,20,11,43,68,156,0,Matches
2602,Waniss Taibi,FRA,"MF,FW",Angers,Ligue 1,19,2002,1.5,8,7,4,4,0,2,4,50.0,2,0,0,0,1,9,1,0,Matches
2603,Flavien Tait,FRA,MF,Rennes,Ligue 1,28,1993,23.6,28,19,13,9,6,13,40,32.5,27,15,4,11,19,47,13,1,Matches
2604,Adrien Tameze,CMR,"MF,DF",Hellas Verona,Serie A,27,1994,28.6,52,29,24,21,7,20,59,33.9,39,40,5,35,52,104,41,0,Matches
2605,Japhet Tanganga,ENG,DF,Tottenham,Premier League,22,1999,8.2,14,8,7,6,1,9,19,47.4,10,13,5,8,9,23,31,0,Matches
2606,Renato Tapia,PER,MF,Celta Vigo,La Liga,26,1995,15.7,50,31,15,31,4,20,50,40.0,30,21,5,16,28,78,43,0,Matches
2607,Edmond Tapsoba,BFA,DF,Leverkusen,Bundesliga,22,1999,20.2,35,17,24,10,1,20,32,62.5,12,27,15,12,29,64,72,1,Matches
2608,Florian Tardieu,FRA,MF,Troyes,Ligue 1,29,1992,29.2,58,25,31,21,6,31,71,43.7,40,31,9,22,42,100,38,0,Matches
2609,Matt Targett,ENG,DF,Aston Villa,Premier League,25,1995,15.9,34,18,28,5,1,24,45,53.3,21,16,9,7,23,57,35,0,Matches
2610,Matt Targett,ENG,DF,Newcastle Utd,Premier League,25,1995,16.0,41,26,26,14,1,24,37,64.9,13,15,4,11,25,66,39,1,Matches
2611,Oussama Targhalline,MAR,FW,Marseille,Ligue 1,19,2002,0.1,0,0,0,0,0,0,0,,0,0,0,0,0,0,0,0,Matches
2612,James Tarkowski,ENG,DF,Burnley,Premier League,28,1992,34.5,65,45,47,17,1,33,47,70.2,14,75,61,14,48,113,186,4,Matches
2613,Ciprian Tătărușanu,ROU,GK,Milan,Serie A,35,1986,6.0,0,0,0,0,0,0,1,0.0,1,0,0,0,0,0,2,1,Matches
2614,Niklas Tauer,GER,"DF,MF",Mainz 05,Bundesliga,20,2001,5.4,16,9,9,7,0,9,14,64.3,5,6,2,4,9,25,14,0,Matches
2615,Nuno Tavares,POR,DF,Arsenal,Premier League,21,2000,13.1,21,14,10,7,4,8,18,44.4,10,15,5,10,9,30,33,1,Matches
2616,Charlie Taylor,ENG,DF,Burnley,Premier League,27,1993,30.3,45,26,31,11,3,26,44,59.1,18,42,20,22,58,103,95,2,Matches
2617,Loum Tchaouna,FRA,"FW,MF",Rennes,Ligue 1,17,2003,1.0,3,1,1,2,0,1,5,20.0,4,0,0,0,2,5,0,0,Matches
2618,Warren Tchimbembé,CGO,MF,Metz,Ligue 1,23,1998,2.3,1,1,0,1,0,0,1,0.0,1,2,1,1,2,3,2,0,Matches
2619,Aurélien Tchouaméni,FRA,MF,Monaco,Ligue 1,21,2000,32.5,86,45,33,49,4,29,55,52.7,26,39,7,32,101,187,34,0,Matches
2620,Mathys Tel,FRA,"FW,MF",Rennes,Ligue 1,16,2005,0.6,2,1,1,1,0,0,0,,0,0,0,0,1,3,2,0,Matches
2621,Jordan Tell,GLP,FW,Clermont Foot,Ligue 1,24,1997,3.2,5,5,0,3,2,1,4,25.0,3,3,0,3,0,5,1,0,Matches
2622,Nathan Tella,NGA,"MF,FW",Southampton,Premier League,22,1999,8.9,13,9,5,7,1,6,17,35.3,11,13,0,13,6,19,9,0,Matches
2623,Alex Telles,BRA,DF,Manchester Utd,Premier League,28,1992,18.4,48,27,35,9,4,27,43,62.8,16,17,4,13,26,74,45,0,Matches
2624,Cristian Tello,ESP,FW,Betis,La Liga,29,1991,9.1,17,11,6,7,4,13,31,41.9,18,9,0,9,10,27,6,0,Matches
2625,Nahuel Tenaglia,ARG,DF,Alavés,La Liga,25,1996,11.9,42,27,30,9,3,24,37,64.9,13,10,2,8,26,68,42,0,Matches
2626,Marc Tenas,ESP,"FW,MF",Alavés,La Liga,20,2001,0.6,1,1,1,0,0,1,1,100.0,0,1,0,1,0,1,0,1,Matches
2627,Marc-André ter Stegen,GER,GK,Barcelona,La Liga,29,1992,35.0,0,0,0,0,0,0,1,0.0,1,0,0,0,1,1,13,5,Matches
2628,Filippo Terracciano,ITA,DF,Hellas Verona,Serie A,18,2003,0.1,0,0,0,0,0,0,0,,0,0,0,0,0,0,1,0,Matches
2629,Pietro Terracciano,ITA,GK,Fiorentina,Serie A,31,1990,31.8,0,0,0,0,0,0,4,0.0,4,0,0,0,2,2,20,1,Matches
2630,Martin Terrier,FRA,"FW,MF",Rennes,Ligue 1,24,1997,30.9,55,33,22,16,17,25,43,58.1,18,29,3,26,18,73,17,0,Matches
2631,Aleksa Terzić,SRB,DF,Fiorentina,Serie A,21,1999,3.0,8,5,3,3,2,4,7,57.1,3,7,0,7,4,12,5,0,Matches
2632,Robert Tesche,GER,MF,Bochum,Bundesliga,34,1987,3.9,6,4,4,1,1,5,7,71.4,2,6,2,4,5,11,5,1,Matches
2633,Tanner Tessmann,USA,MF,Venezia,Serie A,19,2001,7.6,11,5,4,6,1,5,14,35.7,9,19,9,10,5,16,22,0,Matches
2634,Tetê,BRA,"FW,MF",Lyon,Ligue 1,21,2000,6.5,10,5,4,5,1,3,13,23.1,10,4,0,4,3,13,1,0,Matches
2635,Cedric Teuchert,GER,"MF,FW",Union Berlin,Bundesliga,24,1997,1.2,3,2,3,0,0,2,6,33.3,4,1,0,1,0,3,0,0,Matches
2636,Arthur Theate,BEL,DF,Bologna,Serie A,21,2000,26.9,33,19,26,3,4,14,31,45.2,17,29,16,13,42,75,69,0,Matches
2637,Jan Thielmann,GER,"MF,FW",Köln,Bundesliga,19,2002,13.2,24,16,6,12,6,8,23,34.8,15,23,2,21,10,34,11,0,Matches
2638,Sada Thioub,SEN,FW,Angers,Ligue 1,26,1995,0.0,0,0,0,0,0,0,0,,0,0,0,0,0,0,0,0,Matches
2639,Sada Thioub,SEN,"DF,MF",Saint-Étienne,Ligue 1,26,1995,10.6,13,8,5,8,0,6,14,42.9,8,9,0,9,10,23,8,0,Matches
2640,Luke Thomas,ENG,DF,Leicester City,Premier League,20,2001,21.2,50,31,33,13,4,28,65,43.1,37,35,14,21,40,90,55,0,Matches
2641,Romain Thomas,FRA,DF,Angers,Ligue 1,33,1988,28.5,49,37,28,21,0,30,57,52.6,27,35,19,16,44,93,126,0,Matches
2642,Adrien Thomasson,FRA,MF,Strasbourg,Ligue 1,27,1993,26.5,64,31,18,27,19,30,93,32.3,63,56,4,52,29,93,16,1,Matches
2643,Erik Thommy,GER,"FW,MF",Stuttgart,Bundesliga,26,1994,3.0,2,0,0,2,0,1,2,50.0,1,3,0,3,4,6,0,0,Matches
2644,Dominic Thompson,ENG,DF,Brentford,Premier League,21,2000,1.6,1,0,1,0,0,0,1,0.0,1,2,2,0,2,3,3,0,Matches
2645,Morten Thorsby,NOR,MF,Sampdoria,Serie A,25,1996,32.7,46,26,15,23,8,28,56,50.0,28,37,12,25,25,71,39,0,Matches
2646,Thuler,BRA,DF,Montpellier,Ligue 1,22,1999,9.5,21,12,17,4,0,8,15,53.3,7,9,7,2,9,30,30,0,Matches
2647,Khéphren Thuram,FRA,MF,Nice,Ligue 1,20,2001,21.1,33,19,11,18,4,17,35,48.6,18,31,11,20,28,61,19,0,Matches
2648,Marcus Thuram,FRA,FW,Gladbach,Bundesliga,23,1997,10.9,6,5,0,5,1,1,4,25.0,3,5,0,5,5,11,5,0,Matches
2649,Alexis Tibidi,FRA,"MF,FW",Stuttgart,Bundesliga,17,2003,4.3,7,3,1,3,3,3,4,75.0,1,4,0,4,3,10,2,0,Matches
2650,Cheikh Tidiane Sabaly,SEN,"FW,MF",Metz,Ligue 1,22,1999,1.7,6,3,1,4,1,2,2,100.0,0,1,0,1,0,6,1,0,Matches
2651,Youri Tielemans,BEL,MF,Leicester City,Premier League,24,1997,29.2,74,38,23,45,6,42,100,42.0,58,47,13,34,21,95,41,3,Matches
2652,Kieran Tierney,SCO,DF,Arsenal,Premier League,24,1997,21.3,18,14,11,7,0,10,11,90.9,1,23,5,18,15,33,54,0,Matches
2653,Steffen Tigges,GER,"FW,MF",Dortmund,Bundesliga,23,1998,1.2,4,3,1,2,1,2,3,66.7,1,3,1,2,0,4,3,0,Matches
2654,Malik Tillman,USA,"FW,MF",Bayern Munich,Bundesliga,19,2002,1.2,2,1,0,1,1,0,1,0.0,1,5,1,4,2,4,1,0,Matches
2655,Timmy Tillman,GER,MF,Greuther Fürth,Bundesliga,22,1999,22.3,43,26,17,18,8,19,42,45.2,23,33,4,29,12,55,26,0,Matches
2656,David Timor,ESP,MF,Getafe,La Liga,31,1989,3.8,1,1,1,0,0,0,3,0.0,3,3,2,1,1,2,4,1,Matches
2657,Mircea Ţîrlea,ROU,DF,Alavés,La Liga,21,2000,0.2,0,0,0,0,0,0,0,,0,0,0,0,0,0,1,0,Matches
2658,Jean-Clair Todibo,FRA,DF,Nice,Ligue 1,21,1999,34.6,59,37,43,15,1,39,60,65.0,21,45,21,24,51,110,130,2,Matches
2659,Umut Tohumcu,GER,MF,Hoffenheim,Bundesliga,16,2004,0.1,0,0,0,0,0,0,0,,0,0,0,0,0,0,0,0,Matches
2660,Karl Toko Ekambi,CMR,FW,Lyon,Ligue 1,28,1992,25.5,13,7,4,6,3,4,21,19.0,17,26,0,26,20,33,5,0,Matches
2661,Corentin Tolisso,FRA,MF,Bayern Munich,Bundesliga,26,1994,7.8,11,5,1,9,1,7,17,41.2,10,5,1,4,9,20,10,0,Matches
2662,Jeremy Toljan,GER,DF,Sassuolo,Serie A,26,1994,15.5,18,10,12,4,2,13,20,65.0,7,12,5,7,12,30,41,0,Matches
2663,Rafael Tolói,ITA,DF,Atalanta,Serie A,30,1990,16.0,38,15,12,15,11,24,39,61.5,15,23,11,12,26,64,35,0,Matches
2664,Raúl de Tomás,ESP,FW,Espanyol,La Liga,26,1994,32.4,15,11,6,7,2,6,17,35.3,11,12,3,9,6,21,42,1,Matches
2665,Tiago Tomás,POR,FW,Stuttgart,Bundesliga,19,2002,11.9,8,4,0,7,1,0,6,0.0,6,3,0,3,4,12,1,0,Matches
2666,Takehiro Tomiyasu,JPN,DF,Arsenal,Premier League,22,1998,18.7,35,17,19,13,3,21,32,65.6,11,22,3,19,24,59,64,2,Matches
2667,Takehiro Tomiyasu,JPN,DF,Bologna,Serie A,22,1998,0.1,0,0,0,0,0,0,0,,0,1,0,1,1,1,0,0,Matches
2668,James Tomkins,ENG,DF,Crystal Palace,Premier League,32,1989,6.1,8,3,6,2,0,6,8,75.0,2,8,8,0,4,12,18,0,Matches
2669,Fikayo Tomori,ENG,DF,Milan,Serie A,23,1997,30.2,73,44,36,34,3,18,26,69.2,8,37,23,14,45,118,84,1,Matches
2670,Sandro Tonali,ITA,MF,Milan,Serie A,21,2000,28.9,54,37,23,25,6,21,41,51.2,20,26,8,18,34,88,19,0,Matches
2671,Lorenzo Tonelli,ITA,DF,Empoli,Serie A,31,1990,9.7,17,9,11,4,2,6,13,46.2,7,14,8,6,19,36,28,2,Matches
2672,Ivan Toney,ENG,FW,Brentford,Premier League,25,1996,32.3,33,21,5,20,8,12,38,31.6,26,16,2,14,14,47,44,1,Matches
2673,Ernesto Torregrossa,VEN,FW,Sampdoria,Serie A,29,1992,1.3,2,1,1,0,1,1,2,50.0,1,0,0,0,0,2,1,0,Matches
2674,Lucas Torreira,URU,MF,Fiorentina,Serie A,25,1996,24.4,37,29,13,21,3,18,40,45.0,22,18,1,17,26,63,18,0,Matches
2675,Raúl Torrente,ESP,DF,Granada,La Liga,19,2001,14.2,31,21,18,11,2,16,29,55.2,13,14,9,5,12,43,69,0,Matches
2676,Ferrán Torres,ESP,FW,Manchester City,Premier League,21,2000,3.4,2,2,0,1,1,0,3,0.0,3,2,0,2,0,2,1,0,Matches
2677,Ferrán Torres,ESP,FW,Barcelona,La Liga,21,2000,15.7,10,5,3,4,3,3,7,42.9,4,12,3,9,6,16,7,0,Matches
2678,Óliver Torres,ESP,"MF,FW",Sevilla,La Liga,26,1994,11.2,22,12,8,7,7,8,25,32.0,17,10,1,9,6,28,4,0,Matches
2679,Pau Torres,ESP,DF,Villarreal,La Liga,24,1997,31.7,32,19,23,7,2,18,25,72.0,7,32,23,9,19,51,105,2,Matches
2680,Roberto Torres,ESP,"MF,FW",Osasuna,La Liga,32,1989,9.0,7,4,3,1,3,3,15,20.0,12,8,0,8,8,15,4,0,Matches
2681,Lucas Torró,ESP,MF,Osasuna,La Liga,27,1994,30.3,71,40,25,38,8,29,57,50.9,28,32,11,21,47,118,55,0,Matches
2682,Jordan Torunarigha,GER,DF,Hertha BSC,Bundesliga,23,1997,5.4,4,1,1,3,0,4,5,80.0,1,4,2,2,17,21,30,0,Matches
2683,Cenk Tosun,TUR,MF,Everton,Premier League,30,1991,0.1,0,0,0,0,0,0,0,,0,0,0,0,0,0,0,0,Matches
2684,Abdoulaye Touré,GUI,MF,Genoa,Serie A,27,1994,4.8,12,4,3,8,1,5,11,45.5,6,6,1,5,4,16,6,0,Matches
2685,Almamy Touré,MLI,"DF,MF",Eint Frankfurt,Bundesliga,25,1996,5.6,12,9,8,3,1,4,17,23.5,13,10,3,7,5,17,19,0,Matches
2686,Lucas Tousart,FRA,MF,Hertha BSC,Bundesliga,24,1997,21.8,42,25,15,22,5,10,34,29.4,24,30,6,24,35,77,55,0,Matches
2687,Yoann Touzghar,TUN,FW,Troyes,Ligue 1,34,1986,16.2,5,2,1,3,1,1,3,33.3,2,3,1,2,3,8,8,0,Matches
2688,Andros Townsend,ENG,"MF,FW",Everton,Premier League,30,1991,16.2,31,17,15,6,10,15,40,37.5,25,28,2,26,14,45,6,1,Matches
2689,Adama Traoré,ESP,"FW,MF",Wolves,Premier League,25,1996,11.9,8,3,6,0,2,3,7,42.9,4,4,1,3,2,10,1,0,Matches
2690,Adama Traoré,ESP,FW,Barcelona,La Liga,25,1996,4.2,4,2,0,3,1,3,5,60.0,2,2,0,2,4,8,3,1,Matches
2691,Amadou Traore,FRA,FW,Bordeaux,Ligue 1,19,2002,0.2,0,0,0,0,0,0,0,,0,0,0,0,0,0,0,0,Matches
2692,Bertrand Traoré,BFA,"MF,FW",Aston Villa,Premier League,25,1995,2.4,3,3,0,1,2,1,2,50.0,1,0,0,0,0,3,1,0,Matches
2693,Boubacar Traoré,MLI,MF,Metz,Ligue 1,19,2001,19.2,43,26,18,23,2,10,39,25.6,29,29,5,24,25,68,11,1,Matches
2694,Charles Traore,MLI,DF,Nantes,Ligue 1,29,1992,8.0,16,12,10,4,2,2,13,15.4,11,11,4,7,15,31,30,0,Matches
2695,Hamari Traoré,MLI,DF,Rennes,Ligue 1,29,1992,32.1,63,36,25,26,12,41,59,69.5,18,29,8,21,37,100,81,1,Matches
2696,Ismaël Traoré,CIV,DF,Angers,Ligue 1,34,1986,35.7,28,17,16,11,1,13,28,46.4,15,25,17,8,44,72,122,1,Matches
2697,Kevin Trapp,GER,GK,Eint Frankfurt,Bundesliga,31,1990,32.0,0,0,0,0,0,0,1,0.0,1,0,0,0,1,1,13,2,Matches
2698,Miguel Trauco,PER,"DF,MF",Saint-Étienne,Ligue 1,28,1992,12.4,25,18,16,8,1,12,22,54.5,10,13,4,9,23,48,17,0,Matches
2699,Óscar Trejo,ARG,MF,Rayo Vallecano,La Liga,33,1988,22.3,42,24,14,18,10,15,50,30.0,35,26,1,25,13,55,11,0,Matches
2700,Trézéguet,EGY,FW,Aston Villa,Premier League,26,1994,0.1,0,0,0,0,0,0,0,,0,0,0,0,0,0,0,0,Matches
2701,Manu Trigueros,ESP,"MF,FW",Villarreal,La Liga,29,1991,24.2,45,25,16,18,11,23,66,34.8,43,19,3,16,13,58,17,0,Matches
2702,Simone Trimboli,ITA,MF,Sampdoria,Serie A,19,2002,0.7,2,1,2,0,0,2,2,100.0,0,0,0,0,2,4,0,0,Matches
2703,Christopher Trimmel,AUT,"DF,FW",Union Berlin,Bundesliga,34,1987,22.1,49,30,25,19,5,26,45,57.8,19,20,3,17,34,83,75,0,Matches
2704,Francisco Trincão,POR,"FW,MF",Wolves,Premier League,21,1999,14.8,28,15,9,13,6,3,19,15.8,16,17,1,16,12,40,1,1,Matches
2705,Kieran Trippier,ENG,DF,Newcastle Utd,Premier League,30,1990,4.8,17,10,8,8,1,10,16,62.5,6,10,3,7,10,27,10,0,Matches
2706,Kieran Trippier,ENG,"DF,FW",Atlético Madrid,La Liga,30,1990,10.8,22,12,12,5,5,12,21,57.1,9,12,1,11,10,32,11,0,Matches
2707,William Troost-Ekong,NGA,DF,Watford,Premier League,27,1993,15.4,18,9,11,6,1,10,15,66.7,5,24,14,10,7,25,82,1,Matches
2708,Leandro Trossard,BEL,"FW,MF",Brighton,Premier League,26,1994,31.2,34,20,12,9,13,4,31,12.9,27,33,4,29,15,49,10,0,Matches
2709,Adrien Truffert,FRA,DF,Rennes,Ligue 1,19,2001,18.2,29,21,17,9,3,11,24,45.8,13,25,5,20,19,48,30,0,Matches
2710,Philipp Tschauner,GER,GK,RB Leipzig,Bundesliga,35,1985,0.0,0,0,0,0,0,0,0,,0,0,0,0,0,0,0,0,Matches
2711,Kostas Tsimikas,GRE,DF,Liverpool,Premier League,25,1996,9.7,27,12,12,8,7,12,16,75.0,4,6,2,4,10,37,22,2,Matches
2712,Axel Tuanzebe,COD,DF,Aston Villa,Premier League,23,1997,5.6,5,3,3,2,0,2,5,40.0,3,5,4,1,5,10,12,1,Matches
2713,Axel Tuanzebe,COD,DF,Napoli,Serie A,23,1997,0.1,0,0,0,0,0,0,0,,0,1,1,0,0,0,0,0,Matches
2714,Ozan Tufan,TUR,MF,Watford,Premier League,26,1995,3.7,3,2,1,1,1,1,5,20.0,4,2,0,2,2,5,4,0,Matches
2715,Beñat Turrientes,ESP,MF,Real Sociedad,La Liga,19,2002,2.3,0,0,0,0,0,0,4,0.0,4,1,0,1,2,2,2,0,Matches
2716,Tuta,BRA,DF,Eint Frankfurt,Bundesliga,22,1999,24.3,46,28,20,22,4,26,47,55.3,21,43,15,28,41,87,76,1,Matches
2717,Christos Tzolis,GRE,"FW,MF",Norwich City,Premier League,19,2002,3.7,5,3,3,1,1,2,9,22.2,7,3,0,3,1,6,1,0,Matches
2718,Destiny Udogie,ITA,DF,Udinese,Serie A,18,2002,27.5,64,40,30,27,7,33,60,55.0,27,39,6,33,27,91,42,0,Matches
2719,Matthieu Udol,FRA,DF,Metz,Ligue 1,25,1996,11.2,23,14,11,10,2,12,18,66.7,6,20,7,13,31,54,29,1,Matches
2720,Ike Ugbo,CAN,FW,Troyes,Ligue 1,22,1998,9.0,3,1,0,1,2,0,1,0.0,1,4,1,3,2,5,1,0,Matches
2721,Lesley Ugochukwu,FRA,MF,Rennes,Ligue 1,17,2004,4.5,13,9,5,5,3,9,19,47.4,10,7,2,5,4,17,2,0,Matches
2722,Hwang Ui-jo,KOR,FW,Bordeaux,Ligue 1,28,1992,27.9,10,4,4,4,2,4,13,30.8,9,9,1,8,5,15,18,0,Matches
2723,Anthony Ujah,NGA,"FW,MF",Union Berlin,Bundesliga,30,1990,0.4,0,0,0,0,0,0,0,,0,0,0,0,0,0,0,0,Matches
2724,Maximilian Ullmann,AUT,DF,Venezia,Serie A,25,1996,2.7,0,0,0,0,0,0,1,0.0,1,4,0,4,2,2,7,0,Matches
2725,Sven Ulreich,GER,GK,Bayern Munich,Bundesliga,32,1988,6.0,0,0,0,0,0,0,0,,0,0,0,0,0,0,1,0,Matches
2726,Samuel Umtiti,FRA,DF,Barcelona,La Liga,27,1993,1.0,2,2,2,0,0,1,2,50.0,1,1,1,0,0,2,4,0,Matches
2727,Enes Ünal,TUR,FW,Getafe,La Liga,24,1997,31.1,37,22,2,18,17,5,42,11.9,37,25,5,20,5,42,36,0,Matches
2728,Cengiz Ünder,TUR,"FW,MF",Marseille,Ligue 1,24,1997,24.4,18,13,5,6,7,5,18,27.8,13,13,2,11,14,32,9,0,Matches
2729,Dayot Upamecano,FRA,DF,Bayern Munich,Bundesliga,22,1998,24.6,66,42,42,21,3,24,36,66.7,12,20,10,10,32,98,71,6,Matches
2730,Benjamin Uphoff,GER,GK,Freiburg,Bundesliga,27,1993,2.0,0,0,0,0,0,0,0,,0,0,0,0,0,0,2,2,Matches
2731,Kacper Urbanski,POL,MF,Bologna,Serie A,16,2004,0.5,3,2,1,2,0,2,2,100.0,0,2,0,2,0,3,0,0,Matches
2732,Jere Uronen,FIN,DF,Brest,Ligue 1,27,1994,9.8,28,15,15,10,3,14,24,58.3,10,12,3,9,16,44,21,0,Matches
2733,Mark Uth,GER,"MF,FW",Köln,Bundesliga,29,1991,22.5,32,20,9,14,9,15,49,30.6,34,27,1,26,14,46,13,0,Matches
2734,Myrto Uzuni,ALB,"FW,MF",Granada,La Liga,26,1995,9.5,7,4,6,1,0,0,2,0.0,2,13,1,12,10,17,7,0,Matches
2735,Antonio Vacca,ITA,MF,Venezia,Serie A,31,1990,11.8,36,20,24,10,2,14,36,38.9,22,16,8,8,20,56,16,0,Matches
2736,Álvaro Vadillo,ESP,"DF,MF",Espanyol,La Liga,26,1994,0.1,1,1,1,0,0,1,2,50.0,1,0,0,0,0,1,1,0,Matches
2737,Óscar Valentín,ESP,MF,Rayo Vallecano,La Liga,26,1994,28.5,102,53,46,51,5,44,105,41.9,61,56,10,46,39,141,43,0,Matches
2738,Germán Valera,ESP,FW,Real Sociedad,La Liga,19,2002,0.6,3,2,3,0,0,1,1,100.0,0,0,0,0,0,3,1,0,Matches
2739,Yan Valery,TUN,DF,Southampton,Premier League,22,1999,4.1,8,6,4,3,1,4,9,44.4,5,6,3,3,6,14,19,1,Matches
2740,Martin Valjent,SVK,DF,Mallorca,La Liga,25,1995,35.3,31,19,18,12,1,13,24,54.2,11,34,26,8,31,62,173,1,Matches
2741,Jesús Vallejo,ESP,DF,Real Madrid,La Liga,24,1997,3.8,7,5,7,0,0,5,6,83.3,1,9,8,1,6,13,16,0,Matches
2742,Manu Vallejo,ESP,"MF,FW",Alavés,La Liga,24,1997,4.1,8,2,1,4,3,4,13,30.8,9,7,0,7,0,8,4,0,Matches
2743,Manu Vallejo,ESP,"FW,MF",Valencia,La Liga,24,1997,1.1,2,1,1,1,0,0,1,0.0,1,0,0,0,0,2,1,0,Matches
2744,Federico Valverde,URU,MF,Real Madrid,La Liga,23,1998,20.4,36,16,11,16,9,12,31,38.7,19,23,5,18,24,60,12,0,Matches
2745,Virgil van Dijk,NED,DF,Liverpool,Premier League,30,1991,34.0,16,10,11,5,0,11,16,68.8,5,21,14,7,31,47,109,0,Matches
2746,Vanderson,BRA,"FW,DF",Monaco,Ligue 1,20,2001,12.4,35,19,10,19,6,15,23,65.2,8,17,4,13,13,48,12,0,Matches
2747,Zinho Vanheusden,BEL,DF,Genoa,Serie A,22,1999,11.0,18,6,12,5,1,8,14,57.1,6,19,14,5,23,41,42,0,Matches
2748,Jonathan Varane,FRA,MF,Lens,Ligue 1,19,2001,0.0,0,0,0,0,0,0,0,,0,0,0,0,0,0,0,0,Matches
2749,Raphaël Varane,FRA,DF,Manchester Utd,Premier League,28,1993,20.3,28,19,21,6,1,10,22,45.5,12,18,9,9,18,46,82,1,Matches
2750,Jamie Vardy,ENG,FW,Leicester City,Premier League,34,1987,20.1,6,5,0,4,2,1,7,14.3,6,9,0,9,1,7,17,0,Matches
2751,Ruben Vargas,SUI,"MF,FW",Augsburg,Bundesliga,22,1998,22.0,28,21,7,14,7,11,30,36.7,19,9,1,8,16,44,13,0,Matches
2752,Sebastian Vasiliadis,GRE,MF,Arminia,Bundesliga,23,1997,13.3,31,17,12,15,4,15,42,35.7,27,15,2,13,25,56,31,1,Matches
2753,Johan Vásquez,MEX,DF,Genoa,Serie A,22,1998,25.3,79,46,44,32,3,48,75,64.0,27,32,10,22,42,121,85,0,Matches
2754,Denis Vavro,SVK,DF,Lazio,Serie A,25,1996,0.1,0,0,0,0,0,0,0,,0,0,0,0,0,0,0,0,Matches
2755,José Luis García Vayá,ESP,MF,Levante,La Liga,22,1998,22.4,46,27,10,31,5,16,41,39.0,25,24,5,19,38,84,30,0,Matches
2756,Jesus Vazquez,ESP,DF,Valencia,La Liga,18,2003,9.0,24,13,10,8,6,10,22,45.5,12,16,3,13,9,33,19,0,Matches
2757,Kevin Vázquez,ESP,DF,Celta Vigo,La Liga,28,1993,14.8,34,24,12,13,9,14,28,50.0,14,20,7,13,36,70,34,0,Matches
2758,Lucas Vázquez,ESP,DF,Real Madrid,La Liga,30,1991,20.4,43,22,24,9,10,17,35,48.6,18,25,7,18,20,63,41,1,Matches
2759,Matías Vecino,URU,MF,Inter,Serie A,29,1991,4.2,7,5,2,3,2,3,9,33.3,6,10,1,9,4,11,7,0,Matches
2760,Gabriel Veiga,ESP,MF,Celta Vigo,La Liga,19,2002,1.2,5,4,0,4,1,3,12,25.0,9,2,0,2,4,9,1,0,Matches
2761,Miguel Veloso,POR,MF,Hellas Verona,Serie A,35,1986,14.9,23,15,4,17,2,10,16,62.5,6,18,5,13,11,34,18,1,Matches
2762,Joël Veltman,NED,DF,Brighton,Premier League,29,1992,31.9,74,48,47,21,6,21,53,39.6,32,46,16,30,45,119,89,0,Matches
2763,Micky van de Ven,NED,DF,Wolfsburg,Bundesliga,20,2001,2.1,4,4,3,1,0,0,1,0.0,1,4,1,3,2,6,8,0,Matches
2764,Unai Vencedor Paris,ESP,MF,Athletic Club,La Liga,20,2000,26.5,26,11,11,9,6,8,42,19.0,34,31,13,18,19,45,22,0,Matches
2765,Lorenzo Venuti,ITA,DF,Fiorentina,Serie A,26,1995,17.5,25,10,13,10,2,14,24,58.3,10,13,4,9,5,30,27,0,Matches
2766,Daniele Verde,ITA,"FW,MF",Spezia,Serie A,25,1996,21.7,11,4,8,2,1,9,20,45.0,11,17,2,15,18,29,8,0,Matches
2767,Simone Verdi,ITA,"MF,FW",Torino,Serie A,29,1992,0.5,1,1,0,1,0,0,0,,0,0,0,0,0,1,0,0,Matches
2768,Simone Verdi,ITA,"FW,MF",Salernitana,Serie A,29,1992,9.2,12,8,5,2,5,9,20,45.0,11,4,0,4,3,15,1,0,Matches
2769,Gonzalo Verdú,ESP,DF,Elche,La Liga,32,1988,15.5,19,9,15,4,0,8,16,50.0,8,20,14,6,13,32,59,1,Matches
2770,Jordan Veretout,FRA,MF,Roma,Serie A,28,1993,25.8,34,25,20,12,2,15,39,38.5,24,12,1,11,27,61,22,1,Matches
2771,Edoardo Vergani,ITA,"FW,MF",Salernitana,Serie A,20,2001,1.1,2,2,2,0,0,0,0,,0,2,2,0,0,2,2,0,Matches
2772,Vincent Vermeij,NED,MF,Freiburg,Bundesliga,26,1994,0.0,0,0,0,0,0,0,0,,0,1,0,1,0,0,0,0,Matches
2773,Marco Verratti,ITA,MF,Paris S-G,Ligue 1,28,1992,21.5,60,40,16,30,14,32,64,50.0,32,36,10,26,18,78,14,2,Matches
2774,Valerio Verre,ITA,"MF,FW",Sampdoria,Serie A,27,1994,4.7,7,5,1,4,2,4,9,44.4,5,7,0,7,0,7,5,0,Matches
2775,Valerio Verre,ITA,MF,Empoli,Serie A,27,1994,3.4,4,2,3,1,0,2,7,28.6,5,2,0,2,1,5,0,0,Matches
2776,Freddie Veseli,ALB,DF,Salernitana,Serie A,28,1992,6.6,7,2,4,3,0,5,6,83.3,1,10,5,5,4,11,19,0,Matches
2777,Mikel Vesga,ESP,MF,Athletic Club,La Liga,28,1993,15.1,27,14,7,18,2,11,31,35.5,20,16,5,11,20,47,34,2,Matches
2778,Jannik Vestergaard,DEN,DF,Leicester City,Premier League,28,1992,6.3,15,10,12,3,0,8,15,53.3,7,10,8,2,7,22,36,0,Matches
2779,Rúben Vezo,POR,DF,Levante,La Liga,27,1994,26.9,41,29,28,12,1,26,41,63.4,15,41,25,16,36,77,105,1,Matches
2780,Guglielmo Vicario,ITA,GK,Empoli,Serie A,24,1996,38.0,1,1,1,0,0,1,1,100.0,0,1,0,1,1,2,21,1,Matches
2781,Aleix Vidal,ESP,"DF,MF",Espanyol,La Liga,31,1989,21.1,31,25,17,9,5,19,39,48.7,20,19,6,13,25,56,35,2,Matches
2782,Arturo Vidal,CHI,MF,Inter,Serie A,34,1987,8.2,26,10,16,9,1,9,26,34.6,17,13,5,8,7,33,7,1,Matches
2783,Nacho Vidal,ESP,DF,Osasuna,La Liga,26,1995,32.2,83,47,49,25,9,39,77,50.6,38,32,14,18,58,141,79,0,Matches
2784,Gabriel Vidovic,CRO,"FW,MF",Bayern Munich,Bundesliga,17,2003,0.4,0,0,0,0,0,0,0,,0,0,0,0,0,0,0,0,Matches
2785,Ronaldo Vieira,ENG,MF,Sampdoria,Serie A,23,1998,5.5,10,6,6,4,0,5,10,50.0,5,5,2,3,6,16,5,1,Matches
2786,Nick Viergever,NED,DF,Greuther Fürth,Bundesliga,31,1989,23.7,32,23,25,7,0,24,34,70.6,10,31,22,9,37,69,119,1,Matches
2787,Luca Vignali,ITA,"DF,MF",Spezia,Serie A,25,1996,0.9,1,1,0,1,0,0,3,0.0,3,0,0,0,1,2,1,0,Matches
2788,Emanuel Vignato,ITA,"MF,DF",Bologna,Serie A,20,2000,6.6,12,7,5,7,0,6,13,46.2,7,2,0,2,2,14,5,0,Matches
2789,Dídac Vilà,ESP,"DF,MF",Espanyol,La Liga,32,1989,2.3,7,5,2,5,0,4,9,44.4,5,2,1,1,3,10,8,0,Matches
2790,Tonny Vilhena,NED,"MF,FW",Espanyol,La Liga,26,1995,10.3,16,6,7,8,1,7,21,33.3,14,10,2,8,8,24,17,0,Matches
2791,Daniel Villahermosa,ESP,MF,Espanyol,La Liga,20,2001,0.3,0,0,0,0,0,0,0,,0,0,0,0,0,0,1,0,Matches
2792,Asier Villalibre,ESP,FW,Athletic Club,La Liga,23,1997,6.1,4,3,2,1,1,1,2,50.0,1,3,1,2,1,5,7,0,Matches
2793,Gonzalo Villar,ESP,MF,Getafe,La Liga,23,1998,3.3,5,3,4,1,0,2,5,40.0,3,4,1,3,1,6,1,0,Matches
2794,Matías Viña,URU,"DF,FW",Roma,Serie A,23,1997,17.4,46,30,27,14,5,29,59,49.2,30,26,3,23,25,71,33,0,Matches
2795,Nicolas Viola,ITA,MF,Bologna,Serie A,31,1989,1.1,2,2,1,1,0,1,2,50.0,1,1,1,0,0,2,1,0,Matches
2796,Mattia Viti,ITA,DF,Empoli,Serie A,19,2002,16.6,28,16,16,9,3,15,24,62.5,9,28,25,3,29,57,69,1,Matches
2797,Vitolo,ESP,MF,Getafe,La Liga,31,1989,2.5,3,2,1,1,1,2,5,40.0,3,3,0,3,1,4,1,0,Matches
2798,Daniel Vivian,ESP,DF,Athletic Club,La Liga,22,1999,22.1,32,21,24,7,1,17,24,70.8,7,20,15,5,26,58,107,1,Matches
2799,Dušan Vlahović,SRB,FW,Fiorentina,Serie A,21,2000,20.6,5,0,0,2,3,2,11,18.2,9,6,2,4,1,6,16,0,Matches
2800,Dušan Vlahović,SRB,FW,Juventus,Serie A,21,2000,12.0,0,0,0,0,0,0,4,0.0,4,3,0,3,0,0,7,0,Matches
2801,Nikola Vlašić,CRO,"FW,MF",West Ham,Premier League,23,1997,6.2,11,7,4,6,1,5,20,25.0,15,4,0,4,2,13,1,0,Matches
2802,Andreas Voglsammer,GER,"FW,MF",Union Berlin,Bundesliga,29,1992,9.8,14,9,8,3,3,6,14,42.9,8,9,2,7,2,16,7,0,Matches
2803,Kevin Vogt,GER,DF,Hoffenheim,Bundesliga,29,1991,28.5,21,12,15,6,0,11,21,52.4,10,18,7,11,13,34,101,1,Matches
2804,Mërgim Vojvoda,KVX,DF,Torino,Serie A,26,1995,22.0,38,23,23,11,4,20,36,55.6,16,27,8,19,20,58,51,0,Matches
2805,Kevin Volland,GER,"MF,FW",Monaco,Ligue 1,29,1992,27.1,24,10,2,18,4,6,31,19.4,25,20,0,20,3,27,9,0,Matches
2806,Cristian Volpato,ITA,"FW,MF",Roma,Serie A,17,2003,0.4,1,1,0,0,1,1,1,100.0,0,0,0,0,0,1,0,0,Matches
2807,Aster Vranckx,BEL,MF,Wolfsburg,Bundesliga,18,2002,12.7,34,13,14,16,4,14,26,53.8,12,19,7,12,13,47,16,0,Matches
2808,Stefan de Vrij,NED,DF,Inter,Serie A,29,1992,26.8,38,29,22,16,0,12,17,70.6,5,17,8,9,32,70,52,0,Matches
2809,Šime Vrsaljko,CRO,DF,Atlético Madrid,La Liga,29,1992,10.2,27,17,14,12,1,12,20,60.0,8,10,1,9,12,39,30,0,Matches
2810,Nikola Vukčević,MNE,MF,Levante,La Liga,29,1991,1.3,3,2,2,1,0,0,1,0.0,1,2,0,2,2,5,1,0,Matches
2811,Matěj Vydra,CZE,FW,Burnley,Premier League,29,1992,7.5,12,7,3,4,5,3,7,42.9,4,5,1,4,0,12,9,0,Matches
2812,Elye Wahi,FRA,FW,Montpellier,Ligue 1,18,2003,19.8,18,10,9,6,3,6,16,37.5,10,7,0,7,4,22,4,0,Matches
2813,Walace,BRA,MF,Udinese,Serie A,26,1995,33.0,83,49,37,38,8,50,113,44.2,63,51,5,46,54,137,32,1,Matches
2814,Theo Walcott,ENG,"MF,FW",Southampton,Premier League,32,1989,4.2,4,2,2,0,2,1,5,20.0,4,3,0,3,5,9,2,0,Matches
2815,Luca Waldschmidt,GER,"MF,FW",Wolfsburg,Bundesliga,25,1996,8.0,9,1,3,5,1,5,13,38.5,8,5,0,5,8,17,3,0,Matches
2816,Kyle Walker,ENG,DF,Manchester City,Premier League,31,1990,19.5,15,6,7,7,1,8,17,47.1,9,14,4,10,14,29,16,1,Matches
2817,Kyle Walker-Peters,ENG,DF,Southampton,Premier League,24,1997,29.3,57,33,28,21,8,26,38,68.4,12,29,8,21,37,94,53,1,Matches
2818,Sebastian Walukiewicz,POL,DF,Cagliari,Serie A,21,2000,3.4,9,5,7,2,0,3,5,60.0,2,5,2,3,7,16,14,0,Matches
2819,Aaron Wan-Bissaka,ENG,DF,Manchester Utd,Premier League,23,1997,19.9,49,36,25,18,6,14,20,70.0,6,24,14,10,34,83,41,2,Matches
2820,Paul Wanner,GER,"FW,MF",Bayern Munich,Bundesliga,15,2005,0.4,2,2,0,2,0,1,1,100.0,0,0,0,0,0,2,0,0,Matches
2821,Danny Ward,WAL,GK,Leicester City,Premier League,28,1993,1.0,0,0,0,0,0,0,0,,0,0,0,0,0,0,1,0,Matches
2822,Joel Ward,ENG,DF,Crystal Palace,Premier League,31,1989,27.6,44,26,30,11,3,30,57,52.6,27,24,11,13,32,76,107,1,Matches
2823,James Ward-Prowse,ENG,MF,Southampton,Premier League,26,1994,35.7,41,24,12,24,5,19,70,27.1,51,43,15,28,40,81,45,1,Matches
2824,Magnus Warming,DEN,"MF,FW",Torino,Serie A,21,2000,0.6,1,1,0,1,0,0,0,,0,2,0,2,0,1,0,0,Matches
2825,Daniel Wass,DEN,"DF,FW",Atlético Madrid,La Liga,32,1989,0.5,0,0,0,0,0,0,0,,0,0,0,0,0,0,3,0,Matches
2826,Daniel Wass,DEN,MF,Valencia,La Liga,32,1989,17.6,23,13,6,14,3,8,31,25.8,23,13,2,11,13,36,19,0,Matches
2827,Ollie Watkins,ENG,FW,Aston Villa,Premier League,25,1995,32.8,17,13,2,7,8,2,15,13.3,13,25,3,22,12,29,27,0,Matches
2828,Timothy Weah,USA,"MF,FW",Lille,Ligue 1,21,2000,18.0,19,7,8,8,3,10,20,50.0,10,16,1,15,10,29,7,0,Matches
2829,Adam Webster,ENG,DF,Brighton,Premier League,26,1995,15.9,26,8,17,7,2,13,20,65.0,7,25,17,8,17,43,66,2,Matches
2830,Wout Weghorst,NED,FW,Burnley,Premier League,28,1992,16.1,17,9,3,9,5,6,19,31.6,13,16,5,11,6,23,13,0,Matches
2831,Wout Weghorst,NED,FW,Wolfsburg,Bundesliga,28,1992,17.3,13,7,3,3,7,7,17,41.2,10,10,3,7,2,15,11,1,Matches
2832,Noah Weißhaupt,GER,"MF,FW",Freiburg,Bundesliga,19,2001,1.1,1,1,1,0,0,1,2,50.0,1,2,0,2,1,2,1,1,Matches
2833,Danny Welbeck,ENG,"FW,MF",Brighton,Premier League,30,1990,16.4,14,7,2,8,4,3,10,30.0,7,18,2,16,5,19,18,0,Matches
2834,Timo Werner,GER,"FW,MF",Chelsea,Premier League,25,1996,14.3,8,4,3,3,2,2,20,10.0,18,9,0,9,2,10,4,0,Matches
2835,Ashley Westwood,ENG,MF,Burnley,Premier League,31,1990,25.4,21,12,8,12,1,10,31,32.3,21,21,9,12,30,51,16,1,Matches
2836,Ben White,ENG,DF,Arsenal,Premier League,23,1997,32.0,44,23,30,8,6,28,45,62.2,17,42,24,18,42,86,102,0,Matches
2837,Silvan Widmer,SUI,DF,Mainz 05,Bundesliga,28,1993,32.4,60,28,32,20,8,36,61,59.0,25,44,16,28,43,103,59,2,Matches
2838,Georginio Wijnaldum,NED,MF,Paris S-G,Ligue 1,30,1990,18.4,15,9,2,12,1,11,19,57.9,8,13,3,10,9,24,7,0,Matches
2839,Jetro Willems,NED,DF,Greuther Fürth,Bundesliga,27,1994,17.8,30,15,18,10,2,15,26,57.7,11,15,3,12,14,44,42,0,Matches
2840,Brandon Williams,ENG,DF,Norwich City,Premier League,20,2000,23.6,55,37,35,18,2,36,64,56.3,28,26,6,20,44,99,50,0,Matches
2841,Iñaki Williams,GHA,FW,Athletic Club,La Liga,27,1994,30.9,14,5,1,6,7,5,17,29.4,12,18,3,15,3,17,20,0,Matches
2842,Neco Williams,WAL,DF,Liverpool,Premier League,20,2001,0.1,0,0,0,0,0,0,0,,0,0,0,0,0,0,0,0,Matches
2843,Nico Williams,ESP,MF,Athletic Club,La Liga,19,2002,14.9,20,10,6,11,3,10,31,32.3,21,18,2,16,5,25,9,0,Matches
2844,Joe Willock,ENG,MF,Newcastle Utd,Premier League,21,1999,22.6,64,37,30,28,6,29,68,42.6,39,37,6,31,21,85,10,1,Matches
2845,Callum Wilson,ENG,FW,Newcastle Utd,Premier League,29,1992,15.4,9,8,1,5,3,1,4,25.0,3,7,2,5,3,12,10,0,Matches
2846,Patrick Wimmer,AUT,"FW,MF",Arminia,Bundesliga,20,2001,22.8,53,31,13,31,9,22,61,36.1,39,30,1,29,27,80,13,0,Matches
2847,Jonas Wind,DEN,"FW,MF",Wolfsburg,Bundesliga,22,1999,13.1,10,6,1,7,2,1,4,25.0,3,8,3,5,6,16,13,0,Matches
2848,Marten Winkler,GER,MF,Hertha BSC,Bundesliga,18,2002,0.3,0,0,0,0,0,0,0,,0,0,0,0,0,0,0,0,Matches
2849,Harry Winks,ENG,MF,Tottenham,Premier League,25,1996,10.1,15,10,4,9,2,8,21,38.1,13,14,3,11,16,31,10,2,Matches
2850,Frederik Winther,DEN,DF,Augsburg,Bundesliga,20,2001,3.6,7,2,7,0,0,5,6,83.3,1,4,1,3,8,15,21,0,Matches
2851,Florian Wirtz,GER,"MF,FW",Leverkusen,Bundesliga,18,2003,20.6,25,10,6,16,3,10,28,35.7,18,12,1,11,13,38,4,0,Matches
2852,Yoane Wissa,COD,FW,Brentford,Premier League,24,1996,14.3,12,6,5,4,3,1,16,6.3,15,12,5,7,8,20,6,0,Matches
2853,Axel Witsel,BEL,"MF,DF",Dortmund,Bundesliga,32,1989,21.6,42,27,12,23,7,18,30,60.0,12,24,9,15,27,69,38,0,Matches
2854,Hannes Wolf,AUT,"FW,MF",Gladbach,Bundesliga,22,1999,3.4,23,12,4,13,6,10,20,50.0,10,10,0,10,2,25,1,0,Matches
2855,Marius Wolf,GER,"DF,FW",Dortmund,Bundesliga,26,1995,14.7,26,10,13,9,4,12,24,50.0,12,14,1,13,13,39,8,0,Matches
2856,Luca Wollschläger,GER,"FW,MF",Hertha BSC,Bundesliga,18,2003,0.2,1,1,0,1,0,0,1,0.0,1,0,0,0,0,1,0,0,Matches
2857,Jeong Woo-yeong,KOR,"FW,MF",Freiburg,Bundesliga,21,1999,19.8,15,9,6,7,2,5,15,33.3,10,8,1,7,7,22,11,0,Matches
2858,Chris Wood,NZL,FW,Burnley,Premier League,29,1991,15.2,7,5,0,3,4,3,10,30.0,7,13,4,9,0,7,3,0,Matches
2859,Chris Wood,NZL,FW,Newcastle Utd,Premier League,29,1991,14.7,2,0,1,1,0,1,2,50.0,1,5,2,3,2,4,9,0,Matches
2860,Freddie Woodman,ENG,GK,Newcastle Utd,Premier League,24,1997,4.0,0,0,0,0,0,0,0,,0,0,0,0,0,0,0,1,Matches
2861,Christopher Wooh,CMR,DF,Lens,Ligue 1,19,2001,11.7,29,11,20,8,1,11,18,61.1,7,21,14,7,21,50,40,1,Matches
2862,Joscha Wosz,GER,DF,RB Leipzig,Bundesliga,19,2002,0.1,0,0,0,0,0,0,0,,0,0,0,0,0,0,0,0,Matches
2863,Xeka,POR,MF,Lille,Ligue 1,26,1994,18.0,47,27,18,24,5,27,56,48.2,29,23,3,20,24,71,26,1,Matches
2864,Granit Xhaka,SUI,"MF,DF",Arsenal,Premier League,28,1992,25.9,32,18,16,12,4,16,41,39.0,25,21,6,15,21,53,31,0,Matches
2865,Sekou Yansané,GUI,FW,Paris S-G,Ligue 1,18,2003,0.2,0,0,0,0,0,0,1,0.0,1,0,0,0,0,0,1,0,Matches
2866,Andriy Yarmolenko,UKR,"FW,MF",West Ham,Premier League,31,1989,3.5,4,2,2,2,0,2,8,25.0,6,4,2,2,0,4,2,0,Matches
2867,Yusuf Yazıcı,TUR,"MF,FW",Lille,Ligue 1,24,1997,5.7,10,5,3,6,1,1,9,11.1,8,4,0,4,2,12,1,0,Matches
2868,Kelvin Yeboah,ITA,"FW,MF",Genoa,Serie A,21,2000,9.4,14,7,5,7,2,9,19,47.4,10,22,1,21,1,15,7,0,Matches
2869,Gerard Yepes,ESP,"MF,DF",Sampdoria,Serie A,18,2002,0.2,1,0,0,1,0,1,1,100.0,0,1,0,1,0,1,0,0,Matches
2870,Burak Yılmaz,TUR,FW,Lille,Ligue 1,36,1985,24.6,7,2,0,2,5,2,17,11.8,15,8,1,7,2,9,11,0,Matches
2871,Okay Yokuşlu,TUR,"DF,MF",Getafe,La Liga,27,1994,5.2,9,8,6,2,1,5,5,100.0,0,7,5,2,5,14,17,0,Matches
2872,Okay Yokuşlu,TUR,"DF,MF",Celta Vigo,La Liga,27,1994,1.6,4,1,2,1,1,2,3,66.7,1,2,1,1,2,6,6,0,Matches
2873,Leny Yoro,FRA,MF,Lille,Ligue 1,15,2005,0.1,1,0,0,1,0,0,0,,0,1,0,1,0,1,0,0,Matches
2874,Maya Yoshida,JPN,DF,Sampdoria,Serie A,32,1988,20.3,17,10,8,9,0,8,15,53.3,7,27,20,7,28,45,72,1,Matches
2875,Ashley Young,ENG,"DF,FW",Aston Villa,Premier League,36,1985,13.9,18,6,9,6,3,11,16,68.8,5,10,4,6,13,31,25,1,Matches
2876,Nathan Young-Coombes,ENG,MF,Brentford,Premier League,18,2003,0.0,0,0,0,0,0,0,0,,0,0,0,0,0,0,0,0,Matches
2877,Zaydou Youssouf,FRA,MF,Saint-Étienne,Ligue 1,22,1999,17.3,48,26,21,25,2,14,34,41.2,20,11,3,8,17,65,13,0,Matches
2878,Mattia Zaccagni,ITA,MF,Hellas Verona,Serie A,26,1995,2.0,3,1,1,0,2,1,2,50.0,1,1,0,1,4,7,0,0,Matches
2879,Mattia Zaccagni,ITA,FW,Lazio,Serie A,26,1995,20.8,33,16,10,13,10,11,19,57.9,8,17,2,15,20,53,5,0,Matches
2880,Dan-Axel Zagadou,FRA,DF,Dortmund,Bundesliga,22,1999,10.6,13,7,11,1,1,7,10,70.0,3,14,4,10,15,28,38,2,Matches
2881,Wilfried Zaha,CIV,FW,Crystal Palace,Premier League,28,1992,30.7,40,20,14,15,11,10,31,32.3,21,28,0,28,5,45,5,0,Matches
2882,Denis Zakaria,SUI,MF,Juventus,Serie A,24,1996,6.6,11,7,3,6,2,3,11,27.3,8,16,3,13,11,22,7,0,Matches
2883,Denis Zakaria,SUI,"MF,DF",Gladbach,Bundesliga,24,1996,15.5,23,14,9,10,4,12,35,34.3,23,25,5,20,19,42,22,1,Matches
2884,Joseba Zaldúa,ESP,DF,Real Sociedad,La Liga,29,1992,13.0,31,22,20,8,3,16,22,72.7,6,14,4,10,13,44,35,0,Matches
2885,Nicola Zalewski,POL,DF,Roma,Serie A,19,2002,8.8,32,19,17,11,4,21,35,60.0,14,18,1,17,16,48,4,0,Matches
2886,Andre-Frank Zambo Anguissa,CMR,MF,Napoli,Serie A,25,1995,21.4,50,26,24,17,9,25,51,49.0,26,31,5,26,24,74,33,1,Matches
2887,Nicolò Zaniolo,ITA,"FW,MF",Roma,Serie A,22,1999,21.9,24,15,0,15,9,6,28,21.4,22,19,0,19,7,31,6,0,Matches
2888,Alessandro Zanoli,ITA,DF,Napoli,Serie A,20,2000,5.1,10,7,6,3,1,3,5,60.0,2,2,1,1,4,14,16,0,Matches
2889,Mattia Zanotti,ITA,DF,Inter,Serie A,18,2003,0.1,1,0,1,0,0,0,1,0.0,1,0,0,0,0,1,0,0,Matches
2890,Duván Zapata,COL,FW,Atalanta,Serie A,30,1991,19.1,6,2,0,4,2,4,8,50.0,4,8,1,7,3,9,5,0,Matches
2891,Gabriele Zappa,ITA,DF,Cagliari,Serie A,21,1999,12.7,21,9,12,6,3,6,24,25.0,18,15,5,10,14,35,28,0,Matches
2892,Davide Zappacosta,ITA,DF,Atalanta,Serie A,29,1992,26.1,32,22,12,13,7,19,37,51.4,18,32,2,30,12,44,22,0,Matches
2893,Oier Zarraga,ESP,MF,Athletic Club,La Liga,22,1999,13.0,13,5,4,7,2,3,28,10.7,25,17,10,7,19,32,10,0,Matches
2894,Simone Zaza,ITA,"FW,DF",Torino,Serie A,30,1991,1.4,2,2,1,1,0,1,1,100.0,0,3,0,3,0,2,3,0,Matches
2895,Akim Zedadka,ALG,DF,Clermont Foot,Ligue 1,26,1995,37.1,72,44,34,29,9,37,71,52.1,34,32,8,24,58,130,48,0,Matches
2896,Deyovaisio Zeefuik,NED,DF,Hertha BSC,Bundesliga,23,1998,6.3,11,10,6,4,1,6,12,50.0,6,12,4,8,11,22,21,1,Matches
2897,Marvin Zeegelaar,NED,DF,Udinese,Serie A,30,1990,7.1,15,11,6,8,1,5,14,35.7,9,12,4,8,12,27,22,1,Matches
2898,Arber Zeneli,KVX,FW,Reims,Ligue 1,26,1995,4.5,1,0,0,0,1,1,5,20.0,4,0,0,0,1,2,1,0,Matches
2899,Robin Zentner,GER,GK,Mainz 05,Bundesliga,26,1994,32.0,2,2,2,0,0,2,2,100.0,0,0,0,0,2,4,21,1,Matches
2900,Andi Zeqiri,SUI,"FW,MF",Augsburg,Bundesliga,22,1999,11.3,14,7,3,5,6,3,12,25.0,9,10,1,9,2,16,12,0,Matches
2901,Mehdi Zerkane,ALG,"MF,DF",Bordeaux,Ligue 1,22,1999,0.9,0,0,0,0,0,0,1,0.0,1,1,1,0,2,2,0,0,Matches
2902,Edon Zhegrova,KVX,"MF,FW",Lille,Ligue 1,22,1999,5.3,14,5,2,8,4,5,6,83.3,1,4,1,3,2,16,2,0,Matches
2903,Luca Zidane,FRA,GK,Rayo Vallecano,La Liga,23,1998,7.2,0,0,0,0,0,0,1,0.0,1,0,0,0,0,0,1,1,Matches
2904,Piotr Zieliński,POL,MF,Napoli,Serie A,27,1994,23.2,19,12,5,9,5,6,21,28.6,15,13,2,11,8,27,4,0,Matches
2905,David Zima,CZE,DF,Torino,Serie A,20,2000,14.6,20,12,8,11,1,9,20,45.0,11,15,13,2,23,43,42,0,Matches
2906,Christoph Zimmermann,GER,DF,Norwich City,Premier League,28,1993,1.7,6,3,5,1,0,3,4,75.0,1,0,0,0,1,7,4,0,Matches
2907,Oleksandr Zinchenko,UKR,DF,Manchester City,Premier League,24,1996,11.6,20,14,7,10,3,11,20,55.0,9,11,3,8,14,34,15,1,Matches
2908,Hakim Ziyech,MAR,"MF,FW",Chelsea,Premier League,28,1993,14.7,19,10,5,12,2,10,36,27.8,26,11,1,10,10,29,10,0,Matches
2909,Jeroen Zoet,NED,GK,Spezia,Serie A,30,1991,7.0,1,0,1,0,0,1,1,100.0,0,0,0,0,0,1,4,0,Matches
2910,Simon Zoller,GER,FW,Bochum,Bundesliga,30,1991,6.6,4,2,2,1,1,1,3,33.3,2,3,0,3,4,8,2,0,Matches
2911,Nadir Zortea,ITA,"DF,MF",Salernitana,Serie A,22,1999,15.7,21,15,9,7,5,11,19,57.9,8,14,2,12,7,28,33,0,Matches
2912,Tanguy Zoukrou,FRA,DF,Troyes,Ligue 1,18,2003,0.9,1,0,1,0,0,1,2,50.0,1,0,0,0,0,1,2,0,Matches
2913,Kurt Zouma,FRA,DF,West Ham,Premier League,26,1994,23.1,11,6,8,3,0,4,7,57.1,3,31,26,5,34,45,132,0,Matches
2914,Petar Zovko,BIH,GK,Spezia,Serie A,19,2002,0.3,0,0,0,0,0,0,0,,0,0,0,0,0,0,1,0,Matches
2915,Igor Zubeldia,ESP,DF,Real Sociedad,La Liga,24,1997,18.3,20,10,12,8,0,12,18,66.7,6,16,6,10,27,47,53,0,Matches
2916,Martín Zubimendi,ESP,MF,Real Sociedad,La Liga,22,1999,28.8,52,25,19,30,3,22,44,50.0,22,30,13,17,49,101,48,1,Matches
2917,Szymon Żurkowski,POL,MF,Empoli,Serie A,23,1997,25.6,58,33,24,21,13,29,68,42.6,39,43,10,33,35,93,32,1,Matches
2918,Martin Ødegaard,NOR,"MF,FW",Arsenal,Premier League,22,1998,30.9,49,21,6,24,19,22,61,36.1,39,18,1,17,11,60,11,1,Matches
2919,Milan Đurić,BIH,FW,Salernitana,Serie A,31,1990,24.1,1,1,0,1,0,1,3,33.3,2,6,1,5,2,3,32,0,Matches
2920,Filip Đuričić,SRB,"MF,FW",Sassuolo,Serie A,29,1992,7.5,13,10,7,1,5,5,13,38.5,8,7,1,6,4,17,1,0,Matches
1,Brenden Aaronson,USA,"MF,FW",Leeds United,Premier League,21,2000,26.4,45,18,16,22,7,15,46,32.6,31,43,3,40,5,50,6,1,Matches
2,Paxten Aaronson,USA,"MF,DF",Eint Frankfurt,Bundesliga,18,2003,1.9,6,5,2,2,2,2,3,66.7,1,2,1,1,0,6,2,0,Matches
3,James Abankwah,IRL,DF,Udinese,Serie A,18,2004,0.7,1,1,0,1,0,0,0,,0,4,2,2,0,1,5,0,Matches
4,George Abbott,ENG,MF,Tottenham,Premier League,16,2005,0.0,0,0,0,0,0,0,0,,0,0,0,0,1,1,0,0,Matches
5,Yunis Abdelhamid,MAR,DF,Reims,Ligue 1,34,1987,37.0,82,50,47,33,2,39,52,75.0,13,65,27,38,64,146,116,1,Matches
6,Himad Abdelli,ALG,"MF,FW",Angers,Ligue 1,22,1999,23.7,64,38,22,32,10,31,67,46.3,36,30,1,29,28,92,15,0,Matches
7,Salis Abdul Samed,GHA,MF,Lens,Ligue 1,22,2000,32.2,46,26,18,23,5,29,52,55.8,23,38,9,29,36,82,26,0,Matches
8,Laurent Abergel,FRA,MF,Lorient,Ligue 1,29,1993,26.0,92,52,59,30,3,39,92,42.4,53,47,8,39,34,126,39,0,Matches
9,Oliver Abildgaard,DEN,MF,Hellas Verona,Serie A,26,1996,6.6,10,6,6,3,1,7,16,43.8,9,7,1,6,5,15,17,0,Matches
10,Matthis Abline,FRA,"FW,MF",Auxerre,Ligue 1,19,2003,9.0,4,2,0,3,1,0,5,0.0,5,6,1,5,1,5,1,0,Matches
11,Matthis Abline,FRA,"FW,MF",Rennes,Ligue 1,19,2003,1.2,1,1,0,0,1,1,1,100.0,0,1,0,1,2,3,1,0,Matches
12,Abner,BRA,DF,Betis,La Liga,22,2000,6.7,12,9,9,2,1,7,16,43.8,9,8,2,6,8,20,24,0,Matches
13,Zakaria Aboukhlal,MAR,"FW,MF",Toulouse,Ligue 1,22,2000,27.5,33,23,13,9,11,14,45,31.1,31,18,1,17,22,55,23,0,Matches
14,Tammy Abraham,ENG,FW,Roma,Serie A,24,1997,24.3,17,10,4,8,5,3,16,18.8,13,10,4,6,3,20,14,0,Matches
15,Christian Acella,ITA,MF,Cremonese,Serie A,20,2002,0.2,1,0,1,0,0,0,2,0.0,2,0,0,0,0,1,0,0,Matches
16,Francesco Acerbi,ITA,DF,Inter,Serie A,34,1988,26.9,33,19,22,7,4,20,27,74.1,7,25,18,7,41,74,85,2,Matches
17,Álvaro Aceves,ESP,GK,Valladolid,La Liga,19,2003,0.1,0,0,0,0,0,0,0,,0,0,0,0,0,0,0,0,Matches
18,Mohamed Achi,FRA,FW,Nantes,Ligue 1,20,2002,0.4,1,1,1,0,0,1,1,100.0,0,0,0,0,0,1,0,0,Matches
19,Marcos Acuña,ARG,DF,Sevilla,La Liga,30,1991,21.2,57,36,34,17,6,30,42,71.4,12,16,5,11,23,80,36,0,Matches
20,Che Adams,SCO,FW,Southampton,Premier League,26,1996,22.1,17,13,7,8,2,7,12,58.3,5,13,4,9,4,21,22,0,Matches
21,Tyler Adams,USA,MF,Leeds United,Premier League,23,1999,24.0,89,46,44,35,10,50,77,64.9,27,48,8,40,35,124,29,0,Matches
22,Sargis Adamyan,ARM,"FW,MF",Köln,Bundesliga,29,1993,7.2,14,7,5,3,6,7,17,41.2,10,12,0,12,4,18,5,0,Matches
23,Tosin Adarabioyo,ENG,DF,Fulham,Premier League,24,1997,23.2,30,13,22,6,2,16,23,69.6,7,20,15,5,26,56,140,1,Matches
24,Martin Adeline,FRA,"MF,FW",Reims,Ligue 1,18,2003,1.2,3,3,2,1,0,3,4,75.0,1,3,1,2,3,6,3,0,Matches
25,Karim Adeyemi,GER,"FW,MF",Dortmund,Bundesliga,20,2002,15.4,16,11,6,6,4,8,30,26.7,22,18,1,17,7,23,3,0,Matches
26,Amine Adli,MAR,"FW,MF",Leverkusen,Bundesliga,22,2000,15.9,18,10,4,6,8,5,17,29.4,12,28,2,26,6,24,7,0,Matches
27,Yacine Adli,FRA,"MF,FW",Milan,Serie A,22,2000,1.6,6,3,2,4,0,2,2,100.0,0,2,0,2,1,7,1,0,Matches
28,Michel Aebischer,SUI,"FW,MF",Bologna,Serie A,25,1997,17.1,12,6,3,6,3,2,18,11.1,16,14,2,12,7,19,9,0,Matches
29,Felix Afena-Gyan,GHA,"FW,MF",Cremonese,Serie A,19,2003,9.1,7,3,4,1,2,2,10,20.0,8,5,1,4,1,8,6,0,Matches
30,Emmanuel Agbadou,CIV,DF,Reims,Ligue 1,25,1997,26.5,71,49,53,16,2,42,65,64.6,23,30,14,16,32,103,107,3,Matches
31,Julen Agirrezabala,ESP,GK,Athletic Club,La Liga,21,2000,7.5,0,0,0,0,0,0,0,,0,0,0,0,0,0,2,0,Matches
32,Lucien Agoume,FRA,MF,Troyes,Ligue 1,20,2002,12.2,42,25,18,15,9,17,33,51.5,16,14,5,9,27,69,24,0,Matches
33,Felix Agu,GER,"DF,FW",Werder Bremen,Bundesliga,22,1999,0.5,1,0,0,1,0,0,0,,0,1,1,0,0,1,0,0,Matches
34,Álvaro Aguado,ESP,MF,Valladolid,La Liga,26,1996,21.0,27,15,13,11,3,15,25,60.0,10,16,4,12,13,40,15,0,Matches
35,Kevin Agudelo,COL,"MF,FW",Spezia,Serie A,23,1998,23.7,71,38,22,30,19,25,59,42.4,34,39,5,34,10,81,6,0,Matches
36,Nayef Aguerd,MAR,DF,West Ham,Premier League,26,1996,17.7,27,18,18,8,1,13,20,65.0,7,26,24,2,18,45,79,2,Matches
37,Ruben Aguilar,FRA,DF,Monaco,Ligue 1,29,1993,13.0,19,9,7,7,5,8,22,36.4,14,13,1,12,18,37,28,1,Matches
38,Naouirou Ahamada,FRA,"MF,FW",Crystal Palace,Premier League,20,2002,1.0,3,2,3,0,0,1,3,33.3,2,2,0,2,0,3,0,0,Matches
39,Naouirou Ahamada,FRA,MF,Stuttgart,Bundesliga,20,2002,15.5,17,11,7,7,3,8,20,40.0,12,16,5,11,8,25,7,0,Matches
40,Amar Ahmed,SWE,FW,Troyes,Ligue 1,18,2004,0.2,1,1,0,1,0,0,1,0.0,1,0,0,0,1,2,0,0,Matches
41,Jean-Eudes Aholou,CIV,MF,Strasbourg,Ligue 1,28,1994,14.4,34,20,10,20,4,12,31,38.7,19,25,0,25,24,58,15,0,Matches
42,Joseph Aidoo,GHA,DF,Celta Vigo,La Liga,26,1995,34.7,51,36,33,17,1,16,28,57.1,12,26,14,12,31,82,150,0,Matches
43,Ola Aina,NGA,DF,Torino,Serie A,25,1996,9.7,17,13,5,8,4,9,15,60.0,6,12,2,10,11,28,26,0,Matches
44,Rayan Aït-Nouri,ALG,DF,Wolves,Premier League,21,2001,12.0,33,20,25,7,1,9,16,56.3,7,3,0,3,9,42,28,0,Matches
45,Emanuel Aiwum,AUT,DF,Cremonese,Serie A,21,2000,18.4,55,34,36,17,2,33,47,70.2,14,28,16,12,25,80,52,3,Matches
46,Kristoffer Ajer,NOR,DF,Brentford,Premier League,24,1998,8.5,11,8,5,4,2,9,16,56.3,7,6,5,1,7,18,22,0,Matches
47,Ludovic Ajorque,FRA,FW,Strasbourg,Ligue 1,28,1994,8.6,5,4,1,4,0,3,9,33.3,6,3,1,2,2,7,7,0,Matches
48,Ludovic Ajorque,FRA,"FW,MF",Mainz 05,Bundesliga,28,1994,13.5,6,5,1,4,1,1,9,11.1,8,8,2,6,1,7,8,0,Matches
49,Manuel Akanji,SUI,DF,Manchester City,Premier League,27,1995,25.4,36,25,15,18,3,23,36,63.9,13,27,9,18,16,52,33,1,Matches
50,Nathan Aké,NED,DF,Manchester City,Premier League,27,1995,20.8,26,12,15,9,2,11,15,73.3,4,20,10,10,20,46,48,0,Matches
51,Sergio Akieme,ESP,DF,Almería,La Liga,24,1997,25.5,27,16,19,6,2,12,22,54.5,10,22,6,16,14,41,41,0,Matches
52,Babatunde Akinsola,NGA,FW,Valladolid,La Liga,19,2003,0.1,1,1,0,0,1,0,0,,0,0,0,0,0,1,0,0,Matches
53,Maghnes Akliouche,FRA,"MF,FW",Monaco,Ligue 1,20,2002,4.5,7,4,4,3,0,2,8,25.0,6,2,0,2,3,10,2,0,Matches
54,Paul Akouokou,CIV,"MF,DF",Betis,La Liga,24,1997,5.0,16,9,13,3,0,13,20,65.0,7,2,2,0,12,28,17,1,Matches
55,Jean-Daniel Akpa-Akpro,CIV,"MF,FW",Empoli,Serie A,29,1992,15.1,53,37,25,19,9,23,42,54.8,19,35,4,31,13,66,27,0,Matches
56,Kevin Akpoguma,NGA,DF,Hoffenheim,Bundesliga,27,1995,21.7,75,44,45,27,3,32,45,71.1,13,45,16,29,24,99,70,1,Matches
57,David Alaba,AUT,DF,Real Madrid,La Liga,30,1992,20.4,15,11,8,4,3,9,15,60.0,6,18,9,9,14,29,37,1,Matches
58,Ángel Alarcón,ESP,FW,Barcelona,La Liga,18,2004,0.3,,0,,,,,,,,,,,0,,,,Matches
59,Tomás Alarcón,CHI,MF,Cádiz,La Liga,23,1999,2.5,3,2,0,2,1,1,2,50.0,1,1,0,1,2,5,2,0,Matches
60,Lucas Alario,ARG,"FW,MF",Eint Frankfurt,Bundesliga,29,1992,3.7,3,2,1,0,2,0,1,0.0,1,0,0,0,2,5,13,0,Matches
61,Jordi Alba,ESP,DF,Barcelona,La Liga,33,1989,15.8,25,18,13,11,1,12,28,42.9,16,12,5,7,11,36,23,0,Matches
62,Luis Alberto,ESP,MF,Lazio,Serie A,29,1992,27.1,49,29,18,20,11,23,72,31.9,49,35,6,29,9,58,4,0,Matches
63,Raúl Albiol,ESP,DF,Villarreal,La Liga,36,1985,23.5,25,17,17,6,2,14,18,77.8,4,17,13,4,14,39,111,0,Matches
64,Marc Albrighton,ENG,"FW,MF",Leicester City,Premier League,32,1989,2.6,4,1,0,2,2,1,8,12.5,7,6,2,4,1,5,5,0,Matches
65,Thiago Alcántara,ESP,MF,Liverpool,Premier League,31,1991,13.9,43,24,20,21,2,14,23,60.9,9,15,3,12,21,64,13,2,Matches
66,Carlos Alcaraz,ARG,"MF,FW",Southampton,Premier League,19,2002,11.4,10,5,2,7,1,6,22,27.3,16,14,5,9,1,11,11,0,Matches
67,Rubén Alcaraz,ESP,MF,Cádiz,La Liga,31,1991,22.7,43,31,24,18,1,19,54,35.2,35,23,8,15,19,62,37,0,Matches
68,Omar Alderete,PAR,DF,Getafe,La Liga,25,1996,22.7,35,20,21,14,0,28,40,70.0,12,23,16,7,26,61,85,0,Matches
69,Iván Alejo,ESP,"MF,FW",Cádiz,La Liga,27,1995,14.6,32,21,19,9,4,17,37,45.9,20,18,3,15,5,37,12,1,Matches
70,Doğan Alemdar,TUR,GK,Rennes,Ligue 1,19,2002,4.5,0,0,0,0,0,0,0,,0,0,0,0,0,0,1,1,Matches
71,Carles Aleñá,ESP,"MF,FW",Getafe,La Liga,24,1998,23.5,18,10,7,5,6,5,34,14.7,29,19,1,18,4,22,18,0,Matches
72,Trent Alexander-Arnold,ENG,DF,Liverpool,Premier League,23,1998,32.5,57,40,32,16,9,42,80,52.5,38,25,7,18,43,100,41,2,Matches
73,Alejandro Alfaro,ESP,MF,Elche,La Liga,20,2002,0.2,0,0,0,0,0,0,0,,0,0,0,0,0,0,0,0,Matches
74,Ángel Algobia,ESP,MF,Getafe,La Liga,23,1999,12.6,27,13,14,13,0,22,48,45.8,26,15,5,10,3,30,11,0,Matches
75,Mohamed Ali Cho,FRA,"FW,MF",Real Sociedad,La Liga,18,2004,6.5,13,10,6,5,2,4,10,40.0,6,9,0,9,2,15,2,0,Matches
76,Faride Alidou,GER,"DF,MF",Eint Frankfurt,Bundesliga,21,2001,2.0,8,5,3,4,1,3,9,33.3,6,3,0,3,1,9,3,0,Matches
77,Alisson,BRA,GK,Liverpool,Premier League,29,1992,37.0,0,0,0,0,0,0,3,0.0,3,3,0,3,0,0,20,0,Matches
78,Jim Allevinah,GAB,"DF,FW",Clermont Foot,Ligue 1,27,1995,24.9,39,24,24,11,4,19,62,30.6,43,24,2,22,24,63,26,1,Matches
79,Dele Alli,ENG,MF,Everton,Premier League,26,1996,0.4,0,0,0,0,0,0,0,,0,0,0,0,0,0,0,0,Matches
80,Domingos André Ribeiro Almeida,POR,MF,Valencia,La Liga,22,2000,28.2,66,42,23,32,11,26,57,45.6,31,26,0,26,20,86,16,1,Matches
81,Miguel Almirón,PAR,FW,Newcastle Utd,Premier League,28,1994,27.7,46,30,16,19,11,18,42,42.9,24,25,2,23,10,56,17,0,Matches
82,Marcos Alonso,ESP,DF,Barcelona,La Liga,31,1990,13.0,15,10,10,5,0,9,12,75.0,3,14,10,4,11,26,32,0,Matches
83,Mickaël Alphonse,GLP,DF,Ajaccio,Ligue 1,33,1989,15.1,35,23,20,11,4,20,33,60.6,13,17,5,12,35,70,44,1,Matches
84,Éder Álvarez Balanta,COL,"MF,FW",Schalke 04,Bundesliga,29,1993,2.6,5,4,2,3,0,2,6,33.3,4,0,0,0,3,8,4,0,Matches
85,Carlos Álvarez,ESP,MF,Sevilla,La Liga,18,2003,0.1,1,1,0,1,0,0,0,,0,0,0,0,0,1,0,0,Matches
86,Gastón Álvarez,URU,DF,Getafe,La Liga,22,2000,16.7,38,30,24,9,5,23,42,54.8,19,15,5,10,15,53,35,0,Matches
87,Julián Álvarez,ARG,"FW,MF",Manchester City,Premier League,22,2000,16.3,26,16,3,13,10,9,30,30.0,21,13,0,13,2,28,6,0,Matches
88,Agustín Álvarez Martínez,URU,"FW,MF",Sassuolo,Serie A,21,2001,4.1,6,3,0,5,1,1,4,25.0,3,5,1,4,3,9,3,0,Matches
89,Yeray Álvarez,ESP,DF,Athletic Club,La Liga,27,1995,25.9,34,23,26,7,1,24,31,77.4,7,23,13,10,48,82,101,0,Matches
90,Ibrahim Amadou,FRA,"DF,MF",Angers,Ligue 1,29,1993,4.7,10,7,6,3,1,7,11,63.6,4,7,3,4,10,20,20,0,Matches
91,Selim Amallah,MAR,"MF,FW",Valladolid,La Liga,25,1996,3.0,15,9,7,8,0,5,8,62.5,3,2,0,2,5,20,2,0,Matches
92,Daniel Amartey,GHA,DF,Leicester City,Premier League,27,1994,17.9,19,8,13,5,1,12,14,85.7,2,24,17,7,8,27,71,0,Matches
93,Amath,SEN,"MF,FW",Mallorca,La Liga,26,1996,13.6,29,19,14,8,7,14,22,63.6,8,13,1,12,5,34,5,0,Matches
94,Jordan Amavi,FRA,DF,Getafe,La Liga,28,1994,2.2,3,2,3,0,0,1,3,33.3,2,3,0,3,4,7,7,0,Matches
95,Lukáš Ambros,CZE,MF,Wolfsburg,Bundesliga,18,2004,0.2,1,0,1,0,0,1,4,25.0,3,1,0,1,0,1,2,1,Matches
96,Kelvin Amian,FRA,DF,Spezia,Serie A,24,1998,26.4,54,32,33,12,9,24,31,77.4,7,34,12,22,22,76,87,1,Matches
97,Bruno Amione,ARG,DF,Hellas Verona,Serie A,20,2002,0.6,1,1,1,0,0,1,2,50.0,1,1,0,1,0,1,4,0,Matches
98,Bruno Amione,ARG,DF,Sampdoria,Serie A,20,2002,23.2,50,33,36,14,0,19,43,44.2,24,26,11,15,25,75,62,1,Matches
99,Nadiem Amiri,GER,"MF,FW",Leverkusen,Bundesliga,25,1996,10.9,15,6,5,8,2,9,20,45.0,11,12,1,11,6,21,10,2,Matches
100,Samuel Amo-Ameyaw,ENG,MF,Southampton,Premier League,16,2006,0.0,0,0,0,0,0,0,1,0.0,1,0,0,0,0,0,0,0,Matches
101,Ethan Ampadu,WAL,"DF,MF",Spezia,Serie A,21,2000,29.3,66,37,33,28,5,17,41,41.5,24,48,23,25,36,102,98,0,Matches
102,Sofyan Amrabat,MAR,MF,Fiorentina,Serie A,25,1996,22.2,39,24,15,17,7,16,29,55.2,13,23,5,18,21,60,18,2,Matches
103,Ayoub Amraoui,MAR,"DF,FW",Nice,Ligue 1,18,2004,3.3,6,5,3,3,0,2,5,40.0,3,1,0,1,4,10,4,0,Matches
104,Joachim Andersen,DEN,DF,Crystal Palace,Premier League,26,1996,30.9,42,22,30,12,0,16,32,50.0,16,28,13,15,24,66,188,1,Matches
105,Elliot Anderson,SCO,"MF,FW",Newcastle Utd,Premier League,19,2002,4.6,11,5,5,3,3,6,12,50.0,6,11,2,9,6,17,2,0,Matches
106,Felipe Anderson,BRA,FW,Lazio,Serie A,29,1993,32.9,80,50,31,41,8,31,88,35.2,57,58,6,52,31,111,27,0,Matches
107,Benjamin André,FRA,MF,Lille,Ligue 1,31,1990,32.4,128,74,51,60,17,65,121,53.7,56,50,8,42,47,175,60,0,Matches
108,Marcos André,BRA,"FW,MF",Valencia,La Liga,25,1996,5.0,4,1,1,1,2,1,2,50.0,1,4,1,3,0,4,0,0,Matches
109,Komnen Andrić,SRB,FW,Clermont Foot,Ligue 1,27,1995,16.1,13,5,2,7,4,2,15,13.3,13,8,1,7,8,21,13,0,Matches
110,Robert Andrich,GER,MF,Leverkusen,Bundesliga,27,1994,26.7,61,38,30,27,4,26,45,57.8,19,27,9,18,42,103,55,2,Matches
111,Angeliño,ESP,DF,Hoffenheim,Bundesliga,25,1997,29.1,40,24,19,18,3,23,37,62.2,14,32,6,26,25,65,67,0,Matches
112,Fabrizio Angileri,ARG,DF,Getafe,La Liga,28,1994,6.5,12,9,8,3,1,10,17,58.8,7,8,3,5,7,19,10,0,Matches
113,Jaidon Anthony,ENG,"MF,FW",Bournemouth,Premier League,22,1999,14.0,30,17,15,9,6,8,24,33.3,16,30,3,27,10,40,19,0,Matches
114,Janis Antiste,FRA,FW,Sassuolo,Serie A,19,2002,0.6,1,0,1,0,0,1,1,100.0,0,0,0,0,0,1,0,0,Matches
115,Waldemar Anton,GER,DF,Stuttgart,Bundesliga,26,1996,32.6,49,27,27,19,3,27,51,52.9,24,44,16,28,38,87,123,2,Matches
116,Josep Antoni Gayá,ESP,"DF,MF",Mallorca,La Liga,22,2000,1.1,0,0,0,0,0,0,0,,0,4,2,2,1,1,6,0,Matches
117,José Antonio,ESP,"MF,DF",Cádiz,La Liga,18,2004,0.5,2,1,0,0,2,0,0,,0,0,0,0,0,2,0,0,Matches
118,Marcos Antônio,BRA,MF,Lazio,Serie A,22,2000,6.6,9,6,4,5,0,9,20,45.0,11,7,2,5,11,20,18,0,Matches
119,Michail Antonio,JAM,FW,West Ham,Premier League,32,1990,20.3,14,7,1,8,5,3,12,25.0,9,13,5,8,5,19,9,0,Matches
120,Antony,BRA,FW,Manchester Utd,Premier League,22,2000,20.0,22,9,9,9,4,8,28,28.6,20,18,0,18,11,33,6,0,Matches
121,Valentin Antov,BUL,DF,Monza,Serie A,21,2000,3.4,6,5,3,3,0,1,5,20.0,4,5,4,1,4,10,14,1,Matches
122,Christopher Antwi-Adjei,GHA,"FW,MF",Bochum,Bundesliga,28,1994,22.0,23,15,7,8,8,10,29,34.5,19,17,0,17,5,28,16,0,Matches
123,Anuar,MAR,"MF,FW",Valladolid,La Liga,27,1995,2.3,4,4,0,1,3,0,0,,0,5,2,3,3,7,3,0,Matches
124,Houssem Aouar,ALG,MF,Lyon,Ligue 1,24,1998,5.8,12,5,5,5,2,3,9,33.3,6,12,2,10,8,20,3,0,Matches
125,Adil Aouchiche,FRA,MF,Lorient,Ligue 1,20,2002,2.8,5,2,3,1,1,1,9,11.1,8,1,0,1,4,9,1,0,Matches
126,Dennis Appiah,FRA,"DF,MF",Nantes,Ligue 1,30,1992,8.8,21,11,14,7,0,10,27,37.0,17,13,5,8,10,31,16,0,Matches
127,Stredair Appuah,FRA,"DF,MF",Nantes,Ligue 1,18,2004,0.7,2,1,0,2,0,0,0,,0,2,0,2,1,3,0,0,Matches
128,Mauro Arambarri,URU,MF,Getafe,La Liga,26,1995,11.0,14,6,9,4,1,3,17,17.6,14,17,5,12,14,28,19,0,Matches
129,Charles Aránguiz,CHI,MF,Leverkusen,Bundesliga,33,1989,5.5,17,7,7,10,0,12,20,60.0,8,4,0,4,7,24,4,0,Matches
130,Ronald Araújo,URU,DF,Barcelona,La Liga,23,1999,20.0,26,18,12,13,1,6,9,66.7,3,15,7,8,12,38,41,1,Matches
131,Cameron Archer,ENG,"FW,MF",Aston Villa,Premier League,21,2001,0.5,0,0,0,0,0,0,0,,0,0,0,0,0,0,0,0,Matches
132,Taïryk Arconte,FRA,FW,Brest,Ligue 1,18,2003,1.4,1,1,0,0,1,0,3,0.0,3,1,0,1,0,1,2,0,Matches
133,Alphonse Areola,FRA,GK,West Ham,Premier League,29,1993,3.4,0,0,0,0,0,0,0,,0,0,0,0,0,0,0,0,Matches
134,Adu Ares,ESP,"FW,MF",Athletic Club,La Liga,20,2001,0.9,4,2,2,1,1,4,4,100.0,0,1,0,1,2,6,1,0,Matches
135,Joe Aribo,NGA,"MF,FW",Southampton,Premier League,26,1996,13.6,31,20,15,12,4,11,20,55.0,9,14,1,13,10,41,11,0,Matches
136,Adam Armstrong,ENG,"FW,MF",Southampton,Premier League,25,1997,14.8,14,9,6,5,3,3,10,30.0,7,15,3,12,5,19,6,0,Matches
137,Stuart Armstrong,SCO,"MF,FW",Southampton,Premier League,30,1992,15.6,32,21,15,13,4,14,39,35.9,25,18,0,18,10,42,9,2,Matches
138,Marko Arnautović,AUT,FW,Bologna,Serie A,33,1989,17.0,9,6,2,5,2,1,6,16.7,5,11,1,10,2,11,10,0,Matches
139,Maximilian Arnold,GER,MF,Wolfsburg,Bundesliga,28,1994,30.7,62,31,25,28,9,28,54,51.9,26,34,11,23,26,88,65,2,Matches
140,Mohamed El Arouch,FRA,MF,Lyon,Ligue 1,18,2004,0.0,1,1,1,0,0,0,0,,0,0,0,0,0,1,0,0,Matches
141,Sergio Arribas,ESP,"MF,FW",Real Madrid,La Liga,20,2001,0.2,0,0,0,0,0,0,0,,0,1,0,1,0,0,0,0,Matches
142,Kepa Arrizabalaga,ESP,GK,Chelsea,Premier League,27,1994,28.5,2,2,2,0,0,2,3,66.7,1,0,0,0,1,3,16,2,Matches
143,Roberto Arroyo,ESP,MF,Valladolid,La Liga,18,2003,0.2,1,1,0,1,0,1,1,100.0,0,0,0,0,0,1,0,0,Matches
144,Tolgay Arslan,GER,MF,Udinese,Serie A,31,1990,13.5,29,18,13,15,1,14,39,35.9,25,19,0,19,12,41,9,1,Matches
145,Ricard Artero,ESP,"MF,FW",Girona,La Liga,19,2003,1.5,3,3,2,1,0,1,1,100.0,0,2,0,2,1,4,3,0,Matches
146,Santiago Arzamendia,PAR,"DF,MF",Cádiz,La Liga,24,1998,5.4,9,8,7,1,1,6,21,28.6,15,11,1,10,2,11,15,1,Matches
147,Takuma Asano,JPN,"FW,MF",Bochum,Bundesliga,27,1994,19.0,14,9,4,4,6,7,16,43.8,9,17,1,16,8,22,8,0,Matches
148,Santiago Ascacíbar,ARG,MF,Cremonese,Serie A,25,1997,8.1,29,14,17,10,2,14,35,40.0,21,14,2,12,13,42,11,0,Matches
149,Sergio Asenjo,ESP,GK,Valladolid,La Liga,33,1989,10.0,0,0,0,0,0,0,0,,0,0,0,0,0,0,10,2,Matches
150,Marco Asensio,ESP,"FW,MF",Real Madrid,La Liga,26,1996,16.0,16,10,8,6,2,8,19,42.1,11,8,3,5,5,21,4,0,Matches
151,Kristoffer Askildsen,NOR,MF,Lecce,Serie A,21,2001,8.1,7,3,2,3,2,4,10,40.0,6,15,4,11,11,18,6,0,Matches
152,Fisnik Asllani,KVX,FW,Hoffenheim,Bundesliga,19,2002,1.9,0,0,0,0,0,0,4,0.0,4,2,0,2,3,3,3,0,Matches
153,Kristjan Asllani,ALB,MF,Inter,Serie A,20,2002,6.6,11,5,1,8,2,7,10,70.0,3,3,1,2,6,17,4,0,Matches
154,Iago Aspas,ESP,FW,Celta Vigo,La Liga,34,1987,31.9,8,4,0,4,4,3,22,13.6,19,10,1,9,7,15,23,0,Matches
155,Lorenz Assignon,TOG,DF,Rennes,Ligue 1,22,2000,2.9,6,2,4,2,0,2,4,50.0,2,6,0,6,2,8,9,0,Matches
156,Youcef Atal,ALG,"DF,MF",Nice,Ligue 1,26,1996,8.7,38,22,18,15,5,23,32,71.9,9,9,0,9,14,52,13,0,Matches
157,Valentin Atangana Edoa,FRA,MF,Reims,Ligue 1,16,2005,1.9,8,3,4,2,2,3,6,50.0,3,2,1,1,0,8,1,0,Matches
158,Pierre-Emerick Aubameyang,GAB,FW,Chelsea,Premier League,33,1989,6.2,1,0,1,0,0,0,1,0.0,1,2,0,2,2,3,4,2,Matches
159,Pierre-Emerick Aubameyang,GAB,FW,Barcelona,La Liga,33,1989,0.1,0,0,0,0,0,0,0,,0,0,0,0,0,0,0,0,Matches
160,Emil Audero,ITA,GK,Sampdoria,Serie A,25,1997,25.0,0,0,0,0,0,0,2,0.0,2,0,0,0,0,0,7,1,Matches
161,Tommaso Augello,ITA,DF,Sampdoria,Serie A,27,1994,34.0,17,14,13,2,2,9,20,45.0,11,23,7,16,17,34,61,1,Matches
162,Ludwig Augustinsson,SWE,DF,Aston Villa,Premier League,28,1994,0.9,1,1,1,0,0,0,0,,0,0,0,0,0,1,1,0,Matches
163,Ludwig Augustinsson,SWE,DF,Mallorca,La Liga,28,1994,1.5,2,1,2,0,0,1,3,33.3,2,1,0,1,1,3,3,0,Matches
164,Carlos Augusto,BRA,DF,Monza,Serie A,23,1999,34.3,73,38,42,23,8,33,54,61.1,21,24,6,18,24,97,85,1,Matches
165,Serge Aurier,CIV,DF,Nott'ham Forest,Premier League,29,1992,21.6,64,41,41,18,5,23,33,69.7,10,34,11,23,29,93,75,0,Matches
166,Mathias Autret,FRA,"MF,FW",Auxerre,Ligue 1,31,1991,14.3,22,10,10,10,2,7,16,43.8,9,14,2,12,12,34,13,0,Matches
167,Ezequiel Ávila,ARG,"FW,MF",Osasuna,La Liga,28,1994,19.0,8,5,2,4,2,6,23,26.1,17,12,1,11,8,16,16,0,Matches
168,Cédric Avinel,GLP,DF,Ajaccio,Ligue 1,35,1986,19.9,13,7,8,5,0,8,12,66.7,4,20,13,7,15,28,91,1,Matches
169,Taiwo Awoniyi,NGA,FW,Nott'ham Forest,Premier League,24,1997,15.6,17,10,2,10,5,6,12,50.0,6,18,4,14,4,21,20,0,Matches
170,Yasin Ayari,SWE,MF,Brighton,Premier League,18,2003,0.7,2,2,1,1,0,0,4,0.0,4,1,0,1,0,2,0,0,Matches
171,Mehmet Aydin,GER,"DF,FW",Schalke 04,Bundesliga,20,2002,6.3,25,18,14,9,2,11,24,45.8,13,11,0,11,10,35,15,0,Matches
172,André Ayew,GHA,"FW,MF",Nott'ham Forest,Premier League,32,1989,3.5,5,3,0,4,1,2,4,50.0,2,6,1,5,0,5,7,0,Matches
173,Jordan Ayew,GHA,"FW,MF",Crystal Palace,Premier League,30,1991,30.2,66,41,23,20,23,21,53,39.6,32,35,4,31,15,81,31,0,Matches
174,Kaan Ayhan,TUR,DF,Sassuolo,Serie A,27,1994,6.1,10,4,6,4,0,7,7,100.0,0,5,4,1,5,15,26,1,Matches
175,Luke Ayling,ENG,DF,Leeds United,Premier League,30,1991,22.8,66,37,42,15,9,42,85,49.4,43,34,11,23,26,92,52,2,Matches
176,Ayman Azhil,MAR,MF,Leverkusen,Bundesliga,21,2001,0.0,0,0,0,0,0,0,0,,0,0,0,0,0,0,0,0,Matches
177,Sardar Azmoun,IRN,"FW,MF",Leverkusen,Bundesliga,27,1995,10.3,6,3,1,4,1,1,7,14.3,6,4,0,4,2,8,14,0,Matches
178,César Azpilicueta,ESP,DF,Chelsea,Premier League,32,1989,17.0,43,25,23,15,5,22,37,59.5,15,26,5,21,19,62,54,1,Matches
179,Sanoussy Ba,GER,DF,RB Leipzig,Bundesliga,18,2004,0.0,0,0,0,0,0,0,0,,0,0,0,0,0,0,0,0,Matches
180,Iddrisu Baba,GHA,"MF,DF",Mallorca,La Liga,26,1996,18.9,31,17,15,16,0,15,32,46.9,17,18,8,10,11,42,39,0,Matches
181,Srđan Babić,SRB,DF,Almería,La Liga,26,1996,33.3,28,18,20,8,0,15,32,46.9,17,34,22,12,29,57,124,1,Matches
182,Loïc Bade,FRA,DF,Sevilla,La Liga,22,2000,16.1,27,20,23,3,1,17,30,56.7,13,21,13,8,23,50,77,0,Matches
183,Loïc Bade,FRA,DF,Rennes,Ligue 1,22,2000,1.0,1,1,1,0,0,0,0,,0,0,0,0,1,2,3,0,Matches
184,Édgar Badía,ESP,GK,Elche,La Liga,30,1992,36.0,1,0,1,0,0,1,2,50.0,1,0,0,0,0,1,19,3,Matches
185,Benoît Badiashile,FRA,DF,Chelsea,Premier League,21,2001,10.1,14,8,10,4,0,9,14,64.3,5,5,2,3,16,30,34,1,Matches
186,Benoît Badiashile,FRA,DF,Monaco,Ligue 1,21,2001,9.3,10,8,6,4,0,5,10,50.0,5,9,6,3,17,27,40,1,Matches
187,Alex Baena,ESP,"MF,FW",Villarreal,La Liga,21,2001,21.6,30,17,9,15,6,15,45,33.3,30,15,3,12,7,37,16,0,Matches
188,Jaime Báez,URU,DF,Cremonese,Serie A,27,1995,1.1,4,2,3,0,1,3,6,50.0,3,0,0,0,0,4,2,1,Matches
189,Leon Bailey,JAM,"FW,MF",Aston Villa,Premier League,24,1997,21.9,14,6,6,7,1,5,20,25.0,15,13,0,13,6,20,12,0,Matches
190,Eric Bailly,CIV,DF,Marseille,Ligue 1,28,1994,6.0,13,10,6,6,1,7,7,100.0,0,15,12,3,12,25,18,1,Matches
191,Dénys Bain,FRA,DF,Auxerre,Ligue 1,29,1993,1.4,4,3,3,1,0,1,2,50.0,1,2,1,1,2,6,4,0,Matches
192,Brandon Baiye,BEL,MF,Clermont Foot,Ligue 1,21,2000,0.6,3,2,2,1,0,2,3,66.7,1,1,0,1,1,4,3,0,Matches
193,Stefan Bajcetic,ESP,MF,Liverpool,Premier League,17,2004,5.8,9,6,5,3,1,8,27,29.6,19,7,0,7,9,18,4,0,Matches
194,Nedim Bajrami,ALB,"MF,FW",Empoli,Serie A,23,1999,10.4,8,4,3,3,2,4,6,66.7,2,5,0,5,7,15,4,0,Matches
195,Nedim Bajrami,ALB,"FW,MF",Sassuolo,Serie A,23,1999,9.1,12,7,6,2,4,5,11,45.5,6,9,1,8,7,19,6,0,Matches
196,Cédric Bakambu,COD,MF,Marseille,Ligue 1,31,1991,0.7,2,1,2,0,0,2,2,100.0,0,0,0,0,0,2,0,0,Matches
197,Tiemoué Bakayoko,FRA,MF,Milan,Serie A,27,1994,0.5,5,5,4,1,0,3,3,100.0,0,0,0,0,0,5,0,1,Matches
198,Mitchel Bakker,NED,"DF,MF",Leverkusen,Bundesliga,22,2000,18.4,16,8,9,7,0,6,15,40.0,9,20,2,18,15,31,20,2,Matches
199,Ridle Baku,GER,"DF,FW",Wolfsburg,Bundesliga,24,1998,28.7,50,26,29,17,4,32,58,55.2,26,44,6,38,21,71,59,0,Matches
200,Tommaso Baldanzi,ITA,MF,Empoli,Serie A,19,2003,19.7,25,12,9,13,3,7,32,21.9,25,21,1,20,2,27,5,0,Matches
201,Alejandro Balde,ESP,DF,Barcelona,La Liga,18,2003,27.5,42,30,22,16,4,24,41,58.5,17,25,3,22,12,54,17,1,Matches
202,Thierno Balde,FRA,"DF,MF",Troyes,Ligue 1,20,2002,23.9,27,14,19,4,4,18,30,60.0,12,15,3,12,23,50,39,0,Matches
203,Carlos Baleba,CMR,MF,Lille,Ligue 1,18,2004,5.3,13,11,2,9,2,9,14,64.3,5,13,3,10,1,14,3,2,Matches
204,Mikel Balenziaga,ESP,DF,Athletic Club,La Liga,34,1988,1.3,4,4,1,2,1,4,4,100.0,0,0,0,0,1,5,2,0,Matches
205,Leonardo Balerdi,ARG,DF,Marseille,Ligue 1,23,1999,29.3,57,37,43,12,2,32,45,71.1,13,48,29,19,63,120,91,1,Matches
206,Dominic Ballard,ENG,"FW,MF",Southampton,Premier League,17,2005,0.3,0,0,0,0,0,0,0,,0,0,0,0,1,1,0,0,Matches
207,Iván Balliu,ALB,DF,Rayo Vallecano,La Liga,30,1992,35.9,52,29,26,20,6,18,30,60.0,12,26,3,23,25,77,72,1,Matches
208,Fodé Ballo-Touré,SEN,DF,Milan,Serie A,25,1997,5.8,14,9,7,6,1,7,10,70.0,3,11,3,8,2,16,3,0,Matches
209,Folarin Balogun,USA,FW,Reims,Ligue 1,21,2001,33.3,9,5,1,5,3,2,20,10.0,18,20,1,19,3,12,15,0,Matches
210,Abdoulaye Bamba,CIV,DF,Angers,Ligue 1,32,1990,15.2,22,12,15,5,2,16,19,84.2,3,7,3,4,18,40,38,0,Matches
211,Jonathan Bamba,CIV,FW,Lille,Ligue 1,26,1996,30.9,37,17,12,14,11,14,45,31.1,31,36,1,35,22,59,14,0,Matches
212,Patrick Bamford,ENG,FW,Leeds United,Premier League,28,1993,16.8,9,6,0,6,3,4,20,20.0,16,12,5,7,5,14,13,0,Matches
213,Lameck Banda,ZAM,"FW,MF",Lecce,Serie A,21,2001,18.2,30,20,13,14,3,15,41,36.6,26,24,2,22,8,38,5,0,Matches
214,Filippo Bandinelli,ITA,MF,Empoli,Serie A,27,1995,25.1,55,34,19,26,10,17,45,37.8,28,20,7,13,18,73,40,0,Matches
215,Léo Baptistão,BRA,"FW,MF",Almería,La Liga,29,1992,19.2,32,20,13,16,3,13,33,39.4,20,17,2,15,19,51,12,0,Matches
216,Shandon Baptiste,GRN,MF,Brentford,Premier League,24,1998,6.9,15,9,6,6,3,7,17,41.2,10,10,2,8,7,22,10,0,Matches
217,Antonín Barák,CZE,MF,Hellas Verona,Serie A,27,1994,0.3,0,0,0,0,0,0,0,,0,0,0,0,0,0,0,0,Matches
218,Antonín Barák,CZE,MF,Fiorentina,Serie A,27,1994,20.0,21,9,5,7,9,6,16,37.5,10,16,2,14,3,24,13,0,Matches
219,Andrea Barberis,ITA,MF,Monza,Serie A,28,1993,3.8,7,2,4,3,0,5,11,45.5,6,0,0,0,8,15,1,0,Matches
220,Tommaso Barbieri,ITA,DF,Juventus,Serie A,19,2002,1.2,3,3,3,0,0,3,8,37.5,5,3,0,3,0,3,2,0,Matches
221,Bradley Barcola,FRA,"FW,MF",Lyon,Ligue 1,19,2002,16.0,25,16,8,10,7,8,39,20.5,31,29,0,29,19,44,10,0,Matches
222,Melvin Bard,FRA,DF,Nice,Ligue 1,21,2000,27.3,96,60,61,29,6,59,89,66.3,30,35,4,31,64,160,40,1,Matches
223,Francesco Bardi,ITA,GK,Bologna,Serie A,30,1992,1.0,0,0,0,0,0,0,0,,0,0,0,0,0,0,0,0,Matches
224,Keidi Bare,ALB,MF,Espanyol,La Liga,24,1997,5.6,15,8,7,5,3,7,13,53.8,6,8,2,6,11,26,8,0,Matches
225,Nicolò Barella,ITA,MF,Inter,Serie A,25,1997,29.0,49,25,17,26,6,28,53,52.8,25,29,5,24,12,61,12,0,Matches
226,Kike Barja,ESP,"FW,MF",Osasuna,La Liga,25,1997,14.6,15,9,6,5,4,8,24,33.3,16,7,0,7,4,19,3,0,Matches
227,Ross Barkley,ENG,"MF,FW",Nice,Ligue 1,28,1993,10.7,16,9,7,4,5,7,13,53.8,6,7,2,5,8,24,6,0,Matches
228,Aymen Barkok,MAR,MF,Mainz 05,Bundesliga,24,1998,6.5,18,8,10,5,3,5,10,50.0,5,7,0,7,3,21,9,0,Matches
229,Harvey Barnes,ENG,"FW,MF",Leicester City,Premier League,24,1997,30.1,26,14,8,14,4,14,42,33.3,28,32,1,31,8,34,12,0,Matches
230,Leandro Barreiro Martins,LUX,MF,Mainz 05,Bundesliga,22,2000,23.8,60,38,19,28,13,22,49,44.9,27,38,13,25,41,101,39,1,Matches
231,Enzo Barrenechea,ARG,MF,Juventus,Serie A,21,2001,1.8,8,3,3,4,1,3,5,60.0,2,3,0,3,2,10,3,0,Matches
232,Ander Barrenetxea,ESP,"FW,DF",Real Sociedad,La Liga,20,2001,9.8,21,15,15,6,0,12,28,42.9,16,15,1,14,5,26,7,0,Matches
233,Mickaël Barreto,FRA,MF,Ajaccio,Ligue 1,31,1991,14.7,32,20,12,17,3,8,45,17.8,37,17,0,17,18,50,11,0,Matches
234,Pablo Barrios,ESP,MF,Atlético Madrid,La Liga,19,2003,8.0,19,10,3,10,6,8,15,53.3,7,12,2,10,9,28,6,1,Matches
235,Musa Barrow,GAM,"FW,MF",Bologna,Serie A,23,1998,21.8,21,4,10,6,5,8,14,57.1,6,25,1,24,1,22,7,0,Matches
236,Federico Baschirotto,ITA,DF,Lecce,Serie A,25,1996,37.0,40,30,35,5,0,22,36,61.1,14,45,29,16,36,76,192,0,Matches
237,Toma Bašić,CRO,MF,Lazio,Serie A,25,1996,5.7,6,4,4,1,1,3,8,37.5,5,9,0,9,7,13,8,0,Matches
238,Alberto Basso,ITA,MF,Cremonese,Serie A,18,2004,0.2,0,0,0,0,0,0,0,,0,0,0,0,0,0,0,0,Matches
239,Gil Bastião Dias,POR,FW,Stuttgart,Bundesliga,25,1996,4.4,8,6,3,4,1,3,12,25.0,9,7,0,7,2,10,3,0,Matches
240,Alessandro Bastoni,ITA,DF,Inter,Serie A,23,1999,24.0,41,20,20,14,7,11,27,40.7,16,27,13,14,24,65,45,0,Matches
241,Simone Bastoni,ITA,"MF,DF",Spezia,Serie A,25,1996,13.2,47,24,23,19,5,15,33,45.5,18,20,5,15,8,55,14,0,Matches
242,Rodrigo Battaglia,ARG,MF,Mallorca,La Liga,31,1991,7.6,12,5,7,5,0,6,14,42.9,8,16,7,9,5,17,18,0,Matches
243,Maximilian Bauer,GER,DF,Augsburg,Bundesliga,22,2000,20.5,31,17,18,12,1,17,34,50.0,17,25,9,16,23,54,79,1,Matches
244,Oliver Baumann,GER,GK,Hoffenheim,Bundesliga,32,1990,34.0,0,0,0,0,0,0,0,,0,0,0,0,0,0,15,1,Matches
245,Timo Baumgartl,GER,DF,Union Berlin,Bundesliga,26,1996,6.2,11,6,5,4,2,5,18,27.8,13,12,4,8,2,13,14,0,Matches
246,Julian Baumgartlinger,AUT,MF,Augsburg,Bundesliga,34,1988,6.2,15,4,5,6,4,6,19,31.6,13,4,2,2,4,19,15,0,Matches
247,Christoph Baumgartner,AUT,"MF,FW",Hoffenheim,Bundesliga,22,1999,28.5,36,19,12,17,7,9,52,17.3,43,57,5,52,15,51,19,1,Matches
248,Cyrille Bayala,BFA,MF,Ajaccio,Ligue 1,26,1996,22.3,53,37,16,20,17,23,48,47.9,25,20,3,17,25,78,21,0,Matches
249,Brian Bayeye,COD,DF,Torino,Serie A,22,2000,0.7,3,0,3,0,0,1,1,100.0,0,1,1,0,1,4,2,0,Matches
250,Noah Joel Sarenren Bazee,NGA,"MF,FW",Augsburg,Bundesliga,25,1996,0.2,0,0,0,0,0,0,1,0.0,1,1,0,1,0,0,0,0,Matches
251,Gavin Bazunu,IRL,GK,Southampton,Premier League,20,2002,32.0,1,0,1,0,0,1,1,100.0,0,0,0,0,1,2,24,2,Matches
252,Bebé,CPV,FW,Rayo Vallecano,La Liga,32,1990,0.7,0,0,0,0,0,0,2,0.0,2,1,0,1,0,0,0,0,Matches
253,Ihlas Bebou,TOG,"FW,DF",Hoffenheim,Bundesliga,28,1994,15.7,19,16,8,7,4,11,17,64.7,6,9,2,7,7,26,15,0,Matches
254,Rodrigo Becão,BRA,DF,Udinese,Serie A,26,1996,27.6,70,36,50,17,3,40,53,75.5,13,44,24,20,26,96,68,2,Matches
255,Mads Bech Sørensen,DEN,"DF,MF",Brentford,Premier League,23,1999,0.2,0,0,0,0,0,0,0,,0,0,0,0,1,1,1,0,Matches
256,Julius Beck,DEN,MF,Spezia,Serie A,17,2005,0.1,2,1,1,1,0,0,0,,0,0,0,0,0,2,0,0,Matches
257,Sheraldo Becker,SUR,FW,Union Berlin,Bundesliga,27,1995,28.4,15,5,1,7,7,2,11,18.2,9,13,1,12,3,18,7,1,Matches
258,Jan Bednarek,POL,DF,Southampton,Premier League,26,1996,18.6,27,21,20,7,0,12,16,75.0,4,38,27,11,49,76,87,0,Matches
259,Jan Bednarek,POL,DF,Aston Villa,Premier League,26,1996,1.1,3,3,0,3,0,1,1,100.0,0,3,1,2,2,5,5,0,Matches
260,Donny van de Beek,NED,MF,Manchester Utd,Premier League,25,1997,1.9,0,0,0,0,0,0,1,0.0,1,2,1,1,1,1,1,0,Matches
261,Asmir Begović,BIH,GK,Everton,Premier League,35,1987,1.0,0,0,0,0,0,0,0,,0,0,0,0,0,0,1,0,Matches
262,Yanis Begraoui,MAR,"FW,MF",Toulouse,Ligue 1,21,2001,0.7,2,0,1,0,1,1,2,50.0,1,0,0,0,1,3,0,0,Matches
263,Kevin Behrens,GER,FW,Union Berlin,Bundesliga,31,1991,17.1,11,7,4,4,3,4,18,22.2,14,18,3,15,5,16,25,0,Matches
264,Alexis Beka Beka,FRA,"MF,DF",Nice,Ligue 1,21,2001,6.1,16,5,6,9,1,4,15,26.7,11,9,1,8,12,28,6,0,Matches
265,Jérémie Bela,ANG,"DF,MF",Clermont Foot,Ligue 1,29,1993,8.3,6,4,2,1,3,3,4,75.0,1,10,1,9,9,15,8,0,Matches
266,Reda Belahyane,FRA,MF,Nice,Ligue 1,18,2004,2.0,8,6,5,3,0,3,5,60.0,2,5,1,4,2,10,0,0,Matches
267,Youcef Belaïli,ALG,"MF,FW",Ajaccio,Ligue 1,30,1992,12.8,18,10,3,9,6,8,20,40.0,12,10,1,9,5,23,4,0,Matches
268,Youcef Belaïli,ALG,"FW,MF",Brest,Ligue 1,30,1992,4.0,5,2,3,2,0,2,7,28.6,5,2,0,2,1,6,1,0,Matches
269,Haris Belkebla,ALG,MF,Brest,Ligue 1,28,1994,29.5,80,48,35,40,5,44,85,51.8,41,32,6,26,52,132,21,3,Matches
270,Stefan Bell,GER,DF,Mainz 05,Bundesliga,30,1991,26.6,43,28,32,10,1,22,44,50.0,22,42,15,27,44,87,133,0,Matches
271,Armel Bella Kotchap,GER,DF,Southampton,Premier League,20,2001,20.9,37,17,28,9,0,15,20,75.0,5,29,12,17,44,81,110,0,Matches
272,Raoul Bellanova,ITA,DF,Inter,Serie A,22,2000,5.5,14,6,11,2,1,9,14,64.3,5,6,1,5,4,18,14,0,Matches
273,Karim Bellarabi,GER,"FW,MF",Leverkusen,Bundesliga,32,1990,0.9,2,0,1,1,0,2,3,66.7,1,0,0,0,0,2,0,0,Matches
274,Jean-Ricner Bellegarde,FRA,"MF,FW",Strasbourg,Ligue 1,24,1998,26.9,47,25,15,21,11,11,25,44.0,14,26,3,23,26,73,22,0,Matches
275,Héctor Bellerín,ESP,DF,Barcelona,La Liga,27,1995,1.6,2,0,0,2,0,2,3,66.7,1,2,0,2,3,5,2,0,Matches
276,Jude Bellingham,ENG,MF,Dortmund,Bundesliga,19,2003,29.9,76,42,28,34,14,34,51,66.7,17,51,4,47,35,111,30,0,Matches
277,Jeanuël Belocian,FRA,DF,Rennes,Ligue 1,17,2005,5.6,10,7,3,5,2,5,9,55.6,4,6,3,3,6,16,11,0,Matches
278,Andrea Belotti,ITA,FW,Roma,Serie A,28,1993,12.7,12,5,3,5,4,5,11,45.5,6,11,1,10,3,15,5,0,Matches
279,Fran Beltrán,ESP,MF,Celta Vigo,La Liga,23,1999,31.7,34,22,15,14,5,14,55,25.5,41,29,5,24,53,87,35,2,Matches
280,Eliesse Ben Seghir,MAR,"FW,MF",Monaco,Ligue 1,17,2005,11.7,18,10,4,12,2,4,12,33.3,8,18,1,17,4,22,1,0,Matches
281,Salim Ben Seghir,FRA,MF,Marseille,Ligue 1,19,2003,0.0,0,0,0,0,0,0,0,,0,1,0,1,0,0,0,0,Matches
282,Wissam Ben Yedder,FRA,FW,Monaco,Ligue 1,31,1990,23.5,16,9,2,5,9,4,13,30.8,9,15,0,15,4,20,0,0,Matches
283,Marco Benassi,ITA,DF,Fiorentina,Serie A,27,1994,1.0,3,3,2,0,1,3,4,75.0,1,0,0,0,1,4,1,0,Matches
284,Marco Benassi,ITA,MF,Cremonese,Serie A,27,1994,11.1,26,15,9,11,6,15,24,62.5,9,13,1,12,12,38,19,0,Matches
285,Iker Benito,ESP,"FW,MF",Osasuna,La Liga,19,2002,2.0,4,3,0,3,1,2,4,50.0,2,0,0,0,2,6,4,0,Matches
286,Ismaël Bennacer,ALG,MF,Milan,Serie A,24,1997,22.3,59,33,26,31,2,30,51,58.8,21,25,7,18,26,85,16,1,Matches
287,Saïd Benrahma,ALG,"FW,MF",West Ham,Premier League,26,1995,23.0,25,15,11,7,7,11,27,40.7,16,23,1,22,9,34,13,0,Matches
288,Ramy Bensebaini,ALG,DF,Gladbach,Bundesliga,27,1995,27.6,34,21,21,10,3,26,39,66.7,13,44,14,30,36,70,98,1,Matches
289,Nabil Bentaleb,ALG,MF,Angers,Ligue 1,27,1994,27.7,74,40,31,35,8,36,61,59.0,25,33,11,22,44,118,29,3,Matches
290,Rodrigo Bentancur,URU,MF,Tottenham,Premier League,25,1997,16.7,45,28,15,21,9,16,28,57.1,12,28,15,13,20,65,22,0,Matches
291,Daniel Bentley,ENG,GK,Wolves,Premier League,29,1993,2.0,1,1,1,0,0,1,1,100.0,0,0,0,0,0,1,0,1,Matches
292,Karim Benzema,FRA,FW,Real Madrid,La Liga,34,1987,22.6,9,5,2,4,3,2,11,18.2,9,11,0,11,2,11,5,0,Matches
293,Domenico Berardi,ITA,FW,Sassuolo,Serie A,27,1994,20.7,23,14,8,10,5,9,40,22.5,31,13,0,13,19,42,18,0,Matches
294,Yuri Berchiche,ESP,DF,Athletic Club,La Liga,32,1990,26.7,56,32,28,20,8,35,59,59.3,24,37,12,25,40,96,59,1,Matches
295,Álex Berenguer,ESP,FW,Athletic Club,La Liga,27,1995,25.5,58,37,17,25,16,23,60,38.3,37,37,4,33,10,68,6,0,Matches
296,Bartosz Bereszyński,POL,DF,Sampdoria,Serie A,30,1992,13.3,28,18,15,11,2,17,26,65.4,9,18,4,14,21,49,25,0,Matches
297,Bartosz Bereszyński,POL,DF,Napoli,Serie A,30,1992,1.8,3,2,1,1,1,2,2,100.0,0,4,0,4,3,6,3,0,Matches
298,Patrick Berg,NOR,"MF,FW",Lens,Ligue 1,24,1997,0.3,0,0,0,0,0,0,1,0.0,1,0,0,0,1,1,0,0,Matches
299,Mitchell van Bergen,NED,"FW,DF",Reims,Ligue 1,22,1999,10.1,18,8,6,7,5,8,20,40.0,12,8,2,6,6,24,11,0,Matches
300,Mergim Berisha,GER,FW,Augsburg,Bundesliga,24,1998,18.7,11,6,4,3,4,4,14,28.6,10,16,1,15,0,11,19,0,Matches
301,Quentin Bernard,FRA,DF,Auxerre,Ligue 1,33,1989,7.0,9,7,4,2,3,7,15,46.7,8,9,1,8,15,24,17,0,Matches
302,Paul Bernardoni,FRA,GK,Angers,Ligue 1,25,1997,27.0,2,0,2,0,0,2,3,66.7,1,1,0,1,1,3,12,1,Matches
303,Juan Bernat,ESP,"DF,MF",Paris S-G,Ligue 1,29,1993,18.3,32,16,18,9,5,21,39,53.8,18,11,2,9,9,41,22,1,Matches
304,Victor Bernth Kristiansen,DEN,DF,Leicester City,Premier League,19,2002,9.9,38,23,18,16,4,22,30,73.3,8,16,4,12,3,41,26,1,Matches
305,Jason Berthomier,FRA,MF,Clermont Foot,Ligue 1,32,1990,0.3,0,0,0,0,0,0,0,,0,0,0,0,0,0,0,0,Matches
306,Marco Bertini,ITA,MF,Lazio,Serie A,19,2002,0.0,0,0,0,0,0,0,0,,0,0,0,0,0,0,0,0,Matches
307,Beto,GNB,FW,Udinese,Serie A,24,1998,23.7,16,9,0,9,7,4,17,23.5,13,18,3,15,6,22,30,0,Matches
308,Owen Bevan,WAL,DF,Bournemouth,Premier League,18,2003,0.1,0,0,0,0,0,0,0,,0,0,0,0,0,0,0,0,Matches
309,Matteo Bianchetti,ITA,DF,Cremonese,Serie A,29,1993,23.7,32,19,21,9,2,20,32,62.5,12,31,17,14,20,52,111,0,Matches
310,Alessandro Bianco,ITA,MF,Fiorentina,Serie A,19,2002,1.7,5,2,2,3,0,2,3,66.7,1,1,0,1,0,5,0,0,Matches
311,Giulian Biancone,FRA,DF,Nott'ham Forest,Premier League,22,2000,0.2,2,1,2,0,0,1,1,100.0,0,0,0,0,1,3,0,0,Matches
312,Ermin Bičakčić,BIH,DF,Hoffenheim,Bundesliga,32,1990,2.9,8,4,6,1,1,2,6,33.3,4,4,3,1,5,13,14,0,Matches
313,Pedro Bigas,ESP,DF,Elche,La Liga,31,1990,22.4,37,20,30,7,0,18,29,62.1,11,25,14,11,33,70,95,0,Matches
314,Jaka Bijol,SVN,DF,Udinese,Serie A,23,1999,30.3,39,23,32,7,0,16,27,59.3,11,41,25,16,29,68,165,0,Matches
315,El Bilal Touré,MLI,FW,Almería,La Liga,20,2001,14.0,4,3,2,1,1,0,3,0.0,3,6,1,5,1,5,23,0,Matches
316,El Bilal Touré,MLI,FW,Reims,Ligue 1,20,2001,1.0,0,0,0,0,0,0,0,,0,2,0,2,0,0,1,0,Matches
317,Philip Billing,DEN,"MF,FW",Bournemouth,Premier League,26,1996,30.7,63,36,21,33,9,11,42,26.2,31,48,8,40,31,94,58,1,Matches
318,Jean-Claude Billong,CMR,MF,Clermont Foot,Ligue 1,28,1993,0.3,0,0,0,0,0,0,0,,0,1,1,0,1,1,0,0,Matches
319,Cristiano Biraghi,ITA,DF,Fiorentina,Serie A,29,1992,28.3,65,38,29,29,7,32,65,49.2,33,32,7,25,14,79,42,1,Matches
320,Samuele Birindelli,ITA,DF,Monza,Serie A,23,1999,15.6,35,19,21,10,4,18,29,62.1,11,28,8,20,16,51,30,0,Matches
321,Veljko Birmančević,SRB,"FW,MF",Toulouse,Ligue 1,24,1998,4.9,13,7,5,4,4,7,21,33.3,14,12,2,10,7,20,1,0,Matches
322,Tom Bischof,GER,"MF,FW",Hoffenheim,Bundesliga,17,2005,3.5,15,10,8,3,4,7,10,70.0,3,5,1,4,1,16,1,0,Matches
323,Yves Bissouma,MLI,MF,Tottenham,Premier League,25,1996,11.2,16,13,6,6,4,2,7,28.6,5,15,6,9,12,28,10,0,Matches
324,Kristijan Bistrović,CRO,MF,Lecce,Serie A,24,1998,5.1,3,1,3,0,0,0,5,0.0,5,3,0,3,0,3,4,0,Matches
325,Leonardo Bittencourt,GER,"MF,DF",Werder Bremen,Bundesliga,28,1993,18.1,53,28,20,25,8,25,62,40.3,37,13,0,13,10,63,15,0,Matches
326,Marco Bizot,NED,GK,Brest,Ligue 1,31,1991,37.0,0,0,0,0,0,0,1,0.0,1,1,0,1,0,0,24,4,Matches
327,Antonio Blanco,ESP,MF,Cádiz,La Liga,22,2000,1.8,6,4,5,1,0,4,6,66.7,2,5,0,5,1,7,3,0,Matches
328,Lautaro Blanco,ARG,"DF,MF",Elche,La Liga,23,1999,9.7,16,9,10,4,2,9,26,34.6,17,8,1,7,2,18,10,1,Matches
329,Rubén Blanco,ESP,GK,Marseille,Ligue 1,27,1995,5.5,0,0,0,0,0,0,0,,0,0,0,0,0,0,1,0,Matches
330,Ludovic Blas,FRA,"MF,FW",Nantes,Ligue 1,24,1997,31.3,47,30,17,19,11,17,49,34.7,32,26,1,25,19,66,8,0,Matches
331,Janis Blaswich,GER,GK,RB Leipzig,Bundesliga,31,1991,26.0,0,0,0,0,0,0,0,,0,0,0,0,0,0,10,0,Matches
332,Miha Blažič,SVN,DF,Angers,Ligue 1,29,1993,22.0,8,6,8,0,0,7,15,46.7,8,25,19,6,22,30,80,1,Matches
333,Joaquín Blázquez,ARG,GK,Brest,Ligue 1,21,2001,1.0,0,0,0,0,0,0,0,,0,0,0,0,0,0,2,0,Matches
334,Alexis Blin,FRA,MF,Lecce,Serie A,25,1996,26.4,69,39,27,33,9,38,73,52.1,35,55,15,40,34,103,74,0,Matches
335,Daley Blind,NED,"DF,MF",Bayern Munich,Bundesliga,32,1990,1.5,2,0,2,0,0,0,1,0.0,1,4,2,2,2,4,6,0,Matches
336,Myron Boadu,NED,FW,Monaco,Ligue 1,21,2001,3.3,3,3,0,2,1,1,7,14.3,6,1,0,1,0,3,1,0,Matches
337,Jérôme Boateng,GER,DF,Lyon,Ligue 1,33,1988,4.8,3,0,2,1,0,2,6,33.3,4,8,5,3,6,9,16,0,Matches
338,Kevin-Prince Boateng,GHA,MF,Hertha BSC,Bundesliga,35,1987,5.2,8,6,4,2,2,3,9,33.3,6,11,3,8,3,11,5,0,Matches
339,Antonin Bobichon,FRA,MF,Angers,Ligue 1,26,1995,0.2,0,0,0,0,0,0,0,,0,1,0,1,0,0,0,0,Matches
340,Jean-Paul Boëtius,NED,MF,Hertha BSC,Bundesliga,28,1994,11.7,30,16,19,9,2,8,25,32.0,17,25,5,20,14,44,10,0,Matches
341,Jeremie Boga,CIV,"MF,FW",Atalanta,Serie A,25,1997,8.7,9,5,3,2,4,2,5,40.0,3,6,0,6,1,10,1,0,Matches
342,Emil Bohinen,NOR,MF,Salernitana,Serie A,23,1999,9.2,25,13,15,8,2,12,23,52.2,11,25,7,18,17,42,21,0,Matches
343,Quentin Boisgard,FRA,MF,Lorient,Ligue 1,25,1997,2.0,6,2,1,4,1,3,4,75.0,1,3,1,2,4,10,2,0,Matches
344,Willy Boly,CIV,DF,Nott'ham Forest,Premier League,31,1991,7.6,13,6,8,3,2,8,13,61.5,5,13,4,9,12,25,45,0,Matches
345,Giacomo Bonaventura,ITA,MF,Fiorentina,Serie A,32,1989,21.2,35,23,14,15,6,24,37,64.9,13,14,0,14,16,51,5,1,Matches
346,Federico Bonazzoli,ITA,"FW,MF",Salernitana,Serie A,25,1997,12.4,5,3,0,3,2,0,9,0.0,9,9,1,8,3,8,0,0,Matches
347,Warren Bondo,FRA,MF,Monza,Serie A,18,2003,0.7,1,0,1,0,0,0,0,,0,1,0,1,0,1,0,0,Matches
348,Theo Bongonda,COD,"MF,FW",Cádiz,La Liga,26,1995,21.5,28,20,11,14,3,17,40,42.5,23,21,2,19,6,34,14,0,Matches
349,Kevin Bonifazi,ITA,DF,Bologna,Serie A,26,1996,10.0,13,8,7,6,0,6,12,50.0,6,11,8,3,12,25,39,0,Matches
350,Leonardo Bonucci,ITA,DF,Juventus,Serie A,35,1987,9.8,5,4,1,4,0,2,4,50.0,2,12,8,4,13,18,29,0,Matches
351,Neto Borges,BRA,DF,Clermont Foot,Ligue 1,25,1996,31.5,75,45,45,20,10,46,75,61.3,29,45,11,34,41,116,62,1,Matches
352,Yvandro Borges Sanches,LUX,"FW,MF",Gladbach,Bundesliga,18,2004,0.3,2,2,0,2,0,2,2,100.0,0,0,0,0,0,2,0,0,Matches
353,Sebastiaan Bornauw,BEL,DF,Wolfsburg,Bundesliga,23,1999,21.4,29,17,17,10,2,16,22,72.7,6,27,12,15,31,60,83,1,Matches
354,Rafael Borré,COL,"MF,FW",Eint Frankfurt,Bundesliga,26,1995,12.0,25,15,4,13,8,4,17,23.5,13,10,2,8,2,27,9,0,Matches
355,Erik Botheim,NOR,"MF,FW",Salernitana,Serie A,22,2000,9.6,11,7,3,4,4,6,13,46.2,7,3,0,3,0,11,4,0,Matches
356,Sven Botman,NED,DF,Newcastle Utd,Premier League,22,2000,34.7,38,24,31,7,0,22,28,78.6,6,44,24,20,34,72,126,2,Matches
357,Kenji-Van Boto,MAD,DF,Auxerre,Ligue 1,26,1996,2.0,3,2,2,0,1,2,4,50.0,2,0,0,0,1,4,3,0,Matches
358,Kouamé Botué,BFA,"FW,MF",Ajaccio,Ligue 1,19,2002,2.5,4,2,2,1,1,0,2,0.0,2,1,0,1,0,4,1,0,Matches
359,Badredine Bouanani,ALG,"FW,MF",Nice,Ligue 1,17,2004,9.6,13,9,2,7,4,7,14,50.0,7,4,0,4,1,14,2,0,Matches
360,Hicham Boudaoui,ALG,MF,Nice,Ligue 1,22,1999,20.8,67,32,31,30,6,35,53,66.0,18,34,5,29,36,103,16,0,Matches
361,Franci Bouebari,FRA,DF,Strasbourg,Ligue 1,18,2003,0.8,3,0,1,2,0,3,5,60.0,2,0,0,0,2,5,2,0,Matches
362,Sofiane Boufal,MAR,"FW,MF",Angers,Ligue 1,28,1993,9.3,14,9,7,4,3,3,14,21.4,11,6,0,6,5,19,1,0,Matches
363,Yassine Bounou,MAR,GK,Sevilla,La Liga,31,1991,23.9,2,1,2,0,0,1,4,25.0,3,0,0,0,2,4,11,1,Matches
364,Ismaëlben Boura,COM,"DF,FW",Lens,Ligue 1,21,2000,1.0,6,4,4,2,0,5,6,83.3,1,2,1,1,2,8,3,0,Matches
365,Mehdi Bourabia,MAR,MF,Spezia,Serie A,30,1991,30.8,41,20,13,22,6,19,41,46.3,22,39,12,27,32,73,57,0,Matches
366,Benjamin Bourigeaud,FRA,"MF,FW",Rennes,Ligue 1,28,1994,34.1,45,29,16,23,6,21,65,32.3,44,38,3,35,31,76,32,0,Matches
367,Edoardo Bove,ITA,MF,Roma,Serie A,20,2002,11.0,35,18,12,15,8,16,39,41.0,23,15,1,14,10,45,11,0,Matches
368,Jarrod Bowen,ENG,"FW,MF",West Ham,Premier League,25,1996,35.9,39,16,14,11,14,16,58,27.6,42,47,9,38,36,75,25,0,Matches
369,Lucas Boyé,ARG,FW,Elche,La Liga,26,1996,27.4,36,16,12,16,8,17,35,48.6,18,33,5,28,15,51,46,0,Matches
370,Jayden Braaf,NED,"MF,FW",Hellas Verona,Serie A,19,2002,3.2,5,3,2,3,0,0,0,,0,1,0,1,2,7,1,0,Matches
371,Domagoj Bradarić,CRO,DF,Salernitana,Serie A,22,1999,25.0,26,19,14,8,4,7,16,43.8,9,20,5,15,21,47,44,0,Matches
372,Bilal Brahimi,ALG,"FW,MF",Nice,Ligue 1,22,2000,8.9,8,5,2,5,1,1,7,14.3,6,4,0,4,4,12,0,0,Matches
373,Martin Braithwaite,DEN,"FW,MF",Espanyol,La Liga,31,1991,27.3,12,2,2,4,6,5,14,35.7,9,10,0,10,5,17,11,0,Matches
374,Julian Brandt,GER,"MF,FW",Dortmund,Bundesliga,26,1996,26.6,29,20,6,14,9,12,43,27.9,31,23,0,23,15,44,9,1,Matches
375,Darko Brašanac,SRB,MF,Osasuna,La Liga,30,1992,11.6,29,20,12,10,7,12,23,52.2,11,14,2,12,12,41,9,0,Matches
376,Lilian Brassier,FRA,DF,Brest,Ligue 1,22,1999,34.4,42,30,31,8,3,23,32,71.9,9,42,19,23,53,95,132,1,Matches
377,Claudio Bravo,CHI,GK,Betis,La Liga,39,1983,12.0,0,0,0,0,0,0,0,,0,0,0,0,2,2,1,1,Matches
378,Fabian Bredlow,GER,GK,Stuttgart,Bundesliga,27,1995,15.0,1,1,1,0,0,1,1,100.0,0,0,0,0,0,1,4,2,Matches
379,James Bree,ENG,DF,Southampton,Premier League,24,1997,4.1,5,3,4,1,0,3,4,75.0,1,3,1,2,6,11,11,0,Matches
380,Josip Brekalo,CRO,"FW,MF",Fiorentina,Serie A,24,1998,2.5,2,1,0,1,1,1,4,25.0,3,1,0,1,1,3,1,0,Matches
381,Josip Brekalo,CRO,"MF,FW",Wolfsburg,Bundesliga,24,1998,3.0,2,1,2,0,0,0,4,0.0,4,0,0,0,2,4,2,0,Matches
382,Gleison Bremer,BRA,DF,Juventus,Serie A,25,1997,29.3,29,20,23,5,1,19,26,73.1,7,44,22,22,42,71,120,2,Matches
383,Armando Broja,ALB,FW,Chelsea,Premier League,20,2001,3.3,4,1,0,3,1,1,1,100.0,0,10,1,9,1,5,1,0,Matches
384,Dylan Bronn,TUN,DF,Salernitana,Serie A,27,1995,18.7,34,18,17,16,1,20,30,66.7,10,32,20,12,20,54,58,1,Matches
385,David Brooks,WAL,"FW,MF",Bournemouth,Premier League,25,1997,1.9,1,0,1,0,0,0,1,0.0,1,2,0,2,2,3,5,0,Matches
386,John Brooks,USA,DF,Hoffenheim,Bundesliga,29,1993,15.0,18,12,10,8,0,13,18,72.2,5,17,12,5,10,28,105,0,Matches
387,Moritz Broschinski,GER,"FW,MF",Bochum,Bundesliga,21,2000,2.4,0,0,0,0,0,0,5,0.0,5,1,0,1,0,0,6,0,Matches
388,Marcelo Brozović,CRO,MF,Inter,Serie A,29,1992,19.7,37,22,13,22,2,11,37,29.7,26,23,7,16,22,59,28,0,Matches
389,Cédric Brunner,SUI,DF,Schalke 04,Bundesliga,28,1994,25.7,39,27,26,11,2,30,45,66.7,15,24,7,17,43,82,79,0,Matches
390,Lewis Brunt,ENG,DF,Leicester City,Premier League,21,2000,0.3,0,0,0,0,0,0,0,,0,0,0,0,0,0,2,0,Matches
391,Jacob Bruun Larsen,DEN,FW,Hoffenheim,Bundesliga,23,1998,3.6,4,3,0,1,3,3,4,75.0,1,3,1,2,1,5,0,0,Matches
392,Andreas Bruus,DEN,"DF,FW",Troyes,Ligue 1,23,1999,18.1,12,6,9,3,0,8,20,40.0,12,13,2,11,17,29,24,0,Matches
393,Joe Bryan,ENG,"MF,DF",Nice,Ligue 1,28,1993,2.0,5,4,3,2,0,4,4,100.0,0,2,0,2,1,6,1,0,Matches
394,Lee Buchanan,ENG,"DF,FW",Werder Bremen,Bundesliga,21,2001,5.2,14,10,2,11,1,6,12,50.0,6,5,0,5,12,26,21,0,Matches
395,Ante Budimir,CRO,FW,Osasuna,La Liga,31,1991,20.0,19,9,0,12,7,2,10,20.0,8,10,0,10,5,24,19,0,Matches
396,Emi Buendía,ARG,"MF,FW",Aston Villa,Premier League,25,1996,26.8,52,23,20,20,12,21,74,28.4,53,20,2,18,20,72,17,0,Matches
397,Hugo Bueno,ESP,DF,Wolves,Premier League,19,2002,14.6,33,16,23,6,4,17,33,51.5,16,14,1,13,10,43,36,0,Matches
398,Manu Bueno,ESP,MF,Sevilla,La Liga,18,2004,1.7,7,4,3,3,1,5,8,62.5,3,0,0,0,0,7,2,0,Matches
399,Santiago Bueno,URU,DF,Girona,La Liga,23,1998,33.4,63,38,43,19,1,24,36,66.7,12,34,22,12,31,94,105,2,Matches
400,Adam Buksa,POL,"FW,MF",Lens,Ligue 1,26,1996,1.1,1,0,0,0,1,0,3,0.0,3,0,0,0,0,1,0,0,Matches
401,Marius Bülter,GER,"FW,MF",Schalke 04,Bundesliga,29,1993,28.9,22,11,8,7,7,12,32,37.5,20,34,1,33,10,32,20,0,Matches
402,Cristian Buonaiuto,ITA,"MF,FW",Cremonese,Serie A,29,1992,10.9,25,16,8,11,6,12,26,46.2,14,11,0,11,14,39,7,0,Matches
403,Facundo Buonanotte,ARG,"FW,MF",Brighton,Premier League,17,2004,6.3,2,1,1,1,0,1,22,4.5,21,5,2,3,4,6,3,0,Matches
404,Alessandro Buongiorno,ITA,DF,Torino,Serie A,23,1999,30.2,38,25,22,16,0,16,31,51.6,15,38,19,19,60,98,105,2,Matches
405,Delano Burgzorg,NED,"FW,MF",Mainz 05,Bundesliga,23,1998,2.7,3,3,1,1,1,2,3,66.7,1,2,0,2,0,3,2,0,Matches
406,Jonathan Burkardt,GER,"MF,FW",Mainz 05,Bundesliga,22,2000,5.9,3,1,0,1,2,1,4,25.0,3,6,1,5,1,4,1,0,Matches
407,Oliver Burke,SCO,"FW,MF",Werder Bremen,Bundesliga,25,1997,3.0,1,0,0,0,1,0,0,,0,2,0,2,0,1,0,0,Matches
408,Dan Burn,ENG,DF,Newcastle Utd,Premier League,30,1992,34.6,60,38,29,23,8,34,67,50.7,33,42,16,26,32,92,120,2,Matches
409,Maxime Busi,BEL,DF,Reims,Ligue 1,22,1999,11.6,21,16,9,11,1,13,29,44.8,16,14,6,8,14,35,24,0,Matches
410,Sergio Busquets,ESP,MF,Barcelona,La Liga,34,1988,26.0,58,26,24,26,8,29,51,56.9,22,32,6,26,27,85,36,2,Matches
411,Aurélio Buta,POR,DF,Eint Frankfurt,Bundesliga,25,1997,14.6,33,19,15,13,5,15,27,55.6,12,18,1,17,9,42,34,0,Matches
412,Leonardo Buta,POR,DF,Udinese,Serie A,20,2002,0.2,1,1,0,1,0,0,0,,0,0,0,0,0,1,0,0,Matches
413,Marcin Bułka,POL,GK,Nice,Ligue 1,22,1999,2.0,0,0,0,0,0,0,1,0.0,1,0,0,0,1,1,0,0,Matches
414,Rémy Cabella,FRA,"MF,FW",Lille,Ligue 1,32,1990,28.1,64,37,21,28,15,29,64,45.3,35,41,5,36,17,81,7,1,Matches
415,Jimmy Cabot,FRA,"DF,MF",Lens,Ligue 1,28,1994,5.7,20,12,10,8,2,12,26,46.2,14,5,0,5,4,24,12,0,Matches
416,Arthur Cabral,BRA,FW,Fiorentina,Serie A,24,1998,15.9,9,2,1,4,4,4,8,50.0,4,10,1,9,1,10,12,0,Matches
417,Leandro Cabrera,URU,DF,Espanyol,La Liga,31,1991,29.7,46,24,34,12,0,28,43,65.1,15,37,23,14,43,89,114,2,Matches
418,Liberato Cacace,NZL,DF,Empoli,Serie A,21,2000,6.5,25,10,12,8,5,9,15,60.0,6,15,7,8,4,29,16,0,Matches
419,Anthony Caci,FRA,DF,Mainz 05,Bundesliga,25,1997,22.6,58,33,32,20,6,28,42,66.7,14,28,4,24,54,112,40,0,Matches
420,Cafú,POR,MF,Nott'ham Forest,Premier League,29,1993,0.1,0,0,0,0,0,0,0,,0,0,0,0,0,0,1,0,Matches
421,Moisés Caicedo,ECU,MF,Brighton,Premier League,20,2001,34.9,100,50,41,47,12,40,68,58.8,28,43,7,36,56,156,31,3,Matches
422,Tom Cairney,SCO,MF,Fulham,Premier League,31,1991,11.0,17,6,4,8,5,7,10,70.0,3,18,3,15,5,22,3,0,Matches
423,Jens Cajuste,SWE,MF,Reims,Ligue 1,22,1999,17.0,46,25,25,14,7,25,48,52.1,23,30,6,24,18,64,22,0,Matches
424,Cala,ESP,DF,Cádiz,La Liga,32,1989,1.5,2,1,1,1,0,1,2,50.0,1,2,1,1,1,3,12,0,Matches
425,Davide Calabria,ITA,DF,Milan,Serie A,25,1996,18.8,71,44,31,32,8,38,61,62.3,23,22,7,15,25,96,34,0,Matches
426,Mattia Caldara,ITA,DF,Spezia,Serie A,28,1994,13.9,23,14,10,11,2,9,20,45.0,11,23,16,7,17,40,88,2,Matches
427,Luca Caldirola,ITA,DF,Monza,Serie A,31,1991,26.1,26,14,19,4,3,13,26,50.0,13,32,18,14,25,51,66,1,Matches
428,Fernando Calero,ESP,"DF,MF",Espanyol,La Liga,26,1995,17.9,46,29,27,15,4,21,34,61.8,13,31,13,18,13,59,52,0,Matches
429,Duje Ćaleta-Car,CRO,DF,Southampton,Premier League,25,1996,10.5,14,10,9,4,1,6,9,66.7,3,15,11,4,15,29,65,1,Matches
430,Duje Ćaleta-Car,CRO,DF,Marseille,Ligue 1,25,1996,0.1,0,0,0,0,0,0,0,,0,0,0,0,0,0,1,0,Matches
431,Hakan Çalhanoğlu,TUR,MF,Inter,Serie A,28,1994,26.3,48,27,17,26,5,16,43,37.2,27,30,5,25,25,73,13,1,Matches
432,Kerim Calhanoglu,GER,DF,Schalke 04,Bundesliga,19,2002,0.7,2,1,2,0,0,2,2,100.0,0,1,0,1,0,2,3,0,Matches
433,Daniel Caligiuri,ITA,"DF,MF",Augsburg,Bundesliga,34,1988,3.2,8,5,5,3,0,4,5,80.0,1,3,2,1,3,11,2,0,Matches
434,Alexander Callens,PER,DF,Girona,La Liga,30,1992,1.3,3,3,2,1,0,3,4,75.0,1,3,1,2,1,4,9,0,Matches
435,Dominic Calvert-Lewin,ENG,FW,Everton,Premier League,25,1997,12.9,4,2,1,0,3,1,5,20.0,4,5,1,4,3,7,18,0,Matches
436,Mahdi Camara,FRA,MF,Brest,Ligue 1,24,1998,20.2,63,36,18,38,7,25,43,58.1,18,35,4,31,40,103,16,0,Matches
437,Mohamed Camara,GUI,MF,Roma,Serie A,25,1997,7.7,13,10,3,7,3,5,15,33.3,10,5,1,4,10,23,8,0,Matches
438,Mohamed Camara,MLI,MF,Monaco,Ligue 1,22,2000,24.4,83,45,38,39,6,48,92,52.2,44,45,6,39,27,110,14,1,Matches
439,Ousmane Camara,GUI,"FW,MF",Auxerre,Ligue 1,20,2001,0.3,1,1,0,0,1,0,0,,0,0,0,0,0,1,0,0,Matches
440,Ousmane Camara,FRA,DF,Angers,Ligue 1,19,2003,5.8,10,6,5,5,0,5,12,41.7,7,4,2,2,11,21,15,0,Matches
441,Eduardo Camavinga,FRA,"MF,DF",Real Madrid,La Liga,19,2002,22.3,68,48,32,21,15,24,64,37.5,40,24,5,19,17,85,25,0,Matches
442,Nicolò Cambiaghi,ITA,"FW,MF",Empoli,Serie A,21,2000,14.3,30,22,11,12,7,8,27,29.6,19,19,1,18,9,39,8,0,Matches
443,Andrea Cambiaso,ITA,DF,Bologna,Serie A,22,2000,24.1,57,34,34,20,3,28,65,43.1,37,26,2,24,26,83,33,1,Matches
444,Axel Camblan,FRA,"FW,MF",Brest,Ligue 1,18,2003,0.8,2,2,1,1,0,0,1,0.0,1,0,0,0,0,2,0,0,Matches
445,Sergio Camello,ESP,FW,Rayo Vallecano,La Liga,21,2001,26.7,16,10,3,9,4,5,17,29.4,12,9,1,8,2,18,26,0,Matches
446,Chem Campbell,WAL,"FW,MF",Wolves,Premier League,19,2002,0.8,2,1,1,1,0,0,1,0.0,1,2,0,2,1,3,0,0,Matches
447,Emre Can,GER,MF,Dortmund,Bundesliga,28,1994,21.1,57,28,25,27,5,22,43,51.2,21,16,6,10,25,82,39,1,Matches
448,Sergio Canales,ESP,"FW,MF",Betis,La Liga,31,1991,26.7,25,14,10,8,7,14,33,42.4,19,18,0,18,14,39,8,0,Matches
449,Matteo Cancellieri,ITA,FW,Lazio,Serie A,20,2002,2.8,10,4,5,3,2,5,9,55.6,4,4,0,4,1,11,2,0,Matches
450,João Cancelo,POR,DF,Manchester City,Premier League,28,1994,14.2,29,21,16,9,4,17,24,70.8,7,7,1,6,19,48,9,1,Matches
451,João Cancelo,POR,"DF,FW",Bayern Munich,Bundesliga,28,1994,11.2,23,14,9,10,4,10,23,43.5,13,14,2,12,15,38,22,0,Matches
452,Antonio Candreva,ITA,"MF,DF",Salernitana,Serie A,35,1987,30.3,17,7,13,2,2,11,38,28.9,27,7,3,4,17,34,32,0,Matches
453,Thomas Cannon,IRL,FW,Everton,Premier League,19,2002,0.3,0,0,0,0,0,0,0,,0,0,0,0,0,0,0,0,Matches
454,Sergi Canós,ESP,"FW,DF",Brentford,Premier League,25,1997,0.9,0,0,0,0,0,0,2,0.0,2,3,1,2,0,0,1,0,Matches
455,Ander Capa,ESP,DF,Athletic Club,La Liga,30,1992,1.2,1,1,1,0,0,1,5,20.0,4,5,0,5,0,1,2,0,Matches
456,Pierrick Capelle,FRA,"MF,DF",Angers,Ligue 1,35,1987,15.9,36,21,17,15,4,22,55,40.0,33,24,3,21,15,51,24,0,Matches
457,Étienne Capoue,FRA,MF,Villarreal,La Liga,34,1988,21.7,21,12,6,13,2,10,18,55.6,8,12,5,7,19,40,20,1,Matches
458,Gianluca Caprari,ITA,"MF,FW",Monza,Serie A,29,1993,27.1,16,6,3,11,2,8,26,30.8,18,22,1,21,8,24,3,0,Matches
459,Francesco Caputo,ITA,FW,Sampdoria,Serie A,34,1987,12.2,3,1,0,0,3,0,3,0.0,3,0,0,0,1,4,3,0,Matches
460,Francesco Caputo,ITA,FW,Empoli,Serie A,34,1987,19.0,2,2,0,1,1,0,1,0.0,1,7,2,5,2,4,8,0,Matches
461,Maxence Caqueret,FRA,MF,Lyon,Ligue 1,22,2000,30.7,87,54,27,38,22,43,109,39.4,66,45,3,42,39,126,27,0,Matches
462,Andrea Carboni,ITA,DF,Monza,Serie A,21,2001,1.9,3,2,2,0,1,2,5,40.0,3,3,2,1,3,6,2,1,Matches
463,Franco Carboni,ITA,"DF,FW",Monza,Serie A,19,2003,0.7,1,1,1,0,0,0,2,0.0,2,3,0,3,1,2,0,0,Matches
464,Valentin Carboni,ARG,"MF,DF",Inter,Serie A,17,2005,0.3,1,1,0,1,0,1,3,33.3,2,1,0,1,0,1,0,0,Matches
465,Isaac Carcelen,ESP,DF,Cádiz,La Liga,29,1993,24.4,69,51,41,22,6,41,63,65.1,22,35,11,24,19,88,80,1,Matches
466,Irvin Cardona,FRA,"FW,MF",Brest,Ligue 1,24,1997,2.6,2,0,1,1,0,0,3,0.0,3,3,0,3,2,4,2,0,Matches
467,Irvin Cardona,FRA,"MF,FW",Augsburg,Bundesliga,24,1997,3.5,1,1,1,0,0,1,5,20.0,4,3,0,3,4,5,8,0,Matches
468,Igor Carioca,BRA,DF,Lorient,Ligue 1,25,1996,5.1,18,11,12,2,4,12,21,57.1,9,7,0,7,5,23,17,0,Matches
469,Diego Carlos,BRA,DF,Aston Villa,Premier League,29,1993,2.3,1,0,0,1,0,0,1,0.0,1,2,2,0,1,2,2,0,Matches
470,Juan Carlos,ESP,GK,Girona,La Liga,34,1988,10.0,0,0,0,0,0,0,0,,0,0,0,0,1,1,7,1,Matches
471,José Carlos Lazo,ESP,"MF,FW",Almería,La Liga,26,1996,0.2,0,0,0,0,0,0,0,,0,0,0,0,0,0,0,0,Matches
472,José Carlos Lazo,ESP,"MF,FW",Espanyol,La Liga,26,1996,1.8,5,3,2,2,1,3,3,100.0,0,2,0,2,3,8,5,0,Matches
473,Carmona,ESP,"MF,DF",Elche,La Liga,20,2002,6.5,16,9,7,6,3,6,16,37.5,10,14,2,12,8,24,9,0,Matches
474,Carmona,ESP,DF,Sevilla,La Liga,20,2002,5.9,13,11,5,3,5,9,16,56.3,7,10,6,4,7,20,17,1,Matches
475,Marco Carnesecchi,ITA,GK,Cremonese,Serie A,22,2000,27.0,1,1,1,0,0,1,2,50.0,1,0,0,0,0,1,11,2,Matches
476,Yannick Carrasco,BEL,"DF,MF",Atlético Madrid,La Liga,28,1993,25.7,35,14,21,10,4,23,54,42.6,31,23,1,22,12,47,19,0,Matches
477,Dani Carvajal,ESP,DF,Real Madrid,La Liga,30,1992,19.8,32,18,15,12,5,18,35,51.4,17,24,6,18,15,47,49,0,Matches
478,Fabio Carvalho,POR,"MF,FW",Liverpool,Premier League,19,2002,3.9,8,8,3,3,2,3,6,50.0,3,6,0,6,6,14,0,0,Matches
479,Matis Carvalho,POR,GK,Montpellier,Ligue 1,23,1999,1.5,0,0,0,0,0,0,0,,0,0,0,0,1,1,0,0,Matches
480,William Carvalho,POR,MF,Betis,La Liga,30,1992,27.1,43,27,18,23,2,17,44,38.6,27,27,6,21,16,59,22,0,Matches
481,Nicolò Casale,ITA,DF,Lazio,Serie A,24,1998,27.1,42,20,28,14,0,22,34,64.7,12,25,17,8,17,59,73,1,Matches
482,Casemiro,BRA,MF,Manchester Utd,Premier League,30,1992,23.6,88,46,43,35,10,47,92,51.1,45,49,11,38,34,122,64,0,Matches
483,Casemiro,BRA,MF,Real Madrid,La Liga,30,1992,0.1,0,0,0,0,0,0,0,,0,0,0,0,0,0,1,0,Matches
484,Matty Cash,POL,DF,Aston Villa,Premier League,24,1997,20.2,55,32,36,15,4,26,37,70.3,11,20,5,15,26,81,43,0,Matches
485,Tommaso Cassandro,ITA,DF,Lecce,Serie A,22,2000,0.1,1,1,0,1,0,0,0,,0,1,1,0,0,1,0,0,Matches
486,Timothy Castagne,BEL,DF,Leicester City,Premier League,26,1995,36.2,87,44,53,27,7,41,84,48.8,43,50,13,37,43,130,110,0,Matches
487,Michele Castagnetti,ITA,MF,Cremonese,Serie A,32,1989,15.7,46,21,20,24,2,18,54,33.3,36,14,4,10,15,61,22,0,Matches
488,Koen Casteels,BEL,GK,Wolfsburg,Bundesliga,30,1992,34.0,0,0,0,0,0,0,0,,0,0,0,0,1,1,10,1,Matches
489,Valentín Castellanos,ARG,FW,Girona,La Liga,23,1998,28.9,12,5,2,7,3,0,18,0.0,18,22,2,20,6,18,26,0,Matches
490,Jean-Charles Castelletto,CMR,DF,Nantes,Ligue 1,27,1995,28.5,43,26,29,12,2,22,36,61.1,14,35,22,13,58,101,90,0,Matches
491,Samu Castillejo,ESP,"FW,MF",Valencia,La Liga,27,1995,15.1,21,12,8,9,4,8,40,20.0,32,21,2,19,9,30,2,0,Matches
492,Jonny Castro,ESP,DF,Wolves,Premier League,28,1994,14.0,33,15,22,10,1,17,38,44.7,21,26,5,21,14,47,28,2,Matches
493,Gaetano Castrovilli,ITA,MF,Fiorentina,Serie A,25,1997,8.0,10,8,1,7,2,2,9,22.2,7,5,1,4,8,18,5,0,Matches
494,Danilo Cataldi,ITA,MF,Lazio,Serie A,27,1994,21.3,25,16,7,15,3,14,40,35.0,26,23,9,14,24,49,33,0,Matches
495,Catena,ESP,DF,Rayo Vallecano,La Liga,27,1994,34.5,29,14,23,4,2,13,27,48.1,14,32,25,7,28,57,159,1,Matches
496,Yoann Cathline,FRA,"FW,MF",Lorient,Ligue 1,20,2002,12.1,19,12,7,6,6,5,12,41.7,7,10,1,9,8,27,16,1,Matches
497,Maximiliano Caufriez,BEL,DF,Clermont Foot,Ligue 1,25,1997,24.7,40,24,31,8,1,20,28,71.4,8,33,18,15,34,74,70,0,Matches
498,Edinson Cavani,URU,FW,Valencia,La Liga,35,1987,16.1,7,4,3,3,1,3,15,20.0,12,10,3,7,2,9,11,0,Matches
499,Dani Ceballos,ESP,MF,Real Madrid,La Liga,25,1996,17.4,43,29,13,15,15,25,64,39.1,39,23,2,21,25,68,6,1,Matches
500,Pietro Ceccaroni,ITA,DF,Lecce,Serie A,26,1995,0.5,0,0,0,0,0,0,0,,0,1,1,0,3,3,2,0,Matches
501,Federico Ceccherini,ITA,DF,Hellas Verona,Serie A,30,1992,15.7,25,19,15,9,1,13,23,56.5,10,17,10,7,19,44,55,0,Matches
502,Assan Ceesay,GAM,FW,Lecce,Serie A,28,1994,20.1,23,18,7,8,8,9,17,52.9,8,15,2,13,3,26,24,0,Matches
503,Emil Ceide,NOR,FW,Sassuolo,Serie A,20,2001,5.7,5,2,5,0,0,3,5,60.0,2,3,1,2,1,6,0,0,Matches
504,Zeki Çelik,TUR,DF,Roma,Serie A,25,1997,16.7,42,21,19,21,2,24,41,58.5,17,33,6,27,14,56,36,2,Matches
505,Álex Centelles,ESP,DF,Almería,La Liga,24,1997,12.5,22,14,16,3,3,16,22,72.7,6,13,2,11,11,33,40,0,Matches
506,Fabien Centonze,FRA,DF,Nantes,Ligue 1,26,1996,18.8,58,37,30,22,6,30,42,71.4,12,24,7,17,44,102,55,1,Matches
507,Michele Cerofolini,ITA,GK,Fiorentina,Serie A,23,1999,5.0,0,0,0,0,0,0,0,,0,0,0,0,1,1,2,0,Matches
508,Franco Cervi,ARG,"MF,DF",Celta Vigo,La Liga,28,1994,21.0,76,46,29,36,11,33,66,50.0,33,33,1,32,36,112,16,0,Matches
509,Julian Chabot,GER,DF,Köln,Bundesliga,24,1998,20.0,36,23,19,14,3,20,35,57.1,15,30,18,12,41,77,105,0,Matches
510,Florian Chabrolle,FRA,MF,Ajaccio,Ligue 1,24,1998,3.7,6,4,1,5,0,2,4,50.0,2,3,0,3,7,13,2,0,Matches
511,El Chadaille Bitshiabu,FRA,DF,Paris S-G,Ligue 1,17,2005,6.5,10,7,7,2,1,3,12,25.0,9,9,7,2,9,19,13,3,Matches
512,Fares Chaïbi,ALG,"FW,MF",Toulouse,Ligue 1,19,2002,26.0,31,18,8,15,8,17,50,34.0,33,38,5,33,19,50,36,1,Matches
513,Nathaniel Chalobah,ENG,MF,Fulham,Premier League,27,1994,0.1,1,1,1,0,0,1,1,100.0,0,0,0,0,0,1,2,0,Matches
514,Trevoh Chalobah,ENG,DF,Chelsea,Premier League,23,1999,17.9,31,20,22,6,3,24,35,68.6,11,17,7,10,24,55,56,1,Matches
515,Muhammed Cham,AUT,MF,Clermont Foot,Ligue 1,21,2000,21.9,30,15,15,4,11,13,35,37.1,22,13,0,13,7,37,5,0,Matches
516,Calum Chambers,ENG,"DF,MF",Aston Villa,Premier League,27,1995,3.9,9,6,7,2,0,6,8,75.0,2,5,4,1,7,16,10,1,Matches
517,Timothy Chandler,USA,DF,Eint Frankfurt,Bundesliga,32,1990,1.0,2,2,2,0,0,2,2,100.0,0,1,0,1,0,2,3,0,Matches
518,Gaëtan Charbonnier,FRA,"FW,MF",Auxerre,Ligue 1,33,1988,2.8,2,1,0,2,0,0,4,0.0,4,2,0,2,0,2,5,0,Matches
519,Brendan Chardonnet,FRA,DF,Brest,Ligue 1,27,1994,27.7,45,27,27,18,0,20,38,52.6,18,40,19,21,63,108,86,1,Matches
520,Shea Charles,NIR,DF,Manchester City,Premier League,18,2003,0.3,4,0,4,0,0,1,1,100.0,0,0,0,0,1,5,2,0,Matches
521,Xavier Chavalerin,FRA,MF,Troyes,Ligue 1,31,1991,27.0,82,50,39,30,13,27,71,38.0,44,31,8,23,41,123,24,0,Matches
522,Pep Chavarría,ESP,"FW,MF",Rayo Vallecano,La Liga,24,1998,4.1,6,4,2,1,3,1,5,20.0,4,8,0,8,2,8,8,0,Matches
523,Ivane Chegra,FRA,"MF,FW",Ajaccio,Ligue 1,18,2004,2.1,8,3,6,1,1,4,11,36.4,7,0,0,0,1,9,0,0,Matches
524,Pape Cheikh Diop,SEN,MF,Elche,La Liga,24,1997,0.4,0,0,0,0,0,0,1,0.0,1,0,0,0,0,0,0,0,Matches
525,Rayan Cherki,FRA,"MF,FW",Lyon,Ligue 1,18,2003,20.8,14,8,2,5,7,8,23,34.8,15,6,0,6,5,19,1,0,Matches
526,Ilyes Cheti,ALG,DF,Angers,Ligue 1,27,1995,2.3,6,4,4,0,2,5,8,62.5,3,5,1,4,4,10,7,0,Matches
527,Lucas Chevalier,FRA,GK,Lille,Ligue 1,20,2001,32.0,2,1,2,0,0,2,2,100.0,0,1,0,1,2,4,7,2,Matches
528,Fabio Chiarodia,ITA,DF,Werder Bremen,Bundesliga,17,2005,0.7,0,0,0,0,0,0,0,,0,1,0,1,2,2,4,0,Matches
529,Federico Chiesa,ITA,"DF,MF",Juventus,Serie A,24,1997,9.5,22,11,6,6,10,5,14,35.7,9,13,1,12,0,22,1,0,Matches
530,Ben Chilwell,ENG,"DF,MF",Chelsea,Premier League,25,1996,15.6,21,17,12,8,1,13,25,52.0,12,21,2,19,18,39,26,0,Matches
531,Vlad Chiricheș,ROU,DF,Cremonese,Serie A,32,1989,10.9,35,20,27,7,1,16,24,66.7,8,36,23,13,22,57,44,0,Matches
532,Pedro Chirivella,ESP,MF,Nantes,Ligue 1,25,1997,22.5,33,22,12,15,6,17,44,38.6,27,24,1,23,20,53,7,0,Matches
533,Joris Chotard,FRA,MF,Montpellier,Ligue 1,20,2001,27.3,64,34,37,23,4,40,78,51.3,38,40,11,29,40,104,42,1,Matches
534,Andreas Christensen,DEN,DF,Barcelona,La Liga,26,1996,19.6,20,15,9,11,0,10,16,62.5,6,14,12,2,21,41,47,0,Matches
535,Oliver Christensen,DEN,GK,Hertha BSC,Bundesliga,23,1999,33.0,1,0,1,0,0,0,2,0.0,2,0,0,0,0,1,22,2,Matches
536,Ryan Christie,SCO,"MF,FW",Bournemouth,Premier League,27,1995,20.4,34,22,10,23,1,14,50,28.0,36,16,4,12,26,60,20,0,Matches
537,Carney Chukwuemeka,ENG,"MF,FW",Chelsea,Premier League,18,2003,3.9,13,7,7,6,0,3,5,60.0,2,7,0,7,6,19,1,0,Matches
538,Samuel Chukwueze,NGA,"FW,MF",Villarreal,La Liga,23,1999,26.0,14,7,7,2,5,7,23,30.4,16,13,0,13,12,26,16,0,Matches
539,Chumi,ESP,DF,Almería,La Liga,23,1999,16.5,29,16,18,9,2,14,23,60.9,9,20,7,13,15,44,53,0,Matches
540,Darko Churlinov,MKD,FW,Stuttgart,Bundesliga,22,2000,0.3,3,2,2,1,0,2,3,66.7,1,1,0,1,0,3,0,0,Matches
541,Víctor Chust,ESP,DF,Cádiz,La Liga,22,2000,10.7,9,6,7,2,0,4,7,57.1,3,8,3,5,10,19,53,0,Matches
542,Tolga Ciğerci,TUR,MF,Hertha BSC,Bundesliga,30,1992,7.5,16,13,6,9,1,10,16,62.5,6,6,2,4,8,24,5,0,Matches
543,Yanis Cimignani,FRA,"MF,DF",Ajaccio,Ligue 1,20,2002,3.1,11,5,3,7,1,4,5,80.0,1,5,1,4,2,13,2,0,Matches
544,Daniel Ciofani,ITA,FW,Cremonese,Serie A,37,1985,11.8,6,3,1,2,3,4,7,57.1,3,7,1,6,2,8,10,0,Matches
545,Tio Cipot,SVN,"FW,MF",Spezia,Serie A,19,2003,1.5,12,7,6,3,3,6,8,75.0,2,0,0,0,0,12,2,0,Matches
546,Pathé Ciss,SEN,"MF,DF",Rayo Vallecano,La Liga,28,1994,14.2,39,29,11,23,5,15,34,44.1,19,23,10,13,22,61,34,0,Matches
547,Souleymane Cissé,FRA,DF,Clermont Foot,Ligue 1,19,2002,0.4,1,1,1,0,0,1,1,100.0,0,1,1,0,1,2,2,0,Matches
548,Patrick Ciurria,ITA,"DF,MF",Monza,Serie A,27,1995,30.6,31,18,20,10,1,17,33,51.5,16,24,2,22,7,38,32,0,Matches
549,Bobby Clark,ENG,MF,Liverpool,Premier League,17,2005,0.1,0,0,0,0,0,0,0,,0,2,0,2,0,0,0,0,Matches
550,Alexis Claude-Maurice,FRA,FW,Nice,Ligue 1,24,1998,0.7,3,2,2,1,0,3,3,100.0,0,0,0,0,2,5,1,0,Matches
551,Alexis Claude-Maurice,FRA,"MF,FW",Lens,Ligue 1,24,1998,6.7,14,9,5,8,1,6,16,37.5,10,6,0,6,2,16,1,0,Matches
552,Jonathan Clauss,FRA,DF,Marseille,Ligue 1,29,1992,28.8,46,28,21,16,9,23,52,44.2,29,29,4,25,31,77,40,2,Matches
553,Carlos Clerc,ESP,"DF,MF",Elche,La Liga,30,1992,29.3,75,51,55,16,4,31,50,62.0,19,29,7,22,28,103,94,1,Matches
554,Nathaniel Clyne,ENG,DF,Crystal Palace,Premier League,31,1991,18.2,27,16,13,9,5,14,23,60.9,9,22,4,18,19,46,34,0,Matches
555,Conor Coady,ENG,DF,Everton,Premier League,29,1993,23.3,14,9,8,6,0,7,15,46.7,8,21,17,4,14,28,88,3,Matches
556,Nicolò Cocetta,ITA,DF,Udinese,Serie A,18,2003,0.4,0,0,0,0,0,0,1,0.0,1,1,1,0,1,1,1,0,Matches
557,Marcus Coco,FRA,"FW,MF",Nantes,Ligue 1,26,1996,7.1,24,15,11,9,4,11,23,47.8,12,13,3,10,14,38,7,0,Matches
558,Alexandre Coeff,FRA,DF,Auxerre,Ligue 1,30,1992,6.5,10,5,6,4,0,4,9,44.4,5,9,4,5,8,18,35,1,Matches
559,Jack Colback,ENG,MF,Nott'ham Forest,Premier League,32,1989,5.5,18,13,12,6,0,5,8,62.5,3,3,0,3,3,21,9,0,Matches
560,Séamus Coleman,IRL,DF,Everton,Premier League,33,1988,18.4,35,26,21,10,4,19,29,65.5,10,14,7,7,22,57,58,2,Matches
561,David Čolina,CRO,"DF,FW",Augsburg,Bundesliga,22,2000,1.8,4,1,1,1,2,2,2,100.0,0,8,0,8,4,8,3,0,Matches
562,Álex Collado,ESP,MF,Elche,La Liga,23,1999,8.1,26,14,13,11,2,8,13,61.5,5,12,1,11,2,28,4,0,Matches
563,Diego Collado,ESP,FW,Villarreal,La Liga,21,2001,0.1,0,0,0,0,0,0,0,,0,0,0,0,0,0,0,0,Matches
564,Omar Colley,GAM,DF,Sampdoria,Serie A,29,1992,15.4,17,10,10,7,0,9,12,75.0,3,9,5,4,22,39,69,1,Matches
565,Nathan Collins,IRL,DF,Wolves,Premier League,21,2001,20.2,27,15,19,8,0,15,24,62.5,9,35,28,7,21,48,84,0,Matches
566,Lorenzo Colombo,ITA,FW,Lecce,Serie A,20,2002,16.8,17,9,1,9,7,6,14,42.9,8,22,0,22,2,19,7,0,Matches
567,Andrea Colpani,ITA,MF,Monza,Serie A,23,1999,10.5,14,9,6,5,3,8,12,66.7,4,14,2,12,3,17,6,0,Matches
568,Levi Colwill,ENG,DF,Brighton,Premier League,19,2003,13.6,8,7,4,4,0,4,9,44.4,5,5,3,2,15,23,37,1,Matches
569,Kingsley Coman,FRA,"FW,MF",Bayern Munich,Bundesliga,26,1996,15.7,11,8,3,5,3,7,17,41.2,10,19,1,18,2,13,7,0,Matches
570,Eray Cömert,SUI,DF,Valencia,La Liga,24,1998,18.6,35,23,24,10,1,17,33,51.5,16,23,8,15,29,64,76,1,Matches
571,Santi Comesaña,ESP,MF,Rayo Vallecano,La Liga,25,1996,27.2,71,44,24,41,6,38,82,46.3,44,39,3,36,32,103,17,0,Matches
572,Andrea Consigli,ITA,GK,Sassuolo,Serie A,35,1987,35.0,1,0,1,0,0,0,1,0.0,1,0,0,0,0,1,13,3,Matches
573,Abdu Conté,POR,DF,Troyes,Ligue 1,24,1998,14.6,25,17,14,8,3,12,22,54.5,10,13,6,7,6,31,25,0,Matches
574,Andrea Conti,ITA,DF,Sampdoria,Serie A,28,1994,0.3,0,0,0,0,0,0,0,,0,0,0,0,0,0,0,0,Matches
575,Lewis Cook,ENG,MF,Bournemouth,Premier League,25,1997,19.1,37,22,10,22,5,18,44,40.9,26,29,10,19,23,60,31,0,Matches
576,Steve Cook,ENG,DF,Nott'ham Forest,Premier League,31,1991,10.6,8,4,4,4,0,5,7,71.4,2,16,11,5,12,20,51,0,Matches
577,Liam Cooper,SCO,DF,Leeds United,Premier League,30,1991,15.8,38,23,27,9,2,23,36,63.9,13,16,8,8,34,72,57,3,Matches
578,Copete,ESP,DF,Mallorca,La Liga,22,1999,24.5,53,28,35,16,2,26,36,72.2,10,38,17,21,44,97,111,2,Matches
579,Diego Coppola,ITA,DF,Hellas Verona,Serie A,18,2003,13.1,25,17,15,10,0,11,24,45.8,13,20,6,14,14,39,38,0,Matches
580,Francis Coquelin,FRA,MF,Villarreal,La Liga,31,1991,8.3,18,13,7,9,2,7,7,100.0,0,8,2,6,9,27,7,0,Matches
581,Sébastien Corchia,FRA,DF,Nantes,Ligue 1,31,1990,8.7,16,6,10,2,4,11,22,50.0,11,9,3,6,14,30,21,0,Matches
582,Alex Cordaz,ITA,GK,Inter,Serie A,39,1983,0.3,0,0,0,0,0,0,0,,0,0,0,0,0,0,0,0,Matches
583,Maxwel Cornet,CIV,FW,West Ham,Premier League,25,1996,2.7,7,3,5,0,2,4,6,66.7,2,6,0,6,2,9,3,0,Matches
584,Jesús Corona,MEX,FW,Sevilla,La Liga,29,1993,1.2,1,0,1,0,0,0,1,0.0,1,0,0,0,1,2,1,0,Matches
585,Ángel Correa,ARG,"FW,MF",Atlético Madrid,La Liga,27,1995,16.2,12,6,6,3,3,5,16,31.3,11,17,0,17,10,22,6,1,Matches
586,Joaquín Correa,ARG,FW,Inter,Serie A,27,1994,10.6,12,7,3,6,3,4,15,26.7,11,4,1,3,3,15,0,0,Matches
587,Thierry Correia,POR,DF,Valencia,La Liga,23,1999,22.3,71,52,46,22,3,31,54,57.4,23,25,2,23,24,95,54,2,Matches
588,Alessandro Cortinovis,ITA,MF,Hellas Verona,Serie A,21,2001,0.1,1,0,1,0,0,0,0,,0,1,0,1,0,1,0,0,Matches
589,Danny da Costa,GER,DF,Mainz 05,Bundesliga,29,1993,13.7,20,16,7,8,5,12,20,60.0,8,22,3,19,9,29,26,0,Matches
590,David Pereira da Costa,POR,"MF,FW",Lens,Ligue 1,21,2001,15.6,13,7,1,10,2,7,19,36.8,12,19,1,18,11,24,6,0,Matches
591,Diego Costa,ESP,FW,Wolves,Premier League,33,1988,13.8,3,1,3,0,0,2,9,22.2,7,6,1,5,2,5,17,0,Matches
592,Jaume Costa,ESP,DF,Mallorca,La Liga,34,1988,28.9,50,34,26,17,7,29,51,56.9,22,13,5,8,22,72,44,1,Matches
593,Logan Costa,CPV,DF,Toulouse,Ligue 1,21,2001,4.6,9,4,7,1,1,6,9,66.7,3,6,3,3,4,13,12,0,Matches
594,Nuno da Costa,CPV,"FW,MF",Auxerre,Ligue 1,31,1991,22.3,45,23,14,23,8,11,46,23.9,35,21,1,20,20,65,15,0,Matches
595,Samu Costa,POR,MF,Almería,La Liga,21,2000,22.1,61,31,35,20,6,29,61,47.5,32,29,7,22,37,98,64,4,Matches
596,Benoît Costil,FRA,GK,Auxerre,Ligue 1,35,1987,19.0,2,0,2,0,0,2,4,50.0,2,0,0,0,0,2,5,0,Matches
597,Vladimír Coufal,CZE,DF,West Ham,Premier League,29,1992,23.7,58,31,37,15,6,36,51,70.6,15,24,6,18,38,96,70,0,Matches
598,Lassana Coulibaly,MLI,MF,Salernitana,Serie A,26,1996,32.1,84,50,42,35,7,30,73,41.1,43,35,7,28,25,109,33,2,Matches
599,Soumaïla Coulibaly,FRA,DF,Dortmund,Bundesliga,18,2003,0.5,0,0,0,0,0,0,0,,0,0,0,0,0,0,0,1,Matches
600,Tanguy Coulibaly,FRA,"FW,DF",Stuttgart,Bundesliga,21,2001,3.6,12,9,9,1,2,5,12,41.7,7,10,0,10,3,15,0,0,Matches
601,Thibaut Courtois,BEL,GK,Real Madrid,La Liga,30,1992,31.0,1,0,1,0,0,1,1,100.0,0,0,0,0,3,4,7,1,Matches
602,Mathieu Coutadeur,FRA,MF,Ajaccio,Ligue 1,36,1986,21.6,23,13,13,10,0,8,28,28.6,20,19,3,16,19,42,21,0,Matches
603,Philippe Coutinho,BRA,"MF,FW",Aston Villa,Premier League,30,1992,8.8,19,14,8,8,3,9,15,60.0,6,11,1,10,4,23,2,0,Matches
604,Yan Couto,BRA,"DF,MF",Girona,La Liga,20,2002,12.9,25,18,11,11,3,12,20,60.0,8,7,2,5,5,30,10,0,Matches
605,Conor Coventry,IRL,"MF,FW",West Ham,Premier League,22,2000,0.0,0,0,0,0,0,0,0,,0,0,0,0,0,0,0,0,Matches
606,Nicolas Cozza,FRA,DF,Montpellier,Ligue 1,23,1999,14.2,38,21,27,9,2,26,38,68.4,12,11,5,6,21,59,35,1,Matches
607,Nicolas Cozza,FRA,DF,Wolfsburg,Bundesliga,23,1999,1.1,3,3,1,2,0,2,3,66.7,1,3,1,2,0,3,0,0,Matches
608,Alessio Cragno,ITA,GK,Monza,Serie A,28,1994,1.0,0,0,0,0,0,0,1,0.0,1,0,0,0,0,0,0,0,Matches
609,Matthew Craig,SCO,MF,Tottenham,Premier League,19,2003,0.2,4,1,2,2,0,0,0,,0,0,0,0,0,4,0,0,Matches
610,Aaron Cresswell,ENG,DF,West Ham,Premier League,32,1989,24.8,21,11,12,7,2,12,31,38.7,19,21,11,10,27,48,56,0,Matches
611,Bryan Cristante,ITA,"MF,DF",Roma,Serie A,27,1995,32.6,113,62,55,49,9,55,90,61.1,35,39,10,29,18,131,53,0,Matches
612,Domen Črnigoj,SVN,MF,Salernitana,Serie A,26,1995,3.3,8,3,0,7,1,1,2,50.0,1,9,1,8,9,17,6,0,Matches
613,Juan Cruz Armada,ESP,DF,Osasuna,La Liga,30,1992,22.9,24,14,17,4,3,13,23,56.5,10,21,8,13,13,37,58,0,Matches
614,Juan Cruz,ESP,FW,Betis,La Liga,22,2000,2.0,1,0,0,1,0,1,3,33.3,2,1,0,1,0,1,0,0,Matches
615,Juan Cuadrado,COL,"DF,FW",Juventus,Serie A,34,1988,23.1,50,34,34,13,3,27,65,41.5,38,15,2,13,24,74,32,0,Matches
616,Marc Cucurella,ESP,DF,Chelsea,Premier League,24,1998,18.6,66,33,40,15,11,30,60,50.0,30,28,8,20,16,82,48,1,Matches
617,Jorge Cuenca,ESP,DF,Villarreal,La Liga,22,1999,5.6,9,7,7,2,0,4,7,57.1,3,10,8,2,6,15,44,0,Matches
618,Braian Cufré,ARG,DF,Mallorca,La Liga,25,1996,2.4,5,2,2,1,2,2,5,40.0,3,2,1,1,2,7,1,0,Matches
619,Mickaël Cuisance,FRA,MF,Sampdoria,Serie A,22,1999,6.9,13,10,7,5,1,5,23,21.7,18,10,0,10,5,18,4,0,Matches
620,Matheus Cunha,BRA,FW,Wolves,Premier League,23,1999,10.7,7,4,0,5,2,2,10,20.0,8,15,3,12,9,16,11,0,Matches
621,Matheus Cunha,BRA,"FW,MF",Atlético Madrid,La Liga,23,1999,4.2,4,1,1,3,0,0,3,0.0,3,4,1,3,2,6,3,0,Matches
622,Curro,ESP,MF,Almería,La Liga,26,1996,0.5,2,0,1,1,0,1,2,50.0,1,0,0,0,0,2,0,0,Matches
623,Marco D'Alessandro,ITA,"DF,FW",Monza,Serie A,31,1991,3.2,4,4,3,1,0,2,5,40.0,3,2,0,2,1,5,3,0,Matches
624,Danilo D'Ambrosio,ITA,DF,Inter,Serie A,33,1988,8.1,25,17,17,7,1,15,27,55.6,12,12,4,8,10,35,17,0,Matches
625,Luca D'Andrea,ITA,FW,Sassuolo,Serie A,17,2004,3.5,4,0,2,1,1,1,4,25.0,3,2,0,2,1,5,1,0,Matches
626,Damien Da Silva,FRA,DF,Lyon,Ligue 1,34,1988,3.8,8,7,5,3,0,3,3,100.0,0,4,3,1,5,13,12,0,Matches
627,Moanes Dabbur,ISR,FW,Hoffenheim,Bundesliga,30,1992,10.4,11,8,4,5,2,3,9,33.3,6,8,0,8,5,16,0,0,Matches
628,Andréa Dacourt,FRA,MF,Nice,Ligue 1,17,2005,0.0,0,0,0,0,0,0,0,,0,0,0,0,0,0,0,0,Matches
629,Colin Dagba,FRA,"DF,MF",Strasbourg,Ligue 1,23,1998,10.6,32,20,17,10,5,19,26,73.1,7,18,2,16,17,49,19,0,Matches
630,Finn Dahmen,GER,GK,Mainz 05,Bundesliga,24,1998,8.0,0,0,0,0,0,0,0,,0,0,0,0,0,0,3,0,Matches
631,Mahmoud Dahoud,GER,MF,Dortmund,Bundesliga,26,1996,3.7,11,9,3,4,4,7,7,100.0,0,6,2,4,7,18,3,0,Matches
632,Patson Daka,ZAM,FW,Leicester City,Premier League,23,1998,13.2,14,8,6,8,0,3,13,23.1,10,14,2,12,7,21,7,0,Matches
633,Thijs Dallinga,NED,FW,Toulouse,Ligue 1,21,2000,26.1,8,6,2,2,4,1,13,7.7,12,17,3,14,3,11,20,0,Matches
634,Diogo Dalot,POR,DF,Manchester Utd,Premier League,23,1999,23.9,54,41,40,13,1,33,45,73.3,12,25,7,18,37,91,55,2,Matches
635,Muhammed Damar,GER,MF,Hoffenheim,Bundesliga,18,2004,1.8,6,3,1,2,3,1,2,50.0,1,3,0,3,0,6,0,0,Matches
636,Mikkel Damsgaard,DEN,"MF,FW",Brentford,Premier League,22,2000,11.0,31,21,13,13,5,15,42,35.7,27,20,2,18,10,41,14,0,Matches
637,Flavius Daniliuc,AUT,DF,Salernitana,Serie A,21,2001,24.4,57,29,37,17,3,26,47,55.3,21,30,13,17,29,86,76,0,Matches
638,Flavius Daniliuc,AUT,DF,Nice,Ligue 1,21,2001,1.0,2,0,2,0,0,1,1,100.0,0,4,1,3,0,2,1,0,Matches
639,Danilo,BRA,MF,Nott'ham Forest,Premier League,21,2001,10.8,18,7,7,9,2,6,25,24.0,19,26,6,20,9,27,19,0,Matches
640,Danilo,BRA,DF,Juventus,Serie A,31,1991,35.4,92,62,61,23,8,52,73,71.2,21,39,20,19,47,139,114,1,Matches
641,Arnaut Danjuma,NED,"FW,MF",Tottenham,Premier League,25,1997,1.9,2,0,1,1,0,0,0,,0,1,0,1,0,2,0,0,Matches
642,Arnaut Danjuma,NED,FW,Villarreal,La Liga,25,1997,5.3,3,3,1,0,2,1,2,50.0,1,0,0,0,0,3,1,1,Matches
643,Kévin Danois,FRA,MF,Auxerre,Ligue 1,18,2004,0.0,1,1,0,1,0,0,0,,0,0,0,0,1,2,0,0,Matches
644,Kevin Danso,AUT,DF,Lens,Ligue 1,23,1998,35.9,37,19,25,11,1,19,30,63.3,11,48,34,14,33,70,124,0,Matches
645,Dante,BRA,DF,Nice,Ligue 1,38,1983,36.7,70,40,45,21,4,36,59,61.0,23,52,31,21,47,117,125,2,Matches
646,Márton Dárdai,HUN,"DF,MF",Hertha BSC,Bundesliga,20,2002,10.5,17,8,9,8,0,9,18,50.0,9,14,9,5,11,28,45,1,Matches
647,Sergi Darder,ESP,MF,Espanyol,La Liga,28,1993,36.9,69,38,12,43,14,29,73,39.7,44,34,2,32,24,93,23,0,Matches
648,Achraf Dari,MAR,DF,Brest,Ligue 1,23,1999,14.6,21,14,15,5,1,14,20,70.0,6,16,10,6,19,40,65,2,Matches
649,Vladimír Darida,CZE,MF,Hertha BSC,Bundesliga,31,1990,0.3,1,1,0,1,0,0,0,,0,1,0,1,0,1,0,0,Matches
650,Matteo Darmian,ITA,DF,Inter,Serie A,32,1989,22.5,56,30,29,15,12,31,47,66.0,16,33,5,28,21,77,36,0,Matches
651,Josh Dasilva,ENG,MF,Brentford,Premier League,23,1998,15.4,18,9,6,6,6,6,16,37.5,10,22,6,16,5,23,7,1,Matches
652,David Datro Fofana,CIV,FW,Chelsea,Premier League,19,2002,0.8,3,1,1,1,1,1,1,100.0,0,1,0,1,0,3,0,0,Matches
653,Juan David Cabal,COL,DF,Hellas Verona,Serie A,21,2001,4.9,10,6,7,3,0,7,12,58.3,5,8,5,3,13,23,12,0,Matches
654,Jonathan David,CAN,FW,Lille,Ligue 1,22,2000,35.2,24,17,6,11,7,10,27,37.0,17,20,2,18,8,32,13,0,Matches
655,Alphonso Davies,CAN,DF,Bayern Munich,Bundesliga,21,2000,22.7,45,28,25,13,7,18,39,46.2,21,28,4,24,24,69,24,4,Matches
656,Ben Davies,WAL,DF,Tottenham,Premier League,29,1993,25.4,28,11,13,13,2,14,26,53.8,12,17,8,9,18,46,72,0,Matches
657,Tom Davies,ENG,MF,Everton,Premier League,24,1998,6.0,15,9,5,9,1,7,14,50.0,7,10,1,9,4,19,7,1,Matches
658,Paweł Dawidowicz,POL,DF,Hellas Verona,Serie A,27,1995,18.1,48,31,28,17,3,22,31,71.0,9,14,9,5,23,71,71,0,Matches
659,Craig Dawson,ENG,DF,West Ham,Premier League,32,1990,8.0,11,7,9,2,0,5,7,71.4,2,9,6,3,6,17,26,0,Matches
660,Craig Dawson,ENG,DF,Wolves,Premier League,32,1990,15.7,9,6,6,3,0,4,7,57.1,3,31,23,8,12,21,74,2,Matches
661,Kevin De Bruyne,BEL,MF,Manchester City,Premier League,31,1991,26.9,28,12,3,12,13,14,39,35.9,25,27,2,25,9,37,10,0,Matches
662,Charles De Ketelaere,BEL,"MF,FW",Milan,Serie A,21,2001,12.4,26,12,7,14,5,13,30,43.3,17,14,2,12,4,30,9,0,Matches
663,Manuel De Luca,ITA,"FW,MF",Sampdoria,Serie A,24,1998,0.5,0,0,0,0,0,0,0,,0,0,0,0,0,0,0,0,Matches
664,Tommaso De Nipoti,ITA,MF,Atalanta,Serie A,19,2003,0.0,1,0,0,1,0,0,0,,0,0,0,0,0,1,0,0,Matches
665,Rodrigo De Paul,ARG,MF,Atlético Madrid,La Liga,28,1994,21.4,35,21,11,18,6,18,35,51.4,17,20,3,17,8,43,7,0,Matches
666,Mattia De Sciglio,ITA,DF,Juventus,Serie A,29,1992,11.6,14,7,8,3,3,9,14,64.3,5,9,3,6,4,18,20,0,Matches
667,Lorenzo De Silvestri,ITA,DF,Bologna,Serie A,34,1988,7.5,3,2,2,0,1,3,7,42.9,4,6,5,1,3,6,20,0,Matches
668,Thibault De Smet,BEL,DF,Reims,Ligue 1,24,1998,19.5,24,17,10,14,0,11,37,29.7,26,28,5,23,20,44,40,1,Matches
669,Koni De Winter,BEL,DF,Empoli,Serie A,20,2002,11.4,14,9,11,3,0,5,13,38.5,8,14,12,2,6,20,65,0,Matches
670,Grégoire Defrel,MTQ,FW,Sassuolo,Serie A,31,1991,13.0,9,7,5,2,2,4,13,30.8,9,11,0,11,2,11,5,0,Matches
671,Duccio Degl'Innocenti,ITA,MF,Empoli,Serie A,19,2003,0.0,0,0,0,0,0,0,0,,0,0,0,0,1,1,0,0,Matches
672,Brecht Dejaegere,BEL,MF,Toulouse,Ligue 1,31,1991,20.1,40,23,10,20,10,15,51,29.4,36,25,5,20,14,54,11,0,Matches
673,Romain Del Castillo,FRA,"MF,FW",Brest,Ligue 1,26,1996,15.8,39,24,13,17,9,16,36,44.4,20,14,1,13,11,50,5,0,Matches
674,Alberto Del Moral,ESP,MF,Villarreal,La Liga,22,2000,0.1,0,0,0,0,0,0,0,,0,0,0,0,0,0,0,0,Matches
675,Thomas Delaine,FRA,"DF,MF",Strasbourg,Ligue 1,30,1992,11.9,28,14,16,6,6,13,26,50.0,13,8,3,5,16,44,9,0,Matches
676,Thomas Delaney,DEN,MF,Sevilla,La Liga,30,1991,3.4,4,2,0,4,0,3,5,60.0,2,3,2,1,4,8,3,0,Matches
677,Thomas Delaney,DEN,MF,Hoffenheim,Bundesliga,30,1991,3.3,6,3,3,2,1,3,8,37.5,5,5,0,5,1,7,4,0,Matches
678,Sacha Delaye,FRA,"FW,MF",Montpellier,Ligue 1,20,2002,0.2,1,0,0,0,1,1,1,100.0,0,0,0,0,0,1,0,0,Matches
679,Fran Delgado,ESP,DF,Betis,La Liga,21,2001,0.1,0,0,0,0,0,0,0,,0,0,0,0,0,0,0,0,Matches
680,Andy Delort,ALG,FW,Nice,Ligue 1,30,1991,8.7,2,0,1,1,0,1,2,50.0,1,0,0,0,1,3,7,0,Matches
681,Andy Delort,ALG,FW,Nantes,Ligue 1,30,1991,5.2,5,4,1,2,2,2,6,33.3,4,3,0,3,0,5,2,0,Matches
682,Karamoko Dembélé,ENG,"FW,MF",Brest,Ligue 1,19,2003,2.0,2,0,1,1,0,2,2,100.0,0,1,0,1,1,3,0,0,Matches
683,Moussa Dembélé,FRA,"FW,MF",Lyon,Ligue 1,26,1996,9.7,8,4,3,3,2,4,7,57.1,3,5,0,5,2,10,6,0,Matches
684,Ousmane Dembélé,FRA,FW,Barcelona,La Liga,25,1997,15.7,19,12,4,8,7,4,15,26.7,11,10,1,9,0,19,2,0,Matches
685,Siriki Dembélé,CIV,"FW,MF",Bournemouth,Premier League,25,1996,1.2,3,1,2,1,0,0,1,0.0,1,1,0,1,1,4,1,0,Matches
686,Siriki Dembélé,CIV,"MF,FW",Auxerre,Ligue 1,25,1996,4.1,10,6,4,3,3,4,12,33.3,8,2,0,2,1,11,2,0,Matches
687,Merih Demiral,TUR,DF,Atalanta,Serie A,24,1998,17.1,41,29,30,11,0,26,36,72.2,10,24,7,17,24,65,57,1,Matches
688,Kerem Demirbay,GER,MF,Leverkusen,Bundesliga,29,1993,17.2,36,18,16,17,3,18,34,52.9,16,26,6,20,16,52,11,0,Matches
689,Ermedin Demirović,BIH,"FW,MF",Augsburg,Bundesliga,24,1998,26.3,31,14,9,12,10,9,22,40.9,13,31,4,27,14,45,37,0,Matches
690,Diego Demme,GER,MF,Napoli,Serie A,30,1991,1.6,1,0,1,0,0,0,4,0.0,4,2,0,2,0,1,1,0,Matches
691,Sepp van den Berg,NED,DF,Schalke 04,Bundesliga,20,2001,7.7,5,4,2,2,1,1,4,25.0,3,8,5,3,13,18,33,2,Matches
692,Branco van den Boomen,NED,MF,Toulouse,Ligue 1,27,1995,32.1,71,36,26,32,13,36,89,40.4,53,27,4,23,10,81,27,2,Matches
693,Leander Dendoncker,BEL,MF,Aston Villa,Premier League,27,1995,7.7,19,9,11,6,2,11,22,50.0,11,19,4,15,10,29,12,0,Matches
694,Leander Dendoncker,BEL,MF,Wolves,Premier League,27,1995,2.4,4,2,0,3,1,2,3,66.7,1,2,0,2,9,13,4,0,Matches
695,Emmanuel Dennis,NGA,"FW,MF",Nott'ham Forest,Premier League,24,1997,8.0,17,11,5,5,7,8,18,44.4,10,13,1,12,2,19,6,0,Matches
696,Fabio Depaoli,ITA,DF,Hellas Verona,Serie A,25,1997,24.1,48,28,25,16,7,25,44,56.8,19,32,6,26,18,66,33,3,Matches
697,Fabio Depaoli,ITA,"DF,MF",Sampdoria,Serie A,25,1997,1.5,5,3,2,3,0,3,4,75.0,1,1,0,1,1,6,4,0,Matches
698,Kastriot Dermaku,ALB,DF,Lecce,Serie A,30,1992,0.4,0,0,0,0,0,0,0,,0,0,0,0,0,0,0,0,Matches
699,Halil Dervişoğlu,TUR,MF,Brentford,Premier League,22,1999,0.1,0,0,0,0,0,0,1,0.0,1,0,0,0,0,0,0,0,Matches
700,Rémy Descamps,FRA,GK,Nantes,Ligue 1,26,1996,1.0,0,0,0,0,0,0,0,,0,0,0,0,0,0,0,0,Matches
701,Mikkel Desler,DEN,DF,Toulouse,Ligue 1,27,1995,25.1,71,38,36,27,8,43,67,64.2,24,35,6,29,36,107,48,2,Matches
702,Cyriel Dessers,NGA,FW,Cremonese,Serie A,27,1994,17.6,11,4,4,4,3,2,6,33.3,4,14,2,12,3,14,5,0,Matches
703,Sergiño Dest,USA,DF,Milan,Serie A,21,2000,3.7,12,6,3,5,4,3,4,75.0,1,1,0,1,4,16,2,0,Matches
704,Mattia Destro,ITA,"FW,MF",Empoli,Serie A,31,1991,6.4,1,1,0,1,0,0,0,,0,2,0,2,1,2,5,0,Matches
705,Gerard Deulofeu,ESP,FW,Udinese,Serie A,28,1994,13.5,8,5,5,1,2,5,15,33.3,10,8,1,7,2,10,1,0,Matches
706,Kiernan Dewsbury-Hall,ENG,MF,Leicester City,Premier League,23,1998,25.6,53,29,14,34,5,19,47,40.4,28,55,13,42,28,81,21,0,Matches
707,Samuel Di Carmine,ITA,"FW,MF",Cremonese,Serie A,33,1988,0.3,0,0,0,0,0,0,0,,0,0,0,0,0,0,0,0,Matches
708,Federico Di Francesco,ITA,"FW,MF",Lecce,Serie A,28,1994,22.6,28,16,7,11,10,9,19,47.4,10,16,0,16,8,36,14,0,Matches
709,Michele Di Gregorio,ITA,GK,Monza,Serie A,25,1997,37.0,0,0,0,0,0,0,3,0.0,3,1,0,1,4,4,18,3,Matches
710,Giovanni Di Lorenzo,ITA,DF,Napoli,Serie A,28,1993,36.2,60,29,33,19,8,25,49,51.0,24,30,9,21,30,90,60,0,Matches
711,Ángel Di María,ARG,"FW,MF",Juventus,Serie A,34,1988,15.1,10,5,3,5,2,3,19,15.8,16,15,0,15,7,17,0,0,Matches
712,Boulaye Dia,SEN,"FW,MF",Salernitana,Serie A,25,1996,28.0,12,5,3,6,3,2,7,28.6,5,10,0,10,7,19,27,1,Matches
713,Moussa Diaby,FRA,"FW,MF",Leverkusen,Bundesliga,23,1999,30.0,14,8,4,8,2,7,14,50.0,7,8,0,8,5,19,3,0,Matches
714,Mouctar Diakhaby,GUI,DF,Valencia,La Liga,25,1996,27.2,30,16,19,11,0,13,20,65.0,7,30,17,13,20,50,111,2,Matches
715,Mamadou Diakhon,FRA,FW,Reims,Ligue 1,16,2005,0.2,2,0,2,0,0,0,1,0.0,1,1,0,1,1,3,0,0,Matches
716,Bafodé Diakité,FRA,DF,Lille,Ligue 1,21,2001,29.5,54,35,23,24,7,32,57,56.1,25,37,8,29,17,71,58,0,Matches
717,Ibrahim Diakité,GUI,DF,Reims,Ligue 1,18,2003,1.5,3,3,3,0,0,2,3,66.7,1,0,0,0,5,8,6,0,Matches
718,Abdou Diallo,SEN,"DF,MF",RB Leipzig,Bundesliga,26,1996,5.3,6,5,5,1,0,1,3,33.3,2,8,5,3,8,14,22,0,Matches
719,Baila Diallo,FRA,"DF,MF",Clermont Foot,Ligue 1,21,2001,1.0,1,0,1,0,0,0,0,,0,1,1,0,0,1,1,0,Matches
720,Habib Diallo,SEN,FW,Strasbourg,Ligue 1,27,1995,32.0,18,10,8,7,3,6,16,37.5,10,19,4,15,12,30,26,0,Matches
721,Ibrahima Diallo,FRA,MF,Southampton,Premier League,23,1999,9.1,25,15,14,10,1,8,14,57.1,6,11,1,10,6,31,11,0,Matches
722,Ismael Diallo,CIV,DF,Ajaccio,Ligue 1,25,1997,24.2,46,33,35,9,2,35,63,55.6,28,26,12,14,30,76,46,1,Matches
723,Habib Diarra,SEN,"MF,FW",Strasbourg,Ligue 1,18,2004,18.1,24,16,10,11,3,15,29,51.7,14,17,1,16,11,35,13,0,Matches
724,Mamady Diarra,MLI,"MF,DF",Cádiz,La Liga,22,2000,0.7,2,1,2,0,0,1,2,50.0,1,2,0,2,0,2,0,0,Matches
725,Moussa Diarra,MLI,DF,Toulouse,Ligue 1,21,2000,13.6,20,9,9,9,2,9,15,60.0,6,25,10,15,19,39,27,1,Matches
726,Stéphane Diarra,FRA,"FW,MF",Lorient,Ligue 1,23,1998,11.8,25,17,14,9,2,11,29,37.9,18,13,1,12,22,47,9,0,Matches
727,Youba Diarra,MLI,MF,Cádiz,La Liga,24,1998,1.1,3,0,2,1,0,1,5,20.0,4,7,1,6,2,5,3,0,Matches
728,Rúben Dias,POR,DF,Manchester City,Premier League,25,1997,22.2,21,13,10,10,1,11,18,61.1,7,21,13,8,18,39,56,1,Matches
729,Krépin Diatta,SEN,"MF,FW",Monaco,Ligue 1,23,1999,23.0,30,21,4,17,9,13,32,40.6,19,29,1,28,17,47,12,0,Matches
730,Mory Diaw,SEN,GK,Clermont Foot,Ligue 1,29,1993,37.0,0,0,0,0,0,0,4,0.0,4,0,0,0,2,2,13,5,Matches
731,Brahim Díaz,MAR,"MF,FW",Milan,Serie A,22,1999,21.4,32,15,5,22,5,5,15,33.3,10,11,0,11,7,39,6,0,Matches
732,Luis Díaz,COL,FW,Liverpool,Premier League,25,1997,11.1,17,11,4,8,5,8,15,53.3,7,8,0,8,6,23,2,0,Matches
733,Justin Diehl,GER,"MF,FW",Köln,Bundesliga,17,2004,0.2,0,0,0,0,0,0,0,,0,0,0,0,0,0,0,0,Matches
734,Bamba Dieng,SEN,"FW,MF",Marseille,Ligue 1,22,2000,2.2,4,4,2,1,1,3,4,75.0,1,5,1,4,0,4,0,0,Matches
735,Bamba Dieng,SEN,FW,Lorient,Ligue 1,22,2000,8.3,19,10,5,12,2,3,11,27.3,8,6,0,6,2,21,6,0,Matches
736,Eric Dier,ENG,DF,Tottenham,Premier League,28,1994,31.3,30,19,16,12,2,9,19,47.4,10,41,24,17,35,65,112,2,Matches
737,Florian Dietz,GER,FW,Köln,Bundesliga,23,1998,4.4,2,1,0,2,0,1,4,25.0,3,4,1,3,0,2,2,0,Matches
738,Lucas Digne,FRA,DF,Aston Villa,Premier League,29,1993,16.7,30,12,20,9,1,20,33,60.6,13,18,5,13,18,48,45,0,Matches
739,Federico Dimarco,ITA,DF,Inter,Serie A,24,1997,23.0,31,25,6,18,7,9,19,47.4,10,15,4,11,18,49,20,0,Matches
740,Stole Dimitrievski,MKD,GK,Rayo Vallecano,La Liga,28,1993,36.9,1,0,1,0,0,1,2,50.0,1,2,0,2,1,2,17,3,Matches
741,Junior Dina Ebimbe,FRA,"DF,MF",Eint Frankfurt,Bundesliga,21,2000,11.8,30,19,16,14,0,16,33,48.5,17,18,5,13,11,41,20,0,Matches
742,Tristan Dingomé,CMR,MF,Troyes,Ligue 1,31,1991,1.1,1,1,0,1,0,0,2,0.0,2,0,0,0,0,1,0,0,Matches
743,Eren Dinkçi,GER,"FW,MF",Werder Bremen,Bundesliga,20,2001,2.6,5,5,2,1,2,2,6,33.3,4,2,0,2,0,5,2,0,Matches
744,Sinaly Diomande,CIV,DF,Lyon,Ligue 1,21,2001,21.7,42,24,26,15,1,31,49,63.3,18,26,13,13,49,91,75,1,Matches
745,Lois Diony,FRA,FW,Angers,Ligue 1,29,1992,5.6,1,0,0,1,0,1,3,33.3,2,2,0,2,0,1,1,0,Matches
746,Edan Diop,FRA,"DF,FW",Monaco,Ligue 1,17,2004,2.5,13,8,3,3,7,7,15,46.7,8,7,1,6,4,17,1,0,Matches
747,Issa Diop,FRA,DF,Fulham,Premier League,25,1997,22.4,28,19,18,9,1,17,32,53.1,15,24,17,7,35,63,86,0,Matches
748,Sofiane Diop,FRA,"MF,FW",Nice,Ligue 1,22,2000,13.6,23,11,12,6,5,7,20,35.0,13,14,2,12,16,39,5,0,Matches
749,Sofiane Diop,FRA,MF,Monaco,Ligue 1,22,2000,0.7,0,0,0,0,0,0,0,,0,0,0,0,1,1,0,0,Matches
750,Yehvann Diouf,FRA,GK,Reims,Ligue 1,22,1999,31.0,2,0,2,0,0,1,3,33.3,2,0,0,0,1,3,13,5,Matches
751,Axel Disasi,FRA,DF,Monaco,Ligue 1,24,1998,37.0,30,20,13,13,4,13,27,48.1,14,51,31,20,56,86,112,2,Matches
752,Tiago Djaló,POR,DF,Lille,Ligue 1,22,2000,22.4,31,21,23,7,1,13,20,65.0,7,17,11,6,23,54,60,1,Matches
753,Djené,TOG,DF,Getafe,La Liga,30,1991,31.6,41,28,23,17,1,22,38,57.9,16,25,10,15,42,83,81,1,Matches
754,Moussa Djenepo,MLI,"DF,FW",Southampton,Premier League,24,1998,7.9,19,11,13,5,1,11,27,40.7,16,19,2,17,11,30,7,0,Matches
755,Koffi Djidji,CIV,DF,Torino,Serie A,29,1992,26.9,50,25,32,17,1,18,32,56.3,14,29,14,15,34,84,72,0,Matches
756,Alexander Djiku,GHA,DF,Strasbourg,Ligue 1,27,1994,29.7,53,36,37,16,0,26,46,56.5,20,45,19,26,66,119,151,3,Matches
757,Berat Djimsiti,ALB,DF,Atalanta,Serie A,29,1993,20.0,34,19,21,13,0,17,25,68.0,8,17,7,10,36,70,74,1,Matches
758,Moussa Djitte,SEN,FW,Ajaccio,Ligue 1,22,1999,1.5,1,0,0,0,1,1,2,50.0,1,0,0,0,0,1,1,0,Matches
759,Ouparine Djoco,GNB,GK,Clermont Foot,Ligue 1,24,1998,1.0,0,0,0,0,0,0,0,,0,0,0,0,0,0,1,0,Matches
760,Marko Dmitrović,SRB,GK,Sevilla,La Liga,30,1992,14.1,0,0,0,0,0,0,0,,0,0,0,0,0,0,6,0,Matches
761,Alan Do Marcolino,GAB,FW,Rennes,Ligue 1,20,2002,0.2,0,0,0,0,0,0,0,,0,0,0,0,0,0,1,0,Matches
762,Ben Doak,SCO,FW,Liverpool,Premier League,16,2005,0.3,3,2,1,2,0,1,1,100.0,0,1,0,1,0,3,0,0,Matches
763,Ritsu Doan,JPN,"MF,FW",Freiburg,Bundesliga,24,1998,26.9,61,29,19,29,13,25,55,45.5,30,40,1,39,14,75,12,0,Matches
764,Dodô,BRA,DF,Fiorentina,Serie A,23,1998,25.9,40,22,20,14,6,22,46,47.8,24,26,2,24,25,65,37,0,Matches
765,Danilho Doekhi,NED,DF,Union Berlin,Bundesliga,24,1998,24.6,38,23,21,17,0,14,26,53.8,12,27,12,15,29,67,93,0,Matches
766,Matt Doherty,IRL,"DF,MF",Tottenham,Premier League,30,1992,7.4,16,10,12,3,1,8,10,80.0,2,11,6,5,8,24,14,1,Matches
767,Matt Doherty,IRL,DF,Atlético Madrid,La Liga,30,1992,0.2,0,0,0,0,0,0,0,,0,2,0,2,0,0,0,0,Matches
768,Josh Doig,SCO,DF,Hellas Verona,Serie A,20,2002,15.0,19,8,6,7,6,6,16,37.5,10,25,6,19,11,30,13,1,Matches
769,Jeremy Doku,BEL,"MF,FW",Rennes,Ligue 1,20,2002,14.3,25,16,6,13,6,12,24,50.0,12,10,0,10,5,30,2,0,Matches
770,Kasper Dolberg,DEN,FW,Sevilla,La Liga,24,1997,2.2,1,0,0,1,0,1,3,33.3,2,0,0,0,0,1,5,0,Matches
771,Kasper Dolberg,DEN,"FW,MF",Hoffenheim,Bundesliga,24,1997,4.5,7,5,1,4,2,4,6,66.7,2,6,2,4,0,7,5,0,Matches
772,Carlos Dominguez,ESP,DF,Celta Vigo,La Liga,21,2001,1.2,1,1,0,1,0,1,2,50.0,1,1,1,0,0,1,7,0,Matches
773,Nicolás Domínguez,ARG,MF,Bologna,Serie A,24,1998,25.6,79,49,34,33,12,39,76,51.3,37,29,3,26,21,100,29,1,Matches
774,John Donald,ESP,"MF,DF",Elche,La Liga,21,2000,12.1,20,11,9,9,2,7,14,50.0,7,14,7,7,14,34,23,1,Matches
775,Giulio Donati,ITA,DF,Monza,Serie A,32,1990,4.7,4,1,1,1,2,3,6,50.0,3,3,1,2,4,8,11,0,Matches
776,Kyliane Dong,FRA,"MF,FW",Troyes,Ligue 1,17,2004,2.4,3,1,0,2,1,1,2,50.0,1,1,0,1,1,4,0,0,Matches
777,Jordan Dongmo,CMR,MF,Troyes,Ligue 1,21,2001,0.2,1,0,0,1,0,1,1,100.0,0,0,0,0,0,1,0,0,Matches
778,Gianluigi Donnarumma,ITA,GK,Paris S-G,Ligue 1,23,1999,37.9,1,0,1,0,0,1,2,50.0,1,0,0,0,0,1,12,4,Matches
779,Niklas Dorsch,GER,MF,Augsburg,Bundesliga,24,1998,5.4,21,12,8,11,2,9,16,56.3,7,9,3,6,6,27,9,0,Matches
780,Jodel Dossou,BEN,"MF,DF",Clermont Foot,Ligue 1,30,1992,2.9,7,4,3,2,2,4,4,100.0,0,2,1,1,1,8,0,0,Matches
781,Lohann Doucet,FRA,"MF,FW",Nantes,Ligue 1,19,2002,1.0,3,0,2,0,1,3,4,75.0,1,2,0,2,2,5,4,0,Matches
782,Abdoulaye Doucouré,MLI,MF,Everton,Premier League,29,1993,17.0,31,20,9,15,7,12,37,32.4,25,26,3,23,13,44,11,0,Matches
783,Cheick Doucouré,MLI,MF,Crystal Palace,Premier League,22,2000,30.8,77,46,40,33,4,29,52,55.8,23,47,13,34,56,133,48,0,Matches
784,Siriné Doucouré,MLI,"FW,MF",Lorient,Ligue 1,20,2002,1.5,2,2,2,0,0,1,2,50.0,1,0,0,0,1,3,0,0,Matches
785,Désiré Doué,FRA,"MF,FW",Rennes,Ligue 1,17,2005,12.4,37,18,10,23,4,13,32,40.6,19,17,1,16,13,50,3,0,Matches
786,Guela Doué,CIV,"FW,MF",Rennes,Ligue 1,19,2002,0.1,0,0,0,0,0,0,0,,0,0,0,0,0,0,0,0,Matches
787,Ismaël Doukouré,FRA,"DF,MF",Strasbourg,Ligue 1,19,2003,25.5,48,24,23,21,4,20,34,58.8,14,26,8,18,27,75,54,0,Matches
788,Kamory Doumbia,MLI,MF,Reims,Ligue 1,19,2003,12.8,31,16,9,14,8,12,37,32.4,25,17,1,16,13,44,3,0,Matches
789,Souleyman Doumbia,CIV,"DF,FW",Angers,Ligue 1,25,1996,19.9,45,31,31,13,1,17,31,54.8,14,20,3,17,27,72,27,1,Matches
790,Flynn Downes,ENG,MF,West Ham,Premier League,23,1999,8.5,16,9,4,10,2,6,12,50.0,6,15,2,13,7,23,6,0,Matches
791,Kami Doyle,ENG,MF,Southampton,Premier League,16,2005,0.1,0,0,0,0,0,0,0,,0,0,0,0,0,0,0,0,Matches
792,Bartłomiej Drągowski,POL,GK,Spezia,Serie A,24,1997,32.7,1,0,1,0,0,1,5,20.0,4,0,0,0,1,2,15,3,Matches
793,Cody Drameh,ENG,DF,Leeds United,Premier League,20,2001,0.8,5,4,0,4,1,2,3,66.7,1,0,0,0,1,6,1,0,Matches
794,Dion Drena Beljo,CRO,FW,Augsburg,Bundesliga,20,2002,12.5,7,6,3,2,2,2,13,15.4,11,15,2,13,1,8,14,0,Matches
795,Dominick Drexler,GER,"MF,FW",Schalke 04,Bundesliga,32,1990,15.2,25,17,12,10,3,9,22,40.9,13,18,2,16,8,33,12,0,Matches
796,Domingos Duarte,POR,DF,Getafe,La Liga,27,1995,29.5,26,18,21,5,0,19,26,73.1,7,29,23,6,39,65,145,0,Matches
797,Martin Dúbravka,SVK,GK,Newcastle Utd,Premier League,33,1989,1.7,0,0,0,0,0,0,1,0.0,1,0,0,0,0,0,1,0,Matches
798,Marvin Ducksch,GER,FW,Werder Bremen,Bundesliga,28,1994,31.7,8,3,2,4,2,3,16,18.8,13,13,2,11,9,17,41,1,Matches
799,Ondrej Duda,SVK,MF,Hellas Verona,Serie A,27,1994,11.8,22,14,7,12,3,9,16,56.3,7,11,0,11,13,35,8,0,Matches
800,Ondrej Duda,SVK,MF,Köln,Bundesliga,27,1994,7.7,9,8,2,5,2,4,11,36.4,7,7,1,6,2,11,3,0,Matches
801,Shane Duffy,IRL,"DF,FW",Fulham,Premier League,30,1992,0.2,0,0,0,0,0,0,0,,0,0,0,0,0,0,0,1,Matches
802,Rémy Dugimont,FRA,"FW,MF",Auxerre,Ligue 1,36,1986,1.3,2,1,0,1,1,1,2,50.0,1,3,0,3,0,2,5,0,Matches
803,Denzel Dumfries,NED,DF,Inter,Serie A,26,1996,24.6,35,18,17,13,5,22,34,64.7,12,33,9,24,12,47,26,0,Matches
804,Alfred Duncan,GHA,MF,Fiorentina,Serie A,29,1993,12.3,18,10,0,17,1,10,21,47.6,11,9,0,9,8,26,6,0,Matches
805,Lewis Dunk,ENG,DF,Brighton,Premier League,30,1991,36.0,30,19,19,9,2,18,41,43.9,23,37,27,10,34,64,81,1,Matches
806,Maxime Dupé,FRA,GK,Toulouse,Ligue 1,29,1993,38.0,0,0,0,0,0,0,0,,0,0,0,0,0,0,9,3,Matches
807,Jhon Durán,COL,"FW,MF",Aston Villa,Premier League,18,2003,1.5,2,2,0,1,1,1,4,25.0,3,0,0,0,2,4,2,0,Matches
808,Pablo Durán,ESP,"MF,DF",Celta Vigo,La Liga,21,2001,0.4,0,0,0,0,0,0,0,,0,2,1,1,1,1,2,0,Matches
809,Julien Duranville,BEL,MF,Dortmund,Bundesliga,16,2006,0.3,1,1,0,1,0,1,1,100.0,0,0,0,0,0,1,0,0,Matches
810,Hugo Duro,ESP,FW,Valencia,La Liga,22,1999,15.4,15,12,2,6,7,7,17,41.2,10,11,1,10,2,17,7,1,Matches
811,Jean-Kevin Duverne,HAI,DF,Brest,Ligue 1,25,1997,27.9,72,38,44,24,4,42,73,57.5,31,33,5,28,28,100,65,1,Matches
812,Paulo Dybala,ARG,"MF,FW",Roma,Serie A,28,1993,19.3,14,4,1,8,5,8,26,30.8,18,12,1,11,8,22,4,0,Matches
813,Edin Džeko,BIH,FW,Inter,Serie A,36,1986,19.2,3,2,0,3,0,0,4,0.0,4,15,1,14,3,6,25,0,Matches
814,Malcolm Ebiowei,ENG,"MF,FW",Crystal Palace,Premier League,18,2003,0.4,1,1,1,0,0,0,1,0.0,1,2,0,2,0,1,0,0,Matches
815,Festy Ebosele,IRL,DF,Udinese,Serie A,19,2002,4.6,15,10,8,7,0,4,10,40.0,6,5,0,5,2,17,5,0,Matches
816,Enzo Ebosse,CMR,DF,Udinese,Serie A,23,1999,10.3,15,9,11,4,0,9,13,69.2,4,27,6,21,11,26,29,0,Matches
817,Tyronne Ebuehi,NGA,DF,Empoli,Serie A,26,1995,21.4,22,14,11,7,4,9,13,69.2,4,23,12,11,12,34,79,1,Matches
818,Ederson,BRA,GK,Manchester City,Premier League,28,1993,35.0,3,1,3,0,0,1,2,50.0,1,0,0,0,1,4,10,2,Matches
819,Éderson,BRA,MF,Atalanta,Serie A,23,1999,24.6,67,34,18,42,7,29,66,43.9,37,56,7,49,36,103,31,0,Matches
820,Odsonne Édouard,FRA,FW,Crystal Palace,Premier League,24,1998,20.0,25,13,7,12,6,7,13,53.8,6,17,5,12,3,28,22,0,Matches
821,Samuel Edozie,ENG,"FW,MF",Southampton,Premier League,19,2003,6.3,17,10,6,10,1,3,8,37.5,5,7,0,7,6,23,6,0,Matches
822,Maximilian Eggestein,GER,MF,Freiburg,Bundesliga,25,1996,27.2,51,29,21,24,6,17,35,48.6,18,37,8,29,36,87,27,0,Matches
823,Lilian Egloff,GER,"MF,FW",Stuttgart,Bundesliga,19,2002,2.7,12,10,4,5,3,4,6,66.7,2,2,0,2,1,13,1,0,Matches
824,Íñigo Eguaras,ESP,MF,Almería,La Liga,30,1992,10.7,11,8,4,6,1,5,18,27.8,13,9,3,6,6,17,15,0,Matches
825,Kingsley Ehizibue,NED,DF,Udinese,Serie A,27,1995,17.1,47,31,28,13,6,29,45,64.4,16,21,3,18,10,57,42,1,Matches
826,Kingsley Ehizibue,NED,DF,Köln,Bundesliga,27,1995,0.7,0,0,0,0,0,0,0,,0,1,0,1,2,2,1,0,Matches
827,Julian Eitschberger,GER,FW,Hertha BSC,Bundesliga,18,2004,0.0,0,0,0,0,0,0,0,,0,0,0,0,0,0,0,0,Matches
828,Chidera Ejuke,NGA,"FW,MF",Hertha BSC,Bundesliga,24,1998,9.9,5,4,1,4,0,1,5,20.0,4,4,0,4,4,9,1,0,Matches
829,Albin Ekdal,SWE,MF,Spezia,Serie A,33,1989,19.3,37,20,14,20,3,19,45,42.2,26,24,2,22,26,63,36,0,Matches
830,Hugo Ekitike,FRA,FW,Paris S-G,Ligue 1,20,2002,12.8,12,4,1,10,1,4,12,33.3,8,12,0,12,9,21,3,0,Matches
831,Emmanuel Ekong,SWE,"FW,MF",Empoli,Serie A,20,2002,0.2,0,0,0,0,0,0,0,,0,0,0,0,0,0,0,0,Matches
832,Anthony Elanga,SWE,FW,Manchester Utd,Premier League,20,2002,4.7,3,0,0,2,1,1,2,50.0,1,4,0,4,2,5,4,0,Matches
833,Alberth Elis,HON,"MF,FW",Brest,Ligue 1,26,1996,2.9,4,3,1,2,1,1,7,14.3,6,1,0,1,1,5,2,0,Matches
834,Mikael Ellertsson,ISL,"MF,DF",Spezia,Serie A,20,2002,1.9,4,2,1,3,0,0,3,0.0,3,2,1,1,2,6,0,0,Matches
835,Harvey Elliott,ENG,"MF,FW",Liverpool,Premier League,19,2003,17.9,27,18,6,12,9,9,37,24.3,28,26,1,25,15,42,8,0,Matches
836,Elif Elmas,MKD,"FW,MF",Napoli,Serie A,22,1999,18.1,24,13,8,12,4,11,23,47.8,12,18,2,16,11,35,5,0,Matches
837,Mohamed Elneny,EGY,MF,Arsenal,Premier League,30,1992,1.3,1,1,1,0,0,1,1,100.0,0,0,0,0,0,1,0,0,Matches
838,Aritz Elustondo,ESP,DF,Real Sociedad,La Liga,28,1994,16.1,26,17,15,10,1,14,26,53.8,12,15,6,9,20,46,43,1,Matches
839,Nico Elvedi,SUI,DF,Gladbach,Bundesliga,25,1996,31.4,46,24,32,12,2,27,41,65.9,14,31,16,15,35,81,149,3,Matches
840,Rodrigo Ely,BRA,DF,Almería,La Liga,28,1993,35.1,30,21,26,4,0,18,25,72.0,7,46,33,13,31,61,203,1,Matches
841,Mohamed Elyounoussi,NOR,"MF,FW",Southampton,Premier League,27,1994,24.1,46,28,22,20,4,19,44,43.2,25,40,3,37,27,73,37,0,Matches
842,Adri Embarba,ESP,"FW,MF",Almería,La Liga,30,1992,16.4,50,27,21,26,3,22,46,47.8,24,23,0,23,9,59,9,0,Matches
843,Adri Embarba,ESP,FW,Espanyol,La Liga,30,1992,0.4,1,0,0,1,0,1,1,100.0,0,1,0,1,0,1,0,0,Matches
844,Breel Embolo,SUI,FW,Monaco,Ligue 1,25,1997,20.7,15,9,2,7,6,5,10,50.0,5,14,3,11,5,20,12,0,Matches
845,Emerson,BRA,DF,Tottenham,Premier League,23,1999,19.3,54,33,38,12,4,27,40,67.5,13,17,3,14,18,72,75,0,Matches
846,Youssef En-Nesyri,MAR,FW,Sevilla,La Liga,25,1997,18.5,16,8,3,7,6,4,14,28.6,10,6,2,4,4,20,16,0,Matches
847,Julio Enciso,PAR,"FW,MF",Brighton,Premier League,18,2004,9.0,13,4,3,6,4,8,13,61.5,5,9,0,9,4,17,2,0,Matches
848,Wataru Endo,JPN,MF,Stuttgart,Bundesliga,29,1993,32.5,70,37,30,31,9,38,85,44.7,47,44,6,38,26,96,63,0,Matches
849,Arne Engels,BEL,MF,Augsburg,Bundesliga,18,2003,16.0,20,9,9,10,1,8,19,42.1,11,17,5,12,15,35,12,1,Matches
850,Christian Eriksen,DEN,MF,Manchester Utd,Premier League,30,1992,22.8,22,18,10,7,5,10,33,30.3,23,23,9,14,11,33,20,1,Matches
851,Martin Erlic,CRO,DF,Sassuolo,Serie A,24,1998,25.9,27,16,18,8,1,10,23,43.5,13,36,23,13,31,58,120,1,Matches
852,Tjark Ernst,GER,GK,Hertha BSC,Bundesliga,19,2003,1.0,0,0,0,0,0,0,0,,0,0,0,0,0,0,1,0,Matches
853,Gonzalo Escalante,ARG,MF,Cremonese,Serie A,29,1993,6.2,16,8,8,8,0,10,13,76.9,3,7,1,6,10,26,4,0,Matches
854,Gonzalo Escalante,ARG,MF,Cádiz,La Liga,29,1993,12.5,36,24,15,20,1,15,29,51.7,14,18,4,14,17,53,26,1,Matches
855,Sergio Escudero,ESP,DF,Valladolid,La Liga,32,1989,16.0,33,19,21,8,4,15,35,42.9,20,26,6,20,26,59,46,0,Matches
856,Alfonso Espino,URU,DF,Cádiz,La Liga,30,1992,34.7,87,56,55,20,12,48,96,50.0,48,52,11,41,48,135,99,3,Matches
857,Bernardo Espinosa,COL,DF,Girona,La Liga,33,1989,13.6,6,2,2,4,0,3,9,33.3,6,17,10,7,12,18,70,2,Matches
858,Salvatore Esposito,ITA,MF,Spezia,Serie A,21,2000,10.8,15,12,8,5,2,5,21,23.8,16,9,1,8,11,26,18,0,Matches
859,Maxime Estève,FRA,DF,Montpellier,Ligue 1,20,2002,18.3,24,13,17,5,2,12,17,70.6,5,28,17,11,34,58,90,0,Matches
860,Pervis Estupiñán,ECU,DF,Brighton,Premier League,24,1998,29.7,61,31,36,19,6,35,60,58.3,25,30,8,22,37,98,37,1,Matches
861,Jonny Evans,NIR,DF,Leicester City,Premier League,34,1988,11.7,13,5,12,1,0,7,11,63.6,4,15,11,4,18,31,51,0,Matches
862,Edu Expósito,ESP,MF,Espanyol,La Liga,25,1996,12.9,34,20,16,15,3,13,23,56.5,10,7,0,7,12,46,20,0,Matches
863,Eberechi Eze,ENG,"MF,FW",Crystal Palace,Premier League,24,1998,29.3,42,24,17,18,7,18,38,47.4,20,22,0,22,13,55,10,0,Matches
864,Kimberly Ezekwem,GER,DF,Freiburg,Bundesliga,21,2001,0.1,0,0,0,0,0,0,0,,0,1,0,1,0,0,0,0,Matches
865,Nicolás Ezequiel Fernández,ARG,"MF,DF",Elche,La Liga,22,2000,5.7,23,12,10,7,6,9,17,52.9,8,7,0,7,5,28,2,1,Matches
866,Abde Ezzalzouli,MAR,"FW,MF",Osasuna,La Liga,20,2001,16.7,29,19,13,12,4,13,23,56.5,10,20,0,20,4,33,6,0,Matches
867,Łukasz Fabiański,POL,GK,West Ham,Premier League,37,1985,34.6,2,0,2,0,0,1,2,50.0,1,1,0,1,0,2,10,1,Matches
868,Fabinho,BRA,MF,Liverpool,Premier League,28,1993,29.7,65,38,18,40,7,24,62,38.7,38,38,11,27,37,102,40,0,Matches
869,Fábio,BRA,"DF,MF",Nantes,Ligue 1,32,1990,2.5,4,2,1,2,1,4,6,66.7,2,2,0,2,3,7,11,0,Matches
870,Noah Fadiga,SEN,DF,Brest,Ligue 1,22,1999,14.5,30,21,18,9,3,14,26,53.8,12,17,7,10,26,56,18,0,Matches
871,Wout Faes,BEL,DF,Leicester City,Premier League,24,1998,31.0,56,33,28,26,2,28,44,63.6,16,53,37,16,41,97,113,2,Matches
872,Wout Faes,BEL,DF,Reims,Ligue 1,24,1998,3.0,1,1,1,0,0,1,2,50.0,1,6,3,3,7,8,19,0,Matches
873,Nicolò Fagioli,ITA,MF,Juventus,Serie A,21,2001,16.9,29,19,12,15,2,8,27,29.6,19,16,2,14,8,37,7,1,Matches
874,Ralf Fährmann,GER,GK,Schalke 04,Bundesliga,33,1988,11.4,1,0,1,0,0,1,1,100.0,0,0,0,0,0,1,10,2,Matches
875,Romain Faivre,FRA,"MF,FW",Lorient,Ligue 1,24,1998,13.8,13,8,5,4,4,5,25,20.0,20,11,0,11,1,14,4,0,Matches
876,Romain Faivre,FRA,MF,Lyon,Ligue 1,24,1998,3.3,6,3,2,2,2,1,3,33.3,2,3,0,3,0,6,0,0,Matches
877,Radamel Falcao,COL,"FW,MF",Rayo Vallecano,La Liga,36,1986,6.8,4,4,1,3,0,1,8,12.5,7,5,1,4,2,6,10,0,Matches
878,Wladimiro Falcone,ITA,GK,Lecce,Serie A,27,1995,38.0,2,0,2,0,0,2,2,100.0,0,0,0,0,2,4,21,3,Matches
879,Fali,ESP,"DF,MF",Cádiz,La Liga,28,1993,19.0,27,19,19,8,0,18,29,62.1,11,24,15,9,13,40,70,1,Matches
880,Fallou Fall,SEN,DF,Reims,Ligue 1,18,2004,0.4,0,0,0,0,0,0,1,0.0,1,3,3,0,0,0,4,0,Matches
881,Mamadou Fall,SEN,DF,Villarreal,La Liga,19,2002,0.3,0,0,0,0,0,0,0,,0,1,0,1,0,0,1,0,Matches
882,Davide Faraoni,ITA,DF,Hellas Verona,Serie A,30,1991,16.5,34,24,19,13,2,16,41,39.0,25,30,11,19,15,49,37,0,Matches
883,Ansu Fati,ESP,FW,Barcelona,La Liga,19,2002,15.5,16,9,8,4,4,5,18,27.8,13,19,0,19,5,21,6,0,Matches
884,Khalil Fayad,FRA,MF,Montpellier,Ligue 1,18,2004,8.0,30,14,12,16,2,12,21,57.1,9,8,1,7,9,39,4,0,Matches
885,Cheikh Faye,SEN,FW,Montpellier,Ligue 1,23,1999,0.4,0,0,0,0,0,0,0,,0,0,0,0,1,1,0,0,Matches
886,Federico Fazio,ARG,DF,Salernitana,Serie A,35,1987,11.9,15,12,8,7,0,4,11,36.4,7,9,4,5,28,43,61,0,Matches
887,Jacopo Fazzini,ITA,MF,Empoli,Serie A,19,2003,9.2,31,17,20,8,3,18,34,52.9,16,15,3,12,7,38,19,0,Matches
888,Zouhair Feddal,MAR,DF,Valladolid,La Liga,33,1989,4.2,4,2,1,3,0,3,4,75.0,1,9,9,0,5,9,27,0,Matches
889,Nabil Fekir,FRA,MF,Betis,La Liga,29,1993,10.7,11,5,3,3,5,2,9,22.2,7,6,2,4,1,12,0,0,Matches
890,Felipe,BRA,DF,Nott'ham Forest,Premier League,33,1989,15.8,42,23,29,13,0,24,41,58.5,17,34,13,21,36,78,90,0,Matches
891,Felipe,BRA,DF,Atlético Madrid,La Liga,33,1989,2.2,3,2,1,2,0,2,4,50.0,2,2,2,0,0,3,7,0,Matches
892,Luiz Felipe,ITA,DF,Betis,La Liga,25,1997,19.6,34,23,23,11,0,18,34,52.9,16,43,24,19,28,62,106,0,Matches
893,João Félix,POR,"FW,MF",Chelsea,Premier League,22,1999,10.5,14,7,5,6,3,4,12,33.3,8,3,0,3,1,15,1,1,Matches
894,João Félix,POR,"FW,MF",Atlético Madrid,La Liga,22,1999,7.2,10,7,2,3,5,1,6,16.7,5,1,0,1,3,13,2,0,Matches
895,Ohis Felix Uduokhai,GER,DF,Augsburg,Bundesliga,24,1997,16.1,30,20,14,13,3,15,29,51.7,14,27,14,13,29,59,61,1,Matches
896,Kiko Femenía,ESP,DF,Villarreal,La Liga,31,1991,12.6,18,9,14,3,1,13,18,72.2,5,15,6,9,20,38,22,0,Matches
897,Evan Ferguson,IRL,FW,Brighton,Premier League,17,2004,10.6,6,3,1,3,2,1,7,14.3,6,11,1,10,2,8,6,0,Matches
898,Lewis Ferguson,SCO,"MF,FW",Bologna,Serie A,22,1999,25.7,44,25,16,20,8,20,40,50.0,20,22,7,15,19,63,25,0,Matches
899,Bruno Fernandes,POR,"MF,FW",Manchester Utd,Premier League,27,1994,36.8,68,42,24,25,19,30,71,42.3,41,37,5,32,25,93,40,1,Matches
900,Edimilson Fernandes,SUI,DF,Mainz 05,Bundesliga,26,1996,27.1,35,25,26,5,4,18,34,52.9,16,37,16,21,54,89,87,2,Matches
901,Aitor Fernández,ESP,GK,Osasuna,La Liga,31,1991,21.0,1,1,1,0,0,0,1,0.0,1,0,0,0,2,3,17,0,Matches
902,Álex Fernández,ESP,"MF,FW",Cádiz,La Liga,29,1992,17.5,13,7,6,4,3,4,14,28.6,10,14,1,13,8,21,19,0,Matches
903,Álvaro Fernández,ESP,GK,Espanyol,La Liga,24,1998,11.0,0,0,0,0,0,0,0,,0,0,0,0,0,0,7,2,Matches
904,Carlos Fernández,ESP,FW,Real Sociedad,La Liga,26,1996,7.0,6,4,1,3,2,1,15,6.7,14,1,0,1,1,7,4,0,Matches
905,Enzo Fernández,ARG,MF,Chelsea,Premier League,21,2001,17.2,45,27,25,17,3,21,56,37.5,35,32,2,30,16,61,12,1,Matches
906,Federico Fernández,ARG,DF,Elche,La Liga,33,1989,1.0,1,1,1,0,0,1,1,100.0,0,0,0,0,2,3,12,0,Matches
907,Joaquín Fernández,ESP,DF,Valladolid,La Liga,26,1996,24.0,35,28,20,11,4,19,30,63.3,11,31,22,9,27,62,98,1,Matches
908,Valery Fernández,ESP,"MF,DF",Girona,La Liga,22,1999,10.7,12,6,4,6,2,5,9,55.6,4,8,1,7,10,22,9,1,Matches
909,Fernando,ESP,GK,Almería,La Liga,32,1990,36.5,0,0,0,0,0,0,2,0.0,2,2,0,2,1,1,20,3,Matches
910,Fernando,BRA,"MF,DF",Sevilla,La Liga,35,1987,17.5,34,23,14,17,3,18,30,60.0,12,21,10,11,24,58,29,0,Matches
911,Alex Ferrari,ITA,DF,Sampdoria,Serie A,28,1994,9.6,9,5,7,2,0,4,8,50.0,4,21,10,11,19,28,25,0,Matches
912,Alex Ferrari,ITA,DF,Cremonese,Serie A,28,1994,11.2,40,23,32,7,1,28,42,66.7,14,19,4,15,25,65,45,1,Matches
913,Salvador Ferrer,ESP,DF,Spezia,Serie A,24,1998,1.5,4,2,2,2,0,1,3,33.3,2,3,1,2,1,5,4,0,Matches
914,Jordan Ferri,FRA,MF,Montpellier,Ligue 1,30,1992,30.4,55,35,32,19,4,30,89,33.7,59,22,6,16,26,81,21,0,Matches
915,Fidel,ESP,"MF,FW",Elche,La Liga,32,1989,19.0,15,10,8,5,2,4,38,10.5,34,9,0,9,5,20,8,0,Matches
916,Karol Fila,POL,DF,Strasbourg,Ligue 1,24,1998,0.5,0,0,0,0,0,0,0,,0,0,0,0,1,1,1,0,Matches
917,Vincenzo Fiorillo,ITA,GK,Salernitana,Serie A,32,1990,1.0,0,0,0,0,0,0,0,,0,0,0,0,0,0,0,0,Matches
918,Roberto Firmino,BRA,"FW,MF",Liverpool,Premier League,30,1991,13.5,17,12,2,12,3,4,22,18.2,18,16,1,15,7,24,2,0,Matches
919,Junior Firpo,DOM,DF,Leeds United,Premier League,25,1996,15.2,47,25,27,15,5,24,46,52.2,22,23,7,16,24,71,40,0,Matches
920,Kilian Fischer,GER,"DF,FW",Wolfsburg,Bundesliga,21,2000,5.6,9,6,3,4,2,6,11,54.5,5,6,0,6,5,14,18,0,Matches
921,Mark Flekken,NED,GK,Freiburg,Bundesliga,29,1993,34.0,0,0,0,0,0,0,1,0.0,1,1,0,1,0,0,9,5,Matches
922,Florian Flick,GER,MF,Schalke 04,Bundesliga,22,2000,5.7,12,3,7,5,0,4,14,28.6,10,9,3,6,4,16,18,0,Matches
923,Alexis Flips,FRA,"FW,MF",Reims,Ligue 1,22,2000,22.0,51,30,18,17,16,27,64,42.2,37,35,5,30,24,75,12,0,Matches
924,Alessandro Florenzi,ITA,DF,Milan,Serie A,31,1991,2.3,6,4,3,2,1,4,7,57.1,3,1,0,1,4,10,2,0,Matches
925,Phil Foden,ENG,FW,Manchester City,Premier League,22,2000,20.5,16,10,9,5,2,8,19,42.1,11,25,2,23,5,21,12,0,Matches
926,Seko Fofana,CIV,MF,Lens,Ligue 1,27,1995,34.1,28,13,8,18,2,15,39,38.5,24,17,4,13,19,47,14,0,Matches
927,Wesley Fofana,FRA,DF,Leicester City,Premier League,21,2000,2.0,4,2,1,2,1,1,3,33.3,2,1,1,0,9,13,5,0,Matches
928,Wesley Fofana,FRA,DF,Chelsea,Premier League,21,2000,13.1,30,18,19,7,4,13,26,50.0,13,17,10,7,20,50,33,2,Matches
929,Yahia Fofana,CIV,GK,Angers,Ligue 1,21,2000,11.0,0,0,0,0,0,0,0,,0,0,0,0,1,1,4,1,Matches
930,Youssouf Fofana,FRA,MF,Monaco,Ligue 1,23,1999,34.3,81,41,31,42,8,38,74,51.4,36,50,6,44,56,137,32,1,Matches
931,Thomas Foket,BEL,DF,Reims,Ligue 1,27,1994,22.0,35,22,18,11,6,17,46,37.0,29,21,7,14,33,68,29,2,Matches
932,José Fonte,POR,DF,Lille,Ligue 1,38,1983,28.8,23,17,18,4,1,10,21,47.6,11,27,14,13,25,48,112,2,Matches
933,Pablo Fornals,ESP,"FW,MF",West Ham,Premier League,26,1996,16.7,30,15,9,12,9,13,34,38.2,21,16,2,14,14,44,9,0,Matches
934,Emil Forsberg,SWE,"MF,FW",RB Leipzig,Bundesliga,30,1991,16.5,16,11,1,8,7,6,20,30.0,14,25,2,23,3,19,7,0,Matches
935,Adam Forshaw,ENG,MF,Leeds United,Premier League,30,1991,5.3,12,9,5,7,0,7,17,41.2,10,9,1,8,4,16,2,0,Matches
936,Fraser Forster,ENG,GK,Tottenham,Premier League,34,1988,13.5,1,0,1,0,0,0,0,,0,1,0,1,0,1,3,1,Matches
937,Philipp Förster,GER,MF,Bochum,Bundesliga,27,1995,14.5,31,19,11,15,5,12,40,30.0,28,22,0,22,6,37,6,0,Matches
938,Steven Fortes,CPV,DF,Lens,Ligue 1,30,1992,0.1,0,0,0,0,0,0,0,,0,0,0,0,0,0,0,0,Matches
939,Timothy Fosu-Mensah,NED,DF,Leverkusen,Bundesliga,24,1998,2.1,7,5,3,3,1,4,4,100.0,0,2,0,2,0,7,1,0,Matches
940,Dimitri Foulquier,FRA,DF,Valencia,La Liga,29,1993,19.3,31,19,17,8,6,20,28,71.4,8,19,3,16,14,45,40,0,Matches
941,Juan Foyth,ARG,DF,Villarreal,La Liga,24,1998,21.8,73,48,49,22,2,41,57,71.9,16,32,11,21,20,93,68,0,Matches
942,Raphael Framberger,GER,"DF,FW",Augsburg,Bundesliga,26,1995,2.0,10,6,6,4,0,3,5,60.0,2,2,1,1,2,12,5,0,Matches
943,Tyrese Francois,AUS,FW,Fulham,Premier League,22,2000,0.0,0,0,0,0,0,0,1,0.0,1,0,0,0,0,0,1,0,Matches
944,Bartol Franjić,CRO,MF,Wolfsburg,Bundesliga,22,2000,2.5,4,2,2,2,0,0,2,0.0,2,4,1,3,5,9,4,0,Matches
945,Przemysław Frankowski,POL,"DF,MF",Lens,Ligue 1,27,1995,31.5,77,51,37,31,9,39,80,48.8,41,38,6,32,41,118,42,2,Matches
946,Ryan Fraser,SCO,FW,Newcastle Utd,Premier League,28,1994,3.5,2,2,0,0,2,2,5,40.0,3,3,1,2,0,2,3,0,Matches
947,Davide Frattesi,ITA,MF,Sassuolo,Serie A,22,1999,31.9,63,36,24,29,10,25,44,56.8,19,27,6,21,16,79,42,0,Matches
948,Oscar Fraulo,DEN,"FW,MF",Gladbach,Bundesliga,18,2003,0.1,0,0,0,0,0,0,0,,0,0,0,0,0,0,0,0,Matches
949,Fred,BRA,MF,Manchester Utd,Premier League,29,1993,13.9,47,30,24,20,3,15,38,39.5,23,38,2,36,19,66,19,0,Matches
950,Ryan Fredericks,ENG,DF,Bournemouth,Premier League,29,1992,5.9,3,2,2,0,1,1,4,25.0,3,7,2,5,1,4,27,0,Matches
951,Iván Fresneda,ESP,DF,Valladolid,La Liga,17,2004,19.4,48,34,31,13,4,29,47,61.7,18,32,8,24,15,63,60,0,Matches
952,Remo Freuler,SUI,MF,Nott'ham Forest,Premier League,30,1992,24.0,43,23,23,15,5,19,43,44.2,24,36,9,27,29,72,45,0,Matches
953,Michael Frey,SUI,FW,Schalke 04,Bundesliga,28,1994,9.6,13,5,2,8,3,4,13,30.8,9,6,0,6,2,15,1,0,Matches
954,Marco Friedl,AUT,DF,Werder Bremen,Bundesliga,24,1998,28.8,62,46,40,22,0,41,68,60.3,27,46,17,29,58,120,127,1,Matches
955,Marvin Friedrich,GER,DF,Gladbach,Bundesliga,26,1995,13.9,17,11,13,3,1,10,13,76.9,3,14,6,8,11,28,52,0,Matches
956,Jeremie Frimpong,NED,"DF,MF",Leverkusen,Bundesliga,21,2000,30.1,53,27,22,26,5,23,44,52.3,21,24,3,21,16,69,40,0,Matches
957,Chris Führich,GER,"FW,MF",Stuttgart,Bundesliga,24,1998,20.9,36,14,15,14,7,24,44,54.5,20,29,2,27,7,43,13,0,Matches
958,Angelo Fulgini,FRA,"MF,FW",Lens,Ligue 1,25,1996,9.5,14,7,2,4,8,5,14,35.7,9,11,0,11,8,22,2,0,Matches
959,Angelo Fulgini,FRA,MF,Mainz 05,Bundesliga,25,1996,5.8,6,5,2,3,1,5,12,41.7,7,5,0,5,5,11,7,0,Matches
960,Niclas Füllkrug,GER,FW,Werder Bremen,Bundesliga,29,1993,27.5,9,4,0,6,3,3,13,23.1,10,13,4,9,1,10,24,0,Matches
961,Matteo Gabbia,ITA,DF,Milan,Serie A,22,1999,6.8,17,10,12,5,0,6,8,75.0,2,8,3,5,5,22,29,0,Matches
962,Manolo Gabbiadini,ITA,"FW,MF",Sampdoria,Serie A,30,1991,26.2,23,15,8,9,6,9,23,39.1,14,16,2,14,6,29,25,0,Matches
963,Gianluca Gaetano,ITA,MF,Napoli,Serie A,22,2000,0.8,5,3,1,3,1,0,0,,0,1,0,1,1,6,0,0,Matches
964,Roberto Gagliardini,ITA,MF,Inter,Serie A,28,1994,8.7,16,6,9,6,1,10,21,47.6,11,14,5,9,4,20,15,0,Matches
965,Adolfo Gaich,ARG,FW,Hellas Verona,Serie A,23,1999,8.1,5,3,0,3,2,1,6,16.7,5,7,2,5,3,8,7,1,Matches
966,Cody Gakpo,NED,"FW,MF",Liverpool,Premier League,23,1999,16.2,26,15,4,13,9,13,38,34.2,25,13,1,12,4,30,2,0,Matches
967,Javi Galán,ESP,DF,Celta Vigo,La Liga,27,1994,35.1,104,72,60,40,4,48,98,49.0,50,54,5,49,41,145,63,1,Matches
968,Iñigo Ruiz de Galarreta,ESP,MF,Mallorca,La Liga,28,1993,27.2,54,38,27,23,4,20,52,38.5,32,26,9,17,30,84,19,0,Matches
969,Pablo Galdames Millán,CHI,MF,Cremonese,Serie A,25,1996,8.2,14,10,8,3,3,5,33,15.2,28,13,2,11,10,24,13,0,Matches
970,Conor Gallagher,ENG,MF,Chelsea,Premier League,22,2000,18.0,46,33,17,19,10,10,37,27.0,27,41,10,31,23,69,18,1,Matches
971,Antonino Gallo,ITA,DF,Lecce,Serie A,22,2000,27.6,56,36,35,12,9,38,57,66.7,19,37,6,31,13,69,71,0,Matches
972,Gauthier Gallon,FRA,GK,Troyes,Ligue 1,29,1993,29.6,2,2,2,0,0,2,4,50.0,2,0,0,0,2,4,17,0,Matches
973,Cristian Gamboa,CRC,DF,Bochum,Bundesliga,32,1989,16.4,42,24,27,14,1,21,31,67.7,10,20,7,13,16,58,34,1,Matches
974,Kévin Gameiro,FRA,FW,Strasbourg,Ligue 1,35,1987,23.3,20,10,6,10,4,8,28,28.6,20,10,1,9,9,29,0,0,Matches
975,Idrissa Gana Gueye,SEN,MF,Everton,Premier League,32,1989,28.6,97,57,49,35,13,31,62,50.0,31,50,12,38,56,153,34,3,Matches
976,Ignatius Ganago,CMR,"FW,MF",Nantes,Ligue 1,23,1999,16.9,9,7,2,3,4,4,7,57.1,3,13,1,12,2,11,12,0,Matches
977,Ignatius Ganago,CMR,FW,Lens,Ligue 1,23,1999,0.7,0,0,0,0,0,0,0,,0,0,0,0,0,0,1,0,Matches
978,Silvère Ganvoula M'Boussy,CGO,"FW,MF",Bochum,Bundesliga,26,1996,2.7,2,2,0,1,1,0,0,,0,0,0,0,0,2,3,0,Matches
979,Aleix García,ESP,MF,Girona,La Liga,25,1997,26.0,37,20,9,18,10,15,33,45.5,18,24,8,16,31,68,35,1,Matches
980,Álvaro García,ESP,"FW,MF",Rayo Vallecano,La Liga,29,1992,31.9,49,28,21,13,15,11,33,33.3,22,41,4,37,34,83,24,1,Matches
981,Borja García,ESP,"MF,FW",Girona,La Liga,31,1990,7.5,10,4,7,2,1,2,9,22.2,7,3,1,2,5,15,6,1,Matches
982,Carlos García,ESP,DF,Cádiz,La Liga,22,2000,0.3,0,0,0,0,0,0,0,,0,0,0,0,0,0,2,0,Matches
983,Dani García,ESP,MF,Athletic Club,La Liga,32,1990,16.5,46,27,17,25,4,29,47,61.7,18,21,6,15,19,65,21,1,Matches
984,David García,ESP,DF,Osasuna,La Liga,28,1994,29.8,34,20,22,12,0,19,22,86.4,3,28,13,15,45,79,151,0,Matches
985,Eric García,ESP,"DF,MF",Barcelona,La Liga,21,2001,15.7,24,16,16,5,3,9,20,45.0,11,23,10,13,19,43,36,1,Matches
986,Fran Garcia,ESP,DF,Rayo Vallecano,La Liga,22,1999,37.9,84,54,53,23,8,55,96,57.3,41,49,8,41,44,128,66,0,Matches
987,Joan García,ESP,GK,Espanyol,La Liga,21,2001,1.0,0,0,0,0,0,0,0,,0,0,0,0,0,0,0,0,Matches
988,Raúl García,ESP,"FW,MF",Athletic Club,La Liga,36,1986,10.7,12,8,3,4,5,5,15,33.3,10,13,1,12,6,18,9,0,Matches
989,Rubén García,ESP,"FW,MF",Osasuna,La Liga,29,1993,12.9,20,11,12,4,4,7,24,29.2,17,14,1,13,12,32,13,0,Matches
990,Unai García,ESP,DF,Osasuna,La Liga,30,1992,19.0,23,13,13,8,2,12,17,70.6,5,23,14,9,19,42,60,2,Matches
991,Alejandro Garnacho,ARG,"FW,MF",Manchester Utd,Premier League,18,2004,6.3,5,2,2,0,3,1,11,9.1,10,5,0,5,5,10,3,0,Matches
992,James Garner,ENG,"MF,DF",Everton,Premier League,21,2001,8.9,16,13,4,8,4,9,19,47.4,10,9,1,8,12,28,13,0,Matches
993,Felix Garreta,ESP,DF,Betis,La Liga,18,2004,1.0,1,0,0,1,0,0,0,,0,1,1,0,1,2,4,0,Matches
994,Aleix Garrido,ESP,FW,Barcelona,La Liga,18,2004,0.1,2,1,1,0,1,1,1,100.0,0,1,0,1,0,2,0,0,Matches
995,Sékou Gassama,SEN,FW,Valladolid,La Liga,27,1995,0.4,0,0,0,0,0,0,0,,0,0,0,0,0,0,0,0,Matches
996,Johan Gastien,FRA,MF,Clermont Foot,Ligue 1,34,1988,28.9,62,34,30,23,9,38,111,34.2,73,37,7,30,36,98,25,1,Matches
997,Federico Gatti,ITA,DF,Juventus,Serie A,24,1998,16.1,15,11,9,4,2,9,15,60.0,6,20,14,6,21,36,54,2,Matches
998,Gavi,ESP,"MF,FW",Barcelona,La Liga,17,2004,28.1,47,31,7,30,10,21,55,38.2,34,32,5,27,18,65,22,0,Matches
999,Paulo Gazzaniga,ARG,GK,Girona,La Liga,30,1992,28.0,0,0,0,0,0,0,1,0.0,1,0,0,0,1,1,9,5,Matches
1000,David de Gea,ESP,GK,Manchester Utd,Premier League,31,1990,38.0,0,0,0,0,0,0,1,0.0,1,0,0,0,1,1,15,3,Matches
1001,Dario Gebuhr,GER,DF,Eint Frankfurt,Bundesliga,19,2003,0.2,0,0,0,0,0,0,1,0.0,1,0,0,0,0,0,0,0,Matches
1002,Dennis Geiger,GER,MF,Hoffenheim,Bundesliga,24,1998,21.7,45,25,15,28,2,22,35,62.9,13,27,3,24,24,69,18,2,Matches
1003,Joe Gelhardt,ENG,FW,Leeds United,Premier League,20,2002,2.4,6,2,1,3,2,3,5,60.0,2,5,0,5,0,6,4,0,Matches
1004,Valentin Gendrey,FRA,DF,Lecce,Serie A,22,2000,34.5,88,57,54,25,9,40,71,56.3,31,45,4,41,37,125,89,0,Matches
1005,Denis Genreau,AUS,MF,Toulouse,Ligue 1,23,1999,7.3,35,13,16,12,7,13,31,41.9,18,16,1,15,8,43,9,0,Matches
1006,Yannick Gerhardt,GER,MF,Wolfsburg,Bundesliga,28,1994,20.7,29,15,10,11,8,12,30,40.0,18,26,5,21,7,36,24,0,Matches
1007,Valère Germain,FRA,"FW,MF",Montpellier,Ligue 1,32,1990,7.6,13,11,3,5,5,4,12,33.3,8,8,0,8,6,19,12,0,Matches
1008,Gerson,BRA,MF,Marseille,Ligue 1,25,1997,4.6,6,4,1,4,1,3,5,60.0,2,5,0,5,2,8,4,0,Matches
1009,Ismaël Gharbi,ESP,"MF,FW",Paris S-G,Ligue 1,18,2004,0.6,0,0,0,0,0,0,2,0.0,2,2,0,2,3,3,0,0,Matches
1010,Paolo Ghiglione,ITA,DF,Cremonese,Serie A,25,1997,7.9,16,11,10,3,3,10,23,43.5,13,9,4,5,4,20,12,0,Matches
1011,Saman Ghoddos,IRN,"MF,FW",Brentford,Premier League,28,1993,1.5,2,1,0,1,1,1,3,33.3,2,5,1,4,4,6,2,0,Matches
1012,Faouzi Ghoulam,ALG,DF,Angers,Ligue 1,31,1991,5.3,3,3,1,1,1,3,5,60.0,2,4,2,2,4,7,12,1,Matches
1013,Morgan Gibbs-White,ENG,"FW,MF",Wolves,Premier League,22,2000,2.0,3,1,3,0,0,2,4,50.0,2,2,0,2,1,4,3,0,Matches
1014,Morgan Gibbs-White,ENG,"MF,FW",Nott'ham Forest,Premier League,22,2000,33.0,26,14,7,7,12,11,33,33.3,22,23,4,19,14,40,15,0,Matches
1015,Niko Gießelmann,GER,DF,Union Berlin,Bundesliga,30,1991,14.5,21,11,9,9,3,13,31,41.9,18,17,5,12,9,30,28,0,Matches
1016,Samuel Gigot,FRA,DF,Marseille,Ligue 1,28,1993,20.9,46,24,22,21,3,12,15,80.0,3,24,7,17,45,91,85,1,Matches
1017,Rafał Gikiewicz,POL,GK,Augsburg,Bundesliga,34,1987,23.0,2,2,2,0,0,2,3,66.7,1,0,0,0,0,2,15,5,Matches
1018,Bryan Gil,ESP,"MF,FW",Tottenham,Premier League,21,2001,1.6,3,1,3,0,0,0,3,0.0,3,3,0,3,1,4,1,0,Matches
1019,Bryan Gil,ESP,"FW,DF",Sevilla,La Liga,21,2001,10.2,22,11,11,7,4,10,23,43.5,13,10,0,10,8,30,10,0,Matches
1020,David Gil,ESP,GK,Cádiz,La Liga,28,1994,4.0,0,0,0,0,0,0,0,,0,0,0,0,0,0,3,0,Matches
1021,Óscar Gil,ESP,DF,Espanyol,La Liga,25,1997,28.4,63,37,38,16,9,32,61,52.5,29,51,18,33,31,94,55,1,Matches
1022,Mario Gila,ESP,DF,Lazio,Serie A,21,2000,1.0,3,1,3,0,0,0,1,0.0,1,0,0,0,3,6,3,0,Matches
1023,Billy Gilmour,SCO,MF,Brighton,Premier League,21,2001,5.6,5,2,2,2,1,2,8,25.0,6,5,2,3,6,11,5,0,Matches
1024,Álvaro Giménez,ESP,FW,Cádiz,La Liga,31,1991,0.2,0,0,0,0,0,0,1,0.0,1,0,0,0,0,0,0,0,Matches
1025,Gvidas Gineitis,LTU,MF,Torino,Serie A,18,2004,1.5,3,1,0,2,1,1,2,50.0,1,0,0,0,0,3,1,0,Matches
1026,Matthias Ginter,GER,DF,Freiburg,Bundesliga,28,1994,34.0,43,20,29,12,2,26,40,65.0,14,40,24,16,35,78,153,3,Matches
1027,Andrei Girotto,BRA,"DF,MF",Nantes,Ligue 1,30,1992,35.0,122,73,71,45,6,74,132,56.1,58,55,24,31,73,195,176,1,Matches
1028,Olivier Giroud,FRA,FW,Milan,Serie A,35,1986,23.8,8,5,2,4,2,2,10,20.0,8,11,3,8,3,11,23,0,Matches
1029,Jamie Gittens,ENG,"FW,MF",Dortmund,Bundesliga,17,2004,5.9,8,4,2,5,1,2,7,28.6,5,1,0,1,1,9,2,0,Matches
1030,Serge Gnabry,GER,"FW,MF",Bayern Munich,Bundesliga,27,1995,21.6,35,23,11,14,10,17,43,39.5,26,24,1,23,11,46,5,1,Matches
1031,Wilfried Gnonto,ITA,"FW,MF",Leeds United,Premier League,18,2003,15.0,27,17,7,15,5,10,30,33.3,20,24,1,23,5,32,7,0,Matches
1032,Ben Godfrey,ENG,DF,Everton,Premier League,24,1998,8.9,20,11,13,5,2,11,29,37.9,18,12,6,6,8,28,33,1,Matches
1033,Pierluigi Gollini,ITA,GK,Fiorentina,Serie A,27,1995,3.0,1,0,1,0,0,1,1,100.0,0,0,0,0,0,1,2,0,Matches
1034,Pierluigi Gollini,ITA,GK,Napoli,Serie A,27,1995,4.0,0,0,0,0,0,0,0,,0,0,0,0,0,0,1,0,Matches
1035,Aleksandr Golovin,RUS,"MF,FW",Monaco,Ligue 1,26,1996,27.4,62,36,19,32,11,28,72,38.9,44,28,1,27,37,99,10,0,Matches
1036,André Gomes,POR,MF,Lille,Ligue 1,29,1993,18.1,37,19,12,17,8,19,52,36.5,33,20,5,15,9,46,16,1,Matches
1037,Angel Gomes,ENG,MF,Lille,Ligue 1,21,2000,31.3,41,19,12,21,8,18,49,36.7,31,22,2,20,13,54,11,1,Matches
1038,João Gomes,BRA,MF,Wolves,Premier League,21,2001,7.3,29,13,14,14,1,13,23,56.5,10,12,3,9,4,33,11,0,Matches
1039,Toti Gomes,POR,DF,Wolves,Premier League,23,1999,10.9,15,9,11,4,0,9,13,69.2,4,16,8,8,11,26,51,0,Matches
1040,Dani Gómez,ESP,"MF,FW",Espanyol,La Liga,24,1998,1.0,2,1,1,1,0,1,2,50.0,1,0,0,0,1,3,0,0,Matches
1041,Joe Gomez,ENG,DF,Liverpool,Premier League,25,1997,16.3,28,21,15,11,2,11,19,57.9,8,17,11,6,24,52,51,2,Matches
1042,Maxi Gómez,URU,FW,Valencia,La Liga,25,1996,1.2,0,0,0,0,0,0,0,,0,0,0,0,0,0,2,0,Matches
1043,Moi Gómez,ESP,"MF,FW",Osasuna,La Liga,28,1994,27.3,26,17,9,14,3,15,32,46.9,17,15,3,12,10,36,5,1,Matches
1044,Papu Gómez,ARG,"FW,MF",Sevilla,La Liga,34,1988,11.8,6,4,3,3,0,2,10,20.0,8,8,1,7,4,10,5,0,Matches
1045,Sergi Gómez,ESP,DF,Espanyol,La Liga,30,1992,26.0,29,16,20,9,0,18,22,81.8,4,33,19,14,27,56,125,1,Matches
1046,Sergio Gómez,ESP,"DF,MF",Manchester City,Premier League,21,2000,3.9,9,4,6,1,2,5,8,62.5,3,5,3,2,2,11,9,1,Matches
1047,Antonio Gomis,ESP,GK,Atlético Madrid,La Liga,19,2003,0.1,0,0,0,0,0,0,0,,0,0,0,0,0,0,0,0,Matches
1048,Maxime Gonalons,FRA,MF,Clermont Foot,Ligue 1,33,1989,16.1,52,32,25,21,6,25,53,47.2,28,21,1,20,20,72,7,1,Matches
1049,Diego González,ESP,DF,Elche,La Liga,27,1995,10.6,12,7,9,3,0,7,11,63.6,4,14,12,2,7,19,50,1,Matches
1050,Édgar González,ESP,DF,Betis,La Liga,25,1997,19.7,28,19,18,7,3,14,27,51.9,13,12,9,3,21,49,120,0,Matches
1051,Giovanni González,URU,DF,Mallorca,La Liga,27,1994,10.3,16,8,11,2,3,9,22,40.9,13,8,2,6,7,23,22,0,Matches
1052,Joan Gonzàlez,ESP,MF,Lecce,Serie A,20,2002,24.4,48,28,20,18,10,17,51,33.3,34,37,8,29,16,64,28,0,Matches
1053,Nicolás González,ARG,"FW,MF",Fiorentina,Serie A,24,1998,15.0,17,10,3,10,4,5,16,31.3,11,14,0,14,4,21,6,0,Matches
1054,Nicolás González,ESP,MF,Valencia,La Liga,20,2002,15.6,27,15,11,13,3,9,25,36.0,16,21,7,14,19,46,16,0,Matches
1055,Oumar Gonzalez,CMR,DF,Ajaccio,Ligue 1,24,1998,28.6,51,28,34,13,4,23,37,62.2,14,32,11,21,52,103,82,0,Matches
1056,Roberto González,ESP,"FW,MF",Betis,La Liga,21,2001,0.6,0,0,0,0,0,0,1,0.0,1,0,0,0,1,1,0,0,Matches
1057,Jacek Góralski,POL,MF,Bochum,Bundesliga,29,1992,1.6,6,3,3,3,0,4,6,66.7,2,4,0,4,3,9,5,0,Matches
1058,Anthony Gordon,ENG,"FW,MF",Newcastle Utd,Premier League,21,2001,5.4,14,12,5,7,2,9,20,45.0,11,9,1,8,2,16,1,1,Matches
1059,Anthony Gordon,ENG,FW,Everton,Premier League,21,2001,12.2,34,22,17,10,7,8,24,33.3,16,19,0,19,4,38,11,0,Matches
1060,Leon Goretzka,GER,MF,Bayern Munich,Bundesliga,27,1995,19.2,43,24,21,16,6,27,48,56.3,21,40,3,37,30,73,32,0,Matches
1061,Andoni Gorosabel,ESP,DF,Real Sociedad,La Liga,25,1996,19.0,41,25,23,9,9,26,43,60.5,17,21,2,19,17,58,23,0,Matches
1062,Robin Gosens,GER,DF,Inter,Serie A,28,1994,13.2,34,18,15,10,9,15,25,60.0,10,16,2,14,23,57,15,0,Matches
1063,Mario Götze,GER,MF,Eint Frankfurt,Bundesliga,30,1992,30.4,42,25,13,22,7,14,47,29.8,33,25,0,25,13,55,12,0,Matches
1064,Amine Gouiri,ALG,"FW,MF",Nice,Ligue 1,22,2000,2.5,1,1,1,0,0,0,1,0.0,1,1,0,1,0,1,3,0,Matches
1065,Amine Gouiri,ALG,"FW,MF",Rennes,Ligue 1,22,2000,28.0,42,25,14,16,12,14,33,42.4,19,21,0,21,12,54,10,0,Matches
1066,Jeffrey Gouweleeuw,NED,DF,Augsburg,Bundesliga,31,1991,31.1,42,27,19,17,6,24,49,49.0,25,41,23,18,50,92,141,2,Matches
1067,Jonathan Gradit,FRA,DF,Lens,Ligue 1,29,1992,31.4,62,40,30,25,7,31,53,58.5,22,40,26,14,38,100,83,0,Matches
1068,José Gragera,ESP,"MF,DF",Espanyol,La Liga,21,2000,5.1,19,9,11,6,2,6,11,54.5,5,10,4,6,7,26,18,0,Matches
1069,Alberto Grassi,ITA,MF,Empoli,Serie A,27,1995,13.3,26,21,13,13,0,15,24,62.5,9,23,12,11,27,53,45,0,Matches
1070,Ryan Gravenberch,NED,MF,Bayern Munich,Bundesliga,20,2002,6.4,17,8,4,10,3,7,13,53.8,6,9,1,8,9,26,10,0,Matches
1071,Andrew Gravillon,GLP,DF,Torino,Serie A,24,1998,3.5,3,3,0,3,0,0,0,,0,4,2,2,9,12,16,0,Matches
1072,Andrew Gravillon,GLP,DF,Reims,Ligue 1,24,1998,11.5,16,8,9,6,1,8,13,61.5,5,18,9,9,21,37,36,0,Matches
1073,Demarai Gray,JAM,"FW,MF",Everton,Premier League,26,1996,27.9,33,24,9,14,10,17,31,54.8,14,23,3,20,13,46,18,0,Matches
1074,Adrian Grbić,AUT,"MF,FW",Lorient,Ligue 1,25,1996,0.3,0,0,0,0,0,0,1,0.0,1,3,0,3,0,0,0,0,Matches
1075,Ivo Grbić,CRO,GK,Atlético Madrid,La Liga,26,1996,10.2,0,0,0,0,0,0,0,,0,0,0,0,0,0,9,1,Matches
1076,Jack Grealish,ENG,FW,Manchester City,Premier League,26,1995,22.8,25,16,10,12,3,13,23,56.5,10,17,3,14,7,32,9,0,Matches
1077,Sam Greenwood,ENG,"MF,FW",Leeds United,Premier League,20,2002,4.7,15,7,7,8,0,8,21,38.1,13,10,2,8,1,16,1,0,Matches
1078,Michael Gregoritsch,AUT,FW,Freiburg,Bundesliga,28,1994,23.9,19,12,6,9,4,3,21,14.3,18,23,4,19,5,24,10,0,Matches
1079,Dominik Greif,SVK,GK,Mallorca,La Liga,25,1997,1.0,0,0,0,0,0,0,0,,0,0,0,0,0,0,0,0,Matches
1080,Leo Greiml,AUT,DF,Schalke 04,Bundesliga,21,2001,4.0,10,5,4,5,1,5,12,41.7,7,7,3,4,3,13,16,0,Matches
1081,Clément Grenier,FRA,MF,Mallorca,La Liga,31,1991,8.0,20,8,6,12,2,10,20,50.0,10,9,1,8,6,26,7,0,Matches
1082,Antoine Griezmann,FRA,"FW,MF",Atlético Madrid,La Liga,31,1991,31.8,49,34,15,23,11,20,66,30.3,46,34,3,31,24,73,31,0,Matches
1083,Vincenzo Grifo,ITA,"MF,FW",Freiburg,Bundesliga,29,1993,26.8,29,16,6,15,8,13,31,41.9,18,18,1,17,19,48,19,0,Matches
1084,Lennart Grill,GER,GK,Union Berlin,Bundesliga,23,1999,5.0,0,0,0,0,0,0,1,0.0,1,0,0,0,0,0,1,1,Matches
1085,Christian Groß,GER,MF,Werder Bremen,Bundesliga,33,1989,21.0,56,25,20,34,2,29,60,48.3,31,20,5,15,23,79,38,1,Matches
1086,Pascal Groß,GER,"MF,DF",Brighton,Premier League,31,1991,36.0,59,38,23,27,9,25,55,45.5,30,32,10,22,13,72,21,1,Matches
1087,Brajan Gruda,GER,MF,Mainz 05,Bundesliga,18,2004,0.0,0,0,0,0,0,0,0,,0,0,0,0,0,0,0,0,Matches
1088,Ilia Gruev,BUL,MF,Werder Bremen,Bundesliga,22,2000,17.6,44,27,16,25,3,18,31,58.1,13,23,6,17,22,66,21,1,Matches
1089,Carlos Gruezo,ECU,MF,Augsburg,Bundesliga,27,1995,10.7,21,12,12,9,0,9,16,56.3,7,13,4,9,10,31,15,0,Matches
1090,Vicente Guaita,ESP,GK,Crystal Palace,Premier League,35,1987,27.0,0,0,0,0,0,0,0,,0,0,0,0,0,0,9,1,Matches
1091,Andrés Guardado,MEX,MF,Betis,La Liga,35,1986,15.3,41,25,17,20,4,18,43,41.9,25,14,5,9,23,64,29,0,Matches
1092,Sergi Guardiola,ESP,FW,Valladolid,La Liga,31,1991,5.6,12,7,6,5,1,2,4,50.0,2,6,0,6,2,14,7,0,Matches
1093,Sergi Guardiola,ESP,FW,Cádiz,La Liga,31,1991,12.9,9,7,0,6,3,3,12,25.0,9,5,0,5,3,12,7,0,Matches
1094,Nemanja Gudelj,SRB,"DF,MF",Sevilla,La Liga,30,1991,30.9,43,33,22,18,3,20,33,60.6,13,39,29,10,34,77,102,1,Matches
1095,Gabriel Gudmundsson,SWE,"DF,FW",Lille,Ligue 1,23,1999,9.3,19,11,7,10,2,12,22,54.5,10,11,2,9,10,29,20,0,Matches
1096,Gonçalo Guedes,POR,"FW,MF",Wolves,Premier League,25,1996,7.9,8,6,4,3,1,5,8,62.5,3,4,0,4,1,9,2,0,Matches
1097,Axel Gueguin,FRA,"FW,MF",Montpellier,Ligue 1,17,2005,0.3,0,0,0,0,0,0,0,,0,1,0,1,0,0,0,0,Matches
1098,Marc Guéhi,ENG,DF,Crystal Palace,Premier League,22,2000,37.0,52,27,39,11,2,26,42,61.9,16,45,24,21,45,97,134,3,Matches
1099,Mattéo Guendouzi,FRA,MF,Marseille,Ligue 1,23,1999,23.4,39,18,9,21,9,14,38,36.8,24,12,5,7,21,60,18,0,Matches
1100,Javier Guerra,ESP,MF,Valencia,La Liga,19,2003,6.7,16,13,7,4,5,9,20,45.0,11,8,1,7,11,27,9,0,Matches
1101,Raphaël Guerreiro,POR,"DF,MF",Dortmund,Bundesliga,28,1993,25.4,36,20,13,15,8,21,34,61.8,13,21,2,19,36,72,23,0,Matches
1102,Axel Guessand,FRA,DF,Udinese,Serie A,17,2004,0.9,2,1,2,0,0,1,2,50.0,1,1,0,1,2,4,3,0,Matches
1103,Evann Guessand,CIV,"FW,MF",Nantes,Ligue 1,21,2001,14.0,24,16,8,13,3,6,12,50.0,6,17,1,16,9,33,6,0,Matches
1104,Ander Guevara,ESP,MF,Real Sociedad,La Liga,25,1997,2.5,5,2,2,2,1,1,4,25.0,3,6,1,5,2,7,3,0,Matches
1105,Pape Gueye,SEN,MF,Sevilla,La Liga,23,1999,13.0,37,22,13,21,3,16,33,48.5,17,21,5,16,22,59,10,0,Matches
1106,Pape Gueye,SEN,"MF,DF",Marseille,Ligue 1,23,1999,5.5,18,7,10,7,1,7,15,46.7,8,9,2,7,9,27,2,0,Matches
1107,Josuha Guilavogui,FRA,"DF,MF",Wolfsburg,Bundesliga,31,1990,13.1,18,11,7,10,1,6,17,35.3,11,19,13,6,23,41,52,0,Matches
1108,Frederic Guilbert,FRA,DF,Strasbourg,Ligue 1,27,1994,16.2,47,29,18,23,6,25,43,58.1,18,24,3,21,43,90,33,1,Matches
1109,Hugo Guillamón,ESP,MF,Valencia,La Liga,22,2000,18.1,20,12,10,8,2,8,24,33.3,16,14,2,12,19,39,30,2,Matches
1110,Bruno Guimarães,BRA,MF,Newcastle Utd,Premier League,24,1997,30.3,78,40,27,46,5,38,65,58.5,27,28,4,24,36,114,22,1,Matches
1111,Serhou Guirassy,GUI,MF,Rennes,Ligue 1,26,1996,0.3,0,0,0,0,0,0,0,,0,0,0,0,0,0,0,0,Matches
1112,Serhou Guirassy,GUI,FW,Stuttgart,Bundesliga,26,1996,18.3,4,1,2,2,0,1,2,50.0,1,7,2,5,0,4,14,0,Matches
1113,Rafik Guitane,FRA,FW,Reims,Ligue 1,23,1999,0.0,0,0,0,0,0,0,0,,0,0,0,0,0,0,1,0,Matches
1114,Péter Gulácsi,HUN,GK,RB Leipzig,Bundesliga,32,1990,6.0,0,0,0,0,0,0,0,,0,0,0,0,0,0,2,0,Matches
1115,Manuel Gulde,GER,DF,Freiburg,Bundesliga,31,1991,7.1,14,8,10,4,0,2,4,50.0,2,5,1,4,19,33,25,0,Matches
1116,Gerard Gumbau,ESP,MF,Elche,La Liga,27,1994,30.4,44,25,17,23,4,18,51,35.3,33,32,8,24,28,72,40,0,Matches
1117,Robert Gumny,POL,DF,Augsburg,Bundesliga,24,1998,22.4,34,24,13,15,6,11,27,40.7,16,21,7,14,26,60,62,1,Matches
1118,İlkay Gündoğan,GER,MF,Manchester City,Premier League,31,1990,26.1,30,18,7,13,10,12,34,35.3,22,18,3,15,20,50,13,0,Matches
1119,Christian Günter,GER,"DF,MF",Freiburg,Bundesliga,29,1993,30.5,29,21,18,9,2,13,43,30.2,30,22,4,18,16,45,41,0,Matches
1120,Koray Günter,GER,DF,Hellas Verona,Serie A,27,1994,11.1,10,6,1,8,1,4,7,57.1,3,24,15,9,30,40,46,0,Matches
1121,Koray Günter,GER,DF,Sampdoria,Serie A,27,1994,8.6,10,8,6,4,0,6,9,66.7,3,10,5,5,11,21,46,0,Matches
1122,Gorka Guruzeta,ESP,FW,Athletic Club,La Liga,25,1996,15.8,24,20,6,12,6,11,24,45.8,13,23,2,21,4,28,8,0,Matches
1123,Malo Gusto,FRA,DF,Lyon,Ligue 1,19,2003,17.7,42,26,23,11,8,21,43,48.8,22,22,5,17,28,70,23,1,Matches
1124,Raúl Guti,ESP,MF,Elche,La Liga,25,1996,12.4,18,12,8,9,1,8,18,44.4,10,10,3,7,8,26,6,0,Matches
1125,Miguel Gutiérrez,ESP,DF,Girona,La Liga,21,2001,26.6,41,23,23,13,5,23,37,62.2,14,23,5,18,18,59,42,1,Matches
1126,Joško Gvardiol,CRO,DF,RB Leipzig,Bundesliga,20,2002,24.1,23,17,15,8,0,9,22,40.9,13,34,17,17,34,57,76,1,Matches
1127,Darko Gyabi,ENG,FW,Leeds United,Premier League,18,2004,0.1,2,2,1,1,0,0,0,,0,2,0,2,0,2,0,0,Matches
1128,Emmanuel Gyasi,GHA,"FW,DF",Spezia,Serie A,28,1994,31.2,24,15,11,10,3,9,36,25.0,27,24,6,18,8,32,26,0,Matches
1129,Norbert Gyömbér,SVK,DF,Salernitana,Serie A,30,1992,19.3,32,23,25,6,1,16,24,66.7,8,33,22,11,35,67,92,0,Matches
1130,Christian Gytkjær,DEN,"FW,MF",Monza,Serie A,32,1990,6.2,6,2,1,4,1,2,5,40.0,3,6,1,5,0,6,2,0,Matches
1131,Erling Haaland,NOR,FW,Manchester City,Premier League,22,2000,30.8,3,2,0,2,1,1,5,20.0,4,12,4,8,3,6,14,0,Matches
1132,Nicolas Haas,SUI,MF,Empoli,Serie A,26,1996,12.8,27,13,16,6,5,12,24,50.0,12,16,4,12,8,35,27,0,Matches
1133,Janik Haberer,GER,MF,Union Berlin,Bundesliga,28,1994,24.3,29,17,8,18,3,17,48,35.4,31,35,2,33,14,43,25,0,Matches
1134,Alexander Hack,GER,DF,Mainz 05,Bundesliga,28,1993,12.6,30,18,21,9,0,19,33,57.6,14,18,5,13,24,54,45,1,Matches
1135,Munir El Haddadi,MAR,"MF,FW",Getafe,La Liga,26,1995,12.8,12,7,3,7,2,2,10,20.0,8,23,2,21,9,21,7,0,Matches
1136,Jaouen Hadjam,ALG,DF,Nantes,Ligue 1,19,2003,8.9,27,21,13,9,5,16,25,64.0,9,10,3,7,12,39,12,0,Matches
1137,Dennis Hadzikadunic,BIH,DF,Mallorca,La Liga,24,1998,6.8,9,6,4,5,0,4,4,100.0,0,5,4,1,3,12,27,0,Matches
1138,André Hahn,GER,"FW,MF",Augsburg,Bundesliga,31,1990,4.3,9,5,4,4,1,8,12,66.7,4,9,2,7,4,13,14,0,Matches
1139,Amadou Haidara,MLI,MF,RB Leipzig,Bundesliga,24,1998,15.9,25,11,15,10,0,13,34,38.2,21,26,6,20,26,51,20,0,Matches
1140,Massadio Haïdara,MLI,"DF,MF",Lens,Ligue 1,29,1992,18.6,24,16,9,9,6,12,24,50.0,12,26,9,17,36,60,39,1,Matches
1141,Achraf Hakimi,MAR,"DF,MF",Paris S-G,Ligue 1,23,1998,22.8,54,34,19,20,15,31,59,52.5,28,34,2,32,16,70,19,0,Matches
1142,Lewis Hall,ENG,DF,Chelsea,Premier League,17,2004,7.3,23,12,19,4,0,15,22,68.2,7,8,0,8,11,34,11,1,Matches
1143,Sébastien Haller,CIV,FW,Dortmund,Bundesliga,28,1994,13.6,5,4,2,1,2,0,4,0.0,4,8,0,8,1,6,10,0,Matches
1144,Marcel Halstenberg,GER,DF,RB Leipzig,Bundesliga,30,1991,17.3,40,21,20,15,5,23,41,56.1,18,22,1,21,21,61,29,0,Matches
1145,Mathis Hamdi,FRA,DF,Troyes,Ligue 1,18,2003,0.8,0,0,0,0,0,0,1,0.0,1,0,0,0,1,1,1,0,Matches
1146,Ben Hamed Touré,CIV,FW,Ajaccio,Ligue 1,18,2003,2.3,4,4,2,2,0,1,5,20.0,4,2,0,2,1,5,4,0,Matches
1147,Romain Hamouma,FRA,"FW,MF",Ajaccio,Ligue 1,35,1987,12.0,8,3,3,3,2,3,6,50.0,3,8,0,8,2,10,2,0,Matches
1148,Saïd Hamulic,BIH,FW,Toulouse,Ligue 1,21,2000,1.2,0,0,0,0,0,0,0,,0,0,0,0,0,0,0,0,Matches
1149,Andreas Hanche-Olsen,NOR,DF,Mainz 05,Bundesliga,25,1997,16.6,35,23,24,7,4,22,39,56.4,17,16,8,8,33,68,77,2,Matches
1150,Samir Handanović,SVN,GK,Inter,Serie A,38,1984,13.7,0,0,0,0,0,0,0,,0,0,0,0,0,0,5,0,Matches
1151,Genki Haraguchi,JPN,MF,Stuttgart,Bundesliga,31,1991,8.3,16,7,7,7,2,4,16,25.0,12,13,2,11,8,24,6,0,Matches
1152,Genki Haraguchi,JPN,MF,Union Berlin,Bundesliga,31,1991,5.5,12,8,1,10,1,3,9,33.3,6,7,1,6,3,15,9,0,Matches
1153,Amine Harit,MAR,"MF,FW",Marseille,Ligue 1,25,1997,5.7,6,4,0,3,3,3,8,37.5,5,4,1,3,4,10,6,0,Matches
1154,Luke Harris,WAL,"MF,FW",Fulham,Premier League,17,2005,0.1,0,0,0,0,0,0,0,,0,0,0,0,0,0,0,0,Matches
1155,Jack Harrison,ENG,"FW,MF",Leeds United,Premier League,25,1996,30.1,41,17,5,15,21,12,52,23.1,40,47,2,45,22,63,25,0,Matches
1156,Abdou Harroui,NED,MF,Sassuolo,Serie A,24,1998,7.2,17,6,6,7,4,2,7,28.6,5,6,1,5,2,19,10,0,Matches
1157,Makoto Hasebe,JPN,DF,Eint Frankfurt,Bundesliga,38,1984,14.5,18,12,16,2,0,7,22,31.8,15,22,9,13,17,35,45,0,Matches
1158,Haissem Hassan,FRA,"FW,MF",Villarreal,La Liga,20,2002,0.6,0,0,0,0,0,0,2,0.0,2,0,0,0,1,1,0,0,Matches
1159,Hans Hateboer,NED,DF,Atalanta,Serie A,28,1994,15.5,21,13,11,8,2,11,27,40.7,16,23,4,19,12,33,25,0,Matches
1160,Kai Havertz,GER,"FW,MF",Chelsea,Premier League,23,1999,28.5,34,16,4,20,10,10,30,33.3,20,28,0,28,7,41,41,0,Matches
1161,Eden Hazard,BEL,FW,Real Madrid,La Liga,31,1991,2.2,0,0,0,0,0,0,2,0.0,2,1,0,1,1,1,0,0,Matches
1162,Thorgan Hazard,BEL,"FW,DF",Dortmund,Bundesliga,29,1993,5.2,17,6,5,11,1,12,17,70.6,5,6,0,6,5,22,5,0,Matches
1163,Rhys Healey,WAL,FW,Toulouse,Ligue 1,27,1994,0.7,0,0,0,0,0,0,0,,0,0,0,0,0,0,0,0,Matches
1164,Jan Paul van Hecke,NED,DF,Brighton,Premier League,22,2000,3.3,8,6,3,4,1,5,5,100.0,0,8,5,3,6,14,9,0,Matches
1165,Jonas Hector,GER,DF,Köln,Bundesliga,32,1990,31.4,112,66,59,43,10,66,113,58.4,47,61,9,52,39,151,74,1,Matches
1166,Hwang Hee-chan,KOR,"FW,MF",Wolves,Premier League,26,1996,12.6,20,9,7,8,5,6,20,30.0,14,18,2,16,5,25,5,0,Matches
1167,Gauthier Hein,FRA,"MF,FW",Auxerre,Ligue 1,25,1996,20.8,27,20,13,11,3,18,48,37.5,30,10,0,10,6,33,10,0,Matches
1168,Dominique Heintz,GER,DF,Bochum,Bundesliga,28,1993,8.8,13,9,5,7,1,6,17,35.3,11,11,7,4,12,25,34,0,Matches
1169,Dean Henderson,ENG,GK,Nott'ham Forest,Premier League,25,1997,18.0,0,0,0,0,0,0,0,,0,0,0,0,0,0,12,1,Matches
1170,Jordan Henderson,ENG,MF,Liverpool,Premier League,32,1990,23.0,32,23,10,18,4,15,36,41.7,21,21,3,18,21,53,16,1,Matches
1171,Liam Henderson,SCO,MF,Empoli,Serie A,26,1996,11.2,13,10,6,5,2,4,21,19.0,17,10,2,8,10,23,10,0,Matches
1172,Jack Hendry,SCO,DF,Cremonese,Serie A,27,1995,2.4,0,0,0,0,0,0,1,0.0,1,2,1,1,1,1,7,0,Matches
1173,Wayne Hennessey,WAL,GK,Nott'ham Forest,Premier League,35,1987,3.0,1,0,1,0,0,1,1,100.0,0,0,0,0,0,1,2,0,Matches
1174,Benjamin Henrichs,GER,"DF,MF",RB Leipzig,Bundesliga,25,1997,24.3,73,46,41,29,3,43,66,65.2,23,48,4,44,35,108,46,0,Matches
1175,Henrique,BRA,"DF,FW",Lyon,Ligue 1,28,1994,4.0,9,4,3,2,4,6,13,46.2,7,3,1,2,5,14,8,0,Matches
1176,Luiz Henrique,BRA,FW,Betis,La Liga,21,2001,20.1,48,34,27,15,6,20,44,45.5,24,22,0,22,14,62,17,0,Matches
1177,Matheus Henrique,BRA,MF,Sassuolo,Serie A,24,1997,21.6,26,12,9,11,6,12,24,50.0,12,15,4,11,12,38,10,0,Matches
1178,Rico Henry,ENG,DF,Brentford,Premier League,25,1997,36.0,57,31,20,28,9,22,41,53.7,19,29,8,21,30,87,84,1,Matches
1179,Thomas Henry,FRA,FW,Hellas Verona,Serie A,27,1994,11.4,5,3,1,1,3,1,5,20.0,4,6,2,4,0,5,14,0,Matches
1180,Christophe Hérelle,MTQ,DF,Brest,Ligue 1,29,1992,11.8,10,4,7,2,1,4,13,30.8,9,16,11,5,20,30,48,0,Matches
1181,Mario Hermoso,ESP,DF,Atlético Madrid,La Liga,27,1995,23.4,22,15,14,6,2,9,30,30.0,21,19,9,10,19,41,85,1,Matches
1182,Javi Hernández,ESP,DF,Girona,La Liga,24,1998,12.4,21,12,12,7,2,13,21,61.9,8,10,5,5,7,28,38,0,Matches
1183,Aridane Hernández,ESP,DF,Osasuna,La Liga,33,1989,19.9,21,15,17,4,0,12,25,48.0,13,34,21,13,28,49,96,1,Matches
1184,Lucas Hernández,FRA,DF,Bayern Munich,Bundesliga,26,1996,5.3,6,4,3,3,0,5,6,83.3,1,2,1,1,5,11,7,0,Matches
1185,Luis Hernández,ESP,DF,Cádiz,La Liga,33,1989,35.0,33,21,25,7,1,22,36,61.1,14,31,24,7,31,64,145,0,Matches
1186,Mario Hernández,ESP,DF,Rayo Vallecano,La Liga,23,1999,1.1,3,2,2,1,0,3,7,42.9,4,2,0,2,2,5,0,0,Matches
1187,Theo Hernández,FRA,DF,Milan,Serie A,24,1997,30.8,43,24,27,15,1,22,38,57.9,16,34,7,27,21,64,35,1,Matches
1188,Jorge Herrando,ESP,DF,Osasuna,La Liga,21,2001,0.3,0,0,0,0,0,0,0,,0,1,0,1,0,0,3,0,Matches
1189,Ander Herrera,ESP,MF,Athletic Club,La Liga,32,1989,7.7,18,10,8,7,3,6,18,33.3,12,12,3,9,11,29,12,0,Matches
1190,Sergio Herrera,ESP,GK,Osasuna,La Liga,29,1993,17.0,2,0,2,0,0,2,2,100.0,0,1,0,1,1,3,6,2,Matches
1191,Yangel Herrera,VEN,"MF,FW",Girona,La Liga,24,1998,10.7,26,9,9,14,3,6,15,40.0,9,14,1,13,4,30,12,0,Matches
1192,Patrick Herrmann,GER,"FW,MF",Gladbach,Bundesliga,31,1991,1.8,6,2,4,1,1,2,4,50.0,2,2,0,2,2,8,1,0,Matches
1193,Son Heung-min,KOR,"MF,FW",Tottenham,Premier League,30,1992,32.1,24,12,7,8,9,9,30,30.0,21,23,2,21,13,37,6,0,Matches
1194,Aaron Hickey,SCO,DF,Brentford,Premier League,20,2002,21.3,38,26,27,11,0,18,32,56.3,14,18,7,11,17,55,32,1,Matches
1195,Isak Hien,SWE,DF,Hellas Verona,Serie A,23,1999,29.0,73,36,54,19,0,38,61,62.3,23,40,17,23,31,104,92,1,Matches
1196,Omar El Hilali,MAR,"DF,MF",Espanyol,La Liga,18,2003,1.0,3,2,3,0,0,1,2,50.0,1,1,0,1,1,4,6,0,Matches
1197,Piero Hincapié,ECU,"DF,MF",Leverkusen,Bundesliga,20,2002,27.3,51,34,28,20,3,25,38,65.8,13,41,20,21,31,82,83,1,Matches
1198,Jack Hinshelwood,ENG,FW,Brighton,Premier League,17,2005,0.0,1,0,1,0,0,0,0,,0,0,0,0,0,1,0,0,Matches
1199,Morten Hjulmand,DEN,MF,Lecce,Serie A,23,1999,32.9,90,52,49,40,1,37,67,55.2,30,43,11,32,72,162,54,0,Matches
1200,Adam Hložek,CZE,"FW,MF",Leverkusen,Bundesliga,20,2002,14.3,9,4,4,3,2,3,9,33.3,6,9,2,7,6,15,9,0,Matches
1201,Joseph Hodge,IRL,MF,Wolves,Premier League,19,2002,1.9,5,2,1,3,1,3,4,75.0,1,5,0,5,0,5,2,1,Matches
1202,Nicolas Höfler,GER,MF,Freiburg,Bundesliga,32,1990,31.3,66,35,28,35,3,27,61,44.3,34,40,13,27,58,124,49,0,Matches
1203,Jonas Hofmann,GER,"FW,MF",Gladbach,Bundesliga,30,1992,29.8,31,16,17,8,6,15,52,28.8,37,36,2,34,16,47,21,0,Matches
1204,Philipp Hofmann,GER,FW,Bochum,Bundesliga,29,1993,29.2,18,11,0,13,5,5,12,41.7,7,20,8,12,6,24,48,0,Matches
1205,Rob Holding,ENG,DF,Arsenal,Premier League,26,1995,6.3,8,5,4,4,0,3,6,50.0,3,6,5,1,3,11,27,1,Matches
1206,Lucas Höler,GER,"FW,MF",Freiburg,Bundesliga,28,1994,16.7,19,14,5,7,7,6,22,27.3,16,22,5,17,10,29,17,0,Matches
1207,Mason Holgate,ENG,DF,Everton,Premier League,25,1996,5.6,11,7,8,3,0,3,11,27.3,8,7,3,4,7,18,28,0,Matches
1208,Emil Holm,SWE,DF,Spezia,Serie A,22,2000,15.5,26,15,13,8,5,16,31,51.6,15,21,6,15,9,35,41,0,Matches
1209,Noah Holm,NOR,"FW,MF",Reims,Ligue 1,21,2001,2.2,6,4,2,2,2,2,5,40.0,3,0,0,0,0,6,5,0,Matches
1210,Gerrit Holtmann,PHI,"FW,MF",Bochum,Bundesliga,27,1995,10.5,14,7,6,7,1,12,21,57.1,9,15,1,14,2,16,4,0,Matches
1211,Martin Hongla,CMR,MF,Hellas Verona,Serie A,24,1998,5.8,8,5,4,4,0,5,5,100.0,0,7,1,6,6,14,9,0,Matches
1212,Martin Hongla,CMR,"DF,MF",Valladolid,La Liga,24,1998,14.5,18,13,13,5,0,11,21,52.4,10,15,12,3,8,26,46,1,Matches
1213,Franck Honorat,FRA,"FW,MF",Brest,Ligue 1,25,1996,28.2,41,29,20,8,13,19,34,55.9,15,22,2,20,21,62,18,0,Matches
1214,Jannes Horn,GER,"DF,FW",Bochum,Bundesliga,25,1997,0.7,2,1,1,1,0,1,1,100.0,0,1,0,1,3,5,2,0,Matches
1215,Cédric Hountondji,BEN,DF,Angers,Ligue 1,28,1994,34.4,50,36,31,17,2,19,29,65.5,10,44,22,22,59,109,132,1,Matches
1216,Ilyes Housni,FRA,FW,Paris S-G,Ligue 1,17,2005,0.1,1,1,1,0,0,1,1,100.0,0,0,0,0,0,1,0,0,Matches
1217,Lukáš Hrádecký,FIN,GK,Leverkusen,Bundesliga,32,1989,33.0,0,0,0,0,0,0,0,,0,0,0,0,0,0,3,3,Matches
1218,Petko Hristov,BUL,DF,Spezia,Serie A,23,1999,4.1,6,4,2,4,0,5,8,62.5,3,4,2,2,4,10,12,0,Matches
1219,Ajdin Hrustic,AUS,MF,Hellas Verona,Serie A,26,1996,2.5,2,1,1,1,0,1,2,50.0,1,2,0,2,0,2,2,1,Matches
1220,Timo Hübers,GER,DF,Köln,Bundesliga,26,1996,28.4,43,28,35,8,0,24,52,46.2,28,27,13,14,58,101,153,0,Matches
1221,Callum Hudson-Odoi,ENG,"FW,MF",Leverkusen,Bundesliga,21,2000,6.7,5,3,4,0,1,1,1,100.0,0,0,0,0,2,7,4,0,Matches
1222,Will Hughes,ENG,MF,Crystal Palace,Premier League,27,1995,9.4,29,16,11,16,2,11,20,55.0,9,16,7,9,16,45,9,0,Matches
1223,Mats Hummels,GER,DF,Dortmund,Bundesliga,33,1988,22.4,62,34,38,22,2,32,55,58.2,23,30,16,14,33,95,100,1,Matches
1224,Adrien Hunou,FRA,"MF,FW",Angers,Ligue 1,28,1994,24.8,39,20,17,16,6,16,45,35.6,29,35,0,35,7,46,7,0,Matches
1225,Denis Huseinbasic,BIH,"MF,FW",Köln,Bundesliga,21,2001,8.8,23,9,8,11,4,10,25,40.0,15,16,2,14,4,27,5,0,Matches
1226,Omari Hutchinson,ENG,FW,Chelsea,Premier League,18,2003,0.3,0,0,0,0,0,0,0,,0,0,0,0,1,1,0,0,Matches
1227,Elseid Hysaj,ALB,DF,Lazio,Serie A,28,1994,22.2,39,23,24,11,4,23,41,56.1,18,31,7,24,20,59,42,0,Matches
1228,Pierre Højbjerg,DEN,MF,Tottenham,Premier League,26,1995,34.8,56,30,28,22,6,26,67,38.8,41,46,17,29,49,105,64,1,Matches
1229,Rasmus Højlund,DEN,FW,Atalanta,Serie A,19,2003,20.4,4,3,0,2,2,1,6,16.7,5,9,1,8,1,5,5,0,Matches
1230,Iago,BRA,"DF,MF",Augsburg,Bundesliga,25,1997,17.8,34,16,20,10,4,11,29,37.9,18,18,5,13,17,51,53,0,Matches
1231,Pablo Ibáñez,ESP,MF,Osasuna,La Liga,23,1998,11.8,29,13,7,17,5,12,35,34.3,23,19,2,17,8,37,24,0,Matches
1232,Roger Ibanez,BRA,DF,Roma,Serie A,23,1998,31.1,67,33,38,26,3,32,48,66.7,16,30,11,19,66,133,95,2,Matches
1233,Arijon Ibrahimović,GER,MF,Bayern Munich,Bundesliga,16,2005,0.2,1,1,1,0,0,0,0,,0,0,0,0,0,1,0,0,Matches
1234,Zlatan Ibrahimović,SWE,FW,Milan,Serie A,40,1981,1.6,0,0,0,0,0,0,0,,0,1,1,0,0,0,2,0,Matches
1235,Mounaim El Idrissy,FRA,FW,Ajaccio,Ligue 1,23,1999,27.7,32,19,5,20,7,10,36,27.8,26,22,0,22,13,45,20,0,Matches
1236,Antonio Iervolino,ITA,MF,Salernitana,Serie A,19,2003,0.1,0,0,0,0,0,0,1,0.0,1,0,0,0,0,0,0,0,Matches
1237,Iglesias,ESP,"DF,MF",Getafe,La Liga,24,1998,23.8,61,35,40,18,3,33,65,50.8,32,40,5,35,21,82,91,1,Matches
1238,Borja Iglesias,ESP,FW,Betis,La Liga,29,1993,26.3,8,4,3,3,2,2,13,15.4,11,9,1,8,1,9,17,0,Matches
1239,Igor,BRA,DF,Fiorentina,Serie A,24,1998,22.9,43,29,21,18,4,20,27,74.1,7,33,14,19,25,68,56,2,Matches
1240,Kelechi Iheanacho,NGA,"FW,MF",Leicester City,Premier League,25,1996,12.5,7,2,0,3,4,3,10,30.0,7,9,1,8,0,7,8,0,Matches
1241,Jonathan Ikone,FRA,FW,Fiorentina,Serie A,24,1998,22.3,16,8,5,6,5,5,14,35.7,9,18,1,17,4,20,3,0,Matches
1242,Ivan Ilić,SRB,MF,Hellas Verona,Serie A,21,2001,9.5,16,10,9,7,0,6,11,54.5,5,10,1,9,8,24,14,0,Matches
1243,Ivan Ilić,SRB,MF,Torino,Serie A,21,2001,13.1,18,7,6,11,1,10,20,50.0,10,12,3,9,5,23,10,0,Matches
1244,Rareş Ilie,ROU,"MF,FW",Nice,Ligue 1,19,2003,1.6,3,3,0,1,2,2,4,50.0,2,2,0,2,1,4,1,0,Matches
1245,Samuel Iling-Junior,ENG,"DF,FW",Juventus,Serie A,18,2003,3.5,7,2,3,1,3,4,9,44.4,5,5,1,4,2,9,6,0,Matches
1246,Emirhan İlkhan,TUR,MF,Torino,Serie A,18,2004,1.0,1,1,0,1,0,1,1,100.0,0,3,1,2,2,3,2,0,Matches
1247,Emirhan İlkhan,TUR,MF,Sampdoria,Serie A,18,2004,1.3,6,3,2,2,2,2,3,66.7,1,5,1,4,0,6,3,0,Matches
1248,Asier Illarramendi,ESP,MF,Real Sociedad,La Liga,32,1990,12.0,36,18,10,22,4,16,44,36.4,28,27,8,19,18,54,20,0,Matches
1249,Ciro Immobile,ITA,FW,Lazio,Serie A,32,1990,24.7,11,5,4,4,3,6,9,66.7,3,10,2,8,1,12,14,0,Matches
1250,Danny Ings,ENG,FW,West Ham,Premier League,30,1992,8.6,9,8,0,4,5,5,14,35.7,9,8,2,6,3,12,5,0,Matches
1251,Danny Ings,ENG,FW,Aston Villa,Premier League,30,1992,9.2,10,5,1,6,3,1,6,16.7,5,12,1,11,1,11,11,0,Matches
1252,Marcus Ingvartsen,DEN,"FW,MF",Mainz 05,Bundesliga,26,1996,14.6,4,1,0,2,2,1,10,10.0,9,9,1,8,4,8,10,0,Matches
1253,Bonke Innocent,NGA,MF,Lorient,Ligue 1,26,1996,13.1,28,17,13,14,1,11,36,30.6,25,22,5,17,26,54,31,0,Matches
1254,Alexander Isak,SWE,FW,Newcastle Utd,Premier League,22,1999,16.9,18,8,4,7,7,10,28,35.7,18,21,2,19,4,22,8,0,Matches
1255,Alexander Isak,SWE,FW,Real Sociedad,La Liga,22,1999,1.7,1,1,0,0,1,0,0,,0,0,0,0,0,1,2,0,Matches
1256,Isco,ESP,"MF,FW",Sevilla,La Liga,30,1992,8.9,15,9,6,5,4,8,14,57.1,6,3,0,3,10,25,3,0,Matches
1257,Ismaily,BRA,DF,Lille,Ligue 1,32,1990,19.8,41,18,16,16,9,17,32,53.1,15,25,5,20,21,62,39,0,Matches
1258,Ardian Ismajli,ALB,DF,Empoli,Serie A,25,1996,23.3,40,32,25,15,0,18,24,75.0,6,47,31,16,27,67,120,0,Matches
1259,Ko Itakura,JPN,DF,Gladbach,Bundesliga,25,1997,22.0,29,17,18,7,4,16,30,53.3,14,41,25,16,27,56,95,0,Matches
1260,Hiroki Ito,JPN,DF,Stuttgart,Bundesliga,23,1999,28.5,40,29,24,14,2,18,35,51.4,17,38,17,21,40,80,94,0,Matches
1261,Junya Ito,JPN,FW,Reims,Ligue 1,29,1993,32.4,40,20,14,15,11,13,53,24.5,40,29,1,28,8,48,4,1,Matches
1262,Diego Iturralde,ESP,DF,Sevilla,La Liga,19,2003,0.5,1,0,1,0,0,0,2,0.0,2,0,0,0,0,1,1,0,Matches
1263,Andreas Ivan,ROU,MF,Schalke 04,Bundesliga,27,1995,0.5,0,0,0,0,0,0,1,0.0,1,0,0,0,0,0,1,0,Matches
1264,Mihailo Ivanović,SRB,FW,Sampdoria,Serie A,17,2004,0.0,0,0,0,0,0,0,0,,0,0,0,0,0,0,0,0,Matches
1265,Daniel Iversen,DEN,GK,Leicester City,Premier League,25,1997,12.0,0,0,0,0,0,0,0,,0,0,0,0,0,0,6,1,Matches
1266,Alex Iwobi,NGA,"MF,FW",Everton,Premier League,26,1996,37.5,69,37,37,28,4,33,65,50.8,32,41,2,39,25,94,29,0,Matches
1267,Armando Izzo,ITA,DF,Monza,Serie A,30,1992,27.4,73,50,44,27,2,29,45,64.4,16,29,17,12,50,123,87,1,Matches
1268,Nicolas Jackson,SEN,FW,Villarreal,La Liga,21,2001,17.8,14,11,2,10,2,2,8,25.0,6,18,2,16,2,16,4,0,Matches
1269,Lee Jae-sung,KOR,MF,Mainz 05,Bundesliga,29,1992,21.0,38,17,9,21,8,16,36,44.4,20,29,5,24,17,55,21,0,Matches
1270,Paul Jaeckel,GER,DF,Union Berlin,Bundesliga,24,1998,13.3,24,18,11,11,2,17,35,48.6,18,11,5,6,19,43,44,1,Matches
1271,Mato Jajalo,BIH,MF,Udinese,Serie A,34,1988,0.7,0,0,0,0,0,0,1,0.0,1,0,0,0,0,0,2,0,Matches
1272,Kristijan Jakić,CRO,"DF,MF",Eint Frankfurt,Bundesliga,25,1997,16.2,33,21,19,12,2,22,41,53.7,19,32,10,22,14,47,49,1,Matches
1273,Ismail Jakobs,SEN,"DF,FW",Monaco,Ligue 1,22,1999,12.4,11,5,7,3,1,5,12,41.7,7,9,1,8,9,20,18,0,Matches
1274,Marin Jakoliš,CRO,FW,Angers,Ligue 1,25,1996,0.3,1,1,0,0,1,0,0,,0,0,0,0,0,1,0,0,Matches
1275,Daniel James,WAL,FW,Leeds United,Premier League,24,1997,2.2,6,2,1,3,2,3,6,50.0,3,4,0,4,2,8,2,0,Matches
1276,Daniel James,WAL,FW,Fulham,Premier League,24,1997,6.9,10,6,4,5,1,4,9,44.4,5,5,1,4,1,11,5,0,Matches
1277,Reece James,ENG,"DF,MF",Chelsea,Premier League,22,1999,13.8,31,20,10,18,3,15,19,78.9,4,17,2,15,12,43,23,0,Matches
1278,Vitaly Janelt,GER,"MF,DF",Brentford,Premier League,24,1998,24.5,54,27,20,24,10,21,49,42.9,28,29,9,20,29,83,26,0,Matches
1279,Saidy Janko,GAM,DF,Bochum,Bundesliga,26,1995,12.6,23,15,13,8,2,12,20,60.0,8,24,10,14,11,34,33,1,Matches
1280,Pontus Jansson,SWE,DF,Brentford,Premier League,31,1991,8.0,5,3,4,1,0,3,5,60.0,2,13,9,4,9,14,38,0,Matches
1281,Tony Jantschke,GER,"DF,MF",Gladbach,Bundesliga,32,1990,1.1,2,1,1,1,0,1,1,100.0,0,5,3,2,0,2,5,0,Matches
1282,Adnan Januzaj,BEL,FW,Sevilla,La Liga,27,1995,0.5,0,0,0,0,0,0,1,0.0,1,0,0,0,1,1,0,0,Matches
1283,Léo Jardim,BRA,GK,Lille,Ligue 1,27,1995,6.0,0,0,0,0,0,0,1,0.0,1,0,0,0,0,0,0,1,Matches
1284,Luis Javier Suárez,COL,FW,Almería,La Liga,24,1997,16.6,17,11,5,6,6,6,26,23.1,20,13,3,10,3,20,10,0,Matches
1285,Luis Javier Suárez,COL,FW,Marseille,Ligue 1,24,1997,3.3,4,1,1,2,1,1,4,25.0,3,1,0,1,3,7,6,0,Matches
1286,Dany Jean,HAI,"DF,MF",Strasbourg,Ligue 1,19,2002,0.1,0,0,0,0,0,0,1,0.0,1,1,0,1,0,0,0,0,Matches
1287,Julian Jeanvier,GUI,DF,Auxerre,Ligue 1,30,1992,19.6,32,17,24,8,0,13,22,59.1,9,24,17,7,27,59,96,1,Matches
1288,Jeffinho,BRA,FW,Lyon,Ligue 1,22,1999,5.0,17,4,4,9,4,6,15,40.0,9,6,0,6,1,18,0,0,Matches
1289,Fredrik Jensen,FIN,"FW,MF",Augsburg,Bundesliga,24,1997,10.3,15,10,8,3,4,5,10,50.0,5,12,5,7,4,19,12,0,Matches
1290,Mathias Jensen,DEN,MF,Brentford,Premier League,26,1996,31.1,71,36,29,30,12,34,97,35.1,63,54,5,49,32,103,24,1,Matches
1291,Moritz Jenz,GER,DF,Schalke 04,Bundesliga,23,1999,10.5,14,11,8,5,1,5,8,62.5,3,16,10,6,8,22,53,1,Matches
1292,Jesé,ESP,FW,Sampdoria,Serie A,29,1993,2.3,2,0,0,2,0,0,1,0.0,1,3,1,2,1,3,2,0,Matches
1293,Gabriel Jesus,BRA,FW,Arsenal,Premier League,25,1997,22.9,33,25,16,8,9,15,31,48.4,16,27,3,24,11,44,15,1,Matches
1294,Juan Jesus,BRA,DF,Napoli,Serie A,31,1991,10.4,16,11,9,6,1,9,12,75.0,3,18,11,7,10,26,29,0,Matches
1295,Raúl Jiménez,MEX,FW,Wolves,Premier League,31,1991,9.4,9,6,3,5,1,3,6,50.0,3,9,0,9,0,9,8,0,Matches
1296,Joaquín,ESP,"MF,FW",Betis,La Liga,41,1981,5.5,3,3,2,1,0,1,3,33.3,2,7,2,5,4,7,5,0,Matches
1297,Joelinton,BRA,"MF,FW",Newcastle Utd,Premier League,25,1996,29.6,70,49,36,26,8,26,62,41.9,36,52,7,45,48,118,39,0,Matches
1298,Þórir Jóhann Helgason,ISL,MF,Lecce,Serie A,21,2000,2.5,2,2,1,0,1,2,3,66.7,1,3,1,2,3,5,3,0,Matches
1299,Ben Johnson,ENG,DF,West Ham,Premier League,22,2000,9.6,20,14,12,4,4,12,18,66.7,6,12,4,8,9,29,28,1,Matches
1300,Brennan Johnson,WAL,"FW,MF",Nott'ham Forest,Premier League,21,2001,32.6,34,20,18,8,8,8,29,27.6,21,30,1,29,5,39,7,1,Matches
1301,Sam Johnstone,ENG,GK,Crystal Palace,Premier League,29,1993,9.0,0,0,0,0,0,0,0,,0,0,0,0,0,0,5,0,Matches
1302,Paul Joly,FRA,DF,Auxerre,Ligue 1,22,2000,9.6,33,21,21,10,2,19,35,54.3,16,13,2,11,24,57,29,2,Matches
1303,Curtis Jones,ENG,MF,Liverpool,Premier League,21,2001,11.5,34,17,8,12,14,18,31,58.1,13,12,2,10,3,37,9,0,Matches
1304,Frenkie de Jong,NED,MF,Barcelona,La Liga,25,1997,28.2,46,26,16,21,9,17,41,41.5,24,11,1,10,35,81,22,1,Matches
1305,Joan Jordán,ESP,MF,Sevilla,La Liga,28,1994,17.7,32,17,13,17,2,16,38,42.1,22,14,7,7,16,48,14,2,Matches
1306,Jorginho,ITA,MF,Arsenal,Premier League,30,1991,9.5,18,13,6,10,2,5,24,20.8,19,7,2,5,9,27,8,0,Matches
1307,Jorginho,ITA,MF,Chelsea,Premier League,30,1991,14.2,42,23,22,14,6,22,46,47.8,24,18,3,15,21,63,7,0,Matches
1308,Josan,ESP,"DF,MF",Elche,La Liga,32,1989,12.0,25,20,20,5,0,14,27,51.9,13,8,0,8,7,32,15,1,Matches
1309,Willian José,BRA,FW,Betis,La Liga,30,1991,8.1,9,6,6,3,0,4,9,44.4,5,4,0,4,1,10,15,0,Matches
1310,Joselu,ESP,FW,Espanyol,La Liga,32,1990,33.2,13,11,3,4,6,4,17,23.5,13,25,4,21,8,21,43,0,Matches
1311,Mateo Joseph,ESP,"FW,MF",Leeds United,Premier League,18,2003,0.3,0,0,0,0,0,0,0,,0,1,0,1,0,0,1,0,Matches
1312,Diogo Jota,POR,FW,Liverpool,Premier League,25,1996,12.6,23,15,8,8,7,12,37,32.4,25,5,0,5,3,26,11,0,Matches
1313,Stevan Jovetić,MNE,"FW,MF",Hertha BSC,Bundesliga,32,1989,9.9,3,2,2,1,0,1,11,9.1,10,2,1,1,2,5,10,0,Matches
1314,Luka Jović,SRB,"FW,MF",Fiorentina,Serie A,24,1997,17.0,6,3,1,4,1,2,8,25.0,6,7,2,5,2,8,10,0,Matches
1315,Juanmi,ESP,FW,Betis,La Liga,29,1993,10.3,14,10,4,7,3,7,31,22.6,24,10,0,10,4,18,4,0,Matches
1316,Juanpe,ESP,DF,Girona,La Liga,31,1991,15.8,19,11,10,9,0,11,17,64.7,6,12,9,3,10,29,60,1,Matches
1317,Jubal,BRA,DF,Auxerre,Ligue 1,28,1993,35.7,41,26,29,11,1,19,38,50.0,19,57,34,23,53,94,193,0,Matches
1318,Christopher Jullien,FRA,DF,Montpellier,Ligue 1,29,1993,29.9,46,28,29,14,3,28,51,54.9,23,35,18,17,43,89,114,1,Matches
1319,Anthony Jung,GER,"DF,FW",Werder Bremen,Bundesliga,30,1991,29.1,46,27,19,20,7,31,58,53.4,27,30,6,24,22,68,63,0,Matches
1320,Eli Junior Kroupi,FRA,"FW,MF",Lorient,Ligue 1,16,2006,0.1,0,0,0,0,0,0,1,0.0,1,0,0,0,1,1,0,0,Matches
1321,Lago Junior,CIV,"FW,MF",Mallorca,La Liga,31,1990,0.6,1,0,0,1,0,1,1,100.0,0,0,0,0,0,1,0,0,Matches
1322,Hamed Junior Traorè,CIV,"FW,MF",Bournemouth,Premier League,22,2000,4.7,17,11,5,9,3,6,18,33.3,12,9,0,9,2,19,1,0,Matches
1323,Hamed Junior Traorè,CIV,"MF,FW",Sassuolo,Serie A,22,2000,6.6,11,6,4,6,1,4,11,36.4,7,4,0,4,2,13,0,1,Matches
1324,Vinicius Júnior,BRA,FW,Real Madrid,La Liga,22,2000,31.4,30,21,10,12,8,14,39,35.9,25,24,1,23,6,36,1,0,Matches
1325,Josip Juranović,CRO,DF,Union Berlin,Bundesliga,26,1995,10.4,9,7,5,2,2,7,18,38.9,11,9,3,6,6,15,22,1,Matches
1326,James Justin,ENG,DF,Leicester City,Premier League,24,1998,13.9,20,18,7,12,1,9,18,50.0,9,24,6,18,15,35,47,0,Matches
1327,Filip Jørgensen,DEN,GK,Villarreal,La Liga,20,2002,2.0,0,0,0,0,0,0,1,0.0,1,0,0,0,0,0,0,0,Matches
1328,Mathias Jørgensen,DEN,DF,Brentford,Premier League,32,1990,12.3,17,8,9,8,0,9,21,42.9,12,19,12,7,16,33,39,1,Matches
1329,Ozan Kabak,TUR,DF,Hoffenheim,Bundesliga,22,2000,26.5,51,34,27,21,3,17,30,56.7,13,35,23,12,45,96,83,0,Matches
1330,Issa Kaboré,BFA,DF,Marseille,Ligue 1,21,2001,11.4,33,19,10,18,5,21,32,65.6,11,11,1,10,12,45,21,1,Matches
1331,Abdoul Kader Bamba,FRA,"FW,MF",Nantes,Ligue 1,28,1994,0.9,0,0,0,0,0,0,2,0.0,2,3,1,2,0,0,1,0,Matches
1332,Pavel Kadeřábek,CZE,DF,Hoffenheim,Bundesliga,30,1992,18.5,26,20,10,9,7,15,23,65.2,8,12,2,10,14,40,37,1,Matches
1333,Tino Kadewere,ZIM,"FW,MF",Mallorca,La Liga,26,1996,6.0,6,3,3,3,0,4,9,44.4,5,6,2,4,2,8,1,0,Matches
1334,Kaiky,BRA,DF,Almería,La Liga,18,2004,6.5,5,5,5,0,0,3,7,42.9,4,18,10,8,11,16,28,0,Matches
1335,Florian Kainz,AUT,"MF,FW",Köln,Bundesliga,29,1992,26.0,21,10,7,12,2,8,26,30.8,18,27,6,21,32,53,30,1,Matches
1336,Gaël Kakuta,COD,FW,Lens,Ligue 1,31,1991,0.2,0,0,0,0,0,0,0,,0,0,0,0,0,0,1,0,Matches
1337,Sasa Kalajdzic,AUT,FW,Wolves,Premier League,25,1997,0.5,0,0,0,0,0,0,0,,0,0,0,0,1,1,0,0,Matches
1338,Sasa Kalajdzic,AUT,FW,Stuttgart,Bundesliga,25,1997,2.6,3,2,0,1,2,1,3,33.3,2,1,0,1,0,3,0,0,Matches
1339,Arnaud Kalimuendo,FRA,FW,Rennes,Ligue 1,20,2002,20.5,15,8,3,6,6,5,20,25.0,15,15,2,13,2,17,9,0,Matches
1340,Yayah Kallon,SLE,"MF,FW",Hellas Verona,Serie A,21,2001,9.6,14,10,5,4,5,7,12,58.3,5,10,0,10,8,22,5,0,Matches
1341,Gedeon Kalulu,COD,DF,Lorient,Ligue 1,24,1997,27.1,64,34,43,14,7,30,48,62.5,18,32,3,29,28,92,79,2,Matches
1342,Pierre Kalulu,FRA,DF,Milan,Serie A,22,2000,28.3,57,39,33,21,3,28,42,66.7,14,41,17,24,41,98,56,1,Matches
1343,Justin-Noël Kalumba,FRA,DF,Angers,Ligue 1,17,2004,6.1,9,5,5,2,2,5,16,31.3,11,4,1,3,4,13,5,0,Matches
1344,Daichi Kamada,JPN,MF,Eint Frankfurt,Bundesliga,25,1996,25.2,51,31,10,37,4,31,57,54.4,26,31,2,29,16,67,17,1,Matches
1345,Waren Kamanzi,NOR,DF,Toulouse,Ligue 1,21,2000,7.4,16,9,9,5,2,13,19,68.4,6,8,2,6,8,24,9,0,Matches
1346,Bingourou Kamara,SEN,GK,Montpellier,Ligue 1,25,1996,4.5,0,0,0,0,0,0,0,,0,0,0,0,0,0,2,0,Matches
1347,Boubacar Kamara,FRA,MF,Aston Villa,Premier League,22,1999,19.7,58,25,25,23,10,27,56,48.2,29,38,12,26,19,77,24,3,Matches
1348,Jakub Kamiński,POL,"FW,DF",Wolfsburg,Bundesliga,20,2002,22.9,36,25,15,13,8,20,40,50.0,20,37,2,35,8,44,15,0,Matches
1349,Marcin Kamiński,POL,DF,Schalke 04,Bundesliga,30,1992,7.0,6,4,4,0,2,2,4,50.0,2,8,7,1,9,15,28,0,Matches
1350,Kevin Kampl,SVN,MF,RB Leipzig,Bundesliga,31,1990,15.2,21,11,6,14,1,6,27,22.2,21,26,9,17,22,43,11,0,Matches
1351,Nordine Kandil,FRA,"MF,FW",Strasbourg,Ligue 1,20,2001,1.1,3,2,1,2,0,0,3,0.0,3,2,0,2,1,4,1,0,Matches
1352,Harry Kane,ENG,FW,Tottenham,Premier League,29,1993,37.8,15,12,1,6,8,7,21,33.3,14,27,7,20,2,17,18,0,Matches
1353,Lee Kang-in,KOR,"MF,FW",Mallorca,La Liga,21,2001,31.4,42,24,10,22,10,18,61,29.5,43,25,2,23,11,53,7,0,Matches
1354,Wilfried Kanga,CIV,FW,Hertha BSC,Bundesliga,24,1998,15.7,5,4,2,1,2,2,4,50.0,2,14,3,11,2,7,13,0,Matches
1355,N'Golo Kanté,FRA,MF,Chelsea,Premier League,31,1991,5.8,16,10,4,10,2,4,8,50.0,4,11,0,11,6,22,2,0,Matches
1356,Kenan Karaman,TUR,FW,Schalke 04,Bundesliga,28,1994,10.8,11,8,3,5,3,3,12,25.0,9,9,1,8,3,14,9,0,Matches
1357,Yann Karamoh,FRA,"MF,FW",Torino,Serie A,24,1998,8.0,5,2,3,2,0,1,5,20.0,4,5,0,5,0,5,2,1,Matches
1358,Atakan Karazor,GER,MF,Stuttgart,Bundesliga,25,1996,21.8,49,30,18,25,6,24,47,51.1,23,39,11,28,31,80,44,0,Matches
1359,Ayman Kari,FRA,"MF,DF",Lorient,Ligue 1,17,2004,1.1,0,0,0,0,0,0,0,,0,4,0,4,3,3,0,0,Matches
1360,Jon Karrikaburu,ESP,FW,Real Sociedad,La Liga,19,2002,1.0,1,0,0,1,0,0,0,,0,2,0,2,0,1,0,0,Matches
1361,Rick Karsdorp,NED,DF,Roma,Serie A,27,1995,7.9,21,13,11,7,3,13,22,59.1,9,0,0,0,7,28,15,1,Matches
1362,Denso Kasius,NED,DF,Bologna,Serie A,19,2002,3.8,12,6,7,4,1,8,10,80.0,2,6,3,3,3,15,6,0,Matches
1363,Thomas Kastanaras,GRE,"FW,DF",Stuttgart,Bundesliga,19,2003,0.8,0,0,0,0,0,0,0,,0,1,0,1,0,0,0,0,Matches
1364,Grigoris Kastanos,CYP,"MF,DF",Salernitana,Serie A,24,1998,14.3,39,23,18,19,2,16,40,40.0,24,20,6,14,8,47,8,0,Matches
1365,Silas Katompa,COD,"FW,MF",Stuttgart,Bundesliga,23,1998,22.1,25,17,5,14,6,6,20,30.0,14,17,2,15,8,33,1,0,Matches
1366,Moise Kean,ITA,FW,Juventus,Serie A,22,2000,11.1,8,6,2,5,1,3,7,42.9,4,4,0,4,5,13,2,0,Matches
1367,Michael Keane,ENG,DF,Everton,Premier League,29,1993,10.9,7,4,5,2,0,5,8,62.5,3,12,7,5,14,21,55,1,Matches
1368,Neeskens Kebano,COD,FW,Fulham,Premier League,30,1992,8.5,17,9,8,6,3,9,18,50.0,9,14,0,14,1,18,8,0,Matches
1369,Kévin Keben Biakolo,CMR,DF,Toulouse,Ligue 1,18,2004,4.0,3,2,2,0,1,0,4,0.0,4,1,0,1,5,8,9,0,Matches
1370,Thilo Kehrer,GER,DF,West Ham,Premier League,25,1996,24.8,43,24,25,14,4,21,45,46.7,24,16,6,10,34,77,76,1,Matches
1371,Check Keita,FRA,DF,Reims,Ligue 1,19,2003,7.6,12,9,9,3,0,4,9,44.4,5,6,5,1,5,17,24,1,Matches
1372,Naby Keïta,GUI,MF,Liverpool,Premier League,27,1995,3.3,5,4,2,3,0,1,4,25.0,3,1,0,1,2,7,3,0,Matches
1373,Yannik Keitel,GER,MF,Freiburg,Bundesliga,22,2000,7.6,11,7,4,6,1,3,5,60.0,2,6,3,3,13,24,8,0,Matches
1374,Caoimhín Kelleher,IRL,GK,Liverpool,Premier League,23,1998,1.0,0,0,0,0,0,0,0,,0,0,0,0,0,0,0,0,Matches
1375,Lloyd Kelly,ENG,DF,Bournemouth,Premier League,23,1998,22.7,33,18,23,9,1,13,19,68.4,6,26,15,11,26,59,101,1,Matches
1376,Marc-Oliver Kempf,GER,DF,Hertha BSC,Bundesliga,27,1995,30.1,44,27,29,14,1,16,22,72.7,6,42,32,10,51,95,143,0,Matches
1377,Kenedy,BRA,"FW,DF",Valladolid,La Liga,26,1996,3.1,6,2,3,3,0,2,4,50.0,2,2,0,2,1,7,0,0,Matches
1378,Jonjoe Kenny,ENG,DF,Hertha BSC,Bundesliga,25,1997,24.9,46,34,27,16,3,24,42,57.1,18,38,9,29,46,92,74,0,Matches
1379,Franck Kessié,CIV,MF,Barcelona,La Liga,25,1996,11.0,15,9,6,6,3,8,18,44.4,10,10,2,8,12,27,11,2,Matches
1380,Saîf-Eddine Khaoui,TUN,MF,Clermont Foot,Ligue 1,27,1995,22.5,47,28,14,25,8,15,47,31.9,32,17,2,15,33,80,8,0,Matches
1381,Wahbi Khazri,TUN,"FW,MF",Montpellier,Ligue 1,31,1991,18.2,26,13,13,7,6,6,25,24.0,19,17,1,16,9,35,20,0,Matches
1382,Rani Khedira,GER,MF,Union Berlin,Bundesliga,28,1994,32.0,60,33,21,32,7,25,50,50.0,25,33,10,23,40,100,33,0,Matches
1383,Anthony Khelifa,FRA,DF,Ajaccio,Ligue 1,16,2005,0.1,0,0,0,0,0,0,0,,0,0,0,0,0,0,0,0,Matches
1384,Kiké,ESP,FW,Osasuna,La Liga,32,1989,11.3,6,3,0,4,2,2,5,40.0,3,6,1,5,1,7,13,0,Matches
1385,Luca Kilian,GER,DF,Köln,Bundesliga,22,1999,12.5,22,16,14,7,1,12,21,57.1,9,16,8,8,11,33,48,0,Matches
1386,Max Kilman,ENG,DF,Wolves,Premier League,25,1997,36.7,36,20,26,9,1,16,30,53.3,14,70,42,28,19,55,164,1,Matches
1387,Joshua Kimmich,GER,MF,Bayern Munich,Bundesliga,27,1995,31.2,78,49,24,46,8,38,72,52.8,34,36,7,29,41,119,39,2,Matches
1388,Presnel Kimpembe,FRA,DF,Paris S-G,Ligue 1,26,1995,8.1,17,8,9,6,2,9,13,69.2,4,12,7,5,13,30,9,1,Matches
1389,Jakub Kiwior,POL,DF,Arsenal,Premier League,22,2000,4.7,7,5,6,1,0,5,8,62.5,3,5,3,2,6,13,10,0,Matches
1390,Jakub Kiwior,POL,DF,Spezia,Serie A,22,2000,16.0,22,17,15,7,0,6,24,25.0,18,26,18,8,24,46,71,1,Matches
1391,Simon Kjær,DEN,DF,Milan,Serie A,33,1989,11.2,15,8,9,6,0,7,11,63.6,4,14,11,3,9,24,35,1,Matches
1392,Pascal Klemens,GER,DF,Hertha BSC,Bundesliga,17,2005,1.0,0,0,0,0,0,0,1,0.0,1,1,0,1,1,1,3,0,Matches
1393,Mateusz Klich,POL,"MF,FW",Leeds United,Premier League,32,1990,3.1,12,8,3,4,5,7,13,53.8,6,4,0,4,0,12,1,0,Matches
1394,Lukas Klostermann,GER,DF,RB Leipzig,Bundesliga,26,1996,10.1,16,8,7,9,0,8,15,53.3,7,6,3,3,13,29,31,0,Matches
1395,Justin Kluivert,NED,"FW,MF",Valencia,La Liga,23,1999,16.1,17,14,7,4,6,6,12,50.0,6,4,0,4,7,24,4,0,Matches
1396,Ansgar Knauff,GER,DF,Eint Frankfurt,Bundesliga,20,2002,14.3,36,25,22,11,3,15,34,44.1,19,19,1,18,15,51,26,0,Matches
1397,Robin Knoche,GER,DF,Union Berlin,Bundesliga,30,1992,31.9,45,29,29,12,4,24,47,51.1,23,35,18,17,38,83,140,0,Matches
1398,Gregor Kobel,SUI,GK,Dortmund,Bundesliga,24,1997,27.0,0,0,0,0,0,0,1,0.0,1,1,0,1,0,0,7,2,Matches
1399,Robin Koch,GER,DF,Leeds United,Premier League,26,1996,35.3,53,30,32,16,5,24,56,42.9,32,44,21,23,43,96,152,1,Matches
1400,Samuel Koeberlé,FRA,MF,Reims,Ligue 1,17,2004,0.0,0,0,0,0,0,0,0,,0,0,0,0,0,0,0,0,Matches
1401,Rudy Kohon,FRA,DF,Troyes,Ligue 1,18,2004,0.7,4,3,4,0,0,2,2,100.0,0,1,0,1,1,5,2,0,Matches
1402,Dominik Kohr,GER,MF,Mainz 05,Bundesliga,28,1994,25.5,59,33,23,31,5,29,61,47.5,32,46,9,37,34,93,26,1,Matches
1403,Koke,ESP,MF,Atlético Madrid,La Liga,30,1992,28.3,55,38,23,25,7,28,72,38.9,44,35,13,22,20,75,19,0,Matches
1404,Sead Kolašinac,BIH,DF,Marseille,Ligue 1,29,1993,24.6,52,36,24,22,6,24,37,64.9,13,19,2,17,43,95,35,1,Matches
1405,Luca Koleosho,ITA,"FW,DF",Espanyol,La Liga,17,2004,0.7,2,2,0,0,2,1,2,50.0,1,1,0,1,0,2,0,0,Matches
1406,Randal Kolo Muani,FRA,FW,Eint Frankfurt,Bundesliga,23,1998,29.2,14,10,3,3,8,1,9,11.1,8,19,2,17,3,17,13,0,Matches
1407,Timothée Kolodziejczak,FRA,DF,Schalke 04,Bundesliga,30,1991,0.3,0,0,0,0,0,0,1,0.0,1,0,0,0,1,1,1,0,Matches
1408,Cheick Konaté,MLI,DF,Clermont Foot,Ligue 1,18,2004,6.4,19,12,10,7,2,13,22,59.1,9,7,1,6,13,32,8,1,Matches
1409,Ibrahima Konaté,FRA,DF,Liverpool,Premier League,23,1999,17.2,38,26,25,13,0,16,27,59.3,11,12,5,7,26,64,61,4,Matches
1410,Geoffrey Kondogbia,CTA,MF,Atlético Madrid,La Liga,29,1993,11.2,40,23,19,20,1,17,25,68.0,8,9,1,8,26,66,12,1,Matches
1411,Ibrahima Koné,MLI,FW,Lorient,Ligue 1,23,1999,17.5,24,13,3,13,8,5,11,45.5,6,13,0,13,4,28,18,0,Matches
1412,Manu Koné,FRA,MF,Gladbach,Bundesliga,21,2001,29.0,74,39,37,33,4,24,47,51.1,23,44,12,32,32,106,21,0,Matches
1413,Youssouf Koné,MLI,DF,Ajaccio,Ligue 1,27,1995,10.2,28,19,24,4,0,18,25,72.0,7,9,2,7,12,40,32,1,Matches
1414,Ezri Konsa,ENG,DF,Aston Villa,Premier League,24,1997,36.9,42,20,25,15,2,18,26,69.2,8,41,23,18,26,68,120,3,Matches
1415,Teun Koopmeiners,NED,MF,Atalanta,Serie A,24,1998,31.8,46,26,15,24,7,28,55,50.9,27,41,5,36,19,65,36,2,Matches
1416,Odilon Kossonou,CIV,DF,Leverkusen,Bundesliga,21,2001,16.9,21,14,12,7,2,8,16,50.0,8,26,11,15,24,45,58,1,Matches
1417,Filip Kostić,SRB,"DF,FW",Juventus,Serie A,29,1992,28.5,41,26,17,20,4,21,47,44.7,26,30,4,26,16,57,32,0,Matches
1418,Filip Kostić,SRB,"DF,MF",Eint Frankfurt,Bundesliga,29,1992,0.8,2,0,1,1,0,0,0,,0,0,0,0,1,3,0,0,Matches
1419,Christian Kouamé,CIV,FW,Fiorentina,Serie A,24,1997,20.7,27,18,8,10,9,7,14,50.0,7,15,3,12,12,39,8,0,Matches
1420,Rominigue Kouamé,MLI,MF,Troyes,Ligue 1,25,1996,29.6,44,27,28,14,2,17,41,41.5,24,32,11,21,49,93,46,1,Matches
1421,Tomáš Koubek,CZE,GK,Augsburg,Bundesliga,29,1992,11.0,0,0,0,0,0,0,0,,0,0,0,0,0,0,7,0,Matches
1422,Kalidou Koulibaly,SEN,DF,Chelsea,Premier League,31,1991,20.0,45,31,34,8,3,26,40,65.0,14,30,13,17,29,74,77,0,Matches
1423,Jules Koundé,FRA,DF,Barcelona,La Liga,23,1998,27.0,37,23,18,13,6,21,31,67.7,10,24,9,15,19,56,61,3,Matches
1424,Boubakar Kouyaté,MLI,DF,Montpellier,Ligue 1,25,1997,14.0,31,18,18,11,2,19,35,54.3,16,24,14,10,34,65,73,1,Matches
1425,Cheikhou Kouyaté,SEN,MF,Nott'ham Forest,Premier League,32,1989,9.8,29,21,18,8,3,9,13,69.2,4,14,2,12,10,39,24,0,Matches
1426,Mateo Kovačić,CRO,MF,Chelsea,Premier League,28,1994,19.0,36,24,16,14,6,14,36,38.9,22,10,1,9,19,55,16,0,Matches
1427,Viktor Kovalenko,UKR,MF,Spezia,Serie A,26,1996,6.1,9,5,1,6,2,5,8,62.5,3,11,2,9,4,13,7,0,Matches
1428,Soichiro Kozuki,JPN,"FW,MF",Schalke 04,Bundesliga,21,2000,4.2,6,4,3,3,0,4,6,66.7,2,5,0,5,3,9,3,0,Matches
1429,Emil Krafth,SWE,DF,Newcastle Utd,Premier League,27,1994,0.0,0,0,0,0,0,0,0,,0,0,0,0,0,0,0,0,Matches
1430,Alex Král,CZE,MF,Schalke 04,Bundesliga,24,1998,26.2,34,24,10,22,2,17,37,45.9,20,31,6,25,17,51,53,0,Matches
1431,Andrej Kramarić,CRO,"MF,FW",Hoffenheim,Bundesliga,31,1991,26.5,5,2,2,1,2,1,11,9.1,10,14,2,12,6,11,13,0,Matches
1432,Christoph Kramer,GER,MF,Gladbach,Bundesliga,31,1991,24.7,44,33,24,15,5,22,55,40.0,33,34,2,32,17,61,40,0,Matches
1433,Tom Krauß,GER,MF,Schalke 04,Bundesliga,21,2001,27.9,112,68,39,62,11,51,100,51.0,49,39,6,33,36,148,35,0,Matches
1434,Rasmus Kristensen,DEN,DF,Leeds United,Premier League,25,1997,21.8,62,35,35,21,6,42,76,55.3,34,32,14,18,35,97,61,0,Matches
1435,Julian Kristoffersen,NOR,FW,Salernitana,Serie A,25,1997,0.2,0,0,0,0,0,0,0,,0,1,0,1,0,0,0,0,Matches
1436,Raimonds Krollis,LVA,"FW,DF",Spezia,Serie A,20,2001,0.4,1,1,0,0,1,0,1,0.0,1,0,0,0,0,1,0,0,Matches
1437,Toni Kroos,GER,MF,Real Madrid,La Liga,32,1990,23.9,51,32,16,33,2,23,69,33.3,46,23,4,19,24,75,11,0,Matches
1438,Rade Krunić,BIH,MF,Milan,Serie A,28,1993,18.4,40,28,18,18,4,16,50,32.0,34,31,11,20,16,56,21,0,Matches
1439,Max Kruse,GER,"MF,FW",Wolfsburg,Bundesliga,34,1988,3.0,1,1,0,1,0,0,1,0.0,1,2,1,1,0,1,1,0,Matches
1440,Lukas Kübler,GER,DF,Freiburg,Bundesliga,29,1992,18.2,37,25,24,9,4,18,30,60.0,12,25,11,14,29,66,50,0,Matches
1441,Takefusa Kubo,JPN,"FW,MF",Real Sociedad,La Liga,21,2001,27.1,44,26,18,16,10,16,38,42.1,22,29,1,28,9,53,4,0,Matches
1442,Dejan Kulusevski,SWE,"MF,FW",Tottenham,Premier League,22,2000,23.0,38,15,23,7,8,16,44,36.4,28,19,0,19,13,51,7,0,Matches
1443,Sael Kumbedi,FRA,DF,Lyon,Ligue 1,17,2005,14.7,47,27,27,13,7,20,38,52.6,18,23,7,16,10,57,16,0,Matches
1444,Marash Kumbulla,ALB,DF,Roma,Serie A,22,2000,2.9,4,4,2,2,0,2,3,66.7,1,2,1,1,4,8,6,0,Matches
1445,Pierre Kunde,CMR,"MF,FW",Bochum,Bundesliga,27,1995,4.2,12,6,3,8,1,6,14,42.9,8,7,1,6,7,19,9,0,Matches
1446,Alou Kuol,AUS,FW,Stuttgart,Bundesliga,21,2000,0.1,0,0,0,0,0,0,0,,0,0,0,0,0,0,0,0,Matches
1447,Layvin Kurzawa,FRA,DF,Fulham,Premier League,29,1992,1.5,3,2,1,1,1,3,3,100.0,0,1,1,0,2,5,4,0,Matches
1448,Khvicha Kvaratskhelia,GEO,FW,Napoli,Serie A,21,2001,28.0,43,23,12,8,23,17,43,39.5,26,20,0,20,5,48,6,1,Matches
1449,Grejohn Kyei,FRA,FW,Clermont Foot,Ligue 1,26,1995,24.8,16,7,2,9,5,4,13,30.8,9,14,3,11,6,22,22,0,Matches
1450,Daniel Kyereh,GHA,"MF,FW",Freiburg,Bundesliga,26,1996,6.2,6,4,2,4,0,3,6,50.0,3,4,0,4,2,8,6,0,Matches
1451,Giorgos Kyriakopoulos,GRE,"DF,FW",Bologna,Serie A,26,1996,7.8,13,6,4,5,4,10,23,43.5,13,14,2,12,4,17,10,0,Matches
1452,Giorgos Kyriakopoulos,GRE,"FW,DF",Sassuolo,Serie A,26,1996,8.5,21,8,7,9,5,10,14,71.4,4,7,1,6,11,32,12,1,Matches
1453,César de la Hoz,ESP,MF,Almería,La Liga,30,1992,18.6,37,20,17,18,2,19,37,51.4,18,26,6,20,13,50,37,0,Matches
1454,Luca de la Torre,USA,MF,Celta Vigo,La Liga,24,1998,16.5,28,19,11,14,3,12,32,37.5,20,22,1,21,9,37,6,0,Matches
1455,Rémy Labeau Lascary,GLP,"FW,MF",Lens,Ligue 1,19,2003,1.4,4,2,4,0,0,0,0,,0,4,0,4,1,5,0,0,Matches
1456,Gaëtan Laborde,FRA,FW,Nice,Ligue 1,28,1994,27.8,45,25,13,17,15,18,40,45.0,22,27,2,25,9,54,13,0,Matches
1457,Gaëtan Laborde,FRA,FW,Rennes,Ligue 1,28,1994,2.8,1,1,1,0,0,0,1,0.0,1,1,0,1,0,1,1,0,Matches
1458,Alexandre Lacazette,FRA,FW,Lyon,Ligue 1,31,1991,32.5,43,23,7,17,19,10,29,34.5,19,23,3,20,15,58,4,0,Matches
1459,Qazim Laçi,ALB,MF,Ajaccio,Ligue 1,26,1996,2.4,6,3,2,3,1,4,9,44.4,5,5,0,5,2,8,3,0,Matches
1460,Maxence Lacroix,FRA,DF,Wolfsburg,Bundesliga,22,2000,18.1,22,13,15,7,0,8,16,50.0,8,22,11,11,26,48,85,0,Matches
1461,Alban Lafont,FRA,GK,Nantes,Ligue 1,23,1999,37.0,0,0,0,0,0,0,1,0.0,1,0,0,0,0,0,20,4,Matches
1462,Aïssa Laïdouni,TUN,MF,Union Berlin,Bundesliga,25,1996,9.7,14,7,6,8,0,5,17,29.4,12,22,4,18,9,23,3,0,Matches
1463,Konrad Laimer,AUT,MF,RB Leipzig,Bundesliga,25,1997,16.3,60,31,23,30,7,30,54,55.6,24,31,4,27,18,78,8,0,Matches
1464,Stefan Lainer,AUT,DF,Gladbach,Bundesliga,29,1992,9.1,16,8,10,5,1,10,23,43.5,13,8,1,7,14,30,34,1,Matches
1465,Kenny Lala,MAD,DF,Brest,Ligue 1,30,1991,15.7,36,19,19,15,2,22,38,57.9,16,15,5,10,21,57,28,0,Matches
1466,Adam Lallana,ENG,"MF,FW",Brighton,Premier League,34,1988,8.0,9,4,6,2,1,0,7,0.0,7,6,0,6,2,11,1,0,Matches
1467,Vassilis Lambropoulos,GRE,DF,Bochum,Bundesliga,32,1990,7.0,10,8,7,3,0,6,9,66.7,3,5,3,2,13,23,41,0,Matches
1468,Érik Lamela,ARG,"FW,MF",Sevilla,La Liga,30,1992,20.5,46,27,14,16,16,12,34,35.3,22,26,2,24,7,53,3,0,Matches
1469,Mohamed Lamine Bayo,GUI,"FW,MF",Lille,Ligue 1,24,1998,7.2,3,3,0,2,1,0,12,0.0,12,3,1,2,0,3,1,0,Matches
1470,Sam Lammers,NED,FW,Sampdoria,Serie A,25,1997,12.2,12,5,2,7,3,6,15,40.0,9,10,3,7,6,18,11,0,Matches
1471,Sam Lammers,NED,FW,Empoli,Serie A,25,1997,9.8,20,10,5,9,6,7,11,63.6,4,4,1,3,3,23,8,0,Matches
1472,Tariq Lamptey,GHA,DF,Brighton,Premier League,21,2000,5.0,11,6,6,4,1,5,7,71.4,2,7,3,4,7,18,2,0,Matches
1473,Manuel Lanzini,ARG,"MF,FW",West Ham,Premier League,29,1993,2.8,2,2,1,1,0,2,6,33.3,4,2,0,2,2,4,0,0,Matches
1474,Aymeric Laporte,ESP,DF,Manchester City,Premier League,28,1994,11.0,11,8,6,4,1,7,11,63.6,4,10,4,6,3,14,30,1,Matches
1475,Julien Laporte,FRA,DF,Lorient,Ligue 1,28,1993,18.4,22,16,18,3,1,16,22,72.7,6,33,27,6,18,40,108,2,Matches
1476,Cyle Larin,CAN,FW,Valladolid,La Liga,27,1995,16.3,9,3,2,4,3,3,7,42.9,4,6,3,3,0,9,15,0,Matches
1477,Juan Larios,ESP,DF,Southampton,Premier League,18,2004,1.7,7,6,6,1,0,5,5,100.0,0,2,0,2,3,10,4,0,Matches
1478,Yasser Larouci,ALG,"DF,MF",Troyes,Ligue 1,21,2001,20.0,23,13,13,8,2,15,24,62.5,9,15,1,14,26,49,46,0,Matches
1479,Jordan Larsson,SWE,"FW,MF",Schalke 04,Bundesliga,25,1997,5.1,8,5,1,7,0,2,9,22.2,7,9,0,9,4,12,3,0,Matches
1480,Kevin Lasagna,ITA,"FW,MF",Hellas Verona,Serie A,29,1992,17.5,12,6,7,3,2,6,14,42.9,8,17,1,16,5,17,13,0,Matches
1481,Jamaal Lascelles,ENG,DF,Newcastle Utd,Premier League,28,1993,2.4,1,0,1,0,0,1,1,100.0,0,3,2,1,0,1,17,0,Matches
1482,Juanmi Latasa,ESP,FW,Getafe,La Liga,21,2001,5.0,5,4,2,0,3,1,1,100.0,0,3,1,2,1,6,8,0,Matches
1483,Toni Lato,ESP,"DF,MF",Valencia,La Liga,24,1997,10.2,23,11,9,12,2,9,21,42.9,12,10,1,9,6,29,14,0,Matches
1484,Danny Latza,GER,MF,Schalke 04,Bundesliga,32,1989,9.5,17,13,8,8,1,5,17,29.4,12,16,1,15,5,22,15,0,Matches
1485,Armand Lauriente,FRA,FW,Sassuolo,Serie A,23,1998,24.2,21,15,5,7,9,8,21,38.1,13,20,0,20,12,33,8,0,Matches
1486,Armand Lauriente,FRA,FW,Lorient,Ligue 1,23,1998,3.0,8,7,3,4,1,3,7,42.9,4,5,1,4,4,12,1,0,Matches
1487,Roméo Lavia,BEL,MF,Southampton,Premier League,18,2004,24.7,60,35,27,29,4,21,53,39.6,32,47,11,36,33,93,23,1,Matches
1488,Lázaro,BRA,"FW,MF",Almería,La Liga,20,2002,8.0,4,3,3,0,1,3,15,20.0,12,16,1,15,2,6,1,0,Matches
1489,Valentino Lazaro,AUT,DF,Torino,Serie A,26,1996,15.3,10,5,6,0,4,6,14,42.9,8,16,3,13,3,13,29,0,Matches
1490,Marko Lazetić,SRB,FW,Milan,Serie A,18,2004,0.1,0,0,0,0,0,0,0,,0,0,0,0,0,0,0,0,Matches
1491,Darko Lazović,SRB,"MF,DF",Hellas Verona,Serie A,31,1990,24.9,24,13,9,12,3,13,29,44.8,16,14,3,11,16,40,19,0,Matches
1492,Manuel Lazzari,ITA,DF,Lazio,Serie A,28,1993,20.9,33,21,13,14,6,21,36,58.3,15,20,6,14,18,51,36,1,Matches
1493,Théo Le Bris,FRA,"MF,DF",Lorient,Ligue 1,19,2002,16.1,31,19,17,11,3,15,33,45.5,18,21,2,19,18,49,31,0,Matches
1494,Julien Le Cardinal,FRA,DF,Lens,Ligue 1,24,1997,1.8,6,4,5,0,1,4,6,66.7,2,3,0,3,2,8,5,0,Matches
1495,Jérémy Le Douaron,FRA,"MF,FW",Brest,Ligue 1,24,1998,23.0,15,9,5,9,1,3,27,11.1,24,29,2,27,11,26,30,0,Matches
1496,Enzo Le Fée,FRA,MF,Lorient,Ligue 1,22,2000,33.6,108,64,52,40,16,43,113,38.1,70,50,5,45,34,142,38,1,Matches
1497,Vincent Le Goff,FRA,DF,Lorient,Ligue 1,32,1989,37.0,75,32,56,16,3,45,62,72.6,17,29,9,20,41,116,105,1,Matches
1498,Maxime Le Marchand,FRA,DF,Strasbourg,Ligue 1,32,1989,22.4,39,24,23,14,2,19,31,61.3,12,22,14,8,37,76,74,0,Matches
1499,Robin Le Normand,ESP,DF,Real Sociedad,La Liga,25,1996,31.1,36,23,25,9,2,14,27,51.9,13,22,14,8,33,69,93,0,Matches
1500,Rafael Leão,POR,"FW,MF",Milan,Serie A,23,1999,26.9,8,7,2,3,3,6,14,42.9,8,9,2,7,15,23,8,0,Matches
1501,Paolo Lebas,FRA,MF,Ajaccio,Ligue 1,19,2003,0.6,0,0,0,0,0,0,0,,0,0,0,0,0,0,0,0,Matches
1502,Jean-Louis Leca,FRA,GK,Lens,Ligue 1,36,1985,1.0,0,0,0,0,0,0,0,,0,0,0,0,0,0,0,1,Matches
1503,Benjamin Lecomte,FRA,GK,Espanyol,La Liga,31,1991,10.0,0,0,0,0,0,0,0,,0,0,0,0,0,0,3,2,Matches
1504,Benjamin Lecomte,FRA,GK,Montpellier,Ligue 1,31,1991,19.0,0,0,0,0,0,0,2,0.0,2,0,0,0,0,0,6,0,Matches
1505,Jeremías Ledesma,ARG,GK,Cádiz,La Liga,29,1993,34.0,3,2,3,0,0,3,7,42.9,4,1,0,1,2,5,23,3,Matches
1506,Pierre Lees-Melou,FRA,MF,Brest,Ligue 1,29,1993,30.7,97,55,55,37,5,57,123,46.3,66,48,13,35,52,149,46,1,Matches
1507,Diogo Leite,POR,DF,Union Berlin,Bundesliga,23,1999,25.0,35,20,21,14,0,21,34,61.8,13,23,14,9,26,61,99,1,Matches
1508,Maxim Leitsch,GER,DF,Mainz 05,Bundesliga,24,1998,7.4,9,7,6,3,0,4,5,80.0,1,7,4,3,18,27,26,1,Matches
1509,Florian Lejeune,FRA,DF,Rayo Vallecano,La Liga,31,1991,28.5,28,17,19,8,1,17,25,68.0,8,24,16,8,15,43,123,0,Matches
1510,Iñigo Lekue,ESP,DF,Athletic Club,La Liga,29,1993,14.7,24,17,20,4,0,12,19,63.2,7,16,2,14,13,37,31,1,Matches
1511,Thomas Lemar,FRA,MF,Atlético Madrid,La Liga,26,1995,13.9,30,18,10,13,7,10,28,35.7,18,12,3,9,7,37,12,0,Matches
1512,Félix Lemaréchal,FRA,MF,Brest,Ligue 1,18,2003,3.2,5,5,2,1,2,0,3,0.0,3,6,0,6,1,6,2,0,Matches
1513,Dexter Lembikisa,JAM,DF,Wolves,Premier League,18,2003,0.3,0,0,0,0,0,0,0,,0,0,0,0,0,0,0,0,Matches
1514,Mario Lemina,GAB,MF,Wolves,Premier League,28,1993,14.4,38,24,22,13,3,20,38,52.6,18,26,8,18,14,52,24,1,Matches
1515,Mario Lemina,GAB,"MF,DF",Nice,Ligue 1,28,1993,9.3,32,21,11,14,7,12,18,66.7,6,13,5,8,11,43,20,0,Matches
1516,Tim Lemperle,GER,"FW,MF",Köln,Bundesliga,20,2002,1.5,6,4,3,1,2,3,5,60.0,2,5,0,5,1,7,4,0,Matches
1517,Clément Lenglet,FRA,DF,Tottenham,Premier League,27,1995,22.4,38,23,18,15,5,16,34,47.1,18,26,11,15,18,56,68,2,Matches
1518,Bernd Leno,GER,GK,Fulham,Premier League,30,1992,36.0,0,0,0,0,0,0,3,0.0,3,0,0,0,0,0,18,1,Matches
1519,Christopher Lenz,GER,DF,Eint Frankfurt,Bundesliga,27,1994,14.3,29,21,17,7,5,16,37,43.2,21,16,3,13,21,50,34,0,Matches
1520,Donovan Léon,GUF,GK,Auxerre,Ligue 1,29,1992,2.0,0,0,0,0,0,0,0,,0,0,0,0,0,0,1,0,Matches
1521,Sergio León,ESP,FW,Valladolid,La Liga,33,1989,14.8,6,4,0,4,2,3,6,50.0,3,6,0,6,0,6,4,0,Matches
1522,Johann Lepenant,FRA,MF,Lyon,Ligue 1,19,2002,21.5,58,34,24,27,7,32,86,37.2,54,29,5,24,28,86,17,3,Matches
1523,Mehdi Léris,ALG,"MF,DF",Sampdoria,Serie A,24,1998,27.3,63,46,30,24,9,23,55,41.8,32,38,6,32,27,90,34,0,Matches
1524,Jefferson Lerma,COL,MF,Bournemouth,Premier League,27,1994,36.1,50,30,23,23,4,20,45,44.4,25,32,15,17,47,97,91,2,Matches
1525,Benjamin Leroy,FRA,GK,Ajaccio,Ligue 1,33,1989,31.1,0,0,0,0,0,0,2,0.0,2,0,0,0,1,1,16,2,Matches
1526,Léo Leroy,FRA,MF,Montpellier,Ligue 1,22,2000,13.2,53,38,24,26,3,31,57,54.4,26,25,2,23,14,67,8,0,Matches
1527,Alexandre Letellier,FRA,GK,Paris S-G,Ligue 1,31,1990,0.1,0,0,0,0,0,0,0,,0,0,0,0,0,0,0,0,Matches
1528,Ruan Levine,BRA,"MF,FW",Ajaccio,Ligue 1,23,1999,0.3,2,2,1,1,0,0,0,,0,1,0,1,2,4,0,0,Matches
1529,Robert Lewandowski,POL,FW,Barcelona,La Liga,33,1988,31.6,17,11,2,5,10,7,14,50.0,7,20,0,20,2,19,14,0,Matches
1530,Jamie Leweling,GER,"FW,MF",Union Berlin,Bundesliga,21,2001,2.9,5,3,2,2,1,3,5,60.0,2,3,0,3,1,6,0,0,Matches
1531,Jamal Lewis,NIR,"DF,FW",Newcastle Utd,Premier League,24,1998,0.1,0,0,0,0,0,0,0,,0,0,0,0,0,0,0,0,Matches
1532,Rico Lewis,ENG,"DF,MF",Manchester City,Premier League,17,2004,10.0,16,9,9,5,2,6,11,54.5,5,8,4,4,6,22,13,1,Matches
1533,Keane Lewis-Potter,ENG,"FW,MF",Brentford,Premier League,21,2001,3.6,1,0,0,1,0,0,0,,0,5,1,4,0,1,2,0,Matches
1534,Dimitri Liénard,FRA,"DF,MF",Strasbourg,Ligue 1,34,1988,17.1,46,29,20,18,8,34,57,59.6,23,28,4,24,16,62,24,0,Matches
1535,Philipp Lienhart,AUT,DF,Freiburg,Bundesliga,26,1996,27.8,29,18,19,10,0,13,27,48.1,14,29,15,14,35,64,97,0,Matches
1536,Matthijs de Ligt,NED,DF,Bayern Munich,Bundesliga,22,1999,26.7,32,23,15,16,1,15,24,62.5,9,31,20,11,23,55,85,0,Matches
1537,Dimitris Limnios,GRE,FW,Köln,Bundesliga,24,1998,0.4,0,0,0,0,0,0,0,,0,0,0,0,1,1,0,0,Matches
1538,Victor Lindelöf,SWE,DF,Manchester Utd,Premier League,28,1994,15.2,22,17,10,9,3,9,17,52.9,8,18,9,9,21,43,63,1,Matches
1539,Jesper Lindstrøm,DEN,"MF,FW",Eint Frankfurt,Bundesliga,22,2000,18.7,26,11,15,7,4,7,22,31.8,15,25,3,22,9,35,9,0,Matches
1540,Karol Linetty,POL,MF,Torino,Serie A,27,1995,21.0,32,17,7,22,3,13,25,52.0,12,28,8,20,19,51,25,0,Matches
1541,Jesse Lingard,ENG,"FW,MF",Nott'ham Forest,Premier League,29,1992,10.3,4,4,2,2,0,1,7,14.3,6,11,0,11,5,9,4,0,Matches
1542,Samuel Lino,BRA,"FW,MF",Valencia,La Liga,22,1999,32.1,66,43,17,37,12,26,72,36.1,46,34,0,34,18,84,16,0,Matches
1543,Pol Lirola,ESP,DF,Elche,La Liga,24,1997,7.0,13,6,9,3,1,8,13,61.5,5,3,2,1,7,20,16,0,Matches
1544,Mateusz Lis,POL,GK,Troyes,Ligue 1,25,1997,8.3,0,0,0,0,0,0,1,0.0,1,1,0,1,0,0,3,0,Matches
1545,Marcin Listkowski,POL,"MF,FW",Lecce,Serie A,24,1998,0.9,0,0,0,0,0,0,0,,0,0,0,0,3,3,2,0,Matches
1546,Valentino Livramento,ENG,"DF,FW",Southampton,Premier League,19,2002,0.3,2,1,2,0,0,0,0,,0,0,0,0,2,4,3,0,Matches
1547,Dejan Ljubicic,AUT,"MF,FW",Köln,Bundesliga,24,1997,19.0,25,14,7,14,4,13,40,32.5,27,20,1,19,8,33,8,1,Matches
1548,Javier Llabrés,ESP,FW,Mallorca,La Liga,19,2002,0.2,0,0,0,0,0,0,0,,0,0,0,0,0,0,1,0,Matches
1549,Diego Llorente,ESP,DF,Leeds United,Premier League,28,1993,7.2,13,10,8,5,0,4,8,50.0,4,6,2,4,15,28,24,2,Matches
1550,Diego Llorente,ESP,DF,Roma,Serie A,28,1993,6.4,10,5,6,4,0,5,12,41.7,7,4,2,2,11,21,20,0,Matches
1551,Marcos Llorente,ESP,"MF,DF",Atlético Madrid,La Liga,27,1995,18.9,32,15,16,10,6,17,30,56.7,13,26,2,24,17,49,19,0,Matches
1552,Hugo Lloris,FRA,GK,Tottenham,Premier League,35,1986,24.5,1,1,1,0,0,1,3,33.3,2,0,0,0,1,2,13,5,Matches
1553,Giovani Lo Celso,ARG,"MF,FW",Villarreal,La Liga,26,1996,12.5,32,28,7,15,10,12,21,57.1,9,14,2,12,6,38,5,0,Matches
1554,Stanislav Lobotka,SVK,MF,Napoli,Serie A,27,1994,34.5,83,44,35,35,13,43,73,58.9,30,29,7,22,23,106,16,0,Matches
1555,Manuel Locatelli,ITA,MF,Juventus,Serie A,24,1998,27.2,59,33,26,23,10,30,53,56.6,23,50,22,28,27,86,59,0,Matches
1556,Luka Lochoshvili,GEO,DF,Cremonese,Serie A,24,1998,20.4,45,19,30,11,4,22,31,71.0,9,31,10,21,22,67,89,0,Matches
1557,Bradley Locko,FRA,DF,Reims,Ligue 1,20,2002,11.8,31,16,21,4,6,15,27,55.6,12,17,4,13,20,51,21,0,Matches
1558,Bradley Locko,FRA,DF,Brest,Ligue 1,20,2002,3.0,4,3,2,1,1,2,3,66.7,1,4,0,4,2,6,13,0,Matches
1559,Renan Lodi,BRA,DF,Nott'ham Forest,Premier League,24,1998,24.6,52,39,38,8,6,33,66,50.0,33,25,6,19,33,85,74,0,Matches
1560,Ruben Loftus-Cheek,ENG,"MF,DF",Chelsea,Premier League,26,1996,17.1,25,14,8,14,3,12,22,54.5,10,15,2,13,12,37,23,0,Matches
1561,Sean Longstaff,ENG,MF,Newcastle Utd,Premier League,24,1997,28.0,42,21,16,20,6,20,52,38.5,32,35,8,27,16,58,23,0,Matches
1562,Ademola Lookman,NGA,"FW,MF",Atalanta,Serie A,24,1997,19.2,13,5,2,6,5,3,15,20.0,12,18,0,18,4,17,1,0,Matches
1563,Anthony Lopes,POR,GK,Lyon,Ligue 1,31,1990,31.3,1,0,1,0,0,1,4,25.0,3,0,0,0,3,4,10,0,Matches
1564,Rony Lopes,POR,"MF,FW",Troyes,Ligue 1,26,1995,26.1,24,12,6,15,3,7,31,22.6,24,14,2,12,9,33,10,0,Matches
1565,David López,ESP,DF,Girona,La Liga,32,1989,18.4,31,18,17,13,1,19,27,70.4,8,29,19,10,14,45,64,1,Matches
1566,Diego López,ESP,GK,Rayo Vallecano,La Liga,40,1981,1.1,0,0,0,0,0,0,0,,0,0,0,0,0,0,0,1,Matches
1567,Diego López,ESP,"FW,MF",Valencia,La Liga,20,2002,5.0,2,2,1,1,0,2,15,13.3,13,9,0,9,3,5,5,0,Matches
1568,Maxime Lopez,FRA,MF,Sassuolo,Serie A,24,1997,25.5,42,18,26,12,4,16,56,28.6,40,24,6,18,22,64,21,0,Matches
1569,Pau López,ESP,GK,Marseille,Ligue 1,27,1994,32.5,0,0,0,0,0,0,1,0.0,1,0,0,0,0,0,5,1,Matches
1570,Unai López,ESP,MF,Rayo Vallecano,La Liga,26,1995,13.9,32,20,10,17,5,13,37,35.1,24,12,1,11,15,47,6,1,Matches
1571,Dion Lopy,SEN,MF,Reims,Ligue 1,20,2002,15.3,45,24,22,16,7,23,62,37.1,39,27,3,24,22,67,18,0,Matches
1572,Anthony Losilla,FRA,MF,Bochum,Bundesliga,36,1986,30.2,76,49,32,34,10,38,77,49.4,39,39,12,27,37,113,67,0,Matches
1573,Jordan Lotomba,SUI,DF,Nice,Ligue 1,23,1998,27.3,65,38,33,24,8,31,48,64.6,17,38,11,27,32,97,53,0,Matches
1574,Matteo Lovato,ITA,DF,Salernitana,Serie A,22,2000,9.0,17,14,14,3,0,10,25,40.0,15,8,5,3,13,30,33,2,Matches
1575,Dejan Lovren,CRO,DF,Lyon,Ligue 1,33,1989,16.2,25,19,20,5,0,20,29,69.0,9,20,10,10,26,51,70,1,Matches
1576,Sandi Lovrić,SVN,MF,Udinese,Serie A,24,1998,25.9,40,18,16,16,8,25,43,58.1,18,25,2,23,26,66,21,0,Matches
1577,Jamal Lowe,JAM,"MF,FW",Bournemouth,Premier League,28,1994,0.1,0,0,0,0,0,0,0,,0,0,0,0,0,0,0,0,Matches
1578,Anthony Lozano,HON,FW,Cádiz,La Liga,29,1993,16.0,6,4,1,4,1,1,7,14.3,6,12,1,11,3,9,17,0,Matches
1579,Hirving Lozano,MEX,FW,Napoli,Serie A,27,1995,17.8,24,13,10,6,8,9,21,42.9,12,31,0,31,15,39,6,0,Matches
1580,Pol Lozano,ESP,MF,Espanyol,La Liga,22,1999,0.2,0,0,0,0,0,0,0,,0,1,0,1,0,0,1,0,Matches
1581,Jean Lucas,BRA,MF,Monaco,Ligue 1,24,1998,3.2,9,5,3,5,1,6,12,50.0,6,2,1,1,4,13,2,0,Matches
1582,Jhon Lucumí,COL,DF,Bologna,Serie A,24,1998,32.2,53,37,39,13,1,24,43,55.8,19,43,26,17,35,88,100,1,Matches
1583,José Luis Gayà,ESP,DF,Valencia,La Liga,27,1995,30.1,80,46,61,16,3,43,74,58.1,31,28,9,19,23,103,48,0,Matches
1584,José Luis Morales,ESP,"FW,MF",Villarreal,La Liga,35,1987,13.5,7,6,1,2,4,5,17,29.4,12,12,1,11,2,9,2,0,Matches
1585,José Luis Palomino,ARG,DF,Atalanta,Serie A,32,1990,8.4,23,14,16,7,0,11,19,57.9,8,11,4,7,28,51,20,0,Matches
1586,Douglas Luiz,BRA,MF,Aston Villa,Premier League,24,1998,32.5,72,42,31,32,9,29,63,46.0,34,36,7,29,40,112,27,2,Matches
1587,Romelu Lukaku,BEL,FW,Inter,Serie A,29,1993,18.4,3,1,1,0,2,2,5,40.0,3,3,1,2,0,3,16,0,Matches
1588,Castello Lukeba,FRA,DF,Lyon,Ligue 1,19,2002,33.2,39,23,27,8,4,21,31,67.7,10,42,24,18,75,114,105,1,Matches
1589,Dodi Lukebakio,BEL,"FW,MF",Hertha BSC,Bundesliga,24,1997,26.6,18,11,7,8,3,6,27,22.2,21,23,5,18,13,31,17,0,Matches
1590,Saša Lukić,SRB,MF,Fulham,Premier League,25,1996,4.6,8,3,1,4,3,3,7,42.9,4,6,2,4,5,13,3,0,Matches
1591,Saša Lukić,SRB,MF,Torino,Serie A,25,1996,13.3,21,14,10,10,1,9,15,60.0,6,17,7,10,13,34,10,0,Matches
1592,Andriy Lunin,UKR,GK,Real Madrid,La Liga,23,1999,7.0,0,0,0,0,0,0,0,,0,0,0,0,0,0,1,0,Matches
1593,Andrey Lunyov,RUS,GK,Leverkusen,Bundesliga,30,1991,1.0,0,0,0,0,0,0,0,,0,0,0,0,0,0,0,0,Matches
1594,Sebastiano Luperto,ITA,DF,Empoli,Serie A,25,1996,34.8,33,18,24,8,1,9,20,45.0,11,54,42,12,43,76,163,1,Matches
1595,Lyanco,BRA,DF,Southampton,Premier League,25,1997,13.1,24,16,15,9,0,12,18,66.7,6,30,25,5,20,44,65,2,Matches
1596,Charalambos Lykogiannis,GRE,DF,Bologna,Serie A,28,1993,12.3,16,8,5,6,5,5,13,38.5,8,9,4,5,15,31,30,0,Matches
1597,Youssouf M'Changama,COM,MF,Auxerre,Ligue 1,31,1990,12.0,22,11,7,12,3,7,13,53.8,6,6,0,6,15,37,6,1,Matches
1598,Awer Mabil,AUS,"MF,FW",Cádiz,La Liga,26,1995,1.8,2,0,0,1,1,1,3,33.3,2,1,1,0,0,2,1,0,Matches
1599,Alexis Mac Allister,ARG,MF,Brighton,Premier League,23,1998,32.1,70,39,22,40,8,34,71,47.9,37,26,2,24,22,92,10,1,Matches
1600,Deiver Machado,COL,"DF,MF",Lens,Ligue 1,28,1993,24.3,45,26,18,20,7,21,34,61.8,13,21,4,17,21,66,27,0,Matches
1601,Darwin Machís,VEN,FW,Valladolid,La Liga,29,1993,6.7,3,2,0,2,1,1,8,12.5,7,5,0,5,3,6,4,0,Matches
1602,James Maddison,ENG,"MF,FW",Leicester City,Premier League,25,1996,27.6,51,26,25,19,7,19,50,38.0,31,19,1,18,13,64,6,1,Matches
1603,Noni Madueke,ENG,FW,Chelsea,Premier League,20,2002,7.1,12,8,5,4,3,6,13,46.2,7,13,2,11,4,16,7,0,Matches
1604,Pablo Maffeo,ESP,DF,Mallorca,La Liga,25,1997,33.1,75,46,54,16,5,45,78,57.7,33,38,11,27,26,101,76,0,Matches
1605,Gabriel Magalhães,BRA,DF,Arsenal,Premier League,24,1997,37.9,48,30,29,15,4,18,27,66.7,9,49,26,23,32,80,125,3,Matches
1606,Lisandro Magallán,ARG,DF,Elche,La Liga,28,1993,10.0,19,11,11,5,3,10,12,83.3,2,14,5,9,13,32,30,1,Matches
1607,Soungoutou Magassa,FRA,MF,Monaco,Ligue 1,18,2003,0.9,4,1,2,2,0,2,4,50.0,2,3,0,3,1,5,1,0,Matches
1608,Giulio Maggiore,ITA,MF,Salernitana,Serie A,24,1998,9.9,20,8,11,6,3,10,21,47.6,11,19,4,15,8,28,10,0,Matches
1609,Giangiacomo Magnani,ITA,DF,Hellas Verona,Serie A,26,1995,17.0,33,22,20,11,2,19,25,76.0,6,20,15,5,21,54,76,0,Matches
1610,Hugo Magnetti,FRA,MF,Brest,Ligue 1,24,1998,18.8,43,27,18,23,2,23,63,36.5,40,21,1,20,25,68,12,0,Matches
1611,Yohann Magnin,FRA,MF,Clermont Foot,Ligue 1,25,1997,26.7,89,54,37,45,7,54,106,50.9,52,50,12,38,25,114,46,0,Matches
1612,Harry Maguire,ENG,DF,Manchester Utd,Premier League,29,1993,8.5,8,6,6,1,1,4,5,80.0,1,18,11,7,13,21,41,0,Matches
1613,Jon Magunacelaya,ESP,"MF,FW",Real Sociedad,La Liga,22,2000,0.7,1,0,0,0,1,0,2,0.0,2,0,0,0,0,1,1,0,Matches
1614,Riyad Mahrez,ALG,"FW,MF",Manchester City,Premier League,31,1991,21.3,30,14,8,13,9,13,39,33.3,26,27,1,26,9,39,5,0,Matches
1615,Arne Maier,GER,MF,Augsburg,Bundesliga,23,1999,21.8,31,22,17,11,3,10,18,55.6,8,21,0,21,15,46,22,0,Matches
1616,Mike Maignan,FRA,GK,Milan,Serie A,27,1995,22.0,1,0,1,0,0,1,1,100.0,0,0,0,0,1,2,10,1,Matches
1617,Linton Maina,GER,"FW,MF",Köln,Bundesliga,23,1999,24.9,18,12,5,11,2,7,30,23.3,23,19,0,19,5,23,9,0,Matches
1618,Kobbie Mainoo,ENG,MF,Manchester Utd,Premier League,17,2005,0.1,0,0,0,0,0,0,0,,0,1,1,0,0,0,0,0,Matches
1619,Ainsley Maitland-Niles,ENG,"DF,MF",Southampton,Premier League,24,1997,15.6,45,24,23,18,4,28,44,63.6,16,28,7,21,22,67,45,1,Matches
1620,Jordan Majchrzak,POL,FW,Roma,Serie A,17,2004,0.2,0,0,0,0,0,0,0,,0,0,0,0,0,0,0,0,Matches
1621,Lovro Majer,CRO,"MF,FW",Rennes,Ligue 1,24,1998,18.5,34,23,16,13,5,8,29,27.6,21,21,1,20,21,55,5,1,Matches
1622,Jean-Victor Makengo,FRA,MF,Udinese,Serie A,24,1998,8.9,16,13,7,7,2,5,9,55.6,4,8,2,6,9,25,3,0,Matches
1623,Jean-Victor Makengo,FRA,MF,Lorient,Ligue 1,24,1998,11.8,16,8,5,10,1,6,20,30.0,14,8,5,3,10,26,13,1,Matches
1624,Béni Makouana,CGO,"FW,MF",Montpellier,Ligue 1,19,2002,2.2,1,0,0,1,0,0,2,0.0,2,3,1,2,0,1,1,0,Matches
1625,Nemanja Maksimović,SRB,MF,Getafe,La Liga,27,1995,22.8,41,30,17,18,6,19,32,59.4,13,36,14,22,34,75,27,0,Matches
1626,Tyrell Malacia,NED,DF,Manchester Utd,Premier League,22,1999,15.5,46,33,33,12,1,14,25,56.0,11,13,3,10,25,71,49,0,Matches
1627,Lorenzo Malagrida,ITA,"MF,DF",Sampdoria,Serie A,18,2003,1.2,1,0,0,0,1,1,3,33.3,2,1,0,1,0,1,1,0,Matches
1628,Daniel Maldini,ITA,"FW,MF",Spezia,Serie A,20,2001,7.0,12,5,3,4,5,4,11,36.4,7,9,0,9,1,13,8,0,Matches
1629,Youssef Maleh,MAR,MF,Fiorentina,Serie A,23,1998,3.3,3,1,0,3,0,0,4,0.0,4,5,0,5,1,4,3,0,Matches
1630,Youssef Maleh,MAR,MF,Lecce,Serie A,23,1998,7.5,17,8,3,7,7,6,14,42.9,8,20,1,19,5,22,10,0,Matches
1631,Donyell Malen,NED,FW,Dortmund,Bundesliga,23,1999,19.0,13,5,3,4,6,5,12,41.7,7,14,1,13,4,17,11,0,Matches
1632,Ruslan Malinovskyi,UKR,"MF,FW",Atalanta,Serie A,29,1993,6.1,14,8,5,6,3,6,17,35.3,11,8,1,7,5,19,2,0,Matches
1633,Ruslan Malinovskyi,UKR,"MF,FW",Marseille,Ligue 1,29,1993,13.6,21,11,3,12,6,10,26,38.5,16,13,1,12,3,24,9,0,Matches
1634,Hugo Mallo,ESP,DF,Celta Vigo,La Liga,31,1991,24.0,53,29,34,14,5,28,42,66.7,14,28,7,21,24,77,73,0,Matches
1635,Mickael Malsa,MTQ,MF,Valladolid,La Liga,26,1995,0.8,2,2,1,1,0,1,4,25.0,3,1,1,0,2,4,3,0,Matches
1636,Giorgi Mamardashvili,GEO,GK,Valencia,La Liga,21,2000,38.0,0,0,0,0,0,0,0,,0,0,0,0,1,1,11,4,Matches
1637,Hianga Mananga Mbock,FRA,MF,Brest,Ligue 1,22,1999,0.2,0,0,0,0,0,0,1,0.0,1,0,0,0,0,0,0,0,Matches
1638,Gianluca Mancini,ITA,DF,Roma,Serie A,26,1996,31.8,37,19,27,9,1,18,34,52.9,16,38,17,21,46,83,67,0,Matches
1639,Steve Mandanda,FRA,GK,Rennes,Ligue 1,37,1985,33.5,0,0,0,0,0,0,2,0.0,2,0,0,0,0,0,9,3,Matches
1640,Reinildo Mandava,MOZ,DF,Atlético Madrid,La Liga,28,1994,20.6,66,43,46,19,1,38,49,77.6,11,27,12,15,30,96,59,0,Matches
1641,Aïssa Mandi,ALG,DF,Villarreal,La Liga,30,1991,16.2,18,10,14,3,1,6,12,50.0,6,19,14,5,21,39,58,0,Matches
1642,Rolando Mandragora,ITA,MF,Fiorentina,Serie A,25,1997,21.7,42,24,12,22,8,23,52,44.2,29,25,3,22,16,58,21,0,Matches
1643,Sadio Mané,SEN,"FW,MF",Bayern Munich,Bundesliga,30,1992,15.8,11,5,3,3,5,1,9,11.1,8,15,2,13,0,11,4,0,Matches
1644,Orel Mangala,BEL,MF,Nott'ham Forest,Premier League,24,1998,17.2,28,20,16,10,2,12,29,41.4,17,21,7,14,23,51,15,0,Matches
1645,Thomas Mangani,FRA,MF,Ajaccio,Ligue 1,35,1987,14.8,32,17,14,15,3,18,47,38.3,29,22,3,19,24,56,22,1,Matches
1646,Vito Mannone,ITA,GK,Lorient,Ligue 1,34,1988,17.9,0,0,0,0,0,0,0,,0,0,0,0,0,0,4,3,Matches
1647,Javier Manquillo,ESP,DF,Newcastle Utd,Premier League,28,1994,0.4,3,2,2,1,0,2,2,100.0,0,1,0,1,1,4,1,0,Matches
1648,Myziane Maolida,COM,"MF,FW",Reims,Ligue 1,23,1999,2.6,8,3,2,5,1,5,12,41.7,7,1,0,1,2,10,0,0,Matches
1649,Myziane Maolida,COM,"FW,MF",Hertha BSC,Bundesliga,23,1999,1.1,1,1,1,0,0,1,2,50.0,1,0,0,0,0,1,1,0,Matches
1650,Faitout Maouassa,FRA,"FW,DF",Montpellier,Ligue 1,24,1998,21.4,52,32,26,20,6,18,41,43.9,23,31,3,28,20,72,23,0,Matches
1651,Sekou Mara,FRA,"FW,MF",Southampton,Premier League,20,2002,6.2,14,10,5,8,1,3,9,33.3,6,11,0,11,1,15,5,0,Matches
1652,Marcão,BRA,DF,Sevilla,La Liga,26,1996,4.2,2,2,1,1,0,1,1,100.0,0,3,3,0,6,8,14,0,Matches
1653,Solly March,ENG,"FW,DF",Brighton,Premier League,28,1994,30.2,53,31,16,17,20,8,28,28.6,20,34,3,31,24,77,32,0,Matches
1654,Agustín Marchesín,ARG,GK,Celta Vigo,La Liga,34,1988,19.0,0,0,0,0,0,0,1,0.0,1,0,0,0,0,0,7,0,Matches
1655,Federico Marchetti,ITA,GK,Spezia,Serie A,39,1983,0.7,0,0,0,0,0,0,0,,0,0,0,0,0,0,0,0,Matches
1656,Vincent Marchetti,FRA,MF,Ajaccio,Ligue 1,25,1997,27.2,55,26,29,19,7,25,68,36.8,43,23,3,20,19,74,31,0,Matches
1657,Riccardo Marchizza,ITA,DF,Sassuolo,Serie A,24,1998,3.1,2,2,1,1,0,2,4,50.0,2,2,0,2,2,4,8,0,Matches
1658,Gian Marco Ferrari,ITA,DF,Sassuolo,Serie A,30,1992,24.7,23,16,11,10,2,10,17,58.8,7,29,20,9,23,46,81,4,Matches
1659,Emiliano Marcondes,DEN,MF,Bournemouth,Premier League,27,1995,0.1,0,0,0,0,0,0,0,,0,0,0,0,0,0,1,0,Matches
1660,Óscar de Marcos,ESP,DF,Athletic Club,La Liga,33,1989,31.3,67,33,34,22,11,40,76,52.6,36,42,6,36,29,96,59,0,Matches
1661,Alberto Marí,ESP,"FW,MF",Valencia,La Liga,21,2001,1.0,0,0,0,0,0,0,2,0.0,2,0,0,0,0,0,1,0,Matches
1662,José Mari,ESP,MF,Cádiz,La Liga,34,1987,4.4,16,7,12,3,1,10,16,62.5,6,3,1,2,5,21,9,0,Matches
1663,Pablo Marí,ESP,DF,Monza,Serie A,28,1993,27.6,37,19,29,7,1,17,26,65.4,9,22,14,8,31,68,111,3,Matches
1664,José María Giménez,URU,DF,Atlético Madrid,La Liga,27,1995,26.9,43,25,28,14,1,24,35,68.6,11,37,17,20,24,67,138,1,Matches
1665,Mariano,DOM,FW,Real Madrid,La Liga,28,1993,1.7,1,0,0,1,0,0,0,,0,1,0,1,0,1,0,0,Matches
1666,Pablo Marín,ESP,"MF,FW",Real Sociedad,La Liga,19,2003,4.0,10,5,5,4,1,2,7,28.6,5,1,0,1,4,14,2,0,Matches
1667,Răzvan Marin,ROU,MF,Empoli,Serie A,26,1996,28.2,44,22,22,21,1,19,40,47.5,21,29,11,18,14,58,33,0,Matches
1668,Diego Mariño,ESP,GK,Almería,La Liga,32,1990,0.5,0,0,0,0,0,0,0,,0,0,0,0,0,0,0,0,Matches
1669,Guillermo Maripán,CHI,DF,Monaco,Ligue 1,28,1994,24.0,46,26,26,20,0,17,33,51.5,16,39,27,12,38,84,87,0,Matches
1670,Marlon,BRA,DF,Monza,Serie A,26,1995,17.7,35,21,20,14,1,15,29,51.7,14,13,4,9,18,53,50,0,Matches
1671,Omar Marmoush,EGY,FW,Wolfsburg,Bundesliga,23,1999,16.4,16,10,8,2,6,4,16,25.0,12,21,1,20,7,23,4,0,Matches
1672,Marquinhos,BRA,MF,Arsenal,Premier League,19,2003,0.0,0,0,0,0,0,0,0,,0,0,0,0,0,0,0,0,Matches
1673,Marquinhos,BRA,DF,Paris S-G,Ligue 1,28,1994,30.2,33,25,18,12,3,18,26,69.2,8,43,27,16,23,56,83,2,Matches
1674,Luca Marrone,ITA,DF,Monza,Serie A,32,1990,1.5,0,0,0,0,0,0,2,0.0,2,2,2,0,0,0,4,1,Matches
1675,Eric Martel,GER,MF,Köln,Bundesliga,20,2002,22.4,66,41,29,30,7,30,60,50.0,30,29,9,20,33,99,49,0,Matches
1676,Roger Martí,ESP,FW,Elche,La Liga,31,1991,7.3,5,2,3,2,0,1,5,20.0,4,4,0,4,1,6,7,0,Matches
1677,Roger Martí,ESP,FW,Cádiz,La Liga,31,1991,7.1,6,4,2,3,1,1,8,12.5,7,7,0,7,2,8,7,0,Matches
1678,Anthony Martial,FRA,FW,Manchester Utd,Premier League,26,1995,10.9,5,3,0,2,3,1,4,25.0,3,11,2,9,1,6,4,0,Matches
1679,Aarón Martín,ESP,DF,Mainz 05,Bundesliga,25,1997,20.5,42,27,25,11,6,21,40,52.5,19,22,1,21,15,57,31,0,Matches
1680,Ander Martin,ESP,"MF,FW",Real Sociedad,La Liga,21,2000,0.5,2,2,1,1,0,1,4,25.0,3,0,0,0,0,2,1,0,Matches
1681,Andrés Martín,ESP,"FW,MF",Rayo Vallecano,La Liga,23,1999,2.3,4,2,2,1,1,3,5,60.0,2,2,0,2,1,5,2,0,Matches
1682,Carlos Martín,ESP,"FW,MF",Atlético Madrid,La Liga,20,2002,0.3,2,2,0,2,0,2,3,66.7,1,0,0,0,1,3,0,0,Matches
1683,Iván Martín,ESP,MF,Girona,La Liga,23,1999,17.6,9,7,4,4,1,8,23,34.8,15,12,0,12,9,18,12,0,Matches
1684,Jonas Martin,FRA,MF,Lille,Ligue 1,32,1990,3.1,9,7,4,5,0,5,14,35.7,9,3,1,2,7,16,3,0,Matches
1685,Gabriel Martinelli,BRA,FW,Arsenal,Premier League,21,2001,31.0,31,18,13,12,6,9,22,40.9,13,24,1,23,9,40,14,0,Matches
1686,Arnau Martinez,ESP,DF,Girona,La Liga,19,2003,30.4,69,45,41,19,9,38,85,44.7,47,44,10,34,25,94,54,2,Matches
1687,Emiliano Martínez,ARG,GK,Aston Villa,Premier League,29,1992,34.9,0,0,0,0,0,0,2,0.0,2,0,0,0,1,1,23,1,Matches
1688,Iñigo Martínez,ESP,DF,Athletic Club,La Liga,31,1991,14.9,18,8,11,7,0,6,9,66.7,3,17,11,6,18,36,55,0,Matches
1689,Lautaro Martínez,ARG,FW,Inter,Serie A,24,1997,28.6,25,14,3,15,7,7,23,30.4,16,31,1,30,13,38,16,1,Matches
1690,Lisandro Martínez,ARG,DF,Manchester Utd,Premier League,24,1998,23.5,54,28,33,18,3,30,43,69.8,13,51,27,24,33,87,103,0,Matches
1691,Lucas Martínez Quarta,ARG,DF,Fiorentina,Serie A,26,1996,24.1,80,48,44,32,4,42,61,68.9,19,41,19,22,48,128,78,1,Matches
1692,Roger Martínez,ESP,DF,Espanyol,La Liga,18,2004,0.1,0,0,0,0,0,0,0,,0,0,0,0,0,0,0,0,Matches
1693,Gelson Martins,POR,"MF,FW",Monaco,Ligue 1,27,1995,3.8,15,8,6,4,5,4,13,30.8,9,4,1,3,3,18,2,0,Matches
1694,Adam Marušić,MNE,DF,Lazio,Serie A,29,1992,30.7,41,30,23,14,4,25,39,64.1,14,20,6,14,38,79,63,1,Matches
1695,Omar Mascarell,EQG,"MF,DF",Elche,La Liga,29,1993,27.2,53,26,32,19,2,31,64,48.4,33,51,19,32,45,98,54,1,Matches
1696,Adam Masina,MAR,DF,Udinese,Serie A,28,1994,8.8,10,7,7,3,0,6,15,40.0,9,11,4,7,10,20,28,1,Matches
1697,Jordi Masip,ESP,GK,Valladolid,La Liga,33,1989,27.9,0,0,0,0,0,0,2,0.0,2,0,0,0,1,1,3,2,Matches
1698,Erhan Mašović,SRB,"DF,MF",Bochum,Bundesliga,23,1998,24.2,50,31,28,21,1,30,51,58.8,21,30,14,16,27,77,79,0,Matches
1699,Han-Noah Massengo,FRA,MF,Auxerre,Ligue 1,21,2001,12.4,27,15,10,15,2,7,16,43.8,9,12,3,9,14,41,7,0,Matches
1700,Yanis Massolin,FRA,MF,Clermont Foot,Ligue 1,19,2002,0.7,2,1,1,0,1,0,1,0.0,1,1,0,1,2,4,0,0,Matches
1701,Jaime Mata,ESP,"FW,MF",Getafe,La Liga,33,1988,4.9,13,10,4,5,4,7,22,31.8,15,7,2,5,3,16,6,0,Matches
1702,Pape Matar Sarr,SEN,"MF,FW",Tottenham,Premier League,19,2002,2.4,7,6,4,2,1,4,8,50.0,4,3,2,1,6,13,6,0,Matches
1703,Eliot Matazo,BEL,MF,Monaco,Ligue 1,20,2002,13.1,26,12,11,13,2,11,26,42.3,15,18,4,14,15,41,11,1,Matches
1704,Jean-Philippe Mateta,FRA,FW,Crystal Palace,Premier League,25,1997,8.6,7,1,2,4,1,1,3,33.3,2,3,1,2,3,10,18,0,Matches
1705,Nemanja Matić,SRB,MF,Roma,Serie A,33,1988,20.6,47,27,24,19,4,19,33,57.6,14,27,7,20,25,72,21,1,Matches
1706,Joël Matip,CMR,DF,Liverpool,Premier League,30,1991,12.1,14,8,12,2,0,11,23,47.8,12,8,3,5,21,35,45,3,Matches
1707,Henning Matriciani,GER,DF,Schalke 04,Bundesliga,22,2000,20.7,43,23,28,12,3,26,60,43.3,34,28,11,17,23,66,57,1,Matches
1708,Chrislain Matsima,FRA,"DF,MF",Lorient,Ligue 1,20,2002,2.5,0,0,0,0,0,0,0,,0,3,3,0,2,2,7,0,Matches
1709,Chrislain Matsima,FRA,DF,Monaco,Ligue 1,20,2002,5.0,11,6,7,2,2,4,7,57.1,3,5,5,0,9,20,16,0,Matches
1710,Jean Mattéo Bahoya,FRA,"FW,MF",Angers,Ligue 1,17,2005,3.0,7,3,1,3,3,4,7,57.1,3,4,0,4,0,7,0,0,Matches
1711,Azor Matusiwa,NED,MF,Reims,Ligue 1,24,1998,27.6,66,41,30,29,7,36,61,59.0,25,37,11,26,46,112,52,0,Matches
1712,Neal Maupay,FRA,FW,Everton,Premier League,25,1996,12.4,11,5,3,4,4,2,4,50.0,2,8,0,8,5,16,0,0,Matches
1713,Aïman Maurer,MAR,MF,Clermont Foot,Ligue 1,17,2004,5.6,2,1,1,1,0,1,10,10.0,9,1,0,1,3,5,5,0,Matches
1714,Stephy Mavididi,ENG,FW,Montpellier,Ligue 1,24,1998,14.3,24,19,12,8,4,13,27,48.1,14,21,1,20,4,28,10,0,Matches
1715,Konstantinos Mavropanos,GRE,DF,Stuttgart,Bundesliga,24,1997,25.4,50,27,32,15,3,28,38,73.7,10,39,18,21,63,113,99,0,Matches
1716,Christian Mawissa,FRA,DF,Toulouse,Ligue 1,17,2005,1.1,2,0,1,1,0,1,3,33.3,2,0,0,0,3,5,1,0,Matches
1717,Philipp Max,GER,DF,Eint Frankfurt,Bundesliga,28,1993,7.7,12,9,4,7,1,5,16,31.3,11,10,2,8,3,15,11,0,Matches
1718,Eric Maxim Choupo-Moting,CMR,FW,Bayern Munich,Bundesliga,33,1989,12.4,10,7,2,6,2,1,2,50.0,1,8,0,8,0,10,5,0,Matches
1719,Luís Maximiano,POR,GK,Lazio,Serie A,23,1999,0.1,0,0,0,0,0,0,0,,0,0,0,0,0,0,0,0,Matches
1720,Keke Maximilian Topp,GER,FW,Schalke 04,Bundesliga,18,2004,0.2,0,0,0,0,0,0,0,,0,0,0,0,1,1,0,0,Matches
1721,Fernand Mayembo,CGO,DF,Ajaccio,Ligue 1,26,1996,7.9,8,5,6,2,0,4,9,44.4,5,2,0,2,11,19,36,0,Matches
1722,Borja Mayoral,ESP,FW,Getafe,La Liga,25,1997,30.7,9,4,7,2,0,5,31,16.1,26,18,0,18,3,12,10,0,Matches
1723,Ibrahim Maza,GER,"MF,FW",Hertha BSC,Bundesliga,16,2005,0.8,1,1,1,0,0,0,1,0.0,1,2,0,2,0,1,1,0,Matches
1724,Derek Mazou-Sacko,FRA,MF,Troyes,Ligue 1,17,2004,0.2,0,0,0,0,0,0,1,0.0,1,1,0,1,1,1,1,0,Matches
1725,Noussair Mazraoui,MAR,DF,Bayern Munich,Bundesliga,24,1997,11.9,29,21,9,9,11,15,24,62.5,9,13,2,11,10,39,25,0,Matches
1726,Pasquale Mazzocchi,ITA,DF,Salernitana,Serie A,27,1995,21.8,32,18,21,5,6,17,37,45.9,20,10,2,8,10,42,37,2,Matches
1727,Kevin Mbabu,SUI,"DF,FW",Fulham,Premier League,27,1995,1.6,3,2,2,1,0,1,3,33.3,2,2,0,2,3,6,3,0,Matches
1728,Noah Mbamba,BEL,MF,Leverkusen,Bundesliga,17,2005,0.0,0,0,0,0,0,0,0,,0,0,0,0,0,0,0,0,Matches
1729,Kylian Mbappé,FRA,FW,Paris S-G,Ligue 1,23,1998,31.3,10,4,0,5,5,5,16,31.3,11,5,0,5,5,15,6,0,Matches
1730,Mamadou Mbaye,SEN,DF,Cádiz,La Liga,24,1998,8.4,10,7,7,3,0,6,8,75.0,2,10,8,2,7,17,50,1,Matches
1731,Chancel Mbemba,COD,DF,Marseille,Ligue 1,27,1994,31.7,43,26,24,17,2,22,31,71.0,9,25,12,13,42,85,89,0,Matches
1732,Bryan Mbeumo,CMR,FW,Brentford,Premier League,22,1999,32.3,26,18,5,13,8,8,42,19.0,34,24,1,23,13,39,21,0,Matches
1733,Jason Mbock,FRA,"MF,FW",Angers,Ligue 1,22,1999,0.3,0,0,0,0,0,0,0,,0,0,0,0,0,0,0,0,Matches
1734,Jean-Manuel Mbom,GER,MF,Werder Bremen,Bundesliga,22,2000,0.1,0,0,0,0,0,0,1,0.0,1,0,0,0,0,0,0,0,Matches
1735,Nathanael Mbuku,FRA,"FW,MF",Reims,Ligue 1,20,2002,0.7,2,1,2,0,0,2,2,100.0,0,0,0,0,0,2,0,0,Matches
1736,Nathanael Mbuku,FRA,"MF,FW",Augsburg,Bundesliga,20,2002,0.4,1,0,0,1,0,0,0,,0,0,0,0,0,1,0,0,Matches
1737,James McArthur,SCO,MF,Crystal Palace,Premier League,34,1987,0.6,1,1,1,0,0,1,1,100.0,0,2,1,1,1,2,2,0,Matches
1738,Alex McCarthy,ENG,GK,Southampton,Premier League,32,1989,6.0,0,0,0,0,0,0,1,0.0,1,0,0,0,1,1,3,1,Matches
1739,John McGinn,SCO,"MF,FW",Aston Villa,Premier League,27,1994,29.9,66,36,27,29,10,34,71,47.9,37,43,4,39,24,90,19,0,Matches
1740,Scott McKenna,SCO,DF,Nott'ham Forest,Premier League,25,1996,17.5,12,7,7,3,2,6,10,60.0,4,20,14,6,12,24,85,1,Matches
1741,Weston McKennie,USA,MF,Leeds United,Premier League,23,1998,16.0,30,13,5,18,7,10,29,34.5,19,22,3,19,22,52,26,0,Matches
1742,Weston McKennie,USA,"MF,DF",Juventus,Serie A,23,1998,11.7,14,5,3,9,2,5,8,62.5,3,15,4,11,11,25,15,1,Matches
1743,Dwight McNeil,ENG,"FW,MF",Everton,Premier League,22,1999,27.8,64,41,35,14,15,27,65,41.5,38,46,7,39,31,95,41,0,Matches
1744,Scott McTominay,SCO,MF,Manchester Utd,Premier League,25,1996,12.9,32,19,16,10,6,13,22,59.1,9,15,6,9,14,46,45,1,Matches
1745,Gary Medel,CHI,"MF,DF",Bologna,Serie A,34,1987,16.4,25,15,16,7,2,9,16,56.3,7,17,10,7,28,53,34,0,Matches
1746,Facundo Medina,ARG,DF,Lens,Ligue 1,23,1999,30.9,31,20,16,15,0,13,35,37.1,22,25,9,16,26,57,62,1,Matches
1747,Fernando Medrano,ESP,DF,Celta Vigo,La Liga,22,2000,0.1,2,1,2,0,0,1,1,100.0,0,0,0,0,1,3,1,0,Matches
1748,Ben Mee,ENG,DF,Brentford,Premier League,32,1989,36.3,45,24,28,13,4,20,37,54.1,17,54,42,12,48,93,122,2,Matches
1749,Bamo Meïté,CIV,DF,Lorient,Ligue 1,20,2001,16.7,18,8,13,4,1,7,16,43.8,9,33,23,10,16,34,70,0,Matches
1750,Soualiho Meïté,FRA,MF,Cremonese,Serie A,28,1994,26.3,47,31,25,15,7,22,46,47.8,24,27,6,21,27,74,36,0,Matches
1751,Farid El Melali,ALG,"DF,FW",Angers,Ligue 1,25,1997,9.0,21,12,7,12,2,11,22,50.0,11,16,0,16,8,29,7,0,Matches
1752,Gonzalo Melero,ESP,MF,Almería,La Liga,28,1994,20.6,32,16,9,18,5,11,39,28.2,28,23,2,21,7,39,19,1,Matches
1753,Birger Meling,NOR,DF,Rennes,Ligue 1,27,1994,13.4,24,15,9,12,3,12,25,48.0,13,18,2,16,23,47,26,0,Matches
1754,Memphis,NED,FW,Atlético Madrid,La Liga,28,1994,3.0,1,0,0,0,1,0,1,0.0,1,0,0,0,0,1,0,0,Matches
1755,Memphis,NED,FW,Barcelona,La Liga,28,1994,1.3,1,1,1,0,0,0,1,0.0,1,0,0,0,0,1,0,0,Matches
1756,Houboulang Mendes,GNB,DF,Almería,La Liga,24,1998,9.8,19,11,16,3,0,11,27,40.7,16,12,2,10,7,26,23,1,Matches
1757,Nuno Mendes,POR,DF,Paris S-G,Ligue 1,20,2002,17.2,45,30,29,12,4,30,41,73.2,11,19,3,16,17,62,18,0,Matches
1758,Pedro Mendes,POR,DF,Montpellier,Ligue 1,31,1990,0.1,0,0,0,0,0,0,0,,0,0,0,0,0,0,0,1,Matches
1759,Thiago Mendes,BRA,"MF,DF",Lyon,Ligue 1,30,1992,22.9,48,27,24,21,3,30,40,75.0,10,28,8,20,47,95,51,4,Matches
1760,Brais Méndez,ESP,MF,Real Sociedad,La Liga,25,1997,26.7,58,34,18,30,10,24,64,37.5,40,27,3,24,12,70,14,1,Matches
1761,Diego Méndez,ESP,MF,Rayo Vallecano,La Liga,18,2003,0.0,0,0,0,0,0,0,0,,0,0,0,0,1,1,0,0,Matches
1762,Antoine Mendy,FRA,DF,Nice,Ligue 1,18,2004,5.8,22,13,16,5,1,9,15,60.0,6,6,1,5,2,24,16,0,Matches
1763,Arial Mendy,SEN,DF,Clermont Foot,Ligue 1,27,1994,2.5,4,2,3,0,1,2,2,100.0,0,2,0,2,4,8,4,0,Matches
1764,Batista Mendy,FRA,"MF,DF",Angers,Ligue 1,22,2000,31.8,70,30,34,28,8,37,53,69.8,16,38,6,32,21,91,29,2,Matches
1765,Edouard Mendy,SEN,GK,Chelsea,Premier League,30,1992,9.5,0,0,0,0,0,0,0,,0,0,0,0,0,0,3,3,Matches
1766,Ferland Mendy,FRA,DF,Real Madrid,La Liga,27,1995,15.0,21,12,14,6,1,12,20,60.0,8,7,2,5,14,35,16,0,Matches
1767,Nampalys Mendy,SEN,MF,Leicester City,Premier League,30,1992,8.4,13,9,7,6,0,8,15,53.3,7,20,4,16,13,26,2,0,Matches
1768,Gideon Mensah,GHA,DF,Auxerre,Ligue 1,24,1998,25.1,80,44,43,32,5,44,77,57.1,33,33,10,23,38,118,41,0,Matches
1769,Chris Mepham,WAL,DF,Bournemouth,Premier League,24,1997,24.4,45,22,37,8,0,19,30,63.3,11,40,27,13,30,75,152,0,Matches
1770,Jorge Meré,ESP,DF,Cádiz,La Liga,25,1997,6.7,11,7,9,2,0,5,8,62.5,3,9,6,3,6,17,32,0,Matches
1771,Alex Meret,ITA,GK,Napoli,Serie A,25,1997,34.0,0,0,0,0,0,0,0,,0,0,0,0,0,0,6,1,Matches
1772,Mikel Merino,ESP,MF,Real Sociedad,La Liga,26,1996,27.7,77,49,28,33,16,31,62,50.0,31,38,8,30,20,97,51,1,Matches
1773,Quentin Merlin,FRA,DF,Nantes,Ligue 1,20,2002,19.9,31,19,19,8,4,18,38,47.4,20,27,4,23,24,55,30,0,Matches
1774,Yıldırım Mert Çetin,TUR,DF,Lecce,Serie A,25,1997,0.2,1,0,1,0,0,0,0,,0,0,0,0,1,2,1,0,Matches
1775,Roque Mesa,ESP,MF,Valladolid,La Liga,33,1989,18.0,27,15,16,10,1,12,38,31.6,26,16,4,12,13,40,18,0,Matches
1776,Illan Meslier,FRA,GK,Leeds United,Premier League,22,2000,34.0,2,1,2,0,0,2,4,50.0,2,0,0,0,1,3,30,3,Matches
1777,Lionel Messi,ARG,"FW,MF",Paris S-G,Ligue 1,35,1987,31.5,26,18,1,13,12,11,27,40.7,16,11,0,11,2,28,0,0,Matches
1778,Junior Messias,BRA,"FW,DF",Milan,Serie A,31,1991,16.6,24,18,9,9,6,5,19,26.3,14,20,4,16,7,31,28,0,Matches
1779,Amine Messoussa,FRA,FW,Lille,Ligue 1,17,2004,0.0,0,0,0,0,0,0,0,,0,0,0,0,0,0,0,0,Matches
1780,Thomas Meunier,BEL,DF,Dortmund,Bundesliga,30,1991,6.5,16,7,8,5,3,10,17,58.8,7,7,2,5,9,25,16,0,Matches
1781,Alexander Meyer,GER,GK,Dortmund,Bundesliga,31,1991,7.0,0,0,0,0,0,0,1,0.0,1,0,0,0,0,0,1,0,Matches
1782,Sven Michel,GER,"FW,MF",Union Berlin,Bundesliga,32,1990,5.5,9,5,1,5,3,4,8,50.0,4,5,1,4,0,9,4,0,Matches
1783,Alex Mighten,ENG,FW,Nott'ham Forest,Premier League,20,2002,0.1,0,0,0,0,0,0,1,0.0,1,0,0,0,0,0,0,0,Matches
1784,Tommaso Milanese,ITA,MF,Cremonese,Serie A,20,2002,0.3,0,0,0,0,0,0,0,,0,1,1,0,0,0,0,0,Matches
1785,Nikola Milenković,SRB,DF,Fiorentina,Serie A,24,1997,23.7,40,25,20,17,3,18,27,66.7,9,27,14,13,22,62,72,0,Matches
1786,Lewis Miley,ENG,MF,Newcastle Utd,Premier League,16,2006,0.2,0,0,0,0,0,0,0,,0,1,0,1,0,0,0,0,Matches
1787,Arkadiusz Milik,POL,FW,Juventus,Serie A,28,1994,17.6,12,8,2,8,2,2,8,25.0,6,10,1,9,1,13,14,0,Matches
1788,Arkadiusz Milik,POL,FW,Marseille,Ligue 1,28,1994,1.4,1,1,0,0,1,0,1,0.0,1,0,0,0,0,1,2,0,Matches
1789,Sergej Milinković-Savić,SRB,MF,Lazio,Serie A,27,1995,33.6,58,35,22,23,13,24,67,35.8,43,50,12,38,28,86,49,0,Matches
1790,Vanja Milinković-Savić,SRB,GK,Torino,Serie A,25,1997,38.0,2,1,2,0,0,2,2,100.0,0,0,0,0,1,3,19,1,Matches
1791,Éder Militão,BRA,DF,Real Madrid,La Liga,24,1998,30.0,46,32,25,18,3,26,33,78.8,7,67,39,28,42,88,104,2,Matches
1792,Luka Milivojević,SRB,MF,Crystal Palace,Premier League,31,1991,5.7,13,7,7,4,2,7,10,70.0,3,13,4,9,12,25,10,1,Matches
1793,Luis Milla,ESP,MF,Getafe,La Liga,27,1994,20.6,48,30,21,18,9,19,44,43.2,25,13,1,12,32,80,25,1,Matches
1794,Pere Milla,ESP,"FW,MF",Elche,La Liga,29,1992,20.5,31,20,18,8,5,14,41,34.1,27,18,3,15,9,40,19,1,Matches
1795,Enzo Millot,FRA,MF,Stuttgart,Bundesliga,20,2002,9.9,23,16,9,10,4,12,19,63.2,7,20,3,17,12,35,7,0,Matches
1796,James Milner,ENG,"MF,DF",Liverpool,Premier League,36,1986,10.1,26,16,11,11,4,15,34,44.1,19,14,2,12,12,38,15,0,Matches
1797,Marko Milovanović,SRB,FW,Almería,La Liga,18,2003,0.2,0,0,0,0,0,0,0,,0,0,0,0,0,0,0,0,Matches
1798,Kim Min-jae,KOR,DF,Napoli,Serie A,25,1996,33.9,55,30,32,22,1,25,29,86.2,4,36,26,10,41,96,123,1,Matches
1799,Yerry Mina,COL,DF,Everton,Premier League,27,1994,6.6,15,8,9,6,0,9,11,81.8,2,7,4,3,6,21,28,0,Matches
1800,Takumi Minamino,JPN,"MF,FW",Monaco,Ligue 1,27,1995,8.0,15,8,5,7,3,7,35,20.0,28,14,0,14,6,21,4,0,Matches
1801,Tyrone Mings,ENG,DF,Aston Villa,Premier League,29,1993,35.0,15,7,10,5,0,9,20,45.0,11,40,21,19,54,69,163,2,Matches
1802,Óscar Mingueza,ESP,DF,Celta Vigo,La Liga,23,1999,14.3,37,21,27,9,1,25,32,78.1,7,10,4,6,12,49,25,0,Matches
1803,Rafa Mir,ESP,FW,Sevilla,La Liga,25,1997,14.4,8,2,2,4,2,2,5,40.0,3,5,1,4,4,12,11,0,Matches
1804,Aleksei Miranchuk,RUS,MF,Torino,Serie A,26,1995,23.2,11,5,3,4,4,3,11,27.3,8,11,0,11,2,13,5,0,Matches
1805,Juan Miranda,ESP,DF,Betis,La Liga,22,2000,16.4,23,16,16,6,1,14,29,48.3,15,20,7,13,20,43,63,0,Matches
1806,Antonio Mirante,ITA,GK,Milan,Serie A,39,1983,0.0,0,0,0,0,0,0,0,,0,0,0,0,0,0,0,0,Matches
1807,Fabio Miretti,ITA,"MF,FW",Juventus,Serie A,18,2003,13.7,24,11,15,6,3,12,29,41.4,17,20,1,19,4,28,11,0,Matches
1808,Filippo Missori,ITA,DF,Roma,Serie A,18,2004,2.0,4,3,3,0,1,3,6,50.0,3,0,0,0,3,7,5,0,Matches
1809,Tyrick Mitchell,ENG,DF,Crystal Palace,Premier League,22,1999,32.1,71,49,43,23,5,30,53,56.6,23,48,11,37,42,113,78,0,Matches
1810,Kaoru Mitoma,JPN,"FW,MF",Brighton,Premier League,25,1997,25.8,44,27,15,16,13,20,41,48.8,21,25,0,25,17,61,10,0,Matches
1811,Aleksandar Mitrović,SRB,FW,Fulham,Premier League,27,1994,22.3,14,7,8,4,2,5,12,41.7,7,22,5,17,3,17,20,1,Matches
1812,Stefan Mitrović,SRB,DF,Getafe,La Liga,32,1990,18.7,14,6,12,2,0,7,11,63.6,4,12,10,2,17,31,90,2,Matches
1813,Maximilian Mittelstädt,GER,"DF,MF",Hertha BSC,Bundesliga,25,1997,9.4,39,20,31,6,2,17,39,43.6,22,13,2,11,26,65,27,0,Matches
1814,Henrikh Mkhitaryan,ARM,MF,Inter,Serie A,33,1989,22.1,41,26,13,22,6,14,41,34.1,27,27,4,23,21,62,18,0,Matches
1815,Anthony Modeste,FRA,FW,Dortmund,Bundesliga,34,1988,9.0,4,4,2,0,2,2,5,40.0,3,7,0,7,2,6,22,0,Matches
1816,Luka Modrić,CRO,MF,Real Madrid,La Liga,36,1985,19.4,19,9,6,6,7,10,25,40.0,15,15,5,10,10,29,7,0,Matches
1817,Terem Moffi,NGA,FW,Nice,Ligue 1,23,1999,14.8,12,6,0,6,6,2,12,16.7,10,3,0,3,2,14,5,0,Matches
1818,Terem Moffi,NGA,FW,Lorient,Ligue 1,23,1999,15.4,8,5,1,4,3,3,5,60.0,2,11,3,8,3,11,10,0,Matches
1819,Mostafa Mohamed,EGY,FW,Nantes,Ligue 1,24,1997,21.5,18,13,5,7,6,9,20,45.0,11,23,1,22,10,28,33,0,Matches
1820,Tobias Mohr,GER,"DF,MF",Schalke 04,Bundesliga,26,1995,9.3,8,5,3,5,0,2,7,28.6,5,14,5,9,8,16,19,0,Matches
1821,Johan Mojica,COL,DF,Villarreal,La Liga,29,1992,7.1,13,9,9,3,1,5,9,55.6,4,8,3,5,4,17,14,1,Matches
1822,Johan Mojica,COL,"DF,MF",Elche,La Liga,29,1992,3.0,6,3,5,1,0,2,3,66.7,1,3,2,1,4,10,5,0,Matches
1823,Clinton Mola,ENG,DF,Stuttgart,Bundesliga,21,2001,0.2,3,1,2,1,0,1,1,100.0,0,1,1,0,1,4,2,0,Matches
1824,Nahuel Molina,ARG,DF,Atlético Madrid,La Liga,24,1998,31.9,69,43,38,18,13,39,91,42.9,52,38,7,31,18,87,63,1,Matches
1825,Salvatore Molina,ITA,DF,Monza,Serie A,30,1992,2.5,6,5,2,4,0,4,5,80.0,1,4,2,2,1,7,2,0,Matches
1826,Florent Mollet,FRA,MF,Nantes,Ligue 1,30,1991,12.1,14,6,5,4,5,7,24,29.2,17,12,1,11,10,24,11,0,Matches
1827,Florent Mollet,FRA,MF,Schalke 04,Bundesliga,30,1991,4.6,4,1,0,4,0,2,7,28.6,5,7,1,6,1,5,1,0,Matches
1828,Jon Moncayola,ESP,"MF,DF",Osasuna,La Liga,24,1998,27.2,55,39,24,22,9,30,76,39.5,46,37,5,32,17,72,32,2,Matches
1829,Monchu,ESP,MF,Valladolid,La Liga,22,1999,22.6,50,29,20,21,9,19,46,41.3,27,28,11,17,18,68,22,1,Matches
1830,César Montes,MEX,DF,Espanyol,La Liga,25,1997,17.7,17,9,10,7,0,10,18,55.6,8,19,12,7,14,31,101,0,Matches
1831,Daniele Montevago,ITA,FW,Sampdoria,Serie A,19,2003,2.6,1,0,0,0,1,0,1,0.0,1,2,1,1,0,1,1,0,Matches
1832,Gonzalo Montiel,ARG,DF,Sevilla,La Liga,25,1997,16.9,26,15,12,14,0,15,29,51.7,14,25,7,18,19,45,38,0,Matches
1833,Lorenzo Montipò,ITA,GK,Hellas Verona,Serie A,26,1996,37.0,1,0,1,0,0,0,3,0.0,3,1,0,1,0,1,26,3,Matches
1834,Martín Montoya,ESP,DF,Betis,La Liga,31,1991,5.0,13,8,9,4,0,10,12,83.3,2,6,1,5,9,22,14,1,Matches
1835,Kieffer Moore,WAL,FW,Bournemouth,Premier League,29,1992,14.2,14,11,2,9,3,5,16,31.3,11,12,5,7,1,15,26,0,Matches
1836,Andrew Moran,IRL,FW,Brighton,Premier League,18,2003,0.1,0,0,0,0,0,0,0,,0,1,0,1,0,0,0,0,Matches
1837,Álvaro Morata,ESP,FW,Atlético Madrid,La Liga,29,1992,21.1,16,11,4,8,4,3,8,37.5,5,11,3,8,0,16,23,0,Matches
1838,Jon Morcillo,ESP,"FW,MF",Athletic Club,La Liga,23,1998,0.8,1,0,1,0,0,0,1,0.0,1,0,0,0,1,2,0,0,Matches
1839,Alberto Moreno,ESP,DF,Villarreal,La Liga,30,1992,14.4,23,12,10,10,3,11,24,45.8,13,12,1,11,23,46,26,0,Matches
1840,Álex Moreno,ESP,DF,Aston Villa,Premier League,29,1993,14.8,23,14,15,5,3,13,36,36.1,23,18,3,15,7,30,37,2,Matches
1841,Álex Moreno,ESP,DF,Betis,La Liga,29,1993,15.0,29,22,19,10,0,18,36,50.0,18,17,4,13,17,46,39,0,Matches
1842,Diego Moreno,ESP,DF,Osasuna,La Liga,21,2001,7.1,4,4,2,2,0,3,8,37.5,5,7,4,3,5,9,21,0,Matches
1843,Gerard Moreno,ESP,FW,Villarreal,La Liga,30,1992,13.7,11,6,0,6,5,3,6,50.0,3,6,2,4,5,16,10,0,Matches
1844,Marlos Moreno,COL,"MF,DF",Troyes,Ligue 1,25,1996,0.1,2,2,2,0,0,2,3,66.7,1,1,1,0,0,2,0,0,Matches
1845,Tete Morente,ESP,"MF,DF",Elche,La Liga,25,1996,23.0,33,21,18,13,2,15,36,41.7,21,23,3,20,25,58,28,0,Matches
1846,Ilaix Moriba,GUI,MF,Valencia,La Liga,19,2003,11.2,35,16,14,17,4,14,24,58.3,10,11,1,10,4,39,12,0,Matches
1847,Manu Morlanes,ESP,MF,Villarreal,La Liga,23,1999,1.8,3,2,2,1,0,3,3,100.0,0,3,2,1,1,4,2,0,Matches
1848,Manu Morlanes,ESP,MF,Mallorca,La Liga,23,1999,7.8,22,9,12,8,2,13,24,54.2,11,10,5,5,5,27,9,0,Matches
1849,Nikola Moro,CRO,MF,Bologna,Serie A,24,1998,13.6,32,21,11,15,6,14,36,38.9,22,15,2,13,8,40,18,0,Matches
1850,Loren Morón,ESP,FW,Betis,La Liga,28,1993,0.2,2,2,0,1,1,0,0,,0,0,0,0,0,2,1,0,Matches
1851,Cristhian Mosquera,ESP,DF,Valencia,La Liga,18,2004,1.6,4,2,3,1,0,4,5,80.0,1,1,0,1,1,5,5,0,Matches
1852,Dany Mota,POR,"FW,MF",Monza,Serie A,24,1998,21.2,8,7,1,3,4,2,10,20.0,8,5,1,4,6,14,25,0,Matches
1853,Lebo Mothiba,RSA,"FW,MF",Strasbourg,Ligue 1,26,1996,4.8,1,0,1,0,0,0,1,0.0,1,6,1,5,0,1,4,0,Matches
1854,Youssoufa Moukoko,GER,FW,Dortmund,Bundesliga,17,2004,12.7,13,7,3,6,4,3,6,50.0,3,9,0,9,2,15,1,0,Matches
1855,Steve Mounié,BEN,FW,Brest,Ligue 1,27,1994,18.4,13,5,1,7,5,5,14,35.7,9,18,7,11,3,16,20,0,Matches
1856,Mason Mount,ENG,"MF,FW",Chelsea,Premier League,23,1999,18.3,33,19,6,16,11,14,27,51.9,13,24,6,18,8,41,9,0,Matches
1857,Lucas Moura,BRA,"MF,DF",Tottenham,Premier League,29,1992,1.7,8,5,1,3,4,1,4,25.0,3,0,0,0,2,10,1,1,Matches
1858,Bevic Moussiti-Oko,CGO,FW,Ajaccio,Ligue 1,27,1995,7.8,3,1,1,1,1,1,2,50.0,1,5,3,2,2,5,8,0,Matches
1859,João Moutinho,POR,MF,Wolves,Premier League,35,1986,19.8,51,30,24,21,6,19,46,41.3,27,22,6,16,18,69,20,0,Matches
1860,João Moutinho,POR,"DF,FW",Spezia,Serie A,24,1998,0.6,7,1,5,1,1,3,4,75.0,1,1,1,0,0,7,0,0,Matches
1861,Samuel Moutoussamy,COD,MF,Nantes,Ligue 1,25,1996,26.7,64,34,27,28,9,26,76,34.2,50,23,2,21,24,88,15,0,Matches
1862,Divin Mubama,ENG,FW,West Ham,Premier League,17,2004,0.4,1,1,1,0,0,0,0,,0,0,0,0,0,1,0,0,Matches
1863,Mykhailo Mudryk,UKR,"FW,MF",Chelsea,Premier League,21,2001,7.3,11,9,2,4,5,4,13,30.8,9,7,1,6,0,11,3,0,Matches
1864,François Mughe,CMR,MF,Marseille,Ligue 1,18,2004,0.1,0,0,0,0,0,0,0,,0,0,0,0,0,0,0,0,Matches
1865,Nordi Mukiele,FRA,DF,Paris S-G,Ligue 1,24,1997,12.6,31,23,16,6,9,19,29,65.5,10,22,9,13,14,45,16,0,Matches
1866,Mert Müldür,TUR,"FW,DF",Sassuolo,Serie A,23,1999,0.1,0,0,0,0,0,0,0,,0,0,0,0,0,0,0,0,Matches
1867,Florian Müller,GER,GK,Stuttgart,Bundesliga,24,1997,19.0,0,0,0,0,0,0,0,,0,0,0,0,0,0,7,4,Matches
1868,Thomas Müller,GER,"FW,MF",Bayern Munich,Bundesliga,32,1989,18.5,21,12,5,9,7,6,16,37.5,10,19,3,16,4,25,16,0,Matches
1869,Abdul Mumin,GHA,DF,Rayo Vallecano,La Liga,24,1998,10.2,11,9,5,6,0,3,7,42.9,4,13,5,8,9,20,36,2,Matches
1870,Marshall Munetsi,ZIM,MF,Reims,Ligue 1,26,1996,30.0,58,27,13,31,14,20,48,41.7,28,37,11,26,26,84,41,1,Matches
1871,Iker Muniain,ESP,"MF,FW",Athletic Club,La Liga,29,1992,18.8,21,16,7,11,3,6,17,35.3,11,10,1,9,4,25,2,0,Matches
1872,Aihen Muñoz,ESP,DF,Real Sociedad,La Liga,24,1997,19.5,38,23,17,17,4,22,47,46.8,25,26,5,21,9,47,38,0,Matches
1873,Álvaro Muñoz,URU,FW,Real Madrid,La Liga,18,2004,0.9,2,1,1,0,1,1,1,100.0,0,0,0,0,0,2,1,0,Matches
1874,Iker Muñoz,ESP,MF,Osasuna,La Liga,19,2002,2.8,1,0,0,1,0,0,3,0.0,3,2,1,1,3,4,8,0,Matches
1875,Pablo Muñoz,ESP,MF,Rayo Vallecano,La Liga,18,2003,0.1,0,0,0,0,0,0,1,0.0,1,0,0,0,0,0,0,0,Matches
1876,Luis Muriel,COL,"FW,MF",Atalanta,Serie A,31,1991,11.9,9,6,2,3,4,5,16,31.3,11,9,0,9,2,11,2,0,Matches
1877,Jeison Murillo,COL,DF,Sampdoria,Serie A,30,1992,11.7,22,11,16,6,0,17,26,65.4,9,22,14,8,8,30,39,0,Matches
1878,Vedat Muriqi,KVX,FW,Mallorca,La Liga,28,1994,32.6,12,7,4,7,1,3,13,23.1,10,19,7,12,12,24,73,0,Matches
1879,Jacob Murphy,ENG,FW,Newcastle Utd,Premier League,27,1995,13.9,15,7,3,8,4,8,20,40.0,12,17,0,17,7,22,3,0,Matches
1880,Nicola Murru,ITA,DF,Sampdoria,Serie A,27,1994,8.7,24,14,15,8,1,7,13,53.8,6,17,7,10,10,34,21,0,Matches
1881,Yunus Musah,USA,MF,Valencia,La Liga,19,2002,23.4,48,35,17,23,8,20,30,66.7,10,20,1,19,11,59,16,2,Matches
1882,Jamal Musiala,GER,"MF,FW",Bayern Munich,Bundesliga,19,2003,24.4,34,23,9,16,9,13,35,37.1,22,30,3,27,19,53,3,0,Matches
1883,Juan Musso,ARG,GK,Atalanta,Serie A,28,1994,23.1,1,1,1,0,0,1,1,100.0,0,0,0,0,0,1,11,1,Matches
1884,Marlon Mustapha,AUT,"FW,MF",Mainz 05,Bundesliga,21,2001,0.8,2,2,0,2,0,0,0,,0,4,0,4,0,2,0,0,Matches
1885,Yvon Mvogo,SUI,GK,Lorient,Ligue 1,28,1994,20.1,0,0,0,0,0,0,0,,0,0,0,0,2,2,6,3,Matches
1886,Enock Mwepu,ZAM,"FW,MF",Brighton,Premier League,24,1998,2.4,10,5,1,6,3,3,4,75.0,1,3,1,2,1,11,1,0,Matches
1887,Francisco Mwepu,ZAM,FW,Cádiz,La Liga,22,2000,0.2,1,0,0,1,0,0,0,,0,0,0,0,0,1,0,0,Matches
1888,Vitaliy Mykolenko,UKR,DF,Everton,Premier League,23,1999,29.5,58,34,36,19,3,28,51,54.9,23,50,16,34,46,104,99,0,Matches
1889,Joakim Mæhle,DEN,"DF,MF",Atalanta,Serie A,25,1997,24.5,32,18,12,7,13,22,39,56.4,17,29,6,23,24,56,26,0,Matches
1890,Obite N'Dicka,CIV,DF,Eint Frankfurt,Bundesliga,22,1999,29.9,25,18,10,11,4,18,32,56.3,14,47,19,28,31,56,150,0,Matches
1891,Nathan N'Goumou,FRA,FW,Toulouse,Ligue 1,22,2000,1.0,3,2,2,1,0,1,1,100.0,0,2,0,2,2,5,0,0,Matches
1892,Nathan N'Goumou,FRA,FW,Gladbach,Bundesliga,22,2000,7.7,11,5,5,5,1,7,13,53.8,6,9,0,9,1,12,4,0,Matches
1893,Stanley N'Soki,FRA,DF,Hoffenheim,Bundesliga,23,1999,14.3,22,13,14,7,1,12,22,54.5,10,22,5,17,24,46,34,0,Matches
1894,Herculano Nabian,POR,MF,Empoli,Serie A,18,2004,0.0,0,0,0,0,0,0,0,,0,0,0,0,0,0,0,0,Matches
1895,Nacho,ESP,DF,Real Madrid,La Liga,32,1990,18.2,24,16,17,5,2,12,29,41.4,17,11,6,5,18,42,37,0,Matches
1896,Nikolas Nartey,DEN,"DF,MF",Stuttgart,Bundesliga,22,2000,5.3,11,6,7,3,1,5,9,55.6,4,9,0,9,4,15,12,0,Matches
1897,Juanjo Narváez,COL,"MF,FW",Valladolid,La Liga,27,1995,1.6,1,1,1,0,0,1,1,100.0,0,2,0,2,0,1,0,0,Matches
1898,Matija Nastasić,SRB,DF,Mallorca,La Liga,29,1993,10.1,10,8,7,1,2,3,6,50.0,3,11,4,7,18,28,43,1,Matches
1899,Roberto Navarro,ESP,"MF,FW",Real Sociedad,La Liga,20,2002,3.9,5,4,4,0,1,1,2,50.0,1,7,0,7,2,7,2,0,Matches
1900,Jesús Navas,ESP,"DF,FW",Sevilla,La Liga,36,1985,22.0,19,12,8,3,8,11,22,50.0,11,18,7,11,22,41,52,1,Matches
1901,Keylor Navas,CRC,GK,Nott'ham Forest,Premier League,35,1986,17.0,0,0,0,0,0,0,0,,0,0,0,0,1,1,11,2,Matches
1902,Michel Ndary Adopo,FRA,"MF,DF",Torino,Serie A,22,2000,2.9,7,2,4,2,1,1,3,33.3,2,2,2,0,1,8,4,0,Matches
1903,Youssouf Ndayishimiye,BDI,"MF,DF",Nice,Ligue 1,23,1998,6.3,13,9,8,5,0,6,11,54.5,5,8,5,3,12,25,22,1,Matches
1904,Papa Ndiaga Yade,MTN,"DF,MF",Troyes,Ligue 1,22,2000,6.3,10,6,6,2,2,7,22,31.8,15,10,2,8,8,18,10,0,Matches
1905,Wilfred Ndidi,NGA,MF,Leicester City,Premier League,25,1996,18.7,61,42,34,24,3,17,43,39.5,26,32,14,18,38,99,48,3,Matches
1906,Tanguy Ndombele,FRA,MF,Napoli,Serie A,25,1996,9.0,14,8,4,8,2,4,7,57.1,3,10,1,9,7,21,7,1,Matches
1907,Álvaro Negredo,ESP,FW,Cádiz,La Liga,36,1985,8.4,5,4,1,2,2,2,2,100.0,0,4,1,3,0,5,8,0,Matches
1908,Reiss Nelson,ENG,FW,Arsenal,Premier League,22,1999,2.4,4,1,2,1,1,2,4,50.0,2,3,0,3,0,4,4,0,Matches
1909,Ilija Nestorovski,MKD,"FW,MF",Udinese,Serie A,32,1990,7.1,7,3,2,1,4,5,11,45.5,6,6,1,5,2,9,10,0,Matches
1910,Neto,BRA,GK,Bournemouth,Premier League,33,1989,26.5,3,1,3,0,0,3,3,100.0,0,0,0,0,0,3,10,3,Matches
1911,Pedro Neto,POR,"FW,MF",Wolves,Premier League,22,2000,10.7,11,6,4,2,5,7,17,41.2,10,5,1,4,4,15,4,0,Matches
1912,Luca Netz,GER,DF,Gladbach,Bundesliga,19,2003,7.8,25,13,19,3,3,19,32,59.4,13,5,1,4,6,31,27,0,Matches
1913,Manuel Neuer,GER,GK,Bayern Munich,Bundesliga,36,1986,12.0,0,0,0,0,0,0,0,,0,0,0,0,0,0,4,1,Matches
1914,Florian Neuhaus,GER,MF,Gladbach,Bundesliga,25,1997,15.6,19,9,9,5,5,8,27,29.6,19,20,3,17,12,31,5,0,Matches
1915,Rúben Neves,POR,MF,Wolves,Premier League,25,1997,33.5,79,43,31,33,15,32,76,42.1,44,59,22,37,50,129,85,1,Matches
1916,Neymar,BRA,"MF,FW",Paris S-G,Ligue 1,30,1992,17.2,22,14,6,9,7,9,19,47.4,10,7,1,6,4,26,1,1,Matches
1917,Jessic Ngankam,GER,"FW,MF",Hertha BSC,Bundesliga,22,2000,9.2,14,9,7,4,3,6,14,42.9,8,6,1,5,1,15,4,0,Matches
1918,Cyril Ngonge,BEL,"MF,FW",Hellas Verona,Serie A,22,2000,8.3,7,3,2,2,3,3,11,27.3,8,7,0,7,6,13,4,0,Matches
1919,Moussa Niakhate,SEN,DF,Nott'ham Forest,Premier League,26,1996,12.9,18,9,15,3,0,11,22,50.0,11,18,8,10,19,37,60,0,Matches
1920,Ibrahima Niane,SEN,FW,Angers,Ligue 1,23,1999,12.6,6,2,1,4,1,1,6,16.7,5,8,2,6,1,7,9,0,Matches
1921,M'Baye Niang,SEN,FW,Auxerre,Ligue 1,27,1994,16.5,13,7,1,8,4,3,13,23.1,10,22,1,21,1,14,20,0,Matches
1922,Tanguy Nianzou,FRA,DF,Sevilla,La Liga,20,2002,15.2,20,15,10,9,1,8,11,72.7,3,8,5,3,16,36,44,3,Matches
1923,Rasmus Nicolaisen,DEN,DF,Toulouse,Ligue 1,25,1997,33.3,48,21,34,14,0,29,46,63.0,17,58,45,13,50,98,152,0,Matches
1924,Hans Nicolussi Caviglia,ITA,MF,Salernitana,Serie A,22,2000,6.5,15,6,5,8,2,9,15,60.0,6,9,0,9,7,22,7,1,Matches
1925,Florian Niederlechner,GER,"FW,MF",Augsburg,Bundesliga,31,1990,10.1,10,5,5,4,1,4,7,57.1,3,16,2,14,1,11,9,0,Matches
1926,Florian Niederlechner,GER,FW,Hertha BSC,Bundesliga,31,1990,8.7,9,7,2,4,3,2,8,25.0,6,7,0,7,3,12,10,0,Matches
1927,Saúl Ñíguez,ESP,"MF,DF",Atlético Madrid,La Liga,27,1994,12.2,42,27,18,18,6,22,37,59.5,15,27,5,22,15,57,29,0,Matches
1928,Dimitris Nikolaou,GRE,DF,Spezia,Serie A,23,1998,32.9,45,32,31,10,4,25,37,67.6,12,41,26,15,27,72,82,0,Matches
1929,Fernando Niño,ESP,"MF,FW",Villarreal,La Liga,21,2000,0.2,0,0,0,0,0,0,0,,0,0,0,0,0,0,0,0,Matches
1930,Justin Njinmah,GER,FW,Dortmund,Bundesliga,21,2000,0.2,0,0,0,0,0,0,0,,0,0,0,0,0,0,0,0,Matches
1931,Eddie Nketiah,ENG,FW,Arsenal,Premier League,23,1999,12.1,13,9,6,2,5,2,10,20.0,8,7,1,6,1,14,7,0,Matches
1932,Christopher Nkunku,FRA,"FW,MF",RB Leipzig,Bundesliga,24,1997,21.1,6,4,2,1,3,1,6,16.7,5,8,3,5,8,14,11,0,Matches
1933,Felix Nmecha,GER,MF,Wolfsburg,Bundesliga,21,2000,20.4,41,24,11,23,7,16,34,47.1,18,26,10,16,25,66,31,0,Matches
1934,Lukas Nmecha,GER,FW,Wolfsburg,Bundesliga,23,1998,10.0,5,3,0,2,3,3,3,100.0,0,5,1,4,3,8,4,0,Matches
1935,Arnaud Nordin,FRA,FW,Montpellier,Ligue 1,24,1998,26.7,26,14,10,12,4,12,28,42.9,16,19,1,18,14,40,7,0,Matches
1936,Riad Nouri,FRA,"MF,FW",Ajaccio,Ligue 1,37,1985,18.8,21,12,7,10,4,12,29,41.4,17,8,1,7,15,36,11,0,Matches
1937,Hugo Novoa,ESP,"DF,FW",RB Leipzig,Bundesliga,19,2003,2.0,8,2,1,3,4,4,7,57.1,3,4,0,4,1,9,0,0,Matches
1938,Samuel Ntanda,BEL,MF,Sampdoria,Serie A,17,2005,0.0,0,0,0,0,0,0,0,,0,0,0,0,0,0,0,0,Matches
1939,Randy Nteka,ANG,"FW,MF",Elche,La Liga,24,1997,8.1,15,10,7,6,2,2,11,18.2,9,15,3,12,4,19,9,0,Matches
1940,Randy Nteka,ANG,"FW,MF",Rayo Vallecano,La Liga,24,1997,1.3,4,2,2,2,0,1,1,100.0,0,2,0,2,2,6,3,0,Matches
1941,Alexander Nübel,GER,GK,Monaco,Ligue 1,25,1996,38.0,0,0,0,0,0,0,1,0.0,1,0,0,0,1,1,10,3,Matches
1942,Matheus Nunes,POR,MF,Wolves,Premier League,23,1998,27.4,67,43,36,22,9,28,61,45.9,33,35,4,31,16,83,35,2,Matches
1943,Darwin Núñez,URU,FW,Liverpool,Premier League,23,1999,18.8,11,5,2,4,5,4,17,23.5,13,10,0,10,3,14,13,0,Matches
1944,Unai Núñez,ESP,DF,Celta Vigo,La Liga,25,1997,35.0,47,35,29,15,3,18,34,52.9,16,27,17,10,72,119,135,1,Matches
1945,Bram Nuytinck,NED,DF,Udinese,Serie A,32,1990,4.3,7,4,3,4,0,4,8,50.0,4,6,6,0,5,12,22,0,Matches
1946,Bram Nuytinck,NED,DF,Sampdoria,Serie A,32,1990,16.6,54,38,33,21,0,23,34,67.6,11,36,21,15,23,77,84,0,Matches
1947,Ethan Nwaneri,ENG,FW,Arsenal,Premier League,15,2007,0.0,0,0,0,0,0,0,0,,0,1,0,1,0,0,0,0,Matches
1948,Gerzino Nyamsi,FRA,DF,Strasbourg,Ligue 1,25,1997,17.5,28,20,14,12,2,10,12,83.3,2,19,11,8,10,38,63,1,Matches
1949,Ørjan Nyland,NOR,GK,RB Leipzig,Bundesliga,31,1990,2.0,0,0,0,0,0,0,0,,0,0,0,0,0,0,0,0,Matches
1950,M'Bala Nzola,ANG,FW,Spezia,Serie A,25,1996,29.5,12,5,0,6,6,3,9,33.3,6,20,6,14,7,19,21,0,Matches
1951,Christian Nørgaard,DEN,MF,Brentford,Premier League,28,1994,19.6,52,30,21,29,2,18,48,37.5,30,32,9,23,34,86,41,2,Matches
1952,Lewis O'Brien,ENG,MF,Nott'ham Forest,Premier League,23,1998,6.5,16,9,4,11,1,6,12,50.0,6,13,2,11,5,21,9,0,Matches
1953,Pedro Obiang,EQG,MF,Sassuolo,Serie A,30,1992,9.7,26,17,12,12,2,10,18,55.6,8,12,2,10,8,34,15,0,Matches
1954,Jan Oblak,SVN,GK,Atlético Madrid,La Liga,29,1993,27.7,0,0,0,0,0,0,0,,0,0,0,0,1,1,8,0,Matches
1955,Brian Ocampo,URU,"MF,FW",Cádiz,La Liga,23,1999,12.4,18,15,12,5,1,8,21,38.1,13,13,0,13,3,21,3,0,Matches
1956,Lucas Ocampos,ARG,"FW,MF",Sevilla,La Liga,28,1994,12.9,22,14,9,9,4,8,31,25.8,23,17,2,15,8,30,5,0,Matches
1957,Guillermo Ochoa,MEX,GK,Salernitana,Serie A,37,1985,20.0,0,0,0,0,0,0,2,0.0,2,0,0,0,0,0,9,1,Matches
1958,Wilson Odobert,FRA,"MF,FW",Troyes,Ligue 1,17,2004,19.6,20,14,10,7,3,9,25,36.0,16,11,0,11,15,35,5,0,Matches
1959,Álvaro Odriozola,ESP,DF,Real Madrid,La Liga,26,1995,0.4,0,0,0,0,0,0,0,,0,0,0,0,0,0,0,0,Matches
1960,Tim Oermann,GER,DF,Bochum,Bundesliga,18,2003,2.2,2,1,2,0,0,1,1,100.0,0,3,2,1,1,3,8,1,Matches
1961,Odeluga Offiah,ENG,DF,Brighton,Premier League,19,2002,0.3,1,1,1,0,0,0,2,0.0,2,0,0,0,0,1,1,0,Matches
1962,Angelo Ogbonna,ITA,DF,West Ham,Premier League,34,1988,13.7,11,4,7,4,0,5,10,50.0,5,11,7,4,17,28,74,1,Matches
1963,Florent Ogier,FRA,DF,Clermont Foot,Ligue 1,33,1989,18.9,33,16,20,12,1,22,39,56.4,17,22,13,9,18,51,64,1,Matches
1964,Marios Oikonomou,GRE,DF,Sampdoria,Serie A,29,1992,2.4,3,2,3,0,0,1,3,33.3,2,5,4,1,4,7,13,0,Matches
1965,David Okereke,NGA,"FW,MF",Cremonese,Serie A,24,1997,25.2,12,8,4,5,3,3,16,18.8,13,23,3,20,10,22,12,0,Matches
1966,Caleb Okoli,ITA,DF,Atalanta,Serie A,21,2001,10.7,21,17,14,6,1,10,25,40.0,15,10,5,5,30,51,44,3,Matches
1967,Olasagasti,ESP,"MF,DF",Real Sociedad,La Liga,21,2000,0.7,4,4,1,2,1,1,2,50.0,1,2,0,2,0,4,1,0,Matches
1968,Lucas Olaza,URU,DF,Valladolid,La Liga,28,1994,16.6,24,14,12,10,2,17,26,65.4,9,20,8,12,14,38,34,0,Matches
1969,Finn Ole Becker,GER,MF,Hoffenheim,Bundesliga,22,2000,5.7,10,2,4,6,0,4,7,57.1,3,4,0,4,5,15,8,0,Matches
1970,Mathias Olesen,LUX,MF,Köln,Bundesliga,21,2001,5.3,10,5,4,4,2,5,8,62.5,3,6,1,5,2,12,3,0,Matches
1971,Michael Olise,FRA,"FW,MF",Crystal Palace,Premier League,20,2001,30.5,58,34,28,26,4,25,60,41.7,35,46,1,45,26,84,17,0,Matches
1972,Brian Oliván,ESP,DF,Espanyol,La Liga,28,1994,26.7,47,27,30,12,5,17,26,65.4,9,26,6,20,22,69,67,0,Matches
1973,Lucas Oliveira Rosa,BRA,DF,Valladolid,La Liga,22,2000,10.3,39,18,23,10,6,12,20,60.0,8,12,2,10,15,54,24,0,Matches
1974,Mathías Olivera,URU,DF,Napoli,Serie A,24,1997,18.3,39,23,16,16,7,22,43,51.2,21,28,2,26,22,61,26,0,Matches
1975,Dani Olmo,ESP,"MF,FW",RB Leipzig,Bundesliga,24,1998,14.2,15,9,1,10,4,6,14,42.9,8,15,0,15,6,21,6,0,Matches
1976,Jan Olschowsky,GER,GK,Gladbach,Bundesliga,20,2001,4.0,0,0,0,0,0,0,1,0.0,1,1,0,1,0,0,1,0,Matches
1977,Robin Olsen,SWE,GK,Aston Villa,Premier League,32,1990,3.1,0,0,0,0,0,0,2,0.0,2,0,0,0,0,0,1,0,Matches
1978,Warmed Omari,FRA,DF,Rennes,Ligue 1,22,2000,15.1,20,11,14,6,0,14,28,50.0,14,13,7,6,17,37,43,1,Matches
1979,Jonas Omlin,SUI,GK,Montpellier,Ligue 1,28,1994,13.0,1,0,1,0,0,0,0,,0,0,0,0,0,1,8,1,Matches
1980,Jonas Omlin,SUI,GK,Gladbach,Bundesliga,28,1994,14.3,1,1,1,0,0,1,3,33.3,2,1,0,1,0,1,9,1,Matches
1981,Ado Onaiwu,JPN,FW,Toulouse,Ligue 1,26,1995,12.0,11,6,4,4,3,5,13,38.5,8,5,1,4,2,13,5,0,Matches
1982,Amadou Onana,BEL,MF,Everton,Premier League,20,2001,27.6,72,43,24,42,6,30,42,71.4,12,25,6,19,37,109,39,0,Matches
1983,André Onana,CMR,GK,Inter,Serie A,26,1996,24.0,0,0,0,0,0,0,1,0.0,1,0,0,0,0,0,5,0,Matches
1984,Jean Onana,CMR,"MF,DF",Lens,Ligue 1,22,2000,9.0,28,17,8,17,3,10,22,45.5,12,15,5,10,18,46,20,0,Matches
1985,Karim Onisiwo,AUT,"FW,MF",Mainz 05,Bundesliga,30,1992,28.2,19,12,3,10,6,4,21,19.0,17,19,0,19,2,21,7,0,Matches
1986,Josh Onomah,ENG,MF,Fulham,Premier League,25,1997,0.2,1,0,1,0,0,0,0,,0,1,0,1,0,1,0,0,Matches
1987,Paul Onuachu,NGA,FW,Southampton,Premier League,28,1994,4.5,3,2,1,1,1,1,3,33.3,2,4,1,3,0,3,4,0,Matches
1988,Frank Onyeka,NGA,MF,Brentford,Premier League,24,1998,9.4,19,14,11,7,1,10,25,40.0,15,16,3,13,10,29,16,0,Matches
1989,Loïs Openda,BEL,FW,Lens,Ligue 1,22,2000,28.0,11,9,2,6,3,2,13,15.4,11,9,0,9,2,13,6,0,Matches
1990,Willi Orban,HUN,DF,RB Leipzig,Bundesliga,29,1992,32.8,51,30,33,18,0,26,43,60.5,17,42,24,18,39,90,129,1,Matches
1991,Ivan Ordets,UKR,DF,Bochum,Bundesliga,30,1992,27.2,31,19,21,9,1,16,28,57.1,12,34,17,17,57,88,139,0,Matches
1992,Divock Origi,BEL,FW,Milan,Serie A,27,1995,11.4,10,5,4,3,3,5,10,50.0,5,6,2,4,0,10,13,0,Matches
1993,Aimar Oroz,ESP,"MF,FW",Osasuna,La Liga,20,2001,22.4,26,14,8,10,8,8,30,26.7,22,24,1,23,24,50,6,0,Matches
1994,Mislav Oršić,CRO,MF,Southampton,Premier League,29,1992,0.1,1,1,1,0,0,0,0,,0,0,0,0,0,1,0,0,Matches
1995,Riccardo Orsolini,ITA,FW,Bologna,Serie A,25,1997,23.6,30,19,15,10,5,17,41,41.5,24,29,3,26,8,38,18,0,Matches
1996,Stefan Ortega,GER,GK,Manchester City,Premier League,29,1992,3.0,0,0,0,0,0,0,0,,0,0,0,0,0,0,0,0,Matches
1997,Pedro Ortiz,ESP,MF,Sevilla,La Liga,21,2000,0.0,0,0,0,0,0,0,0,,0,0,0,0,0,0,0,0,Matches
1998,Jordi Osei-Tutu,ENG,"DF,FW",Bochum,Bundesliga,23,1998,8.3,23,18,13,5,5,12,23,52.2,11,12,5,7,10,33,8,0,Matches
1999,Victor Osimhen,NGA,FW,Napoli,Serie A,23,1998,28.5,10,6,1,2,7,0,7,0.0,7,6,1,5,6,16,29,0,Matches
2000,Patrick Osterhage,GER,MF,Bochum,Bundesliga,22,2000,11.4,20,17,8,10,2,11,16,68.8,5,17,6,11,12,32,25,0,Matches
2001,Paulo Otávio,BRA,DF,Wolfsburg,Bundesliga,27,1994,22.7,72,46,46,17,9,44,66,66.7,22,42,6,36,30,102,70,1,Matches
2002,Dango Ouattara,BFA,"MF,FW",Bournemouth,Premier League,20,2002,13.8,28,15,20,6,2,13,32,40.6,19,20,3,17,13,41,29,1,Matches
2003,Dango Ouattara,BFA,"FW,MF",Lorient,Ligue 1,20,2002,17.2,41,26,20,11,10,15,28,53.6,13,24,6,18,19,60,21,0,Matches
2004,Remi Oudin,FRA,"FW,MF",Lecce,Serie A,25,1996,14.7,25,13,9,12,4,10,23,43.5,13,16,2,14,29,54,23,0,Matches
2005,Zinédine Ould Khaled,FRA,"MF,FW",Angers,Ligue 1,22,2000,0.6,1,1,0,1,0,0,1,0.0,1,0,0,0,2,3,0,0,Matches
2006,Azzedine Ounahi,MAR,"MF,FW",Marseille,Ligue 1,22,2000,1.3,2,1,1,1,0,0,2,0.0,2,1,0,1,0,2,0,0,Matches
2007,Azzedine Ounahi,MAR,"MF,FW",Angers,Ligue 1,22,2000,12.5,19,8,5,13,1,10,20,50.0,10,8,0,8,15,34,4,1,Matches
2008,Adam Ounas,ALG,FW,Napoli,Serie A,25,1996,0.2,0,0,0,0,0,0,0,,0,0,0,0,1,1,0,0,Matches
2009,Adam Ounas,ALG,"FW,MF",Lille,Ligue 1,25,1996,11.8,20,11,4,10,6,8,13,61.5,5,16,0,16,7,27,5,0,Matches
2010,Thomas Ouwejan,NED,DF,Schalke 04,Bundesliga,25,1996,10.0,20,8,13,5,2,6,10,60.0,4,17,4,13,13,33,27,0,Matches
2011,Reece Oxford,ENG,DF,Augsburg,Bundesliga,23,1998,1.0,1,1,1,0,0,0,0,,0,4,3,1,1,2,5,0,Matches
2012,Alex Oxlade-Chamberlain,ENG,"FW,MF",Liverpool,Premier League,28,1993,3.7,5,4,1,2,2,1,5,20.0,4,5,2,3,1,6,4,0,Matches
2013,Mikel Oyarzabal,ESP,"FW,MF",Real Sociedad,La Liga,25,1997,13.5,13,7,5,3,5,5,19,26.3,14,14,4,10,3,16,5,0,Matches
2014,Salih Özcan,TUR,MF,Dortmund,Bundesliga,24,1998,17.5,31,18,10,16,5,16,39,41.0,23,24,2,22,28,59,19,1,Matches
2015,Cenk Özkacar,TUR,DF,Valencia,La Liga,21,2000,15.2,27,20,17,10,0,14,19,73.7,5,14,2,12,12,39,47,4,Matches
2016,David Ozoh,ENG,FW,Crystal Palace,Premier League,17,2005,0.0,0,0,0,0,0,0,0,,0,0,0,0,0,0,0,0,Matches
2017,Levin Öztunalı,GER,MF,Union Berlin,Bundesliga,26,1996,0.1,0,0,0,0,0,0,1,0.0,1,0,0,0,0,0,0,0,Matches
2018,Fernando Pacheco,ESP,GK,Almería,La Liga,30,1992,1.0,0,0,0,0,0,0,0,,0,0,0,0,0,0,1,0,Matches
2019,Fernando Pacheco,ESP,GK,Espanyol,La Liga,30,1992,16.0,0,0,0,0,0,0,1,0.0,1,0,0,0,1,1,11,0,Matches
2020,Jon Pacheco,ESP,DF,Real Sociedad,La Liga,21,2001,13.3,16,10,10,6,0,6,10,60.0,4,9,6,3,12,28,37,1,Matches
2021,Gonçalo Paciência,POR,"FW,MF",Celta Vigo,La Liga,27,1994,7.4,8,5,0,5,3,2,7,28.6,5,9,1,8,0,8,4,0,Matches
2022,Simone Pafundi,ITA,"MF,FW",Udinese,Serie A,16,2006,0.9,8,5,1,5,2,2,4,50.0,2,0,0,0,1,9,0,0,Matches
2023,Exequiel Palacios,ARG,MF,Leverkusen,Bundesliga,23,1998,18.4,59,36,20,33,6,29,48,60.4,19,29,2,27,33,92,28,0,Matches
2024,Helibelton Palacios,COL,DF,Elche,La Liga,29,1993,21.3,38,20,21,15,2,19,26,73.1,7,26,12,14,20,58,55,0,Matches
2025,Ante Palaversa,CRO,MF,Troyes,Ligue 1,22,2000,0.3,1,1,1,0,0,0,0,,0,0,0,0,1,2,0,0,Matches
2026,Isaac Palazón Camacho,ESP,"FW,MF",Rayo Vallecano,La Liga,27,1994,32.9,45,30,11,23,11,24,66,36.4,42,42,3,39,17,62,30,0,Matches
2027,João Palhinha,POR,MF,Fulham,Premier League,27,1995,34.5,148,83,59,65,24,71,135,52.6,64,48,5,43,46,194,61,2,Matches
2028,Nicolas Pallois,FRA,DF,Nantes,Ligue 1,34,1987,24.6,69,44,51,16,2,42,70,60.0,28,35,18,17,30,99,131,2,Matches
2029,Cole Palmer,ENG,"MF,FW",Manchester City,Premier League,20,2002,4.1,5,1,0,3,2,3,5,60.0,2,2,1,1,1,6,2,0,Matches
2030,Erik Palmer-Brown,USA,DF,Troyes,Ligue 1,25,1997,35.5,42,27,31,10,1,18,33,54.5,15,56,29,27,26,68,166,1,Matches
2031,Emerson Palmieri,ITA,DF,West Ham,Premier League,27,1994,14.7,26,14,9,15,2,12,24,50.0,12,17,4,13,15,41,36,0,Matches
2032,Miloš Pantović,SRB,MF,Union Berlin,Bundesliga,26,1996,2.3,4,2,4,0,0,3,5,60.0,2,3,0,3,0,4,5,0,Matches
2033,Flavio Paoletti,ITA,MF,Sampdoria,Serie A,19,2003,3.2,2,2,0,2,0,1,5,20.0,4,1,0,1,5,7,9,0,Matches
2034,Antonios Papadopoulos,GER,DF,Dortmund,Bundesliga,22,1999,0.1,0,0,0,0,0,0,0,,0,0,0,0,1,1,0,0,Matches
2035,Lucas Paquetá,BRA,MF,West Ham,Premier League,24,1997,23.9,71,53,23,36,12,27,68,39.7,41,41,4,37,16,87,31,0,Matches
2036,Lucas Paquetá,BRA,MF,Lyon,Ligue 1,24,1997,1.8,5,4,0,5,0,1,3,33.3,2,2,0,2,1,6,3,0,Matches
2037,Aitor Paredes,ESP,DF,Athletic Club,La Liga,22,2000,9.5,7,6,4,2,1,6,11,54.5,5,11,7,4,14,21,26,0,Matches
2038,Kevin Paredes,USA,"FW,MF",Wolfsburg,Bundesliga,19,2003,5.9,13,9,6,3,4,9,12,75.0,3,7,0,7,6,19,8,0,Matches
2039,Leandro Paredes,ARG,MF,Juventus,Serie A,28,1994,10.9,19,13,7,11,1,10,22,45.5,12,8,0,8,17,36,22,0,Matches
2040,Leandro Paredes,ARG,MF,Paris S-G,Ligue 1,28,1994,0.6,1,1,1,0,0,1,1,100.0,0,2,1,1,1,2,0,0,Matches
2041,Daniel Parejo,ESP,MF,Villarreal,La Liga,33,1989,36.5,71,40,32,23,16,30,75,40.0,45,40,12,28,29,100,31,2,Matches
2042,Fabiano Parisi,ITA,DF,Empoli,Serie A,21,2000,31.4,65,35,37,21,7,30,72,41.7,42,51,16,35,41,106,91,0,Matches
2043,Moises Parra Gutierrez,ESP,FW,Getafe,La Liga,20,2002,0.1,1,0,0,1,0,0,0,,0,0,0,0,0,1,0,0,Matches
2044,Raúl Parra,ESP,DF,Cádiz,La Liga,22,1999,3.4,4,2,4,0,0,4,9,44.4,5,5,3,2,1,5,9,0,Matches
2045,Thomas Partey,GHA,MF,Arsenal,Premier League,29,1993,27.6,70,40,20,35,15,25,52,48.1,27,26,5,21,28,98,41,1,Matches
2046,Marco Pašalić,CRO,MF,Dortmund,Bundesliga,21,2000,0.1,0,0,0,0,0,0,0,,0,0,0,0,0,0,0,0,Matches
2047,Mario Pašalić,CRO,"MF,FW",Atalanta,Serie A,27,1995,19.7,22,10,6,14,2,6,23,26.1,17,22,4,18,21,43,13,0,Matches
2048,Pascu,ESP,"DF,FW",Villarreal,La Liga,19,2003,0.1,0,0,0,0,0,0,0,,0,0,0,0,0,0,0,0,Matches
2049,Felix Passlack,GER,DF,Dortmund,Bundesliga,24,1998,0.7,4,3,0,4,0,1,1,100.0,0,1,1,0,0,4,1,0,Matches
2050,Javier Pastore,ARG,MF,Elche,La Liga,33,1989,0.1,0,0,0,0,0,0,0,,0,0,0,0,0,0,0,0,Matches
2051,Patric,ESP,DF,Lazio,Serie A,29,1993,15.7,17,11,12,3,2,11,16,68.8,5,17,12,5,11,28,53,1,Matches
2052,Rui Patrício,POR,GK,Roma,Serie A,34,1988,35.0,1,1,1,0,0,1,1,100.0,0,0,0,0,2,3,6,3,Matches
2053,Nathan Patterson,SCO,"DF,MF",Everton,Premier League,20,2001,14.2,49,24,32,13,4,29,54,53.7,25,24,4,20,15,64,45,0,Matches
2054,Paulinho,BRA,FW,Leverkusen,Bundesliga,22,2000,0.9,0,0,0,0,0,0,0,,0,1,0,1,0,0,2,0,Matches
2055,Gabriel Paulista,BRA,DF,Valencia,La Liga,31,1990,16.7,17,9,13,4,0,13,19,68.4,6,22,14,8,32,49,79,2,Matches
2056,Benjamin Pavard,FRA,DF,Bayern Munich,Bundesliga,26,1996,27.0,70,41,36,26,8,36,48,75.0,12,35,16,19,44,114,83,0,Matches
2057,Jiří Pavlenka,CZE,GK,Werder Bremen,Bundesliga,30,1992,32.3,1,0,1,0,0,1,5,20.0,4,1,0,1,3,4,21,1,Matches
2058,Dimitri Payet,FRA,"MF,FW",Marseille,Ligue 1,35,1987,9.3,6,4,2,2,2,3,11,27.3,8,4,0,4,0,6,4,0,Matches
2059,Ben Pearson,ENG,MF,Bournemouth,Premier League,27,1995,3.2,7,3,3,3,1,1,3,33.3,2,4,0,4,2,9,6,0,Matches
2060,Kristian Pedersen,DEN,DF,Köln,Bundesliga,27,1994,3.1,5,4,4,1,0,0,2,0.0,2,3,0,3,6,11,17,0,Matches
2061,Mads Pedersen,DEN,"DF,MF",Augsburg,Bundesliga,25,1996,20.4,44,23,31,11,2,22,33,66.7,11,32,9,23,20,64,41,1,Matches
2062,Alfonso Pedraza,ESP,DF,Villarreal,La Liga,26,1996,18.1,35,26,20,10,5,19,29,65.5,10,19,1,18,18,53,31,0,Matches
2063,Pedri,ESP,MF,Barcelona,La Liga,19,2002,22.0,39,22,15,17,7,13,45,28.9,32,27,0,27,13,52,8,1,Matches
2064,Pedro,ESP,FW,Lazio,Serie A,35,1987,21.1,35,24,14,10,11,11,30,36.7,19,18,2,16,6,41,4,1,Matches
2065,Adrià Pedrosa,ESP,"DF,MF",Espanyol,La Liga,24,1998,2.5,5,1,5,0,0,4,7,57.1,3,1,1,0,5,10,3,0,Matches
2066,Jordan Pefok,USA,FW,Union Berlin,Bundesliga,26,1996,15.1,15,7,3,4,8,2,17,11.8,15,17,5,12,4,19,15,0,Matches
2067,Gianluca Pegolo,ITA,GK,Sassuolo,Serie A,41,1981,2.0,0,0,0,0,0,0,1,0.0,1,0,0,0,0,0,1,0,Matches
2068,Dženan Pejčinović,GER,FW,Wolfsburg,Bundesliga,17,2005,0.1,0,0,0,0,0,0,0,,0,0,0,0,0,0,0,0,Matches
2069,Peter Pekarík,SVK,DF,Hertha BSC,Bundesliga,35,1986,2.3,4,3,4,0,0,4,6,66.7,2,6,2,4,4,8,7,0,Matches
2070,Pietro Pellegri,ITA,FW,Torino,Serie A,21,2001,5.2,6,2,1,3,2,2,3,66.7,1,5,1,4,0,6,4,0,Matches
2071,Lorenzo Pellegrini,ITA,MF,Roma,Serie A,26,1996,28.3,52,29,24,24,4,22,48,45.8,26,27,4,23,26,78,22,0,Matches
2072,Luca Pellegrini,ITA,DF,Lazio,Serie A,23,1999,2.0,1,0,0,1,0,1,4,25.0,3,3,0,3,7,8,4,0,Matches
2073,Luca Pellegrini,ITA,DF,Eint Frankfurt,Bundesliga,23,1999,6.2,13,8,10,3,0,8,8,100.0,0,8,2,6,7,20,11,1,Matches
2074,Théo Pellenard,FRA,DF,Auxerre,Ligue 1,28,1994,1.1,1,0,1,0,0,1,1,100.0,0,3,1,2,2,3,2,0,Matches
2075,Facundo Pellistri,URU,"FW,MF",Manchester Utd,Premier League,20,2001,0.7,1,1,0,1,0,0,0,,0,0,0,0,0,1,3,0,Matches
2076,Timothee Pembele,FRA,DF,Paris S-G,Ligue 1,19,2002,2.9,5,5,3,1,1,2,4,50.0,2,2,0,2,4,9,2,0,Matches
2077,Iñaki Peña,ESP,GK,Barcelona,La Liga,23,1999,0.8,0,0,0,0,0,0,0,,0,0,0,0,0,0,0,1,Matches
2078,Rubén Peña,ESP,"DF,MF",Osasuna,La Liga,31,1991,14.2,32,18,10,18,4,20,41,48.8,21,23,8,15,17,49,31,0,Matches
2079,Patrick Pentz,AUT,GK,Reims,Ligue 1,25,1997,7.0,0,0,0,0,0,0,0,,0,0,0,0,0,0,1,0,Matches
2080,Nicolas Pépé,CIV,"FW,MF",Nice,Ligue 1,27,1995,16.6,25,13,14,5,6,11,25,44.0,14,17,0,17,3,28,1,0,Matches
2081,Ricardo Pepi,USA,FW,Augsburg,Bundesliga,19,2003,1.1,1,1,1,0,0,1,1,100.0,0,1,0,1,0,1,1,0,Matches
2082,Pepín,EQG,MF,Monza,Serie A,25,1996,12.5,28,19,10,11,7,9,27,33.3,18,14,3,11,13,41,17,0,Matches
2083,Alberto Perea,ESP,MF,Cádiz,La Liga,31,1990,0.5,2,0,2,0,0,0,0,,0,2,0,2,0,2,0,0,Matches
2084,Juan Perea,COL,FW,Stuttgart,Bundesliga,22,2000,4.6,5,4,0,2,3,2,4,50.0,2,2,1,1,1,6,3,0,Matches
2085,Andreas Pereira,BRA,MF,Fulham,Premier League,26,1996,29.9,18,9,3,6,9,8,34,23.5,26,21,3,18,6,24,8,0,Matches
2086,Brayann Pereira,FRA,DF,Auxerre,Ligue 1,19,2003,2.0,6,5,5,1,0,1,5,20.0,4,2,2,0,2,8,8,1,Matches
2087,Danilo Pereira,POR,"DF,MF",Paris S-G,Ligue 1,30,1991,26.8,32,17,15,14,3,19,26,73.1,7,26,19,7,36,68,59,1,Matches
2088,Mathias Pereira Lage,POR,"MF,FW",Brest,Ligue 1,25,1996,14.0,20,7,5,14,1,11,29,37.9,18,10,1,9,14,34,12,0,Matches
2089,Ricardo Pereira,POR,"DF,MF",Leicester City,Premier League,28,1993,5.0,11,7,8,3,0,7,17,41.2,10,8,2,6,4,15,20,0,Matches
2090,Roberto Pereyra,ARG,"DF,MF",Udinese,Serie A,31,1991,31.3,36,20,21,12,3,16,44,36.4,28,20,5,15,16,52,28,0,Matches
2091,Ayoze Pérez,ESP,"MF,FW",Leicester City,Premier League,29,1993,4.2,11,8,5,4,2,8,19,42.1,11,6,0,6,2,13,3,0,Matches
2092,Ayoze Pérez,ESP,"FW,MF",Betis,La Liga,29,1993,15.4,31,15,9,16,6,10,40,25.0,30,22,0,22,13,44,5,0,Matches
2093,Carles Pérez,ESP,"MF,FW",Celta Vigo,La Liga,24,1998,23.8,39,23,12,17,10,22,66,33.3,44,29,3,26,6,45,9,0,Matches
2094,Francisco Perez,ESP,"FW,MF",Valencia,La Liga,19,2002,1.6,1,1,1,0,0,0,3,0.0,3,0,0,0,0,1,1,0,Matches
2095,Kike Pérez,ESP,MF,Valladolid,La Liga,25,1997,25.6,67,33,30,32,5,25,68,36.8,43,26,7,19,20,87,28,0,Matches
2096,Lucas Pérez,ESP,FW,Cádiz,La Liga,33,1988,7.0,3,2,2,1,0,1,3,33.3,2,2,0,2,1,4,3,0,Matches
2097,Luis Pérez,ESP,DF,Valladolid,La Liga,27,1995,13.5,44,24,26,12,6,27,38,71.1,11,13,4,9,16,60,29,0,Matches
2098,Nehuén Pérez,ARG,DF,Udinese,Serie A,22,2000,31.3,77,40,54,20,3,39,55,70.9,16,53,23,30,35,112,106,1,Matches
2099,Simone Perilli,ITA,GK,Hellas Verona,Serie A,27,1995,1.0,0,0,0,0,0,0,0,,0,0,0,0,0,0,0,0,Matches
2100,Mattia Perin,ITA,GK,Juventus,Serie A,29,1992,10.5,0,0,0,0,0,0,0,,0,0,0,0,0,0,0,0,Matches
2101,Samuele Perisan,ITA,GK,Empoli,Serie A,24,1997,7.0,0,0,0,0,0,0,0,,0,0,0,0,0,0,2,0,Matches
2102,Ivan Perišić,CRO,"DF,MF",Tottenham,Premier League,33,1989,23.4,42,24,25,10,7,27,47,57.4,20,29,7,22,22,64,49,1,Matches
2103,Romain Perraud,FRA,DF,Southampton,Premier League,24,1997,20.4,54,33,23,23,8,28,52,53.8,24,24,6,18,20,74,42,0,Matches
2104,Gaëtan Perrin,FRA,"MF,FW",Auxerre,Ligue 1,26,1996,15.5,17,8,5,6,6,8,30,26.7,22,15,0,15,10,27,9,0,Matches
2105,Lucas Perrin,FRA,DF,Strasbourg,Ligue 1,23,1998,19.6,44,27,28,14,2,25,49,51.0,24,13,5,8,36,80,53,0,Matches
2106,Máximo Perrone,ARG,MF,Manchester City,Premier League,19,2003,0.2,0,0,0,0,0,0,0,,0,1,0,1,0,0,0,0,Matches
2107,Matteo Pessina,ITA,MF,Monza,Serie A,25,1997,32.6,57,36,28,21,8,26,62,41.9,36,50,15,35,37,94,33,1,Matches
2108,Andrea Petagna,ITA,FW,Monza,Serie A,27,1995,18.5,7,5,2,3,2,3,6,50.0,3,16,4,12,3,10,18,0,Matches
2109,Nils Petersen,GER,FW,Freiburg,Bundesliga,33,1988,3.1,6,4,0,3,3,2,5,40.0,3,11,2,9,1,7,6,0,Matches
2110,Lukas Petkov,BUL,"MF,FW",Augsburg,Bundesliga,21,2000,1.6,5,1,4,1,0,2,3,66.7,1,4,1,3,1,6,0,0,Matches
2111,Cameron Peupion,AUS,MF,Brighton,Premier League,19,2002,0.1,0,0,0,0,0,0,0,,0,0,0,0,0,0,0,0,Matches
2112,Germán Pezzella,ARG,DF,Betis,La Liga,31,1991,27.9,41,28,32,9,0,26,38,68.4,12,32,15,17,50,91,129,1,Matches
2113,Giuseppe Pezzella,ITA,DF,Lecce,Serie A,24,1997,10.2,21,9,16,2,3,9,16,56.3,7,11,3,8,8,29,31,1,Matches
2114,Luca Pfeiffer,GER,FW,Stuttgart,Bundesliga,25,1996,7.8,1,1,1,0,0,0,1,0.0,1,4,0,4,1,2,5,0,Matches
2115,Maximilian Philipp,GER,FW,Wolfsburg,Bundesliga,28,1994,1.3,2,1,1,1,0,1,1,100.0,0,1,0,1,0,2,0,0,Matches
2116,Maximilian Philipp,GER,"FW,MF",Werder Bremen,Bundesliga,28,1994,4.9,6,5,3,2,1,1,9,11.1,8,7,1,6,3,9,4,0,Matches
2117,Kalvin Phillips,ENG,MF,Manchester City,Premier League,26,1995,3.3,6,4,3,3,0,2,10,20.0,8,7,3,4,5,11,10,0,Matches
2118,Nathaniel Phillips,ENG,DF,Liverpool,Premier League,25,1997,0.7,2,1,0,2,0,2,2,100.0,0,0,0,0,2,4,1,0,Matches
2119,Krzysztof Piątek,POL,FW,Salernitana,Serie A,27,1995,23.8,18,11,3,9,6,5,21,23.8,16,17,4,13,2,20,39,0,Matches
2120,Roberto Piccoli,ITA,FW,Hellas Verona,Serie A,21,2001,2.1,1,0,1,0,0,0,2,0.0,2,2,0,2,0,1,2,0,Matches
2121,Roberto Piccoli,ITA,FW,Empoli,Serie A,21,2001,5.7,1,1,1,0,0,0,3,0.0,3,4,1,3,1,2,9,0,Matches
2122,Charles Pickel,COD,MF,Cremonese,Serie A,25,1997,27.6,55,23,25,26,4,32,57,56.1,25,37,5,32,24,79,36,1,Matches
2123,Jordan Pickford,ENG,GK,Everton,Premier League,28,1994,37.0,0,0,0,0,0,0,1,0.0,1,0,0,0,4,4,15,3,Matches
2124,Amos Pieper,GER,DF,Werder Bremen,Bundesliga,24,1998,21.7,46,28,25,19,2,24,40,60.0,16,23,11,12,30,76,94,1,Matches
2125,Ronaël Pierre-Gabriel,FRA,DF,Espanyol,La Liga,24,1998,2.6,17,9,12,4,1,5,11,45.5,6,5,2,3,9,26,11,0,Matches
2126,Ronaël Pierre-Gabriel,FRA,DF,Strasbourg,Ligue 1,24,1998,7.3,25,18,11,12,2,15,17,88.2,2,16,3,13,9,34,22,0,Matches
2127,Andrea Pinamonti,ITA,FW,Sassuolo,Serie A,23,1999,24.0,10,7,0,5,5,3,7,42.9,4,19,2,17,2,12,11,0,Matches
2128,Ethan Pinnock,JAM,DF,Brentford,Premier League,29,1993,30.0,52,28,33,12,7,18,24,75.0,6,41,31,10,35,87,215,2,Matches
2129,Yeremi Pino,ESP,"FW,MF",Villarreal,La Liga,19,2002,27.2,62,38,25,20,17,21,56,37.5,35,41,4,37,15,77,36,0,Matches
2130,Gerard Piqué,ESP,DF,Barcelona,La Liga,35,1987,4.3,5,4,1,4,0,4,4,100.0,0,2,1,1,2,7,19,0,Matches
2131,Lorenzo Pirola,ITA,DF,Salernitana,Serie A,20,2002,21.6,33,29,18,14,1,19,27,70.4,8,50,35,15,30,63,85,1,Matches
2132,Niccolò Pisilli,ITA,MF,Roma,Serie A,17,2004,0.0,0,0,0,0,0,0,0,,0,0,0,0,0,0,0,0,Matches
2133,Marko Pjaca,CRO,"MF,FW",Empoli,Serie A,27,1995,5.8,4,3,3,1,0,3,5,60.0,2,3,0,3,3,7,3,0,Matches
2134,Óscar Plano,ESP,"FW,MF",Valladolid,La Liga,31,1991,22.6,40,25,9,17,14,12,37,32.4,25,26,2,24,29,69,23,0,Matches
2135,Gonzalo Plata,ECU,FW,Valladolid,La Liga,21,2000,25.6,66,35,31,24,11,23,70,32.9,47,40,0,40,12,78,10,1,Matches
2136,Marvin Plattenhardt,GER,DF,Hertha BSC,Bundesliga,30,1992,26.7,43,33,24,15,4,29,47,61.7,18,25,11,14,15,58,82,0,Matches
2137,Alassane Pléa,FRA,FW,Gladbach,Bundesliga,29,1993,19.7,16,8,5,7,4,8,26,30.8,18,23,3,20,12,28,14,0,Matches
2138,Tommaso Pobega,ITA,MF,Milan,Serie A,23,1999,9.8,27,16,8,15,4,13,20,65.0,7,12,4,8,9,36,11,0,Matches
2139,Daniel Podence,POR,"FW,MF",Wolves,Premier League,26,1995,19.7,27,17,13,9,5,6,32,18.8,26,19,0,19,7,34,6,0,Matches
2140,Paul Pogba,FRA,"MF,FW",Juventus,Serie A,29,1993,1.2,0,0,0,0,0,0,1,0.0,1,0,0,0,0,0,2,0,Matches
2141,Joel Pohjanpalo,FIN,"FW,MF",Leverkusen,Bundesliga,27,1994,0.0,0,0,0,0,0,0,0,,0,0,0,0,0,0,0,0,Matches
2142,Matteo Politano,ITA,FW,Napoli,Serie A,28,1993,13.0,18,9,9,5,4,11,25,44.0,14,6,0,6,7,25,7,0,Matches
2143,Sebastian Polter,GER,FW,Schalke 04,Bundesliga,31,1991,7.0,4,3,0,4,0,1,4,25.0,3,4,0,4,1,5,6,0,Matches
2144,Ezequiel Ponce,ARG,"FW,MF",Elche,La Liga,25,1997,12.5,9,7,0,6,3,0,7,0.0,7,6,1,5,1,10,13,0,Matches
2145,Julien Ponceau,FRA,MF,Lorient,Ligue 1,21,2000,18.4,28,19,10,14,4,10,32,31.3,22,27,3,24,14,42,12,0,Matches
2146,Marin Pongračić,CRO,DF,Lecce,Serie A,24,1997,8.8,16,14,8,7,1,5,7,71.4,2,4,3,1,16,32,31,0,Matches
2147,Nick Pope,ENG,GK,Newcastle Utd,Premier League,30,1992,36.2,1,0,1,0,0,1,3,33.3,2,0,0,0,0,1,27,2,Matches
2148,Łukasz Poręba,POL,MF,Lens,Ligue 1,22,2000,2.9,5,4,2,1,2,2,3,66.7,1,3,0,3,4,9,2,0,Matches
2149,Jackson Porozo,ECU,DF,Troyes,Ligue 1,21,2000,18.0,32,20,24,7,1,13,31,41.9,18,24,17,7,33,65,75,0,Matches
2150,Pedro Porro,ESP,"DF,MF",Tottenham,Premier League,22,1999,12.6,25,16,8,15,2,14,39,35.9,25,25,2,23,15,40,24,1,Matches
2151,Francisco Portillo,ESP,"MF,FW",Almería,La Liga,32,1990,8.0,13,6,4,5,4,3,16,18.8,13,7,1,6,7,20,8,0,Matches
2152,Portu,ESP,"MF,DF",Getafe,La Liga,30,1992,19.7,28,21,14,10,4,18,42,42.9,24,23,3,20,17,45,20,1,Matches
2153,Stefan Posch,AUT,DF,Bologna,Serie A,25,1997,28.1,81,43,41,29,11,44,75,58.7,31,44,15,29,35,116,69,0,Matches
2154,Stefan Posch,AUT,DF,Hoffenheim,Bundesliga,25,1997,0.2,0,0,0,0,0,0,0,,0,0,0,0,0,0,0,0,Matches
2155,Yussuf Poulsen,DEN,FW,RB Leipzig,Bundesliga,28,1994,4.6,6,4,1,4,1,2,5,40.0,3,3,1,2,0,6,5,0,Matches
2156,José Pozo,ESP,"MF,FW",Rayo Vallecano,La Liga,26,1996,1.0,2,2,0,2,0,0,0,,0,0,0,0,1,3,1,0,Matches
2157,Manuel Pozo,ESP,FW,Valladolid,La Liga,20,2001,0.2,0,0,0,0,0,0,0,,0,2,0,2,2,2,0,0,Matches
2158,Alejandro Pozo Pozo,ESP,DF,Almería,La Liga,23,1999,20.9,37,19,17,17,3,27,53,50.9,26,30,5,25,26,63,45,1,Matches
2159,Dennis Praet,BEL,"MF,FW",Leicester City,Premier League,28,1994,7.2,12,9,5,6,1,6,11,54.5,5,12,2,10,5,17,6,0,Matches
2160,Abdón Prats,ESP,"FW,MF",Mallorca,La Liga,29,1992,4.6,1,0,1,0,0,0,0,,0,5,0,5,0,1,2,0,Matches
2161,Sanjin Prcić,BIH,MF,Strasbourg,Ligue 1,28,1993,18.1,27,12,6,16,5,19,31,61.3,12,22,7,15,25,52,22,0,Matches
2162,Isaac Price,NIR,MF,Everton,Premier League,18,2003,0.4,0,0,0,0,0,0,1,0.0,1,1,1,0,0,0,0,0,Matches
2163,Grischa Prömel,GER,MF,Hoffenheim,Bundesliga,27,1995,16.2,27,19,14,11,2,9,25,36.0,16,22,4,18,8,35,23,0,Matches
2164,Ivan Provedel,ITA,GK,Lazio,Serie A,28,1994,37.9,1,0,1,0,0,0,0,,0,0,0,0,0,1,15,1,Matches
2165,Javi Puado,ESP,"FW,MF",Espanyol,La Liga,24,1998,26.0,20,11,12,5,3,12,28,42.9,16,12,2,10,10,30,14,0,Matches
2166,Mehdi Puch-Herrantz,FRA,MF,Ajaccio,Ligue 1,18,2004,0.5,2,2,0,1,1,1,2,50.0,1,1,0,1,3,5,0,0,Matches
2167,Tymoteusz Puchacz,POL,DF,Union Berlin,Bundesliga,23,1999,0.6,1,0,1,0,0,0,0,,0,0,0,0,0,1,1,0,Matches
2168,Arnau Puigmal,ESP,"MF,FW",Almería,La Liga,21,2001,8.5,22,14,10,7,5,12,17,70.6,5,7,0,7,11,33,6,0,Matches
2169,Christian Pulisic,USA,"FW,DF",Chelsea,Premier League,23,1998,9.1,11,6,3,6,2,3,5,60.0,2,8,1,7,4,15,4,0,Matches
2170,Ignacio Pussetto,ARG,"MF,DF",Sampdoria,Serie A,26,1995,1.7,6,3,2,3,1,3,4,75.0,1,4,0,4,0,6,3,0,Matches
2171,Niklas Pyyhtiä,FIN,MF,Bologna,Serie A,18,2003,1.2,1,0,0,1,0,0,1,0.0,1,1,1,0,1,2,4,0,Matches
2172,Fabio Quagliarella,ITA,FW,Sampdoria,Serie A,39,1983,8.9,2,1,1,1,0,1,7,14.3,6,5,1,4,0,2,9,0,Matches
2173,Giacomo Quagliata,ITA,DF,Cremonese,Serie A,22,2000,7.8,10,8,7,1,2,5,11,45.5,6,7,2,5,11,21,8,0,Matches
2174,Eduardo Quaresma,POR,DF,Hoffenheim,Bundesliga,20,2002,1.0,5,3,3,2,0,1,3,33.3,2,3,2,1,0,5,3,0,Matches
2175,Joshua Quarshie,GER,MF,Hoffenheim,Bundesliga,18,2004,0.0,0,0,0,0,0,0,0,,0,0,0,0,0,0,0,0,Matches
2176,Ghjuvanni Quilichini,FRA,GK,Ajaccio,Ligue 1,19,2002,0.9,0,0,0,0,0,0,0,,0,0,0,0,0,0,1,0,Matches
2177,Domingos Quina,POR,MF,Elche,La Liga,22,1999,3.1,3,2,2,1,0,1,3,33.3,2,5,0,5,3,6,1,0,Matches
2178,Rubén Quintanilla,ESP,DF,Mallorca,La Liga,20,2002,0.0,0,0,0,0,0,0,0,,0,1,0,1,0,0,0,0,Matches
2179,Adrien Rabiot,FRA,MF,Juventus,Serie A,27,1995,30.5,65,35,31,23,11,30,57,52.6,27,37,7,30,26,91,44,1,Matches
2180,Nemanja Radonjić,SRB,"MF,FW",Torino,Serie A,26,1996,16.2,2,1,2,0,0,0,4,0.0,4,3,0,3,2,4,4,0,Matches
2181,Ivan Radovanović,SRB,"MF,DF",Salernitana,Serie A,33,1988,7.5,12,4,8,4,0,4,10,40.0,6,9,3,6,7,19,9,1,Matches
2182,Ionuț Radu,ROU,GK,Cremonese,Serie A,25,1997,9.0,0,0,0,0,0,0,0,,0,0,0,0,0,0,1,3,Matches
2183,Ionuț Radu,ROU,GK,Auxerre,Ligue 1,25,1997,17.0,0,0,0,0,0,0,0,,0,0,0,0,0,0,3,3,Matches
2184,Ștefan Radu,ROU,FW,Lazio,Serie A,35,1986,0.0,0,0,0,0,0,0,0,,0,0,0,0,0,0,0,0,Matches
2185,Antonio Raillo,ESP,DF,Mallorca,La Liga,30,1991,30.7,34,21,23,11,0,10,15,66.7,5,38,29,9,31,65,158,1,Matches
2186,Antonio Raimondo,ITA,FW,Bologna,Serie A,18,2004,0.2,0,0,0,0,0,0,0,,0,0,0,0,0,0,1,0,Matches
2187,Predrag Rajković,SRB,GK,Mallorca,La Liga,26,1995,36.0,0,0,0,0,0,0,2,0.0,2,0,0,0,0,0,16,1,Matches
2188,Ivan Rakitić,CRO,MF,Sevilla,La Liga,34,1988,19.9,37,26,10,18,9,19,40,47.5,21,21,1,20,27,64,20,0,Matches
2189,Diant Ramaj,GER,GK,Eint Frankfurt,Bundesliga,20,2001,1.0,0,0,0,0,0,0,0,,0,0,0,0,0,0,1,0,Matches
2190,Largie Ramazani,BEL,"FW,MF",Almería,La Liga,21,2001,15.6,15,9,6,3,6,8,27,29.6,19,11,0,11,15,30,10,0,Matches
2191,Simon Ramet,FRA,DF,Lille,Ligue 1,19,2003,0.0,0,0,0,0,0,0,0,,0,0,0,0,0,0,0,0,Matches
2192,Adil Rami,FRA,DF,Troyes,Ligue 1,36,1985,17.7,19,14,13,5,1,17,32,53.1,15,23,16,7,25,44,75,3,Matches
2193,Chris Ramos,ESP,FW,Cádiz,La Liga,25,1997,7.9,12,9,2,7,3,4,11,36.4,7,8,3,5,1,13,19,0,Matches
2194,Sergio Ramos,ESP,DF,Paris S-G,Ligue 1,36,1986,30.0,34,26,14,18,2,23,44,52.3,21,29,13,16,34,68,93,3,Matches
2195,Aaron Ramsdale,ENG,GK,Arsenal,Premier League,24,1998,38.0,1,1,1,0,0,1,1,100.0,0,0,0,0,0,1,20,6,Matches
2196,Aaron Ramsey,WAL,MF,Nice,Ligue 1,31,1990,17.6,47,25,18,19,10,16,39,41.0,23,25,4,21,17,64,18,1,Matches
2197,Jacob Ramsey,ENG,"MF,FW",Aston Villa,Premier League,21,2001,29.3,69,39,23,35,11,32,69,46.4,37,48,8,40,23,92,34,0,Matches
2198,Luca Ranieri,ITA,DF,Fiorentina,Serie A,23,1999,5.6,9,4,6,3,0,6,9,66.7,3,5,3,2,11,20,15,1,Matches
2199,Andrea Ranocchia,ITA,DF,Monza,Serie A,34,1988,0.5,3,1,1,2,0,3,4,75.0,1,5,5,0,0,3,7,0,Matches
2200,Filippo Ranocchia,ITA,MF,Monza,Serie A,21,2001,5.9,11,6,5,4,2,4,12,33.3,8,5,1,4,4,15,7,0,Matches
2201,Lilian Raolisoa,FRA,"DF,MF",Angers,Ligue 1,22,2000,1.9,11,9,6,3,2,7,10,70.0,3,3,1,2,3,14,5,0,Matches
2202,Raphinha,BRA,FW,Barcelona,La Liga,25,1996,23.0,29,19,10,7,12,11,31,35.5,20,33,1,32,14,43,11,1,Matches
2203,Nicolai Rapp,GER,"MF,DF",Werder Bremen,Bundesliga,25,1996,0.8,3,1,3,0,0,0,3,0.0,3,0,0,0,0,3,1,0,Matches
2204,Elba Rashani,KVX,"MF,FW",Clermont Foot,Ligue 1,29,1993,24.0,39,26,13,19,7,13,39,33.3,26,27,2,25,21,60,19,0,Matches
2205,Marcus Rashford,ENG,FW,Manchester Utd,Premier League,24,1997,32.0,20,10,7,8,5,9,24,37.5,15,31,4,27,7,27,14,0,Matches
2206,Giacomo Raspadori,ITA,FW,Sassuolo,Serie A,22,2000,0.5,0,0,0,0,0,0,0,,0,0,0,0,0,0,0,0,Matches
2207,Giacomo Raspadori,ITA,"FW,MF",Napoli,Serie A,22,2000,10.1,10,8,0,6,4,4,10,40.0,6,9,0,9,4,14,4,0,Matches
2208,Rafael Ratão,BRA,"FW,MF",Toulouse,Ligue 1,26,1995,20.6,52,36,29,16,7,27,73,37.0,46,34,0,34,21,73,7,0,Matches
2209,David Raum,GER,"DF,MF",RB Leipzig,Bundesliga,24,1998,18.7,39,25,23,12,4,17,29,58.6,12,24,6,18,16,55,26,1,Matches
2210,Nicola Ravaglia,ITA,GK,Sampdoria,Serie A,33,1988,9.0,0,0,0,0,0,0,1,0.0,1,0,0,0,0,0,7,0,Matches
2211,Rayan Raveloson,MAD,"DF,MF",Auxerre,Ligue 1,25,1997,27.0,38,23,21,16,1,23,33,69.7,10,43,12,31,39,77,70,0,Matches
2212,David Raya,ESP,GK,Brentford,Premier League,26,1995,38.0,0,0,0,0,0,0,2,0.0,2,1,0,1,1,1,10,3,Matches
2213,Tim Ream,USA,DF,Fulham,Premier League,34,1987,32.2,30,16,15,12,3,13,26,50.0,13,45,24,21,41,71,116,3,Matches
2214,Ante Rebić,CRO,"FW,MF",Milan,Serie A,28,1993,10.9,10,8,1,3,6,3,11,27.3,8,6,1,5,1,11,5,0,Matches
2215,Arkadiusz Reca,POL,DF,Spezia,Serie A,27,1995,24.1,44,28,22,12,10,19,32,59.4,13,21,5,16,24,68,54,0,Matches
2216,Nathan Redmond,ENG,DF,Southampton,Premier League,28,1994,0.0,0,0,0,0,0,0,0,,0,0,0,0,0,0,0,0,Matches
2217,Harrison Reed,ENG,MF,Fulham,Premier League,27,1995,31.8,44,27,17,21,6,16,51,31.4,35,54,12,42,19,63,36,0,Matches
2218,Sergio Reguilón,ESP,DF,Atlético Madrid,La Liga,25,1996,3.4,7,5,5,2,0,5,7,71.4,2,3,0,3,2,9,4,0,Matches
2219,Bobby Reid,JAM,"FW,DF",Fulham,Premier League,29,1993,27.5,42,24,14,14,14,16,36,44.4,20,25,3,22,20,62,28,1,Matches
2220,Pepe Reina,ESP,GK,Villarreal,La Liga,39,1982,22.0,0,0,0,0,0,0,1,0.0,1,0,0,0,1,1,4,4,Matches
2221,Jeff Reine-Adélaïde,FRA,MF,Troyes,Ligue 1,24,1998,2.6,3,2,2,1,0,1,2,50.0,1,2,0,2,2,5,1,0,Matches
2222,Jeff Reine-Adélaïde,FRA,MF,Lyon,Ligue 1,24,1998,3.7,8,5,1,5,2,5,9,55.6,4,4,0,4,6,14,0,0,Matches
2223,Reinier,BRA,"MF,FW",Girona,La Liga,20,2002,7.2,12,10,7,3,2,2,8,25.0,6,6,0,6,5,17,4,0,Matches
2224,Rocco Reitz,GER,MF,Gladbach,Bundesliga,20,2002,0.0,0,0,0,0,0,0,0,,0,0,0,0,0,0,0,0,Matches
2225,Karim Rekik,NED,DF,Sevilla,La Liga,27,1994,13.1,11,5,8,3,0,4,5,80.0,1,12,5,7,10,21,24,0,Matches
2226,Álex Remiro,ESP,GK,Real Sociedad,La Liga,27,1995,38.0,1,1,1,0,0,1,3,33.3,2,0,0,0,0,1,17,3,Matches
2227,Panagiotis Retsos,GRE,DF,Hellas Verona,Serie A,23,1998,1.4,5,4,2,2,1,3,3,100.0,0,4,1,3,2,7,3,0,Matches
2228,Marco Reus,GER,"MF,FW",Dortmund,Bundesliga,33,1989,15.0,30,17,12,14,4,7,24,29.2,17,12,4,8,8,38,8,0,Matches
2229,Alejandro Revuelta Montero,ESP,DF,Getafe,La Liga,22,2000,0.0,0,0,0,0,0,0,0,,0,0,0,0,0,0,1,0,Matches
2230,Elvis Rexhbeçaj,GER,MF,Augsburg,Bundesliga,24,1997,28.0,51,30,18,24,9,29,59,49.2,30,39,12,27,17,68,40,0,Matches
2231,Gio Reyna,USA,"FW,MF",Dortmund,Bundesliga,19,2002,6.9,14,7,2,5,7,5,10,50.0,5,8,2,6,3,17,5,0,Matches
2232,Chadi Riad,MAR,MF,Barcelona,La Liga,19,2003,0.0,0,0,0,0,0,0,0,,0,0,0,0,0,0,0,0,Matches
2233,Nico Ribaudo,ESP,"MF,FW",Espanyol,La Liga,21,2001,13.9,18,13,5,9,4,11,30,36.7,19,19,1,18,5,23,1,0,Matches
2234,Alexsandro Ribeiro,BRA,DF,Lille,Ligue 1,22,1999,17.9,32,18,24,7,1,19,28,67.9,9,11,2,9,25,57,59,1,Matches
2235,Franck Ribéry,FRA,MF,Salernitana,Serie A,39,1983,0.4,0,0,0,0,0,0,0,,0,1,0,1,0,0,0,0,Matches
2236,Samuele Ricci,ITA,MF,Torino,Serie A,20,2001,23.0,32,21,17,10,5,18,23,78.3,5,20,5,15,17,49,29,1,Matches
2237,Declan Rice,ENG,MF,West Ham,Premier League,23,1999,36.4,79,38,44,31,4,31,50,62.0,19,45,15,30,63,142,58,0,Matches
2238,Chris Richards,USA,DF,Crystal Palace,Premier League,22,2000,5.0,9,6,8,1,0,5,7,71.4,2,10,1,9,8,17,31,0,Matches
2239,Richarlison,BRA,"MF,FW",Tottenham,Premier League,25,1997,11.2,21,16,13,5,3,12,27,44.4,15,14,1,13,5,26,10,0,Matches
2240,Marco Richter,GER,"MF,FW",Hertha BSC,Bundesliga,24,1997,20.4,43,23,18,17,8,19,48,39.6,29,29,2,27,24,67,25,0,Matches
2241,Diego Rico,ESP,DF,Real Sociedad,La Liga,29,1993,18.3,35,21,17,11,7,12,27,44.4,15,18,5,13,20,55,51,1,Matches
2242,Jaïro Riedewald,NED,"DF,MF",Crystal Palace,Premier League,25,1996,0.7,2,1,2,0,0,0,1,0.0,1,2,0,2,0,2,4,0,Matches
2243,Manuel Riemann,GER,GK,Bochum,Bundesliga,33,1988,34.0,3,2,3,0,0,3,5,60.0,2,1,0,1,5,8,23,7,Matches
2244,Tomás Rincón,VEN,MF,Sampdoria,Serie A,34,1988,28.4,56,27,22,26,8,29,61,47.5,32,37,7,30,30,86,18,0,Matches
2245,Rémy Riou,FRA,GK,Lyon,Ligue 1,34,1987,6.7,1,0,1,0,0,1,1,100.0,0,0,0,0,0,1,3,0,Matches
2246,Renaud Ripart,FRA,"FW,MF",Troyes,Ligue 1,29,1993,14.7,40,23,14,20,6,19,52,36.5,33,29,2,27,7,47,5,0,Matches
2247,Rodrigo Riquelme,ESP,"MF,FW",Girona,La Liga,22,2000,24.2,20,8,8,8,4,9,35,25.7,26,16,0,16,11,31,5,0,Matches
2248,Matt Ritchie,SCO,"FW,MF",Newcastle Utd,Premier League,32,1989,0.4,1,1,0,1,0,1,3,33.3,2,0,0,0,1,2,0,0,Matches
2249,Sergi Roberto,ESP,"DF,MF",Barcelona,La Liga,30,1992,14.5,22,15,12,6,4,7,18,38.9,11,15,7,8,11,33,16,0,Matches
2250,Lucas Robertone,ARG,MF,Almería,La Liga,25,1997,31.6,50,28,20,21,9,28,64,43.8,36,45,7,38,46,96,46,1,Matches
2251,Andrew Robertson,SCO,DF,Liverpool,Premier League,28,1994,28.7,38,21,12,16,10,21,41,51.2,20,32,5,27,18,56,50,3,Matches
2252,Antonee Robinson,USA,DF,Fulham,Premier League,24,1997,34.3,62,38,43,15,4,44,65,67.7,21,49,13,36,53,115,83,3,Matches
2253,Joel Robles,ESP,GK,Leeds United,Premier League,32,1990,4.0,0,0,0,0,0,0,1,0.0,1,0,0,0,0,0,2,1,Matches
2254,Joel Roca,ESP,"MF,FW",Girona,La Liga,17,2005,0.9,2,2,2,0,0,2,5,40.0,3,1,1,0,0,2,1,0,Matches
2255,Marc Roca,ESP,MF,Leeds United,Premier League,25,1996,25.7,66,40,27,34,5,20,65,30.8,45,34,10,24,23,89,24,2,Matches
2256,Enzo Roco,CHI,DF,Elche,La Liga,29,1992,18.4,33,13,23,10,0,15,24,62.5,9,22,15,7,17,50,63,1,Matches
2257,Marek Rodák,SVK,GK,Fulham,Premier League,25,1996,2.0,0,0,0,0,0,0,0,,0,0,0,0,0,0,1,1,Matches
2258,Sebastian Rode,GER,MF,Eint Frankfurt,Bundesliga,31,1990,15.7,38,24,7,28,3,14,45,31.1,31,18,2,16,16,54,12,0,Matches
2259,Joe Rodon,WAL,DF,Rennes,Ligue 1,24,1997,15.7,11,7,9,2,0,4,10,40.0,6,16,12,4,9,20,54,1,Matches
2260,Rodri,ESP,MF,Manchester City,Premier League,26,1996,32.3,67,41,28,28,11,26,53,49.1,27,40,14,26,33,100,43,1,Matches
2261,Rodri,ESP,"FW,MF",Betis,La Liga,22,2000,17.8,16,11,5,9,2,8,17,47.1,9,10,0,10,13,29,2,0,Matches
2262,Rodrigo,ESP,"FW,MF",Leeds United,Premier League,31,1991,21.5,24,10,2,15,7,8,19,42.1,11,16,4,12,6,30,21,1,Matches
2263,Ángel Rodríguez,ESP,"FW,MF",Mallorca,La Liga,35,1987,4.4,1,1,0,1,0,0,2,0.0,2,3,0,3,1,2,1,0,Matches
2264,Óscar Rodríguez Arnaiz,ESP,MF,Celta Vigo,La Liga,24,1998,19.7,32,25,12,15,5,13,28,46.4,15,16,2,14,24,56,15,0,Matches
2265,Dani Rodríguez,ESP,MF,Mallorca,La Liga,34,1988,23.3,42,23,18,22,2,21,46,45.7,25,31,8,23,21,63,14,0,Matches
2266,Guido Rodríguez,ARG,MF,Betis,La Liga,28,1994,31.9,115,75,59,50,6,54,101,53.5,47,58,14,44,42,157,76,1,Matches
2267,Miguel Rodríguez,ESP,"MF,FW",Celta Vigo,La Liga,19,2003,2.8,7,5,4,3,0,4,11,36.4,7,6,0,6,1,8,3,0,Matches
2268,Pablo Rodríguez,ESP,"FW,MF",Lecce,Serie A,20,2001,0.6,2,1,2,0,0,0,2,0.0,2,3,0,3,0,2,0,0,Matches
2269,Ricardo Rodríguez,SUI,DF,Torino,Serie A,29,1992,29.7,54,33,30,17,7,28,42,66.7,14,30,15,15,38,92,61,0,Matches
2270,Rodrygo,BRA,"FW,MF",Real Madrid,La Liga,21,2001,26.4,17,10,3,7,7,4,23,17.4,19,23,0,23,8,25,5,0,Matches
2271,Mads Roerslev,DEN,DF,Brentford,Premier League,23,1999,12.3,22,12,19,3,0,16,33,48.5,17,14,5,9,9,31,38,0,Matches
2272,Agustín Rogel,URU,DF,Hertha BSC,Bundesliga,24,1997,15.8,18,9,13,5,0,11,17,64.7,6,15,8,7,11,29,74,1,Matches
2273,Rogério,BRA,DF,Sassuolo,Serie A,24,1998,33.3,37,21,22,8,7,17,35,48.6,18,32,9,23,37,74,70,0,Matches
2274,Merlin Röhl,GER,"MF,FW",Freiburg,Bundesliga,20,2002,0.6,1,0,1,0,0,0,0,,0,0,0,0,0,1,1,0,Matches
2275,Tony Rölke,GER,FW,Hertha BSC,Bundesliga,19,2003,0.2,0,0,0,0,0,0,0,,0,1,0,1,0,0,1,0,Matches
2276,Filippo Romagna,ITA,DF,Sassuolo,Serie A,25,1997,0.5,0,0,0,0,0,0,0,,0,1,1,0,0,0,2,0,Matches
2277,Alessio Romagnoli,ITA,DF,Lazio,Serie A,27,1995,32.5,33,15,19,14,0,11,22,50.0,11,33,26,7,38,71,108,0,Matches
2278,Simone Romagnoli,ITA,DF,Lecce,Serie A,32,1990,1.9,6,5,3,3,0,2,2,100.0,0,4,1,3,1,7,11,0,Matches
2279,Leo Román,ESP,GK,Mallorca,La Liga,22,2000,1.0,0,0,0,0,0,0,0,,0,0,0,0,0,0,0,0,Matches
2280,Cristian Romero,ARG,DF,Tottenham,Premier League,24,1998,26.3,68,36,42,24,2,29,46,63.0,17,40,18,22,44,112,102,3,Matches
2281,Iván Romero,ESP,MF,Sevilla,La Liga,21,2001,0.1,0,0,0,0,0,0,0,,0,0,0,0,0,0,0,0,Matches
2282,Luka Romero,ARG,FW,Lazio,Serie A,17,2004,1.7,0,0,0,0,0,0,3,0.0,3,4,0,4,3,3,1,0,Matches
2283,Oriol Romeu,ESP,MF,Southampton,Premier League,30,1991,0.8,1,0,0,1,0,0,0,,0,1,0,1,1,2,1,0,Matches
2284,Oriol Romeu,ESP,MF,Girona,La Liga,30,1991,32.8,70,38,36,26,8,26,51,51.0,25,48,10,38,37,107,54,0,Matches
2285,Cristiano Ronaldo,POR,FW,Manchester Utd,Premier League,37,1985,5.8,2,2,1,0,1,1,2,50.0,1,0,0,0,1,3,9,0,Matches
2286,Connor Ronan,IRL,MF,Wolves,Premier League,24,1998,0.0,0,0,0,0,0,0,0,,0,0,0,0,0,0,0,0,Matches
2287,Salomón Rondón,VEN,FW,Everton,Premier League,32,1989,1.2,0,0,0,0,0,0,0,,0,1,1,0,0,0,0,0,Matches
2288,Valentin Rongier,FRA,MF,Marseille,Ligue 1,27,1994,33.7,93,59,33,47,13,41,77,53.2,36,50,11,39,54,147,38,1,Matches
2289,Marten de Roon,NED,MF,Atalanta,Serie A,31,1991,32.9,77,39,37,35,5,37,81,45.7,44,37,4,33,36,113,58,0,Matches
2290,Pablo Rosario,NED,"MF,DF",Nice,Ligue 1,25,1997,19.6,46,26,22,20,4,18,34,52.9,16,15,5,10,23,69,32,1,Matches
2291,Francesco Rossi,ITA,GK,Atalanta,Serie A,31,1991,0.0,0,0,0,0,0,0,0,,0,0,0,0,0,0,0,0,Matches
2292,Tom Rothe,GER,DF,Dortmund,Bundesliga,17,2004,0.3,1,1,0,1,0,1,1,100.0,0,0,0,0,1,2,2,0,Matches
2293,Joe Rothwell,ENG,MF,Bournemouth,Premier League,27,1995,11.3,20,13,7,12,1,7,21,33.3,14,14,3,11,9,29,7,0,Matches
2294,Anthony Rouault,FRA,DF,Toulouse,Ligue 1,21,2001,36.8,66,37,54,10,2,30,58,51.7,28,52,26,26,56,122,126,4,Matches
2295,Jérôme Roussillon,FRA,"MF,DF",Wolfsburg,Bundesliga,29,1993,0.2,0,0,0,0,0,0,0,,0,0,0,0,0,0,0,0,Matches
2296,Jérôme Roussillon,FRA,DF,Union Berlin,Bundesliga,29,1993,10.6,16,9,6,8,2,8,12,66.7,4,7,2,5,4,20,22,0,Matches
2297,Nicolò Rovella,ITA,MF,Monza,Serie A,20,2001,19.3,45,29,22,21,2,13,36,36.1,23,20,1,19,40,85,17,0,Matches
2298,Nicolò Rovella,ITA,MF,Juventus,Serie A,20,2001,0.3,1,1,0,1,0,1,1,100.0,0,0,0,0,0,1,0,0,Matches
2299,Amir Rrahmani,KVX,DF,Napoli,Serie A,28,1994,27.2,33,18,20,13,0,17,26,65.4,9,36,20,16,14,47,79,1,Matches
2300,Ruan,BRA,DF,Sassuolo,Serie A,23,1999,19.0,38,26,25,12,1,19,29,65.5,10,29,17,12,24,62,80,3,Matches
2301,Rubén,ESP,"DF,MF",Espanyol,La Liga,21,2001,9.9,30,15,18,9,3,20,29,69.0,9,14,4,10,18,48,18,0,Matches
2302,Antonio Rüdiger,GER,DF,Real Madrid,La Liga,29,1993,26.8,18,16,12,5,1,14,23,60.9,9,23,13,10,19,37,74,0,Matches
2303,Sebastian Rudy,GER,MF,Hoffenheim,Bundesliga,32,1990,8.8,26,12,10,16,0,13,27,48.1,14,27,7,20,11,37,13,0,Matches
2304,Daniele Rugani,ITA,DF,Juventus,Serie A,28,1994,6.3,7,0,6,1,0,4,4,100.0,0,7,5,2,7,14,32,0,Matches
2305,Matteo Ruggeri,ITA,"DF,MF",Atalanta,Serie A,20,2002,9.2,17,12,5,9,3,8,16,50.0,8,14,3,11,12,29,16,0,Matches
2306,Mário Rui,POR,DF,Napoli,Serie A,31,1991,19.4,34,22,17,13,4,20,41,48.8,21,17,4,13,15,49,24,1,Matches
2307,Aitor Ruibal,ESP,"DF,FW",Betis,La Liga,26,1996,16.2,47,29,35,9,3,31,58,53.4,27,17,2,15,24,71,41,0,Matches
2308,Kays Ruiz Atil,FRA,MF,Auxerre,Ligue 1,19,2002,0.7,1,1,1,0,0,0,1,0.0,1,2,1,1,3,4,0,0,Matches
2309,Fabián Ruiz Peña,ESP,MF,Paris S-G,Ligue 1,26,1996,21.0,62,28,25,30,7,43,79,54.4,36,24,1,23,18,80,23,1,Matches
2310,Víctor Ruiz,ESP,DF,Betis,La Liga,33,1989,6.2,5,3,3,2,0,3,3,100.0,0,10,7,3,6,11,34,0,Matches
2311,Gerónimo Rulli,ARG,GK,Villarreal,La Liga,30,1992,14.0,0,0,0,0,0,0,0,,0,1,0,1,1,1,6,2,Matches
2312,Alessandro Russo,ITA,GK,Sassuolo,Serie A,21,2001,1.0,0,0,0,0,0,0,0,,0,0,0,0,0,0,1,1,Matches
2313,Franco Russo,ARG,DF,Mallorca,La Liga,27,1994,1.6,2,1,2,0,0,0,1,0.0,1,5,0,5,3,5,5,0,Matches
2314,Georginio Rutter,FRA,"FW,MF",Leeds United,Premier League,20,2002,3.0,10,9,5,3,2,5,8,62.5,3,5,0,5,3,13,3,0,Matches
2315,Georginio Rutter,FRA,FW,Hoffenheim,Bundesliga,20,2002,11.2,7,4,1,4,2,1,3,33.3,2,10,2,8,5,12,6,0,Matches
2316,Julian Ryerson,NOR,DF,Union Berlin,Bundesliga,24,1997,11.5,28,17,17,10,1,15,25,60.0,10,15,3,12,12,40,19,0,Matches
2317,Julian Ryerson,NOR,DF,Dortmund,Bundesliga,24,1997,15.7,27,15,17,7,3,19,37,51.4,18,13,2,11,8,35,28,0,Matches
2318,Frederik Rønnow,DEN,GK,Union Berlin,Bundesliga,29,1992,29.0,0,0,0,0,0,0,5,0.0,5,0,0,0,0,0,9,1,Matches
2319,José Sá,POR,GK,Wolves,Premier League,29,1993,36.0,1,0,1,0,0,1,1,100.0,0,0,0,0,0,1,10,6,Matches
2320,Youssouf Sabaly,SEN,DF,Betis,La Liga,29,1993,18.7,45,23,29,14,2,22,33,66.7,11,35,8,27,19,64,52,1,Matches
2321,Halid Šabanović,BIH,DF,Angers,Ligue 1,22,1999,7.1,8,6,7,1,0,6,8,75.0,2,8,2,6,8,16,12,0,Matches
2322,Abdelhamid Sabiri,MAR,"MF,FW",Sampdoria,Serie A,25,1996,11.9,18,7,5,9,4,4,13,30.8,9,18,4,14,2,20,5,0,Matches
2323,Marcel Sabitzer,AUT,MF,Manchester Utd,Premier League,28,1994,7.0,12,8,3,8,1,2,11,18.2,9,6,2,4,8,20,11,0,Matches
2324,Marcel Sabitzer,AUT,MF,Bayern Munich,Bundesliga,28,1994,7.0,27,14,11,10,6,10,17,58.8,7,3,0,3,10,37,9,0,Matches
2325,Falaye Sacko,MLI,DF,Montpellier,Ligue 1,27,1995,28.7,46,25,25,15,6,32,51,62.7,19,43,14,29,33,79,75,1,Matches
2326,Umar Sadiq,NGA,FW,Almería,La Liga,25,1997,2.7,0,0,0,0,0,0,1,0.0,1,2,0,2,0,0,3,0,Matches
2327,Umar Sadiq,NGA,FW,Real Sociedad,La Liga,25,1997,0.9,1,1,0,0,1,0,1,0.0,1,2,0,2,0,1,0,0,Matches
2328,Alexis Saelemaekers,BEL,"FW,DF",Milan,Serie A,23,1999,15.6,31,20,12,16,3,19,41,46.3,22,13,1,12,19,50,11,0,Matches
2329,Wesley Saïd,FRA,"FW,MF",Lens,Ligue 1,27,1995,7.2,4,1,1,2,1,2,6,33.3,4,4,0,4,1,5,2,0,Matches
2330,Allan Saint-Maximin,FRA,FW,Newcastle Utd,Premier League,25,1997,12.4,10,3,3,6,1,2,11,18.2,9,4,0,4,5,15,2,0,Matches
2331,Théo Sainte-Luce,FRA,DF,Montpellier,Ligue 1,23,1998,5.9,13,11,8,5,0,7,14,50.0,7,7,2,5,10,23,11,0,Matches
2332,Samuel Sáiz,ESP,MF,Girona,La Liga,31,1991,2.7,2,2,0,2,0,1,2,50.0,1,3,0,3,0,2,1,1,Matches
2333,Bukayo Saka,ENG,FW,Arsenal,Premier League,20,2001,35.3,63,34,22,15,26,20,44,45.5,24,38,0,38,14,77,19,0,Matches
2334,Hamza Sakhi,FRA,MF,Auxerre,Ligue 1,26,1996,18.4,44,22,22,17,5,22,42,52.4,20,16,1,15,25,69,9,0,Matches
2335,Mamadou Sakho,FRA,DF,Montpellier,Ligue 1,32,1990,8.5,9,5,4,5,0,3,5,60.0,2,17,12,5,8,17,35,1,Matches
2336,Jacopo Sala,ITA,MF,Spezia,Serie A,30,1991,1.2,1,0,1,0,0,0,2,0.0,2,2,0,2,1,2,2,0,Matches
2337,Ibrahim Salah,MAR,"FW,MF",Rennes,Ligue 1,20,2001,2.5,8,1,5,3,0,2,15,13.3,13,3,0,3,2,10,0,0,Matches
2338,Mohamed Salah,EGY,FW,Liverpool,Premier League,30,1992,36.6,21,12,4,5,12,10,26,38.5,16,21,0,21,6,27,4,0,Matches
2339,Amine Salama,FRA,"FW,MF",Angers,Ligue 1,22,2000,13.9,11,9,3,7,1,2,12,16.7,10,8,2,6,10,21,2,0,Matches
2340,Kike Salas,ESP,DF,Sevilla,La Liga,20,2002,4.1,1,1,1,0,0,0,0,,0,4,3,1,5,6,23,0,Matches
2341,William Saliba,FRA,DF,Arsenal,Premier League,21,2001,26.8,34,20,23,9,2,15,18,83.3,3,13,10,3,19,53,85,4,Matches
2342,Dikeni-Rafid Salifou,TOG,MF,Werder Bremen,Bundesliga,19,2003,0.0,0,0,0,0,0,0,0,,0,0,0,0,0,0,0,0,Matches
2343,Mohammed Salisu,GHA,DF,Southampton,Premier League,23,1999,21.9,52,29,34,16,2,24,34,70.6,10,56,25,31,30,82,122,1,Matches
2344,Roland Sallai,HUN,"MF,FW",Freiburg,Bundesliga,25,1997,11.1,11,8,4,3,4,4,10,40.0,6,7,1,6,2,13,11,0,Matches
2345,Yoann Salmier,GUF,DF,Troyes,Ligue 1,29,1992,29.4,51,29,34,12,5,21,35,60.0,14,34,19,15,39,90,124,0,Matches
2346,Salvi,ESP,"FW,MF",Rayo Vallecano,La Liga,31,1991,5.4,13,8,5,5,3,2,8,25.0,6,0,0,0,2,15,2,0,Matches
2347,Lazar Samardzic,SRB,MF,Udinese,Serie A,20,2002,20.5,33,16,9,20,4,17,43,39.5,26,13,0,13,11,44,16,0,Matches
2348,Diadie Samassékou,MLI,"MF,FW",Hoffenheim,Bundesliga,26,1996,0.4,1,0,0,1,0,0,1,0.0,1,0,0,0,0,1,0,0,Matches
2349,Mama Samba Baldé,GNB,FW,Troyes,Ligue 1,26,1995,29.6,46,21,14,21,11,13,28,46.4,15,30,3,27,10,56,13,0,Matches
2350,Brice Samba,FRA,GK,Lens,Ligue 1,28,1994,37.0,1,0,1,0,0,1,2,50.0,1,1,0,1,0,1,12,2,Matches
2351,Albert Sambi Lokonga,BEL,MF,Arsenal,Premier League,22,1999,2.2,1,1,0,0,1,0,2,0.0,2,1,0,1,5,6,2,0,Matches
2352,Albert Sambi Lokonga,BEL,MF,Crystal Palace,Premier League,22,1999,6.0,13,10,7,4,2,8,12,66.7,4,8,3,5,7,20,10,0,Matches
2353,Junior Sambia,FRA,DF,Salernitana,Serie A,25,1996,7.7,12,5,7,4,1,6,10,60.0,4,9,3,6,8,20,16,1,Matches
2354,Fede San Emeterio,ESP,MF,Cádiz,La Liga,25,1997,20.5,41,22,23,16,2,22,46,47.8,24,34,14,20,17,58,28,0,Matches
2355,Antonio Sanabria,PAR,FW,Torino,Serie A,26,1996,27.0,11,5,3,3,5,1,7,14.3,6,9,2,7,4,15,7,0,Matches
2356,Leandro Sanca,GNB,"FW,MF",Spezia,Serie A,22,2000,0.4,1,1,0,0,1,1,1,100.0,0,0,0,0,0,1,0,0,Matches
2357,Oihan Sancet,ESP,MF,Athletic Club,La Liga,22,2000,28.1,27,16,2,19,6,11,37,29.7,26,10,0,10,4,31,9,1,Matches
2358,Renato Sanches,POR,MF,Paris S-G,Ligue 1,24,1997,8.0,8,1,1,3,4,5,14,35.7,9,13,3,10,9,17,4,0,Matches
2359,Alexis Sánchez,CHI,"FW,MF",Marseille,Ligue 1,33,1988,29.8,27,17,5,16,6,3,24,12.5,21,14,0,14,5,32,6,0,Matches
2360,Antonio Sánchez,ESP,"MF,DF",Mallorca,La Liga,25,1997,12.0,19,8,13,4,2,10,34,29.4,24,18,0,18,22,41,14,1,Matches
2361,Davinson Sánchez,COL,DF,Tottenham,Premier League,26,1996,9.5,24,11,17,6,1,14,20,70.0,6,16,10,6,12,36,41,0,Matches
2362,Iván Sánchez,ESP,"MF,FW",Valladolid,La Liga,29,1992,12.8,20,14,8,8,4,10,27,37.0,17,14,1,13,8,28,4,0,Matches
2363,Javi Sánchez,ESP,DF,Valladolid,La Liga,25,1997,26.6,43,26,27,15,1,17,26,65.4,9,32,22,10,46,89,116,0,Matches
2364,Manu Sánchez,ESP,DF,Osasuna,La Liga,21,2000,23.6,51,35,35,9,7,33,63,52.4,30,33,5,28,14,65,51,0,Matches
2365,Robert Sánchez,ESP,GK,Brighton,Premier League,24,1997,23.0,1,0,1,0,0,0,0,,0,0,0,0,3,4,9,2,Matches
2366,Jadon Sancho,ENG,"FW,MF",Manchester Utd,Premier League,22,2000,18.7,16,10,7,5,4,8,28,28.6,20,25,2,23,7,23,6,0,Matches
2367,Alex Sandro,BRA,DF,Juventus,Serie A,31,1991,19.9,35,20,16,16,3,15,22,68.2,7,27,10,17,15,50,64,1,Matches
2368,Leroy Sané,GER,"MF,FW",Bayern Munich,Bundesliga,26,1996,22.3,38,30,11,19,8,18,36,50.0,18,11,1,10,3,41,1,2,Matches
2369,Sidi Sané,GER,FW,Schalke 04,Bundesliga,19,2003,0.3,1,1,1,0,0,1,1,100.0,0,0,0,0,0,1,0,0,Matches
2370,Morgan Sanson,FRA,MF,Aston Villa,Premier League,27,1994,0.1,2,1,1,1,0,1,1,100.0,0,0,0,0,0,2,0,0,Matches
2371,Morgan Sanson,FRA,MF,Strasbourg,Ligue 1,27,1994,15.8,36,25,10,16,10,17,56,30.4,39,21,1,20,22,58,9,0,Matches
2372,Nicola Sansone,ITA,FW,Bologna,Serie A,30,1991,8.2,12,4,6,4,2,5,10,50.0,5,0,0,0,0,12,4,0,Matches
2373,Baptiste Santamaria,FRA,MF,Rennes,Ligue 1,27,1995,20.1,41,22,13,23,5,21,41,51.2,20,21,5,16,21,62,23,0,Matches
2374,Riccardo Saponara,ITA,FW,Fiorentina,Serie A,30,1991,13.4,10,5,3,6,1,5,9,55.6,4,7,1,6,5,15,9,1,Matches
2375,Pablo Sarabia,ESP,"FW,MF",Wolves,Premier League,30,1992,8.5,12,6,4,5,3,6,15,40.0,9,7,0,7,2,14,4,0,Matches
2376,Pablo Sarabia,ESP,"FW,MF",Paris S-G,Ligue 1,30,1992,4.1,5,4,2,2,1,1,7,14.3,6,3,0,3,2,7,0,0,Matches
2377,Jeremy Sarmiento,ECU,MF,Brighton,Premier League,20,2002,2.0,6,3,4,1,1,2,5,40.0,3,2,0,2,1,7,0,0,Matches
2378,Amin Sarr,SWE,FW,Lyon,Ligue 1,21,2001,6.0,9,6,1,4,4,1,4,25.0,3,2,0,2,0,9,4,0,Matches
2379,Bouna Sarr,SEN,FW,Bayern Munich,Bundesliga,30,1992,0.0,0,0,0,0,0,0,0,,0,0,0,0,0,0,0,0,Matches
2380,Malang Sarr,FRA,DF,Monaco,Ligue 1,23,1999,8.0,6,3,5,1,0,1,5,20.0,4,11,7,4,15,21,29,2,Matches
2381,Mamadou Sarr,FRA,MF,Lyon,Ligue 1,16,2005,0.1,0,0,0,0,0,0,0,,0,0,0,0,0,0,0,0,Matches
2382,Mouhamadou Sarr,SEN,GK,Cremonese,Serie A,25,1997,2.0,0,0,0,0,0,0,0,,0,0,0,0,0,0,2,0,Matches
2383,Martin Satriano,URU,FW,Empoli,Serie A,21,2001,18.9,13,8,5,6,2,6,14,42.9,8,5,0,5,3,16,22,0,Matches
2384,Téji Savanier,FRA,MF,Montpellier,Ligue 1,30,1991,28.3,46,30,16,19,11,23,70,32.9,47,30,2,28,30,76,12,1,Matches
2385,Esteban Saveljich,MNE,FW,Rayo Vallecano,La Liga,31,1991,0.0,0,0,0,0,0,0,0,,0,0,0,0,0,0,0,0,Matches
2386,Stefan Savić,MNE,DF,Atlético Madrid,La Liga,31,1991,21.6,39,26,29,7,3,26,39,66.7,13,17,8,9,33,72,67,2,Matches
2387,Joe Scally,USA,DF,Gladbach,Bundesliga,19,2002,24.5,31,20,25,5,1,24,31,77.4,7,17,6,11,8,39,61,0,Matches
2388,Giorgio Scalvini,ITA,DF,Atalanta,Serie A,18,2003,25.9,54,29,30,18,6,29,55,52.7,26,36,13,23,56,110,57,2,Matches
2389,Gianluca Scamacca,ITA,FW,West Ham,Premier League,23,1999,10.3,10,5,1,3,6,2,2,100.0,0,3,0,3,4,14,5,0,Matches
2390,Gustavo Scarpa,BRA,"MF,FW",Nott'ham Forest,Premier League,28,1994,2.0,5,2,3,1,1,2,5,40.0,3,4,0,4,0,5,3,0,Matches
2391,Kevin Schade,GER,FW,Brentford,Premier League,20,2001,8.1,12,8,7,2,3,5,10,50.0,5,7,0,7,4,16,6,0,Matches
2392,Kevin Schade,GER,"FW,MF",Freiburg,Bundesliga,20,2001,2.0,6,4,3,2,1,3,5,60.0,2,0,0,0,0,6,2,0,Matches
2393,András Schäfer,HUN,MF,Union Berlin,Bundesliga,23,1999,9.6,21,9,7,12,2,6,14,42.9,8,12,2,10,4,25,11,0,Matches
2394,Fabian Schär,SUI,DF,Newcastle Utd,Premier League,30,1991,35.6,47,22,31,13,3,24,39,61.5,15,34,19,15,52,99,139,0,Matches
2395,Derry Scherhant,GER,"FW,MF",Hertha BSC,Bundesliga,19,2002,3.2,7,6,3,3,1,4,8,50.0,4,3,0,3,0,7,5,0,Matches
2396,Patrik Schick,CZE,FW,Leverkusen,Bundesliga,26,1996,10.5,0,0,0,0,0,0,1,0.0,1,4,1,3,1,1,7,0,Matches
2397,Kingsley Schindler,GHA,"DF,MF",Köln,Bundesliga,29,1993,12.1,23,12,13,8,2,18,28,64.3,10,14,2,12,15,38,24,0,Matches
2398,Xaver Schlager,AUT,MF,RB Leipzig,Bundesliga,24,1997,16.7,41,24,13,26,2,20,43,46.5,23,19,2,17,17,58,23,0,Matches
2399,Keven Schlotterbeck,GER,DF,Freiburg,Bundesliga,25,1997,0.2,0,0,0,0,0,0,0,,0,1,1,0,2,2,2,0,Matches
2400,Keven Schlotterbeck,GER,DF,Bochum,Bundesliga,25,1997,8.2,17,9,12,5,0,9,11,81.8,2,11,5,6,14,31,49,0,Matches
2401,Nico Schlotterbeck,GER,DF,Dortmund,Bundesliga,22,1999,25.0,59,34,34,24,1,37,53,69.8,16,38,21,17,32,91,71,1,Matches
2402,Jeffrey Schlupp,GHA,"MF,FW",Crystal Palace,Premier League,29,1992,28.1,66,46,28,29,9,22,43,51.2,21,39,8,31,23,89,38,0,Matches
2403,Kasper Schmeichel,DEN,GK,Nice,Ligue 1,35,1986,36.0,1,0,1,0,0,1,4,25.0,3,1,0,1,1,2,11,1,Matches
2404,Jonathan Schmid,FRA,DF,Freiburg,Bundesliga,32,1990,0.5,1,1,1,0,0,0,0,,0,1,0,1,1,2,1,1,Matches
2405,Romano Schmid,AUT,"MF,FW",Werder Bremen,Bundesliga,22,2000,16.9,24,15,5,13,6,10,22,45.5,12,21,3,18,7,31,12,0,Matches
2406,Kenneth Schmidt,GER,DF,Freiburg,Bundesliga,20,2002,2.8,6,3,4,2,0,5,6,83.3,1,4,2,2,0,6,2,0,Matches
2407,Niklas Schmidt,GER,MF,Werder Bremen,Bundesliga,24,1998,12.1,25,10,12,11,2,13,28,46.4,15,10,0,10,5,30,12,0,Matches
2408,Benno Schmitz,GER,DF,Köln,Bundesliga,27,1994,26.9,64,42,31,28,5,42,82,51.2,40,34,4,30,26,90,57,0,Matches
2409,Jerdy Schouten,NED,MF,Bologna,Serie A,25,1997,27.9,63,38,28,33,2,27,49,55.1,22,40,17,23,40,103,43,1,Matches
2410,Perr Schuurs,NED,DF,Torino,Serie A,22,1999,25.8,51,25,29,17,5,14,26,53.8,12,28,16,12,28,79,102,0,Matches
2411,Marvin Schwäbe,GER,GK,Köln,Bundesliga,27,1995,34.0,1,0,1,0,0,1,1,100.0,0,0,0,0,2,3,8,2,Matches
2412,Alexander Schwolow,GER,GK,Schalke 04,Bundesliga,30,1992,22.6,0,0,0,0,0,0,2,0.0,2,0,0,0,1,1,6,3,Matches
2413,Demba Seck,SEN,"MF,FW",Torino,Serie A,21,2001,5.8,5,2,3,2,0,2,3,66.7,1,3,1,2,1,6,1,0,Matches
2414,Haris Seferović,SUI,FW,Celta Vigo,La Liga,30,1992,9.9,6,3,1,4,1,3,8,37.5,5,7,1,6,1,7,6,1,Matches
2415,Telasco Segovia,VEN,MF,Sampdoria,Serie A,19,2003,0.0,0,0,0,0,0,0,0,,0,0,0,0,0,0,0,0,Matches
2416,Jacopo Segre,ITA,DF,Torino,Serie A,25,1997,0.2,0,0,0,0,0,0,0,,0,0,0,0,0,0,0,0,Matches
2417,Paul Seguin,GER,MF,Union Berlin,Bundesliga,27,1995,7.7,17,8,9,4,4,8,18,44.4,10,6,0,6,6,23,7,0,Matches
2418,Alidu Seidu,GHA,DF,Clermont Foot,Ligue 1,22,2000,27.3,52,31,35,14,3,31,51,60.8,20,28,14,14,52,104,50,2,Matches
2419,Davie Selke,GER,FW,Hertha BSC,Bundesliga,27,1995,3.1,2,1,1,1,0,0,1,0.0,1,3,1,2,1,3,5,0,Matches
2420,Davie Selke,GER,FW,Köln,Bundesliga,27,1995,9.7,0,0,0,0,0,0,4,0.0,4,4,1,3,0,0,11,0,Matches
2421,Matz Sels,BEL,GK,Strasbourg,Ligue 1,30,1992,38.0,4,3,4,0,0,4,4,100.0,0,0,0,0,4,8,23,0,Matches
2422,Nélson Semedo,POR,DF,Wolves,Premier League,28,1993,29.2,71,42,48,19,4,33,64,51.6,31,42,15,27,29,100,83,2,Matches
2423,Vivaldo Semedo,POR,"FW,MF",Udinese,Serie A,17,2005,0.4,0,0,0,0,0,0,0,,0,1,0,1,0,0,1,0,Matches
2424,Antoine Semenyo,GHA,"FW,MF",Bournemouth,Premier League,22,2000,2.9,1,0,0,0,1,1,6,16.7,5,10,1,9,2,3,4,0,Matches
2425,Marvin Senaya,TOG,DF,Strasbourg,Ligue 1,21,2001,0.1,0,0,0,0,0,0,1,0.0,1,1,0,1,0,0,1,0,Matches
2426,Marcos Senesi,ARG,DF,Bournemouth,Premier League,25,1997,27.7,50,35,28,22,0,23,44,52.3,21,38,20,18,43,93,146,2,Matches
2427,Stefano Sensi,ITA,MF,Monza,Serie A,26,1995,18.0,41,26,25,13,3,18,48,37.5,30,13,3,10,20,61,4,0,Matches
2428,Jaime Seoane,ESP,"MF,FW",Getafe,La Liga,25,1997,3.6,10,4,3,4,3,2,8,25.0,6,7,3,4,1,11,2,0,Matches
2429,Luigi Sepe,ITA,GK,Salernitana,Serie A,31,1991,17.0,0,0,0,0,0,0,1,0.0,1,0,0,0,0,0,0,0,Matches
2430,Suat Serdar,GER,MF,Hertha BSC,Bundesliga,25,1997,22.5,51,23,14,30,7,20,41,48.8,21,48,12,36,29,80,24,0,Matches
2431,Leonardo Sernicola,ITA,DF,Cremonese,Serie A,25,1997,25.7,45,33,25,13,7,29,43,67.4,14,23,6,17,38,83,55,0,Matches
2432,Ryan Sessegnon,ENG,DF,Tottenham,Premier League,22,2000,9.0,16,11,9,7,0,6,12,50.0,6,8,1,7,6,22,17,1,Matches
2433,Stephan El Shaarawy,ITA,"DF,MF",Roma,Serie A,29,1992,16.9,21,9,8,10,3,6,22,27.3,16,11,1,10,15,36,11,0,Matches
2434,Eniss Shabani,ALB,MF,Mainz 05,Bundesliga,19,2003,0.1,0,0,0,0,0,0,0,,0,0,0,0,0,0,0,0,Matches
2435,Luke Shaw,ENG,DF,Manchester Utd,Premier League,27,1995,28.4,55,36,31,22,2,32,46,69.6,14,51,17,34,36,91,55,2,Matches
2436,Jonjo Shelvey,ENG,MF,Newcastle Utd,Premier League,30,1992,0.4,1,0,1,0,0,0,1,0.0,1,1,0,1,0,1,0,0,Matches
2437,Jonjo Shelvey,ENG,MF,Nott'ham Forest,Premier League,30,1992,6.0,2,1,0,1,1,1,9,11.1,8,7,2,5,5,7,10,1,Matches
2438,Eldor Shomurodov,UZB,FW,Spezia,Serie A,27,1995,9.0,5,5,3,1,1,2,11,18.2,9,5,1,4,3,8,4,0,Matches
2439,Eldor Shomurodov,UZB,FW,Roma,Serie A,27,1995,1.3,1,0,1,0,0,0,2,0.0,2,1,0,1,1,2,0,0,Matches
2440,Kaj Sierhuis,NED,"FW,MF",Reims,Ligue 1,24,1998,2.4,3,3,1,0,2,0,5,0.0,5,3,1,2,1,4,2,0,Matches
2441,Vincent Sierro,SUI,MF,Toulouse,Ligue 1,26,1995,7.4,19,11,9,9,1,11,29,37.9,18,12,3,9,4,23,11,1,Matches
2442,Kiliann Sildillia,FRA,"DF,MF",Freiburg,Bundesliga,20,2002,22.0,33,20,10,19,4,18,30,60.0,12,24,9,15,21,54,47,1,Matches
2443,André Silva,POR,FW,RB Leipzig,Bundesliga,26,1995,19.3,12,6,2,5,5,3,8,37.5,5,11,1,10,3,15,3,0,Matches
2444,Bernardo Silva,POR,"MF,FW",Manchester City,Premier League,27,1994,24.5,44,23,11,25,8,18,45,40.0,27,23,6,17,16,60,6,0,Matches
2445,Caio Henrique Oliveira Silva,BRA,DF,Monaco,Ligue 1,25,1997,32.2,74,51,42,28,4,44,76,57.9,32,28,8,20,26,100,68,1,Matches
2446,David Silva,ESP,MF,Real Sociedad,La Liga,36,1986,21.5,36,21,11,18,7,11,19,57.9,8,17,2,15,15,51,16,0,Matches
2447,Rui Silva,POR,GK,Betis,La Liga,28,1994,26.0,4,1,4,0,0,4,4,100.0,0,0,0,0,0,4,12,1,Matches
2448,Thiago Silva,BRA,DF,Chelsea,Premier League,37,1984,26.1,41,27,24,17,0,21,31,67.7,10,38,29,9,34,75,111,3,Matches
2449,Marco Silvestri,ITA,GK,Udinese,Serie A,31,1991,38.0,2,1,2,0,0,2,3,66.7,1,0,0,0,1,3,15,1,Matches
2450,Abdallah Sima,SEN,FW,Angers,Ligue 1,21,2001,20.4,22,13,4,15,3,7,19,36.8,12,8,0,8,4,26,19,0,Matches
2451,Mohamed Simakan,FRA,DF,RB Leipzig,Bundesliga,22,2000,16.2,21,14,12,5,4,14,21,66.7,7,21,4,17,16,37,55,0,Matches
2452,Giovanni Simeone,ARG,FW,Napoli,Serie A,27,1995,4.5,12,3,3,5,4,3,8,37.5,5,2,1,1,1,13,4,0,Matches
2453,Ellis Simms,ENG,FW,Everton,Premier League,21,2001,2.5,0,0,0,0,0,0,0,,0,0,0,0,0,0,1,0,Matches
2454,Simo,ESP,DF,Espanyol,La Liga,17,2005,1.6,3,1,3,0,0,2,3,66.7,1,5,4,1,0,3,3,0,Matches
2455,Moses Simon,NGA,"FW,MF",Nantes,Ligue 1,27,1995,26.1,18,9,6,7,5,7,15,46.7,8,14,1,13,11,29,3,0,Matches
2456,Unai Simón,ESP,GK,Athletic Club,La Liga,25,1997,30.5,2,0,2,0,0,1,1,100.0,0,1,0,1,0,2,9,3,Matches
2457,Lassine Sinayoko,MLI,"MF,FW",Auxerre,Ligue 1,22,1999,17.4,33,15,14,12,7,21,40,52.5,19,12,0,12,18,51,17,0,Matches
2458,Wilfried Singo,CIV,DF,Torino,Serie A,21,2000,22.7,27,17,14,10,3,12,19,63.2,7,15,2,13,12,39,33,1,Matches
2459,Luis Sinisterra,COL,FW,Leeds United,Premier League,23,1999,9.6,21,14,8,9,4,11,18,61.1,7,11,1,10,8,29,2,0,Matches
2460,Daley Sinkgraven,NED,"DF,MF",Leverkusen,Bundesliga,27,1995,3.8,10,7,7,3,0,7,9,77.8,2,8,4,4,5,15,7,0,Matches
2461,Tobias Sippel,GER,GK,Gladbach,Bundesliga,34,1988,5.7,0,0,0,0,0,0,0,,0,0,0,0,0,0,1,1,Matches
2462,Hugo Siquet,BEL,DF,Freiburg,Bundesliga,20,2002,0.2,2,2,2,0,0,2,2,100.0,0,1,0,1,0,2,0,0,Matches
2463,Salvatore Sirigu,ITA,GK,Fiorentina,Serie A,35,1987,1.0,0,0,0,0,0,0,0,,0,0,0,0,0,0,1,0,Matches
2464,Ibrahima Sissoko,MLI,MF,Strasbourg,Ligue 1,24,1997,14.6,40,22,18,17,5,22,42,52.4,20,20,6,14,10,50,19,0,Matches
2465,Moussa Sissoko,FRA,MF,Nantes,Ligue 1,32,1989,21.3,26,16,16,7,3,12,18,66.7,6,22,5,17,16,42,17,0,Matches
2466,Tim Skarke,GER,"DF,MF",Union Berlin,Bundesliga,25,1996,0.6,1,1,0,0,1,0,0,,0,1,0,1,0,1,0,0,Matches
2467,Tim Skarke,GER,"FW,MF",Schalke 04,Bundesliga,25,1996,4.9,13,7,3,8,2,8,11,72.7,3,5,0,5,0,13,4,0,Matches
2468,Ellyes Skhiri,TUN,MF,Köln,Bundesliga,27,1995,31.7,79,44,29,42,8,26,66,39.4,40,52,12,40,56,135,48,0,Matches
2469,Oliver Skipp,ENG,MF,Tottenham,Premier League,21,2000,16.6,34,17,18,15,1,16,33,48.5,17,17,8,9,17,51,19,1,Matches
2470,Leo Skiri Østigård,NOR,DF,Napoli,Serie A,22,1999,4.7,4,1,3,1,0,1,1,100.0,0,3,3,0,6,10,18,1,Matches
2471,Łukasz Skorupski,POL,GK,Bologna,Serie A,31,1991,37.0,2,1,2,0,0,1,2,50.0,1,0,0,0,0,2,19,2,Matches
2472,Robert Skov,DEN,DF,Hoffenheim,Bundesliga,26,1996,15.0,22,11,14,7,1,10,26,38.5,16,22,8,14,8,30,20,2,Matches
2473,Milan Škriniar,SVK,DF,Inter,Serie A,27,1995,19.7,29,18,14,11,4,18,32,56.3,14,18,13,5,13,42,46,3,Matches
2474,Naatan Skyttä,FIN,MF,Toulouse,Ligue 1,20,2002,0.3,0,0,0,0,0,0,0,,0,0,0,0,1,1,0,0,Matches
2475,Islam Slimani,ALG,FW,Brest,Ligue 1,34,1988,11.0,5,3,2,2,1,0,3,0.0,3,2,0,2,1,6,11,0,Matches
2476,Chris Smalling,ENG,DF,Roma,Serie A,32,1989,31.2,26,15,16,10,0,13,21,61.9,8,51,36,15,43,69,123,0,Matches
2477,Adam Smith,ENG,DF,Bournemouth,Premier League,31,1991,32.7,49,29,27,19,3,29,60,48.3,31,30,13,17,25,74,81,1,Matches
2478,Emile Smith Rowe,ENG,"MF,FW",Arsenal,Premier League,22,2000,1.9,1,1,1,0,0,1,3,33.3,2,1,0,1,0,1,2,0,Matches
2479,Hrvoje Smolčić,CRO,DF,Eint Frankfurt,Bundesliga,21,2000,5.2,8,7,6,2,0,5,10,50.0,5,11,4,7,6,14,38,0,Matches
2480,Cédric Soares,POR,DF,Arsenal,Premier League,30,1991,0.3,0,0,0,0,0,0,1,0.0,1,1,0,1,0,0,1,0,Matches
2481,Cédric Soares,POR,DF,Fulham,Premier League,30,1991,2.2,8,5,4,3,1,3,3,100.0,0,3,1,2,1,9,5,0,Matches
2482,Danilo Soares,BRA,DF,Bochum,Bundesliga,30,1991,19.6,72,46,42,23,7,43,72,59.7,29,29,6,23,30,102,56,1,Matches
2483,Eduard Sobol,UKR,DF,Strasbourg,Ligue 1,27,1995,9.7,19,10,10,6,3,9,13,69.2,4,10,1,9,8,27,19,0,Matches
2484,Rubén Sobrino,ESP,"MF,FW",Cádiz,La Liga,30,1992,27.4,55,37,29,17,9,23,56,41.1,33,33,3,30,24,79,20,1,Matches
2485,Alex Sola,ESP,DF,Real Sociedad,La Liga,23,1999,3.9,18,9,14,3,1,7,10,70.0,3,7,2,5,7,25,10,0,Matches
2486,Dominic Solanke,ENG,"FW,MF",Bournemouth,Premier League,24,1997,31.8,15,9,8,3,4,5,22,22.7,17,26,7,19,6,21,46,0,Matches
2487,Augusto Solari,ARG,MF,Celta Vigo,La Liga,30,1992,2.9,10,6,6,3,1,3,11,27.3,8,5,0,5,4,14,3,0,Matches
2488,Ola Solbakken,NOR,"MF,FW",Roma,Serie A,23,1998,5.6,2,2,1,1,0,2,7,28.6,5,2,0,2,2,4,8,0,Matches
2489,Nikola Soldo,CRO,DF,Köln,Bundesliga,21,2001,6.6,15,9,8,7,0,7,11,63.6,4,7,6,1,7,22,28,0,Matches
2490,Carlos Soler,ESP,MF,Valencia,La Liga,25,1997,2.7,2,0,0,1,1,2,3,66.7,1,1,0,1,0,2,2,0,Matches
2491,Carlos Soler,ESP,MF,Paris S-G,Ligue 1,25,1997,13.2,20,12,6,10,4,10,19,52.6,9,12,4,8,4,24,6,0,Matches
2492,François-Joseph Sollacaro,FRA,GK,Ajaccio,Ligue 1,28,1994,6.0,0,0,0,0,0,0,0,,0,0,0,0,0,0,2,2,Matches
2493,Manor Solomon,ISR,FW,Fulham,Premier League,23,1999,6.4,20,12,12,6,2,9,16,56.3,7,8,0,8,5,25,3,0,Matches
2494,Yann Sommer,SUI,GK,Gladbach,Bundesliga,33,1988,10.0,1,0,1,0,0,1,1,100.0,0,0,0,0,0,1,8,0,Matches
2495,Yann Sommer,SUI,GK,Bayern Munich,Bundesliga,33,1988,19.0,0,0,0,0,0,0,0,,0,0,0,0,1,1,5,1,Matches
2496,Brandon Soppy,FRA,DF,Udinese,Serie A,20,2002,1.0,1,1,0,1,0,0,0,,0,4,0,4,1,2,1,0,Matches
2497,Brandon Soppy,FRA,DF,Atalanta,Serie A,20,2002,7.1,8,5,4,4,0,3,9,33.3,6,10,0,10,3,11,7,0,Matches
2498,David Soria,ESP,GK,Getafe,La Liga,29,1993,38.0,0,0,0,0,0,0,1,0.0,1,0,0,0,1,1,20,4,Matches
2499,Roberto Soriano,ITA,"FW,MF",Bologna,Serie A,31,1991,14.7,31,16,9,16,6,13,25,52.0,12,23,2,21,6,37,14,0,Matches
2500,Borna Sosa,CRO,DF,Stuttgart,Bundesliga,24,1998,21.7,27,21,18,8,1,21,32,65.6,11,20,5,15,19,46,37,0,Matches
2501,Joaquin Sosa,URU,DF,Bologna,Serie A,20,2002,7.6,6,2,5,1,0,4,18,22.2,14,5,3,2,6,12,31,0,Matches
2502,Hugo Sotelo,ESP,MF,Celta Vigo,La Liga,18,2003,0.2,0,0,0,0,0,0,0,,0,0,0,0,0,0,0,0,Matches
2503,Florian Sotoca,FRA,"MF,FW",Lens,Ligue 1,31,1990,33.9,39,19,11,17,11,15,40,37.5,25,41,2,39,29,68,51,0,Matches
2504,Riccardo Sottil,ITA,FW,Fiorentina,Serie A,23,1999,9.3,4,3,2,0,2,2,5,40.0,3,2,0,2,0,4,0,0,Matches
2505,Tomáš Souček,CZE,MF,West Ham,Premier League,27,1995,31.3,77,37,41,29,7,28,58,48.3,30,42,17,25,53,130,71,3,Matches
2506,Matìas Soulé,ARG,"MF,FW",Juventus,Serie A,19,2003,4.7,7,4,3,2,2,5,7,71.4,2,7,1,6,3,10,3,0,Matches
2507,Moussa Soumano,FRA,FW,Ajaccio,Ligue 1,17,2005,5.5,2,2,0,1,1,0,6,0.0,6,2,0,2,0,2,0,0,Matches
2508,Adama Soumaoro,FRA,DF,Bologna,Serie A,30,1992,20.7,25,17,11,12,2,5,7,71.4,2,18,13,5,15,40,75,1,Matches
2509,Boubakary Soumaré,FRA,MF,Leicester City,Premier League,23,1999,18.1,57,34,29,26,2,23,44,52.3,21,15,4,11,33,90,27,1,Matches
2510,Arnaud Souquet,FRA,"DF,FW",Montpellier,Ligue 1,30,1992,4.0,22,16,13,7,2,11,14,78.6,3,8,3,5,4,26,4,0,Matches
2511,Dyego Sousa,POR,FW,Almería,La Liga,32,1989,5.9,10,6,5,4,1,4,5,80.0,1,4,2,2,1,11,14,0,Matches
2512,Harry Souttar,AUS,DF,Leicester City,Premier League,23,1998,11.0,15,9,10,5,0,7,18,38.9,11,16,12,4,12,27,45,0,Matches
2513,Vinicius Souza,BRA,MF,Espanyol,La Liga,23,1999,27.0,99,66,41,45,13,33,59,55.9,26,31,14,17,48,147,50,1,Matches
2514,Djibril Sow,SUI,MF,Eint Frankfurt,Bundesliga,25,1997,29.4,41,25,13,25,3,22,44,50.0,22,22,4,18,28,69,23,0,Matches
2515,Çağlar Söyüncü,TUR,DF,Leicester City,Premier League,26,1996,5.9,14,9,10,4,0,7,10,70.0,3,9,8,1,7,21,30,0,Matches
2516,Kevin Spadanuda,SUI,"MF,FW",Ajaccio,Ligue 1,25,1997,11.8,29,18,15,9,5,12,33,36.4,21,18,0,18,11,40,5,0,Matches
2517,Djed Spence,ENG,"FW,DF",Tottenham,Premier League,21,2000,0.1,0,0,0,0,0,0,0,,0,0,0,0,0,0,0,0,Matches
2518,Djed Spence,ENG,DF,Rennes,Ligue 1,21,2000,6.4,14,6,8,2,4,11,18,61.1,7,10,3,7,4,18,15,0,Matches
2519,Stijn Spierings,NED,MF,Toulouse,Ligue 1,26,1996,34.7,95,67,37,49,9,43,101,42.6,58,49,11,38,53,148,44,0,Matches
2520,Leonardo Spinazzola,ITA,DF,Roma,Serie A,29,1993,18.4,15,8,7,6,2,8,23,34.8,15,13,3,10,9,24,25,0,Matches
2521,Marco Sportiello,ITA,GK,Atalanta,Serie A,30,1992,14.9,1,0,1,0,0,1,3,33.3,2,0,0,0,0,1,2,0,Matches
2522,Jack Stacey,ENG,DF,Bournemouth,Premier League,26,1996,3.3,5,4,3,1,1,2,5,40.0,3,3,1,2,5,10,15,0,Matches
2523,Anton Stach,GER,MF,Mainz 05,Bundesliga,23,1998,23.0,27,21,10,15,2,16,38,42.1,22,28,2,26,41,68,25,0,Matches
2524,Kostas Stafylidis,GRE,"DF,MF",Bochum,Bundesliga,28,1993,11.6,27,16,13,8,6,10,24,41.7,14,21,8,13,20,47,31,1,Matches
2525,Jens Stage,DEN,MF,Werder Bremen,Bundesliga,25,1996,20.6,34,17,15,18,1,10,37,27.0,27,34,11,23,16,50,37,0,Matches
2526,Veit Stange,GER,MF,Hertha BSC,Bundesliga,18,2004,0.1,1,1,1,0,0,1,1,100.0,0,0,0,0,0,1,0,0,Matches
2527,Josip Stanišić,CRO,DF,Bayern Munich,Bundesliga,22,2000,6.4,19,11,14,2,3,12,17,70.6,5,9,1,8,7,26,11,3,Matches
2528,Junior Stanislas,ENG,MF,Bournemouth,Premier League,32,1989,0.7,0,0,0,0,0,0,0,,0,2,1,1,0,0,0,0,Matches
2529,Jay Stansfield,ENG,FW,Fulham,Premier League,19,2002,1.0,0,0,0,0,0,0,2,0.0,2,4,1,3,1,1,1,0,Matches
2530,Niklas Stark,GER,DF,Werder Bremen,Bundesliga,27,1995,23.1,56,36,29,24,3,27,42,64.3,15,24,13,11,37,93,110,0,Matches
2531,Jason Steele,ENG,GK,Brighton,Premier League,31,1990,15.0,0,0,0,0,0,0,1,0.0,1,0,0,0,0,0,6,1,Matches
2532,Calvin Stengs,NED,FW,Nice,Ligue 1,23,1998,2.4,2,2,1,0,1,1,2,50.0,1,0,0,0,0,2,0,0,Matches
2533,Pascal Stenzel,GER,DF,Stuttgart,Bundesliga,26,1996,3.7,12,8,8,4,0,5,9,55.6,4,9,2,7,5,17,6,0,Matches
2534,Jack Stephens,ENG,DF,Southampton,Premier League,28,1994,0.5,2,2,2,0,0,1,1,100.0,0,1,1,0,1,3,2,0,Matches
2535,Jack Stephens,ENG,DF,Bournemouth,Premier League,28,1994,13.0,15,11,10,4,1,6,10,60.0,4,23,16,7,16,31,53,0,Matches
2536,Raheem Sterling,ENG,"FW,MF",Chelsea,Premier League,27,1994,21.0,18,10,5,4,9,8,14,57.1,6,17,0,17,2,20,5,0,Matches
2537,Angelo Stiller,GER,MF,Hoffenheim,Bundesliga,21,2001,7.8,26,12,9,13,4,8,12,66.7,4,12,2,10,10,36,14,0,Matches
2538,Lars Stindl,GER,"FW,MF",Gladbach,Bundesliga,33,1988,19.3,24,14,4,17,3,10,28,35.7,18,24,5,19,11,35,19,0,Matches
2539,Kevin Stöger,AUT,MF,Bochum,Bundesliga,28,1993,28.9,84,45,38,32,14,31,94,33.0,63,27,4,23,26,110,21,1,Matches
2540,Petar Stojanović,SVN,DF,Empoli,Serie A,26,1995,17.0,42,22,28,10,4,26,43,60.5,17,17,5,12,11,53,55,0,Matches
2541,John Stones,ENG,"DF,MF",Manchester City,Premier League,28,1994,20.5,23,13,11,8,4,7,10,70.0,3,17,10,7,9,32,40,0,Matches
2542,Jørgen Strand Larsen,NOR,FW,Celta Vigo,La Liga,22,2000,18.9,15,7,3,5,7,7,30,23.3,23,14,5,9,3,18,24,0,Matches
2543,Tony Strata,FRA,"MF,DF",Ajaccio,Ligue 1,17,2004,1.5,4,3,4,0,0,4,5,80.0,1,2,0,2,1,5,7,0,Matches
2544,Gabriel Strefezza,BRA,"FW,MF",Lecce,Serie A,25,1997,27.1,50,24,18,20,12,27,53,50.9,26,36,3,33,16,66,15,0,Matches
2545,Dávid Strelec,SVK,FW,Spezia,Serie A,21,2001,1.9,2,2,0,1,1,2,2,100.0,0,0,0,0,0,2,0,0,Matches
2546,Pascal Struijk,NED,DF,Leeds United,Premier League,22,1999,24.4,84,57,43,31,10,49,75,65.3,26,32,12,20,32,116,70,1,Matches
2547,Cristhian Stuani,URU,FW,Girona,La Liga,35,1986,12.1,13,6,2,7,4,5,14,35.7,9,10,0,10,2,15,5,0,Matches
2548,Damián Suárez,URU,"DF,MF",Getafe,La Liga,34,1988,21.6,49,33,23,19,7,26,48,54.2,22,40,0,40,15,64,36,0,Matches
2549,Denis Suárez,ESP,"MF,FW",Espanyol,La Liga,28,1994,10.5,26,20,12,12,2,13,45,28.9,32,11,1,10,5,31,4,0,Matches
2550,Mario Suárez,ESP,"MF,DF",Rayo Vallecano,La Liga,35,1987,0.1,0,0,0,0,0,0,0,,0,1,0,1,0,0,0,0,Matches
2551,Gabriel Suazo,CHI,DF,Toulouse,Ligue 1,24,1997,14.0,38,22,20,15,3,29,63,46.0,34,21,5,16,22,60,24,1,Matches
2552,Isaac Success,NGA,FW,Udinese,Serie A,26,1996,20.2,8,4,2,5,1,3,8,37.5,5,13,2,11,4,12,18,0,Matches
2553,Niklas Süle,GER,DF,Dortmund,Bundesliga,26,1995,23.5,25,19,18,3,4,14,23,60.9,9,28,19,9,17,42,53,0,Matches
2554,Ibrahim Sulemana,GHA,MF,Hellas Verona,Serie A,19,2003,7.2,19,13,10,7,2,6,12,50.0,6,8,2,6,14,33,15,0,Matches
2555,Kamaldeen Sulemana,GHA,"FW,MF",Southampton,Premier League,20,2002,10.7,15,9,4,7,4,4,14,28.6,10,16,0,16,6,21,6,0,Matches
2556,Kamaldeen Sulemana,GHA,"FW,MF",Rennes,Ligue 1,20,2002,3.6,6,3,1,4,1,1,5,20.0,4,2,0,2,4,10,2,0,Matches
2557,Crysencio Summerville,NED,FW,Leeds United,Premier League,20,2001,15.8,30,20,14,14,2,11,23,47.8,12,20,2,18,13,43,11,0,Matches
2558,Ivan Šunjić,CRO,MF,Hertha BSC,Bundesliga,25,1996,11.0,38,20,16,21,1,16,24,66.7,8,17,5,12,13,51,19,1,Matches
2559,Sam Surridge,ENG,FW,Nott'ham Forest,Premier League,24,1998,3.6,5,0,1,3,1,1,4,25.0,3,5,2,3,0,5,7,0,Matches
2560,Suso,ESP,"MF,FW",Sevilla,La Liga,28,1993,11.8,16,10,5,7,4,10,22,45.5,12,7,1,6,2,18,3,0,Matches
2561,Yuito Suzuki,JPN,"FW,MF",Strasbourg,Ligue 1,20,2001,0.4,0,0,0,0,0,0,0,,0,3,0,3,0,0,0,0,Matches
2562,Mattias Svanberg,SWE,"MF,FW",Wolfsburg,Bundesliga,23,1999,20.4,25,16,8,16,1,10,30,33.3,20,27,5,22,21,46,25,1,Matches
2563,Mile Svilar,SRB,GK,Roma,Serie A,22,1999,3.0,0,0,0,0,0,0,0,,0,0,0,0,0,0,1,0,Matches
2564,Williot Swedberg,SWE,MF,Celta Vigo,La Liga,18,2004,0.6,3,1,1,0,2,0,0,,0,2,0,2,0,3,1,0,Matches
2565,Issiaga Sylla,GUI,DF,Montpellier,Ligue 1,28,1994,14.5,28,16,19,8,1,15,31,48.4,16,19,3,16,32,60,35,0,Matches
2566,Issiaga Sylla,GUI,DF,Toulouse,Ligue 1,28,1994,15.2,28,15,14,9,5,15,34,44.1,19,15,5,10,38,66,38,0,Matches
2567,Wojciech Szczęsny,POL,GK,Juventus,Serie A,32,1990,27.5,1,0,1,0,0,0,1,0.0,1,0,0,0,0,1,7,0,Matches
2568,Dominik Szoboszlai,HUN,"MF,FW",RB Leipzig,Bundesliga,21,2000,27.2,45,28,12,20,13,17,42,40.5,25,43,2,41,17,62,27,0,Matches
2569,Alexander Sørloth,NOR,FW,Real Sociedad,La Liga,26,1995,26.5,18,9,3,6,9,7,14,50.0,7,15,1,14,2,20,26,1,Matches
2570,Alexander Sørloth,NOR,FW,RB Leipzig,Bundesliga,26,1995,0.1,0,0,0,0,0,0,0,,0,0,0,0,0,0,0,0,Matches
2571,Nicolás Tagliafico,ARG,DF,Lyon,Ligue 1,29,1992,33.2,91,53,36,41,14,50,78,64.1,28,45,11,34,57,148,47,0,Matches
2572,Jonathan Tah,GER,DF,Leverkusen,Bundesliga,26,1996,27.6,25,12,21,4,0,12,18,66.7,6,30,18,12,40,65,118,0,Matches
2573,Benjamin Tahirovic,BIH,MF,Roma,Serie A,19,2003,3.9,8,5,5,2,1,4,12,33.3,8,9,4,5,3,11,3,0,Matches
2574,Waniss Taibi,FRA,MF,Angers,Ligue 1,20,2002,2.1,9,5,4,4,1,2,4,50.0,2,1,0,1,2,11,2,0,Matches
2575,Flavien Tait,FRA,MF,Rennes,Ligue 1,29,1993,18.7,30,15,8,17,5,19,42,45.2,23,16,4,12,20,50,12,0,Matches
2576,Montassar Talbi,TUN,DF,Lorient,Ligue 1,24,1998,38.0,53,25,40,13,0,22,35,62.9,13,55,34,21,40,93,190,3,Matches
2577,Thibault Tamas,FRA,DF,Montpellier,Ligue 1,21,2001,0.1,0,0,0,0,0,0,0,,0,0,0,0,1,1,0,0,Matches
2578,Adrien Tameze,CMR,MF,Hellas Verona,Serie A,28,1994,33.7,51,30,21,26,4,28,63,44.4,35,51,14,37,37,88,55,2,Matches
2579,Japhet Tanganga,ENG,DF,Tottenham,Premier League,23,1999,1.6,3,2,3,0,0,1,5,20.0,4,1,0,1,2,5,8,0,Matches
2580,Renato Tapia,PER,"MF,DF",Celta Vigo,La Liga,27,1995,16.1,47,25,21,21,5,18,37,48.6,19,29,11,18,19,66,37,0,Matches
2581,Edmond Tapsoba,BFA,DF,Leverkusen,Bundesliga,23,1999,31.9,51,30,35,12,4,30,42,71.4,12,40,17,23,36,87,109,1,Matches
2582,Florian Tardieu,FRA,MF,Troyes,Ligue 1,30,1992,11.2,31,20,19,12,0,12,31,38.7,19,19,4,15,23,54,15,0,Matches
2583,Matt Targett,ENG,DF,Newcastle Utd,Premier League,26,1995,6.8,13,10,8,3,2,9,24,37.5,15,8,3,5,9,22,16,0,Matches
2584,James Tarkowski,ENG,DF,Everton,Premier League,29,1992,38.0,51,26,36,13,2,20,39,51.3,19,99,78,21,51,102,201,3,Matches
2585,Ciprian Tătărușanu,ROU,GK,Milan,Serie A,36,1986,16.0,0,0,0,0,0,0,0,,0,0,0,0,1,1,2,0,Matches
2586,Niklas Tauer,GER,"DF,MF",Mainz 05,Bundesliga,21,2001,1.0,2,1,2,0,0,1,3,33.3,2,2,1,1,2,4,4,0,Matches
2587,Nuno Tavares,POR,"DF,MF",Marseille,Ligue 1,22,2000,26.1,56,30,19,24,13,28,56,50.0,28,32,4,28,15,71,25,0,Matches
2588,Marcus Tavernier,ENG,"MF,FW",Bournemouth,Premier League,23,1999,19.4,33,22,19,11,3,11,33,33.3,22,25,4,21,9,42,23,0,Matches
2589,Enzo Tchato,CMR,DF,Montpellier,Ligue 1,19,2002,12.2,26,17,14,11,1,13,22,59.1,9,17,2,15,7,33,33,0,Matches
2590,Aurélien Tchouaméni,FRA,MF,Real Madrid,La Liga,22,2000,23.5,64,40,23,36,5,23,38,60.5,15,20,6,14,49,113,50,0,Matches
2591,Mathys Tel,FRA,FW,Bayern Munich,Bundesliga,17,2005,4.6,2,2,0,1,1,1,1,100.0,0,5,1,4,0,2,2,0,Matches
2592,Semir Telalovic,GER,"MF,FW",Gladbach,Bundesliga,22,1999,0.1,0,0,0,0,0,0,0,,0,0,0,0,0,0,0,0,Matches
2593,Alex Telles,BRA,DF,Sevilla,La Liga,29,1992,15.9,21,13,15,6,0,13,25,52.0,12,17,5,12,20,41,38,0,Matches
2594,Marc-André ter Stegen,GER,GK,Barcelona,La Liga,30,1992,37.2,0,0,0,0,0,0,0,,0,0,0,0,1,1,7,3,Matches
2595,Simon Terodde,GER,FW,Schalke 04,Bundesliga,34,1988,20.3,15,8,4,7,4,3,14,21.4,11,6,2,4,6,21,9,0,Matches
2596,Filippo Terracciano,ITA,"DF,MF",Hellas Verona,Serie A,19,2003,9.1,20,13,11,7,2,15,20,75.0,5,7,4,3,10,30,14,0,Matches
2597,Pietro Terracciano,ITA,GK,Fiorentina,Serie A,32,1990,29.0,2,1,2,0,0,2,3,66.7,1,0,0,0,1,3,14,0,Matches
2598,Ramón Terrats,ESP,MF,Villarreal,La Liga,21,2000,9.1,15,10,3,8,4,9,17,52.9,8,11,4,7,8,23,6,2,Matches
2599,Ramón Terrats,ESP,MF,Girona,La Liga,21,2000,2.4,4,2,1,3,0,2,6,33.3,4,6,2,4,3,7,3,1,Matches
2600,Martin Terrier,FRA,"FW,MF",Rennes,Ligue 1,25,1997,14.7,25,11,7,9,9,13,24,54.2,11,15,2,13,14,39,6,0,Matches
2601,Aleksa Terzić,SRB,DF,Fiorentina,Serie A,22,1999,10.4,16,9,9,4,3,11,21,52.4,10,13,4,9,5,21,16,0,Matches
2602,Tetê,BRA,FW,Leicester City,Premier League,22,2000,8.2,14,8,5,7,2,6,21,28.6,15,9,0,9,2,16,3,0,Matches
2603,Tetê,BRA,"FW,MF",Lyon,Ligue 1,22,2000,12.3,21,10,8,5,8,10,19,52.6,9,9,0,9,13,34,2,0,Matches
2604,Kenny Tete,NED,DF,Fulham,Premier League,26,1995,28.5,83,46,41,29,13,38,51,74.5,13,48,17,31,52,135,81,1,Matches
2605,Florian Thauvin,FRA,"FW,MF",Udinese,Serie A,29,1993,6.1,2,1,0,2,0,2,13,15.4,11,5,0,5,2,4,2,0,Matches
2606,Arthur Theate,BEL,DF,Rennes,Ligue 1,22,2000,34.7,29,19,17,8,4,17,30,56.7,13,26,14,12,30,59,114,3,Matches
2607,Malick Thiaw,GER,DF,Milan,Serie A,20,2001,15.1,31,26,22,9,0,11,20,55.0,9,11,5,6,12,43,65,1,Matches
2608,Malick Thiaw,GER,DF,Schalke 04,Bundesliga,20,2001,3.0,3,1,2,1,0,1,2,50.0,1,4,3,1,9,12,24,1,Matches
2609,Jan Thielmann,GER,FW,Köln,Bundesliga,20,2002,9.7,9,8,3,4,2,2,11,18.2,9,16,3,13,9,18,7,0,Matches
2610,Sada Thioub,SEN,"DF,FW",Angers,Ligue 1,27,1995,11.8,19,10,9,8,2,8,17,47.1,9,13,0,13,7,26,5,1,Matches
2611,Luke Thomas,ENG,DF,Leicester City,Premier League,21,2001,11.9,23,19,15,5,3,15,32,46.9,17,20,4,16,27,50,35,0,Matches
2612,Adrien Thomasson,FRA,MF,Strasbourg,Ligue 1,28,1993,10.4,19,9,8,6,5,9,30,30.0,21,18,0,18,3,22,2,0,Matches
2613,Adrien Thomasson,FRA,"MF,FW",Lens,Ligue 1,28,1993,14.2,24,17,8,11,5,12,45,26.7,33,25,2,23,4,28,17,0,Matches
2614,Morten Thorsby,NOR,MF,Union Berlin,Bundesliga,26,1996,9.3,22,10,9,11,2,13,21,61.9,8,11,5,6,3,25,20,0,Matches
2615,Kristian Thorstvedt,NOR,MF,Sassuolo,Serie A,23,1999,12.6,16,7,4,9,3,6,17,35.3,11,19,5,14,14,30,13,0,Matches
2616,Khéphren Thuram,FRA,MF,Nice,Ligue 1,21,2001,28.3,51,25,22,23,6,19,43,44.2,24,33,13,20,38,89,34,0,Matches
2617,Marcus Thuram,FRA,FW,Gladbach,Bundesliga,24,1997,27.9,14,7,3,6,5,6,13,46.2,7,20,3,17,6,20,22,0,Matches
2618,Alexis Tibidi,FRA,"FW,MF",Troyes,Ligue 1,18,2003,0.8,1,1,1,0,0,0,0,,0,0,0,0,0,1,0,0,Matches
2619,Youri Tielemans,BEL,MF,Leicester City,Premier League,25,1997,26.0,66,39,27,30,9,23,62,37.1,39,35,8,27,28,94,24,1,Matches
2620,Kieran Tierney,SCO,DF,Arsenal,Premier League,25,1997,8.8,20,11,9,9,2,12,16,75.0,4,8,2,6,11,31,25,0,Matches
2621,Steffen Tigges,GER,FW,Köln,Bundesliga,24,1998,17.7,12,7,1,8,3,4,14,28.6,10,13,2,11,8,20,17,0,Matches
2622,Jean-Clair Todibo,FRA,DF,Nice,Ligue 1,22,1999,31.9,76,48,54,19,3,41,56,73.2,15,41,19,22,41,117,110,2,Matches
2623,Harry Toffolo,ENG,DF,Nott'ham Forest,Premier League,26,1995,10.4,17,8,10,4,3,10,14,71.4,4,16,8,8,10,27,33,0,Matches
2624,Umut Tohumcu,GER,"MF,DF",Hoffenheim,Bundesliga,17,2004,3.0,10,5,4,5,1,3,9,33.3,6,4,0,4,2,12,8,0,Matches
2625,Karl Toko Ekambi,CMR,"FW,MF",Rennes,Ligue 1,29,1992,10.8,3,1,1,1,1,3,9,33.3,6,5,0,5,9,12,3,0,Matches
2626,Karl Toko Ekambi,CMR,"FW,MF",Lyon,Ligue 1,29,1992,15.0,9,9,2,4,3,4,15,26.7,11,12,2,10,9,18,6,0,Matches
2627,Corentin Tolisso,FRA,MF,Lyon,Ligue 1,27,1994,22.6,44,27,16,23,5,25,66,37.9,41,25,5,20,24,68,23,1,Matches
2628,Jeremy Toljan,GER,DF,Sassuolo,Serie A,27,1994,29.7,36,23,17,14,5,22,33,66.7,11,31,14,17,18,54,60,1,Matches
2629,Rafael Tolói,ITA,DF,Atalanta,Serie A,31,1990,30.9,69,44,37,32,0,35,64,54.7,29,42,18,24,57,126,88,1,Matches
2630,Raúl de Tomás,ESP,FW,Rayo Vallecano,La Liga,27,1994,8.9,3,2,0,1,2,2,6,33.3,4,4,0,4,0,3,6,0,Matches
2631,Tiago Tomás,POR,"FW,MF",Stuttgart,Bundesliga,20,2002,14.3,10,4,2,4,4,8,13,61.5,5,9,2,7,1,11,5,0,Matches
2632,Takehiro Tomiyasu,JPN,DF,Arsenal,Premier League,23,1998,7.4,27,18,12,10,5,13,18,72.2,5,7,0,7,14,41,15,1,Matches
2633,James Tomkins,ENG,DF,Crystal Palace,Premier League,33,1989,3.8,4,2,2,1,1,1,3,33.3,2,3,2,1,5,9,19,0,Matches
2634,Fikayo Tomori,ENG,DF,Milan,Serie A,24,1997,30.7,70,34,44,25,1,22,34,64.7,12,46,25,21,29,99,88,1,Matches
2635,Sandro Tonali,ITA,MF,Milan,Serie A,22,2000,30.1,64,41,35,24,5,27,44,61.4,17,34,9,25,25,89,26,1,Matches
2636,Lorenzo Tonelli,ITA,DF,Empoli,Serie A,32,1990,0.2,0,0,0,0,0,0,1,0.0,1,0,0,0,0,0,0,0,Matches
2637,Ivan Toney,ENG,FW,Brentford,Premier League,26,1996,32.8,23,13,4,9,10,7,23,30.4,16,24,9,15,14,37,36,0,Matches
2638,Pablo Torre,ESP,"FW,MF",Barcelona,La Liga,19,2003,1.6,2,1,0,1,1,2,4,50.0,2,1,0,1,2,4,1,0,Matches
2639,David Torres,ESP,DF,Valladolid,La Liga,19,2003,4.3,1,1,0,1,0,1,1,100.0,0,4,2,2,3,4,8,0,Matches
2640,Ferrán Torres,ESP,"FW,MF",Barcelona,La Liga,22,2000,15.5,13,7,4,5,4,5,20,25.0,15,11,2,9,3,16,5,0,Matches
2641,Óliver Torres,ESP,"MF,FW",Sevilla,La Liga,27,1994,23.7,39,23,12,13,14,18,59,30.5,41,26,5,21,10,49,10,0,Matches
2642,Pau Torres,ESP,DF,Villarreal,La Liga,25,1997,33.9,43,25,25,13,5,23,36,63.9,13,36,27,9,13,56,146,3,Matches
2643,Roberto Torres,ESP,"FW,MF",Osasuna,La Liga,33,1989,0.1,0,0,0,0,0,0,0,,0,0,0,0,0,0,0,0,Matches
2644,Lucas Torró,ESP,MF,Osasuna,La Liga,28,1994,27.5,48,32,28,15,5,18,42,42.9,24,24,3,21,42,90,64,1,Matches
2645,Nabil Touaizi,MAR,MF,Espanyol,La Liga,21,2001,0.0,0,0,0,0,0,0,0,,0,0,0,0,0,0,0,0,Matches
2646,Almamy Touré,MLI,DF,Eint Frankfurt,Bundesliga,26,1996,4.4,13,7,7,5,1,5,9,55.6,4,9,2,7,10,23,8,0,Matches
2647,Birama Touré,MLI,MF,Auxerre,Ligue 1,30,1992,37.8,80,47,35,35,10,34,93,36.6,59,54,9,45,67,147,49,0,Matches
2648,Mohamed Toure,AUS,"FW,MF",Reims,Ligue 1,18,2004,0.3,0,0,0,0,0,0,0,,0,0,0,0,0,0,0,0,Matches
2649,Souleymane Touré,FRA,DF,Marseille,Ligue 1,19,2003,0.8,2,1,1,1,0,1,2,50.0,1,1,0,1,0,2,5,0,Matches
2650,Souleymane Touré,FRA,DF,Auxerre,Ligue 1,19,2003,17.6,29,13,19,9,1,16,20,80.0,4,32,12,20,26,55,56,1,Matches
2651,Lucas Tousart,FRA,MF,Hertha BSC,Bundesliga,25,1997,32.7,73,38,35,28,10,27,60,45.0,33,42,6,36,48,121,75,1,Matches
2652,Yoann Touzghar,TUN,FW,Ajaccio,Ligue 1,35,1986,5.0,3,2,0,2,1,0,1,0.0,1,0,0,0,0,3,1,0,Matches
2653,Adama Traoré,ESP,"FW,MF",Wolves,Premier League,26,1996,16.6,14,7,7,4,3,4,9,44.4,5,8,1,7,3,17,17,0,Matches
2654,Bertrand Traoré,BFA,"FW,MF",Aston Villa,Premier League,26,1995,2.6,1,1,1,0,0,1,4,25.0,3,5,0,5,2,3,0,0,Matches
2655,Boubacar Traoré,MLI,MF,Wolves,Premier League,20,2001,4.6,12,5,4,5,3,3,7,42.9,4,4,2,2,7,19,1,0,Matches
2656,Charles Traore,MLI,DF,Nantes,Ligue 1,30,1992,5.4,8,5,5,2,1,5,7,71.4,2,9,2,7,10,18,12,0,Matches
2657,Hamari Traoré,MLI,DF,Rennes,Ligue 1,30,1992,28.1,48,32,26,15,7,28,52,53.8,24,33,7,26,38,86,64,0,Matches
2658,Kevin Trapp,GER,GK,Eint Frankfurt,Bundesliga,32,1990,33.0,1,1,1,0,0,0,2,0.0,2,2,0,2,0,1,10,0,Matches
2659,Mark Travers,IRL,GK,Bournemouth,Premier League,23,1999,11.5,0,0,0,0,0,0,0,,0,1,0,1,0,0,6,0,Matches
2660,Óscar Trejo,ARG,"MF,FW",Rayo Vallecano,La Liga,34,1988,23.8,48,32,12,23,13,9,44,20.5,35,31,3,28,8,56,8,1,Matches
2661,Manu Trigueros,ESP,MF,Villarreal,La Liga,30,1991,9.2,20,14,9,5,6,9,22,40.9,13,9,2,7,5,25,4,0,Matches
2662,Christopher Trimmel,AUT,DF,Union Berlin,Bundesliga,35,1987,20.1,31,16,16,12,3,20,31,64.5,11,14,1,13,25,56,48,0,Matches
2663,Théo Trinker,FRA,MF,Nice,Ligue 1,21,2001,0.0,0,0,0,0,0,0,0,,0,0,0,0,0,0,0,0,Matches
2664,Kieran Trippier,ENG,DF,Newcastle Utd,Premier League,31,1990,37.1,71,49,36,27,8,46,90,51.1,44,45,15,30,43,114,84,2,Matches
2665,William Troost-Ekong,NGA,DF,Salernitana,Serie A,28,1993,4.9,11,3,7,4,0,6,7,85.7,1,7,4,3,6,17,10,0,Matches
2666,Leandro Trossard,BEL,FW,Arsenal,Premier League,27,1994,10.3,12,7,4,2,6,6,18,33.3,12,18,0,18,6,18,3,1,Matches
2667,Leandro Trossard,BEL,"FW,MF",Brighton,Premier League,27,1994,14.6,10,6,7,1,2,1,8,12.5,7,17,0,17,6,16,1,0,Matches
2668,Adrien Truffert,FRA,DF,Rennes,Ligue 1,20,2001,21.7,62,32,36,17,9,31,46,67.4,15,32,8,24,22,84,55,0,Matches
2669,Frank Tsadjout,ITA,FW,Cremonese,Serie A,23,1999,11.7,10,8,3,6,1,3,9,33.3,6,7,1,6,8,18,9,0,Matches
2670,Kostas Tsimikas,GRE,DF,Liverpool,Premier League,26,1996,8.6,14,9,10,2,2,10,16,62.5,6,8,1,7,12,26,15,0,Matches
2671,Theocharis Tsingaras,GRE,MF,Toulouse,Ligue 1,21,2000,0.1,0,0,0,0,0,0,0,,0,0,0,0,0,0,0,0,Matches
2672,Viktor Tsyhankov,UKR,MF,Girona,La Liga,24,1997,16.5,8,8,5,1,2,1,14,7.1,13,13,2,11,7,15,12,0,Matches
2673,Alessandro Tuia,ITA,DF,Lecce,Serie A,32,1990,5.7,10,6,6,4,0,3,9,33.3,6,3,1,2,15,25,29,0,Matches
2674,Martin Turk,SVN,GK,Sampdoria,Serie A,18,2003,4.0,0,0,0,0,0,0,0,,0,0,0,0,0,0,1,0,Matches
2675,Beñat Turrientes,ESP,"MF,FW",Real Sociedad,La Liga,20,2002,1.2,3,3,3,0,0,1,5,20.0,4,2,0,2,0,3,3,0,Matches
2676,Tuta,BRA,DF,Eint Frankfurt,Bundesliga,23,1999,30.2,53,35,27,19,7,33,57,57.9,24,47,14,33,49,102,134,2,Matches
2677,Destiny Udogie,ITA,DF,Udinese,Serie A,19,2002,30.0,71,45,42,24,5,34,59,57.6,25,34,6,28,36,107,25,0,Matches
2678,Ike Ugbo,CAN,"FW,MF",Troyes,Ligue 1,23,1998,9.9,5,2,2,2,1,3,11,27.3,8,8,2,6,2,7,4,0,Matches
2679,Lesley Ugochukwu,FRA,MF,Rennes,Ligue 1,18,2004,14.8,36,19,13,20,3,16,24,66.7,8,24,10,14,21,57,16,0,Matches
2680,Samir Ujkani,KVX,GK,Empoli,Serie A,34,1988,0.1,0,0,0,0,0,0,0,,0,0,0,0,0,0,0,0,Matches
2681,Sven Ulreich,GER,GK,Bayern Munich,Bundesliga,33,1988,3.0,1,1,1,0,0,1,1,100.0,0,0,0,0,0,1,0,1,Matches
2682,Lauren Ulrich,GER,MF,Stuttgart,Bundesliga,17,2005,0.1,1,1,0,0,1,0,0,,0,0,0,0,0,1,0,0,Matches
2683,Samuel Umtiti,FRA,DF,Lecce,Serie A,28,1993,23.5,52,34,25,25,2,18,26,69.2,8,26,14,12,26,78,79,0,Matches
2684,Enes Ünal,TUR,FW,Getafe,La Liga,25,1997,33.0,26,14,5,19,2,7,25,28.0,18,19,2,17,6,32,35,0,Matches
2685,Deniz Undav,GER,"FW,MF",Brighton,Premier League,26,1996,7.0,7,4,2,2,3,2,8,25.0,6,4,1,3,0,7,1,0,Matches
2686,Cengiz Ünder,TUR,"MF,DF",Marseille,Ligue 1,25,1997,27.7,37,19,15,13,9,13,34,38.2,21,18,2,16,18,55,13,0,Matches
2687,Dayot Upamecano,FRA,DF,Bayern Munich,Bundesliga,23,1998,26.1,65,37,43,22,0,28,45,62.2,17,26,6,20,27,92,71,4,Matches
2688,Filip Uremović,CRO,DF,Hertha BSC,Bundesliga,25,1997,19.2,38,23,29,8,1,14,22,63.6,8,18,13,5,36,74,88,2,Matches
2689,Oscar Ureña,DOM,MF,Girona,La Liga,19,2003,1.1,4,2,2,2,0,2,3,66.7,1,2,0,2,1,5,0,0,Matches
2690,Jere Uronen,FIN,DF,Brest,Ligue 1,28,1994,3.3,8,5,4,4,0,7,12,58.3,5,6,2,4,7,15,5,0,Matches
2691,Jere Uronen,FIN,DF,Schalke 04,Bundesliga,28,1994,7.5,14,10,6,6,2,6,10,60.0,4,5,2,3,8,22,13,0,Matches
2692,Mark Uth,GER,"MF,FW",Köln,Bundesliga,30,1991,0.5,0,0,0,0,0,0,0,,0,0,0,0,0,0,0,0,Matches
2693,Josha Vagnoman,GER,DF,Stuttgart,Bundesliga,21,2000,16.4,26,15,12,11,3,15,27,55.6,12,20,2,18,8,34,29,1,Matches
2694,Diego Valencia,CHI,"MF,FW",Salernitana,Serie A,22,2000,2.6,8,5,4,2,2,2,9,22.2,7,10,1,9,1,9,2,0,Matches
2695,Óscar Valentín,ESP,MF,Rayo Vallecano,La Liga,27,1994,28.4,92,51,29,50,13,46,121,38.0,75,60,9,51,44,136,30,0,Matches
2696,Emanuele Valeri,ITA,DF,Cremonese,Serie A,23,1998,30.9,54,27,29,21,4,29,69,42.0,40,17,3,14,22,76,44,1,Matches
2697,Yan Valery,TUN,DF,Southampton,Premier League,23,1999,0.5,0,0,0,0,0,0,0,,0,1,0,1,0,0,3,0,Matches
2698,Yan Valery,TUN,DF,Angers,Ligue 1,23,1999,27.7,54,39,28,20,6,20,37,54.1,17,35,15,20,34,88,82,0,Matches
2699,Martin Valjent,SVK,DF,Mallorca,La Liga,26,1995,29.5,35,27,22,12,1,19,28,67.9,9,39,21,18,29,64,137,0,Matches
2700,Jesús Vallejo,ESP,DF,Real Madrid,La Liga,25,1997,0.2,0,0,0,0,0,0,0,,0,0,0,0,0,0,0,0,Matches
2701,Manu Vallejo,ESP,"FW,MF",Girona,La Liga,25,1997,2.3,4,1,1,2,1,1,6,16.7,5,2,0,2,1,5,3,0,Matches
2702,Mattia Valoti,ITA,"MF,FW",Monza,Serie A,28,1993,5.0,17,10,7,9,1,5,16,31.3,11,13,3,10,3,20,6,0,Matches
2703,Federico Valverde,URU,"MF,FW",Real Madrid,La Liga,24,1998,27.8,31,20,14,11,6,13,26,50.0,13,31,4,27,17,48,15,0,Matches
2704,Virgil van Dijk,NED,DF,Liverpool,Premier League,31,1991,31.5,27,14,13,11,3,8,19,42.1,11,24,16,8,31,58,138,3,Matches
2705,Vanderson,BRA,"DF,MF",Monaco,Ligue 1,21,2001,24.6,84,48,36,34,14,44,75,58.7,31,36,9,27,48,132,36,1,Matches
2706,Raphaël Varane,FRA,DF,Manchester Utd,Premier League,29,1993,21.2,24,9,18,6,0,7,17,41.2,10,24,17,7,11,35,91,0,Matches
2707,Jamie Vardy,ENG,FW,Leicester City,Premier League,35,1987,20.6,9,5,4,2,3,1,8,12.5,7,17,3,14,2,11,30,0,Matches
2708,Ruben Vargas,SUI,"MF,FW",Augsburg,Bundesliga,23,1998,12.6,15,7,6,7,2,5,11,45.5,6,8,2,6,6,21,16,1,Matches
2709,Johan Vásquez,MEX,DF,Cremonese,Serie A,23,1998,20.1,41,26,34,7,0,18,39,46.2,21,27,20,7,45,86,93,1,Matches
2710,Jesus Vazquez,ESP,"DF,MF",Valencia,La Liga,19,2003,3.4,13,8,9,1,3,6,11,54.5,5,4,0,4,1,14,8,0,Matches
2711,Kevin Vázquez,ESP,"DF,MF",Celta Vigo,La Liga,29,1993,4.9,13,8,5,7,1,8,12,66.7,4,4,1,3,2,15,8,0,Matches
2712,Lucas Vázquez,ESP,DF,Real Madrid,La Liga,31,1991,12.7,34,23,22,10,2,20,28,71.4,8,10,0,10,7,41,13,0,Matches
2713,Matías Vecino,URU,MF,Lazio,Serie A,30,1991,18.8,47,27,13,23,11,23,48,47.9,25,33,10,23,16,63,39,1,Matches
2714,Gabriel Veiga,ESP,MF,Celta Vigo,La Liga,20,2002,25.5,43,19,14,25,4,16,52,30.8,36,30,3,27,21,64,6,0,Matches
2715,Renato Veiga,POR,DF,Augsburg,Bundesliga,19,2003,7.1,9,6,4,3,2,7,9,77.8,2,20,6,14,7,16,29,1,Matches
2716,Miloš Veljković,SRB,DF,Werder Bremen,Bundesliga,26,1995,25.2,30,19,17,13,0,18,29,62.1,11,32,16,16,33,63,103,0,Matches
2717,Miguel Veloso,POR,MF,Hellas Verona,Serie A,36,1986,12.9,33,10,20,12,1,16,26,61.5,10,26,6,20,6,39,14,0,Matches
2718,Joël Veltman,NED,DF,Brighton,Premier League,30,1992,24.3,62,32,44,14,4,37,57,64.9,20,27,8,19,19,81,51,0,Matches
2719,Micky van de Ven,NED,DF,Wolfsburg,Bundesliga,21,2001,33.0,45,30,26,18,1,28,39,71.8,11,42,24,18,26,71,108,2,Matches
2720,Unai Vencedor Paris,ESP,MF,Athletic Club,La Liga,21,2000,2.1,3,1,0,3,0,1,6,16.7,5,5,0,5,1,4,1,0,Matches
2721,Lorenzo Venuti,ITA,DF,Fiorentina,Serie A,27,1995,10.3,18,7,6,11,1,11,18,61.1,7,7,2,5,5,23,17,2,Matches
2722,Daniele Verde,ITA,"FW,MF",Spezia,Serie A,26,1996,11.1,4,4,3,0,1,3,7,42.9,4,6,0,6,8,12,4,0,Matches
2723,Simone Verdi,ITA,"MF,FW",Hellas Verona,Serie A,30,1992,12.2,15,10,7,5,3,6,17,35.3,11,8,1,7,0,15,2,0,Matches
2724,Gonzalo Verdú,ESP,DF,Elche,La Liga,33,1988,7.8,10,5,8,2,0,4,8,50.0,4,8,6,2,10,20,33,0,Matches
2725,Jordan Veretout,FRA,MF,Marseille,Ligue 1,29,1993,31.8,56,35,17,32,7,25,53,47.2,28,22,7,15,36,92,40,2,Matches
2726,Marco Verratti,ITA,MF,Paris S-G,Ligue 1,29,1992,24.4,76,49,34,36,6,38,89,42.7,51,42,6,36,27,103,11,3,Matches
2727,Valerio Verre,ITA,MF,Sampdoria,Serie A,28,1994,7.5,14,7,6,5,3,8,17,47.1,9,9,1,8,9,23,3,0,Matches
2728,Mikel Vesga,ESP,MF,Athletic Club,La Liga,29,1993,28.6,57,35,21,31,5,25,68,36.8,43,39,8,31,36,93,39,3,Matches
2729,Guglielmo Vicario,ITA,GK,Empoli,Serie A,25,1996,30.9,1,1,1,0,0,1,2,50.0,1,0,0,0,0,1,15,2,Matches
2730,João Victor,BRA,DF,Nantes,Ligue 1,24,1998,9.4,19,11,9,7,3,12,22,54.5,10,11,1,10,15,34,30,0,Matches
2731,Aleix Vidal,ESP,"MF,FW",Espanyol,La Liga,32,1989,11.4,11,5,6,3,2,4,22,18.2,18,21,2,19,15,26,14,0,Matches
2732,Clément Vidal,FRA,"DF,MF",Ajaccio,Ligue 1,22,2000,21.1,25,15,14,11,0,18,38,47.4,20,27,16,11,27,52,73,1,Matches
2733,Nacho Vidal,ESP,DF,Osasuna,La Liga,27,1995,13.9,27,14,16,6,5,17,32,53.1,15,17,4,13,19,46,33,1,Matches
2734,Gabriel Vidovic,CRO,FW,Bayern Munich,Bundesliga,18,2003,0.2,0,0,0,0,0,0,0,,0,0,0,0,0,0,0,0,Matches
2735,Fabio Vieira,POR,"MF,FW",Arsenal,Premier League,22,2000,5.7,6,4,3,0,3,3,5,60.0,2,5,0,5,4,10,2,0,Matches
2736,Ronaldo Vieira,ENG,MF,Torino,Serie A,24,1998,0.2,1,0,0,1,0,1,1,100.0,0,0,0,0,0,1,2,0,Matches
2737,Ronaldo Vieira,ENG,MF,Sampdoria,Serie A,24,1998,9.1,18,10,4,12,2,10,13,76.9,3,15,5,10,13,31,10,2,Matches
2738,Emanuel Vignato,ITA,"MF,FW",Bologna,Serie A,21,2000,2.7,4,4,2,2,0,2,4,50.0,2,2,0,2,3,7,0,0,Matches
2739,Emanuel Vignato,ITA,"MF,FW",Empoli,Serie A,21,2000,0.6,2,0,2,0,0,0,0,,0,0,0,0,0,2,1,0,Matches
2740,Samuele Vignato,ITA,"MF,FW",Monza,Serie A,18,2004,0.7,0,0,0,0,0,0,0,,0,1,0,1,0,0,0,0,Matches
2741,Tonny Vilhena,NED,MF,Salernitana,Serie A,27,1995,25.2,44,22,16,23,5,20,50,40.0,30,17,7,10,18,62,21,0,Matches
2742,Toni Villa,ESP,MF,Valladolid,La Liga,27,1995,1.0,6,3,2,3,1,4,9,44.4,5,0,0,0,0,6,0,0,Matches
2743,Toni Villa,ESP,"MF,FW",Girona,La Liga,27,1995,9.9,25,18,9,11,5,10,23,43.5,13,8,0,8,8,33,3,0,Matches
2744,Asier Villalibre,ESP,FW,Athletic Club,La Liga,24,1997,1.1,0,0,0,0,0,0,0,,0,0,0,0,0,0,1,0,Matches
2745,Gonzalo Villar,ESP,MF,Sampdoria,Serie A,24,1998,7.7,13,7,4,8,1,7,15,46.7,8,11,3,8,4,17,9,1,Matches
2746,Gonzalo Villar,ESP,MF,Getafe,La Liga,24,1998,5.1,10,5,1,6,3,6,14,42.9,8,9,2,7,6,16,5,0,Matches
2747,Iván Villar,ESP,GK,Celta Vigo,La Liga,25,1997,19.0,0,0,0,0,0,0,1,0.0,1,0,0,0,0,0,7,0,Matches
2748,Matías Viña,URU,DF,Bournemouth,Premier League,24,1997,5.1,19,11,9,8,2,14,30,46.7,16,13,1,12,4,23,22,0,Matches
2749,Matías Viña,URU,DF,Roma,Serie A,24,1997,0.6,3,1,1,1,1,1,3,33.3,2,5,1,4,2,5,5,0,Matches
2750,Rúben Vinagre,POR,"DF,MF",Everton,Premier League,23,1999,0.3,2,2,1,1,0,1,2,50.0,1,0,0,0,0,2,1,0,Matches
2751,Carlos Vinícius,BRA,FW,Fulham,Premier League,27,1995,12.3,4,1,0,2,2,0,4,0.0,4,7,0,7,0,4,10,0,Matches
2752,Alan Virginius,FRA,FW,Lille,Ligue 1,19,2003,2.9,3,2,1,1,1,0,4,0.0,4,0,0,0,2,5,1,0,Matches
2753,Mattia Viti,ITA,DF,Nice,Ligue 1,20,2002,7.0,4,2,1,1,2,2,5,40.0,3,9,3,6,8,12,22,0,Matches
2754,Vitinha,POR,FW,Marseille,Ligue 1,22,2000,5.2,15,7,0,6,9,3,11,27.3,8,3,0,3,2,17,6,0,Matches
2755,Vitinha,POR,MF,Paris S-G,Ligue 1,22,2000,27.2,58,25,21,27,10,27,83,32.5,56,27,4,23,25,83,15,0,Matches
2756,Daniel Vivian,ESP,DF,Athletic Club,La Liga,23,1999,26.4,57,32,36,16,5,36,45,80.0,9,27,14,13,24,81,90,3,Matches
2757,Dušan Vlahović,SRB,FW,Juventus,Serie A,22,2000,21.4,11,6,0,7,4,4,10,40.0,6,10,3,7,3,14,8,1,Matches
2758,Nikola Vlašić,CRO,"MF,FW",Torino,Serie A,24,1997,30.3,32,21,9,16,7,15,34,44.1,19,25,2,23,10,42,14,0,Matches
2759,Joel Voelkerling Persson,SWE,"FW,MF",Lecce,Serie A,19,2003,1.1,1,1,0,0,1,0,1,0.0,1,1,0,1,0,1,0,0,Matches
2760,Kevin Vogt,GER,DF,Hoffenheim,Bundesliga,30,1991,19.7,15,10,10,5,0,9,22,40.9,13,18,11,7,26,41,67,0,Matches
2761,Mërgim Vojvoda,KVX,DF,Torino,Serie A,27,1995,19.1,22,12,15,6,1,12,24,50.0,12,14,2,12,10,32,31,1,Matches
2762,Kevin Volland,GER,"FW,MF",Monaco,Ligue 1,30,1992,7.1,8,4,1,5,2,2,8,25.0,6,8,0,8,2,10,0,0,Matches
2763,Cristian Volpato,ITA,MF,Roma,Serie A,18,2003,2.5,3,2,1,1,1,0,2,0.0,2,2,0,2,2,5,0,0,Matches
2764,Lukáš Vorlický,CZE,"MF,FW",Atalanta,Serie A,20,2002,0.3,0,0,0,0,0,0,0,,0,0,0,0,1,1,0,0,Matches
2765,Aster Vranckx,BEL,MF,Milan,Serie A,19,2002,2.7,3,2,0,2,1,2,7,28.6,5,3,1,2,2,5,1,0,Matches
2766,Aster Vranckx,BEL,MF,Wolfsburg,Bundesliga,19,2002,0.1,0,0,0,0,0,0,0,,0,0,0,0,0,0,1,0,Matches
2767,Stefan de Vrij,NED,DF,Inter,Serie A,30,1992,21.6,28,18,19,9,0,8,14,57.1,6,18,10,8,40,68,80,0,Matches
2768,Robert Wagner,GER,MF,Freiburg,Bundesliga,19,2003,0.4,0,0,0,0,0,0,0,,0,2,0,2,0,0,2,0,Matches
2769,Elye Wahi,FRA,FW,Montpellier,Ligue 1,19,2003,27.9,9,3,2,3,4,5,14,35.7,9,14,2,12,3,12,5,0,Matches
2770,Walace,BRA,MF,Udinese,Serie A,27,1995,35.4,82,39,42,31,9,41,90,45.6,49,47,12,35,51,133,51,1,Matches
2771,Theo Walcott,ENG,"FW,MF",Southampton,Premier League,33,1989,12.5,13,6,8,4,1,8,27,29.6,19,8,1,7,9,22,7,0,Matches
2772,Luca Waldschmidt,GER,"FW,MF",Wolfsburg,Bundesliga,26,1996,5.8,5,2,2,1,2,2,10,20.0,8,6,0,6,3,8,5,0,Matches
2773,Kyle Walker,ENG,DF,Manchester City,Premier League,32,1990,21.8,13,9,8,5,0,4,24,16.7,20,12,2,10,18,31,22,0,Matches
2774,Kyle Walker-Peters,ENG,DF,Southampton,Premier League,25,1997,29.4,61,32,34,24,3,22,43,51.2,21,47,8,39,27,88,52,0,Matches
2775,Sebastian Walukiewicz,POL,DF,Empoli,Serie A,22,2000,6.7,9,6,7,2,0,4,6,66.7,2,10,9,1,7,16,30,0,Matches
2776,Aaron Wan-Bissaka,ENG,DF,Manchester Utd,Premier League,24,1997,15.9,40,25,20,17,3,23,25,92.0,2,24,8,16,22,62,41,0,Matches
2777,Paul Wanner,GER,MF,Bayern Munich,Bundesliga,16,2005,0.3,3,1,1,2,0,1,1,100.0,0,0,0,0,0,3,1,0,Matches
2778,Danny Ward,WAL,GK,Leicester City,Premier League,29,1993,26.0,1,1,1,0,0,1,3,33.3,2,0,0,0,0,1,14,2,Matches
2779,Joel Ward,ENG,DF,Crystal Palace,Premier League,32,1989,25.1,50,36,30,11,9,30,41,73.2,11,32,16,16,25,75,80,1,Matches
2780,James Ward-Prowse,ENG,MF,Southampton,Premier League,27,1994,37.5,65,37,31,27,7,21,61,34.4,40,30,10,20,55,120,48,0,Matches
2781,Ollie Watkins,ENG,FW,Aston Villa,Premier League,26,1995,34.7,19,13,3,13,3,10,27,37.0,17,21,4,17,10,29,39,0,Matches
2782,Timothy Weah,USA,"DF,FW",Lille,Ligue 1,22,2000,19.4,24,14,13,9,2,16,29,55.2,13,17,3,14,23,47,18,0,Matches
2783,Adam Webster,ENG,DF,Brighton,Premier League,27,1995,22.1,22,12,10,9,3,11,19,57.9,8,30,19,11,19,41,55,4,Matches
2784,Wout Weghorst,NED,"FW,MF",Manchester Utd,Premier League,29,1992,8.9,11,5,6,1,4,2,9,22.2,7,7,2,5,7,18,9,0,Matches
2785,Julian Weigl,GER,MF,Gladbach,Bundesliga,26,1995,21.0,43,16,21,21,1,23,41,56.1,18,23,2,21,18,61,32,0,Matches
2786,Nelson Weiper,GER,"FW,DF",Mainz 05,Bundesliga,17,2005,1.1,2,0,0,0,2,1,3,33.3,2,2,0,2,0,2,1,0,Matches
2787,Mitchell Weiser,GER,"DF,FW",Werder Bremen,Bundesliga,28,1994,28.0,71,43,38,24,9,38,75,50.7,37,50,7,43,28,99,38,1,Matches
2788,Noah Weißhaupt,GER,"MF,DF",Freiburg,Bundesliga,20,2001,4.7,11,6,3,7,1,2,7,28.6,5,4,0,4,6,17,8,0,Matches
2789,Shon Weissman,ISR,FW,Valladolid,La Liga,26,1996,8.3,2,1,1,1,0,0,4,0.0,4,8,0,8,1,3,7,0,Matches
2790,Danny Welbeck,ENG,FW,Brighton,Premier League,31,1990,20.6,15,7,0,7,8,4,11,36.4,7,24,2,22,5,20,20,0,Matches
2791,Marcel Wenig,GER,MF,Eint Frankfurt,Bundesliga,18,2004,0.0,0,0,0,0,0,0,0,,0,0,0,0,0,0,0,0,Matches
2792,Axel Werner,ARG,GK,Elche,La Liga,26,1996,2.0,0,0,0,0,0,0,1,0.0,1,0,0,0,0,0,0,0,Matches
2793,Timo Werner,GER,"FW,MF",RB Leipzig,Bundesliga,26,1996,21.5,10,5,4,3,3,4,12,33.3,8,12,0,12,7,17,5,0,Matches
2794,Ben White,ENG,DF,Arsenal,Premier League,24,1997,33.9,60,31,23,30,7,42,70,60.0,28,47,11,36,22,82,79,1,Matches
2795,Harvey White,ENG,MF,Tottenham,Premier League,20,2001,0.1,0,0,0,0,0,0,1,0.0,1,0,0,0,0,0,0,0,Matches
2796,Joseph Whitworth,ENG,GK,Crystal Palace,Premier League,18,2004,2.0,0,0,0,0,0,0,0,,0,0,0,0,0,0,1,0,Matches
2797,Silvan Widmer,SUI,DF,Mainz 05,Bundesliga,29,1993,18.8,26,17,15,10,1,20,39,51.3,19,22,8,14,31,57,28,0,Matches
2798,Mateusz Wieteska,POL,DF,Clermont Foot,Ligue 1,25,1997,34.6,41,23,28,13,0,19,33,57.6,14,44,28,16,56,97,97,4,Matches
2799,Georginio Wijnaldum,NED,MF,Roma,Serie A,31,1990,8.5,4,3,1,3,0,0,2,0.0,2,7,1,6,2,6,3,0,Matches
2800,Iñaki Williams,GHA,FW,Athletic Club,La Liga,28,1994,31.5,22,16,5,14,3,9,24,37.5,15,18,3,15,7,29,34,0,Matches
2801,Neco Williams,WAL,DF,Nott'ham Forest,Premier League,21,2001,20.9,72,47,49,17,6,38,71,53.5,33,33,8,25,33,105,48,0,Matches
2802,Nico Williams,ESP,FW,Athletic Club,La Liga,20,2002,29.5,31,16,10,15,6,19,41,46.3,22,40,2,38,8,39,14,1,Matches
2803,Willian,BRA,FW,Fulham,Premier League,33,1988,23.6,13,8,8,3,2,7,25,28.0,18,13,0,13,9,22,9,0,Matches
2804,Joe Willock,ENG,MF,Newcastle Utd,Premier League,22,1999,28.4,51,30,13,26,12,25,58,43.1,33,54,8,46,25,76,17,0,Matches
2805,Callum Wilson,ENG,FW,Newcastle Utd,Premier League,30,1992,20.9,9,3,0,8,1,0,3,0.0,3,8,0,8,1,10,5,0,Matches
2806,Harry Wilson,WAL,FW,Fulham,Premier League,25,1997,12.2,21,13,9,9,3,8,18,44.4,10,17,2,15,6,27,14,0,Matches
2807,Patrick Wimmer,AUT,"FW,MF",Wolfsburg,Bundesliga,21,2001,18.3,39,26,18,11,10,12,38,31.6,26,27,2,25,15,54,15,0,Matches
2808,Jonas Wind,DEN,FW,Wolfsburg,Bundesliga,23,1999,14.3,14,6,2,7,5,5,10,50.0,5,14,4,10,1,15,10,0,Matches
2809,Harry Winks,ENG,MF,Sampdoria,Serie A,26,1996,19.1,27,12,7,18,2,14,43,32.6,29,14,8,6,24,51,24,0,Matches
2810,Frederik Winther,DEN,DF,Augsburg,Bundesliga,21,2001,1.0,2,2,1,1,0,0,2,0.0,2,1,1,0,0,2,7,0,Matches
2811,Florian Wirtz,GER,"FW,MF",Leverkusen,Bundesliga,19,2003,12.1,18,10,9,7,2,8,16,50.0,8,15,1,14,1,19,6,0,Matches
2812,Przemysław Wiśniewski,POL,DF,Spezia,Serie A,24,1998,11.1,13,6,7,6,0,6,18,33.3,12,16,8,8,11,24,66,0,Matches
2813,Yoane Wissa,COD,FW,Brentford,Premier League,25,1996,17.8,17,12,4,7,6,6,13,46.2,7,10,0,10,6,23,15,0,Matches
2814,Axel Witsel,BEL,"DF,MF",Atlético Madrid,La Liga,33,1989,25.1,36,22,22,11,3,17,31,54.8,14,20,11,9,23,59,76,0,Matches
2815,Maximilian Wöber,AUT,DF,Leeds United,Premier League,24,1998,14.1,25,18,9,15,1,16,24,66.7,8,32,14,18,27,52,67,1,Matches
2816,Hannes Wolf,AUT,FW,Gladbach,Bundesliga,23,1999,5.0,11,8,4,5,2,5,13,38.5,8,3,0,3,3,14,9,0,Matches
2817,Marius Wolf,GER,DF,Dortmund,Bundesliga,27,1995,17.4,25,18,9,12,4,16,29,55.2,13,40,10,30,18,43,22,1,Matches
2818,Jeong Woo-yeong,KOR,"MF,FW",Freiburg,Bundesliga,22,1999,7.3,7,3,4,2,1,2,5,40.0,3,7,1,6,1,8,7,0,Matches
2819,Chris Wood,NZL,FW,Newcastle Utd,Premier League,30,1991,5.0,5,4,0,3,2,3,5,60.0,2,2,2,0,1,6,7,0,Matches
2820,Chris Wood,NZL,FW,Nott'ham Forest,Premier League,30,1991,4.1,0,0,0,0,0,0,1,0.0,1,2,1,1,1,1,2,0,Matches
2821,Christopher Wooh,CMR,DF,Rennes,Ligue 1,20,2001,11.2,16,7,8,8,0,9,11,81.8,2,11,5,6,6,22,49,0,Matches
2822,Christopher Wooh,CMR,MF,Lens,Ligue 1,20,2001,0.0,0,0,0,0,0,0,1,0.0,1,0,0,0,0,0,1,0,Matches
2823,Joe Worrall,ENG,DF,Nott'ham Forest,Premier League,25,1997,24.7,53,25,39,12,2,25,35,71.4,10,33,23,10,26,79,111,1,Matches
2824,Xeka,POR,MF,Rennes,Ligue 1,27,1994,6.1,10,3,6,3,1,7,16,43.8,9,11,2,9,6,16,8,0,Matches
2825,Granit Xhaka,SUI,MF,Arsenal,Premier League,29,1992,33.3,34,27,11,18,5,16,41,39.0,25,28,10,18,15,49,45,1,Matches
2826,Lamine Yamal,ESP,FW,Barcelona,La Liga,15,2007,0.1,0,0,0,0,0,0,0,,0,0,0,0,0,0,0,0,Matches
2827,Jawad El Yamiq,MAR,DF,Valladolid,La Liga,30,1992,17.9,17,11,10,7,0,6,11,54.5,5,27,19,8,37,54,101,0,Matches
2828,Ryan Yates,ENG,MF,Nott'ham Forest,Premier League,24,1997,20.4,38,19,19,16,3,14,22,63.6,8,26,8,18,10,48,44,0,Matches
2829,Yusuf Yazıcı,TUR,MF,Lille,Ligue 1,25,1997,2.2,0,0,0,0,0,0,0,,0,2,0,2,0,0,1,0,Matches
2830,Kelvin Yeboah,ITA,"FW,MF",Augsburg,Bundesliga,22,2000,3.9,6,4,2,4,0,2,5,40.0,3,7,0,7,1,7,2,0,Matches
2831,Gerard Yepes,ESP,MF,Sampdoria,Serie A,19,2002,2.2,5,3,2,3,0,1,3,33.3,2,3,0,3,4,9,3,0,Matches
2832,Darlin Yongwa,CMR,DF,Lorient,Ligue 1,21,2000,8.7,13,11,7,5,1,4,15,26.7,11,13,1,12,5,18,11,0,Matches
2833,Leny Yoro,FRA,DF,Lille,Ligue 1,16,2005,8.5,11,5,8,3,0,4,9,44.4,5,6,1,5,18,29,27,1,Matches
2834,Maya Yoshida,JPN,DF,Schalke 04,Bundesliga,33,1988,28.4,34,22,19,13,2,18,29,62.1,11,40,29,11,46,80,132,2,Matches
2835,Ashley Young,ENG,DF,Aston Villa,Premier League,37,1985,22.6,50,27,34,15,1,37,50,74.0,13,25,11,14,21,71,65,0,Matches
2836,Mohamed Youssouf,COM,DF,Ajaccio,Ligue 1,34,1988,27.3,72,44,41,24,7,38,61,62.3,23,32,8,24,65,137,70,0,Matches
2837,Illia Zabarnyi,UKR,DF,Bournemouth,Premier League,19,2002,3.3,4,2,4,0,0,3,7,42.9,4,7,2,5,3,7,14,0,Matches
2838,Mattia Zaccagni,ITA,FW,Lazio,Serie A,27,1995,30.8,42,28,16,18,8,14,38,36.8,24,37,3,34,21,63,10,1,Matches
2839,Dan-Axel Zagadou,FRA,DF,Stuttgart,Bundesliga,23,1999,14.1,14,9,10,4,0,5,14,35.7,9,19,16,3,21,35,81,1,Matches
2840,Wilfried Zaha,CIV,"FW,MF",Crystal Palace,Premier League,29,1992,25.4,32,20,12,12,8,8,21,38.1,13,21,1,20,16,48,9,0,Matches
2841,Warren Zaïre-Emery,FRA,"MF,DF",Paris S-G,Ligue 1,16,2006,10.3,17,10,5,10,2,8,29,27.6,21,11,0,11,12,29,17,0,Matches
2842,Denis Zakaria,SUI,MF,Chelsea,Premier League,25,1996,4.6,9,5,5,2,2,2,8,25.0,6,4,1,3,3,12,10,0,Matches
2843,Denis Zakaria,SUI,MF,Juventus,Serie A,25,1996,1.4,6,3,1,4,1,2,2,100.0,0,2,0,2,2,8,1,0,Matches
2844,Rodrigo Zalazar,URU,"MF,FW",Schalke 04,Bundesliga,22,1999,14.7,16,8,5,9,2,9,24,37.5,15,16,1,15,7,23,13,0,Matches
2845,Joseba Zaldúa,ESP,DF,Cádiz,La Liga,30,1992,7.1,15,8,10,4,1,7,10,70.0,3,4,2,2,11,26,22,0,Matches
2846,Nicola Zalewski,POL,DF,Roma,Serie A,20,2002,24.4,45,26,25,15,5,22,71,31.0,49,27,1,26,31,76,23,0,Matches
2847,Andre-Frank Zambo Anguissa,CMR,MF,Napoli,Serie A,26,1995,33.9,53,32,16,29,8,16,64,25.0,48,50,4,46,49,102,25,0,Matches
2848,Oliver Zandén,SWE,"DF,MF",Toulouse,Ligue 1,20,2001,1.6,2,1,1,0,1,2,5,40.0,3,0,0,0,1,3,7,0,Matches
2849,Luca Zanimacchia,ITA,"MF,FW",Cremonese,Serie A,24,1998,8.3,21,13,11,6,4,8,21,38.1,13,9,0,9,9,30,5,0,Matches
2850,Nicolò Zaniolo,ITA,"MF,FW",Roma,Serie A,23,1999,9.9,7,5,2,4,1,2,7,28.6,5,11,0,11,2,9,0,0,Matches
2851,Alessandro Zanoli,ITA,DF,Sampdoria,Serie A,21,2000,17.1,22,14,14,6,2,8,17,47.1,9,19,15,4,12,34,39,0,Matches
2852,Alessandro Zanoli,ITA,DF,Napoli,Serie A,21,2000,0.1,1,0,0,1,0,0,0,,0,0,0,0,0,1,1,0,Matches
2853,Mattia Zanotti,ITA,DF,Inter,Serie A,19,2003,0.3,0,0,0,0,0,0,1,0.0,1,2,0,2,0,0,0,0,Matches
2854,Duván Zapata,COL,FW,Atalanta,Serie A,31,1991,15.4,8,4,1,3,4,3,5,60.0,2,6,2,4,4,12,17,1,Matches
2855,Davide Zappacosta,ITA,DF,Atalanta,Serie A,30,1992,16.3,34,18,17,12,5,15,22,68.2,7,23,2,21,9,43,16,0,Matches
2856,Oier Zarraga,ESP,MF,Athletic Club,La Liga,23,1999,9.5,14,9,5,7,2,8,20,40.0,12,7,0,7,10,24,5,0,Matches
2857,Akim Zedadka,ALG,DF,Auxerre,Ligue 1,27,1995,17.8,35,21,21,10,4,18,32,56.3,14,17,3,14,23,58,51,1,Matches
2858,Akim Zedadka,ALG,"DF,MF",Lille,Ligue 1,27,1995,3.9,1,1,1,0,0,0,2,0.0,2,3,0,3,2,3,6,0,Matches
2859,Karim Zedadka,FRA,FW,Napoli,Serie A,22,2000,0.2,0,0,0,0,0,0,0,,0,0,0,0,0,0,1,0,Matches
2860,Deyovaisio Zeefuik,NED,DF,Hellas Verona,Serie A,24,1998,0.1,1,1,0,1,0,0,0,,0,0,0,0,0,1,0,0,Matches
2861,Marvin Zeegelaar,NED,DF,Udinese,Serie A,31,1990,3.9,8,4,6,2,0,3,4,75.0,1,2,0,2,3,11,5,0,Matches
2862,Mehdi Zeffane,ALG,"DF,MF",Clermont Foot,Ligue 1,30,1992,7.3,12,7,5,7,0,4,21,19.0,17,14,6,8,22,34,12,0,Matches
2863,Aaron Zehnter,GER,DF,Augsburg,Bundesliga,17,2004,0.0,0,0,0,0,0,0,1,0.0,1,0,0,0,1,1,0,0,Matches
2864,Jordan Zemura,ZIM,DF,Bournemouth,Premier League,22,1999,16.2,39,24,24,14,1,23,44,52.3,21,31,9,22,16,55,32,0,Matches
2865,Arber Zeneli,KVX,"FW,MF",Reims,Ligue 1,27,1995,11.1,9,3,3,3,3,5,12,41.7,7,8,0,8,2,11,2,0,Matches
2866,Robin Zentner,GER,GK,Mainz 05,Bundesliga,27,1994,26.0,0,0,0,0,0,0,4,0.0,4,0,0,0,0,0,17,1,Matches
2867,Alessio Zerbin,ITA,FW,Napoli,Serie A,23,1999,2.2,10,5,4,5,1,4,8,50.0,4,2,0,2,2,12,2,0,Matches
2868,Michael Zetterer,GER,GK,Werder Bremen,Bundesliga,27,1995,1.7,0,0,0,0,0,0,0,,0,0,0,0,0,0,1,0,Matches
2869,Nathan Zeze,FRA,DF,Nantes,Ligue 1,17,2005,0.7,3,2,2,1,0,1,1,100.0,0,0,0,0,0,3,1,0,Matches
2870,Edon Zhegrova,KVX,"FW,MF",Lille,Ligue 1,23,1999,11.7,18,12,6,7,5,12,20,60.0,8,9,0,9,2,20,2,0,Matches
2871,Piotr Zieliński,POL,MF,Napoli,Serie A,28,1994,25.4,17,10,1,11,5,12,25,48.0,13,16,5,11,14,31,7,0,Matches
2872,David Zima,CZE,DF,Torino,Serie A,21,2000,4.5,9,5,5,4,0,3,4,75.0,1,7,2,5,9,18,11,2,Matches
2873,Oleksandr Zinchenko,UKR,DF,Arsenal,Premier League,25,1996,23.5,40,18,14,17,9,21,40,52.5,19,20,2,18,22,62,38,2,Matches
2874,Joshua Zirkzee,NED,FW,Bologna,Serie A,21,2001,9.1,4,2,1,1,2,2,7,28.6,5,4,1,3,4,8,4,0,Matches
2875,Hakim Ziyech,MAR,"FW,MF",Chelsea,Premier League,29,1993,7.3,20,12,12,5,3,4,9,44.4,5,8,0,8,5,25,5,1,Matches
2876,Jeroen Zoet,NED,GK,Spezia,Serie A,31,1991,3.7,1,1,1,0,0,1,1,100.0,0,0,0,0,0,1,1,0,Matches
2877,Simon Zoller,GER,FW,Bochum,Bundesliga,31,1991,16.2,11,4,2,8,1,4,12,33.3,8,14,1,13,6,17,21,0,Matches
2878,Nadir Zortea,ITA,"DF,MF",Atalanta,Serie A,23,1999,2.5,10,5,3,7,0,3,4,75.0,1,4,0,4,0,10,4,0,Matches
2879,Nadir Zortea,ITA,DF,Sassuolo,Serie A,23,1999,7.3,15,8,12,2,1,9,14,64.3,5,10,4,6,4,19,21,0,Matches
2880,Tanguy Zoukrou,FRA,DF,Troyes,Ligue 1,19,2003,5.7,14,7,8,6,0,10,14,71.4,4,18,11,7,2,16,24,0,Matches
2881,Kurt Zouma,FRA,DF,West Ham,Premier League,27,1994,22.1,9,4,4,5,0,5,8,62.5,3,17,14,3,30,39,120,1,Matches
2882,Petar Zovko,BIH,GK,Spezia,Serie A,20,2002,0.8,1,0,1,0,0,1,1,100.0,0,0,0,0,0,1,0,0,Matches
2883,Igor Zubeldia,ESP,DF,Real Sociedad,La Liga,25,1997,28.2,35,18,28,7,0,25,35,71.4,10,23,17,6,21,56,93,0,Matches
2884,Martín Zubimendi,ESP,MF,Real Sociedad,La Liga,23,1999,34.5,59,33,23,30,6,24,45,53.3,21,44,17,27,37,96,55,4,Matches
2885,Szymon Żurkowski,POL,MF,Fiorentina,Serie A,24,1997,0.4,0,0,0,0,0,0,0,,0,0,0,0,0,0,0,0,Matches
2886,Szymon Żurkowski,POL,MF,Spezia,Serie A,24,1997,4.7,9,3,4,4,1,2,15,13.3,13,9,2,7,4,13,6,0,Matches
2887,Martin Ødegaard,NOR,MF,Arsenal,Premier League,23,1998,34.7,36,23,12,14,10,14,47,29.8,33,20,5,15,6,42,12,1,Matches
2888,Milan Đurić,BIH,FW,Hellas Verona,Serie A,32,1990,15.2,2,1,1,0,1,1,3,33.3,2,7,4,3,1,3,24,0,Matches
2889,Filip Đuričić,SRB,"MF,FW",Sampdoria,Serie A,30,1992,24.1,43,22,18,20,5,14,32,43.8,18,19,6,13,7,50,8,0,Matches
1,Max Aarons,ENG,DF,Bournemouth,Premier League,23,2000,13.7,29,19,20,7,2,20,34,58.8,14,9,5,4,8,37,27,0,Matches
2,Brenden Aaronson,USA,"MF,FW",Union Berlin,Bundesliga,22,2000,14.1,32,18,13,13,6,16,32,50.0,16,26,1,25,2,34,4,0,Matches
3,Paxten Aaronson,USA,MF,Eint Frankfurt,Bundesliga,19,2003,1.1,2,2,1,1,0,1,1,100.0,0,2,0,2,0,2,0,0,Matches
4,Keyliane Abdallah,FRA,FW,Marseille,Ligue 1,17,2006,0.0,0,0,0,0,0,0,0,,0,0,0,0,0,0,0,0,Matches
5,Yunis Abdelhamid,MAR,DF,Reims,Ligue 1,35,1987,30.9,64,35,36,23,5,26,45,57.8,19,51,32,19,39,103,109,2,Matches
6,Salis Abdul Samed,GHA,MF,Lens,Ligue 1,23,2000,16.9,21,14,8,10,3,8,18,44.4,10,12,1,11,12,33,18,0,Matches
7,Nabil Aberdin,FRA,DF,Getafe,La Liga,20,2002,2.0,0,0,0,0,0,0,1,0.0,1,0,0,0,0,0,4,0,Matches
8,Laurent Abergel,FRA,MF,Lorient,Ligue 1,30,1993,31.8,85,52,43,34,8,38,96,39.6,58,29,6,23,61,146,61,3,Matches
9,Matthis Abline,FRA,FW,Nantes,Ligue 1,20,2003,11.6,9,4,4,3,2,3,8,37.5,5,3,0,3,3,12,5,0,Matches
10,Abner,BRA,DF,Betis,La Liga,23,2000,15.6,25,19,15,9,1,17,34,50.0,17,23,5,18,15,40,62,0,Matches
11,Zakaria Aboukhlal,MAR,"MF,FW",Toulouse,Ligue 1,23,2000,8.4,9,8,1,5,3,3,12,25.0,9,9,1,8,1,10,2,0,Matches
12,Abdel Abqar,MAR,DF,Alavés,La Liga,24,1999,25.7,35,19,28,5,2,21,35,60.0,14,31,26,5,23,58,115,0,Matches
13,Tammy Abraham,ENG,FW,Roma,Serie A,25,1997,2.7,3,1,0,1,2,0,0,,0,1,0,1,0,3,4,0,Matches
14,Francesco Acerbi,ITA,DF,Inter,Serie A,35,1988,26.5,22,13,16,6,0,11,14,78.6,3,20,13,7,32,54,77,1,Matches
15,Joshua Acheampong,ENG,DF,Chelsea,Premier League,17,2006,0.1,0,0,0,0,0,0,0,,0,3,3,0,0,0,0,0,Matches
16,Marcos Acuña,ARG,DF,Sevilla,La Liga,31,1991,14.4,33,21,20,12,1,9,14,64.3,5,12,2,10,4,37,25,0,Matches
17,Bénie Adama Traore,CIV,"FW,MF",Sheffield Utd,Premier League,20,2002,4.3,4,2,1,2,1,0,4,0.0,4,4,1,3,1,5,1,0,Matches
18,Bénie Adama Traore,CIV,"FW,MF",Nantes,Ligue 1,20,2002,5.6,8,4,2,5,1,3,7,42.9,4,3,0,3,1,9,1,0,Matches
19,Akor Adams,NGA,FW,Montpellier,Ligue 1,23,2000,25.0,12,4,3,4,5,3,7,42.9,4,9,2,7,5,17,11,0,Matches
20,Tyler Adams,USA,MF,Bournemouth,Premier League,24,1999,1.3,4,3,1,3,0,2,3,66.7,1,2,0,2,4,8,2,0,Matches
21,Junior Adamu,AUT,"FW,MF",Freiburg,Bundesliga,22,2001,1.2,5,1,1,2,2,1,2,50.0,1,1,0,1,0,5,2,0,Matches
22,Sargis Adamyan,ARM,"FW,MF",Köln,Bundesliga,30,1993,8.9,14,9,2,9,3,6,11,54.5,5,16,1,15,5,19,7,0,Matches
23,Tosin Adarabioyo,ENG,DF,Fulham,Premier League,25,1997,18.0,21,11,16,5,0,12,21,57.1,9,16,11,5,25,46,80,0,Matches
24,Elijah Adebayo,ENG,FW,Luton Town,Premier League,25,1998,15.8,4,1,1,0,3,1,12,8.3,11,13,2,11,6,10,25,0,Matches
25,Karim Adeyemi,GER,"FW,MF",Dortmund,Bundesliga,21,2002,10.1,16,14,9,4,3,8,20,40.0,12,11,0,11,3,19,5,0,Matches
26,Simon Adingra,CIV,FW,Brighton,Premier League,21,2002,24.7,45,20,23,11,11,19,42,45.2,23,31,1,30,19,64,22,0,Matches
27,Nathaniel Adjei,GHA,DF,Lorient,Ligue 1,20,2002,13.8,13,9,8,3,2,6,7,85.7,1,15,8,7,18,31,64,1,Matches
28,Amine Adli,MAR,"MF,FW",Leverkusen,Bundesliga,23,2000,10.0,16,7,2,10,4,7,17,41.2,10,10,2,8,6,22,5,0,Matches
29,Yacine Adli,FRA,MF,Milan,Serie A,23,2000,15.6,34,17,17,13,4,13,35,37.1,22,22,8,14,20,54,15,1,Matches
30,Adryelson,BRA,"DF,FW",Lyon,Ligue 1,25,1998,0.1,0,0,0,0,0,0,0,,0,0,0,0,1,1,3,0,Matches
31,Adson,BRA,"MF,FW",Nantes,Ligue 1,22,2000,2.6,7,6,1,6,0,2,2,100.0,0,5,0,5,2,9,2,0,Matches
32,Michel Aebischer,SUI,MF,Bologna,Serie A,26,1997,24.8,35,20,9,20,6,15,34,44.1,19,28,6,22,12,47,22,0,Matches
33,Emmanuel Agbadou,CIV,DF,Reims,Ligue 1,26,1997,28.8,65,41,38,23,4,44,64,68.8,20,47,25,22,55,120,116,1,Matches
34,Julen Agirrezabala,ESP,GK,Athletic Club,La Liga,22,2000,2.6,0,0,0,0,0,0,0,,0,0,0,0,0,0,0,0,Matches
35,Lucien Agoume,FRA,MF,Inter,Serie A,21,2002,0.1,0,0,0,0,0,0,0,,0,0,0,0,0,0,0,0,Matches
36,Lucien Agoume,FRA,MF,Sevilla,La Liga,21,2002,8.6,23,18,7,14,2,9,12,75.0,3,6,1,5,7,30,8,0,Matches
37,Felix Agu,GER,"DF,MF",Werder Bremen,Bundesliga,23,1999,17.9,45,29,28,13,4,29,41,70.7,12,27,7,20,13,58,41,0,Matches
38,Nayef Aguerd,MAR,DF,West Ham,Premier League,27,1996,20.6,26,14,19,7,0,16,22,72.7,6,33,24,9,17,43,85,2,Matches
39,Ruben Aguilar,FRA,DF,Lens,Ligue 1,30,1993,21.4,53,31,27,23,3,27,45,60.0,18,35,5,30,26,79,46,0,Matches
40,Brandon Aguilera,CRC,FW,Nott'ham Forest,Premier League,20,2003,0.1,0,0,0,0,0,0,0,,0,0,0,0,0,0,0,0,Matches
41,Naouirou Ahamada,FRA,"MF,FW",Crystal Palace,Premier League,21,2002,3.9,13,9,5,6,2,8,17,47.1,9,3,0,3,2,15,4,0,Matches
42,Anel Ahmedhodžić,BIH,DF,Sheffield Utd,Premier League,24,1999,29.4,64,36,48,14,2,30,49,61.2,19,43,26,17,35,99,137,2,Matches
43,Joseph Aidoo,GHA,DF,Celta Vigo,La Liga,27,1995,4.5,8,3,6,2,0,4,8,50.0,4,3,1,2,4,12,28,0,Matches
44,Ola Aina,NGA,DF,Nott'ham Forest,Premier League,26,1996,18.8,47,31,31,12,4,29,41,70.7,12,19,3,16,18,65,51,1,Matches
45,Rayan Aït-Nouri,ALG,"DF,MF",Wolves,Premier League,22,2001,25.9,71,44,41,23,7,28,49,57.1,21,32,6,26,15,86,38,0,Matches
46,Tosin Aiyegun,BEN,"MF,FW",Lorient,Ligue 1,25,1998,10.0,6,4,2,3,1,3,9,33.3,6,4,1,3,2,8,8,0,Matches
47,Kristoffer Ajer,NOR,DF,Brentford,Premier League,25,1998,20.4,38,21,25,9,4,23,36,63.9,13,26,11,15,25,63,79,1,Matches
48,Ludovic Ajorque,FRA,FW,Mainz 05,Bundesliga,29,1994,15.1,3,2,1,2,0,2,11,18.2,9,6,2,4,4,7,11,0,Matches
49,Manuel Akanji,SUI,"DF,MF",Manchester City,Premier League,28,1995,27.9,42,28,16,18,8,22,39,56.4,17,28,12,16,23,65,70,3,Matches
50,Marley Aké,FRA,FW,Udinese,Serie A,22,2001,0.1,0,0,0,0,0,0,0,,0,0,0,0,0,0,0,0,Matches
51,Nathan Aké,NED,DF,Manchester City,Premier League,28,1995,22.7,26,16,15,8,3,13,20,65.0,7,17,2,15,14,40,54,0,Matches
52,Ilias Akhomach,MAR,"MF,FW",Villarreal,La Liga,19,2004,16.8,36,21,11,16,9,10,20,50.0,10,10,2,8,13,49,13,0,Matches
53,Sergio Akieme,ESP,DF,Almería,La Liga,25,1997,18.6,27,15,18,7,2,13,16,81.3,3,14,4,10,10,37,34,0,Matches
54,Sergio Akieme,ESP,DF,Reims,Ligue 1,25,1997,9.1,11,5,6,3,2,8,11,72.7,3,9,3,6,10,21,25,0,Matches
55,Ebenezer Akinsanmiro,NGA,MF,Inter,Serie A,18,2004,0.2,0,0,0,0,0,0,1,0.0,1,0,0,0,0,0,0,0,Matches
56,Maghnes Akliouche,FRA,"MF,FW",Monaco,Ligue 1,21,2002,17.9,37,23,12,20,5,12,36,33.3,24,21,0,21,9,46,3,0,Matches
57,Paul Akouokou,CIV,MF,Betis,La Liga,25,1997,0.3,5,3,0,2,3,3,3,100.0,0,3,1,2,1,6,1,0,Matches
58,Paul Akouokou,CIV,MF,Lyon,Ligue 1,25,1997,3.4,14,9,2,10,2,6,7,85.7,1,5,1,4,6,20,11,0,Matches
59,Jean-Daniel Akpa-Akpro,CIV,MF,Monza,Serie A,30,1992,7.8,20,11,14,4,2,3,9,33.3,6,10,4,6,12,32,15,1,Matches
60,David Akpan Ankeye,NGA,FW,Genoa,Serie A,21,2002,0.6,1,0,0,1,0,0,1,0.0,1,1,0,1,0,1,0,0,Matches
61,Kevin Akpoguma,NGA,DF,Hoffenheim,Bundesliga,28,1995,12.2,35,18,22,12,1,26,35,74.3,9,28,8,20,18,53,32,0,Matches
62,David Alaba,AUT,DF,Real Madrid,La Liga,31,1992,12.8,13,9,7,5,1,4,8,50.0,4,10,7,3,15,28,34,0,Matches
63,Luis Alberto,ESP,MF,Lazio,Serie A,30,1992,25.7,35,20,16,12,7,15,53,28.3,38,34,4,30,7,42,13,0,Matches
64,Raúl Albiol,ESP,DF,Villarreal,La Liga,37,1985,22.6,25,14,15,9,1,18,27,66.7,9,31,24,7,16,41,102,0,Matches
65,Thiago Alcántara,ESP,MF,Liverpool,Premier League,32,1991,0.1,0,0,0,0,0,0,0,,0,0,0,0,0,0,0,0,Matches
66,Carlos Alcaraz,ARG,MF,Juventus,Serie A,20,2002,4.2,6,6,0,6,0,5,10,50.0,5,5,2,3,5,11,4,0,Matches
67,Rubén Alcaraz,ESP,MF,Cádiz,La Liga,32,1991,34.8,97,59,39,52,6,50,121,41.3,71,60,14,46,33,130,55,2,Matches
68,Omar Alderete,PAR,DF,Getafe,La Liga,26,1996,24.4,28,21,15,13,0,19,35,54.3,16,30,18,12,13,41,111,0,Matches
69,Iván Alejo,ESP,MF,Cádiz,La Liga,28,1995,18.8,40,23,23,11,6,17,57,29.8,40,20,0,20,7,47,17,0,Matches
70,Carles Aleñá,ESP,MF,Getafe,La Liga,25,1998,11.3,24,8,7,14,3,10,24,41.7,14,14,3,11,4,28,13,0,Matches
71,Trent Alexander-Arnold,ENG,DF,Liverpool,Premier League,24,1998,23.9,39,26,26,11,2,27,87,31.0,60,22,2,20,31,70,48,5,Matches
72,Aboubacar Ali,FRA,"MF,FW",Strasbourg,Ligue 1,17,2006,1.4,2,0,0,2,0,0,0,,0,1,0,1,1,3,2,0,Matches
73,Mohamed Ali Cho,FRA,"FW,MF",Real Sociedad,La Liga,19,2004,2.8,4,3,3,1,0,2,7,28.6,5,6,0,6,1,5,1,0,Matches
74,Mohamed Ali Cho,FRA,FW,Nice,Ligue 1,19,2004,9.6,12,9,4,7,1,3,11,27.3,8,10,0,10,3,15,6,0,Matches
75,Faride Alidou,GER,"FW,MF",Köln,Bundesliga,22,2001,14.2,10,4,3,6,1,4,18,22.2,14,23,2,21,8,18,15,1,Matches
76,Nabil Alioui,FRA,"MF,FW",Le Havre,Ligue 1,24,1999,11.2,3,2,2,1,0,2,4,50.0,2,6,1,5,3,6,4,0,Matches
77,Alisson,BRA,GK,Liverpool,Premier League,30,1992,28.0,0,0,0,0,0,0,1,0.0,1,0,0,0,0,0,11,4,Matches
78,Tadeo Allende,ARG,"MF,FW",Celta Vigo,La Liga,24,1999,3.7,6,1,3,2,1,4,6,66.7,2,3,0,3,3,9,3,0,Matches
79,Jim Allevinah,GAB,"MF,DF",Clermont Foot,Ligue 1,28,1995,20.7,30,18,11,14,5,14,35,40.0,21,20,3,17,13,43,30,0,Matches
80,Domingos André Ribeiro Almeida,POR,"FW,MF",Valencia,La Liga,23,2000,10.7,25,15,9,12,4,9,19,47.4,10,13,1,12,6,31,5,0,Matches
81,Miguel Almirón,PAR,FW,Newcastle Utd,Premier League,29,1994,21.5,36,24,13,15,8,11,29,37.9,18,29,2,27,10,46,13,0,Matches
82,Pontus Almqvist,SWE,"FW,MF",Lecce,Serie A,24,1999,23.4,45,29,16,22,7,23,51,45.1,28,21,2,19,14,59,10,0,Matches
83,Marcos Alonso,ESP,DF,Barcelona,La Liga,32,1990,2.8,5,3,2,3,0,3,4,75.0,1,2,0,2,4,9,6,0,Matches
84,Adrià Altimira,ESP,"DF,MF",Villarreal,La Liga,22,2001,8.6,16,7,9,6,1,9,24,37.5,15,18,5,13,5,21,18,0,Matches
85,Sergi Altimira,ESP,MF,Betis,La Liga,21,2001,6.3,15,8,8,6,1,11,23,47.8,12,12,1,11,9,24,10,0,Matches
86,Edson Álvarez,MEX,MF,West Ham,Premier League,25,1997,26.4,80,39,47,26,7,31,66,47.0,35,59,20,39,42,122,81,0,Matches
87,Gastón Álvarez,URU,DF,Getafe,La Liga,23,2000,28.2,68,37,43,20,5,37,57,64.9,20,40,11,29,35,103,80,0,Matches
88,Hugo Álvarez,ESP,"MF,DF",Celta Vigo,La Liga,20,2003,8.5,14,9,8,3,3,9,20,45.0,11,4,1,3,5,19,9,0,Matches
89,Julián Álvarez,ARG,"MF,FW",Manchester City,Premier League,23,2000,29.4,24,13,5,8,11,8,32,25.0,24,30,0,30,2,26,14,1,Matches
90,Yeray Álvarez,ESP,DF,Athletic Club,La Liga,28,1995,12.8,18,9,15,3,0,12,19,63.2,7,8,5,3,11,29,34,1,Matches
91,Skelly Alvero,FRA,MF,Lyon,Ligue 1,21,2002,4.7,8,7,5,2,1,2,9,22.2,7,5,1,4,2,10,5,0,Matches
92,Skelly Alvero,FRA,MF,Werder Bremen,Bundesliga,21,2002,1.4,6,4,1,5,0,3,3,100.0,0,3,1,2,1,7,1,0,Matches
93,Papa Amadou Diallo,SEN,FW,Metz,Ligue 1,19,2004,9.9,18,8,10,7,1,7,21,33.3,14,11,1,10,11,29,16,0,Matches
94,Selim Amallah,MAR,"FW,MF",Valencia,La Liga,26,1996,6.7,17,12,7,7,3,3,9,33.3,6,13,0,13,11,28,6,0,Matches
95,Amath,SEN,"FW,MF",Mallorca,La Liga,27,1996,4.4,9,6,7,2,0,2,10,20.0,8,2,0,2,3,12,6,0,Matches
96,Lorenzo Amatucci,ITA,MF,Fiorentina,Serie A,19,2004,0.2,0,0,0,0,0,0,0,,0,0,0,0,0,0,0,0,Matches
97,Jordan Amavi,FRA,DF,Brest,Ligue 1,29,1994,1.0,1,1,0,1,0,1,3,33.3,2,2,1,1,3,4,2,0,Matches
98,Zeki Amdouni,SUI,FW,Burnley,Premier League,22,2000,21.7,27,18,1,15,11,7,25,28.0,18,23,10,13,9,36,10,0,Matches
99,Kelvin Amian,FRA,DF,Nantes,Ligue 1,25,1998,8.9,16,7,12,4,0,11,15,73.3,4,6,0,6,7,23,28,0,Matches
100,Bruno Amione,ARG,DF,Hellas Verona,Serie A,21,2002,6.4,11,3,9,2,0,4,5,80.0,1,4,2,2,9,20,19,2,Matches
101,Michael Amir Murillo,PAN,DF,Marseille,Ligue 1,27,1996,11.1,23,11,13,6,4,15,23,65.2,8,9,2,7,11,34,34,2,Matches
102,Nadiem Amiri,GER,MF,Mainz 05,Bundesliga,26,1996,14.6,22,14,8,10,4,13,19,68.4,6,16,2,14,14,36,18,0,Matches
103,Nadiem Amiri,GER,MF,Leverkusen,Bundesliga,26,1996,1.0,4,2,0,3,1,0,3,0.0,3,0,0,0,0,4,1,0,Matches
104,Kofi Amoako,GER,MF,Wolfsburg,Bundesliga,18,2005,0.0,0,0,0,0,0,0,0,,0,0,0,0,0,0,0,0,Matches
105,Sofyan Amrabat,MAR,"MF,DF",Manchester Utd,Premier League,26,1996,10.4,27,16,17,8,2,17,31,54.8,14,20,7,13,8,35,19,2,Matches
106,Joachim Andersen,DEN,DF,Crystal Palace,Premier League,27,1996,37.9,56,35,33,21,2,29,39,74.4,10,33,18,15,41,97,207,1,Matches
107,Elliot Anderson,SCO,"MF,FW",Newcastle Utd,Premier League,20,2002,11.4,24,18,12,9,3,15,29,51.7,14,23,4,19,8,32,23,0,Matches
108,Felipe Anderson,BRA,"FW,MF",Lazio,Serie A,30,1993,30.8,78,45,32,33,13,34,90,37.8,56,45,3,42,27,105,23,0,Matches
109,Benjamin André,FRA,MF,Lille,Ligue 1,32,1990,28.6,89,49,39,45,5,43,81,53.1,38,34,5,29,35,124,60,0,Matches
110,Komnen Andrić,SRB,FW,Clermont Foot,Ligue 1,28,1995,1.9,2,1,0,1,1,0,4,0.0,4,2,0,2,0,2,1,0,Matches
111,Robert Andrich,GER,"MF,DF",Leverkusen,Bundesliga,28,1994,18.8,30,18,8,14,8,13,24,54.2,11,15,4,11,20,50,17,0,Matches
112,Miguel Ángel Rubio,ESP,DF,Granada,La Liga,25,1998,17.3,20,12,14,6,0,14,21,66.7,7,31,18,13,28,48,74,2,Matches
113,Angeliño,ESP,DF,Roma,Serie A,26,1997,12.7,21,11,12,6,3,11,19,57.9,8,11,5,6,12,33,37,1,Matches
114,Fabrizio Angileri,ARG,"DF,MF",Getafe,La Liga,29,1994,1.8,1,1,1,0,0,1,3,33.3,2,0,0,0,4,5,8,0,Matches
115,Jaidon Anthony,ENG,FW,Bournemouth,Premier League,23,1999,1.7,3,1,1,0,2,1,7,14.3,6,3,0,3,1,4,3,0,Matches
116,Waldemar Anton,GER,DF,Stuttgart,Bundesliga,27,1996,32.1,39,25,21,16,2,23,42,54.8,19,33,20,13,40,79,150,1,Matches
117,Michail Antonio,JAM,FW,West Ham,Premier League,33,1990,18.8,15,8,5,6,4,3,11,27.3,8,16,3,13,4,19,4,0,Matches
118,Antony,BRA,FW,Manchester Utd,Premier League,23,2000,14.7,40,21,15,19,6,20,40,50.0,20,29,1,28,12,52,9,0,Matches
119,Christopher Antwi-Adjei,GHA,"FW,MF",Bochum,Bundesliga,29,1994,13.5,21,12,10,6,5,12,22,54.5,10,13,2,11,2,23,11,1,Matches
120,Houssem Aouar,ALG,"MF,FW",Roma,Serie A,25,1998,8.4,16,11,4,10,2,3,12,25.0,9,5,0,5,4,20,2,1,Matches
121,Stredair Appuah,FRA,"FW,MF",Nantes,Ligue 1,19,2004,0.9,0,0,0,0,0,0,3,0.0,3,0,0,0,1,1,1,0,Matches
122,Mauro Arambarri,URU,MF,Getafe,La Liga,27,1995,3.8,6,2,3,2,1,1,6,16.7,5,1,0,1,2,8,7,0,Matches
123,Jon Aramburu,VEN,DF,Real Sociedad,La Liga,21,2002,6.0,24,15,12,10,2,15,25,60.0,10,8,3,5,7,31,17,0,Matches
124,Asaf Arania,ISR,MF,Darmstadt 98,Bundesliga,17,2005,0.1,0,0,0,0,0,0,0,,0,0,0,0,0,0,0,0,Matches
125,Julian Araujo,MEX,DF,Las Palmas,La Liga,21,2001,16.2,41,22,29,7,5,23,33,69.7,10,23,16,7,10,51,52,1,Matches
126,Ronald Araújo,URU,DF,Barcelona,La Liga,24,1999,22.2,27,22,11,15,1,12,17,70.6,5,20,11,9,12,39,66,2,Matches
127,Oliver Arblaster,ENG,MF,Sheffield Utd,Premier League,19,2004,10.5,23,14,11,8,4,7,15,46.7,8,17,7,10,15,38,9,0,Matches
128,Cameron Archer,ENG,"FW,MF",Sheffield Utd,Premier League,22,2001,20.4,18,13,6,6,6,8,18,44.4,10,22,3,19,1,19,11,0,Matches
129,Cameron Archer,ENG,MF,Aston Villa,Premier League,22,2001,0.1,0,0,0,0,0,0,0,,0,0,0,0,0,0,0,0,Matches
130,Alphonse Areola,FRA,GK,West Ham,Premier League,30,1993,30.0,1,1,1,0,0,1,3,33.3,2,0,0,0,1,2,16,0,Matches
131,Adu Ares,ESP,FW,Athletic Club,La Liga,21,2001,2.9,8,4,4,2,2,2,3,66.7,1,1,0,1,1,9,0,0,Matches
132,Jesús Areso,ESP,DF,Osasuna,La Liga,24,1999,29.6,45,24,25,13,7,31,38,81.6,7,36,15,21,18,63,58,0,Matches
133,Simone Aresti,ITA,GK,Cagliari,Serie A,37,1986,0.0,0,0,0,0,0,0,0,,0,0,0,0,0,0,0,0,Matches
134,Matias Arezo,URU,FW,Granada,La Liga,20,2002,4.1,7,3,2,5,0,1,5,20.0,4,4,1,3,1,8,4,0,Matches
135,Iñigo Arguibide,ESP,DF,Osasuna,La Liga,18,2005,0.2,1,0,0,1,0,0,0,,0,0,0,0,0,1,1,0,Matches
136,Yoël Armougom,FRA,"DF,MF",Clermont Foot,Ligue 1,25,1998,2.6,3,3,2,0,1,2,3,66.7,1,1,0,1,1,4,3,0,Matches
137,José Arnaiz,ESP,"FW,MF",Osasuna,La Liga,28,1995,10.3,14,8,6,4,4,6,21,28.6,15,11,2,9,3,17,2,0,Matches
138,Hákon Arnar Haraldsson,ISL,"FW,MF",Lille,Ligue 1,20,2003,14.3,12,8,4,7,1,5,21,23.8,16,7,2,5,3,15,5,0,Matches
139,Marko Arnautović,AUT,FW,Inter,Serie A,34,1989,8.9,10,4,3,5,2,4,7,57.1,3,8,1,7,5,15,5,0,Matches
140,Maximilian Arnold,GER,MF,Wolfsburg,Bundesliga,29,1994,27.8,51,31,15,27,9,28,57,49.1,29,23,4,19,24,75,60,0,Matches
141,Mohamed El Arouch,FRA,FW,Lyon,Ligue 1,19,2004,0.0,0,0,0,0,0,0,0,,0,0,0,0,0,0,0,0,Matches
142,Sergio Arribas,ESP,"MF,FW",Almería,La Liga,21,2001,22.7,34,17,16,17,1,14,31,45.2,17,20,1,19,16,50,8,1,Matches
143,Kepa Arrizabalaga,ESP,GK,Real Madrid,La Liga,28,1994,13.3,0,0,0,0,0,0,1,0.0,1,0,0,0,0,0,4,0,Matches
144,Arthur,BRA,DF,Leverkusen,Bundesliga,20,2003,2.0,4,3,2,0,2,2,2,100.0,0,1,1,0,0,4,7,0,Matches
145,Takuma Asano,JPN,"FW,MF",Bochum,Bundesliga,28,1994,22.1,17,6,2,9,6,7,23,30.4,16,17,3,14,4,21,11,0,Matches
146,Marco Asensio,ESP,"MF,FW",Paris S-G,Ligue 1,27,1996,12.4,12,10,4,7,1,4,13,30.8,9,7,0,7,5,17,2,0,Matches
147,Kristjan Asllani,ALB,MF,Inter,Serie A,21,2002,8.7,7,2,3,4,0,2,11,18.2,9,9,3,6,11,18,8,0,Matches
148,Joel Asoro,SWE,"FW,MF",Metz,Ligue 1,24,1999,9.4,13,9,7,6,0,3,10,30.0,7,7,1,6,6,19,9,0,Matches
149,Jonathan Asp Jensen,DEN,FW,Bayern Munich,Bundesliga,17,2006,0.0,0,0,0,0,0,0,0,,0,0,0,0,0,0,1,0,Matches
150,Iago Aspas,ESP,FW,Celta Vigo,La Liga,35,1987,30.1,11,6,4,6,1,1,15,6.7,14,23,3,20,10,21,8,0,Matches
151,Lorenz Assignon,TOG,DF,Burnley,Premier League,23,2000,13.7,35,17,18,13,4,14,27,51.9,13,22,7,15,19,54,43,1,Matches
152,Lorenz Assignon,TOG,DF,Rennes,Ligue 1,23,2000,11.2,24,12,12,8,4,9,24,37.5,15,9,4,5,9,33,27,1,Matches
153,Youcef Atal,ALG,DF,Nice,Ligue 1,27,1996,4.0,9,3,6,2,1,6,8,75.0,2,7,1,6,4,13,1,0,Matches
154,Valentin Atangana Edoa,FRA,MF,Reims,Ligue 1,17,2005,6.2,19,13,6,9,4,5,13,38.5,8,5,1,4,6,25,9,0,Matches
155,Arthur Atta,FRA,"MF,FW",Metz,Ligue 1,20,2003,10.3,18,14,8,7,3,8,19,42.1,11,13,3,10,10,28,23,0,Matches
156,Noah Atubolu,GER,GK,Freiburg,Bundesliga,21,2002,34.0,0,0,0,0,0,0,1,0.0,1,0,0,0,0,0,8,1,Matches
157,Pierre-Emerick Aubameyang,GAB,FW,Marseille,Ligue 1,34,1989,29.1,22,14,4,11,7,7,26,26.9,19,30,5,25,9,31,26,0,Matches
158,Emil Audero,ITA,GK,Inter,Serie A,26,1997,3.7,0,0,0,0,0,0,0,,0,0,0,0,0,0,1,0,Matches
159,Tommaso Augello,ITA,DF,Cagliari,Serie A,28,1994,26.9,26,19,18,6,2,16,25,64.0,9,21,10,11,17,43,89,0,Matches
160,Carlos Augusto,BRA,DF,Inter,Serie A,24,1999,19.2,29,21,20,9,0,15,22,68.2,7,20,8,12,16,45,52,0,Matches
161,Yann Aurel Bisseck,GER,DF,Inter,Serie A,22,2000,10.0,14,6,10,3,1,6,9,66.7,3,10,7,3,5,19,23,0,Matches
162,Serge Aurier,CIV,"DF,MF",Nott'ham Forest,Premier League,30,1992,9.3,20,14,9,11,0,5,11,45.5,6,10,3,7,9,29,36,1,Matches
163,Ezequiel Ávila,ARG,"FW,MF",Osasuna,La Liga,29,1994,9.6,3,2,1,1,1,3,11,27.3,8,14,0,14,4,7,8,0,Matches
164,Ezequiel Ávila,ARG,FW,Betis,La Liga,29,1994,3.3,2,1,0,2,0,1,3,33.3,2,2,0,2,1,3,4,0,Matches
165,Taiwo Awoniyi,NGA,FW,Nott'ham Forest,Premier League,25,1997,11.6,9,7,1,4,4,1,2,50.0,1,7,2,5,1,10,9,0,Matches
166,André Ayew,GHA,FW,Le Havre,Ligue 1,33,1989,12.3,15,11,7,6,2,6,9,66.7,3,8,3,5,2,17,11,0,Matches
167,Jordan Ayew,GHA,"FW,MF",Crystal Palace,Premier League,31,1991,28.3,65,36,23,28,14,21,42,50.0,21,43,2,41,16,81,15,0,Matches
168,Neil El Aynaoui,FRA,MF,Lens,Ligue 1,22,2001,17.4,37,20,13,20,4,20,46,43.5,26,20,6,14,32,69,21,1,Matches
169,Sardar Azmoun,IRN,"FW,MF",Roma,Serie A,28,1995,6.5,8,5,2,5,1,4,8,50.0,4,4,1,3,3,11,6,1,Matches
170,César Azpilicueta,ESP,DF,Atlético Madrid,La Liga,33,1989,15.8,25,14,15,9,1,12,19,63.2,7,25,6,19,16,41,46,0,Matches
171,Paulo Azzi,BRA,"DF,MF",Cagliari,Serie A,29,1994,10.6,19,11,10,6,3,9,18,50.0,9,11,2,9,16,35,23,0,Matches
172,Oussama El Azzouzi,MAR,MF,Bologna,Serie A,22,2001,6.1,12,7,4,5,3,7,14,50.0,7,8,2,6,6,18,12,0,Matches
173,Abdellah Baallal,MAR,MF,Clermont Foot,Ligue 1,18,2004,0.0,0,0,0,0,0,0,0,,0,1,0,1,0,0,0,0,Matches
174,Iddrisu Baba,GHA,MF,Almería,La Liga,27,1996,15.9,46,26,27,18,1,17,39,43.6,22,20,6,14,11,57,27,2,Matches
175,Srđan Babić,SRB,DF,Almería,La Liga,27,1996,1.0,2,2,0,2,0,1,1,100.0,0,1,1,0,0,2,2,0,Matches
176,Shavy Babicka,GAB,"FW,MF",Toulouse,Ligue 1,23,2000,4.1,11,8,2,7,2,2,5,40.0,3,6,1,5,0,11,2,0,Matches
177,Loïc Bade,FRA,DF,Sevilla,La Liga,23,2000,25.3,65,41,53,12,0,30,49,61.2,19,23,15,8,38,103,116,2,Matches
178,Milan Badelj,CRO,MF,Genoa,Serie A,34,1989,28.2,51,27,23,24,4,24,61,39.3,37,45,13,32,50,101,54,1,Matches
179,Matthias Bader,GER,"DF,MF",Darmstadt 98,Bundesliga,26,1997,20.0,51,25,32,11,8,33,65,50.8,32,22,4,18,25,76,20,0,Matches
180,Benoît Badiashile,FRA,DF,Chelsea,Premier League,22,2001,14.9,21,15,12,9,0,9,14,64.3,5,21,14,7,18,39,66,2,Matches
181,Alex Baena,ESP,"MF,FW",Villarreal,La Liga,22,2001,28.7,34,21,10,16,8,20,47,42.6,27,23,2,21,13,47,17,1,Matches
182,Jaime Báez,URU,"FW,MF",Frosinone,Serie A,28,1995,5.6,4,1,0,2,2,0,7,0.0,7,5,0,5,4,8,1,0,Matches
183,Nicola Bagnolini,ITA,GK,Bologna,Serie A,19,2004,0.1,0,0,0,0,0,0,0,,0,0,0,0,0,0,0,0,Matches
184,Leon Bailey,JAM,"MF,FW",Aston Villa,Premier League,25,1997,23.0,13,7,7,4,2,5,20,25.0,15,18,1,17,9,22,6,0,Matches
185,Eric Bailly,CIV,DF,Villarreal,La Liga,29,1994,9.3,5,3,4,1,0,2,2,100.0,0,8,8,0,9,14,38,2,Matches
186,Stefan Bajcetic,ESP,MF,Liverpool,Premier League,18,2004,0.3,4,1,3,1,0,3,5,60.0,2,0,0,0,0,4,0,0,Matches
187,Nedim Bajrami,ALB,"MF,FW",Sassuolo,Serie A,24,1999,14.6,13,6,6,3,4,5,13,38.5,8,5,1,4,6,19,8,0,Matches
188,Cédric Bakambu,COD,FW,Betis,La Liga,32,1991,2.2,1,0,0,1,0,0,0,,0,2,0,2,0,1,0,0,Matches
189,Tiemoué Bakayoko,FRA,MF,Lorient,Ligue 1,28,1994,14.6,34,17,14,17,3,15,28,53.6,13,10,4,6,26,60,15,1,Matches
190,Mitchel Bakker,NED,DF,Atalanta,Serie A,23,2000,4.2,7,3,6,1,0,2,12,16.7,10,5,0,5,3,10,6,0,Matches
191,Ridle Baku,GER,"DF,MF",Wolfsburg,Bundesliga,25,1998,22.4,37,20,24,7,6,21,46,45.7,25,27,1,26,21,58,45,1,Matches
192,Dilane Bakwa,FRA,"FW,MF",Strasbourg,Ligue 1,20,2002,24.2,30,22,12,13,5,11,40,27.5,29,26,1,25,20,50,11,0,Matches
193,Tommaso Baldanzi,ITA,"MF,FW",Empoli,Serie A,20,2003,8.3,4,2,1,1,2,3,10,30.0,7,7,0,7,2,6,0,0,Matches
194,Tommaso Baldanzi,ITA,"FW,MF",Roma,Serie A,20,2003,5.8,9,5,3,4,2,1,1,100.0,0,2,0,2,0,9,4,0,Matches
195,Alejandro Balde,ESP,DF,Barcelona,La Liga,19,2003,15.3,20,11,11,6,3,7,11,63.6,4,14,1,13,5,25,21,1,Matches
196,Aliou Baldé,GUI,"FW,DF",Nice,Ligue 1,20,2002,0.8,4,1,0,3,1,1,1,100.0,0,2,1,1,3,7,0,0,Matches
197,George Baldock,GRE,DF,Sheffield Utd,Premier League,30,1993,10.8,18,10,10,7,1,6,15,40.0,9,14,8,6,10,28,33,0,Matches
198,Carlos Baleba,CMR,MF,Brighton,Premier League,19,2004,14.7,40,20,17,19,4,23,46,50.0,23,35,7,28,18,58,30,3,Matches
199,Carlos Baleba,CMR,MF,Lille,Ligue 1,19,2004,0.7,6,2,1,4,1,3,4,75.0,1,0,0,0,2,8,0,0,Matches
200,Leonardo Balerdi,ARG,DF,Marseille,Ligue 1,24,1999,25.2,79,50,55,23,1,49,67,73.1,18,38,15,23,51,130,91,0,Matches
201,Iván Balliu,ALB,DF,Rayo Vallecano,La Liga,31,1992,31.9,44,31,20,24,0,22,39,56.4,17,27,11,16,29,73,66,1,Matches
202,Fodé Ballo-Touré,SEN,"DF,MF",Fulham,Premier League,26,1997,0.8,4,2,1,3,0,1,2,50.0,1,1,0,1,3,7,2,0,Matches
203,Folarin Balogun,USA,FW,Monaco,Ligue 1,22,2001,18.8,12,4,3,8,1,5,13,38.5,8,10,0,10,3,15,4,0,Matches
204,Jonathan Bamba,CIV,"MF,FW",Celta Vigo,La Liga,27,1996,22.0,14,9,4,8,2,2,17,11.8,15,20,0,20,18,32,12,0,Matches
205,Mohamed Bamba,CIV,FW,Lorient,Ligue 1,21,2001,12.6,14,9,3,8,3,4,10,40.0,6,7,1,6,2,16,3,0,Matches
206,Samuel Bamba,GER,FW,Dortmund,Bundesliga,19,2004,0.5,1,1,1,0,0,1,2,50.0,1,0,0,0,0,1,1,0,Matches
207,Lameck Banda,ZAM,FW,Lecce,Serie A,22,2001,15.0,27,23,11,12,4,7,21,33.3,14,18,0,18,3,30,7,0,Matches
208,Daniel Bandeira,POR,MF,Hellas Verona,Serie A,23,2000,5.0,6,5,1,4,1,3,7,42.9,4,3,0,3,3,9,9,0,Matches
209,Mamady Bangré,BFA,"FW,MF",Toulouse,Ligue 1,22,2001,1.1,4,2,2,2,0,3,4,75.0,1,0,0,0,4,8,3,0,Matches
210,Mattia Bani,ITA,DF,Genoa,Serie A,29,1993,25.6,26,10,18,7,1,11,22,50.0,11,51,31,20,22,48,116,1,Matches
211,Léo Baptistão,BRA,FW,Almería,La Liga,30,1992,20.4,25,16,12,8,5,9,25,36.0,16,13,1,12,11,36,22,0,Matches
212,Shandon Baptiste,GRN,MF,Brentford,Premier League,25,1998,2.5,4,4,2,2,0,1,5,20.0,4,5,1,4,3,7,6,0,Matches
213,Antonín Barák,CZE,"MF,FW",Fiorentina,Serie A,28,1994,9.0,6,2,1,3,2,3,7,42.9,4,5,0,5,2,8,4,0,Matches
214,Valentín Barco,ARG,"DF,FW",Brighton,Premier League,19,2004,3.4,11,5,4,5,2,6,8,75.0,2,3,0,3,4,15,3,1,Matches
215,Bradley Barcola,FRA,FW,Lyon,Ligue 1,20,2002,3.0,5,2,0,2,3,1,7,14.3,6,4,0,4,2,7,0,0,Matches
216,Bradley Barcola,FRA,"FW,MF",Paris S-G,Ligue 1,20,2002,15.2,34,16,12,13,9,7,25,28.0,18,27,2,25,10,44,13,1,Matches
217,Melvin Bard,FRA,DF,Nice,Ligue 1,22,2000,29.5,69,38,28,30,11,37,63,58.7,26,46,12,34,42,111,46,0,Matches
218,Nicolò Barella,ITA,MF,Inter,Serie A,26,1997,31.6,46,30,17,20,9,19,63,30.2,44,31,1,30,10,56,12,1,Matches
219,Kike Barja,ESP,"FW,MF",Osasuna,La Liga,26,1997,3.4,6,2,2,2,2,3,8,37.5,5,2,1,1,2,8,2,0,Matches
220,Ross Barkley,ENG,MF,Luton Town,Premier League,29,1993,29.1,47,19,16,21,10,11,48,22.9,37,25,9,16,25,72,51,2,Matches
221,Aymen Barkok,MAR,"MF,FW",Mainz 05,Bundesliga,25,1998,3.6,9,5,2,6,1,3,6,50.0,3,7,0,7,2,11,1,0,Matches
222,Harvey Barnes,ENG,"FW,MF",Newcastle Utd,Premier League,25,1997,8.9,6,1,3,2,1,1,2,50.0,1,1,0,1,5,11,3,0,Matches
223,Leandro Barreiro Martins,LUX,MF,Mainz 05,Bundesliga,23,2000,29.0,65,40,19,37,9,30,50,60.0,20,45,16,29,36,101,53,0,Matches
224,Enzo Barrenechea,ARG,MF,Frosinone,Serie A,22,2001,31.2,65,42,28,29,8,28,70,40.0,42,47,12,35,27,92,61,2,Matches
225,Ander Barrenetxea,ESP,"FW,MF",Real Sociedad,La Liga,21,2001,15.9,32,21,7,16,9,10,26,38.5,16,18,1,17,6,38,5,0,Matches
226,Pablo Barrios,ESP,MF,Atlético Madrid,La Liga,20,2003,17.3,45,25,15,29,1,19,40,47.5,21,20,3,17,28,73,24,2,Matches
227,Davide Bartesaghi,ITA,"DF,MF",Milan,Serie A,17,2005,0.9,2,0,1,1,0,2,4,50.0,2,1,1,0,0,2,7,0,Matches
228,Marc Bartra,ESP,DF,Betis,La Liga,32,1991,2.5,4,3,3,1,0,4,5,80.0,1,3,1,2,3,7,10,0,Matches
229,Federico Baschirotto,ITA,DF,Lecce,Serie A,26,1996,36.6,21,12,16,5,0,8,15,53.3,7,42,26,16,23,44,144,1,Matches
230,Steven Baseya,FRA,DF,Strasbourg,Ligue 1,18,2005,0.1,2,1,1,1,0,1,1,100.0,0,0,0,0,0,2,1,0,Matches
231,Chris Basham,ENG,"DF,MF",Sheffield Utd,Premier League,35,1988,3.6,7,2,4,3,0,2,9,22.2,7,9,4,5,5,12,17,0,Matches
232,Toma Bašić,CRO,MF,Salernitana,Serie A,26,1996,12.9,20,13,10,9,1,10,27,37.0,17,18,6,12,14,34,29,0,Matches
233,Calvin Bassey,NGA,DF,Fulham,Premier League,23,1999,25.6,49,29,33,15,1,21,29,72.4,8,32,11,21,28,77,84,4,Matches
234,Alessandro Bastoni,ITA,DF,Inter,Serie A,24,1999,25.2,46,33,31,12,3,26,40,65.0,14,25,11,14,23,69,48,1,Matches
235,Simone Bastoni,ITA,"MF,DF",Empoli,Serie A,26,1996,8.3,22,13,12,7,3,11,22,50.0,11,8,0,8,11,33,18,0,Matches
236,Augusto Batalla,ARG,GK,Granada,La Liga,27,1996,17.0,0,0,0,0,0,0,1,0.0,1,0,0,0,0,0,10,2,Matches
237,Daniel Batz,GER,GK,Mainz 05,Bundesliga,32,1991,4.0,0,0,0,0,0,0,0,,0,0,0,0,0,0,3,0,Matches
238,Maximilian Bauer,GER,DF,Augsburg,Bundesliga,23,2000,9.0,19,12,13,4,2,9,17,52.9,8,14,8,6,11,30,30,1,Matches
239,Elias Baum,GER,"DF,MF",Eint Frankfurt,Bundesliga,17,2005,0.3,1,0,0,0,1,0,0,,0,3,2,1,0,1,1,0,Matches
240,Oliver Baumann,GER,GK,Hoffenheim,Bundesliga,33,1990,34.0,1,1,1,0,0,1,2,50.0,1,0,0,0,0,1,19,2,Matches
241,Christoph Baumgartner,AUT,"MF,FW",RB Leipzig,Bundesliga,23,1999,12.9,26,13,10,12,4,14,38,36.8,24,20,1,19,5,31,14,0,Matches
242,Bebé,CPV,"MF,FW",Rayo Vallecano,La Liga,33,1990,2.4,2,2,1,1,0,1,5,20.0,4,1,0,1,0,2,0,0,Matches
243,Ihlas Bebou,TOG,"FW,DF",Hoffenheim,Bundesliga,29,1994,18.2,22,12,10,8,4,8,16,50.0,8,13,2,11,14,36,15,0,Matches
244,Mohamed Bechikh,FRA,"FW,MF",Strasbourg,Ligue 1,18,2005,0.2,0,0,0,0,0,0,0,,0,0,0,0,0,0,0,0,Matches
245,Adrian Beck,GER,"MF,FW",Heidenheim,Bundesliga,26,1997,10.8,22,13,8,12,2,9,24,37.5,15,17,0,17,4,26,15,0,Matches
246,Owen Beck,WAL,DF,Liverpool,Premier League,20,2002,0.1,2,1,1,1,0,0,0,,0,0,0,0,0,2,1,0,Matches
247,Sheraldo Becker,SUR,"FW,MF",Real Sociedad,La Liga,28,1995,8.6,2,2,0,2,0,0,1,0.0,1,3,0,3,1,3,0,0,Matches
248,Sheraldo Becker,SUR,"FW,MF",Union Berlin,Bundesliga,28,1995,7.2,3,3,0,2,1,0,2,0.0,2,2,0,2,0,3,2,0,Matches
249,Chris Bedia,CIV,"FW,MF",Union Berlin,Bundesliga,27,1996,1.6,2,1,0,2,0,0,1,0.0,1,3,0,3,0,2,2,0,Matches
250,Donny van de Beek,NED,DF,Manchester Utd,Premier League,26,1997,0.0,0,0,0,0,0,0,0,,0,1,0,1,0,0,0,0,Matches
251,Donny van de Beek,NED,"MF,FW",Eint Frankfurt,Bundesliga,26,1997,4.0,8,3,3,3,2,3,7,42.9,4,5,1,4,3,11,1,0,Matches
252,Yanis Begraoui,MAR,"FW,MF",Toulouse,Ligue 1,22,2001,3.3,5,3,1,3,1,3,9,33.3,6,4,0,4,5,10,5,0,Matches
253,Kevin Behrens,GER,FW,Wolfsburg,Bundesliga,32,1991,6.8,2,1,0,1,1,0,2,0.0,2,9,0,9,3,5,6,0,Matches
254,Kevin Behrens,GER,FW,Union Berlin,Bundesliga,32,1991,14.0,13,10,3,7,3,1,4,25.0,3,7,2,5,6,19,19,0,Matches
255,Maximilian Beier,GER,"FW,MF",Hoffenheim,Bundesliga,20,2002,26.9,20,12,5,11,4,4,19,21.1,15,21,1,20,9,29,12,0,Matches
256,Jérémie Bela,ANG,"MF,FW",Clermont Foot,Ligue 1,30,1993,2.3,1,1,0,1,0,1,3,33.3,2,1,0,1,0,1,1,0,Matches
257,Reda Belahyane,FRA,MF,Hellas Verona,Serie A,19,2004,1.0,1,1,0,1,0,1,1,100.0,0,0,0,0,1,2,0,0,Matches
258,Reda Belahyane,FRA,MF,Nice,Ligue 1,19,2004,0.3,1,0,0,1,0,1,1,100.0,0,0,0,0,0,1,0,0,Matches
259,Amari'i Bell,JAM,DF,Luton Town,Premier League,29,1994,19.1,50,33,30,19,1,22,35,62.9,13,33,15,18,25,75,60,1,Matches
260,Stefan Bell,GER,DF,Mainz 05,Bundesliga,31,1991,7.4,8,8,7,1,0,4,8,50.0,4,7,5,2,6,14,30,0,Matches
261,Alaa Bellaarouch,MAR,GK,Strasbourg,Ligue 1,21,2002,15.0,0,0,0,0,0,0,0,,0,0,0,0,1,1,11,2,Matches
262,Raoul Bellanova,ITA,DF,Torino,Serie A,23,2000,33.8,36,26,15,17,4,18,31,58.1,13,21,4,17,15,51,36,3,Matches
263,Jean-Ricner Bellegarde,FRA,"MF,FW",Wolves,Premier League,25,1998,10.6,17,10,9,6,2,7,15,46.7,8,18,2,16,8,25,14,0,Matches
264,Jean-Ricner Bellegarde,FRA,"MF,FW",Strasbourg,Ligue 1,25,1998,3.0,5,3,3,2,0,3,6,50.0,3,4,0,4,4,9,0,0,Matches
265,Héctor Bellerín,ESP,DF,Betis,La Liga,28,1995,19.0,34,22,14,16,4,20,53,37.7,33,13,5,8,22,56,40,1,Matches
266,Jude Bellingham,ENG,MF,Real Madrid,La Liga,20,2003,25.7,42,34,14,18,10,12,36,33.3,24,55,5,50,21,63,17,0,Matches
267,Jeanuël Belocian,FRA,DF,Rennes,Ligue 1,18,2005,16.1,32,22,23,8,1,22,28,78.6,6,18,10,8,13,45,49,0,Matches
268,Andrea Belotti,ITA,FW,Fiorentina,Serie A,29,1993,10.5,8,3,1,5,2,5,12,41.7,7,8,1,7,2,10,3,0,Matches
269,Andrea Belotti,ITA,FW,Roma,Serie A,29,1993,7.5,8,4,2,3,3,3,6,50.0,3,7,0,7,2,10,3,0,Matches
270,Fran Beltrán,ESP,MF,Celta Vigo,La Liga,24,1999,27.0,56,32,22,23,11,24,63,38.1,39,28,2,26,18,74,34,0,Matches
271,Lucas Beltrán,ARG,"FW,MF",Fiorentina,Serie A,22,2001,18.8,27,14,4,18,5,11,20,55.0,9,29,3,26,2,29,11,0,Matches
272,Eliesse Ben Seghir,MAR,"MF,FW",Monaco,Ligue 1,18,2005,4.8,9,6,2,5,2,3,7,42.9,4,6,0,6,2,11,2,0,Matches
273,Anis Ben Slimane,TUN,MF,Sheffield Utd,Premier League,22,2001,4.7,11,6,5,2,4,4,10,40.0,6,7,1,6,5,16,7,0,Matches
274,Wissam Ben Yedder,FRA,FW,Monaco,Ligue 1,32,1990,25.7,4,3,1,2,1,1,11,9.1,10,18,0,18,8,12,1,0,Matches
275,Carlos Benavídez,URU,MF,Alavés,La Liga,25,1998,12.6,56,35,19,26,11,19,34,55.9,15,13,5,8,19,75,31,0,Matches
276,Ismaël Bennacer,ALG,MF,Milan,Serie A,25,1997,12.8,29,19,11,16,2,11,22,50.0,11,12,4,8,12,41,9,2,Matches
277,Saïd Benrahma,ALG,"FW,MF",West Ham,Premier League,27,1995,6.9,8,4,5,3,0,4,15,26.7,11,8,0,8,5,13,7,0,Matches
278,Saïd Benrahma,ALG,"FW,MF",Lyon,Ligue 1,27,1995,8.6,9,7,1,6,2,5,7,71.4,2,7,0,7,1,10,3,0,Matches
279,Ramy Bensebaini,ALG,DF,Dortmund,Bundesliga,28,1995,11.5,34,21,21,11,2,24,34,70.6,10,22,7,15,16,50,37,0,Matches
280,Nabil Bentaleb,ALG,MF,Lille,Ligue 1,28,1994,21.9,49,32,29,18,2,22,43,51.2,21,33,12,21,37,86,33,0,Matches
281,Rodrigo Bentancur,URU,MF,Tottenham,Premier League,26,1997,11.2,23,15,10,11,2,10,24,41.7,14,15,4,11,17,40,16,1,Matches
282,Daniel Bentley,ENG,GK,Wolves,Premier League,30,1993,4.3,0,0,0,0,0,0,1,0.0,1,0,0,0,0,0,1,0,Matches
283,Lucas Beraldo,BRA,DF,Paris S-G,Ligue 1,19,2003,11.2,22,14,14,8,0,10,25,40.0,15,15,6,9,20,42,25,0,Matches
284,Domenico Berardi,ITA,FW,Sassuolo,Serie A,28,1994,15.9,17,8,7,9,1,2,21,9.5,19,17,0,17,13,30,9,0,Matches
285,Yuri Berchiche,ESP,DF,Athletic Club,La Liga,33,1990,21.4,33,25,13,14,6,19,33,57.6,14,28,9,19,20,53,62,0,Matches
286,Álex Berenguer,ESP,FW,Athletic Club,La Liga,28,1995,17.7,23,14,9,9,5,7,24,29.2,17,23,0,23,5,28,13,0,Matches
287,Bartosz Bereszyński,POL,DF,Empoli,Serie A,31,1992,19.6,41,25,25,13,3,24,40,60.0,16,22,10,12,21,62,52,0,Matches
288,Jóhann Berg Guðmundsson,ISL,"MF,FW",Burnley,Premier League,32,1990,13.2,13,4,6,5,2,7,16,43.8,9,14,0,14,16,29,16,0,Matches
289,Sander Berge,NOR,MF,Burnley,Premier League,25,1998,33.4,76,46,35,36,5,34,58,58.6,24,49,20,29,23,99,60,2,Matches
290,Etrit Berisha,ALB,GK,Empoli,Serie A,34,1989,14.0,0,0,0,0,0,0,1,0.0,1,0,0,0,0,0,7,1,Matches
291,Medon Berisha,ALB,"FW,MF",Lecce,Serie A,19,2003,2.3,3,1,3,0,0,0,2,0.0,2,2,2,0,1,4,0,0,Matches
292,Mergim Berisha,GER,FW,Hoffenheim,Bundesliga,25,1998,1.6,0,0,0,0,0,0,0,,0,2,1,1,0,0,0,0,Matches
293,Mergim Berisha,GER,FW,Augsburg,Bundesliga,25,1998,1.4,0,0,0,0,0,0,0,,0,1,0,1,0,0,3,0,Matches
294,Bernardo,BRA,DF,Bochum,Bundesliga,28,1995,32.5,99,58,56,35,8,45,69,65.2,24,66,30,36,55,154,120,1,Matches
295,Victor Bernth Kristiansen,DEN,DF,Bologna,Serie A,20,2002,25.6,52,34,23,22,7,20,35,57.1,15,35,8,27,12,64,45,1,Matches
296,Matúš Bero,SVK,"MF,FW",Bochum,Bundesliga,27,1995,18.5,32,22,13,12,7,13,32,40.6,19,24,3,21,12,44,26,0,Matches
297,Luke Berry,ENG,"MF,DF",Luton Town,Premier League,31,1992,3.6,7,2,2,4,1,2,3,66.7,1,6,1,5,0,7,3,0,Matches
298,Dimitry Bertaud,COD,GK,Montpellier,Ligue 1,25,1998,4.0,0,0,0,0,0,0,0,,0,0,0,0,0,0,0,0,Matches
299,Jan-Niklas Beste,GER,"FW,MF",Heidenheim,Bundesliga,24,1999,28.9,77,49,35,24,18,28,55,50.9,27,48,1,47,18,95,31,0,Matches
300,Beto,GNB,FW,Everton,Premier League,25,1998,10.6,14,6,1,6,7,4,12,33.3,8,11,0,11,1,15,14,0,Matches
301,Beto,GNB,FW,Udinese,Serie A,25,1998,0.8,1,0,0,0,1,0,0,,0,0,0,0,0,1,0,0,Matches
302,Davide Bettella,ITA,MF,Monza,Serie A,23,2000,0.0,0,0,0,0,0,0,0,,0,0,0,0,0,0,0,0,Matches
303,Sam Beukema,NED,DF,Bologna,Serie A,24,1998,28.3,27,11,14,11,2,16,25,64.0,9,35,21,14,15,42,99,2,Matches
304,Jordan Beyer,GER,DF,Burnley,Premier League,23,2000,13.7,35,20,22,12,1,14,24,58.3,10,22,15,7,16,51,68,1,Matches
305,Pep Biel,ESP,"MF,FW",Augsburg,Bundesliga,26,1996,3.2,4,3,0,2,2,1,3,33.3,2,2,1,1,2,6,2,0,Matches
306,Jaka Bijol,SVN,DF,Udinese,Serie A,24,1999,23.2,43,27,34,9,0,22,35,62.9,13,36,21,15,23,66,140,1,Matches
307,El Bilal Touré,MLI,FW,Atalanta,Serie A,21,2001,4.4,1,1,0,1,0,0,1,0.0,1,0,0,0,1,2,2,0,Matches
308,Philip Billing,DEN,MF,Bournemouth,Premier League,27,1996,15.5,33,16,7,22,4,9,27,33.3,18,31,5,26,20,53,28,1,Matches
309,Cristiano Biraghi,ITA,DF,Fiorentina,Serie A,30,1992,26.2,47,28,20,24,3,28,52,53.8,24,30,5,25,14,61,43,0,Matches
310,Davide Biraschi,ITA,DF,Genoa,Serie A,29,1994,1.0,3,3,1,2,0,1,3,33.3,2,0,0,0,2,5,5,0,Matches
311,Samuele Birindelli,ITA,DF,Monza,Serie A,24,1999,22.4,28,19,16,7,5,14,25,56.0,11,30,11,19,18,46,48,0,Matches
312,Tom Bischof,GER,"MF,FW",Hoffenheim,Bundesliga,18,2005,2.0,8,4,6,1,1,2,9,22.2,7,3,0,3,1,9,2,0,Matches
313,Yves Bissouma,MLI,MF,Tottenham,Premier League,26,1996,23.0,80,52,32,36,12,41,61,67.2,20,28,5,23,37,117,43,3,Matches
314,Leonardo Bittencourt,GER,MF,Werder Bremen,Bundesliga,29,1993,17.5,42,18,20,17,5,15,39,38.5,24,18,1,17,13,55,6,0,Matches
315,Marco Bizot,NED,GK,Brest,Ligue 1,32,1991,32.0,0,0,0,0,0,0,1,0.0,1,0,0,0,0,0,18,3,Matches
316,Antonio Blanco,ESP,MF,Alavés,La Liga,23,2000,27.0,61,36,29,27,5,31,86,36.0,55,25,2,23,35,96,30,0,Matches
317,Rubén Blanco,ESP,GK,Marseille,Ligue 1,28,1995,1.3,0,0,0,0,0,0,0,,0,0,0,0,0,0,0,0,Matches
318,Hendry Blank,GER,DF,Dortmund,Bundesliga,18,2004,0.5,1,0,1,0,0,1,1,100.0,0,1,0,1,0,1,4,0,Matches
319,Ludovic Blas,FRA,"FW,MF",Rennes,Ligue 1,25,1997,17.4,30,14,16,13,1,12,28,42.9,16,13,1,12,6,36,9,0,Matches
320,Janis Blaswich,GER,GK,RB Leipzig,Bundesliga,32,1991,21.0,1,1,1,0,0,0,0,,0,0,0,0,0,1,7,3,Matches
321,Alexis Blin,FRA,MF,Lecce,Serie A,26,1996,18.2,33,19,11,19,3,15,43,34.9,28,16,2,14,22,55,39,0,Matches
322,Daley Blind,NED,DF,Girona,La Liga,33,1990,33.0,47,21,33,13,1,29,47,61.7,18,37,19,18,21,68,113,0,Matches
323,Myron Boadu,NED,FW,Monaco,Ligue 1,22,2001,0.9,2,2,0,1,1,1,2,50.0,1,2,0,2,0,2,0,0,Matches
324,Benicio Boaitey,ENG,"FW,DF",Brighton,Premier League,19,2004,0.4,0,0,0,0,0,0,1,0.0,1,1,0,1,0,0,2,0,Matches
325,Jérôme Boateng,GER,DF,Salernitana,Serie A,34,1988,2.6,0,0,0,0,0,0,0,,0,6,5,1,4,4,21,0,Matches
326,Oscar Bobb,NOR,"FW,MF",Manchester City,Premier League,20,2003,3.4,7,3,1,2,4,2,4,50.0,2,4,0,4,5,12,1,0,Matches
327,Sacha Boey,FRA,DF,Bayern Munich,Bundesliga,22,2000,1.2,2,0,2,0,0,1,2,50.0,1,1,0,1,1,3,2,0,Matches
328,Jeremie Boga,CIV,FW,Nice,Ligue 1,26,1997,22.2,18,7,6,10,2,10,20,50.0,10,26,2,24,8,26,4,0,Matches
329,Jayden Bogle,ENG,DF,Sheffield Utd,Premier League,23,2000,31.0,66,36,43,21,2,35,70,50.0,35,42,11,31,32,98,97,0,Matches
330,Emil Bohinen,NOR,MF,Genoa,Serie A,24,1999,0.6,1,1,0,1,0,0,0,,0,1,0,1,0,1,3,0,Matches
331,Emil Bohinen,NOR,MF,Salernitana,Serie A,24,1999,5.9,8,6,5,3,0,2,10,20.0,8,8,2,6,14,22,6,1,Matches
332,Adama Bojang,GAM,FW,Reims,Ligue 1,19,2004,0.9,2,1,1,0,1,0,0,,0,2,1,1,1,3,0,0,Matches
333,Daniel Boloca,ROU,MF,Sassuolo,Serie A,24,1998,22.5,48,33,18,25,5,27,46,58.7,19,23,13,10,14,62,33,2,Matches
334,Willy Boly,CIV,DF,Nott'ham Forest,Premier League,32,1991,16.0,46,29,36,9,1,22,40,55.0,18,32,21,11,25,71,90,0,Matches
335,Giacomo Bonaventura,ITA,MF,Fiorentina,Serie A,33,1989,25.3,26,13,6,10,10,9,21,42.9,12,16,1,15,14,40,10,0,Matches
336,Federico Bonazzoli,ITA,"FW,MF",Hellas Verona,Serie A,26,1997,11.3,4,1,1,3,0,1,8,12.5,7,9,1,8,3,7,3,0,Matches
337,Warren Bondo,FRA,MF,Monza,Serie A,19,2003,16.4,29,22,16,10,3,13,17,76.5,4,13,3,10,6,35,13,0,Matches
338,Giovanni Bonfanti,ITA,DF,Atalanta,Serie A,20,2003,1.0,4,2,2,2,0,2,3,66.7,1,1,1,0,1,5,1,0,Matches
339,Victor Boniface,NGA,FW,Leverkusen,Bundesliga,22,2000,17.2,6,4,0,1,5,1,4,25.0,3,6,1,5,0,6,13,0,Matches
340,Kevin Bonifazi,ITA,DF,Bologna,Serie A,27,1996,1.0,4,0,0,4,0,1,2,50.0,1,0,0,0,0,4,7,1,Matches
341,Kevin Bonifazi,ITA,DF,Frosinone,Serie A,27,1996,3.4,5,3,2,3,0,2,3,66.7,1,1,0,1,3,8,9,0,Matches
342,Leonardo Bonucci,ITA,DF,Union Berlin,Bundesliga,36,1987,5.1,6,5,2,4,0,4,4,100.0,0,5,3,2,7,13,16,0,Matches
343,Ângelo Borges,BRA,"FW,MF",Strasbourg,Ligue 1,18,2004,12.2,24,11,9,7,8,11,31,35.5,20,18,0,18,9,33,2,0,Matches
344,Neto Borges,BRA,DF,Clermont Foot,Ligue 1,26,1996,28.0,48,24,25,18,5,28,63,44.4,35,28,6,22,57,105,84,0,Matches
345,Yvandro Borges Sanches,LUX,"MF,FW",Gladbach,Bundesliga,19,2004,0.2,0,0,0,0,0,0,0,,0,0,0,0,0,0,0,0,Matches
346,Sebastiaan Bornauw,BEL,DF,Wolfsburg,Bundesliga,24,1999,15.9,26,12,19,7,0,13,19,68.4,6,21,12,9,18,44,81,0,Matches
347,Rafael Borré,COL,FW,Werder Bremen,Bundesliga,27,1995,11.0,10,7,2,4,4,5,16,31.3,11,8,2,6,2,12,10,0,Matches
348,Gennaro Borrelli,ITA,FW,Frosinone,Serie A,23,2000,0.3,0,0,0,0,0,0,0,,0,0,0,0,0,0,0,0,Matches
349,Adri Bosch,ESP,DF,Granada,La Liga,22,2001,0.3,1,1,1,0,0,0,0,,0,0,0,0,0,1,1,0,Matches
350,Erik Botheim,NOR,"FW,MF",Salernitana,Serie A,23,2000,3.5,2,0,2,0,0,0,1,0.0,1,3,0,3,0,2,2,0,Matches
351,Sven Botman,NED,DF,Newcastle Utd,Premier League,23,2000,15.3,20,13,14,6,0,8,13,61.5,5,20,16,4,9,29,61,3,Matches
352,Saïmon Bouabré,FRA,MF,Monaco,Ligue 1,17,2006,0.5,2,2,0,2,0,1,2,50.0,1,1,0,1,0,2,0,0,Matches
353,Ayyoub Bouaddi,FRA,MF,Lille,Ligue 1,15,2007,1.5,6,2,6,0,0,2,5,40.0,3,2,0,2,1,7,3,0,Matches
354,Badredine Bouanani,ALG,FW,Nice,Ligue 1,18,2004,1.8,3,2,1,1,1,3,4,75.0,1,5,0,5,3,6,0,0,Matches
355,Badredine Bouanani,ALG,MF,Lorient,Ligue 1,18,2004,4.9,4,2,1,1,2,2,4,50.0,2,3,0,3,2,6,3,0,Matches
356,Mohamed Bouchenna,FRA,"MF,FW",Clermont Foot,Ligue 1,17,2006,0.3,1,0,1,0,0,0,0,,0,0,0,0,0,1,0,0,Matches
357,Hicham Boudaoui,ALG,MF,Nice,Ligue 1,23,1999,17.9,41,19,16,22,3,21,30,70.0,9,15,1,14,11,52,15,0,Matches
358,Yassine Bounou,MAR,GK,Sevilla,La Liga,32,1991,1.0,0,0,0,0,0,0,0,,0,0,0,0,0,0,0,0,Matches
359,Mehdi Bourabia,MAR,MF,Frosinone,Serie A,31,1991,2.2,5,4,1,4,0,2,4,50.0,2,3,0,3,0,5,4,0,Matches
360,Benjamin Bourigeaud,FRA,"MF,FW",Rennes,Ligue 1,29,1994,26.9,31,18,14,9,8,13,44,29.5,31,31,2,29,22,53,39,2,Matches
361,Bilal Boutobba,FRA,"FW,MF",Clermont Foot,Ligue 1,24,1998,10.3,22,12,6,10,6,10,23,43.5,13,9,0,9,8,30,3,0,Matches
362,Hugo Boutsingkham,FRA,"MF,FW",Nantes,Ligue 1,20,2003,0.1,0,0,0,0,0,0,0,,0,0,0,0,0,0,1,0,Matches
363,Edoardo Bove,ITA,MF,Roma,Serie A,21,2002,19.8,60,31,16,31,13,27,46,58.7,19,21,1,20,11,71,11,1,Matches
364,Jarrod Bowen,ENG,FW,West Ham,Premier League,26,1996,33.5,42,28,14,14,14,13,35,37.1,22,37,5,32,19,61,14,0,Matches
365,Lucas Boyé,ARG,FW,Granada,La Liga,27,1996,28.2,50,25,14,25,11,14,34,41.2,20,35,5,30,10,60,46,0,Matches
366,Domagoj Bradarić,CRO,DF,Salernitana,Serie A,23,1999,30.5,29,20,13,10,6,15,25,60.0,10,22,7,15,32,61,62,1,Matches
367,Conor Bradley,NIR,DF,Liverpool,Premier League,20,2003,8.4,33,25,14,12,7,24,38,63.2,14,17,1,16,10,43,14,0,Matches
368,Bilal Brahimi,ALG,FW,Nice,Ligue 1,23,2000,0.1,0,0,0,0,0,0,1,0.0,1,0,0,0,0,0,0,0,Matches
369,Bilal Brahimi,ALG,"FW,MF",Brest,Ligue 1,23,2000,2.5,0,0,0,0,0,0,3,0.0,3,3,0,3,0,0,0,0,Matches
370,Julian Brandt,GER,"MF,FW",Dortmund,Bundesliga,27,1996,24.7,17,14,8,8,1,10,27,37.0,17,20,3,17,8,25,18,0,Matches
371,Jarrad Branthwaite,ENG,DF,Everton,Premier League,21,2002,34.6,66,32,42,22,2,45,62,72.6,17,51,36,15,50,116,163,2,Matches
372,Darko Brašanac,SRB,MF,Osasuna,La Liga,31,1992,0.5,1,0,1,0,0,1,1,100.0,0,1,0,1,0,1,0,0,Matches
373,Lilian Brassier,FRA,DF,Brest,Ligue 1,23,1999,29.7,31,18,18,13,0,12,24,50.0,12,28,21,7,41,72,93,0,Matches
374,Brau,ESP,DF,Granada,La Liga,21,2001,0.3,1,0,1,0,0,1,1,100.0,0,0,0,0,0,1,2,0,Matches
375,Claudio Bravo,CHI,GK,Betis,La Liga,40,1983,7.0,0,0,0,0,0,0,1,0.0,1,0,0,0,0,0,2,0,Matches
376,Fabian Bredlow,GER,GK,Stuttgart,Bundesliga,28,1995,4.0,0,0,0,0,0,0,1,0.0,1,0,0,0,0,0,3,0,Matches
377,Tim Breithaupt,GER,MF,Augsburg,Bundesliga,21,2002,7.0,20,11,11,9,0,13,21,61.9,8,15,3,12,8,28,10,0,Matches
378,Josip Brekalo,CRO,FW,Fiorentina,Serie A,25,1998,7.2,8,6,6,2,0,2,11,18.2,9,7,0,7,1,9,0,0,Matches
379,Gleison Bremer,BRA,DF,Juventus,Serie A,26,1997,35.9,58,42,32,21,5,21,29,72.4,8,45,27,18,40,98,147,0,Matches
380,Brenner,BRA,"MF,FW",Udinese,Serie A,23,2000,2.1,8,7,1,5,2,4,7,57.1,3,2,0,2,0,8,2,0,Matches
381,Ben Brereton,CHI,"FW,MF",Sheffield Utd,Premier League,24,1999,12.3,9,4,4,4,1,4,10,40.0,6,9,3,6,3,12,12,0,Matches
382,Ben Brereton,CHI,"FW,MF",Villarreal,La Liga,24,1999,3.0,2,2,1,0,1,0,2,0.0,2,0,0,0,0,2,0,0,Matches
383,Marco Brescianini,ITA,MF,Frosinone,Serie A,23,2000,25.8,28,13,13,12,3,9,25,36.0,16,22,5,17,10,38,37,0,Matches
384,Maximilian Breunig,GER,FW,Freiburg,Bundesliga,22,2000,0.1,0,0,0,0,0,0,0,,0,1,0,1,0,0,0,0,Matches
385,Rhian Brewster,ENG,"FW,MF",Sheffield Utd,Premier League,23,2000,3.8,5,1,1,2,2,0,2,0.0,2,2,0,2,1,6,2,0,Matches
386,Bennit Bröger,GER,FW,Wolfsburg,Bundesliga,17,2006,0.1,0,0,0,0,0,0,0,,0,0,0,0,0,0,0,0,Matches
387,Armando Broja,ALB,FW,Chelsea,Premier League,21,2001,5.0,3,0,0,1,2,1,2,50.0,1,5,1,4,0,3,3,0,Matches
388,Armando Broja,ALB,FW,Fulham,Premier League,21,2001,1.0,0,0,0,0,0,0,0,,0,1,0,1,0,0,0,0,Matches
389,Dylan Bronn,TUN,"DF,MF",Salernitana,Serie A,28,1995,0.6,0,0,0,0,0,0,1,0.0,1,2,0,2,0,0,4,0,Matches
390,Andre Brooks,ENG,"MF,DF",Sheffield Utd,Premier League,19,2003,10.4,22,13,7,11,4,9,21,42.9,12,13,1,12,14,36,20,0,Matches
391,David Brooks,WAL,"FW,MF",Bournemouth,Premier League,26,1997,3.1,5,4,2,1,2,2,4,50.0,2,3,0,3,2,7,2,0,Matches
392,John Brooks,USA,DF,Hoffenheim,Bundesliga,30,1993,17.1,28,15,17,10,1,15,30,50.0,15,29,17,12,27,55,109,1,Matches
393,Moritz Broschinski,GER,FW,Bochum,Bundesliga,22,2000,13.9,11,7,2,5,4,2,8,25.0,6,11,2,9,0,11,6,0,Matches
394,Jacob Brown,SCO,"MF,FW",Luton Town,Premier League,25,1998,11.3,19,12,7,7,5,7,18,38.9,11,20,1,19,8,27,22,0,Matches
395,Josh Brownhill,ENG,MF,Burnley,Premier League,27,1995,25.0,61,35,23,28,10,27,37,73.0,10,33,8,25,34,95,40,1,Matches
396,Alexander Brunst,GER,GK,Darmstadt 98,Bundesliga,28,1995,3.0,0,0,0,0,0,0,2,0.0,2,0,0,0,0,0,2,1,Matches
397,Jacob Bruun Larsen,DEN,"MF,FW",Burnley,Premier League,24,1998,13.9,9,4,4,3,2,7,21,33.3,14,16,2,14,7,16,23,0,Matches
398,Tajon Buchanan,CAN,DF,Inter,Serie A,24,1999,1.8,1,1,0,0,1,1,2,50.0,1,1,0,1,0,1,4,0,Matches
399,Ante Budimir,CRO,FW,Osasuna,La Liga,32,1991,27.1,21,15,2,11,8,5,14,35.7,9,19,5,14,5,26,18,0,Matches
400,Hugo Bueno,ESP,"DF,MF",Wolves,Premier League,20,2002,8.2,21,14,12,7,2,12,19,63.2,7,17,4,13,6,27,24,0,Matches
401,Manu Bueno,ESP,MF,Sevilla,La Liga,19,2004,1.3,4,2,4,0,0,3,3,100.0,0,3,0,3,0,4,1,0,Matches
402,Santiago Bueno,URU,DF,Wolves,Premier League,24,1998,9.1,13,7,5,7,1,5,11,45.5,6,22,12,10,6,19,33,0,Matches
403,Marius Bülter,GER,"DF,FW",Hoffenheim,Bundesliga,30,1993,15.0,18,11,9,5,4,12,23,52.2,11,17,3,14,10,28,20,0,Matches
404,Facundo Buonanotte,ARG,"FW,MF",Brighton,Premier League,18,2004,15.2,42,22,13,22,7,14,44,31.8,30,22,3,19,8,50,5,0,Matches
405,Alessandro Buongiorno,ITA,DF,Torino,Serie A,24,1999,28.1,70,39,43,24,3,24,34,70.6,10,20,12,8,69,139,131,0,Matches
406,Jonathan Burkardt,GER,"FW,MF",Mainz 05,Bundesliga,23,2000,17.1,12,8,2,6,4,4,11,36.4,7,16,3,13,3,15,2,0,Matches
407,Oliver Burke,SCO,FW,Werder Bremen,Bundesliga,26,1997,0.4,0,0,0,0,0,0,2,0.0,2,0,0,0,0,0,0,0,Matches
408,Reece Burke,ENG,DF,Luton Town,Premier League,26,1996,18.4,37,23,17,14,6,12,26,46.2,14,25,18,7,18,55,78,1,Matches
409,Dan Burn,ENG,DF,Newcastle Utd,Premier League,31,1992,30.3,61,33,37,20,4,26,61,42.6,35,55,25,30,37,98,124,1,Matches
410,Rareș-Cătălin Burnete,ROU,FW,Lecce,Serie A,19,2004,0.1,0,0,0,0,0,0,0,,0,0,0,0,0,0,0,0,Matches
411,Mason Burstow,ENG,FW,Chelsea,Premier League,19,2003,0.1,0,0,0,0,0,0,0,,0,0,0,0,0,0,0,0,Matches
412,Marnon Busch,GER,DF,Heidenheim,Bundesliga,28,1994,6.6,11,9,6,3,2,7,12,58.3,5,9,2,7,10,21,12,0,Matches
413,Maxime Busi,BEL,"FW,DF",Reims,Ligue 1,23,1999,1.8,2,0,0,1,1,0,2,0.0,2,6,1,5,4,6,5,0,Matches
414,Pablo Busto,ESP,DF,Betis,La Liga,17,2005,0.5,1,1,0,0,1,1,1,100.0,0,0,0,0,1,2,3,0,Matches
415,Aurélio Buta,POR,"DF,MF",Eint Frankfurt,Bundesliga,26,1997,19.4,40,25,19,16,5,21,38,55.3,17,24,5,19,15,55,36,0,Matches
416,Marcin Bułka,POL,GK,Nice,Ligue 1,23,1999,34.0,0,0,0,0,0,0,2,0.0,2,0,0,0,0,0,9,3,Matches
417,Rémy Cabella,FRA,"FW,MF",Lille,Ligue 1,33,1990,16.4,54,36,19,20,15,20,54,37.0,34,32,0,32,5,59,5,0,Matches
418,Jovane Cabral,CPV,"MF,FW",Salernitana,Serie A,25,1998,7.5,13,9,4,7,2,3,9,33.3,6,3,0,3,1,14,4,0,Matches
419,Liberato Cacace,NZL,DF,Empoli,Serie A,22,2000,21.2,40,24,24,13,3,24,38,63.2,14,23,6,17,19,59,56,0,Matches
420,Anthony Caci,FRA,DF,Mainz 05,Bundesliga,26,1997,27.6,56,23,30,25,1,27,44,61.4,17,43,7,36,32,88,45,0,Matches
421,Moisés Caicedo,ECU,MF,Chelsea,Premier League,21,2001,31.8,91,46,38,42,11,36,60,60.0,24,59,25,34,37,128,44,4,Matches
422,Tom Cairney,SCO,MF,Fulham,Premier League,32,1991,16.5,24,16,10,12,2,13,25,52.0,12,16,4,12,13,37,6,0,Matches
423,Jens Cajuste,SWE,MF,Napoli,Serie A,23,1999,11.3,36,24,13,17,6,20,37,54.1,17,20,3,17,4,40,15,0,Matches
424,Davide Calabria,ITA,DF,Milan,Serie A,26,1996,24.3,70,38,38,25,7,44,72,61.1,28,26,7,19,24,94,49,1,Matches
425,Riccardo Calafiori,ITA,DF,Bologna,Serie A,21,2002,26.1,47,32,28,16,3,22,32,68.8,10,38,13,25,50,97,74,3,Matches
426,Mattia Caldara,ITA,DF,Milan,Serie A,29,1994,0.4,1,1,1,0,0,1,1,100.0,0,1,1,0,1,2,1,0,Matches
427,Luca Caldirola,ITA,DF,Monza,Serie A,32,1991,23.8,25,14,19,4,2,13,22,59.1,9,26,17,9,29,54,53,0,Matches
428,Duje Ćaleta-Car,CRO,DF,Lyon,Ligue 1,26,1996,22.1,26,11,19,6,1,18,22,81.8,4,27,14,13,18,44,94,1,Matches
429,Hakan Çalhanoğlu,TUR,MF,Inter,Serie A,29,1994,28.4,66,33,29,29,8,32,49,65.3,17,29,13,16,24,90,22,0,Matches
430,José Callejón,ESP,"MF,FW",Granada,La Liga,36,1987,8.9,13,6,10,3,0,8,22,36.4,14,7,1,6,5,18,10,0,Matches
431,Dominic Calvert-Lewin,ENG,FW,Everton,Premier League,26,1997,24.1,13,6,2,6,5,2,15,13.3,13,14,4,10,4,17,38,0,Matches
432,Lamine Camara,SEN,MF,Metz,Ligue 1,19,2004,25.1,62,42,26,30,6,24,49,49.0,25,35,2,33,28,90,34,0,Matches
433,Mahdi Camara,FRA,MF,Brest,Ligue 1,25,1998,22.4,55,39,8,40,7,20,49,40.8,29,24,1,23,27,82,19,0,Matches
434,Mohamed Camara,MLI,MF,Monaco,Ligue 1,23,2000,11.5,35,21,10,20,5,15,29,51.7,14,8,2,6,11,46,7,0,Matches
435,Francesco Camarda,ITA,FW,Milan,Serie A,15,2008,0.2,0,0,0,0,0,0,2,0.0,2,0,0,0,0,0,0,0,Matches
436,Eduardo Camavinga,FRA,"MF,DF",Real Madrid,La Liga,20,2002,20.2,76,47,39,29,8,23,39,59.0,16,36,8,28,29,105,29,1,Matches
437,Nicolò Cambiaghi,ITA,"FW,MF",Empoli,Serie A,22,2000,28.4,51,39,15,20,16,16,35,45.7,19,26,1,25,14,65,8,0,Matches
438,Andrea Cambiaso,ITA,"DF,FW",Juventus,Serie A,23,2000,26.4,47,30,23,15,9,25,43,58.1,18,28,3,25,11,58,26,1,Matches
439,Axel Camblan,FRA,FW,Brest,Ligue 1,19,2003,1.0,3,1,0,2,1,2,4,50.0,2,2,0,2,0,3,0,0,Matches
440,Sergio Camello,ESP,FW,Rayo Vallecano,La Liga,22,2001,18.5,16,5,3,10,3,6,15,40.0,9,10,2,8,3,19,15,0,Matches
441,José Campaña,ESP,MF,Las Palmas,La Liga,30,1993,1.9,2,2,1,1,0,0,2,0.0,2,3,2,1,2,4,3,0,Matches
442,Emre Can,GER,"MF,DF",Dortmund,Bundesliga,29,1994,21.7,63,45,37,23,3,28,48,58.3,20,30,7,23,22,85,41,2,Matches
443,Matteo Cancellieri,ITA,"FW,MF",Empoli,Serie A,21,2002,19.9,35,22,12,16,7,13,36,36.1,23,19,0,19,6,41,18,0,Matches
444,João Cancelo,POR,DF,Barcelona,La Liga,29,1994,27.8,64,44,35,21,8,38,58,65.5,20,35,6,29,29,93,59,1,Matches
445,Fali Candé,GNB,DF,Metz,Ligue 1,25,1998,20.5,40,19,31,9,0,20,35,57.1,15,41,28,13,20,60,107,1,Matches
446,Antonio Candreva,ITA,"MF,FW",Salernitana,Serie A,36,1987,30.6,18,13,8,8,2,9,25,36.0,16,9,0,9,7,25,23,0,Matches
447,Thomas Cannon,IRL,FW,Everton,Premier League,20,2002,0.0,0,0,0,0,0,0,0,,0,0,0,0,0,0,0,0,Matches
448,Sergi Canós,ESP,"MF,FW",Valencia,La Liga,26,1997,13.7,23,13,7,11,5,10,24,41.7,14,14,2,12,11,34,9,0,Matches
449,Luigi Canotto,ITA,FW,Frosinone,Serie A,29,1994,0.2,0,0,0,0,0,0,0,,0,0,0,0,0,0,0,0,Matches
450,Gino Caoki,FRA,MF,Lorient,Ligue 1,19,2004,0.1,0,0,0,0,0,0,1,0.0,1,0,0,0,0,0,0,0,Matches
451,Étienne Capoue,FRA,MF,Villarreal,La Liga,35,1988,16.2,32,18,17,12,3,15,22,68.2,7,20,4,16,22,54,24,1,Matches
452,Gianluca Caprari,ITA,"MF,FW",Monza,Serie A,30,1993,3.2,2,1,1,1,0,0,1,0.0,1,0,0,0,2,4,0,0,Matches
453,Elia Caprile,ITA,GK,Empoli,Serie A,21,2001,23.0,1,0,1,0,0,1,1,100.0,0,0,0,0,0,1,16,2,Matches
454,Francesco Caputo,ITA,FW,Empoli,Serie A,35,1987,14.1,2,0,0,0,2,0,1,0.0,1,4,0,4,1,3,3,0,Matches
455,Maxence Caqueret,FRA,MF,Lyon,Ligue 1,23,2000,33.6,91,64,39,37,15,38,107,35.5,69,40,9,31,48,139,26,2,Matches
456,Andrea Carboni,ITA,DF,Monza,Serie A,22,2001,16.5,38,22,24,12,2,20,31,64.5,11,23,13,10,17,55,56,1,Matches
457,Valentin Carboni,ARG,"MF,FW",Monza,Serie A,18,2005,13.0,25,15,10,12,3,8,26,30.8,18,12,1,11,7,32,4,0,Matches
458,Isaac Carcelen,ESP,DF,Cádiz,La Liga,30,1993,29.0,50,31,30,15,5,25,45,55.6,20,24,7,17,27,77,87,2,Matches
459,Cárdenas,ESP,GK,Rayo Vallecano,La Liga,26,1997,1.0,0,0,0,0,0,0,0,,0,0,0,0,0,0,1,0,Matches
460,Irvin Cardona,FRA,"MF,DF",Augsburg,Bundesliga,25,1997,0.6,1,1,0,0,1,1,3,33.3,2,1,0,1,0,1,1,0,Matches
461,Marc Cardona,ESP,FW,Las Palmas,La Liga,28,1995,8.0,9,8,3,4,2,1,12,8.3,11,5,0,5,2,11,7,0,Matches
462,Sergi Cardona,ESP,DF,Las Palmas,La Liga,24,1999,31.3,90,55,52,29,9,55,96,57.3,41,45,7,38,46,136,102,0,Matches
463,Johnny Cardoso,USA,MF,Betis,La Liga,21,2001,14.8,48,29,19,24,5,22,33,66.7,11,20,5,15,32,80,31,0,Matches
464,Igor Carioca,BRA,"DF,MF",Lorient,Ligue 1,26,1996,2.9,8,6,6,1,1,4,6,66.7,2,0,0,0,3,11,6,0,Matches
465,Diego Carlos,BRA,DF,Aston Villa,Premier League,30,1993,20.2,27,16,22,4,1,13,21,61.9,8,24,19,5,13,40,78,3,Matches
466,Carmona,ESP,"DF,MF",Getafe,La Liga,21,2002,14.6,30,21,13,14,3,9,28,32.1,19,15,2,13,21,51,25,0,Matches
467,Marco Carnesecchi,ITA,GK,Atalanta,Serie A,23,2000,26.9,0,0,0,0,0,0,0,,0,0,0,0,0,0,22,3,Matches
468,Yannick Carrasco,BEL,DF,Atlético Madrid,La Liga,29,1993,2.5,4,4,3,1,0,2,7,28.6,5,2,0,2,1,5,6,0,Matches
469,Álvaro Carreras,ESP,"MF,FW",Granada,La Liga,20,2003,5.3,13,8,8,4,1,5,11,45.5,6,5,1,4,7,20,9,1,Matches
470,Rasmus Carstensen,DEN,"DF,FW",Köln,Bundesliga,22,2000,18.4,47,22,23,20,4,31,56,55.4,25,38,9,29,20,67,50,2,Matches
471,Antonin Cartillier,FRA,DF,Monaco,Ligue 1,19,2004,0.1,0,0,0,0,0,0,0,,0,1,0,1,0,0,0,0,Matches
472,Dani Carvajal,ESP,DF,Real Madrid,La Liga,31,1992,24.1,47,32,28,15,4,23,42,54.8,19,28,9,19,22,69,54,4,Matches
473,Fabio Carvalho,POR,MF,RB Leipzig,Bundesliga,20,2002,1.8,3,1,0,2,1,1,3,33.3,2,8,0,8,0,3,1,0,Matches
474,William Carvalho,POR,MF,Betis,La Liga,31,1992,7.6,20,12,11,7,2,10,16,62.5,6,8,1,7,8,28,9,1,Matches
475,Cesare Casadei,ITA,"FW,MF",Chelsea,Premier League,20,2003,0.9,5,3,2,1,2,2,5,40.0,3,1,0,1,0,5,4,0,Matches
476,Marc Casado,ESP,MF,Barcelona,La Liga,19,2003,0.2,1,1,1,0,0,1,1,100.0,0,0,0,0,1,2,2,0,Matches
477,Nicolò Casale,ITA,DF,Lazio,Serie A,25,1998,17.3,15,9,13,2,0,6,15,40.0,9,19,16,3,12,27,61,0,Matches
478,Casemiro,BRA,"MF,DF",Manchester Utd,Premier League,31,1992,22.0,83,56,43,32,8,51,106,48.1,55,74,33,41,18,101,71,1,Matches
479,Kaelan Casey,ENG,DF,West Ham,Premier League,18,2004,0.0,0,0,0,0,0,0,0,,0,0,0,0,0,0,1,0,Matches
480,Matty Cash,POL,DF,Aston Villa,Premier League,25,1997,23.8,54,31,24,24,6,29,59,49.2,30,35,14,21,18,72,59,0,Matches
481,Josué Casimir,FRA,"FW,DF",Le Havre,Ligue 1,21,2001,22.4,31,18,14,14,3,7,18,38.9,11,23,2,21,13,44,25,0,Matches
482,Giuseppe Caso,ITA,"FW,MF",Frosinone,Serie A,24,1998,4.6,4,3,2,0,2,2,3,66.7,1,0,0,0,0,4,0,0,Matches
483,Cristian Cásseres Jr.,VEN,MF,Toulouse,Ligue 1,23,2000,21.6,70,34,31,33,6,29,61,47.5,32,34,4,30,27,97,33,1,Matches
484,Timothy Castagne,BEL,DF,Fulham,Premier League,27,1995,29.3,49,24,23,16,10,26,44,59.1,18,38,10,28,38,87,69,1,Matches
485,Koen Casteels,BEL,GK,Wolfsburg,Bundesliga,31,1992,25.0,2,1,2,0,0,2,3,66.7,1,0,0,0,0,2,16,5,Matches
486,Valentín Castellanos,ARG,FW,Lazio,Serie A,24,1998,18.7,22,10,1,12,9,6,20,30.0,14,22,2,20,2,24,18,0,Matches
487,Jean-Charles Castelletto,CMR,DF,Nantes,Ligue 1,28,1995,27.4,34,26,22,10,2,18,29,62.1,11,19,10,9,32,66,81,0,Matches
488,Samu Castillejo,ESP,"FW,MF",Sassuolo,Serie A,28,1995,6.0,12,10,5,5,2,7,19,36.8,12,16,1,15,1,13,3,0,Matches
489,Jonny Castro,ESP,MF,Wolves,Premier League,29,1994,0.1,0,0,0,0,0,0,1,0.0,1,1,1,0,0,0,0,0,Matches
490,Santiago Castro,ARG,FW,Bologna,Serie A,18,2004,2.7,2,1,0,1,1,1,3,33.3,2,1,0,1,1,3,1,0,Matches
491,Gaetano Castrovilli,ITA,"FW,MF",Fiorentina,Serie A,26,1997,4.1,3,2,1,2,0,1,8,12.5,7,4,0,4,2,5,3,0,Matches
492,Danilo Cataldi,ITA,MF,Lazio,Serie A,28,1994,15.1,24,12,7,16,1,8,18,44.4,10,15,7,8,17,41,19,1,Matches
493,Catena,ESP,DF,Osasuna,La Liga,28,1994,28.2,33,18,26,6,1,19,35,54.3,16,24,15,9,15,48,119,3,Matches
494,Maximiliano Caufriez,BEL,DF,Clermont Foot,Ligue 1,26,1997,18.4,38,28,31,5,2,19,29,65.5,10,18,12,6,18,56,69,2,Matches
495,Ivan Cavaleiro,POR,FW,Lille,Ligue 1,29,1993,8.6,10,6,3,4,3,7,20,35.0,13,9,2,7,5,15,6,0,Matches
496,Dani Ceballos,ESP,"MF,FW",Real Madrid,La Liga,26,1996,6.6,10,5,4,5,1,5,14,35.7,9,9,2,7,0,10,4,1,Matches
497,Emil Ceide,NOR,"FW,MF",Sassuolo,Serie A,21,2001,2.0,2,2,1,1,0,1,1,100.0,0,6,1,5,0,2,0,0,Matches
498,Zeki Çelik,TUR,DF,Roma,Serie A,26,1997,7.5,23,16,10,10,3,14,25,56.0,11,12,5,7,8,31,25,0,Matches
499,Álex Centelles,ESP,DF,Almería,La Liga,25,1997,10.9,11,6,9,2,0,8,18,44.4,10,5,2,3,18,29,29,0,Matches
500,Fabien Centonze,FRA,DF,Hellas Verona,Serie A,27,1996,7.5,14,8,10,4,0,5,10,50.0,5,14,2,12,10,24,18,0,Matches
501,Fabien Centonze,FRA,DF,Nantes,Ligue 1,27,1996,1.0,2,1,2,0,0,2,3,66.7,1,2,1,1,0,2,1,0,Matches
502,Václav Černý,CZE,"FW,MF",Wolfsburg,Bundesliga,25,1997,10.2,8,3,3,4,1,2,14,14.3,12,13,0,13,8,16,6,0,Matches
503,Michele Cerofolini,ITA,GK,Frosinone,Serie A,24,1999,7.5,0,0,0,0,0,0,0,,0,0,0,0,0,0,5,1,Matches
504,Alberto Cerri,ITA,FW,Empoli,Serie A,27,1996,6.1,3,3,1,1,1,2,5,40.0,3,3,1,2,3,6,7,0,Matches
505,Leonardo Cerri,ITA,DF,Juventus,Serie A,20,2003,0.1,0,0,0,0,0,0,0,,0,0,0,0,0,0,0,0,Matches
506,Franco Cervi,ARG,"MF,DF",Celta Vigo,La Liga,29,1994,6.1,24,18,13,9,2,13,24,54.2,11,16,0,16,9,33,4,0,Matches
507,Julian Chabot,GER,DF,Köln,Bundesliga,25,1998,30.0,59,42,40,17,2,35,59,59.3,24,66,43,23,45,104,145,0,Matches
508,El Chadaille Bitshiabu,FRA,"DF,MF",RB Leipzig,Bundesliga,18,2005,0.4,1,0,1,0,0,0,0,,0,0,0,0,1,2,4,0,Matches
509,Fares Chaïbi,ALG,"FW,MF",Toulouse,Ligue 1,20,2002,0.6,0,0,0,0,0,0,0,,0,0,0,0,0,0,2,0,Matches
510,Fares Chaïbi,ALG,"MF,FW",Eint Frankfurt,Bundesliga,20,2002,21.2,27,17,7,12,8,8,18,44.4,10,37,1,36,5,32,19,0,Matches
511,Trevoh Chalobah,ENG,DF,Chelsea,Premier League,24,1999,10.6,16,12,10,2,4,10,15,66.7,5,8,7,1,8,24,51,0,Matches
512,Muhammed Cham,AUT,"MF,FW",Clermont Foot,Ligue 1,22,2000,28.4,25,14,10,13,2,11,27,40.7,16,20,2,18,8,33,5,1,Matches
513,Calum Chambers,ENG,"MF,DF",Aston Villa,Premier League,28,1995,1.7,3,0,3,0,0,0,1,0.0,1,2,1,1,2,5,4,0,Matches
514,Timothy Chandler,USA,"MF,DF",Eint Frankfurt,Bundesliga,33,1990,0.2,0,0,0,0,0,0,0,,0,0,0,0,0,0,0,0,Matches
515,Brendan Chardonnet,FRA,DF,Brest,Ligue 1,28,1994,33.0,57,34,33,22,2,32,63,50.8,31,58,34,24,53,110,139,3,Matches
516,Charlys,BRA,MF,Hellas Verona,Serie A,19,2004,0.3,0,0,0,0,0,0,0,,0,0,0,0,1,1,0,0,Matches
517,Pep Chavarría,ESP,"DF,MF",Rayo Vallecano,La Liga,25,1998,13.0,23,18,15,6,2,11,17,64.7,6,15,3,12,6,29,29,1,Matches
518,Jhoanner Chávez,ECU,DF,Lens,Ligue 1,21,2002,5.3,6,5,2,2,2,3,9,33.3,6,2,0,2,5,11,11,0,Matches
519,Walid Cheddira,MAR,FW,Frosinone,Serie A,25,1998,23.6,12,7,1,8,3,4,8,50.0,4,6,1,5,5,17,10,0,Matches
520,Rayan Cherki,FRA,"MF,FW",Lyon,Ligue 1,19,2003,19.1,28,15,4,16,8,17,46,37.0,29,13,3,10,7,35,1,0,Matches
521,Youssef Chermiti,POR,FW,Everton,Premier League,19,2004,2.3,3,2,2,1,0,1,5,20.0,4,4,1,3,1,4,2,0,Matches
522,Lucas Chevalier,FRA,GK,Lille,Ligue 1,21,2001,33.0,3,0,3,0,0,3,4,75.0,1,1,0,1,0,3,11,2,Matches
523,Fabio Chiarodia,ITA,DF,Gladbach,Bundesliga,18,2005,1.7,8,5,5,1,2,5,7,71.4,2,2,1,1,3,11,9,0,Matches
524,Federico Chiesa,ITA,FW,Juventus,Serie A,25,1997,24.4,20,10,7,6,7,3,13,23.1,10,17,1,16,6,26,4,0,Matches
525,Ben Chilwell,ENG,DF,Chelsea,Premier League,26,1996,8.4,15,10,5,9,1,5,8,62.5,3,11,3,8,4,19,19,1,Matches
526,Tawanda Chirewa,ZIM,"MF,FW",Wolves,Premier League,19,2003,1.6,7,3,3,3,1,2,3,66.7,1,0,0,0,1,8,0,0,Matches
527,Pedro Chirivella,ESP,MF,Nantes,Ligue 1,26,1997,28.8,50,28,20,29,1,30,76,39.5,46,22,5,17,31,81,28,0,Matches
528,Leon Chiwome,ENG,FW,Wolves,Premier League,17,2006,1.9,2,1,0,1,1,1,2,50.0,1,3,1,2,0,2,2,0,Matches
529,Tahith Chong,NED,"MF,FW",Luton Town,Premier League,23,1999,22.0,36,22,19,13,4,15,33,45.5,18,30,6,24,8,44,11,1,Matches
530,Joris Chotard,FRA,MF,Montpellier,Ligue 1,21,2001,28.7,81,52,45,25,11,48,96,50.0,48,47,21,26,44,125,60,0,Matches
531,Andreas Christensen,DEN,"DF,MF",Barcelona,La Liga,27,1996,22.0,23,14,7,14,2,16,28,57.1,12,23,10,13,21,44,41,0,Matches
532,Jacob Christensen,DEN,MF,Köln,Bundesliga,22,2001,2.4,10,6,7,3,0,4,7,57.1,3,8,2,6,4,14,4,0,Matches
533,Oliver Christensen,DEN,GK,Fiorentina,Serie A,24,1999,4.0,0,0,0,0,0,0,0,,0,0,0,0,0,0,1,0,Matches
534,Ryan Christie,SCO,MF,Bournemouth,Premier League,28,1995,32.3,86,44,34,35,17,39,92,42.4,53,52,11,41,52,138,53,1,Matches
535,Carney Chukwuemeka,ENG,"MF,FW",Chelsea,Premier League,19,2003,2.5,6,4,3,3,0,1,3,33.3,2,1,1,0,0,6,1,0,Matches
536,Samuel Chukwueze,NGA,FW,Milan,Serie A,24,1999,11.3,18,7,11,5,2,9,17,52.9,8,3,1,2,6,24,3,0,Matches
537,Chumi,ESP,DF,Almería,La Liga,24,1999,27.0,34,22,22,12,0,16,26,61.5,10,38,23,15,14,48,107,3,Matches
538,Víctor Chust,ESP,DF,Cádiz,La Liga,23,2000,20.7,29,18,23,5,1,18,32,56.3,14,27,21,6,11,40,92,1,Matches
539,Pathé Ciss,SEN,MF,Rayo Vallecano,La Liga,29,1994,18.5,44,24,16,26,2,16,29,55.2,13,27,10,17,30,74,54,0,Matches
540,Alphadjo Cissè,ITA,FW,Hellas Verona,Serie A,16,2006,0.1,0,0,0,0,0,0,0,,0,0,0,0,0,0,0,0,Matches
541,Djaoui Cissé,FRA,MF,Rennes,Ligue 1,19,2004,0.0,0,0,0,0,0,0,0,,0,0,0,0,0,0,0,0,Matches
542,Ibrahim Cissoko,NED,"FW,MF",Toulouse,Ligue 1,20,2003,2.7,4,3,3,1,0,1,3,33.3,2,3,0,3,1,5,0,0,Matches
543,Giorgio Cittadini,ITA,DF,Monza,Serie A,21,2002,0.2,1,1,1,0,0,1,1,100.0,0,1,1,0,0,1,0,0,Matches
544,Giorgio Cittadini,ITA,DF,Genoa,Serie A,21,2002,1.2,5,4,4,1,0,3,3,100.0,0,1,0,1,3,8,5,0,Matches
545,Patrick Ciurria,ITA,"DF,MF",Monza,Serie A,28,1995,17.8,30,18,13,13,4,13,21,61.9,8,20,5,15,9,39,28,0,Matches
546,Bobby Clark,ENG,MF,Liverpool,Premier League,18,2005,1.0,2,1,1,1,0,1,5,20.0,4,6,2,4,1,3,1,0,Matches
547,Jordan Clark,ENG,MF,Luton Town,Premier League,29,1993,14.5,30,17,14,11,5,11,39,28.2,28,24,3,21,11,41,15,1,Matches
548,Alexis Claude-Maurice,FRA,MF,Nice,Ligue 1,25,1998,5.6,12,5,3,6,3,1,5,20.0,4,4,1,3,5,17,7,0,Matches
549,Jonathan Clauss,FRA,DF,Marseille,Ligue 1,30,1992,23.0,47,20,22,19,6,26,49,53.1,23,17,3,14,36,83,46,0,Matches
550,Silvi Clúa,ESP,MF,Girona,La Liga,18,2005,0.0,2,0,2,0,0,2,2,100.0,0,1,0,1,0,2,0,0,Matches
551,Nathaniel Clyne,ENG,DF,Crystal Palace,Premier League,32,1991,14.9,24,15,11,11,2,14,21,66.7,7,18,6,12,10,34,33,0,Matches
552,Marcus Coco,FRA,"DF,FW",Nantes,Ligue 1,27,1996,16.5,43,26,29,10,4,28,60,46.7,32,19,1,18,21,64,38,0,Matches
553,Saúl Coco,EQG,DF,Las Palmas,La Liga,24,1999,25.5,32,19,25,7,0,11,18,61.1,7,27,15,12,20,52,120,3,Matches
554,Séamus Coleman,IRL,DF,Everton,Premier League,34,1988,7.4,17,14,10,3,4,11,16,68.8,5,12,4,8,7,24,26,1,Matches
555,Maxime Colin,FRA,DF,Metz,Ligue 1,31,1991,20.4,39,23,25,7,7,16,29,55.2,13,22,7,15,20,59,71,0,Matches
556,Nathan Collins,IRL,DF,Brentford,Premier League,22,2001,29.5,38,20,24,12,2,19,29,65.5,10,46,30,16,44,82,141,4,Matches
557,Nnamdi Collins,GER,DF,Eint Frankfurt,Bundesliga,19,2004,1.0,0,0,0,0,0,0,0,,0,0,0,0,2,2,4,0,Matches
558,Lorenzo Colombo,ITA,FW,Monza,Serie A,21,2002,15.1,17,12,3,9,5,8,14,57.1,6,18,5,13,0,17,14,0,Matches
559,Andrea Colpani,ITA,"MF,FW",Monza,Serie A,24,1999,29.5,25,15,6,13,6,11,20,55.0,9,11,4,7,14,39,14,0,Matches
560,Levi Colwill,ENG,DF,Chelsea,Premier League,20,2003,20.0,48,30,26,17,5,26,34,76.5,8,28,10,18,26,74,66,0,Matches
561,Kingsley Coman,FRA,FW,Bayern Munich,Bundesliga,27,1996,12.4,12,7,5,3,4,9,17,52.9,8,15,1,14,2,14,5,0,Matches
562,Eray Cömert,SUI,DF,Nantes,Ligue 1,25,1998,22.2,42,28,28,13,1,28,38,73.7,10,35,18,17,36,78,77,1,Matches
563,Santi Comesaña,ESP,MF,Villarreal,La Liga,26,1996,18.4,44,26,15,21,8,19,38,50.0,19,33,9,24,22,66,27,1,Matches
564,Pietro Comuzzo,ITA,"DF,FW",Fiorentina,Serie A,18,2005,0.5,1,1,1,0,0,1,1,100.0,0,1,0,1,1,2,2,0,Matches
565,Alois Confais,FRA,"MF,FW",Le Havre,Ligue 1,26,1996,0.1,2,2,1,1,0,1,1,100.0,0,0,0,0,0,2,0,0,Matches
566,Andrea Consigli,ITA,GK,Sassuolo,Serie A,36,1987,35.0,0,0,0,0,0,0,0,,0,1,0,1,1,1,19,1,Matches
567,Bambasé Conté,GER,"MF,FW",Hoffenheim,Bundesliga,20,2003,0.5,3,3,2,0,1,1,1,100.0,0,0,0,0,0,3,0,0,Matches
568,Nikita Contini Baranovsky,ITA,GK,Napoli,Serie A,27,1996,0.2,0,0,0,0,0,0,0,,0,0,0,0,0,0,1,0,Matches
569,Lewis Cook,ENG,MF,Bournemouth,Premier League,26,1997,31.0,61,41,24,30,7,34,63,54.0,29,32,11,21,65,126,46,1,Matches
570,Copete,ESP,DF,Mallorca,La Liga,23,1999,14.8,45,27,27,17,1,30,43,69.8,13,12,6,6,32,77,47,1,Matches
571,Diego Coppola,ITA,DF,Hellas Verona,Serie A,19,2003,18.2,36,22,25,9,2,20,33,60.6,13,26,9,17,27,63,89,1,Matches
572,Francis Coquelin,FRA,MF,Villarreal,La Liga,32,1991,10.1,20,12,8,10,2,5,13,38.5,8,14,4,10,16,36,15,0,Matches
573,Tommaso Corazza,ITA,DF,Bologna,Serie A,19,2004,2.2,10,4,9,1,0,4,9,44.4,5,2,0,2,5,15,3,0,Matches
574,Theo Corbeanu,CAN,"MF,FW",Granada,La Liga,21,2002,2.0,5,2,2,3,0,1,3,33.3,2,3,0,3,3,8,2,0,Matches
575,Jeppe Corfitzen,DEN,FW,Lecce,Serie A,18,2004,0.1,1,0,0,1,0,1,1,100.0,0,0,0,0,0,1,0,0,Matches
576,Jack Cork,ENG,MF,Burnley,Premier League,34,1989,0.3,2,0,0,2,0,1,3,33.3,2,0,0,0,1,3,1,0,Matches
577,Maxwel Cornet,CIV,"MF,FW",West Ham,Premier League,26,1996,1.2,3,2,3,0,0,1,5,20.0,4,2,0,2,2,5,1,0,Matches
578,Giacomo Corona,ITA,FW,Empoli,Serie A,19,2004,0.1,0,0,0,0,0,0,0,,0,0,0,0,0,0,0,0,Matches
579,Jesús Corona,MEX,"MF,DF",Sevilla,La Liga,30,1993,0.2,0,0,0,0,0,0,0,,0,0,0,0,1,1,0,0,Matches
580,Ángel Correa,ARG,"FW,MF",Atlético Madrid,La Liga,28,1995,17.0,22,15,3,11,8,5,17,29.4,12,13,0,13,2,24,6,0,Matches
581,Joaquín Correa,ARG,"FW,MF",Marseille,Ligue 1,28,1994,4.8,7,5,4,2,1,0,8,0.0,8,2,0,2,1,8,1,0,Matches
582,Thierry Correia,POR,DF,Valencia,La Liga,24,1999,23.9,63,35,39,20,4,28,49,57.1,21,39,16,23,33,96,61,0,Matches
583,Oscar Cortés,COL,"FW,MF",Lens,Ligue 1,19,2003,0.5,0,0,0,0,0,0,0,,0,1,0,1,0,0,0,0,Matches
584,Danny da Costa,GER,DF,Mainz 05,Bundesliga,30,1993,9.2,18,9,9,7,2,9,19,47.4,10,17,4,13,16,34,24,0,Matches
585,David Pereira da Costa,POR,MF,Lens,Ligue 1,22,2001,16.6,18,10,5,12,1,10,23,43.5,13,21,4,17,16,34,8,1,Matches
586,Jaume Costa,ESP,DF,Mallorca,La Liga,35,1988,18.7,38,22,23,10,5,18,29,62.1,11,14,4,10,16,54,35,0,Matches
587,João Costa,BRA,"MF,FW",Roma,Serie A,18,2005,0.2,0,0,0,0,0,0,0,,0,0,0,0,0,0,0,0,Matches
588,Logan Costa,CPV,DF,Toulouse,Ligue 1,22,2001,29.4,40,24,31,9,0,15,24,62.5,9,42,27,15,23,63,120,1,Matches
589,Samu Costa,POR,MF,Mallorca,La Liga,22,2000,25.6,91,50,40,46,5,46,93,49.5,47,28,14,14,39,130,59,3,Matches
590,Benoît Costil,FRA,GK,Salernitana,Serie A,36,1987,13.0,2,1,1,1,0,2,3,66.7,1,0,0,0,0,2,5,1,Matches
591,Grégoire Coudert,FRA,GK,Brest,Ligue 1,24,1999,2.0,0,0,0,0,0,0,0,,0,0,0,0,0,0,0,0,Matches
592,Vladimír Coufal,CZE,DF,West Ham,Premier League,30,1992,34.8,64,41,50,12,2,38,75,50.7,37,49,15,34,43,107,97,0,Matches
593,Lassana Coulibaly,MLI,MF,Salernitana,Serie A,27,1996,23.1,47,32,20,21,6,22,49,44.9,27,23,5,18,16,63,29,0,Matches
594,Mamadou Coulibaly,SEN,DF,Salernitana,Serie A,24,1999,0.0,0,0,0,0,0,0,0,,0,0,0,0,0,0,0,0,Matches
595,Mamadou Coulibaly,FRA,MF,Monaco,Ligue 1,19,2004,1.3,7,4,2,3,2,3,8,37.5,5,4,0,4,0,7,0,0,Matches
596,Tanguy Coulibaly,FRA,"FW,MF",Montpellier,Ligue 1,22,2001,6.9,13,11,8,4,1,4,9,44.4,5,11,1,10,2,15,2,0,Matches
597,Thibaut Courtois,BEL,GK,Real Madrid,La Liga,31,1992,3.7,1,0,1,0,0,0,0,,0,0,0,0,0,1,0,0,Matches
598,Philippe Coutinho,BRA,"MF,FW",Aston Villa,Premier League,31,1992,0.3,0,0,0,0,0,0,1,0.0,1,0,0,0,0,0,0,0,Matches
599,Yan Couto,BRA,"DF,FW",Girona,La Liga,21,2002,24.9,45,34,25,14,6,20,40,50.0,20,14,2,12,10,55,31,1,Matches
600,Nicolas Cozza,FRA,DF,Nantes,Ligue 1,24,1999,9.9,35,23,23,10,2,17,24,70.8,7,7,0,7,14,49,32,0,Matches
601,Nicolas Cozza,FRA,DF,Wolfsburg,Bundesliga,24,1999,3.1,8,6,4,4,0,2,7,28.6,5,3,0,3,4,12,6,0,Matches
602,Alessio Cragno,ITA,GK,Sassuolo,Serie A,29,1994,3.0,0,0,0,0,0,0,0,,0,0,0,0,0,0,3,1,Matches
603,Crespo,POR,MF,Rayo Vallecano,La Liga,26,1996,5.9,16,9,8,6,2,9,17,52.9,8,15,6,9,10,26,7,0,Matches
604,Aaron Cresswell,ENG,"DF,FW",West Ham,Premier League,33,1989,4.8,3,2,1,1,1,2,3,66.7,1,5,3,2,3,6,7,0,Matches
605,Bryan Cristante,ITA,"MF,DF",Roma,Serie A,28,1995,36.5,72,41,33,28,11,28,50,56.0,22,36,6,30,25,97,55,2,Matches
606,Cristian,ESP,GK,Valencia,La Liga,25,1998,0.6,0,0,0,0,0,0,0,,0,0,0,0,0,0,0,0,Matches
607,Juan Cruz Armada,ESP,DF,Osasuna,La Liga,31,1992,18.5,27,15,16,10,1,17,25,68.0,8,14,7,7,12,39,39,1,Matches
608,Juan Cruz,ARG,"FW,MF",Hellas Verona,Serie A,24,1999,1.2,2,2,0,0,2,0,0,,0,1,0,1,1,3,0,0,Matches
609,Juan Cruz,ESP,FW,Betis,La Liga,23,2000,0.8,0,0,0,0,0,0,1,0.0,1,0,0,0,0,0,0,0,Matches
610,Juan Cuadrado,COL,DF,Inter,Serie A,35,1988,3.0,4,3,2,2,0,3,5,60.0,2,6,1,5,1,5,2,0,Matches
611,Pau Cubarsí,ESP,DF,Barcelona,La Liga,16,2007,17.3,22,14,18,3,1,13,18,72.2,5,20,16,4,12,34,65,0,Matches
612,Marc Cucurella,ESP,DF,Chelsea,Premier League,25,1998,19.8,62,38,36,21,5,34,64,53.1,30,36,13,23,22,84,48,0,Matches
613,Iván Cuéllar,ESP,GK,Mallorca,La Liga,39,1984,1.0,0,0,0,0,0,0,0,,0,0,0,0,0,0,0,0,Matches
614,Jorge Cuenca,ESP,DF,Villarreal,La Liga,23,1999,21.8,42,29,26,10,6,19,30,63.3,11,26,15,11,21,63,114,0,Matches
615,Josh Cullen,IRL,MF,Burnley,Premier League,27,1996,22.9,42,29,15,22,5,26,46,56.5,20,31,19,12,15,57,26,1,Matches
616,Matheus Cunha,BRA,"FW,MF",Wolves,Premier League,24,1999,27.1,30,16,8,17,5,13,35,37.1,22,28,7,21,13,43,21,1,Matches
617,Marvin Cuni,ALB,FW,Frosinone,Serie A,22,2001,5.9,8,3,1,3,4,3,4,75.0,1,10,1,9,1,9,0,0,Matches
618,Eric Curbelo,ESP,"DF,MF",Las Palmas,La Liga,29,1994,1.1,4,3,2,2,0,3,4,75.0,1,3,1,2,2,6,5,1,Matches
619,Sam Curtis,IRL,DF,Sheffield Utd,Premier League,17,2005,0.3,1,0,1,0,0,1,2,50.0,1,2,0,2,0,1,0,0,Matches
620,Tomáš Čvančara,CZE,FW,Gladbach,Bundesliga,22,2000,10.0,4,3,0,2,2,1,3,33.3,2,5,1,4,2,6,8,0,Matches
621,Danilo D'Ambrosio,ITA,DF,Monza,Serie A,34,1988,17.1,57,34,34,20,3,28,41,68.3,13,22,13,9,14,71,31,0,Matches
622,Alberto Dadie,ESP,MF,Real Sociedad,La Liga,21,2002,0.3,2,1,2,0,0,0,0,,0,1,0,1,0,2,0,0,Matches
623,Trévis Dago,CIV,"FW,MF",Lille,Ligue 1,18,2005,0.3,0,0,0,0,0,0,0,,0,0,0,0,1,1,0,0,Matches
624,Finn Dahmen,GER,GK,Augsburg,Bundesliga,25,1998,31.0,1,0,1,0,0,1,3,33.3,2,0,0,0,0,1,17,5,Matches
625,Mahmoud Dahoud,GER,MF,Brighton,Premier League,27,1996,5.0,9,4,2,4,3,3,9,33.3,6,4,1,3,1,10,5,0,Matches
626,Mahmoud Dahoud,GER,MF,Stuttgart,Bundesliga,27,1996,2.5,5,1,1,4,0,3,7,42.9,4,4,0,4,0,5,1,0,Matches
627,Ameen Al-Dakhil,BEL,DF,Burnley,Premier League,21,2002,11.7,12,5,4,7,1,1,10,10.0,9,13,6,7,12,24,38,2,Matches
628,Thijs Dallinga,NED,FW,Toulouse,Ligue 1,22,2000,27.9,29,15,6,11,12,9,15,60.0,6,11,4,7,3,32,35,0,Matches
629,Diogo Dalot,POR,DF,Manchester Utd,Premier League,24,1999,35.3,81,51,58,12,11,51,74,68.9,23,44,16,28,37,118,111,0,Matches
630,Mikkel Damsgaard,DEN,MF,Brentford,Premier League,23,2000,9.4,29,17,13,9,7,14,40,35.0,26,23,1,22,11,40,10,1,Matches
631,Flavius Daniliuc,AUT,DF,Salernitana,Serie A,22,2001,8.3,19,11,12,5,2,9,19,47.4,10,13,4,9,8,27,15,0,Matches
632,Danilo,BRA,MF,Nott'ham Forest,Premier League,22,2001,19.9,36,18,22,12,2,21,46,45.7,25,33,8,25,35,71,42,0,Matches
633,Danilo,BRA,DF,Juventus,Serie A,32,1991,27.2,60,36,38,18,4,32,48,66.7,16,34,15,19,37,97,94,0,Matches
634,Arnaut Danjuma,NED,"MF,FW",Everton,Premier League,26,1997,6.6,6,4,2,3,1,1,4,25.0,3,4,0,4,3,9,0,0,Matches
635,Jayden Danns,ENG,FW,Liverpool,Premier League,17,2006,0.1,0,0,0,0,0,0,0,,0,0,0,0,0,0,0,0,Matches
636,Kevin Danso,AUT,DF,Lens,Ligue 1,24,1998,29.5,24,14,12,11,1,15,30,50.0,15,43,30,13,23,47,115,1,Matches
637,Dante,BRA,DF,Nice,Ligue 1,39,1983,31.6,62,30,44,16,2,38,52,73.1,14,43,22,21,37,99,77,2,Matches
638,Raimane Daou,COM,"DF,MF",Marseille,Ligue 1,18,2004,0.3,1,1,1,0,0,1,2,50.0,1,0,0,0,0,1,2,0,Matches
639,Mohammed Daramy,DEN,"FW,MF",Reims,Ligue 1,21,2002,18.3,10,9,4,4,2,6,16,37.5,10,5,1,4,4,14,4,0,Matches
640,Sergi Darder,ESP,MF,Mallorca,La Liga,29,1993,24.0,39,26,13,21,5,12,31,38.7,19,20,4,16,16,55,16,0,Matches
641,Achraf Dari,MAR,"DF,FW",Brest,Ligue 1,24,1999,1.3,1,1,1,0,0,0,2,0.0,2,2,0,2,5,6,9,1,Matches
642,Matteo Darmian,ITA,DF,Inter,Serie A,33,1989,26.7,48,22,23,15,10,20,53,37.7,33,27,11,16,13,61,55,0,Matches
643,Lukas Daschner,GER,"MF,FW",Bochum,Bundesliga,24,1998,6.0,9,4,2,3,4,4,9,44.4,5,7,0,7,2,11,2,0,Matches
644,Josh Dasilva,ENG,"DF,FW",Brentford,Premier League,24,1998,0.3,2,1,0,1,1,0,0,,0,0,0,0,0,2,0,0,Matches
645,David Datro Fofana,CIV,FW,Burnley,Premier League,20,2002,9.8,10,5,3,5,2,3,6,50.0,3,9,3,6,1,11,2,0,Matches
646,David Datro Fofana,CIV,"FW,MF",Union Berlin,Bundesliga,20,2002,7.6,10,7,3,5,2,4,9,44.4,5,4,0,4,0,10,5,0,Matches
647,Juan David Cabal,COL,DF,Hellas Verona,Serie A,22,2001,16.6,36,27,19,14,3,18,29,62.1,11,30,9,21,26,62,55,2,Matches
648,Jonathan David,CAN,FW,Lille,Ligue 1,23,2000,29.2,26,15,6,13,7,8,26,30.8,18,16,0,16,9,35,4,0,Matches
649,Alphonso Davies,CAN,DF,Bayern Munich,Bundesliga,22,2000,22.9,47,24,29,13,5,30,53,56.6,23,30,4,26,26,73,49,1,Matches
650,Ben Davies,WAL,DF,Tottenham,Premier League,30,1993,12.1,24,17,13,8,3,16,21,76.2,5,17,15,2,10,34,35,0,Matches
651,Tom Davies,ENG,MF,Sheffield Utd,Premier League,25,1998,2.5,10,5,4,3,3,3,9,33.3,6,2,1,1,3,13,6,1,Matches
652,Keinan Davis,ENG,"FW,MF",Udinese,Serie A,25,1998,2.1,0,0,0,0,0,0,0,,0,0,0,0,0,0,3,0,Matches
653,Paweł Dawidowicz,POL,DF,Hellas Verona,Serie A,28,1995,23.8,53,30,33,18,2,17,29,58.6,12,17,9,8,24,77,114,1,Matches
654,Craig Dawson,ENG,DF,Wolves,Premier League,33,1990,24.5,30,20,23,6,1,22,34,64.7,12,51,39,12,16,46,120,1,Matches
655,Kevin De Bruyne,BEL,MF,Manchester City,Premier League,32,1991,13.6,14,9,1,5,8,7,20,35.0,13,5,0,5,4,18,4,0,Matches
656,Charles De Ketelaere,BEL,"FW,MF",Atalanta,Serie A,22,2001,22.5,33,21,3,12,18,10,20,50.0,10,30,2,28,7,40,6,0,Matches
657,Rodrigo De Paul,ARG,MF,Atlético Madrid,La Liga,29,1994,23.1,31,21,11,14,6,15,38,39.5,23,28,1,27,11,42,15,2,Matches
658,Mattia De Sciglio,ITA,DF,Juventus,Serie A,30,1992,0.5,0,0,0,0,0,0,0,,0,1,0,1,1,1,2,0,Matches
659,Lorenzo De Silvestri,ITA,DF,Bologna,Serie A,35,1988,7.5,10,8,5,2,3,4,7,57.1,3,9,4,5,6,16,27,0,Matches
660,Thibault De Smet,BEL,DF,Reims,Ligue 1,25,1998,20.3,56,35,36,16,4,33,59,55.9,26,25,5,20,21,77,51,1,Matches
661,Koni De Winter,BEL,DF,Genoa,Serie A,21,2002,26.4,44,25,26,13,5,21,31,67.7,10,30,10,20,21,65,78,0,Matches
662,Grégoire Defrel,MTQ,"FW,MF",Sassuolo,Serie A,32,1991,8.4,17,8,7,5,5,7,15,46.7,8,10,0,10,3,20,9,0,Matches
663,Alessandro Deiola,ITA,MF,Cagliari,Serie A,27,1995,17.9,33,19,13,16,4,18,47,38.3,29,16,6,10,9,42,37,0,Matches
664,Romain Del Castillo,FRA,FW,Brest,Ligue 1,27,1996,27.7,46,29,14,18,14,18,70,25.7,52,33,1,32,9,55,8,0,Matches
665,Thomas Delaine,FRA,"DF,MF",Strasbourg,Ligue 1,31,1992,22.7,38,19,29,8,1,20,42,47.6,22,18,2,16,17,55,51,0,Matches
666,Sacha Delaye,FRA,"MF,FW",Montpellier,Ligue 1,21,2002,1.4,7,2,2,2,3,1,6,16.7,5,2,0,2,0,7,1,0,Matches
667,Hannes Delcroix,BEL,DF,Burnley,Premier League,24,1999,6.5,10,6,6,4,0,3,4,75.0,1,9,3,6,9,19,26,0,Matches
668,Alessandro Dellavalle,ITA,DF,Torino,Serie A,19,2004,0.2,0,0,0,0,0,0,0,,0,1,1,0,1,1,0,0,Matches
669,Olivier Deman,BEL,DF,Werder Bremen,Bundesliga,23,2000,15.2,28,15,21,4,3,18,38,47.4,20,24,8,16,14,42,49,1,Matches
670,Karamoko Dembélé,ENG,"MF,FW",Brest,Ligue 1,20,2003,0.2,0,0,0,0,0,0,0,,0,0,0,0,0,0,0,0,Matches
671,Ousmane Dembélé,FRA,"MF,FW",Paris S-G,Ligue 1,26,1997,16.7,19,14,2,7,10,6,13,46.2,7,11,0,11,5,24,4,1,Matches
672,Jessy Deminguet,FRA,"MF,FW",Strasbourg,Ligue 1,25,1998,7.7,14,9,6,8,0,6,18,33.3,12,8,0,8,9,23,5,1,Matches
673,Ermedin Demirović,BIH,"FW,MF",Augsburg,Bundesliga,25,1998,31.9,24,14,5,16,3,12,40,30.0,28,28,2,26,11,35,26,0,Matches
674,Diego Demme,GER,MF,Napoli,Serie A,31,1991,0.8,1,1,0,1,0,0,1,0.0,1,0,0,0,0,1,0,0,Matches
675,Sepp van den Berg,NED,DF,Mainz 05,Bundesliga,21,2001,31.5,38,23,20,15,3,15,26,57.7,11,66,36,30,43,81,159,2,Matches
676,Leander Dendoncker,BEL,MF,Aston Villa,Premier League,28,1995,1.3,6,4,3,2,1,4,5,80.0,1,5,2,3,2,8,3,1,Matches
677,Leander Dendoncker,BEL,MF,Napoli,Serie A,28,1995,0.3,0,0,0,0,0,0,0,,0,1,1,0,0,0,0,0,Matches
678,Rémy Descamps,FRA,GK,Nantes,Ligue 1,27,1996,6.0,0,0,0,0,0,0,0,,0,0,0,0,0,0,7,0,Matches
679,Mikkel Desler,DEN,DF,Toulouse,Ligue 1,28,1995,17.2,18,12,8,7,3,9,17,52.9,8,32,13,19,19,37,38,0,Matches
680,Arthur Desmas,FRA,GK,Le Havre,Ligue 1,29,1994,33.0,0,0,0,0,0,0,2,0.0,2,0,0,0,0,0,13,1,Matches
681,Mattia Destro,ITA,"FW,MF",Empoli,Serie A,32,1991,4.1,2,1,0,2,0,1,1,100.0,0,4,0,4,2,4,3,0,Matches
682,Samuele Di Benedetto,GER,MF,Stuttgart,Bundesliga,18,2005,0.1,0,0,0,0,0,0,0,,0,0,0,0,1,1,0,0,Matches
683,Federico Di Francesco,ITA,"FW,MF",Lecce,Serie A,29,1994,0.2,1,0,0,1,0,0,0,,0,0,0,0,0,1,0,0,Matches
684,Raffaele Di Gennaro,ITA,GK,Inter,Serie A,29,1993,0.3,0,0,0,0,0,0,0,,0,0,0,0,0,0,0,0,Matches
685,Michele Di Gregorio,ITA,GK,Monza,Serie A,26,1997,31.9,1,0,1,0,0,1,4,25.0,3,1,0,1,1,2,10,2,Matches
686,Giovanni Di Lorenzo,ITA,DF,Napoli,Serie A,29,1993,35.9,58,36,26,26,6,32,68,47.1,36,43,16,27,24,82,45,0,Matches
687,Alessandro Di Pardo,ITA,"DF,MF",Cagliari,Serie A,24,1999,4.0,4,1,3,0,1,0,3,0.0,3,9,2,7,5,9,7,0,Matches
688,Boulaye Dia,SEN,"FW,MF",Salernitana,Serie A,26,1996,12.7,4,2,2,2,0,1,3,33.3,2,5,0,5,3,7,7,0,Matches
689,Moussa Diaby,FRA,"FW,MF",Aston Villa,Premier League,24,1999,24.2,12,5,5,4,3,4,22,18.2,18,8,1,7,9,21,6,0,Matches
690,Lamine Diack,SEN,MF,Nantes,Ligue 1,22,2000,0.0,0,0,0,0,0,0,0,,0,0,0,0,0,0,0,0,Matches
691,Mouctar Diakhaby,GUI,"DF,MF",Valencia,La Liga,26,1996,11.9,18,11,9,9,0,11,13,84.6,2,17,7,10,11,29,62,0,Matches
692,Mamadou Diakhon,FRA,"FW,MF",Reims,Ligue 1,17,2005,2.3,5,3,2,1,2,3,9,33.3,6,1,0,1,1,6,1,0,Matches
693,Bafodé Diakité,FRA,DF,Lille,Ligue 1,22,2001,18.8,29,20,12,15,2,24,32,75.0,8,16,8,8,21,50,49,1,Matches
694,Ibrahim Diakité,GUI,DF,Reims,Ligue 1,19,2003,1.2,1,0,0,1,0,0,1,0.0,1,3,0,3,2,3,5,0,Matches
695,Moussa Diakité,MLI,MF,Cádiz,La Liga,19,2003,0.0,0,0,0,0,0,0,0,,0,0,0,0,0,0,0,0,Matches
696,Oumar Diakité,CIV,FW,Reims,Ligue 1,19,2003,17.6,25,12,10,9,6,7,21,33.3,14,13,0,13,7,32,7,0,Matches
697,Amad Diallo,CIV,"FW,MF",Manchester Utd,Premier League,21,2002,4.3,10,3,1,6,3,3,7,42.9,4,3,1,2,1,11,6,0,Matches
698,Amadou Diallo,ENG,MF,Newcastle Utd,Premier League,20,2003,0.0,0,0,0,0,0,0,0,,0,0,0,0,0,0,0,0,Matches
699,Assane Diao,ESP,FW,Betis,La Liga,17,2005,11.6,20,12,5,9,6,6,17,35.3,11,22,4,18,7,27,7,0,Matches
700,Habib Diarra,SEN,"MF,FW",Strasbourg,Ligue 1,19,2004,25.6,30,23,8,20,2,9,33,27.3,24,23,4,19,17,47,15,0,Matches
701,Moussa Diarra,MLI,DF,Toulouse,Ligue 1,22,2000,15.5,32,12,16,15,1,13,27,48.1,14,30,14,16,20,52,43,0,Matches
702,Rúben Dias,POR,DF,Manchester City,Premier League,26,1997,28.4,39,20,14,21,4,19,26,73.1,7,32,17,15,30,69,77,0,Matches
703,Krépin Diatta,SEN,"DF,FW",Monaco,Ligue 1,24,1999,13.4,37,20,17,16,4,27,49,55.1,22,17,2,15,16,53,22,0,Matches
704,Mory Diaw,SEN,GK,Clermont Foot,Ligue 1,30,1993,30.0,1,1,1,0,0,1,2,50.0,1,0,0,0,1,2,13,5,Matches
705,Mahamadou Diawara,FRA,MF,Lyon,Ligue 1,18,2005,4.0,9,6,4,5,0,3,11,27.3,8,4,1,3,4,13,4,0,Matches
706,Brahim Díaz,MAR,"FW,MF",Real Madrid,La Liga,23,1999,17.2,29,19,4,16,9,6,13,46.2,7,16,1,15,5,34,2,0,Matches
707,Luis Díaz,COL,FW,Liverpool,Premier League,26,1997,29.2,35,25,5,17,13,7,30,23.3,23,15,0,15,3,38,8,0,Matches
708,Víctor Díaz,ESP,"DF,MF",Granada,La Liga,35,1988,1.8,5,3,2,3,0,1,3,33.3,2,1,0,1,1,6,8,0,Matches
709,Famara Diedhiou,SEN,"FW,MF",Granada,La Liga,30,1992,1.0,1,1,0,1,0,0,1,0.0,1,0,0,0,0,1,2,0,Matches
710,Justin Diehl,GER,"FW,MF",Köln,Bundesliga,18,2004,1.9,0,0,0,0,0,0,0,,0,1,1,0,0,0,0,1,Matches
711,Bamba Dieng,SEN,FW,Lorient,Ligue 1,23,2000,6.1,3,3,0,3,0,1,3,33.3,2,3,0,3,0,3,7,0,Matches
712,Eric Dier,ENG,DF,Tottenham,Premier League,29,1994,2.2,2,1,2,0,0,2,2,100.0,0,3,3,0,2,4,12,0,Matches
713,Eric Dier,ENG,DF,Bayern Munich,Bundesliga,29,1994,13.0,11,8,5,5,1,5,6,83.3,1,20,12,8,10,21,48,1,Matches
714,Guillaume Dietsch,FRA,GK,Metz,Ligue 1,22,2001,0.8,0,0,0,0,0,0,0,,0,0,0,0,0,0,0,0,Matches
715,Florian Dietz,GER,"FW,MF",Köln,Bundesliga,24,1998,0.8,0,0,0,0,0,0,0,,0,1,0,1,0,0,0,0,Matches
716,Lucas Digne,FRA,DF,Aston Villa,Premier League,30,1993,26.8,47,19,35,9,3,25,44,56.8,19,20,2,18,26,73,67,0,Matches
717,Federico Dimarco,ITA,DF,Inter,Serie A,25,1997,23.1,42,25,19,14,9,17,35,48.6,18,18,3,15,9,51,34,1,Matches
718,Stole Dimitrievski,MKD,GK,Rayo Vallecano,La Liga,29,1993,37.0,1,1,1,0,0,1,1,100.0,0,0,0,0,0,1,17,3,Matches
719,Junior Dina Ebimbe,FRA,"MF,DF",Eint Frankfurt,Bundesliga,22,2000,21.7,44,29,15,17,12,18,41,43.9,23,28,7,21,9,53,39,1,Matches
720,Eren Dinkçi,GER,"FW,MF",Heidenheim,Bundesliga,21,2001,29.4,32,18,16,13,3,19,48,39.6,29,40,4,36,12,44,21,0,Matches
721,Sinaly Diomande,CIV,DF,Lyon,Ligue 1,22,2001,9.9,10,4,5,3,2,9,16,56.3,7,12,9,3,15,25,26,1,Matches
722,Edan Diop,FRA,"MF,DF",Monaco,Ligue 1,18,2004,1.8,10,8,6,3,1,7,9,77.8,2,3,0,3,1,11,5,0,Matches
723,Issa Diop,FRA,DF,Fulham,Premier League,26,1997,15.8,30,16,23,5,2,15,20,75.0,5,28,19,9,17,47,80,1,Matches
724,Sofiane Diop,FRA,FW,Nice,Ligue 1,23,2000,5.5,8,6,3,4,1,4,10,40.0,6,4,0,4,3,11,3,0,Matches
725,Andy Diouf,FRA,MF,Lens,Ligue 1,20,2003,14.6,28,19,12,11,5,14,22,63.6,8,13,3,10,3,31,5,1,Matches
726,Yehvann Diouf,FRA,GK,Reims,Ligue 1,23,1999,34.0,0,0,0,0,0,0,1,0.0,1,0,0,0,1,1,19,3,Matches
727,Axel Disasi,FRA,DF,Chelsea,Premier League,25,1998,28.7,33,19,20,10,3,23,30,76.7,7,26,19,7,18,51,102,2,Matches
728,Tiago Djaló,POR,DF,Juventus,Serie A,23,2000,0.2,0,0,0,0,0,0,0,,0,1,0,1,0,0,1,0,Matches
729,Chaim El Djebali,TUN,MF,Lyon,Ligue 1,19,2004,0.1,0,0,0,0,0,0,0,,0,0,0,0,0,0,0,0,Matches
730,Djené,TOG,"DF,MF",Getafe,La Liga,31,1991,27.6,34,19,18,13,3,15,26,57.7,11,31,15,16,23,57,70,0,Matches
731,Koffi Djidji,CIV,DF,Torino,Serie A,30,1992,8.4,14,9,9,5,0,3,4,75.0,1,10,5,5,10,24,20,0,Matches
732,Berat Djimsiti,ALB,DF,Atalanta,Serie A,30,1993,31.5,42,24,29,12,1,19,31,61.3,12,53,33,20,57,99,100,0,Matches
733,Marko Dmitrović,SRB,GK,Sevilla,La Liga,31,1992,13.0,1,1,1,0,0,1,2,50.0,1,0,0,0,1,2,5,0,Matches
734,Ben Doak,SCO,FW,Liverpool,Premier League,17,2005,0.2,0,0,0,0,0,0,0,,0,0,0,0,0,0,0,0,Matches
735,Ritsu Doan,JPN,"DF,MF",Freiburg,Bundesliga,25,1998,25.0,50,27,21,19,10,21,36,58.3,15,30,3,27,9,59,29,0,Matches
736,Lewis Dobbin,ENG,MF,Everton,Premier League,20,2003,2.6,9,7,3,5,1,5,9,55.6,4,5,1,4,1,10,0,0,Matches
737,Dodô,BRA,DF,Fiorentina,Serie A,24,1998,5.8,5,3,1,4,0,2,5,40.0,3,2,0,2,5,10,11,0,Matches
738,Danilho Doekhi,NED,DF,Union Berlin,Bundesliga,25,1998,24.0,34,23,18,16,0,15,21,71.4,6,46,25,21,38,72,111,1,Matches
739,Matt Doherty,IRL,"DF,MF",Wolves,Premier League,31,1992,12.8,31,18,17,10,4,12,23,52.2,11,15,5,10,7,38,47,0,Matches
740,Josh Doig,SCO,DF,Hellas Verona,Serie A,21,2002,9.2,16,9,9,7,0,13,17,76.5,4,12,3,9,4,20,17,1,Matches
741,Josh Doig,SCO,DF,Sassuolo,Serie A,21,2002,14.9,25,17,16,9,0,15,27,55.6,12,31,10,21,16,41,38,0,Matches
742,Jeremy Doku,BEL,"FW,MF",Manchester City,Premier League,21,2002,17.7,39,22,13,12,14,9,20,45.0,11,14,0,14,9,48,5,0,Matches
743,Jeremy Doku,BEL,FW,Rennes,Ligue 1,21,2002,1.2,2,2,1,0,1,1,1,100.0,0,0,0,0,0,2,0,0,Matches
744,Jaume Doménech,ESP,GK,Valencia,La Liga,32,1990,0.9,0,0,0,0,0,0,0,,0,0,0,0,0,0,0,0,Matches
745,Carlos Dominguez,ESP,DF,Celta Vigo,La Liga,22,2001,17.6,33,21,17,9,7,23,37,62.2,14,24,12,12,22,55,78,0,Matches
746,Mario Dominguez,ESP,FW,Valencia,La Liga,19,2004,0.3,0,0,0,0,0,0,0,,0,0,0,0,0,0,0,0,Matches
747,Nicolás Domínguez,ARG,"MF,FW",Nott'ham Forest,Premier League,25,1998,16.6,63,34,35,27,1,23,48,47.9,25,31,5,26,18,81,24,0,Matches
748,Nicolás Domínguez,ARG,MF,Bologna,Serie A,25,1998,1.1,1,0,1,0,0,0,2,0.0,2,3,0,3,0,1,2,0,Matches
749,Giulio Donati,ITA,DF,Monza,Serie A,33,1990,0.4,0,0,0,0,0,0,0,,0,0,0,0,0,0,1,1,Matches
750,Jamie Donley,ENG,FW,Tottenham,Premier League,18,2005,0.0,0,0,0,0,0,0,0,,0,0,0,0,0,0,3,0,Matches
751,Gianluigi Donnarumma,ITA,GK,Paris S-G,Ligue 1,24,1999,24.1,0,0,0,0,0,0,0,,0,0,0,0,1,1,9,4,Matches
752,Patrick Dorgu,DEN,"DF,MF",Lecce,Serie A,18,2004,17.4,43,22,22,17,4,22,34,64.7,12,16,5,11,9,52,45,2,Matches
753,Niklas Dorsch,GER,MF,Augsburg,Bundesliga,25,1998,15.4,35,24,13,21,1,13,33,39.4,20,15,9,6,16,51,27,0,Matches
754,Alberto Dossena,ITA,DF,Cagliari,Serie A,24,1998,33.1,55,35,43,12,0,32,48,66.7,16,50,27,23,45,100,172,2,Matches
755,Carlos Dotor,ESP,MF,Celta Vigo,La Liga,22,2001,7.9,14,7,3,8,3,4,13,30.8,9,12,2,10,4,18,4,0,Matches
756,Abdoulaye Doucouré,MLI,"FW,MF",Everton,Premier League,30,1993,29.2,43,27,20,14,9,18,46,39.1,28,23,3,20,15,58,19,0,Matches
757,Cheick Doucouré,MLI,MF,Crystal Palace,Premier League,23,2000,10.2,34,17,15,13,6,18,30,60.0,12,13,2,11,20,54,12,0,Matches
758,Siriné Doucouré,MLI,FW,Lorient,Ligue 1,21,2002,4.7,8,6,0,4,4,3,3,100.0,0,4,0,4,1,9,6,0,Matches
759,Désiré Doué,FRA,"MF,FW",Rennes,Ligue 1,18,2005,18.1,32,18,11,14,7,10,33,30.3,23,30,1,29,14,46,8,0,Matches
760,Guela Doué,CIV,DF,Rennes,Ligue 1,20,2002,13.7,28,21,14,12,2,22,32,68.8,10,12,1,11,15,43,65,1,Matches
761,Alfie Doughty,ENG,DF,Luton Town,Premier League,23,1999,32.5,63,40,29,18,16,37,82,45.1,45,51,9,42,31,94,43,4,Matches
762,Douglas,BRA,MF,Nantes,Ligue 1,26,1997,19.7,70,42,34,30,6,30,59,50.8,29,22,8,14,26,96,30,0,Matches
763,Ismaël Doukouré,FRA,"MF,DF",Strasbourg,Ligue 1,20,2003,18.4,23,16,7,14,2,13,21,61.9,8,19,7,12,19,42,29,2,Matches
764,Kamory Doumbia,MLI,MF,Brest,Ligue 1,20,2003,9.8,28,18,8,10,10,10,29,34.5,19,14,0,14,9,37,6,0,Matches
765,Anastasios Douvikas,GRE,FW,Celta Vigo,La Liga,23,1999,10.1,15,7,2,6,7,3,8,37.5,5,6,3,3,2,17,9,0,Matches
766,Artem Dovbyk,UKR,FW,Girona,La Liga,26,1997,28.7,4,3,2,1,1,0,2,0.0,2,8,1,7,0,4,17,0,Matches
767,Nikola Dovedan,AUT,"MF,FW",Heidenheim,Bundesliga,29,1994,7.3,14,9,2,10,2,5,25,20.0,20,9,0,9,1,15,3,0,Matches
768,Damion Downs,USA,"FW,MF",Köln,Bundesliga,19,2004,2.0,1,1,1,0,0,1,2,50.0,1,1,0,1,0,1,1,0,Matches
769,Tommy Doyle,ENG,MF,Wolves,Premier League,21,2001,13.6,26,13,11,10,5,14,23,60.9,9,22,9,13,12,38,18,0,Matches
770,Radu Drăgușin,ROU,DF,Tottenham,Premier League,21,2002,4.8,5,3,5,0,0,3,3,100.0,0,5,4,1,8,13,19,0,Matches
771,Radu Drăgușin,ROU,DF,Genoa,Serie A,21,2002,19.0,16,11,9,6,1,8,9,88.9,1,18,12,6,21,37,87,3,Matches
772,Dion Drena Beljo,CRO,"FW,MF",Augsburg,Bundesliga,21,2002,6.5,0,0,0,0,0,0,2,0.0,2,8,1,7,1,1,4,0,Matches
773,Tim Drexler,GER,DF,Hoffenheim,Bundesliga,18,2005,6.4,16,9,12,4,0,8,17,47.1,9,12,8,4,8,24,14,0,Matches
774,Domingos Duarte,POR,DF,Getafe,La Liga,28,1995,10.1,7,4,6,0,1,5,7,71.4,2,7,5,2,8,15,27,0,Matches
775,Rubén Duarte,ESP,DF,Alavés,La Liga,27,1995,20.9,39,20,21,16,2,21,31,67.7,10,21,6,15,23,62,69,0,Matches
776,Martin Dúbravka,SVK,GK,Newcastle Utd,Premier League,34,1989,22.1,0,0,0,0,0,0,4,0.0,4,0,0,0,0,0,8,1,Matches
777,Marvin Ducksch,GER,FW,Werder Bremen,Bundesliga,29,1994,30.0,8,3,4,3,1,6,14,42.9,8,2,0,2,4,12,25,0,Matches
778,Ondrej Duda,SVK,MF,Hellas Verona,Serie A,28,1994,27.3,59,39,17,35,7,31,52,59.6,21,29,12,17,26,85,21,0,Matches
779,Denzel Dumfries,NED,DF,Inter,Serie A,27,1996,18.2,22,13,9,11,2,9,23,39.1,14,15,6,9,12,34,33,1,Matches
780,Paul Dummett,WAL,DF,Newcastle Utd,Premier League,31,1991,0.2,1,0,1,0,0,1,1,100.0,0,0,0,0,0,1,1,0,Matches
781,Alfred Duncan,GHA,MF,Fiorentina,Serie A,30,1993,21.0,35,22,13,15,7,15,35,42.9,20,27,5,22,11,46,13,0,Matches
782,Lewis Dunk,ENG,DF,Brighton,Premier League,31,1991,31.9,27,14,17,9,1,13,36,36.1,23,49,37,12,31,58,90,1,Matches
783,Jhon Durán,COL,"FW,MF",Aston Villa,Premier League,19,2003,5.3,6,5,3,1,2,1,6,16.7,5,6,0,6,1,7,10,0,Matches
784,Julien Duranville,BEL,"FW,MF",Dortmund,Bundesliga,17,2006,0.1,1,0,0,1,0,1,1,100.0,0,0,0,0,0,1,0,0,Matches
785,Hugo Duro,ESP,FW,Valencia,La Liga,23,1999,33.1,16,8,5,8,3,9,29,31.0,20,24,5,19,5,21,27,0,Matches
786,Jean-Kevin Duverne,HAI,DF,Nantes,Ligue 1,26,1997,15.0,37,19,16,17,4,18,44,40.9,26,17,5,12,18,55,34,0,Matches
787,Paulo Dybala,ARG,"FW,MF",Roma,Serie A,29,1993,21.8,22,13,3,10,9,2,18,11.1,16,12,0,12,3,25,6,1,Matches
788,Aron Dønnum,NOR,"FW,MF",Toulouse,Ligue 1,25,1998,17.7,16,10,3,8,5,7,22,31.8,15,13,0,13,8,24,16,1,Matches
789,George Earthy,ENG,FW,West Ham,Premier League,18,2004,0.4,0,0,0,0,0,0,1,0.0,1,0,0,0,1,1,0,0,Matches
790,Simon Ebonog,CMR,MF,Le Havre,Ligue 1,18,2004,0.2,1,1,0,1,0,1,1,100.0,0,1,1,0,0,1,1,0,Matches
791,Festy Ebosele,IRL,DF,Udinese,Serie A,20,2002,18.9,33,20,23,9,1,21,35,60.0,14,33,2,31,10,43,27,0,Matches
792,Enzo Ebosse,CMR,DF,Udinese,Serie A,24,1999,0.1,1,1,1,0,0,0,1,0.0,1,0,0,0,1,2,0,0,Matches
793,Tyronne Ebuehi,NGA,DF,Empoli,Serie A,27,1995,12.2,14,9,9,5,0,7,11,63.6,4,9,4,5,6,20,27,1,Matches
794,Ederson,BRA,GK,Manchester City,Premier League,29,1993,30.9,0,0,0,0,0,0,1,0.0,1,0,0,0,0,0,10,1,Matches
795,Éderson,BRA,MF,Atalanta,Serie A,24,1999,31.9,83,49,38,38,7,44,63,69.8,19,48,8,40,41,124,33,1,Matches
796,Odsonne Édouard,FRA,"FW,MF",Crystal Palace,Premier League,25,1998,17.3,24,12,8,8,8,4,19,21.1,15,17,1,16,6,30,19,0,Matches
797,John Egan,IRL,DF,Sheffield Utd,Premier League,30,1992,5.4,6,4,4,2,0,4,11,36.4,7,10,4,6,13,19,39,1,Matches
798,Maximilian Eggestein,GER,MF,Freiburg,Bundesliga,26,1996,32.4,49,24,25,19,5,15,36,41.7,21,53,19,34,28,77,40,1,Matches
799,Lilian Egloff,GER,"MF,DF",Stuttgart,Bundesliga,20,2002,1.2,4,1,3,1,0,2,4,50.0,2,3,1,2,1,5,0,0,Matches
800,Kingsley Ehizibue,NED,DF,Udinese,Serie A,28,1995,10.6,22,14,16,4,2,11,18,61.1,7,21,3,18,8,30,36,0,Matches
801,Hjalmar Ekdal,SWE,DF,Burnley,Premier League,24,1998,4.9,4,2,2,2,0,2,4,50.0,2,10,5,5,6,10,21,0,Matches
802,Hugo Ekitike,FRA,FW,Paris S-G,Ligue 1,21,2002,0.1,0,0,0,0,0,0,0,,0,0,0,0,0,0,0,0,Matches
803,Hugo Ekitike,FRA,FW,Eint Frankfurt,Bundesliga,21,2002,8.0,11,7,3,6,2,4,6,66.7,2,10,0,10,2,13,4,0,Matches
804,Emmanuel Ekong,SWE,FW,Empoli,Serie A,21,2002,0.1,0,0,0,0,0,0,0,,0,0,0,0,0,0,0,0,Matches
805,Caleb Ekuban,GHA,FW,Genoa,Serie A,29,1994,12.6,8,4,2,4,2,5,9,55.6,4,11,3,8,1,9,7,0,Matches
806,Anthony Elanga,SWE,"FW,MF",Nott'ham Forest,Premier League,21,2002,27.0,33,19,20,6,7,17,36,47.2,19,22,2,20,8,41,20,1,Matches
807,Simon Elisor,FRA,FW,Metz,Ligue 1,24,1999,8.5,9,2,3,2,4,2,6,33.3,4,6,1,5,0,9,9,0,Matches
808,Harvey Elliott,ENG,"MF,FW",Liverpool,Premier League,20,2003,15.0,27,17,8,14,5,10,31,32.3,21,27,0,27,6,33,7,0,Matches
809,Elif Elmas,MKD,"FW,MF",Napoli,Serie A,23,1999,3.8,4,3,1,3,0,2,2,100.0,0,2,0,2,2,6,8,0,Matches
810,Elif Elmas,MKD,"MF,FW",RB Leipzig,Bundesliga,23,1999,3.0,8,6,1,6,1,6,8,75.0,2,5,0,5,1,9,2,0,Matches
811,Mohamed Elneny,EGY,MF,Arsenal,Premier League,31,1992,0.3,0,0,0,0,0,0,1,0.0,1,0,0,0,1,1,0,0,Matches
812,Aritz Elustondo,ESP,DF,Real Sociedad,La Liga,29,1994,9.0,11,7,5,4,2,6,14,42.9,8,12,10,2,7,18,26,0,Matches
813,Nico Elvedi,SUI,DF,Gladbach,Bundesliga,26,1996,27.6,33,18,22,10,1,18,24,75.0,6,40,25,15,43,76,150,2,Matches
814,Adri Embarba,ESP,"FW,MF",Almería,La Liga,31,1992,27.5,55,37,29,15,11,26,53,49.1,27,37,1,36,15,70,12,0,Matches
815,Breel Embolo,SUI,FW,Monaco,Ligue 1,26,1997,2.0,3,3,0,2,1,1,4,25.0,3,1,0,1,1,4,2,0,Matches
816,Emanuel Emegha,NED,FW,Strasbourg,Ligue 1,20,2003,23.1,8,5,2,4,2,4,9,44.4,5,13,3,10,2,10,25,0,Matches
817,Emerson,BRA,DF,Tottenham,Premier League,24,1999,12.9,36,24,23,10,3,21,43,48.8,22,23,10,13,20,56,50,1,Matches
818,Youssef En-Nesyri,MAR,FW,Sevilla,La Liga,26,1997,28.6,10,7,3,4,3,0,10,0.0,10,9,1,8,7,17,29,1,Matches
819,Julio Enciso,PAR,"MF,FW",Brighton,Premier League,19,2004,5.3,6,2,3,2,1,2,7,28.6,5,11,0,11,0,6,3,0,Matches
820,Wataru Endo,JPN,MF,Liverpool,Premier League,30,1993,19.1,48,28,11,31,6,20,61,32.8,41,24,2,22,20,68,31,3,Matches
821,Arne Engels,BEL,"MF,DF",Augsburg,Bundesliga,19,2003,15.6,33,18,15,14,4,12,29,41.4,17,23,1,22,15,48,21,0,Matches
822,Christian Eriksen,DEN,MF,Manchester Utd,Premier League,31,1992,12.7,18,13,5,10,3,12,33,36.4,21,17,6,11,4,22,13,0,Matches
823,Martin Erlic,CRO,DF,Sassuolo,Serie A,25,1998,29.1,37,22,26,8,3,20,30,66.7,10,31,16,15,28,65,128,1,Matches
824,Gonzalo Escalante,ARG,MF,Cádiz,La Liga,30,1993,18.9,39,24,16,14,9,20,55,36.4,35,23,5,18,26,65,33,2,Matches
825,Aarón Escandell,ESP,GK,Las Palmas,La Liga,27,1995,1.7,0,0,0,0,0,0,0,,0,0,0,0,0,0,1,1,Matches
826,Alfonso Espino,URU,DF,Rayo Vallecano,La Liga,31,1992,27.9,67,45,43,22,2,30,82,36.6,52,26,4,22,40,107,63,0,Matches
827,Bernardo Espinosa,COL,DF,Girona,La Liga,34,1989,0.0,1,1,1,0,0,1,1,100.0,0,0,0,0,0,1,2,0,Matches
828,Maxime Estève,FRA,DF,Burnley,Premier League,21,2002,14.5,27,10,15,12,0,18,32,56.3,14,21,10,11,27,54,56,0,Matches
829,Maxime Estève,FRA,DF,Montpellier,Ligue 1,21,2002,11.1,16,12,11,5,0,10,15,66.7,5,13,9,4,18,34,50,0,Matches
830,Oscar Estupiñan,COL,FW,Metz,Ligue 1,26,1996,2.9,5,4,0,3,2,1,2,50.0,1,2,0,2,0,5,0,0,Matches
831,Pervis Estupiñán,ECU,DF,Brighton,Premier League,25,1998,13.8,26,13,12,11,3,14,30,46.7,16,14,4,10,21,47,20,0,Matches
832,Karl Etta,CMR,FW,Cádiz,La Liga,19,2004,0.2,1,1,0,1,0,0,0,,0,0,0,0,0,1,0,0,Matches
833,Jonny Evans,NIR,DF,Manchester Utd,Premier League,35,1988,15.5,22,14,20,2,0,12,21,57.1,9,25,18,7,23,45,76,0,Matches
834,Eberechi Eze,ENG,"MF,FW",Crystal Palace,Premier League,25,1998,22.8,35,17,4,18,13,15,31,48.4,16,27,2,25,11,46,6,0,Matches
835,Abde Ezzalzouli,MAR,"FW,MF",Barcelona,La Liga,21,2001,0.8,1,1,0,0,1,0,1,0.0,1,1,0,1,0,1,0,0,Matches
836,Abde Ezzalzouli,MAR,FW,Betis,La Liga,21,2001,9.6,17,14,7,5,5,4,14,28.6,10,10,0,10,5,22,5,0,Matches
837,Giovanni Fabbian,ITA,"MF,FW",Bologna,Serie A,20,2003,11.7,17,10,9,7,1,7,12,58.3,5,5,2,3,7,24,11,0,Matches
838,Łukasz Fabiański,POL,GK,West Ham,Premier League,38,1985,8.0,1,0,1,0,0,1,2,50.0,1,0,0,0,1,2,4,0,Matches
839,Nicolò Fagioli,ITA,MF,Juventus,Serie A,22,2001,4.9,5,3,1,3,1,3,7,42.9,4,3,0,3,4,9,1,0,Matches
840,Romain Faivre,FRA,"MF,FW",Bournemouth,Premier League,25,1998,0.5,1,1,0,1,0,0,3,0.0,3,0,0,0,0,1,0,0,Matches
841,Romain Faivre,FRA,"MF,FW",Lorient,Ligue 1,25,1998,16.1,13,6,5,4,4,6,15,40.0,9,6,1,5,7,20,3,1,Matches
842,Ilhan Fakili,FRA,"MF,FW",Clermont Foot,Ligue 1,17,2006,1.0,0,0,0,0,0,0,1,0.0,1,1,0,1,1,1,0,0,Matches
843,Radamel Falcao,COL,"FW,DF",Rayo Vallecano,La Liga,37,1986,4.5,7,5,1,5,1,1,3,33.3,2,2,0,2,3,10,4,0,Matches
844,Wladimiro Falcone,ITA,GK,Lecce,Serie A,28,1995,38.0,0,0,0,0,0,0,0,,0,1,0,1,1,1,21,2,Matches
845,Fali,ESP,DF,Cádiz,La Liga,29,1993,28.3,41,26,29,11,1,21,36,58.3,15,38,24,14,27,68,120,0,Matches
846,Davide Faraoni,ITA,DF,Hellas Verona,Serie A,31,1991,6.7,13,10,5,6,2,7,10,70.0,3,9,5,4,6,19,21,0,Matches
847,Davide Faraoni,ITA,DF,Fiorentina,Serie A,31,1991,4.4,9,4,5,2,2,5,11,45.5,6,3,1,2,5,14,14,0,Matches
848,Ansu Fati,ESP,"MF,FW",Brighton,Premier League,20,2002,5.8,5,3,1,2,2,1,11,9.1,10,8,0,8,3,8,3,0,Matches
849,Ansu Fati,ESP,"MF,FW",Barcelona,La Liga,20,2002,0.6,0,0,0,0,0,0,1,0.0,1,0,0,0,0,0,0,0,Matches
850,Khalil Fayad,FRA,"FW,MF",Montpellier,Ligue 1,19,2004,11.4,28,15,17,7,4,9,22,40.9,13,15,3,12,14,42,6,0,Matches
851,Federico Fazio,ARG,DF,Salernitana,Serie A,36,1987,15.1,18,11,14,4,0,8,14,57.1,6,22,19,3,17,35,99,1,Matches
852,Jacopo Fazzini,ITA,MF,Empoli,Serie A,20,2003,13.7,49,25,27,13,9,30,53,56.6,23,21,3,18,12,61,18,0,Matches
853,Peter Federico,DOM,"MF,FW",Valencia,La Liga,21,2002,7.2,5,3,3,1,1,1,10,10.0,9,11,0,11,7,12,10,0,Matches
854,Nabil Fekir,FRA,"MF,FW",Betis,La Liga,30,1993,11.7,15,10,5,7,3,5,10,50.0,5,9,0,9,7,22,3,0,Matches
855,Felipe,BRA,DF,Nott'ham Forest,Premier League,34,1989,4.2,12,9,9,3,0,9,12,75.0,3,4,1,3,4,16,12,0,Matches
856,Luiz Felipe,ITA,DF,Betis,La Liga,26,1997,4.0,7,3,5,2,0,4,5,80.0,1,10,4,6,4,11,16,0,Matches
857,João Félix,POR,FW,Barcelona,La Liga,23,1999,17.1,22,16,9,7,6,8,22,36.4,14,14,1,13,10,32,11,0,Matches
858,Ohis Felix Uduokhai,GER,DF,Augsburg,Bundesliga,25,1997,32.5,37,21,18,14,5,16,25,64.0,9,45,35,10,46,83,178,2,Matches
859,Kiko Femenía,ESP,DF,Villarreal,La Liga,32,1991,17.6,35,25,19,13,3,19,34,55.9,15,21,6,15,31,66,45,0,Matches
860,Evan Ferguson,IRL,FW,Brighton,Premier League,18,2004,15.2,14,6,4,7,3,5,14,35.7,9,10,3,7,2,16,8,0,Matches
861,Lewis Ferguson,SCO,MF,Bologna,Serie A,23,1999,30.1,37,21,16,17,4,16,37,43.2,21,25,8,17,17,54,27,1,Matches
862,Bruno Fernandes,POR,"MF,FW",Manchester Utd,Premier League,28,1994,34.6,68,38,27,25,16,30,88,34.1,58,49,6,43,27,95,50,2,Matches
863,Edimilson Fernandes,SUI,DF,Mainz 05,Bundesliga,27,1996,14.3,25,16,15,9,1,16,24,66.7,8,14,6,8,22,47,52,0,Matches
864,Aitor Fernández,ESP,GK,Osasuna,La Liga,32,1991,6.1,0,0,0,0,0,0,1,0.0,1,0,0,0,0,0,5,1,Matches
865,Álex Fernández,ESP,MF,Cádiz,La Liga,30,1992,14.3,19,9,10,9,0,11,22,50.0,11,17,5,12,15,34,30,0,Matches
866,Carlos Fernández,ESP,FW,Real Sociedad,La Liga,27,1996,4.5,11,7,3,6,2,0,2,0.0,2,4,0,4,0,11,5,0,Matches
867,Enzo Fernández,ARG,MF,Chelsea,Premier League,22,2001,24.5,50,22,22,18,10,27,65,41.5,38,36,13,23,17,67,28,0,Matches
868,Raúl Fernández,ESP,GK,Granada,La Liga,35,1988,3.1,0,0,0,0,0,0,1,0.0,1,0,0,0,0,0,1,2,Matches
869,Valery Fernández,ESP,"MF,FW",Girona,La Liga,23,1999,5.6,11,9,4,7,0,6,8,75.0,2,6,1,5,1,12,4,0,Matches
870,Fernando,ESP,GK,Almería,La Liga,33,1990,4.0,0,0,0,0,0,0,0,,0,1,0,1,0,0,2,0,Matches
871,Fernando,BRA,MF,Sevilla,La Liga,36,1987,5.1,9,8,2,4,3,5,9,55.6,4,2,0,2,7,16,9,0,Matches
872,Ichem Ferrah,FRA,FW,Lille,Ligue 1,17,2005,0.0,0,0,0,0,0,0,0,,0,0,0,0,0,0,0,0,Matches
873,Andrea Ferraris,ITA,MF,Monza,Serie A,20,2003,0.1,1,1,1,0,0,0,0,,0,0,0,0,0,1,0,0,Matches
874,André Ferreira,POR,GK,Granada,La Liga,27,1996,14.9,0,0,0,0,0,0,1,0.0,1,0,0,0,0,0,9,2,Matches
875,João Ferreira,POR,DF,Udinese,Serie A,22,2001,20.2,58,42,36,18,4,34,58,58.6,24,27,6,21,29,87,89,0,Matches
876,Jordan Ferri,FRA,MF,Montpellier,Ligue 1,31,1992,22.6,36,22,16,17,3,20,67,29.9,47,19,1,18,13,49,23,0,Matches
877,Nacho Ferri,ESP,"FW,MF",Eint Frankfurt,Bundesliga,18,2004,0.8,3,3,1,2,0,2,3,66.7,1,0,0,0,0,3,2,0,Matches
878,Rachad Fettal,MAR,FW,Almería,La Liga,18,2005,0.2,1,1,1,0,0,0,0,,0,0,0,0,0,1,0,0,Matches
879,Seydou Fini,ITA,"DF,FW",Genoa,Serie A,17,2006,0.4,0,0,0,0,0,0,0,,0,0,0,0,0,0,0,0,Matches
880,Max Finkgräfe,GER,"DF,FW",Köln,Bundesliga,19,2004,19.5,65,39,40,25,0,39,74,52.7,35,35,10,25,22,87,39,0,Matches
881,Vincenzo Fiorillo,ITA,GK,Salernitana,Serie A,33,1990,4.0,0,0,0,0,0,0,0,,0,0,0,0,0,0,0,1,Matches
882,Kilian Fischer,GER,"DF,MF",Wolfsburg,Bundesliga,22,2000,3.2,8,6,4,3,1,2,5,40.0,3,8,1,7,1,9,12,0,Matches
883,John Fleck,SCO,"MF,DF",Sheffield Utd,Premier League,31,1991,1.0,1,0,0,1,0,0,1,0.0,1,0,0,0,0,1,1,0,Matches
884,Mark Flekken,NED,GK,Brentford,Premier League,30,1993,36.5,1,1,1,0,0,1,5,20.0,4,1,0,1,0,1,17,1,Matches
885,Alessandro Florenzi,ITA,DF,Milan,Serie A,32,1991,19.2,43,21,26,12,5,26,48,54.2,22,16,9,7,20,63,25,1,Matches
886,Phil Foden,ENG,"FW,MF",Manchester City,Premier League,23,2000,31.7,31,20,11,10,10,13,31,41.9,18,30,0,30,13,44,18,1,Matches
887,Wes Foderingham,ENG,GK,Sheffield Utd,Premier League,32,1991,29.4,5,3,5,0,0,5,6,83.3,1,0,0,0,0,5,18,6,Matches
888,Malick Fofana,BEL,FW,Lyon,Ligue 1,18,2005,6.2,5,4,3,1,1,4,9,44.4,5,3,0,3,5,10,9,0,Matches
889,Youssouf Fofana,FRA,MF,Monaco,Ligue 1,24,1999,30.0,61,39,19,36,6,30,66,45.5,36,35,7,28,37,98,31,1,Matches
890,Jonas Föhrenbach,GER,DF,Heidenheim,Bundesliga,27,1996,31.0,44,24,24,14,6,19,36,52.8,17,34,19,15,31,75,70,0,Matches
891,Thomas Foket,BEL,DF,Reims,Ligue 1,28,1994,20.4,32,17,21,8,3,20,45,44.4,25,34,12,22,25,57,36,0,Matches
892,Michael Folorunsho,ITA,"MF,FW",Hellas Verona,Serie A,25,1998,30.9,50,28,21,22,7,23,57,40.4,34,45,12,33,17,67,44,2,Matches
893,Tiago Fonseca Morais,POR,FW,Lille,Ligue 1,19,2003,0.5,1,1,0,1,0,0,0,,0,0,0,0,1,2,0,0,Matches
894,Pablo Fornals,ESP,"MF,FW",West Ham,Premier League,27,1996,4.7,10,6,4,3,3,5,16,31.3,11,8,1,7,6,16,7,0,Matches
895,Pablo Fornals,ESP,"FW,MF",Betis,La Liga,27,1996,12.8,24,16,8,11,5,12,22,54.5,10,14,0,14,22,46,10,2,Matches
896,Emil Forsberg,SWE,"MF,FW",RB Leipzig,Bundesliga,31,1991,5.2,7,3,2,5,0,5,12,41.7,7,7,0,7,0,7,5,0,Matches
897,Omari Forson,ENG,FW,Manchester Utd,Premier League,19,2004,0.8,2,0,0,2,0,1,1,100.0,0,0,0,0,0,2,0,0,Matches
898,Philipp Förster,GER,"MF,FW",Bochum,Bundesliga,28,1995,4.3,9,5,3,4,2,2,6,33.3,4,3,0,3,7,16,3,0,Matches
899,Héctor Fort,ESP,DF,Barcelona,La Liga,16,2006,3.5,6,5,5,1,0,4,10,40.0,6,0,0,0,2,8,4,0,Matches
900,Lyle Foster,RSA,"FW,MF",Burnley,Premier League,22,2000,21.1,19,10,5,6,8,6,17,35.3,11,13,3,10,3,22,34,0,Matches
901,Dimitri Foulquier,FRA,"DF,MF",Valencia,La Liga,30,1993,20.5,39,22,22,13,4,18,26,69.2,8,10,1,9,16,55,49,1,Matches
902,Juan Foyth,ARG,DF,Villarreal,La Liga,25,1998,11.8,26,15,18,8,0,12,27,44.4,15,17,4,13,12,38,44,0,Matches
903,Matheus França,BRA,"MF,FW",Crystal Palace,Premier League,19,2004,2.6,3,3,2,1,0,1,7,14.3,6,4,0,4,1,4,1,0,Matches
904,Bartol Franjić,CRO,MF,Darmstadt 98,Bundesliga,23,2000,13.7,15,12,4,10,1,7,28,25.0,21,12,4,8,30,45,29,2,Matches
905,Przemysław Frankowski,POL,DF,Lens,Ligue 1,28,1995,24.4,60,39,25,26,9,31,74,41.9,43,30,7,23,25,85,36,0,Matches
906,Nathan Fraser,IRL,FW,Wolves,Premier League,18,2005,2.1,5,2,2,1,2,1,3,33.3,2,2,1,1,1,6,2,0,Matches
907,Davide Frattesi,ITA,MF,Inter,Serie A,23,1999,10.6,10,6,3,7,0,4,8,50.0,4,9,3,6,5,15,19,0,Matches
908,Jean Frederic N'Guessan,CIV,"MF,FW",Metz,Ligue 1,20,2003,1.2,3,1,0,3,0,0,3,0.0,3,3,0,3,1,4,0,0,Matches
909,Morten Frendrup,DEN,MF,Genoa,Serie A,22,2001,34.9,133,72,47,70,16,55,91,60.4,36,55,14,41,51,184,42,1,Matches
910,Remo Freuler,SUI,MF,Bologna,Serie A,31,1992,29.2,78,50,41,32,5,38,69,55.1,31,37,9,28,36,114,53,2,Matches
911,Marco Friedl,AUT,DF,Werder Bremen,Bundesliga,25,1998,24.4,53,32,38,15,0,36,48,75.0,12,45,29,16,35,88,129,0,Matches
912,Marvin Friedrich,GER,DF,Gladbach,Bundesliga,27,1995,17.4,23,15,16,6,1,12,20,60.0,8,28,20,8,17,40,87,0,Matches
913,Jeremie Frimpong,NED,DF,Leverkusen,Bundesliga,22,2000,25.0,26,17,12,7,7,8,20,40.0,12,26,0,26,7,33,17,0,Matches
914,Jorge de Frutos,ESP,"FW,MF",Rayo Vallecano,La Liga,26,1997,17.2,19,8,5,8,6,7,22,31.8,15,12,0,12,7,26,18,0,Matches
915,Chris Führich,GER,"FW,MF",Stuttgart,Bundesliga,25,1998,28.5,30,19,6,14,10,16,37,43.2,21,31,0,31,7,37,7,0,Matches
916,Shiō Fukuda,JPN,"FW,MF",Gladbach,Bundesliga,19,2004,0.4,2,0,1,1,0,1,2,50.0,1,0,0,0,1,3,0,0,Matches
917,Angelo Fulgini,FRA,MF,Lens,Ligue 1,26,1996,15.3,23,14,6,13,4,11,19,57.9,8,22,1,21,8,31,11,0,Matches
918,Niclas Füllkrug,GER,FW,Werder Bremen,Bundesliga,30,1993,2.0,1,1,0,1,0,1,1,100.0,0,2,1,1,0,1,1,0,Matches
919,Niclas Füllkrug,GER,FW,Dortmund,Bundesliga,30,1993,24.6,7,2,1,6,0,2,8,25.0,6,17,4,13,2,9,25,0,Matches
920,Gerardo Fusco,ITA,FW,Salernitana,Serie A,18,2005,0.2,0,0,0,0,0,0,0,,0,0,0,0,0,0,0,0,Matches
921,Daniel Fuzato,BRA,GK,Getafe,La Liga,26,1997,0.1,0,0,0,0,0,0,0,,0,0,0,0,0,0,1,0,Matches
922,Matteo Gabbia,ITA,DF,Milan,Serie A,23,1999,14.2,29,20,15,13,1,18,24,75.0,6,11,6,5,10,39,48,0,Matches
923,Matteo Gabbia,ITA,DF,Villarreal,La Liga,23,1999,5.3,10,6,4,6,0,5,8,62.5,3,5,2,3,8,18,36,1,Matches
924,Gianluca Gaetano,ITA,"FW,MF",Cagliari,Serie A,23,2000,8.3,7,4,0,4,3,2,7,28.6,5,4,0,4,3,10,4,0,Matches
925,Gianluca Gaetano,ITA,MF,Napoli,Serie A,23,2000,1.8,4,1,0,4,0,2,4,50.0,2,5,2,3,1,5,4,0,Matches
926,Roberto Gagliardini,ITA,"MF,DF",Monza,Serie A,29,1994,26.2,61,30,27,25,9,31,50,62.0,19,30,11,19,31,92,38,0,Matches
927,Cody Gakpo,NED,"FW,MF",Liverpool,Premier League,24,1999,18.3,27,17,8,14,5,8,25,32.0,17,21,4,17,14,41,7,0,Matches
928,Javi Galán,ESP,DF,Atlético Madrid,La Liga,28,1994,1.0,5,4,2,2,1,4,5,80.0,1,1,0,1,1,6,3,0,Matches
929,Javi Galán,ESP,DF,Real Sociedad,La Liga,28,1994,11.9,38,22,15,19,4,15,30,50.0,15,24,1,23,14,52,17,1,Matches
930,Iñigo Ruiz de Galarreta,ESP,MF,Athletic Club,La Liga,29,1993,23.2,49,31,15,26,8,24,49,49.0,25,18,5,13,12,61,17,0,Matches
931,Pablo Galdames Millán,CHI,"MF,DF",Genoa,Serie A,26,1996,0.1,0,0,0,0,0,0,0,,0,1,0,1,0,0,0,0,Matches
932,Conor Gallagher,ENG,MF,Chelsea,Premier League,23,2000,34.8,85,52,37,31,17,33,77,42.9,44,50,11,39,43,128,34,0,Matches
933,Antonino Gallo,ITA,DF,Lecce,Serie A,23,2000,27.7,43,27,31,11,1,31,49,63.3,18,34,9,25,25,68,67,0,Matches
934,Cristian Gamboa,CRC,DF,Bochum,Bundesliga,33,1989,13.2,24,18,12,11,1,14,33,42.4,19,20,7,13,15,39,34,1,Matches
935,Kévin Gameiro,FRA,"FW,MF",Strasbourg,Ligue 1,36,1987,15.0,10,10,5,3,2,2,17,11.8,15,9,0,9,3,13,7,0,Matches
936,Idrissa Gana Gueye,SEN,MF,Everton,Premier League,33,1989,20.9,73,44,32,27,14,29,46,63.0,17,24,7,17,28,101,16,0,Matches
937,Ignatius Ganago,CMR,"FW,MF",Nantes,Ligue 1,24,1999,2.0,0,0,0,0,0,0,1,0.0,1,1,0,1,1,1,1,0,Matches
938,Aleix García,ESP,MF,Girona,La Liga,26,1997,35.5,49,28,17,26,6,28,54,51.9,26,45,17,28,36,85,53,3,Matches
939,Álvaro García,ESP,"FW,MF",Rayo Vallecano,La Liga,30,1992,27.5,34,25,15,10,9,7,34,20.6,27,35,0,35,36,70,33,0,Matches
940,Dani García,ESP,MF,Athletic Club,La Liga,33,1990,8.3,17,11,4,7,6,12,24,50.0,12,9,3,6,8,25,11,0,Matches
941,David García,ESP,DF,Osasuna,La Liga,29,1994,25.9,29,18,19,9,1,16,26,61.5,10,40,19,21,18,47,115,2,Matches
942,Eric García,ESP,DF,Barcelona,La Liga,22,2001,0.6,0,0,0,0,0,0,0,,0,1,1,0,0,0,0,0,Matches
943,Eric García,ESP,DF,Girona,La Liga,22,2001,29.3,55,37,34,18,3,34,49,69.4,15,36,18,18,30,85,79,2,Matches
944,Fran Garcia,ESP,DF,Real Madrid,La Liga,23,1999,15.5,25,17,11,12,2,13,31,41.9,18,16,3,13,19,44,28,1,Matches
945,Francisco Jesús Crespo García,ESP,FW,Las Palmas,La Liga,27,1996,5.6,12,8,3,6,3,6,18,33.3,12,4,0,4,2,14,5,0,Matches
946,Gonzalo García,ESP,"FW,MF",Real Madrid,La Liga,19,2004,0.2,0,0,0,0,0,0,1,0.0,1,1,1,0,0,0,1,0,Matches
947,Jastin García,ESP,FW,Girona,La Liga,19,2004,0.4,1,0,0,0,1,0,0,,0,0,0,0,0,1,1,0,Matches
948,Raúl García,ESP,"FW,MF",Athletic Club,La Liga,37,1986,4.7,9,6,2,4,3,4,9,44.4,5,10,1,9,3,12,9,0,Matches
949,Rubén García,ESP,"FW,MF",Osasuna,La Liga,30,1993,17.2,32,18,8,17,7,13,33,39.4,20,23,3,20,12,44,23,0,Matches
950,Santiago García,ESP,FW,Getafe,La Liga,21,2001,0.3,1,0,0,0,1,1,1,100.0,0,0,0,0,0,1,0,0,Matches
951,Ulisses Garcia,SUI,DF,Marseille,Ligue 1,27,1996,10.1,21,16,6,13,2,13,20,65.0,7,8,3,5,7,28,13,2,Matches
952,Unai García,ESP,DF,Osasuna,La Liga,31,1992,6.2,12,9,9,2,1,5,10,50.0,5,7,1,6,8,20,18,0,Matches
953,Alejandro Garnacho,ARG,FW,Manchester Utd,Premier League,19,2004,28.5,22,15,7,6,9,12,45,26.7,33,26,2,24,18,40,18,0,Matches
954,James Garner,ENG,MF,Everton,Premier League,22,2001,33.4,83,44,32,38,13,35,82,42.7,47,45,14,31,45,128,47,1,Matches
955,Luca Garritano,ITA,"MF,DF",Frosinone,Serie A,29,1994,5.4,10,5,7,2,1,5,15,33.3,10,13,0,13,4,14,8,1,Matches
956,Yarek Gasiorowski,ESP,DF,Valencia,La Liga,18,2005,8.2,22,12,14,5,3,13,19,68.4,6,15,8,7,15,37,50,1,Matches
957,Johan Gastien,FRA,MF,Clermont Foot,Ligue 1,35,1988,25.1,43,22,18,21,4,23,81,28.4,58,31,9,22,36,79,24,4,Matches
958,Federico Gatti,ITA,DF,Juventus,Serie A,25,1998,29.3,33,19,16,16,1,19,24,79.2,5,26,15,11,19,52,90,1,Matches
959,Federico Gattoni,ARG,"DF,FW",Sevilla,La Liga,24,1999,0.1,1,0,1,0,0,1,1,100.0,0,0,0,0,0,1,1,0,Matches
960,Gavi,ESP,"MF,FW",Barcelona,La Liga,18,2004,10.5,39,21,20,14,5,18,36,50.0,18,19,3,16,8,47,16,1,Matches
961,Paulo Gazzaniga,ARG,GK,Girona,La Liga,31,1992,38.0,2,2,2,0,0,2,4,50.0,2,0,0,0,0,2,12,1,Matches
962,Yann Gboho,FRA,"MF,FW",Toulouse,Ligue 1,22,2001,13.3,14,4,6,6,2,8,23,34.8,15,21,1,20,4,18,2,0,Matches
963,Dennis Geiger,GER,MF,Hoffenheim,Bundesliga,25,1998,0.7,1,0,1,0,0,0,0,,0,1,1,0,0,1,0,0,Matches
964,Gelabert,ESP,"MF,FW",Toulouse,Ligue 1,22,2000,8.4,14,8,5,6,3,7,20,35.0,13,8,2,6,5,19,8,0,Matches
965,Francesco Gelli,ITA,"MF,DF",Frosinone,Serie A,26,1996,17.3,19,13,8,4,7,10,24,41.7,14,19,3,16,11,30,27,1,Matches
966,Luca Gemello,ITA,GK,Torino,Serie A,23,2000,2.0,0,0,0,0,0,0,1,0.0,1,0,0,0,0,0,1,1,Matches
967,Valentin Gendrey,FRA,DF,Lecce,Serie A,23,2000,33.8,55,33,35,16,4,30,46,65.2,16,40,11,29,35,90,99,0,Matches
968,Denis Genreau,AUS,"MF,FW",Toulouse,Ligue 1,24,1999,5.2,12,9,6,6,0,8,15,53.3,7,8,1,7,6,18,8,0,Matches
969,Yannick Gerhardt,GER,"MF,DF",Wolfsburg,Bundesliga,29,1994,18.1,31,20,16,12,3,9,32,28.1,23,15,2,13,7,38,35,0,Matches
970,Anwar El Ghazi,NED,"MF,DF",Mainz 05,Bundesliga,28,1995,0.6,0,0,0,0,0,0,1,0.0,1,0,0,0,0,0,0,0,Matches
971,Farés Ghedjemis,FRA,"FW,MF",Frosinone,Serie A,20,2002,2.0,2,0,1,0,1,0,2,0.0,2,2,0,2,1,3,2,0,Matches
972,Saman Ghoddos,IRN,DF,Brentford,Premier League,29,1993,8.2,28,19,19,7,2,17,31,54.8,14,9,2,7,5,33,12,0,Matches
973,Lautaro Gianetti,ARG,DF,Udinese,Serie A,29,1993,7.0,9,4,7,2,0,4,5,80.0,1,10,6,4,19,28,39,0,Matches
974,Morgan Gibbs-White,ENG,"MF,FW",Nott'ham Forest,Premier League,23,2000,35.1,36,24,6,20,10,14,33,42.4,19,31,8,23,17,53,21,0,Matches
975,Samuel Gigot,FRA,DF,Marseille,Ligue 1,29,1993,19.2,33,22,16,13,4,13,19,68.4,6,28,18,10,25,58,93,1,Matches
976,Bryan Gil,ESP,"FW,MF",Tottenham,Premier League,22,2001,2.3,1,0,0,0,1,1,4,25.0,3,3,0,3,3,4,4,0,Matches
977,David Gil,ESP,GK,Cádiz,La Liga,29,1994,4.1,0,0,0,0,0,0,1,0.0,1,0,0,0,0,0,3,0,Matches
978,Mario Gila,ESP,DF,Lazio,Serie A,22,2000,20.1,32,14,23,8,1,19,34,55.9,15,27,14,13,20,52,69,0,Matches
979,Alfie Gilchrist,ENG,DF,Chelsea,Premier League,19,2003,2.3,4,0,4,0,0,2,5,40.0,3,6,3,3,3,7,11,0,Matches
980,Billy Gilmour,SCO,MF,Brighton,Premier League,22,2001,23.6,26,16,14,10,2,11,35,31.4,24,23,9,14,11,37,14,1,Matches
981,Benedikt Gimber,GER,DF,Heidenheim,Bundesliga,26,1997,22.5,40,24,25,14,1,19,35,54.3,16,27,17,10,16,56,101,1,Matches
982,Gvidas Gineitis,LTU,MF,Torino,Serie A,19,2004,6.0,11,7,3,8,0,4,7,57.1,3,10,4,6,4,15,9,1,Matches
983,Matthias Ginter,GER,DF,Freiburg,Bundesliga,29,1994,21.3,29,15,19,9,1,16,29,55.2,13,40,26,14,16,45,93,0,Matches
984,Olivier Giroud,FRA,FW,Milan,Serie A,36,1986,26.3,17,11,6,6,5,2,14,14.3,12,14,3,11,6,23,22,0,Matches
985,Jamie Gittens,ENG,"FW,MF",Dortmund,Bundesliga,18,2004,11.8,14,7,6,7,1,2,17,11.8,15,11,2,9,4,18,7,0,Matches
986,Klaus Gjasula,ALB,"DF,MF",Darmstadt 98,Bundesliga,33,1989,15.1,44,22,18,25,1,17,30,56.7,13,26,14,12,19,63,42,2,Matches
987,Serge Gnabry,GER,"FW,MF",Bayern Munich,Bundesliga,28,1995,4.8,8,5,0,5,3,2,13,15.4,11,5,0,5,3,11,2,0,Matches
988,Ben Godfrey,ENG,DF,Everton,Premier League,25,1998,12.4,30,20,17,8,5,15,28,53.6,13,14,8,6,16,46,57,0,Matches
989,Edoardo Goldaniga,ITA,DF,Cagliari,Serie A,29,1993,11.2,12,7,9,3,0,4,10,40.0,6,11,7,4,15,27,37,1,Matches
990,Pierluigi Gollini,ITA,GK,Napoli,Serie A,28,1995,7.0,1,1,1,0,0,1,1,100.0,0,0,0,0,1,2,2,0,Matches
991,Aleksandr Golovin,RUS,"MF,FW",Monaco,Ligue 1,27,1996,23.9,42,30,14,22,6,15,42,35.7,27,37,3,34,21,63,14,0,Matches
992,André Gomes,POR,"MF,FW",Everton,Premier League,30,1993,5.6,7,4,2,3,2,3,13,23.1,10,10,1,9,3,10,4,1,Matches
993,Angel Gomes,ENG,MF,Lille,Ligue 1,22,2000,28.6,26,13,4,15,7,14,32,43.8,18,23,6,17,18,44,28,1,Matches
994,João Gomes,BRA,MF,Wolves,Premier League,22,2001,29.4,128,74,67,49,12,44,99,44.4,55,51,8,43,18,146,29,2,Matches
995,Toti Gomes,POR,DF,Wolves,Premier League,24,1999,30.8,44,25,32,8,4,24,37,64.9,13,40,19,21,26,70,93,2,Matches
996,Joe Gomez,ENG,DF,Liverpool,Premier League,26,1997,19.8,47,31,24,16,7,30,63,47.6,33,26,4,22,19,66,50,2,Matches
997,Maxi Gómez,URU,FW,Cádiz,La Liga,26,1996,12.9,6,4,2,3,1,3,5,60.0,2,8,3,5,3,9,3,0,Matches
998,Moi Gómez,ESP,"MF,FW",Osasuna,La Liga,29,1994,22.3,30,19,7,19,4,9,24,37.5,15,15,1,14,11,41,22,0,Matches
999,Papu Gómez,ARG,"MF,FW",Monza,Serie A,35,1988,0.5,0,0,0,0,0,0,2,0.0,2,0,0,0,1,1,0,0,Matches
1000,Sergio Gómez,ESP,"FW,MF",Manchester City,Premier League,22,2000,0.6,1,0,0,1,0,1,2,50.0,1,0,0,0,1,2,0,0,Matches
1001,Unai Gómez,ESP,MF,Athletic Club,La Liga,20,2003,9.7,12,10,2,6,4,5,10,50.0,5,13,2,11,2,14,9,0,Matches
1002,Iron Gomis,FRA,MF,Salernitana,Serie A,23,1999,1.5,4,1,2,2,0,0,1,0.0,1,2,0,2,2,6,2,0,Matches
1003,Maxime Gonalons,FRA,MF,Clermont Foot,Ligue 1,34,1989,14.4,47,33,14,27,6,25,57,43.9,32,18,3,15,20,67,11,0,Matches
1004,Édgar González,ESP,"DF,MF",Almería,La Liga,26,1997,28.0,45,21,22,20,3,25,49,51.0,24,48,28,20,38,83,130,3,Matches
1005,Enso Gonzalez,PAR,"MF,DF",Wolves,Premier League,18,2005,0.0,0,0,0,0,0,0,1,0.0,1,0,0,0,0,0,0,0,Matches
1006,Fabio González,ESP,MF,Las Palmas,La Liga,26,1997,1.4,2,2,2,0,0,1,2,50.0,1,2,0,2,0,2,0,0,Matches
1007,Giovanni González,URU,DF,Mallorca,La Liga,28,1994,27.4,73,45,37,32,4,40,81,49.4,41,24,3,21,31,104,60,2,Matches
1008,Hugo González,ESP,"MF,FW",Valencia,La Liga,20,2003,1.0,2,1,0,2,0,0,0,,0,0,0,0,0,2,0,0,Matches
1009,Iñaki González,ESP,MF,Las Palmas,La Liga,19,2004,0.1,1,0,1,0,0,0,0,,0,0,0,0,0,1,1,0,Matches
1010,Joan Gonzàlez,ESP,MF,Lecce,Serie A,21,2002,14.3,31,18,16,12,3,17,28,60.7,11,20,3,17,5,36,9,0,Matches
1011,Nicolás González,ARG,FW,Fiorentina,Serie A,25,1998,21.3,28,18,15,8,5,8,28,28.6,20,26,1,25,12,40,9,0,Matches
1012,Urko González,ESP,MF,Real Sociedad,La Liga,22,2001,1.7,4,1,0,3,1,2,2,100.0,0,1,0,1,1,5,6,0,Matches
1013,Anthony Gordon,ENG,FW,Newcastle Utd,Premier League,22,2001,32.1,55,34,16,28,11,22,64,34.4,42,27,0,27,7,62,7,0,Matches
1014,Kaide Gordon,ENG,FW,Liverpool,Premier League,18,2004,0.0,0,0,0,0,0,0,0,,0,0,0,0,0,0,0,0,Matches
1015,Daniel Gore,ENG,MF,Manchester Utd,Premier League,18,2004,0.0,1,1,0,1,0,1,1,100.0,0,0,0,0,1,2,0,0,Matches
1016,Leon Goretzka,GER,MF,Bayern Munich,Bundesliga,28,1995,24.9,41,23,18,14,9,24,54,44.4,30,44,8,36,31,72,42,1,Matches
1017,Mathieu Gorgelin,FRA,GK,Le Havre,Ligue 1,32,1990,1.0,0,0,0,0,0,0,0,,0,0,0,0,0,0,0,0,Matches
1018,Andoni Gorosabel,ESP,DF,Alavés,La Liga,26,1996,31.7,62,42,40,17,5,38,75,50.7,37,24,8,16,28,90,69,0,Matches
1019,Robin Gosens,GER,"DF,MF",Union Berlin,Bundesliga,29,1994,25.4,63,44,25,31,7,30,44,68.2,14,52,9,43,36,99,75,0,Matches
1020,Mario Götze,GER,MF,Eint Frankfurt,Bundesliga,31,1992,23.0,51,34,18,25,8,28,62,45.2,34,19,3,16,14,65,10,0,Matches
1021,Amine Gouiri,ALG,"FW,MF",Rennes,Ligue 1,23,2000,23.0,20,10,4,11,5,8,19,42.1,11,18,1,17,14,34,12,0,Matches
1022,Jeffrey Gouweleeuw,NED,DF,Augsburg,Bundesliga,32,1991,28.8,35,23,13,17,5,16,25,64.0,9,44,24,20,35,70,108,0,Matches
1023,Pablo Gozalbez,ESP,"MF,FW",Valencia,La Liga,22,2001,1.1,1,0,0,0,1,1,6,16.7,5,0,0,0,1,2,2,0,Matches
1024,Jonathan Gradit,FRA,DF,Lens,Ligue 1,30,1992,23.5,32,20,15,14,3,19,35,54.3,16,30,17,13,37,69,61,0,Matches
1025,Jens Grahl,GER,GK,Eint Frankfurt,Bundesliga,34,1988,2.0,0,0,0,0,0,0,0,,0,0,0,0,0,0,3,0,Matches
1026,Samuel Grandsir,FRA,"MF,FW",Le Havre,Ligue 1,26,1996,6.7,16,12,5,9,2,8,18,44.4,10,4,0,4,3,19,3,1,Matches
1027,Alberto Grassi,ITA,MF,Empoli,Serie A,28,1995,20.1,30,18,13,13,4,10,26,38.5,16,26,11,15,41,71,37,0,Matches
1028,Ryan Gravenberch,NED,MF,Liverpool,Premier League,21,2002,12.5,26,12,5,13,8,12,29,41.4,17,20,2,18,14,40,11,0,Matches
1029,Ryan Gravenberch,NED,FW,Bayern Munich,Bundesliga,21,2002,0.1,0,0,0,0,0,0,0,,0,0,0,0,0,0,0,0,Matches
1030,Adrian Grbić,AUT,FW,Lorient,Ligue 1,26,1996,0.3,0,0,0,0,0,0,0,,0,0,0,0,0,0,0,0,Matches
1031,Ivo Grbić,CRO,GK,Sheffield Utd,Premier League,27,1996,8.6,0,0,0,0,0,0,1,0.0,1,1,0,1,0,0,9,1,Matches
1032,Jack Grealish,ENG,"FW,MF",Manchester City,Premier League,27,1995,11.2,13,8,6,7,0,6,12,50.0,6,13,2,11,6,19,5,0,Matches
1033,Mason Greenwood,ENG,"MF,FW",Getafe,La Liga,21,2001,29.6,11,6,3,5,3,4,21,19.0,17,9,0,9,4,15,4,0,Matches
1034,Michael Gregoritsch,AUT,FW,Freiburg,Bundesliga,29,1994,18.7,16,12,8,5,3,2,14,14.3,12,17,4,13,9,25,27,0,Matches
1035,Dominik Greif,SVK,GK,Mallorca,La Liga,26,1997,1.0,0,0,0,0,0,0,0,,0,0,0,0,0,0,0,0,Matches
1036,Antoine Griezmann,FRA,"FW,MF",Atlético Madrid,La Liga,32,1991,29.4,33,19,14,14,5,15,41,36.6,26,34,3,31,10,43,23,1,Matches
1037,Vincenzo Grifo,ITA,"MF,FW",Freiburg,Bundesliga,30,1993,25.8,31,20,14,11,6,14,31,45.2,17,22,1,21,15,46,20,0,Matches
1038,Florian Grillitsch,AUT,"DF,MF",Hoffenheim,Bundesliga,27,1995,25.5,54,28,31,19,4,22,54,40.7,32,41,20,21,52,106,90,2,Matches
1039,Álex Grimaldo,ESP,DF,Leverkusen,Bundesliga,27,1995,30.9,45,24,26,10,9,30,55,54.5,25,32,7,25,22,67,41,0,Matches
1040,Christian Groß,GER,"DF,MF",Werder Bremen,Bundesliga,34,1989,8.9,21,16,11,9,1,11,25,44.0,14,17,6,11,13,34,28,1,Matches
1041,Pascal Groß,GER,"MF,DF",Brighton,Premier League,32,1991,34.6,70,46,33,21,16,31,72,43.1,41,41,8,33,22,92,32,3,Matches
1042,Brajan Gruda,GER,"MF,FW",Mainz 05,Bundesliga,19,2004,18.2,22,14,5,11,6,14,24,58.3,10,15,0,15,5,27,4,0,Matches
1043,Ilia Gruev,BUL,MF,Werder Bremen,Bundesliga,23,2000,0.0,0,0,0,0,0,0,0,,0,0,0,0,0,0,0,0,Matches
1044,Vicente Guaita,ESP,GK,Celta Vigo,La Liga,36,1987,26.7,1,1,1,0,0,1,2,50.0,1,0,0,0,0,1,9,1,Matches
1045,Andrés Guardado,MEX,MF,Betis,La Liga,36,1986,5.0,17,12,5,9,3,7,14,50.0,7,4,2,2,6,23,5,0,Matches
1046,Sergi Guardiola,ESP,"FW,MF",Cádiz,La Liga,32,1991,5.5,10,7,2,6,2,4,9,44.4,5,10,0,10,0,10,4,0,Matches
1047,Nemanja Gudelj,SRB,"DF,MF",Sevilla,La Liga,31,1991,19.4,31,24,18,10,3,17,31,54.8,14,17,9,8,27,58,56,0,Matches
1048,Gabriel Gudmundsson,SWE,"DF,FW",Lille,Ligue 1,24,1999,14.1,22,16,7,13,2,12,20,60.0,8,14,3,11,15,37,25,0,Matches
1049,Gonçalo Guedes,POR,"FW,MF",Villarreal,La Liga,26,1996,10.6,6,4,1,2,3,2,7,28.6,5,8,0,8,2,8,3,0,Matches
1050,Axel Gueguin,FRA,"DF,FW",Montpellier,Ligue 1,18,2005,1.5,9,5,6,2,1,2,6,33.3,4,2,0,2,2,11,6,0,Matches
1051,Marc Guéhi,ENG,DF,Crystal Palace,Premier League,23,2000,22.5,28,19,21,7,0,14,24,58.3,10,22,17,5,18,46,89,1,Matches
1052,Mattéo Guendouzi,FRA,MF,Lazio,Serie A,24,1999,26.3,34,15,11,18,5,21,49,42.9,28,24,6,18,21,55,24,1,Matches
1053,Mattéo Guendouzi,FRA,MF,Marseille,Ligue 1,24,1999,0.2,0,0,0,0,0,0,0,,0,1,1,0,0,0,0,0,Matches
1054,Javier Guerra,ESP,MF,Valencia,La Liga,20,2003,27.8,54,24,25,22,7,22,58,37.9,36,27,7,20,18,72,44,0,Matches
1055,Raphaël Guerreiro,POR,"DF,MF",Bayern Munich,Bundesliga,29,1993,13.2,19,16,6,9,4,9,15,60.0,6,7,1,6,15,34,5,1,Matches
1056,Axel Guessand,FRA,DF,Udinese,Serie A,18,2004,0.5,1,1,0,1,0,1,1,100.0,0,1,0,1,0,1,0,0,Matches
1057,Evann Guessand,CIV,FW,Nice,Ligue 1,22,2001,17.3,16,7,2,7,7,6,7,85.7,1,12,1,11,12,28,7,0,Matches
1058,Ander Guevara,ESP,MF,Alavés,La Liga,26,1997,32.6,59,32,28,25,6,31,64,48.4,33,34,12,22,13,72,46,1,Matches
1059,Pape Gueye,SEN,"MF,DF",Marseille,Ligue 1,24,1999,8.5,33,21,11,19,3,13,19,68.4,6,17,3,14,13,46,12,0,Matches
1060,Josuha Guilavogui,FRA,DF,Mainz 05,Bundesliga,32,1990,4.5,15,10,10,5,0,6,7,85.7,1,13,7,6,13,28,21,0,Matches
1061,Morgan Guilavogui,GUI,"FW,MF",Lens,Ligue 1,25,1998,6.3,21,10,4,12,5,5,11,45.5,6,11,2,9,4,25,7,0,Matches
1062,Frederic Guilbert,FRA,"DF,MF",Strasbourg,Ligue 1,28,1994,27.7,87,50,49,30,8,47,72,65.3,25,39,10,29,71,158,99,1,Matches
1063,Hugo Guillamón,ESP,MF,Valencia,La Liga,23,2000,14.6,24,15,7,14,3,11,17,64.7,6,8,3,5,12,36,25,2,Matches
1064,Bruno Guimarães,BRA,MF,Newcastle Utd,Premier League,25,1997,36.3,88,53,45,32,11,40,77,51.9,37,52,14,38,35,123,20,0,Matches
1065,Serhou Guirassy,GUI,FW,Stuttgart,Bundesliga,27,1996,24.5,6,3,1,4,1,2,5,40.0,3,8,1,7,6,12,29,0,Matches
1066,Marc Guiu,ESP,"FW,MF",Barcelona,La Liga,17,2006,0.8,1,0,0,1,0,0,0,,0,0,0,0,0,1,0,0,Matches
1067,Péter Gulácsi,HUN,GK,RB Leipzig,Bundesliga,33,1990,13.0,0,0,0,0,0,0,0,,0,0,0,0,0,0,8,1,Matches
1068,Manuel Gulde,GER,DF,Freiburg,Bundesliga,32,1991,22.7,37,23,23,13,1,17,23,73.9,6,24,14,10,25,62,82,0,Matches
1069,Arda Güler,TUR,"FW,MF",Real Madrid,La Liga,18,2005,4.2,6,4,1,3,2,5,8,62.5,3,0,0,0,2,8,5,0,Matches
1070,Gerard Gumbau,ESP,MF,Granada,La Liga,28,1994,29.7,55,34,21,30,4,23,62,37.1,39,24,5,19,25,80,30,2,Matches
1071,Robert Gumny,POL,DF,Augsburg,Bundesliga,25,1998,5.3,6,5,1,3,2,1,5,20.0,4,13,5,8,7,13,15,0,Matches
1072,İlkay Gündoğan,GER,MF,Barcelona,La Liga,32,1990,33.3,32,22,14,16,2,12,39,30.8,27,19,4,15,21,53,18,1,Matches
1073,Christian Günter,GER,DF,Freiburg,Bundesliga,30,1993,11.8,20,12,9,11,0,7,18,38.9,11,9,3,6,2,22,16,0,Matches
1074,Jon Guridi,ESP,MF,Alavés,La Liga,28,1995,29.8,42,24,10,27,5,12,45,26.7,33,23,3,20,22,64,22,0,Matches
1075,Gorka Guruzeta,ESP,FW,Athletic Club,La Liga,26,1996,24.6,34,23,6,25,3,9,30,30.0,21,36,2,34,17,51,23,0,Matches
1076,Malo Gusto,FRA,DF,Chelsea,Premier League,20,2003,19.5,55,27,34,15,6,35,52,67.3,17,28,4,24,17,72,43,1,Matches
1077,Miguel Gutiérrez,ESP,DF,Girona,La Liga,22,2001,33.7,29,18,11,14,4,13,35,37.1,22,27,11,16,22,51,66,2,Matches
1078,Albert Guðmundsson,ISL,"FW,MF",Genoa,Serie A,26,1997,33.5,23,10,8,10,5,12,44,27.3,32,15,2,13,11,34,13,0,Matches
1079,Joško Gvardiol,CRO,DF,Manchester City,Premier League,21,2002,25.9,55,33,21,24,10,21,38,55.3,17,36,12,24,27,82,37,3,Matches
1080,Emmanuel Gyasi,GHA,"DF,FW",Empoli,Serie A,29,1994,20.9,34,17,18,13,3,15,32,46.9,17,30,12,18,5,39,27,1,Matches
1081,Norbert Gyömbér,SVK,DF,Salernitana,Serie A,31,1992,19.6,36,18,30,6,0,20,26,76.9,6,33,23,10,23,59,77,2,Matches
1082,Erling Haaland,NOR,FW,Manchester City,Premier League,23,2000,28.4,6,3,0,3,3,2,3,66.7,1,11,1,10,2,8,16,0,Matches
1083,Nicolas Haas,SUI,MF,Empoli,Serie A,27,1996,1.0,5,3,1,2,2,3,3,100.0,0,1,0,1,1,6,1,0,Matches
1084,Janik Haberer,GER,"MF,DF",Union Berlin,Bundesliga,29,1994,13.6,36,24,16,13,7,22,45,48.9,23,21,4,17,12,48,18,0,Matches
1085,Robin Hack,GER,"FW,MF",Gladbach,Bundesliga,24,1998,15.0,15,8,6,7,2,4,17,23.5,13,16,0,16,14,29,21,0,Matches
1086,Antwoine Hackford,ENG,FW,Sheffield Utd,Premier League,19,2004,0.1,0,0,0,0,0,0,0,,0,0,0,0,0,0,0,0,Matches
1087,Munir El Haddadi,MAR,FW,Las Palmas,La Liga,27,1995,27.2,40,27,18,17,5,17,38,44.7,21,27,1,26,11,51,16,0,Matches
1088,Jaouen Hadjam,ALG,DF,Nantes,Ligue 1,20,2003,1.2,6,4,5,1,0,1,2,50.0,1,0,0,0,3,9,2,0,Matches
1089,Ianis Hagi,ROU,"MF,FW",Alavés,La Liga,24,1998,8.9,17,12,2,14,1,5,12,41.7,7,8,0,8,5,22,4,0,Matches
1090,Amadou Haidara,MLI,MF,RB Leipzig,Bundesliga,25,1998,17.0,42,27,24,16,2,23,41,56.1,18,28,6,22,21,63,37,0,Matches
1091,Massadio Haïdara,MLI,DF,Lens,Ligue 1,30,1992,8.2,9,8,5,3,1,4,6,66.7,2,7,2,5,11,20,32,3,Matches
1092,Oualid El Hajjam,MAR,"DF,MF",Le Havre,Ligue 1,32,1991,4.4,8,7,5,2,1,2,9,22.2,7,5,1,4,6,14,10,0,Matches
1093,Achraf Hakimi,MAR,DF,Paris S-G,Ligue 1,24,1998,21.5,29,19,14,9,6,17,34,50.0,17,28,4,24,12,41,28,2,Matches
1094,Lewis Hall,ENG,DF,Newcastle Utd,Premier League,18,2004,8.7,28,18,17,10,1,17,28,60.7,11,17,2,15,12,40,22,1,Matches
1095,Sébastien Haller,CIV,FW,Dortmund,Bundesliga,29,1994,4.4,1,0,0,1,0,1,1,100.0,0,4,1,3,0,1,7,0,Matches
1096,Gustavo Hamer,NED,MF,Sheffield Utd,Premier League,26,1997,32.3,39,21,17,15,7,16,59,27.1,43,33,9,24,29,68,35,0,Matches
1097,Andreas Hanche-Olsen,NOR,DF,Mainz 05,Bundesliga,26,1997,11.0,20,12,10,8,2,10,16,62.5,6,10,4,6,11,31,41,0,Matches
1098,Isak Hansen-Aarøen,NOR,MF,Werder Bremen,Bundesliga,18,2004,0.3,0,0,0,0,0,0,1,0.0,1,1,0,1,1,1,0,0,Matches
1099,Ridgeciano Haps,SUR,DF,Genoa,Serie A,30,1993,8.6,7,6,3,2,2,5,8,62.5,3,3,0,3,6,13,11,1,Matches
1100,Genki Haraguchi,JPN,MF,Stuttgart,Bundesliga,32,1991,0.3,1,1,1,0,0,0,0,,0,0,0,0,0,1,1,0,Matches
1101,Amine Harit,MAR,"MF,FW",Marseille,Ligue 1,26,1997,20.2,28,16,8,17,3,13,37,35.1,24,31,4,27,12,40,4,0,Matches
1102,Luke Harris,WAL,MF,Fulham,Premier League,18,2005,0.8,1,1,1,0,0,0,1,0.0,1,0,0,0,0,1,0,0,Matches
1103,Jack Harrison,ENG,"MF,FW",Everton,Premier League,26,1996,24.6,37,22,12,12,13,17,49,34.7,32,25,5,20,12,49,24,0,Matches
1104,Abdou Harroui,NED,"MF,FW",Frosinone,Serie A,25,1998,11.3,23,11,11,11,1,8,16,50.0,8,19,3,16,5,28,8,0,Matches
1105,Makoto Hasebe,JPN,"DF,MF",Eint Frankfurt,Bundesliga,39,1984,2.4,4,2,2,2,0,3,6,50.0,3,2,1,1,2,6,5,0,Matches
1106,Daiki Hashioka,JPN,DF,Luton Town,Premier League,24,1999,6.6,11,5,6,4,1,5,11,45.5,6,12,7,5,8,19,20,0,Matches
1107,Hans Hateboer,NED,DF,Atalanta,Serie A,29,1994,12.4,12,5,8,2,2,5,15,33.3,10,21,7,14,4,16,21,0,Matches
1108,Pantelis Hatzidiakos,GRE,DF,Cagliari,Serie A,26,1997,9.5,22,10,12,10,0,10,17,58.8,7,14,5,9,13,35,30,1,Matches
1109,Kai Havertz,GER,"MF,FW",Arsenal,Premier League,24,1999,29.3,35,15,7,21,7,14,39,35.9,25,26,1,25,20,55,22,0,Matches
1110,Thorgan Hazard,BEL,DF,Dortmund,Bundesliga,30,1993,0.1,0,0,0,0,0,0,0,,0,0,0,0,0,0,0,0,Matches
1111,Jan Paul van Hecke,NED,DF,Brighton,Premier League,23,2000,26.3,47,26,25,19,3,27,45,60.0,18,49,27,22,30,77,76,4,Matches
1112,Hwang Hee-chan,KOR,"FW,MF",Wolves,Premier League,27,1996,23.5,20,10,11,8,1,9,24,37.5,15,19,1,18,10,30,9,0,Matches
1113,Silvan Hefti,SUI,"MF,DF",Genoa,Serie A,25,1997,1.3,6,1,2,3,1,4,7,57.1,3,2,0,2,0,6,1,0,Matches
1114,Silvan Hefti,SUI,"DF,FW",Montpellier,Ligue 1,25,1997,7.9,21,15,10,7,4,15,29,51.7,14,7,2,5,8,29,11,0,Matches
1115,Dominique Heintz,GER,DF,Köln,Bundesliga,29,1993,6.3,12,5,6,6,0,8,12,66.7,4,6,1,5,3,15,28,0,Matches
1116,Dean Henderson,ENG,GK,Crystal Palace,Premier League,26,1997,18.0,1,1,1,0,0,1,2,50.0,1,0,0,0,0,1,8,2,Matches
1117,Liam Henderson,SCO,MF,Empoli,Serie A,27,1996,0.1,0,0,0,0,0,0,0,,0,0,0,0,0,0,0,0,Matches
1118,Benjamin Henrichs,GER,DF,RB Leipzig,Bundesliga,26,1997,28.1,68,39,32,26,10,27,58,46.6,31,49,4,45,33,101,37,0,Matches
1119,Henrique,BRA,DF,Lyon,Ligue 1,29,1994,6.7,10,6,6,4,0,6,11,54.5,5,8,2,6,10,20,3,0,Matches
1120,Luis Henrique,BRA,"FW,DF",Marseille,Ligue 1,21,2001,8.7,8,7,4,1,3,4,7,57.1,3,9,0,9,8,16,3,0,Matches
1121,Luiz Henrique,BRA,FW,Betis,La Liga,22,2001,6.8,15,11,4,10,1,9,14,64.3,5,11,0,11,5,20,8,0,Matches
1122,Matheus Henrique,BRA,MF,Sassuolo,Serie A,25,1997,27.8,43,29,21,18,4,18,43,41.9,25,18,8,10,25,68,31,6,Matches
1123,Rico Henry,ENG,DF,Brentford,Premier League,26,1997,4.5,7,5,3,3,1,6,7,85.7,1,8,3,5,5,12,5,1,Matches
1124,Thomas Henry,FRA,FW,Hellas Verona,Serie A,28,1994,3.7,0,0,0,0,0,0,0,,0,0,0,0,0,0,5,0,Matches
1125,Christophe Hérelle,MTQ,DF,Metz,Ligue 1,30,1992,18.0,32,15,24,7,1,13,23,56.5,10,16,9,7,18,50,68,2,Matches
1126,Mario Hermoso,ESP,DF,Atlético Madrid,La Liga,28,1995,28.4,46,25,29,13,4,28,51,54.9,23,27,9,18,30,76,93,0,Matches
1127,Javi Hernández,ESP,DF,Cádiz,La Liga,25,1998,27.9,43,24,26,12,5,25,46,54.3,21,34,9,25,19,62,72,1,Matches
1128,Aridane Hernández,ESP,DF,Rayo Vallecano,La Liga,34,1989,18.8,10,8,5,4,1,4,11,36.4,7,19,14,5,14,24,98,1,Matches
1129,Lucas Hernández,FRA,DF,Paris S-G,Ligue 1,27,1996,21.2,52,36,28,15,9,29,50,58.0,21,21,5,16,27,79,38,0,Matches
1130,Luis Hernández,ESP,DF,Cádiz,La Liga,34,1989,8.0,7,3,4,3,0,4,8,50.0,4,3,2,1,8,15,25,0,Matches
1131,Theo Hernández,FRA,DF,Milan,Serie A,25,1997,31.0,30,17,19,11,0,11,22,50.0,11,33,13,20,23,53,42,1,Matches
1132,Jorge Herrando,ESP,DF,Osasuna,La Liga,22,2001,18.3,29,19,23,6,0,12,19,63.2,7,20,11,9,15,44,69,1,Matches
1133,Ander Herrera,ESP,MF,Athletic Club,La Liga,33,1989,11.4,44,32,11,26,7,20,36,55.6,16,16,6,10,15,59,18,1,Matches
1134,Cristian Herrera,ESP,"FW,MF",Las Palmas,La Liga,32,1991,1.8,1,1,0,1,0,1,2,50.0,1,1,0,1,0,1,2,0,Matches
1135,Sergio Herrera,ESP,GK,Osasuna,La Liga,30,1993,31.9,2,2,2,0,0,2,3,66.7,1,0,0,0,0,2,22,3,Matches
1136,Yangel Herrera,VEN,MF,Girona,La Liga,25,1998,23.4,64,37,28,30,6,30,56,53.6,26,30,8,22,24,88,45,1,Matches
1137,Patrick Herrmann,GER,"FW,DF",Gladbach,Bundesliga,32,1991,1.0,4,4,2,1,1,2,2,100.0,0,1,0,1,1,5,2,0,Matches
1138,Juan Herzog,ESP,DF,Las Palmas,La Liga,20,2003,3.2,6,5,5,1,0,3,6,50.0,3,4,1,3,2,8,17,0,Matches
1139,Son Heung-min,KOR,FW,Tottenham,Premier League,31,1992,32.6,21,13,6,7,8,10,21,47.6,11,4,1,3,8,29,4,0,Matches
1140,Aaron Hickey,SCO,DF,Brentford,Premier League,21,2002,7.9,16,9,9,3,4,7,7,100.0,0,7,3,4,3,19,10,0,Matches
1141,Isak Hien,SWE,DF,Hellas Verona,Serie A,24,1999,9.6,17,10,10,7,0,10,19,52.6,9,12,5,7,7,24,33,1,Matches
1142,Isak Hien,SWE,DF,Atalanta,Serie A,24,1999,10.4,18,12,8,10,0,7,15,46.7,8,12,5,7,14,32,33,0,Matches
1143,James Hill,ENG,DF,Bournemouth,Premier League,21,2002,0.8,3,2,1,2,0,1,1,100.0,0,3,2,1,3,6,8,0,Matches
1144,Piero Hincapié,ECU,DF,Leverkusen,Bundesliga,21,2002,16.5,35,22,14,17,4,13,17,76.5,4,18,7,11,13,48,43,0,Matches
1145,Jack Hinshelwood,ENG,DF,Brighton,Premier League,18,2005,9.7,14,5,7,4,3,5,13,38.5,8,6,2,4,14,28,18,0,Matches
1146,Adam Hložek,CZE,"MF,FW",Leverkusen,Bundesliga,21,2002,5.1,10,4,2,4,4,3,7,42.9,4,4,1,3,2,12,1,0,Matches
1147,Nicolas Höfler,GER,MF,Freiburg,Bundesliga,33,1990,25.9,63,40,36,20,7,22,49,44.9,27,30,16,14,31,94,45,0,Matches
1148,Jonas Hofmann,GER,MF,Leverkusen,Bundesliga,31,1992,24.5,20,14,6,9,5,10,24,41.7,14,18,0,18,8,28,6,0,Matches
1149,Philipp Hofmann,GER,FW,Bochum,Bundesliga,30,1993,17.5,10,5,4,5,1,4,7,57.1,3,11,2,9,4,14,17,0,Matches
1150,Lucas Höler,GER,"FW,MF",Freiburg,Bundesliga,29,1994,25.6,32,24,14,10,8,4,23,17.4,19,19,4,15,15,47,35,0,Matches
1151,Mason Holgate,ENG,DF,Sheffield Utd,Premier League,26,1996,7.9,12,7,5,6,1,5,12,41.7,7,12,5,7,11,23,40,0,Matches
1152,Fabian Holland,GER,"MF,DF",Darmstadt 98,Bundesliga,33,1990,20.4,47,26,18,21,8,20,37,54.1,17,22,12,10,24,71,29,0,Matches
1153,Benedict Hollerbach,GER,"FW,MF",Union Berlin,Bundesliga,22,2001,14.2,17,11,5,7,5,7,22,31.8,15,28,0,28,4,21,3,0,Matches
1154,Emil Holm,SWE,DF,Atalanta,Serie A,23,2000,10.5,28,19,17,9,2,16,36,44.4,20,25,3,22,7,35,25,0,Matches
1155,Gerrit Holtmann,PHI,"MF,FW",Darmstadt 98,Bundesliga,28,1995,4.4,8,5,3,4,1,7,10,70.0,3,7,0,7,2,10,4,1,Matches
1156,Martin Hongla,CMR,MF,Hellas Verona,Serie A,25,1998,12.0,24,13,9,13,2,8,11,72.7,3,8,3,5,7,31,24,0,Matches
1157,Martin Hongla,CMR,"MF,DF",Granada,La Liga,25,1998,6.2,7,3,2,5,0,3,9,33.3,6,6,3,3,6,13,13,1,Matches
1158,Franck Honorat,FRA,"DF,FW",Gladbach,Bundesliga,26,1996,26.1,25,13,13,10,2,11,20,55.0,9,22,3,19,9,34,35,1,Matches
1159,Mathias Honsak,AUT,"FW,MF",Darmstadt 98,Bundesliga,26,1996,11.3,14,7,7,6,1,6,20,30.0,14,14,2,12,8,22,25,0,Matches
1160,Sydney van Hooijdonk,NED,FW,Bologna,Serie A,23,2000,2.4,3,0,0,2,1,1,2,50.0,1,1,1,0,1,4,4,0,Matches
1161,Fraser Hornby,SCO,"FW,MF",Darmstadt 98,Bundesliga,23,1999,2.4,0,0,0,0,0,0,1,0.0,1,2,1,1,0,0,4,0,Matches
1162,Lukáš Hrádecký,FIN,GK,Leverkusen,Bundesliga,33,1989,33.0,0,0,0,0,0,0,1,0.0,1,1,0,1,0,0,10,2,Matches
1163,Xabier Huarte Armendáriz,ESP,MF,Osasuna,La Liga,22,2001,0.1,0,0,0,0,0,0,0,,0,0,0,0,0,0,0,0,Matches
1164,Timo Hübers,GER,DF,Köln,Bundesliga,27,1996,30.9,68,47,51,14,3,49,80,61.3,31,54,28,26,63,131,168,1,Matches
1165,Callum Hudson-Odoi,ENG,"FW,MF",Nott'ham Forest,Premier League,22,2000,20.6,18,8,4,5,9,7,28,25.0,21,16,1,15,7,25,12,1,Matches
1166,Will Hughes,ENG,MF,Crystal Palace,Premier League,28,1995,21.0,61,33,30,20,11,24,48,50.0,24,36,14,22,21,82,25,0,Matches
1167,Dean Huijsen,ESP,DF,Roma,Serie A,18,2005,5.7,10,5,5,5,0,1,4,25.0,3,7,4,3,4,14,26,2,Matches
1168,Dean Huijsen,ESP,DF,Juventus,Serie A,18,2005,0.1,0,0,0,0,0,0,0,,0,0,0,0,0,0,1,0,Matches
1169,Mats Hummels,GER,DF,Dortmund,Bundesliga,34,1988,17.6,52,34,34,12,6,30,53,56.6,23,33,11,22,33,85,82,0,Matches
1170,Denis Huseinbasic,BIH,MF,Köln,Bundesliga,22,2001,18.1,38,18,17,15,6,20,31,64.5,11,26,1,25,13,51,14,0,Matches
1171,Elseid Hysaj,ALB,DF,Lazio,Serie A,29,1994,13.3,24,14,8,13,3,15,24,62.5,9,16,6,10,17,41,31,0,Matches
1172,Pierre Højbjerg,DEN,MF,Tottenham,Premier League,27,1995,14.6,32,18,13,17,2,13,34,38.2,21,21,7,14,19,51,30,3,Matches
1173,Rasmus Højlund,DEN,FW,Manchester Utd,Premier League,20,2003,24.0,11,7,2,3,6,5,13,38.5,8,9,1,8,1,12,19,0,Matches
1174,Iago,BRA,DF,Augsburg,Bundesliga,26,1997,18.0,36,17,22,10,4,17,33,51.5,16,39,8,31,18,54,43,0,Matches
1175,Pablo Ibáñez,ESP,MF,Osasuna,La Liga,24,1998,12.8,18,9,5,7,6,5,21,23.8,16,26,3,23,9,27,17,0,Matches
1176,Arijon Ibrahimović,GER,"FW,DF",Frosinone,Serie A,17,2005,5.3,7,6,4,2,1,1,9,11.1,8,4,0,4,1,8,3,0,Matches
1177,Iglesias,ESP,"DF,FW",Getafe,La Liga,25,1998,15.7,41,22,25,11,5,21,33,63.6,12,18,7,11,16,57,53,0,Matches
1178,Borja Iglesias,ESP,FW,Betis,La Liga,30,1993,4.5,0,0,0,0,0,0,3,0.0,3,0,0,0,2,2,2,0,Matches
1179,Borja Iglesias,ESP,FW,Leverkusen,Bundesliga,30,1993,2.8,1,0,0,1,0,0,1,0.0,1,2,0,2,1,2,1,0,Matches
1180,Igor,BRA,DF,Brighton,Premier League,25,1998,18.2,25,18,7,16,2,17,29,58.6,12,22,9,13,14,39,52,1,Matches
1181,Jonathan Ikone,FRA,FW,Fiorentina,Serie A,25,1998,18.7,22,11,7,9,6,10,17,58.8,7,12,0,12,3,25,8,0,Matches
1182,Chukwubuikem Ikwuemesi,NGA,FW,Salernitana,Serie A,21,2001,11.8,3,1,0,2,1,2,6,33.3,4,1,1,0,1,4,8,0,Matches
1183,Andrej Ilic,SRB,FW,Lille,Ligue 1,23,2000,0.1,0,0,0,0,0,0,0,,0,0,0,0,0,0,0,0,Matches
1184,Ivan Ilić,SRB,MF,Torino,Serie A,22,2001,23.3,22,8,9,10,3,13,27,48.1,14,20,7,13,20,42,31,0,Matches
1185,Samuel Iling-Junior,ENG,"DF,MF",Juventus,Serie A,19,2003,9.0,23,13,9,11,3,11,18,61.1,7,17,5,12,6,29,19,0,Matches
1186,Imanol,ESP,DF,Athletic Club,La Liga,23,2000,5.8,7,5,1,5,1,5,18,27.8,13,6,0,6,7,14,15,0,Matches
1187,Joel Imasuen,USA,FW,Werder Bremen,Bundesliga,18,2004,0.0,0,0,0,0,0,0,0,,0,0,0,0,0,0,0,0,Matches
1188,Ciro Immobile,ITA,FW,Lazio,Serie A,33,1990,18.4,11,9,2,5,4,3,14,21.4,11,9,3,6,5,16,11,0,Matches
1189,Gino Infantino,ARG,MF,Fiorentina,Serie A,20,2003,1.1,1,1,0,1,0,0,1,0.0,1,4,0,4,3,4,1,0,Matches
1190,Danny Ings,ENG,FW,West Ham,Premier League,31,1992,4.5,6,2,0,6,0,4,13,30.8,9,4,1,3,3,9,7,0,Matches
1191,Bonke Innocent,NGA,MF,Lorient,Ligue 1,27,1996,2.3,6,4,2,2,2,2,9,22.2,7,2,1,1,4,10,2,0,Matches
1192,Tim Iroegbunam,ENG,MF,Aston Villa,Premier League,20,2003,1.8,7,5,4,2,1,4,9,44.4,5,3,0,3,2,9,3,0,Matches
1193,Alexander Isak,SWE,FW,Newcastle Utd,Premier League,23,1999,25.1,5,0,2,1,2,2,8,25.0,6,16,1,15,6,11,13,0,Matches
1194,Gustav Isaksen,DEN,FW,Lazio,Serie A,22,2001,11.9,4,3,2,1,1,1,9,11.1,8,11,1,10,4,8,4,0,Matches
1195,Isco,ESP,MF,Betis,La Liga,31,1992,25.8,41,27,15,21,5,14,38,36.8,24,19,1,18,10,51,7,0,Matches
1196,Thomas Isherwood,SWE,DF,Darmstadt 98,Bundesliga,25,1998,7.1,11,5,7,3,1,5,9,55.6,4,10,7,3,10,21,34,0,Matches
1197,Ismaily,BRA,DF,Lille,Ligue 1,33,1990,27.4,72,47,34,25,13,31,60,51.7,29,33,6,27,32,104,77,0,Matches
1198,Ardian Ismajli,ALB,DF,Empoli,Serie A,26,1996,22.7,26,16,18,6,2,18,23,78.3,5,28,17,11,23,49,126,1,Matches
1199,Yanis Issoufou,FRA,MF,Montpellier,Ligue 1,16,2006,0.1,0,0,0,0,0,0,0,,0,0,0,0,0,0,0,0,Matches
1200,Ko Itakura,JPN,"DF,MF",Gladbach,Bundesliga,26,1997,17.7,34,21,17,15,2,16,26,61.5,10,32,18,14,22,56,62,0,Matches
1201,Hiroki Ito,JPN,DF,Stuttgart,Bundesliga,24,1999,24.8,19,18,13,6,0,11,26,42.3,15,29,17,12,29,48,86,2,Matches
1202,Junya Ito,JPN,"FW,MF",Reims,Ligue 1,30,1993,30.2,33,15,11,14,8,10,36,27.8,26,23,1,22,14,47,7,0,Matches
1203,Diego Iturralde,ESP,DF,Sevilla,La Liga,20,2003,0.4,0,0,0,0,0,0,0,,0,1,1,0,0,0,2,0,Matches
1204,Alex Iwobi,NGA,MF,Everton,Premier League,27,1996,1.6,2,0,1,0,1,2,3,66.7,1,2,0,2,1,3,0,0,Matches
1205,Alex Iwobi,NGA,"FW,MF",Fulham,Premier League,27,1996,24.4,29,18,12,15,2,12,25,48.0,13,16,0,16,14,43,9,0,Matches
1206,Armando Izzo,ITA,DF,Monza,Serie A,31,1992,18.3,27,17,17,9,1,16,27,59.3,11,20,16,4,27,54,49,1,Matches
1207,Nicolas Jackson,SEN,FW,Chelsea,Premier League,22,2001,31.1,21,13,5,8,8,5,24,20.8,19,20,5,15,4,25,17,0,Matches
1208,Jérémy Jacquet,FRA,MF,Rennes,Ligue 1,18,2005,0.1,1,1,1,0,0,0,1,0.0,1,0,0,0,1,2,0,0,Matches
1209,Jérémy Jacquet,FRA,DF,Clermont Foot,Ligue 1,18,2005,2.8,4,3,4,0,0,3,3,100.0,0,7,3,4,6,10,10,0,Matches
1210,Lee Jae-sung,KOR,"MF,FW",Mainz 05,Bundesliga,30,1992,23.5,33,20,11,16,6,13,39,33.3,26,22,2,20,27,60,23,0,Matches
1211,Paul Jaeckel,GER,DF,Union Berlin,Bundesliga,25,1998,2.6,7,2,4,3,0,5,9,55.6,4,3,2,1,4,11,7,0,Matches
1212,Filip Jagiełło,POL,MF,Genoa,Serie A,25,1997,0.4,0,0,0,0,0,0,1,0.0,1,1,1,0,1,1,0,0,Matches
1213,Kristijan Jakić,CRO,MF,Augsburg,Bundesliga,26,1997,11.7,28,14,14,10,4,15,33,45.5,18,13,1,12,20,48,15,0,Matches
1214,Kristijan Jakić,CRO,"MF,FW",Eint Frankfurt,Bundesliga,26,1997,2.2,3,3,1,2,0,1,3,33.3,2,1,0,1,2,5,2,0,Matches
1215,Ismail Jakobs,SEN,DF,Monaco,Ligue 1,23,1999,16.3,57,41,27,21,9,29,47,61.7,18,19,2,17,11,68,40,0,Matches
1216,Ablie Jallow,GAM,"MF,FW",Metz,Ligue 1,24,1998,10.2,8,5,2,3,3,3,5,60.0,2,4,0,4,8,16,3,0,Matches
1217,Reece James,ENG,DF,Chelsea,Premier League,23,1999,4.7,14,9,10,3,1,8,10,80.0,2,4,4,0,3,17,7,1,Matches
1218,Vitaly Janelt,GER,"MF,DF",Brentford,Premier League,25,1998,33.9,63,38,29,25,9,32,64,50.0,32,35,9,26,36,99,64,3,Matches
1219,Jakub Jankto,CZE,"MF,FW",Cagliari,Serie A,27,1996,9.7,12,9,9,1,2,8,20,40.0,12,5,1,4,5,17,20,0,Matches
1220,Tony Jantschke,GER,"DF,MF",Gladbach,Bundesliga,33,1990,0.3,1,1,1,0,0,1,1,100.0,0,2,2,0,1,2,4,0,Matches
1221,Adnan Januzaj,BEL,"FW,MF",Sevilla,La Liga,28,1995,2.1,3,3,2,0,1,0,1,0.0,1,2,0,2,1,4,0,0,Matches
1222,Nuha Jatta,GAM,FW,RB Leipzig,Bundesliga,17,2006,0.0,0,0,0,0,0,0,0,,0,0,0,0,0,0,0,0,Matches
1223,Mikel Jauregizar,ESP,MF,Athletic Club,La Liga,19,2003,1.7,0,0,0,0,0,0,6,0.0,6,5,0,5,0,0,2,0,Matches
1224,Luis Javier Suárez,COL,FW,Almería,La Liga,25,1997,10.2,7,5,2,5,0,2,6,33.3,4,11,0,11,0,7,13,0,Matches
1225,Danley Jean-Jacques,HAI,MF,Metz,Ligue 1,23,2000,29.8,54,28,24,21,9,19,56,33.9,37,48,7,41,44,98,44,0,Matches
1226,Salim El Jebari,MAR,MF,Atlético Madrid,La Liga,19,2004,0.1,1,0,0,1,0,0,0,,0,0,0,0,0,1,1,0,Matches
1227,Daniel Jebbison,ENG,FW,Sheffield Utd,Premier League,19,2003,0.2,0,0,0,0,0,0,0,,0,1,0,1,0,0,0,0,Matches
1228,Jeffinho,BRA,"FW,MF",Lyon,Ligue 1,23,1999,3.4,11,4,3,5,3,4,11,36.4,7,1,0,1,0,11,0,0,Matches
1229,Fredrik Jensen,FIN,"MF,FW",Augsburg,Bundesliga,25,1997,14.9,23,11,9,8,6,14,28,50.0,14,30,1,29,12,35,21,0,Matches
1230,Mathias Jensen,DEN,MF,Brentford,Premier League,27,1996,24.5,54,32,25,22,7,26,95,27.4,69,41,6,35,23,77,25,1,Matches
1231,Moritz Jenz,GER,DF,Wolfsburg,Bundesliga,24,1999,19.4,34,24,21,11,2,14,21,66.7,7,29,17,12,26,60,94,0,Matches
1232,Gabriel Jesus,BRA,FW,Arsenal,Premier League,26,1997,16.4,24,17,11,5,8,5,18,27.8,13,23,1,22,13,37,12,0,Matches
1233,Juan Jesus,BRA,DF,Napoli,Serie A,32,1991,23.5,42,19,28,12,2,23,33,69.7,10,23,12,11,23,65,67,1,Matches
1234,Alejandro Jiménez,ESP,DF,Milan,Serie A,18,2005,0.8,2,1,2,0,0,2,5,40.0,3,0,0,0,0,2,4,0,Matches
1235,Raúl Jiménez,MEX,FW,Fulham,Premier League,32,1991,15.5,18,12,4,8,6,7,20,35.0,13,11,3,8,4,22,13,0,Matches
1236,João Pedro,BRA,"FW,MF",Brighton,Premier League,21,2001,22.7,31,14,10,13,8,14,24,58.3,10,15,2,13,11,42,28,0,Matches
1237,Joelinton,BRA,"MF,FW",Newcastle Utd,Premier League,26,1996,14.2,39,27,21,15,3,14,38,36.8,24,23,7,16,19,58,11,1,Matches
1238,Ryan John Giles,ENG,"DF,MF",Luton Town,Premier League,23,2000,5.6,8,6,4,3,1,2,7,28.6,5,2,0,2,4,12,22,0,Matches
1239,Ben Johnson,ENG,"DF,FW",West Ham,Premier League,23,2000,6.0,11,7,7,3,1,9,14,64.3,5,2,1,1,5,16,14,0,Matches
1240,Brennan Johnson,WAL,FW,Tottenham,Premier League,22,2001,23.2,26,15,14,5,7,12,31,38.7,19,37,1,36,10,36,12,1,Matches
1241,Brennan Johnson,WAL,"FW,MF",Nott'ham Forest,Premier League,22,2001,2.6,4,1,1,1,2,2,4,50.0,2,4,1,3,0,4,0,0,Matches
1242,Joseph Johnson,ENG,DF,Luton Town,Premier League,17,2006,0.9,0,0,0,0,0,0,1,0.0,1,0,0,0,0,0,0,0,Matches
1243,Sam Johnstone,ENG,GK,Crystal Palace,Premier League,30,1993,20.0,1,0,1,0,0,1,1,100.0,0,0,0,0,1,2,5,0,Matches
1244,Curtis Jones,ENG,MF,Liverpool,Premier League,22,2001,13.0,27,14,12,12,3,10,23,43.5,13,22,0,22,7,34,8,0,Matches
1245,Frenkie de Jong,NED,MF,Barcelona,La Liga,26,1997,18.2,43,26,14,23,6,8,19,42.1,11,18,8,10,14,57,28,1,Matches
1246,Joan Jordán,ESP,MF,Sevilla,La Liga,29,1994,4.2,8,7,3,3,2,7,15,46.7,8,4,2,2,4,12,2,0,Matches
1247,Jordi,ESP,"MF,DF",Getafe,La Liga,22,2001,6.4,16,11,3,11,2,7,15,46.7,8,7,2,5,8,24,7,0,Matches
1248,Jeremy Jorge,ESP,FW,Getafe,La Liga,20,2003,0.0,0,0,0,0,0,0,0,,0,0,0,0,0,0,0,0,Matches
1249,Kaio Jorge,BRA,FW,Frosinone,Serie A,21,2002,9.0,6,4,0,1,5,3,4,75.0,1,6,0,6,1,7,0,0,Matches
1250,Jorginho,ITA,MF,Arsenal,Premier League,31,1991,10.2,24,10,6,10,8,11,23,47.8,12,17,1,16,12,36,7,1,Matches
1251,Willian José,BRA,FW,Betis,La Liga,31,1991,21.9,7,3,1,2,4,2,5,40.0,3,8,2,6,2,9,15,0,Matches
1252,Joselu,ESP,FW,Real Madrid,La Liga,33,1990,18.7,6,3,1,4,1,0,7,0.0,7,11,1,10,6,12,11,0,Matches
1253,Diogo Jota,POR,FW,Liverpool,Premier League,26,1996,12.7,23,13,6,13,4,10,23,43.5,13,9,1,8,7,30,4,0,Matches
1254,Antoine Joujou,FRA,"FW,MF",Le Havre,Ligue 1,20,2003,8.7,20,12,7,7,6,11,21,52.4,10,11,2,9,7,27,5,0,Matches
1255,Luka Jović,SRB,FW,Milan,Serie A,25,1997,9.7,6,4,0,3,3,4,6,66.7,2,3,0,3,1,7,9,0,Matches
1256,Kamil Jóźwiak,POL,MF,Granada,La Liga,25,1998,6.3,13,10,4,6,3,9,17,52.9,8,4,0,4,2,15,6,0,Matches
1257,Juanmi,ESP,FW,Cádiz,La Liga,30,1993,9.7,9,4,2,7,0,2,9,22.2,7,6,0,6,6,15,3,0,Matches
1258,Juanpe,ESP,DF,Girona,La Liga,32,1991,8.3,11,8,8,3,0,9,10,90.0,1,17,11,6,7,18,50,1,Matches
1259,Mads Juel Andersen,DEN,DF,Luton Town,Premier League,25,1997,4.4,6,5,4,2,0,4,4,100.0,0,9,6,3,8,14,29,0,Matches
1260,Christopher Jullien,FRA,DF,Montpellier,Ligue 1,30,1993,13.7,16,12,11,5,0,6,17,35.3,11,25,20,5,12,28,106,2,Matches
1261,Anthony Jung,GER,DF,Werder Bremen,Bundesliga,31,1991,28.7,37,23,21,14,2,18,33,54.5,15,39,17,22,24,61,102,0,Matches
1262,Eli Junior Kroupi,FRA,"FW,MF",Lorient,Ligue 1,17,2006,12.0,7,4,2,2,3,1,9,11.1,8,6,0,6,10,17,5,0,Matches
1263,Hamed Junior Traorè,CIV,MF,Bournemouth,Premier League,23,2000,0.5,1,0,1,0,0,1,3,33.3,2,3,0,3,0,1,0,0,Matches
1264,Hamed Junior Traorè,CIV,MF,Napoli,Serie A,23,2000,4.2,4,2,2,0,2,1,6,16.7,5,3,0,3,2,6,1,1,Matches
1265,Vinicius Júnior,BRA,FW,Real Madrid,La Liga,23,2000,20.7,18,13,5,5,8,3,12,25.0,9,13,0,13,1,19,3,2,Matches
1266,Josip Juranović,CRO,DF,Union Berlin,Bundesliga,27,1995,14.4,20,14,11,7,2,10,21,47.6,11,17,3,14,12,32,27,1,Matches
1267,David Jurásek,CZE,DF,Hoffenheim,Bundesliga,22,2000,5.5,14,11,13,1,0,7,17,41.2,10,7,2,5,3,17,22,1,Matches
1268,Julian Justvan,GER,"FW,MF",Hoffenheim,Bundesliga,25,1998,0.5,1,0,1,0,0,1,2,50.0,1,1,0,1,0,1,0,0,Matches
1269,Julian Justvan,GER,"MF,FW",Darmstadt 98,Bundesliga,25,1998,11.4,10,4,2,7,1,3,17,17.6,14,12,2,10,11,21,6,1,Matches
1270,Filip Jørgensen,DEN,GK,Villarreal,La Liga,21,2002,36.0,3,1,3,0,0,3,4,75.0,1,0,0,0,2,5,10,3,Matches
1271,Mathias Jørgensen,DEN,DF,Brentford,Premier League,33,1990,12.1,17,12,15,1,1,11,19,57.9,8,9,5,4,12,29,40,0,Matches
1272,Mohamed Kaba,FRA,MF,Lecce,Serie A,21,2001,15.3,39,23,15,16,8,17,34,50.0,17,22,4,18,12,51,13,0,Matches
1273,Sory Kaba,GUI,FW,Las Palmas,La Liga,28,1995,8.0,2,0,0,2,0,0,5,0.0,5,6,0,6,0,2,9,0,Matches
1274,Ozan Kabak,TUR,DF,Hoffenheim,Bundesliga,23,2000,25.4,48,35,32,14,2,19,33,57.6,14,43,21,22,46,94,106,2,Matches
1275,Christian Kabasele,BEL,DF,Udinese,Serie A,32,1991,9.6,10,7,4,5,1,2,11,18.2,9,15,9,6,12,22,56,0,Matches
1276,Issa Kaboré,BFA,DF,Luton Town,Premier League,22,2001,19.2,52,28,23,21,8,24,45,53.3,21,22,11,11,16,68,56,2,Matches
1277,Abdoul Kader Bamba,FRA,"FW,MF",Nantes,Ligue 1,29,1994,6.8,10,7,2,5,3,5,15,33.3,10,4,0,4,4,14,4,1,Matches
1278,Yaya Kader Fofana,MLI,"MF,DF",Reims,Ligue 1,19,2004,0.4,3,3,1,1,1,0,1,0.0,1,0,0,0,1,4,0,0,Matches
1279,Pavel Kadeřábek,CZE,"DF,FW",Hoffenheim,Bundesliga,31,1992,26.8,31,19,10,15,6,18,40,45.0,22,22,8,14,23,54,68,0,Matches
1280,Tino Kadewere,ZIM,"FW,MF",Lyon,Ligue 1,27,1996,3.3,1,1,0,1,0,1,5,20.0,4,3,1,2,5,6,7,0,Matches
1281,Tino Kadewere,ZIM,"FW,MF",Nantes,Ligue 1,27,1996,8.7,9,4,3,3,3,6,11,54.5,5,10,1,9,10,19,8,0,Matches
1282,Kaiky,BRA,DF,Almería,La Liga,19,2004,5.8,7,4,6,0,1,3,6,50.0,3,9,7,2,3,10,29,1,Matches
1283,Florian Kainz,AUT,"MF,FW",Köln,Bundesliga,30,1992,24.4,28,20,8,13,7,17,39,43.6,22,20,6,14,13,41,23,1,Matches
1284,Sasa Kalajdzic,AUT,FW,Wolves,Premier League,26,1997,1.8,6,2,3,2,1,1,2,50.0,1,3,0,3,1,7,6,0,Matches
1285,Sasa Kalajdzic,AUT,FW,Eint Frankfurt,Bundesliga,26,1997,3.6,2,2,0,2,0,0,0,,0,2,2,0,2,4,6,0,Matches
1286,Arnaud Kalimuendo,FRA,FW,Rennes,Ligue 1,21,2002,23.8,5,4,2,2,1,2,5,40.0,3,13,2,11,4,9,4,0,Matches
1287,Yayah Kallon,SLE,FW,Hellas Verona,Serie A,22,2001,0.0,0,0,0,0,0,0,0,,0,0,0,0,0,0,0,0,Matches
1288,Gedeon Kalulu,COD,DF,Lorient,Ligue 1,25,1997,10.8,23,17,13,8,2,12,22,54.5,10,18,2,16,5,28,30,0,Matches
1289,Pierre Kalulu,FRA,DF,Milan,Serie A,23,2000,4.2,5,1,2,3,0,1,2,50.0,1,4,3,1,1,6,12,1,Matches
1290,Daichi Kamada,JPN,MF,Lazio,Serie A,26,1996,17.2,53,36,22,22,9,28,52,53.8,24,24,5,19,18,71,7,0,Matches
1291,Waren Kamanzi,NOR,"DF,FW",Toulouse,Ligue 1,22,2000,13.2,36,24,16,16,4,13,23,56.5,10,11,3,8,9,45,35,0,Matches
1292,Boubacar Kamara,FRA,MF,Aston Villa,Premier League,23,1999,18.4,43,29,16,21,6,24,47,51.1,23,21,7,14,21,64,16,0,Matches
1293,Hassane Kamara,CIV,DF,Udinese,Serie A,29,1994,24.7,45,32,26,13,6,25,38,65.8,13,29,2,27,26,71,66,0,Matches
1294,Willy Kambwala,FRA,DF,Manchester Utd,Premier League,18,2004,3.7,3,1,1,2,0,1,3,33.3,2,6,3,3,4,7,14,1,Matches
1295,Jakub Kamiński,POL,"FW,MF",Wolfsburg,Bundesliga,21,2002,5.3,14,5,12,2,0,3,6,50.0,3,3,0,3,2,16,5,0,Matches
1296,Thomas Kaminski,BEL,GK,Luton Town,Premier League,30,1992,37.8,2,1,2,0,0,2,6,33.3,4,1,0,1,0,2,14,2,Matches
1297,Kevin Kampl,SVN,MF,RB Leipzig,Bundesliga,32,1990,15.1,19,8,8,9,2,10,21,47.6,11,19,7,12,11,30,14,1,Matches
1298,Harry Kane,ENG,FW,Bayern Munich,Bundesliga,30,1993,31.5,13,9,4,4,5,6,18,33.3,12,12,4,8,6,19,14,0,Matches
1299,Lee Kang-in,KOR,"FW,MF",Paris S-G,Ligue 1,22,2001,16.3,26,13,7,9,10,15,36,41.7,21,7,0,7,6,32,3,0,Matches
1300,Yann Karamoh,FRA,"MF,FW",Torino,Serie A,25,1998,1.8,1,0,0,0,1,0,0,,0,0,0,0,0,1,1,0,Matches
1301,Yann Karamoh,FRA,"FW,MF",Montpellier,Ligue 1,25,1998,3.2,1,0,0,0,1,1,2,50.0,1,3,0,3,0,1,0,0,Matches
1302,Atakan Karazor,GER,MF,Stuttgart,Bundesliga,26,1996,29.1,72,44,23,38,11,29,60,48.3,31,37,8,29,27,99,43,0,Matches
1303,Ayman Kari,FRA,MF,Lorient,Ligue 1,18,2004,9.9,18,14,9,9,0,12,19,63.2,7,19,2,17,6,24,9,1,Matches
1304,Emir Karic,AUT,DF,Darmstadt 98,Bundesliga,26,1997,19.8,45,27,23,14,8,21,33,63.6,12,42,11,31,13,58,43,0,Matches
1305,Loris Karius,GER,GK,Newcastle Utd,Premier League,30,1993,1.0,0,0,0,0,0,0,0,,0,0,0,0,0,0,1,0,Matches
1306,Jesper Karlsson,SWE,FW,Bologna,Serie A,25,1998,3.8,3,3,2,1,0,2,8,25.0,6,4,0,4,4,7,1,0,Matches
1307,Jon Karrikaburu,ESP,"MF,FW",Alavés,La Liga,20,2002,0.2,0,0,0,0,0,0,0,,0,0,0,0,0,0,0,0,Matches
1308,Rick Karsdorp,NED,DF,Roma,Serie A,28,1995,13.2,25,18,11,8,6,16,24,66.7,8,13,4,9,9,34,16,0,Matches
1309,Grigoris Kastanos,CYP,"MF,DF",Salernitana,Serie A,25,1998,16.4,23,14,8,9,6,9,20,45.0,11,13,4,9,8,31,9,0,Matches
1310,Silas Katompa,COD,"FW,MF",Stuttgart,Bundesliga,24,1998,10.0,5,3,3,2,0,3,12,25.0,9,9,0,9,0,5,4,0,Matches
1311,Panos Katseris,GRE,DF,Lorient,Ligue 1,22,2001,11.6,26,20,16,8,2,16,25,64.0,9,20,4,16,8,34,18,0,Matches
1312,Mikkel Kaufmann,DEN,FW,Union Berlin,Bundesliga,22,2001,5.4,6,3,2,3,1,3,10,30.0,7,12,0,12,1,7,4,0,Matches
1313,Michael Kayode,ITA,DF,Fiorentina,Serie A,19,2004,22.9,53,30,27,15,11,35,48,72.9,13,25,12,13,18,71,46,2,Matches
1314,Moise Kean,ITA,FW,Juventus,Serie A,23,2000,7.3,7,4,3,2,2,1,3,33.3,2,4,1,3,2,9,5,0,Matches
1315,Michael Keane,ENG,DF,Everton,Premier League,30,1993,4.9,7,3,3,3,1,1,7,14.3,6,5,4,1,5,12,18,1,Matches
1316,Ibrahima Kebe,MLI,MF,Girona,La Liga,22,2000,0.1,1,1,0,1,0,0,0,,0,1,0,1,1,2,0,0,Matches
1317,Kévin Keben Biakolo,CMR,DF,Toulouse,Ligue 1,19,2004,5.8,4,2,4,0,0,3,6,50.0,3,7,0,7,8,12,17,0,Matches
1318,Yassine Kechta,MAR,MF,Le Havre,Ligue 1,21,2002,20.5,46,24,24,19,3,31,73,42.5,42,20,3,17,23,69,16,1,Matches
1319,Thilo Kehrer,GER,"DF,MF",West Ham,Premier League,26,1996,0.2,1,1,0,1,0,0,0,,0,2,2,0,0,1,0,0,Matches
1320,Thilo Kehrer,GER,DF,Monaco,Ligue 1,26,1996,14.7,32,22,22,7,3,22,39,56.4,17,18,6,12,30,62,55,0,Matches
1321,Habib Keita,MLI,MF,Clermont Foot,Ligue 1,21,2002,14.2,34,19,14,15,5,17,28,60.7,11,27,10,17,29,63,30,0,Matches
1322,Naby Keïta,GUI,"MF,DF",Werder Bremen,Bundesliga,28,1995,1.2,1,1,1,0,0,0,1,0.0,1,2,0,2,2,3,1,0,Matches
1323,Yannik Keitel,GER,"DF,MF",Freiburg,Bundesliga,23,2000,10.2,20,15,14,5,1,10,15,66.7,5,17,8,9,12,32,44,3,Matches
1324,Caoimhín Kelleher,IRL,GK,Liverpool,Premier League,24,1998,10.0,0,0,0,0,0,0,0,,0,0,0,0,0,0,4,1,Matches
1325,Thomas Keller,GER,"MF,FW",Heidenheim,Bundesliga,23,1999,0.0,0,0,0,0,0,0,0,,0,0,0,0,0,0,0,0,Matches
1326,Lloyd Kelly,ENG,DF,Bournemouth,Premier League,24,1998,17.3,24,19,10,9,5,14,25,56.0,11,22,12,10,13,37,67,0,Matches
1327,Omari Kellyman,ENG,FW,Aston Villa,Premier League,17,2005,0.4,1,0,0,1,0,1,2,50.0,1,0,0,0,0,1,0,0,Matches
1328,Aljoscha Kemlein,GER,MF,Union Berlin,Bundesliga,18,2004,0.3,0,0,0,0,0,0,3,0.0,3,1,0,1,0,0,0,0,Matches
1329,Tobias Kempe,GER,MF,Darmstadt 98,Bundesliga,34,1989,15.0,20,13,9,8,3,8,24,33.3,16,16,4,12,9,29,12,0,Matches
1330,Milos Kerkez,HUN,DF,Bournemouth,Premier League,19,2003,21.9,47,26,31,13,3,30,42,71.4,12,31,11,20,20,67,60,2,Matches
1331,Kaine Kesler-Hayden,ENG,"MF,DF",Aston Villa,Premier League,20,2002,0.1,0,0,0,0,0,0,0,,0,0,0,0,0,0,0,0,Matches
1332,Reda Khadra,GER,"FW,MF",Reims,Ligue 1,22,2001,15.2,16,10,5,4,7,8,20,40.0,12,8,2,6,3,19,13,0,Matches
1333,Wahbi Khazri,TUN,FW,Montpellier,Ligue 1,32,1991,12.6,24,17,8,12,4,14,35,40.0,21,10,0,10,3,27,7,0,Matches
1334,Rani Khedira,GER,MF,Union Berlin,Bundesliga,29,1994,14.9,35,22,15,19,1,17,26,65.4,9,12,5,7,22,57,38,0,Matches
1335,Abdukodir Khusanov,UZB,DF,Lens,Ligue 1,19,2004,9.0,21,12,13,8,0,9,17,52.9,8,13,8,5,13,34,32,2,Matches
1336,Kiké,ESP,"FW,MF",Alavés,La Liga,33,1989,15.8,8,4,2,3,3,4,9,44.4,5,16,5,11,1,9,12,0,Matches
1337,Luca Kilian,GER,DF,Köln,Bundesliga,23,1999,7.1,16,9,15,1,0,9,14,64.3,5,12,5,7,7,23,28,0,Matches
1338,Max Kilman,ENG,DF,Wolves,Premier League,26,1997,38.0,47,21,40,6,1,24,32,75.0,8,64,37,27,39,86,182,4,Matches
1339,Joshua Kimmich,GER,"MF,DF",Bayern Munich,Bundesliga,28,1995,24.2,45,33,25,15,5,26,39,66.7,13,32,4,28,14,59,28,1,Matches
1340,Jakub Kiwior,POL,DF,Arsenal,Premier League,23,2000,10.5,20,12,11,8,1,14,19,73.7,5,11,3,8,8,28,28,1,Matches
1341,Simon Kjær,DEN,DF,Milan,Serie A,34,1989,13.0,24,15,11,11,2,14,22,63.6,8,22,16,6,14,38,46,2,Matches
1342,Davy Klaassen,NED,MF,Inter,Serie A,30,1993,2.3,4,2,0,4,0,1,3,33.3,2,5,1,4,3,7,4,0,Matches
1343,Christoph Klarer,AUT,DF,Darmstadt 98,Bundesliga,23,2000,26.2,37,22,30,4,3,24,36,66.7,12,31,20,11,21,58,94,1,Matches
1344,Tim Kleindienst,GER,FW,Heidenheim,Bundesliga,27,1995,31.9,21,12,6,11,4,7,25,28.0,18,32,8,24,12,33,58,0,Matches
1345,Lukas Klostermann,GER,DF,RB Leipzig,Bundesliga,27,1996,16.0,15,10,7,7,1,4,13,30.8,9,25,12,13,13,28,64,1,Matches
1346,Justin Kluivert,NED,"MF,FW",Bournemouth,Premier League,24,1999,21.3,28,14,5,12,11,8,30,26.7,22,16,1,15,8,36,11,0,Matches
1347,Ansgar Knauff,GER,"MF,DF",Eint Frankfurt,Bundesliga,21,2002,23.4,43,26,17,16,10,17,31,54.8,14,40,3,37,20,63,15,0,Matches
1348,Robin Knoche,GER,DF,Union Berlin,Bundesliga,31,1992,21.3,34,22,27,7,0,19,30,63.3,11,27,19,8,13,47,73,0,Matches
1349,Gregor Kobel,SUI,GK,Dortmund,Bundesliga,25,1997,26.3,0,0,0,0,0,0,1,0.0,1,0,0,0,0,0,11,0,Matches
1350,Robin Koch,GER,DF,Eint Frankfurt,Bundesliga,27,1996,30.4,38,23,26,12,0,17,27,63.0,10,33,24,9,32,70,136,2,Matches
1351,Philipp Köhn,SUI,GK,Monaco,Ligue 1,25,1998,22.0,1,1,1,0,0,1,1,100.0,0,0,0,0,1,2,5,3,Matches
1352,Dominik Kohr,GER,"DF,MF",Mainz 05,Bundesliga,29,1994,24.3,65,42,36,25,4,36,57,63.2,21,27,6,21,43,108,58,0,Matches
1353,Koke,ESP,MF,Atlético Madrid,La Liga,31,1992,27.7,66,44,27,32,7,36,79,45.6,43,37,12,25,16,82,34,1,Matches
1354,Sead Kolašinac,BIH,DF,Atalanta,Serie A,30,1993,24.2,44,32,23,19,2,30,49,61.2,19,22,9,13,21,65,47,0,Matches
1355,Luca Koleosho,ITA,"MF,FW",Burnley,Premier League,18,2004,10.8,7,4,2,5,0,2,10,20.0,8,13,0,13,2,9,0,0,Matches
1356,Randal Kolo Muani,FRA,"FW,MF",Paris S-G,Ligue 1,24,1998,14.1,10,8,5,3,2,5,13,38.5,8,5,0,5,4,14,10,0,Matches
1357,Randal Kolo Muani,FRA,FW,Eint Frankfurt,Bundesliga,24,1998,1.7,0,0,0,0,0,0,0,,0,0,0,0,0,0,1,0,Matches
1358,Mert Kömür,GER,"MF,DF",Augsburg,Bundesliga,18,2005,1.3,3,3,3,0,0,3,5,60.0,2,0,0,0,0,3,1,0,Matches
1359,Cheick Konaté,MLI,DF,Clermont Foot,Ligue 1,19,2004,11.9,26,15,17,9,0,20,36,55.6,16,16,2,14,13,39,21,0,Matches
1360,Ibrahima Konaté,FRA,DF,Liverpool,Premier League,24,1999,17.5,36,22,22,13,1,18,24,75.0,6,18,12,6,20,56,51,1,Matches
1361,Geoffrey Kondogbia,CTA,MF,Marseille,Ligue 1,30,1993,16.3,48,31,18,25,5,13,32,40.6,19,21,4,17,30,78,25,0,Matches
1362,Abdoul Koné,FRA,DF,Reims,Ligue 1,18,2005,2.1,7,7,5,2,0,4,11,36.4,7,2,0,2,2,9,9,0,Matches
1363,Amadou Koné,MLI,MF,Reims,Ligue 1,18,2005,5.3,13,8,11,2,0,6,10,60.0,4,8,3,5,10,23,10,0,Matches
1364,Ibrahima Koné,MLI,FW,Almería,La Liga,24,1999,3.1,1,0,1,0,0,1,1,100.0,0,1,0,1,0,1,4,0,Matches
1365,Ibrahima Koné,MLI,FW,Lorient,Ligue 1,24,1999,0.4,0,0,0,0,0,0,1,0.0,1,0,0,0,0,0,0,0,Matches
1366,Manu Koné,FRA,MF,Gladbach,Bundesliga,22,2001,17.3,45,26,20,20,5,17,25,68.0,8,22,1,21,15,60,16,1,Matches
1367,Ezri Konsa,ENG,DF,Aston Villa,Premier League,25,1997,34.1,54,32,28,23,3,23,27,85.2,4,36,20,16,28,82,73,3,Matches
1368,Teun Koopmeiners,NED,MF,Atalanta,Serie A,25,1998,29.2,39,24,12,22,5,17,50,34.0,33,33,3,30,10,49,35,0,Matches
1369,Odilon Kossonou,CIV,DF,Leverkusen,Bundesliga,22,2001,20.1,30,20,11,12,7,15,26,57.7,11,27,3,24,27,57,43,1,Matches
1370,Filip Kostić,SRB,DF,Juventus,Serie A,30,1992,20.2,37,23,20,13,4,17,33,51.5,16,29,8,21,9,46,43,0,Matches
1371,Christian Kouamé,CIV,FW,Fiorentina,Serie A,25,1997,12.1,13,4,7,6,0,6,10,60.0,4,16,0,16,2,15,10,0,Matches
1372,Rominigue Kouamé,MLI,MF,Cádiz,La Liga,26,1996,9.1,14,9,6,7,1,7,15,46.7,8,10,2,8,13,27,10,1,Matches
1373,Koffi Kouao,CIV,DF,Metz,Ligue 1,25,1998,9.6,20,13,12,7,1,11,17,64.7,6,9,6,3,13,33,38,1,Matches
1374,Tomáš Koubek,CZE,GK,Augsburg,Bundesliga,30,1992,3.0,0,0,0,0,0,0,0,,0,0,0,0,0,0,1,1,Matches
1375,Therence Koudou,FRA,DF,Reims,Ligue 1,18,2004,3.5,2,2,1,1,0,0,2,0.0,2,4,3,1,4,6,9,0,Matches
1376,Jules Koundé,FRA,DF,Barcelona,La Liga,24,1998,32.2,37,23,22,10,5,28,51,54.9,23,32,12,20,25,62,83,5,Matches
1377,Boubakar Kouyaté,MLI,DF,Montpellier,Ligue 1,26,1997,21.4,49,30,39,8,2,28,51,54.9,23,31,20,11,29,78,123,1,Matches
1378,Cheikhou Kouyaté,SEN,MF,Nott'ham Forest,Premier League,33,1989,2.4,8,5,3,3,2,1,4,25.0,3,4,1,3,2,10,10,0,Matches
1379,Mateo Kovačić,CRO,MF,Manchester City,Premier League,29,1994,17.2,36,25,16,15,5,18,28,64.3,10,23,1,22,10,46,10,0,Matches
1380,Viktor Kovalenko,UKR,MF,Empoli,Serie A,27,1996,6.8,5,2,2,2,1,2,8,25.0,6,12,2,10,1,6,7,0,Matches
1381,Matej Kovar,CZE,GK,Leverkusen,Bundesliga,23,2000,1.0,0,0,0,0,0,0,0,,0,0,0,0,0,0,0,0,Matches
1382,Dawid Kownacki,POL,FW,Werder Bremen,Bundesliga,26,1997,4.2,1,1,1,0,0,1,4,25.0,3,3,1,2,0,1,1,0,Matches
1383,Emil Krafth,SWE,DF,Newcastle Utd,Premier League,28,1994,10.1,21,14,10,7,4,12,25,48.0,13,8,3,5,9,30,21,0,Matches
1384,Alex Král,CZE,MF,Union Berlin,Bundesliga,25,1998,15.2,19,14,7,10,2,8,20,40.0,12,15,4,11,11,30,30,0,Matches
1385,Andrej Kramarić,CRO,"MF,FW",Hoffenheim,Bundesliga,32,1991,24.4,11,2,5,4,2,6,13,46.2,7,14,2,12,10,21,12,2,Matches
1386,Christoph Kramer,GER,MF,Gladbach,Bundesliga,32,1991,2.8,10,5,5,5,0,2,14,14.3,12,7,1,6,4,14,6,0,Matches
1387,Frans Krätzig,GER,DF,Bayern Munich,Bundesliga,20,2003,0.6,2,0,2,0,0,1,2,50.0,1,0,0,0,0,2,0,0,Matches
1388,Tom Krauß,GER,MF,Mainz 05,Bundesliga,22,2001,15.0,57,33,22,31,4,21,58,36.2,37,33,4,29,17,74,28,0,Matches
1389,Rasmus Kristensen,DEN,DF,Roma,Serie A,26,1997,19.4,36,19,25,8,3,28,50,56.0,22,27,7,20,8,44,50,0,Matches
1390,Thomas Kristensen,DEN,DF,Udinese,Serie A,21,2002,23.3,35,24,25,10,0,21,33,63.6,12,29,20,9,29,64,118,0,Matches
1391,Toni Kroos,GER,MF,Real Madrid,La Liga,33,1990,23.6,53,34,19,25,9,24,59,40.7,35,22,4,18,17,70,11,1,Matches
1392,Nikola Krstović,MNE,FW,Lecce,Serie A,23,2000,26.4,17,6,3,9,5,6,10,60.0,4,12,4,8,4,21,22,0,Matches
1393,Rade Krunić,BIH,MF,Milan,Serie A,29,1993,7.6,10,8,3,6,1,4,9,44.4,5,7,3,4,11,21,14,0,Matches
1394,Lukas Kübler,GER,DF,Freiburg,Bundesliga,30,1992,20.5,50,24,35,13,2,26,42,61.9,16,36,14,22,37,87,57,1,Matches
1395,Takefusa Kubo,JPN,"FW,MF",Real Sociedad,La Liga,22,2001,23.9,26,17,15,6,5,9,23,39.1,14,21,2,19,11,37,8,1,Matches
1396,Mahmut Kücüksahin,,MF,Augsburg,Bundesliga,19,2004,0.0,0,0,0,0,0,0,0,,0,0,0,0,0,0,0,0,Matches
1397,Mohammed Kudus,GHA,"FW,MF",West Ham,Premier League,22,2000,27.6,65,47,27,27,11,20,40,50.0,20,25,0,25,11,76,9,1,Matches
1398,Christian Kühlwetter,GER,MF,Heidenheim,Bundesliga,27,1996,0.1,0,0,0,0,0,0,0,,0,0,0,0,0,0,0,0,Matches
1399,Dejan Kulusevski,SWE,"FW,MF",Tottenham,Premier League,23,2000,30.7,62,33,19,20,23,25,67,37.3,42,24,1,23,18,80,2,1,Matches
1400,Sael Kumbedi,FRA,DF,Lyon,Ligue 1,18,2005,10.3,30,20,14,12,4,9,22,40.9,13,12,3,9,14,44,18,2,Matches
1401,Marash Kumbulla,ALB,DF,Sassuolo,Serie A,23,2000,4.0,3,2,2,1,0,1,2,50.0,1,8,6,2,0,3,22,0,Matches
1402,Justin Kumi,ITA,FW,Sassuolo,Serie A,19,2004,0.0,0,0,0,0,0,0,0,,0,0,0,0,0,0,0,0,Matches
1403,Layvin Kurzawa,FRA,DF,Paris S-G,Ligue 1,30,1992,0.1,0,0,0,0,0,0,0,,0,0,0,0,0,0,0,0,Matches
1404,Berkan Kutlu,TUR,MF,Genoa,Serie A,25,1998,2.2,6,4,5,1,0,3,6,50.0,3,3,0,3,4,10,5,0,Matches
1405,Daler Kuzyaev,RUS,MF,Le Havre,Ligue 1,30,1993,23.2,34,19,11,13,10,15,43,34.9,28,18,5,13,22,56,18,1,Matches
1406,Khvicha Kvaratskhelia,GEO,FW,Napoli,Serie A,22,2001,30.4,42,21,11,19,12,15,49,30.6,34,15,1,14,13,55,9,0,Matches
1407,Giorgi Kvernadze,GEO,"FW,DF",Frosinone,Serie A,20,2003,0.7,3,0,2,0,1,2,2,100.0,0,1,0,1,1,4,0,0,Matches
1408,Moritz-Broni Kwarteng,GHA,FW,Bochum,Bundesliga,25,1998,3.1,3,0,0,3,0,1,7,14.3,6,4,0,4,2,5,0,0,Matches
1409,Grejohn Kyei,FRA,FW,Clermont Foot,Ligue 1,27,1995,11.4,6,4,2,2,2,2,3,66.7,1,5,1,4,1,7,10,0,Matches
1410,Giorgos Kyriakopoulos,GRE,DF,Monza,Serie A,27,1996,19.0,19,10,16,3,0,11,24,45.8,13,18,1,17,13,32,28,0,Matches
1411,Luca de la Torre,USA,MF,Celta Vigo,La Liga,25,1998,21.7,39,21,12,22,5,22,43,51.2,21,23,4,19,12,51,17,0,Matches
1412,Gaëtan Laborde,FRA,"FW,MF",Nice,Ligue 1,29,1994,21.2,18,12,8,4,6,11,30,36.7,19,20,2,18,6,24,8,1,Matches
1413,Alexandre Lacazette,FRA,FW,Lyon,Ligue 1,32,1991,25.5,19,12,8,9,2,5,17,29.4,12,22,3,19,8,27,9,0,Matches
1414,Maxence Lacroix,FRA,DF,Wolfsburg,Bundesliga,23,2000,26.2,48,29,28,18,2,29,41,70.7,12,35,12,23,24,72,121,0,Matches
1415,Alban Lafont,FRA,GK,Nantes,Ligue 1,24,1999,27.7,0,0,0,0,0,0,2,0.0,2,0,0,0,0,0,14,0,Matches
1416,Yoel Lago,ESP,DF,Celta Vigo,La Liga,19,2004,1.0,2,0,2,0,0,0,0,,0,1,0,1,0,2,2,0,Matches
1417,Aïssa Laïdouni,TUN,MF,Union Berlin,Bundesliga,26,1996,11.9,21,12,4,12,5,4,12,33.3,8,26,2,24,12,33,14,2,Matches
1418,Konrad Laimer,AUT,"DF,MF",Bayern Munich,Bundesliga,26,1997,19.7,56,36,25,20,11,22,52,42.3,30,42,6,36,18,74,13,2,Matches
1419,Stefan Lainer,AUT,"DF,MF",Gladbach,Bundesliga,30,1992,8.3,23,16,15,8,0,14,24,58.3,10,13,6,7,5,28,28,0,Matches
1420,Kenny Lala,MAD,DF,Brest,Ligue 1,31,1991,33.0,78,51,39,28,11,30,56,53.6,26,27,6,21,28,106,75,1,Matches
1421,Adam Lallana,ENG,"MF,FW",Brighton,Premier League,35,1988,9.4,8,3,4,4,0,0,4,0.0,4,2,1,1,3,11,1,0,Matches
1422,Mathis Lambourde,FRA,FW,Rennes,Ligue 1,17,2006,0.1,0,0,0,0,0,0,1,0.0,1,1,0,1,0,0,1,0,Matches
1423,Érik Lamela,ARG,"FW,MF",Sevilla,La Liga,31,1992,5.1,21,14,4,10,7,10,15,66.7,5,12,0,12,1,22,5,0,Matches
1424,Mohamed Lamine Bayo,GUI,FW,Le Havre,Ligue 1,25,1998,15.4,13,5,2,5,6,2,10,20.0,8,8,1,7,2,15,11,0,Matches
1425,Didier Lamkel Zé,CMR,"FW,MF",Metz,Ligue 1,26,1996,6.1,7,2,2,4,1,2,5,40.0,3,4,0,4,0,7,11,0,Matches
1426,Tariq Lamptey,GHA,"DF,FW",Brighton,Premier League,22,2000,10.2,21,14,14,5,2,13,22,59.1,9,7,3,4,6,27,6,0,Matches
1427,Bruno Langa,MOZ,DF,Almería,La Liga,25,1997,9.1,17,12,10,5,2,6,14,42.9,8,11,4,7,4,21,33,2,Matches
1428,Gianluca Lapadula,PER,FW,Cagliari,Serie A,33,1990,13.4,1,1,0,0,1,1,10,10.0,9,2,1,1,2,3,5,0,Matches
1429,Aymeric Laporte,ESP,DF,Manchester City,Premier League,29,1994,0.1,0,0,0,0,0,0,0,,0,1,1,0,0,0,1,0,Matches
1430,Julien Laporte,FRA,DF,Lorient,Ligue 1,29,1993,20.2,23,14,15,7,1,16,36,44.4,20,36,26,10,11,34,116,1,Matches
1431,Cyle Larin,CAN,FW,Mallorca,La Liga,28,1995,20.3,17,8,6,4,7,2,7,28.6,5,16,5,11,3,20,17,0,Matches
1432,Yasser Larouci,ALG,DF,Sheffield Utd,Premier League,22,2001,5.9,17,9,10,5,2,10,14,71.4,4,6,1,5,7,24,20,1,Matches
1433,Hugo Larsson,SWE,MF,Eint Frankfurt,Bundesliga,19,2004,21.0,32,18,18,10,4,15,28,53.6,13,34,7,27,29,61,30,1,Matches
1434,Jamaal Lascelles,ENG,DF,Newcastle Utd,Premier League,29,1993,12.0,14,9,7,7,0,6,11,54.5,5,17,12,5,5,19,42,0,Matches
1435,Juanmi Latasa,ESP,FW,Getafe,La Liga,22,2001,17.3,9,7,0,6,3,1,11,9.1,10,9,0,9,4,13,21,0,Matches
1436,Toni Lato,ESP,DF,Mallorca,La Liga,25,1997,17.2,38,23,19,13,6,16,27,59.3,11,17,3,14,17,55,27,0,Matches
1437,Armand Lauriente,FRA,FW,Sassuolo,Serie A,24,1998,32.3,31,20,8,14,9,13,44,29.5,31,29,4,25,15,46,11,0,Matches
1438,Roméo Lavia,BEL,MF,Chelsea,Premier League,19,2004,0.4,1,0,0,1,0,0,0,,0,0,0,0,0,1,1,0,Matches
1439,Lázaro,BRA,"FW,MF",Almería,La Liga,21,2002,3.2,4,1,2,0,2,2,8,25.0,6,4,0,4,1,5,1,0,Matches
1440,Valentino Lazaro,AUT,"DF,MF",Torino,Serie A,27,1996,22.2,18,11,7,9,2,13,19,68.4,6,14,1,13,8,26,29,0,Matches
1441,Darko Lazović,SRB,"FW,MF",Hellas Verona,Serie A,32,1990,21.4,26,16,11,6,9,16,31,51.6,15,10,1,9,6,32,14,0,Matches
1442,Manuel Lazzari,ITA,DF,Lazio,Serie A,29,1993,18.6,26,18,13,10,3,18,28,64.3,10,20,4,16,12,38,37,1,Matches
1443,Théo Le Bris,FRA,"DF,MF",Lorient,Ligue 1,20,2002,16.8,35,22,25,7,3,19,40,47.5,21,24,3,21,12,47,42,0,Matches
1444,Julien Le Cardinal,FRA,DF,Brest,Ligue 1,25,1997,5.3,19,11,11,7,1,8,12,66.7,4,6,3,3,13,32,26,0,Matches
1445,Julien Le Cardinal,FRA,DF,Lens,Ligue 1,25,1997,0.6,6,2,4,2,0,4,9,44.4,5,2,1,1,0,6,0,0,Matches
1446,Jérémy Le Douaron,FRA,FW,Brest,Ligue 1,25,1998,18.0,21,10,7,9,5,11,26,42.3,15,14,1,13,2,23,10,0,Matches
1447,Enzo Le Fée,FRA,MF,Rennes,Ligue 1,23,2000,17.0,50,35,23,17,10,23,47,48.9,24,17,3,14,19,69,20,0,Matches
1448,Vincent Le Goff,FRA,"DF,MF",Lorient,Ligue 1,33,1989,6.0,5,0,4,0,1,4,8,50.0,4,11,3,8,3,8,10,0,Matches
1449,Robin Le Normand,ESP,DF,Real Sociedad,La Liga,26,1996,27.4,31,22,16,15,0,17,30,56.7,13,26,15,11,28,59,96,1,Matches
1450,Nicola Leali,ITA,GK,Genoa,Serie A,30,1993,2.0,0,0,0,0,0,0,0,,0,0,0,0,0,0,0,0,Matches
1451,Rafael Leão,POR,FW,Milan,Serie A,24,1999,27.9,16,10,3,8,5,8,13,61.5,5,15,1,14,9,25,19,0,Matches
1452,Adrien Lebeau,FRA,"MF,FW",Brest,Ligue 1,24,1999,0.6,0,0,0,0,0,0,3,0.0,3,2,1,1,0,0,1,0,Matches
1453,Jean-Louis Leca,FRA,GK,Lens,Ligue 1,37,1985,1.0,0,0,0,0,0,0,0,,0,0,0,0,0,0,1,0,Matches
1454,Benjamin Lecomte,FRA,GK,Montpellier,Ligue 1,32,1991,30.0,0,0,0,0,0,0,1,0.0,1,0,0,0,0,0,16,1,Matches
1455,Jeremías Ledesma,ARG,GK,Cádiz,La Liga,30,1993,33.9,1,1,1,0,0,1,4,25.0,3,0,0,0,0,1,15,3,Matches
1456,Pierre Lees-Melou,FRA,MF,Brest,Ligue 1,30,1993,28.0,96,67,51,41,4,49,129,38.0,80,61,11,50,43,139,64,3,Matches
1457,Diogo Leite,POR,DF,Union Berlin,Bundesliga,24,1999,30.0,52,36,31,15,6,25,51,49.0,26,48,22,26,47,99,155,1,Matches
1458,Maxim Leitsch,GER,DF,Mainz 05,Bundesliga,25,1998,4.2,6,3,5,1,0,3,6,50.0,3,2,0,2,4,10,13,0,Matches
1459,Florian Lejeune,FRA,DF,Rayo Vallecano,La Liga,32,1991,37.0,39,25,26,11,2,19,30,63.3,11,33,18,15,23,62,155,1,Matches
1460,Stefan Lekovic,SRB,DF,Villarreal,La Liga,19,2004,0.3,0,0,0,0,0,0,0,,0,1,1,0,0,0,1,0,Matches
1461,Iñigo Lekue,ESP,DF,Athletic Club,La Liga,30,1993,22.2,40,22,25,10,5,27,53,50.9,26,24,6,18,15,55,50,0,Matches
1462,Thomas Lemar,FRA,MF,Atlético Madrid,La Liga,27,1995,1.8,3,1,2,1,0,1,2,50.0,1,0,0,0,0,3,0,0,Matches
1463,Mario Lemina,GAB,MF,Wolves,Premier League,29,1993,33.0,90,58,46,33,11,25,47,53.2,22,36,9,27,41,131,64,0,Matches
1464,Álvaro Lemos,ESP,DF,Las Palmas,La Liga,30,1993,2.8,4,1,1,3,0,0,2,0.0,2,3,1,2,2,6,4,0,Matches
1465,Ruben Lendinez,ESP,DF,Valencia,La Liga,20,2003,0.1,2,2,0,2,0,1,1,100.0,0,0,0,0,0,2,1,0,Matches
1466,Clément Lenglet,FRA,DF,Aston Villa,Premier League,28,1995,12.8,13,9,7,5,1,7,13,53.8,6,19,11,8,7,20,47,1,Matches
1467,Bernd Leno,GER,GK,Fulham,Premier League,31,1992,38.0,0,0,0,0,0,0,0,,0,0,0,0,0,0,14,1,Matches
1468,Christopher Lenz,GER,"DF,MF",RB Leipzig,Bundesliga,28,1994,0.5,2,1,2,0,0,1,1,100.0,0,0,0,0,2,4,2,0,Matches
1469,Christopher Lenz,GER,DF,Eint Frankfurt,Bundesliga,28,1994,0.1,1,1,0,1,0,1,1,100.0,0,0,0,0,0,1,1,0,Matches
1470,Johann Lepenant,FRA,MF,Lyon,Ligue 1,20,2002,2.8,4,3,2,2,0,1,8,12.5,7,5,0,5,4,8,0,0,Matches
1471,Jefferson Lerma,COL,"MF,DF",Crystal Palace,Premier League,28,1994,26.7,42,25,15,23,4,19,40,47.5,21,31,12,19,36,78,72,0,Matches
1472,Léo Leroy,FRA,MF,Montpellier,Ligue 1,23,2000,5.5,19,10,8,8,3,6,21,28.6,15,12,3,9,7,26,8,0,Matches
1473,Robert Lewandowski,POL,FW,Barcelona,La Liga,34,1988,30.6,8,5,0,6,2,4,12,33.3,8,13,4,9,9,17,18,0,Matches
1474,Jamie Leweling,GER,"FW,MF",Stuttgart,Bundesliga,22,2001,16.9,18,10,4,6,8,5,17,29.4,12,21,1,20,5,23,13,0,Matches
1475,Rico Lewis,ENG,"DF,MF",Manchester City,Premier League,18,2004,9.0,10,7,4,4,2,3,7,42.9,4,7,1,6,4,14,6,0,Matches
1476,Keane Lewis-Potter,ENG,"FW,DF",Brentford,Premier League,22,2001,16.0,17,7,5,11,1,7,15,46.7,8,10,2,8,7,24,23,0,Matches
1477,Philipp Lienhart,AUT,DF,Freiburg,Bundesliga,27,1996,14.1,20,13,14,5,1,13,23,56.5,10,18,11,7,14,34,51,0,Matches
1478,Matthijs de Ligt,NED,DF,Bayern Munich,Bundesliga,23,1999,15.4,15,12,4,8,3,6,11,54.5,5,14,10,4,19,34,52,0,Matches
1479,Victor Lindelöf,SWE,DF,Manchester Utd,Premier League,29,1994,14.8,15,10,8,7,0,5,13,38.5,8,18,9,9,12,27,40,1,Matches
1480,Jesper Lindstrøm,DEN,"FW,MF",Napoli,Serie A,23,2000,4.8,8,3,2,3,3,4,8,50.0,4,3,0,3,2,10,6,0,Matches
1481,Jesper Lindstrøm,DEN,FW,Eint Frankfurt,Bundesliga,23,2000,0.9,1,1,1,0,0,0,0,,0,0,0,0,0,1,0,0,Matches
1482,Karol Linetty,POL,MF,Torino,Serie A,28,1995,20.6,30,21,9,20,1,9,29,31.0,20,24,8,16,23,53,27,1,Matches
1483,Samuel Lino,BRA,"DF,MF",Atlético Madrid,La Liga,23,1999,23.1,61,34,32,17,12,35,70,50.0,35,37,1,36,14,75,27,0,Matches
1484,Luca Lipani,ITA,MF,Sassuolo,Serie A,18,2005,4.3,9,7,4,3,2,3,11,27.3,8,9,2,7,6,15,7,0,Matches
1485,Pol Lirola,ESP,DF,Frosinone,Serie A,25,1997,17.1,30,18,14,15,1,17,35,48.6,18,12,1,11,19,49,41,1,Matches
1486,Marcin Listkowski,POL,FW,Lecce,Serie A,25,1998,0.1,0,0,0,0,0,0,0,,0,0,0,0,0,0,0,0,Matches
1487,Valentino Livramento,ENG,DF,Newcastle Utd,Premier League,20,2002,14.6,23,13,15,6,2,10,21,47.6,11,16,7,9,25,48,41,1,Matches
1488,Dejan Ljubicic,AUT,"MF,FW",Köln,Bundesliga,25,1997,22.8,43,27,20,18,5,20,43,46.5,23,22,2,20,18,61,11,0,Matches
1489,Javier Llabrés,ESP,"MF,FW",Mallorca,La Liga,20,2002,2.7,3,1,1,1,1,1,2,50.0,1,1,0,1,3,6,4,0,Matches
1490,Diego Llorente,ESP,DF,Roma,Serie A,29,1993,24.1,31,19,20,10,1,11,24,45.8,13,40,27,13,22,53,79,0,Matches
1491,Marcos Llorente,ESP,"MF,DF",Atlético Madrid,La Liga,28,1995,28.5,40,23,18,17,5,16,44,36.4,28,36,11,25,14,54,35,0,Matches
1492,Gautier Lloris,FRA,DF,Le Havre,Ligue 1,28,1995,30.9,50,28,40,9,1,28,42,66.7,14,50,30,20,32,82,142,1,Matches
1493,Abou Lô,SEN,"MF,DF",Metz,Ligue 1,23,2000,2.2,3,1,2,1,0,1,4,25.0,3,5,2,3,4,7,8,0,Matches
1494,Giovani Lo Celso,ARG,MF,Tottenham,Premier League,27,1996,5.6,22,13,10,8,4,9,14,64.3,5,4,1,3,5,27,2,0,Matches
1495,Stanislav Lobotka,SVK,MF,Napoli,Serie A,28,1994,36.5,61,39,18,30,13,24,60,40.0,36,30,8,22,30,91,29,0,Matches
1496,Manuel Locatelli,ITA,MF,Juventus,Serie A,25,1998,33.4,69,43,24,35,10,31,58,53.4,27,43,17,26,25,94,65,0,Matches
1497,Bradley Locko,FRA,DF,Brest,Ligue 1,21,2002,32.9,97,55,57,34,6,47,80,58.8,33,28,1,27,40,137,69,0,Matches
1498,Tom Lockyer,WAL,DF,Luton Town,Premier League,28,1994,13.0,25,16,17,6,2,15,22,68.2,7,23,13,10,23,48,68,0,Matches
1499,Renan Lodi,BRA,DF,Marseille,Ligue 1,25,1998,13.7,24,16,8,13,3,13,21,61.9,8,7,2,5,16,40,35,0,Matches
1500,Ruben Loftus-Cheek,ENG,MF,Milan,Serie A,27,1996,23.0,28,18,7,14,7,15,27,55.6,12,24,12,12,9,37,10,1,Matches
1501,Andy Logbo,FRA,FW,Le Havre,Ligue 1,19,2004,2.8,0,0,0,0,0,0,3,0.0,3,7,3,4,0,0,2,0,Matches
1502,Enzo Loiodice,FRA,MF,Las Palmas,La Liga,22,2000,19.9,62,35,15,34,13,20,42,47.6,22,20,2,18,12,74,16,1,Matches
1503,Sean Longstaff,ENG,MF,Newcastle Utd,Premier League,25,1997,30.5,54,30,17,29,8,24,63,38.1,39,43,7,36,17,71,23,0,Matches
1504,Ademola Lookman,NGA,"FW,MF",Atalanta,Serie A,25,1997,21.0,20,15,2,11,7,8,22,36.4,14,19,0,19,9,29,0,1,Matches
1505,Noah Loosli,SUI,DF,Bochum,Bundesliga,26,1997,3.8,10,7,6,4,0,7,14,50.0,7,7,1,6,7,17,18,0,Matches
1506,Anthony Lopes,POR,GK,Lyon,Ligue 1,32,1990,31.0,0,0,0,0,0,0,0,,0,0,0,0,0,0,16,0,Matches
1507,David López,ESP,DF,Girona,La Liga,33,1989,21.8,33,20,21,12,0,17,22,77.3,5,28,19,9,20,53,63,4,Matches
1508,Diego López,ESP,"MF,FW",Valencia,La Liga,21,2002,29.5,37,25,14,16,7,13,56,23.2,43,23,1,22,20,57,12,0,Matches
1509,Fermin López,ESP,"MF,FW",Barcelona,La Liga,20,2003,16.1,41,21,15,18,8,14,40,35.0,26,14,1,13,4,45,9,0,Matches
1510,Javi López,ESP,DF,Alavés,La Liga,21,2002,26.5,23,12,11,9,3,15,26,57.7,11,25,9,16,10,33,77,1,Matches
1511,Maxime Lopez,FRA,MF,Fiorentina,Serie A,25,1997,8.9,18,9,5,10,3,6,12,50.0,6,3,1,2,7,25,6,0,Matches
1512,Maxime Lopez,FRA,MF,Sassuolo,Serie A,25,1997,1.6,2,1,1,1,0,1,2,50.0,1,1,1,0,2,4,0,0,Matches
1513,Pau López,ESP,GK,Marseille,Ligue 1,28,1994,32.7,0,0,0,0,0,0,2,0.0,2,0,0,0,0,0,10,1,Matches
1514,Unai López,ESP,MF,Rayo Vallecano,La Liga,27,1995,23.4,48,24,18,23,7,21,53,39.6,32,24,3,21,16,64,15,2,Matches
1515,Dion Lopy,SEN,MF,Almería,La Liga,21,2002,21.3,62,37,36,20,6,17,44,38.6,27,23,5,18,15,77,22,2,Matches
1516,Anthony Losilla,FRA,MF,Bochum,Bundesliga,37,1986,28.6,63,37,15,40,8,23,51,45.1,28,37,8,29,25,88,51,0,Matches
1517,Jordan Lotomba,SUI,DF,Nice,Ligue 1,24,1998,20.0,36,28,18,9,9,25,35,71.4,10,30,9,21,16,52,26,1,Matches
1518,Tom Louchet,FRA,"MF,DF",Nice,Ligue 1,20,2003,4.5,14,5,6,6,2,7,11,63.6,4,7,3,4,3,17,9,0,Matches
1519,Imran Louza,MAR,MF,Lorient,Ligue 1,24,1999,9.6,13,7,2,8,3,2,8,25.0,6,8,1,7,9,22,4,0,Matches
1520,Matteo Lovato,ITA,DF,Torino,Serie A,23,2000,6.0,10,7,5,5,0,4,5,80.0,1,9,5,4,13,23,10,0,Matches
1521,Matteo Lovato,ITA,DF,Salernitana,Serie A,23,2000,10.5,27,14,17,8,2,16,24,66.7,8,14,7,7,18,45,41,1,Matches
1522,Dejan Lovren,CRO,DF,Lyon,Ligue 1,34,1989,8.0,9,7,6,3,0,3,7,42.9,4,6,5,1,12,21,37,0,Matches
1523,Sandi Lovrić,SVN,MF,Udinese,Serie A,25,1998,22.1,25,12,9,11,5,9,23,39.1,14,21,2,19,21,46,24,0,Matches
1524,Max Lowe,ENG,"DF,MF",Sheffield Utd,Premier League,26,1997,5.6,21,10,13,5,3,8,15,53.3,7,10,4,6,5,26,15,0,Matches
1525,Anthony Lozano,HON,"MF,FW",Getafe,La Liga,30,1993,1.0,0,0,0,0,0,0,1,0.0,1,0,0,0,0,0,1,0,Matches
1526,Anthony Lozano,HON,FW,Almería,La Liga,30,1993,8.6,7,5,2,5,0,4,7,57.1,3,6,1,5,2,9,12,0,Matches
1527,Lucas,BRA,DF,Cádiz,La Liga,22,2001,17.1,47,27,32,11,4,32,55,58.2,23,27,4,23,17,64,45,0,Matches
1528,Lorenzo Lucca,ITA,FW,Udinese,Serie A,22,2000,28.8,19,11,4,11,4,5,20,25.0,15,18,3,15,3,22,36,1,Matches
1529,Jhon Lucumí,COL,DF,Bologna,Serie A,25,1998,24.6,48,29,31,17,0,27,36,75.0,9,32,17,15,16,64,68,2,Matches
1530,José Luis Gayà,ESP,DF,Valencia,La Liga,28,1995,19.9,71,36,44,23,4,43,67,64.2,24,18,3,15,11,82,42,0,Matches
1531,José Luis Morales,ESP,"FW,MF",Villarreal,La Liga,36,1987,11.6,5,3,1,4,0,3,13,23.1,10,9,1,8,7,12,4,0,Matches
1532,José Luis Palomino,ARG,DF,Atalanta,Serie A,33,1990,0.3,2,1,1,1,0,1,1,100.0,0,2,1,1,1,3,6,0,Matches
1533,Douglas Luiz,BRA,MF,Aston Villa,Premier League,25,1998,33.3,58,38,21,27,10,25,53,47.2,28,32,8,24,23,81,18,2,Matches
1534,Romelu Lukaku,BEL,FW,Roma,Serie A,30,1993,29.3,6,5,1,2,3,2,4,50.0,2,7,1,6,0,6,19,1,Matches
1535,Castello Lukeba,FRA,DF,RB Leipzig,Bundesliga,20,2002,24.3,19,12,10,9,0,10,12,83.3,2,35,13,22,12,31,94,2,Matches
1536,Dodi Lukebakio,BEL,"FW,MF",Sevilla,La Liga,25,1997,12.5,5,2,2,2,1,1,6,16.7,5,9,2,7,2,7,5,0,Matches
1537,Saša Lukić,SRB,MF,Fulham,Premier League,26,1996,12.5,33,19,9,17,7,18,39,46.2,21,18,5,13,16,49,19,1,Matches
1538,Karlo Lulić,CRO,MF,Frosinone,Serie A,27,1996,0.2,0,0,0,0,0,0,0,,0,1,0,1,1,1,0,0,Matches
1539,Andriy Lunin,UKR,GK,Real Madrid,La Liga,24,1999,21.0,0,0,0,0,0,0,1,0.0,1,0,0,0,0,0,15,1,Matches
1540,Sebastiano Luperto,ITA,DF,Empoli,Serie A,26,1996,37.8,37,26,25,10,2,15,24,62.5,9,46,35,11,32,69,157,1,Matches
1541,Mateus Lusuardi,BRA,DF,Frosinone,Serie A,19,2004,2.4,2,1,1,1,0,1,3,33.3,2,4,2,2,4,6,8,0,Matches
1542,Andreas Luthe,GER,GK,Bochum,Bundesliga,36,1987,1.0,0,0,0,0,0,0,0,,0,0,0,0,0,0,1,0,Matches
1543,Zito Luvumbo,ANG,"FW,MF",Cagliari,Serie A,21,2002,21.6,9,6,5,2,2,4,15,26.7,11,19,0,19,1,10,2,0,Matches
1544,Charalambos Lykogiannis,GRE,DF,Bologna,Serie A,29,1993,10.0,10,6,5,4,1,5,10,50.0,5,15,5,10,5,15,30,0,Matches
1545,Senne Lynen,BEL,MF,Werder Bremen,Bundesliga,24,1999,20.0,64,38,33,27,4,30,70,42.9,40,41,8,33,41,105,56,0,Matches
1546,Joshua M'Bahia,CIV,MF,Clermont Foot,Ligue 1,18,2005,0.2,0,0,0,0,0,0,0,,0,0,0,0,0,0,0,0,Matches
1547,Othmane Maamma,FRA,FW,Montpellier,Ligue 1,17,2005,1.0,3,3,2,0,1,1,1,100.0,0,3,0,3,0,3,0,0,Matches
1548,Ian Maatsen,NED,"FW,MF",Chelsea,Premier League,21,2002,2.3,3,2,1,1,1,0,4,0.0,4,4,0,4,3,6,10,0,Matches
1549,Ian Maatsen,NED,DF,Dortmund,Bundesliga,21,2002,14.0,30,22,15,9,6,16,30,53.3,14,22,4,18,13,43,26,0,Matches
1550,Alexis Mac Allister,ARG,MF,Liverpool,Premier League,24,1998,28.9,99,55,35,50,14,59,125,47.2,66,65,8,57,35,134,25,1,Matches
1551,Deiver Machado,COL,DF,Lens,Ligue 1,29,1993,12.5,24,18,10,10,4,15,20,75.0,5,13,2,11,7,31,8,0,Matches
1552,Darwin Machís,VEN,MF,Cádiz,La Liga,30,1993,8.7,23,14,7,9,7,13,24,54.2,11,8,1,7,4,27,2,0,Matches
1553,James Maddison,ENG,MF,Tottenham,Premier League,26,1996,23.7,33,19,5,18,10,15,29,51.7,14,15,3,12,13,46,10,1,Matches
1554,Noni Madueke,ENG,FW,Chelsea,Premier League,21,2002,11.7,16,10,8,4,4,11,34,32.4,23,11,0,11,4,20,14,0,Matches
1555,Pablo Maffeo,ESP,DF,Mallorca,La Liga,26,1997,16.2,35,22,18,13,4,23,40,57.5,17,12,2,10,10,45,23,0,Matches
1556,Gabriel Magalhães,BRA,DF,Arsenal,Premier League,25,1997,33.8,48,28,24,22,2,17,22,77.3,5,44,33,11,31,79,100,1,Matches
1557,Soungoutou Magassa,FRA,"DF,MF",Monaco,Ligue 1,19,2003,15.0,56,26,22,32,2,26,48,54.2,22,21,4,17,21,77,36,2,Matches
1558,Giulio Maggiore,ITA,MF,Salernitana,Serie A,25,1998,20.0,49,29,26,22,1,20,42,47.6,22,27,5,22,24,73,38,0,Matches
1559,Matej Maglica,CRO,DF,Darmstadt 98,Bundesliga,24,1998,18.9,35,21,25,10,0,22,36,61.1,14,29,11,18,22,57,92,5,Matches
1560,Giangiacomo Magnani,ITA,DF,Hellas Verona,Serie A,27,1995,27.2,33,18,23,10,0,15,25,60.0,10,50,28,22,45,78,118,0,Matches
1561,Hugo Magnetti,FRA,MF,Brest,Ligue 1,25,1998,26.0,49,27,18,26,5,24,58,41.4,34,19,1,18,18,67,18,0,Matches
1562,Yohann Magnin,FRA,MF,Clermont Foot,Ligue 1,26,1997,18.7,49,31,12,32,5,22,47,46.8,25,38,13,25,19,68,26,1,Matches
1563,Frank Magri,CMR,"FW,MF",Toulouse,Ligue 1,23,1999,16.0,22,14,5,12,5,15,21,71.4,6,16,4,12,4,26,17,0,Matches
1564,Harry Maguire,ENG,DF,Manchester Utd,Premier League,30,1993,18.4,24,17,14,10,0,12,22,54.5,10,33,24,9,25,49,83,1,Matches
1565,Jon Magunacelaya,ESP,"FW,MF",Real Sociedad,La Liga,23,2000,1.3,5,3,2,3,0,4,8,50.0,4,3,0,3,0,5,2,0,Matches
1566,Adel Mahamoud,COM,FW,Nantes,Ligue 1,20,2003,0.1,0,0,0,0,0,0,1,0.0,1,0,0,0,0,0,0,0,Matches
1567,Arne Maier,GER,MF,Augsburg,Bundesliga,24,1999,11.1,14,9,5,8,1,5,14,35.7,9,19,2,17,6,20,11,0,Matches
1568,Habib Maïga,CIV,"MF,FW",Metz,Ligue 1,27,1996,1.6,2,2,1,0,1,1,3,33.3,2,2,0,2,4,6,2,0,Matches
1569,Mike Maignan,FRA,GK,Milan,Serie A,28,1995,29.0,1,0,1,0,0,1,1,100.0,0,1,0,1,1,2,4,3,Matches
1570,Linton Maina,GER,"FW,MF",Köln,Bundesliga,24,1999,21.1,18,15,11,5,2,9,28,32.1,19,12,1,11,6,24,12,0,Matches
1571,Patrick Mainka,GER,DF,Heidenheim,Bundesliga,28,1994,34.0,85,49,58,24,3,38,74,51.4,36,66,32,34,49,134,158,1,Matches
1572,Kobbie Mainoo,ENG,MF,Manchester Utd,Premier League,18,2005,21.4,47,27,20,16,11,21,45,46.7,24,20,12,8,22,69,30,1,Matches
1573,Ainsley Maitland-Niles,ENG,"DF,MF",Lyon,Ligue 1,25,1997,15.9,34,18,12,14,8,19,37,51.4,18,16,6,10,17,51,29,1,Matches
1574,Radosław Majecki,POL,GK,Monaco,Ligue 1,23,1999,12.0,0,0,0,0,0,0,0,,0,1,0,1,0,0,5,1,Matches
1575,Lovro Majer,CRO,MF,Rennes,Ligue 1,25,1998,0.2,0,0,0,0,0,0,0,,0,0,0,0,0,0,1,0,Matches
1576,Lovro Majer,CRO,"MF,FW",Wolfsburg,Bundesliga,25,1998,23.4,39,18,17,22,0,12,31,38.7,19,20,1,19,12,51,13,0,Matches
1577,Jean-Victor Makengo,FRA,"MF,FW",Lorient,Ligue 1,25,1998,5.3,5,4,3,2,0,2,6,33.3,4,12,1,11,8,13,5,0,Matches
1578,Jordy Makengo,FRA,DF,Freiburg,Bundesliga,21,2001,11.4,17,11,11,5,1,6,10,60.0,4,16,4,12,11,28,37,0,Matches
1579,Antoine Makoumbou,CGO,MF,Cagliari,Serie A,25,1998,30.0,41,24,21,15,5,15,30,50.0,15,23,4,19,16,57,27,2,Matches
1580,Nemanja Maksimović,SRB,MF,Getafe,La Liga,28,1995,36.3,65,43,26,31,8,23,41,56.1,18,56,23,33,46,111,61,0,Matches
1581,Julián Malatini,ARG,DF,Werder Bremen,Bundesliga,22,2001,6.7,18,13,12,3,3,16,24,66.7,8,8,1,7,13,31,26,0,Matches
1582,Daniel Maldini,ITA,"MF,FW",Monza,Serie A,21,2001,3.7,3,2,0,2,1,3,6,50.0,3,2,0,2,2,5,1,0,Matches
1583,Daniel Maldini,ITA,"FW,MF",Empoli,Serie A,21,2001,2.9,4,2,0,2,2,2,2,100.0,0,5,0,5,2,6,2,0,Matches
1584,Youssef Maleh,MAR,MF,Empoli,Serie A,24,1998,28.9,74,48,30,36,8,23,52,44.2,29,62,7,55,25,99,29,0,Matches
1585,Donyell Malen,NED,"FW,MF",Dortmund,Bundesliga,24,1999,19.8,11,7,5,3,3,2,6,33.3,4,11,4,7,2,13,8,0,Matches
1586,Ruslan Malinovskyi,UKR,MF,Genoa,Serie A,30,1993,17.2,35,20,18,11,6,17,41,41.5,24,22,8,14,5,40,16,0,Matches
1587,Lennard Maloney,USA,MF,Heidenheim,Bundesliga,23,1999,25.4,43,26,14,24,5,25,59,42.4,34,33,9,24,25,68,88,0,Matches
1588,Aaron Malouda,FRA,FW,Lille,Ligue 1,17,2005,0.0,0,0,0,0,0,0,0,,0,0,0,0,0,0,0,0,Matches
1589,Giorgi Mamardashvili,GEO,GK,Valencia,La Liga,22,2000,36.5,4,3,4,0,0,4,4,100.0,0,1,0,1,2,6,22,2,Matches
1590,David Mamutovic,GER,"FW,DF",Mainz 05,Bundesliga,22,2000,0.1,1,1,0,1,0,1,1,100.0,0,0,0,0,0,1,0,0,Matches
1591,Wilson Manafá,POR,"DF,MF",Granada,La Liga,29,1994,2.7,6,4,3,2,1,4,7,57.1,3,1,0,1,1,7,4,1,Matches
1592,Hianga Mananga Mbock,FRA,"MF,FW",Brest,Ligue 1,23,1999,0.1,1,0,0,0,1,1,2,50.0,1,0,0,0,1,2,0,0,Matches
1593,Gianluca Mancini,ITA,DF,Roma,Serie A,27,1996,31.9,34,20,21,11,2,11,27,40.7,16,38,26,12,36,70,77,1,Matches
1594,Marco Mancosu,ITA,"MF,FW",Cagliari,Serie A,34,1988,1.7,3,0,0,2,1,1,2,50.0,1,0,0,0,0,3,0,0,Matches
1595,Steve Mandanda,FRA,GK,Rennes,Ligue 1,38,1985,34.0,2,0,2,0,0,2,4,50.0,2,0,0,0,0,2,6,1,Matches
1596,Christos Mandas,GRE,GK,Lazio,Serie A,21,2001,8.0,0,0,0,0,0,0,1,0.0,1,0,0,0,1,1,3,1,Matches
1597,Reinildo Mandava,MOZ,DF,Atlético Madrid,La Liga,29,1994,8.1,30,22,16,11,3,19,22,86.4,3,10,2,8,15,45,21,0,Matches
1598,Aïssa Mandi,ALG,DF,Villarreal,La Liga,31,1991,12.4,13,8,8,5,0,7,14,50.0,7,10,7,3,8,21,41,0,Matches
1599,Rolando Mandragora,ITA,MF,Fiorentina,Serie A,26,1997,17.6,26,11,8,13,5,10,22,45.5,12,14,3,11,9,35,18,1,Matches
1600,Orel Mangala,BEL,MF,Nott'ham Forest,Premier League,25,1998,17.4,27,13,16,10,1,14,29,48.3,15,12,6,6,26,53,32,0,Matches
1601,Orel Mangala,BEL,MF,Lyon,Ligue 1,25,1998,4.4,5,3,0,2,3,1,3,33.3,2,3,2,1,5,10,6,0,Matches
1602,Vito Mannone,ITA,GK,Lille,Ligue 1,35,1988,1.0,0,0,0,0,0,0,0,,0,0,0,0,0,0,0,0,Matches
1603,Kostas Manolas,GRE,DF,Salernitana,Serie A,32,1991,5.4,9,5,6,3,0,6,8,75.0,2,10,7,3,2,11,20,0,Matches
1604,Javier Manquillo,ESP,"DF,MF",Celta Vigo,La Liga,29,1994,8.3,15,11,6,5,4,8,15,53.3,7,14,3,11,3,18,17,0,Matches
1605,Braydon Manu,GHA,MF,Darmstadt 98,Bundesliga,26,1997,1.9,2,0,0,1,1,0,0,,0,1,0,1,0,2,0,0,Matches
1606,Benson Manuel,ANG,"MF,FW",Burnley,Premier League,26,1997,1.3,3,2,2,1,0,0,0,,0,1,0,1,0,3,0,0,Matches
1607,Faitout Maouassa,FRA,"DF,MF",Granada,La Liga,25,1998,2.5,8,5,6,1,1,4,5,80.0,1,6,0,6,1,9,3,0,Matches
1608,Faitout Maouassa,FRA,"MF,DF",Lens,Ligue 1,25,1998,0.8,1,1,1,0,0,1,1,100.0,0,1,0,1,0,1,3,0,Matches
1609,Marcão,BRA,DF,Sevilla,La Liga,27,1996,3.9,9,6,5,4,0,6,10,60.0,4,8,6,2,4,13,11,1,Matches
1610,Solly March,ENG,"FW,DF",Brighton,Premier League,29,1994,6.2,19,14,9,7,3,8,14,57.1,6,5,0,5,11,30,8,0,Matches
1611,Riccardo Marchizza,ITA,DF,Frosinone,Serie A,25,1998,12.8,7,6,4,3,0,3,13,23.1,10,10,2,8,7,14,33,0,Matches
1612,Gian Marco Ferrari,ITA,DF,Sassuolo,Serie A,31,1992,25.2,22,10,11,11,0,12,18,66.7,6,28,17,11,25,47,76,0,Matches
1613,Óscar de Marcos,ESP,DF,Athletic Club,La Liga,34,1989,25.1,56,39,26,24,6,42,71,59.2,29,28,6,22,15,71,44,0,Matches
1614,Alberto Marí,ESP,FW,Valencia,La Liga,22,2001,3.1,4,2,0,1,3,1,1,100.0,0,3,0,3,0,4,5,0,Matches
1615,José Mari,ESP,"MF,FW",Cádiz,La Liga,35,1987,0.2,2,1,0,2,0,1,2,50.0,1,0,0,0,0,2,0,0,Matches
1616,Pablo Marí,ESP,DF,Monza,Serie A,29,1993,29.1,41,25,34,7,0,22,34,64.7,12,40,25,15,37,78,115,1,Matches
1617,José María Giménez,URU,DF,Atlético Madrid,La Liga,28,1995,14.7,18,10,10,7,1,5,16,31.3,11,16,12,4,10,28,95,0,Matches
1618,Mariano,DOM,"FW,MF",Sevilla,La Liga,29,1993,2.7,1,1,0,1,0,0,1,0.0,1,1,0,1,0,1,2,0,Matches
1619,Mirko Marić,CRO,FW,Monza,Serie A,28,1995,3.2,4,0,2,1,1,0,2,0.0,2,4,0,4,2,6,3,0,Matches
1620,Rafa Marín,ESP,DF,Alavés,La Liga,21,2002,27.1,32,20,23,9,0,14,27,51.9,13,34,21,13,33,65,129,2,Matches
1621,Răzvan Marin,ROU,MF,Empoli,Serie A,27,1996,20.2,40,22,13,23,4,19,29,65.5,10,16,4,12,6,46,30,2,Matches
1622,Diego Mariño,ESP,GK,Almería,La Liga,33,1990,1.0,0,0,0,0,0,0,0,,0,0,0,0,0,0,1,0,Matches
1623,Guillermo Maripán,CHI,DF,Monaco,Ligue 1,29,1994,19.6,22,8,15,6,1,10,27,37.0,17,26,13,13,30,52,106,4,Matches
1624,Mika Màrmol,ESP,DF,Las Palmas,La Liga,21,2002,35.3,70,42,44,24,2,35,53,66.0,18,39,19,20,44,114,147,2,Matches
1625,Omar Marmoush,EGY,"FW,MF",Eint Frankfurt,Bundesliga,24,1999,25.6,21,11,7,8,6,6,16,37.5,10,13,0,13,11,32,7,0,Matches
1626,Marquinhos,BRA,"FW,MF",Nantes,Ligue 1,20,2003,1.7,3,2,2,0,1,1,4,25.0,3,7,2,5,6,9,1,0,Matches
1627,Marquinhos,BRA,DF,Paris S-G,Ligue 1,29,1994,17.1,19,11,10,7,2,11,17,64.7,6,29,19,10,17,36,58,1,Matches
1628,Unai Marrero,ESP,GK,Real Sociedad,La Liga,21,2001,1.6,0,0,0,0,0,0,0,,0,0,0,0,0,0,0,0,Matches
1629,Agustín Martegani,ARG,MF,Salernitana,Serie A,23,2000,8.1,13,7,7,3,3,6,18,33.3,12,4,1,3,4,17,7,1,Matches
1630,Eric Martel,GER,MF,Köln,Bundesliga,21,2002,27.3,70,43,32,34,4,37,67,55.2,30,65,19,46,43,113,80,0,Matches
1631,Roger Martí,ESP,FW,Cádiz,La Liga,32,1991,15.1,12,6,1,9,2,2,7,28.6,5,16,1,15,7,19,4,0,Matches
1632,Anthony Martial,FRA,FW,Manchester Utd,Premier League,27,1995,5.0,4,1,1,1,2,1,1,100.0,0,4,0,4,0,4,3,0,Matches
1633,Aarón Martín,ESP,DF,Genoa,Serie A,26,1997,15.3,21,10,7,10,4,9,22,40.9,13,12,4,8,9,30,15,0,Matches
1634,Iván Martín,ESP,MF,Girona,La Liga,24,1999,30.3,44,25,22,15,7,22,57,38.6,35,25,3,22,21,65,14,0,Matches
1635,Jon Martin,ESP,DF,Real Sociedad,La Liga,17,2006,0.3,0,0,0,0,0,0,0,,0,0,0,0,0,0,3,0,Matches
1636,Jonas Martin,FRA,MF,Brest,Ligue 1,33,1990,13.4,43,27,17,24,2,21,36,58.3,15,16,2,14,9,52,28,2,Matches
1637,Mario Martín,ESP,MF,Real Madrid,La Liga,19,2004,0.2,5,1,0,2,3,3,4,75.0,1,2,1,1,0,5,0,0,Matches
1638,Gabriel Martinelli,BRA,FW,Arsenal,Premier League,22,2001,22.4,30,24,9,12,9,13,32,40.6,19,23,1,22,5,35,9,1,Matches
1639,Tommaso Martinelli,ITA,GK,Fiorentina,Serie A,17,2006,1.0,,0,,,,,,,,,,,0,,,,Matches
1640,Arnau Martinez,ESP,DF,Girona,La Liga,20,2003,13.8,25,16,17,6,2,15,32,46.9,17,15,5,10,10,35,41,3,Matches
1641,Emiliano Martínez,ARG,GK,Aston Villa,Premier League,30,1992,33.5,0,0,0,0,0,0,0,,0,0,0,0,0,0,12,3,Matches
1642,Iñigo Martínez,ESP,DF,Barcelona,La Liga,32,1991,14.4,10,7,9,1,0,6,8,75.0,2,13,10,3,11,21,50,0,Matches
1643,Josep Martinez,ESP,GK,Genoa,Serie A,25,1998,36.0,0,0,0,0,0,0,0,,0,0,0,0,1,1,21,3,Matches
1644,Lautaro Martínez,ARG,FW,Inter,Serie A,25,1997,29.5,22,16,4,13,5,4,19,21.1,15,30,1,29,20,42,10,0,Matches
1645,Lisandro Martínez,ARG,DF,Manchester Utd,Premier League,25,1998,7.2,12,8,8,4,0,5,12,41.7,7,10,8,2,5,17,26,0,Matches
1646,Marc Martínez,ESP,GK,Granada,La Liga,33,1990,3.0,0,0,0,0,0,0,1,0.0,1,0,0,0,0,0,1,0,Matches
1647,Lucas Martínez Quarta,ARG,DF,Fiorentina,Serie A,27,1996,25.5,75,47,43,28,4,36,54,66.7,18,38,14,24,30,105,69,4,Matches
1648,Adam Marušić,MNE,DF,Lazio,Serie A,30,1992,34.4,45,31,24,19,2,27,49,55.1,22,27,7,20,29,74,63,2,Matches
1649,Marvin,ESP,"FW,DF",Las Palmas,La Liga,23,2000,20.6,39,25,18,17,4,18,36,50.0,18,28,2,26,14,53,18,1,Matches
1650,Omar Mascarell,EQG,MF,Mallorca,La Liga,30,1993,17.5,33,16,16,17,0,18,35,51.4,17,24,8,16,31,64,30,1,Matches
1651,Adam Masina,MAR,DF,Udinese,Serie A,29,1994,0.7,4,0,2,2,0,2,4,50.0,2,2,1,1,2,6,5,0,Matches
1652,Adam Masina,MAR,DF,Torino,Serie A,29,1994,11.4,17,12,8,8,1,5,20,25.0,15,12,6,6,11,28,30,0,Matches
1653,Erhan Mašović,SRB,"DF,MF",Bochum,Bundesliga,24,1998,24.7,64,40,37,22,5,37,70,52.9,33,32,10,22,25,89,75,2,Matches
1654,Han-Noah Massengo,FRA,"MF,DF",Burnley,Premier League,22,2001,0.2,1,1,1,0,0,0,0,,0,1,0,1,0,1,0,0,Matches
1655,Roberto Massimo,GER,"FW,DF",Stuttgart,Bundesliga,22,2000,0.9,1,0,1,0,0,1,2,50.0,1,0,0,0,0,1,1,0,Matches
1656,Clinton Mata,ANG,DF,Lyon,Ligue 1,30,1992,24.7,43,24,29,8,6,23,40,57.5,17,35,16,19,40,83,61,0,Matches
1657,Jaime Mata,ESP,"FW,MF",Getafe,La Liga,34,1988,19.9,24,15,12,8,4,11,26,42.3,15,18,1,17,17,41,31,0,Matches
1658,Pape Matar Sarr,SEN,MF,Tottenham,Premier League,20,2002,23.0,34,24,11,17,6,15,36,41.7,21,21,5,16,31,65,28,1,Matches
1659,Eliot Matazo,BEL,MF,Monaco,Ligue 1,21,2002,1.1,3,1,0,3,0,2,4,50.0,2,1,1,0,3,6,0,0,Matches
1660,Jean-Philippe Mateta,FRA,FW,Crystal Palace,Premier League,26,1997,25.4,22,15,4,11,7,6,10,60.0,4,13,4,9,4,26,14,0,Matches
1661,Nemanja Matić,SRB,MF,Rennes,Ligue 1,34,1988,11.4,19,10,7,9,3,9,12,75.0,3,15,7,8,27,46,19,0,Matches
1662,Nemanja Matić,SRB,MF,Lyon,Ligue 1,34,1988,13.9,17,11,8,7,2,9,19,47.4,10,17,6,11,16,33,17,1,Matches
1663,Joël Matip,CMR,DF,Liverpool,Premier League,31,1991,8.7,12,6,7,4,1,8,12,66.7,4,16,12,4,9,21,43,0,Matches
1664,Alex Matos,ENG,MF,Chelsea,Premier League,18,2004,0.0,0,0,0,0,0,0,0,,0,0,0,0,0,0,0,0,Matches
1665,Chrislain Matsima,FRA,DF,Clermont Foot,Ligue 1,21,2002,13.1,18,11,11,7,0,10,18,55.6,8,14,10,4,13,31,74,1,Matches
1666,Chrislain Matsima,FRA,DF,Monaco,Ligue 1,21,2002,3.3,9,7,5,3,1,2,7,28.6,5,4,1,3,4,13,4,0,Matches
1667,Jean Mattéo Bahoya,FRA,"MF,FW",Eint Frankfurt,Bundesliga,18,2005,2.0,3,1,0,3,0,1,4,25.0,3,2,0,2,1,4,1,0,Matches
1668,Remi Matthews,ENG,GK,Crystal Palace,Premier League,29,1994,0.0,0,0,0,0,0,0,0,,0,0,0,0,0,0,1,0,Matches
1669,Alan Matturro,URU,DF,Genoa,Serie A,18,2004,1.2,1,1,1,0,0,1,1,100.0,0,6,3,3,2,3,4,0,Matches
1670,Azor Matusiwa,NED,MF,Reims,Ligue 1,25,1998,15.4,39,27,17,19,3,22,32,68.8,10,21,3,18,33,72,32,1,Matches
1671,Azor Matusiwa,NED,MF,Rennes,Ligue 1,25,1998,8.8,7,3,3,4,0,4,7,57.1,3,9,2,7,11,18,17,0,Matches
1672,Neal Maupay,FRA,FW,Brentford,Premier League,26,1996,14.7,10,7,4,5,1,3,13,23.1,10,11,0,11,2,12,3,0,Matches
1673,Neal Maupay,FRA,FW,Everton,Premier League,26,1996,1.2,0,0,0,0,0,0,1,0.0,1,2,0,2,0,0,1,0,Matches
1674,Aïman Maurer,MAR,"MF,FW",Clermont Foot,Ligue 1,18,2004,0.6,1,1,1,0,0,1,3,33.3,2,0,0,0,0,1,0,0,Matches
1675,Konstantinos Mavropanos,GRE,DF,West Ham,Premier League,25,1997,16.7,28,16,17,9,2,17,21,81.0,4,21,13,8,23,51,79,3,Matches
1676,Christian Mawissa,FRA,DF,Toulouse,Ligue 1,18,2005,12.4,22,15,14,4,4,9,23,39.1,14,22,11,11,22,44,41,1,Matches
1677,Philipp Max,GER,DF,Eint Frankfurt,Bundesliga,29,1993,15.0,26,17,6,18,2,19,26,73.1,7,18,1,17,7,33,18,2,Matches
1678,Eric Maxim Choupo-Moting,CMR,"MF,FW",Bayern Munich,Bundesliga,34,1989,8.0,17,12,8,5,4,6,14,42.9,8,5,0,5,7,24,7,0,Matches
1679,Luís Maximiano,POR,GK,Almería,La Liga,24,1999,33.0,0,0,0,0,0,0,1,0.0,1,0,0,0,0,0,19,2,Matches
1680,Noam Mayoka-Tika,BEL,MF,Marseille,Ligue 1,19,2003,0.0,0,0,0,0,0,0,0,,0,0,0,0,0,0,0,0,Matches
1681,Borja Mayoral,ESP,FW,Getafe,La Liga,26,1997,23.9,9,5,2,2,5,5,22,22.7,17,7,0,7,4,13,16,0,Matches
1682,Senny Mayulu,FRA,"FW,MF",Paris S-G,Ligue 1,17,2006,3.6,13,8,6,6,1,6,7,85.7,1,1,0,1,3,16,0,0,Matches
1683,Youssef Maziz,FRA,"FW,MF",Metz,Ligue 1,25,1998,1.4,0,0,0,0,0,0,2,0.0,2,1,0,1,1,1,2,0,Matches
1684,Noussair Mazraoui,MAR,DF,Bayern Munich,Bundesliga,25,1997,13.3,32,21,14,11,7,13,21,61.9,8,14,1,13,20,52,27,1,Matches
1685,Luca Mazzitelli,ITA,MF,Frosinone,Serie A,27,1995,24.6,45,23,15,24,6,26,49,53.1,23,23,7,16,19,64,62,0,Matches
1686,Pasquale Mazzocchi,ITA,DF,Salernitana,Serie A,28,1995,14.1,25,19,14,10,1,16,29,55.2,13,14,6,8,5,30,31,0,Matches
1687,Pasquale Mazzocchi,ITA,DF,Napoli,Serie A,28,1995,4.8,5,2,1,2,2,2,3,66.7,1,5,1,4,1,6,13,0,Matches
1688,Kevin Mbabu,SUI,DF,Augsburg,Bundesliga,28,1995,22.7,51,39,25,18,8,23,40,57.5,17,29,9,20,24,75,48,0,Matches
1689,Noah Mbamba,BEL,MF,Leverkusen,Bundesliga,18,2005,0.2,0,0,0,0,0,0,0,,0,0,0,0,1,1,0,0,Matches
1690,Ethan Mbappé,FRA,"MF,DF",Paris S-G,Ligue 1,16,2006,0.5,0,0,0,0,0,0,2,0.0,2,1,0,1,0,0,0,0,Matches
1691,Kylian Mbappé,FRA,FW,Paris S-G,Ligue 1,24,1998,24.0,4,1,1,1,2,4,9,44.4,5,4,0,4,2,6,2,0,Matches
1692,Malick Mbaye,SEN,"MF,FW",Metz,Ligue 1,19,2004,1.7,5,1,0,1,4,1,2,50.0,1,1,0,1,1,6,2,0,Matches
1693,Mamadou Mbaye,SEN,DF,Cádiz,La Liga,25,1998,3.2,6,3,3,3,0,2,5,40.0,3,10,7,3,5,11,26,0,Matches
1694,Chancel Mbemba,COD,DF,Marseille,Ligue 1,28,1994,24.5,33,21,25,7,1,17,30,56.7,13,21,13,8,13,46,95,1,Matches
1695,Nolan Mbemba,CGO,MF,Le Havre,Ligue 1,28,1995,0.2,2,1,0,1,1,1,2,50.0,1,0,0,0,0,2,0,0,Matches
1696,Bryan Mbeumo,CMR,FW,Brentford,Premier League,23,1999,21.8,15,10,6,6,3,5,19,26.3,14,26,2,24,7,22,13,0,Matches
1697,Christ Mbondi,FRA,FW,Reims,Ligue 1,18,2004,0.0,1,1,1,0,0,1,1,100.0,0,0,0,0,0,1,0,0,Matches
1698,Jordi Mboula,ESP,"FW,MF",Hellas Verona,Serie A,24,1999,3.4,4,4,1,2,1,4,7,57.1,3,4,1,3,1,5,0,0,Matches
1699,Nathanael Mbuku,FRA,FW,Augsburg,Bundesliga,21,2002,0.1,0,0,0,0,0,0,0,,0,1,0,1,0,0,0,0,Matches
1700,James Mcatee,ENG,"MF,FW",Sheffield Utd,Premier League,20,2002,20.2,32,21,9,13,10,13,33,39.4,20,20,0,20,11,43,18,0,Matches
1701,James Mcatee,ENG,MF,Manchester City,Premier League,20,2002,0.0,0,0,0,0,0,0,0,,0,1,0,1,0,0,0,0,Matches
1702,Oliver McBurnie,SCO,FW,Sheffield Utd,Premier League,27,1996,14.2,17,7,4,7,6,5,12,41.7,7,18,2,16,5,22,28,0,Matches
1703,James McConnell,ENG,MF,Liverpool,Premier League,18,2004,0.0,0,0,0,0,0,0,0,,0,1,0,1,1,1,0,0,Matches
1704,John McGinn,SCO,"MF,FW",Aston Villa,Premier League,28,1994,33.3,59,35,18,34,7,32,77,41.6,45,33,4,29,21,80,21,0,Matches
1705,Scott McKenna,SCO,DF,Nott'ham Forest,Premier League,26,1996,4.6,4,0,3,1,0,2,3,66.7,1,6,4,2,5,9,27,0,Matches
1706,Weston McKennie,USA,"MF,DF",Juventus,Serie A,24,1998,28.8,48,29,31,11,6,17,27,63.0,10,28,7,21,18,66,69,0,Matches
1707,Dwight McNeil,ENG,"MF,FW",Everton,Premier League,23,1999,32.1,44,27,16,14,14,24,55,43.6,31,44,7,37,22,66,37,0,Matches
1708,Scott McTominay,SCO,"MF,FW",Manchester Utd,Premier League,26,1996,21.1,49,25,23,24,2,22,33,66.7,11,34,12,22,14,63,54,0,Matches
1709,Facundo Medina,ARG,DF,Lens,Ligue 1,24,1999,30.2,64,38,25,31,8,44,69,63.8,25,38,13,25,24,88,59,2,Matches
1710,Ben Mee,ENG,DF,Brentford,Premier League,33,1989,14.1,26,15,12,12,2,17,22,77.3,5,21,13,8,13,39,63,1,Matches
1711,Marvin Mehlem,GER,MF,Darmstadt 98,Bundesliga,25,1997,16.5,28,21,10,14,4,11,27,40.7,16,21,2,19,33,61,15,0,Matches
1712,Bamo Meïté,CIV,DF,Marseille,Ligue 1,21,2001,7.1,16,10,13,3,0,8,12,66.7,4,11,5,6,11,27,35,0,Matches
1713,Bamo Meïté,CIV,DF,Lorient,Ligue 1,21,2001,1.6,2,1,2,0,0,0,1,0.0,1,3,2,1,3,5,9,0,Matches
1714,Hannibal Mejbri,TUN,"MF,FW",Manchester Utd,Premier League,20,2003,1.5,3,3,1,2,0,1,3,33.3,2,1,1,0,0,3,0,0,Matches
1715,Hannibal Mejbri,TUN,MF,Sevilla,La Liga,20,2003,1.2,3,3,1,2,0,0,1,0.0,1,1,0,1,0,3,0,0,Matches
1716,Óscar Melendo,ESP,"MF,FW",Granada,La Liga,25,1997,12.5,14,6,4,10,0,4,12,33.3,8,13,0,13,5,19,4,1,Matches
1717,Gonzalo Melero,ESP,"MF,FW",Almería,La Liga,29,1994,12.3,14,8,7,5,2,7,19,36.8,12,12,4,8,4,18,11,0,Matches
1718,Birger Meling,NOR,DF,Rennes,Ligue 1,28,1994,0.2,1,1,1,0,0,1,1,100.0,0,1,0,1,0,1,0,0,Matches
1719,Arthur Melo,BRA,MF,Fiorentina,Serie A,26,1996,22.1,45,30,17,24,4,26,42,61.9,16,27,3,24,18,63,8,0,Matches
1720,Memphis,NED,FW,Atlético Madrid,La Liga,29,1994,9.9,5,2,0,3,2,3,6,50.0,3,2,0,2,1,6,0,0,Matches
1721,Houboulang Mendes,GNB,DF,Almería,La Liga,25,1998,4.4,16,13,11,5,0,8,16,50.0,8,4,2,2,1,17,17,1,Matches
1722,Nuno Mendes,POR,DF,Paris S-G,Ligue 1,21,2002,3.0,5,5,4,1,0,4,7,57.1,3,4,0,4,4,9,2,0,Matches
1723,Tomás Mendes,ESP,MF,Alavés,La Liga,18,2004,0.1,0,0,0,0,0,0,0,,0,0,0,0,0,0,0,0,Matches
1724,Brais Méndez,ESP,"MF,FW",Real Sociedad,La Liga,26,1997,26.8,42,28,13,20,9,15,43,34.9,28,23,4,19,12,54,21,0,Matches
1725,Bruno Méndez,URU,DF,Granada,La Liga,23,1999,14.8,36,17,19,12,5,21,37,56.8,16,24,6,18,26,62,45,0,Matches
1726,Diego Méndez,ESP,MF,Rayo Vallecano,La Liga,19,2003,0.1,1,1,1,0,0,1,1,100.0,0,0,0,0,1,2,0,0,Matches
1727,Leonardo Mendicino,ITA,MF,Atalanta,Serie A,17,2006,0.0,0,0,0,0,0,0,0,,0,0,0,0,0,0,0,0,Matches
1728,Antoine Mendy,FRA,DF,Nice,Ligue 1,19,2004,4.6,7,5,4,3,0,3,7,42.9,4,4,1,3,8,15,16,0,Matches
1729,Benjamin Mendy,FRA,DF,Lorient,Ligue 1,29,1994,7.9,3,1,2,1,0,1,5,20.0,4,8,2,6,7,10,20,0,Matches
1730,Ferland Mendy,FRA,DF,Real Madrid,La Liga,28,1995,19.1,15,10,12,2,1,11,14,78.6,3,12,2,10,13,28,26,1,Matches
1731,Formose Mendy,SEN,DF,Lorient,Ligue 1,22,2001,14.0,33,19,24,8,1,20,33,60.6,13,23,12,11,20,53,59,1,Matches
1732,Nampalys Mendy,SEN,MF,Lens,Ligue 1,31,1992,11.7,29,18,10,13,6,16,20,80.0,4,11,4,7,14,43,14,1,Matches
1733,Teden Mengi,ENG,DF,Luton Town,Premier League,21,2002,27.4,54,22,33,20,1,19,30,63.3,11,39,27,12,57,111,140,1,Matches
1734,Chris Mepham,WAL,DF,Bournemouth,Premier League,25,1997,6.9,12,11,9,3,0,9,14,64.3,5,13,6,7,7,19,30,1,Matches
1735,Jorge Meré,ESP,DF,Cádiz,La Liga,26,1997,7.5,8,7,6,2,0,4,7,57.1,3,5,3,2,8,16,33,0,Matches
1736,Alex Meret,ITA,GK,Napoli,Serie A,26,1997,30.8,1,0,1,0,0,1,2,50.0,1,0,0,0,0,1,10,1,Matches
1737,Mikel Merino,ESP,MF,Real Sociedad,La Liga,27,1996,27.6,77,43,25,34,18,22,48,45.8,26,36,11,25,16,93,55,3,Matches
1738,Quentin Merlin,FRA,DF,Marseille,Ligue 1,21,2002,7.8,13,12,7,5,1,8,20,40.0,12,4,0,4,6,19,14,0,Matches
1739,Quentin Merlin,FRA,DF,Nantes,Ligue 1,21,2002,14.3,29,20,15,12,2,16,25,64.0,9,22,1,21,18,47,22,0,Matches
1740,Junior Messias,BRA,"MF,DF",Genoa,Serie A,32,1991,11.7,26,20,19,5,2,8,19,42.1,11,9,1,8,5,31,22,0,Matches
1741,Thomas Meunier,BEL,DF,Dortmund,Bundesliga,31,1991,6.5,5,1,3,2,0,3,13,23.1,10,8,2,6,4,9,22,0,Matches
1742,Bastien Meupiyou,FRA,DF,Nantes,Ligue 1,17,2006,0.1,0,0,0,0,0,0,0,,0,0,0,0,0,0,1,0,Matches
1743,Alexander Meyer,GER,GK,Dortmund,Bundesliga,32,1991,7.7,1,1,1,0,0,1,1,100.0,0,0,0,0,0,1,2,1,Matches
1744,Omenuke Mfulu,COD,"MF,FW",Las Palmas,La Liga,29,1994,0.9,4,3,3,1,0,0,1,0.0,1,1,1,0,2,6,5,0,Matches
1745,Lucas Michal,FRA,FW,Monaco,Ligue 1,18,2005,0.1,0,0,0,0,0,0,0,,0,0,0,0,0,0,0,0,Matches
1746,Sven Michel,GER,"FW,MF",Augsburg,Bundesliga,33,1990,6.5,7,5,2,1,4,2,7,28.6,5,1,0,1,0,7,4,0,Matches
1747,Miguel,ESP,"FW,MF",Alavés,La Liga,23,1999,0.7,0,0,0,0,0,0,0,,0,2,0,2,0,0,0,0,Matches
1748,Georges Mikautadze,GEO,FW,Metz,Ligue 1,22,2000,19.4,4,3,1,2,1,0,9,0.0,9,11,0,11,8,12,3,0,Matches
1749,Nikola Milenković,SRB,DF,Fiorentina,Serie A,25,1997,27.9,41,21,24,14,3,22,36,61.1,14,22,14,8,27,68,95,1,Matches
1750,Lewis Miley,ENG,MF,Newcastle Utd,Premier League,17,2006,13.4,33,21,6,20,7,15,32,46.9,17,20,3,17,8,41,18,2,Matches
1751,Arkadiusz Milik,POL,FW,Juventus,Serie A,29,1994,10.2,9,5,2,5,2,3,5,60.0,2,7,1,6,5,14,3,0,Matches
1752,Vanja Milinković-Savić,SRB,GK,Torino,Serie A,26,1997,36.0,1,0,1,0,0,1,1,100.0,0,0,0,0,1,2,14,4,Matches
1753,Éder Militão,BRA,DF,Real Madrid,La Liga,25,1998,5.5,7,3,4,3,0,6,9,66.7,3,4,3,1,4,11,19,1,Matches
1754,Luis Milla,ESP,MF,Getafe,La Liga,28,1994,23.5,57,33,19,28,10,28,47,59.6,19,20,1,19,32,89,10,0,Matches
1755,Enzo Millot,FRA,"MF,FW",Stuttgart,Bundesliga,21,2002,24.9,40,22,9,21,10,18,39,46.2,21,24,2,22,16,56,7,1,Matches
1756,James Milner,ENG,"DF,MF",Brighton,Premier League,37,1986,8.6,20,14,9,10,1,9,14,64.3,5,9,0,9,8,28,16,0,Matches
1757,Jovan Milošević,SRB,"FW,MF",Stuttgart,Bundesliga,18,2005,0.3,0,0,0,0,0,0,0,,0,0,0,0,0,0,0,0,Matches
1758,Marko Milovanović,SRB,"FW,MF",Almería,La Liga,19,2003,3.4,4,4,1,3,0,2,4,50.0,2,2,0,2,0,4,5,0,Matches
1759,Kim Min-jae,KOR,DF,Bayern Munich,Bundesliga,26,1996,21.9,37,24,21,11,5,12,24,50.0,12,29,19,10,45,82,70,2,Matches
1760,Yerry Mina,COL,"DF,MF",Fiorentina,Serie A,28,1994,0.5,1,1,1,0,0,1,2,50.0,1,0,0,0,0,1,2,0,Matches
1761,Yerry Mina,COL,DF,Cagliari,Serie A,28,1994,13.5,20,13,14,6,0,13,19,68.4,6,23,14,9,4,24,77,0,Matches
1762,Takumi Minamino,JPN,MF,Monaco,Ligue 1,28,1995,23.5,34,17,10,13,11,16,54,29.6,38,29,1,28,11,45,8,0,Matches
1763,Lucas Mincarelli,FRA,"DF,MF",Montpellier,Ligue 1,19,2004,10.9,29,16,19,6,4,17,34,50.0,17,17,4,13,8,37,27,0,Matches
1764,Tyrone Mings,ENG,DF,Aston Villa,Premier League,30,1993,0.3,0,0,0,0,0,0,0,,0,0,0,0,1,1,1,0,Matches
1765,Óscar Mingueza,ESP,"DF,MF",Celta Vigo,La Liga,24,1999,33.3,62,38,44,11,7,37,80,46.3,43,38,7,31,17,79,49,2,Matches
1766,Ignasi Miquel,ESP,DF,Granada,La Liga,30,1992,33.2,47,30,39,6,2,23,40,57.5,17,32,16,16,45,92,132,4,Matches
1767,Rafa Mir,ESP,"FW,MF",Sevilla,La Liga,26,1997,4.3,2,2,1,1,0,1,2,50.0,1,2,0,2,1,3,1,0,Matches
1768,Ignacio Miramon,ARG,MF,Lille,Ligue 1,20,2003,0.4,1,0,0,1,0,0,1,0.0,1,1,0,1,0,1,0,0,Matches
1769,Aleksei Miranchuk,RUS,"MF,FW",Atalanta,Serie A,27,1995,13.1,12,6,6,4,2,5,13,38.5,8,6,1,5,2,14,5,1,Matches
1770,Juan Miranda,ESP,DF,Betis,La Liga,23,2000,20.6,38,24,21,13,4,17,31,54.8,14,31,6,25,19,57,62,0,Matches
1771,Kevin Miranda,ITA,DF,Sassuolo,Serie A,20,2003,0.2,0,0,0,0,0,0,0,,0,0,0,0,0,0,1,0,Matches
1772,Antonio Mirante,ITA,GK,Milan,Serie A,40,1983,2.0,0,0,0,0,0,0,0,,0,0,0,0,0,0,1,0,Matches
1773,Fabio Miretti,ITA,MF,Juventus,Serie A,19,2003,12.3,18,14,6,8,4,10,26,38.5,16,10,1,9,7,25,6,0,Matches
1774,Filippo Missori,ITA,DF,Sassuolo,Serie A,19,2004,3.0,6,3,2,4,0,4,11,36.4,7,3,2,1,4,10,8,0,Matches
1775,Tyrick Mitchell,ENG,"DF,MF",Crystal Palace,Premier League,23,1999,35.6,105,60,75,21,9,43,60,71.7,17,63,10,53,26,131,104,0,Matches
1776,Kaoru Mitoma,JPN,FW,Brighton,Premier League,26,1997,16.5,13,6,3,7,3,5,19,26.3,14,15,1,14,5,18,12,0,Matches
1777,Aleksandar Mitrović,SRB,FW,Fulham,Premier League,28,1994,0.4,0,0,0,0,0,0,0,,0,0,0,0,0,0,0,0,Matches
1778,Stefan Mitrović,SRB,"FW,MF",Hellas Verona,Serie A,20,2002,4.3,6,3,0,5,1,2,5,40.0,3,6,1,5,0,6,4,0,Matches
1779,Stefan Mitrović,SRB,DF,Getafe,La Liga,33,1990,7.8,9,3,7,2,0,4,8,50.0,4,3,2,1,6,15,26,0,Matches
1780,Maximilian Mittelstädt,GER,DF,Stuttgart,Bundesliga,26,1997,23.4,91,51,46,39,6,53,89,59.6,36,36,6,30,46,137,65,0,Matches
1781,Henrikh Mkhitaryan,ARM,MF,Inter,Serie A,34,1989,30.9,62,34,18,35,9,24,49,49.0,25,23,4,19,29,91,43,0,Matches
1782,Marko Mladenović,SRB,MF,Eint Frankfurt,Bundesliga,18,2005,0.1,0,0,0,0,0,0,0,,0,0,0,0,0,0,0,0,Matches
1783,Jakub Moder,POL,"MF,DF",Brighton,Premier League,24,1999,6.9,19,10,9,5,5,9,18,50.0,9,8,2,6,2,21,12,0,Matches
1784,Luka Modrić,CRO,MF,Real Madrid,La Liga,37,1985,18.8,22,15,10,6,6,9,25,36.0,16,13,4,9,21,43,9,0,Matches
1785,Max Moerstedt,GER,"DF,FW",Hoffenheim,Bundesliga,,,0.1,0,0,0,0,0,0,1,0.0,1,0,0,0,0,0,0,0,Matches
1786,Terem Moffi,NGA,FW,Nice,Ligue 1,24,1999,21.7,7,4,0,5,2,3,12,25.0,9,14,1,13,3,10,15,0,Matches
1787,Mostafa Mohamed,EGY,FW,Nantes,Ligue 1,25,1997,22.2,21,14,7,11,3,6,28,21.4,22,21,5,16,12,33,29,0,Matches
1788,Dion Moise Sahi,CIV,"MF,FW",Strasbourg,Ligue 1,21,2001,7.0,5,5,1,2,2,0,3,0.0,3,11,1,10,1,6,7,0,Matches
1789,Johan Mojica,COL,DF,Osasuna,La Liga,30,1992,22.7,30,22,11,15,4,16,25,64.0,9,15,2,13,21,51,40,2,Matches
1790,Alberto Moleiro,ESP,"FW,MF",Las Palmas,La Liga,19,2003,20.0,15,6,4,7,4,6,30,20.0,24,11,0,11,7,22,10,0,Matches
1791,Nahuel Molina,ARG,DF,Atlético Madrid,La Liga,25,1998,20.6,38,22,16,18,4,26,54,48.1,28,19,3,16,9,47,36,1,Matches
1792,Florent Mollet,FRA,"MF,FW",Nantes,Ligue 1,31,1991,23.1,18,11,8,6,4,10,31,32.3,21,18,5,13,13,31,17,0,Matches
1793,Jon Moncayola,ESP,MF,Osasuna,La Liga,25,1998,20.0,27,18,14,10,3,17,42,40.5,25,31,5,26,15,42,21,0,Matches
1794,Enzo Mongo,FRA,DF,Nantes,Ligue 1,18,2005,0.1,1,1,1,0,0,1,2,50.0,1,1,1,0,1,2,0,0,Matches
1795,Ilario Monterisi,ITA,DF,Frosinone,Serie A,21,2001,16.3,23,13,14,7,2,12,26,46.2,14,22,18,4,8,31,63,0,Matches
1796,César Montes,MEX,DF,Almería,La Liga,26,1997,19.9,22,13,13,9,0,9,18,50.0,9,21,9,12,11,33,94,0,Matches
1797,Gonzalo Montiel,ARG,DF,Nott'ham Forest,Premier League,26,1997,8.9,22,19,12,8,2,16,29,55.2,13,8,3,5,9,31,31,1,Matches
1798,Lorenzo Montipò,ITA,GK,Hellas Verona,Serie A,27,1996,37.0,1,1,1,0,0,1,3,33.3,2,0,0,0,0,1,25,2,Matches
1799,Kieffer Moore,WAL,"FW,MF",Bournemouth,Premier League,30,1992,1.2,0,0,0,0,0,0,0,,0,0,0,0,0,0,0,0,Matches
1800,Mikey Moore,ENG,MF,Tottenham,Premier League,15,2007,0.0,0,0,0,0,0,0,0,,0,0,0,0,0,0,1,0,Matches
1801,Álvaro Morata,ESP,FW,Atlético Madrid,La Liga,30,1992,21.2,16,10,4,7,5,3,5,60.0,2,18,3,15,1,17,26,0,Matches
1802,Diego Moreira,POR,"FW,MF",Lyon,Ligue 1,18,2004,3.0,0,0,0,0,0,0,3,0.0,3,3,0,3,2,2,5,0,Matches
1803,Alberto Moreno,ESP,DF,Villarreal,La Liga,31,1992,16.5,31,21,19,10,2,10,30,33.3,20,12,2,10,24,55,33,0,Matches
1804,Álex Moreno,ESP,DF,Aston Villa,Premier League,30,1993,11.5,18,12,18,0,0,12,19,63.2,7,11,2,9,13,31,37,0,Matches
1805,Gerard Moreno,ESP,FW,Villarreal,La Liga,31,1992,24.6,25,12,10,7,8,11,25,44.0,14,24,7,17,9,34,24,0,Matches
1806,Jorge Moreno,ESP,DF,Osasuna,La Liga,22,2001,0.2,0,0,0,0,0,0,0,,0,1,0,1,0,0,3,0,Matches
1807,Mateu Morey,ESP,DF,Dortmund,Bundesliga,23,2000,1.2,2,2,1,1,0,2,4,50.0,2,3,1,2,1,3,3,0,Matches
1808,Ilaix Moriba,GUI,"MF,FW",Getafe,La Liga,20,2003,6.7,20,11,3,11,6,4,9,44.4,5,3,1,2,4,24,10,0,Matches
1809,Manu Morlanes,ESP,MF,Mallorca,La Liga,24,1999,17.9,50,29,23,26,1,23,53,43.4,30,13,1,12,20,70,21,0,Matches
1810,Nikola Moro,CRO,MF,Bologna,Serie A,25,1998,9.3,21,16,8,12,1,8,15,53.3,7,14,1,13,7,28,10,0,Matches
1811,Carlton Morris,ENG,"FW,MF",Luton Town,Premier League,27,1995,31.8,15,8,4,6,5,9,15,60.0,6,24,5,19,1,16,53,0,Matches
1812,Cristhian Mosquera,ESP,DF,Valencia,La Liga,19,2004,34.2,57,34,36,18,3,25,39,64.1,14,42,23,19,36,93,137,2,Matches
1813,Yerson Mosquera,COL,DF,Villarreal,La Liga,22,2001,13.7,27,13,18,7,2,12,15,80.0,3,12,2,10,17,44,65,0,Matches
1814,Dany Mota,POR,"FW,MF",Monza,Serie A,25,1998,22.8,13,7,2,5,6,8,17,47.1,9,4,1,3,2,15,18,0,Matches
1815,Lebo Mothiba,RSA,FW,Strasbourg,Ligue 1,27,1996,6.9,5,2,1,4,0,3,4,75.0,1,6,1,5,0,5,11,0,Matches
1816,Youssoufa Moukoko,GER,FW,Dortmund,Bundesliga,18,2004,6.9,4,1,2,2,0,3,7,42.9,4,4,1,3,2,6,4,0,Matches
1817,Steve Mounié,BEN,FW,Brest,Ligue 1,28,1994,19.7,8,7,0,3,5,3,11,27.3,8,13,3,10,2,10,18,0,Matches
1818,Mason Mount,ENG,"MF,FW",Manchester Utd,Premier League,24,1999,5.7,22,14,6,10,6,6,16,37.5,10,6,1,5,6,28,3,0,Matches
1819,Samuel Moutoussamy,COD,MF,Nantes,Ligue 1,26,1996,12.3,38,20,14,17,7,17,37,45.9,20,16,3,13,11,49,13,0,Matches
1820,Loris Mouyokolo,FRA,DF,Lorient,Ligue 1,22,2001,1.0,4,1,4,0,0,1,1,100.0,0,1,0,1,0,4,3,0,Matches
1821,Divin Mubama,ENG,FW,West Ham,Premier League,18,2004,0.9,0,0,0,0,0,0,0,,0,0,0,0,0,0,0,0,Matches
1822,Mykhailo Mudryk,UKR,FW,Chelsea,Premier League,22,2001,17.5,21,12,9,7,5,10,32,31.3,22,14,1,13,9,30,9,0,Matches
1823,François Mughe,CMR,"MF,DF",Marseille,Ligue 1,19,2004,2.0,0,0,0,0,0,0,3,0.0,3,2,0,2,1,1,1,0,Matches
1824,Nordi Mukiele,FRA,DF,Paris S-G,Ligue 1,25,1997,8.8,12,8,6,5,1,8,15,53.3,7,17,4,13,14,26,28,0,Matches
1825,Samuele Mulattieri,ITA,"FW,MF",Sassuolo,Serie A,22,2000,5.1,1,1,0,0,1,1,2,50.0,1,7,2,5,1,2,2,0,Matches
1826,Andreas Müller,GER,MF,Darmstadt 98,Bundesliga,23,2000,3.9,14,9,8,5,1,4,9,44.4,5,5,2,3,4,18,5,0,Matches
1827,Jannik Müller,GER,"DF,MF",Darmstadt 98,Bundesliga,29,1994,12.6,33,16,21,9,3,16,27,59.3,11,24,12,12,17,50,39,1,Matches
1828,Kevin Müller,GER,GK,Heidenheim,Bundesliga,32,1991,34.0,3,0,3,0,0,3,5,60.0,2,0,0,0,0,3,6,1,Matches
1829,Marcus Müller,GER,MF,Mainz 05,Bundesliga,20,2002,0.2,0,0,0,0,0,0,0,,0,0,0,0,0,0,0,0,Matches
1830,Thomas Müller,GER,"MF,FW",Bayern Munich,Bundesliga,33,1989,18.4,26,16,5,10,11,13,35,37.1,22,22,0,22,3,29,6,0,Matches
1831,Abdul Mumin,GHA,DF,Rayo Vallecano,La Liga,25,1998,18.8,19,10,13,4,2,8,10,80.0,2,27,19,8,22,41,82,1,Matches
1832,Marshall Munetsi,ZIM,MF,Reims,Ligue 1,27,1996,24.1,61,39,18,34,9,33,61,54.1,28,21,7,14,14,75,33,0,Matches
1833,Iker Muniain,ESP,"MF,FW",Athletic Club,La Liga,30,1992,6.6,5,1,2,3,0,1,3,33.3,2,4,1,3,0,5,0,0,Matches
1834,Rodrigo Muniz,BRA,FW,Fulham,Premier League,22,2001,17.7,7,3,1,5,1,1,6,16.7,5,9,3,6,6,13,20,0,Matches
1835,Aihen Muñoz,ESP,DF,Real Sociedad,La Liga,25,1997,12.5,36,21,20,10,6,24,35,68.6,11,16,8,8,9,45,33,0,Matches
1836,Álvaro Muñoz,URU,FW,Real Madrid,La Liga,19,2004,0.0,0,0,0,0,0,0,0,,0,0,0,0,0,0,1,0,Matches
1837,Daniel Muñoz,COL,"DF,MF",Crystal Palace,Premier League,27,1996,16.0,55,35,31,14,10,19,38,50.0,19,29,7,22,24,79,47,0,Matches
1838,Iker Muñoz,ESP,MF,Osasuna,La Liga,20,2002,20.6,32,18,13,17,2,15,31,48.4,16,16,5,11,11,43,50,0,Matches
1839,Javier Muñoz,ESP,MF,Las Palmas,La Liga,28,1995,29.3,42,23,14,22,6,16,44,36.4,28,40,4,36,20,62,29,1,Matches
1840,Finley Munroe,ENG,MF,Aston Villa,Premier League,18,2005,0.0,0,0,0,0,0,0,0,,0,0,0,0,0,0,0,0,Matches
1841,Arijanet Muric,KVX,GK,Burnley,Premier League,24,1998,10.0,1,1,1,0,0,1,1,100.0,0,0,0,0,0,1,10,4,Matches
1842,Luis Muriel,COL,"FW,MF",Atalanta,Serie A,32,1991,4.5,3,2,0,2,1,1,1,100.0,0,4,0,4,1,4,0,0,Matches
1843,Murillo,BRA,DF,Nott'ham Forest,Premier League,21,2002,31.0,50,31,36,13,1,19,33,57.6,14,41,24,17,37,87,188,0,Matches
1844,Vedat Muriqi,KVX,FW,Mallorca,La Liga,29,1994,25.9,11,6,4,3,4,2,14,14.3,12,11,4,7,6,17,26,0,Matches
1845,Alex Murphy,IRL,"DF,FW",Newcastle Utd,Premier League,19,2004,0.1,1,1,0,1,0,1,2,50.0,1,1,0,1,1,2,0,0,Matches
1846,Jacob Murphy,ENG,"FW,DF",Newcastle Utd,Premier League,28,1995,13.2,20,10,8,4,8,12,26,46.2,14,17,0,17,6,26,16,0,Matches
1847,Yunus Musah,USA,"MF,FW",Milan,Serie A,20,2002,16.4,25,14,15,6,4,8,15,53.3,7,18,4,14,10,35,16,1,Matches
1848,Jamal Musiala,GER,"MF,FW",Bayern Munich,Bundesliga,20,2003,19.5,40,25,9,21,10,14,36,38.9,22,25,1,24,16,56,5,0,Matches
1849,Florent Muslija,KVX,"MF,FW",Freiburg,Bundesliga,25,1998,1.2,5,4,3,2,0,2,5,40.0,3,1,0,1,0,5,2,0,Matches
1850,Juan Musso,ARG,GK,Atalanta,Serie A,29,1994,11.0,1,0,1,0,0,1,1,100.0,0,0,0,0,0,1,6,0,Matches
1851,Kingstone Mutandwa,ZAM,"FW,MF",Cagliari,Serie A,20,2003,0.4,1,0,1,0,0,1,4,25.0,3,1,0,1,0,1,2,0,Matches
1852,Yvon Mvogo,SUI,GK,Lorient,Ligue 1,29,1994,34.0,0,0,0,0,0,0,1,0.0,1,0,0,0,0,0,15,3,Matches
1853,Joel Mvuka,NOR,"DF,FW",Lorient,Ligue 1,20,2002,2.2,5,3,3,1,1,3,7,42.9,4,1,0,1,2,7,1,0,Matches
1854,Junior Mwanga,FRA,"MF,FW",Strasbourg,Ligue 1,20,2003,16.1,40,20,23,12,5,12,24,50.0,12,20,5,15,18,58,19,0,Matches
1855,Phillipp Mwene,AUT,DF,Mainz 05,Bundesliga,29,1994,22.2,34,15,15,16,3,16,33,48.5,17,27,3,24,17,51,47,0,Matches
1856,Vitaliy Mykolenko,UKR,DF,Everton,Premier League,24,1999,27.4,69,38,46,21,2,41,66,62.1,25,36,11,25,36,105,92,0,Matches
1857,Joakim Mæhle,DEN,"DF,MF",Wolfsburg,Bundesliga,26,1997,27.2,62,39,33,18,11,41,64,64.1,23,43,5,38,29,91,65,0,Matches
1858,Obite N'Dicka,CIV,DF,Roma,Serie A,23,1999,24.1,32,18,12,19,1,12,20,60.0,8,30,16,14,16,48,75,0,Matches
1859,Kévin N'Doram,FRA,MF,Metz,Ligue 1,27,1996,17.8,31,22,20,9,2,17,38,44.7,21,17,8,9,27,58,38,0,Matches
1860,Nathan N'Goumou,FRA,"FW,MF",Gladbach,Bundesliga,23,2000,15.4,37,22,17,18,2,16,34,47.1,18,22,0,22,5,42,17,1,Matches
1861,Stanley N'Soki,FRA,DF,Hoffenheim,Bundesliga,24,1999,7.0,21,10,12,8,1,17,29,58.6,12,13,2,11,8,29,33,0,Matches
1862,Nacho,ESP,DF,Real Madrid,La Liga,33,1990,19.4,18,10,9,7,2,6,13,46.2,7,23,13,10,18,36,56,0,Matches
1863,Bilal Nadir,FRA,"MF,FW",Marseille,Ligue 1,19,2003,1.3,4,3,2,2,0,1,2,50.0,1,0,0,0,2,6,2,0,Matches
1864,Mahamadou Nagida,CMR,DF,Rennes,Ligue 1,18,2005,1.2,1,1,0,0,1,0,2,0.0,2,2,1,1,4,5,0,0,Matches
1865,Marvelous Nakamba,ZIM,MF,Luton Town,Premier League,29,1994,12.6,40,24,24,14,2,24,42,57.1,18,23,6,17,11,51,11,1,Matches
1866,Keito Nakamura,JPN,"FW,MF",Reims,Ligue 1,23,2000,15.3,28,11,9,10,9,17,37,45.9,20,15,2,13,6,34,7,0,Matches
1867,Nahitan Nández,URU,"MF,DF",Cagliari,Serie A,27,1995,26.0,59,40,27,23,9,27,64,42.2,37,25,2,23,19,78,32,0,Matches
1868,Matija Nastasić,SRB,DF,Mallorca,La Liga,30,1993,25.1,35,17,26,9,0,24,32,75.0,8,33,20,13,29,64,114,0,Matches
1869,Natan,BRA,DF,Napoli,Serie A,22,2001,10.6,14,10,10,3,1,5,10,50.0,5,12,9,3,8,22,32,0,Matches
1870,Lapo Nava,ITA,GK,Milan,Serie A,19,2004,0.0,0,0,0,0,0,0,0,,0,0,0,0,0,0,0,0,Matches
1871,Roberto Navarro,ESP,"MF,FW",Cádiz,La Liga,21,2002,21.0,46,29,20,21,5,22,43,51.2,21,33,0,33,19,65,7,1,Matches
1872,Jesús Navas,ESP,DF,Sevilla,La Liga,37,1985,22.3,37,27,21,14,2,22,40,55.0,18,15,7,8,22,59,48,0,Matches
1873,Keylor Navas,CRC,GK,Paris S-G,Ligue 1,36,1986,4.0,0,0,0,0,0,0,0,,0,0,0,0,0,0,2,0,Matches
1874,Michel Ndary Adopo,FRA,MF,Atalanta,Serie A,23,2000,1.2,4,3,0,3,1,1,1,100.0,0,0,0,0,0,4,2,1,Matches
1875,Youssouf Ndayishimiye,BDI,"MF,DF",Nice,Ligue 1,24,1998,19.0,31,20,17,12,2,12,23,52.2,11,19,11,8,12,43,47,1,Matches
1876,Bassirou Ndiaye,SEN,FW,Lorient,Ligue 1,21,2002,1.7,5,2,2,2,1,3,5,60.0,2,1,1,0,1,6,0,0,Matches
1877,Iliman Ndiaye,SEN,"FW,MF",Marseille,Ligue 1,23,2000,18.0,21,18,5,11,5,11,29,37.9,18,14,2,12,6,27,6,0,Matches
1878,Massamba Ndiaye,SEN,GK,Clermont Foot,Ligue 1,21,2001,4.0,0,0,0,0,0,0,0,,0,0,0,0,0,0,2,0,Matches
1879,Rassoul Ndiaye,SEN,"MF,FW",Le Havre,Ligue 1,21,2001,5.8,25,17,8,16,1,12,24,50.0,12,2,1,1,4,29,5,0,Matches
1880,Michael Ndiweni,ENG,FW,Newcastle Utd,Premier League,19,2003,0.0,0,0,0,0,0,0,0,,0,0,0,0,0,0,0,0,Matches
1881,Cher Ndour,ITA,MF,Paris S-G,Ligue 1,19,2004,0.3,2,2,0,2,0,1,2,50.0,1,0,0,0,0,2,0,0,Matches
1882,Dan Ndoye,SUI,"FW,MF",Bologna,Serie A,22,2000,19.7,30,15,17,11,2,17,39,43.6,22,20,1,19,10,40,14,0,Matches
1883,Joseph Nduquidi,FRA,"MF,DF",Metz,Ligue 1,18,2004,8.3,11,4,6,3,2,1,9,11.1,8,11,3,8,11,22,15,1,Matches
1884,Loïc Nego,HUN,"DF,MF",Le Havre,Ligue 1,32,1991,17.3,37,26,21,12,4,18,30,60.0,12,12,2,10,16,53,17,0,Matches
1885,Álvaro Negredo,ESP,"FW,MF",Cádiz,La Liga,37,1985,0.6,0,0,0,0,0,0,0,,0,1,0,1,1,1,0,0,Matches
1886,Reiss Nelson,ENG,FW,Arsenal,Premier League,23,1999,3.0,9,6,5,1,3,8,10,80.0,2,5,1,4,1,10,5,0,Matches
1887,Zack Nelson,ENG,"MF,DF",Luton Town,Premier League,18,2004,0.1,1,0,1,0,0,0,0,,0,0,0,0,0,1,0,0,Matches
1888,Neto,BRA,GK,Bournemouth,Premier League,34,1989,32.0,0,0,0,0,0,0,0,,0,1,0,1,1,1,12,3,Matches
1889,Pedro Neto,POR,"FW,MF",Wolves,Premier League,23,2000,16.8,7,3,3,2,2,5,15,33.3,10,5,1,4,5,12,2,0,Matches
1890,Luca Netz,GER,DF,Gladbach,Bundesliga,20,2003,24.7,38,22,19,16,3,23,43,53.5,20,36,10,26,22,60,76,1,Matches
1891,Manuel Neuer,GER,GK,Bayern Munich,Bundesliga,37,1986,22.8,1,1,1,0,0,0,0,,0,0,0,0,0,1,14,3,Matches
1892,Florian Neuhaus,GER,MF,Gladbach,Bundesliga,26,1997,13.6,15,12,7,8,0,8,26,30.8,18,8,6,2,14,29,8,0,Matches
1893,Carlos Neva,ESP,DF,Granada,La Liga,27,1996,35.0,32,21,22,9,1,17,40,42.5,23,39,14,25,30,62,108,2,Matches
1894,Jessic Ngankam,GER,"FW,MF",Mainz 05,Bundesliga,23,2000,2.0,1,1,0,1,0,0,0,,0,3,1,2,3,4,0,0,Matches
1895,Jessic Ngankam,GER,FW,Eint Frankfurt,Bundesliga,23,2000,3.1,3,2,1,1,1,0,0,,0,0,0,0,0,3,1,0,Matches
1896,Cyril Ngonge,BEL,"FW,MF",Hellas Verona,Serie A,23,2000,15.9,14,9,5,3,6,5,14,35.7,9,7,1,6,4,18,10,0,Matches
1897,Cyril Ngonge,BEL,FW,Napoli,Serie A,23,2000,3.5,5,3,1,4,0,2,2,100.0,0,2,0,2,0,5,2,0,Matches
1898,Steve Ngoura,FRA,"FW,MF",Le Havre,Ligue 1,18,2005,2.5,2,1,1,1,0,1,4,25.0,3,0,0,0,0,2,3,0,Matches
1899,Moussa Niakhate,SEN,DF,Nott'ham Forest,Premier League,27,1996,16.2,42,25,33,9,0,20,25,80.0,5,19,12,7,14,56,51,0,Matches
1900,M'Baye Niang,SEN,FW,Empoli,Serie A,28,1994,7.9,3,1,0,1,2,0,6,0.0,6,7,1,6,3,6,10,0,Matches
1901,Tanguy Nianzou,FRA,DF,Sevilla,La Liga,21,2002,3.5,12,8,9,2,1,8,11,72.7,3,2,0,2,3,15,9,1,Matches
1902,Shamar Nicholson,JAM,FW,Clermont Foot,Ligue 1,26,1997,16.5,6,2,0,4,2,1,4,25.0,3,6,2,4,0,6,15,0,Matches
1903,Rasmus Nicolaisen,DEN,DF,Toulouse,Ligue 1,26,1997,32.5,50,30,39,11,0,26,44,59.1,18,44,33,11,42,92,158,1,Matches
1904,Moritz Nicolas,GER,GK,Gladbach,Bundesliga,25,1997,27.0,1,0,1,0,0,1,3,33.3,2,0,0,0,0,1,12,5,Matches
1905,Hans Nicolussi Caviglia,ITA,MF,Juventus,Serie A,23,2000,3.0,5,2,1,3,1,4,6,66.7,2,5,1,4,0,5,2,0,Matches
1906,Saúl Ñíguez,ESP,MF,Atlético Madrid,La Liga,28,1994,15.3,64,39,29,29,6,30,49,61.2,19,36,9,27,14,78,56,0,Matches
1907,Justin Njinmah,GER,FW,Werder Bremen,Bundesliga,22,2000,11.3,5,1,2,2,1,3,9,33.3,6,9,1,8,2,7,6,0,Matches
1908,Eddie Nketiah,ENG,FW,Arsenal,Premier League,24,1999,12.0,12,7,2,6,4,2,7,28.6,5,11,0,11,4,16,4,0,Matches
1909,Niels Nkounkou,FRA,"DF,MF",Eint Frankfurt,Bundesliga,22,2000,14.5,54,30,34,17,3,29,64,45.3,35,30,2,28,16,70,30,0,Matches
1910,Christopher Nkunku,FRA,"FW,MF",Chelsea,Premier League,25,1997,4.9,5,4,0,4,1,1,2,50.0,1,4,1,3,2,7,4,0,Matches
1911,Felix Nmecha,GER,MF,Dortmund,Bundesliga,22,2000,11.3,19,13,7,8,4,11,22,50.0,11,18,5,13,11,30,19,0,Matches
1912,Lukas Nmecha,GER,FW,Wolfsburg,Bundesliga,24,1998,0.5,1,1,0,0,1,0,0,,0,1,0,1,0,1,0,0,Matches
1913,Peru Nolaskoain,ESP,"DF,MF",Athletic Club,La Liga,24,1998,0.1,1,1,1,0,0,1,1,100.0,0,0,0,0,0,1,1,0,Matches
1914,Joseph Nonge,BEL,MF,Juventus,Serie A,18,2005,0.3,0,0,0,0,0,0,0,,0,0,0,0,0,0,1,0,Matches
1915,Jonathan Norbye,NOR,MF,RB Leipzig,Bundesliga,16,2007,0.0,0,0,0,0,0,0,0,,0,0,0,0,0,0,0,0,Matches
1916,Arnaud Nordin,FRA,"FW,MF",Montpellier,Ligue 1,25,1998,13.8,12,6,3,5,4,6,16,37.5,10,11,0,11,2,14,10,0,Matches
1917,Rhys Norrington-Davies,WAL,DF,Sheffield Utd,Premier League,24,1999,1.2,1,1,1,0,0,0,1,0.0,1,2,0,2,1,2,2,0,Matches
1918,Oliver Norwood,NIR,MF,Sheffield Utd,Premier League,32,1991,16.0,41,26,18,18,5,20,47,42.6,27,24,9,15,21,62,39,0,Matches
1919,Tijjani Noslin,NED,"FW,MF",Hellas Verona,Serie A,24,1999,14.9,18,8,5,7,6,6,16,37.5,10,17,2,15,2,20,14,0,Matches
1920,Randy Nteka,ANG,"FW,MF",Rayo Vallecano,La Liga,25,1997,6.4,11,4,1,6,4,4,10,40.0,6,6,1,5,2,13,11,1,Matches
1921,Ernest Nuamah,GHA,"FW,MF",Lyon,Ligue 1,19,2003,20.4,28,14,18,6,4,12,38,31.6,26,15,1,14,8,36,9,0,Matches
1922,Alexander Nübel,GER,GK,Stuttgart,Bundesliga,26,1996,30.0,2,2,2,0,0,2,4,50.0,2,0,0,0,0,2,13,4,Matches
1923,Kasim Nuhu,GHA,DF,Hoffenheim,Bundesliga,28,1995,0.1,0,0,0,0,0,0,0,,0,0,0,0,0,0,0,0,Matches
1924,Matheus Nunes,POR,MF,Wolves,Premier League,24,1998,2.0,3,1,3,0,0,2,6,33.3,4,0,0,0,6,9,1,0,Matches
1925,Matheus Nunes,POR,MF,Manchester City,Premier League,24,1998,7.3,10,4,1,7,2,5,16,31.3,11,7,1,6,1,11,8,1,Matches
1926,Darwin Núñez,URU,FW,Liverpool,Premier League,24,1999,22.7,22,12,2,10,10,11,23,47.8,12,18,6,12,3,25,9,0,Matches
1927,Unai Núñez,ESP,DF,Celta Vigo,La Liga,26,1997,31.1,51,28,30,19,2,23,49,46.9,26,38,24,14,52,103,153,3,Matches
1928,Fabian Nürnberger,GER,"DF,MF",Darmstadt 98,Bundesliga,24,1999,16.8,29,22,22,6,1,22,41,53.7,19,11,1,10,17,46,26,0,Matches
1929,Ethan Nwaneri,ENG,FW,Arsenal,Premier League,16,2007,0.2,0,0,0,0,0,0,0,,0,1,0,1,0,0,0,0,Matches
1930,Simeon Nwankwo,NGA,FW,Salernitana,Serie A,31,1992,7.6,6,3,0,2,4,1,3,33.3,2,7,0,7,0,6,4,0,Matches
1931,Gerzino Nyamsi,FRA,DF,Strasbourg,Ligue 1,26,1997,12.1,18,14,13,5,0,12,18,66.7,6,19,11,8,10,28,43,0,Matches
1932,Ørjan Nyland,NOR,GK,Sevilla,La Liga,32,1990,24.0,0,0,0,0,0,0,1,0.0,1,0,0,0,0,0,9,1,Matches
1933,Rabby Nzingoula,CGO,"MF,FW",Strasbourg,Ligue 1,17,2005,1.5,3,3,0,3,0,3,4,75.0,1,4,0,4,5,8,0,0,Matches
1934,M'Bala Nzola,ANG,FW,Fiorentina,Serie A,26,1996,17.2,11,8,1,4,6,6,7,85.7,1,10,1,9,0,11,22,0,Matches
1935,Christian Nørgaard,DEN,MF,Brentford,Premier League,29,1994,27.8,81,50,42,31,8,32,87,36.8,55,48,6,42,54,135,50,0,Matches
1936,Jake O'Brien,IRL,DF,Lyon,Ligue 1,22,2001,26.3,22,16,16,5,1,14,20,70.0,6,23,18,5,12,34,98,1,Matches
1937,Mark O'Mahony,IRL,FW,Brighton,Premier League,18,2005,0.7,1,0,1,0,0,1,2,50.0,1,2,1,1,0,1,1,0,Matches
1938,Dara O'Shea,IRL,DF,Burnley,Premier League,24,1999,32.1,39,20,22,14,3,11,26,42.3,15,41,30,11,35,74,158,2,Matches
1939,Michael Obafemi,IRL,"FW,MF",Burnley,Premier League,23,2000,0.2,0,0,0,0,0,0,0,,0,1,0,1,0,0,0,0,Matches
1940,Adam Obert,SVK,DF,Cagliari,Serie A,20,2002,10.5,17,9,8,8,1,8,17,47.1,9,13,7,6,21,38,41,1,Matches
1941,Pedro Obiang,EQG,MF,Sassuolo,Serie A,31,1992,5.0,8,4,3,4,1,2,10,20.0,8,6,4,2,8,16,10,0,Matches
1942,Jan Oblak,SVN,GK,Atlético Madrid,La Liga,30,1993,38.0,0,0,0,0,0,0,0,,0,0,0,0,0,0,10,0,Matches
1943,Brian Ocampo,URU,"MF,FW",Cádiz,La Liga,24,1999,2.8,4,3,1,3,0,2,5,40.0,3,4,0,4,3,7,0,0,Matches
1944,Lucas Ocampos,ARG,"FW,MF",Sevilla,La Liga,29,1994,31.9,66,47,22,27,17,29,58,50.0,29,34,1,33,21,87,29,0,Matches
1945,Guillermo Ochoa,MEX,GK,Salernitana,Serie A,38,1985,21.0,0,0,0,0,0,0,1,0.0,1,0,0,0,0,0,9,1,Matches
1946,Jens Odgaard,DEN,"FW,MF",Bologna,Serie A,24,1999,4.8,4,4,1,1,2,1,3,33.3,2,9,0,9,1,5,3,0,Matches
1947,Wilson Odobert,FRA,"MF,FW",Burnley,Premier League,18,2004,23.3,17,13,8,5,4,6,22,27.3,16,26,2,24,6,23,14,0,Matches
1948,Álvaro Odriozola,ESP,DF,Real Sociedad,La Liga,27,1995,4.4,9,7,7,1,1,5,5,100.0,0,2,1,1,8,17,7,0,Matches
1949,Tim Oermann,GER,DF,Bochum,Bundesliga,19,2003,7.9,19,11,11,4,4,9,14,64.3,5,15,6,9,2,21,22,0,Matches
1950,Odeluga Offiah,ENG,DF,Brighton,Premier League,20,2002,1.4,1,0,1,0,0,1,1,100.0,0,0,0,0,1,2,0,0,Matches
1951,Chiedozie Ogbene,IRL,"MF,DF",Luton Town,Premier League,26,1997,22.2,17,10,10,7,0,12,22,54.5,10,14,3,11,7,24,34,2,Matches
1952,Angelo Ogbonna,ITA,DF,West Ham,Premier League,35,1988,7.1,11,5,9,2,0,6,7,85.7,1,13,10,3,3,14,29,0,Matches
1953,Florent Ogier,FRA,DF,Clermont Foot,Ligue 1,34,1989,10.5,19,9,13,6,0,11,18,61.1,7,25,19,6,9,28,35,3,Matches
1954,Noah Okafor,SUI,"FW,MF",Milan,Serie A,23,2000,9.9,6,4,1,4,1,3,10,30.0,7,8,1,7,0,6,10,0,Matches
1955,David Okereke,NGA,"FW,MF",Torino,Serie A,25,1997,2.8,3,1,1,1,1,0,3,0.0,3,2,0,2,1,4,0,0,Matches
1956,Caleb Okoli,ITA,DF,Frosinone,Serie A,22,2001,32.4,56,34,33,22,1,29,44,65.9,15,48,32,16,29,85,156,4,Matches
1957,Maduka Okoye,NGA,GK,Udinese,Serie A,23,1999,21.0,0,0,0,0,0,0,0,,0,0,0,0,1,1,4,2,Matches
1958,Masaya Okugawa,JPN,"FW,DF",Augsburg,Bundesliga,27,1996,0.4,0,0,0,0,0,0,0,,0,0,0,0,0,0,2,0,Matches
1959,Joseph Okumu,KEN,DF,Reims,Ligue 1,26,1997,19.4,44,28,28,14,2,24,38,63.2,14,27,19,8,35,79,112,2,Matches
1960,Aingeru Olabarrieta,ESP,FW,Athletic Club,La Liga,17,2005,0.1,0,0,0,0,0,0,0,,0,0,0,0,0,0,0,0,Matches
1961,Michael Olakigbe,ENG,"DF,FW",Brentford,Premier League,19,2004,0.7,3,0,2,1,0,2,4,50.0,2,7,0,7,1,4,0,1,Matches
1962,Olasagasti,ESP,MF,Real Sociedad,La Liga,22,2000,4.0,16,13,4,7,5,5,8,62.5,3,2,0,2,3,19,5,1,Matches
1963,Finn Ole Becker,GER,MF,Hoffenheim,Bundesliga,23,2000,6.7,10,9,8,2,0,4,17,23.5,13,9,1,8,1,11,10,0,Matches
1964,Mathias Olesen,LUX,"MF,FW",Köln,Bundesliga,22,2001,1.2,0,0,0,0,0,0,0,,0,0,0,0,2,2,2,0,Matches
1965,Michael Olise,FRA,"FW,MF",Crystal Palace,Premier League,21,2001,14.2,19,10,7,10,2,8,24,33.3,16,21,0,21,11,30,9,0,Matches
1966,Mathías Olivera,URU,DF,Napoli,Serie A,25,1997,17.4,50,29,29,15,6,23,39,59.0,16,35,6,29,20,70,25,0,Matches
1967,Dani Olmo,ESP,MF,RB Leipzig,Bundesliga,25,1998,16.1,26,18,14,8,4,10,22,45.5,12,7,0,7,13,39,12,1,Matches
1968,Robin Olsen,SWE,GK,Aston Villa,Premier League,33,1990,4.5,0,0,0,0,0,0,0,,0,0,0,0,0,0,1,0,Matches
1969,Warmed Omari,FRA,DF,Rennes,Ligue 1,23,2000,23.0,32,19,23,7,2,16,28,57.1,12,30,20,10,33,65,77,2,Matches
1970,Becir Omeragic,SUI,"DF,MF",Montpellier,Ligue 1,21,2002,25.7,48,29,31,13,4,20,33,60.6,13,51,29,22,27,75,65,0,Matches
1971,Jonas Omlin,SUI,GK,Gladbach,Bundesliga,29,1994,7.0,1,0,1,0,0,1,1,100.0,0,0,0,0,0,1,3,0,Matches
1972,Andrew Omobamidele,IRL,DF,Nott'ham Forest,Premier League,21,2002,8.7,10,3,9,1,0,5,8,62.5,3,12,8,4,13,23,42,1,Matches
1973,Samu Omorodion,ESP,FW,Alavés,La Liga,19,2004,21.3,6,3,1,4,1,0,4,0.0,4,11,2,9,1,7,14,0,Matches
1974,Samu Omorodion,ESP,FW,Granada,La Liga,19,2004,0.9,1,1,0,1,0,1,1,100.0,0,0,0,0,0,1,0,0,Matches
1975,Amadou Onana,BEL,MF,Everton,Premier League,21,2001,23.2,71,38,32,31,8,21,42,50.0,21,25,6,19,21,92,31,0,Matches
1976,André Onana,CMR,GK,Manchester Utd,Premier League,27,1996,38.0,2,0,2,0,0,2,2,100.0,0,0,0,0,0,2,11,2,Matches
1977,Jean Onana,CMR,MF,Marseille,Ligue 1,23,2000,6.3,23,14,6,14,3,13,25,52.0,12,10,2,8,11,34,11,1,Matches
1978,Ryan One,SCO,FW,Sheffield Utd,Premier League,17,2006,0.1,0,0,0,0,0,0,0,,0,0,0,0,0,0,0,0,Matches
1979,Karim Onisiwo,AUT,"FW,MF",Mainz 05,Bundesliga,31,1992,16.6,17,8,4,6,7,6,11,54.5,5,18,4,14,2,19,7,0,Matches
1980,Tyler Onyango,ENG,MF,Everton,Premier League,20,2003,0.0,0,0,0,0,0,0,0,,0,0,0,0,0,0,0,0,Matches
1981,Fred Onyedinma,ENG,"DF,MF",Luton Town,Premier League,26,1996,4.5,10,6,7,3,0,5,12,41.7,7,3,0,3,1,11,13,0,Matches
1982,Frank Onyeka,NGA,MF,Brentford,Premier League,25,1998,12.9,37,24,9,23,5,16,29,55.2,13,15,7,8,23,60,17,0,Matches
1983,Loïs Openda,BEL,FW,RB Leipzig,Bundesliga,23,2000,30.0,3,3,0,1,2,0,6,0.0,6,19,3,16,5,8,14,0,Matches
1984,Royce Openda Owaga,GAB,FW,Lorient,Ligue 1,21,2002,0.2,0,0,0,0,0,0,0,,0,0,0,0,0,0,0,0,Matches
1985,Christopher Operi,CIV,DF,Le Havre,Ligue 1,26,1997,27.2,55,36,37,15,3,32,59,54.2,27,45,7,38,35,90,68,1,Matches
1986,Leon Opitz,GER,"FW,DF",Werder Bremen,Bundesliga,18,2005,0.2,2,2,1,1,0,2,3,66.7,1,0,0,0,0,2,0,0,Matches
1987,Gift Orban,NGA,FW,Lyon,Ligue 1,21,2002,5.3,4,3,0,1,3,1,4,25.0,3,2,0,2,1,5,2,1,Matches
1988,Willi Orban,HUN,DF,RB Leipzig,Bundesliga,30,1992,17.6,20,12,8,10,2,9,18,50.0,9,22,13,9,16,36,76,1,Matches
1989,Ivan Ordets,UKR,DF,Bochum,Bundesliga,31,1992,20.9,19,14,11,6,2,10,17,58.8,7,41,29,12,31,50,130,0,Matches
1990,Divock Origi,BEL,FW,Nott'ham Forest,Premier League,28,1995,6.7,6,4,5,0,1,0,0,,0,6,0,6,2,8,4,0,Matches
1991,Gaetano Oristanio,ITA,"FW,MF",Cagliari,Serie A,20,2002,12.3,20,10,5,14,1,5,17,29.4,12,11,0,11,9,29,8,0,Matches
1992,Aimar Oroz,ESP,MF,Osasuna,La Liga,21,2001,26.0,43,26,18,20,5,13,37,35.1,24,27,2,25,16,59,11,0,Matches
1993,Riccardo Orsolini,ITA,"FW,MF",Bologna,Serie A,26,1997,19.9,23,14,13,4,6,9,30,30.0,21,25,3,22,8,31,19,1,Matches
1994,Stefan Ortega,GER,GK,Manchester City,Premier League,30,1992,7.1,0,0,0,0,0,0,0,,0,0,0,0,0,0,2,1,Matches
1995,Eneko Ortiz,ESP,DF,Alavés,La Liga,20,2003,0.2,0,0,0,0,0,0,0,,0,0,0,0,0,0,0,0,Matches
1996,Asier Osambela,ESP,MF,Osasuna,La Liga,19,2004,0.1,2,1,0,1,1,0,0,,0,0,0,0,0,2,0,0,Matches
1997,Ben Osborn,ENG,"DF,MF",Sheffield Utd,Premier League,28,1994,15.2,22,9,11,9,2,8,17,47.1,9,18,2,16,8,30,30,0,Matches
1998,Gabriel Osho,NGA,DF,Luton Town,Premier League,24,1998,20.5,41,22,21,19,1,16,27,59.3,11,37,20,17,31,72,92,0,Matches
1999,Victor Osimhen,NGA,FW,Napoli,Serie A,24,1998,22.0,9,5,0,4,5,2,4,50.0,2,5,1,4,2,11,18,0,Matches
2000,Milutin Osmajić,MNE,MF,Cádiz,La Liga,24,1999,0.1,0,0,0,0,0,0,0,,0,0,0,0,0,0,0,0,Matches
2001,Patrick Osterhage,GER,MF,Bochum,Bundesliga,23,2000,20.7,38,26,14,23,1,17,36,47.2,19,36,9,27,27,65,32,1,Matches
2002,William Osula,DEN,FW,Sheffield Utd,Premier League,19,2003,8.7,2,2,1,0,1,1,2,50.0,1,3,1,2,2,4,9,0,Matches
2003,Dango Ouattara,BFA,"FW,DF",Bournemouth,Premier League,21,2002,13.7,45,27,22,11,12,19,34,55.9,15,18,3,15,22,67,35,0,Matches
2004,Kassoum Ouattara,FRA,"DF,FW",Monaco,Ligue 1,18,2004,7.1,17,12,8,5,4,9,20,45.0,11,11,0,11,13,30,20,0,Matches
2005,Remi Oudin,FRA,"MF,FW",Lecce,Serie A,26,1996,20.2,26,14,12,12,2,12,19,63.2,7,13,1,12,20,46,22,0,Matches
2006,Alexandre Oukidja,ALG,GK,Metz,Ligue 1,35,1988,33.2,2,1,2,0,0,1,2,50.0,1,1,0,1,3,5,24,3,Matches
2007,Azzedine Ounahi,MAR,MF,Marseille,Ligue 1,23,2000,13.4,25,11,9,14,2,11,32,34.4,21,6,1,5,11,36,8,0,Matches
2008,Adam Ounas,ALG,FW,Lille,Ligue 1,26,1996,4.6,4,3,2,2,0,2,7,28.6,5,2,0,2,6,10,1,0,Matches
2009,Patrick Ouotro,CIV,FW,Strasbourg,Ligue 1,17,2005,0.1,0,0,0,0,0,0,0,,0,0,0,0,0,0,0,0,Matches
2010,Aiham Ousou,SYR,DF,Cádiz,La Liga,23,2000,4.8,8,5,6,2,0,5,5,100.0,0,1,0,1,7,15,15,0,Matches
2011,Jesús Owono,EQG,GK,Alavés,La Liga,22,2001,4.0,0,0,0,0,0,0,0,,0,0,0,0,0,0,3,0,Matches
2012,Mikel Oyarzabal,ESP,"FW,MF",Real Sociedad,La Liga,26,1997,24.0,23,18,7,11,5,7,21,33.3,14,25,4,21,4,27,12,0,Matches
2013,Anthony Oyono,GAB,DF,Frosinone,Serie A,22,2001,13.3,37,26,21,14,2,23,34,67.6,11,17,3,14,9,46,32,0,Matches
2014,Salih Özcan,TUR,MF,Dortmund,Bundesliga,25,1998,13.2,20,12,11,8,1,10,18,55.6,8,28,3,25,17,37,18,1,Matches
2015,Cenk Özkacar,TUR,DF,Valencia,La Liga,22,2000,17.8,26,15,22,4,0,15,23,65.2,8,18,7,11,18,44,84,1,Matches
2016,David Ozoh,ENG,"MF,DF",Crystal Palace,Premier League,18,2005,1.7,10,6,3,6,1,5,6,83.3,1,2,0,2,0,10,2,0,Matches
2017,Jon Pacheco,ESP,DF,Real Sociedad,La Liga,22,2001,17.0,25,15,21,4,0,14,22,63.6,8,17,6,11,10,35,53,1,Matches
2018,Willian Pacho,ECU,DF,Eint Frankfurt,Bundesliga,21,2001,33.0,62,37,38,23,1,31,53,58.5,22,51,22,29,47,109,152,2,Matches
2019,Gonçalo Paciência,POR,"FW,MF",Bochum,Bundesliga,28,1994,7.2,8,4,2,2,4,3,6,50.0,3,5,0,5,0,8,7,0,Matches
2020,Simone Pafundi,ITA,MF,Udinese,Serie A,17,2006,0.1,0,0,0,0,0,0,0,,0,0,0,0,0,0,0,0,Matches
2021,Riccardo Pagano,ITA,"MF,DF",Roma,Serie A,18,2004,0.6,2,2,1,1,0,0,6,0.0,6,3,2,1,0,2,2,0,Matches
2022,Pablo Pagis,FRA,MF,Lorient,Ligue 1,20,2002,1.8,10,6,5,4,1,6,10,60.0,4,2,0,2,3,13,1,0,Matches
2023,Exequiel Palacios,ARG,MF,Leverkusen,Bundesliga,24,1998,20.3,60,34,28,26,6,26,53,49.1,27,24,0,24,29,89,20,2,Matches
2024,Isaac Palazón Camacho,ESP,"MF,FW",Rayo Vallecano,La Liga,28,1994,31.0,46,25,16,21,9,20,58,34.5,38,29,2,27,16,62,41,0,Matches
2025,João Palhinha,POR,MF,Fulham,Premier League,28,1995,30.0,152,75,80,60,12,103,152,67.8,49,57,9,48,46,198,58,0,Matches
2026,Nicolas Pallois,FRA,DF,Nantes,Ligue 1,35,1987,17.7,34,19,21,11,2,19,35,54.3,16,37,26,11,26,60,111,0,Matches
2027,Cole Palmer,ENG,"FW,MF",Chelsea,Premier League,21,2002,29.0,23,12,9,6,8,8,19,42.1,11,20,2,18,20,43,13,2,Matches
2028,Cole Palmer,ENG,MF,Manchester City,Premier League,21,2002,0.1,0,0,0,0,0,0,0,,0,0,0,0,0,0,0,0,Matches
2029,Emerson Palmieri,ITA,DF,West Ham,Premier League,28,1994,34.9,106,68,48,42,16,57,90,63.3,33,47,15,32,43,149,96,0,Matches
2030,Joaquín Panichelli,ARG,"FW,MF",Alavés,La Liga,20,2002,2.5,3,3,1,1,1,1,2,50.0,1,1,0,1,1,4,4,0,Matches
2031,Miloš Pantović,SRB,MF,Union Berlin,Bundesliga,27,1996,0.2,0,0,0,0,0,0,0,,0,0,0,0,0,0,0,0,Matches
2032,Antonios Papadopoulos,GER,DF,Dortmund,Bundesliga,23,1999,1.3,6,3,6,0,0,6,7,85.7,1,3,2,1,2,8,7,0,Matches
2033,Christos Papadopoulos,GRE,FW,Genoa,Serie A,18,2004,0.0,0,0,0,0,0,0,1,0.0,1,0,0,0,0,0,0,0,Matches
2034,Sokratis Papastathopoulos,GRE,DF,Betis,La Liga,35,1988,12.6,21,14,16,5,0,13,17,76.5,4,15,9,6,6,27,60,0,Matches
2035,Merveille Papela,GER,"MF,DF",Mainz 05,Bundesliga,22,2001,2.9,5,4,2,3,0,0,4,0.0,4,1,0,1,4,9,2,0,Matches
2036,Leart Paqarada,KVX,DF,Köln,Bundesliga,28,1994,11.9,21,11,9,9,3,11,22,50.0,11,17,5,12,10,31,30,1,Matches
2037,Lucas Paquetá,BRA,"FW,MF",West Ham,Premier League,25,1997,29.1,71,48,38,26,7,25,52,48.1,27,28,1,27,21,92,28,2,Matches
2038,Victor Parada,ESP,"FW,MF",Alavés,La Liga,21,2002,0.0,1,1,0,1,0,1,1,100.0,0,0,0,0,0,1,0,0,Matches
2039,Aitor Paredes,ESP,DF,Athletic Club,La Liga,23,2000,30.0,20,11,11,9,0,7,14,50.0,7,23,11,12,33,53,104,0,Matches
2040,Kevin Paredes,USA,"FW,MF",Wolfsburg,Bundesliga,20,2003,15.9,42,21,22,13,7,20,34,58.8,14,27,2,25,23,65,26,0,Matches
2041,Leandro Paredes,ARG,MF,Roma,Serie A,29,1994,29.3,57,36,30,22,5,33,77,42.9,44,26,7,19,29,86,43,1,Matches
2042,Daniel Parejo,ESP,MF,Villarreal,La Liga,34,1989,28.7,43,30,16,21,6,20,46,43.5,26,25,9,16,21,64,29,3,Matches
2043,Fabiano Parisi,ITA,DF,Fiorentina,Serie A,22,2000,16.2,30,15,11,12,7,15,26,57.7,11,21,5,16,17,47,26,0,Matches
2044,Ben Parkinson,ENG,FW,Newcastle Utd,Premier League,18,2005,0.3,0,0,0,0,0,0,0,,0,1,0,1,0,0,1,0,Matches
2045,Thomas Partey,GHA,"MF,DF",Arsenal,Premier League,30,1993,8.8,14,11,9,4,1,5,10,50.0,5,9,3,6,11,25,9,0,Matches
2046,Mario Pašalić,CRO,MF,Atalanta,Serie A,28,1995,22.8,28,17,9,18,1,14,31,45.2,17,29,6,23,16,44,34,0,Matches
2047,Triantafyllos Pasaridīs,GRE,DF,Salernitana,Serie A,27,1996,5.0,11,7,9,2,0,9,14,64.3,5,7,3,4,3,14,19,0,Matches
2048,Pascu,ESP,FW,Villarreal,La Liga,20,2003,0.2,0,0,0,0,0,0,0,,0,0,0,0,0,0,0,0,Matches
2049,Felix Passlack,GER,DF,Bochum,Bundesliga,25,1998,10.7,21,14,9,10,2,14,24,58.3,10,13,2,11,10,31,21,0,Matches
2050,Patric,ESP,DF,Lazio,Serie A,30,1993,17.9,13,8,10,3,0,8,18,44.4,10,15,9,6,6,19,44,0,Matches
2051,Rui Patrício,POR,GK,Roma,Serie A,35,1988,23.0,0,0,0,0,0,0,1,0.0,1,1,0,1,0,0,3,1,Matches
2052,Nathan Patterson,SCO,DF,Everton,Premier League,21,2001,11.2,34,24,21,11,2,14,37,37.8,23,14,3,11,9,43,33,0,Matches
2053,Gabriel Paulista,BRA,DF,Atlético Madrid,La Liga,32,1990,4.5,7,5,4,3,0,3,4,75.0,1,5,3,2,4,11,27,0,Matches
2054,Gabriel Paulista,BRA,DF,Valencia,La Liga,32,1990,15.5,10,7,8,2,0,6,11,54.5,5,15,7,8,24,34,78,0,Matches
2055,Benjamin Pavard,FRA,DF,Inter,Serie A,27,1996,18.6,34,21,21,11,2,20,24,83.3,4,25,15,10,32,66,44,1,Matches
2056,Jiří Pavlenka,CZE,GK,Werder Bremen,Bundesliga,31,1992,7.0,0,0,0,0,0,0,0,,0,0,0,0,0,0,2,0,Matches
2057,Aleksandar Pavlovic,GER,MF,Bayern Munich,Bundesliga,19,2004,13.6,28,16,10,14,4,17,33,51.5,16,13,3,10,17,45,12,0,Matches
2058,Leonardo Pavoletti,ITA,FW,Cagliari,Serie A,34,1988,7.0,1,1,0,0,1,0,1,0.0,1,2,1,1,0,1,7,0,Matches
2059,Martín Payero,ARG,MF,Udinese,Serie A,24,1998,20.0,54,32,28,19,7,19,46,41.3,27,25,7,18,15,69,21,0,Matches
2060,Nicolás Paz,ARG,"MF,FW",Real Madrid,La Liga,18,2004,0.3,0,0,0,0,0,0,0,,0,2,0,2,1,1,0,0,Matches
2061,Myles Peart-Harris,ENG,"DF,MF",Brentford,Premier League,20,2002,0.1,0,0,0,0,0,0,0,,0,0,0,0,0,0,1,0,Matches
2062,Sydie Peck,ENG,MF,Sheffield Utd,Premier League,18,2004,0.1,0,0,0,0,0,0,0,,0,0,0,0,0,0,0,0,Matches
2063,Mads Pedersen,DEN,DF,Augsburg,Bundesliga,26,1996,19.8,64,39,31,27,6,24,44,54.5,20,20,3,17,19,83,46,0,Matches
2064,Marcus Pedersen,NOR,DF,Sassuolo,Serie A,23,2000,17.9,36,24,25,5,6,21,25,84.0,4,19,5,14,10,46,51,0,Matches
2065,Alfonso Pedraza,ESP,DF,Villarreal,La Liga,27,1996,12.4,25,9,18,5,2,9,17,52.9,8,16,7,9,13,38,19,0,Matches
2066,Pedri,ESP,"MF,FW",Barcelona,La Liga,20,2002,16.4,33,24,16,13,4,8,27,29.6,19,27,3,24,14,47,10,0,Matches
2067,Pedro,ESP,"FW,MF",Lazio,Serie A,36,1987,9.1,16,12,5,7,4,3,12,25.0,9,16,2,14,3,19,1,0,Matches
2068,Adrià Pedrosa,ESP,DF,Sevilla,La Liga,25,1998,19.5,46,26,28,14,4,23,34,67.6,11,26,6,20,15,61,54,0,Matches
2069,Jordan Pefok,USA,FW,Gladbach,Bundesliga,27,1996,15.8,10,4,0,8,2,3,8,37.5,5,12,3,9,5,15,28,0,Matches
2070,Jordan Pefok,USA,FW,Union Berlin,Bundesliga,27,1996,0.3,0,0,0,0,0,0,0,,0,1,1,0,0,0,0,0,Matches
2071,Dženan Pejčinović,GER,FW,Wolfsburg,Bundesliga,18,2005,0.4,0,0,0,0,0,0,0,,0,1,0,1,0,0,0,0,Matches
2072,Pietro Pellegri,ITA,FW,Torino,Serie A,22,2001,8.4,5,1,1,4,0,1,5,20.0,4,4,1,3,2,7,3,0,Matches
2073,Lorenzo Pellegrini,ITA,MF,Roma,Serie A,27,1996,20.7,35,20,14,16,5,17,51,33.3,34,28,5,23,20,55,22,0,Matches
2074,Luca Pellegrini,ITA,DF,Lazio,Serie A,24,1999,8.7,18,13,7,10,1,9,17,52.9,8,7,3,4,9,27,20,0,Matches
2075,Marco Pellegrino,,DF,Salernitana,Serie A,,,6.1,8,6,4,3,1,5,10,50.0,5,11,6,5,10,18,28,0,Matches
2076,Marco Pellegrino,,DF,Milan,Serie A,,,0.8,1,1,0,0,1,0,2,0.0,2,1,1,0,1,2,2,0,Matches
2077,Facundo Pellistri,URU,"FW,MF",Manchester Utd,Premier League,21,2001,1.9,5,3,4,1,0,1,3,33.3,2,7,1,6,1,6,5,0,Matches
2078,Facundo Pellistri,URU,"MF,FW",Granada,La Liga,21,2001,13.7,29,19,12,10,7,6,21,28.6,15,18,0,18,4,33,7,0,Matches
2079,Andy Pelmard,FRA,DF,Clermont Foot,Ligue 1,23,2000,33.2,51,38,41,9,1,32,40,80.0,8,37,20,17,33,84,99,2,Matches
2080,Aurélien Pelon,FRA,DF,Lorient,Ligue 1,19,2004,1.0,1,0,1,0,0,0,2,0.0,2,2,2,0,0,1,7,0,Matches
2081,Faris Pemi Moumbagna,CMR,FW,Marseille,Ligue 1,23,2000,6.1,2,1,0,2,0,0,3,0.0,3,4,0,4,3,5,1,0,Matches
2082,Iñaki Peña,ESP,GK,Barcelona,La Liga,24,1999,10.0,0,0,0,0,0,0,1,0.0,1,0,0,0,0,0,5,1,Matches
2083,Marcos Peña,ESP,MF,Almería,La Liga,18,2005,4.9,19,14,12,7,0,6,12,50.0,6,9,3,6,13,32,8,0,Matches
2084,Rubén Peña,ESP,"DF,FW",Osasuna,La Liga,32,1991,23.2,47,25,22,18,7,20,49,40.8,29,37,8,29,30,77,39,3,Matches
2085,Pepín,EQG,"MF,FW",Monza,Serie A,26,1996,2.7,6,1,1,4,1,2,4,50.0,2,5,2,3,0,6,6,0,Matches
2086,Alberto Perea,ESP,"MF,FW",Granada,La Liga,32,1990,0.0,0,0,0,0,0,0,2,0.0,2,0,0,0,0,0,0,0,Matches
2087,Andreas Pereira,BRA,MF,Fulham,Premier League,27,1996,29.0,25,12,4,12,9,11,41,26.8,30,16,2,14,4,29,12,0,Matches
2088,Danilo Pereira,POR,DF,Paris S-G,Ligue 1,31,1991,22.2,22,12,14,6,2,9,17,52.9,8,29,26,3,23,45,100,1,Matches
2089,Mathias Pereira Lage,POR,"FW,MF",Brest,Ligue 1,26,1996,13.2,21,15,7,8,6,7,28,25.0,21,14,5,9,10,31,13,0,Matches
2090,Pedro Pereira,POR,DF,Monza,Serie A,25,1998,9.3,19,13,14,4,1,9,17,52.9,8,15,2,13,4,23,18,0,Matches
2091,Daniel Peretz,ISR,GK,Bayern Munich,Bundesliga,23,2000,0.2,0,0,0,0,0,0,0,,0,0,0,0,0,0,0,0,Matches
2092,Roberto Pereyra,ARG,"FW,MF",Udinese,Serie A,32,1991,20.6,19,9,11,5,3,11,29,37.9,18,20,4,16,7,26,18,0,Matches
2093,Ayoze Pérez,ESP,FW,Betis,La Liga,30,1993,25.5,59,32,16,33,10,21,49,42.9,28,42,4,38,22,81,18,0,Matches
2094,Carles Pérez,ESP,"MF,DF",Celta Vigo,La Liga,25,1998,8.6,13,5,6,5,2,7,18,38.9,11,14,1,13,5,18,8,0,Matches
2095,Francisco Perez,ESP,"MF,FW",Valencia,La Liga,20,2002,22.8,30,17,10,14,6,15,44,34.1,29,19,0,19,14,44,5,0,Matches
2096,Kike Pérez,ESP,"MF,FW",Rayo Vallecano,La Liga,26,1997,9.3,27,11,11,15,1,11,23,47.8,12,11,0,11,8,35,6,0,Matches
2097,Nehuén Pérez,ARG,DF,Udinese,Serie A,23,2000,36.0,72,48,42,28,2,39,48,81.3,9,53,26,27,45,117,158,1,Matches
2098,Matteo Perez Vinlöf,SWE,FW,Bayern Munich,Bundesliga,17,2005,0.2,0,0,0,0,0,0,0,,0,0,0,0,1,1,0,0,Matches
2099,Simone Perilli,ITA,GK,Hellas Verona,Serie A,28,1995,1.0,0,0,0,0,0,0,0,,0,0,0,0,0,0,0,0,Matches
2100,Mattia Perin,ITA,GK,Juventus,Serie A,30,1992,2.5,0,0,0,0,0,0,0,,0,0,0,0,0,0,1,0,Matches
2101,Samuele Perisan,ITA,GK,Empoli,Serie A,25,1997,1.0,0,0,0,0,0,0,0,,0,0,0,0,0,0,0,0,Matches
2102,Ivan Perišić,CRO,FW,Tottenham,Premier League,34,1989,1.1,3,2,1,1,1,3,5,60.0,2,1,0,1,2,5,1,0,Matches
2103,Romain Perraud,FRA,"DF,FW",Nice,Ligue 1,25,1997,4.1,7,6,5,1,1,4,11,36.4,7,4,0,4,6,13,15,1,Matches
2104,Lucas Perrin,FRA,DF,Strasbourg,Ligue 1,24,1998,30.3,47,30,33,14,0,28,46,60.9,18,45,32,13,28,75,113,0,Matches
2105,Máximo Perrone,ARG,MF,Las Palmas,La Liga,20,2003,18.0,42,21,17,22,3,19,39,48.7,20,27,4,23,24,66,21,0,Matches
2106,Pavao Pervan,AUT,GK,Wolfsburg,Bundesliga,35,1987,9.0,0,0,0,0,0,0,0,,0,0,0,0,0,0,4,0,Matches
2107,Matteo Pessina,ITA,MF,Monza,Serie A,26,1997,35.8,44,25,20,20,4,23,49,46.9,26,29,11,18,27,71,46,1,Matches
2108,Andrea Petagna,ITA,FW,Cagliari,Serie A,28,1995,11.1,4,2,1,0,3,1,2,50.0,1,6,3,3,1,5,4,0,Matches
2109,Denis Petrić,SRB,GK,Nantes,Ligue 1,35,1988,0.3,0,0,0,0,0,0,0,,0,0,0,0,0,0,0,0,Matches
2110,Njegoš Petrović,SRB,"MF,FW",Granada,La Liga,24,1999,1.7,5,2,4,1,0,2,3,66.7,1,2,0,2,1,6,3,0,Matches
2111,Đorđe Petrović,SRB,GK,Chelsea,Premier League,23,1999,22.1,0,0,0,0,0,0,0,,0,0,0,0,0,0,12,3,Matches
2112,Jens Petter Hauge,NOR,"MF,FW",Eint Frankfurt,Bundesliga,23,1999,1.6,2,1,1,0,1,2,7,28.6,5,5,1,4,0,2,1,0,Matches
2113,Germán Pezzella,ARG,DF,Betis,La Liga,32,1991,30.7,34,24,24,10,0,23,38,60.5,15,31,18,13,31,65,150,0,Matches
2114,Giuseppe Pezzella,ITA,DF,Empoli,Serie A,25,1997,12.1,25,14,19,5,1,20,28,71.4,8,17,6,11,2,27,35,0,Matches
2115,Luca Pfeiffer,GER,"FW,MF",Darmstadt 98,Bundesliga,26,1996,18.0,11,6,2,6,3,5,11,45.5,6,5,1,4,2,13,21,0,Matches
2116,Patric Pfeiffer,GER,DF,Augsburg,Bundesliga,23,1999,5.7,11,7,6,4,1,5,6,83.3,1,10,6,4,11,22,21,0,Matches
2117,Maximilian Philipp,GER,"FW,MF",Freiburg,Bundesliga,29,1994,3.6,8,5,4,4,0,1,6,16.7,5,7,0,7,1,9,3,0,Matches
2118,Kalvin Phillips,ENG,MF,West Ham,Premier League,27,1995,3.4,11,6,2,8,1,5,9,55.6,4,4,1,3,4,15,2,1,Matches
2119,Kalvin Phillips,ENG,MF,Manchester City,Premier League,27,1995,1.0,3,3,1,1,1,0,0,,0,0,0,0,2,5,2,0,Matches
2120,Jaden Philogene Bidace,ENG,FW,Aston Villa,Premier League,21,2002,0.0,0,0,0,0,0,0,0,,0,0,0,0,0,0,0,0,Matches
2121,Kamil Piątkowski,POL,DF,Granada,La Liga,23,2000,5.6,18,10,16,1,1,10,14,71.4,4,6,5,1,8,26,28,1,Matches
2122,Roberto Piccoli,ITA,FW,Empoli,Serie A,22,2001,0.4,1,1,0,0,1,1,1,100.0,0,0,0,0,0,1,0,0,Matches
2123,Roberto Piccoli,ITA,FW,Lecce,Serie A,22,2001,15.3,10,6,3,5,2,1,4,25.0,3,17,1,16,4,14,16,0,Matches
2124,Florian Pick,GER,"MF,FW",Heidenheim,Bundesliga,27,1995,3.6,4,4,3,0,1,2,3,66.7,1,2,0,2,2,6,2,0,Matches
2125,Jordan Pickford,ENG,GK,Everton,Premier League,29,1994,38.0,1,0,1,0,0,1,1,100.0,0,3,0,3,0,1,19,1,Matches
2126,Amos Pieper,GER,DF,Werder Bremen,Bundesliga,25,1998,6.6,14,11,8,6,0,7,13,53.8,6,12,7,5,9,23,36,1,Matches
2127,Marvin Pieringer,GER,"MF,FW",Heidenheim,Bundesliga,23,1999,16.8,19,12,5,11,3,8,20,40.0,12,28,4,24,12,31,21,0,Matches
2128,Santiago Pierotti,ARG,"MF,FW",Lecce,Serie A,22,2001,2.2,8,8,2,5,1,2,8,25.0,6,5,0,5,1,9,0,0,Matches
2129,Niccolò Pierozzi,ITA,DF,Salernitana,Serie A,21,2001,9.7,17,11,13,4,0,11,22,50.0,11,24,7,17,11,28,36,0,Matches
2130,Ronaël Pierre-Gabriel,FRA,DF,Nantes,Ligue 1,25,1998,6.6,15,9,12,2,1,5,7,71.4,2,13,4,9,8,23,25,0,Matches
2131,Andrea Pinamonti,ITA,FW,Sassuolo,Serie A,24,1999,34.2,13,8,1,6,6,5,22,22.7,17,19,2,17,1,14,40,0,Matches
2132,Ethan Pinnock,JAM,DF,Brentford,Premier League,30,1993,28.0,35,23,22,13,0,9,20,45.0,11,40,24,16,43,78,170,3,Matches
2133,Yeremi Pino,ESP,"MF,FW",Villarreal,La Liga,20,2002,5.3,25,18,12,10,3,9,18,50.0,9,11,1,10,5,30,5,0,Matches
2134,Carlo Pinsoglio,ITA,GK,Juventus,Serie A,33,1990,0.5,0,0,0,0,0,0,0,,0,0,0,0,0,0,0,0,Matches
2135,Lorenzo Pirola,ITA,DF,Salernitana,Serie A,21,2002,22.1,39,23,25,14,0,15,28,53.6,13,46,30,16,25,64,93,1,Matches
2136,Niccolò Pisilli,ITA,MF,Roma,Serie A,18,2004,0.1,0,0,0,0,0,0,0,,0,0,0,0,0,0,0,0,Matches
2137,Alassane Pléa,FRA,"FW,MF",Gladbach,Bundesliga,30,1993,21.3,17,7,5,8,4,7,15,46.7,8,11,0,11,2,19,6,0,Matches
2138,Tommaso Pobega,ITA,MF,Milan,Serie A,24,1999,3.5,16,9,11,5,0,6,13,46.2,7,10,2,8,6,22,7,0,Matches
2139,Paul Pogba,FRA,MF,Juventus,Serie A,30,1993,0.6,1,1,0,1,0,1,1,100.0,0,0,0,0,1,2,1,0,Matches
2140,Ole Pohlmann,GER,MF,Dortmund,Bundesliga,22,2001,0.6,1,0,0,1,0,1,2,50.0,1,0,0,0,0,1,1,0,Matches
2141,Matteo Politano,ITA,FW,Napoli,Serie A,29,1993,26.2,19,8,8,7,4,11,34,32.4,23,9,1,8,15,34,11,1,Matches
2142,Sebastian Polter,GER,FW,Darmstadt 98,Bundesliga,32,1991,5.0,1,0,1,0,0,0,1,0.0,1,5,1,4,0,1,4,0,Matches
2143,Julien Ponceau,FRA,MF,Lorient,Ligue 1,22,2000,24.9,32,15,12,14,6,9,30,30.0,21,22,1,21,19,51,20,0,Matches
2144,Marin Pongračić,CRO,DF,Lecce,Serie A,25,1997,35.8,43,30,22,20,1,19,25,76.0,6,37,26,11,51,94,130,1,Matches
2145,Nick Pope,ENG,GK,Newcastle Utd,Premier League,31,1992,14.9,0,0,0,0,0,0,1,0.0,1,0,0,0,0,0,7,2,Matches
2146,Pedro Porro,ESP,DF,Tottenham,Premier League,23,1999,34.3,91,63,43,34,14,62,120,51.7,58,63,18,45,34,125,102,3,Matches
2147,Portu,ESP,FW,Getafe,La Liga,31,1992,1.1,5,3,4,0,1,5,6,83.3,1,0,0,0,0,5,0,0,Matches
2148,Portu,ESP,"MF,FW",Girona,La Liga,31,1992,13.2,18,13,3,10,5,3,18,16.7,15,9,1,8,4,22,6,0,Matches
2149,Stefan Posch,AUT,DF,Bologna,Serie A,26,1997,26.8,77,46,35,38,4,49,88,55.7,39,27,8,19,18,95,72,0,Matches
2150,Yussuf Poulsen,DEN,FW,RB Leipzig,Bundesliga,29,1994,13.5,13,8,1,9,3,4,14,28.6,10,13,3,10,4,17,15,0,Matches
2151,José Pozo,ESP,MF,Rayo Vallecano,La Liga,27,1996,0.2,1,1,0,1,0,1,1,100.0,0,1,0,1,0,1,0,0,Matches
2152,Alejandro Pozo Pozo,ESP,"DF,MF",Almería,La Liga,24,1999,10.8,19,12,11,6,2,12,20,60.0,8,14,4,10,7,26,21,0,Matches
2153,Beñat Prados,ESP,"MF,DF",Athletic Club,La Liga,22,2001,16.1,45,28,11,23,11,23,42,54.8,19,32,5,27,23,68,27,0,Matches
2154,Matteo Prati,ITA,MF,Cagliari,Serie A,19,2003,21.9,45,25,15,27,3,26,42,61.9,16,29,6,23,15,60,26,1,Matches
2155,Abdón Prats,ESP,"FW,MF",Mallorca,La Liga,30,1992,14.1,6,4,2,2,2,3,5,60.0,2,6,3,3,2,8,12,0,Matches
2156,Sanjin Prcić,BIH,MF,Strasbourg,Ligue 1,29,1993,1.0,0,0,0,0,0,0,1,0.0,1,2,1,1,3,3,1,0,Matches
2157,Grischa Prömel,GER,MF,Hoffenheim,Bundesliga,28,1995,23.8,32,18,11,15,6,14,32,43.8,18,22,6,16,22,54,36,0,Matches
2158,Ivan Provedel,ITA,GK,Lazio,Serie A,29,1994,30.0,1,0,1,0,0,1,3,33.3,2,0,0,0,0,1,12,1,Matches
2159,Marc Pubill,ESP,DF,Almería,La Liga,20,2003,20.9,47,23,35,8,4,22,39,56.4,17,20,8,12,15,62,83,1,Matches
2160,Gustavo Puerta,COL,"DF,MF",Leverkusen,Bundesliga,20,2003,0.5,5,3,2,2,1,1,2,50.0,1,2,0,2,0,5,0,0,Matches
2161,Antonio Puertas,ESP,"MF,FW",Granada,La Liga,31,1992,8.1,12,8,6,5,1,6,15,40.0,9,5,0,5,6,18,4,0,Matches
2162,Arnau Puigmal,ESP,"FW,DF",Almería,La Liga,22,2001,2.8,2,1,1,1,0,1,3,33.3,2,3,0,3,3,5,2,0,Matches
2163,Christian Pulisic,USA,"FW,MF",Milan,Serie A,24,1998,28.9,35,26,14,11,10,17,30,56.7,13,20,1,19,10,45,10,1,Matches
2164,George Pușcaș,ROU,FW,Genoa,Serie A,27,1996,2.1,0,0,0,0,0,0,3,0.0,3,1,0,1,0,0,1,0,Matches
2165,Jarell Quansah,ENG,DF,Liverpool,Premier League,20,2003,13.2,25,22,17,7,1,14,20,70.0,6,16,8,8,17,42,39,1,Matches
2166,Domingos Quina,POR,MF,Udinese,Serie A,23,1999,0.1,1,1,1,0,0,0,0,,0,0,0,0,0,1,0,0,Matches
2167,Adrien Rabiot,FRA,MF,Juventus,Serie A,28,1995,29.5,58,39,22,30,6,30,45,66.7,15,26,6,20,25,83,34,0,Matches
2168,Uroš Račić,SRB,MF,Sassuolo,Serie A,25,1998,9.1,10,4,6,4,0,0,9,0.0,9,16,7,9,7,17,22,0,Matches
2169,Nemanja Radonjić,SRB,"MF,FW",Torino,Serie A,27,1996,4.2,1,1,0,0,1,1,3,33.3,2,3,0,3,0,1,0,0,Matches
2170,Nemanja Radonjić,SRB,"MF,DF",Mallorca,La Liga,27,1996,3.9,4,2,1,3,0,1,4,25.0,3,2,0,2,3,7,3,0,Matches
2171,Aleksandar Radovanović,SRB,DF,Almería,La Liga,29,1993,6.3,8,7,7,1,0,6,6,100.0,0,8,8,0,11,19,48,0,Matches
2172,Ionuț Radu,ROU,GK,Bournemouth,Premier League,26,1997,2.0,0,0,0,0,0,0,0,,0,0,0,0,0,0,0,0,Matches
2173,Boris Radunović,SRB,GK,Cagliari,Serie A,27,1996,7.0,0,0,0,0,0,0,0,,0,0,0,0,1,1,1,2,Matches
2174,Hamza Rafia,TUN,MF,Lecce,Serie A,24,1999,13.4,44,31,13,27,4,13,30,43.3,17,27,1,26,11,55,13,0,Matches
2175,Abdellah Raihani,MAR,FW,Atlético Madrid,La Liga,19,2004,0.1,0,0,0,0,0,0,1,0.0,1,0,0,0,0,0,0,0,Matches
2176,Antonio Raillo,ESP,DF,Mallorca,La Liga,31,1991,24.4,30,23,18,12,0,17,23,73.9,6,44,30,14,37,67,104,2,Matches
2177,Luca Raimund,GER,"FW,MF",Stuttgart,Bundesliga,18,2005,0.3,3,1,2,1,0,0,0,,0,2,0,2,0,3,0,0,Matches
2178,Predrag Rajković,SRB,GK,Mallorca,La Liga,27,1995,36.0,2,1,2,0,0,2,2,100.0,0,0,0,0,0,2,14,0,Matches
2179,Jesurun Rak Sakyi,ENG,"MF,FW",Crystal Palace,Premier League,20,2002,1.5,4,1,3,1,0,2,3,66.7,1,2,0,2,3,7,1,0,Matches
2180,Ivan Rakitić,CRO,MF,Sevilla,La Liga,35,1988,15.8,30,16,9,12,9,11,19,57.9,8,16,5,11,14,44,12,0,Matches
2181,Ylber Ramadani,ALB,MF,Lecce,Serie A,27,1996,33.0,68,41,32,29,7,37,96,38.5,59,54,13,41,44,112,44,0,Matches
2182,Largie Ramazani,BEL,"FW,MF",Almería,La Liga,22,2001,17.3,12,7,5,6,1,6,26,23.1,20,16,2,14,34,46,10,0,Matches
2183,Benito Ramírez,ESP,"FW,MF",Las Palmas,La Liga,28,1995,4.3,5,3,2,3,0,3,6,50.0,3,7,1,6,3,8,0,0,Matches
2184,Sandro Ramírez,ESP,FW,Las Palmas,La Liga,28,1995,20.1,12,8,4,6,2,6,15,40.0,9,13,1,12,4,16,14,1,Matches
2185,Chris Ramos,ESP,"FW,MF",Cádiz,La Liga,26,1997,29.0,28,15,9,15,4,8,27,29.6,19,23,7,16,9,37,44,0,Matches
2186,Gonçalo Ramos,POR,FW,Paris S-G,Ligue 1,22,2001,15.8,25,15,4,12,9,6,20,30.0,14,12,2,10,5,30,16,0,Matches
2187,Sergio Ramos,ESP,DF,Sevilla,La Liga,37,1986,28.0,45,30,32,11,2,27,40,67.5,13,35,30,5,41,86,156,0,Matches
2188,Aaron Ramsdale,ENG,GK,Arsenal,Premier League,25,1998,6.0,0,0,0,0,0,0,0,,0,0,0,0,0,0,3,2,Matches
2189,Aaron Ramsey,ENG,"MF,FW",Burnley,Premier League,20,2003,5.9,17,14,7,5,5,8,16,50.0,8,11,2,9,1,18,10,0,Matches
2190,Jacob Ramsey,ENG,"FW,MF",Aston Villa,Premier League,22,2001,9.5,16,8,7,6,3,5,15,33.3,10,15,2,13,3,19,8,0,Matches
2191,Luca Ranieri,ITA,DF,Fiorentina,Serie A,24,1999,22.9,14,10,11,1,2,8,13,61.5,5,25,11,14,29,43,64,0,Matches
2192,Filippo Ranocchia,ITA,"MF,DF",Empoli,Serie A,22,2001,5.3,16,11,7,9,0,7,16,43.8,9,9,1,8,3,19,14,0,Matches
2193,Grant Ranos,ARM,"MF,FW",Gladbach,Bundesliga,20,2003,0.5,1,0,0,0,1,0,0,,0,0,0,0,0,1,0,0,Matches
2194,Raphinha,BRA,"FW,MF",Barcelona,La Liga,26,1996,15.2,14,8,6,6,2,4,18,22.2,14,17,1,16,13,27,11,0,Matches
2195,Nicolai Rapp,GER,DF,Werder Bremen,Bundesliga,26,1996,0.8,3,2,2,1,0,2,2,100.0,0,2,0,2,2,5,8,0,Matches
2196,Elba Rashani,KVX,"MF,FW",Clermont Foot,Ligue 1,30,1993,13.1,30,18,4,17,9,11,24,45.8,13,17,3,14,12,42,15,0,Matches
2197,Marcus Rashford,ENG,FW,Manchester Utd,Premier League,25,1997,25.2,19,12,9,4,6,9,26,34.6,17,15,1,14,4,23,21,0,Matches
2198,Giacomo Raspadori,ITA,"FW,MF",Napoli,Serie A,23,2000,17.6,21,10,6,10,5,6,15,40.0,9,15,1,14,3,24,7,0,Matches
2199,Andrei Ratiu,ROU,"DF,MF",Rayo Vallecano,La Liga,25,1998,7.0,12,4,6,5,1,8,15,53.3,7,4,1,3,0,12,12,0,Matches
2200,Raúl,ESP,FW,Osasuna,La Liga,22,2000,15.1,10,4,4,2,4,2,10,20.0,8,9,1,8,5,15,11,0,Matches
2201,David Raum,GER,DF,RB Leipzig,Bundesliga,25,1998,30.4,58,35,24,29,5,34,58,58.6,24,51,9,42,27,85,82,2,Matches
2202,Federico Ravaglia,ITA,GK,Bologna,Serie A,23,1999,5.9,0,0,0,0,0,0,0,,0,0,0,0,0,0,2,0,Matches
2203,David Raya,ESP,GK,Arsenal,Premier League,27,1995,32.0,1,1,1,0,0,1,1,100.0,0,0,0,0,0,1,8,5,Matches
2204,Tim Ream,USA,DF,Fulham,Premier League,35,1987,16.7,20,9,13,5,2,9,18,50.0,9,23,15,8,25,45,61,2,Matches
2205,Abderrahman Rebbach,ALG,"FW,MF",Alavés,La Liga,24,1998,8.0,9,5,4,2,3,5,15,33.3,10,10,1,9,3,12,7,0,Matches
2206,Nathan Redmond,ENG,"FW,MF",Burnley,Premier League,29,1994,1.6,2,1,0,0,2,1,4,25.0,3,1,0,1,0,2,3,0,Matches
2207,Harrison Reed,ENG,MF,Fulham,Premier League,28,1995,14.7,29,18,9,17,3,13,31,41.9,18,19,9,10,11,40,24,0,Matches
2208,Sergio Reguilón,ESP,DF,Manchester Utd,Premier League,26,1996,4.6,13,8,6,2,5,8,17,47.1,9,10,0,10,5,18,7,0,Matches
2209,Sergio Reguilón,ESP,DF,Brentford,Premier League,26,1996,12.4,45,20,26,18,1,24,40,60.0,16,23,6,17,16,61,41,1,Matches
2210,Bobby Reid,JAM,FW,Fulham,Premier League,30,1993,15.8,22,14,5,15,2,4,16,25.0,12,24,2,22,5,27,14,0,Matches
2211,Tijjani Reijnders,NED,MF,Milan,Serie A,25,1998,31.3,46,25,10,31,5,21,43,48.8,22,26,8,18,18,64,26,0,Matches
2212,Pepe Reina,ESP,GK,Villarreal,La Liga,40,1982,2.0,0,0,0,0,0,0,0,,0,0,0,0,0,0,1,0,Matches
2213,Reinier,BRA,"MF,FW",Frosinone,Serie A,21,2002,11.8,21,10,6,12,3,5,17,29.4,12,24,4,20,10,31,5,0,Matches
2214,Rocco Reitz,GER,MF,Gladbach,Bundesliga,21,2002,23.7,61,36,28,29,4,28,55,50.9,27,61,20,41,44,105,31,1,Matches
2215,Álex Remiro,ESP,GK,Real Sociedad,La Liga,28,1995,36.4,0,0,0,0,0,0,0,,0,0,0,0,0,0,24,2,Matches
2216,Guillaume Restes,FRA,GK,Toulouse,Ligue 1,18,2005,34.0,0,0,0,0,0,0,3,0.0,3,0,0,0,0,0,19,1,Matches
2217,Mateo Retegui,ITA,FW,Genoa,Serie A,24,1999,24.6,17,9,7,8,2,6,20,30.0,14,18,2,16,0,17,30,0,Matches
2218,Marco Reus,GER,"MF,FW",Dortmund,Bundesliga,34,1989,17.8,37,25,20,14,3,12,27,44.4,15,17,2,15,5,42,18,0,Matches
2219,Elvis Rexhbeçaj,GER,MF,Augsburg,Bundesliga,25,1997,22.1,30,19,14,13,3,18,36,50.0,18,32,7,25,20,50,20,0,Matches
2220,Gio Reyna,USA,"FW,MF",Nott'ham Forest,Premier League,20,2002,2.6,7,3,4,0,3,3,6,50.0,3,3,0,3,2,9,0,0,Matches
2221,Gio Reyna,USA,"MF,FW",Dortmund,Bundesliga,20,2002,3.1,9,6,3,4,2,2,5,40.0,3,5,1,4,2,11,5,0,Matches
2222,Chadi Riad,MAR,DF,Betis,La Liga,20,2003,24.0,35,24,17,18,0,17,27,63.0,10,23,14,9,23,58,108,0,Matches
2223,Alexsandro Ribeiro,BRA,DF,Lille,Ligue 1,23,1999,24.7,32,22,24,8,0,16,31,51.6,15,25,15,10,35,67,116,5,Matches
2224,Rodrigo Ribeiro,POR,"MF,FW",Nott'ham Forest,Premier League,18,2005,0.2,0,0,0,0,0,0,1,0.0,1,1,0,1,1,1,0,0,Matches
2225,Samuele Ricci,ITA,MF,Torino,Serie A,21,2001,26.6,33,18,17,12,4,15,23,65.2,8,21,3,18,27,60,25,0,Matches
2226,Declan Rice,ENG,MF,Arsenal,Premier League,24,1999,35.8,83,51,37,38,8,32,57,56.1,25,37,11,26,44,127,52,0,Matches
2227,Chris Richards,USA,"DF,MF",Crystal Palace,Premier League,23,2000,23.3,46,28,21,22,3,20,30,66.7,10,32,12,20,27,73,109,0,Matches
2228,Amir Richardson,MAR,MF,Reims,Ligue 1,21,2002,15.0,33,23,12,18,3,10,22,45.5,12,26,5,21,15,48,30,0,Matches
2229,Richarlison,BRA,FW,Tottenham,Premier League,26,1997,16.6,16,11,4,8,4,2,10,20.0,8,32,6,26,8,24,23,0,Matches
2230,Marco Richter,GER,"MF,FW",Mainz 05,Bundesliga,25,1997,8.0,10,4,5,3,2,4,11,36.4,7,9,0,9,2,12,1,0,Matches
2231,Diego Rico,ESP,DF,Getafe,La Liga,30,1993,28.2,64,48,32,23,9,41,76,53.9,35,25,8,17,41,105,76,0,Matches
2232,Clemens Riedel,GER,DF,Darmstadt 98,Bundesliga,20,2003,8.4,22,13,16,5,1,15,24,62.5,9,11,3,8,11,33,26,0,Matches
2233,Fabian Rieder,SUI,MF,Rennes,Ligue 1,21,2002,4.1,13,7,2,9,2,6,11,54.5,5,3,1,2,5,18,2,0,Matches
2234,Jaïro Riedewald,NED,"MF,FW",Crystal Palace,Premier League,26,1996,2.6,9,3,2,4,3,3,6,50.0,3,0,0,0,2,11,2,0,Matches
2235,Manuel Riemann,GER,GK,Bochum,Bundesliga,34,1988,33.0,2,1,2,0,0,2,4,50.0,2,0,0,0,1,3,25,1,Matches
2236,Luis Rioja,ESP,"FW,MF",Alavés,La Liga,29,1993,27.8,27,19,10,12,5,14,43,32.6,29,28,1,27,16,43,28,0,Matches
2237,Rémy Riou,FRA,GK,Lyon,Ligue 1,35,1987,3.0,0,0,0,0,0,0,1,0.0,1,0,0,0,0,0,1,1,Matches
2238,Rodrigo Riquelme,ESP,"DF,MF",Atlético Madrid,La Liga,23,2000,17.0,30,19,18,4,8,18,46,39.1,28,19,0,19,9,39,20,0,Matches
2239,Alberto Risco,ESP,MF,Getafe,La Liga,17,2005,1.5,2,2,1,1,0,0,4,0.0,4,0,0,0,0,2,1,0,Matches
2240,Mihailo Ristić,SRB,"DF,MF",Celta Vigo,La Liga,27,1995,9.0,15,9,9,6,0,9,12,75.0,3,9,2,7,10,25,23,0,Matches
2241,Matt Ritchie,SCO,"FW,MF",Newcastle Utd,Premier League,33,1989,1.4,5,3,2,2,1,2,4,50.0,2,3,2,1,1,6,5,0,Matches
2242,Gorka Rivera Alonso,ESP,DF,Getafe,La Liga,18,2004,0.0,0,0,0,0,0,0,0,,0,0,0,0,0,0,0,0,Matches
2243,Sergi Roberto,ESP,"MF,DF",Barcelona,La Liga,31,1992,9.6,15,10,4,10,1,3,11,27.3,8,7,2,5,8,23,7,1,Matches
2244,Lucas Robertone,ARG,MF,Almería,La Liga,26,1997,26.5,61,33,28,23,10,25,50,50.0,25,43,9,34,51,112,43,0,Matches
2245,Connor Roberts,WAL,DF,Burnley,Premier League,27,1995,9.1,12,5,6,4,2,8,17,47.1,9,8,6,2,4,16,25,2,Matches
2246,Andrew Robertson,SCO,DF,Liverpool,Premier League,29,1994,18.8,35,24,21,11,3,26,43,60.5,17,20,6,14,13,48,40,0,Matches
2247,Antonee Robinson,USA,DF,Fulham,Premier League,25,1997,36.3,93,58,60,26,7,52,110,47.3,58,56,8,48,80,173,117,3,Matches
2248,Jack Robinson,ENG,DF,Sheffield Utd,Premier League,29,1993,32.1,43,28,29,14,0,25,39,64.1,14,49,33,16,33,76,132,2,Matches
2249,Marc Roca,ESP,MF,Betis,La Liga,26,1996,22.0,52,36,17,29,6,30,53,56.6,23,29,6,23,17,69,23,1,Matches
2250,Sebastian Rode,GER,MF,Eint Frankfurt,Bundesliga,32,1990,0.7,6,4,0,5,1,4,6,66.7,2,0,0,0,1,7,1,0,Matches
2251,Sergio Rodelas,ESP,"FW,DF",Granada,La Liga,18,2004,1.4,3,2,1,0,2,0,3,0.0,3,0,0,0,0,3,0,0,Matches
2252,Rodri,ESP,MF,Manchester City,Premier League,27,1996,32.6,70,43,25,33,12,29,60,48.3,31,32,8,24,26,96,41,4,Matches
2253,Rodri,ESP,"FW,MF",Betis,La Liga,23,2000,11.7,17,10,6,7,4,8,21,38.1,13,11,0,11,8,25,2,0,Matches
2254,Óscar Rodríguez Arnaiz,ESP,"MF,FW",Getafe,La Liga,25,1998,10.7,24,13,2,15,7,9,15,60.0,6,12,1,11,5,29,5,0,Matches
2255,Damián Rodríguez,ESP,MF,Celta Vigo,La Liga,20,2003,2.9,6,3,1,3,2,1,3,33.3,2,4,2,2,1,7,2,0,Matches
2256,Dani Rodríguez,ESP,MF,Mallorca,La Liga,35,1988,29.1,47,24,21,20,6,21,45,46.7,24,34,5,29,15,62,21,0,Matches
2257,Guido Rodríguez,ARG,MF,Betis,La Liga,29,1994,20.5,53,30,21,24,8,34,55,61.8,21,27,6,21,29,82,44,0,Matches
2258,Jay Rodriguez,ENG,FW,Burnley,Premier League,34,1989,9.1,14,9,7,4,3,7,13,53.8,6,11,1,10,1,15,8,0,Matches
2259,Kirian Rodríguez,ESP,MF,Las Palmas,La Liga,27,1996,35.7,52,32,22,25,5,24,67,35.8,43,39,3,36,28,80,23,1,Matches
2260,Miguel Rodríguez,ESP,MF,Celta Vigo,La Liga,20,2003,3.3,6,3,3,1,2,3,9,33.3,6,8,0,8,4,10,0,0,Matches
2261,Ricardo Rodríguez,SUI,DF,Torino,Serie A,30,1992,30.8,45,26,21,22,2,28,45,62.2,17,22,9,13,24,69,64,2,Matches
2262,Rodrygo,BRA,FW,Real Madrid,La Liga,22,2001,26.4,16,15,2,9,5,5,19,26.3,14,14,0,14,8,24,6,0,Matches
2263,Mads Roerslev,DEN,DF,Brentford,Premier League,24,1999,22.1,48,31,34,9,5,27,54,50.0,27,15,3,12,19,67,71,0,Matches
2264,Rogério,BRA,DF,Wolfsburg,Bundesliga,25,1998,10.1,14,6,7,5,2,10,14,71.4,4,16,5,11,5,19,23,1,Matches
2265,Morgan Rogers,ENG,"MF,FW",Aston Villa,Premier League,21,2002,7.1,8,1,3,2,3,2,11,18.2,9,11,0,11,3,11,11,0,Matches
2266,Merlin Röhl,GER,"MF,FW",Freiburg,Bundesliga,21,2002,16.4,21,13,10,9,2,8,21,38.1,13,27,3,24,9,30,22,0,Matches
2267,Alessio Romagnoli,ITA,DF,Lazio,Serie A,28,1995,26.8,25,18,14,11,0,16,24,66.7,8,29,17,12,29,54,115,0,Matches
2268,Simone Romagnoli,ITA,DF,Frosinone,Serie A,33,1990,30.2,35,15,23,11,1,15,20,75.0,5,51,36,15,29,64,147,0,Matches
2269,Carlos Romero,ESP,DF,Villarreal,La Liga,21,2001,2.9,11,5,8,1,2,7,12,58.3,5,3,0,3,1,12,11,0,Matches
2270,Cristian Romero,ARG,DF,Tottenham,Premier League,25,1998,31.0,66,40,35,25,6,32,44,72.7,12,46,22,24,44,110,106,1,Matches
2271,Isaac Romero,ESP,FW,Sevilla,La Liga,23,2000,11.5,6,3,2,2,2,5,9,55.6,4,12,0,12,0,6,11,0,Matches
2272,Luka Romero,ARG,"FW,MF",Milan,Serie A,18,2004,1.0,0,0,0,0,0,0,3,0.0,3,2,0,2,0,0,0,0,Matches
2273,Luka Romero,ARG,FW,Almería,La Liga,18,2004,4.9,5,1,2,3,0,2,4,50.0,2,12,1,11,1,6,2,1,Matches
2274,Oriol Romeu,ESP,MF,Barcelona,La Liga,31,1991,10.4,34,20,17,14,3,13,24,54.2,11,12,2,10,10,44,18,0,Matches
2275,Valentin Rongier,FRA,MF,Marseille,Ligue 1,28,1994,9.5,23,12,9,12,2,14,26,53.8,12,16,4,12,15,38,18,0,Matches
2276,Frank Ronstadt,GER,"DF,MF",Darmstadt 98,Bundesliga,26,1997,0.8,1,0,0,1,0,0,1,0.0,1,1,0,1,1,2,3,0,Matches
2277,Marten de Roon,NED,"MF,DF",Atalanta,Serie A,32,1991,28.9,80,43,36,32,12,35,82,42.7,47,36,10,26,40,120,54,0,Matches
2278,Unai Ropero,ESP,MF,Alavés,La Liga,21,2001,0.1,0,0,0,0,0,0,0,,0,0,0,0,0,0,0,0,Matches
2279,Vitor Roque,BRA,FW,Barcelona,La Liga,18,2005,3.6,3,2,2,0,1,0,2,0.0,2,3,0,3,0,3,5,0,Matches
2280,Pablo Rosario,NED,"MF,DF",Nice,Ligue 1,26,1997,22.3,36,25,15,16,5,23,34,67.6,11,27,13,14,29,65,39,0,Matches
2281,Valentin Rosier,FRA,"DF,MF",Nice,Ligue 1,26,1996,0.6,1,0,1,0,0,0,0,,0,1,0,1,2,3,5,0,Matches
2282,Francesco Rossi,ITA,GK,Atalanta,Serie A,32,1991,0.1,0,0,0,0,0,0,0,,0,0,0,0,0,0,0,0,Matches
2283,Joe Rothwell,ENG,MF,Bournemouth,Premier League,28,1995,4.3,7,2,4,2,1,2,8,25.0,6,4,2,2,3,10,2,0,Matches
2284,Anthony Rouault,FRA,DF,Stuttgart,Bundesliga,22,2001,11.2,21,12,14,5,2,13,21,61.9,8,14,8,6,8,29,28,0,Matches
2285,Jérôme Roussillon,FRA,DF,Union Berlin,Bundesliga,30,1993,8.4,16,9,6,7,3,8,12,66.7,4,13,4,9,5,21,26,0,Matches
2286,Nicolò Rovella,ITA,MF,Lazio,Serie A,21,2001,14.6,46,28,25,17,4,16,36,44.4,20,27,6,21,23,69,29,0,Matches
2287,Amir Rrahmani,KVX,DF,Napoli,Serie A,29,1994,28.9,33,27,17,14,2,16,32,50.0,16,24,10,14,20,53,90,0,Matches
2288,Ruan,BRA,DF,Sassuolo,Serie A,24,1999,16.8,25,15,11,10,4,10,18,55.6,8,18,15,3,24,49,68,2,Matches
2289,Pelly Ruddock Mpanzu,COD,MF,Luton Town,Premier League,30,1993,12.2,13,5,6,6,1,5,9,55.6,4,15,7,8,9,22,16,3,Matches
2290,Antonio Rüdiger,GER,DF,Real Madrid,La Liga,30,1993,30.1,26,15,18,4,4,16,20,80.0,4,27,20,7,11,37,89,0,Matches
2291,Fabian Rüdlin,GER,MF,Freiburg,Bundesliga,26,1997,0.1,1,0,0,0,1,0,0,,0,0,0,0,0,1,0,0,Matches
2292,Javier Rueda Garcia,ESP,"MF,DF",Celta Vigo,La Liga,21,2002,0.2,0,0,0,0,0,0,0,,0,0,0,0,0,0,0,0,Matches
2293,Daniele Rugani,ITA,DF,Juventus,Serie A,29,1994,13.2,11,9,7,3,1,4,5,80.0,1,11,4,7,9,20,42,0,Matches
2294,Matteo Ruggeri,ITA,DF,Atalanta,Serie A,21,2002,27.2,29,15,14,7,8,16,30,53.3,14,46,4,42,23,52,44,0,Matches
2295,Mário Rui,POR,DF,Napoli,Serie A,32,1991,13.4,27,15,17,5,5,14,21,66.7,7,17,2,15,15,42,19,0,Matches
2296,Aitor Ruibal,ESP,"DF,FW",Betis,La Liga,27,1996,11.3,46,27,28,13,5,32,59,54.2,27,12,1,11,14,60,33,1,Matches
2297,Fabián Ruiz Peña,ESP,MF,Paris S-G,Ligue 1,27,1996,13.3,34,23,17,14,3,23,42,54.8,19,8,2,6,11,45,21,2,Matches
2298,Sergio Ruiz,ESP,MF,Granada,La Liga,28,1994,27.7,83,46,43,36,4,38,84,45.2,46,24,6,18,28,111,43,1,Matches
2299,Julian Ryerson,NOR,DF,Dortmund,Bundesliga,25,1997,19.6,41,23,26,11,4,27,47,57.4,20,31,7,24,10,51,35,3,Matches
2300,Frederik Rønnow,DEN,GK,Union Berlin,Bundesliga,30,1992,33.0,1,1,1,0,0,0,0,,0,0,0,0,1,2,20,2,Matches
2301,José Sá,POR,GK,Wolves,Premier League,30,1993,33.7,0,0,0,0,0,0,1,0.0,1,3,0,3,0,0,21,5,Matches
2302,Youssouf Sabaly,SEN,DF,Betis,La Liga,30,1993,11.6,16,11,12,3,1,8,12,66.7,4,6,3,3,11,27,27,0,Matches
2303,Emmanuel Sabbi,USA,"FW,MF",Le Havre,Ligue 1,25,1997,17.6,38,19,15,15,8,16,39,41.0,23,26,2,24,19,57,7,0,Matches
2304,Stefano Sabelli,ITA,DF,Genoa,Serie A,30,1993,27.0,50,24,28,19,3,15,46,32.6,31,27,6,21,23,73,35,0,Matches
2305,Marcel Sabitzer,AUT,MF,Dortmund,Bundesliga,29,1994,21.8,39,24,18,20,1,23,42,54.8,19,31,12,19,12,51,34,0,Matches
2306,Falaye Sacko,MLI,DF,Montpellier,Ligue 1,28,1995,15.4,28,16,13,10,5,21,32,65.6,11,19,7,12,24,52,37,0,Matches
2307,Dominic Sadi,ENG,FW,Bournemouth,Premier League,19,2003,0.0,0,0,0,0,0,0,0,,0,0,0,0,0,0,0,0,Matches
2308,Umar Sadiq,NGA,FW,Real Sociedad,La Liga,26,1997,12.0,15,10,2,8,5,4,8,50.0,4,9,0,9,0,15,10,0,Matches
2309,Alexis Saelemaekers,BEL,"FW,MF",Bologna,Serie A,24,1999,21.0,32,22,13,14,5,12,27,44.4,15,13,1,12,13,45,10,1,Matches
2310,Pablo Saenz,ESP,MF,Granada,La Liga,22,2001,0.2,3,3,2,0,1,1,3,33.3,2,0,0,0,0,3,0,0,Matches
2311,Modibo Sagnan,MLI,DF,Montpellier,Ligue 1,24,1999,11.7,34,22,23,9,2,15,25,60.0,10,13,9,4,15,49,67,0,Matches
2312,Wesley Saïd,FRA,"FW,MF",Lens,Ligue 1,28,1995,11.3,8,4,1,2,5,2,9,22.2,7,4,0,4,4,12,3,0,Matches
2313,Théo Sainte-Luce,FRA,DF,Montpellier,Ligue 1,24,1998,3.8,17,7,10,6,1,11,19,57.9,8,9,4,5,3,20,15,0,Matches
2314,Bukayo Saka,ENG,FW,Arsenal,Premier League,21,2001,32.4,66,35,22,24,20,26,59,44.1,33,43,2,41,15,81,24,1,Matches
2315,Mamadou Sakho,FRA,DF,Montpellier,Ligue 1,33,1990,0.1,1,1,1,0,0,1,1,100.0,0,0,0,0,0,1,1,0,Matches
2316,Ibrahim Salah,MAR,"FW,MF",Rennes,Ligue 1,21,2001,5.8,15,7,5,6,4,11,18,61.1,7,4,0,4,10,25,5,0,Matches
2317,Mohamed Salah,EGY,FW,Liverpool,Premier League,31,1992,28.2,17,11,1,8,8,6,21,28.6,15,19,1,18,2,19,1,0,Matches
2318,Amine Salama,FRA,FW,Reims,Ligue 1,23,2000,3.5,0,0,0,0,0,0,0,,0,1,0,1,1,1,1,0,Matches
2319,Kike Salas,ESP,DF,Sevilla,La Liga,21,2002,17.8,41,23,26,12,3,22,36,61.1,14,25,14,11,26,67,91,1,Matches
2320,William Saliba,FRA,DF,Arsenal,Premier League,22,2001,38.0,41,26,28,12,1,20,27,74.1,7,32,17,15,29,70,81,3,Matches
2321,Mohammed Salisu,GHA,DF,Monaco,Ligue 1,24,1999,11.5,27,12,11,13,3,17,26,65.4,9,21,12,9,22,49,44,0,Matches
2322,Roland Sallai,HUN,"MF,FW",Freiburg,Bundesliga,26,1997,20.4,17,10,5,5,7,8,20,40.0,12,21,1,20,6,23,23,0,Matches
2323,Yoann Salmier,GUF,DF,Le Havre,Ligue 1,30,1992,17.4,22,10,13,6,3,13,20,65.0,7,21,15,6,21,43,57,0,Matches
2324,Salvi,ESP,MF,Rayo Vallecano,La Liga,32,1991,0.3,0,0,0,0,0,0,4,0.0,4,0,0,0,1,1,0,0,Matches
2325,Lazar Samardzic,SRB,MF,Udinese,Serie A,21,2002,26.4,40,19,18,18,4,16,39,41.0,23,26,6,20,10,50,25,0,Matches
2326,Diadie Samassékou,MLI,MF,Cádiz,La Liga,27,1996,1.0,5,3,2,2,1,5,6,83.3,1,0,0,0,3,8,1,0,Matches
2327,Diadie Samassékou,MLI,MF,Hoffenheim,Bundesliga,27,1996,0.0,0,0,0,0,0,0,0,,0,0,0,0,1,1,0,0,Matches
2328,Mama Samba Baldé,GNB,"FW,MF",Lyon,Ligue 1,27,1995,6.1,8,5,1,2,5,3,9,33.3,6,0,0,0,3,11,1,1,Matches
2329,Brice Samba,FRA,GK,Lens,Ligue 1,29,1994,33.0,1,1,1,0,0,1,1,100.0,0,0,0,0,0,1,10,3,Matches
2330,Albert Sambi Lokonga,BEL,MF,Luton Town,Premier League,23,1999,14.5,29,18,14,12,3,17,24,70.8,7,23,13,10,11,40,14,0,Matches
2331,Junior Sambia,FRA,"DF,MF",Salernitana,Serie A,26,1996,11.5,12,5,8,1,3,6,11,54.5,5,15,7,8,11,23,28,0,Matches
2332,Fede San Emeterio,ESP,MF,Cádiz,La Liga,26,1997,1.7,3,2,2,1,0,1,4,25.0,3,3,2,1,2,5,1,0,Matches
2333,Antonio Sanabria,PAR,"FW,MF",Torino,Serie A,27,1996,23.7,18,15,5,9,4,4,9,44.4,5,7,1,6,6,24,12,0,Matches
2334,Oihan Sancet,ESP,MF,Athletic Club,La Liga,23,2000,21.9,19,11,3,10,6,8,21,38.1,13,5,1,4,10,29,5,0,Matches
2335,Renato Sanches,POR,MF,Roma,Serie A,25,1997,1.6,2,1,1,1,0,2,3,66.7,1,2,0,2,0,2,1,0,Matches
2336,Ricard Sánchez,ESP,DF,Granada,La Liga,23,2000,25.5,29,18,15,8,6,12,24,50.0,12,32,4,28,13,42,64,0,Matches
2337,Alexis Sánchez,CHI,"FW,MF",Inter,Serie A,34,1988,8.5,7,6,0,5,2,1,4,25.0,3,4,1,3,1,8,3,0,Matches
2338,Antonio Sánchez,ESP,MF,Mallorca,La Liga,26,1997,16.1,25,11,13,10,2,11,32,34.4,21,24,5,19,13,38,13,0,Matches
2339,Davinson Sánchez,COL,DF,Tottenham,Premier League,27,1996,0.9,0,0,0,0,0,0,0,,0,3,2,1,1,1,2,0,Matches
2340,Juanlu Sánchez,ESP,DF,Sevilla,La Liga,19,2003,13.1,56,35,34,18,4,34,58,58.6,24,24,7,17,12,68,36,0,Matches
2341,Manu Sánchez,ESP,"DF,MF",Celta Vigo,La Liga,22,2000,19.7,54,28,21,25,8,31,55,56.4,24,23,3,20,19,73,65,0,Matches
2342,Robert Sánchez,ESP,GK,Chelsea,Premier League,25,1997,15.9,0,0,0,0,0,0,0,,0,0,0,0,0,0,11,3,Matches
2343,Jadon Sancho,ENG,"FW,MF",Manchester Utd,Premier League,23,2000,0.9,1,0,1,0,0,1,3,33.3,2,1,0,1,1,2,0,0,Matches
2344,Jadon Sancho,ENG,"FW,MF",Dortmund,Bundesliga,23,2000,10.5,5,4,1,3,1,0,4,0.0,4,11,0,11,4,9,6,0,Matches
2345,Alex Sandro,BRA,DF,Juventus,Serie A,32,1991,8.0,13,7,7,6,0,4,5,80.0,1,13,7,6,15,28,23,0,Matches
2346,Ibou Sané,SEN,"MF,FW",Metz,Ligue 1,18,2005,1.4,6,4,2,1,3,2,2,100.0,0,3,0,3,1,7,2,0,Matches
2347,Leroy Sané,GER,FW,Bayern Munich,Bundesliga,27,1996,23.7,15,8,6,6,3,4,19,21.1,15,12,0,12,7,22,3,0,Matches
2348,Sadibou Sané,SEN,DF,Metz,Ligue 1,19,2004,9.4,19,12,16,2,1,6,7,85.7,1,14,9,5,8,27,64,0,Matches
2349,Arouna Sangante,SEN,DF,Le Havre,Ligue 1,21,2002,29.9,53,33,27,23,3,24,40,60.0,16,35,18,17,66,119,93,2,Matches
2350,Ibrahim Sangaré,CIV,MF,Nott'ham Forest,Premier League,25,1997,11.5,42,23,25,13,4,12,29,41.4,17,24,7,17,16,58,21,0,Matches
2351,Morgan Sanson,FRA,MF,Nice,Ligue 1,28,1994,21.8,26,19,12,7,7,12,31,38.7,19,34,5,29,20,46,16,0,Matches
2352,Nicola Sansone,ITA,"FW,MF",Lecce,Serie A,31,1991,8.5,11,6,6,2,3,5,16,31.3,11,7,1,6,4,15,5,2,Matches
2353,Baptiste Santamaria,FRA,MF,Rennes,Ligue 1,28,1995,21.4,52,33,21,25,6,29,46,63.0,17,15,6,9,34,86,33,1,Matches
2354,Jesús Santiago,ESP,MF,Getafe,La Liga,19,2004,7.3,17,8,8,5,4,4,7,57.1,3,3,0,3,0,17,8,0,Matches
2355,Andrey Santos,BRA,MF,Nott'ham Forest,Premier League,19,2004,0.1,0,0,0,0,0,0,0,,0,1,0,1,0,0,0,0,Matches
2356,Andrey Santos,BRA,MF,Strasbourg,Ligue 1,19,2004,9.2,29,18,15,13,1,17,26,65.4,9,8,0,8,10,39,11,1,Matches
2357,Tiago Santos,POR,DF,Lille,Ligue 1,21,2002,26.3,63,42,31,19,13,30,52,57.7,22,24,5,19,15,78,37,0,Matches
2358,Paco Sanz,ESP,DF,Almería,La Liga,18,2004,0.3,0,0,0,0,0,0,1,0.0,1,0,0,0,0,0,4,0,Matches
2359,Riccardo Saponara,ITA,"FW,MF",Hellas Verona,Serie A,31,1991,3.8,3,1,2,0,1,1,7,14.3,6,4,0,4,0,3,2,0,Matches
2360,Pablo Sarabia,ESP,"MF,FW",Wolves,Premier League,31,1992,19.4,20,13,8,8,4,12,36,33.3,24,17,1,16,10,30,9,0,Matches
2361,Amin Sarr,SWE,"FW,MF",Lyon,Ligue 1,22,2001,1.1,1,0,0,1,0,0,0,,0,1,0,1,0,1,1,0,Matches
2362,Amin Sarr,SWE,"FW,MF",Wolfsburg,Bundesliga,22,2001,4.3,3,2,1,2,0,1,2,50.0,1,6,1,5,2,5,1,0,Matches
2363,Bouna Sarr,SEN,DF,Bayern Munich,Bundesliga,31,1992,1.2,2,0,1,1,0,2,2,100.0,0,3,0,3,0,2,1,0,Matches
2364,Ismaila Sarr,SEN,"FW,MF",Marseille,Ligue 1,25,1998,16.1,14,8,2,10,2,6,17,35.3,11,21,6,15,13,27,11,0,Matches
2365,Mamadou Sarr,FRA,DF,Lyon,Ligue 1,17,2005,0.1,0,0,0,0,0,0,0,,0,0,0,0,0,0,0,0,Matches
2366,Martin Satriano,URU,FW,Brest,Ligue 1,22,2001,20.7,24,16,6,13,5,10,25,40.0,15,19,7,12,7,31,28,0,Matches
2367,Téji Savanier,FRA,MF,Montpellier,Ligue 1,31,1991,30.7,37,20,16,15,6,14,63,22.2,49,36,8,28,33,70,28,1,Matches
2368,Stefan Savić,MNE,DF,Atlético Madrid,La Liga,32,1991,18.1,27,19,16,7,4,15,30,50.0,15,29,15,14,27,54,61,1,Matches
2369,Sávio,BRA,"FW,MF",Girona,La Liga,19,2004,33.1,42,25,14,22,6,16,28,57.1,12,34,0,34,18,60,11,1,Matches
2370,Zanos Savva,CYP,"DF,MF",Torino,Serie A,17,2005,0.3,1,1,0,1,0,1,3,33.3,2,0,0,0,0,1,1,0,Matches
2371,Saba Sazonov,GEO,DF,Torino,Serie A,21,2002,4.0,9,7,4,5,0,3,3,100.0,0,8,5,3,3,12,22,0,Matches
2372,Joe Scally,USA,DF,Gladbach,Bundesliga,20,2002,24.8,41,28,21,17,3,23,40,57.5,17,31,11,20,18,59,78,2,Matches
2373,Giorgio Scalvini,ITA,DF,Atalanta,Serie A,19,2003,28.3,53,33,29,19,5,19,40,47.5,21,44,17,27,59,112,71,0,Matches
2374,Gianluca Scamacca,ITA,FW,Atalanta,Serie A,24,1999,16.1,15,9,4,5,6,7,14,50.0,7,7,1,6,4,19,9,0,Matches
2375,Dane Scarlett,ENG,FW,Tottenham,Premier League,19,2004,0.2,1,1,0,0,1,0,1,0.0,1,0,0,0,0,1,0,0,Matches
2376,Kevin Schade,GER,"FW,MF",Brentford,Premier League,21,2001,3.7,3,1,1,2,0,0,5,0.0,5,2,0,2,1,4,4,0,Matches
2377,András Schäfer,HUN,MF,Union Berlin,Bundesliga,24,1999,13.5,29,16,9,15,5,11,20,55.0,9,25,4,21,20,49,25,0,Matches
2378,Fabian Schär,SUI,DF,Newcastle Utd,Premier League,31,1991,33.9,42,24,27,13,2,18,40,45.0,22,50,38,12,36,78,133,1,Matches
2379,Patrik Schick,CZE,FW,Leverkusen,Bundesliga,27,1996,11.8,6,4,0,3,3,1,5,20.0,4,2,0,2,1,7,7,0,Matches
2380,Stefan Schimmer,GER,"MF,FW",Heidenheim,Bundesliga,29,1994,1.7,1,1,0,1,0,0,3,0.0,3,2,0,2,1,2,6,0,Matches
2381,Xaver Schlager,AUT,MF,RB Leipzig,Bundesliga,25,1997,27.5,81,50,35,38,8,21,53,39.6,32,41,8,33,19,100,27,0,Matches
2382,Keven Schlotterbeck,GER,DF,Bochum,Bundesliga,26,1997,24.3,42,22,26,14,2,25,30,83.3,5,33,23,10,33,75,104,2,Matches
2383,Nico Schlotterbeck,GER,DF,Dortmund,Bundesliga,23,1999,31.8,70,50,36,27,7,41,65,63.1,24,52,25,27,45,115,101,3,Matches
2384,Jeffrey Schlupp,GHA,"FW,MF",Crystal Palace,Premier League,30,1992,15.0,38,24,14,16,8,9,18,50.0,9,13,2,11,8,46,24,0,Matches
2385,Romano Schmid,AUT,"MF,FW",Werder Bremen,Bundesliga,23,2000,28.9,35,20,7,22,6,14,46,30.4,32,36,7,29,11,46,17,2,Matches
2386,Kenneth Schmidt,GER,DF,Freiburg,Bundesliga,21,2002,0.8,2,2,2,0,0,2,4,50.0,2,1,0,1,1,3,2,0,Matches
2387,Niklas Schmidt,GER,MF,Toulouse,Ligue 1,25,1998,14.1,36,21,13,19,4,16,33,48.5,17,14,7,7,4,40,13,0,Matches
2388,Benno Schmitz,GER,DF,Köln,Bundesliga,28,1994,12.8,27,15,20,7,0,17,34,50.0,17,19,4,15,7,34,29,0,Matches
2389,Fabian Schnellhardt,GER,MF,Darmstadt 98,Bundesliga,29,1994,2.6,4,1,2,1,1,1,3,33.3,2,1,0,1,4,8,5,0,Matches
2390,Jan Schöppner,GER,MF,Heidenheim,Bundesliga,24,1999,22.2,48,26,26,20,2,21,42,50.0,21,37,7,30,26,74,57,0,Matches
2391,Marcel Schuhen,GER,GK,Darmstadt 98,Bundesliga,30,1993,31.0,1,0,1,0,0,1,3,33.3,2,0,0,0,2,3,11,4,Matches
2392,Perr Schuurs,NED,DF,Torino,Serie A,23,1999,8.6,20,12,11,8,1,3,9,33.3,6,10,2,8,9,29,23,0,Matches
2393,Marvin Schwäbe,GER,GK,Köln,Bundesliga,28,1995,34.0,1,0,1,0,0,1,1,100.0,0,0,0,0,0,1,10,1,Matches
2394,Alexander Schwolow,GER,GK,Union Berlin,Bundesliga,31,1992,1.0,0,0,0,0,0,0,0,,0,0,0,0,0,0,2,0,Matches
2395,Alex Scott,ENG,MF,Bournemouth,Premier League,19,2003,11.3,24,15,8,10,6,12,28,42.9,16,14,4,10,12,36,18,2,Matches
2396,Simone Scuffet,ITA,GK,Cagliari,Serie A,27,1996,31.0,1,0,1,0,0,1,2,50.0,1,1,0,1,1,2,9,0,Matches
2397,Jérémy Sebas,MTQ,"FW,MF",Strasbourg,Ligue 1,20,2003,4.4,7,1,2,3,2,3,5,60.0,2,3,1,2,1,8,1,0,Matches
2398,Demba Seck,SEN,MF,Torino,Serie A,22,2001,4.7,5,3,1,4,0,3,4,75.0,1,1,0,1,1,6,0,0,Matches
2399,Demba Seck,SEN,"FW,MF",Frosinone,Serie A,22,2001,3.3,7,4,2,3,2,4,5,80.0,1,3,0,3,1,8,1,0,Matches
2400,Aleksandar Sedlar,SRB,DF,Alavés,La Liga,31,1991,10.5,14,10,10,4,0,10,16,62.5,6,8,4,4,13,27,43,0,Matches
2401,Alidu Seidu,GHA,DF,Rennes,Ligue 1,23,2000,6.6,21,9,17,3,1,14,19,73.7,5,11,3,8,10,31,13,0,Matches
2402,Alidu Seidu,GHA,DF,Clermont Foot,Ligue 1,23,2000,12.6,32,24,17,15,0,24,31,77.4,7,15,7,8,25,57,37,0,Matches
2403,Nicolas Seiwald,AUT,MF,RB Leipzig,Bundesliga,22,2001,8.0,33,18,16,15,2,16,25,64.0,9,12,2,10,8,41,15,0,Matches
2404,Nikola Sekulov,ITA,FW,Juventus,Serie A,21,2002,0.1,0,0,0,0,0,0,0,,0,0,0,0,0,0,0,0,Matches
2405,Davie Selke,GER,FW,Köln,Bundesliga,28,1995,14.1,4,2,1,3,0,0,2,0.0,2,5,3,2,0,4,20,0,Matches
2406,Matz Sels,BEL,GK,Nott'ham Forest,Premier League,31,1992,16.0,0,0,0,0,0,0,0,,0,0,0,0,0,0,11,1,Matches
2407,Matz Sels,BEL,GK,Strasbourg,Ligue 1,31,1992,19.0,0,0,0,0,0,0,0,,0,2,0,2,0,0,13,1,Matches
2408,Nélson Semedo,POR,"DF,MF",Wolves,Premier League,29,1993,34.3,79,48,52,19,8,38,64,59.4,26,44,8,36,36,115,85,1,Matches
2409,Vivaldo Semedo,POR,FW,Udinese,Serie A,18,2005,0.1,0,0,0,0,0,0,0,,0,0,0,0,0,0,0,0,Matches
2410,Antoine Semenyo,GHA,FW,Bournemouth,Premier League,23,2000,23.4,24,17,7,9,8,9,27,33.3,18,39,2,37,6,30,21,0,Matches
2411,Marvin Senaya,TOG,"DF,MF",Strasbourg,Ligue 1,22,2001,23.8,72,53,38,25,9,42,68,61.8,26,40,13,27,41,113,68,0,Matches
2412,Marcos Senesi,ARG,DF,Bournemouth,Premier League,26,1997,24.9,55,32,28,23,4,24,56,42.9,32,50,23,27,35,90,109,1,Matches
2413,Stefano Sensi,ITA,MF,Inter,Serie A,27,1995,0.5,1,1,0,1,0,1,3,33.3,2,1,0,1,1,2,0,0,Matches
2414,Suat Serdar,GER,MF,Hellas Verona,Serie A,26,1997,18.4,51,39,24,23,4,22,45,48.9,23,29,7,22,20,71,25,1,Matches
2415,Benjamin Šeško,SVN,FW,RB Leipzig,Bundesliga,20,2003,17.0,13,5,2,7,4,2,9,22.2,7,23,2,21,3,16,27,0,Matches
2416,Kevin Sessa,GER,"MF,FW",Heidenheim,Bundesliga,23,2000,11.2,17,10,9,6,2,7,16,43.8,9,12,1,11,4,21,17,0,Matches
2417,Aaron Seydel,GER,FW,Darmstadt 98,Bundesliga,27,1996,6.9,3,2,0,2,1,0,3,0.0,3,8,2,6,1,4,9,0,Matches
2418,Andres Sfait,ROU,"DF,MF",Salernitana,Serie A,18,2004,0.3,1,1,1,0,0,1,2,50.0,1,0,0,0,0,1,0,0,Matches
2419,Stephan El Shaarawy,ITA,"FW,DF",Roma,Serie A,30,1992,19.3,21,13,14,4,3,6,15,40.0,9,11,4,7,13,34,15,2,Matches
2420,Luke Shaw,ENG,DF,Manchester Utd,Premier League,28,1995,10.7,11,8,7,3,1,9,15,60.0,6,18,11,7,6,17,39,0,Matches
2421,James Shea,ENG,GK,Luton Town,Premier League,32,1991,0.2,0,0,0,0,0,0,0,,0,0,0,0,0,0,2,0,Matches
2422,Eldor Shomurodov,UZB,"FW,MF",Cagliari,Serie A,28,1995,10.4,11,4,2,6,3,6,10,60.0,4,5,0,5,4,15,4,0,Matches
2423,Steven Shpendi,ALB,"FW,MF",Empoli,Serie A,20,2003,4.6,0,0,0,0,0,0,4,0.0,4,2,1,1,1,1,0,0,Matches
2424,Sofiane Sidi Ali,FRA,MF,Marseille,Ligue 1,28,1995,0.2,2,0,0,2,0,1,2,50.0,1,1,0,1,2,4,0,0,Matches
2425,Vincent Sierro,SUI,MF,Toulouse,Ligue 1,27,1995,25.1,41,24,15,20,6,27,77,35.1,50,37,13,24,27,68,33,0,Matches
2426,Tim Siersleben,GER,DF,Heidenheim,Bundesliga,23,2000,10.1,27,11,21,6,0,8,20,40.0,12,16,10,6,21,48,29,1,Matches
2427,Kiliann Sildillia,FRA,DF,Freiburg,Bundesliga,21,2002,20.1,43,19,28,8,7,26,42,61.9,16,33,15,18,22,65,64,0,Matches
2428,André Silva,POR,FW,Real Sociedad,La Liga,27,1995,8.1,2,2,0,0,2,0,4,0.0,4,3,0,3,1,3,3,0,Matches
2429,Bernardo Silva,POR,"MF,FW",Manchester City,Premier League,28,1994,28.6,51,23,13,25,13,25,57,43.9,32,32,4,28,17,68,15,1,Matches
2430,Caio Henrique Oliveira Silva,BRA,DF,Monaco,Ligue 1,26,1997,6.9,13,7,3,7,3,6,9,66.7,3,8,2,6,6,19,9,0,Matches
2431,Fábio Silva,POR,FW,Wolves,Premier League,21,2002,2.9,7,4,3,4,0,2,3,66.7,1,1,0,1,2,9,0,0,Matches
2432,Rui Silva,POR,GK,Betis,La Liga,29,1994,27.5,0,0,0,0,0,0,3,0.0,3,0,0,0,1,1,13,1,Matches
2433,Thiago Silva,BRA,DF,Chelsea,Premier League,38,1984,28.1,29,15,22,6,1,20,34,58.8,14,33,24,9,26,55,153,4,Matches
2434,Marco Silvestri,ITA,GK,Udinese,Serie A,32,1991,17.0,0,0,0,0,0,0,3,0.0,3,1,0,1,0,0,5,3,Matches
2435,Mohamed Simakan,FRA,DF,RB Leipzig,Bundesliga,23,2000,23.8,48,29,28,19,1,32,44,72.7,12,36,14,22,29,77,69,0,Matches
2436,Giovanni Simeone,ARG,FW,Napoli,Serie A,28,1995,8.9,12,4,1,3,8,3,12,25.0,9,11,0,11,1,13,7,0,Matches
2437,Giuliano Simeone,ARG,FW,Alavés,La Liga,20,2002,7.0,7,5,2,3,2,5,17,29.4,12,10,0,10,5,12,3,0,Matches
2438,Jan-Carlo Simic,SRB,DF,Milan,Serie A,18,2005,1.6,1,1,1,0,0,0,0,,0,5,4,1,0,1,3,0,Matches
2439,Moses Simon,NGA,"FW,MF",Nantes,Ligue 1,28,1995,19.9,7,5,2,5,0,2,8,25.0,6,9,1,8,3,10,5,1,Matches
2440,Unai Simón,ESP,GK,Athletic Club,La Liga,26,1997,35.4,2,1,1,1,0,2,3,66.7,1,0,0,0,1,3,9,0,Matches
2441,Xavi Simons,NED,MF,RB Leipzig,Bundesliga,20,2003,29.5,30,17,10,11,9,15,31,48.4,16,23,0,23,16,46,4,0,Matches
2442,Wilfried Singo,CIV,DF,Monaco,Ligue 1,22,2000,24.3,34,25,18,14,2,17,26,65.4,9,27,14,13,51,85,81,2,Matches
2443,Luis Sinisterra,COL,"FW,MF",Bournemouth,Premier League,24,1999,7.8,23,12,9,10,4,9,16,56.3,7,18,0,18,8,31,4,0,Matches
2444,Daley Sinkgraven,NED,DF,Las Palmas,La Liga,28,1995,4.3,11,5,6,5,0,2,8,25.0,6,5,3,2,6,17,9,0,Matches
2445,Jailson Siqueira,BRA,"DF,MF",Celta Vigo,La Liga,27,1995,10.0,27,18,22,5,0,13,24,54.2,11,13,5,8,12,39,32,0,Matches
2446,Ayanda Sishuba,BEL,"MF,FW",Lens,Ligue 1,18,2005,0.7,3,1,0,2,1,1,2,50.0,1,1,0,1,0,3,0,0,Matches
2447,Ibrahima Sissoko,MLI,MF,Strasbourg,Ligue 1,25,1997,18.2,47,33,13,25,9,23,30,76.7,7,21,8,13,19,66,30,0,Matches
2448,Moussa Sissoko,FRA,MF,Nantes,Ligue 1,33,1989,20.2,27,16,13,8,6,12,25,48.0,13,8,2,6,12,39,31,0,Matches
2449,Antonio Sivera,ESP,GK,Alavés,La Liga,26,1996,34.0,0,0,0,0,0,0,1,0.0,1,0,0,0,0,0,17,1,Matches
2450,Tim Skarke,GER,"FW,DF",Darmstadt 98,Bundesliga,26,1996,26.7,26,16,12,10,4,10,28,35.7,18,25,2,23,6,32,20,0,Matches
2451,Ellyes Skhiri,TUN,MF,Eint Frankfurt,Bundesliga,28,1995,24.1,44,24,18,19,7,19,36,52.8,17,33,4,29,39,83,47,2,Matches
2452,Oliver Skipp,ENG,"MF,DF",Tottenham,Premier League,22,2000,7.9,18,12,9,6,3,11,18,61.1,7,12,1,11,3,21,9,0,Matches
2453,Leo Skiri Østigård,NOR,DF,Napoli,Serie A,23,1999,18.1,24,12,13,10,1,6,11,54.5,5,18,12,6,16,40,65,0,Matches
2454,Łukasz Skorupski,POL,GK,Bologna,Serie A,32,1991,32.0,2,2,2,0,0,2,3,66.7,1,0,0,0,1,3,11,3,Matches
2455,Robert Skov,DEN,"DF,FW",Hoffenheim,Bundesliga,27,1996,14.0,24,16,15,8,1,17,36,47.2,19,17,4,13,10,34,23,1,Matches
2456,Milan Škriniar,SVK,DF,Paris S-G,Ligue 1,28,1995,18.1,24,18,17,7,0,14,22,63.6,8,19,10,9,12,36,51,2,Matches
2457,Naatan Skyttä,FIN,"MF,FW",Toulouse,Ligue 1,21,2002,1.3,4,4,2,1,1,1,1,100.0,0,0,0,0,0,4,0,0,Matches
2458,Chris Smalling,ENG,DF,Roma,Serie A,33,1989,4.3,1,1,1,0,0,1,4,25.0,3,6,5,1,5,6,8,0,Matches
2459,Adam Smith,ENG,DF,Bournemouth,Premier League,32,1991,23.9,37,23,18,11,8,19,39,48.7,20,28,11,17,21,58,62,0,Matches
2460,Emile Smith Rowe,ENG,MF,Arsenal,Premier League,23,2000,3.9,4,1,2,2,0,2,4,50.0,2,3,1,2,3,7,1,0,Matches
2461,Hrvoje Smolčić,CRO,DF,Eint Frankfurt,Bundesliga,22,2000,3.9,7,3,7,0,0,4,5,80.0,1,3,1,2,6,13,23,1,Matches
2462,Cédric Soares,POR,DF,Arsenal,Premier League,31,1991,0.7,0,0,0,0,0,0,0,,0,0,0,0,0,0,0,0,Matches
2463,Danilo Soares,BRA,DF,Bochum,Bundesliga,31,1991,3.9,10,6,5,3,2,5,8,62.5,3,6,0,6,7,17,11,0,Matches
2464,Eduard Sobol,UKR,DF,Strasbourg,Ligue 1,28,1995,0.3,0,0,0,0,0,0,0,,0,0,0,0,0,0,1,0,Matches
2465,Rubén Sobrino,ESP,"MF,FW",Cádiz,La Liga,31,1992,18.3,52,28,18,26,8,22,51,43.1,29,26,2,24,16,68,18,0,Matches
2466,Andrea Sodero,ITA,MF,Empoli,Serie A,18,2004,0.1,0,0,0,0,0,0,0,,0,0,0,0,0,0,0,0,Matches
2467,Emran Soglo,ENG,"MF,DF",Marseille,Ligue 1,18,2005,1.2,2,1,0,2,0,1,3,33.3,2,6,0,6,1,3,3,0,Matches
2468,Alex Sola,ESP,"FW,MF",Alavés,La Liga,24,1999,14.0,27,15,11,9,7,14,26,53.8,12,18,2,16,11,38,16,0,Matches
2469,Alex Sola,ESP,"DF,MF",Real Sociedad,La Liga,24,1999,0.3,0,0,0,0,0,0,0,,0,0,0,0,1,1,2,0,Matches
2470,Dominic Solanke,ENG,FW,Bournemouth,Premier League,25,1997,36.9,23,11,3,13,7,10,29,34.5,19,24,5,19,7,30,43,0,Matches
2471,Ola Solbakken,NOR,FW,Roma,Serie A,24,1998,0.3,0,0,0,0,0,0,0,,0,0,0,0,0,0,0,0,Matches
2472,Carlos Soler,ESP,"MF,DF",Paris S-G,Ligue 1,26,1997,12.1,15,10,9,2,4,6,21,28.6,15,10,3,7,5,20,11,1,Matches
2473,Jhon Solis,COL,MF,Girona,La Liga,18,2004,4.3,10,8,4,5,1,4,12,33.3,8,8,3,5,8,18,7,1,Matches
2474,Manor Solomon,ISR,FW,Tottenham,Premier League,24,1999,2.2,3,3,1,1,1,1,2,50.0,1,4,0,4,3,6,2,0,Matches
2475,Daniele Sommariva,ITA,GK,Genoa,Serie A,26,1997,0.1,0,0,0,0,0,0,0,,0,0,0,0,0,0,0,0,Matches
2476,Yann Sommer,SUI,GK,Inter,Serie A,34,1988,34.0,2,1,2,0,0,2,2,100.0,0,1,0,1,0,2,7,1,Matches
2477,Brandon Soppy,FRA,DF,Torino,Serie A,21,2002,2.0,2,2,1,1,0,2,6,33.3,4,2,0,2,0,2,3,1,Matches
2478,David Soria,ESP,GK,Getafe,La Liga,30,1993,37.9,0,0,0,0,0,0,2,0.0,2,0,0,0,0,0,21,6,Matches
2479,Alberto Soro,ESP,MF,Granada,La Liga,24,1999,0.1,0,0,0,0,0,0,0,,0,0,0,0,0,0,0,0,Matches
2480,Alessandro Sorrentino,ITA,GK,Monza,Serie A,21,2002,6.1,0,0,0,0,0,0,0,,0,0,0,0,0,0,0,0,Matches
2481,Borna Sosa,CRO,"FW,DF",Stuttgart,Bundesliga,25,1998,0.5,0,0,0,0,0,0,1,0.0,1,0,0,0,0,0,0,0,Matches
2482,Hugo Sotelo,ESP,MF,Celta Vigo,La Liga,19,2003,8.0,19,17,3,13,3,8,20,40.0,12,7,1,6,2,21,5,0,Matches
2483,Florian Sotoca,FRA,"MF,FW",Lens,Ligue 1,32,1990,28.9,33,22,9,21,3,17,38,44.7,21,41,4,37,20,53,34,0,Matches
2484,Riccardo Sottil,ITA,FW,Fiorentina,Serie A,24,1999,12.3,10,5,5,1,4,3,8,37.5,5,12,0,12,2,12,2,0,Matches
2485,Tomáš Souček,CZE,MF,West Ham,Premier League,28,1995,31.9,53,35,24,26,3,21,47,44.7,26,55,28,27,37,90,109,0,Matches
2486,Matìas Soulé,ARG,"FW,MF",Frosinone,Serie A,20,2003,34.7,41,27,12,14,15,19,40,47.5,21,38,4,34,18,59,9,0,Matches
2487,Boubakary Soumaré,FRA,MF,Sevilla,La Liga,24,1999,25.4,39,28,24,14,1,14,26,53.8,12,25,7,18,26,65,20,1,Matches
2488,Issa Soumaré,SEN,"FW,MF",Le Havre,Ligue 1,22,2000,2.6,2,0,2,0,0,0,4,0.0,4,0,0,0,0,2,2,0,Matches
2489,Vinicius Souza,BRA,MF,Sheffield Utd,Premier League,24,1999,29.6,125,76,59,51,15,41,74,55.4,33,57,17,40,32,157,75,1,Matches
2490,Djibril Sow,SUI,MF,Sevilla,La Liga,26,1997,16.2,28,21,15,8,5,9,25,36.0,16,20,3,17,17,45,8,1,Matches
2491,Saidou Sow,GUI,DF,Strasbourg,Ligue 1,21,2002,8.0,20,12,17,3,0,9,13,69.2,4,7,4,3,12,32,36,3,Matches
2492,Çağlar Söyüncü,TUR,DF,Atlético Madrid,La Liga,27,1996,1.3,1,1,1,0,0,0,0,,0,1,0,1,1,2,7,0,Matches
2493,Djed Spence,ENG,DF,Genoa,Serie A,22,2000,9.5,16,10,12,4,0,8,10,80.0,2,20,5,15,8,24,28,0,Matches
2494,Stijn Spierings,NED,MF,Toulouse,Ligue 1,27,1996,16.8,53,40,26,20,7,29,52,55.8,23,22,5,17,26,79,32,0,Matches
2495,Stijn Spierings,NED,MF,Lens,Ligue 1,27,1996,1.3,1,0,0,1,0,1,1,100.0,0,2,1,1,2,3,1,0,Matches
2496,Leonardo Spinazzola,ITA,DF,Roma,Serie A,30,1993,14.6,15,7,10,5,0,8,18,44.4,10,8,2,6,3,18,15,0,Matches
2497,Marco Sportiello,ITA,GK,Milan,Serie A,31,1992,7.0,0,0,0,0,0,0,0,,0,0,0,0,0,0,2,0,Matches
2498,Anton Stach,GER,MF,Hoffenheim,Bundesliga,24,1998,25.8,73,42,40,27,6,33,63,52.4,30,38,12,26,72,145,67,1,Matches
2499,Anton Stach,GER,MF,Mainz 05,Bundesliga,24,1998,1.9,3,0,2,0,1,2,4,50.0,2,5,0,5,2,5,5,0,Matches
2500,Jens Stage,DEN,MF,Werder Bremen,Bundesliga,26,1996,25.9,52,22,21,23,8,18,50,36.0,32,42,23,19,23,75,55,0,Matches
2501,Benjamin Stambouli,FRA,MF,Reims,Ligue 1,32,1990,3.2,9,7,3,5,1,6,11,54.5,5,3,1,2,2,11,8,0,Matches
2502,Josip Stanišić,CRO,DF,Leverkusen,Bundesliga,23,2000,14.0,38,20,19,13,6,22,33,66.7,11,18,3,15,9,47,26,0,Matches
2503,Carl Starfelt,SWE,DF,Celta Vigo,La Liga,28,1995,24.6,36,30,30,5,1,19,28,67.9,9,35,28,7,34,70,159,2,Matches
2504,Niklas Stark,GER,DF,Werder Bremen,Bundesliga,28,1995,12.1,26,15,13,11,2,12,18,66.7,6,14,7,7,19,45,61,1,Matches
2505,Jason Steele,ENG,GK,Brighton,Premier League,32,1990,17.0,0,0,0,0,0,0,3,0.0,3,0,0,0,0,0,8,1,Matches
2506,Pascal Stenzel,GER,DF,Stuttgart,Bundesliga,27,1996,11.8,18,8,7,9,2,10,30,33.3,20,22,8,14,15,33,26,0,Matches
2507,Leonidas Stergiou,SUI,DF,Stuttgart,Bundesliga,21,2002,6.6,15,8,7,7,1,9,13,69.2,4,8,1,7,5,20,13,0,Matches
2508,Raheem Sterling,ENG,"FW,MF",Chelsea,Premier League,28,1994,22.0,21,10,7,8,6,12,26,46.2,14,13,0,13,13,34,9,1,Matches
2509,Trivante Stewart,JAM,"FW,MF",Salernitana,Serie A,23,2000,1.1,0,0,0,0,0,0,0,,0,1,0,1,0,0,0,0,Matches
2510,Angelo Stiller,GER,MF,Hoffenheim,Bundesliga,22,2001,0.9,0,0,0,0,0,0,1,0.0,1,2,0,2,0,0,3,0,Matches
2511,Angelo Stiller,GER,MF,Stuttgart,Bundesliga,22,2001,29.9,55,33,15,34,6,24,42,57.1,18,41,13,28,28,83,25,2,Matches
2512,Kevin Stöger,AUT,MF,Bochum,Bundesliga,29,1993,29.6,49,30,21,21,7,25,63,39.7,38,46,4,42,19,68,18,0,Matches
2513,Filip Stojilković,SUI,"FW,MF",Darmstadt 98,Bundesliga,23,2000,1.7,1,1,0,0,1,0,0,,0,0,0,0,0,1,1,0,Matches
2514,John Stones,ENG,"DF,MF",Manchester City,Premier League,29,1994,11.8,2,1,1,0,1,0,3,0.0,3,11,7,4,10,12,21,0,Matches
2515,Thomas Strakosha,ALB,GK,Brentford,Premier League,28,1995,1.5,0,0,0,0,0,0,0,,0,0,0,0,0,0,0,0,Matches
2516,Jørgen Strand Larsen,NOR,FW,Celta Vigo,La Liga,23,2000,31.8,21,11,1,15,5,8,38,21.1,30,15,1,14,5,26,17,0,Matches
2517,Gabriel Strefezza,BRA,FW,Lecce,Serie A,26,1997,12.4,24,17,8,7,9,14,20,70.0,6,17,0,17,7,31,11,0,Matches
2518,Kevin Strootman,NED,MF,Genoa,Serie A,33,1990,13.4,34,19,13,18,3,15,31,48.4,16,20,6,14,7,41,22,0,Matches
2519,Cristhian Stuani,URU,FW,Girona,La Liga,36,1986,8.9,14,11,4,6,4,4,7,57.1,3,9,2,7,5,19,13,0,Matches
2520,Álex Suárez,ESP,DF,Las Palmas,La Liga,30,1993,28.5,53,36,33,15,5,31,37,83.8,6,33,14,19,18,71,84,0,Matches
2521,Damián Suárez,URU,DF,Getafe,La Liga,35,1988,14.4,36,21,16,16,4,26,45,57.8,19,13,3,10,10,46,31,0,Matches
2522,Denis Suárez,ESP,"MF,FW",Villarreal,La Liga,29,1994,1.5,0,0,0,0,0,0,2,0.0,2,2,2,0,0,0,4,0,Matches
2523,Gabriel Suazo,CHI,DF,Toulouse,Ligue 1,25,1997,26.2,66,32,40,19,7,38,86,44.2,48,37,4,33,26,92,33,0,Matches
2524,Isaac Success,NGA,"FW,MF",Udinese,Serie A,27,1996,9.8,6,4,0,5,1,1,3,33.3,2,6,1,5,2,8,11,0,Matches
2525,Niklas Süle,GER,DF,Dortmund,Bundesliga,27,1995,16.8,18,10,14,3,1,11,16,68.8,5,25,14,11,25,43,58,2,Matches
2526,Ibrahim Sulemana,GHA,MF,Cagliari,Serie A,20,2003,14.9,36,14,15,15,6,17,27,63.0,10,24,5,19,7,43,23,0,Matches
2527,Tomáš Suslov,SVK,"MF,FW",Hellas Verona,Serie A,21,2002,23.2,42,30,11,22,9,15,47,31.9,32,15,0,15,6,48,8,0,Matches
2528,Suso,ESP,"MF,FW",Sevilla,La Liga,29,1993,16.9,24,17,14,8,2,8,28,28.6,20,9,0,9,5,29,4,0,Matches
2529,Mattias Svanberg,SWE,MF,Wolfsburg,Bundesliga,24,1999,19.1,37,17,8,19,10,12,38,31.6,26,25,5,20,21,58,28,0,Matches
2530,Max Svensson,ESP,FW,Osasuna,La Liga,,,0.0,1,0,0,0,1,0,0,,0,0,0,0,0,1,0,0,Matches
2531,Mile Svilar,SRB,GK,Roma,Serie A,23,1999,15.0,0,0,0,0,0,0,0,,0,0,0,0,0,0,2,1,Matches
2532,Williot Swedberg,SWE,"FW,MF",Celta Vigo,La Liga,19,2004,4.9,9,4,3,6,0,5,8,62.5,3,11,1,10,0,9,4,0,Matches
2533,Karol Świderski,POL,"FW,MF",Hellas Verona,Serie A,26,1997,5.6,7,3,1,3,3,2,3,66.7,1,6,4,2,1,8,8,0,Matches
2534,Abakar Sylla,CIV,DF,Strasbourg,Ligue 1,20,2002,19.9,54,23,30,19,5,29,40,72.5,11,40,11,29,26,80,70,2,Matches
2535,Dembo Sylla,GUI,DF,Lorient,Ligue 1,20,2002,0.5,1,1,0,1,0,0,0,,0,0,0,0,1,2,2,0,Matches
2536,Issiaga Sylla,GUI,"DF,FW",Montpellier,Ligue 1,29,1994,16.2,28,17,20,6,2,16,34,47.1,18,21,7,14,23,51,53,0,Matches
2537,Mamadou Sylla,SEN,"FW,MF",Alavés,La Liga,29,1994,0.2,0,0,0,0,0,0,0,,0,1,1,0,0,0,1,0,Matches
2538,Attila Szalai,HUN,DF,Hoffenheim,Bundesliga,25,1998,3.2,3,1,3,0,0,1,4,25.0,3,6,2,4,1,4,7,0,Matches
2539,Attila Szalai,HUN,DF,Freiburg,Bundesliga,25,1998,1.1,1,1,1,0,0,1,2,50.0,1,5,2,3,1,2,11,1,Matches
2540,Wojciech Szczęsny,POL,GK,Juventus,Serie A,33,1990,35.0,0,0,0,0,0,0,0,,0,0,0,0,1,1,11,2,Matches
2541,Dominik Szoboszlai,HUN,MF,Liverpool,Premier League,22,2000,23.4,32,19,12,12,8,16,50,32.0,34,37,2,35,15,47,16,1,Matches
2542,Przemysław Szymiński,POL,MF,Frosinone,Serie A,29,1994,0.1,0,0,0,0,0,0,0,,0,1,1,0,0,0,0,0,Matches
2543,Alexander Sørloth,NOR,FW,Villarreal,La Liga,27,1995,27.7,6,3,1,2,3,2,6,33.3,4,9,4,5,0,6,26,0,Matches
2544,Musa Al-Taamari,JOR,FW,Montpellier,Ligue 1,26,1997,21.4,20,16,10,5,5,9,21,42.9,12,18,2,16,4,24,5,0,Matches
2545,Nicolás Tagliafico,ARG,DF,Lyon,Ligue 1,30,1992,23.6,54,34,23,22,9,22,49,44.9,27,25,8,17,28,82,43,0,Matches
2546,Jonathan Tah,GER,DF,Leverkusen,Bundesliga,27,1996,29.2,19,9,10,7,2,5,16,31.3,11,28,23,5,23,42,97,1,Matches
2547,Montassar Talbi,TUN,DF,Lorient,Ligue 1,25,1998,24.5,38,22,23,13,2,19,32,59.4,13,39,23,16,32,70,114,0,Matches
2548,Yassin Tallal,ESP,FW,Getafe,La Liga,18,2005,0.0,0,0,0,0,0,0,0,,0,0,0,0,0,0,0,0,Matches
2549,Adrien Tameze,CMR,"DF,MF",Torino,Serie A,29,1994,23.8,35,16,13,18,4,18,37,48.6,19,24,11,13,47,82,25,2,Matches
2550,Renato Tapia,PER,"MF,DF",Celta Vigo,La Liga,28,1995,14.9,41,29,19,19,3,14,25,56.0,11,31,7,24,21,62,50,1,Matches
2551,Edmond Tapsoba,BFA,DF,Leverkusen,Bundesliga,24,1999,23.2,34,25,17,15,2,17,24,70.8,7,21,10,11,24,58,52,3,Matches
2552,Matt Targett,ENG,DF,Newcastle Utd,Premier League,27,1995,0.9,2,0,1,1,0,1,1,100.0,0,1,0,1,0,2,2,0,Matches
2553,Oussama Targhalline,MAR,MF,Le Havre,Ligue 1,21,2002,11.4,23,11,16,7,0,15,25,60.0,10,9,3,6,20,43,14,2,Matches
2554,James Tarkowski,ENG,DF,Everton,Premier League,30,1992,38.0,61,42,46,14,1,27,48,56.3,21,82,56,26,56,117,191,2,Matches
2555,César Tárrega,ESP,DF,Valencia,La Liga,21,2002,0.1,0,0,0,0,0,0,0,,0,0,0,0,0,0,2,0,Matches
2556,Jimi Tauriainen,ENG,FW,Chelsea,Premier League,19,2004,0.0,0,0,0,0,0,0,0,,0,0,0,0,0,0,0,0,Matches
2557,Nuno Tavares,POR,DF,Nott'ham Forest,Premier League,23,2000,5.1,11,7,9,1,1,8,9,88.9,1,6,0,6,1,12,21,0,Matches
2558,Marcus Tavernier,ENG,FW,Bournemouth,Premier League,24,1999,23.5,53,34,25,22,6,26,48,54.2,22,31,3,28,5,58,23,0,Matches
2559,Elayis Tavsan,NED,"MF,FW",Hellas Verona,Serie A,22,2001,0.6,0,0,0,0,0,0,1,0.0,1,0,0,0,0,0,1,0,Matches
2560,Charlie Taylor,ENG,DF,Burnley,Premier League,29,1993,25.9,35,20,19,14,2,17,35,48.6,18,27,11,16,19,54,78,0,Matches
2561,Marciano Tchami,GNB,"FW,MF",Almería,La Liga,19,2004,0.5,0,0,0,0,0,0,0,,0,0,0,0,0,0,0,0,Matches
2562,Loum Tchaouna,FRA,"FW,MF",Salernitana,Serie A,19,2003,23.3,20,10,5,13,2,10,20,50.0,10,20,1,19,4,24,16,1,Matches
2563,Jackson Tchatchoua,CMR,DF,Hellas Verona,Serie A,21,2001,19.2,39,26,25,12,2,23,48,47.9,25,17,7,10,23,62,49,2,Matches
2564,Enzo Tchato,CMR,DF,Montpellier,Ligue 1,20,2002,12.5,26,17,18,4,4,11,25,44.0,14,20,7,13,11,37,25,0,Matches
2565,Aurélien Tchouaméni,FRA,"MF,DF",Real Madrid,La Liga,23,2000,22.1,38,23,19,17,2,9,18,50.0,9,21,13,8,28,66,52,1,Matches
2566,Mathys Tel,FRA,"FW,MF",Bayern Munich,Bundesliga,18,2005,11.7,12,2,3,4,5,4,6,66.7,2,11,0,11,6,18,6,0,Matches
2567,Nathan Tella,NGA,"DF,MF",Leverkusen,Bundesliga,24,1999,9.1,13,8,6,5,2,5,10,50.0,5,10,0,10,3,16,8,0,Matches
2568,Nahuel Tenaglia,ARG,DF,Alavés,La Liga,27,1996,12.7,29,19,22,4,3,16,28,57.1,12,14,8,6,12,41,59,0,Matches
2569,Arnau Tenas,ESP,GK,Paris S-G,Ligue 1,22,2001,5.9,0,0,0,0,0,0,0,,0,0,0,0,0,0,0,0,Matches
2570,Marc-André ter Stegen,GER,GK,Barcelona,La Liga,31,1992,28.0,0,0,0,0,0,0,0,,0,0,0,0,0,0,3,3,Matches
2571,Filippo Terracciano,ITA,DF,Hellas Verona,Serie A,20,2003,14.4,30,19,23,6,1,17,31,54.8,14,24,6,18,20,50,17,0,Matches
2572,Filippo Terracciano,ITA,"DF,FW",Milan,Serie A,20,2003,0.8,2,2,1,1,0,1,3,33.3,2,3,0,3,0,2,1,0,Matches
2573,Pietro Terracciano,ITA,GK,Fiorentina,Serie A,33,1990,33.0,1,1,1,0,0,1,3,33.3,2,1,0,1,0,1,8,0,Matches
2574,Ramón Terrats,ESP,"MF,DF",Villarreal,La Liga,22,2000,8.7,17,13,8,8,1,7,15,46.7,8,11,1,10,3,20,9,0,Matches
2575,Martin Terrier,FRA,"FW,MF",Rennes,Ligue 1,26,1997,17.0,14,9,3,8,3,6,14,42.9,8,21,4,17,9,23,17,0,Matches
2576,Kenny Tete,NED,DF,Fulham,Premier League,27,1995,9.6,27,17,19,6,2,11,19,57.9,8,10,3,7,16,43,35,0,Matches
2577,Benjamin Tetteh,GHA,"FW,MF",Metz,Ligue 1,26,1997,3.1,6,6,1,5,0,4,7,57.1,3,0,0,0,0,6,1,0,Matches
2578,Teddy Teuma,MLT,MF,Reims,Ligue 1,29,1993,23.5,54,36,19,21,14,25,62,40.3,37,33,4,29,20,74,6,0,Matches
2579,Florian Thauvin,FRA,FW,Udinese,Serie A,30,1993,19.0,7,4,2,4,1,4,13,30.8,9,9,1,8,3,10,2,0,Matches
2580,Arthur Theate,BEL,DF,Rennes,Ligue 1,23,2000,25.5,30,17,19,6,5,24,37,64.9,13,40,23,17,31,61,90,2,Matches
2581,Norman Theuerkauf,GER,"MF,DF",Heidenheim,Bundesliga,36,1987,14.0,24,16,13,7,4,13,22,59.1,9,16,6,10,14,38,21,0,Matches
2582,Malick Thiaw,GER,DF,Milan,Serie A,21,2001,18.0,34,17,15,17,2,12,25,48.0,13,23,13,10,13,47,55,0,Matches
2583,Jan Thielmann,GER,"FW,DF",Köln,Bundesliga,21,2002,17.5,28,18,13,9,6,12,24,50.0,12,31,6,25,8,36,28,0,Matches
2584,Denis Thomalla,GER,"MF,FW",Heidenheim,Bundesliga,30,1992,5.0,9,6,4,4,1,5,11,45.5,6,3,2,1,4,13,13,0,Matches
2585,Luke Thomas,ENG,DF,Sheffield Utd,Premier League,22,2001,10.2,20,9,13,6,1,8,14,57.1,6,23,5,18,10,30,27,0,Matches
2586,Adrien Thomasson,FRA,MF,Lens,Ligue 1,29,1993,13.3,25,14,4,16,5,11,34,32.4,23,14,0,14,9,34,10,1,Matches
2587,Morten Thorsby,NOR,MF,Genoa,Serie A,27,1996,12.9,19,11,9,8,2,7,14,50.0,7,21,5,16,4,23,20,0,Matches
2588,Kristian Thorstvedt,NOR,MF,Sassuolo,Serie A,24,1999,26.6,40,22,7,28,5,22,44,50.0,22,25,9,16,21,61,36,0,Matches
2589,Khéphren Thuram,FRA,MF,Nice,Ligue 1,22,2001,23.4,42,29,13,23,6,20,40,50.0,20,21,10,11,18,60,37,0,Matches
2590,Marcus Thuram,FRA,FW,Inter,Serie A,25,1997,29.9,23,15,9,9,5,4,13,30.8,9,26,3,23,4,27,19,0,Matches
2591,Cheikh Tidiane Sabaly,SEN,"FW,MF",Metz,Ligue 1,24,1999,15.3,40,20,23,12,5,16,40,40.0,24,19,2,17,10,50,14,0,Matches
2592,Youri Tielemans,BEL,"MF,FW",Aston Villa,Premier League,26,1997,18.0,41,20,17,18,6,16,40,40.0,24,23,3,20,15,56,9,0,Matches
2593,Kieran Tierney,SCO,DF,Real Sociedad,La Liga,26,1997,13.8,37,24,16,18,3,18,27,66.7,9,22,8,14,10,47,45,0,Matches
2594,Phillip Tietz,GER,FW,Augsburg,Bundesliga,26,1997,26.5,23,14,7,13,3,6,15,40.0,9,17,3,14,6,29,35,0,Matches
2595,Steffen Tigges,GER,FW,Köln,Bundesliga,25,1998,8.1,10,6,4,5,1,3,7,42.9,4,4,2,2,1,11,12,0,Matches
2596,Antonio Tikvić,CRO,DF,Udinese,Serie A,19,2004,0.0,0,0,0,0,0,0,0,,0,0,0,0,0,0,0,0,Matches
2597,Jurriën Timber,NED,DF,Arsenal,Premier League,22,2001,0.8,2,2,1,1,0,0,0,,0,1,0,1,0,2,1,0,Matches
2598,Jean-Clair Todibo,FRA,DF,Nice,Ligue 1,23,1999,29.5,58,28,35,17,6,34,56,60.7,22,34,15,19,38,96,97,1,Matches
2599,Harry Toffolo,ENG,DF,Nott'ham Forest,Premier League,27,1995,16.2,26,14,20,6,0,15,24,62.5,9,34,13,21,14,40,49,0,Matches
2600,Umut Tohumcu,GER,MF,Hoffenheim,Bundesliga,18,2004,11.2,16,12,9,7,0,6,19,31.6,13,11,1,10,6,22,12,0,Matches
2601,Corentin Tolisso,FRA,MF,Lyon,Ligue 1,28,1994,19.3,33,21,13,11,9,14,33,42.4,19,26,9,17,10,43,18,0,Matches
2602,Jeremy Toljan,GER,DF,Sassuolo,Serie A,28,1994,23.1,13,10,8,4,1,9,15,60.0,6,17,5,12,16,29,49,1,Matches
2603,Rafael Tolói,ITA,DF,Atalanta,Serie A,32,1990,10.7,20,9,7,8,5,14,27,51.9,13,9,4,5,13,33,29,0,Matches
2604,Raúl de Tomás,ESP,FW,Rayo Vallecano,La Liga,28,1994,14.1,9,5,4,3,2,3,6,50.0,3,3,0,3,1,10,8,0,Matches
2605,Tiago Tomás,POR,"FW,MF",Wolfsburg,Bundesliga,21,2002,11.5,5,2,3,0,2,1,6,16.7,5,13,0,13,3,8,9,0,Matches
2606,Takehiro Tomiyasu,JPN,DF,Arsenal,Premier League,24,1998,12.8,20,9,15,4,1,11,18,61.1,7,10,4,6,18,38,33,0,Matches
2607,James Tomkins,ENG,DF,Crystal Palace,Premier League,34,1989,0.1,0,0,0,0,0,0,0,,0,0,0,0,1,1,0,0,Matches
2608,Fikayo Tomori,ENG,DF,Milan,Serie A,25,1997,23.6,42,24,29,10,3,18,29,62.1,11,34,23,11,26,68,75,1,Matches
2609,Sandro Tonali,ITA,MF,Newcastle Utd,Premier League,23,2000,4.9,7,7,4,2,1,3,9,33.3,6,3,0,3,2,9,4,0,Matches
2610,Ivan Toney,ENG,FW,Brentford,Premier League,27,1996,16.1,15,5,2,7,6,6,14,42.9,8,5,1,4,10,25,18,0,Matches
2611,Pablo Torre,ESP,"MF,FW",Girona,La Liga,20,2003,7.8,5,2,0,5,0,4,10,40.0,6,10,2,8,4,9,6,1,Matches
2612,Raúl Torrente,ESP,DF,Granada,La Liga,21,2001,13.9,29,16,20,9,0,17,22,77.3,5,16,10,6,11,40,68,2,Matches
2613,Ferrán Torres,ESP,FW,Barcelona,La Liga,23,2000,13.5,9,6,1,6,2,5,16,31.3,11,7,1,6,5,14,6,0,Matches
2614,Óliver Torres,ESP,MF,Sevilla,La Liga,28,1994,18.0,37,22,17,15,5,22,57,38.6,35,40,4,36,6,43,6,0,Matches
2615,Pau Torres,ESP,DF,Aston Villa,Premier League,26,1997,27.4,29,18,17,11,1,14,30,46.7,16,28,12,16,14,43,75,0,Matches
2616,Lucas Torró,ESP,MF,Osasuna,La Liga,29,1994,19.9,25,15,11,8,6,11,28,39.3,17,10,2,8,33,58,37,0,Matches
2617,Fabio Torsiello,ITA,"FW,DF",Darmstadt 98,Bundesliga,18,2005,1.7,1,0,1,0,0,1,8,12.5,7,1,0,1,1,2,1,0,Matches
2618,Ahmed Touba,ALG,DF,Lecce,Serie A,25,1998,3.1,6,4,3,3,0,3,4,75.0,1,4,3,1,7,13,20,0,Matches
2619,Abdoulaye Touré,GUI,MF,Le Havre,Ligue 1,29,1994,25.4,47,28,22,22,3,30,60,50.0,30,30,8,22,25,72,33,0,Matches
2620,Souleymane Touré,FRA,DF,Lorient,Ligue 1,20,2003,22.8,25,12,16,9,0,8,14,57.1,6,38,20,18,36,61,101,2,Matches
2621,Lucas Tousart,FRA,MF,Union Berlin,Bundesliga,26,1997,17.5,35,20,14,17,4,17,37,45.9,20,32,9,23,25,60,41,0,Matches
2622,Andros Townsend,ENG,"MF,FW",Luton Town,Premier League,32,1991,13.4,21,13,11,2,8,13,27,48.1,14,12,0,12,5,26,10,0,Matches
2623,James Trafford,ENG,GK,Burnley,Premier League,20,2002,28.0,2,1,2,0,0,2,2,100.0,0,0,0,0,1,3,18,1,Matches
2624,Adama Traoré,ESP,"FW,MF",Fulham,Premier League,27,1996,4.2,4,3,1,2,1,3,6,50.0,3,2,0,2,1,5,2,0,Matches
2625,Bertrand Traoré,BFA,"DF,FW",Aston Villa,Premier League,27,1995,0.1,1,1,1,0,0,0,0,,0,0,0,0,0,1,1,0,Matches
2626,Bertrand Traoré,BFA,MF,Villarreal,La Liga,27,1995,6.3,5,4,2,1,2,1,4,25.0,3,6,0,6,1,6,2,0,Matches
2627,Boubacar Traoré,MLI,MF,Wolves,Premier League,21,2001,9.1,35,23,16,17,2,9,21,42.9,12,12,2,10,5,40,7,0,Matches
2628,Chaka Traorè,CIV,FW,Milan,Serie A,18,2004,0.2,2,1,2,0,0,1,2,50.0,1,1,1,0,0,2,0,0,Matches
2629,Daouda Traoré,FRA,MF,Nice,Ligue 1,17,2006,0.2,0,0,0,0,0,0,0,,0,0,0,0,0,0,0,0,Matches
2630,Hamari Traoré,MLI,DF,Real Sociedad,La Liga,31,1992,25.5,44,19,24,17,3,25,43,58.1,18,27,8,19,24,68,59,2,Matches
2631,Ismaël Traoré,CIV,DF,Metz,Ligue 1,36,1986,24.7,19,12,13,6,0,8,21,38.1,13,33,20,13,30,49,86,0,Matches
2632,Omar Traoré,GER,DF,Heidenheim,Bundesliga,25,1998,27.5,60,33,33,21,6,32,56,57.1,24,32,7,25,40,100,54,1,Matches
2633,Kevin Trapp,GER,GK,Eint Frankfurt,Bundesliga,33,1990,32.0,0,0,0,0,0,0,0,,0,0,0,0,1,1,9,1,Matches
2634,Mark Travers,IRL,GK,Bournemouth,Premier League,24,1999,4.0,0,0,0,0,0,0,0,,0,0,0,0,0,0,2,0,Matches
2635,Óscar Trejo,ARG,"FW,MF",Rayo Vallecano,La Liga,35,1988,15.3,27,15,11,9,7,13,21,61.9,8,21,1,20,5,32,9,0,Matches
2636,Mike Trésor,BEL,"FW,MF",Burnley,Premier League,24,1999,4.7,10,6,9,1,0,8,18,44.4,10,5,0,5,1,11,1,0,Matches
2637,Manu Trigueros,ESP,MF,Villarreal,La Liga,31,1991,3.4,7,5,6,1,0,4,10,40.0,6,1,1,0,3,10,9,0,Matches
2638,Christopher Trimmel,AUT,DF,Union Berlin,Bundesliga,36,1987,18.3,23,15,12,10,1,13,33,39.4,20,16,3,13,13,36,57,0,Matches
2639,Kieran Trippier,ENG,DF,Newcastle Utd,Premier League,32,1990,24.8,57,27,30,16,11,37,77,48.1,40,41,8,33,24,81,57,3,Matches
2640,Leandro Trossard,BEL,"FW,MF",Arsenal,Premier League,28,1994,18.3,27,16,8,9,10,9,25,36.0,16,27,1,26,8,35,6,0,Matches
2641,Adrien Truffert,FRA,DF,Rennes,Ligue 1,21,2001,23.8,39,21,23,10,6,25,40,62.5,15,31,5,26,19,58,49,0,Matches
2642,Auston Trusty,USA,DF,Sheffield Utd,Premier League,24,1998,28.6,47,30,31,13,3,21,43,48.8,22,41,22,19,35,82,153,3,Matches
2643,Kostas Tsimikas,GRE,DF,Liverpool,Premier League,27,1996,7.5,19,13,9,6,4,9,15,60.0,6,9,1,8,6,25,10,0,Matches
2644,Viktor Tsyhankov,UKR,"MF,FW",Girona,La Liga,25,1997,22.8,29,20,11,13,5,14,26,53.8,12,18,1,17,12,41,24,0,Matches
2645,Stefano Turati,ITA,GK,Frosinone,Serie A,21,2001,30.5,0,0,0,0,0,0,0,,0,0,0,0,0,0,6,3,Matches
2646,Matt Turner,USA,GK,Nott'ham Forest,Premier League,29,1994,17.0,0,0,0,0,0,0,0,,0,0,0,0,0,0,8,4,Matches
2647,Beñat Turrientes,ESP,MF,Real Sociedad,La Liga,21,2002,18.7,31,17,6,20,5,13,30,43.3,17,19,8,11,6,37,17,0,Matches
2648,Tuta,BRA,DF,Eint Frankfurt,Bundesliga,24,1999,28.9,63,33,38,19,6,39,59,66.1,20,29,12,17,36,99,99,0,Matches
2649,Destiny Udogie,ITA,DF,Tottenham,Premier League,20,2002,26.6,68,33,41,16,11,27,49,55.1,22,27,8,19,37,105,80,5,Matches
2650,Matthieu Udol,FRA,DF,Metz,Ligue 1,27,1996,30.0,55,37,38,12,5,38,56,67.9,18,62,16,46,50,105,108,0,Matches
2651,Manuel Ugarte Ribeiro,URU,MF,Paris S-G,Ligue 1,22,2001,21.5,98,57,39,43,16,43,89,48.3,46,27,6,21,40,138,25,2,Matches
2652,Lesley Ugochukwu,FRA,MF,Chelsea,Premier League,19,2004,3.3,14,10,4,8,2,4,10,40.0,6,6,2,4,1,15,5,0,Matches
2653,Lukas Ullrich,GER,"DF,FW",Gladbach,Bundesliga,19,2004,0.5,1,0,1,0,0,1,4,25.0,3,0,0,0,0,1,1,0,Matches
2654,Sven Ulreich,GER,GK,Bayern Munich,Bundesliga,34,1988,11.0,1,0,1,0,0,1,1,100.0,0,0,0,0,0,1,3,2,Matches
2655,Samuel Umtiti,FRA,DF,Lille,Ligue 1,29,1993,2.1,1,1,0,1,0,1,4,25.0,3,0,0,0,2,3,4,0,Matches
2656,Enes Ünal,TUR,"FW,MF",Bournemouth,Premier League,26,1997,3.6,6,4,2,3,1,2,5,40.0,3,4,2,2,1,7,6,0,Matches
2657,Enes Ünal,TUR,"FW,MF",Getafe,La Liga,26,1997,1.6,0,0,0,0,0,0,0,,0,1,0,1,0,0,2,0,Matches
2658,Deniz Undav,GER,"FW,MF",Stuttgart,Bundesliga,27,1996,23.2,28,13,6,8,14,4,15,26.7,11,17,0,17,6,34,5,0,Matches
2659,Dayot Upamecano,FRA,DF,Bayern Munich,Bundesliga,24,1998,19.6,34,21,21,11,2,15,29,51.7,14,19,7,12,19,53,56,3,Matches
2660,Kacper Urbanski,POL,"MF,FW",Bologna,Serie A,18,2004,10.3,16,10,5,10,1,6,13,46.2,7,15,1,14,4,20,14,0,Matches
2661,Mark Uth,GER,"MF,FW",Köln,Bundesliga,31,1991,4.1,8,4,2,3,3,4,12,33.3,8,6,0,6,1,9,2,0,Matches
2662,Myrto Uzuni,ALB,FW,Granada,La Liga,28,1995,27.2,18,14,8,7,3,6,27,22.2,21,19,3,16,4,22,7,0,Matches
2663,Josha Vagnoman,GER,DF,Stuttgart,Bundesliga,22,2000,13.1,28,18,15,11,2,15,30,50.0,15,11,5,6,2,30,16,1,Matches
2664,Óscar Valentín,ESP,MF,Rayo Vallecano,La Liga,28,1994,29.9,107,66,39,62,6,46,101,45.5,55,62,10,52,35,142,52,1,Matches
2665,Emanuele Valeri,ITA,DF,Frosinone,Serie A,24,1998,13.1,19,16,10,5,4,10,21,47.6,11,14,3,11,9,28,22,0,Matches
2666,Martin Valjent,SVK,DF,Mallorca,La Liga,27,1995,26.1,34,18,19,13,2,18,30,60.0,12,26,11,15,29,63,112,1,Matches
2667,Jesús Vallejo,ESP,DF,Granada,La Liga,26,1997,1.2,3,1,1,2,0,2,2,100.0,0,3,2,1,0,3,1,1,Matches
2668,Álvaro Vallés,ESP,GK,Las Palmas,La Liga,26,1997,36.3,3,2,3,0,0,3,8,37.5,5,0,0,0,0,3,40,1,Matches
2669,Federico Valverde,URU,MF,Real Madrid,La Liga,25,1998,32.3,47,34,22,13,12,24,42,57.1,18,39,2,37,43,90,40,0,Matches
2670,Kévin Van Den Kerkhof,ALG,"FW,MF",Metz,Ligue 1,27,1996,21.3,31,24,11,13,7,13,32,40.6,19,15,2,13,11,42,32,1,Matches
2671,Siebe Van Der Heyden,BEL,DF,Mallorca,La Liga,25,1998,3.2,9,2,7,2,0,4,6,66.7,2,1,1,0,7,16,12,0,Matches
2672,Virgil van Dijk,NED,DF,Liverpool,Premier League,32,1991,35.3,40,23,24,13,3,12,14,85.7,2,47,34,13,39,79,144,0,Matches
2673,Vanderson,BRA,DF,Monaco,Ligue 1,22,2001,18.2,60,41,20,30,10,32,70,45.7,38,29,2,27,35,95,37,1,Matches
2674,Raphaël Varane,FRA,DF,Manchester Utd,Premier League,30,1993,15.3,18,11,10,7,1,10,14,71.4,4,23,18,5,15,33,88,0,Matches
2675,Ruben Vargas,SUI,"MF,FW",Augsburg,Bundesliga,24,1998,21.8,23,10,6,10,7,10,25,40.0,15,19,4,15,7,30,17,0,Matches
2676,Johan Vásquez,MEX,DF,Genoa,Serie A,24,1998,31.7,51,33,38,11,2,32,50,64.0,18,50,26,24,45,96,113,0,Matches
2677,José Luis García Vayá,ESP,MF,Valencia,La Liga,24,1998,36.7,78,53,36,36,6,37,71,52.1,34,41,10,31,49,127,71,0,Matches
2678,Borja Vázquez,ESP,FW,Cádiz,La Liga,18,2005,0.0,1,0,1,0,0,1,1,100.0,0,0,0,0,0,1,1,0,Matches
2679,Jesus Vazquez,ESP,"DF,MF",Valencia,La Liga,20,2003,8.0,24,12,13,8,3,10,16,62.5,6,17,4,13,3,27,24,0,Matches
2680,Kevin Vázquez,ESP,DF,Celta Vigo,La Liga,30,1993,7.8,15,13,7,7,1,12,21,57.1,9,11,3,8,5,20,25,0,Matches
2681,Lucas Vázquez,ESP,DF,Real Madrid,La Liga,32,1991,15.8,37,25,22,14,1,18,25,72.0,7,27,5,22,12,49,36,0,Matches
2682,Matías Vecino,URU,MF,Lazio,Serie A,31,1991,12.8,32,17,12,20,0,20,31,64.5,11,17,5,12,12,44,21,0,Matches
2683,Gabriel Veiga,ESP,FW,Celta Vigo,La Liga,21,2002,0.2,0,0,0,0,0,0,0,,0,0,0,0,0,0,0,0,Matches
2684,Alejo Véliz,ARG,FW,Tottenham,Premier League,19,2003,0.6,1,0,1,0,0,0,0,,0,0,0,0,0,1,0,0,Matches
2685,Alejo Véliz,ARG,FW,Sevilla,La Liga,19,2003,0.4,1,0,0,1,0,1,2,50.0,1,0,0,0,0,1,1,0,Matches
2686,Miloš Veljković,SRB,DF,Werder Bremen,Bundesliga,27,1995,21.3,31,15,17,13,1,16,31,51.6,15,31,20,11,17,48,57,0,Matches
2687,Joël Veltman,NED,DF,Brighton,Premier League,31,1992,17.6,54,41,32,17,5,39,58,67.2,19,17,7,10,18,72,57,1,Matches
2688,Micky van de Ven,NED,DF,Tottenham,Premier League,22,2001,26.0,49,35,34,12,3,24,33,72.7,9,25,15,10,18,67,78,1,Matches
2689,Lorenzo Venuti,ITA,DF,Lecce,Serie A,28,1995,4.0,6,4,5,1,0,6,10,60.0,4,4,3,1,5,11,14,0,Matches
2690,Bart Verbruggen,NED,GK,Brighton,Premier League,20,2002,21.0,1,1,1,0,0,1,2,50.0,1,0,0,0,0,1,11,3,Matches
2691,Simone Verdi,ITA,FW,Torino,Serie A,31,1992,0.0,0,0,0,0,0,0,0,,0,0,0,0,0,0,0,0,Matches
2692,Jordan Veretout,FRA,MF,Marseille,Ligue 1,30,1993,24.3,38,22,19,13,6,18,39,46.2,21,20,4,16,13,51,25,0,Matches
2693,Arthur Vermeeren,BEL,MF,Atlético Madrid,La Liga,18,2005,1.8,1,0,0,1,0,0,1,0.0,1,5,0,5,6,7,2,0,Matches
2694,Yorbe Vertessen,BEL,"FW,MF",Union Berlin,Bundesliga,22,2001,6.6,3,2,0,3,0,1,4,25.0,3,8,0,8,1,4,3,0,Matches
2695,Mikel Vesga,ESP,MF,Athletic Club,La Liga,30,1993,17.0,40,20,11,23,6,19,49,38.8,30,19,7,12,32,72,35,1,Matches
2696,Guglielmo Vicario,ITA,GK,Tottenham,Premier League,26,1996,38.0,0,0,0,0,0,0,1,0.0,1,0,0,0,1,1,31,2,Matches
2697,Carlos Vicente,ESP,FW,Alavés,La Liga,24,1999,12.4,16,6,7,7,2,10,25,40.0,15,4,0,4,4,20,9,0,Matches
2698,Nacho Vidal,ESP,"DF,FW",Osasuna,La Liga,28,1995,1.1,5,4,2,2,1,2,5,40.0,3,2,0,2,0,5,6,0,Matches
2699,Nacho Vidal,ESP,DF,Mallorca,La Liga,28,1995,4.6,12,5,4,5,3,6,13,46.2,7,5,2,3,3,15,9,0,Matches
2700,Fabio Vieira,POR,"MF,FW",Arsenal,Premier League,23,2000,3.3,3,2,2,0,1,3,3,100.0,0,0,0,0,2,5,2,0,Matches
2701,Fran Vieites,ESP,GK,Betis,La Liga,24,1999,3.5,1,0,1,0,0,1,1,100.0,0,0,0,0,0,1,2,1,Matches
2702,Jonathan Viera,ESP,"MF,FW",Las Palmas,La Liga,33,1989,6.9,6,3,1,2,3,1,9,11.1,8,0,0,0,0,6,1,0,Matches
2703,Jonathan Viera,ESP,MF,Almería,La Liga,33,1989,10.1,19,9,6,9,4,10,19,52.6,9,4,0,4,4,23,1,0,Matches
2704,Emanuel Vignato,ITA,"MF,FW",Salernitana,Serie A,22,2000,3.5,10,7,4,5,1,5,6,83.3,1,1,0,1,1,11,7,0,Matches
2705,Samuele Vignato,ITA,"MF,FW",Monza,Serie A,19,2004,3.8,6,4,2,3,1,2,3,66.7,1,2,0,2,1,7,1,0,Matches
2706,Oscar Vilhelmsson,SWE,"FW,MF",Darmstadt 98,Bundesliga,19,2003,15.3,13,6,3,7,3,7,10,70.0,3,15,5,10,3,16,19,0,Matches
2707,Toni Villa,ESP,FW,Girona,La Liga,28,1995,0.1,0,0,0,0,0,0,0,,0,0,0,0,0,0,0,0,Matches
2708,Asier Villalibre,ESP,FW,Athletic Club,La Liga,25,1997,5.7,2,1,0,0,2,2,2,100.0,0,2,1,1,0,2,6,0,Matches
2709,Gonzalo Villar,ESP,MF,Granada,La Liga,25,1998,20.0,51,33,26,20,5,26,41,63.4,15,32,10,22,6,57,26,1,Matches
2710,Iván Villar,ESP,GK,Celta Vigo,La Liga,26,1997,11.3,0,0,0,0,0,0,1,0.0,1,0,0,0,0,0,6,0,Matches
2711,Matías Viña,URU,DF,Sassuolo,Serie A,25,1997,11.3,34,21,22,7,5,20,36,55.6,16,12,2,10,9,43,34,0,Matches
2712,Rúben Vinagre,POR,"DF,FW",Hellas Verona,Serie A,24,1999,3.1,4,2,1,1,2,3,4,75.0,1,6,3,3,1,5,4,0,Matches
2713,Carlos Vinícius,BRA,FW,Fulham,Premier League,28,1995,3.5,3,2,0,1,2,0,4,0.0,4,4,0,4,0,3,1,0,Matches
2714,Nicolas Viola,ITA,"MF,FW",Cagliari,Serie A,33,1989,13.4,13,9,2,8,3,7,17,41.2,10,9,0,9,2,15,6,0,Matches
2715,Alan Virginius,FRA,FW,Lille,Ligue 1,20,2003,0.8,1,1,1,0,0,0,1,0.0,1,0,0,0,0,1,0,0,Matches
2716,Alan Virginius,FRA,FW,Clermont Foot,Ligue 1,20,2003,10.4,9,5,4,4,1,4,11,36.4,7,7,0,7,3,12,7,0,Matches
2717,Ricardo Visus,ESP,DF,Betis,La Liga,22,2001,1.8,2,2,1,1,0,2,2,100.0,0,2,2,0,2,4,9,1,Matches
2718,Mattia Viti,ITA,DF,Sassuolo,Serie A,21,2002,10.9,24,15,14,7,3,10,22,45.5,12,20,10,10,10,34,44,0,Matches
2719,Vitinha,POR,"FW,MF",Genoa,Serie A,23,2000,3.2,2,2,1,0,1,1,2,50.0,1,2,0,2,0,2,2,0,Matches
2720,Vitinha,POR,FW,Marseille,Ligue 1,23,2000,10.3,14,8,3,5,6,3,12,25.0,9,11,2,9,5,19,8,0,Matches
2721,Vitinha,POR,MF,Paris S-G,Ligue 1,23,2000,23.6,39,24,12,16,11,16,48,33.3,32,29,11,18,23,62,30,2,Matches
2722,Vitinho,BRA,"DF,MF",Burnley,Premier League,24,1999,25.7,64,34,36,22,6,43,86,50.0,43,44,6,38,12,76,47,4,Matches
2723,Daniel Vivian,ESP,DF,Athletic Club,La Liga,24,1999,32.0,42,28,29,11,2,28,45,62.2,17,49,25,24,31,73,104,0,Matches
2724,Odisseas Vlachodimos,GRE,GK,Nott'ham Forest,Premier League,29,1994,5.0,0,0,0,0,0,0,1,0.0,1,0,0,0,0,0,1,0,Matches
2725,Dušan Vlahović,SRB,FW,Juventus,Serie A,23,2000,25.6,9,5,0,6,3,4,11,36.4,7,4,2,2,1,10,11,0,Matches
2726,Nikola Vlašić,CRO,"MF,FW",Torino,Serie A,25,1997,29.0,28,16,6,14,8,4,30,13.3,26,26,7,19,11,39,16,0,Matches
2727,Alessandro Vogliacco,ITA,DF,Genoa,Serie A,24,1998,13.0,23,15,14,8,1,12,15,80.0,3,16,10,6,30,53,40,1,Matches
2728,Kevin Vogt,GER,DF,Hoffenheim,Bundesliga,31,1991,14.7,14,10,7,7,0,8,13,61.5,5,16,13,3,9,23,54,0,Matches
2729,Kevin Vogt,GER,DF,Union Berlin,Bundesliga,31,1991,14.7,10,9,6,4,0,6,12,50.0,6,22,15,7,7,17,72,2,Matches
2730,Mërgim Vojvoda,KVX,DF,Torino,Serie A,28,1995,15.3,17,8,7,6,4,11,16,68.8,5,12,2,10,13,30,28,0,Matches
2731,Kevin Volland,GER,"FW,MF",Union Berlin,Bundesliga,31,1992,14.9,22,9,8,8,6,8,20,40.0,12,8,0,8,6,28,12,0,Matches
2732,Cristian Volpato,ITA,"MF,FW",Sassuolo,Serie A,19,2003,7.2,16,8,9,6,1,9,25,36.0,16,7,0,7,1,17,5,0,Matches
2733,Aster Vranckx,BEL,MF,Wolfsburg,Bundesliga,20,2002,12.8,32,15,11,11,10,15,28,53.6,13,17,6,11,14,46,29,0,Matches
2734,Stefan de Vrij,NED,DF,Inter,Serie A,31,1992,17.6,18,13,13,4,1,8,15,53.3,7,22,10,12,24,42,51,0,Matches
2735,Elye Wahi,FRA,FW,Montpellier,Ligue 1,20,2003,0.2,0,0,0,0,0,0,0,,0,0,0,0,0,0,0,0,Matches
2736,Elye Wahi,FRA,FW,Lens,Ligue 1,20,2003,18.8,6,4,1,3,2,2,10,20.0,8,5,1,4,3,9,3,0,Matches
2737,Walace,BRA,MF,Udinese,Serie A,28,1995,36.0,66,43,40,26,0,36,77,46.8,41,43,6,37,43,109,66,1,Matches
2738,Luca Waldschmidt,GER,"MF,FW",Köln,Bundesliga,27,1996,12.7,19,12,4,12,3,5,16,31.3,11,18,3,15,6,25,8,1,Matches
2739,Kyle Walker,ENG,DF,Manchester City,Premier League,33,1990,30.7,38,24,19,17,2,19,39,48.7,20,19,6,13,27,65,40,1,Matches
2740,Sebastian Walukiewicz,POL,DF,Empoli,Serie A,23,2000,22.8,39,28,33,6,0,28,41,68.3,13,50,31,19,15,54,121,0,Matches
2741,Aaron Wan-Bissaka,ENG,DF,Manchester Utd,Premier League,25,1997,19.8,42,25,18,20,4,19,26,73.1,7,29,15,14,41,83,68,1,Matches
2742,Joel Ward,ENG,DF,Crystal Palace,Premier League,33,1989,22.0,45,28,26,18,1,30,47,63.8,17,17,10,7,14,59,94,1,Matches
2743,James Ward-Prowse,ENG,MF,West Ham,Premier League,28,1994,33.3,45,29,14,23,8,18,44,40.9,26,31,9,22,38,83,49,0,Matches
2744,Lewis Warrington,ENG,FW,Everton,Premier League,20,2002,0.0,0,0,0,0,0,0,0,,0,0,0,0,0,0,0,0,Matches
2745,Deivid Washington,BRA,"DF,FW",Chelsea,Premier League,18,2005,0.1,1,1,1,0,0,0,1,0.0,1,0,0,0,0,1,0,0,Matches
2746,Kjell-Arik Wätjen,GER,"MF,FW",Dortmund,Bundesliga,17,2006,1.2,3,2,2,1,0,2,5,40.0,3,1,1,0,0,3,3,0,Matches
2747,Ollie Watkins,ENG,FW,Aston Villa,Premier League,27,1995,35.7,12,7,0,5,7,5,11,45.5,6,26,4,22,4,16,20,0,Matches
2748,Timothy Weah,USA,"DF,FW",Juventus,Serie A,23,2000,14.0,27,20,16,8,3,15,20,75.0,5,12,1,11,5,32,15,0,Matches
2749,Adam Webster,ENG,DF,Brighton,Premier League,28,1995,12.7,14,12,8,5,1,6,18,33.3,12,16,12,4,16,30,43,1,Matches
2750,Wout Weghorst,NED,FW,Hoffenheim,Bundesliga,30,1992,22.0,13,6,4,7,2,9,15,60.0,6,25,8,17,6,19,24,0,Matches
2751,Julian Weigl,GER,MF,Gladbach,Bundesliga,27,1995,30.7,66,40,28,32,6,41,67,61.2,26,47,14,33,48,114,61,1,Matches
2752,Nelson Weiper,GER,"FW,MF",Mainz 05,Bundesliga,18,2005,1.4,2,1,2,0,0,2,3,66.7,1,1,0,1,1,3,0,0,Matches
2753,Mitchell Weiser,GER,"DF,MF",Werder Bremen,Bundesliga,29,1994,29.3,64,38,29,25,10,31,53,58.5,22,36,6,30,20,84,43,0,Matches
2754,Noah Weißhaupt,GER,"DF,FW",Freiburg,Bundesliga,21,2001,8.4,9,4,6,0,3,5,11,45.5,6,8,1,7,8,17,12,0,Matches
2755,Shon Weissman,ISR,"FW,DF",Salernitana,Serie A,27,1996,5.5,4,3,2,0,2,0,4,0.0,4,2,1,1,3,7,4,0,Matches
2756,Shon Weissman,ISR,FW,Granada,La Liga,27,1996,0.9,1,1,0,0,1,1,4,25.0,3,3,0,3,0,1,1,0,Matches
2757,Danny Welbeck,ENG,"FW,MF",Brighton,Premier League,32,1990,18.8,35,17,9,17,9,10,17,58.8,7,12,0,12,9,44,17,1,Matches
2758,Timo Werner,GER,FW,Tottenham,Premier League,27,1996,9.0,7,4,3,4,0,5,18,27.8,13,12,0,12,3,10,2,0,Matches
2759,Timo Werner,GER,"FW,MF",RB Leipzig,Bundesliga,27,1996,2.3,2,1,0,1,1,0,0,,0,1,0,1,1,3,0,0,Matches
2760,Adam Wharton,ENG,MF,Crystal Palace,Premier League,19,2004,14.4,48,32,18,22,8,23,46,50.0,23,17,3,14,20,68,24,1,Matches
2761,Ethan Wheatley,ENG,FW,Manchester Utd,Premier League,17,2006,0.2,1,1,0,1,0,1,1,100.0,0,2,0,2,2,3,0,0,Matches
2762,Ben White,ENG,DF,Arsenal,Premier League,25,1997,33.2,48,28,20,22,6,26,58,44.8,32,48,22,26,32,80,77,1,Matches
2763,Joe White,ENG,MF,Newcastle Utd,Premier League,20,2002,0.1,1,1,1,0,0,0,0,,0,0,0,0,0,1,0,0,Matches
2764,Silvan Widmer,SUI,DF,Mainz 05,Bundesliga,30,1993,13.8,23,10,12,8,3,17,28,60.7,11,18,5,13,16,39,37,0,Matches
2765,Mateusz Wieteska,POL,DF,Cagliari,Serie A,26,1997,10.7,14,11,9,3,2,3,10,30.0,7,10,5,5,14,28,48,0,Matches
2766,Mateusz Wieteska,POL,DF,Clermont Foot,Ligue 1,26,1997,1.9,4,1,3,1,0,3,5,60.0,2,4,2,2,5,9,8,0,Matches
2767,Iñaki Williams,GHA,FW,Athletic Club,La Liga,29,1994,31.6,24,17,6,8,10,13,34,38.2,21,42,8,34,14,38,29,0,Matches
2768,Neco Williams,WAL,DF,Nott'ham Forest,Premier League,22,2001,18.2,69,40,42,18,9,35,56,62.5,21,44,13,31,22,91,53,0,Matches
2769,Nico Williams,ESP,FW,Athletic Club,La Liga,21,2002,25.1,31,12,9,15,7,13,36,36.1,23,18,2,16,3,34,4,1,Matches
2770,Willian,BRA,FW,Fulham,Premier League,34,1988,22.8,18,11,6,7,5,3,21,14.3,18,13,0,13,9,27,12,1,Matches
2771,Joe Willock,ENG,MF,Newcastle Utd,Premier League,23,1999,4.7,13,7,7,6,0,4,11,36.4,7,7,0,7,1,14,1,0,Matches
2772,Callum Wilson,ENG,FW,Newcastle Utd,Premier League,31,1992,11.0,5,3,0,2,3,0,4,0.0,4,6,0,6,2,7,4,0,Matches
2773,Harry Wilson,WAL,FW,Fulham,Premier League,26,1997,18.0,21,14,9,8,4,11,28,39.3,17,27,3,24,10,31,12,0,Matches
2774,Josh Wilson-Esbrand,ENG,"DF,MF",Reims,Ligue 1,20,2002,5.1,5,4,2,3,0,2,8,25.0,6,5,2,3,6,11,7,0,Matches
2775,Patrick Wimmer,AUT,"FW,MF",Wolfsburg,Bundesliga,22,2001,6.5,14,5,5,5,4,8,18,44.4,10,14,0,14,3,17,7,0,Matches
2776,Jonas Wind,DEN,FW,Wolfsburg,Bundesliga,24,1999,29.5,13,10,4,6,3,7,17,41.2,10,13,4,9,3,16,21,0,Matches
2777,Florian Wirtz,GER,MF,Leverkusen,Bundesliga,20,2003,26.4,27,18,7,14,6,9,29,31.0,20,36,2,34,9,36,3,0,Matches
2778,Yoane Wissa,COD,FW,Brentford,Premier League,26,1996,27.7,28,16,13,10,5,5,20,25.0,15,24,3,21,9,37,15,0,Matches
2779,Axel Witsel,BEL,DF,Atlético Madrid,La Liga,34,1989,30.9,35,21,23,12,0,17,24,70.8,7,40,21,19,16,51,119,0,Matches
2780,Maximilian Wittek,GER,"DF,FW",Bochum,Bundesliga,27,1995,11.9,23,17,9,11,3,13,21,61.9,8,12,1,11,18,41,23,0,Matches
2781,Maximilian Wöber,AUT,DF,Gladbach,Bundesliga,25,1998,23.0,66,31,40,25,1,31,53,58.5,22,47,26,21,38,104,111,0,Matches
2782,Marius Wolf,GER,DF,Dortmund,Bundesliga,28,1995,13.0,20,12,8,11,1,11,23,47.8,12,12,2,10,8,28,20,0,Matches
2783,Nick Woltemade,GER,"FW,MF",Werder Bremen,Bundesliga,21,2002,13.2,34,23,7,20,7,15,21,71.4,6,12,0,12,5,39,17,0,Matches
2784,Jeong Woo-yeong,KOR,"MF,FW",Stuttgart,Bundesliga,23,1999,7.0,15,9,6,8,1,6,8,75.0,2,5,0,5,7,22,5,0,Matches
2785,Chris Wood,NZL,FW,Nott'ham Forest,Premier League,31,1991,20.1,7,4,1,4,2,3,9,33.3,6,11,3,8,1,8,26,0,Matches
2786,Cauley Woodrow,ENG,"FW,MF",Luton Town,Premier League,28,1994,4.7,16,10,8,4,4,9,16,56.3,7,7,1,6,1,17,14,0,Matches
2787,Christopher Wooh,CMR,DF,Rennes,Ligue 1,21,2001,15.4,18,12,12,6,0,8,15,53.3,7,19,9,10,18,36,51,0,Matches
2788,Joe Worrall,ENG,DF,Nott'ham Forest,Premier League,26,1997,4.9,7,5,6,1,0,3,6,50.0,3,5,4,1,3,10,32,1,Matches
2789,Xeber,ESP,"FW,MF",Alavés,La Liga,26,1997,3.4,5,5,3,2,0,3,7,42.9,4,2,1,1,1,6,2,0,Matches
2790,Granit Xhaka,SUI,MF,Leverkusen,Bundesliga,30,1992,31.3,29,21,11,14,4,9,30,30.0,21,29,8,21,19,48,42,0,Matches
2791,Antal Yaakobishvili,HUN,DF,Girona,La Liga,19,2004,0.7,2,1,1,1,0,1,1,100.0,0,0,0,0,3,5,3,0,Matches
2792,Lamine Yamal,ESP,FW,Barcelona,La Liga,16,2007,24.5,61,37,32,15,14,18,48,37.5,30,32,0,32,19,80,11,0,Matches
2793,Roman Yaremchuk,UKR,FW,Valencia,La Liga,27,1995,10.3,5,2,1,2,2,3,6,50.0,3,4,0,4,1,6,9,0,Matches
2794,Yehor Yarmoliuk,UKR,MF,Brentford,Premier League,19,2004,7.6,17,11,6,8,3,7,17,41.2,10,17,4,13,6,23,5,0,Matches
2795,Ryan Yates,ENG,MF,Nott'ham Forest,Premier League,25,1997,22.1,66,39,39,21,6,19,34,55.9,15,42,15,27,21,87,44,1,Matches
2796,Yusuf Yazıcı,TUR,"MF,FW",Lille,Ligue 1,26,1997,14.6,19,11,6,9,4,4,15,26.7,11,10,1,9,5,24,5,0,Matches
2797,Kelvin Yeboah,ITA,FW,Montpellier,Ligue 1,23,2000,3.1,4,2,2,2,0,1,3,33.3,2,3,2,1,1,5,3,0,Matches
2798,Bertuğ Yıldırım,TUR,FW,Rennes,Ligue 1,21,2002,5.2,7,5,2,3,2,3,8,37.5,5,8,0,8,0,7,4,0,Matches
2799,Kenan Yıldız,TUR,"FW,MF",Juventus,Serie A,18,2005,10.6,13,9,5,6,2,4,8,50.0,4,6,0,6,1,14,4,0,Matches
2800,Darlin Yongwa,CMR,DF,Lorient,Ligue 1,22,2000,12.9,30,23,17,11,2,14,25,56.0,11,14,2,12,15,45,36,0,Matches
2801,Leny Yoro,FRA,DF,Lille,Ligue 1,17,2005,29.7,36,25,27,7,2,17,31,54.8,14,20,14,6,36,72,97,1,Matches
2802,Ashley Young,ENG,"DF,MF",Everton,Premier League,38,1985,25.3,53,38,28,19,6,30,54,55.6,24,24,6,18,22,75,50,3,Matches
2803,Etienne Youte Kinkoue,FRA,DF,Le Havre,Ligue 1,21,2002,21.6,15,9,13,2,0,7,11,63.6,4,21,16,5,44,59,104,0,Matches
2804,Illia Zabarnyi,UKR,DF,Bournemouth,Premier League,20,2002,37.0,59,32,29,29,1,23,50,46.0,27,53,34,19,33,92,143,4,Matches
2805,Mattia Zaccagni,ITA,"FW,MF",Lazio,Serie A,28,1995,21.7,27,16,11,15,1,9,21,42.9,12,26,2,24,21,48,15,0,Matches
2806,Dan-Axel Zagadou,FRA,DF,Stuttgart,Bundesliga,24,1999,16.1,21,14,16,5,0,4,8,50.0,4,23,18,5,20,41,78,1,Matches
2807,Yoram Zague,FRA,DF,Paris S-G,Ligue 1,17,2006,4.1,18,8,11,4,3,11,24,45.8,13,3,0,3,4,22,9,1,Matches
2808,Warren Zaïre-Emery,FRA,"MF,DF",Paris S-G,Ligue 1,17,2006,21.8,51,28,18,24,9,28,51,54.9,23,32,8,24,15,66,22,2,Matches
2809,Denis Zakaria,SUI,"MF,DF",Monaco,Ligue 1,26,1996,23.7,38,27,11,20,7,12,30,40.0,18,39,13,26,47,85,41,0,Matches
2810,Arsen Zakharyan,RUS,"MF,FW",Real Sociedad,La Liga,20,2003,13.6,22,15,8,11,3,9,22,40.9,13,16,0,16,4,26,10,0,Matches
2811,Joseba Zaldúa,ESP,DF,Cádiz,La Liga,31,1992,7.8,20,12,17,2,1,13,21,61.9,8,6,4,2,2,22,20,0,Matches
2812,Nicola Zalewski,POL,"DF,FW",Roma,Serie A,21,2002,10.8,20,14,10,9,1,8,22,36.4,14,12,4,8,9,29,17,0,Matches
2813,Andre-Frank Zambo Anguissa,CMR,MF,Napoli,Serie A,27,1995,31.0,61,33,21,29,11,34,69,49.3,35,40,5,35,28,89,19,1,Matches
2814,Nicolò Zaniolo,ITA,"FW,MF",Aston Villa,Premier League,24,1999,9.3,19,9,10,7,2,9,17,52.9,8,13,0,13,1,20,11,0,Matches
2815,Alessandro Zanoli,ITA,DF,Salernitana,Serie A,22,2000,10.2,16,13,9,7,0,7,12,58.3,5,10,2,8,1,17,17,0,Matches
2816,Alessandro Zanoli,ITA,"DF,FW",Napoli,Serie A,22,2000,0.6,1,1,1,0,0,0,0,,0,0,0,0,1,2,1,0,Matches
2817,Duván Zapata,COL,FW,Torino,Serie A,32,1991,32.0,18,7,9,2,7,3,12,25.0,9,20,6,14,7,25,26,0,Matches
2818,Duván Zapata,COL,FW,Atalanta,Serie A,32,1991,1.2,0,0,0,0,0,0,1,0.0,1,0,0,0,0,0,1,0,Matches
2819,Gabriele Zappa,ITA,DF,Cagliari,Serie A,23,1999,28.5,54,31,29,16,9,29,41,70.7,12,29,5,24,20,74,75,2,Matches
2820,Davide Zappacosta,ITA,DF,Atalanta,Serie A,31,1992,20.7,30,20,15,10,5,16,34,47.1,18,29,4,25,5,35,19,0,Matches
2821,Bryan Zaragoza,ESP,"MF,FW",Granada,La Liga,22,2001,18.2,18,9,8,6,4,8,23,34.8,15,9,0,9,3,21,3,0,Matches
2822,Bryan Zaragoza,ESP,"FW,MF",Bayern Munich,Bundesliga,22,2001,2.0,4,4,2,1,1,3,3,100.0,0,0,0,0,2,6,0,0,Matches
2823,Anass Zaroury,MAR,"FW,MF",Burnley,Premier League,22,2000,1.7,1,0,1,0,0,0,4,0.0,4,2,0,2,0,1,1,1,Matches
2824,Oier Zarraga,ESP,MF,Udinese,Serie A,24,1999,4.5,3,3,2,1,0,1,5,20.0,4,5,2,3,5,8,16,1,Matches
2825,Mehdi Zeffane,ALG,"DF,MF",Clermont Foot,Ligue 1,31,1992,13.7,31,20,17,11,3,17,34,50.0,17,14,3,11,16,47,34,0,Matches
2826,Jordan Zemura,ZIM,DF,Udinese,Serie A,23,1999,11.5,24,16,13,7,4,11,19,57.9,8,5,1,4,13,37,21,0,Matches
2827,Robin Zentner,GER,GK,Mainz 05,Bundesliga,28,1994,30.0,2,2,2,0,0,2,5,40.0,3,1,0,1,1,3,19,1,Matches
2828,Alessio Zerbin,ITA,"DF,FW",Monza,Serie A,24,1999,7.6,18,10,13,2,3,4,13,30.8,9,16,3,13,3,21,5,0,Matches
2829,Alessio Zerbin,ITA,"FW,DF",Napoli,Serie A,24,1999,1.7,5,2,1,3,1,2,7,28.6,5,1,0,1,0,5,0,0,Matches
2830,Kevin Zeroli,ITA,MF,Milan,Serie A,18,2005,0.3,1,1,1,0,0,0,0,,0,1,0,1,0,1,1,0,Matches
2831,Cedric Zesiger,SUI,DF,Wolfsburg,Bundesliga,25,1998,18.2,19,9,13,4,2,10,22,45.5,12,32,21,11,15,34,88,1,Matches
2832,Michael Zetterer,GER,GK,Werder Bremen,Bundesliga,28,1995,27.0,3,1,3,0,0,3,3,100.0,0,0,0,0,0,3,7,3,Matches
2833,Nathan Zeze,FRA,DF,Nantes,Ligue 1,18,2005,11.4,11,6,9,2,0,7,14,50.0,7,12,3,9,12,23,47,1,Matches
2834,Edon Zhegrova,KVX,FW,Lille,Ligue 1,24,1999,25.4,32,18,9,15,8,14,36,38.9,22,17,1,16,8,40,8,0,Matches
2835,Piotr Zieliński,POL,MF,Napoli,Serie A,29,1994,21.4,23,15,6,13,4,12,24,50.0,12,12,1,11,9,32,15,0,Matches
2836,David Zima,CZE,DF,Torino,Serie A,22,2000,1.0,1,1,1,0,0,0,0,,0,0,0,0,3,4,7,0,Matches
2837,Christoph Zimmermann,GER,DF,Darmstadt 98,Bundesliga,30,1993,13.6,33,21,26,7,0,19,39,48.7,20,21,14,7,21,54,66,1,Matches
2838,Oleksandr Zinchenko,UKR,DF,Arsenal,Premier League,26,1996,19.1,50,30,19,24,7,35,52,67.3,17,18,3,15,20,70,26,2,Matches
2839,Joshua Zirkzee,NED,FW,Bologna,Serie A,22,2001,30.7,32,20,8,15,9,13,24,54.2,11,25,2,23,3,35,36,0,Matches
2840,Luc Zogbé,CIV,DF,Brest,Ligue 1,18,2005,0.1,0,0,0,0,0,0,1,0.0,1,1,1,0,1,1,0,0,Matches
2841,Simon Zoller,GER,"FW,MF",Bochum,Bundesliga,32,1991,0.5,0,0,0,0,0,0,0,,0,1,0,1,0,0,0,0,Matches
2842,Nadir Zortea,ITA,DF,Frosinone,Serie A,24,1999,14.0,21,14,8,13,0,10,22,45.5,12,13,5,8,4,25,29,1,Matches
2843,Nadir Zortea,ITA,DF,Atalanta,Serie A,24,1999,1.7,5,4,3,1,1,1,4,25.0,3,2,0,2,1,6,3,0,Matches
2844,Kurt Zouma,FRA,DF,West Ham,Premier League,28,1994,31.5,23,17,14,9,0,10,16,62.5,6,38,28,10,29,52,160,0,Matches
2845,Igor Zubeldia,ESP,DF,Real Sociedad,La Liga,26,1997,28.0,32,25,20,10,2,19,26,73.1,7,28,19,9,32,64,97,3,Matches
2846,Martín Zubimendi,ESP,MF,Real Sociedad,La Liga,24,1999,29.5,49,27,18,29,2,23,42,54.8,19,33,9,24,37,86,54,0,Matches
2847,Szymon Żurkowski,POL,MF,Empoli,Serie A,25,1997,9.6,15,6,5,8,2,5,15,33.3,10,5,1,4,6,21,11,0,Matches
2848,Lovro Zvonarek,CRO,"FW,MF",Bayern Munich,Bundesliga,18,2005,1.8,0,0,0,0,0,0,5,0.0,5,3,0,3,0,0,2,0,Matches
2849,Martin Ødegaard,NOR,MF,Arsenal,Premier League,24,1998,34.3,49,17,18,21,10,17,58,29.3,41,23,1,22,15,64,5,0,Matches
2850,Milan Đurić,BIH,FW,Hellas Verona,Serie A,33,1990,13.4,1,0,0,0,1,0,3,0.0,3,0,0,0,1,2,13,0,Matches
2851,Milan Đurić,BIH,FW,Monza,Serie A,33,1990,14.0,5,5,0,5,0,2,4,50.0,2,6,2,4,0,5,27,0,Matches
2852,Mateusz Łęgowski,POL,MF,Salernitana,Serie A,20,2003,12.7,23,12,8,12,3,11,26,42.3,15,13,2,11,7,30,16,0,Matches
