Rk,Player,Nation,Pos,Squad,Comp,Age,Born,90s,Tkl,TklW,Def 3rd,Mid 3rd,Att 3rd,DribTkl,Att,Tkl%,Lost,Blocks,Sh,Pass,Int,Tkl+Int,Clr,Err,Matches,Season,Interceptions/90,Tackles/90
1,Patrick van Aanholt,NED,DF,Crystal Palace,Premier League,26,1990,24.3,47,32,29,15,3,16,34,47.1,18,24,5,19,47,94,64,2,0,2017-2018,1.934156378600823,1.934156378600823
2,Rolando Aarons,ENG,"MF,FW",Newcastle Utd,Premier League,21,1995,1.5,4,4,3,1,0,4,6,66.7,2,3,0,3,1,5,0,0,0,2017-2018,0.6666666666666666,2.6666666666666665
3,Rolando Aarons,ENG,"MF,FW",Hellas Verona,Serie A,21,1995,5.7,13,8,4,4,5,1,7,14.3,6,3,1,2,2,15,0,0,0,2017-2018,0.3508771929824561,2.280701754385965
4,Ignazio Abate,ITA,DF,Milan,Serie A,30,1986,11.7,20,17,10,9,1,6,11,54.5,5,22,2,20,8,28,29,0,0,2017-2018,0.6837606837606838,1.7094017094017095
5,Aymen Abdennour,TUN,DF,Marseille,Ligue 1,27,1989,5.5,7,3,5,2,0,4,7,57.1,3,5,5,0,4,11,20,0,0,2017-2018,0.7272727272727273,1.2727272727272727
6,Aly Abeid,MTN,DF,Levante,La Liga,19,1997,0.9,2,1,1,1,0,0,1,0.0,1,1,0,1,3,5,3,0,0,2017-2018,3.333333333333333,2.2222222222222223
7,Mehdi Abeid,ALG,MF,Dijon,Ligue 1,24,1992,13.1,23,15,8,14,1,8,32,25.0,24,11,6,5,18,41,25,2,0,2017-2018,1.3740458015267176,1.7557251908396947
8,David Abraham,ARG,DF,Eint Frankfurt,Bundesliga,31,1986,25.6,40,32,29,10,1,27,36,75.0,9,29,15,14,40,80,141,1,0,2017-2018,1.5625,1.5625
9,Tammy Abraham,ENG,FW,Swansea City,Premier League,19,1997,19.2,10,8,1,7,2,1,13,7.7,12,8,1,7,1,11,11,0,0,2017-2018,0.052083333333333336,0.5208333333333334
10,Amir Abrashi,ALB,MF,Freiburg,Bundesliga,27,1990,9.4,35,32,15,18,2,16,23,69.6,7,22,5,17,19,54,20,0,0,2017-2018,2.021276595744681,3.723404255319149
11,Francesco Acerbi,ITA,DF,Sassuolo,Serie A,29,1988,38.0,51,32,26,22,3,22,36,61.1,14,42,21,21,88,139,255,1,0,2017-2018,2.3157894736842106,1.3421052631578947
12,Afriyie Acquah,GHA,MF,Torino,Serie A,25,1992,10.6,8,6,2,6,0,1,7,14.3,6,8,1,7,16,24,10,2,0,2017-2018,1.509433962264151,0.7547169811320755
13,Charlie Adam,SCO,MF,Stoke City,Premier League,31,1985,4.6,9,5,2,5,2,5,17,29.4,12,2,0,2,9,18,11,2,0,2017-2018,1.956521739130435,1.956521739130435
14,Antonio Adán,ESP,GK,Betis,La Liga,30,1987,30.0,1,0,1,0,0,1,1,100.0,0,1,0,1,0,1,11,2,0,2017-2018,0.0,0.03333333333333333
15,Aday,ESP,DF,Girona,La Liga,29,1987,20.4,17,15,11,4,2,6,17,35.3,11,19,3,16,25,42,52,1,0,2017-2018,1.2254901960784315,0.8333333333333334
16,Khaled Adénon,BEN,DF,Amiens,Ligue 1,32,1985,32.5,38,24,26,12,0,15,32,46.9,17,42,26,16,65,103,221,1,0,2017-2018,2.0,1.1692307692307693
17,Claud Adjapong,ITA,"DF,FW",Sassuolo,Serie A,19,1998,13.6,35,26,24,5,6,11,13,84.6,2,16,3,13,23,58,37,0,0,2017-2018,1.6911764705882353,2.573529411764706
18,René Adler,GER,GK,Mainz 05,Bundesliga,32,1985,14.0,1,1,1,0,0,1,1,100.0,0,0,0,0,0,1,8,1,0,2017-2018,0.0,0.07142857142857142
19,Yacine Adli,FRA,FW,Paris S-G,Ligue 1,17,2000,0.1,0,0,0,0,0,0,0,0.0,0,0,0,0,0,0,0,0,0,2017-2018,0.0,0.0
20,Ali Adnan Kadhim,IRQ,"DF,FW",Udinese,Serie A,23,1993,18.6,54,35,35,14,5,29,50,58.0,21,31,6,25,41,95,90,0,0,2017-2018,2.204301075268817,2.9032258064516125
21,Adrián,ESP,GK,West Ham,Premier League,30,1987,19.0,2,1,2,0,0,1,4,25.0,3,1,0,1,0,2,15,1,0,2017-2018,0.0,0.10526315789473684
22,Aritz Aduriz,ESP,FW,Athletic Club,La Liga,36,1981,23.9,11,8,2,6,3,1,6,16.7,5,6,0,6,3,14,18,0,0,2017-2018,0.12552301255230125,0.46025104602510464
23,Ibrahim Afellay,NED,MF,Stoke City,Premier League,31,1986,1.8,3,3,0,3,0,1,2,50.0,1,1,0,1,1,4,1,0,0,2017-2018,0.5555555555555556,1.6666666666666665
24,Benik Afobe,COD,FW,Bournemouth,Premier League,24,1993,6.8,4,3,1,2,1,1,6,16.7,5,4,0,4,0,4,6,0,0,2017-2018,0.0,0.5882352941176471
25,Martin Agirregabiria,ESP,DF,Alavés,La Liga,21,1996,20.3,50,33,31,17,2,32,50,64.0,18,13,7,6,41,91,66,0,0,2017-2018,2.019704433497537,2.4630541871921183
26,Imanol Agirretxe,ESP,FW,Real Sociedad,La Liga,30,1987,2.6,0,0,0,0,0,0,1,0.0,1,0,0,0,0,0,2,0,0,2017-2018,0.0,0.0
27,Sergio Agüero,ARG,FW,Manchester City,Premier League,29,1988,21.8,9,6,2,6,1,2,17,11.8,15,12,1,11,6,15,3,0,0,2017-2018,0.27522935779816515,0.4128440366972477
28,Ruben Aguilar,FRA,DF,Montpellier,Ligue 1,24,1993,27.3,91,50,37,41,13,36,71,50.7,35,25,3,22,37,128,90,0,0,2017-2018,1.3553113553113554,3.333333333333333
29,Matías Aguirregaray,URU,DF,Las Palmas,La Liga,28,1989,12.8,26,20,12,12,2,12,32,37.5,20,13,1,12,24,50,25,0,0,2017-2018,1.875,2.03125
30,Jean-Eudes Aholou,CIV,MF,Strasbourg,Ligue 1,23,1994,33.4,70,34,32,37,1,17,55,30.9,38,29,7,22,75,145,58,1,0,2017-2018,2.245508982035928,2.0958083832335332
31,Ailton,BRA,"DF,MF",Stuttgart,Bundesliga,22,1995,1.2,8,5,3,5,0,4,8,50.0,4,5,0,5,2,10,5,0,0,2017-2018,1.6666666666666667,6.666666666666667
32,Youssef Aït Bennasser,MAR,MF,Caen,Ligue 1,21,1996,22.7,47,28,17,27,3,15,64,23.4,49,35,2,33,32,79,30,0,0,2017-2018,1.4096916299559472,2.0704845814977975
33,Arlind Ajeti,ALB,DF,Crotone,Serie A,23,1993,14.1,42,23,25,14,3,18,30,60.0,12,27,15,12,34,76,82,0,0,2017-2018,2.4113475177304964,2.978723404255319
34,Manuel Akanji,SUI,DF,Dortmund,Bundesliga,22,1995,10.0,22,15,14,8,0,15,17,88.2,2,11,4,7,7,29,43,2,0,2017-2018,0.7,2.2
35,Nathan Aké,NED,DF,Bournemouth,Premier League,22,1995,37.3,53,32,34,16,3,22,40,55.0,18,47,24,23,48,101,246,2,0,2017-2018,1.28686327077748,1.420911528150134
36,Ager Aketxe,ESP,MF,Athletic Club,La Liga,23,1993,0.4,1,1,1,0,0,1,2,50.0,1,1,0,1,1,2,0,0,0,2017-2018,2.5,2.5
37,Chadrac Akolo,COD,"MF,FW",Stuttgart,Bundesliga,22,1995,12.2,20,14,3,12,5,6,14,42.9,8,19,0,19,5,25,5,0,0,2017-2018,0.4098360655737705,1.639344262295082
38,Kevin Akpoguma,NGA,DF,Hoffenheim,Bundesliga,22,1995,18.8,47,39,29,16,2,24,35,68.6,11,18,4,14,22,69,60,1,0,2017-2018,1.1702127659574468,2.5
39,David Alaba,AUT,DF,Bayern Munich,Bundesliga,25,1992,17.2,23,14,11,9,3,14,20,70.0,6,21,6,15,10,33,23,0,0,2017-2018,0.5813953488372093,1.3372093023255816
40,Lucas Alario,ARG,FW,Leverkusen,Bundesliga,24,1992,17.2,16,10,2,12,2,3,8,37.5,5,17,4,13,4,20,16,0,0,2017-2018,0.23255813953488372,0.9302325581395349
41,David Alba,ESP,DF,Getafe,La Liga,18,1999,0.7,1,1,1,0,0,1,1,100.0,0,0,0,0,0,1,7,1,0,2017-2018,0.0,1.4285714285714286
42,Jordi Alba,ESP,DF,Barcelona,La Liga,28,1989,30.5,63,42,35,22,6,26,52,50.0,26,34,5,29,68,131,67,1,0,2017-2018,2.2295081967213113,2.0655737704918034
43,Raúl Albentosa,ESP,DF,La Coruña,La Liga,28,1988,19.4,13,6,9,4,0,7,20,35.0,13,26,19,7,26,39,92,1,0,2017-2018,1.3402061855670104,0.6701030927835052
44,Luis Alberto,ESP,"FW,MF",Lazio,Serie A,24,1992,29.7,39,28,8,23,8,10,44,22.7,34,30,2,28,16,55,7,0,0,2017-2018,0.5387205387205387,1.3131313131313131
45,Raúl Albiol,ESP,DF,Napoli,Serie A,31,1985,30.5,29,19,15,14,0,13,19,68.4,6,18,13,5,32,61,129,1,0,2017-2018,1.0491803278688525,0.9508196721311475
46,Miiko Albornoz,CHI,"DF,MF",Hannover 96,Bundesliga,26,1990,7.8,24,20,17,4,3,11,16,68.8,5,15,2,13,5,29,23,0,0,2017-2018,0.6410256410256411,3.076923076923077
47,Marc Albrighton,ENG,"MF,FW",Leicester City,Premier League,27,1989,28.2,52,33,16,29,7,16,52,30.8,36,32,4,28,27,79,34,0,0,2017-2018,0.9574468085106383,1.8439716312056738
48,Paco Alcácer,ESP,"MF,FW",Barcelona,La Liga,23,1993,7.7,4,3,0,2,2,0,6,0.0,6,5,0,5,11,15,3,0,0,2017-2018,1.4285714285714286,0.5194805194805194
49,Pedro Alcalá,ESP,DF,Girona,La Liga,28,1989,7.7,9,5,5,4,0,1,3,33.3,2,7,3,4,14,23,41,0,0,2017-2018,1.8181818181818181,1.1688311688311688
50,Thiago Alcántara,ESP,"MF,FW",Bayern Munich,Bundesliga,26,1991,13.9,45,35,11,25,9,15,26,57.7,11,22,3,19,27,72,6,1,0,2017-2018,1.9424460431654675,3.237410071942446
51,David Alcibiade,FRA,DF,Nantes,Ligue 1,25,1991,2.3,9,5,5,3,1,2,4,50.0,2,5,3,2,7,16,8,0,0,2017-2018,3.0434782608695654,3.91304347826087
52,Toby Alderweireld,BEL,DF,Tottenham,Premier League,28,1989,13.1,19,13,7,11,1,8,15,53.3,7,11,5,6,4,23,55,0,0,2017-2018,0.3053435114503817,1.450381679389313
53,Steve Aldo One,CMR,DF,La Coruña,La Liga,22,1995,1.0,1,0,0,1,0,0,0,0.0,0,0,0,0,0,1,7,0,0,2017-2018,0.0,1.0
54,Álex Alegría,ESP,FW,Levante,La Liga,24,1992,7.0,8,5,1,3,4,2,6,33.3,4,7,0,7,4,12,9,0,0,2017-2018,0.5714285714285714,1.1428571428571428
55,Iván Alejo,ESP,"MF,FW",Eibar,La Liga,22,1995,12.2,20,16,4,9,7,1,10,10.0,9,9,0,9,5,25,1,0,0,2017-2018,0.4098360655737705,1.639344262295082
56,Alexander,ARG,"MF,FW",Leganés,La Liga,28,1988,11.8,14,11,2,11,1,2,12,16.7,10,11,0,11,22,36,4,0,0,2017-2018,1.8644067796610169,1.1864406779661016
57,Trent Alexander-Arnold,ENG,DF,Liverpool,Premier League,18,1998,17.5,37,25,23,9,5,22,36,61.1,14,20,5,15,28,65,46,1,0,2017-2018,1.6,2.1142857142857143
58,Alexis,ESP,DF,Alavés,La Liga,31,1985,24.3,33,24,24,7,2,20,45,44.4,25,28,14,14,30,63,114,3,0,2017-2018,1.2345679012345678,1.3580246913580247
59,Alisson,BRA,GK,Roma,Serie A,24,1992,37.0,1,0,1,0,0,0,1,0.0,1,0,0,0,2,3,22,4,0,2017-2018,0.05405405405405406,0.02702702702702703
60,Allan,BRA,MF,Napoli,Serie A,26,1991,31.7,107,68,24,65,18,36,104,34.6,68,52,3,49,28,135,16,0,0,2017-2018,0.8832807570977919,3.3753943217665614
61,Joe Allen,WAL,MF,Stoke City,Premier League,27,1990,34.9,96,62,41,43,12,27,87,31.0,60,43,9,34,58,154,68,1,0,2017-2018,1.66189111747851,2.7507163323782238
62,Dele Alli,ENG,"MF,FW",Tottenham,Premier League,21,1996,32.9,46,30,15,21,10,8,34,23.5,26,33,7,26,19,65,22,1,0,2017-2018,0.5775075987841946,1.3981762917933132
63,Júnior Alonso,PAR,DF,Lille,Ligue 1,24,1993,30.9,58,31,36,22,0,28,50,56.0,22,26,16,10,56,114,153,1,0,2017-2018,1.8122977346278317,1.877022653721683
64,José Alonso Lara,ESP,MF,Sevilla,La Liga,17,2000,0.1,0,0,0,0,0,0,0,0.0,0,0,0,0,0,0,0,0,0,2017-2018,0.0,0.0
65,Marcos Alonso,ESP,"DF,MF",Chelsea,Premier League,26,1990,31.7,51,33,30,18,3,23,44,52.3,21,36,5,31,47,98,76,1,0,2017-2018,1.4826498422712935,1.608832807570978
66,Ricky Álvarez,ARG,MF,Sampdoria,Serie A,29,1988,3.0,4,2,1,3,0,1,4,25.0,3,5,0,5,2,6,3,0,0,2017-2018,0.6666666666666666,1.3333333333333333
67,Sergio Álvarez,ESP,GK,Celta Vigo,La Liga,30,1986,16.4,0,0,0,0,0,0,1,0.0,1,1,0,1,0,0,11,1,0,2017-2018,0.0,0.0
68,Yeray Álvarez,ESP,DF,Athletic Club,La Liga,22,1995,7.5,12,7,8,4,0,6,9,66.7,3,8,2,6,11,23,18,0,0,2017-2018,1.4666666666666666,1.6
69,Dani Alves,BRA,DF,Paris S-G,Ligue 1,34,1983,22.9,80,57,45,27,8,33,58,56.9,25,24,3,21,28,108,21,0,0,2017-2018,1.2227074235807862,3.493449781659389
70,Ibrahim Amadou,FRA,"MF,DF",Lille,Ligue 1,24,1993,26.7,43,29,24,19,0,14,27,51.9,13,30,13,17,41,84,70,3,0,2017-2018,1.5355805243445693,1.6104868913857677
71,Eloi Amagat,ESP,MF,Girona,La Liga,32,1985,0.2,0,0,0,0,0,0,1,0.0,1,0,0,0,0,0,0,0,0,2017-2018,0.0,0.0
72,Morgan Amalfitano,FRA,"MF,FW",Rennes,Ligue 1,32,1985,8.3,8,5,3,3,2,2,5,40.0,3,6,0,6,4,12,7,0,0,2017-2018,0.48192771084337344,0.9638554216867469
73,Romain Amalfitano,FRA,MF,Dijon,Ligue 1,27,1989,30.0,59,37,18,38,3,25,69,36.2,44,29,7,22,85,144,35,2,0,2017-2018,2.8333333333333335,1.9666666666666666
74,Daniel Amartey,GHA,DF,Leicester City,Premier League,22,1994,5.4,8,4,7,1,0,3,7,42.9,4,7,3,4,7,15,21,1,0,2017-2018,1.2962962962962963,1.4814814814814814
75,Jordi Amat,IDN,"DF,MF",Betis,La Liga,25,1992,22.7,32,23,15,16,1,11,24,45.8,13,14,4,10,38,70,77,2,0,2017-2018,1.6740088105726874,1.4096916299559472
76,Amath,SEN,"MF,FW",Getafe,La Liga,21,1996,31.8,78,53,32,28,18,24,89,27.0,65,36,3,33,33,111,20,0,0,2017-2018,1.0377358490566038,2.452830188679245
77,Jordan Amavi,FRA,DF,Marseille,Ligue 1,23,1994,24.4,52,35,32,12,8,23,56,41.1,33,28,11,17,45,97,86,1,0,2017-2018,1.8442622950819674,2.1311475409836067
78,Stephan Ambrosius,GHA,DF,Hamburger SV,Bundesliga,18,1998,0.5,0,0,0,0,0,0,0,0.0,0,2,1,1,1,1,4,0,0,2017-2018,2.0,0.0
79,Kelvin Amian,FRA,DF,Toulouse,Ligue 1,19,1998,35.0,59,43,45,10,4,22,31,71.0,9,25,7,18,45,104,127,1,0,2017-2018,1.2857142857142858,1.6857142857142857
80,Nadiem Amiri,GER,MF,Hoffenheim,Bundesliga,20,1996,19.4,39,26,13,21,5,19,42,45.2,23,33,4,29,17,56,7,0,0,2017-2018,0.8762886597938145,2.0103092783505154
81,Ethan Ampadu,WAL,DF,Chelsea,Premier League,16,2000,0.1,1,1,0,1,0,0,0,0.0,0,0,0,0,0,1,2,0,0,2017-2018,0.0,10.0
82,Nordin Amrabat,MAR,FW,Watford,Premier League,30,1987,2.2,6,3,1,5,0,1,3,33.3,2,1,0,1,0,6,2,0,0,2017-2018,0.0,2.727272727272727
83,Nordin Amrabat,MAR,"FW,MF",Leganés,La Liga,30,1987,18.0,19,10,5,10,4,5,17,29.4,12,13,0,13,5,24,2,0,0,2017-2018,0.2777777777777778,1.0555555555555556
84,Jon Ander Serantes,ESP,GK,Leganés,La Liga,27,1989,1.0,0,0,0,0,0,0,0,0.0,0,0,0,0,0,0,0,1,0,2017-2018,0.0,0.0
85,Joachim Andersen,DEN,DF,Sampdoria,Serie A,21,1996,6.1,8,3,6,2,0,4,4,100.0,0,6,4,2,9,17,41,1,0,2017-2018,1.4754098360655739,1.3114754098360657
86,Felipe Anderson,BRA,"FW,MF",Lazio,Serie A,24,1993,12.9,34,21,7,11,16,6,35,17.1,29,17,0,17,11,45,8,1,0,2017-2018,0.8527131782945736,2.635658914728682
87,Florin Andone,ROU,FW,La Coruña,La Liga,24,1993,18.2,9,7,4,4,1,4,17,23.5,13,9,2,7,3,12,12,0,0,2017-2018,0.16483516483516483,0.4945054945054945
88,Nícolas Andrade,BRA,GK,Hellas Verona,Serie A,29,1988,36.0,2,1,2,0,0,1,4,25.0,3,2,0,2,2,4,16,7,0,2017-2018,0.05555555555555555,0.05555555555555555
89,Benjamin André,FRA,MF,Rennes,Ligue 1,26,1990,33.5,93,54,36,50,7,43,113,38.1,70,56,4,52,57,150,96,1,0,2017-2018,1.7014925373134329,2.7761194029850746
90,Marco Andreolli,ITA,DF,Cagliari,Serie A,31,1986,20.3,25,17,20,4,1,12,20,60.0,8,24,17,7,30,55,139,0,0,2017-2018,1.477832512315271,1.2315270935960592
91,Yoann Andreu,FRA,DF,Angers,Ligue 1,28,1989,23.0,48,30,40,6,2,16,39,41.0,23,23,5,18,37,85,75,1,0,2017-2018,1.608695652173913,2.0869565217391304
92,Miguel Ángel Guerrero,ESP,FW,Leganés,La Liga,27,1990,16.0,7,5,0,2,5,1,11,9.1,10,11,0,11,9,16,16,0,0,2017-2018,0.5625,0.4375
93,José Ángel,ESP,DF,Eibar,La Liga,27,1989,27.0,61,44,36,19,6,38,58,65.5,20,31,1,30,38,99,76,0,0,2017-2018,1.4074074074074074,2.259259259259259
94,Miguel Ángel Moyá,ESP,GK,Real Sociedad,La Liga,33,1984,8.5,0,0,0,0,0,0,1,0.0,1,0,0,0,2,2,7,0,0,2017-2018,0.23529411764705882,0.0
95,Miguel Ángel Rubio,ESP,DF,Getafe,La Liga,19,1998,0.3,0,0,0,0,0,0,0,0.0,0,0,0,0,0,0,1,0,0,2017-2018,0.0,0.0
96,Gabriele Angella,ITA,DF,Udinese,Serie A,28,1989,9.9,15,13,11,3,1,8,11,72.7,3,11,9,2,21,36,66,0,0,2017-2018,2.121212121212121,1.5151515151515151
97,Cristian Ansaldi,ARG,DF,Torino,Serie A,30,1986,20.8,49,33,25,20,4,14,37,37.8,23,23,5,18,20,69,61,0,0,2017-2018,0.9615384615384615,2.355769230769231
98,Luca Antei,ITA,DF,Benevento,Serie A,25,1992,6.6,19,14,12,7,0,6,11,54.5,5,10,8,2,26,45,35,0,0,2017-2018,3.9393939393939394,2.878787878787879
99,Mirco Antenucci,ITA,FW,SPAL,Serie A,32,1984,28.6,16,13,6,8,2,0,21,0.0,21,14,0,14,11,27,15,0,0,2017-2018,0.3846153846153846,0.5594405594405594
100,Waldemar Anton,GER,"DF,MF",Hannover 96,Bundesliga,21,1996,25.3,65,49,39,21,5,41,65,63.1,24,56,27,29,39,104,112,3,0,2017-2018,1.541501976284585,2.569169960474308
101,Luca Antonelli,ITA,"DF,FW",Milan,Serie A,30,1987,1.6,1,1,0,0,1,0,2,0.0,2,1,0,1,1,2,8,0,0,2017-2018,0.625,0.625
102,Michail Antonio,JAM,"FW,MF",West Ham,Premier League,27,1990,15.0,15,9,7,6,2,4,14,28.6,10,14,0,14,13,28,16,0,0,2017-2018,0.8666666666666667,1.0
103,Mirko Antonucci,ITA,FW,Roma,Serie A,18,1999,0.3,0,0,0,0,0,0,0,0.0,0,0,0,0,0,0,0,0,0,2017-2018,0.0,0.0
104,Vitorino Antunes,POR,DF,Getafe,La Liga,30,1987,31.1,58,44,42,14,2,38,74,51.4,36,31,3,28,58,116,89,1,0,2017-2018,1.864951768488746,1.864951768488746
105,Dennis Aogo,GER,"MF,DF",Stuttgart,Bundesliga,30,1987,21.7,35,26,17,18,0,14,22,63.6,8,27,3,24,29,64,27,1,0,2017-2018,1.336405529953917,1.6129032258064517
106,Houssem Aouar,ALG,"MF,FW",Lyon,Ligue 1,19,1998,27.0,66,42,22,39,5,20,66,30.3,46,30,0,30,39,105,34,0,0,2017-2018,1.4444444444444444,2.4444444444444446
107,Alberto Aquilani,ITA,MF,Las Palmas,La Liga,33,1984,14.4,33,19,13,17,3,11,31,35.5,20,20,4,16,23,56,23,0,0,2017-2018,1.597222222222222,2.2916666666666665
108,Mauro Arambarri,URU,MF,Getafe,La Liga,21,1995,23.6,56,41,19,30,7,14,47,29.8,33,26,3,23,25,81,36,0,0,2017-2018,1.059322033898305,2.3728813559322033
109,Guilherme Arana,BRA,DF,Sevilla,La Liga,20,1997,2.1,4,2,3,1,0,1,1,100.0,0,0,0,0,5,9,8,0,0,2017-2018,2.380952380952381,1.9047619047619047
110,Charles Aránguiz,CHI,MF,Leverkusen,Bundesliga,28,1989,25.6,75,61,17,50,8,33,62,53.2,29,46,5,41,48,123,27,2,0,2017-2018,1.875,2.9296875
111,Luiz Araújo,BRA,"FW,MF",Lille,Ligue 1,21,1996,22.4,41,31,23,17,1,10,47,21.3,37,24,0,24,16,57,11,1,0,2017-2018,0.7142857142857143,1.830357142857143
112,Sergio Araujo,ARG,"MF,FW",Las Palmas,La Liga,25,1992,0.4,3,2,0,0,3,1,1,100.0,0,0,0,0,0,3,0,0,0,2017-2018,0.0,7.5
113,Anaitz Arbilla,ESP,DF,Eibar,La Liga,30,1987,26.8,38,30,24,12,2,21,40,52.5,19,21,10,11,78,116,108,2,0,2017-2018,2.9104477611940296,1.417910447761194
114,Alphonse Areola,FRA,GK,Paris S-G,Ligue 1,24,1993,34.0,0,0,0,0,0,0,1,0.0,1,0,0,0,0,0,7,4,0,2017-2018,0.0,0.0
115,Scott Arfield,CAN,"MF,FW",Burnley,Premier League,28,1988,14.8,36,26,20,13,3,19,44,43.2,25,22,1,21,11,47,24,0,0,2017-2018,0.7432432432432432,2.4324324324324325
116,Samuel Armenteros,SWE,FW,Benevento,Serie A,27,1990,4.8,4,2,1,3,0,0,3,0.0,3,1,1,0,1,5,3,0,0,2017-2018,0.20833333333333334,0.8333333333333334
117,Yoël Armougom,FRA,"DF,MF",Caen,Ligue 1,19,1998,1.5,2,1,0,1,1,1,1,100.0,0,1,1,0,1,3,2,1,0,2017-2018,0.6666666666666666,1.3333333333333333
118,José Arnaiz,ESP,MF,Barcelona,La Liga,22,1995,0.1,1,1,0,1,0,0,0,0.0,0,0,0,0,0,1,0,0,0,2017-2018,0.0,10.0
119,Marko Arnautović,AUT,"FW,MF",West Ham,Premier League,28,1989,25.7,21,16,9,8,4,7,19,36.8,12,20,3,17,13,34,35,0,0,2017-2018,0.5058365758754864,0.8171206225680934
120,Maximilian Arnold,GER,MF,Wolfsburg,Bundesliga,23,1994,27.3,51,41,23,23,5,25,57,43.9,32,31,4,27,28,79,34,0,0,2017-2018,1.0256410256410255,1.8681318681318682
121,Jann-Fiete Arp,GER,"FW,MF",Hamburger SV,Bundesliga,17,2000,9.4,7,5,0,3,4,1,7,14.3,6,6,0,6,2,9,7,0,0,2017-2018,0.2127659574468085,0.7446808510638298
122,Alejandro Arribas,ESP,DF,La Coruña,La Liga,28,1989,3.0,2,2,1,1,0,1,5,20.0,4,5,3,2,6,8,8,0,0,2017-2018,2.0,0.6666666666666666
123,Kepa Arrizabalaga,ESP,GK,Athletic Club,La Liga,22,1994,30.0,0,0,0,0,0,0,2,0.0,2,0,0,0,2,2,6,2,0,2017-2018,0.06666666666666667,0.0
124,Harry Arter,IRL,MF,Bournemouth,Premier League,27,1989,10.7,19,16,10,7,2,6,23,26.1,17,18,5,13,9,28,6,0,0,2017-2018,0.8411214953271029,1.7757009345794394
125,Aythami Artiles,ESP,DF,Las Palmas,La Liga,31,1986,2.0,2,2,2,0,0,0,1,0.0,1,2,1,1,2,4,19,0,0,2017-2018,1.0,1.0
126,Kwadwo Asamoah,GHA,DF,Juventus,Serie A,28,1988,17.4,28,21,12,14,2,15,23,65.2,8,11,0,11,18,46,30,0,0,2017-2018,1.0344827586206897,1.6091954022988506
127,Takuma Asano,JPN,"FW,MF",Stuttgart,Bundesliga,22,1994,8.0,7,5,3,3,1,2,8,25.0,6,7,0,7,3,10,2,0,0,2017-2018,0.375,0.875
128,Santiago Ascacíbar,ARG,MF,Stuttgart,Bundesliga,20,1997,26.5,91,65,41,43,7,41,74,55.4,33,45,10,35,47,138,38,1,0,2017-2018,1.7735849056603774,3.4339622641509435
129,Sergio Asenjo,ESP,GK,Villarreal,La Liga,28,1989,23.0,2,2,2,0,0,1,5,20.0,4,0,0,0,0,2,11,2,0,2017-2018,0.0,0.08695652173913043
130,Marco Asensio,ESP,"FW,MF",Real Madrid,La Liga,21,1996,20.5,26,17,7,13,6,11,26,42.3,15,15,0,15,9,35,2,0,0,2017-2018,0.43902439024390244,1.2682926829268293
131,Iago Aspas,ESP,FW,Celta Vigo,La Liga,29,1987,32.6,26,22,10,10,6,5,34,14.7,29,15,1,14,23,49,11,1,0,2017-2018,0.705521472392638,0.7975460122699386
132,Benoît Assou-Ekotto,CMR,DF,Metz,Ligue 1,33,1984,11.7,12,9,5,6,1,5,15,33.3,10,7,4,3,46,58,21,0,0,2017-2018,3.931623931623932,1.0256410256410258
133,Simon Asta,GER,MF,Augsburg,Bundesliga,16,2001,0.1,2,1,2,0,0,2,2,100.0,0,1,0,1,0,2,0,0,0,2017-2018,0.0,20.0
134,Davide Astori,ITA,DF,Fiorentina,Serie A,30,1987,25.0,47,31,33,13,1,18,29,62.1,11,29,17,12,51,98,131,2,0,2017-2018,2.04,1.88
135,Christian Atsu,GHA,"FW,MF",Newcastle Utd,Premier League,25,1992,19.8,17,16,10,7,0,7,20,35.0,13,35,5,30,13,30,27,1,0,2017-2018,0.6565656565656566,0.8585858585858586
136,Pierre-Emerick Aubameyang,GAB,FW,Arsenal,Premier League,28,1989,11.7,5,4,3,2,0,1,7,14.3,6,14,1,13,3,8,7,0,0,2017-2018,0.25641025641025644,0.4273504273504274
137,Pierre-Emerick Aubameyang,GAB,FW,Dortmund,Bundesliga,28,1989,15.7,5,5,1,1,3,2,8,25.0,6,16,1,15,3,8,1,0,0,2017-2018,0.1910828025477707,0.3184713375796179
138,Jean-Kévin Augustin,FRA,FW,RB Leipzig,Bundesliga,20,1997,14.1,16,11,4,11,1,3,7,42.9,4,17,1,16,4,20,4,0,0,2017-2018,0.28368794326241137,1.1347517730496455
139,Ludwig Augustinsson,SWE,"DF,FW",Werder Bremen,Bundesliga,23,1994,28.1,45,34,22,20,3,22,32,68.8,10,25,3,22,39,84,53,0,0,2017-2018,1.387900355871886,1.601423487544484
140,Yann Aurel Bisseck,GER,"DF,MF",Köln,Bundesliga,16,2000,1.7,2,2,2,0,0,1,1,100.0,0,1,1,0,3,5,8,0,0,2017-2018,1.7647058823529411,1.1764705882352942
141,Serge Aurier,CIV,DF,Tottenham,Premier League,24,1992,15.9,48,27,27,13,8,11,31,35.5,20,20,1,19,31,79,54,1,0,2017-2018,1.949685534591195,3.0188679245283017
142,Charlie Austin,ENG,FW,Southampton,Premier League,28,1989,11.5,7,5,1,3,3,3,10,30.0,7,15,3,12,1,8,10,0,0,2017-2018,0.08695652173913043,0.6086956521739131
143,Danilo Avelar,BRA,DF,Amiens,Ligue 1,28,1989,19.2,41,33,27,9,5,14,45,31.1,31,16,7,9,37,78,83,1,0,2017-2018,1.9270833333333335,2.135416666666667
144,Felipe Avenatti,URU,FW,Bologna,Serie A,24,1993,5.2,6,4,1,5,0,1,2,50.0,1,7,1,6,1,7,6,0,0,2017-2018,0.1923076923076923,1.1538461538461537
145,Durel Avounou,CGO,"DF,MF",Caen,Ligue 1,19,1997,7.2,16,11,6,9,1,5,17,29.4,12,12,1,11,10,26,25,0,0,2017-2018,1.3888888888888888,2.2222222222222223
146,Chidozie Awaziem,NGA,DF,Nantes,Ligue 1,20,1997,16.8,43,30,33,10,0,28,40,70.0,12,18,11,7,16,59,97,0,0,2017-2018,0.9523809523809523,2.5595238095238093
147,André Ayew,GHA,"MF,FW",West Ham,Premier League,27,1989,9.9,19,14,6,10,3,6,19,31.6,13,5,0,5,4,23,3,0,0,2017-2018,0.40404040404040403,1.9191919191919191
148,André Ayew,GHA,"MF,FW",Swansea City,Premier League,27,1989,10.6,15,10,3,10,2,2,13,15.4,11,13,1,12,5,20,8,0,0,2017-2018,0.4716981132075472,1.4150943396226416
149,Jordan Ayew,GHA,"FW,MF",Swansea City,Premier League,25,1991,31.7,82,60,20,35,27,15,54,27.8,39,43,3,40,24,106,20,1,0,2017-2018,0.7570977917981073,2.586750788643533
150,Karim Azamoum,FRA,MF,Troyes,Ligue 1,27,1990,25.0,84,57,41,37,6,27,68,39.7,41,30,11,19,26,110,61,3,0,2017-2018,1.04,3.36
151,César Azpilicueta,ESP,DF,Chelsea,Premier League,27,1989,37.0,80,59,47,26,7,27,54,50.0,27,48,22,26,54,134,135,1,0,2017-2018,1.4594594594594594,2.1621621621621623
152,Ludovic Baal,GUF,DF,Rennes,Ligue 1,31,1986,12.9,41,27,29,8,4,13,35,37.1,22,13,2,11,15,56,37,1,0,2017-2018,1.1627906976744187,3.1782945736434107
153,Khouma Babacar,SEN,FW,Fiorentina,Serie A,24,1993,5.0,4,4,3,0,1,2,4,50.0,2,0,0,0,2,6,5,0,0,2017-2018,0.4,0.8
154,Khouma Babacar,SEN,FW,Sassuolo,Serie A,24,1993,8.3,10,6,2,4,4,2,6,33.3,4,8,0,8,3,13,1,0,0,2017-2018,0.36144578313253006,1.2048192771084336
155,Carlos Bacca,COL,FW,Villarreal,La Liga,30,1986,27.7,10,2,2,4,4,1,12,8.3,11,16,1,15,8,18,16,0,0,2017-2018,0.2888086642599278,0.36101083032490977
156,Milan Badelj,CRO,MF,Fiorentina,Serie A,28,1989,26.1,71,41,26,38,7,28,71,39.4,43,48,2,46,71,142,52,3,0,2017-2018,2.7203065134099615,2.7203065134099615
157,Holger Badstuber,GER,"DF,MF",Stuttgart,Bundesliga,28,1989,24.1,44,32,29,14,1,22,39,56.4,17,27,14,13,41,85,111,4,0,2017-2018,1.7012448132780082,1.8257261410788381
158,Dylan Bahamboula,CGO,"FW,MF",Dijon,Ligue 1,22,1995,0.3,0,0,0,0,0,0,0,0.0,0,0,0,0,0,0,0,0,0,2017-2018,0.0,0.0
159,Farès Bahlouli,FRA,"MF,FW",Lille,Ligue 1,22,1995,3.4,10,8,4,3,3,2,7,28.6,5,7,0,7,1,11,1,0,0,2017-2018,0.29411764705882354,2.9411764705882355
160,Stéphane Bahoken,CMR,FW,Strasbourg,Ligue 1,25,1992,18.5,16,11,3,8,5,4,22,18.2,18,18,1,17,9,25,1,0,0,2017-2018,0.4864864864864865,0.8648648648648649
161,Daniel Baier,GER,MF,Augsburg,Bundesliga,33,1984,28.2,83,62,38,40,5,46,83,55.4,37,26,5,21,57,140,41,1,0,2017-2018,2.021276595744681,2.9432624113475176
162,Leon Bailey,JAM,"FW,DF",Leverkusen,Bundesliga,19,1997,24.6,16,12,7,4,5,8,13,61.5,5,28,0,28,15,31,6,0,0,2017-2018,0.6097560975609756,0.6504065040650406
163,Eric Bailly,CIV,DF,Manchester Utd,Premier League,23,1994,11.1,17,10,10,5,2,5,12,41.7,7,11,6,5,25,42,58,1,0,2017-2018,2.2522522522522523,1.5315315315315317
164,Leighton Baines,ENG,DF,Everton,Premier League,32,1984,21.2,25,13,18,3,4,9,14,64.3,5,18,6,12,25,50,56,0,0,2017-2018,1.179245283018868,1.179245283018868
165,Riad Bajić,BIH,"FW,MF",Udinese,Serie A,23,1994,0.9,0,0,0,0,0,0,0,0.0,0,0,0,0,0,0,3,0,0,2017-2018,0.0,0.0
166,Marvin Bakalorz,GER,MF,Hannover 96,Bundesliga,27,1989,22.8,44,25,19,23,2,22,37,59.5,15,38,7,31,20,64,46,1,0,2017-2018,0.8771929824561403,1.9298245614035088
167,Cédric Bakambu,COD,FW,Villarreal,La Liga,26,1991,14.0,10,7,3,6,1,1,7,14.3,6,9,1,8,3,13,27,0,0,2017-2018,0.21428571428571427,0.7142857142857143
168,Tiemoué Bakayoko,FRA,MF,Chelsea,Premier League,22,1994,23.6,64,41,25,32,7,16,48,33.3,32,23,6,17,37,101,38,4,0,2017-2018,1.5677966101694913,2.711864406779661
169,Zakaria Bakkali,BEL,"FW,MF",La Coruña,La Liga,21,1996,10.1,12,10,7,4,1,4,14,28.6,10,5,0,5,4,16,6,0,0,2017-2018,0.39603960396039606,1.188118811881188
170,Ridle Baku,GER,MF,Mainz 05,Bundesliga,19,1998,2.6,3,3,1,1,1,0,1,0.0,1,3,0,3,3,6,2,0,0,2017-2018,1.1538461538461537,1.1538461538461537
171,Keita Baldé,SEN,"FW,MF",Monaco,Ligue 1,22,1995,16.4,12,8,5,6,1,1,11,9.1,10,10,1,9,6,18,5,0,0,2017-2018,0.3658536585365854,0.7317073170731708
172,Sam Baldock,ENG,FW,Brighton,Premier League,28,1989,0.4,0,0,0,0,0,0,0,0.0,0,0,0,0,0,0,0,0,0,2017-2018,0.0,0.0
173,Gareth Bale,WAL,"FW,MF",Real Madrid,La Liga,28,1989,20.0,19,13,7,8,4,3,14,21.4,11,13,1,12,12,31,18,0,0,2017-2018,0.6,0.95
174,Mikel Balenziaga,ESP,DF,Athletic Club,La Liga,29,1988,17.2,34,24,17,13,4,15,27,55.6,12,24,5,19,17,51,61,0,0,2017-2018,0.9883720930232559,1.9767441860465118
175,Andrija Balić,CRO,MF,Udinese,Serie A,19,1997,12.0,18,9,5,12,1,8,27,29.6,19,6,3,3,16,34,13,0,0,2017-2018,1.3333333333333333,1.5
176,Iván Balliu,ALB,DF,Metz,Ligue 1,25,1992,21.7,34,22,22,6,6,12,28,42.9,16,23,9,14,27,61,64,1,0,2017-2018,1.2442396313364055,1.566820276497696
177,Fodé Ballo-Touré,SEN,DF,Lille,Ligue 1,20,1997,22.8,50,36,29,16,5,21,47,44.7,26,27,2,25,28,78,47,1,0,2017-2018,1.2280701754385965,2.1929824561403506
178,Florent Balmont,FRA,MF,Dijon,Ligue 1,37,1980,9.6,14,9,4,9,1,4,25,16.0,21,15,1,14,8,22,5,0,0,2017-2018,0.8333333333333334,1.4583333333333335
179,Leon Balogun,NGA,DF,Mainz 05,Bundesliga,29,1988,13.0,39,32,27,11,1,22,31,71.0,9,21,9,12,32,71,64,0,0,2017-2018,2.4615384615384617,3.0
180,Mario Balotelli,ITA,FW,Nice,Ligue 1,26,1990,25.2,7,4,1,3,3,0,6,0.0,6,9,2,7,8,15,26,0,0,2017-2018,0.31746031746031744,0.2777777777777778
181,Abdoulaye Bamba,CIV,DF,Angers,Ligue 1,27,1990,17.0,29,22,23,6,0,16,30,53.3,14,8,1,7,11,40,52,0,0,2017-2018,0.6470588235294118,1.7058823529411764
182,Jonathan Bamba,CIV,FW,Saint-Étienne,Ligue 1,21,1996,28.6,30,21,18,11,1,12,61,19.7,49,30,4,26,19,49,17,0,0,2017-2018,0.6643356643356643,1.048951048951049
183,Yacine Bammou,MAR,"MF,FW",Nantes,Ligue 1,25,1991,8.1,18,11,6,10,2,4,14,28.6,10,16,4,12,6,24,9,0,0,2017-2018,0.7407407407407408,2.2222222222222223
184,Éver Banega,ARG,MF,Sevilla,La Liga,29,1988,26.7,71,53,25,37,9,22,63,34.9,41,23,1,22,12,83,17,3,0,2017-2018,0.449438202247191,2.659176029962547
185,Mattia Bani,ITA,DF,Chievo,Serie A,23,1993,14.6,28,20,22,6,0,11,26,42.3,15,19,10,9,27,55,111,0,0,2017-2018,1.8493150684931507,1.9178082191780823
186,Beni Baningime,COD,MF,Everton,Premier League,18,1998,2.2,6,2,1,2,3,0,4,0.0,4,5,1,4,2,8,2,0,0,2017-2018,0.9090909090909091,2.727272727272727
187,Léo Baptistão,BRA,"FW,MF",Espanyol,La Liga,24,1992,29.7,54,34,12,28,14,13,52,25.0,39,22,1,21,23,77,25,0,0,2017-2018,0.7744107744107744,1.8181818181818181
188,Sekou Baradji,FRA,MF,Amiens,Ligue 1,33,1984,0.1,0,0,0,0,0,0,0,0.0,0,0,0,0,1,1,0,0,0,2017-2018,10.0,0.0
189,Antonín Barák,CZE,MF,Udinese,Serie A,22,1994,30.1,58,38,22,27,9,21,58,36.2,37,34,2,32,18,76,26,1,0,2017-2018,0.5980066445182723,1.9269102990033222
190,Andrea Barberis,ITA,MF,Crotone,Serie A,23,1993,33.7,80,44,33,42,5,16,68,23.5,52,52,5,47,58,138,67,1,0,2017-2018,1.7210682492581602,2.373887240356083
191,Mariano Barbosa,ARG,GK,Villarreal,La Liga,33,1984,12.5,0,0,0,0,0,0,0,0.0,0,0,0,0,1,1,4,0,0,2017-2018,0.08,0.0
192,Enis Bardhi,MKD,MF,Levante,La Liga,22,1995,17.6,39,26,14,16,9,10,38,26.3,28,11,0,11,16,55,7,0,0,2017-2018,0.9090909090909091,2.215909090909091
193,Phil Bardsley,SCO,DF,Burnley,Premier League,32,1985,12.5,17,16,9,7,1,4,11,36.4,7,22,6,16,22,39,77,0,0,2017-2018,1.76,1.36
194,Nicolò Barella,ITA,MF,Cagliari,Serie A,20,1997,32.8,92,69,37,43,12,25,78,32.1,53,48,6,42,45,137,53,0,0,2017-2018,1.3719512195121952,2.804878048780488
195,Philipp Bargfrede,GER,MF,Werder Bremen,Bundesliga,28,1989,20.7,60,45,29,30,1,33,55,60.0,22,35,12,23,47,107,52,0,0,2017-2018,2.2705314009661834,2.898550724637681
196,Ross Barkley,ENG,MF,Chelsea,Premier League,23,1993,1.4,0,0,0,0,0,0,1,0.0,1,3,1,2,0,0,2,0,0,2017-2018,0.0,0.0
197,Aymen Barkok,MAR,"FW,MF",Eint Frankfurt,Bundesliga,19,1998,3.5,11,11,6,4,1,5,7,71.4,2,8,2,6,2,13,3,0,0,2017-2018,0.5714285714285714,3.142857142857143
198,Ashley Barnes,ENG,FW,Burnley,Premier League,27,1989,24.1,21,14,1,14,6,5,29,17.2,24,26,5,21,2,23,19,0,0,2017-2018,0.08298755186721991,0.871369294605809
199,Harvey Barnes,ENG,"MF,FW",Leicester City,Premier League,19,1997,0.1,0,0,0,0,0,0,0,0.0,0,0,0,0,0,0,0,0,0,2017-2018,0.0,0.0
200,Antonio Barragán,ESP,DF,Betis,La Liga,30,1987,26.4,59,42,40,11,8,24,36,66.7,12,22,5,17,24,83,66,0,0,2017-2018,0.9090909090909092,2.234848484848485
201,Antonio Barreca,ITA,DF,Torino,Serie A,22,1995,5.2,9,8,3,5,1,4,4,100.0,0,3,0,3,5,14,16,0,0,2017-2018,0.9615384615384615,1.7307692307692306
202,Édgar Barreto,PAR,MF,Sampdoria,Serie A,33,1984,21.8,67,42,23,32,12,18,70,25.7,52,45,2,43,21,88,29,3,0,2017-2018,0.963302752293578,3.073394495412844
203,Barri,ESP,"MF,FW",Getafe,La Liga,21,1995,1.3,1,0,0,1,0,0,4,0.0,4,1,1,0,1,2,3,0,0,2017-2018,0.7692307692307692,0.7692307692307692
204,Musa Barrow,GAM,FW,Atalanta,Serie A,18,1998,4.9,5,2,1,3,1,2,4,50.0,2,2,0,2,1,6,2,0,0,2017-2018,0.2040816326530612,1.0204081632653061
205,Gareth Barry,ENG,MF,West Brom,Premier League,36,1981,21.4,35,19,17,14,4,15,45,33.3,30,19,11,8,14,49,34,0,0,2017-2018,0.6542056074766356,1.6355140186915889
206,Fin Bartels,GER,FW,Werder Bremen,Bundesliga,30,1987,12.5,12,9,4,3,5,4,12,33.3,8,5,1,4,7,19,1,1,0,2017-2018,0.56,0.96
207,Kyle Bartley,ENG,DF,Swansea City,Premier League,26,1991,2.6,3,2,3,0,0,2,2,100.0,0,6,6,0,4,7,21,0,0,2017-2018,1.5384615384615383,1.1538461538461537
208,Marc Bartra,ESP,DF,Betis,La Liga,26,1991,15.8,38,28,30,8,0,21,39,53.8,18,19,10,9,32,70,97,1,0,2017-2018,2.0253164556962022,2.4050632911392404
209,Marc Bartra,ESP,DF,Dortmund,Bundesliga,26,1991,9.0,28,19,16,12,0,15,24,62.5,9,14,2,12,28,56,43,1,0,2017-2018,3.111111111111111,3.111111111111111
210,Andrea Barzagli,ITA,DF,Juventus,Serie A,36,1981,16.1,26,15,14,11,1,9,16,56.3,7,14,7,7,17,43,46,0,0,2017-2018,1.0559006211180124,1.6149068322981366
211,Daniele Baselli,ITA,MF,Torino,Serie A,25,1992,28.0,63,33,23,36,4,20,56,35.7,36,29,5,24,57,120,40,1,0,2017-2018,2.0357142857142856,2.25
212,Nicolas Basin,FRA,DF,Metz,Ligue 1,19,1998,3.5,9,7,5,3,1,4,9,44.4,5,6,3,3,8,17,14,0,0,2017-2018,2.2857142857142856,2.5714285714285716
213,Dušan Basta,SRB,DF,Lazio,Serie A,32,1984,8.6,9,7,4,3,2,6,14,42.9,8,10,3,7,13,22,15,0,0,2017-2018,1.5116279069767442,1.0465116279069768
214,Gil Bastião Dias,POR,"FW,MF",Fiorentina,Serie A,20,1996,13.2,49,31,28,15,6,19,48,39.6,29,23,0,23,19,68,12,1,0,2017-2018,1.4393939393939394,3.7121212121212124
215,Gil Bastião Dias,POR,MF,Monaco,Ligue 1,20,1996,0.1,1,1,0,1,0,0,0,0.0,0,0,0,0,0,1,0,0,0,2017-2018,0.0,10.0
216,Samuel Bastien,COD,MF,Chievo,Serie A,20,1996,15.1,17,13,7,8,2,7,23,30.4,16,23,2,21,18,35,25,0,0,2017-2018,1.1920529801324504,1.1258278145695364
217,Borja Bastón,ESP,FW,Málaga,La Liga,24,1992,10.9,9,7,1,6,2,1,13,7.7,12,7,0,7,3,12,5,0,0,2017-2018,0.27522935779816515,0.8256880733944953
218,Alessandro Bastoni,ITA,DF,Atalanta,Serie A,18,1999,1.0,2,2,2,0,0,1,1,100.0,0,0,0,0,1,3,3,0,0,2017-2018,1.0,2.0
219,Bastos,ANG,DF,Lazio,Serie A,26,1991,15.6,33,24,19,13,1,19,30,63.3,11,13,8,5,24,57,67,0,0,2017-2018,1.5384615384615385,2.1153846153846154
220,Michy Batshuayi,BEL,FW,Chelsea,Premier League,23,1993,4.0,5,4,2,3,0,1,3,33.3,2,0,0,0,1,6,3,0,0,2017-2018,0.25,1.25
221,Michy Batshuayi,BEL,FW,Dortmund,Bundesliga,23,1993,9.3,8,6,1,4,3,2,4,50.0,2,4,0,4,0,8,5,0,0,2017-2018,0.0,0.8602150537634408
222,Moritz Bauer,AUT,"DF,MF",Stoke City,Premier League,25,1992,14.5,24,17,17,7,0,10,26,38.5,16,9,1,8,12,36,48,0,0,2017-2018,0.8275862068965517,1.6551724137931034
223,Robert Bauer,GER,"DF,FW",Werder Bremen,Bundesliga,22,1995,10.6,31,25,21,9,1,15,25,60.0,10,8,2,6,21,52,25,2,0,2017-2018,1.9811320754716981,2.9245283018867925
224,Oliver Baumann,GER,GK,Hoffenheim,Bundesliga,27,1990,34.0,0,0,0,0,0,0,2,0.0,2,0,0,0,1,1,15,6,0,2017-2018,0.029411764705882353,0.0
225,Timo Baumgartl,GER,DF,Stuttgart,Bundesliga,21,1996,29.0,87,71,55,29,3,56,75,74.7,19,50,21,29,34,121,132,1,0,2017-2018,1.1724137931034482,3.0
226,Julian Baumgartlinger,AUT,"MF,DF",Leverkusen,Bundesliga,29,1988,15.5,47,37,21,21,5,14,29,48.3,15,25,2,23,18,65,23,0,0,2017-2018,1.1612903225806452,3.032258064516129
227,Jon Bautista,ESP,"FW,MF",Real Sociedad,La Liga,22,1995,2.0,0,0,0,0,0,0,1,0.0,1,2,0,2,0,0,0,0,0,2017-2018,0.0,0.0
228,Paul Baysse,FRA,DF,Málaga,La Liga,29,1988,13.8,25,16,21,3,1,10,17,58.8,7,10,6,4,20,45,84,0,0,2017-2018,1.4492753623188406,1.8115942028985506
229,Paul Baysse,FRA,DF,Bordeaux,Ligue 1,29,1988,6.3,4,2,3,1,0,1,5,20.0,4,4,3,1,7,11,38,1,0,2017-2018,1.1111111111111112,0.6349206349206349
230,Noah Joel Sarenren Bazee,NGA,"FW,MF",Hannover 96,Bundesliga,20,1996,1.3,0,0,0,0,0,0,0,0.0,0,3,0,3,0,0,3,0,0,2017-2018,0.0,0.0
231,Hervé Bazile,HAI,"MF,FW",Caen,Ligue 1,27,1990,9.7,21,15,9,7,5,5,15,33.3,10,22,0,22,15,36,8,0,0,2017-2018,1.5463917525773196,2.1649484536082477
232,Riechedly Bazoer,NED,MF,Wolfsburg,Bundesliga,20,1996,6.6,8,7,5,2,1,2,4,50.0,2,2,1,1,8,16,4,1,0,2017-2018,1.2121212121212122,1.2121212121212122
233,Enrico Bearzotti,ITA,"DF,FW",Hellas Verona,Serie A,20,1996,4.6,3,2,2,0,1,1,4,25.0,3,3,1,2,4,7,18,0,0,2017-2018,0.8695652173913044,0.6521739130434783
234,Claudio Beauvue,GLP,FW,Leganés,La Liga,29,1988,18.6,5,3,2,2,1,1,12,8.3,11,7,0,7,2,7,16,0,0,2017-2018,0.1075268817204301,0.26881720430107525
235,Bebé,CPV,"MF,FW",Eibar,La Liga,27,1990,4.1,9,7,1,4,4,3,8,37.5,5,5,0,5,3,12,1,0,0,2017-2018,0.7317073170731708,2.1951219512195124
236,Ihlas Bebou,TOG,"MF,FW",Hannover 96,Bundesliga,23,1994,23.8,37,29,15,17,5,14,27,51.9,13,34,3,31,24,61,27,0,0,2017-2018,1.0084033613445378,1.5546218487394958
237,Andreas Beck,GER,DF,Stuttgart,Bundesliga,30,1987,21.4,46,29,27,16,3,21,31,67.7,10,32,2,30,19,65,46,1,0,2017-2018,0.8878504672897197,2.149532710280374
238,Henri Bedimo,CMR,"DF,FW",Marseille,Ligue 1,33,1984,0.5,0,0,0,0,0,0,1,0.0,1,0,0,0,1,1,1,0,0,2017-2018,2.0,0.0
239,Jan Bednarek,POL,DF,Southampton,Premier League,21,1996,4.7,6,3,6,0,0,3,6,50.0,3,2,1,1,5,11,27,0,0,2017-2018,1.0638297872340425,1.276595744680851
240,Asmir Begović,BIH,GK,Bournemouth,Premier League,30,1987,38.0,0,0,0,0,0,0,2,0.0,2,0,0,0,2,2,16,7,0,2017-2018,0.05263157894736842,0.0
241,Valon Behrami,SUI,MF,Udinese,Serie A,32,1985,15.5,63,46,30,27,6,8,44,18.2,36,47,15,32,22,85,19,0,0,2017-2018,1.4193548387096775,4.064516129032258
242,Vid Belec,SVN,GK,Benevento,Serie A,27,1990,12.4,0,0,0,0,0,0,0,0.0,0,0,0,0,1,1,6,1,0,2017-2018,0.08064516129032258,0.0
243,Vid Belec,SVN,GK,Sampdoria,Serie A,27,1990,2.0,0,0,0,0,0,0,0,0.0,0,0,0,0,0,0,1,0,0,2017-2018,0.0,0.0
244,Ishak Belfodil,ALG,FW,Werder Bremen,Bundesliga,25,1992,15.0,7,6,2,3,2,0,3,0.0,3,10,1,9,1,8,9,0,0,2017-2018,0.06666666666666667,0.4666666666666667
245,Stefan Bell,GER,DF,Mainz 05,Bundesliga,25,1991,24.2,36,25,23,13,0,27,39,69.2,12,35,18,17,46,82,123,2,0,2017-2018,1.9008264462809918,1.4876033057851241
246,Karim Bellarabi,GER,"MF,FW",Leverkusen,Bundesliga,27,1990,12.7,22,17,10,9,3,10,19,52.6,9,26,1,25,13,35,5,0,0,2017-2018,1.0236220472440944,1.7322834645669292
247,Héctor Bellerín,ESP,DF,Arsenal,Premier League,22,1995,33.9,57,43,36,12,9,25,52,48.1,27,42,8,34,23,80,89,4,0,2017-2018,0.6784660766961652,1.68141592920354
248,François Bellugou,FRA,MF,Troyes,Ligue 1,30,1987,24.2,48,33,23,21,4,21,49,42.9,28,20,6,14,28,76,45,0,0,2017-2018,1.15702479338843,1.9834710743801653
249,Andrea Belotti,ITA,FW,Torino,Serie A,23,1993,29.8,32,23,9,15,8,3,30,10.0,27,14,1,13,6,38,19,1,0,2017-2018,0.20134228187919462,1.0738255033557047
250,Chaouki Ben Saada,TUN,"FW,MF",Troyes,Ligue 1,33,1984,3.8,11,8,5,3,3,2,11,18.2,9,3,0,3,2,13,3,0,0,2017-2018,0.5263157894736842,2.8947368421052633
251,Wissam Ben Yedder,FRA,FW,Sevilla,La Liga,26,1990,18.9,12,8,2,5,5,1,2,50.0,1,10,0,10,5,17,2,0,0,2017-2018,0.2645502645502646,0.634920634920635
252,Diego Benaglio,SUI,GK,Monaco,Ligue 1,33,1983,2.5,0,0,0,0,0,0,0,0.0,0,0,0,0,0,0,0,0,0,2017-2018,0.0,0.0
253,Ahmad Benali,LBY,MF,Crotone,Serie A,25,1992,9.0,19,10,8,10,1,5,27,18.5,22,14,1,13,8,27,15,0,0,2017-2018,0.8888888888888888,2.111111111111111
254,Yohan Benalouane,TUN,DF,Leicester City,Premier League,30,1987,1.0,7,3,6,1,0,4,6,66.7,2,1,1,0,1,8,4,0,0,2017-2018,1.0,7.0
255,Marco Benassi,ITA,"MF,FW",Fiorentina,Serie A,22,1994,30.9,54,38,18,22,14,17,52,32.7,35,52,2,50,28,82,36,0,0,2017-2018,0.9061488673139159,1.7475728155339807
256,Medhi Benatia,MAR,DF,Juventus,Serie A,30,1987,19.5,28,21,20,6,2,8,15,53.3,7,18,13,5,43,71,89,1,0,2017-2018,2.2051282051282053,1.435897435897436
257,Lars Bender,GER,"DF,MF",Leverkusen,Bundesliga,28,1989,17.7,63,52,26,32,5,35,53,66.0,18,34,7,27,28,91,40,0,0,2017-2018,1.5819209039548023,3.5593220338983054
258,Sven Bender,GER,DF,Leverkusen,Bundesliga,28,1989,26.1,51,37,33,18,0,26,34,76.5,8,49,21,28,50,101,123,1,0,2017-2018,1.9157088122605364,1.954022988505747
259,László Bénes,SVK,MF,Gladbach,Bundesliga,19,1997,0.4,0,0,0,0,0,0,1,0.0,1,2,1,1,1,1,2,0,0,2017-2018,2.5,0.0
260,Nicolas Benezet,FRA,"FW,MF",Guingamp,Ligue 1,26,1991,18.3,38,30,18,16,4,11,37,29.7,26,8,2,6,12,50,7,0,0,2017-2018,0.6557377049180327,2.0765027322404372
261,Marcel Benger,GER,MF,Gladbach,Bundesliga,19,1998,0.0,0,0,0,0,0,0,0,0.0,0,0,0,0,0,0,0,0,0,2017-2018,,
262,Walter Benítez,ARG,GK,Nice,Ligue 1,24,1993,28.0,0,0,0,0,0,0,2,0.0,2,0,0,0,0,0,5,3,0,2017-2018,0.0,0.0
263,Charlison Benschop,CUW,"MF,DF",Hannover 96,Bundesliga,27,1989,2.0,4,4,1,3,0,3,8,37.5,5,1,0,1,2,6,2,0,0,2017-2018,1.0,2.0
264,Ramy Bensebaini,ALG,DF,Rennes,Ligue 1,22,1995,26.0,56,39,31,21,4,26,55,47.3,29,24,16,8,37,93,177,1,0,2017-2018,1.4230769230769231,2.1538461538461537
265,Nabil Bentaleb,ALG,MF,Schalke 04,Bundesliga,22,1994,11.2,25,22,7,17,1,8,23,34.8,15,18,6,12,23,48,27,2,0,2017-2018,2.053571428571429,2.232142857142857
266,Rodrigo Bentancur,URU,MF,Juventus,Serie A,20,1997,6.5,18,11,10,7,1,2,16,12.5,14,5,1,4,3,21,14,0,0,2017-2018,0.46153846153846156,2.769230769230769
267,Christian Benteke,BEL,FW,Crystal Palace,Premier League,26,1990,24.9,11,4,3,7,1,2,17,11.8,15,15,3,12,3,14,44,0,0,2017-2018,0.12048192771084339,0.44176706827309237
268,Karim Benzema,FRA,FW,Real Madrid,La Liga,29,1987,23.9,14,8,2,6,6,3,20,15.0,17,18,0,18,8,22,19,0,0,2017-2018,0.3347280334728034,0.5857740585774059
269,Yassine Benzia,ALG,"MF,FW",Lille,Ligue 1,22,1994,25.4,62,41,21,31,10,17,62,27.4,45,31,4,27,28,90,14,0,0,2017-2018,1.1023622047244095,2.440944881889764
270,Saido Berahino,BDI,FW,Stoke City,Premier League,23,1993,5.5,2,2,0,1,1,0,1,0.0,1,4,1,3,1,3,2,0,0,2017-2018,0.18181818181818182,0.36363636363636365
271,Domenico Berardi,ITA,FW,Sassuolo,Serie A,22,1994,25.5,31,17,9,16,6,11,65,16.9,54,23,0,23,17,48,14,1,0,2017-2018,0.6666666666666666,1.2156862745098038
272,Yuri Berchiche,ESP,DF,Paris S-G,Ligue 1,27,1990,19.1,39,27,21,11,7,12,25,48.0,13,15,2,13,24,63,53,0,0,2017-2018,1.256544502617801,2.0418848167539267
273,Álex Berenguer,ESP,FW,Torino,Serie A,22,1995,11.6,18,15,7,8,3,5,17,29.4,12,22,3,19,10,28,13,0,0,2017-2018,0.8620689655172414,1.5517241379310345
274,Bartosz Bereszyński,POL,DF,Sampdoria,Serie A,25,1992,27.6,63,47,30,28,5,31,53,58.5,22,33,8,25,30,93,98,2,0,2017-2018,1.0869565217391304,2.282608695652174
275,Jóhann Berg Guðmundsson,ISL,MF,Burnley,Premier League,26,1990,31.5,43,27,16,19,8,20,47,42.6,27,21,1,20,34,77,43,0,0,2017-2018,1.0793650793650793,1.3650793650793651
276,Markel Bergara,ESP,MF,Getafe,La Liga,31,1986,16.3,35,22,17,17,1,7,25,28.0,18,10,3,7,23,58,20,0,0,2017-2018,1.411042944785276,2.147239263803681
277,Emil Berggreen,DEN,FW,Mainz 05,Bundesliga,24,1993,7.4,2,2,0,0,2,1,4,25.0,3,7,1,6,1,3,10,0,0,2017-2018,0.13513513513513511,0.27027027027027023
278,Robert Berić,SVN,FW,Saint-Étienne,Ligue 1,26,1991,11.6,6,4,1,3,2,1,16,6.3,15,9,1,8,5,11,4,0,0,2017-2018,0.4310344827586207,0.5172413793103449
279,Kévin Bérigaud,FRA,"FW,MF",Montpellier,Ligue 1,29,1988,3.0,4,3,1,1,2,2,6,33.3,4,1,0,1,0,4,1,0,0,2017-2018,0.0,1.3333333333333333
280,Etrit Berisha,ALB,GK,Atalanta,Serie A,28,1989,31.0,1,1,1,0,0,1,1,100.0,0,0,0,0,1,2,5,3,0,2017-2018,0.03225806451612903,0.03225806451612903
281,Federico Bernardeschi,ITA,"FW,MF",Juventus,Serie A,23,1994,9.4,8,5,4,3,1,1,7,14.3,6,9,0,9,11,19,18,1,0,2017-2018,1.1702127659574468,0.851063829787234
282,Bernardo,BRA,DF,RB Leipzig,Bundesliga,22,1995,15.0,43,30,18,22,3,29,40,72.5,11,30,6,24,18,61,81,0,0,2017-2018,1.2,2.8666666666666667
283,Juan Bernat,ESP,"DF,FW",Bayern Munich,Bundesliga,24,1993,9.9,25,19,13,8,4,11,18,61.1,7,11,1,10,10,35,9,1,0,2017-2018,1.0101010101010102,2.525252525252525
284,Andrea Bertolacci,ITA,MF,Genoa,Serie A,26,1991,32.2,85,53,40,38,7,21,63,33.3,42,46,12,34,46,131,37,1,0,2017-2018,1.4285714285714284,2.639751552795031
285,Ryan Bertrand,ENG,DF,Southampton,Premier League,27,1989,34.8,48,35,27,17,4,19,31,61.3,12,28,9,19,44,92,74,0,0,2017-2018,1.264367816091954,1.3793103448275863
286,Muhamed Bešić,BIH,MF,Everton,Premier League,24,1992,0.5,1,1,1,0,0,1,3,33.3,2,2,2,0,0,1,1,0,0,2017-2018,0.0,2.0
287,Daniel Bessa,ITA,"MF,FW",Hellas Verona,Serie A,24,1993,15.4,26,19,9,15,2,8,29,27.6,21,12,2,10,14,40,8,1,0,2017-2018,0.9090909090909091,1.6883116883116882
288,Daniel Bessa,ITA,MF,Genoa,Serie A,24,1993,4.9,6,6,2,2,2,0,1,0.0,1,7,0,7,3,9,6,0,0,2017-2018,0.6122448979591836,1.2244897959183672
289,Vincent Bessat,FRA,"DF,MF",Caen,Ligue 1,31,1985,17.4,41,27,23,16,2,22,48,45.8,26,19,1,18,18,59,18,0,0,2017-2018,1.0344827586206897,2.35632183908046
290,Quentin Beunardeau,FRA,GK,Metz,Ligue 1,23,1994,0.4,0,0,0,0,0,0,0,0.0,0,0,0,0,0,0,0,0,0,2017-2018,0.0,0.0
291,Matteo Bianchetti,ITA,DF,Hellas Verona,Serie A,24,1993,1.4,3,1,3,0,0,1,3,33.3,2,3,2,1,2,5,8,0,0,2017-2018,1.4285714285714286,2.142857142857143
292,Ermin Bičakčić,BIH,DF,Hoffenheim,Bundesliga,27,1990,6.1,17,15,8,8,1,8,12,66.7,4,4,2,2,9,26,26,0,0,2017-2018,1.4754098360655739,2.7868852459016393
293,Pedro Bigas,ESP,DF,Las Palmas,La Liga,26,1990,9.9,14,9,10,4,0,7,13,53.8,6,18,11,7,16,30,41,2,0,2017-2018,1.6161616161616161,1.4141414141414141
294,Lucas Biglia,ARG,MF,Milan,Serie A,31,1986,22.7,59,36,28,26,5,22,61,36.1,39,49,12,37,28,87,51,1,0,2017-2018,1.2334801762114538,2.5991189427312777
295,Philip Billing,DEN,MF,Huddersfield,Premier League,21,1996,8.5,25,16,11,11,3,8,22,36.4,14,17,1,16,18,43,19,0,0,2017-2018,2.1176470588235294,2.9411764705882355
296,Jean-Claude Billong,CMR,DF,Benevento,Serie A,23,1993,3.3,9,7,5,4,0,5,8,62.5,3,4,3,1,6,15,17,0,0,2017-2018,1.8181818181818183,2.7272727272727275
297,Davide Biondini,ITA,MF,Sassuolo,Serie A,34,1983,2.3,4,4,2,2,0,1,2,50.0,1,1,0,1,3,7,1,0,0,2017-2018,1.3043478260869565,1.7391304347826089
298,Cristiano Biraghi,ITA,DF,Fiorentina,Serie A,24,1992,33.1,74,48,33,32,9,36,58,62.1,22,42,5,37,43,117,103,2,0,2017-2018,1.2990936555891237,2.2356495468277946
299,Mame Biram Diouf,SEN,"FW,DF",Stoke City,Premier League,29,1987,28.8,48,36,26,15,7,8,21,38.1,13,22,0,22,14,62,76,1,0,2017-2018,0.4861111111111111,1.6666666666666665
300,Davide Biraschi,ITA,DF,Genoa,Serie A,23,1994,20.0,33,25,13,19,1,18,25,72.0,7,19,10,9,38,71,78,0,0,2017-2018,1.9,1.65
301,Valter Birsa,SVN,"MF,FW",Chievo,Serie A,30,1986,27.8,28,14,7,18,3,7,54,13.0,47,22,2,20,24,52,20,1,0,2017-2018,0.8633093525179856,1.0071942446043165
302,Milan Biševac,SRB,DF,Metz,Ligue 1,33,1983,7.9,7,5,5,1,1,5,7,71.4,2,2,0,2,5,12,43,0,0,2017-2018,0.6329113924050632,0.8860759493670886
303,Yves Bissouma,MLI,"MF,DF",Lille,Ligue 1,20,1996,17.3,67,50,30,32,5,19,39,48.7,20,13,2,11,31,98,31,1,0,2017-2018,1.791907514450867,3.8728323699421963
304,Leonardo Bittencourt,GER,"MF,FW",Köln,Bundesliga,23,1993,17.9,49,42,17,21,11,19,43,44.2,24,26,0,26,17,66,11,1,0,2017-2018,0.9497206703910616,2.7374301675977657
305,Albano Bizzarri,ARG,GK,Udinese,Serie A,39,1977,32.0,2,2,2,0,0,2,2,100.0,0,0,0,0,1,3,12,4,0,2017-2018,0.03125,0.0625
306,Rubén Blanco,ESP,GK,Celta Vigo,La Liga,22,1995,21.6,0,0,0,0,0,0,2,0.0,2,1,0,1,3,3,16,1,0,2017-2018,0.13888888888888887,0.0
307,Ludovic Blas,FRA,MF,Guingamp,Ligue 1,19,1997,19.9,23,14,10,12,1,7,36,19.4,29,15,3,12,19,42,9,1,0,2017-2018,0.9547738693467337,1.155778894472362
308,Pablo de Blasis,ARG,"FW,MF",Mainz 05,Bundesliga,29,1988,18.4,39,23,19,11,9,16,33,48.5,17,33,0,33,10,49,34,0,0,2017-2018,0.5434782608695653,2.1195652173913047
309,Jérémy Blayac,FRA,FW,Strasbourg,Ligue 1,34,1983,10.2,5,3,0,3,2,2,9,22.2,7,7,2,5,1,6,11,0,0,2017-2018,0.09803921568627452,0.4901960784313726
310,Alexis Blin,FRA,MF,Toulouse,Ligue 1,20,1996,21.0,57,37,23,30,4,22,69,31.9,47,27,6,21,31,88,31,0,0,2017-2018,1.4761904761904763,2.7142857142857144
311,Daley Blind,NED,"DF,MF",Manchester Utd,Premier League,27,1990,4.0,6,4,3,2,1,2,7,28.6,5,3,0,3,7,13,14,0,0,2017-2018,1.75,1.5
312,Danny Blum,GER,"MF,DF",Eint Frankfurt,Bundesliga,26,1991,0.3,0,0,0,0,0,0,0,0.0,0,0,0,0,1,1,0,0,0,2017-2018,3.3333333333333335,0.0
313,Emmanuel Boateng,GHA,FW,Levante,La Liga,21,1996,14.2,4,3,0,0,4,0,6,0.0,6,8,1,7,5,9,17,0,0,2017-2018,0.35211267605633806,0.28169014084507044
314,Jérôme Boateng,GER,DF,Bayern Munich,Bundesliga,28,1988,18.2,26,18,18,7,1,19,32,59.4,13,20,12,8,21,47,52,1,0,2017-2018,1.153846153846154,1.4285714285714286
315,Kevin-Prince Boateng,GHA,"MF,FW",Eint Frankfurt,Bundesliga,30,1987,26.2,34,22,10,22,2,11,36,30.6,25,29,6,23,23,57,43,1,0,2017-2018,0.8778625954198473,1.297709923664122
316,Raúl Bobadilla,PAR,"FW,MF",Gladbach,Bundesliga,30,1987,5.0,7,6,1,3,3,4,8,50.0,4,6,0,6,0,7,1,0,0,2017-2018,0.0,1.4
317,Yann Bodiger,FRA,MF,Toulouse,Ligue 1,22,1995,2.5,3,1,0,3,0,1,6,16.7,5,0,0,0,2,5,3,0,0,2017-2018,0.8,1.2
318,Mathieu Bodmer,FRA,"DF,MF",Amiens,Ligue 1,34,1982,4.4,6,3,5,1,0,5,6,83.3,1,6,3,3,1,7,15,0,0,2017-2018,0.22727272727272727,1.3636363636363635
319,Jeremie Boga,CIV,MF,Chelsea,Premier League,20,1997,0.2,0,0,0,0,0,0,0,0.0,0,0,0,0,0,0,0,0,0,2017-2018,0.0,0.0
320,Quentin Boisgard,FRA,MF,Toulouse,Ligue 1,20,1997,2.0,2,2,0,2,0,0,3,0.0,3,2,0,2,0,2,1,0,0,2017-2018,0.0,1.0
321,Yannick Bolasie,COD,FW,Everton,Premier League,28,1989,9.5,8,7,4,1,3,2,7,28.6,5,5,0,5,4,12,8,0,0,2017-2018,0.42105263157894735,0.8421052631578947
322,Deian Boldor,ROU,DF,Hellas Verona,Serie A,22,1995,1.0,3,2,3,0,0,2,3,66.7,1,5,2,3,3,6,11,0,0,2017-2018,3.0,3.0
323,Giacomo Bonaventura,ITA,MF,Milan,Serie A,27,1989,28.2,31,20,7,19,5,9,45,20.0,36,31,6,25,33,64,17,0,0,2017-2018,1.1702127659574468,1.099290780141844
324,Federico Bonazzoli,ITA,"FW,DF",SPAL,Serie A,20,1997,2.0,1,0,0,1,0,0,0,0.0,0,3,0,3,0,1,0,0,0,2017-2018,0.0,0.5
325,Federico Bonazzoli,ITA,FW,Sampdoria,Serie A,20,1997,0.3,0,0,0,0,0,0,0,0.0,0,0,0,0,0,0,0,0,0,2017-2018,0.0,0.0
326,Daniele Bonera,ITA,DF,Villarreal,La Liga,36,1981,13.2,16,11,8,7,1,10,15,66.7,5,17,12,5,12,28,72,0,0,2017-2018,0.9090909090909092,1.2121212121212122
327,Gaëtan Bong,CMR,DF,Brighton,Premier League,29,1988,24.8,39,32,25,11,3,15,26,57.7,11,24,6,18,40,79,81,1,0,2017-2018,1.6129032258064515,1.5725806451612903
328,Kevin Bonifazi,ITA,"DF,MF",Torino,Serie A,21,1996,4.5,11,7,6,5,0,4,6,66.7,2,7,5,2,13,24,15,0,0,2017-2018,2.888888888888889,2.4444444444444446
329,Landry Bonnefoi,FRA,GK,Strasbourg,Ligue 1,33,1983,3.0,0,0,0,0,0,0,0,0.0,0,0,0,0,0,0,2,0,0,2017-2018,0.0,0.0
330,Leonardo Bonucci,ITA,DF,Milan,Serie A,30,1987,34.3,30,21,22,7,1,11,18,61.1,7,31,22,9,51,81,132,0,0,2017-2018,1.4868804664723034,0.8746355685131196
331,Wilfried Bony,CIV,FW,Swansea City,Premier League,28,1988,7.9,5,4,2,2,1,1,5,20.0,4,4,1,3,2,7,15,0,0,2017-2018,0.2531645569620253,0.6329113924050632
332,Celso Borges,CRC,MF,La Coruña,La Liga,29,1988,25.6,61,39,34,22,5,15,47,31.9,32,39,7,32,34,95,36,0,0,2017-2018,1.328125,2.3828125
333,Fabio Borini,ITA,"DF,FW",Milan,Serie A,26,1991,17.9,38,23,12,18,8,16,37,43.2,21,32,6,26,13,51,43,0,0,2017-2018,0.7262569832402235,2.122905027932961
334,Marco Borriello,ITA,FW,SPAL,Serie A,35,1982,8.6,4,2,2,1,1,0,1,0.0,1,1,0,1,1,5,6,0,0,2017-2018,0.11627906976744186,0.46511627906976744
335,Gabriel Boschilia,BRA,"FW,MF",Monaco,Ligue 1,21,1996,0.9,4,1,1,2,1,1,4,25.0,3,1,0,1,0,4,0,0,0,2017-2018,0.0,4.444444444444445
336,Ryad Boudebouz,ALG,"MF,FW",Betis,La Liga,27,1990,15.1,32,18,6,21,5,6,26,23.1,20,18,1,17,7,39,8,0,0,2017-2018,0.4635761589403974,2.119205298013245
337,Jean-Christophe Bouet,FRA,GK,Amiens,Ligue 1,34,1983,1.0,0,0,0,0,0,0,0,0.0,0,0,0,0,0,0,0,0,0,2017-2018,0.0,0.0
338,Sofiane Boufal,MAR,"FW,MF",Southampton,Premier League,23,1993,13.5,37,24,12,14,11,12,35,34.3,23,20,1,19,6,43,6,0,0,2017-2018,0.4444444444444444,2.740740740740741
339,Arnold Bouka Moutou,CGO,DF,Dijon,Ligue 1,28,1988,3.7,8,5,6,0,2,6,8,75.0,2,4,1,3,4,12,5,0,0,2017-2018,1.081081081081081,2.162162162162162
340,Farid Boulaya,ALG,"MF,FW",Metz,Ligue 1,24,1993,2.0,5,1,4,1,0,3,6,50.0,3,1,0,1,1,6,2,0,0,2017-2018,0.5,2.5
341,Yassine Bounou,MAR,GK,Girona,La Liga,26,1991,29.5,1,1,1,0,0,0,2,0.0,2,0,0,0,4,5,14,0,0,2017-2018,0.13559322033898305,0.03389830508474576
342,Emmanuel Bourgaud,FRA,"FW,MF",Amiens,Ligue 1,29,1987,6.0,17,11,5,9,3,10,23,43.5,13,5,0,5,6,23,11,0,0,2017-2018,1.0,2.8333333333333335
343,Benjamin Bourigeaud,FRA,"MF,FW",Rennes,Ligue 1,23,1994,34.5,55,30,18,30,7,20,93,21.5,73,48,4,44,45,100,29,0,0,2017-2018,1.3043478260869565,1.5942028985507246
344,Eneko Bóveda,ESP,DF,La Coruña,La Liga,28,1988,7.4,24,16,13,10,1,8,13,61.5,5,18,7,11,16,40,36,2,0,2017-2018,2.162162162162162,3.243243243243243
345,Eneko Bóveda,ESP,DF,Athletic Club,La Liga,28,1988,5.8,12,11,7,4,1,5,11,45.5,6,3,0,3,14,26,14,0,0,2017-2018,2.413793103448276,2.0689655172413794
346,Lucas Boyé,ARG,FW,Torino,Serie A,21,1996,1.7,9,8,5,3,1,1,3,33.3,2,5,0,5,2,11,2,0,0,2017-2018,1.1764705882352942,5.294117647058823
347,Lucas Boyé,ARG,"FW,MF",Celta Vigo,La Liga,21,1996,3.1,12,8,3,7,2,3,10,30.0,7,5,0,5,6,18,4,0,0,2017-2018,1.9354838709677418,3.8709677419354835
348,Robbie Brady,IRL,MF,Burnley,Premier League,25,1992,14.2,32,21,14,17,1,8,28,28.6,20,17,3,14,7,39,29,0,0,2017-2018,0.49295774647887325,2.2535211267605635
349,Martin Braithwaite,DEN,FW,Bordeaux,Ligue 1,26,1991,10.2,6,4,0,4,2,1,6,16.7,5,6,2,4,0,6,3,0,0,2017-2018,0.0,0.5882352941176471
350,Brandon,ESP,"FW,MF",Rennes,Ligue 1,22,1995,4.0,10,9,3,4,3,1,11,9.1,10,11,1,10,5,15,1,0,0,2017-2018,1.25,2.5
351,Julian Brandt,GER,"FW,MF",Leverkusen,Bundesliga,21,1996,25.8,24,18,11,9,4,11,29,37.9,18,23,1,22,16,40,12,1,0,2017-2018,0.6201550387596899,0.9302325581395349
352,Darko Brašanac,SRB,"MF,FW",Leganés,La Liga,25,1992,13.4,32,17,11,17,4,13,33,39.4,20,14,3,11,14,46,12,0,0,2017-2018,1.044776119402985,2.388059701492537
353,Claudio Bravo,CHI,GK,Manchester City,Premier League,34,1983,2.5,0,0,0,0,0,0,1,0.0,1,0,0,0,0,0,0,0,0,2017-2018,0.0,0.0
354,Josip Brekalo,CRO,FW,Wolfsburg,Bundesliga,19,1998,9.7,15,12,6,7,2,6,12,50.0,6,17,0,17,4,19,3,0,0,2017-2018,0.4123711340206186,1.5463917525773196
355,Josip Brekalo,CRO,"MF,FW",Stuttgart,Bundesliga,19,1998,8.1,20,12,7,8,5,6,8,75.0,2,8,2,6,3,23,1,0,0,2017-2018,0.3703703703703704,2.469135802469136
356,Jimmy Briand,FRA,FW,Guingamp,Ligue 1,31,1985,35.7,33,21,13,15,5,4,42,9.5,38,17,2,15,12,45,51,0,0,2017-2018,0.3361344537815126,0.9243697478991596
357,Enrico Brignola,ITA,"MF,FW",Benevento,Serie A,18,1999,15.0,28,21,17,10,1,12,38,31.6,26,13,0,13,6,34,7,0,0,2017-2018,0.4,1.8666666666666667
358,Alberto Brignoli,ITA,GK,Benevento,Serie A,25,1991,12.5,0,0,0,0,0,0,0,0.0,0,0,0,0,0,0,15,3,0,2017-2018,0.0,0.0
359,Miguel Britos,URU,DF,Watford,Premier League,32,1985,8.9,15,11,10,5,0,6,11,54.5,5,9,1,8,12,27,45,1,0,2017-2018,1.348314606741573,1.6853932584269662
360,Leon Britton,ENG,MF,Swansea City,Premier League,34,1982,3.4,6,5,0,5,1,5,8,62.5,3,3,1,2,1,7,1,0,0,2017-2018,0.29411764705882354,1.7647058823529411
361,Petar Brlek,CRO,MF,Genoa,Serie A,23,1994,2.6,9,7,4,5,0,3,7,42.9,4,0,0,0,1,10,3,0,0,2017-2018,0.3846153846153846,3.4615384615384612
362,John Brooks,USA,DF,Wolfsburg,Bundesliga,24,1993,8.1,20,13,15,4,1,16,22,72.7,6,11,5,6,10,30,46,0,0,2017-2018,1.234567901234568,2.469135802469136
363,Daniel Brosinski,GER,"DF,FW",Mainz 05,Bundesliga,29,1988,27.8,45,35,21,18,6,22,44,50.0,22,46,11,35,24,69,75,2,0,2017-2018,0.8633093525179856,1.618705035971223
364,Izzy Brown,ENG,"MF,FW",Brighton,Premier League,20,1997,3.5,3,3,2,1,0,1,7,14.3,6,3,0,3,1,4,3,0,0,2017-2018,0.2857142857142857,0.8571428571428571
365,Marcelo Brozović,CRO,MF,Inter,Serie A,24,1992,21.4,60,43,21,31,8,19,63,30.2,44,30,7,23,18,78,18,0,0,2017-2018,0.8411214953271029,2.8037383177570097
366,Bruma,POR,"MF,FW",RB Leipzig,Bundesliga,22,1994,17.9,18,16,7,7,4,9,18,50.0,9,28,2,26,12,30,11,0,0,2017-2018,0.670391061452514,1.005586592178771
367,Jeffrey Bruma,NED,DF,Wolfsburg,Bundesliga,25,1991,11.0,13,11,13,0,0,6,14,42.9,8,17,12,5,14,27,43,2,0,2017-2018,1.2727272727272727,1.1818181818181819
368,Bruno,ESP,DF,Brighton,Premier League,36,1980,22.4,30,17,21,6,3,14,22,63.6,8,17,11,6,38,68,76,0,0,2017-2018,1.6964285714285716,1.3392857142857144
369,Chris Brunt,NIR,"MF,DF",West Brom,Premier League,32,1984,21.3,41,24,19,21,1,11,31,35.5,20,28,4,24,22,63,45,1,0,2017-2018,1.0328638497652582,1.9248826291079812
370,Jacob Bruun Larsen,DEN,"MF,DF",Stuttgart,Bundesliga,18,1998,1.2,0,0,0,0,0,0,0,0.0,0,1,0,1,1,1,2,0,0,2017-2018,0.8333333333333334,0.0
371,Jacob Bruun Larsen,DEN,DF,Dortmund,Bundesliga,18,1998,0.1,1,1,1,0,0,1,2,50.0,1,0,0,0,0,1,0,0,0,2017-2018,0.0,10.0
372,Marcel Büchel,LIE,MF,Hellas Verona,Serie A,26,1991,18.8,37,21,15,21,1,13,48,27.1,35,35,6,29,45,82,46,1,0,2017-2018,2.3936170212765955,1.9680851063829787
373,Ante Budimir,CRO,FW,Crotone,Serie A,26,1991,17.6,28,20,4,16,8,2,20,10.0,18,20,3,17,7,35,27,0,0,2017-2018,0.3977272727272727,1.5909090909090908
374,Alberto Bueno,ESP,"MF,FW",Málaga,La Liga,29,1988,2.5,3,2,2,1,0,2,11,18.2,9,2,0,2,1,4,2,0,0,2017-2018,0.4,1.2
375,Gianluigi Buffon,ITA,GK,Juventus,Serie A,39,1978,20.7,0,0,0,0,0,0,0,0.0,0,0,0,0,0,0,11,2,0,2017-2018,0.0,0.0
376,Onur Bulut,TUR,FW,Freiburg,Bundesliga,23,1994,0.4,0,0,0,0,0,0,1,0.0,1,0,0,0,0,0,0,0,0,2017-2018,0.0,0.0
377,Alessandro Buongiorno,ITA,DF,Torino,Serie A,18,1999,0.1,0,0,0,0,0,0,0,0.0,0,0,0,0,0,0,1,0,0,2017-2018,0.0,0.0
378,Nicolás Burdisso,ARG,DF,Torino,Serie A,36,1981,23.0,20,11,13,7,0,7,11,63.6,4,23,14,9,30,50,124,3,0,2017-2018,1.3043478260869565,0.8695652173913043
379,Guido Burgstaller,AUT,FW,Schalke 04,Bundesliga,28,1989,25.8,14,9,0,10,4,4,14,28.6,10,28,3,25,10,24,9,0,0,2017-2018,0.38759689922480617,0.5426356589147286
380,Burgui,ESP,"MF,FW",Alavés,La Liga,23,1993,11.5,10,5,2,4,4,2,6,33.3,4,5,0,5,7,17,1,0,0,2017-2018,0.6086956521739131,0.8695652173913043
381,Oliver Burke,SCO,"FW,MF",West Brom,Premier League,20,1997,4.1,6,4,3,2,1,4,12,33.3,8,3,0,3,7,13,3,0,0,2017-2018,1.707317073170732,1.4634146341463417
382,Roman Bürki,SUI,GK,Dortmund,Bundesliga,26,1990,33.0,1,1,1,0,0,1,3,33.3,2,1,0,1,0,1,10,4,0,2017-2018,0.0,0.030303030303030304
383,Patrick Burner,MTQ,DF,Nice,Ligue 1,21,1996,10.0,18,12,13,5,0,7,20,35.0,13,6,0,6,13,31,23,0,0,2017-2018,1.3,1.8
384,Dženis Burnić,BIH,MF,Stuttgart,Bundesliga,19,1998,3.4,9,6,2,5,2,4,10,40.0,6,2,0,2,4,13,3,0,0,2017-2018,1.1764705882352942,2.6470588235294117
385,Sergio Busquets,ESP,MF,Barcelona,La Liga,29,1988,28.8,88,48,27,46,15,39,79,49.4,40,37,10,27,51,139,15,1,0,2017-2018,1.7708333333333333,3.0555555555555554
386,Unai Bustinza,ESP,DF,Leganés,La Liga,25,1992,18.2,36,21,25,8,3,21,38,55.3,17,17,9,8,47,83,64,0,0,2017-2018,2.5824175824175826,1.978021978021978
387,Ludovic Butelle,FRA,GK,Angers,Ligue 1,34,1983,18.4,0,0,0,0,0,0,0,0.0,0,0,0,0,1,1,10,2,0,2017-2018,0.05434782608695653,0.0
388,Jack Butland,ENG,GK,Stoke City,Premier League,24,1993,35.0,1,1,1,0,0,1,1,100.0,0,1,0,1,1,2,26,1,0,2017-2018,0.02857142857142857,0.02857142857142857
389,Sam Byram,ENG,"DF,MF",West Ham,Premier League,23,1993,2.8,9,5,6,3,0,4,9,44.4,5,6,2,4,9,18,16,0,0,2017-2018,3.2142857142857144,3.2142857142857144
390,Jakub Błaszczykowski,POL,"FW,MF",Wolfsburg,Bundesliga,31,1985,5.8,12,8,8,2,2,6,13,46.2,7,11,3,8,5,17,3,0,0,2017-2018,0.8620689655172414,2.0689655172413794
391,Erick Cabaco,URU,DF,Levante,La Liga,22,1995,11.6,25,14,21,4,0,14,20,70.0,6,10,8,2,17,42,71,2,0,2017-2018,1.4655172413793105,2.1551724137931036
392,Willy Caballero,ARG,GK,Chelsea,Premier League,35,1981,3.0,0,0,0,0,0,0,0,0.0,0,0,0,0,0,0,3,0,0,2017-2018,0.0,0.0
393,Yohan Cabaye,FRA,MF,Crystal Palace,Premier League,31,1986,26.4,70,44,39,28,3,24,97,24.7,73,47,4,43,79,149,29,4,0,2017-2018,2.9924242424242427,2.651515151515152
394,Rémy Cabella,FRA,"FW,MF",Marseille,Ligue 1,27,1990,0.7,7,4,2,2,3,2,4,50.0,2,0,0,0,1,8,0,0,0,2017-2018,1.4285714285714286,10.0
395,Rémy Cabella,FRA,"MF,FW",Saint-Étienne,Ligue 1,27,1990,25.1,58,39,29,22,7,17,73,23.3,56,31,0,31,14,72,4,2,0,2017-2018,0.5577689243027888,2.3107569721115535
396,Gustavo Cabral,ARG,DF,Celta Vigo,La Liga,31,1985,21.0,29,21,14,15,0,14,38,36.8,24,22,11,11,43,72,106,2,0,2017-2018,2.0476190476190474,1.380952380952381
397,Leandro Cabrera,URU,DF,Crotone,Serie A,26,1991,4.1,8,5,8,0,0,0,3,0.0,3,5,2,3,6,14,33,0,0,2017-2018,1.4634146341463417,1.9512195121951221
398,Leandro Cabrera,URU,DF,Getafe,La Liga,26,1991,8.0,19,10,12,7,0,7,17,41.2,10,9,5,4,22,41,37,0,0,2017-2018,2.75,2.375
399,Fabrizio Cacciatore,ITA,DF,Chievo,Serie A,30,1986,31.9,34,27,20,9,5,15,30,50.0,15,33,11,22,38,72,99,3,0,2017-2018,1.1912225705329154,1.0658307210031348
400,Martín Cáceres,URU,DF,Hellas Verona,Serie A,30,1987,12.9,16,11,14,1,1,7,18,38.9,11,9,5,4,19,35,41,1,0,2017-2018,1.4728682170542635,1.2403100775193798
401,Martín Cáceres,URU,DF,Lazio,Serie A,30,1987,4.9,12,7,9,2,1,10,14,71.4,4,4,4,0,4,16,13,0,0,2017-2018,0.8163265306122448,2.4489795918367343
402,Cafú,POR,MF,Metz,Ligue 1,24,1993,7.6,9,7,3,4,2,3,11,27.3,8,3,1,2,12,21,13,0,0,2017-2018,1.5789473684210527,1.1842105263157896
403,Jonathan Cafu,BRA,"FW,MF",Bordeaux,Ligue 1,26,1991,7.0,16,9,7,6,3,5,13,38.5,8,6,1,5,10,26,1,0,0,2017-2018,1.4285714285714286,2.2857142857142856
404,Gary Cahill,ENG,DF,Chelsea,Premier League,31,1985,23.2,29,21,15,9,5,10,21,47.6,11,21,14,7,27,56,127,1,0,2017-2018,1.1637931034482758,1.25
405,Yannick Cahuzac,FRA,MF,Toulouse,Ligue 1,32,1985,16.9,39,28,20,19,0,15,26,57.7,11,29,10,19,30,69,42,0,0,2017-2018,1.775147928994083,2.307692307692308
406,Felipe Caicedo,ECU,"FW,MF",Lazio,Serie A,28,1988,8.0,11,10,3,5,3,2,7,28.6,5,6,0,6,1,12,4,0,0,2017-2018,0.125,1.375
407,Caiuby,BRA,FW,Augsburg,Bundesliga,29,1988,31.7,53,40,20,27,6,17,42,40.5,25,36,1,35,15,68,42,2,0,2017-2018,0.47318611987381703,1.6719242902208202
408,Cala,ESP,DF,Getafe,La Liga,27,1989,20.0,21,14,16,5,0,13,27,48.1,14,21,10,11,39,60,124,0,0,2017-2018,1.95,1.05
409,Davide Calabria,ITA,DF,Milan,Serie A,20,1996,17.4,64,50,33,24,7,21,41,51.2,20,19,4,15,33,97,82,1,0,2017-2018,1.8965517241379313,3.6781609195402303
410,Mattia Caldara,ITA,DF,Atalanta,Serie A,23,1994,24.0,39,26,15,24,0,13,33,39.4,20,31,18,13,41,80,113,1,0,2017-2018,1.7083333333333333,1.625
411,Carlos Calderón,ESP,MF,Getafe,La Liga,22,1995,0.0,1,1,0,0,1,0,0,0.0,0,0,0,0,0,1,0,0,0,2017-2018,,inf
412,Luca Caldirola,ITA,DF,Werder Bremen,Bundesliga,26,1991,1.0,1,0,0,1,0,1,1,100.0,0,1,0,1,3,4,3,0,0,2017-2018,3.0,1.0
413,Hakan Çalhanoğlu,TUR,"FW,MF",Milan,Serie A,23,1994,24.1,37,27,11,18,8,8,31,25.8,23,29,2,27,22,59,15,0,0,2017-2018,0.9128630705394191,1.5352697095435683
414,Fabrizio Caligara,ITA,MF,Cagliari,Serie A,17,2000,0.2,0,0,0,0,0,0,0,0.0,0,1,1,0,1,1,1,0,0,2017-2018,5.0,0.0
415,Daniel Caligiuri,ITA,"DF,MF",Schalke 04,Bundesliga,29,1988,32.4,100,66,48,43,9,49,94,52.1,45,59,4,55,67,167,71,0,0,2017-2018,2.0679012345679015,3.0864197530864197
416,José Callejón,ESP,FW,Napoli,Serie A,30,1987,36.0,33,27,15,14,4,10,47,21.3,37,42,5,37,22,55,31,0,0,2017-2018,0.6111111111111112,0.9166666666666666
417,Jonathan Calleri,ARG,FW,Las Palmas,La Liga,23,1993,34.5,24,16,5,10,9,4,23,17.4,19,15,2,13,7,31,35,0,0,2017-2018,0.2028985507246377,0.6956521739130435
418,Simone Calvano,ITA,MF,Hellas Verona,Serie A,24,1993,7.2,13,12,4,9,0,3,16,18.8,13,10,4,6,15,28,14,1,0,2017-2018,2.0833333333333335,1.8055555555555556
419,Dominic Calvert-Lewin,ENG,FW,Everton,Premier League,20,1997,20.9,15,8,5,3,7,2,15,13.3,13,13,1,12,10,25,23,1,0,2017-2018,0.47846889952153115,0.7177033492822967
420,Ignacio Camacho,ESP,"MF,DF",Wolfsburg,Bundesliga,27,1990,10.6,27,21,10,16,1,9,23,39.1,14,14,5,9,41,68,43,0,0,2017-2018,3.867924528301887,2.547169811320755
421,Abdoul Camara,GUI,"FW,MF",Guingamp,Ligue 1,27,1990,9.9,6,4,2,3,1,3,11,27.3,8,7,1,6,7,13,4,0,0,2017-2018,0.7070707070707071,0.6060606060606061
422,Souleymane Camara,SEN,FW,Montpellier,Ligue 1,34,1982,10.4,6,4,0,5,1,0,3,0.0,3,3,1,2,2,8,15,0,0,2017-2018,0.1923076923076923,0.5769230769230769
423,Víctor Camarasa,ESP,MF,Betis,La Liga,23,1994,13.9,20,15,8,10,2,3,13,23.1,10,8,0,8,15,35,13,0,0,2017-2018,1.079136690647482,1.4388489208633093
424,Geoff Cameron,USA,"DF,MF",Stoke City,Premier League,32,1985,16.9,34,21,20,12,2,11,27,40.7,16,28,8,20,36,70,68,0,0,2017-2018,2.1301775147928996,2.0118343195266273
425,José Campaña,ESP,MF,Levante,La Liga,24,1993,30.4,57,36,25,27,5,19,58,32.8,39,31,10,21,45,102,37,0,0,2017-2018,1.480263157894737,1.875
426,Joel Campbell,CRC,"MF,FW",Betis,La Liga,25,1992,2.4,6,2,3,3,0,3,6,50.0,3,2,0,2,0,6,0,0,0,2017-2018,0.0,2.5
427,Tyrese Campbell,ENG,FW,Stoke City,Premier League,17,1999,0.9,2,1,0,2,0,1,1,100.0,0,1,1,0,1,3,0,0,0,2017-2018,1.1111111111111112,2.2222222222222223
428,Emre Can,GER,MF,Liverpool,Premier League,23,1994,23.2,67,54,32,29,6,18,43,41.9,25,32,4,28,28,95,37,1,0,2017-2018,1.206896551724138,2.887931034482759
429,Sergio Canales,ESP,"MF,FW",Real Sociedad,La Liga,26,1991,21.4,30,24,6,18,6,9,32,28.1,23,25,0,25,11,41,3,0,0,2017-2018,0.5140186915887851,1.4018691588785048
430,João Cancelo,POR,DF,Inter,Serie A,23,1994,20.6,42,29,27,11,4,17,42,40.5,25,15,2,13,35,77,51,0,0,2017-2018,1.6990291262135921,2.0388349514563107
431,João Cancelo,POR,MF,Valencia,La Liga,23,1994,1.0,1,1,0,1,0,1,1,100.0,0,1,0,1,2,3,0,0,0,2017-2018,2.0,1.0
432,Antonio Candreva,ITA,FW,Inter,Serie A,30,1987,28.2,12,7,7,5,0,8,39,20.5,31,20,2,18,22,34,24,0,0,2017-2018,0.7801418439716312,0.425531914893617
433,Paolo Cannavaro,ITA,DF,Sassuolo,Serie A,36,1981,16.0,17,9,11,5,1,8,20,40.0,12,17,13,4,27,44,94,1,0,2017-2018,1.6875,1.0625
434,Ander Capa,ESP,DF,Eibar,La Liga,25,1992,25.0,57,38,34,14,9,25,38,65.8,13,21,2,19,52,109,50,1,0,2017-2018,2.08,2.28
435,Pierrick Capelle,FRA,MF,Angers,Ligue 1,30,1987,20.9,50,37,29,17,4,16,70,22.9,54,29,0,29,34,84,26,0,0,2017-2018,1.6267942583732058,2.3923444976076556
436,Leonardo Capezzi,ITA,MF,Sampdoria,Serie A,22,1995,2.4,8,4,5,3,0,4,6,66.7,2,6,0,6,0,8,3,0,0,2017-2018,0.0,3.3333333333333335
437,Étienne Capoue,FRA,MF,Watford,Premier League,29,1988,17.1,43,26,15,25,3,19,47,40.4,28,21,1,20,43,86,38,0,0,2017-2018,2.5146198830409356,2.5146198830409356
438,Elio Capradossi,UGA,DF,Roma,Serie A,21,1996,0.9,1,0,1,0,0,0,0,0.0,0,2,2,0,2,3,13,0,0,2017-2018,2.2222222222222223,1.1111111111111112
439,Gianluca Caprari,ITA,"FW,MF",Sampdoria,Serie A,24,1993,20.1,19,11,2,11,6,0,10,0.0,10,25,2,23,5,24,3,0,0,2017-2018,0.24875621890547261,0.9452736318407959
440,Marco Capuano,ITA,DF,Crotone,Serie A,25,1991,15.6,20,10,14,6,0,5,15,33.3,10,19,13,6,28,48,93,0,0,2017-2018,1.794871794871795,1.2820512820512822
441,Marco Capuano,ITA,DF,Cagliari,Serie A,25,1991,7.7,13,9,6,7,0,4,8,50.0,4,7,2,5,6,19,23,1,0,2017-2018,0.7792207792207793,1.6883116883116882
442,Antonio Caracciolo,ITA,DF,Hellas Verona,Serie A,27,1990,31.7,52,34,41,8,3,17,30,56.7,13,64,44,20,39,91,203,0,0,2017-2018,1.2302839116719244,1.640378548895899
443,Yoan Cardinale,FRA,GK,Nice,Ligue 1,23,1994,10.0,0,0,0,0,0,0,0,0.0,0,0,0,0,0,0,0,3,0,2017-2018,0.0,0.0
444,Diego Carlos,BRA,DF,Nantes,Ligue 1,24,1993,25.5,70,42,51,15,4,28,38,73.7,10,50,29,21,29,99,155,3,0,2017-2018,1.1372549019607843,2.7450980392156863
445,Lionel Carole,FRA,DF,Sevilla,La Liga,26,1991,6.0,12,6,7,5,0,5,7,71.4,2,6,3,3,6,18,29,0,0,2017-2018,1.0,2.0
446,Yannick Carrasco,BEL,"MF,FW",Atlético Madrid,La Liga,23,1993,10.0,17,13,7,5,5,3,8,37.5,5,9,0,9,4,21,3,0,0,2017-2018,0.4,1.7
447,Michael Carrick,ENG,MF,Manchester Utd,Premier League,36,1981,1.2,1,1,0,1,0,0,1,0.0,1,2,0,2,1,2,3,0,0,2017-2018,0.8333333333333334,0.8333333333333334
448,Daniel Carriço,POR,DF,Sevilla,La Liga,28,1988,5.1,7,7,6,1,0,4,7,57.1,3,6,3,3,10,17,22,0,0,2017-2018,1.9607843137254903,1.3725490196078431
449,André Carrillo,PER,"FW,MF",Watford,Premier League,26,1991,17.1,31,24,16,12,3,8,33,24.2,25,7,0,7,15,46,16,0,0,2017-2018,0.8771929824561403,1.8128654970760232
450,Guido Carrillo,ARG,FW,Southampton,Premier League,26,1991,5.0,5,1,0,3,2,0,1,0.0,1,4,0,4,0,5,5,0,0,2017-2018,0.0,1.0
451,Guido Carrillo,ARG,FW,Monaco,Ligue 1,26,1991,4.7,3,1,0,2,1,0,4,0.0,4,3,1,2,0,3,8,0,0,2017-2018,0.0,0.6382978723404255
452,Thomas Carrique,FRA,DF,Bordeaux,Ligue 1,18,1999,1.0,1,0,0,1,0,1,3,33.3,2,0,0,0,2,3,3,0,0,2017-2018,2.0,1.0
453,Andy Carroll,ENG,FW,West Ham,Premier League,28,1989,8.3,3,3,2,0,1,0,1,0.0,1,3,2,1,2,5,15,0,0,2017-2018,0.24096385542168672,0.36144578313253006
454,Tom Carroll,ENG,MF,Swansea City,Premier League,25,1992,28.6,53,33,22,23,8,14,53,26.4,39,37,8,29,29,82,18,1,0,2017-2018,1.013986013986014,1.8531468531468531
455,Federico Cartabia,ARG,"FW,MF",La Coruña,La Liga,24,1993,14.7,37,23,15,15,7,11,30,36.7,19,15,0,15,18,55,10,0,0,2017-2018,1.2244897959183674,2.5170068027210886
456,Dani Carvajal,ESP,DF,Real Madrid,La Liga,25,1992,24.7,59,40,27,22,10,22,38,57.9,16,33,15,18,38,97,42,2,0,2017-2018,1.5384615384615385,2.388663967611336
457,Casemiro,BRA,MF,Real Madrid,La Liga,25,1992,28.8,109,78,64,39,6,42,84,50.0,42,56,11,45,63,172,49,3,0,2017-2018,2.1875,3.7847222222222223
458,Kiko Casilla,ESP,GK,Real Madrid,La Liga,30,1986,10.0,1,0,1,0,0,1,1,100.0,0,0,0,0,2,3,6,2,0,2017-2018,0.2,0.1
459,Francesco Cassata,ITA,MF,Sassuolo,Serie A,20,1997,5.1,12,7,6,5,1,2,10,20.0,8,3,0,3,5,17,0,0,0,2017-2018,0.9803921568627452,2.3529411764705883
460,Timothy Castagne,BEL,DF,Atalanta,Serie A,21,1995,16.7,54,37,32,14,8,13,27,48.1,14,25,4,21,26,80,48,0,0,2017-2018,1.5568862275449102,3.2335329341317367
461,Leandro Castán,BRA,DF,Cagliari,Serie A,30,1986,12.7,24,15,16,8,0,15,20,75.0,5,16,10,6,23,47,48,1,0,2017-2018,1.8110236220472442,1.8897637795275593
462,Koen Casteels,BEL,GK,Wolfsburg,Bundesliga,25,1992,34.0,2,1,2,0,0,2,2,100.0,0,0,0,0,1,3,16,1,0,2017-2018,0.029411764705882353,0.058823529411764705
463,Dani Castellano,ESP,DF,Las Palmas,La Liga,29,1987,22.5,46,29,29,16,1,25,48,52.1,23,28,7,21,42,88,64,1,0,2017-2018,1.8666666666666667,2.0444444444444443
464,Javi Castellano,ESP,MF,Las Palmas,La Liga,29,1987,17.4,47,27,20,25,2,20,37,54.1,17,23,6,17,38,85,16,1,0,2017-2018,2.1839080459770117,2.7011494252873565
465,Samu Castillejo,ESP,"MF,FW",Villarreal,La Liga,22,1995,23.0,41,28,22,10,9,13,62,21.0,49,39,5,34,22,63,37,0,0,2017-2018,0.9565217391304348,1.7826086956521738
466,Chory Castro,URU,"MF,FW",Málaga,La Liga,32,1984,22.9,37,24,15,14,8,11,32,34.4,21,21,2,19,23,60,13,0,0,2017-2018,1.0043668122270744,1.6157205240174672
467,Gonzalo Castro,GER,MF,Dortmund,Bundesliga,30,1987,13.4,26,18,7,18,1,5,22,22.7,17,23,3,20,10,36,13,1,0,2017-2018,0.7462686567164178,1.9402985074626866
468,Jonny Castro,ESP,DF,Celta Vigo,La Liga,23,1994,35.6,102,78,60,31,11,43,91,47.3,48,48,8,40,93,195,92,1,0,2017-2018,2.6123595505617976,2.8651685393258424
469,Lucas Castro,ARG,MF,Chievo,Serie A,28,1989,22.1,54,40,14,29,11,16,43,37.2,27,39,7,32,38,92,35,0,0,2017-2018,1.7194570135746605,2.443438914027149
470,Rubén Castro,ESP,FW,Betis,La Liga,36,1981,4.0,1,1,0,0,1,0,0,0.0,0,0,0,0,0,1,2,0,0,2017-2018,0.0,0.25
471,Danilo Cataldi,ITA,MF,Benevento,Serie A,22,1994,25.4,33,25,12,19,2,5,28,17.9,23,18,5,13,37,70,20,1,0,2017-2018,1.4566929133858268,1.299212598425197
472,Craig Cathcart,NIR,DF,Watford,Premier League,28,1989,5.8,8,5,5,3,0,4,5,80.0,1,8,6,2,3,11,38,0,0,2017-2018,0.5172413793103449,1.3793103448275863
473,Edinson Cavani,URU,FW,Paris S-G,Ligue 1,30,1987,28.7,15,9,5,4,6,2,16,12.5,14,10,1,9,5,20,22,0,0,2017-2018,0.17421602787456447,0.5226480836236934
474,Marijan Ćavar,BIH,MF,Eint Frankfurt,Bundesliga,19,1998,0.4,0,0,0,0,0,0,3,0.0,3,0,0,0,0,0,0,0,0,2017-2018,0.0,0.0
475,Dani Ceballos,ESP,MF,Real Madrid,La Liga,20,1996,4.5,8,7,3,2,3,4,16,25.0,12,6,0,6,5,13,1,0,0,2017-2018,1.1111111111111112,1.7777777777777777
476,Federico Ceccherini,ITA,DF,Crotone,Serie A,25,1992,35.9,35,21,28,4,3,13,25,52.0,12,39,21,18,83,118,276,1,0,2017-2018,2.3119777158774375,0.9749303621169917
477,Emanuel Cecchini,ARG,"MF,DF",Málaga,La Liga,20,1996,0.3,3,1,2,1,0,2,3,66.7,1,0,0,0,2,5,2,0,0,2017-2018,6.666666666666667,10.0
478,Petr Čech,CZE,GK,Arsenal,Premier League,35,1982,33.8,1,1,1,0,0,1,1,100.0,0,0,0,0,0,1,23,7,0,2017-2018,0.0,0.02958579881656805
479,Ricardo Centurión,ARG,"MF,FW",Genoa,Serie A,24,1993,0.6,0,0,0,0,0,0,0,0.0,0,0,0,0,0,0,0,0,0,2017-2018,0.0,0.0
480,Luca Ceppitelli,ITA,DF,Cagliari,Serie A,27,1989,24.7,45,33,31,12,2,16,34,47.1,18,33,21,12,50,95,156,0,0,2017-2018,2.0242914979757085,1.8218623481781377
481,Fabio Ceravolo,ITA,FW,Benevento,Serie A,30,1987,0.6,0,0,0,0,0,0,1,0.0,1,1,0,1,0,0,0,0,0,2017-2018,0.0,0.0
482,Alessio Cerci,ITA,FW,Hellas Verona,Serie A,30,1987,18.2,15,10,7,3,5,4,16,25.0,12,4,0,4,4,19,8,0,0,2017-2018,0.21978021978021978,0.8241758241758242
483,Boštjan Cesar,SVN,DF,Chievo,Serie A,35,1982,6.1,4,3,3,1,0,3,4,75.0,1,6,4,2,3,7,40,0,0,2017-2018,0.49180327868852464,0.6557377049180328
484,Damir Ceter,COL,FW,Cagliari,Serie A,19,1997,2.2,2,1,0,2,0,0,0,0.0,0,3,0,3,0,2,1,0,0,2017-2018,0.0,0.9090909090909091
485,Nacer Chadli,BEL,"FW,MF",West Brom,Premier League,27,1989,2.9,1,0,1,0,0,1,4,25.0,3,0,0,0,0,1,4,0,0,2017-2018,0.0,0.3448275862068966
486,Fouad Chafik,MAR,DF,Dijon,Ligue 1,30,1986,17.9,58,49,31,19,8,20,35,57.1,15,17,1,16,33,91,46,1,0,2017-2018,1.8435754189944136,3.240223463687151
487,Nathaniel Chalobah,ENG,MF,Watford,Premier League,22,1994,5.0,9,6,2,6,1,2,5,40.0,3,6,5,1,6,15,6,0,0,2017-2018,1.2,1.8
488,Calum Chambers,ENG,DF,Arsenal,Premier League,22,1995,9.6,17,10,10,6,1,5,14,35.7,9,14,11,3,18,35,47,0,0,2017-2018,1.875,1.7708333333333335
489,Nereo Champagne,ARG,GK,Leganés,La Liga,32,1985,2.0,0,0,0,0,0,0,0,0.0,0,0,0,0,0,0,3,0,0,2017-2018,0.0,0.0
490,Timothy Chandler,USA,"DF,FW",Eint Frankfurt,Bundesliga,27,1990,21.0,27,21,11,13,3,11,17,64.7,6,15,0,15,33,60,52,0,0,2017-2018,1.5714285714285714,1.2857142857142858
491,Kwon Chang-hoon,KOR,"FW,MF",Dijon,Ligue 1,23,1994,23.7,37,22,10,18,9,11,35,31.4,24,32,1,31,24,61,30,0,0,2017-2018,1.0126582278481013,1.5611814345991561
492,Charles,BRA,FW,Eibar,La Liga,33,1984,17.6,11,8,2,5,4,1,8,12.5,7,7,0,7,7,18,10,0,0,2017-2018,0.3977272727272727,0.625
493,Charly Charrier,FRA,"MF,FW",Amiens,Ligue 1,31,1986,1.2,1,0,1,0,0,0,2,0.0,2,1,0,1,2,3,0,0,0,2017-2018,1.6666666666666667,0.8333333333333334
494,Pape Cheikh Diop,SEN,MF,Lyon,Ligue 1,19,1997,0.1,0,0,0,0,0,0,0,0.0,0,0,0,0,0,0,0,0,0,2017-2018,0.0,0.0
495,Chema,ESP,DF,Levante,La Liga,25,1992,22.4,20,13,14,6,0,9,18,50.0,9,43,27,16,30,50,110,1,0,2017-2018,1.3392857142857144,0.8928571428571429
496,Denis Cheryshev,RUS,"MF,FW",Villarreal,La Liga,26,1990,10.3,27,16,12,10,5,6,23,26.1,17,18,1,17,13,40,10,0,0,2017-2018,1.262135922330097,2.6213592233009706
497,Raman Chibsah,GHA,MF,Benevento,Serie A,24,1993,11.6,20,13,10,7,3,4,14,28.6,10,13,2,11,4,24,16,0,0,2017-2018,0.3448275862068966,1.7241379310344829
498,Leandro Chichizola,ARG,GK,Las Palmas,La Liga,27,1990,27.0,2,0,2,0,0,2,6,33.3,4,0,0,0,4,6,29,3,0,2017-2018,0.14814814814814814,0.07407407407407407
499,Giorgio Chiellini,ITA,DF,Juventus,Serie A,32,1984,24.0,28,19,17,10,1,7,15,46.7,8,21,14,7,47,75,142,3,0,2017-2018,1.9583333333333333,1.1666666666666667
500,Federico Chiesa,ITA,"FW,MF",Fiorentina,Serie A,19,1997,33.5,62,41,22,22,18,16,54,29.6,38,34,1,33,18,80,16,0,0,2017-2018,0.5373134328358209,1.8507462686567164
501,Ben Chilwell,ENG,DF,Leicester City,Premier League,20,1996,20.6,36,26,21,10,5,15,32,46.9,17,31,4,27,28,64,71,3,0,2017-2018,1.3592233009708736,1.7475728155339805
502,Vlad Chiricheș,ROU,DF,Napoli,Serie A,27,1989,6.5,8,4,7,1,0,2,5,40.0,3,2,1,1,16,24,19,1,0,2017-2018,2.4615384615384617,1.2307692307692308
503,Hamza Choudhury,ENG,"MF,DF",Leicester City,Premier League,19,1997,4.2,9,5,6,3,0,2,10,20.0,8,12,1,11,8,17,4,0,0,2017-2018,1.9047619047619047,2.142857142857143
504,Andreas Christensen,DEN,DF,Chelsea,Premier League,21,1996,23.2,26,13,23,3,0,10,15,66.7,5,25,17,8,39,65,109,5,0,2017-2018,1.6810344827586208,1.120689655172414
505,Chuca,ESP,MF,Villarreal,La Liga,20,1997,1.0,1,0,1,0,0,1,3,33.3,2,1,1,0,1,2,1,1,0,2017-2018,1.0,1.0
506,Lee Chung-yong,KOR,"FW,MF",Crystal Palace,Premier League,29,1988,1.5,2,0,0,1,1,0,0,0.0,0,3,0,3,2,4,0,1,0,2017-2018,1.3333333333333333,1.3333333333333333
507,Amato Ciciretti,ITA,"MF,FW",Benevento,Serie A,23,1993,9.0,14,8,5,6,3,2,11,18.2,9,9,0,9,6,20,4,0,0,2017-2018,0.6666666666666666,1.5555555555555556
508,Cifu,ESP,DF,Málaga,La Liga,26,1990,1.2,2,1,0,1,1,1,5,20.0,4,1,1,0,2,4,2,0,0,2017-2018,1.6666666666666667,1.6666666666666667
509,Luca Cigarini,ITA,MF,Cagliari,Serie A,31,1986,22.5,42,30,16,25,1,18,64,28.1,46,32,5,27,42,84,27,1,0,2017-2018,1.8666666666666667,1.8666666666666667
510,Per Ciljan Skjelbred,NOR,MF,Hertha BSC,Bundesliga,30,1987,24.3,89,66,33,54,2,42,64,65.6,22,31,6,25,45,134,23,0,0,2017-2018,1.8518518518518519,3.662551440329218
511,Jasper Cillessen,NED,GK,Barcelona,La Liga,28,1989,1.0,0,0,0,0,0,0,0,0.0,0,0,0,0,0,0,0,0,0,2017-2018,0.0,0.0
512,Thiago Cionek,POL,DF,SPAL,Serie A,31,1986,15.0,28,21,18,6,4,11,20,55.0,9,19,9,10,35,63,99,0,0,2017-2018,2.3333333333333335,1.8666666666666667
513,Saliou Ciss,SEN,"DF,MF",Angers,Ligue 1,27,1989,1.6,3,2,1,1,1,2,5,40.0,3,0,0,0,2,5,1,0,0,2017-2018,1.25,1.875
514,Karamoko Cissé,GUI,"FW,MF",Benevento,Serie A,28,1988,0.2,1,1,1,0,0,0,0,0.0,0,0,0,0,0,1,0,0,0,2017-2018,0.0,5.0
515,Issa Cissokho,SEN,DF,Amiens,Ligue 1,32,1985,18.1,31,23,22,9,0,18,32,56.3,14,18,8,10,34,65,87,1,0,2017-2018,1.878453038674033,1.7127071823204418
516,Ciaran Clark,IRL,DF,Newcastle Utd,Premier League,27,1989,19.4,25,17,17,8,0,11,21,52.4,10,15,10,5,17,42,144,1,0,2017-2018,0.8762886597938145,1.288659793814433
517,Christian Clemens,GER,"MF,FW",Köln,Bundesliga,25,1991,7.2,12,11,6,5,1,4,13,30.8,9,8,0,8,4,16,7,0,0,2017-2018,0.5555555555555556,1.6666666666666665
518,Tom Cleverley,ENG,MF,Watford,Premier League,27,1989,21.1,48,26,25,16,7,21,52,40.4,31,11,1,10,25,73,21,0,0,2017-2018,1.1848341232227488,2.2748815165876777
519,Sam Clucas,ENG,MF,Swansea City,Premier League,26,1990,22.7,34,19,21,11,2,10,29,34.5,19,31,7,24,29,63,34,1,0,2017-2018,1.277533039647577,1.497797356828194
520,Nathaniel Clyne,ENG,"DF,FW",Liverpool,Premier League,26,1991,1.9,3,1,2,1,0,0,1,0.0,1,2,1,1,0,3,3,0,0,2017-2018,0.0,1.5789473684210527
521,Marcus Coco,FRA,"FW,MF",Guingamp,Ligue 1,21,1996,17.6,40,28,17,13,10,7,35,20.0,28,22,3,19,15,55,9,0,0,2017-2018,0.8522727272727272,2.2727272727272725
522,Massimo Coda,ITA,FW,Benevento,Serie A,28,1988,15.7,12,9,3,4,5,2,13,15.4,11,7,2,5,6,18,11,0,0,2017-2018,0.3821656050955414,0.7643312101910829
523,Isaac Cofie,GHA,MF,Genoa,Serie A,25,1991,6.6,13,10,3,9,1,7,15,46.7,8,9,3,6,10,23,7,0,0,2017-2018,1.5151515151515151,1.9696969696969697
524,Renaud Cohade,FRA,MF,Metz,Ligue 1,32,1984,36.6,143,86,63,71,9,46,119,38.7,73,70,10,60,53,196,91,0,0,2017-2018,1.4480874316939891,3.9071038251366117
525,Coke,ESP,DF,Levante,La Liga,30,1987,15.4,35,23,26,7,2,18,39,46.2,21,17,5,12,34,69,46,0,0,2017-2018,2.207792207792208,2.2727272727272725
526,Coke,ESP,MF,Schalke 04,Bundesliga,30,1987,0.0,0,0,0,0,0,0,0,0.0,0,0,0,0,0,0,0,0,0,2017-2018,,
527,Emre Çolak,TUR,MF,La Coruña,La Liga,26,1991,16.1,24,19,4,14,6,7,28,25.0,21,7,1,6,7,31,5,1,0,2017-2018,0.43478260869565216,1.4906832298136645
528,Séamus Coleman,IRL,DF,Everton,Premier League,28,1988,11.5,14,14,9,3,2,6,11,54.5,5,16,12,4,10,24,29,2,0,2017-2018,0.8695652173913043,1.2173913043478262
529,James Collins,WAL,DF,West Ham,Premier League,33,1983,11.7,15,9,11,4,0,8,11,72.7,3,13,10,3,16,31,120,1,0,2017-2018,1.3675213675213675,1.2820512820512822
530,Racine Coly,SEN,DF,Nice,Ligue 1,21,1995,6.9,15,12,9,5,1,9,19,47.4,10,5,2,3,15,30,18,0,0,2017-2018,2.1739130434782608,2.1739130434782608
531,Kingsley Coman,FRA,"FW,MF",Bayern Munich,Bundesliga,21,1996,12.8,11,10,2,6,3,5,10,50.0,5,6,0,6,7,18,1,0,0,2017-2018,0.546875,0.859375
532,Marvin Compper,GER,DF,RB Leipzig,Bundesliga,32,1985,1.0,2,2,0,2,0,2,3,66.7,1,2,2,0,0,2,8,0,0,2017-2018,0.0,2.0
533,Alois Confais,FRA,"MF,DF",Troyes,Ligue 1,20,1996,6.8,8,6,7,1,0,3,9,33.3,6,7,4,3,4,12,15,1,0,2017-2018,0.5882352941176471,1.1764705882352942
534,Daniel Congré,FRA,DF,Montpellier,Ligue 1,32,1985,29.3,62,46,36,24,2,31,59,52.5,28,29,16,13,56,118,124,2,0,2017-2018,1.9112627986348123,2.1160409556313993
535,Andrea Consigli,ITA,GK,Sassuolo,Serie A,30,1987,36.8,0,0,0,0,0,0,2,0.0,2,0,0,0,0,0,27,6,0,2017-2018,0.0,0.0
536,Diego Contento,GER,"DF,MF",Bordeaux,Ligue 1,27,1990,1.2,3,0,1,2,0,1,1,100.0,0,2,1,1,1,4,9,0,0,2017-2018,0.8333333333333334,2.5
537,Andrea Conti,ITA,DF,Milan,Serie A,23,1994,1.7,4,2,1,3,0,2,3,66.7,1,3,0,3,1,5,5,0,0,2017-2018,0.5882352941176471,2.3529411764705883
538,Lewis Cook,ENG,MF,Bournemouth,Premier League,20,1997,24.9,67,35,37,30,0,26,69,37.7,43,33,12,21,35,102,25,2,0,2017-2018,1.4056224899598395,2.6907630522088355
539,Steve Cook,ENG,DF,Bournemouth,Premier League,26,1991,30.7,37,19,28,7,2,19,29,65.5,10,63,45,18,54,91,232,4,0,2017-2018,1.7589576547231272,1.205211726384365
540,Duje Čop,CRO,"FW,MF",Cagliari,Serie A,27,1990,1.1,1,1,0,0,1,0,1,0.0,1,1,0,1,0,1,0,0,0,2017-2018,0.0,0.9090909090909091
541,Francis Coquelin,FRA,"MF,DF",Arsenal,Premier League,26,1991,1.9,5,4,2,3,0,1,3,33.3,2,1,0,1,3,8,2,0,0,2017-2018,1.5789473684210527,2.6315789473684212
542,Francis Coquelin,FRA,"MF,DF",Valencia,La Liga,26,1991,7.3,18,14,11,6,1,9,16,56.3,7,9,2,7,20,38,23,0,0,2017-2018,2.73972602739726,2.4657534246575343
543,Sébastien Corchia,FRA,DF,Sevilla,La Liga,26,1990,9.1,18,13,7,8,3,9,16,56.3,7,18,4,14,16,34,20,0,0,2017-2018,1.7582417582417582,1.978021978021978
544,Alex Cordaz,ITA,GK,Crotone,Serie A,34,1983,38.0,0,0,0,0,0,0,0,0.0,0,0,0,0,2,2,16,4,0,2017-2018,0.05263157894736842,0.0
545,Iñigo Córdoba,ESP,FW,Athletic Club,La Liga,20,1997,16.2,44,30,18,21,5,16,58,27.6,42,31,0,31,21,65,9,0,0,2017-2018,1.2962962962962963,2.7160493827160495
546,Jhon Córdoba,COL,FW,Köln,Bundesliga,24,1993,10.6,13,10,0,11,2,1,5,20.0,4,6,2,4,1,14,9,0,0,2017-2018,0.09433962264150944,1.2264150943396226
547,Sergio Córdova,VEN,"FW,MF",Augsburg,Bundesliga,19,1997,6.5,5,5,0,2,3,3,4,75.0,1,12,2,10,0,5,6,0,0,2017-2018,0.0,0.7692307692307693
548,Jérémy Cordoval,GLP,DF,Troyes,Ligue 1,27,1990,10.2,20,16,12,7,1,9,14,64.3,5,12,2,10,9,29,35,0,0,2017-2018,0.8823529411764707,1.9607843137254903
549,Benjamin Corgnet,FRA,"MF,FW",Strasbourg,Ligue 1,30,1987,15.3,28,19,5,16,7,6,28,21.4,22,18,1,17,11,39,11,0,0,2017-2018,0.7189542483660131,1.8300653594771241
550,Jack Cork,ENG,MF,Burnley,Premier League,28,1989,38.0,60,44,25,27,8,20,62,32.3,42,36,15,21,41,101,86,1,0,2017-2018,1.0789473684210527,1.5789473684210527
551,Andreas Cornelius,DEN,FW,Atalanta,Serie A,24,1993,10.4,9,5,3,3,3,1,7,14.3,6,7,0,7,2,11,7,0,0,2017-2018,0.1923076923076923,0.8653846153846153
552,Maxwel Cornet,CIV,FW,Lyon,Ligue 1,20,1996,14.1,17,12,6,9,2,3,25,12.0,22,11,1,10,14,31,14,0,0,2017-2018,0.9929078014184397,1.2056737588652482
553,Quentin Cornette,FRA,"FW,MF",Amiens,Ligue 1,23,1994,5.0,11,8,5,3,3,3,13,23.1,10,7,0,7,3,14,5,0,0,2017-2018,0.6,2.2
554,Ángel Correa,ARG,"MF,FW",Atlético Madrid,La Liga,22,1995,25.0,41,29,12,16,13,8,57,14.0,49,30,1,29,25,66,17,0,0,2017-2018,1.0,1.64
555,Joaquín Correa,ARG,FW,Sevilla,La Liga,22,1994,13.3,15,10,7,6,2,8,29,27.6,21,15,1,14,2,17,12,0,0,2017-2018,0.15037593984962405,1.1278195488721805
556,Andrea Cossu,ITA,"MF,FW",Cagliari,Serie A,37,1980,2.7,1,0,0,0,1,0,2,0.0,2,2,0,2,3,4,2,0,0,2017-2018,1.111111111111111,0.37037037037037035
557,Andrea Costa,ITA,DF,Benevento,Serie A,31,1986,15.3,19,14,13,6,0,9,19,47.4,10,21,15,6,37,56,78,2,0,2017-2018,2.418300653594771,1.2418300653594772
558,Danny da Costa,GER,"DF,FW",Eint Frankfurt,Bundesliga,24,1993,13.4,41,34,17,14,10,24,28,85.7,4,21,4,17,13,54,47,0,0,2017-2018,0.9701492537313433,3.059701492537313
559,Diego Costa,ESP,FW,Atlético Madrid,La Liga,28,1988,11.6,17,11,2,10,5,4,15,26.7,11,14,4,10,5,22,3,0,0,2017-2018,0.4310344827586207,1.4655172413793105
560,Douglas Costa,BRA,"FW,MF",Juventus,Serie A,26,1990,19.9,17,14,10,5,2,8,25,32.0,17,15,0,15,7,24,7,0,0,2017-2018,0.35175879396984927,0.8542713567839196
561,Filippo Costa,ITA,DF,SPAL,Serie A,22,1995,16.4,19,12,7,7,5,7,17,41.2,10,23,6,17,22,41,50,0,0,2017-2018,1.3414634146341464,1.1585365853658538
562,Jaume Costa,ESP,DF,Villarreal,La Liga,29,1988,28.2,67,43,39,22,6,33,51,64.7,18,30,8,22,46,113,97,0,0,2017-2018,1.6312056737588654,2.375886524822695
563,Angelo da Costa Júnior,BRA,GK,Bologna,Serie A,33,1983,4.0,0,0,0,0,0,0,0,0.0,0,0,0,0,0,0,2,0,0,2017-2018,0.0,0.0
564,Nuno da Costa,CPV,"FW,MF",Strasbourg,Ligue 1,26,1991,19.2,50,32,12,29,9,7,35,20.0,28,21,0,21,19,69,9,0,0,2017-2018,0.9895833333333334,2.604166666666667
565,Benoît Costil,FRA,GK,Bordeaux,Ligue 1,30,1987,36.0,0,0,0,0,0,0,2,0.0,2,0,0,0,3,3,13,4,0,2017-2018,0.08333333333333333,0.0
566,Kalifa Coulibaly,MLI,FW,Nantes,Ligue 1,25,1991,3.8,6,6,3,1,2,2,4,50.0,2,0,0,0,0,6,6,0,0,2017-2018,0.0,1.5789473684210527
567,Lassana Coulibaly,MLI,MF,Angers,Ligue 1,21,1996,9.3,26,17,13,10,3,10,35,28.6,25,15,1,14,8,34,10,0,0,2017-2018,0.8602150537634408,2.7956989247311825
568,Thibaut Courtois,BEL,GK,Chelsea,Premier League,25,1992,35.0,0,0,0,0,0,0,0,0.0,0,0,0,0,0,0,8,1,0,2017-2018,0.0,0.0
569,Philippe Coutinho,BRA,"MF,FW",Liverpool,Premier League,25,1992,12.3,17,14,4,10,3,3,21,14.3,18,10,0,10,10,27,5,1,0,2017-2018,0.8130081300813008,1.3821138211382114
570,Philippe Coutinho,BRA,"MF,FW",Barcelona,La Liga,25,1992,14.4,27,14,8,14,5,9,32,28.1,23,14,0,14,6,33,4,0,0,2017-2018,0.41666666666666663,1.875
571,Nicolas Cozza,FRA,"DF,MF",Montpellier,Ligue 1,18,1999,6.4,21,11,12,8,1,7,16,43.8,9,5,2,3,13,34,12,0,0,2017-2018,2.03125,3.28125
572,Alessio Cragno,ITA,GK,Cagliari,Serie A,23,1994,28.2,0,0,0,0,0,0,0,0.0,0,1,0,1,0,0,12,0,0,2017-2018,0.0,0.0
573,Martin Cranie,ENG,DF,Huddersfield,Premier League,30,1986,2.0,3,2,2,1,0,0,1,0.0,1,3,3,0,1,4,10,0,0,2017-2018,0.5,1.5
574,Michele Cremonesi,ITA,DF,SPAL,Serie A,29,1988,4.3,4,2,2,2,0,1,4,25.0,3,5,3,2,7,11,28,0,0,2017-2018,1.627906976744186,0.9302325581395349
575,Aaron Cresswell,ENG,DF,West Ham,Premier League,27,1989,34.1,34,21,12,20,2,19,30,63.3,11,42,17,25,44,78,117,1,0,2017-2018,1.2903225806451613,0.9970674486803519
576,Lorenzo Crisetig,ITA,MF,Bologna,Serie A,24,1993,6.2,18,14,8,9,1,7,24,29.2,17,8,2,6,13,31,16,1,0,2017-2018,2.096774193548387,2.903225806451613
577,Bryan Cristante,ITA,MF,Atalanta,Serie A,22,1995,31.4,66,50,21,32,13,18,59,30.5,41,43,6,37,23,89,27,0,0,2017-2018,0.7324840764331211,2.1019108280254777
578,Sebastián Cristóforo,URU,MF,Fiorentina,Serie A,23,1993,3.0,16,12,6,8,2,9,19,47.4,10,4,0,4,4,20,6,0,0,2017-2018,1.3333333333333333,5.333333333333333
579,Enzo Crivelli,FRA,FW,Angers,Ligue 1,22,1995,11.4,13,9,2,6,5,1,5,20.0,4,4,0,4,2,15,6,0,0,2017-2018,0.17543859649122806,1.1403508771929824
580,Enzo Crivelli,FRA,FW,Caen,Ligue 1,22,1995,8.1,4,2,2,1,1,1,5,20.0,4,1,0,1,2,6,2,0,0,2017-2018,0.2469135802469136,0.4938271604938272
581,Giovanni Crociata,ITA,"MF,FW",Crotone,Serie A,19,1997,3.2,9,6,3,4,2,1,4,25.0,3,7,0,7,4,13,3,0,0,2017-2018,1.25,2.8125
582,Luca Crosta,ITA,GK,Cagliari,Serie A,19,1998,1.0,0,0,0,0,0,0,0,0.0,0,0,0,0,0,0,1,0,0,2017-2018,0.0,0.0
583,Peter Crouch,ENG,FW,Stoke City,Premier League,36,1981,17.4,2,0,0,1,1,0,12,0.0,12,7,4,3,1,3,31,0,0,2017-2018,0.0574712643678161,0.1149425287356322
584,Juan Cruz,ESP,FW,Málaga,La Liga,17,2000,0.1,2,2,0,2,0,0,0,0.0,0,0,0,0,0,2,0,0,0,2017-2018,0.0,20.0
585,Juan Cuadrado,COL,"FW,MF",Juventus,Serie A,29,1988,15.0,28,19,17,9,2,11,27,40.7,16,14,0,14,19,47,14,1,0,2017-2018,1.2666666666666666,1.8666666666666667
586,Iván Cuéllar,ESP,GK,Leganés,La Liga,33,1984,35.0,4,3,4,0,0,3,4,75.0,1,0,0,0,3,7,22,6,0,2017-2018,0.08571428571428572,0.11428571428571428
587,Mickaël Cuisance,FRA,"MF,FW",Gladbach,Bundesliga,17,1999,13.4,31,20,16,11,4,19,29,65.5,10,22,4,18,10,41,10,1,0,2017-2018,0.7462686567164178,2.3134328358208953
588,Josh Cullen,IRL,MF,West Ham,Premier League,21,1996,0.1,0,0,0,0,0,0,1,0.0,1,1,1,0,2,2,0,0,0,2017-2018,20.0,0.0
589,Patrick Cutrone,ITA,FW,Milan,Serie A,19,1998,16.7,11,10,2,7,2,1,10,10.0,9,11,1,10,3,14,12,0,0,2017-2018,0.17964071856287425,0.6586826347305389
590,Wylan Cyprien,FRA,MF,Nice,Ligue 1,22,1995,10.6,9,7,4,4,1,2,11,18.2,9,7,1,6,11,20,7,2,0,2017-2018,1.0377358490566038,0.8490566037735849
591,Marco D'Alessandro,ITA,"MF,FW",Benevento,Serie A,26,1991,11.6,31,22,15,9,7,8,24,33.3,16,12,1,11,10,41,8,1,0,2017-2018,0.8620689655172414,2.6724137931034484
592,Danilo D'Ambrosio,ITA,DF,Inter,Serie A,28,1988,33.1,82,64,38,35,9,30,59,50.8,29,31,7,24,45,127,68,1,0,2017-2018,1.3595166163141994,2.4773413897280965
593,Damien Da Silva,FRA,DF,Caen,Ligue 1,29,1988,31.5,52,35,40,12,0,20,33,60.6,13,45,25,20,36,88,184,2,0,2017-2018,1.1428571428571428,1.6507936507936507
594,Kouadio-Yves Dabila,CIV,DF,Lille,Ligue 1,20,1997,10.5,20,11,14,4,2,6,10,60.0,4,14,6,8,10,30,46,0,0,2017-2018,0.9523809523809523,1.9047619047619047
595,Bryan Dabo,BFA,MF,Fiorentina,Serie A,25,1992,6.6,17,11,6,10,1,6,15,40.0,9,13,1,12,15,32,24,1,0,2017-2018,2.272727272727273,2.5757575757575757
596,Bryan Dabo,BFA,"MF,FW",Saint-Étienne,Ligue 1,25,1992,14.3,25,16,12,10,3,7,29,24.1,22,12,1,11,11,36,22,0,0,2017-2018,0.7692307692307692,1.7482517482517481
597,Mahmoud Dahoud,GER,MF,Dortmund,Bundesliga,21,1996,12.7,38,23,11,21,6,13,30,43.3,17,18,2,16,12,50,7,0,0,2017-2018,0.9448818897637796,2.9921259842519685
598,Dario Dainelli,ITA,DF,Chievo,Serie A,38,1979,16.7,19,14,14,4,1,10,21,47.6,11,27,22,5,46,65,126,0,0,2017-2018,2.754491017964072,1.1377245508982037
599,Felipe dal Belo,BRA,DF,SPAL,Serie A,33,1984,28.6,51,34,32,16,3,25,49,51.0,24,42,24,18,48,99,157,1,0,2017-2018,1.6783216783216783,1.7832167832167831
600,Charlie Daniels,ENG,"DF,MF",Bournemouth,Premier League,30,1986,33.4,48,34,32,12,4,22,41,53.7,19,34,7,27,31,79,114,0,0,2017-2018,0.9281437125748503,1.437125748502994
601,Danilo,BRA,DF,Manchester City,Premier League,26,1991,15.0,43,29,25,12,6,19,35,54.3,16,15,6,9,19,62,33,0,0,2017-2018,1.2666666666666666,2.8666666666666667
602,Scott Dann,ENG,DF,Crystal Palace,Premier League,30,1987,15.9,10,5,8,2,0,7,17,41.2,10,17,14,3,23,33,98,1,0,2017-2018,1.4465408805031446,0.6289308176100629
603,Kevin Danso,AUT,DF,Augsburg,Bundesliga,18,1998,12.3,18,12,13,5,0,12,16,75.0,4,21,14,7,20,38,63,1,0,2017-2018,1.6260162601626016,1.4634146341463414
604,Dante,BRA,DF,Nice,Ligue 1,33,1983,32.4,43,28,32,10,1,21,36,58.3,15,44,25,19,47,90,130,2,0,2017-2018,1.4506172839506173,1.3271604938271606
605,Romain Danzé,FRA,DF,Rennes,Ligue 1,31,1986,7.6,12,7,3,4,5,8,13,61.5,5,11,2,9,3,15,34,0,0,2017-2018,0.39473684210526316,1.5789473684210527
606,Andrea Danzi,ITA,MF,Hellas Verona,Serie A,18,1999,4.4,11,6,7,4,0,5,13,38.5,8,3,0,3,5,16,5,1,0,2017-2018,1.1363636363636362,2.5
607,Stéphane Darbion,FRA,"FW,MF",Troyes,Ligue 1,33,1984,19.0,19,14,13,4,2,5,40,12.5,35,21,2,19,20,39,17,0,0,2017-2018,1.0526315789473684,1.0
608,Palkó Dárdai,HUN,"FW,MF",Hertha BSC,Bundesliga,18,1999,0.3,0,0,0,0,0,0,0,0.0,0,0,0,0,0,0,1,0,0,2017-2018,0.0,0.0
609,Sergi Darder,ESP,MF,Espanyol,La Liga,23,1993,30.9,64,43,29,28,7,19,62,30.6,43,31,5,26,52,116,48,1,0,2017-2018,1.6828478964401294,2.0711974110032365
610,Sergi Darder,ESP,MF,Lyon,Ligue 1,23,1993,2.3,9,3,1,5,3,1,7,14.3,6,0,0,0,3,12,3,0,0,2017-2018,1.3043478260869565,3.91304347826087
611,Vladimír Darida,CZE,MF,Hertha BSC,Bundesliga,26,1990,18.2,38,28,11,18,9,11,26,42.3,15,22,4,18,24,62,23,0,0,2017-2018,1.3186813186813187,2.087912087912088
612,Karl Darlow,ENG,GK,Newcastle Utd,Premier League,26,1990,10.0,0,0,0,0,0,0,0,0.0,0,0,0,0,0,0,3,4,0,2017-2018,0.0,0.0
613,Matteo Darmian,ITA,DF,Manchester Utd,Premier League,27,1989,4.9,16,14,7,7,2,6,19,31.6,13,5,3,2,7,23,23,0,0,2017-2018,1.4285714285714284,3.265306122448979
614,Ben Davies,WAL,DF,Tottenham,Premier League,24,1993,25.8,47,33,13,21,13,25,48,52.1,23,24,5,19,28,75,70,1,0,2017-2018,1.0852713178294573,1.821705426356589
615,Tom Davies,ENG,MF,Everton,Premier League,19,1998,21.1,30,20,14,11,5,12,54,22.2,42,19,5,14,24,54,21,0,0,2017-2018,1.1374407582938388,1.4218009478672984
616,Steven Davis,NIR,MF,Southampton,Premier League,32,1985,16.9,30,21,10,17,3,11,30,36.7,19,22,6,16,15,45,24,1,0,2017-2018,0.8875739644970415,1.775147928994083
617,Salem Al-Dawsari,KSA,MF,Villarreal,La Liga,25,1991,0.4,1,0,0,1,0,1,1,100.0,0,1,0,1,0,1,0,0,0,2017-2018,0.0,2.5
618,Craig Dawson,ENG,DF,West Brom,Premier League,27,1990,27.9,38,28,25,7,6,13,36,36.1,23,39,26,13,52,90,140,0,0,2017-2018,1.863799283154122,1.3620071684587813
619,Kevin De Bruyne,BEL,MF,Manchester City,Premier League,26,1991,34.1,62,43,23,25,14,23,80,28.8,57,45,2,43,25,87,14,2,0,2017-2018,0.7331378299120235,1.8181818181818181
620,Sebastien De Maio,FRA,DF,Bologna,Serie A,30,1987,22.8,26,17,15,11,0,10,25,40.0,15,35,18,17,36,62,147,0,0,2017-2018,1.5789473684210527,1.1403508771929824
621,Rodrigo De Paul,ARG,"FW,MF",Udinese,Serie A,23,1994,25.8,31,18,10,17,4,4,32,12.5,28,34,1,33,16,47,8,0,0,2017-2018,0.6201550387596899,1.2015503875968991
622,Daniele De Rossi,ITA,MF,Roma,Serie A,34,1983,20.3,23,13,12,9,2,9,33,27.3,24,18,13,5,43,66,45,2,0,2017-2018,2.1182266009852215,1.1330049261083743
623,Mattia De Sciglio,ITA,DF,Juventus,Serie A,24,1992,10.8,22,17,7,13,2,9,13,69.2,4,12,2,10,14,36,32,0,0,2017-2018,1.2962962962962963,2.0370370370370368
624,Lorenzo De Silvestri,ITA,DF,Torino,Serie A,29,1988,32.8,39,25,19,13,7,16,26,61.5,10,47,10,37,27,66,165,0,0,2017-2018,0.8231707317073171,1.1890243902439026
625,Lucas Deaux,FRA,MF,Guingamp,Ligue 1,28,1988,21.6,62,45,21,37,4,20,67,29.9,47,41,6,35,32,94,19,0,0,2017-2018,1.4814814814814814,2.8703703703703702
626,Mathieu Debuchy,FRA,DF,Saint-Étienne,Ligue 1,32,1985,14.6,34,25,22,8,4,17,30,56.7,13,16,10,6,27,61,73,0,0,2017-2018,1.8493150684931507,2.328767123287671
627,Troy Deeney,ENG,FW,Watford,Premier League,29,1988,20.5,15,11,3,8,4,3,11,27.3,8,14,1,13,5,20,20,0,0,2017-2018,0.24390243902439024,0.7317073170731707
628,Jermain Defoe,ENG,FW,Bournemouth,Premier League,34,1982,12.1,12,9,2,6,4,2,10,20.0,8,10,0,10,4,16,1,0,0,2017-2018,0.3305785123966942,0.9917355371900827
629,Steven Defour,BEL,MF,Burnley,Premier League,29,1988,22.2,33,22,12,18,3,10,46,21.7,36,35,7,28,46,79,25,0,0,2017-2018,2.0720720720720722,1.4864864864864866
630,Grégoire Defrel,MTQ,"FW,MF",Roma,Serie A,26,1991,5.4,8,3,1,1,6,2,8,25.0,6,5,0,5,3,11,6,0,0,2017-2018,0.5555555555555555,1.4814814814814814
631,Alessandro Deiola,ITA,MF,Cagliari,Serie A,21,1995,5.0,9,7,5,3,1,6,13,46.2,7,8,0,8,4,13,12,0,0,2017-2018,0.8,1.8
632,Lorenzo Del Pinto,ITA,MF,Benevento,Serie A,27,1990,8.4,23,17,10,10,3,7,25,28.0,18,13,4,9,16,39,7,2,0,2017-2018,1.9047619047619047,2.738095238095238
633,Damien Delaney,IRL,DF,Crystal Palace,Premier League,36,1981,1.1,2,1,2,0,0,1,1,100.0,0,5,4,1,3,5,7,0,0,2017-2018,2.727272727272727,1.8181818181818181
634,Thomas Delaney,DEN,MF,Werder Bremen,Bundesliga,25,1991,31.1,79,61,27,46,6,36,53,67.9,17,37,12,25,43,122,74,4,0,2017-2018,1.382636655948553,2.540192926045016
635,Jonathan Delaplace,FRA,MF,Caen,Ligue 1,31,1986,6.5,10,8,1,8,1,3,10,30.0,7,13,5,8,8,18,8,0,0,2017-2018,1.2307692307692308,1.5384615384615385
636,Cristian Dell'Orco,ITA,DF,Sassuolo,Serie A,23,1994,4.7,4,1,1,2,1,1,3,33.3,2,5,1,4,10,14,19,0,0,2017-2018,2.127659574468085,0.851063829787234
637,Andy Delort,ALG,FW,Toulouse,Ligue 1,25,1991,25.9,20,13,2,9,9,4,19,21.1,15,10,0,10,12,32,22,0,0,2017-2018,0.46332046332046334,0.7722007722007722
638,Fabian Delph,ENG,DF,Manchester City,Premier League,27,1989,19.3,46,34,21,16,9,18,37,48.6,19,16,0,16,30,76,42,2,0,2017-2018,1.5544041450777202,2.383419689119171
639,Mousa Dembélé,BEL,MF,Tottenham,Premier League,30,1987,20.9,36,24,19,11,6,9,37,24.3,28,20,0,20,33,69,15,0,0,2017-2018,1.5789473684210527,1.722488038277512
640,Ousmane Dembélé,FRA,"FW,MF",Barcelona,La Liga,20,1997,10.3,10,7,2,5,3,1,13,7.7,12,8,0,8,5,15,2,0,0,2017-2018,0.48543689320388345,0.9708737864077669
641,Jessy Deminguet,FRA,"MF,FW",Caen,Ligue 1,19,1998,5.9,12,9,4,6,2,4,14,28.6,10,5,0,5,10,22,13,0,0,2017-2018,1.694915254237288,2.0338983050847457
642,Kerem Demirbay,GER,MF,Hoffenheim,Bundesliga,24,1993,13.5,38,30,15,17,6,12,28,42.9,16,21,3,18,14,52,21,0,0,2017-2018,1.037037037037037,2.814814814814815
643,Ermedin Demirović,BIH,FW,Alavés,La Liga,19,1998,2.0,1,1,0,1,0,0,1,0.0,1,5,0,5,0,1,2,0,0,2017-2018,0.0,0.5
644,Diego Demme,GER,MF,RB Leipzig,Bundesliga,25,1991,25.4,81,57,29,48,4,47,87,54.0,40,31,3,28,48,129,29,0,0,2017-2018,1.8897637795275593,3.188976377952756
645,Fabio Depaoli,ITA,"DF,MF",Chievo,Serie A,20,1997,13.2,31,22,21,7,3,21,40,52.5,19,27,10,17,15,46,42,0,0,2017-2018,1.1363636363636365,2.3484848484848486
646,Mathieu Deplagne,FRA,DF,Troyes,Ligue 1,25,1991,26.8,52,38,33,14,5,20,48,41.7,28,26,10,16,60,112,95,2,0,2017-2018,2.2388059701492535,1.9402985074626866
647,Laurent Depoitre,BEL,FW,Huddersfield,Premier League,28,1988,20.2,14,8,4,8,2,3,21,14.3,18,15,3,12,11,25,36,0,0,2017-2018,0.5445544554455446,0.6930693069306931
648,Mike van der Hoorn,NED,DF,Swansea City,Premier League,24,1992,21.6,32,22,23,8,1,16,24,66.7,8,24,14,10,39,71,127,0,0,2017-2018,1.8055555555555554,1.4814814814814814
649,Gregory van der Wiel,NED,DF,Cagliari,Serie A,29,1988,3.2,5,3,4,1,0,3,5,60.0,2,1,0,1,10,15,12,0,0,2017-2018,3.125,1.5625
650,Daniele Dessena,ITA,"MF,DF",Cagliari,Serie A,30,1987,6.4,18,10,12,5,1,6,12,50.0,6,7,1,6,6,24,17,0,0,2017-2018,0.9375,2.8125
651,Mattia Destro,ITA,FW,Bologna,Serie A,26,1991,18.0,15,13,4,9,2,3,11,27.3,8,10,1,9,5,20,26,0,0,2017-2018,0.2777777777777778,0.8333333333333334
652,Gerard Deulofeu,ESP,"FW,MF",Watford,Premier League,23,1994,4.8,5,3,2,2,1,2,11,18.2,9,0,0,0,4,9,3,1,0,2017-2018,0.8333333333333334,1.0416666666666667
653,Gerard Deulofeu,ESP,"MF,FW",Barcelona,La Liga,23,1994,5.6,8,5,6,1,1,3,4,75.0,1,2,0,2,8,16,0,0,0,2017-2018,1.4285714285714286,1.4285714285714286
654,Gianluca Di Chiara,ITA,DF,Benevento,Serie A,23,1993,11.2,26,19,18,6,2,7,21,33.3,14,10,3,7,11,37,37,1,0,2017-2018,0.9821428571428572,2.3214285714285716
655,Federico Di Francesco,ITA,"FW,DF",Bologna,Serie A,23,1994,17.7,26,13,14,8,4,5,20,25.0,15,24,2,22,16,42,25,0,0,2017-2018,0.903954802259887,1.4689265536723164
656,Davide Di Gennaro,ITA,MF,Lazio,Serie A,29,1988,0.1,1,0,1,0,0,1,1,100.0,0,0,0,0,0,1,0,0,0,2017-2018,0.0,10.0
657,Ángel Di María,ARG,FW,Paris S-G,Ligue 1,29,1988,23.5,13,10,5,3,5,7,39,17.9,32,18,2,16,10,23,8,0,0,2017-2018,0.425531914893617,0.5531914893617021
658,Franco Di Santo,ARG,"FW,MF",Schalke 04,Bundesliga,28,1989,18.4,17,13,3,13,1,7,15,46.7,8,12,1,11,2,19,24,0,0,2017-2018,0.10869565217391305,0.923913043478261
659,Cheick Diabaté,MLI,FW,Benevento,Serie A,29,1988,7.4,1,1,0,1,0,1,3,33.3,2,2,0,2,0,1,6,0,0,2017-2018,0.0,0.13513513513513511
660,Fousseni Diabaté,MLI,"MF,FW",Leicester City,Premier League,21,1995,6.5,9,6,5,3,1,1,4,25.0,3,6,0,6,8,17,8,0,0,2017-2018,1.2307692307692308,1.3846153846153846
661,Moussa Diaby,FRA,MF,Crotone,Serie A,18,1999,0.8,1,0,1,0,0,1,4,25.0,3,1,0,1,1,2,0,0,0,2017-2018,1.25,1.25
662,Fallou Diagne,SEN,"DF,MF",Metz,Ligue 1,27,1989,24.9,33,20,21,12,0,7,22,31.8,15,33,18,15,46,79,116,3,0,2017-2018,1.8473895582329318,1.3253012048192772
663,Adama Diakhaby,FRA,FW,Monaco,Ligue 1,21,1996,9.4,23,15,6,12,5,6,16,37.5,10,13,0,13,13,36,5,0,0,2017-2018,1.3829787234042552,2.4468085106382977
664,Mouctar Diakhaby,GUI,DF,Lyon,Ligue 1,20,1996,8.1,10,6,7,3,0,4,7,57.1,3,14,9,5,12,22,52,1,0,2017-2018,1.4814814814814816,1.234567901234568
665,Abdou Diallo,SEN,DF,Mainz 05,Bundesliga,21,1996,26.8,75,53,45,25,5,38,50,76.0,12,37,14,23,50,125,75,0,0,2017-2018,1.8656716417910448,2.798507462686567
666,Abdoulaye Diallo,SEN,GK,Rennes,Ligue 1,25,1992,3.0,0,0,0,0,0,0,0,0.0,0,0,0,0,0,0,4,1,0,2017-2018,0.0,0.0
667,Habib Diallo,SEN,"FW,MF",Metz,Ligue 1,22,1995,0.2,0,0,0,0,0,0,0,0.0,0,0,0,0,0,0,0,0,0,2017-2018,0.0,0.0
668,Mustapha Diallo,SEN,MF,Guingamp,Ligue 1,31,1986,15.4,48,36,15,29,4,15,33,45.5,18,20,4,16,20,68,29,0,0,2017-2018,1.2987012987012987,3.116883116883117
669,Mohamed Diamé,SEN,MF,Newcastle Utd,Premier League,30,1987,22.7,89,64,33,48,8,16,62,25.8,46,44,7,37,48,137,30,2,0,2017-2018,2.1145374449339207,3.9207048458149782
670,Lassana Diarra,FRA,MF,Paris S-G,Ligue 1,32,1985,6.7,12,4,4,7,1,8,12,66.7,4,3,1,2,6,18,6,0,0,2017-2018,0.8955223880597015,1.791044776119403
671,Amadou Diawara,GUI,MF,Napoli,Serie A,20,1997,7.3,11,9,3,7,1,1,7,14.3,6,12,2,10,9,20,5,0,0,2017-2018,1.2328767123287672,1.5068493150684932
672,Brahim Díaz,MAR,"FW,DF",Manchester City,Premier League,17,1999,0.6,1,0,1,0,0,0,0,0.0,0,3,0,3,1,2,0,0,0,2017-2018,1.6666666666666667,1.6666666666666667
673,Bakaye Dibassy,MLI,DF,Amiens,Ligue 1,27,1989,30.9,71,51,45,22,4,24,50,48.0,26,52,26,26,58,129,148,0,0,2017-2018,1.877022653721683,2.2977346278317152
674,Daniel Didavi,GER,MF,Wolfsburg,Bundesliga,27,1990,24.9,34,19,10,19,5,14,33,42.4,19,20,1,19,7,41,12,0,0,2017-2018,0.28112449799196787,1.3654618473895583
675,Thomas Didillon,FRA,GK,Metz,Ligue 1,21,1995,9.0,0,0,0,0,0,0,1,0.0,1,0,0,0,0,0,5,2,0,2017-2018,0.0,0.0
676,Étienne Didot,FRA,MF,Guingamp,Ligue 1,34,1983,18.0,54,33,20,33,1,20,43,46.5,23,21,7,14,19,73,29,0,0,2017-2018,1.0555555555555556,3.0
677,Adrián Diéguez,ESP,DF,Alavés,La Liga,21,1996,4.8,10,5,5,5,0,6,13,46.2,7,5,0,5,11,21,24,1,0,2017-2018,2.291666666666667,2.0833333333333335
678,Dennis Diekmeier,GER,DF,Hamburger SV,Bundesliga,27,1989,20.8,47,43,31,10,6,25,36,69.4,11,22,11,11,16,63,50,0,0,2017-2018,0.7692307692307692,2.2596153846153846
679,Eric Dier,ENG,"MF,DF",Tottenham,Premier League,23,1994,31.4,61,43,15,39,7,17,42,40.5,25,32,11,21,48,109,93,7,0,2017-2018,1.5286624203821657,1.9426751592356688
680,Lucas Digne,FRA,DF,Barcelona,La Liga,24,1993,7.8,22,17,13,6,3,8,12,66.7,4,15,3,12,12,34,18,0,0,2017-2018,1.5384615384615385,2.8205128205128207
681,Landry Dimata,BEL,FW,Wolfsburg,Bundesliga,19,1997,10.0,7,6,4,3,0,5,6,83.3,1,6,2,4,2,9,5,0,0,2017-2018,0.2,0.7
682,Tristan Dingomé,CMR,MF,Troyes,Ligue 1,26,1991,13.2,25,20,12,9,4,5,13,38.5,8,12,0,12,12,37,16,1,0,2017-2018,0.9090909090909092,1.893939393939394
683,Ismaël Diomandé,CIV,"DF,MF",Caen,Ligue 1,24,1992,7.9,14,8,7,6,1,10,15,66.7,5,11,5,6,5,19,20,0,0,2017-2018,0.6329113924050632,1.7721518987341771
684,Lois Diony,FRA,FW,Saint-Étienne,Ligue 1,24,1992,10.3,3,0,1,2,0,0,3,0.0,3,5,1,4,1,4,8,0,0,2017-2018,0.0970873786407767,0.2912621359223301
685,Issa Diop,FRA,DF,Toulouse,Ligue 1,20,1997,34.0,58,43,35,22,1,21,48,43.8,27,38,25,13,76,134,128,0,0,2017-2018,2.235294117647059,1.7058823529411764
686,Papakouli Diop,SEN,MF,Espanyol,La Liga,31,1986,2.9,5,3,1,3,1,0,3,0.0,3,5,2,3,6,11,6,0,0,2017-2018,2.0689655172413794,1.7241379310344829
687,Papakouli Diop,SEN,MF,Eibar,La Liga,31,1986,10.4,26,20,6,16,4,11,26,42.3,15,3,0,3,13,39,10,0,0,2017-2018,1.25,2.5
688,Assane Dioussé,SEN,MF,Saint-Étienne,Ligue 1,19,1997,14.9,32,21,14,14,4,13,34,38.2,21,29,2,27,11,43,16,2,0,2017-2018,0.7382550335570469,2.1476510067114094
689,Djené,TOG,DF,Getafe,La Liga,25,1991,36.0,87,65,71,15,1,34,52,65.4,18,33,14,19,78,165,190,1,0,2017-2018,2.1666666666666665,2.4166666666666665
690,Koffi Djidji,CIV,DF,Nantes,Ligue 1,24,1992,26.8,55,39,32,20,3,19,29,65.5,10,34,15,19,45,100,126,0,0,2017-2018,1.6791044776119401,2.0522388059701493
691,Alexander Djiku,GHA,DF,Caen,Ligue 1,22,1994,28.0,65,43,52,11,2,25,52,48.1,27,34,5,29,57,122,155,2,0,2017-2018,2.0357142857142856,2.3214285714285716
692,Papy Djilobodji,SEN,DF,Dijon,Ligue 1,28,1988,30.0,45,29,34,11,0,21,43,48.8,22,38,25,13,71,116,211,5,0,2017-2018,2.3666666666666667,1.5
693,Berat Djimsiti,ALB,DF,Benevento,Serie A,24,1993,30.0,32,17,28,4,0,12,30,40.0,18,37,23,14,62,94,178,1,0,2017-2018,2.066666666666667,1.0666666666666667
694,Marko Dmitrović,SRB,GK,Eibar,La Liga,25,1992,36.0,4,4,4,0,0,4,11,36.4,7,1,0,1,2,6,26,2,0,2017-2018,0.05555555555555555,0.1111111111111111
695,Keagan Dolly,RSA,"MF,FW",Montpellier,Ligue 1,24,1993,9.8,12,7,2,7,3,1,11,9.1,10,11,0,11,1,13,2,0,0,2017-2018,0.1020408163265306,1.2244897959183672
696,Jaume Doménech,ESP,GK,Valencia,La Liga,26,1990,5.0,0,0,0,0,0,0,0,0.0,0,0,0,0,0,0,2,0,0,2017-2018,0.0,0.0
697,Jean-Luc Dompé,FRA,FW,Amiens,Ligue 1,21,1995,0.3,0,0,0,0,0,0,0,0.0,0,0,0,0,0,0,0,0,0,2017-2018,0.0,0.0
698,Giulio Donati,ITA,"DF,FW",Mainz 05,Bundesliga,27,1990,25.4,56,42,30,21,5,34,50,68.0,16,38,8,30,35,91,66,1,0,2017-2018,1.3779527559055118,2.204724409448819
699,Ji Dong-won,KOR,"FW,MF",Augsburg,Bundesliga,26,1991,0.2,2,1,0,1,1,0,0,0.0,0,1,1,0,1,3,0,0,0,2017-2018,5.0,10.0
700,Anastasios Donis,GRE,"MF,FW",Stuttgart,Bundesliga,20,1996,10.5,20,14,10,6,4,6,8,75.0,2,2,0,2,9,29,7,0,0,2017-2018,0.8571428571428571,1.9047619047619047
701,Gianluigi Donnarumma,ITA,GK,Milan,Serie A,18,1999,38.0,1,0,1,0,0,1,1,100.0,0,0,0,0,1,2,13,8,0,2017-2018,0.02631578947368421,0.02631578947368421
702,Godfred Donsah,GHA,MF,Bologna,Serie A,21,1996,19.9,29,20,11,14,4,10,17,58.8,7,25,0,25,22,51,43,0,0,2017-2018,1.105527638190955,1.4572864321608041
703,Dória,BRA,DF,Marseille,Ligue 1,22,1994,0.9,2,2,0,2,0,0,0,0.0,0,3,1,2,1,3,1,0,0,2017-2018,1.1111111111111112,2.2222222222222223
704,Niklas Dorsch,GER,MF,Bayern Munich,Bundesliga,19,1998,1.0,1,1,0,1,0,0,2,0.0,2,0,0,0,1,2,0,0,0,2017-2018,1.0,1.0
705,Mauro dos Santos,ARG,DF,Leganés,La Liga,28,1989,10.9,16,14,11,5,0,10,15,66.7,5,7,5,2,12,28,53,1,0,2017-2018,1.1009174311926606,1.4678899082568806
706,Mathieu Dossevi,TOG,"FW,MF",Metz,Ligue 1,29,1988,27.9,35,25,15,15,5,7,39,17.9,32,24,3,21,28,63,12,0,0,2017-2018,1.0035842293906811,1.2544802867383513
707,Abdoulaye Doucouré,MLI,MF,Watford,Premier League,24,1993,36.9,79,52,28,42,9,27,79,34.2,52,43,10,33,54,133,61,0,0,2017-2018,1.4634146341463414,2.140921409214092
708,Cheick Doukouré,CIV,MF,Levante,La Liga,24,1992,11.4,34,19,18,15,1,6,22,27.3,16,15,4,11,14,48,4,0,0,2017-2018,1.2280701754385965,2.982456140350877
709,Mohamed Dräger,TUN,"MF,FW",Freiburg,Bundesliga,21,1996,0.6,0,0,0,0,0,0,1,0.0,1,1,0,1,0,0,0,0,0,2017-2018,0.0,0.0
710,Aleksandar Dragović,AUT,DF,Leicester City,Premier League,26,1991,8.5,13,10,13,0,0,7,13,53.8,6,16,8,8,16,29,46,0,0,2017-2018,1.8823529411764706,1.5294117647058822
711,Aleksandar Dragović,AUT,DF,Leverkusen,Bundesliga,26,1991,0.5,0,0,0,0,0,0,1,0.0,1,0,0,0,0,0,0,1,0,2017-2018,0.0,0.0
712,Bartłomiej Drągowski,POL,GK,Fiorentina,Serie A,19,1997,2.4,0,0,0,0,0,0,0,0.0,0,0,0,0,0,0,0,1,0,2017-2018,0.0,0.0
713,Boukary Dramé,SEN,"DF,MF",SPAL,Serie A,32,1985,1.1,1,1,1,0,0,0,0,0.0,0,0,0,0,2,3,4,0,0,2017-2018,1.8181818181818181,0.9090909090909091
714,Julian Draxler,GER,"MF,FW",Paris S-G,Ligue 1,23,1993,18.9,20,14,4,13,3,6,32,18.8,26,18,2,16,28,48,8,0,0,2017-2018,1.4814814814814816,1.0582010582010584
715,Danny Drinkwater,ENG,MF,Chelsea,Premier League,27,1990,5.9,15,10,6,8,1,3,17,17.6,14,10,2,8,8,23,7,0,0,2017-2018,1.3559322033898304,2.542372881355932
716,Josip Drmić,SUI,"FW,MF",Gladbach,Bundesliga,24,1992,5.2,0,0,0,0,0,0,4,0.0,4,1,0,1,0,0,1,1,0,2017-2018,0.0,0.0
717,Rick van Drongelen,NED,DF,Hamburger SV,Bundesliga,18,1998,16.0,30,25,23,7,0,21,28,75.0,7,20,11,9,19,49,58,1,0,2017-2018,1.1875,1.875
718,Óscar Duarte,CRC,DF,Espanyol,La Liga,28,1989,11.0,12,9,8,4,0,4,11,36.4,7,8,8,0,9,21,60,2,0,2017-2018,0.8181818181818182,1.0909090909090908
719,Rubén Duarte,ESP,DF,Alavés,La Liga,21,1995,23.8,76,40,42,27,7,35,59,59.3,24,40,10,30,44,120,94,0,0,2017-2018,1.8487394957983192,3.1932773109243695
720,Leo Dubois,FRA,DF,Nantes,Ligue 1,22,1994,33.6,50,39,33,15,2,20,47,42.6,27,47,13,34,50,100,99,2,0,2017-2018,1.4880952380952381,1.4880952380952381
721,Martin Dúbravka,SVK,GK,Newcastle Utd,Premier League,28,1989,12.0,0,0,0,0,0,0,0,0.0,0,0,0,0,0,0,3,2,0,2017-2018,0.0,0.0
722,Ondrej Duda,SVK,MF,Hertha BSC,Bundesliga,22,1994,8.3,16,12,7,6,3,6,14,42.9,8,15,0,15,4,20,8,0,0,2017-2018,0.48192771084337344,1.9277108433734937
723,Shane Duffy,IRL,DF,Brighton,Premier League,25,1992,36.6,31,19,22,9,0,7,20,35.0,13,66,59,7,50,81,332,5,0,2017-2018,1.366120218579235,0.8469945355191256
724,Paul Dummett,WAL,DF,Newcastle Utd,Premier League,25,1991,17.8,28,19,21,7,0,13,27,48.1,14,27,10,17,23,51,107,1,0,2017-2018,1.2921348314606742,1.5730337078651684
725,Alfred Duncan,GHA,MF,Sassuolo,Serie A,24,1993,21.6,39,29,16,18,5,15,52,28.8,37,32,2,30,19,58,29,1,0,2017-2018,0.8796296296296295,1.8055555555555554
726,Lewis Dunk,ENG,DF,Brighton,Premier League,25,1991,38.0,67,33,49,18,0,25,48,52.1,23,73,58,15,71,138,230,2,0,2017-2018,1.868421052631579,1.763157894736842
727,Maxime Dupé,FRA,GK,Nantes,Ligue 1,24,1993,1.0,0,0,0,0,0,0,0,0.0,0,0,0,0,0,0,2,0,0,2017-2018,0.0,0.0
728,Jimmy Durmaz,SWE,"MF,FW",Toulouse,Ligue 1,28,1989,11.4,16,9,5,5,6,6,14,42.9,8,2,0,2,14,30,9,0,0,2017-2018,1.2280701754385965,1.4035087719298245
729,Riza Durmisi,DEN,DF,Betis,La Liga,23,1994,23.1,39,21,24,14,1,10,18,55.6,8,18,7,11,15,54,65,1,0,2017-2018,0.6493506493506493,1.6883116883116882
730,Hugo Duro,ESP,FW,Getafe,La Liga,17,1999,0.2,0,0,0,0,0,0,1,0.0,1,0,0,0,0,0,0,0,0,2017-2018,0.0,0.0
731,Noë Dussenne,BEL,FW,Crotone,Serie A,25,1992,0.9,2,0,2,0,0,0,0,0.0,0,0,0,0,1,3,8,0,0,2017-2018,1.1111111111111112,2.2222222222222223
732,Paulo Dybala,ARG,"MF,FW",Juventus,Serie A,23,1993,26.1,19,11,4,10,5,4,32,12.5,28,22,0,22,12,31,4,0,0,2017-2018,0.45977011494252873,0.7279693486590038
733,Nathan Dyer,ENG,"MF,FW",Swansea City,Premier League,29,1987,14.5,22,16,8,9,5,6,24,25.0,18,13,0,13,11,33,3,0,0,2017-2018,0.7586206896551724,1.5172413793103448
734,Edin Džeko,BIH,FW,Roma,Serie A,31,1986,33.5,15,10,1,9,5,3,15,20.0,12,9,1,8,4,19,36,0,0,2017-2018,0.11940298507462686,0.44776119402985076
735,Blerim Džemaili,SUI,"MF,FW",Bologna,Serie A,31,1986,13.3,27,19,11,15,1,9,27,33.3,18,15,4,11,18,45,11,0,0,2017-2018,1.3533834586466165,2.0300751879699246
736,Félix Eboa Eboa,CMR,DF,Guingamp,Ligue 1,20,1997,16.9,19,11,12,7,0,8,16,50.0,8,21,11,10,39,58,119,2,0,2017-2018,2.307692307692308,1.124260355029586
737,Éder,ITA,"FW,MF",Inter,Serie A,30,1986,8.9,10,7,2,4,4,0,10,0.0,10,6,1,5,5,15,4,0,0,2017-2018,0.5617977528089887,1.1235955056179774
738,Simone Edera,ITA,"FW,MF",Torino,Serie A,20,1997,3.6,6,2,2,4,0,3,10,30.0,7,0,0,0,2,8,1,0,0,2017-2018,0.5555555555555556,1.6666666666666665
739,Ederson,BRA,GK,Manchester City,Premier League,23,1993,35.5,1,1,1,0,0,0,0,0.0,0,1,0,1,0,1,15,6,0,2017-2018,0.0,0.028169014084507043
740,Tom Edwards,ENG,"DF,MF",Stoke City,Premier League,18,1999,5.3,15,9,10,5,0,8,8,100.0,0,5,2,3,5,20,20,0,0,2017-2018,0.9433962264150944,2.8301886792452833
741,Mandela Egbo,ENG,"DF,MF",Gladbach,Bundesliga,19,1997,0.1,0,0,0,0,0,0,0,0.0,0,0,0,0,0,0,2,0,0,2017-2018,0.0,0.0
742,Johannes Eggestein,GER,"FW,DF",Werder Bremen,Bundesliga,19,1998,1.1,0,0,0,0,0,0,1,0.0,1,2,1,1,1,1,0,0,0,2017-2018,0.9090909090909091,0.0
743,Maximilian Eggestein,GER,MF,Werder Bremen,Bundesliga,20,1996,29.9,70,48,32,34,4,34,58,58.6,24,41,6,35,40,110,51,0,0,2017-2018,1.3377926421404682,2.3411371237458196
744,Albin Ekdal,SWE,MF,Hamburger SV,Bundesliga,28,1989,12.3,39,28,19,19,1,18,29,62.1,11,20,3,17,21,60,19,0,0,2017-2018,1.7073170731707317,3.170731707317073
745,Josip Elez,CRO,DF,Hannover 96,Bundesliga,23,1994,8.6,12,8,9,2,1,5,9,55.6,4,9,7,2,16,28,39,1,0,2017-2018,1.8604651162790697,1.3953488372093024
746,Rob Elliot,IRL,GK,Newcastle Utd,Premier League,31,1986,16.0,0,0,0,0,0,0,1,0.0,1,0,0,0,0,0,8,0,0,2017-2018,0.0,0.0
747,Mohamed Elneny,EGY,MF,Arsenal,Premier League,25,1992,9.6,12,6,6,3,3,6,10,60.0,4,11,0,11,10,22,12,2,0,2017-2018,1.0416666666666667,1.25
748,Aritz Elustondo,ESP,DF,Real Sociedad,La Liga,23,1994,17.7,32,20,20,9,3,19,30,63.3,11,20,7,13,45,77,84,0,0,2017-2018,2.542372881355932,1.807909604519774
749,Nico Elvedi,SUI,DF,Gladbach,Bundesliga,20,1996,32.4,66,46,41,22,3,37,55,67.3,18,39,9,30,51,117,108,3,0,2017-2018,1.5740740740740742,2.037037037037037
750,Rodrigo Ely,BRA,DF,Alavés,La Liga,23,1993,29.9,32,18,26,6,0,19,34,55.9,15,45,36,9,50,82,183,0,0,2017-2018,1.6722408026755853,1.0702341137123745
751,Breel Embolo,SUI,"FW,MF",Schalke 04,Bundesliga,20,1997,10.2,14,10,3,7,4,2,9,22.2,7,13,0,13,6,20,3,0,0,2017-2018,0.5882352941176471,1.3725490196078431
752,Youssef En-Nesyri,MAR,FW,Málaga,La Liga,20,1997,17.7,31,25,10,14,7,6,26,23.1,20,11,0,11,9,40,32,0,0,2017-2018,0.5084745762711864,1.7514124293785311
753,Sergi Enrich,ESP,FW,Eibar,La Liga,27,1990,14.8,11,8,3,3,5,2,8,25.0,6,13,1,12,6,17,8,0,0,2017-2018,0.4054054054054054,0.7432432432432432
754,Javier Eraso,ESP,"MF,FW",Leganés,La Liga,27,1990,28.1,32,15,10,18,4,13,42,31.0,29,16,5,11,23,55,17,0,0,2017-2018,0.8185053380782917,1.1387900355871885
755,Christian Eriksen,DEN,"MF,FW",Tottenham,Premier League,25,1992,35.8,51,29,16,30,5,17,59,28.8,42,38,1,37,31,82,21,0,0,2017-2018,0.8659217877094972,1.4245810055865924
756,Gonzalo Escalante,ARG,MF,Eibar,La Liga,24,1993,17.4,59,35,21,32,6,17,39,43.6,22,26,3,23,32,91,19,0,0,2017-2018,1.8390804597701151,3.3908045977011496
757,Sergio Escudero,ESP,DF,Sevilla,La Liga,27,1989,25.9,78,49,40,26,12,32,62,51.6,30,35,6,29,66,144,69,1,0,2017-2018,2.5482625482625485,3.011583011583012
758,Bernardo Espinosa,COL,DF,Girona,La Liga,28,1989,31.9,36,22,29,6,1,18,33,54.5,15,27,19,8,66,102,169,0,0,2017-2018,2.0689655172413794,1.1285266457680252
759,Michael Esser,GER,GK,Hannover 96,Bundesliga,29,1987,3.0,0,0,0,0,0,0,1,0.0,1,0,0,0,0,0,0,0,0,2017-2018,0.0,0.0
760,Alexander Esswein,GER,"FW,MF",Hertha BSC,Bundesliga,27,1990,6.9,25,16,13,10,2,12,25,48.0,13,4,0,4,9,34,11,0,0,2017-2018,1.3043478260869565,3.623188405797101
761,Oghenekaro Etebo,NGA,MF,Las Palmas,La Liga,21,1995,13.5,24,17,9,12,3,12,26,46.2,14,17,3,14,27,51,10,0,0,2017-2018,2.0,1.7777777777777777
762,Beñat Etxebarria,ESP,MF,Athletic Club,La Liga,30,1987,12.4,28,20,12,13,3,13,36,36.1,23,6,1,5,28,56,12,0,0,2017-2018,2.258064516129032,2.258064516129032
763,Xabier Etxeita,ESP,DF,Athletic Club,La Liga,29,1987,4.2,2,2,2,0,0,1,4,25.0,3,3,2,1,7,9,25,1,0,2017-2018,1.6666666666666665,0.47619047619047616
764,Jonny Evans,NIR,DF,West Brom,Premier League,29,1988,25.2,29,22,19,8,2,14,33,42.4,19,22,13,9,48,77,131,1,0,2017-2018,1.9047619047619049,1.150793650793651
765,Franck Evina,CMR,FW,Bayern Munich,Bundesliga,17,2000,1.2,2,2,2,0,0,2,2,100.0,0,5,0,5,0,2,0,0,0,2017-2018,0.0,1.6666666666666667
766,Patrice Evra,FRA,"DF,MF",West Ham,Premier League,36,1981,2.5,6,4,5,1,0,6,8,75.0,2,4,1,3,7,13,6,0,0,2017-2018,2.8,2.4
767,Patrice Evra,FRA,DF,Marseille,Ligue 1,36,1981,3.9,6,5,5,1,0,3,6,50.0,3,2,2,0,3,9,16,0,0,2017-2018,0.7692307692307693,1.5384615384615385
768,Edu Expósito,ESP,"MF,FW",La Coruña,La Liga,20,1996,1.1,1,0,0,0,1,0,1,0.0,1,1,0,1,2,3,2,0,0,2017-2018,1.8181818181818181,0.9090909090909091
769,Erik Expósito,ESP,FW,Las Palmas,La Liga,21,1996,5.2,1,1,0,1,0,0,6,0.0,6,6,0,6,1,2,5,0,0,2017-2018,0.1923076923076923,0.1923076923076923
770,Valentin Eysseric,FRA,"FW,MF",Fiorentina,Serie A,25,1992,7.8,17,13,7,4,6,6,20,30.0,14,10,2,8,6,23,6,0,0,2017-2018,0.7692307692307693,2.1794871794871797
771,Valentin Eysseric,FRA,FW,Nice,Ligue 1,25,1992,1.0,0,0,0,0,0,0,0,0.0,0,4,0,4,1,1,0,0,0,2017-2018,1.0,0.0
772,Imoh Ezekiel,NGA,"MF,FW",Las Palmas,La Liga,23,1993,5.2,8,6,3,2,3,3,4,75.0,1,4,0,4,2,10,3,0,0,2017-2018,0.3846153846153846,1.5384615384615383
773,Marco Fabián,MEX,"MF,FW",Eint Frankfurt,Bundesliga,28,1989,4.7,5,3,2,3,0,3,4,75.0,1,2,0,2,3,8,1,0,0,2017-2018,0.6382978723404255,1.0638297872340425
774,Łukasz Fabiański,POL,GK,Swansea City,Premier League,32,1985,38.0,0,0,0,0,0,0,0,0.0,0,0,0,0,0,0,10,2,0,2017-2018,0.0,0.0
775,Fabinho,BRA,MF,Monaco,Ligue 1,23,1993,34.0,114,64,38,67,9,48,112,42.9,64,48,13,35,43,157,62,0,0,2017-2018,1.2647058823529411,3.3529411764705883
776,Cesc Fàbregas,ESP,MF,Chelsea,Premier League,30,1987,25.6,68,49,30,29,9,18,69,26.1,51,25,4,21,22,90,26,2,0,2017-2018,0.859375,2.65625
777,Ralf Fährmann,GER,GK,Schalke 04,Bundesliga,28,1988,33.5,1,0,1,0,0,1,3,33.3,2,1,0,1,1,2,12,7,0,2017-2018,0.029850746268656716,0.029850746268656716
778,Fayçal Fajr,MAR,"MF,FW",Getafe,La Liga,28,1988,26.5,62,45,22,34,6,17,66,25.8,49,26,4,22,30,92,42,0,0,2017-2018,1.1320754716981132,2.339622641509434
779,Radamel Falcao,COL,FW,Monaco,Ligue 1,31,1986,23.7,11,6,0,8,3,2,13,15.4,11,13,3,10,10,21,11,0,0,2017-2018,0.4219409282700422,0.4641350210970464
780,Diego Falcinelli,ITA,FW,Fiorentina,Serie A,26,1991,4.9,1,1,1,0,0,0,5,0.0,5,5,1,4,1,2,4,0,0,2017-2018,0.2040816326530612,0.2040816326530612
781,Diego Falcinelli,ITA,FW,Sassuolo,Serie A,26,1991,14.6,4,4,1,2,1,1,13,7.7,12,12,2,10,2,6,9,0,0,2017-2018,0.136986301369863,0.273972602739726
782,Simon Falette,GUI,DF,Metz,Ligue 1,25,1992,1.0,0,0,0,0,0,0,0,0.0,0,0,0,0,1,1,8,0,0,2017-2018,1.0,0.0
783,Simon Falette,GUI,DF,Eint Frankfurt,Bundesliga,25,1992,24.6,34,30,23,10,1,19,31,61.3,12,37,15,22,58,92,134,1,0,2017-2018,2.357723577235772,1.3821138211382114
784,Cesar Falletti,URU,"MF,FW",Bologna,Serie A,24,1992,3.6,11,7,4,6,1,4,8,50.0,4,10,0,10,0,11,5,0,0,2017-2018,0.0,3.0555555555555554
785,Iago Falque,ESP,"FW,MF",Torino,Serie A,27,1990,31.3,41,31,15,20,6,6,43,14.0,37,22,0,22,15,56,15,0,0,2017-2018,0.4792332268370607,1.3099041533546325
786,Paolo Faragò,ITA,DF,Cagliari,Serie A,24,1993,27.3,92,67,53,24,15,24,60,40.0,36,41,5,36,23,115,76,0,0,2017-2018,0.8424908424908425,3.36996336996337
787,Imad Faraj,MAR,"MF,DF",Lille,Ligue 1,18,1999,1.8,5,2,2,1,2,4,8,50.0,4,1,0,1,4,9,3,0,0,2017-2018,2.2222222222222223,2.7777777777777777
788,Davide Faraoni,ITA,"DF,MF",Crotone,Serie A,25,1991,19.5,62,39,36,20,6,28,47,59.6,19,30,8,22,58,120,76,0,0,2017-2018,2.9743589743589745,3.1794871794871793
789,Mohamed Fares,ALG,"DF,MF",Hellas Verona,Serie A,21,1996,28.9,50,33,29,17,4,16,42,38.1,26,24,5,19,50,100,132,2,0,2017-2018,1.7301038062283738,1.7301038062283738
790,Diego Farias,BRA,"FW,MF",Cagliari,Serie A,27,1990,17.9,21,15,3,9,9,6,24,25.0,18,17,0,17,8,29,6,0,0,2017-2018,0.446927374301676,1.1731843575418994
791,Federico Fazio,ARG,DF,Roma,Serie A,30,1987,32.5,56,43,38,18,0,25,31,80.6,6,30,22,8,46,102,161,3,0,2017-2018,1.4153846153846155,1.7230769230769232
792,Zouhair Feddal,MAR,DF,Betis,La Liga,28,1989,14.0,22,14,14,6,2,7,12,58.3,5,17,13,4,36,58,95,2,0,2017-2018,2.5714285714285716,1.5714285714285714
793,Nabil Fekir,FRA,"MF,FW",Lyon,Ligue 1,24,1993,27.5,45,33,11,24,10,8,40,20.0,32,11,0,11,8,53,5,0,0,2017-2018,0.2909090909090909,1.6363636363636365
794,Felipe,BRA,DF,Hannover 96,Bundesliga,30,1987,5.1,8,8,4,4,0,2,4,50.0,2,4,3,1,11,19,29,0,0,2017-2018,2.1568627450980395,1.5686274509803924
795,Luiz Felipe,ITA,DF,Lazio,Serie A,20,1997,13.0,40,28,24,16,0,15,25,60.0,10,26,14,12,18,58,50,1,0,2017-2018,1.3846153846153846,3.076923076923077
796,Ohis Felix Uduokhai,GER,DF,Wolfsburg,Bundesliga,19,1997,17.3,42,23,27,13,2,17,24,70.8,7,23,10,13,34,76,66,6,0,2017-2018,1.9653179190751444,2.4277456647398843
797,Marouane Fellaini,BEL,MF,Manchester Utd,Premier League,29,1987,7.6,15,8,6,8,1,2,11,18.2,9,12,3,9,14,29,19,1,0,2017-2018,1.842105263157895,1.973684210526316
798,Kiko Femenía,ESP,"DF,FW",Watford,Premier League,26,1991,19.0,36,28,22,11,3,14,27,51.9,13,15,2,13,34,70,31,1,0,2017-2018,1.7894736842105263,1.894736842105263
799,Leroy Fer,NED,MF,Swansea City,Premier League,27,1990,15.5,44,32,18,21,5,13,30,43.3,17,18,4,14,12,56,24,3,0,2017-2018,0.7741935483870968,2.838709677419355
800,Julien Féret,FRA,MF,Caen,Ligue 1,35,1982,34.0,40,27,10,25,5,14,75,18.7,61,52,7,45,49,89,58,2,0,2017-2018,1.4411764705882353,1.1764705882352942
801,Edimilson Fernandes,SUI,"MF,DF",West Ham,Premier League,21,1996,9.4,17,9,10,7,0,9,21,42.9,12,13,1,12,16,33,8,0,0,2017-2018,1.702127659574468,1.8085106382978722
802,Gelson Fernandes,SUI,MF,Eint Frankfurt,Bundesliga,30,1986,11.5,58,46,25,29,4,23,45,51.1,22,23,3,20,16,74,21,0,0,2017-2018,1.391304347826087,5.043478260869565
803,Andrés Fernández,ESP,GK,Villarreal,La Liga,30,1986,2.5,1,0,1,0,0,0,0,0.0,0,0,0,0,0,1,4,0,0,2017-2018,0.0,0.4
804,Augusto Fernández,ARG,MF,Atlético Madrid,La Liga,31,1986,1.2,3,2,1,2,0,1,3,33.3,2,3,2,1,2,5,3,0,0,2017-2018,1.6666666666666667,2.5
805,Brian Fernández,ARG,FW,Metz,Ligue 1,22,1994,1.4,0,0,0,0,0,0,1,0.0,1,2,0,2,0,0,0,0,0,2017-2018,0.0,0.0
806,Carlos Fernández,ESP,FW,Sevilla,La Liga,21,1996,1.5,2,1,1,1,0,0,2,0.0,2,1,0,1,0,2,0,0,0,2017-2018,0.0,1.3333333333333333
807,Federico Fernández,ARG,DF,Swansea City,Premier League,28,1989,29.7,40,29,30,6,4,20,30,66.7,10,35,27,8,38,78,201,1,0,2017-2018,1.2794612794612794,1.3468013468013469
808,Raúl Fernández,ESP,GK,Levante,La Liga,29,1988,11.0,0,0,0,0,0,0,0,0.0,0,1,0,1,0,0,10,1,0,2017-2018,0.0,0.0
809,Fernandinho,BRA,MF,Manchester City,Premier League,32,1985,32.0,62,35,22,28,12,24,65,36.9,41,38,6,32,47,109,68,2,0,2017-2018,1.46875,1.9375
810,Alex Ferrari,ITA,DF,Hellas Verona,Serie A,23,1994,23.7,73,54,42,23,8,36,67,53.7,31,41,15,26,47,120,117,4,0,2017-2018,1.9831223628691983,3.080168776371308
811,Jordan Ferri,FRA,MF,Lyon,Ligue 1,25,1992,7.1,20,11,8,11,1,7,20,35.0,13,11,1,10,5,25,11,2,0,2017-2018,0.7042253521126761,2.8169014084507045
812,Sam Field,ENG,MF,West Brom,Premier League,19,1998,6.0,14,11,8,4,2,3,10,30.0,7,6,1,5,11,25,8,0,0,2017-2018,1.8333333333333333,2.3333333333333335
813,Afonso Figueiredo,POR,"DF,FW",Rennes,Ligue 1,24,1993,2.5,6,3,3,3,0,3,5,60.0,2,0,0,0,0,6,4,0,0,2017-2018,0.0,2.4
814,Gian Filippo Felicioli,ITA,"MF,DF",Hellas Verona,Serie A,19,1997,3.1,13,8,5,5,3,0,4,0.0,4,0,0,0,5,18,6,0,0,2017-2018,1.6129032258064515,4.193548387096774
815,Alfreð Finnbogason,ISL,FW,Augsburg,Bundesliga,28,1989,20.2,18,13,7,5,6,8,15,53.3,7,15,1,14,14,32,7,0,0,2017-2018,0.6930693069306931,0.8910891089108911
816,Roberto Firmino,BRA,FW,Liverpool,Premier League,25,1991,30.7,65,50,9,36,20,8,58,13.8,50,40,2,38,18,83,10,0,0,2017-2018,0.5863192182410424,2.1172638436482085
817,Junior Firpo,DOM,DF,Betis,La Liga,20,1996,13.2,26,17,15,8,3,10,18,55.6,8,21,2,19,20,46,37,1,0,2017-2018,1.5151515151515151,1.9696969696969697
818,Viktor Fischer,DEN,"FW,MF",Mainz 05,Bundesliga,23,1994,3.7,4,4,2,1,1,2,5,40.0,3,2,0,2,3,7,2,0,0,2017-2018,0.8108108108108107,1.081081081081081
819,Mathieu Flamini,FRA,MF,Getafe,La Liga,33,1984,5.3,11,5,3,7,1,4,9,44.4,5,2,0,2,8,19,8,0,0,2017-2018,1.509433962264151,2.0754716981132075
820,Darren Fletcher,SCO,MF,Stoke City,Premier League,33,1984,24.7,47,26,23,20,4,15,55,27.3,40,13,3,10,26,73,33,3,0,2017-2018,1.0526315789473684,1.902834008097166
821,Sergio Floccari,ITA,FW,SPAL,Serie A,35,1981,9.8,13,9,7,5,1,6,11,54.5,5,6,1,5,2,15,6,0,0,2017-2018,0.2040816326530612,1.3265306122448979
822,Alessandro Florenzi,ITA,DF,Roma,Serie A,26,1991,26.5,38,28,20,13,5,18,47,38.3,29,19,8,11,44,82,62,1,0,2017-2018,1.6603773584905661,1.4339622641509433
823,Phil Foden,ENG,"MF,FW",Manchester City,Premier League,17,2000,0.5,1,1,0,1,0,0,1,0.0,1,0,0,0,0,1,1,0,0,2017-2018,0.0,2.0
824,Guessouma Fofana,MTN,MF,Amiens,Ligue 1,24,1992,8.3,20,13,8,12,0,6,13,46.2,7,7,1,6,12,32,11,0,0,2017-2018,1.4457831325301203,2.4096385542168672
825,Seko Fofana,CIV,MF,Udinese,Serie A,22,1995,20.8,20,17,8,12,0,4,20,20.0,16,17,3,14,27,47,26,1,0,2017-2018,1.2980769230769231,0.9615384615384615
826,Andreu Fontàs,ESP,DF,Celta Vigo,La Liga,27,1989,9.8,13,9,8,5,0,3,13,23.1,10,9,5,4,14,27,30,0,0,2017-2018,1.4285714285714284,1.3265306122448979
827,José Fonte,POR,DF,West Ham,Premier League,33,1983,7.6,11,6,5,6,0,2,6,33.3,4,12,9,3,14,25,37,1,0,2017-2018,1.842105263157895,1.4473684210526316
828,Pablo Fornals,ESP,"MF,FW",Villarreal,La Liga,21,1996,29.1,52,33,19,26,7,18,60,30.0,42,29,3,26,22,74,18,0,0,2017-2018,0.7560137457044673,1.7869415807560136
829,Emil Forsberg,SWE,MF,RB Leipzig,Bundesliga,25,1991,15.2,24,17,3,15,6,9,21,42.9,12,19,1,18,8,32,4,0,0,2017-2018,0.5263157894736842,1.5789473684210527
830,Fraser Forster,ENG,GK,Southampton,Premier League,29,1988,20.0,0,0,0,0,0,0,0,0.0,0,0,0,0,0,0,7,4,0,2017-2018,0.0,0.0
831,Steven Fortes,CPV,DF,Toulouse,Ligue 1,25,1992,1.7,4,2,3,1,0,1,3,33.3,2,0,0,0,3,7,6,0,0,2017-2018,1.7647058823529411,2.3529411764705883
832,Marco Fossati,ITA,MF,Hellas Verona,Serie A,24,1992,12.2,27,13,11,14,2,11,33,33.3,22,19,6,13,23,50,31,1,0,2017-2018,1.8852459016393444,2.2131147540983607
833,Iver Fossum,NOR,MF,Hannover 96,Bundesliga,21,1996,14.5,27,19,8,13,6,10,31,32.3,21,28,3,25,15,42,14,0,0,2017-2018,1.0344827586206897,1.8620689655172413
834,Ben Foster,ENG,GK,West Brom,Premier League,34,1983,37.0,1,0,1,0,0,0,7,0.0,7,0,0,0,1,2,12,1,0,2017-2018,0.02702702702702703,0.02702702702702703
835,Timothy Fosu-Mensah,NED,DF,Crystal Palace,Premier League,19,1998,17.7,42,33,33,8,1,21,34,61.8,13,17,9,8,31,73,74,1,0,2017-2018,1.7514124293785311,2.3728813559322033
836,Dimitri Foulquier,FRA,DF,Strasbourg,Ligue 1,24,1993,13.8,25,12,15,8,2,7,17,41.2,10,15,4,11,14,39,33,0,0,2017-2018,1.0144927536231882,1.8115942028985506
837,Lilian Fournier,FRA,FW,Metz,Ligue 1,19,1998,0.2,0,0,0,0,0,0,0,0.0,0,0,0,0,0,0,0,0,0,2017-2018,0.0,0.0
838,Raphael Framberger,GER,DF,Augsburg,Bundesliga,21,1995,7.7,22,18,14,6,2,15,16,93.8,1,12,3,9,14,36,15,0,0,2017-2018,1.8181818181818181,2.857142857142857
839,Simon Francis,ENG,DF,Bournemouth,Premier League,32,1985,30.1,49,34,26,16,7,24,43,55.8,19,29,18,11,49,98,194,4,0,2017-2018,1.627906976744186,1.627906976744186
840,Mike Frantz,GER,MF,Freiburg,Bundesliga,30,1986,11.6,23,16,9,11,3,6,16,37.5,10,13,3,10,13,36,15,0,0,2017-2018,1.120689655172414,1.9827586206896552
841,Ryan Fraser,SCO,"MF,DF",Bournemouth,Premier League,23,1994,22.3,11,8,7,2,2,7,20,35.0,13,20,4,16,17,28,34,0,0,2017-2018,0.7623318385650224,0.49327354260089684
842,Fabian Frei,SUI,MF,Mainz 05,Bundesliga,28,1989,8.9,22,15,7,12,3,8,15,53.3,7,10,0,10,16,38,17,1,0,2017-2018,1.797752808988764,2.4719101123595504
843,Remo Freuler,SUI,MF,Atalanta,Serie A,25,1992,33.4,89,62,35,41,13,27,82,32.9,55,46,13,33,28,117,37,2,0,2017-2018,0.8383233532934132,2.6646706586826348
844,Marco Friedl,AUT,"DF,MF",Werder Bremen,Bundesliga,19,1998,6.7,9,8,4,4,1,7,10,70.0,3,10,1,9,8,17,17,1,0,2017-2018,1.1940298507462686,1.3432835820895521
845,Marco Friedl,AUT,MF,Bayern Munich,Bundesliga,19,1998,0.5,0,0,0,0,0,0,0,0.0,0,1,0,1,1,1,0,0,0,2017-2018,2.0,0.0
846,Christian Fuchs,AUT,DF,Leicester City,Premier League,31,1986,21.3,41,27,25,12,4,14,40,35.0,26,23,3,20,58,99,86,0,0,2017-2018,2.7230046948356805,1.9248826291079812
847,Javi Fuego,ESP,MF,Villarreal,La Liga,33,1984,6.0,20,13,8,11,1,7,14,50.0,7,7,4,3,3,23,14,0,0,2017-2018,0.5,3.3333333333333335
848,Javi Fuego,ESP,MF,Espanyol,La Liga,33,1984,14.9,34,25,19,12,3,11,28,39.3,17,15,6,9,19,53,23,0,0,2017-2018,1.2751677852348993,2.2818791946308723
849,Chris Führich,GER,MF,Köln,Bundesliga,19,1998,1.1,4,3,1,2,1,2,5,40.0,3,3,0,3,0,4,1,0,0,2017-2018,0.0,3.6363636363636362
850,Angelo Fulgini,FRA,MF,Angers,Ligue 1,20,1996,17.0,21,11,9,8,4,8,27,29.6,19,21,2,19,20,41,7,0,0,2017-2018,1.1764705882352942,1.2352941176470589
851,Niclas Füllkrug,GER,FW,Hannover 96,Bundesliga,24,1993,26.5,16,11,4,8,4,10,20,50.0,10,22,3,19,8,24,30,0,0,2017-2018,0.3018867924528302,0.6037735849056604
852,Jay Fulton,SCO,MF,Swansea City,Premier League,23,1994,0.2,0,0,0,0,0,0,0,0.0,0,0,0,0,0,0,1,0,0,2017-2018,0.0,0.0
853,Ramiro Funes Mori,ARG,DF,Everton,Premier League,26,1991,1.3,0,0,0,0,0,0,0,0.0,0,1,1,0,3,3,14,0,0,2017-2018,2.3076923076923075,0.0
854,Manolo Gabbiadini,ITA,FW,Southampton,Premier League,25,1991,12.0,3,2,0,2,1,1,15,6.7,14,3,0,3,4,7,6,0,0,2017-2018,0.3333333333333333,0.25
855,Gabi,ESP,MF,Atlético Madrid,La Liga,34,1983,26.1,80,49,39,37,4,38,104,36.5,66,28,10,18,44,124,38,0,0,2017-2018,1.685823754789272,3.065134099616858
856,Gabriel,BRA,MF,Leganés,La Liga,23,1993,26.4,90,69,28,54,8,29,74,39.2,45,38,4,34,38,128,27,0,0,2017-2018,1.4393939393939394,3.409090909090909
857,Mijat Gaćinović,SRB,"MF,FW",Eint Frankfurt,Bundesliga,22,1995,20.2,56,44,21,27,8,20,52,38.5,32,38,1,37,39,95,22,1,0,2017-2018,1.9306930693069309,2.7722772277227725
858,Roberto Gagliardini,ITA,MF,Inter,Serie A,23,1994,22.1,63,45,28,29,6,20,54,37.0,34,18,3,15,45,108,32,2,0,2017-2018,2.0361990950226243,2.850678733031674
859,Nicolás Gaitán,ARG,"MF,FW",Atlético Madrid,La Liga,29,1988,2.4,9,6,3,5,1,3,9,33.3,6,2,0,2,1,10,3,0,0,2017-2018,0.4166666666666667,3.75
860,Milan Gajić,SRB,DF,Bordeaux,Ligue 1,21,1996,4.0,6,3,4,2,0,2,4,50.0,2,7,0,7,4,10,14,0,0,2017-2018,1.0,1.5
861,Serge Gakpé,TOG,"FW,MF",Amiens,Ligue 1,30,1987,20.3,16,11,9,7,0,6,27,22.2,21,18,1,17,10,26,15,0,0,2017-2018,0.49261083743842365,0.7881773399014778
862,Andrey Galabinov,BUL,FW,Genoa,Serie A,28,1988,12.5,7,5,0,5,2,0,5,0.0,5,17,1,16,2,9,11,0,0,2017-2018,0.16,0.56
863,Álex Gálvez,ESP,DF,Las Palmas,La Liga,28,1989,18.0,50,36,26,24,0,22,41,53.7,19,20,11,9,43,93,74,2,0,2017-2018,2.388888888888889,2.7777777777777777
864,Álex Gálvez,ESP,DF,Eibar,La Liga,28,1989,4.0,11,4,5,6,0,7,12,58.3,5,5,1,4,13,24,17,0,0,2017-2018,3.25,2.75
865,Bruno Gama,POR,"FW,MF",La Coruña,La Liga,29,1987,1.3,1,1,1,0,0,1,3,33.3,2,0,0,0,0,1,2,0,0,2017-2018,0.0,0.7692307692307692
866,Alessandro Gamberini,ITA,DF,Chievo,Serie A,35,1981,20.2,13,8,11,2,0,8,12,66.7,4,32,25,7,16,29,117,1,0,2017-2018,0.7920792079207921,0.6435643564356436
867,Kévin Gameiro,FRA,FW,Atlético Madrid,La Liga,30,1987,12.5,11,9,3,4,4,1,10,10.0,9,6,0,6,4,15,11,0,0,2017-2018,0.32,0.88
868,Jesús Gámez,ESP,DF,Newcastle Utd,Premier League,32,1985,1.1,4,2,1,0,3,1,3,33.3,2,2,0,2,2,6,5,0,0,2017-2018,1.8181818181818181,3.6363636363636362
869,Idrissa Gana Gueye,SEN,MF,Everton,Premier League,27,1989,30.6,117,93,65,41,11,35,86,40.7,51,59,9,50,62,179,48,1,0,2017-2018,2.026143790849673,3.8235294117647056
870,Ignatius Ganago,CMR,"FW,MF",Nice,Ligue 1,18,1999,0.8,0,0,0,0,0,0,2,0.0,2,1,0,1,0,0,1,0,0,2017-2018,0.0,0.0
871,Najib Gandi,FRA,"FW,MF",Nantes,Ligue 1,23,1994,1.1,6,5,3,2,1,4,6,66.7,2,4,1,3,4,10,3,0,0,2017-2018,3.6363636363636362,5.454545454545454
872,Ganso,BRA,MF,Sevilla,La Liga,27,1989,5.8,15,11,3,12,0,3,11,27.3,8,7,0,7,2,17,4,0,0,2017-2018,0.3448275862068966,2.586206896551724
873,Ezequiel Garay,ARG,DF,Valencia,La Liga,30,1986,22.5,18,12,15,3,0,10,14,71.4,4,22,11,11,24,42,139,0,0,2017-2018,1.0666666666666667,0.8
874,Aleix García,ESP,MF,Girona,La Liga,20,1997,9.5,24,14,13,9,2,12,22,54.5,10,9,1,8,17,41,12,0,0,2017-2018,1.7894736842105263,2.526315789473684
875,Borja García,ESP,MF,Girona,La Liga,26,1990,31.1,39,18,15,18,6,13,39,33.3,26,31,2,29,30,69,15,0,0,2017-2018,0.9646302250803858,1.2540192926045015
876,Dani García,ESP,MF,Eibar,La Liga,27,1990,30.8,80,59,23,47,10,31,80,38.8,49,28,4,24,70,150,25,0,0,2017-2018,2.2727272727272725,2.5974025974025974
877,David García,ESP,DF,Las Palmas,La Liga,35,1982,9.6,16,10,10,4,2,8,12,66.7,4,15,8,7,19,35,33,1,0,2017-2018,1.9791666666666667,1.6666666666666667
878,Javi García,ESP,"MF,DF",Betis,La Liga,30,1987,26.8,34,22,18,16,0,13,40,32.5,27,19,12,7,25,59,78,1,0,2017-2018,0.9328358208955224,1.2686567164179103
879,Manu García,ESP,MF,Alavés,La Liga,31,1986,27.1,95,65,38,51,6,24,89,27.0,65,34,11,23,35,130,67,0,0,2017-2018,1.2915129151291511,3.5055350553505535
880,Raúl García,ESP,"MF,FW",Athletic Club,La Liga,31,1986,29.2,82,51,28,36,18,26,71,36.6,45,55,3,52,30,112,23,0,0,2017-2018,1.0273972602739727,2.808219178082192
881,Raúl García,ESP,DF,Leganés,La Liga,28,1989,15.5,34,25,24,9,1,18,30,60.0,12,18,3,15,19,53,50,1,0,2017-2018,1.2258064516129032,2.193548387096774
882,Samu García,ESP,MF,Málaga,La Liga,27,1990,2.0,8,6,4,3,1,3,10,30.0,7,4,0,4,6,14,3,0,0,2017-2018,3.0,4.0
883,Samu García,ESP,"FW,MF",Levante,La Liga,27,1990,2.1,9,7,1,6,2,2,5,40.0,3,3,0,3,1,10,2,0,0,2017-2018,0.47619047619047616,4.285714285714286
884,Sergio García,ESP,"FW,MF",Espanyol,La Liga,34,1983,18.2,15,12,1,10,4,3,22,13.6,19,6,3,3,10,25,12,0,0,2017-2018,0.5494505494505495,0.8241758241758242
885,Ulisses Garcia,SUI,FW,Werder Bremen,Bundesliga,21,1996,1.0,1,1,1,0,0,1,2,50.0,1,0,0,0,0,1,3,0,0,2017-2018,0.0,1.0
886,Luca Garritano,ITA,"MF,FW",Chievo,Serie A,23,1994,2.1,4,3,2,1,1,0,4,0.0,4,3,1,2,1,5,6,0,0,2017-2018,0.47619047619047616,1.9047619047619047
887,Bruno Gaspar,ANG,DF,Fiorentina,Serie A,24,1993,8.7,20,11,13,6,1,9,15,60.0,6,8,1,7,9,29,25,0,0,2017-2018,1.0344827586206897,2.298850574712644
888,Mario Gaspar,ESP,DF,Villarreal,La Liga,26,1990,31.2,110,66,63,37,10,58,87,66.7,29,58,11,47,58,168,114,0,0,2017-2018,1.858974358974359,3.5256410256410255
889,Gianluca Gaudino,GER,MF,Chievo,Serie A,20,1996,0.2,0,0,0,0,0,0,0,0.0,0,1,0,1,0,0,1,0,0,2017-2018,0.0,0.0
890,Dwight Gayle,ENG,FW,Newcastle Utd,Premier League,26,1990,21.8,12,10,2,8,2,1,21,4.8,20,16,2,14,6,18,17,0,0,2017-2018,0.27522935779816515,0.5504587155963303
891,Paulo Gazzaniga,ARG,GK,Tottenham,Premier League,25,1992,1.0,0,0,0,0,0,0,1,0.0,1,0,0,0,0,0,0,0,0,2017-2018,0.0,0.0
892,Marcello Gazzola,ITA,DF,Sassuolo,Serie A,32,1985,8.2,10,9,3,6,1,8,12,66.7,4,10,2,8,8,18,25,0,0,2017-2018,0.9756097560975611,1.2195121951219514
893,Jean-Philippe Gbamin,CIV,"MF,DF",Mainz 05,Bundesliga,21,1995,28.8,78,63,48,26,4,43,65,66.2,22,50,10,40,50,128,80,0,0,2017-2018,1.7361111111111112,2.7083333333333335
894,David de Gea,ESP,GK,Manchester Utd,Premier League,26,1990,37.0,0,0,0,0,0,0,1,0.0,1,1,0,1,0,0,9,3,0,2017-2018,0.0,0.0
895,Theodor Gebre Selassie,CZE,"DF,FW",Werder Bremen,Bundesliga,30,1986,31.4,67,41,36,25,6,36,57,63.2,21,34,2,32,51,118,83,1,0,2017-2018,1.624203821656051,2.1337579617834397
896,Dennis Geiger,GER,MF,Hoffenheim,Bundesliga,19,1998,17.6,52,36,19,31,2,16,40,40.0,24,38,2,36,15,67,7,0,0,2017-2018,0.8522727272727272,2.954545454545454
897,Johannes Geis,GER,"DF,MF",Sevilla,La Liga,23,1993,7.5,20,15,12,7,1,11,21,52.4,10,13,5,8,10,30,27,1,0,2017-2018,1.3333333333333333,2.6666666666666665
898,Jérémy Gélin,FRA,"DF,MF",Rennes,Ligue 1,20,1997,25.7,37,18,22,14,1,20,53,37.7,33,22,12,10,37,74,92,3,0,2017-2018,1.4396887159533074,1.4396887159533074
899,Romain Genevois,HAI,DF,Caen,Ligue 1,29,1987,20.1,48,28,27,13,8,21,39,53.8,18,25,11,14,31,79,76,0,0,2017-2018,1.5422885572139302,2.388059701492537
900,Santiago Gentiletti,ARG,DF,Genoa,Serie A,32,1985,3.2,4,3,4,0,0,1,6,16.7,5,1,0,1,3,7,11,1,0,2017-2018,0.9375,1.25
901,Christian Gentner,GER,MF,Stuttgart,Bundesliga,31,1985,26.8,91,67,35,44,12,44,84,52.4,40,41,5,36,35,126,52,0,0,2017-2018,1.3059701492537312,3.3955223880597014
902,Yannick Gerhardt,GER,"DF,MF",Wolfsburg,Bundesliga,23,1994,13.6,37,28,18,14,5,22,34,64.7,12,25,5,20,15,52,31,0,0,2017-2018,1.1029411764705883,2.7205882352941178
903,Valère Germain,FRA,FW,Marseille,Ligue 1,27,1990,24.1,16,11,5,7,4,3,18,16.7,15,11,0,11,6,22,19,0,0,2017-2018,0.24896265560165973,0.6639004149377593
904,Gerson,BRA,"MF,FW",Roma,Serie A,20,1997,10.1,20,12,10,8,2,2,7,28.6,5,15,2,13,11,31,11,1,0,2017-2018,1.0891089108910892,1.9801980198019802
905,Willem Geubbels,FRA,"FW,MF",Lyon,Ligue 1,15,2001,0.4,2,2,1,1,0,0,1,0.0,1,0,0,0,0,2,0,0,0,2017-2018,0.0,5.0
906,Yassine El Ghanassy,BEL,"MF,FW",Nantes,Ligue 1,27,1990,7.2,7,4,1,3,3,1,4,25.0,3,1,0,1,4,11,4,0,0,2017-2018,0.5555555555555556,0.9722222222222222
907,Anwar El Ghazi,NED,"FW,MF",Lille,Ligue 1,22,1995,18.3,23,18,7,13,3,9,29,31.0,20,11,1,10,7,30,7,1,0,2017-2018,0.3825136612021858,1.256830601092896
908,Rachid Ghezzal,ALG,"FW,MF",Monaco,Ligue 1,25,1992,11.2,31,24,6,22,3,7,34,20.6,27,17,0,17,11,42,2,1,0,2017-2018,0.9821428571428572,2.7678571428571432
909,Faouzi Ghoulam,ALG,DF,Napoli,Serie A,26,1991,10.9,8,4,3,5,0,4,6,66.7,2,10,2,8,15,23,19,0,0,2017-2018,1.3761467889908257,0.7339449541284403
910,Emanuele Giaccherini,ITA,"MF,FW",Chievo,Serie A,32,1985,10.0,7,4,4,2,1,5,25,20.0,20,9,3,6,5,12,6,0,0,2017-2018,0.5,0.7
911,Emanuele Giaccherini,ITA,"FW,MF",Napoli,Serie A,32,1985,0.7,1,1,0,1,0,0,0,0.0,0,0,0,0,0,1,0,0,0,2017-2018,0.0,1.4285714285714286
912,Niccolò Giannetti,ITA,"FW,DF",Cagliari,Serie A,26,1991,3.3,5,4,2,3,0,2,6,33.3,4,1,0,1,1,6,3,0,0,2017-2018,0.30303030303030304,1.5151515151515151
913,Kieran Gibbs,ENG,DF,West Brom,Premier League,27,1989,31.4,41,24,27,10,4,16,30,53.3,14,32,12,20,48,89,102,0,0,2017-2018,1.5286624203821657,1.3057324840764333
914,Rafał Gikiewicz,POL,GK,Freiburg,Bundesliga,29,1987,1.7,0,0,0,0,0,0,0,0.0,0,0,0,0,0,0,0,0,0,2017-2018,0.0,0.0
915,Carles Gil,ESP,"FW,MF",La Coruña,La Liga,24,1992,5.3,6,4,1,4,1,1,5,20.0,4,5,0,5,4,10,0,0,0,2017-2018,0.7547169811320755,1.1320754716981132
916,Nacho Gil,ESP,"FW,MF",Las Palmas,La Liga,21,1995,8.1,10,6,6,2,2,5,21,23.8,16,9,0,9,6,16,2,0,0,2017-2018,0.7407407407407408,1.234567901234568
917,Nacho Gil,ESP,MF,Valencia,La Liga,21,1995,2.5,6,1,2,4,0,1,8,12.5,7,6,0,6,2,8,2,0,0,2017-2018,0.8,2.4
918,Guillaume Gillet,BEL,MF,Nantes,Ligue 1,33,1984,0.2,0,0,0,0,0,0,0,0.0,0,1,1,0,0,0,0,0,0,2017-2018,0.0,0.0
919,Dani Giménez,ESP,GK,Betis,La Liga,34,1983,3.4,0,0,0,0,0,0,0,0.0,0,0,0,0,0,0,0,0,0,2017-2018,0.0,0.0
920,Daniel Ginczek,GER,FW,Stuttgart,Bundesliga,26,1991,16.9,8,4,3,5,0,2,12,16.7,10,16,1,15,5,13,13,0,0,2017-2018,0.2958579881656805,0.4733727810650888
921,Matthias Ginter,GER,DF,Gladbach,Bundesliga,23,1994,34.0,48,37,27,20,1,35,45,77.8,10,40,17,23,40,88,114,1,0,2017-2018,1.1764705882352942,1.411764705882353
922,Jimmy Giraudon,FRA,DF,Troyes,Ligue 1,25,1992,23.2,26,16,20,6,0,10,16,62.5,6,30,22,8,31,57,128,2,0,2017-2018,1.3362068965517242,1.120689655172414
923,Thibault Giresse,FRA,"FW,MF",Guingamp,Ligue 1,36,1981,0.3,0,0,0,0,0,0,0,0.0,0,0,0,0,1,1,0,0,0,2017-2018,3.3333333333333335,0.0
924,Andrei Girotto,BRA,MF,Nantes,Ligue 1,25,1992,16.9,57,38,15,37,5,21,52,40.4,31,32,7,25,15,72,45,1,0,2017-2018,0.8875739644970415,3.3727810650887577
925,Olivier Giroud,FRA,FW,Arsenal,Premier League,30,1986,4.3,5,4,1,2,2,1,5,20.0,4,1,0,1,1,6,4,0,0,2017-2018,0.23255813953488372,1.1627906976744187
926,Olivier Giroud,FRA,FW,Chelsea,Premier League,30,1986,6.8,4,3,1,2,1,1,3,33.3,2,0,0,0,1,5,5,0,0,2017-2018,0.14705882352941177,0.5882352941176471
927,Kamil Glik,POL,DF,Monaco,Ligue 1,29,1988,36.0,36,23,22,12,2,15,29,51.7,14,28,18,10,54,90,279,2,0,2017-2018,1.5,1.0
928,Serge Gnabry,GER,FW,Hoffenheim,Bundesliga,22,1995,16.7,32,22,10,18,4,13,24,54.2,11,15,1,14,8,40,9,2,0,2017-2018,0.47904191616766467,1.9161676646706587
929,Joris Gnagnon,FRA,DF,Rennes,Ligue 1,20,1997,32.4,42,29,29,9,4,21,31,67.7,10,22,16,6,29,71,154,2,0,2017-2018,0.8950617283950618,1.2962962962962963
930,Massimo Gobbi,ITA,DF,Chievo,Serie A,36,1980,22.8,24,18,13,9,2,11,26,42.3,15,20,5,15,22,46,90,1,0,2017-2018,0.9649122807017544,1.0526315789473684
931,Diego Godín,URU,DF,Atlético Madrid,La Liga,31,1986,28.4,50,33,37,11,2,26,47,55.3,21,33,20,13,59,109,145,1,0,2017-2018,2.0774647887323945,1.7605633802816902
932,Edoardo Goldaniga,ITA,DF,Sassuolo,Serie A,23,1993,12.8,14,8,10,4,0,5,9,55.6,4,10,5,5,19,33,56,0,0,2017-2018,1.484375,1.09375
933,Connor Goldson,ENG,DF,Brighton,Premier League,24,1992,2.2,2,2,1,1,0,1,4,25.0,3,3,3,0,1,3,9,0,0,2017-2018,0.45454545454545453,0.9090909090909091
934,Pierluigi Gollini,ITA,GK,Atalanta,Serie A,22,1995,6.9,0,0,0,0,0,0,0,0.0,0,0,0,0,0,0,1,0,0,2017-2018,0.0,0.0
935,André Gomes,POR,MF,Barcelona,La Liga,24,1993,7.1,19,12,8,10,1,5,13,38.5,8,7,1,6,4,23,6,0,0,2017-2018,0.5633802816901409,2.676056338028169
936,Heurelho Gomes,BRA,GK,Watford,Premier League,36,1981,23.6,0,0,0,0,0,0,1,0.0,1,1,0,1,2,2,15,3,0,2017-2018,0.0847457627118644,0.0
937,Ibai Gómez,ESP,"MF,FW",Alavés,La Liga,27,1989,25.8,19,15,11,4,4,6,30,20.0,24,16,1,15,15,34,20,1,0,2017-2018,0.5813953488372093,0.7364341085271318
938,Joe Gomez,ENG,DF,Liverpool,Premier League,20,1997,21.1,58,45,32,23,3,21,40,52.5,19,19,8,11,34,92,57,1,0,2017-2018,1.6113744075829384,2.748815165876777
939,Mario Gómez,GER,FW,Wolfsburg,Bundesliga,32,1985,10.4,6,6,2,3,1,2,6,33.3,4,10,1,9,0,6,16,0,0,2017-2018,0.0,0.5769230769230769
940,Mario Gómez,GER,FW,Stuttgart,Bundesliga,32,1985,15.4,13,11,0,8,5,2,10,20.0,8,6,0,6,4,17,17,0,0,2017-2018,0.2597402597402597,0.8441558441558441
941,Maxi Gómez,URU,FW,Celta Vigo,La Liga,20,1996,34.1,7,4,1,4,2,0,18,0.0,18,9,4,5,3,10,34,0,0,2017-2018,0.0879765395894428,0.20527859237536655
942,Papu Gómez,ARG,"MF,FW",Atalanta,Serie A,29,1988,30.6,14,9,6,5,3,5,26,19.2,21,16,1,15,22,36,7,0,0,2017-2018,0.7189542483660131,0.45751633986928103
943,Sergi Gómez,ESP,DF,Celta Vigo,La Liga,25,1992,29.8,52,37,38,13,1,20,34,58.8,14,32,22,10,56,108,118,1,0,2017-2018,1.8791946308724832,1.74496644295302
944,Sergio Gómez,ESP,MF,Dortmund,Bundesliga,16,2000,0.1,0,0,0,0,0,0,0,0.0,0,0,0,0,0,0,0,0,0,2017-2018,0.0,0.0
945,Vicente Gómez,ESP,MF,Las Palmas,La Liga,28,1988,16.9,21,13,6,11,4,10,29,34.5,19,18,4,14,17,38,14,1,0,2017-2018,1.0059171597633136,1.2426035502958581
946,Alfred Gomis,SEN,GK,SPAL,Serie A,23,1993,25.1,0,0,0,0,0,0,1,0.0,1,0,0,0,1,1,10,3,0,2017-2018,0.0398406374501992,0.0
947,Maxime Gonalons,FRA,MF,Roma,Serie A,28,1989,12.2,26,18,7,12,7,9,23,39.1,14,15,4,11,23,49,19,1,0,2017-2018,1.8852459016393444,2.1311475409836067
948,Anthony Gonçalves,FRA,"MF,FW",Strasbourg,Ligue 1,31,1986,19.5,50,31,14,32,4,15,50,30.0,35,27,0,27,25,75,27,0,0,2017-2018,1.2820512820512822,2.5641025641025643
949,Vagner Gonçalves,CPV,FW,Saint-Étienne,Ligue 1,21,1996,1.2,0,0,0,0,0,0,3,0.0,3,2,0,2,0,0,0,0,0,2017-2018,0.0,0.0
950,Jérôme Gondorf,GER,"MF,FW",Werder Bremen,Bundesliga,29,1988,8.9,12,9,3,9,0,4,18,22.2,14,11,2,9,6,18,12,0,0,2017-2018,0.6741573033707865,1.348314606741573
951,Adrián González,ESP,"MF,FW",Málaga,La Liga,29,1988,26.0,40,25,14,22,4,12,50,24.0,38,25,8,17,38,78,34,0,0,2017-2018,1.4615384615384615,1.5384615384615385
952,Álvaro González,ESP,DF,Villarreal,La Liga,27,1990,32.2,38,26,30,7,1,22,41,53.7,19,34,23,11,53,91,188,0,0,2017-2018,1.6459627329192545,1.1801242236024843
953,Bruno González,ESP,DF,Getafe,La Liga,27,1990,17.1,25,18,18,7,0,13,26,50.0,13,11,3,8,31,56,107,0,0,2017-2018,1.8128654970760232,1.461988304093567
954,Diego González,ESP,DF,Málaga,La Liga,22,1995,15.9,27,19,20,7,0,18,26,69.2,8,25,10,15,19,46,69,0,0,2017-2018,1.1949685534591195,1.6981132075471699
955,Fabio González,ESP,MF,Las Palmas,La Liga,20,1997,0.7,2,1,2,0,0,1,4,25.0,3,1,0,1,1,3,1,0,0,2017-2018,1.4285714285714286,2.857142857142857
956,Giancarlo González,CRC,DF,Bologna,Serie A,29,1988,20.6,20,15,14,5,1,9,13,69.2,4,26,18,8,33,53,152,1,0,2017-2018,1.6019417475728155,0.9708737864077669
957,Mario González,ESP,FW,Villarreal,La Liga,21,1996,0.2,0,0,0,0,0,0,0,0.0,0,1,0,1,0,0,0,0,0,2017-2018,0.0,0.0
958,Georges Gope-Fenepej,NCL,FW,Amiens,Ligue 1,28,1988,0.5,0,0,0,0,0,0,0,0.0,0,0,0,0,0,0,0,0,0,2017-2018,0.0,0.0
959,Leon Goretzka,GER,MF,Schalke 04,Bundesliga,22,1995,22.0,50,34,22,22,6,14,50,28.0,36,45,4,41,41,91,35,0,0,2017-2018,1.8636363636363635,2.272727272727273
960,Mathieu Gorgelin,FRA,GK,Lyon,Ligue 1,26,1990,4.0,0,0,0,0,0,0,0,0.0,0,0,0,0,0,0,0,1,0,2017-2018,0.0,0.0
961,Andoni Gorosabel,ESP,DF,Real Sociedad,La Liga,20,1996,0.8,3,2,1,2,0,2,5,40.0,3,1,0,1,4,7,1,0,0,2017-2018,5.0,3.75
962,Robin Gosens,GER,DF,Atalanta,Serie A,23,1994,16.1,61,46,35,22,4,27,46,58.7,19,17,2,15,22,83,40,0,0,2017-2018,1.3664596273291925,3.7888198757763973
963,Dan Gosling,ENG,MF,Bournemouth,Premier League,27,1990,21.6,50,25,19,26,5,19,68,27.9,49,36,8,28,25,75,35,0,0,2017-2018,1.1574074074074074,2.314814814814815
964,Mario Götze,GER,MF,Dortmund,Bundesliga,25,1992,17.8,50,43,19,24,7,14,34,41.2,20,17,1,16,8,58,9,0,0,2017-2018,0.449438202247191,2.8089887640449436
965,Mohamed Gouaida,TUN,MF,Hamburger SV,Bundesliga,24,1993,0.6,3,3,1,1,1,0,0,0.0,0,0,0,0,0,3,3,0,0,2017-2018,0.0,5.0
966,Prince-Désir Gouano,FRA,DF,Amiens,Ligue 1,23,1993,30.5,42,29,32,8,2,22,31,71.0,9,58,47,11,49,91,191,6,0,2017-2018,1.6065573770491803,1.3770491803278688
967,Lemouya Goudiaby,SEN,DF,Metz,Ligue 1,20,1997,0.9,2,1,0,2,0,1,3,33.3,2,2,1,1,0,2,3,0,0,2017-2018,0.0,2.2222222222222223
968,Amine Gouiri,ALG,"FW,MF",Lyon,Ligue 1,17,2000,0.9,1,1,1,0,0,0,1,0.0,1,0,0,0,2,3,0,0,0,2017-2018,2.2222222222222223,1.1111111111111112
969,Yoann Gourcuff,FRA,"MF,FW",Rennes,Ligue 1,31,1986,4.7,7,5,1,3,3,0,2,0.0,2,5,0,5,2,9,2,0,0,2017-2018,0.425531914893617,1.4893617021276595
970,Jeffrey Gouweleeuw,NED,DF,Augsburg,Bundesliga,26,1991,26.5,57,44,36,18,3,27,41,65.9,14,36,10,26,54,111,128,0,0,2017-2018,2.0377358490566038,2.150943396226415
971,Julio Gracia,ESP,"DF,FW",Betis,La Liga,19,1998,0.3,0,0,0,0,0,0,0,0.0,0,0,0,0,1,1,0,0,0,2017-2018,3.3333333333333335,0.0
972,Max Gradel,CIV,"FW,MF",Toulouse,Ligue 1,29,1987,26.8,63,36,28,21,14,24,72,33.3,48,39,2,37,14,77,30,0,0,2017-2018,0.5223880597014925,2.3507462686567164
973,Samuel Grandsir,FRA,"FW,MF",Troyes,Ligue 1,20,1996,28.9,69,43,39,18,12,21,73,28.8,52,31,3,28,23,92,19,1,0,2017-2018,0.795847750865052,2.387543252595156
974,Álex Granell,ESP,MF,Girona,La Liga,28,1988,31.6,78,53,31,39,8,38,114,33.3,76,46,3,43,47,125,29,0,0,2017-2018,1.4873417721518987,2.4683544303797467
975,Esteban Granero,ESP,MF,Espanyol,La Liga,30,1987,13.7,32,22,15,13,4,9,27,33.3,18,19,0,19,19,51,21,0,0,2017-2018,1.3868613138686132,2.3357664233576645
976,Lee Grant,ENG,GK,Stoke City,Premier League,34,1983,3.0,1,1,1,0,0,1,1,100.0,0,0,0,0,0,1,0,0,0,2017-2018,0.0,0.3333333333333333
977,Alberto Grassi,ITA,MF,SPAL,Serie A,22,1995,25.0,44,33,22,12,10,16,35,45.7,19,27,8,19,47,91,55,0,0,2017-2018,1.88,1.76
978,Andrew Gravillon,GLP,DF,Benevento,Serie A,19,1998,0.9,2,1,2,0,0,0,1,0.0,1,1,1,0,3,5,10,0,0,2017-2018,3.333333333333333,2.2222222222222223
979,Andre Gray,JAM,FW,Watford,Premier League,26,1991,16.6,2,1,0,1,1,0,3,0.0,3,11,0,11,4,6,3,0,0,2017-2018,0.24096385542168672,0.12048192771084336
980,Demarai Gray,JAM,"MF,FW",Leicester City,Premier League,21,1996,18.9,17,15,6,9,2,4,23,17.4,19,27,0,27,11,28,14,1,0,2017-2018,0.5820105820105821,0.8994708994708995
981,Michael Gregoritsch,AUT,"MF,FW",Augsburg,Bundesliga,23,1994,28.1,35,27,13,15,7,11,26,42.3,15,27,1,26,10,45,56,0,0,2017-2018,0.3558718861209964,1.2455516014234875
982,Clément Grenier,FRA,MF,Guingamp,Ligue 1,26,1991,13.4,23,14,3,13,7,12,42,28.6,30,16,1,15,14,37,15,1,0,2017-2018,1.044776119402985,1.716417910447761
983,Clément Grenier,FRA,FW,Lyon,Ligue 1,26,1991,0.1,1,1,1,0,0,0,0,0.0,0,0,0,0,0,1,0,0,0,2017-2018,0.0,10.0
984,Anto Grgić,SUI,MF,Stuttgart,Bundesliga,20,1996,0.1,0,0,0,0,0,0,0,0.0,0,0,0,0,0,0,0,0,0,2017-2018,0.0,0.0
985,Antoine Griezmann,FRA,"FW,MF",Atlético Madrid,La Liga,26,1991,28.0,36,24,6,23,7,10,30,33.3,20,20,1,19,10,46,14,0,0,2017-2018,0.35714285714285715,1.2857142857142858
986,Vincenzo Grifo,ITA,"MF,FW",Gladbach,Bundesliga,24,1993,8.7,8,5,3,3,2,4,8,50.0,4,8,1,7,5,13,6,0,0,2017-2018,0.574712643678161,0.9195402298850576
987,Florian Grillitsch,AUT,MF,Hoffenheim,Bundesliga,21,1995,21.0,68,46,30,36,2,35,58,60.3,23,26,3,23,39,107,25,1,0,2017-2018,1.8571428571428572,3.238095238095238
988,Jérémy Grimm,FRA,MF,Strasbourg,Ligue 1,30,1987,9.0,23,17,15,6,2,9,24,37.5,15,11,3,8,19,42,31,1,0,2017-2018,2.111111111111111,2.5555555555555554
989,Pascal Groß,GER,"FW,MF",Brighton,Premier League,26,1991,32.5,36,24,18,16,2,10,67,14.9,57,31,5,26,14,50,20,0,0,2017-2018,0.4307692307692308,1.1076923076923078
990,Marko Grujić,SRB,"MF,DF",Liverpool,Premier League,21,1996,0.2,2,2,0,1,1,2,2,100.0,0,0,0,0,0,2,0,0,0,2017-2018,0.0,10.0
991,Vicente Guaita,ESP,GK,Getafe,La Liga,30,1987,33.0,0,0,0,0,0,0,0,0.0,0,0,0,0,3,3,12,1,0,2017-2018,0.09090909090909091,0.0
992,Andrés Guardado,MEX,MF,Betis,La Liga,30,1986,25.2,41,27,17,18,6,15,55,27.3,40,27,5,22,22,63,29,1,0,2017-2018,0.873015873015873,1.626984126984127
993,Karim Guédé,SVK,FW,Freiburg,Bundesliga,32,1985,0.7,2,2,2,0,0,2,2,100.0,0,1,1,0,1,3,0,0,0,2017-2018,1.4285714285714286,2.857142857142857
994,Gonçalo Guedes,POR,MF,Valencia,La Liga,20,1996,27.1,38,26,18,15,5,16,51,31.4,35,22,0,22,16,54,10,0,0,2017-2018,0.5904059040590406,1.4022140221402213
995,Gonçalo Guedes,POR,FW,Paris S-G,Ligue 1,20,1996,0.1,0,0,0,0,0,0,0,0.0,0,0,0,0,0,0,0,0,0,2017-2018,0.0,0.0
996,Ramiro Guerra,URU,MF,Villarreal,La Liga,20,1997,0.8,3,2,1,0,2,2,3,66.7,1,0,0,0,0,3,2,0,0,2017-2018,0.0,3.75
997,Raphaël Guerreiro,POR,"DF,MF",Dortmund,Bundesliga,23,1993,6.1,10,8,5,4,1,2,5,40.0,3,3,0,3,11,21,8,0,0,2017-2018,1.8032786885245902,1.639344262295082
998,Francis Guerrero,ESP,"DF,MF",Betis,La Liga,21,1996,11.0,31,19,22,7,2,16,34,47.1,18,16,4,12,21,52,26,0,0,2017-2018,1.9090909090909092,2.8181818181818183
999,John Guidetti,SWE,FW,Alavés,La Liga,25,1992,13.6,7,7,3,1,3,2,10,20.0,8,10,1,9,2,9,7,0,0,2017-2018,0.14705882352941177,0.5147058823529412
1000,John Guidetti,SWE,"FW,MF",Celta Vigo,La Liga,25,1992,1.3,0,0,0,0,0,0,0,0.0,0,0,0,0,0,0,0,0,0,2017-2018,0.0,0.0
1001,Josuha Guilavogui,FRA,MF,Wolfsburg,Bundesliga,26,1990,26.7,65,46,43,20,2,30,50,60.0,20,34,10,24,66,131,63,0,0,2017-2018,2.471910112359551,2.4344569288389515
1002,Frederic Guilbert,FRA,DF,Caen,Ligue 1,22,1994,36.0,136,89,71,58,7,50,105,47.6,55,43,13,30,88,224,136,0,0,2017-2018,2.4444444444444446,3.7777777777777777
1003,Guilherme,BRA,"MF,FW",Benevento,Serie A,26,1991,10.5,20,11,7,7,6,3,19,15.8,16,14,1,13,8,28,4,0,0,2017-2018,0.7619047619047619,1.9047619047619047
1004,Guilherme,BRA,MF,La Coruña,La Liga,26,1991,29.3,79,56,35,37,7,28,77,36.4,49,36,9,27,46,125,62,0,0,2017-2018,1.5699658703071673,2.696245733788396
1005,Baptiste Guillaume,BEL,"FW,MF",Angers,Ligue 1,22,1995,5.1,4,1,0,2,2,0,5,0.0,5,4,1,3,2,6,1,0,0,2017-2018,0.3921568627450981,0.7843137254901962
1006,Serhou Guirassy,GUI,FW,Köln,Bundesliga,21,1996,9.5,3,3,0,2,1,1,5,20.0,4,9,1,8,1,4,11,0,0,2017-2018,0.10526315789473684,0.3157894736842105
1007,Péter Gulácsi,HUN,GK,RB Leipzig,Bundesliga,27,1990,33.0,0,0,0,0,0,0,2,0.0,2,0,0,0,0,0,12,4,0,2017-2018,0.0,0.0
1008,Manuel Gulde,GER,DF,Freiburg,Bundesliga,26,1991,17.0,16,10,14,2,0,10,19,52.6,9,24,17,7,14,30,71,0,0,2017-2018,0.8235294117647058,0.9411764705882353
1009,Gerard Gumbau,ESP,MF,Leganés,La Liga,22,1994,15.9,35,26,13,21,1,12,37,32.4,25,12,4,8,14,49,27,0,0,2017-2018,0.8805031446540881,2.20125786163522
1010,İlkay Gündoğan,GER,MF,Manchester City,Premier League,26,1990,16.9,27,15,8,14,5,9,37,24.3,28,14,1,13,16,43,12,0,0,2017-2018,0.9467455621301776,1.5976331360946747
1011,Christian Günter,GER,"DF,MF",Freiburg,Bundesliga,24,1993,34.0,73,54,45,21,7,38,63,60.3,25,38,7,31,20,93,68,0,0,2017-2018,0.5882352941176471,2.1470588235294117
1012,Jon Guridi,ESP,MF,Real Sociedad,La Liga,22,1995,0.6,1,0,1,0,0,0,1,0.0,1,1,0,1,0,1,0,0,0,2017-2018,0.0,1.6666666666666667
1013,Régis Gurtner,FRA,GK,Amiens,Ligue 1,30,1986,37.0,1,0,1,0,0,1,1,100.0,0,0,0,0,4,5,15,4,0,2017-2018,0.10810810810810811,0.02702702702702703
1014,Samuel Gustafson,SWE,"MF,FW",Torino,Serie A,22,1995,0.9,3,2,3,0,0,1,3,33.3,2,2,0,2,0,3,0,0,0,2017-2018,0.0,3.333333333333333
1015,Luiz Gustavo,BRA,"MF,DF",Marseille,Ligue 1,30,1987,33.5,89,54,45,40,4,26,62,41.9,36,44,13,31,50,139,56,1,0,2017-2018,1.492537313432836,2.656716417910448
1016,Alejandro Gutiérrez Mozo,ESP,MF,Leganés,La Liga,22,1995,0.5,3,2,1,2,0,1,4,25.0,3,0,0,0,0,3,0,0,0,2017-2018,0.0,6.0
1017,Jonathan de Guzmán,NED,MF,Eint Frankfurt,Bundesliga,29,1987,12.1,16,16,8,8,0,6,16,37.5,10,13,0,13,13,29,12,0,0,2017-2018,1.0743801652892562,1.322314049586777
1018,Bright Gyamfi,GHA,DF,Benevento,Serie A,21,1996,3.6,2,2,1,1,0,1,2,50.0,1,3,1,2,7,9,8,0,0,2017-2018,1.9444444444444444,0.5555555555555556
1019,Nicolas Haas,SUI,MF,Atalanta,Serie A,21,1996,1.9,1,1,1,0,0,0,2,0.0,2,1,1,0,1,2,4,1,0,2017-2018,0.5263157894736842,0.5263157894736842
1020,Janik Haberer,GER,"MF,FW",Freiburg,Bundesliga,23,1994,30.5,62,49,20,34,8,23,57,40.4,34,43,1,42,30,92,42,0,0,2017-2018,0.9836065573770492,2.0327868852459017
1021,Hacen,MTN,"FW,MF",Levante,La Liga,19,1997,0.9,0,0,0,0,0,0,0,0.0,0,4,2,2,1,1,0,0,0,2017-2018,1.1111111111111112,0.0
1022,Alexander Hack,GER,DF,Mainz 05,Bundesliga,23,1993,14.3,46,34,25,19,2,24,37,64.9,13,31,18,13,26,72,87,2,0,2017-2018,1.8181818181818181,3.2167832167832167
1023,Robin Hack,GER,"FW,MF",Hoffenheim,Bundesliga,18,1998,0.8,2,2,1,0,1,0,1,0.0,1,1,1,0,0,2,1,0,0,2017-2018,0.0,2.5
1024,Munir El Haddadi,MAR,FW,Alavés,La Liga,21,1995,27.2,25,20,8,9,8,5,14,35.7,9,13,2,11,9,34,5,0,0,2017-2018,0.33088235294117646,0.9191176470588236
1025,Oussama Haddadi,TUN,DF,Dijon,Ligue 1,25,1992,27.8,44,29,33,9,2,14,47,29.8,33,29,12,17,43,87,79,1,0,2017-2018,1.5467625899280575,1.5827338129496402
1026,Florent Hadergjonaj,KVX,"DF,MF",Huddersfield,Premier League,23,1994,18.6,21,16,7,10,4,12,30,40.0,18,22,10,12,17,38,45,0,0,2017-2018,0.9139784946236559,1.129032258064516
1027,André Hahn,GER,FW,Hamburger SV,Bundesliga,26,1990,15.1,33,24,15,13,5,10,32,31.3,22,30,2,28,10,43,26,0,0,2017-2018,0.6622516556291391,2.185430463576159
1028,Massadio Haïdara,MLI,FW,Newcastle Utd,Premier League,24,1992,0.0,0,0,0,0,0,0,0,0.0,0,0,0,0,0,0,0,0,0,2017-2018,,
1029,Oualid El Hajjam,MAR,DF,Amiens,Ligue 1,26,1991,24.4,64,44,37,22,5,23,49,46.9,26,25,5,20,59,123,91,1,0,2017-2018,2.418032786885246,2.6229508196721314
1030,Izet Hajrović,BIH,"MF,FW",Werder Bremen,Bundesliga,25,1991,2.1,1,0,1,0,0,0,1,0.0,1,0,0,0,2,3,1,0,0,2017-2018,0.9523809523809523,0.47619047619047616
1031,Achraf Hakimi,MAR,DF,Real Madrid,La Liga,18,1998,8.4,21,15,9,6,6,11,25,44.0,14,9,1,8,10,31,19,1,0,2017-2018,1.1904761904761905,2.5
1032,Alen Halilović,CRO,"FW,MF",Las Palmas,La Liga,21,1996,14.5,11,7,5,6,0,4,17,23.5,13,10,1,9,5,16,4,0,0,2017-2018,0.3448275862068966,0.7586206896551724
1033,Sébastien Haller,CIV,FW,Eint Frankfurt,Bundesliga,23,1994,26.1,25,16,4,16,5,7,14,50.0,7,17,4,13,8,33,39,0,0,2017-2018,0.3065134099616858,0.9578544061302682
1034,Emil Hallfreðsson,ISL,MF,Udinese,Serie A,33,1984,8.5,19,14,9,7,3,7,24,29.2,17,13,2,11,20,39,16,0,0,2017-2018,2.3529411764705883,2.235294117647059
1035,Marcel Halstenberg,GER,DF,RB Leipzig,Bundesliga,25,1991,13.1,29,19,16,9,4,15,19,78.9,4,15,1,14,23,52,42,1,0,2017-2018,1.7557251908396947,2.213740458015267
1036,Ben Hamer,ENG,GK,Leicester City,Premier League,29,1987,3.1,0,0,0,0,0,0,1,0.0,1,0,0,0,0,0,3,1,0,2017-2018,0.0,0.0
1037,Romain Hamouma,FRA,FW,Saint-Étienne,Ligue 1,30,1987,20.5,19,13,7,6,6,1,22,4.5,21,15,4,11,13,32,8,1,0,2017-2018,0.6341463414634146,0.926829268292683
1038,Marek Hamšík,SVK,MF,Napoli,Serie A,30,1987,26.3,36,22,10,15,11,15,37,40.5,22,35,2,33,14,50,16,0,0,2017-2018,0.532319391634981,1.3688212927756653
1039,Samir Handanović,SVN,GK,Inter,Serie A,33,1984,38.0,0,0,0,0,0,0,0,0.0,0,1,0,1,0,0,7,1,0,2017-2018,0.0,0.0
1040,Tim Handwerker,GER,"MF,DF",Köln,Bundesliga,19,1998,4.4,12,7,9,2,1,5,7,71.4,2,3,0,3,6,18,10,0,0,2017-2018,1.3636363636363635,2.727272727272727
1041,Genki Haraguchi,JPN,FW,Hertha BSC,Bundesliga,26,1991,2.3,6,6,2,3,1,2,6,33.3,4,4,0,4,2,8,3,0,0,2017-2018,0.8695652173913044,2.608695652173913
1042,Amine Harit,MAR,"MF,FW",Schalke 04,Bundesliga,20,1997,22.7,39,27,11,21,7,13,37,35.1,24,23,0,23,19,58,11,0,0,2017-2018,0.8370044052863437,1.7180616740088106
1043,Martin Harnik,AUT,"FW,MF",Hannover 96,Bundesliga,30,1987,21.0,17,10,4,10,3,4,25,16.0,21,21,2,19,8,25,26,0,0,2017-2018,0.38095238095238093,0.8095238095238095
1044,Rekeem Harper,ENG,MF,West Brom,Premier League,17,2000,0.2,1,1,0,1,0,0,0,0.0,0,0,0,0,0,1,0,0,0,2017-2018,0.0,5.0
1045,Joe Hart,ENG,GK,West Ham,Premier League,30,1987,19.0,1,1,1,0,0,1,2,50.0,1,1,0,1,0,1,2,4,0,2017-2018,0.0,0.05263157894736842
1046,Makoto Hasebe,JPN,"DF,MF",Eint Frankfurt,Bundesliga,33,1984,23.2,38,23,19,19,0,21,33,63.6,12,40,19,21,25,63,74,0,0,2017-2018,1.0775862068965518,1.6379310344827587
1047,Hans Hateboer,NED,DF,Atalanta,Serie A,23,1994,26.6,31,25,13,13,5,15,26,57.7,11,32,5,27,30,61,46,1,0,2017-2018,1.1278195488721805,1.1654135338345863
1048,Kai Havertz,GER,"MF,FW",Leverkusen,Bundesliga,18,1999,23.8,34,23,8,23,3,12,25,48.0,13,33,2,31,19,53,23,0,0,2017-2018,0.7983193277310924,1.4285714285714286
1049,Isaac Hayden,ENG,MF,Newcastle Utd,Premier League,22,1995,15.3,40,23,23,16,1,12,34,35.3,22,21,6,15,23,63,43,0,0,2017-2018,1.5032679738562091,2.6143790849673203
1050,Eden Hazard,BEL,"FW,MF",Chelsea,Premier League,26,1991,26.9,6,3,2,3,1,3,21,14.3,18,11,0,11,3,9,0,0,0,2017-2018,0.11152416356877325,0.2230483271375465
1051,Thorgan Hazard,BEL,"MF,FW",Gladbach,Bundesliga,24,1993,32.7,49,32,16,23,10,20,54,37.0,34,39,1,38,28,77,18,0,0,2017-2018,0.856269113149847,1.4984709480122322
1052,Tom Heaton,ENG,GK,Burnley,Premier League,31,1986,3.4,0,0,0,0,0,0,0,0.0,0,0,0,0,0,0,0,0,0,2017-2018,0.0,0.0
1053,Jonas Hector,GER,"DF,MF",Köln,Bundesliga,27,1990,19.5,47,35,23,18,6,18,40,45.0,22,39,6,33,28,75,65,2,0,2017-2018,1.435897435897436,2.41025641025641
1054,Michael Hefele,GER,DF,Huddersfield,Premier League,26,1990,0.4,0,0,0,0,0,0,0,0.0,0,0,0,0,1,1,5,0,0,2017-2018,2.5,0.0
1055,Ahmed Hegazi,EGY,DF,West Brom,Premier League,26,1991,37.6,58,38,46,12,0,26,50,52.0,24,55,37,18,60,118,278,2,0,2017-2018,1.5957446808510638,1.5425531914893615
1056,Gauthier Hein,FRA,FW,Metz,Ligue 1,20,1996,0.9,2,2,2,0,0,2,4,50.0,2,1,0,1,2,4,1,0,0,2017-2018,2.2222222222222223,2.2222222222222223
1057,Dominique Heintz,GER,DF,Köln,Bundesliga,23,1993,31.0,60,42,47,13,0,38,64,59.4,26,35,17,18,53,113,140,0,0,2017-2018,1.7096774193548387,1.935483870967742
1058,Filip Helander,SWE,DF,Bologna,Serie A,24,1993,27.8,48,32,33,15,0,15,29,51.7,14,47,25,22,37,85,160,2,0,2017-2018,1.330935251798561,1.7266187050359711
1059,Marcel Heller,GER,"FW,MF",Augsburg,Bundesliga,31,1986,14.4,37,24,21,14,2,12,28,42.9,16,22,1,21,10,47,7,0,0,2017-2018,0.6944444444444444,2.569444444444444
1060,Tomer Hemed,ISR,FW,Brighton,Premier League,30,1987,9.4,7,5,3,4,0,2,10,20.0,8,10,1,9,2,9,12,0,0,2017-2018,0.2127659574468085,0.7446808510638298
1061,Jordan Henderson,ENG,MF,Liverpool,Premier League,27,1990,24.1,51,33,13,32,6,18,52,34.6,34,33,2,31,31,82,27,0,0,2017-2018,1.2863070539419086,2.116182572614108
1062,Jeff Hendrick,IRL,"FW,MF",Burnley,Premier League,25,1992,25.9,16,10,4,10,2,3,17,17.6,14,11,2,9,8,24,21,1,0,2017-2018,0.3088803088803089,0.6177606177606177
1063,Wayne Hennessey,WAL,GK,Crystal Palace,Premier League,30,1987,27.0,0,0,0,0,0,0,0,0.0,0,1,0,1,2,2,5,1,0,2017-2018,0.07407407407407407,0.0
1064,Benjamin Henrichs,GER,DF,Leverkusen,Bundesliga,20,1997,14.1,42,28,23,16,3,27,43,62.8,16,23,3,20,31,73,32,0,0,2017-2018,2.198581560283688,2.978723404255319
1065,Dalbert Henrique,BRA,DF,Inter,Serie A,23,1993,5.9,15,10,11,3,1,7,13,53.8,6,7,4,3,13,28,19,0,0,2017-2018,2.2033898305084745,2.542372881355932
1066,Christophe Hérelle,MTQ,DF,Troyes,Ligue 1,24,1992,32.9,39,26,27,12,0,16,30,53.3,14,38,27,11,56,95,241,1,0,2017-2018,1.702127659574468,1.1854103343465046
1067,Mario Hermoso,ESP,DF,Espanyol,La Liga,22,1995,21.4,14,12,13,1,0,8,21,38.1,13,15,8,7,25,39,122,0,0,2017-2018,1.1682242990654206,0.6542056074766356
1068,Hernán,ESP,MF,Las Palmas,La Liga,26,1990,3.9,18,9,8,7,3,10,17,58.8,7,2,0,2,8,26,5,0,0,2017-2018,2.0512820512820515,4.615384615384616
1069,Héctor Hernández,ESP,DF,Alavés,La Liga,26,1991,0.2,1,1,0,1,0,1,1,100.0,0,0,0,0,0,1,1,0,0,2017-2018,0.0,5.0
1070,Javier Hernández,MEX,FW,West Ham,Premier League,29,1988,17.2,11,7,2,7,2,3,14,21.4,11,6,1,5,6,17,1,0,0,2017-2018,0.3488372093023256,0.6395348837209303
1071,Lucas Hernández,FRA,DF,Atlético Madrid,La Liga,21,1996,23.5,93,68,51,35,7,55,74,74.3,19,35,10,25,40,133,90,0,0,2017-2018,1.702127659574468,3.9574468085106385
1072,Luis Hernández,ESP,DF,Málaga,La Liga,28,1989,36.0,49,43,37,9,3,17,33,51.5,16,32,21,11,77,126,185,1,0,2017-2018,2.138888888888889,1.3611111111111112
1073,Pablo Hernández,CHI,MF,Celta Vigo,La Liga,30,1986,20.2,48,33,17,27,4,14,46,30.4,32,29,11,18,40,88,72,0,0,2017-2018,1.9801980198019802,2.376237623762376
1074,Theo Hernández,FRA,DF,Real Madrid,La Liga,19,1997,10.7,21,15,16,2,3,13,25,52.0,12,9,2,7,17,38,20,0,0,2017-2018,1.5887850467289721,1.9626168224299068
1075,Hernani,BRA,"MF,FW",Saint-Étienne,Ligue 1,23,1994,6.0,21,13,9,9,3,10,22,45.5,12,15,2,13,6,27,5,0,0,2017-2018,1.0,3.5
1076,Ander Herrera,ESP,MF,Manchester Utd,Premier League,27,1989,14.1,56,29,32,20,4,20,69,29.0,49,33,6,27,34,90,22,2,0,2017-2018,2.4113475177304964,3.971631205673759
1077,Borja Herrera,ESP,DF,Las Palmas,La Liga,24,1993,2.7,2,1,2,0,0,2,7,28.6,5,6,1,5,3,5,4,0,0,2017-2018,1.111111111111111,0.7407407407407407
1078,Iago Herrerín,ESP,GK,Athletic Club,La Liga,29,1988,8.0,2,1,2,0,0,2,2,100.0,0,0,0,0,0,2,7,1,0,2017-2018,0.0,0.25
1079,Patrick Herrmann,GER,"MF,FW",Gladbach,Bundesliga,26,1991,12.5,29,21,9,13,7,17,29,58.6,12,13,0,13,17,46,19,0,0,2017-2018,1.36,2.32
1080,Përparim Hetemaj,FIN,MF,Chievo,Serie A,30,1986,26.8,74,48,34,25,15,29,78,37.2,49,39,6,33,39,113,47,1,0,2017-2018,1.4552238805970148,2.761194029850746
1081,Son Heung-min,KOR,FW,Tottenham,Premier League,25,1992,25.7,17,10,2,12,3,2,28,7.1,26,18,0,18,10,27,12,0,0,2017-2018,0.38910505836575876,0.6614785992217899
1082,Thomas Heurtaux,FRA,DF,Hellas Verona,Serie A,29,1988,15.5,14,11,12,2,0,4,8,50.0,4,25,16,9,37,51,97,1,0,2017-2018,2.3870967741935485,0.9032258064516129
1083,Gonzalo Higuaín,ARG,FW,Juventus,Serie A,29,1987,31.3,19,17,3,7,9,2,19,10.5,17,19,4,15,7,26,20,0,0,2017-2018,0.22364217252396165,0.6070287539936102
1084,Oscar Hiljemark,SWE,MF,Genoa,Serie A,25,1992,14.2,12,8,2,8,2,3,24,12.5,21,14,4,10,9,21,12,0,0,2017-2018,0.6338028169014085,0.8450704225352114
1085,Vitorino Hilton,BRA,DF,Montpellier,Ligue 1,39,1977,27.0,44,26,33,11,0,13,36,36.1,23,28,14,14,58,102,140,5,0,2017-2018,2.1481481481481484,1.6296296296296295
1086,Kaylen Hinds,ENG,FW,Wolfsburg,Bundesliga,19,1998,1.0,1,1,1,0,0,0,0,0.0,0,1,0,1,1,2,0,0,0,2017-2018,1.0,1.0
1087,Martin Hinteregger,AUT,DF,Augsburg,Bundesliga,24,1992,29.5,79,51,55,22,2,47,61,77.0,14,40,27,13,49,128,135,3,0,2017-2018,1.6610169491525424,2.6779661016949152
1088,Marwin Hitz,SUI,GK,Augsburg,Bundesliga,29,1987,32.0,1,1,1,0,0,1,3,33.3,2,0,0,0,0,1,12,3,0,2017-2018,0.0,0.03125
1089,Andrew Hjulsager,DEN,"DF,MF",Celta Vigo,La Liga,22,1995,0.2,0,0,0,0,0,0,2,0.0,2,1,0,1,0,0,0,0,0,2017-2018,0.0,0.0
1090,Wesley Hoedt,NED,DF,Southampton,Premier League,23,1994,28.0,60,51,48,12,0,36,61,59.0,25,32,17,15,40,100,177,2,0,2017-2018,1.4285714285714286,2.142857142857143
1091,Nicolas Höfler,GER,MF,Freiburg,Bundesliga,27,1990,25.1,57,36,23,30,4,31,50,62.0,19,42,10,32,44,101,51,2,0,2017-2018,1.752988047808765,2.2709163346613543
1092,Jonas Hofmann,GER,"MF,FW",Gladbach,Bundesliga,25,1992,11.5,23,19,12,11,0,12,26,46.2,14,15,4,11,12,35,16,0,0,2017-2018,1.0434782608695652,2.0
1093,Marco Höger,GER,MF,Köln,Bundesliga,27,1989,18.6,60,40,31,28,1,30,64,46.9,34,35,5,30,25,85,27,1,0,2017-2018,1.3440860215053763,3.225806451612903
1094,Jonathan Hogg,ENG,MF,Huddersfield,Premier League,28,1988,26.6,93,64,29,59,5,26,89,29.2,63,51,12,39,69,162,48,0,0,2017-2018,2.5939849624060147,3.496240601503759
1095,Rob Holding,ENG,DF,Arsenal,Premier League,21,1995,9.1,19,14,13,5,1,4,12,33.3,8,16,10,6,21,40,40,2,0,2017-2018,2.307692307692308,2.087912087912088
1096,José Holebas,GRE,DF,Watford,Premier League,33,1984,26.5,51,31,34,14,3,18,44,40.9,26,24,8,16,29,80,95,2,0,2017-2018,1.0943396226415094,1.9245283018867925
1097,Lucas Höler,GER,"FW,MF",Freiburg,Bundesliga,23,1994,10.1,24,20,8,13,3,9,24,37.5,15,10,0,10,7,31,13,0,0,2017-2018,0.6930693069306931,2.376237623762376
1098,Mason Holgate,ENG,DF,Everton,Premier League,20,1996,13.2,23,16,15,7,1,10,21,47.6,11,12,9,3,23,46,86,2,0,2017-2018,1.7424242424242424,1.7424242424242424
1099,Lewis Holtby,GER,"MF,FW",Hamburger SV,Bundesliga,26,1990,13.3,44,29,14,26,4,17,32,53.1,15,23,2,21,10,54,9,0,0,2017-2018,0.7518796992481203,3.308270676691729
1100,Gerrit Holtmann,PHI,"FW,DF",Mainz 05,Bundesliga,22,1995,10.0,16,13,8,5,3,11,22,50.0,11,19,2,17,12,28,9,0,0,2017-2018,1.2,1.6
1101,Jannes Horn,GER,DF,Köln,Bundesliga,20,1997,9.2,16,11,11,4,1,11,14,78.6,3,12,3,9,17,33,26,0,0,2017-2018,1.847826086956522,1.7391304347826089
1102,Timo Horn,GER,GK,Köln,Bundesliga,24,1993,34.0,3,2,3,0,0,3,6,50.0,3,0,0,0,0,3,18,2,0,2017-2018,0.0,0.08823529411764706
1103,Benedikt Höwedes,GER,DF,Juventus,Serie A,29,1988,2.7,1,1,1,0,0,0,0,0.0,0,0,0,0,8,9,10,1,0,2017-2018,2.962962962962963,0.37037037037037035
1104,Lukáš Hrádecký,FIN,GK,Eint Frankfurt,Bundesliga,27,1989,34.0,0,0,0,0,0,0,2,0.0,2,0,0,0,0,0,23,3,0,2017-2018,0.0,0.0
1105,Branimir Hrgota,SWE,"MF,FW",Eint Frankfurt,Bundesliga,24,1993,2.2,5,4,0,3,2,4,7,57.1,3,2,0,2,0,5,1,0,0,2017-2018,0.0,2.2727272727272725
1106,Timo Hübers,GER,DF,Hannover 96,Bundesliga,21,1996,5.0,11,10,9,2,0,9,15,60.0,6,13,8,5,9,20,31,0,0,2017-2018,1.8,2.2
1107,Benjamin Hübner,GER,DF,Hoffenheim,Bundesliga,28,1989,25.7,71,56,43,27,1,31,46,67.4,15,40,18,22,51,122,114,0,0,2017-2018,1.9844357976653697,2.762645914396887
1108,Florian Hübner,GER,DF,Hannover 96,Bundesliga,26,1991,3.6,10,9,8,2,0,5,9,55.6,4,3,2,1,6,16,21,0,0,2017-2018,1.6666666666666665,2.7777777777777777
1109,Tomáš Hubočan,SVK,DF,Marseille,Ligue 1,31,1985,1.0,1,0,1,0,0,0,4,0.0,4,0,0,0,0,1,1,0,0,2017-2018,0.0,1.0
1110,Callum Hudson-Odoi,ENG,"FW,DF",Chelsea,Premier League,16,2000,0.3,0,0,0,0,0,0,0,0.0,0,0,0,0,0,0,0,0,0,2017-2018,0.0,0.0
1111,Will Hughes,ENG,MF,Watford,Premier League,22,1995,11.0,34,18,7,18,9,9,19,47.4,10,16,1,15,15,49,6,0,0,2017-2018,1.3636363636363635,3.090909090909091
1112,Jordan Hugill,ENG,FW,West Ham,Premier League,25,1992,0.3,0,0,0,0,0,0,1,0.0,1,0,0,0,0,0,0,0,0,2017-2018,0.0,0.0
1113,Vitor Hugo,BRA,DF,Fiorentina,Serie A,26,1991,13.4,32,21,26,6,0,10,17,58.8,7,10,6,4,43,75,92,0,0,2017-2018,3.2089552238805967,2.388059701492537
1114,Mats Hummels,GER,DF,Bayern Munich,Bundesliga,28,1988,24.6,62,52,41,18,3,35,51,68.6,16,31,12,19,55,117,59,2,0,2017-2018,2.2357723577235773,2.5203252032520322
1115,Uwe Hünemeier,GER,DF,Brighton,Premier League,31,1986,0.2,0,0,0,0,0,0,0,0.0,0,0,0,0,0,0,4,0,0,2017-2018,0.0,0.0
1116,Adrien Hunou,FRA,"FW,MF",Rennes,Ligue 1,23,1994,16.2,27,15,11,8,8,11,42,26.2,31,22,1,21,9,36,8,1,0,2017-2018,0.5555555555555556,1.6666666666666667
1117,Aaron Hunt,GER,"MF,FW",Hamburger SV,Bundesliga,30,1986,23.1,36,24,12,20,4,11,37,29.7,26,20,2,18,14,50,18,2,0,2017-2018,0.6060606060606061,1.5584415584415583
1118,Emerson Hyndman,USA,MF,Bournemouth,Premier League,21,1996,0.6,0,0,0,0,0,0,1,0.0,1,2,0,2,1,1,1,0,0,2017-2018,1.6666666666666667,0.0
1119,Elseid Hysaj,ALB,DF,Napoli,Serie A,23,1994,34.7,64,45,28,30,6,32,56,57.1,24,35,4,31,43,107,68,4,0,2017-2018,1.239193083573487,1.8443804034582132
1120,Suk Hyun-jun,KOR,FW,Troyes,Ligue 1,26,1991,13.3,6,5,2,2,2,1,9,11.1,8,10,0,10,1,7,7,0,0,2017-2018,0.07518796992481203,0.45112781954887216
1121,Pierre Højbjerg,DEN,MF,Southampton,Premier League,21,1995,18.6,45,29,24,18,3,13,56,23.2,43,30,3,27,37,82,26,1,0,2017-2018,1.9892473118279568,2.419354838709677
1122,Jordon Ibe,ENG,"MF,FW",Bournemouth,Premier League,21,1995,22.2,14,12,7,5,2,6,22,27.3,16,5,0,5,10,24,11,0,0,2017-2018,0.45045045045045046,0.6306306306306306
1123,Vedad Ibišević,BIH,FW,Hertha BSC,Bundesliga,32,1984,16.1,10,8,1,5,4,4,7,57.1,3,8,1,7,4,14,23,0,0,2017-2018,0.24844720496894407,0.6211180124223602
1124,Vicente Iborra,ESP,MF,Leicester City,Premier League,29,1988,15.7,23,18,13,10,0,9,36,25.0,27,25,11,14,19,42,49,1,0,2017-2018,1.2101910828025477,1.4649681528662422
1125,Zlatan Ibrahimović,SWE,"MF,FW",Manchester Utd,Premier League,35,1981,1.2,2,1,1,0,1,0,1,0.0,1,0,0,0,0,2,1,0,0,2017-2018,0.0,1.6666666666666667
1126,Mauro Icardi,ARG,FW,Inter,Serie A,24,1993,32.9,3,2,1,2,0,1,8,12.5,7,14,6,8,5,8,23,1,0,2017-2018,0.1519756838905775,0.0911854103343465
1127,Brown Ideye,NGA,FW,Málaga,La Liga,28,1988,8.1,2,2,0,2,0,0,5,0.0,5,2,0,2,1,3,11,0,0,2017-2018,0.1234567901234568,0.2469135802469136
1128,Edgar Ié,GNB,DF,Lille,Ligue 1,23,1994,35.0,74,42,55,18,1,31,69,44.9,38,57,26,31,84,158,135,3,0,2017-2018,2.4,2.1142857142857143
1129,Julien Ielsch,FRA,"MF,DF",Amiens,Ligue 1,34,1983,6.8,28,18,12,11,5,7,25,28.0,18,16,3,13,11,39,15,2,0,2017-2018,1.6176470588235294,4.11764705882353
1130,Pietro Iemmello,ITA,FW,Benevento,Serie A,25,1992,9.8,2,2,1,1,0,2,8,25.0,6,4,0,4,1,3,11,2,0,2017-2018,0.1020408163265306,0.2040816326530612
1131,Kelechi Iheanacho,NGA,"FW,MF",Leicester City,Premier League,20,1996,9.2,9,6,3,5,1,3,20,15.0,17,10,2,8,3,12,4,0,0,2017-2018,0.32608695652173914,0.9782608695652175
1132,Jordan Ikoko,COD,DF,Guingamp,Ligue 1,23,1994,26.9,44,29,24,15,5,22,42,52.4,20,20,2,18,48,92,74,0,0,2017-2018,1.784386617100372,1.6356877323420076
1133,Jonathan Ikone,FRA,"MF,FW",Montpellier,Ligue 1,19,1998,11.1,13,10,3,6,4,4,14,28.6,10,8,0,8,6,19,3,0,0,2017-2018,0.5405405405405406,1.1711711711711712
1134,Josip Iličić,SVN,"MF,FW",Atalanta,Serie A,29,1988,22.2,24,19,5,13,6,8,29,27.6,21,19,0,19,16,40,2,0,0,2017-2018,0.7207207207207208,1.0810810810810811
1135,Asier Illarramendi,ESP,MF,Real Sociedad,La Liga,27,1990,35.1,85,57,35,41,9,37,90,41.1,53,44,8,36,75,160,35,0,0,2017-2018,2.1367521367521367,2.4216524216524213
1136,Jules Iloki,FRA,"MF,FW",Nantes,Ligue 1,25,1992,15.8,13,9,1,9,3,3,16,18.8,13,8,0,8,12,25,16,0,0,2017-2018,0.7594936708860759,0.8227848101265822
1137,Stefan Ilsanker,AUT,"DF,MF",RB Leipzig,Bundesliga,28,1989,14.3,37,29,23,11,3,22,39,56.4,17,23,10,13,25,62,55,1,0,2017-2018,1.7482517482517481,2.5874125874125875
1138,Giannelli Imbula,COD,MF,Toulouse,Ligue 1,24,1992,24.9,29,19,10,15,4,7,29,24.1,22,17,2,15,20,49,13,3,0,2017-2018,0.8032128514056225,1.1646586345381527
1139,Ciro Immobile,ITA,FW,Lazio,Serie A,27,1990,29.8,4,2,0,3,1,0,17,0.0,17,14,1,13,0,4,9,0,0,2017-2018,0.0,0.1342281879194631
1140,Emmanuel Imorou,BEN,DF,Caen,Ligue 1,28,1988,0.4,0,0,0,0,0,0,0,0.0,0,0,0,0,1,1,1,0,0,2017-2018,2.5,0.0
1141,Tom Ince,ENG,"MF,FW",Huddersfield,Premier League,25,1992,27.2,35,27,14,16,5,10,29,34.5,19,20,0,20,12,47,12,0,0,2017-2018,0.4411764705882353,1.286764705882353
1142,Svante Ingelsson,SWE,MF,Udinese,Serie A,19,1998,3.6,9,6,3,3,3,2,10,20.0,8,4,0,4,6,15,4,0,0,2017-2018,1.6666666666666665,2.5
1143,Roberto Inglese,ITA,FW,Chievo,Serie A,25,1991,30.9,31,21,13,9,9,7,30,23.3,23,21,2,19,8,39,17,1,0,2017-2018,0.25889967637540456,1.0032362459546926
1144,Danny Ings,ENG,FW,Liverpool,Premier League,25,1992,3.0,5,3,1,3,1,0,0,0.0,0,4,0,4,2,7,1,0,0,2017-2018,0.6666666666666666,1.6666666666666667
1145,Andrés Iniesta,ESP,MF,Barcelona,La Liga,33,1984,20.3,28,22,11,8,9,6,31,19.4,25,21,2,19,10,38,12,1,0,2017-2018,0.49261083743842365,1.379310344827586
1146,Lorenzo Insigne,ITA,FW,Napoli,Serie A,26,1991,34.3,29,17,11,13,5,13,33,39.4,20,20,0,20,17,46,4,0,0,2017-2018,0.4956268221574344,0.8454810495626823
1147,Emiliano Insúa,ARG,DF,Stuttgart,Bundesliga,28,1989,23.4,46,34,27,16,3,17,32,53.1,15,30,4,26,36,82,48,1,0,2017-2018,1.5384615384615385,1.965811965811966
1148,Pablo Insua,ESP,DF,Schalke 04,Bundesliga,23,1993,0.3,0,0,0,0,0,0,0,0.0,0,1,1,0,0,0,1,0,0,2017-2018,0.0,0.0
1149,Takashi Inui,JPN,"MF,FW",Eibar,La Liga,29,1988,29.2,39,21,12,19,8,13,42,31.0,29,36,0,36,18,57,10,0,0,2017-2018,0.6164383561643836,1.3356164383561644
1150,Artur Ioniță,MDA,MF,Cagliari,Serie A,26,1990,29.7,63,45,30,24,9,17,38,44.7,21,39,7,32,28,91,29,0,0,2017-2018,0.9427609427609428,2.121212121212121
1151,Gorka Iraizoz,ESP,GK,Girona,La Liga,36,1981,8.5,1,1,1,0,0,1,2,50.0,1,0,0,0,1,2,9,2,0,2017-2018,0.11764705882352941,0.11764705882352941
1152,Stephen Ireland,IRL,"MF,FW",Stoke City,Premier League,30,1986,1.5,3,1,2,1,0,1,5,20.0,4,4,2,2,1,4,1,0,0,2017-2018,0.6666666666666666,2.0
1153,Carlos Isaac,ESP,DF,Atlético Madrid,La Liga,19,1998,0.7,1,0,1,0,0,1,3,33.3,2,0,0,0,2,3,1,0,0,2017-2018,2.857142857142857,1.4285714285714286
1154,Alexander Isak,SWE,"FW,MF",Dortmund,Bundesliga,17,1999,1.3,1,0,0,1,0,0,1,0.0,1,1,0,1,0,1,0,0,0,2017-2018,0.0,0.7692307692307692
1155,Isco,ESP,MF,Real Madrid,La Liga,25,1992,19.7,22,12,5,10,7,5,35,14.3,30,11,0,11,15,37,2,0,0,2017-2018,0.7614213197969544,1.116751269035533
1156,Tatsuya Ito,JPN,"MF,FW",Hamburger SV,Bundesliga,20,1997,11.2,16,13,4,8,4,11,22,50.0,11,28,0,28,6,22,1,0,0,2017-2018,0.5357142857142857,1.4285714285714286
1157,Gian-Luca Itter,GER,DF,Wolfsburg,Bundesliga,18,1999,4.6,19,12,15,2,2,14,22,63.6,8,6,0,6,5,24,15,0,0,2017-2018,1.0869565217391306,4.130434782608696
1158,Manuel Iturra,CHI,MF,Málaga,La Liga,33,1984,17.6,70,45,36,27,7,22,55,40.0,33,19,2,17,29,99,23,0,0,2017-2018,1.6477272727272725,3.977272727272727
1159,Ander Iturraspe,ESP,MF,Athletic Club,La Liga,28,1989,21.2,42,31,18,22,2,10,32,31.3,22,22,7,15,35,77,57,0,0,2017-2018,1.650943396226415,1.9811320754716981
1160,Ivi,ESP,"MF,FW",Levante,La Liga,23,1994,19.6,48,34,19,23,6,21,62,33.9,41,21,1,20,15,63,15,0,0,2017-2018,0.7653061224489796,2.4489795918367343
1161,Alex Iwobi,NGA,"MF,FW",Arsenal,Premier League,21,1996,20.3,19,15,8,8,3,5,18,27.8,13,19,1,18,7,26,10,1,0,2017-2018,0.3448275862068965,0.9359605911330049
1162,José Izquierdo,COL,"MF,FW",Brighton,Premier League,25,1992,22.0,23,15,12,9,2,7,19,36.8,12,6,0,6,16,39,34,0,0,2017-2018,0.7272727272727273,1.0454545454545454
1163,Armando Izzo,ITA,DF,Genoa,Serie A,25,1992,15.4,30,23,14,10,6,12,18,66.7,6,15,6,9,34,64,70,0,0,2017-2018,2.207792207792208,1.948051948051948
1164,Koo Ja-cheol,KOR,MF,Augsburg,Bundesliga,28,1989,22.7,54,41,18,31,5,27,44,61.4,17,22,3,19,27,81,34,2,0,2017-2018,1.1894273127753305,2.378854625550661
1165,Paul Jaeckel,GER,DF,Wolfsburg,Bundesliga,19,1998,3.0,3,3,3,0,0,1,2,50.0,1,5,2,3,1,4,8,0,0,2017-2018,0.3333333333333333,1.0
1166,Phil Jagielka,ENG,DF,Everton,Premier League,34,1982,22.9,33,23,24,9,0,8,21,38.1,13,30,20,10,39,72,179,1,0,2017-2018,1.7030567685589522,1.4410480349344978
1167,Kilian Jakob,GER,FW,Augsburg,Bundesliga,19,1998,0.6,0,0,0,0,0,0,0,0.0,0,1,0,1,0,0,1,0,0,2017-2018,0.0,0.0
1168,Eldin Jakupović,SUI,GK,Leicester City,Premier League,32,1984,2.0,0,0,0,0,0,0,0,0.0,0,0,0,0,0,0,4,0,0,2017-2018,0.0,0.0
1169,Christophe Jallet,FRA,DF,Nice,Ligue 1,33,1983,13.0,29,21,21,8,0,11,26,42.3,15,18,6,12,16,45,47,0,0,2017-2018,1.2307692307692308,2.230769230769231
1170,Ablie Jallow,GAM,FW,Metz,Ligue 1,18,1998,1.4,1,1,1,0,0,0,5,0.0,5,1,0,1,3,4,1,0,0,2017-2018,2.142857142857143,0.7142857142857143
1171,Matty James,ENG,MF,Leicester City,Premier League,26,1991,11.0,19,10,7,11,1,2,10,20.0,8,14,2,12,17,36,25,0,0,2017-2018,1.5454545454545454,1.7272727272727273
1172,Vasilije Janjicic,SUI,MF,Hamburger SV,Bundesliga,18,1998,3.6,14,11,5,9,0,2,4,50.0,2,6,1,5,3,17,5,0,0,2017-2018,0.8333333333333333,3.888888888888889
1173,Christoph Janker,GER,"DF,MF",Augsburg,Bundesliga,32,1985,0.9,4,3,3,1,0,2,3,66.7,1,0,0,0,1,5,4,1,0,2017-2018,1.1111111111111112,4.444444444444445
1174,Saidy Janko,GAM,DF,Saint-Étienne,Ligue 1,21,1995,15.8,43,30,25,14,4,14,24,58.3,10,21,1,20,14,57,50,0,0,2017-2018,0.8860759493670886,2.721518987341772
1175,Jakub Jankto,CZE,"MF,FW",Udinese,Serie A,21,1996,29.5,29,18,9,14,6,10,46,21.7,36,46,8,38,20,49,27,0,0,2017-2018,0.6779661016949152,0.9830508474576272
1176,Daryl Janmaat,NED,DF,Watford,Premier League,28,1989,20.2,46,31,29,10,7,22,52,42.3,30,16,5,11,33,79,61,0,0,2017-2018,1.6336633663366338,2.2772277227722775
1177,Vincent Janssen,NED,DF,Tottenham,Premier League,23,1994,0.0,0,0,0,0,0,0,0,0.0,0,0,0,0,0,0,0,0,0,2017-2018,,
1178,Tony Jantschke,GER,DF,Gladbach,Bundesliga,27,1990,8.1,13,11,9,4,0,8,13,61.5,5,10,1,9,6,19,25,0,0,2017-2018,0.7407407407407408,1.6049382716049383
1179,Adnan Januzaj,BEL,FW,Real Sociedad,La Liga,22,1995,17.5,16,11,2,8,6,5,18,27.8,13,12,0,12,11,27,5,0,0,2017-2018,0.6285714285714286,0.9142857142857143
1180,Nicolas Janvier,FRA,MF,Rennes,Ligue 1,18,1998,0.8,4,1,1,1,2,1,2,50.0,1,1,0,1,1,5,0,0,0,2017-2018,1.25,5.0
1181,Paweł Jaroszyński,POL,DF,Chievo,Serie A,22,1994,9.0,20,12,14,5,1,9,18,50.0,9,11,4,7,21,41,40,1,0,2017-2018,2.3333333333333335,2.2222222222222223
1182,Rune Jarstein,NOR,GK,Hertha BSC,Bundesliga,32,1984,31.0,1,1,1,0,0,1,2,50.0,1,0,0,0,0,1,8,5,0,2017-2018,0.0,0.03225806451612903
1183,Jason,ESP,"FW,MF",Levante,La Liga,23,1994,19.8,32,25,11,14,7,11,38,28.9,27,14,1,13,20,52,8,0,0,2017-2018,1.0101010101010102,1.6161616161616161
1184,Bakery Jatta,GAM,"MF,FW",Hamburger SV,Bundesliga,19,1998,3.3,14,12,2,12,0,4,6,66.7,2,6,1,5,3,17,5,0,0,2017-2018,0.9090909090909092,4.242424242424242
1185,Corentin Jean,FRA,"FW,MF",Toulouse,Ligue 1,22,1995,18.8,12,8,4,7,1,5,21,23.8,16,14,1,13,14,26,10,0,0,2017-2018,0.7446808510638298,0.6382978723404255
1186,Benjamin Jeannot,FRA,FW,Dijon,Ligue 1,25,1992,15.6,12,7,5,6,1,1,13,7.7,12,9,3,6,6,18,26,0,0,2017-2018,0.38461538461538464,0.7692307692307693
1187,Tin Jedvaj,CRO,DF,Leverkusen,Bundesliga,21,1995,6.7,10,6,2,6,2,8,15,53.3,7,9,1,8,9,19,18,0,0,2017-2018,1.3432835820895521,1.4925373134328357
1188,Jemerson,BRA,DF,Monaco,Ligue 1,24,1992,31.7,48,32,32,15,1,24,31,77.4,7,46,32,14,56,104,169,1,0,2017-2018,1.7665615141955837,1.5141955835962146
1189,Jesé,ESP,"FW,MF",Stoke City,Premier League,24,1993,6.8,10,7,3,5,2,3,13,23.1,10,5,0,5,0,10,3,0,0,2017-2018,0.0,1.4705882352941178
1190,Gabriel Jesus,BRA,FW,Manchester City,Premier League,20,1997,18.5,23,15,6,10,7,3,22,13.6,19,16,0,16,8,31,6,0,0,2017-2018,0.43243243243243246,1.2432432432432432
1191,Juan Jesus,BRA,DF,Roma,Serie A,26,1991,18.4,42,30,25,15,2,18,34,52.9,16,18,9,9,39,81,63,0,0,2017-2018,2.1195652173913047,2.2826086956521743
1192,Álvaro Jiménez,ESP,"MF,FW",Getafe,La Liga,22,1995,5.9,15,8,5,6,4,8,21,38.1,13,6,0,6,1,16,6,0,0,2017-2018,0.1694915254237288,2.542372881355932
1193,Joaquín,ESP,"MF,FW",Betis,La Liga,36,1981,27.5,22,19,11,10,1,4,16,25.0,12,17,2,15,15,37,38,0,0,2017-2018,0.5454545454545454,0.8
1194,Aron Jóhannsson,USA,"MF,FW",Werder Bremen,Bundesliga,26,1990,3.1,4,3,2,2,0,1,7,14.3,6,3,0,3,1,5,5,0,0,2017-2018,0.3225806451612903,1.2903225806451613
1195,Fabian Johnson,USA,"MF,DF",Gladbach,Bundesliga,29,1987,5.2,16,10,7,7,2,6,7,85.7,1,10,2,8,2,18,13,0,0,2017-2018,0.3846153846153846,3.0769230769230766
1196,Glen Johnson,ENG,DF,Stoke City,Premier League,32,1984,6.1,7,5,5,2,0,3,12,25.0,9,7,2,5,10,17,23,0,0,2017-2018,1.639344262295082,1.1475409836065575
1197,Karl-Johan Johnsson,SWE,GK,Guingamp,Ligue 1,27,1990,38.0,0,0,0,0,0,0,1,0.0,1,0,0,0,0,0,14,4,0,2017-2018,0.0,0.0
1198,Miloš Jojić,SRB,MF,Köln,Bundesliga,25,1992,16.2,36,26,18,15,3,16,40,40.0,24,31,4,27,15,51,16,0,0,2017-2018,0.9259259259259259,2.2222222222222223
1199,Jonathas,BRA,FW,Hannover 96,Bundesliga,28,1989,7.0,7,3,2,4,1,1,2,50.0,1,3,1,2,0,7,9,0,0,2017-2018,0.0,1.0
1200,Phil Jones,ENG,DF,Manchester Utd,Premier League,25,1992,21.9,25,18,20,5,0,9,20,45.0,11,25,17,8,41,66,133,2,0,2017-2018,1.8721461187214614,1.1415525114155252
1201,Nigel de Jong,NED,MF,Mainz 05,Bundesliga,32,1984,8.2,17,12,7,9,1,10,14,71.4,4,5,1,4,12,29,22,1,0,2017-2018,1.4634146341463417,2.073170731707317
1202,Jony,ESP,"FW,MF",Málaga,La Liga,26,1991,2.4,3,2,2,0,1,0,4,0.0,4,1,0,1,2,5,1,0,0,2017-2018,0.8333333333333334,1.25
1203,Joan Jordán,ESP,MF,Eibar,La Liga,23,1994,27.0,31,24,8,19,4,10,68,14.7,58,24,0,24,30,61,12,0,0,2017-2018,1.1111111111111112,1.1481481481481481
1204,Jorge,BRA,DF,Monaco,Ligue 1,21,1996,21.3,69,40,34,25,10,23,38,60.5,15,19,2,17,66,135,86,0,0,2017-2018,3.0985915492957745,3.2394366197183095
1205,Jorginho,ITA,MF,Napoli,Serie A,25,1991,29.4,62,46,14,39,9,15,68,22.1,53,32,3,29,50,112,12,2,0,2017-2018,1.7006802721088436,2.108843537414966
1206,Willian José,BRA,FW,Real Sociedad,La Liga,25,1991,30.8,10,7,1,5,4,2,9,22.2,7,10,1,9,5,15,31,0,0,2017-2018,0.16233766233766234,0.3246753246753247
1207,Joselu,ESP,FW,Newcastle Utd,Premier League,27,1990,19.0,22,17,10,11,1,7,34,20.6,27,25,2,23,11,33,39,0,0,2017-2018,0.5789473684210527,1.1578947368421053
1208,Yann Jouffre,FRA,"FW,MF",Metz,Ligue 1,33,1984,3.1,3,2,0,2,1,1,6,16.7,5,5,1,4,3,6,2,0,0,2017-2018,0.9677419354838709,0.9677419354838709
1209,Vukašin Jovanović,SRB,DF,Bordeaux,Ligue 1,21,1996,16.0,18,14,11,7,0,6,14,42.9,8,18,10,8,27,45,67,0,0,2017-2018,1.6875,1.125
1210,Stevan Jovetić,MNE,FW,Monaco,Ligue 1,27,1989,8.4,4,4,0,3,1,0,9,0.0,9,5,0,5,3,7,3,0,0,2017-2018,0.35714285714285715,0.47619047619047616
1211,Luka Jović,SRB,FW,Eint Frankfurt,Bundesliga,19,1997,10.4,5,5,0,5,0,1,3,33.3,2,6,2,4,1,6,2,0,0,2017-2018,0.09615384615384615,0.4807692307692307
1212,Jozabed,ESP,MF,Celta Vigo,La Liga,26,1991,16.4,18,12,7,9,2,3,18,16.7,15,18,2,16,16,34,19,0,0,2017-2018,0.9756097560975611,1.0975609756097562
1213,Juanfran,ESP,DF,La Coruña,La Liga,28,1988,34.0,64,44,38,22,4,35,65,53.8,30,29,11,18,63,127,121,0,0,2017-2018,1.8529411764705883,1.8823529411764706
1214,Juanfran,ESP,DF,Atlético Madrid,La Liga,32,1985,14.5,33,24,21,9,3,21,32,65.6,11,14,4,10,26,59,35,0,0,2017-2018,1.793103448275862,2.2758620689655173
1215,Juankar,ESP,DF,Málaga,La Liga,27,1990,8.7,23,17,13,8,2,11,20,55.0,9,8,1,7,19,42,26,0,0,2017-2018,2.1839080459770117,2.6436781609195403
1216,Juanmi,ESP,"FW,MF",Real Sociedad,La Liga,24,1993,16.5,22,13,7,12,3,4,22,18.2,18,11,0,11,10,32,6,0,0,2017-2018,0.6060606060606061,1.3333333333333333
1217,Juanpe,ESP,DF,Girona,La Liga,26,1991,34.1,48,30,28,20,0,30,43,69.8,13,27,19,8,53,101,137,0,0,2017-2018,1.5542521994134897,1.407624633431085
1218,Juanpi,VEN,"MF,FW",Málaga,La Liga,23,1994,6.8,11,8,2,7,2,3,8,37.5,5,7,0,7,6,17,1,0,0,2017-2018,0.8823529411764706,1.6176470588235294
1219,Mariano Julio Izco,ARG,MF,Crotone,Serie A,34,1983,2.0,6,4,2,4,0,2,4,50.0,2,2,0,2,4,10,1,0,0,2017-2018,2.0,3.0
1220,Christopher Jullien,FRA,DF,Toulouse,Ligue 1,24,1993,28.9,36,25,27,9,0,15,32,46.9,17,29,19,10,40,76,182,5,0,2017-2018,1.384083044982699,1.245674740484429
1221,David Juncà,ESP,DF,Eibar,La Liga,23,1993,10.0,15,13,9,6,0,7,19,36.8,12,7,1,6,11,26,25,0,0,2017-2018,1.1,1.5
1222,Gideon Jung,GER,"MF,DF",Hamburger SV,Bundesliga,22,1994,28.6,59,41,32,24,3,22,38,57.9,16,29,12,17,38,97,71,1,0,2017-2018,1.3286713286713285,2.062937062937063
1223,Sebastian Jung,GER,DF,Wolfsburg,Bundesliga,27,1990,0.9,2,2,1,1,0,1,1,100.0,0,0,0,0,0,2,5,0,0,2017-2018,0.0,2.2222222222222223
1224,Zlatko Junuzović,AUT,"MF,FW",Werder Bremen,Bundesliga,29,1987,18.1,35,23,17,12,6,18,38,47.4,20,23,2,21,18,53,12,0,0,2017-2018,0.9944751381215469,1.9337016574585635
1225,Mathias Jørgensen,DEN,DF,Huddersfield,Premier League,27,1990,38.0,55,36,40,13,2,19,45,42.2,26,49,20,29,76,131,249,5,0,2017-2018,2.0,1.4473684210526316
1226,Christian Kabasele,BEL,DF,Watford,Premier League,26,1991,25.9,42,25,28,14,0,21,36,58.3,15,37,23,14,34,76,185,0,0,2017-2018,1.3127413127413128,1.6216216216216217
1227,Younès Kaboul,FRA,DF,Watford,Premier League,31,1986,1.7,3,2,0,3,0,0,0,0.0,0,4,2,2,2,5,15,0,0,2017-2018,1.1764705882352942,1.7647058823529411
1228,Alexander Kačaniklić,SWE,"MF,FW",Nantes,Ligue 1,25,1991,3.5,8,5,7,1,0,5,10,50.0,5,5,2,3,6,14,7,0,0,2017-2018,1.7142857142857142,2.2857142857142856
1229,Gojko Kačar,SRB,DF,Augsburg,Bundesliga,30,1987,2.5,7,6,6,1,0,3,7,42.9,4,3,2,1,4,11,7,0,0,2017-2018,1.6,2.8
1230,Elias Kachunga,COD,"FW,MF",Huddersfield,Premier League,25,1992,14.8,30,26,13,12,5,8,19,42.1,11,14,1,13,2,32,9,0,0,2017-2018,0.13513513513513511,2.0270270270270268
1231,Pavel Kadeřábek,CZE,"FW,DF",Hoffenheim,Bundesliga,25,1992,24.4,44,30,22,18,4,20,44,45.5,24,27,8,19,34,78,45,1,0,2017-2018,1.3934426229508197,1.8032786885245902
1232,Shinji Kagawa,JPN,MF,Dortmund,Bundesliga,28,1989,13.0,32,22,11,14,7,18,27,66.7,9,6,0,6,6,38,2,0,0,2017-2018,0.46153846153846156,2.4615384615384617
1233,Sullay Kaikai,SLE,MF,Crystal Palace,Premier League,21,1995,0.2,1,0,0,1,0,0,0,0.0,0,1,0,1,0,1,1,0,0,2017-2018,0.0,5.0
1234,Florian Kainz,AUT,"MF,FW",Werder Bremen,Bundesliga,24,1992,19.0,33,25,9,18,6,9,19,47.4,10,23,0,23,17,50,13,0,0,2017-2018,0.8947368421052632,1.736842105263158
1235,Dominik Kaiser,GER,"MF,FW",RB Leipzig,Bundesliga,28,1988,3.1,5,5,1,3,1,4,11,36.4,7,6,0,6,1,6,8,0,0,2017-2018,0.3225806451612903,1.6129032258064515
1236,Gaël Kakuta,COD,"MF,FW",Amiens,Ligue 1,26,1991,34.3,54,32,14,27,13,9,40,22.5,31,33,3,30,26,80,19,0,0,2017-2018,0.7580174927113703,1.5743440233236152
1237,Nikola Kalinić,CRO,FW,Milan,Serie A,29,1988,20.1,6,5,1,4,1,0,8,0.0,8,4,1,3,3,9,12,0,0,2017-2018,0.14925373134328357,0.29850746268656714
1238,Salomon Kalou,CIV,"FW,MF",Hertha BSC,Bundesliga,31,1985,24.5,19,11,12,5,2,9,17,52.9,8,37,1,36,10,29,29,0,0,2017-2018,0.40816326530612246,0.7755102040816326
1239,Daichi Kamada,JPN,"MF,FW",Eint Frankfurt,Bundesliga,20,1996,1.6,1,1,0,1,0,0,0,0.0,0,0,0,0,1,2,0,0,0,2017-2018,0.625,0.625
1240,François Kamano,GUI,FW,Bordeaux,Ligue 1,21,1996,22.4,32,24,11,14,7,10,35,28.6,25,18,2,16,15,47,8,0,0,2017-2018,0.6696428571428572,1.4285714285714286
1241,Bingourou Kamara,SEN,GK,Strasbourg,Ligue 1,20,1996,18.8,0,0,0,0,0,0,2,0.0,2,0,0,0,1,1,6,3,0,2017-2018,0.05319148936170213,0.0
1242,Boubacar Kamara,FRA,"DF,MF",Marseille,Ligue 1,17,1999,5.1,14,14,9,5,0,8,12,66.7,4,7,3,4,3,17,18,0,0,2017-2018,0.5882352941176471,2.7450980392156863
1243,Marcin Kamiński,POL,DF,Stuttgart,Bundesliga,25,1992,12.6,17,14,5,11,1,12,18,66.7,6,12,3,9,30,47,55,0,0,2017-2018,2.380952380952381,1.3492063492063493
1244,Kevin Kampl,SVN,MF,RB Leipzig,Bundesliga,26,1990,22.4,42,33,16,20,6,16,39,41.0,23,37,2,35,33,75,33,0,0,2017-2018,1.4732142857142858,1.8750000000000002
1245,Kevin Kampl,SVN,MF,Leverkusen,Bundesliga,26,1990,0.3,1,1,1,0,0,1,1,100.0,0,0,0,0,0,1,0,0,0,2017-2018,0.0,3.3333333333333335
1246,Harry Kane,ENG,FW,Tottenham,Premier League,24,1993,34.2,17,12,2,8,7,4,15,26.7,11,15,4,11,5,22,19,0,0,2017-2018,0.14619883040935672,0.49707602339181284
1247,Wilfried Kanga,CIV,"FW,MF",Angers,Ligue 1,19,1998,1.9,2,2,0,2,0,0,2,0.0,2,0,0,0,0,2,1,0,0,2017-2018,0.0,1.0526315789473684
1248,Mamadou Kanouté,SEN,"FW,MF",Benevento,Serie A,23,1993,0.4,0,0,0,0,0,0,0,0.0,0,0,0,0,1,1,1,0,0,2017-2018,2.5,0.0
1249,N'Golo Kanté,FRA,MF,Chelsea,Premier League,26,1991,33.3,113,77,55,52,6,33,92,35.9,59,40,4,36,85,198,29,3,0,2017-2018,2.552552552552553,3.3933933933933935
1250,Bartosz Kapustka,POL,"FW,MF",Freiburg,Bundesliga,20,1996,2.6,9,5,2,6,1,4,6,66.7,2,4,0,4,3,12,0,0,0,2017-2018,1.1538461538461537,3.4615384615384612
1251,Kenan Karaman,TUR,"MF,FW",Hannover 96,Bundesliga,23,1994,9.5,16,13,9,6,1,6,7,85.7,1,10,4,6,1,17,17,0,0,2017-2018,0.10526315789473684,1.6842105263157894
1252,Yann Karamoh,FRA,"FW,MF",Inter,Serie A,19,1998,5.4,3,1,1,1,1,0,3,0.0,3,4,0,4,4,7,1,1,0,2017-2018,0.7407407407407407,0.5555555555555555
1253,Loris Karius,GER,GK,Liverpool,Premier League,24,1993,19.0,0,0,0,0,0,0,0,0.0,0,0,0,0,1,1,4,0,0,2017-2018,0.05263157894736842,0.0
1254,Orestis Karnezis,GRE,GK,Watford,Premier League,32,1985,14.4,0,0,0,0,0,0,2,0.0,2,0,0,0,1,1,3,3,0,2017-2018,0.06944444444444445,0.0
1255,Rick Karsdorp,NED,DF,Roma,Serie A,22,1995,0.9,1,1,1,0,0,0,0,0.0,0,0,0,0,1,2,0,0,0,2017-2018,1.1111111111111112,1.1111111111111112
1256,Aleksandar Katai,SRB,"MF,DF",Alavés,La Liga,26,1991,0.6,1,1,0,1,0,0,1,0.0,1,0,0,0,0,1,0,0,0,2017-2018,0.0,1.6666666666666667
1257,Florian Kath,GER,"FW,MF",Freiburg,Bundesliga,22,1994,7.5,15,10,3,9,3,9,17,52.9,8,9,0,9,8,23,1,0,0,2017-2018,1.0666666666666667,2.0
1258,Ole Käuper,GER,MF,Werder Bremen,Bundesliga,20,1997,0.8,6,5,2,4,0,1,4,25.0,3,1,0,1,2,8,0,0,0,2017-2018,2.5,7.5
1259,Eiji Kawashima,JPN,GK,Metz,Ligue 1,34,1983,28.5,1,1,1,0,0,1,3,33.3,2,0,0,0,3,4,9,2,0,2017-2018,0.10526315789473684,0.03508771929824561
1260,Beram Kayal,ISR,MF,Brighton,Premier League,29,1988,8.3,18,11,10,7,1,6,26,23.1,20,11,4,7,12,30,9,0,0,2017-2018,1.4457831325301203,2.1686746987951806
1261,Joris Kayembe,COD,"FW,MF",Nantes,Ligue 1,22,1994,1.0,1,0,1,0,0,0,4,0.0,4,0,0,0,0,1,4,0,0,2017-2018,0.0,1.0
1262,Olarenwaju Kayode,NGA,"FW,MF",Girona,La Liga,24,1993,4.3,3,3,1,2,0,0,4,0.0,4,1,0,1,1,4,0,0,0,2017-2018,0.23255813953488372,0.6976744186046512
1263,Moise Kean,ITA,FW,Hellas Verona,Serie A,17,2000,12.6,8,5,1,3,4,1,6,16.7,5,6,0,6,7,15,4,0,0,2017-2018,0.5555555555555556,0.6349206349206349
1264,Michael Keane,ENG,DF,Everton,Premier League,24,1993,28.4,33,25,26,5,2,19,43,44.2,24,39,28,11,53,86,214,0,0,2017-2018,1.8661971830985917,1.1619718309859155
1265,Thilo Kehrer,GER,DF,Schalke 04,Bundesliga,20,1996,26.3,81,64,41,36,4,46,68,67.6,22,42,12,30,35,116,113,2,0,2017-2018,1.3307984790874525,3.079847908745247
1266,Cheick Keita,MLI,DF,Bologna,Serie A,21,1996,1.4,2,2,1,1,0,1,3,33.3,2,5,0,5,2,4,1,0,0,2017-2018,1.4285714285714286,1.4285714285714286
1267,Naby Keïta,GUI,MF,RB Leipzig,Bundesliga,22,1995,21.8,65,48,25,33,7,17,43,39.5,26,26,3,23,36,101,18,0,0,2017-2018,1.6513761467889907,2.981651376146789
1268,Keko,ESP,"MF,FW",Málaga,La Liga,25,1991,13.4,38,23,17,13,8,15,47,31.9,32,25,3,22,13,51,9,0,0,2017-2018,0.9701492537313433,2.835820895522388
1269,Martin Kelly,ENG,DF,Crystal Palace,Premier League,27,1990,13.3,19,13,15,4,0,14,26,53.8,12,16,11,5,9,28,67,3,0,2017-2018,0.6766917293233082,1.4285714285714286
1270,Marc-Oliver Kempf,GER,DF,Freiburg,Bundesliga,22,1995,10.0,13,12,9,4,0,5,8,62.5,3,7,7,0,17,30,52,0,0,2017-2018,1.7,1.3
1271,Kenedy,BRA,"MF,DF",Newcastle Utd,Premier League,21,1996,11.4,31,17,16,13,2,12,35,34.3,23,12,1,11,14,45,11,0,0,2017-2018,1.2280701754385965,2.719298245614035
1272,Jonjoe Kenny,ENG,DF,Everton,Premier League,20,1997,17.7,41,33,28,10,3,20,32,62.5,12,17,7,10,28,69,95,0,0,2017-2018,1.5819209039548023,2.3163841807909606
1273,Ryan Kent,ENG,"FW,MF",Freiburg,Bundesliga,20,1996,2.7,4,3,2,1,1,2,5,40.0,3,6,0,6,1,5,1,0,0,2017-2018,0.37037037037037035,1.4814814814814814
1274,Christophe Kerbrat,FRA,DF,Guingamp,Ligue 1,30,1986,36.9,62,45,47,14,1,35,65,53.8,30,49,40,9,62,124,249,2,0,2017-2018,1.6802168021680217,1.6802168021680217
1275,Franck Kessié,CIV,MF,Milan,Serie A,20,1996,36.3,48,34,20,19,9,17,44,38.6,27,47,11,36,26,74,45,3,0,2017-2018,0.7162534435261708,1.322314049586777
1276,Billy Ketkeophomphone,LAO,MF,Angers,Ligue 1,27,1990,4.9,14,9,4,5,5,5,15,33.3,10,9,0,9,5,19,8,0,0,2017-2018,1.0204081632653061,2.8571428571428568
1277,Driss Khalid,MAR,FW,Toulouse,Ligue 1,18,1999,0.3,1,0,0,0,1,0,0,0.0,0,0,0,0,0,1,2,0,0,2017-2018,0.0,3.3333333333333335
1278,Saîf-Eddine Khaoui,TUN,"MF,FW",Troyes,Ligue 1,22,1995,21.7,57,25,22,27,8,15,50,30.0,35,12,2,10,27,84,9,0,0,2017-2018,1.2442396313364055,2.6267281105990783
1279,Wahbi Khazri,TUN,"FW,MF",Rennes,Ligue 1,26,1991,21.3,26,18,7,10,9,7,39,17.9,32,29,0,29,7,33,7,0,0,2017-2018,0.32863849765258213,1.220657276995305
1280,Rani Khedira,GER,"MF,DF",Augsburg,Bundesliga,23,1994,25.3,62,47,25,28,9,33,47,70.2,14,41,18,23,36,98,96,0,0,2017-2018,1.4229249011857708,2.450592885375494
1281,Sami Khedira,GER,MF,Juventus,Serie A,30,1987,21.2,14,9,1,9,4,2,23,8.7,21,13,3,10,20,34,20,0,0,2017-2018,0.9433962264150944,0.6603773584905661
1282,Stefan Kießling,GER,"DF,MF",Leverkusen,Bundesliga,33,1984,0.9,0,0,0,0,0,0,0,0.0,0,2,0,2,0,0,1,0,0,2017-2018,0.0,0.0
1283,Kiké,ESP,FW,Eibar,La Liga,27,1989,27.3,14,8,1,7,6,2,11,18.2,9,15,1,14,10,24,14,0,0,2017-2018,0.3663003663003663,0.5128205128205128
1284,Joshua Kimmich,GER,DF,Bayern Munich,Bundesliga,22,1995,25.9,32,23,14,13,5,20,38,52.6,18,26,5,21,20,52,40,0,0,2017-2018,0.7722007722007722,1.2355212355212355
1285,Presnel Kimpembe,FRA,DF,Paris S-G,Ligue 1,21,1995,26.9,39,28,20,18,1,9,14,64.3,5,17,10,7,24,63,80,1,0,2017-2018,0.892193308550186,1.449814126394052
1286,Andy King,WAL,MF,Leicester City,Premier League,28,1988,6.0,8,5,0,5,3,0,3,0.0,3,4,2,2,5,13,13,0,0,2017-2018,0.8333333333333334,1.3333333333333333
1287,Andy King,WAL,MF,Swansea City,Premier League,28,1988,7.9,18,11,10,8,0,5,14,35.7,9,7,0,7,6,24,14,1,0,2017-2018,0.7594936708860759,2.2784810126582276
1288,Joshua King,NOR,"FW,MF",Bournemouth,Premier League,25,1992,27.3,36,26,11,17,8,4,27,14.8,23,23,3,20,4,40,14,1,0,2017-2018,0.14652014652014653,1.3186813186813187
1289,Simon Kjær,DEN,DF,Sevilla,La Liga,28,1989,17.5,35,24,25,8,2,13,22,59.1,9,16,10,6,32,67,109,0,0,2017-2018,1.8285714285714285,2.0
1290,Davy Klaassen,NED,"MF,FW",Everton,Premier League,24,1993,2.8,3,1,1,2,0,2,6,33.3,4,2,1,1,1,4,2,0,0,2017-2018,0.35714285714285715,1.0714285714285714
1291,Felix Klaus,GER,"MF,FW",Hannover 96,Bundesliga,24,1992,22.0,48,38,20,21,7,23,50,46.0,27,29,4,25,8,56,28,0,0,2017-2018,0.36363636363636365,2.1818181818181817
1292,Ragnar Klavan,EST,DF,Liverpool,Premier League,31,1985,16.1,14,10,6,7,1,6,12,50.0,6,11,5,6,15,29,85,1,0,2017-2018,0.9316770186335402,0.8695652173913043
1293,Tim Kleindienst,GER,"FW,DF",Freiburg,Bundesliga,21,1995,12.6,22,15,6,12,4,4,17,23.5,13,17,3,14,6,28,21,0,0,2017-2018,0.4761904761904762,1.746031746031746
1294,Lukas Klostermann,GER,DF,RB Leipzig,Bundesliga,21,1996,24.3,56,41,34,18,4,28,37,75.7,9,33,6,27,33,89,79,0,0,2017-2018,1.3580246913580247,2.304526748971193
1295,Lukas Klünter,GER,"DF,FW",Köln,Bundesliga,21,1996,14.8,25,20,16,8,1,16,24,66.7,8,11,2,9,13,38,28,1,0,2017-2018,0.8783783783783783,1.689189189189189
1296,Robin Knoche,GER,DF,Wolfsburg,Bundesliga,25,1992,23.4,34,20,26,8,0,25,35,71.4,10,36,24,12,25,59,89,1,0,2017-2018,1.0683760683760684,1.4529914529914532
1297,Anthony Knockaert,FRA,"MF,FW",Brighton,Premier League,25,1991,26.9,39,26,25,11,3,16,55,29.1,39,29,3,26,23,62,16,0,0,2017-2018,0.8550185873605949,1.449814126394052
1298,Törles Knöll,GER,"MF,FW",Hamburger SV,Bundesliga,19,1997,0.2,0,0,0,0,0,0,0,0.0,0,1,0,1,0,0,0,0,0,2017-2018,0.0,0.0
1299,Robin Koch,GER,"MF,DF",Freiburg,Bundesliga,21,1996,21.3,34,24,21,13,0,10,18,55.6,8,27,11,16,35,69,67,0,0,2017-2018,1.6431924882629108,1.596244131455399
1300,Kenan Kodro,BIH,"FW,DF",Mainz 05,Bundesliga,23,1993,2.6,1,1,0,1,0,0,0,0.0,0,1,0,1,3,4,0,0,0,2017-2018,1.1538461538461537,0.3846153846153846
1301,Hervé Koffi,BFA,GK,Lille,Ligue 1,20,1996,4.0,0,0,0,0,0,0,0,0.0,0,0,0,0,1,1,1,1,0,2017-2018,0.25,0.0
1302,Dominik Kohr,GER,MF,Leverkusen,Bundesliga,23,1994,18.5,49,26,20,25,4,25,41,61.0,16,39,5,34,30,79,24,0,0,2017-2018,1.6216216216216217,2.6486486486486487
1303,Seybou Koita,NIG,FW,Amiens,Ligue 1,23,1994,2.4,1,1,1,0,0,1,1,100.0,0,0,0,0,0,1,2,0,0,2017-2018,0.0,0.4166666666666667
1304,Koke,ESP,MF,Atlético Madrid,La Liga,25,1992,30.6,75,45,31,32,12,27,95,28.4,68,40,3,37,24,99,38,0,0,2017-2018,0.7843137254901961,2.4509803921568625
1305,Aleksandar Kolarov,SRB,DF,Roma,Serie A,31,1985,34.0,58,47,34,16,8,27,49,55.1,22,24,7,17,53,111,100,2,0,2017-2018,1.5588235294117647,1.7058823529411764
1306,Sead Kolašinac,BIH,DF,Arsenal,Premier League,24,1993,23.9,49,37,28,13,8,20,39,51.3,19,15,3,12,26,75,56,0,0,2017-2018,1.087866108786611,2.0502092050209204
1307,Vincent Kompany,BEL,DF,Manchester City,Premier League,31,1986,15.5,20,11,14,5,1,13,19,68.4,6,10,8,2,16,36,73,1,0,2017-2018,1.032258064516129,1.2903225806451613
1308,Ibrahima Konaté,FRA,DF,RB Leipzig,Bundesliga,18,1999,13.6,32,25,20,12,0,18,23,78.3,5,14,3,11,20,52,66,0,0,2017-2018,1.4705882352941178,2.3529411764705883
1309,Moussa Konaté,SEN,FW,Amiens,Ligue 1,24,1993,27.5,8,6,1,4,3,3,23,13.0,20,10,2,8,3,11,11,0,0,2017-2018,0.10909090909090909,0.2909090909090909
1310,Geoffrey Kondogbia,CTA,MF,Valencia,La Liga,24,1993,29.0,88,57,38,43,7,23,68,33.8,45,46,14,32,62,150,66,0,0,2017-2018,2.1379310344827585,3.0344827586206895
1311,Bakary Koné,BFA,DF,Strasbourg,Ligue 1,29,1988,27.4,26,17,23,3,0,12,31,38.7,19,20,10,10,33,59,122,2,0,2017-2018,1.2043795620437956,0.9489051094890512
1312,Terence Kongolo,NED,DF,Huddersfield,Premier League,23,1994,11.7,33,20,19,13,1,14,22,63.6,8,12,6,6,32,65,71,0,0,2017-2018,2.735042735042735,2.8205128205128207
1313,Terence Kongolo,NED,DF,Monaco,Ligue 1,23,1994,2.9,6,4,4,2,0,0,2,0.0,2,5,3,2,5,11,14,0,0,2017-2018,1.7241379310344829,2.0689655172413794
1314,Yevhen Konoplyanka,UKR,"FW,MF",Schalke 04,Bundesliga,27,1989,17.4,11,9,3,4,4,3,11,27.3,8,18,1,17,5,16,6,0,0,2017-2018,0.2873563218390805,0.632183908045977
1315,Julian Korb,GER,"DF,MF",Hannover 96,Bundesliga,25,1992,26.0,52,41,27,19,6,37,68,54.4,31,30,2,28,22,74,77,0,0,2017-2018,0.8461538461538461,2.0
1316,Laurent Koscielny,FRA,DF,Arsenal,Premier League,31,1985,24.7,43,21,27,12,4,19,33,57.6,14,28,15,13,54,97,138,3,0,2017-2018,2.1862348178137654,1.7408906882591093
1317,Filip Kostić,SRB,"FW,MF",Hamburger SV,Bundesliga,24,1992,27.1,48,38,16,21,11,20,41,48.8,21,42,1,41,10,58,12,0,0,2017-2018,0.36900369003690037,1.7712177121771218
1318,Christian Kouakou,CIV,"MF,FW",Caen,Ligue 1,26,1991,9.4,24,13,14,8,2,5,19,26.3,14,16,1,15,8,32,6,1,0,2017-2018,0.851063829787234,2.553191489361702
1319,Rominigue Kouamé,MLI,"DF,MF",Lille,Ligue 1,20,1996,2.2,5,2,2,2,1,2,3,66.7,1,1,0,1,5,10,0,0,0,2017-2018,2.2727272727272725,2.2727272727272725
1320,Tomáš Koubek,CZE,GK,Rennes,Ligue 1,24,1992,34.0,0,0,0,0,0,0,1,0.0,1,0,0,0,3,3,22,3,0,2017-2018,0.08823529411764706,0.0
1321,Kalidou Koulibaly,SEN,DF,Napoli,Serie A,26,1991,34.1,54,42,31,19,4,20,40,50.0,20,36,16,20,40,94,119,3,0,2017-2018,1.1730205278592374,1.5835777126099706
1322,Jules Koundé,FRA,DF,Bordeaux,Ligue 1,18,1998,17.7,26,19,19,7,0,13,17,76.5,4,14,11,3,14,40,97,0,0,2017-2018,0.7909604519774012,1.4689265536723164
1323,Cheikhou Kouyaté,SEN,MF,West Ham,Premier League,27,1989,31.1,71,49,43,26,2,23,62,37.1,39,31,11,20,32,103,56,1,0,2017-2018,1.0289389067524115,2.282958199356913
1324,Mateo Kovačić,CRO,MF,Real Madrid,La Liga,23,1994,11.0,37,27,19,18,0,8,27,29.6,19,9,4,5,5,42,5,0,0,2017-2018,0.45454545454545453,3.3636363636363638
1325,Maksym Koval,UKR,GK,La Coruña,La Liga,24,1992,1.3,0,0,0,0,0,0,0,0.0,0,0,0,0,0,0,0,2,0,2017-2018,0.0,0.0
1326,Dawid Kownacki,POL,FW,Sampdoria,Serie A,20,1997,9.1,8,7,1,4,3,3,11,27.3,8,7,0,7,1,9,5,0,0,2017-2018,0.10989010989010989,0.8791208791208791
1327,Vincent Koziello,FRA,MF,Nice,Ligue 1,21,1995,9.0,16,8,9,5,2,5,16,31.3,11,8,3,5,19,35,7,1,0,2017-2018,2.111111111111111,1.7777777777777777
1328,Vincent Koziello,FRA,MF,Köln,Bundesliga,21,1995,8.8,28,21,6,21,1,10,21,47.6,11,9,0,9,10,38,5,1,0,2017-2018,1.1363636363636362,3.1818181818181817
1329,Thomas Kraft,GER,GK,Hertha BSC,Bundesliga,29,1988,3.0,0,0,0,0,0,0,0,0.0,0,0,0,0,0,0,1,0,0,2017-2018,0.0,0.0
1330,Emil Krafth,SWE,DF,Bologna,Serie A,22,1994,10.5,23,16,14,8,1,10,19,52.6,9,12,4,8,16,39,39,1,0,2017-2018,1.5238095238095237,2.1904761904761907
1331,Oliver Kragl,GER,MF,Crotone,Serie A,27,1990,1.1,1,0,0,1,0,0,0,0.0,0,1,0,1,2,3,2,0,0,2017-2018,1.8181818181818181,0.9090909090909091
1332,Andrej Kramarić,CRO,"FW,MF",Hoffenheim,Bundesliga,26,1991,24.8,8,6,4,3,1,3,8,37.5,5,15,0,15,6,14,7,0,0,2017-2018,0.24193548387096772,0.3225806451612903
1333,Christoph Kramer,GER,MF,Gladbach,Bundesliga,26,1991,23.9,89,70,43,34,12,39,76,51.3,37,29,4,25,43,132,37,1,0,2017-2018,1.7991631799163181,3.7238493723849375
1334,Ladislav Krejčí,CZE,"MF,FW",Bologna,Serie A,25,1992,4.4,7,5,1,3,3,1,5,20.0,4,3,0,3,2,9,3,0,0,2017-2018,0.45454545454545453,1.5909090909090908
1335,Rene Krhin,SVN,MF,Nantes,Ligue 1,27,1990,14.6,18,12,7,11,0,3,17,17.6,14,11,2,9,16,34,39,0,0,2017-2018,1.095890410958904,1.2328767123287672
1336,Bojan Krkić,ESP,MF,Stoke City,Premier League,26,1990,0.8,0,0,0,0,0,0,1,0.0,1,1,0,1,0,0,0,0,0,2017-2018,0.0,0.0
1337,Bojan Krkić,ESP,"FW,MF",Alavés,La Liga,26,1990,4.9,2,1,1,1,0,1,2,50.0,1,5,0,5,3,5,0,0,0,2017-2018,0.6122448979591836,0.4081632653061224
1338,Michael Krohn-Dehli,DEN,MF,La Coruña,La Liga,34,1983,8.1,12,9,6,5,1,4,17,23.5,13,2,0,2,13,25,7,0,0,2017-2018,1.6049382716049383,1.4814814814814816
1339,Michael Krohn-Dehli,DEN,"MF,FW",Sevilla,La Liga,34,1983,6.0,13,7,4,5,4,6,11,54.5,5,5,0,5,4,17,7,0,0,2017-2018,0.6666666666666666,2.1666666666666665
1340,Toni Kroos,GER,MF,Real Madrid,La Liga,27,1990,25.1,55,35,19,29,7,22,59,37.3,37,20,2,18,16,71,10,1,0,2017-2018,0.6374501992031872,2.191235059760956
1341,Max Kruse,GER,FW,Werder Bremen,Bundesliga,29,1988,27.3,17,12,3,10,4,5,22,22.7,17,9,0,9,11,28,4,1,0,2017-2018,0.40293040293040294,0.6227106227106227
1342,Grzegorz Krychowiak,POL,MF,West Brom,Premier League,27,1990,18.2,39,24,18,17,4,12,49,24.5,37,23,5,18,45,84,23,0,0,2017-2018,2.4725274725274726,2.142857142857143
1343,Lukas Kübler,GER,"DF,MF",Freiburg,Bundesliga,24,1992,12.8,31,19,16,15,0,13,23,56.5,10,15,6,9,18,49,41,0,0,2017-2018,1.40625,2.421875
1344,Jasmin Kurtić,SVN,"MF,FW",SPAL,Serie A,28,1989,16.0,28,18,13,11,4,5,21,23.8,16,13,1,12,17,45,25,0,0,2017-2018,1.0625,1.75
1345,Jasmin Kurtić,SVN,MF,Atalanta,Serie A,28,1989,7.4,12,7,6,3,3,3,7,42.9,4,7,0,7,5,17,4,0,0,2017-2018,0.6756756756756757,1.6216216216216215
1346,Layvin Kurzawa,FRA,DF,Paris S-G,Ligue 1,24,1992,18.9,44,32,20,15,9,15,39,38.5,24,16,3,13,35,79,41,2,0,2017-2018,1.851851851851852,2.3280423280423284
1347,Filip Kusić,SRB,"DF,MF",Köln,Bundesliga,21,1996,0.2,0,0,0,0,0,0,0,0.0,0,0,0,0,0,0,1,0,0,2017-2018,0.0,0.0
1348,Zdravko Kuzmanović,SRB,MF,Málaga,La Liga,29,1987,5.3,4,4,1,3,0,0,5,0.0,5,2,2,0,4,8,9,0,0,2017-2018,0.7547169811320755,0.7547169811320755
1349,Han Kwang-song,PRK,FW,Cagliari,Serie A,18,1998,3.1,1,1,0,0,1,0,4,0.0,4,4,0,4,0,1,0,0,0,2017-2018,0.0,0.3225806451612903
1350,Enock Kwateng,FRA,DF,Nantes,Ligue 1,20,1997,1.0,8,6,6,2,0,7,11,63.6,4,2,0,2,1,9,7,0,0,2017-2018,1.0,8.0
1351,Alberto de la Bella,ESP,DF,Real Sociedad,La Liga,31,1985,17.0,36,22,25,10,1,16,28,57.1,12,19,5,14,21,57,54,0,0,2017-2018,1.2352941176470589,2.1176470588235294
1352,Rajiv van La Parra,NED,"FW,MF",Huddersfield,Premier League,26,1991,23.7,41,29,18,15,8,12,41,29.3,29,27,1,26,21,62,8,1,0,2017-2018,0.8860759493670887,1.729957805907173
1353,Brighton Labeau,MTQ,FW,Amiens,Ligue 1,21,1996,0.3,0,0,0,0,0,0,0,0.0,0,0,0,0,0,0,0,0,0,2017-2018,0.0,0.0
1354,Gaëtan Laborde,FRA,FW,Bordeaux,Ligue 1,23,1994,10.6,9,7,1,6,2,2,7,28.6,5,8,2,6,1,10,7,1,0,2017-2018,0.09433962264150944,0.8490566037735849
1355,Alexandre Lacazette,FRA,FW,Arsenal,Premier League,26,1991,24.5,24,17,6,11,7,4,27,14.8,23,19,3,16,7,31,5,0,0,2017-2018,0.2857142857142857,0.9795918367346939
1356,Mehdi Lacen,ALG,MF,Málaga,La Liga,33,1984,11.7,35,19,18,17,0,14,38,36.8,24,13,1,12,15,50,11,0,0,2017-2018,1.2820512820512822,2.9914529914529915
1357,Mehdi Lacen,ALG,MF,Getafe,La Liga,33,1984,0.7,3,1,2,1,0,0,0,0.0,0,1,0,1,0,3,1,0,0,2017-2018,0.0,4.285714285714286
1358,Léo Lacroix,SUI,DF,Saint-Étienne,Ligue 1,25,1992,8.6,13,8,8,5,0,5,9,55.6,4,6,3,3,11,24,54,1,0,2017-2018,1.2790697674418605,1.5116279069767442
1359,Freddie Ladapo,ENG,FW,Crystal Palace,Premier League,24,1993,0.2,0,0,0,0,0,0,0,0.0,0,0,0,0,0,0,0,0,0,2017-2018,0.0,0.0
1360,Alban Lafont,FRA,GK,Toulouse,Ligue 1,18,1999,38.0,1,0,1,0,0,1,4,25.0,3,0,0,0,2,3,20,5,0,2017-2018,0.05263157894736842,0.02631578947368421
1361,Víctor Laguardia,ESP,DF,Alavés,La Liga,27,1989,17.0,20,15,13,5,2,11,19,57.9,8,23,14,9,29,49,109,0,0,2017-2018,1.7058823529411764,1.1764705882352942
1362,Konrad Laimer,AUT,"DF,MF",RB Leipzig,Bundesliga,20,1997,14.9,57,39,31,22,4,28,57,49.1,29,37,2,35,11,68,32,0,0,2017-2018,0.7382550335570469,3.825503355704698
1363,Kenny Lala,MAD,DF,Strasbourg,Ligue 1,25,1991,30.3,87,47,53,28,6,21,47,44.7,26,18,10,8,42,129,70,2,0,2017-2018,1.386138613861386,2.871287128712871
1364,Adam Lallana,ENG,"MF,FW",Liverpool,Premier League,29,1988,3.4,3,1,3,0,0,2,10,20.0,8,3,0,3,1,4,1,0,0,2017-2018,0.29411764705882354,0.8823529411764706
1365,Eugenio Lamanna,ITA,GK,Genoa,Serie A,27,1989,1.0,0,0,0,0,0,0,0,0.0,0,0,0,0,0,0,1,0,0,2017-2018,0.0,0.0
1366,Érik Lamela,ARG,"FW,MF",Tottenham,Premier League,25,1992,9.4,23,13,9,7,7,3,20,15.0,17,11,1,10,7,30,5,0,0,2017-2018,0.7446808510638298,2.4468085106382977
1367,Ádám Lang,HUN,DF,Dijon,Ligue 1,24,1993,2.6,3,1,3,0,0,3,5,60.0,2,2,1,1,3,6,12,0,0,2017-2018,1.1538461538461537,1.1538461538461537
1368,Sebastian Langkamp,GER,DF,Hertha BSC,Bundesliga,29,1988,10.6,15,12,9,6,0,11,18,61.1,7,7,4,3,21,36,58,1,0,2017-2018,1.9811320754716981,1.4150943396226416
1369,Sebastian Langkamp,GER,DF,Werder Bremen,Bundesliga,29,1988,4.6,7,3,4,3,0,4,4,100.0,0,7,5,2,8,15,18,0,0,2017-2018,1.7391304347826089,1.5217391304347827
1370,Manuel Lanzini,ARG,"MF,FW",West Ham,Premier League,24,1993,22.7,20,11,6,11,3,2,34,5.9,32,7,1,6,30,50,5,2,0,2017-2018,1.3215859030837005,0.881057268722467
1371,Gianluca Lapadula,PER,FW,Genoa,Serie A,27,1990,16.6,8,5,4,4,0,1,11,9.1,10,7,1,6,3,11,8,0,0,2017-2018,0.18072289156626503,0.48192771084337344
1372,Aymeric Laporte,ESP,DF,Manchester City,Premier League,23,1994,9.0,8,7,6,2,0,3,8,37.5,5,2,1,1,11,19,27,0,0,2017-2018,1.2222222222222223,0.8888888888888888
1373,Aymeric Laporte,ESP,DF,Athletic Club,La Liga,23,1994,19.0,38,23,27,11,0,14,25,56.0,11,19,13,6,27,65,94,1,0,2017-2018,1.4210526315789473,2.0
1374,Danilo Larangeira,BRA,DF,Udinese,Serie A,33,1984,30.8,35,21,26,8,1,16,29,55.2,13,50,38,12,50,85,161,2,0,2017-2018,1.6233766233766234,1.1363636363636362
1375,Kevin Lasagna,ITA,FW,Udinese,Serie A,24,1992,23.7,10,7,0,8,2,2,7,28.6,5,27,4,23,8,18,18,0,0,2017-2018,0.33755274261603374,0.4219409282700422
1376,Jamaal Lascelles,ENG,DF,Newcastle Utd,Premier League,23,1993,32.5,31,19,19,11,1,12,19,63.2,7,33,24,9,28,59,232,1,0,2017-2018,0.8615384615384616,0.9538461538461539
1377,Paul Lasne,FRA,MF,Montpellier,Ligue 1,28,1989,34.0,68,45,27,39,2,12,54,22.2,42,20,1,19,57,125,26,0,0,2017-2018,1.6764705882352942,2.0
1378,Borja Lasso,ESP,MF,Sevilla,La Liga,23,1994,0.6,4,1,2,2,0,1,2,50.0,1,3,0,3,0,4,0,0,0,2017-2018,0.0,6.666666666666667
1379,Toni Lato,ESP,"DF,MF",Valencia,La Liga,19,1997,8.9,30,16,22,6,2,16,27,59.3,11,9,3,6,9,39,23,0,0,2017-2018,1.0112359550561798,3.3707865168539324
1380,Danny Latza,GER,MF,Mainz 05,Bundesliga,27,1989,26.1,67,48,28,33,6,33,73,45.2,40,43,8,35,26,93,47,1,0,2017-2018,0.9961685823754789,2.5670498084291187
1381,Vincent Laurini,FRA,DF,Fiorentina,Serie A,28,1989,17.9,34,23,21,9,4,12,22,54.5,10,20,5,15,11,45,72,1,0,2017-2018,0.6145251396648045,1.8994413407821231
1382,Wesley Lautoa,NCL,"DF,MF",Dijon,Ligue 1,29,1987,6.9,17,13,11,6,0,6,12,50.0,6,10,4,6,19,36,24,1,0,2017-2018,2.753623188405797,2.463768115942029
1383,Diego Laxalt,URU,DF,Genoa,Serie A,24,1993,31.2,54,43,31,17,6,22,59,37.3,37,38,3,35,25,79,55,1,0,2017-2018,0.8012820512820513,1.7307692307692308
1384,Miguel Layún,MEX,DF,Sevilla,La Liga,29,1988,13.2,28,19,14,12,2,17,36,47.2,19,18,4,14,15,43,44,1,0,2017-2018,1.1363636363636365,2.121212121212121
1385,Achraf Lazaar,MAR,"MF,DF",Benevento,Serie A,25,1992,5.3,12,8,9,2,1,5,11,45.5,6,5,1,4,6,18,10,0,0,2017-2018,1.1320754716981132,2.2641509433962264
1386,Valentino Lazaro,AUT,"MF,FW",Hertha BSC,Bundesliga,21,1996,20.7,33,28,11,12,10,15,31,48.4,16,35,2,33,15,48,32,0,0,2017-2018,0.7246376811594203,1.5942028985507246
1387,Darko Lazović,SRB,"DF,MF",Genoa,Serie A,26,1990,13.8,19,12,16,2,1,9,18,50.0,9,8,0,8,13,32,12,0,0,2017-2018,0.9420289855072463,1.3768115942028984
1388,Manuel Lazzari,ITA,DF,SPAL,Serie A,23,1993,34.6,61,47,33,21,7,27,62,43.5,35,32,7,25,31,92,73,2,0,2017-2018,0.8959537572254335,1.7630057803468207
1389,Mickaël Le Bihan,FRA,"FW,MF",Nice,Ligue 1,27,1990,1.2,0,0,0,0,0,0,3,0.0,3,0,0,0,1,1,0,0,0,2017-2018,0.8333333333333334,0.0
1390,Maxime Le Marchand,FRA,DF,Nice,Ligue 1,27,1989,28.2,48,36,28,18,2,20,41,48.8,21,36,13,23,65,113,105,4,0,2017-2018,2.3049645390070923,1.702127659574468
1391,James Lea Siliki,CMR,MF,Rennes,Ligue 1,21,1996,20.2,31,21,9,19,3,6,41,14.6,35,21,1,20,18,49,14,1,0,2017-2018,0.8910891089108911,1.5346534653465347
1392,Mathew Leckie,AUS,"FW,MF",Hertha BSC,Bundesliga,26,1991,20.6,35,30,16,15,4,20,35,57.1,15,26,3,23,19,54,32,1,0,2017-2018,0.9223300970873786,1.6990291262135921
1393,Benjamin Lecomte,FRA,GK,Montpellier,Ligue 1,26,1991,38.0,1,1,1,0,0,0,0,0.0,0,1,0,1,0,1,14,1,0,2017-2018,0.0,0.02631578947368421
1394,Pierre Lees-Melou,FRA,"MF,FW",Nice,Ligue 1,24,1993,32.1,78,47,29,39,10,27,76,35.5,49,52,11,41,34,112,38,2,0,2017-2018,1.0591900311526479,2.4299065420560746
1395,Matthias Lehmann,GER,MF,Köln,Bundesliga,34,1983,16.8,33,23,14,18,1,17,29,58.6,12,15,7,8,26,59,24,1,0,2017-2018,1.5476190476190474,1.9642857142857142
1396,Lucas Leiva,BRA,MF,Lazio,Serie A,30,1987,32.0,107,80,43,59,5,29,100,29.0,71,33,7,26,70,177,59,0,0,2017-2018,2.1875,3.34375
1397,Florian Lejeune,FRA,DF,Newcastle Utd,Premier League,26,1991,23.4,34,20,26,8,0,14,30,46.7,16,21,15,6,46,80,154,0,0,2017-2018,1.965811965811966,1.4529914529914532
1398,Iñigo Lekue,ESP,"DF,FW",Athletic Club,La Liga,24,1993,23.5,71,42,37,26,8,34,53,64.2,19,29,3,26,16,87,46,1,0,2017-2018,0.6808510638297872,3.021276595744681
1399,Thomas Lemar,FRA,"MF,FW",Monaco,Ligue 1,21,1995,26.4,33,17,9,19,5,10,41,24.4,31,22,1,21,18,51,16,1,0,2017-2018,0.6818181818181819,1.25
1400,Mario Lemina,GAB,MF,Southampton,Premier League,23,1993,19.1,55,40,21,29,5,12,30,40.0,18,18,6,12,36,91,36,4,0,2017-2018,1.8848167539267013,2.8795811518324603
1401,Mauricio Lemos,URU,DF,Sassuolo,Serie A,21,1995,7.8,11,9,8,3,0,7,14,50.0,7,10,5,5,9,20,33,1,0,2017-2018,1.153846153846154,1.4102564102564104
1402,Mauricio Lemos,URU,"DF,MF",Las Palmas,La Liga,21,1995,14.0,22,10,17,5,0,15,27,55.6,12,16,13,3,25,47,51,1,0,2017-2018,1.7857142857142858,1.5714285714285714
1403,Dylan Lempereur,FRA,DF,Metz,Ligue 1,18,1998,1.6,5,3,3,1,1,2,6,33.3,4,1,0,1,0,5,6,0,0,2017-2018,0.0,3.125
1404,Clément Lenglet,FRA,DF,Sevilla,La Liga,22,1995,33.3,67,50,32,35,0,21,38,55.3,17,44,27,17,35,102,157,1,0,2017-2018,1.0510510510510511,2.012012012012012
1405,Aaron Lennon,ENG,MF,Burnley,Premier League,30,1987,12.4,20,14,5,14,1,2,20,10.0,18,20,5,15,8,28,18,0,0,2017-2018,0.6451612903225806,1.6129032258064515
1406,Aaron Lennon,ENG,"FW,MF",Everton,Premier League,30,1987,8.8,17,10,10,5,2,5,21,23.8,16,13,1,12,11,28,9,0,0,2017-2018,1.25,1.9318181818181817
1407,Bernd Leno,GER,GK,Leverkusen,Bundesliga,25,1992,33.0,0,0,0,0,0,0,1,0.0,1,0,0,0,1,1,11,2,0,2017-2018,0.030303030303030304,0.0
1408,Pedro León,ESP,"FW,MF",Eibar,La Liga,30,1986,10.3,9,4,0,2,7,0,4,0.0,4,18,2,16,9,18,5,0,0,2017-2018,0.8737864077669902,0.8737864077669902
1409,Sergio León,ESP,FW,Betis,La Liga,28,1989,22.0,13,7,3,6,4,3,11,27.3,8,12,1,11,6,19,5,0,0,2017-2018,0.2727272727272727,0.5909090909090909
1410,Lukas Lerager,DEN,MF,Bordeaux,Ligue 1,24,1993,36.5,107,74,33,61,13,33,107,30.8,74,44,8,36,67,174,66,1,0,2017-2018,1.8356164383561644,2.9315068493150687
1411,Mehdi Léris,ALG,"MF,FW",Chievo,Serie A,19,1998,0.5,1,1,1,0,0,0,1,0.0,1,0,0,0,1,2,0,0,0,2017-2018,2.0,2.0
1412,Jefferson Lerma,COL,MF,Levante,La Liga,22,1994,23.7,51,35,26,23,2,17,45,37.8,28,25,10,15,49,100,43,0,0,2017-2018,2.067510548523207,2.151898734177215
1413,Maxime Lestienne,BEL,MF,Málaga,La Liga,25,1992,7.4,8,5,5,0,3,3,15,20.0,12,7,1,6,6,14,6,0,0,2017-2018,0.8108108108108107,1.081081081081081
1414,Alexandre Letellier,FRA,GK,Angers,Ligue 1,26,1990,13.0,0,0,0,0,0,0,0,0.0,0,0,0,0,0,0,1,2,0,2017-2018,0.0,0.0
1415,Gaetano Letizia,ITA,DF,Benevento,Serie A,27,1990,23.8,36,26,21,14,1,19,49,38.8,30,24,3,21,33,69,47,3,0,2017-2018,1.3865546218487395,1.5126050420168067
1416,Timo Letschert,NED,DF,Sassuolo,Serie A,24,1993,4.6,13,8,10,3,0,5,8,62.5,3,9,3,6,7,20,23,0,0,2017-2018,1.5217391304347827,2.8260869565217392
1417,Robert Lewandowski,POL,FW,Bayern Munich,Bundesliga,28,1988,24.1,5,3,1,1,3,0,3,0.0,3,6,0,6,5,10,10,0,0,2017-2018,0.20746887966804978,0.20746887966804978
1418,Igor Lewczuk,POL,DF,Bordeaux,Ligue 1,32,1985,4.9,9,7,5,3,1,3,6,50.0,3,2,2,0,7,16,11,0,0,2017-2018,1.4285714285714284,1.8367346938775508
1419,Stephan Lichtsteiner,SUI,DF,Juventus,Serie A,33,1984,18.9,31,27,16,10,5,9,17,52.9,8,11,2,9,15,46,38,1,0,2017-2018,0.7936507936507937,1.6402116402116402
1420,Dimitri Liénard,FRA,"MF,FW",Strasbourg,Ligue 1,29,1988,28.9,77,51,37,32,8,30,84,35.7,54,35,2,33,52,129,41,1,0,2017-2018,1.7993079584775087,2.6643598615916955
1421,Philipp Lienhart,AUT,DF,Freiburg,Bundesliga,21,1996,9.6,16,14,12,4,0,6,17,35.3,11,14,9,5,11,27,60,0,0,2017-2018,1.1458333333333335,1.6666666666666667
1422,Lucas Lima,BRA,"DF,FW",Nantes,Ligue 1,25,1991,29.5,73,46,40,27,6,31,68,45.6,37,42,6,36,38,111,85,0,0,2017-2018,1.2881355932203389,2.4745762711864407
1423,Victor Lindelöf,SWE,DF,Manchester Utd,Premier League,23,1994,14.3,17,11,10,6,1,9,14,64.3,5,15,11,4,13,30,67,1,0,2017-2018,0.9090909090909091,1.1888111888111887
1424,Karol Linetty,POL,MF,Sampdoria,Serie A,22,1995,23.8,66,49,25,31,10,17,77,22.1,60,40,2,38,18,84,13,0,0,2017-2018,0.7563025210084033,2.773109243697479
1425,Jesse Lingard,ENG,"MF,FW",Manchester Utd,Premier League,24,1992,20.2,30,21,10,13,7,5,27,18.5,22,18,3,15,9,39,13,0,0,2017-2018,0.44554455445544555,1.4851485148514851
1426,Pol Lirola,ESP,"DF,FW",Sassuolo,Serie A,19,1997,22.5,34,21,26,6,2,20,35,57.1,15,11,4,7,28,62,88,1,0,2017-2018,1.2444444444444445,1.511111111111111
1427,Jake Livermore,ENG,MF,West Brom,Premier League,27,1989,29.7,72,41,27,35,10,24,64,37.5,40,44,9,35,26,98,36,2,0,2017-2018,0.8754208754208754,2.4242424242424243
1428,Raúl Lizoain,ESP,GK,Las Palmas,La Liga,26,1991,11.0,1,0,1,0,0,1,3,33.3,2,0,0,0,1,2,2,3,0,2017-2018,0.09090909090909091,0.09090909090909091
1429,Adem Ljajić,SRB,"MF,FW",Torino,Serie A,25,1991,24.1,12,9,4,6,2,5,13,38.5,8,11,1,10,9,21,13,0,0,2017-2018,0.37344398340248963,0.49792531120331945
1430,Diego Llorente,ESP,DF,Real Sociedad,La Liga,23,1993,25.8,30,22,16,13,1,18,29,62.1,11,41,18,23,43,73,96,0,0,2017-2018,1.6666666666666665,1.1627906976744187
1431,Fernando Llorente,ESP,"FW,MF",Tottenham,Premier League,32,1985,2.6,6,3,1,2,3,1,2,50.0,1,0,0,0,0,6,6,0,0,2017-2018,0.0,2.3076923076923075
1432,Marcos Llorente,ESP,MF,Real Madrid,La Liga,22,1995,6.1,15,8,7,8,0,6,11,54.5,5,7,0,7,5,20,8,0,0,2017-2018,0.819672131147541,2.459016393442623
1433,Hugo Lloris,FRA,GK,Tottenham,Premier League,30,1986,36.0,1,1,1,0,0,1,4,25.0,3,0,0,0,2,3,34,8,0,2017-2018,0.05555555555555555,0.027777777777777776
1434,Giovani Lo Celso,ARG,MF,Paris S-G,Ligue 1,21,1996,19.7,77,58,26,36,15,26,74,35.1,48,30,5,25,19,96,12,1,0,2017-2018,0.9644670050761421,3.9086294416243654
1435,Simone Lo Faso,ITA,FW,Fiorentina,Serie A,19,1998,0.4,1,1,1,0,0,0,1,0.0,1,0,0,0,1,2,0,0,0,2017-2018,2.5,2.5
1436,Stanislav Lobotka,SVK,MF,Celta Vigo,La Liga,22,1994,34.0,64,45,24,35,5,23,65,35.4,42,25,9,16,39,103,22,0,0,2017-2018,1.1470588235294117,1.8823529411764706
1437,Jürgen Locadia,CUW,"FW,MF",Brighton,Premier League,23,1993,2.5,1,0,0,1,0,0,1,0.0,1,0,0,0,1,2,1,1,0,2017-2018,0.4,0.4
1438,Manuel Locatelli,ITA,MF,Milan,Serie A,19,1998,7.6,16,13,6,9,1,4,18,22.2,14,10,2,8,9,25,13,0,0,2017-2018,1.1842105263157896,2.1052631578947367
1439,Ruben Loftus-Cheek,ENG,MF,Crystal Palace,Premier League,21,1996,20.8,21,15,7,13,1,7,30,23.3,23,19,2,17,22,43,31,0,0,2017-2018,1.0576923076923077,1.0096153846153846
1440,Enzo Loiodice,FRA,MF,Dijon,Ligue 1,16,2000,1.9,9,5,4,5,0,4,7,57.1,3,0,0,0,2,11,0,0,0,2017-2018,1.0526315789473684,4.736842105263158
1441,Joe Lolley,ENG,"FW,MF",Huddersfield,Premier League,24,1992,2.5,2,0,1,1,0,0,2,0.0,2,0,0,0,3,5,2,1,0,2017-2018,1.2,0.8
1442,David Lombán,ESP,DF,Eibar,La Liga,30,1987,11.0,16,8,12,3,1,10,15,66.7,5,6,4,2,29,45,66,2,0,2017-2018,2.6363636363636362,1.4545454545454546
1443,Cristiano Lombardi,ITA,"MF,DF",Benevento,Serie A,21,1995,12.4,25,19,16,7,2,6,27,22.2,21,12,2,10,13,38,22,0,0,2017-2018,1.0483870967741935,2.0161290322580645
1444,Kevin Long,IRL,DF,Burnley,Premier League,26,1990,16.0,32,23,28,4,0,16,26,61.5,10,25,14,11,19,51,129,1,0,2017-2018,1.1875,2.0
1445,Shane Long,IRL,FW,Southampton,Premier League,30,1987,17.6,25,20,1,19,5,10,30,33.3,20,14,2,12,12,37,29,0,0,2017-2018,0.6818181818181818,1.4204545454545454
1446,Ademola Lookman,NGA,"FW,MF",Everton,Premier League,19,1997,1.8,1,1,0,1,0,0,2,0.0,2,2,0,2,1,2,3,0,0,2017-2018,0.5555555555555556,0.5555555555555556
1447,Ademola Lookman,NGA,"MF,FW",RB Leipzig,Bundesliga,19,1997,6.4,5,4,2,3,0,0,0,0.0,0,3,0,3,2,7,2,0,0,2017-2018,0.3125,0.78125
1448,Anthony Lopes,POR,GK,Lyon,Ligue 1,26,1990,34.0,0,0,0,0,0,0,0,0.0,0,0,0,0,1,1,17,4,0,2017-2018,0.029411764705882353,0.0
1449,Rony Lopes,POR,"FW,MF",Monaco,Ligue 1,21,1995,28.1,55,32,15,27,13,21,78,26.9,57,23,2,21,16,71,22,0,0,2017-2018,0.5693950177935942,1.9572953736654803
1450,Adrián López,ESP,"FW,MF",La Coruña,La Liga,29,1988,26.1,24,14,11,8,5,7,25,28.0,18,22,4,18,10,34,49,0,0,2017-2018,0.38314176245210724,0.9195402298850575
1451,Alberto López,ESP,DF,Málaga,La Liga,22,1995,0.5,1,1,0,1,0,1,1,100.0,0,1,0,1,2,3,2,0,0,2017-2018,4.0,2.0
1452,Andoni López,ESP,DF,Athletic Club,La Liga,21,1996,1.0,1,0,1,0,0,1,1,100.0,0,1,0,1,1,2,6,0,0,2017-2018,1.0,1.0
1453,David López,ESP,"DF,MF",Espanyol,La Liga,27,1989,37.0,67,49,47,19,1,27,54,50.0,27,43,26,17,67,134,161,0,0,2017-2018,1.8108108108108107,1.8108108108108107
1454,Diego López,ESP,GK,Espanyol,La Liga,35,1981,9.5,0,0,0,0,0,0,1,0.0,1,0,0,0,0,0,1,0,0,2017-2018,0.0,0.0
1455,Iván López,ESP,DF,Levante,La Liga,23,1993,1.9,1,1,1,0,0,0,0,0.0,0,2,2,0,8,9,2,0,0,2017-2018,4.2105263157894735,0.5263157894736842
1456,Javi López,ESP,DF,Espanyol,La Liga,31,1986,10.7,47,35,31,12,4,18,35,51.4,17,7,2,5,18,65,48,0,0,2017-2018,1.6822429906542058,4.392523364485982
1457,Lisandro López,ARG,DF,Inter,Serie A,27,1989,0.5,2,2,1,1,0,0,2,0.0,2,0,0,0,1,3,3,0,0,2017-2018,2.0,4.0
1458,Maxi López,ARG,FW,Udinese,Serie A,33,1984,18.7,12,8,2,7,3,0,4,0.0,4,8,2,6,2,14,18,0,0,2017-2018,0.10695187165775401,0.6417112299465241
1459,Maxime Lopez,FRA,"MF,FW",Marseille,Ligue 1,19,1997,15.3,30,20,12,12,6,12,56,21.4,44,16,2,14,7,37,6,1,0,2017-2018,0.45751633986928103,1.9607843137254901
1460,Pedro López Muñoz,ESP,DF,Levante,La Liga,33,1983,17.7,33,23,21,10,2,17,30,56.7,13,22,7,15,26,59,45,0,0,2017-2018,1.4689265536723164,1.864406779661017
1461,Pau López,ESP,GK,Espanyol,La Liga,22,1994,28.5,0,0,0,0,0,0,0,0.0,0,0,0,0,1,1,15,2,0,2017-2018,0.03508771929824561,0.0
1462,Pedro López,ESP,GK,Betis,La Liga,22,1995,4.6,0,0,0,0,0,0,0,0.0,0,1,0,1,0,0,3,0,0,2017-2018,0.0,0.0
1463,Víctor López,ESP,MF,Alavés,La Liga,20,1997,0.7,2,1,0,2,0,0,1,0.0,1,0,0,0,1,3,1,0,0,2017-2018,1.4285714285714286,2.857142857142857
1464,Jonas Lössl,DEN,GK,Huddersfield,Premier League,28,1989,38.0,1,0,1,0,0,1,5,20.0,4,0,0,0,4,5,13,6,0,2017-2018,0.10526315789473684,0.02631578947368421
1465,Dejan Lovren,CRO,DF,Liverpool,Premier League,28,1989,23.6,26,17,14,11,1,12,22,54.5,10,26,15,11,38,64,146,2,0,2017-2018,1.6101694915254237,1.1016949152542372
1466,Chris Löwe,GER,DF,Huddersfield,Premier League,28,1989,17.6,43,29,26,15,2,20,44,45.5,24,21,8,13,34,77,65,3,0,2017-2018,1.9318181818181817,2.443181818181818
1467,Matthew Lowton,ENG,DF,Burnley,Premier League,28,1989,25.5,55,34,26,27,2,28,60,46.7,32,35,15,20,39,94,141,2,0,2017-2018,1.5294117647058822,2.156862745098039
1468,Anthony Lozano,HON,"FW,MF",Girona,La Liga,24,1993,5.2,9,5,2,7,0,1,5,20.0,4,3,0,3,3,12,2,0,0,2017-2018,0.5769230769230769,1.7307692307692306
1469,Fabio Lucioni,ITA,DF,Benevento,Serie A,29,1987,8.0,11,9,7,4,0,7,11,63.6,4,14,11,3,7,18,61,0,0,2017-2018,0.875,1.375
1470,Filipe Luís,BRA,DF,Atlético Madrid,La Liga,31,1985,18.4,83,52,41,33,9,36,49,73.5,13,27,7,20,35,118,34,0,0,2017-2018,1.9021739130434785,4.510869565217392
1471,José Luis Gayà,ESP,DF,Valencia,La Liga,22,1995,32.4,77,60,52,22,3,43,68,63.2,25,43,12,31,56,133,90,1,0,2017-2018,1.7283950617283952,2.376543209876543
1472,José Luis Morales,ESP,"MF,FW",Levante,La Liga,30,1987,34.0,37,23,15,15,7,13,65,20.0,52,28,0,28,26,63,20,0,0,2017-2018,0.7647058823529411,1.088235294117647
1473,José Luis Palomino,ARG,DF,Atalanta,Serie A,27,1990,22.0,60,39,36,19,5,24,51,47.1,27,36,21,15,39,99,111,1,0,2017-2018,1.7727272727272727,2.727272727272727
1474,Luisinho,POR,DF,La Coruña,La Liga,32,1985,29.1,111,77,64,40,7,65,96,67.7,31,24,4,20,55,166,113,0,0,2017-2018,1.8900343642611683,3.8144329896907214
1475,David Luiz,BRA,"DF,MF",Chelsea,Premier League,30,1987,9.3,18,11,13,4,1,11,21,52.4,10,9,5,4,24,42,45,2,0,2017-2018,2.5806451612903225,1.9354838709677418
1476,Douglas Luiz,BRA,"MF,FW",Girona,La Liga,19,1998,3.4,10,9,4,6,0,3,11,27.3,8,1,0,1,4,14,0,0,0,2017-2018,1.1764705882352942,2.9411764705882355
1477,Everton Luiz,BRA,MF,SPAL,Serie A,29,1988,7.1,22,16,10,10,2,6,29,20.7,23,8,1,7,10,32,8,1,0,2017-2018,1.4084507042253522,3.098591549295775
1478,Jordan Lukaku,BEL,DF,Lazio,Serie A,23,1994,15.1,28,15,14,11,3,10,16,62.5,6,14,2,12,15,43,23,0,0,2017-2018,0.9933774834437087,1.8543046357615895
1479,Romelu Lukaku,BEL,FW,Manchester Utd,Premier League,24,1993,31.9,7,4,1,3,3,0,13,0.0,13,9,2,7,3,10,22,2,0,2017-2018,0.09404388714733543,0.219435736677116
1480,Lars Lukas Mai,GER,DF,Bayern Munich,Bundesliga,17,2000,2.0,4,4,4,0,0,3,4,75.0,1,3,2,1,3,7,3,0,0,2017-2018,1.5,2.0
1481,Dodi Lukebakio,BEL,"MF,FW",Watford,Premier League,19,1997,0.2,1,0,1,0,0,0,0,0.0,0,0,0,0,0,1,0,0,0,2017-2018,0.0,5.0
1482,Saša Lukić,SRB,MF,Levante,La Liga,20,1996,11.0,21,16,9,8,4,5,16,31.3,11,14,6,8,17,38,13,0,0,2017-2018,1.5454545454545454,1.9090909090909092
1483,Senad Lulić,BIH,"DF,MF",Lazio,Serie A,31,1986,27.0,66,40,32,22,12,21,80,26.3,59,32,4,28,36,102,39,0,0,2017-2018,1.3333333333333333,2.4444444444444446
1484,Levi Lumeka,ENG,FW,Crystal Palace,Premier League,18,1998,0.3,1,1,1,0,0,0,0,0.0,0,0,0,0,1,2,0,0,0,2017-2018,3.3333333333333335,3.3333333333333335
1485,Antonio Luna,ESP,DF,Levante,La Liga,26,1991,22.5,39,26,23,13,3,24,41,58.5,17,26,9,17,36,75,68,0,0,2017-2018,1.6,1.7333333333333334
1486,Arnaud Lusamba,COD,MF,Nice,Ligue 1,20,1997,1.8,12,9,4,6,2,3,7,42.9,4,5,0,5,1,13,1,0,0,2017-2018,0.5555555555555556,6.666666666666666
1487,Fabian Lustenberger,SUI,"MF,DF",Hertha BSC,Bundesliga,29,1988,17.6,47,34,26,20,1,21,31,67.7,10,31,12,19,24,71,74,1,0,2017-2018,1.3636363636363635,2.6704545454545454
1488,Andreas Luthe,GER,GK,Augsburg,Bundesliga,30,1987,2.0,0,0,0,0,0,0,0,0.0,0,0,0,0,0,0,2,0,0,2017-2018,0.0,0.0
1489,Lyanco,BRA,DF,Torino,Serie A,20,1997,3.5,11,8,8,3,0,5,8,62.5,3,4,3,1,5,16,17,0,0,2017-2018,1.4285714285714286,3.142857142857143
1490,Charalambos Lykogiannis,GRE,DF,Cagliari,Serie A,23,1993,7.6,16,12,9,5,2,11,18,61.1,7,12,3,9,15,31,28,0,0,2017-2018,1.973684210526316,2.1052631578947367
1491,Cheikh M'Bengue,SEN,DF,Saint-Étienne,Ligue 1,29,1988,5.4,8,4,8,0,0,4,4,100.0,0,6,4,2,8,16,22,1,0,2017-2018,1.4814814814814814,1.4814814814814814
1492,Raïs M'Bolhi,ALG,GK,Rennes,Ligue 1,31,1986,1.0,0,0,0,0,0,0,1,0.0,1,0,0,0,0,0,0,0,0,2017-2018,0.0,0.0
1493,Yann M'Vila,FRA,MF,Saint-Étienne,Ligue 1,27,1990,16.4,26,16,11,12,3,7,24,29.2,17,13,1,12,31,57,56,0,0,2017-2018,1.8902439024390245,1.5853658536585367
1494,Zinédine Machach,FRA,"FW,MF",Toulouse,Ligue 1,21,1996,2.1,7,3,5,1,1,4,5,80.0,1,1,0,1,2,9,2,0,0,2017-2018,0.9523809523809523,3.333333333333333
1495,Pablo Maffeo,ESP,DF,Girona,La Liga,20,1997,29.4,74,55,39,23,12,25,49,51.0,24,28,7,21,50,124,82,0,0,2017-2018,1.7006802721088436,2.5170068027210886
1496,Gabriel Magalhães,BRA,DF,Troyes,Ligue 1,19,1997,0.9,1,1,1,0,0,0,1,0.0,1,2,1,1,0,1,4,1,0,2017-2018,0.0,1.1111111111111112
1497,Christian Maggio,ITA,DF,Napoli,Serie A,35,1982,7.1,17,10,9,6,2,7,19,36.8,12,15,4,11,13,30,21,0,0,2017-2018,1.8309859154929577,2.3943661971830985
1498,Francesco Magnanelli,ITA,MF,Sassuolo,Serie A,32,1984,27.7,56,38,30,20,6,20,65,30.8,45,26,7,19,58,114,78,2,0,2017-2018,2.0938628158844765,2.0216606498194944
1499,Harry Maguire,ENG,DF,Leicester City,Premier League,24,1993,38.0,63,46,47,15,1,26,43,60.5,17,35,28,7,48,111,181,1,0,2017-2018,1.263157894736842,1.6578947368421053
1500,Hicham Mahou,FRA,"MF,FW",Nice,Ligue 1,18,1999,0.6,1,1,1,0,0,1,3,33.3,2,0,0,0,3,4,0,0,0,2017-2018,5.0,1.6666666666666667
1501,Riyad Mahrez,ALG,"MF,FW",Leicester City,Premier League,26,1991,32.8,39,27,16,17,6,10,63,15.9,53,32,1,31,18,57,15,0,0,2017-2018,0.5487804878048781,1.1890243902439026
1502,Thiago Maia,BRA,"MF,DF",Lille,Ligue 1,20,1997,27.4,55,40,26,26,3,15,61,24.6,46,32,10,22,61,116,47,1,0,2017-2018,2.226277372262774,2.007299270072993
1503,Arne Maier,GER,MF,Hertha BSC,Bundesliga,18,1999,13.6,29,23,12,16,1,18,24,75.0,6,19,3,16,24,53,20,0,0,2017-2018,1.7647058823529411,2.1323529411764706
1504,Sebastian Maier,GER,MF,Hannover 96,Bundesliga,23,1993,2.9,11,6,4,7,0,2,12,16.7,10,6,1,5,4,15,1,1,0,2017-2018,1.3793103448275863,3.793103448275862
1505,Domenico Maietta,ITA,DF,Bologna,Serie A,34,1982,5.2,5,4,4,1,0,3,9,33.3,6,8,6,2,7,12,13,1,0,2017-2018,1.346153846153846,0.9615384615384615
1506,Habib Maïga,CIV,"MF,DF",Saint-Étienne,Ligue 1,21,1996,7.9,29,18,16,10,3,12,30,40.0,18,8,4,4,19,48,10,0,0,2017-2018,2.4050632911392404,3.670886075949367
1507,Mike Maignan,FRA,GK,Lille,Ligue 1,22,1995,33.7,1,1,1,0,0,1,1,100.0,0,0,0,0,0,1,8,6,0,2017-2018,0.0,0.029673590504451036
1508,Linton Maina,GER,MF,Hannover 96,Bundesliga,18,1999,0.1,1,1,0,0,1,0,0,0.0,0,0,0,0,1,2,0,0,0,2017-2018,10.0,10.0
1509,Ainsley Maitland-Niles,ENG,"DF,MF",Arsenal,Premier League,19,1997,10.2,25,17,12,7,6,14,31,45.2,17,15,1,14,12,37,35,2,0,2017-2018,1.1764705882352942,2.450980392156863
1510,Jean-Victor Makengo,FRA,"FW,MF",Nice,Ligue 1,19,1998,2.7,4,2,2,2,0,1,2,50.0,1,1,0,1,3,7,1,1,0,2017-2018,1.111111111111111,1.4814814814814814
1511,Nemanja Maksimović,SRB,MF,Valencia,La Liga,22,1995,6.2,21,13,10,8,3,8,16,50.0,8,15,6,9,16,37,8,0,0,2017-2018,2.5806451612903225,3.3870967741935485
1512,Nikola Maksimović,SRB,DF,Napoli,Serie A,25,1991,1.1,1,1,0,1,0,1,1,100.0,0,1,0,1,0,1,5,0,0,2017-2018,0.0,0.9090909090909091
1513,Malcom,BRA,FW,Bordeaux,Ligue 1,20,1997,31.7,15,10,3,7,5,1,28,3.6,27,13,1,12,14,29,6,0,0,2017-2018,0.44164037854889593,0.47318611987381703
1514,Kévin Malcuit,MAR,DF,Lille,Ligue 1,26,1991,20.2,51,37,31,16,4,17,25,68.0,8,13,5,8,38,89,47,0,0,2017-2018,1.8811881188118813,2.5247524752475248
1515,Yunus Mallı,TUR,"FW,MF",Wolfsburg,Bundesliga,25,1992,24.9,25,17,8,14,3,12,25,48.0,13,23,0,23,12,37,17,0,0,2017-2018,0.48192771084337355,1.0040160642570282
1516,Hugo Mallo,ESP,DF,Celta Vigo,La Liga,26,1991,33.3,84,55,55,26,3,35,53,66.0,18,30,15,15,68,152,111,1,0,2017-2018,2.042042042042042,2.522522522522523
1517,Scott Malone,ENG,DF,Huddersfield,Premier League,26,1991,12.4,39,29,27,10,2,17,24,70.8,7,12,2,10,26,65,43,2,0,2017-2018,2.096774193548387,3.1451612903225805
1518,Vincent Manceau,FRA,DF,Angers,Ligue 1,28,1989,33.0,84,49,56,22,6,42,76,55.3,34,34,2,32,34,118,103,0,0,2017-2018,1.0303030303030303,2.5454545454545454
1519,Gianluca Mancini,ITA,DF,Atalanta,Serie A,21,1996,7.6,20,14,11,8,1,10,17,58.8,7,8,2,6,15,35,22,0,0,2017-2018,1.973684210526316,2.6315789473684212
1520,Steve Mandanda,FRA,GK,Marseille,Ligue 1,32,1985,30.0,0,0,0,0,0,0,0,0.0,0,0,0,0,0,0,10,3,0,2017-2018,0.0,0.0
1521,Aïssa Mandi,ALG,DF,Betis,La Liga,25,1991,33.6,54,35,27,25,2,19,34,55.9,15,39,24,15,71,125,133,3,0,2017-2018,2.113095238095238,1.607142857142857
1522,Georges Mandjeck,CMR,"MF,DF",Metz,Ligue 1,28,1988,10.8,25,14,8,16,1,8,18,44.4,10,9,3,6,18,43,21,1,0,2017-2018,1.6666666666666665,2.314814814814815
1523,Rolando Mandragora,ITA,MF,Crotone,Serie A,20,1997,36.0,91,60,48,34,9,26,69,37.7,43,41,13,28,86,177,75,0,0,2017-2018,2.388888888888889,2.5277777777777777
1524,Mario Mandžukić,CRO,FW,Juventus,Serie A,31,1986,25.8,36,23,13,11,12,8,29,27.6,21,20,3,17,25,61,42,2,0,2017-2018,0.9689922480620154,1.3953488372093024
1525,Sadio Mané,SEN,FW,Liverpool,Premier League,25,1992,24.3,28,20,8,11,9,3,23,13.0,20,20,0,20,9,37,8,0,0,2017-2018,0.37037037037037035,1.1522633744855966
1526,Eliaquim Mangala,FRA,DF,Everton,Premier League,26,1991,1.5,2,1,1,1,0,0,0,0.0,0,0,0,0,1,3,4,1,0,2017-2018,0.6666666666666666,1.3333333333333333
1527,Eliaquim Mangala,FRA,DF,Manchester City,Premier League,26,1991,5.4,5,3,5,0,0,1,3,33.3,2,4,3,1,2,7,24,0,0,2017-2018,0.37037037037037035,0.9259259259259258
1528,Orel Mangala,BEL,MF,Stuttgart,Bundesliga,19,1998,8.7,28,18,7,19,2,11,21,52.4,10,8,2,6,18,46,15,0,0,2017-2018,2.0689655172413794,3.218390804597701
1529,Kader Mangane,SEN,DF,Strasbourg,Ligue 1,34,1983,19.1,37,24,29,8,0,11,21,52.4,10,28,18,10,24,61,120,4,0,2017-2018,1.256544502617801,1.9371727748691099
1530,Thomas Mangani,FRA,MF,Angers,Ligue 1,30,1987,33.6,92,59,35,46,11,28,120,23.3,92,40,5,35,40,132,45,1,0,2017-2018,1.1904761904761905,2.738095238095238
1531,Kostas Manolas,GRE,DF,Roma,Serie A,26,1991,26.0,23,20,14,7,2,9,15,60.0,6,31,24,7,46,69,133,2,0,2017-2018,1.7692307692307692,0.8846153846153846
1532,Javier Manquillo,ESP,DF,Newcastle Utd,Premier League,23,1994,19.5,36,22,25,8,3,15,30,50.0,15,25,6,19,18,54,65,0,0,2017-2018,0.9230769230769231,1.8461538461538463
1533,Martín Mantovani,ARG,DF,Leganés,La Liga,33,1984,11.4,12,5,10,2,0,7,10,70.0,3,10,6,4,22,34,67,0,0,2017-2018,1.9298245614035088,1.0526315789473684
1534,José Manuel Jurado,ESP,"MF,FW",Espanyol,La Liga,31,1986,16.7,18,14,8,8,2,5,14,35.7,9,13,1,12,16,34,5,0,0,2017-2018,0.9580838323353293,1.0778443113772456
1535,Harrison Manzala,COD,"FW,MF",Amiens,Ligue 1,23,1994,20.7,32,23,16,9,7,8,25,32.0,17,22,3,19,18,50,15,0,0,2017-2018,0.8695652173913043,1.5458937198067633
1536,Myziane Maolida,COM,"FW,MF",Lyon,Ligue 1,18,1999,3.7,5,5,3,2,0,0,2,0.0,2,1,0,1,0,5,0,0,0,2017-2018,0.0,1.3513513513513513
1537,Faitout Maouassa,FRA,"MF,FW",Rennes,Ligue 1,19,1998,9.9,6,3,2,3,1,2,10,20.0,8,12,2,10,6,12,5,0,0,2017-2018,0.6060606060606061,0.6060606060606061
1538,Fernando Marçal,BRA,DF,Lyon,Ligue 1,28,1989,14.4,34,20,22,8,4,14,29,48.3,15,14,6,8,26,60,69,0,0,2017-2018,1.8055555555555556,2.361111111111111
1539,Vincent Marcel,FRA,"MF,FW",Nice,Ligue 1,20,1997,0.5,1,1,0,1,0,0,1,0.0,1,1,0,1,0,1,0,0,0,2017-2018,0.0,2.0
1540,Marcelo,BRA,DF,Real Madrid,La Liga,29,1988,25.1,53,37,19,23,11,22,58,37.9,36,26,2,24,30,83,23,2,0,2017-2018,1.195219123505976,2.1115537848605577
1541,Marcelo,BRA,DF,Lyon,Ligue 1,30,1987,34.5,27,25,16,10,1,9,25,36.0,16,32,18,14,57,84,235,4,0,2017-2018,1.6521739130434783,0.782608695652174
1542,Solly March,ENG,"MF,FW",Brighton,Premier League,23,1994,20.6,54,41,34,14,6,22,54,40.7,32,27,3,24,13,67,49,0,0,2017-2018,0.6310679611650485,2.6213592233009706
1543,Gabriele Marchegiani,ITA,GK,SPAL,Serie A,21,1996,0.0,0,0,0,0,0,0,0,0.0,0,0,0,0,0,0,0,0,0,2017-2018,,
1544,Claudio Marchisio,ITA,MF,Juventus,Serie A,31,1986,9.1,17,10,9,5,3,6,21,28.6,15,7,2,5,4,21,7,0,0,2017-2018,0.43956043956043955,1.8681318681318682
1545,Gian Marco Ferrari,ITA,DF,Sampdoria,Serie A,25,1992,29.4,12,8,8,4,0,5,10,50.0,5,42,38,4,31,43,149,4,0,2017-2018,1.054421768707483,0.40816326530612246
1546,Óscar de Marcos,ESP,"DF,FW",Athletic Club,La Liga,28,1989,18.4,28,21,11,15,2,13,29,44.8,16,15,2,13,19,47,36,0,0,2017-2018,1.032608695652174,1.5217391304347827
1547,José María Giménez,URU,DF,Atlético Madrid,La Liga,22,1995,18.8,38,27,29,6,3,23,35,65.7,12,28,15,13,30,68,101,1,0,2017-2018,1.5957446808510638,2.021276595744681
1548,Mariano,DOM,FW,Lyon,Ligue 1,23,1993,27.9,16,11,0,5,11,2,23,8.7,21,9,1,8,3,19,20,0,0,2017-2018,0.10752688172043011,0.5734767025089607
1549,Adrian Mariappa,JAM,DF,Watford,Premier League,30,1986,24.6,45,26,33,12,0,14,34,41.2,20,25,16,9,45,90,133,4,0,2017-2018,1.8292682926829267,1.8292682926829267
1550,Jordan Marié,FRA,MF,Dijon,Ligue 1,25,1991,20.9,63,38,22,36,5,18,66,27.3,48,26,9,17,40,103,25,2,0,2017-2018,1.9138755980861246,3.0143540669856463
1551,Adrián Marín,ESP,DF,Villarreal,La Liga,20,1997,2.6,6,4,3,3,0,2,8,25.0,6,2,0,2,3,9,8,0,0,2017-2018,1.1538461538461537,2.3076923076923075
1552,João Mário,POR,MF,West Ham,Premier League,24,1993,11.4,14,11,6,5,3,6,19,31.6,13,7,0,7,8,22,4,1,0,2017-2018,0.7017543859649122,1.2280701754385965
1553,João Mário,POR,"MF,FW",Inter,Serie A,24,1993,6.2,8,4,3,3,2,2,8,25.0,6,6,1,5,4,12,5,0,0,2017-2018,0.6451612903225806,1.2903225806451613
1554,Guillermo Maripán,CHI,DF,Alavés,La Liga,23,1994,17.0,28,16,24,4,0,17,32,53.1,15,19,10,9,36,64,108,0,0,2017-2018,2.1176470588235294,1.6470588235294117
1555,Marlon,BRA,DF,Nice,Ligue 1,21,1995,21.4,36,26,22,13,1,15,22,68.2,7,19,15,4,15,51,72,2,0,2017-2018,0.7009345794392524,1.6822429906542058
1556,Dominic Maroh,SVN,DF,Köln,Bundesliga,30,1987,10.2,22,15,18,4,0,15,18,83.3,3,17,9,8,21,43,68,1,0,2017-2018,2.058823529411765,2.1568627450980395
1557,Marquinhos,BRA,DF,Paris S-G,Ligue 1,23,1994,25.1,28,14,14,14,0,13,21,61.9,8,36,22,14,14,42,114,2,0,2017-2018,0.5577689243027888,1.1155378486055776
1558,Bruno Martella,ITA,DF,Crotone,Serie A,24,1992,29.1,30,21,19,7,4,12,30,40.0,18,22,9,13,48,78,151,1,0,2017-2018,1.6494845360824741,1.0309278350515463
1559,Roger Martí,ESP,FW,Levante,La Liga,26,1991,10.7,8,4,2,5,1,2,13,15.4,11,11,0,11,1,9,5,0,0,2017-2018,0.09345794392523366,0.7476635514018692
1560,Anthony Martial,FRA,FW,Manchester Utd,Premier League,21,1995,17.6,15,13,9,2,4,3,12,25.0,9,5,1,4,3,18,7,0,0,2017-2018,0.17045454545454544,0.8522727272727272
1561,Aarón Martín,ESP,DF,Espanyol,La Liga,20,1997,31.3,56,36,41,12,3,31,59,52.5,28,26,5,21,49,105,78,0,0,2017-2018,1.5654952076677315,1.7891373801916932
1562,Jonas Martin,FRA,MF,Strasbourg,Ligue 1,27,1990,33.6,73,50,41,28,4,17,54,31.5,37,30,3,27,33,106,36,0,0,2017-2018,0.9821428571428571,2.1726190476190474
1563,Cuco Martina,CUW,DF,Everton,Premier League,27,1989,20.3,61,35,38,15,8,27,46,58.7,19,17,4,13,42,103,130,2,0,2017-2018,2.0689655172413794,3.0049261083743843
1564,Carlos Martínez,ESP,DF,Real Sociedad,La Liga,31,1986,0.0,0,0,0,0,0,0,0,0.0,0,0,0,0,0,0,0,0,0,2017-2018,,
1565,Emiliano Martínez,ARG,GK,Getafe,La Liga,24,1992,5.0,0,0,0,0,0,0,0,0.0,0,0,0,0,0,0,3,0,0,2017-2018,0.0,0.0
1566,Iñigo Martínez,ESP,DF,Athletic Club,La Liga,26,1991,16.0,28,20,20,8,0,18,29,62.1,11,17,8,9,30,58,82,0,0,2017-2018,1.875,1.75
1567,Iñigo Martínez,ESP,DF,Real Sociedad,La Liga,26,1991,11.7,14,9,9,4,1,5,11,45.5,6,9,4,5,23,37,55,0,0,2017-2018,1.965811965811966,1.1965811965811965
1568,Javi Martínez,ESP,"MF,DF",Bayern Munich,Bundesliga,28,1988,17.9,31,22,11,15,5,9,19,47.4,10,16,5,11,33,64,40,1,0,2017-2018,1.8435754189944136,1.7318435754189945
1569,Pablo Martinez,FRA,DF,Strasbourg,Ligue 1,28,1989,23.5,41,34,28,12,1,22,49,44.9,27,25,12,13,51,92,112,3,0,2017-2018,2.1702127659574466,1.7446808510638299
1570,Roger Martínez,COL,FW,Villarreal,La Liga,23,1994,2.6,1,1,0,1,0,0,2,0.0,2,2,0,2,0,1,1,0,0,2017-2018,0.0,0.3846153846153846
1571,Christopher Martins,LUX,MF,Lyon,Ligue 1,20,1997,0.8,3,2,0,3,0,1,2,50.0,1,0,0,0,1,4,0,0,0,2017-2018,1.25,3.75
1572,Bruno Martins Indi,NED,DF,Stoke City,Premier League,25,1992,13.8,21,12,18,3,0,10,19,52.6,9,16,11,5,21,42,77,1,0,2017-2018,1.5217391304347825,1.5217391304347825
1573,Jonathan Martins Pereira,FRA,DF,Guingamp,Ligue 1,31,1986,12.6,34,18,21,10,3,8,23,34.8,15,9,3,6,37,71,39,1,0,2017-2018,2.9365079365079367,2.6984126984126986
1574,Adam Marušić,MNE,DF,Lazio,Serie A,24,1992,28.0,28,21,17,8,3,12,28,42.9,16,22,2,20,31,59,33,0,0,2017-2018,1.1071428571428572,1.0
1575,Omar Mascarell,EQG,MF,Eint Frankfurt,Bundesliga,24,1993,8.6,20,16,8,12,0,10,18,55.6,8,14,1,13,21,41,10,0,0,2017-2018,2.441860465116279,2.3255813953488373
1576,Javier Mascherano,ARG,DF,Barcelona,La Liga,33,1984,6.0,15,13,9,6,0,8,9,88.9,1,14,8,6,8,23,20,0,0,2017-2018,1.3333333333333333,2.5
1577,Andrea Masiello,ITA,DF,Atalanta,Serie A,31,1986,30.1,58,38,34,20,4,30,54,55.6,24,24,6,18,72,130,137,0,0,2017-2018,2.3920265780730894,1.9269102990033222
1578,Adam Masina,MAR,DF,Bologna,Serie A,23,1994,31.4,82,57,49,26,7,36,84,42.9,48,46,7,39,51,133,127,0,0,2017-2018,1.624203821656051,2.6114649681528666
1579,Eden Massouema,CGO,"MF,FW",Dijon,Ligue 1,20,1997,2.1,2,1,2,0,0,2,2,100.0,0,3,0,3,5,7,2,0,0,2017-2018,2.380952380952381,0.9523809523809523
1580,Arthur Masuaku,COD,DF,West Ham,Premier League,23,1993,20.8,58,37,36,16,6,25,58,43.1,33,25,2,23,26,84,38,1,0,2017-2018,1.25,2.7884615384615383
1581,Juan Mata,ESP,FW,Manchester Utd,Premier League,29,1988,21.4,18,13,4,12,2,2,24,8.3,22,10,0,10,15,33,10,1,0,2017-2018,0.7009345794392524,0.8411214953271029
1582,Christian Mathenia,GER,GK,Hamburger SV,Bundesliga,25,1992,24.0,0,0,0,0,0,0,3,0.0,3,0,0,0,0,0,11,3,0,2017-2018,0.0,0.0
1583,Nemanja Matić,SRB,MF,Manchester Utd,Premier League,28,1988,34.6,70,42,32,34,4,23,71,32.4,48,50,13,37,64,134,62,2,0,2017-2018,1.8497109826589595,2.0231213872832368
1584,Joël Matip,CMR,DF,Liverpool,Premier League,25,1991,22.2,35,24,23,11,1,12,24,50.0,12,26,15,11,35,70,101,1,0,2017-2018,1.5765765765765767,1.5765765765765767
1585,Ryder Matos,BRA,MF,Udinese,Serie A,24,1993,1.9,3,1,1,1,1,1,1,100.0,0,2,0,2,2,5,3,0,0,2017-2018,1.0526315789473684,1.5789473684210527
1586,Ryder Matos,BRA,"FW,MF",Hellas Verona,Serie A,24,1993,10.9,18,15,11,5,2,4,9,44.4,5,5,0,5,3,21,9,1,0,2017-2018,0.27522935779816515,1.6513761467889907
1587,Alessandro Matri,ITA,FW,Sassuolo,Serie A,32,1984,10.2,2,1,1,1,0,0,3,0.0,3,1,0,1,0,2,5,0,0,2017-2018,0.0,0.19607843137254904
1588,Ville Matti Steinmann,GER,MF,Hamburger SV,Bundesliga,22,1995,6.6,16,10,6,8,2,8,17,47.1,9,6,1,5,18,34,9,1,0,2017-2018,2.7272727272727275,2.4242424242424243
1589,Federico Mattiello,ITA,DF,SPAL,Serie A,22,1995,24.5,59,40,31,22,6,21,44,47.7,23,53,15,38,64,123,66,0,0,2017-2018,2.6122448979591835,2.4081632653061225
1590,Blaise Matuidi,FRA,MF,Juventus,Serie A,30,1987,26.2,49,35,14,25,10,10,35,28.6,25,28,4,24,32,81,22,1,0,2017-2018,1.2213740458015268,1.870229007633588
1591,Blaise Matuidi,FRA,MF,Paris S-G,Ligue 1,30,1987,0.3,1,1,1,0,0,0,0,0.0,0,2,1,1,0,1,0,0,0,2017-2018,0.0,3.3333333333333335
1592,José Mauri,ITA,MF,Milan,Serie A,21,1996,0.1,0,0,0,0,0,0,0,0.0,0,0,0,0,0,0,0,0,0,2017-2018,0.0,0.0
1593,Maurício,BRA,DF,Lazio,Serie A,28,1988,0.1,0,0,0,0,0,0,0,0.0,0,0,0,0,0,0,0,0,0,2017-2018,0.0,0.0
1594,Mërgim Mavraj,ALB,DF,Hamburger SV,Bundesliga,31,1986,16.1,45,32,32,11,2,22,37,59.5,15,28,12,16,21,66,91,3,0,2017-2018,1.3043478260869563,2.795031055900621
1595,Konstantinos Mavropanos,GRE,DF,Arsenal,Premier League,19,1997,2.2,1,1,1,0,0,1,2,50.0,1,4,3,1,6,7,11,1,0,2017-2018,2.727272727272727,0.45454545454545453
1596,Alfie Mawson,ENG,DF,Swansea City,Premier League,23,1994,38.0,32,22,24,8,0,16,27,59.3,11,41,32,9,35,67,229,5,0,2017-2018,0.9210526315789473,0.8421052631578947
1597,Philipp Max,GER,DF,Augsburg,Bundesliga,23,1993,32.9,65,47,36,19,10,34,59,57.6,25,27,8,19,33,98,65,1,0,2017-2018,1.0030395136778116,1.9756838905775076
1598,Alexandru Maxim,ROU,MF,Mainz 05,Bundesliga,27,1990,10.6,17,12,6,8,3,7,22,31.8,15,20,2,18,6,23,3,0,0,2017-2018,0.5660377358490566,1.6037735849056605
1599,Eric Maxim Choupo-Moting,CMR,"FW,MF",Stoke City,Premier League,28,1989,25.7,42,30,21,16,5,9,32,28.1,23,31,3,28,23,65,29,1,0,2017-2018,0.8949416342412452,1.6342412451361867
1600,Florian Mayer,GER,DF,Gladbach,Bundesliga,19,1998,0.2,1,1,1,0,0,1,1,100.0,0,0,0,0,0,1,1,0,0,2017-2018,0.0,5.0
1601,Borja Mayoral,ESP,"FW,MF",Real Madrid,La Liga,20,1997,3.8,6,3,0,4,2,1,5,20.0,4,3,0,3,0,6,0,0,0,2017-2018,0.0,1.5789473684210527
1602,Róbert Mazáň,SVK,DF,Celta Vigo,La Liga,23,1994,0.9,0,0,0,0,0,0,1,0.0,1,1,0,1,2,2,0,0,0,2017-2018,2.2222222222222223,0.0
1603,Luca Mazzitelli,ITA,MF,Sassuolo,Serie A,21,1995,11.3,37,24,14,15,8,10,36,27.8,26,21,2,19,21,58,19,0,0,2017-2018,1.8584070796460175,3.2743362831858405
1604,Kylian Mbappé,FRA,"FW,MF",Monaco,Ligue 1,18,1998,0.8,1,1,0,1,0,0,0,0.0,0,0,0,0,1,2,0,0,0,2017-2018,1.25,1.25
1605,Kylian Mbappé,FRA,FW,Paris S-G,Ligue 1,18,1998,23.3,11,8,3,3,5,1,13,7.7,12,4,1,3,0,11,1,0,0,2017-2018,0.0,0.4721030042918455
1606,Ibrahima Mbaye,SEN,DF,Bologna,Serie A,22,1994,19.6,59,34,40,17,2,25,36,69.4,11,25,6,19,28,87,95,0,0,2017-2018,1.4285714285714284,3.010204081632653
1607,Chancel Mbemba,COD,DF,Newcastle Utd,Premier League,22,1994,7.5,16,12,13,3,0,10,17,58.8,7,7,3,4,15,31,44,1,0,2017-2018,2.0,2.1333333333333333
1608,Adama Mbengue,SEN,DF,Caen,Ligue 1,23,1993,17.7,71,48,48,18,5,41,65,63.1,24,21,1,20,28,99,50,0,0,2017-2018,1.5819209039548023,4.011299435028249
1609,Isaac Mbenza,BEL,"FW,MF",Montpellier,Ligue 1,21,1996,23.3,16,11,4,8,4,6,16,37.5,10,8,1,7,4,20,5,0,0,2017-2018,0.17167381974248927,0.6866952789699571
1610,Bryan Mbeumo,CMR,"FW,MF",Troyes,Ligue 1,17,1999,0.7,0,0,0,0,0,0,3,0.0,3,2,0,2,0,0,2,0,0,2017-2018,0.0,0.0
1611,Jordi Mboula,ESP,MF,Monaco,Ligue 1,18,1999,0.3,0,0,0,0,0,0,0,0.0,0,2,0,2,0,0,2,0,0,2017-2018,0.0,0.0
1612,James McArthur,SCO,MF,Crystal Palace,Premier League,29,1987,27.0,58,44,28,27,3,23,61,37.7,38,39,2,37,36,94,44,2,0,2017-2018,1.3333333333333333,2.1481481481481484
1613,Gareth McAuley,NIR,DF,West Brom,Premier League,37,1979,5.1,8,7,6,2,0,3,7,42.9,4,7,4,3,11,19,16,0,0,2017-2018,2.1568627450980395,1.5686274509803924
1614,Oliver McBurnie,SCO,"FW,MF",Swansea City,Premier League,21,1996,3.1,4,3,0,2,2,1,3,33.3,2,2,0,2,0,4,3,0,0,2017-2018,0.0,1.2903225806451613
1615,Alex McCarthy,ENG,GK,Southampton,Premier League,27,1989,18.0,0,0,0,0,0,0,0,0.0,0,0,0,0,1,1,8,0,0,2017-2018,0.05555555555555555,0.0
1616,James McCarthy,IRL,MF,Everton,Premier League,26,1990,2.3,9,9,3,4,2,1,5,20.0,4,9,2,7,5,14,3,1,0,2017-2018,2.173913043478261,3.91304347826087
1617,James McClean,IRL,"MF,FW",West Brom,Premier League,28,1989,15.6,40,28,23,14,3,10,55,18.2,45,18,4,14,20,60,22,0,0,2017-2018,1.2820512820512822,2.5641025641025643
1618,Weston McKennie,USA,MF,Schalke 04,Bundesliga,18,1998,14.0,36,23,11,21,4,13,32,40.6,19,16,2,14,20,56,32,0,0,2017-2018,1.4285714285714286,2.5714285714285716
1619,Sam McQueen,ENG,"DF,MF",Southampton,Premier League,22,1995,1.6,4,4,4,0,0,2,4,50.0,2,2,1,1,3,7,3,0,0,2017-2018,1.875,2.5
1620,Scott McTominay,SCO,MF,Manchester Utd,Premier League,20,1996,7.0,11,9,4,5,2,5,13,38.5,8,3,0,3,13,24,9,0,0,2017-2018,1.8571428571428572,1.5714285714285714
1621,Iuri Medeiros,POR,"FW,MF",Genoa,Serie A,23,1994,7.1,6,4,3,2,1,4,8,50.0,4,3,1,2,2,8,3,0,0,2017-2018,0.28169014084507044,0.8450704225352114
1622,Slobodan Medojević,SRB,MF,Eint Frankfurt,Bundesliga,26,1990,0.3,0,0,0,0,0,0,0,0.0,0,0,0,0,0,0,1,0,0,2017-2018,0.0,0.0
1623,Álvaro Medrán,ESP,MF,Alavés,La Liga,23,1994,10.5,20,14,5,10,5,8,21,38.1,13,7,0,7,13,33,10,0,0,2017-2018,1.2380952380952381,1.9047619047619047
1624,Álvaro Medrán,ESP,MF,Valencia,La Liga,23,1994,0.8,1,1,1,0,0,1,2,50.0,1,0,0,0,3,4,1,0,0,2017-2018,3.75,1.25
1625,Ben Mee,ENG,DF,Burnley,Premier League,27,1989,29.0,33,20,22,11,0,16,29,55.2,13,51,42,9,33,66,217,1,0,2017-2018,1.1379310344827587,1.1379310344827587
1626,Riccardo Meggiorini,ITA,FW,Chievo,Serie A,31,1985,8.7,9,6,3,6,0,1,6,16.7,5,12,3,9,2,11,9,0,0,2017-2018,0.2298850574712644,1.0344827586206897
1627,Admir Mehmedi,SUI,"FW,MF",Wolfsburg,Bundesliga,26,1991,3.2,4,2,3,1,0,2,2,100.0,0,1,1,0,1,5,3,0,0,2017-2018,0.3125,1.25
1628,Admir Mehmedi,SUI,"DF,MF",Leverkusen,Bundesliga,26,1991,7.8,20,18,6,11,3,4,13,30.8,9,13,0,13,13,33,5,0,0,2017-2018,1.6666666666666667,2.5641025641025643
1629,Alexander Meier,GER,FW,Eint Frankfurt,Bundesliga,34,1983,0.0,0,0,0,0,0,0,0,0.0,0,0,0,0,0,0,0,0,0,2017-2018,,
1630,Soualiho Meïté,FRA,MF,Bordeaux,Ligue 1,23,1994,14.8,25,13,4,19,2,9,32,28.1,23,22,6,16,23,48,13,1,0,2017-2018,1.554054054054054,1.689189189189189
1631,Soualiho Meïté,FRA,MF,Monaco,Ligue 1,23,1994,1.1,2,1,1,1,0,2,5,40.0,3,1,0,1,3,5,3,0,0,2017-2018,2.727272727272727,1.8181818181818181
1632,Óscar Melendo,ESP,"MF,FW",Espanyol,La Liga,19,1997,7.6,2,2,2,0,0,0,5,0.0,5,2,0,2,3,5,3,0,0,2017-2018,0.39473684210526316,0.2631578947368421
1633,Memphis,NED,FW,Lyon,Ligue 1,23,1994,28.4,13,9,4,3,6,3,28,10.7,25,15,0,15,9,22,5,0,0,2017-2018,0.31690140845070425,0.45774647887323944
1634,Ledian Memushaj,ALB,MF,Benevento,Serie A,30,1986,14.0,28,18,11,13,4,7,30,23.3,23,24,5,19,10,38,10,1,0,2017-2018,0.7142857142857143,2.0
1635,Pedro Mendes,POR,DF,Montpellier,Ligue 1,26,1990,31.7,62,50,37,19,6,23,41,56.1,18,36,25,11,44,106,152,0,0,2017-2018,1.38801261829653,1.9558359621451105
1636,Thiago Mendes,BRA,MF,Lille,Ligue 1,25,1992,25.5,25,16,10,11,4,5,23,21.7,18,21,3,18,25,50,29,0,0,2017-2018,0.9803921568627451,0.9803921568627451
1637,Brais Méndez,ESP,"MF,FW",Celta Vigo,La Liga,20,1997,10.5,19,15,9,6,4,7,17,41.2,10,13,0,13,4,23,12,0,0,2017-2018,0.38095238095238093,1.8095238095238095
1638,Stiven Mendoza,COL,"FW,MF",Amiens,Ligue 1,25,1992,11.5,18,10,7,7,4,2,11,18.2,9,11,1,10,15,33,8,0,0,2017-2018,1.3043478260869565,1.565217391304348
1639,Alexandre Mendy,GNB,FW,Bordeaux,Ligue 1,23,1994,8.8,4,4,1,2,1,1,6,16.7,5,5,1,4,1,5,4,0,0,2017-2018,0.11363636363636363,0.45454545454545453
1640,Benjamin Mendy,FRA,"DF,FW",Manchester City,Premier League,23,1994,4.0,5,4,2,0,3,5,7,71.4,2,5,0,5,8,13,9,0,0,2017-2018,2.0,1.25
1641,Ferland Mendy,FRA,DF,Lyon,Ligue 1,22,1995,23.6,45,28,29,13,3,20,31,64.5,11,18,5,13,25,70,43,0,0,2017-2018,1.059322033898305,1.906779661016949
1642,Nampalys Mendy,SEN,MF,Nice,Ligue 1,25,1992,10.7,13,6,8,5,0,5,17,29.4,12,9,1,8,13,26,10,1,0,2017-2018,1.2149532710280375,1.2149532710280375
1643,Hamza Mendyl,MAR,"DF,MF",Lille,Ligue 1,19,1997,9.5,18,10,12,6,0,11,20,55.0,9,5,0,5,17,35,26,0,0,2017-2018,1.7894736842105263,1.894736842105263
1644,Gabriel Mercado,ARG,DF,Sevilla,La Liga,30,1987,23.5,55,37,35,18,2,36,67,53.7,31,32,20,12,42,97,83,1,0,2017-2018,1.7872340425531914,2.3404255319148937
1645,Jorge Meré,ESP,DF,Köln,Bundesliga,20,1997,21.0,34,23,25,9,0,23,35,65.7,12,25,13,12,34,68,110,1,0,2017-2018,1.619047619047619,1.619047619047619
1646,Alex Meret,ITA,GK,SPAL,Serie A,20,1997,12.9,0,0,0,0,0,0,1,0.0,1,0,0,0,0,0,5,0,0,2017-2018,0.0,0.0
1647,Mikel Merino,ESP,MF,Newcastle Utd,Premier League,21,1996,15.0,56,40,21,32,3,17,56,30.4,39,36,8,28,34,90,25,0,0,2017-2018,2.2666666666666666,3.7333333333333334
1648,Sabin Merino,ESP,"FW,MF",Athletic Club,La Liga,25,1992,4.2,7,3,2,3,2,3,8,37.5,5,6,2,4,1,8,10,0,0,2017-2018,0.23809523809523808,1.6666666666666665
1649,Dries Mertens,BEL,FW,Napoli,Serie A,30,1987,33.4,28,22,5,13,10,5,36,13.9,31,18,2,16,5,33,8,1,0,2017-2018,0.14970059880239522,0.8383233532934132
1650,Per Mertesacker,GER,DF,Arsenal,Premier League,32,1984,4.1,2,2,0,2,0,0,1,0.0,1,4,3,1,6,8,22,2,0,2017-2018,1.4634146341463417,0.48780487804878053
1651,Roque Mesa,ESP,MF,Swansea City,Premier League,28,1989,8.4,20,13,8,8,4,10,37,27.0,27,6,0,6,13,33,8,1,0,2017-2018,1.5476190476190474,2.380952380952381
1652,Roque Mesa,ESP,MF,Sevilla,La Liga,28,1989,3.8,13,10,2,7,4,6,8,75.0,2,3,2,1,0,13,5,0,0,2017-2018,0.0,3.4210526315789473
1653,Lionel Messi,ARG,FW,Barcelona,La Liga,30,1987,33.3,17,8,0,11,6,2,18,11.1,16,11,1,10,7,24,0,0,0,2017-2018,0.21021021021021022,0.5105105105105106
1654,Thomas Meunier,BEL,DF,Paris S-G,Ligue 1,25,1991,17.5,38,21,22,12,4,18,34,52.9,16,7,2,5,18,56,54,2,0,2017-2018,1.0285714285714285,2.1714285714285713
1655,Mexer,MOZ,DF,Rennes,Ligue 1,28,1988,13.3,15,12,9,6,0,9,12,75.0,3,13,7,6,16,31,98,2,0,2017-2018,1.2030075187969924,1.1278195488721805
1656,Max Meyer,GER,MF,Schalke 04,Bundesliga,21,1995,19.2,48,38,23,21,4,19,47,40.4,28,25,3,22,54,102,11,0,0,2017-2018,2.8125,2.5
1657,Senna Miangue,BEL,"DF,FW",Cagliari,Serie A,20,1997,8.9,7,5,4,2,1,3,7,42.9,4,8,1,7,7,14,35,0,0,2017-2018,0.7865168539325842,0.7865168539325842
1658,Michel,BRA,DF,Las Palmas,La Liga,27,1990,23.7,33,24,21,8,4,14,25,56.0,11,21,11,10,39,72,64,1,0,2017-2018,1.6455696202531647,1.3924050632911393
1659,Mathieu Michel,FRA,GK,Angers,Ligue 1,25,1991,6.6,0,0,0,0,0,0,1,0.0,1,0,0,0,0,0,0,1,0,2017-2018,0.0,0.0
1660,Clément Michelin,FRA,DF,Toulouse,Ligue 1,20,1997,3.1,11,7,7,4,0,7,11,63.6,4,3,1,2,4,15,12,0,0,2017-2018,1.2903225806451613,3.5483870967741935
1661,Francesco Migliore,ITA,DF,Genoa,Serie A,29,1988,3.7,5,5,4,1,0,2,6,33.3,4,1,0,1,3,8,9,1,0,2017-2018,0.8108108108108107,1.3513513513513513
1662,Simon Mignolet,BEL,GK,Liverpool,Premier League,29,1988,19.0,2,1,2,0,0,1,3,33.3,2,0,0,0,0,2,5,3,0,2017-2018,0.0,0.10526315789473684
1663,Nikola Milenković,SRB,DF,Fiorentina,Serie A,19,1997,13.9,39,25,20,16,3,16,29,55.2,13,18,8,10,23,62,70,0,0,2017-2018,1.6546762589928057,2.805755395683453
1664,Danijel Milićević,BIH,"MF,FW",Metz,Ligue 1,31,1986,7.9,8,4,0,4,4,1,9,11.1,8,5,0,5,3,11,2,0,0,2017-2018,0.37974683544303794,1.0126582278481011
1665,Arkadiusz Milik,POL,"FW,MF",Napoli,Serie A,23,1994,5.0,2,1,0,1,1,0,1,0.0,1,5,0,5,1,3,4,0,0,2017-2018,0.2,0.4
1666,Sergej Milinković-Savić,SRB,MF,Lazio,Serie A,22,1995,31.6,55,39,11,34,10,13,52,25.0,39,29,6,23,33,88,36,1,0,2017-2018,1.0443037974683544,1.740506329113924
1667,Vanja Milinković-Savić,SRB,GK,Torino,Serie A,20,1997,1.0,0,0,0,0,0,0,0,0.0,0,0,0,0,0,0,0,0,0,2017-2018,0.0,0.0
1668,Luka Milivojević,SRB,MF,Crystal Palace,Premier League,26,1991,34.2,85,52,40,37,8,31,86,36.0,55,50,12,38,71,156,81,3,0,2017-2018,2.0760233918128654,2.485380116959064
1669,James Milner,ENG,MF,Liverpool,Premier League,31,1986,19.7,58,45,18,32,8,15,39,38.5,24,33,5,28,21,79,23,0,0,2017-2018,1.0659898477157361,2.9441624365482233
1670,Santi Mina,ESP,FW,Valencia,La Liga,21,1995,17.3,17,9,4,9,4,4,22,18.2,18,14,1,13,2,19,19,0,0,2017-2018,0.11560693641618497,0.9826589595375722
1671,Yerry Mina,COL,DF,Barcelona,La Liga,22,1994,4.1,10,8,6,4,0,4,6,66.7,2,6,3,3,6,16,16,0,0,2017-2018,1.4634146341463417,2.439024390243903
1672,Tyrone Mings,ENG,DF,Bournemouth,Premier League,24,1993,2.2,1,1,1,0,0,0,0,0.0,0,2,2,0,6,7,13,1,0,2017-2018,2.727272727272727,0.45454545454545453
1673,Ignasi Miquel,ESP,DF,Málaga,La Liga,24,1992,19.7,19,10,11,7,1,4,15,26.7,11,23,13,10,33,52,113,0,0,2017-2018,1.6751269035532996,0.9644670050761421
1674,Kevin Mirallas,BEL,"FW,MF",Everton,Premier League,29,1987,1.5,4,3,1,2,1,0,1,0.0,1,0,0,0,0,4,3,0,0,2017-2018,0.0,2.6666666666666665
1675,Miranda,BRA,DF,Inter,Serie A,32,1984,30.3,48,37,38,10,0,22,25,88.0,3,30,23,7,38,86,131,2,0,2017-2018,1.2541254125412542,1.584158415841584
1676,Antonio Mirante,ITA,GK,Bologna,Serie A,34,1983,33.0,0,0,0,0,0,0,3,0.0,3,1,0,1,0,0,11,5,0,2017-2018,0.0,0.0
1677,Simone Missiroli,ITA,MF,Sassuolo,Serie A,31,1986,32.4,62,37,25,31,6,14,72,19.4,58,46,8,38,67,129,70,0,0,2017-2018,2.0679012345679015,1.9135802469135803
1678,Kostas Mitroglou,GRE,FW,Marseille,Ligue 1,29,1988,9.7,3,2,1,2,0,1,4,25.0,3,1,1,0,0,3,2,0,0,2017-2018,0.0,0.30927835051546393
1679,Aleksandar Mitrović,SRB,FW,Newcastle Utd,Premier League,22,1994,1.1,1,1,0,1,0,0,1,0.0,1,1,0,1,0,1,2,0,0,2017-2018,0.0,0.9090909090909091
1680,Maximilian Mittelstädt,GER,"MF,DF",Hertha BSC,Bundesliga,20,1997,4.7,19,11,14,4,1,10,19,52.6,9,8,1,7,9,28,11,0,0,2017-2018,1.9148936170212765,4.042553191489362
1681,Henrikh Mkhitaryan,ARM,"FW,MF",Arsenal,Premier League,28,1989,8.8,18,13,9,7,2,5,21,23.8,16,16,2,14,8,26,7,0,0,2017-2018,0.9090909090909091,2.0454545454545454
1682,Henrikh Mkhitaryan,ARM,"MF,FW",Manchester Utd,Premier League,28,1989,10.2,15,11,4,7,4,5,25,20.0,20,8,0,8,7,22,3,0,0,2017-2018,0.6862745098039216,1.4705882352941178
1683,Luka Modrić,CRO,MF,Real Madrid,La Liga,31,1985,21.9,33,22,14,15,4,15,41,36.6,26,13,4,9,31,64,7,0,0,2017-2018,1.4155251141552512,1.5068493150684932
1684,Niklas Moisander,FIN,DF,Werder Bremen,Bundesliga,31,1985,25.0,36,28,22,13,1,24,36,66.7,12,21,9,12,38,74,98,2,0,2017-2018,1.52,1.44
1685,Johan Mojica,COL,DF,Girona,La Liga,24,1992,23.7,42,27,31,8,3,21,37,56.8,16,24,3,21,32,74,42,2,0,2017-2018,1.350210970464135,1.7721518987341773
1686,Jorge Molina,ESP,FW,Getafe,La Liga,35,1982,31.0,18,10,3,6,9,4,27,14.8,23,25,4,21,7,25,27,0,0,2017-2018,0.22580645161290322,0.5806451612903226
1687,Daniel Molina Orta,ESP,MF,Celta Vigo,La Liga,21,1996,0.1,0,0,0,0,0,0,0,0.0,0,0,0,0,0,0,0,0,0,2017-2018,0.0,0.0
1688,Cristian Molinaro,ITA,DF,Torino,Serie A,34,1983,17.4,37,29,19,14,4,11,18,61.1,7,15,4,11,22,59,70,1,0,2017-2018,1.264367816091954,2.1264367816091956
1689,Francisco Molinero,ESP,DF,Getafe,La Liga,32,1985,6.4,13,10,10,3,0,7,16,43.8,9,6,0,6,14,27,27,0,0,2017-2018,2.1875,2.03125
1690,Florent Mollet,FRA,"MF,FW",Metz,Ligue 1,25,1991,15.7,25,18,10,12,3,3,25,12.0,22,8,1,7,11,36,8,0,0,2017-2018,0.7006369426751593,1.5923566878980893
1691,Momo,ESP,"FW,MF",Las Palmas,La Liga,35,1982,7.5,14,8,8,3,3,4,13,30.8,9,5,0,5,5,19,1,0,0,2017-2018,0.6666666666666666,1.8666666666666667
1692,Thomas Monconduit,FRA,MF,Amiens,Ligue 1,26,1991,32.8,81,49,33,43,5,34,87,39.1,53,52,17,35,55,136,81,2,0,2017-2018,1.676829268292683,2.4695121951219514
1693,Kévin Monnet-Paquet,FRA,"FW,MF",Saint-Étienne,Ligue 1,28,1988,19.6,33,25,9,19,5,11,48,22.9,37,15,2,13,13,46,23,1,0,2017-2018,0.6632653061224489,1.683673469387755
1694,Nacho Monreal,ESP,DF,Arsenal,Premier League,31,1986,24.9,54,32,19,29,6,21,48,43.8,27,26,7,19,56,110,83,2,0,2017-2018,2.248995983935743,2.168674698795181
1695,Jefferson Montero,ECU,"MF,FW",Getafe,La Liga,27,1989,0.6,1,1,1,0,0,1,1,100.0,0,0,0,0,0,1,2,0,0,2017-2018,0.0,1.6666666666666667
1696,Riccardo Montolivo,ITA,MF,Milan,Serie A,32,1985,12.1,29,21,11,15,3,7,24,29.2,17,17,4,13,19,48,15,0,0,2017-2018,1.5702479338842976,2.396694214876033
1697,Martín Montoya,ESP,DF,Valencia,La Liga,26,1991,23.9,66,48,36,22,8,30,55,54.5,25,35,10,25,53,119,89,0,0,2017-2018,2.2175732217573225,2.761506276150628
1698,Walter Montoya,ARG,FW,Sevilla,La Liga,24,1993,0.8,1,1,1,0,0,1,3,33.3,2,1,0,1,0,1,3,0,0,2017-2018,0.0,1.25
1699,Shaq Moore,USA,DF,Levante,La Liga,20,1996,4.7,8,6,3,3,2,3,7,42.9,4,4,0,4,13,21,11,0,0,2017-2018,2.7659574468085104,1.702127659574468
1700,Aaron Mooy,AUS,MF,Huddersfield,Premier League,26,1990,34.1,102,60,39,51,12,23,55,41.8,32,39,5,34,38,140,52,0,0,2017-2018,1.1143695014662756,2.9912023460410557
1701,Emre Mor,TUR,"FW,MF",Celta Vigo,La Liga,20,1997,7.4,14,7,6,7,1,6,11,54.5,5,7,1,6,4,18,7,0,0,2017-2018,0.5405405405405405,1.8918918918918919
1702,Luca Mora,ITA,MF,SPAL,Serie A,29,1988,10.4,19,17,6,8,5,5,17,29.4,12,9,3,6,4,23,20,0,0,2017-2018,0.3846153846153846,1.8269230769230769
1703,Sergio Mora,ESP,MF,Getafe,La Liga,37,1979,9.0,21,15,8,12,1,14,31,45.2,17,10,2,8,15,36,11,0,0,2017-2018,1.6666666666666667,2.3333333333333335
1704,Erik Morán,ESP,MF,Leganés,La Liga,26,1991,2.5,2,2,1,0,1,0,3,0.0,3,1,1,0,4,6,0,0,0,2017-2018,1.6,0.8
1705,Álvaro Morata,ESP,FW,Chelsea,Premier League,24,1992,22.9,13,8,0,7,6,1,21,4.8,20,17,4,13,6,19,20,0,0,2017-2018,0.26200873362445415,0.5676855895196506
1706,Jan Morávek,CZE,MF,Augsburg,Bundesliga,27,1989,7.8,41,37,17,23,1,21,36,58.3,15,19,3,16,11,52,11,0,0,2017-2018,1.4102564102564104,5.256410256410256
1707,Jérémy Morel,MAD,DF,Lyon,Ligue 1,33,1984,32.4,39,27,23,15,1,18,23,78.3,5,28,23,5,46,85,129,5,0,2017-2018,1.4197530864197532,1.2037037037037037
1708,Alberto Moreno,ESP,DF,Liverpool,Premier League,25,1992,14.1,35,26,21,12,2,13,29,44.8,16,19,2,17,12,47,44,0,0,2017-2018,0.851063829787234,2.4822695035460995
1709,Gerard Moreno,ESP,FW,Espanyol,La Liga,25,1992,37.9,41,28,7,22,12,12,53,22.6,41,27,6,21,19,60,46,0,0,2017-2018,0.5013192612137204,1.0817941952506596
1710,Héctor Moreno,MEX,DF,Roma,Serie A,29,1988,2.6,2,2,1,1,0,0,1,0.0,1,1,1,0,3,5,5,0,0,2017-2018,1.1538461538461537,0.7692307692307692
1711,Héctor Moreno,MEX,DF,Real Sociedad,La Liga,29,1988,8.0,7,3,7,0,0,5,7,71.4,2,3,3,0,10,17,17,0,0,2017-2018,1.25,0.875
1712,Marlos Moreno,COL,"MF,DF",Girona,La Liga,20,1996,0.3,1,1,0,0,1,0,1,0.0,1,1,0,1,0,1,0,0,0,2017-2018,0.0,3.3333333333333335
1713,Emiliano Moretti,ITA,DF,Torino,Serie A,36,1981,19.8,31,18,25,6,0,14,16,87.5,2,30,23,7,21,52,77,2,0,2017-2018,1.0606060606060606,1.5656565656565655
1714,Wes Morgan,JAM,DF,Leicester City,Premier League,33,1984,31.3,35,25,26,8,1,12,18,66.7,6,41,27,14,31,66,146,1,0,2017-2018,0.9904153354632588,1.1182108626198082
1715,Loren Morón,ESP,FW,Betis,La Liga,23,1993,11.8,14,8,4,5,5,4,17,23.5,13,14,1,13,1,15,12,0,0,2017-2018,0.0847457627118644,1.1864406779661016
1716,James Morrison,SCO,MF,West Brom,Premier League,31,1986,2.3,2,1,0,2,0,1,4,25.0,3,1,1,0,1,3,1,0,0,2017-2018,0.4347826086956522,0.8695652173913044
1717,Victor Moses,NGA,"DF,MF",Chelsea,Premier League,26,1990,23.4,37,29,21,13,3,14,24,58.3,10,29,4,25,15,52,39,2,0,2017-2018,0.6410256410256411,1.5811965811965814
1718,Pedro Mosquera,ESP,MF,La Coruña,La Liga,29,1988,15.5,48,31,15,29,4,13,38,34.2,25,26,6,20,23,71,38,0,0,2017-2018,1.4838709677419355,3.096774193548387
1719,Lebo Mothiba,RSA,FW,Lille,Ligue 1,21,1996,13.2,8,5,4,0,4,0,7,0.0,7,6,2,4,2,10,11,0,0,2017-2018,0.15151515151515152,0.6060606060606061
1720,Thiago Motta,ITA,MF,Paris S-G,Ligue 1,34,1982,12.8,28,21,14,11,3,8,24,33.3,16,15,6,9,21,49,26,1,0,2017-2018,1.640625,2.1875
1721,François Moubandje,SUI,DF,Toulouse,Ligue 1,27,1990,18.9,28,15,20,7,1,10,34,29.4,24,23,7,16,27,55,75,0,0,2017-2018,1.4285714285714286,1.4814814814814816
1722,Jessy Moulin,FRA,GK,Saint-Étienne,Ligue 1,31,1986,3.4,0,0,0,0,0,0,0,0.0,0,0,0,0,0,0,3,2,0,2017-2018,0.0,0.0
1723,Steve Mounié,BEN,FW,Huddersfield,Premier League,22,1994,20.6,11,8,2,4,5,0,19,0.0,19,23,3,20,7,18,30,0,0,2017-2018,0.3398058252427184,0.5339805825242718
1724,Lucas Moura,BRA,"FW,MF",Tottenham,Premier League,24,1992,2.3,4,2,3,0,1,1,3,33.3,2,2,0,2,2,6,2,0,0,2017-2018,0.8695652173913044,1.7391304347826089
1725,Lucas Moura,BRA,FW,Paris S-G,Ligue 1,24,1992,0.8,1,1,0,1,0,0,1,0.0,1,0,0,0,0,1,0,0,0,2017-2018,0.0,1.25
1726,Lys Mousset,FRA,"FW,MF",Bournemouth,Premier League,21,1996,6.6,9,5,6,3,0,0,8,0.0,8,5,2,3,3,12,9,0,0,2017-2018,0.4545454545454546,1.3636363636363638
1727,João Moutinho,POR,MF,Monaco,Ligue 1,30,1986,31.1,65,41,19,37,9,27,80,33.8,53,52,12,40,36,101,54,0,0,2017-2018,1.157556270096463,2.090032154340836
1728,Samuel Moutoussamy,COD,MF,Nantes,Ligue 1,20,1996,4.8,15,7,6,7,2,5,8,62.5,3,7,1,6,3,18,4,0,0,2017-2018,0.625,3.125
1729,Toni Moya,ESP,MF,Atlético Madrid,La Liga,19,1998,0.0,0,0,0,0,0,0,0,0.0,0,0,0,0,0,0,0,0,0,2017-2018,,
1730,Ndombe Mubele,COD,"FW,MF",Toulouse,Ligue 1,23,1994,4.1,8,4,6,2,0,4,10,40.0,6,11,0,11,9,17,4,0,0,2017-2018,2.1951219512195124,1.9512195121951221
1731,Ndombe Mubele,COD,"FW,MF",Rennes,Ligue 1,23,1994,13.6,14,8,5,6,3,5,13,38.5,8,9,0,9,3,17,3,0,0,2017-2018,0.22058823529411764,1.0294117647058825
1732,Nordi Mukiele,FRA,DF,Montpellier,Ligue 1,19,1997,31.0,70,55,41,25,4,25,44,56.8,19,26,14,12,73,143,104,2,0,2017-2018,2.3548387096774195,2.2580645161290325
1733,Álex Mula,ESP,"FW,MF",Málaga,La Liga,21,1996,6.2,7,3,3,4,0,2,12,16.7,10,5,0,5,6,13,1,0,0,2017-2018,0.9677419354838709,1.129032258064516
1734,Florian Müller,GER,GK,Mainz 05,Bundesliga,19,1997,5.0,0,0,0,0,0,0,0,0.0,0,0,0,0,0,0,1,1,0,2017-2018,0.0,0.0
1735,Nicolai Müller,GER,"DF,MF",Hamburger SV,Bundesliga,29,1987,1.1,2,0,0,1,1,0,0,0.0,0,1,0,1,0,2,0,0,0,2017-2018,0.0,1.8181818181818181
1736,Thomas Müller,GER,"MF,FW",Bayern Munich,Bundesliga,27,1989,22.3,35,30,10,15,10,13,27,48.1,14,17,1,16,7,42,14,1,0,2017-2018,0.3139013452914798,1.569506726457399
1737,Iker Muniain,ESP,"MF,FW",Athletic Club,La Liga,24,1992,8.7,10,8,2,6,2,1,7,14.3,6,4,0,4,4,14,3,0,0,2017-2018,0.4597701149425288,1.149425287356322
1738,Marc Muniesa,ESP,DF,Girona,La Liga,25,1992,12.5,33,18,17,15,1,11,23,47.8,12,12,5,7,33,66,40,0,0,2017-2018,2.64,2.64
1739,Ezequiel Muñoz,ARG,DF,Leganés,La Liga,26,1990,15.6,36,28,24,12,0,11,20,55.0,9,18,11,7,24,60,84,0,0,2017-2018,1.5384615384615385,2.307692307692308
1740,Sulley Muntari,GHA,MF,La Coruña,La Liga,32,1984,4.5,9,7,2,7,0,1,7,14.3,6,10,4,6,11,20,10,0,0,2017-2018,2.4444444444444446,2.0
1741,Alessandro Murgia,ITA,MF,Lazio,Serie A,20,1996,8.6,19,12,9,9,1,5,19,26.3,14,14,3,11,17,36,13,0,0,2017-2018,1.9767441860465118,2.2093023255813953
1742,Luis Muriel,COL,FW,Sevilla,La Liga,26,1991,17.9,16,9,2,8,6,2,23,8.7,21,16,2,14,3,19,4,1,0,2017-2018,0.1675977653631285,0.893854748603352
1743,Jeison Murillo,COL,DF,Valencia,La Liga,25,1992,15.3,31,24,25,6,0,14,21,66.7,7,18,9,9,29,60,85,1,0,2017-2018,1.8954248366013071,2.026143790849673
1744,Jacob Murphy,ENG,"MF,FW",Newcastle Utd,Premier League,22,1995,12.8,13,10,5,4,4,7,27,25.9,20,16,0,16,6,19,13,2,0,2017-2018,0.46875,1.015625
1745,Jamie Murphy,SCO,MF,Brighton,Premier League,27,1989,1.9,2,2,2,0,0,2,4,50.0,2,0,0,0,1,3,3,0,0,2017-2018,0.5263157894736842,1.0526315789473684
1746,Glenn Murray,ENG,FW,Brighton,Premier League,33,1983,24.4,18,12,4,11,3,2,18,11.1,16,16,4,12,5,23,27,0,0,2017-2018,0.20491803278688525,0.7377049180327869
1747,Nicola Murru,ITA,DF,Sampdoria,Serie A,22,1994,16.1,40,31,18,18,4,24,38,63.2,14,29,4,25,17,57,60,1,0,2017-2018,1.0559006211180124,2.484472049689441
1748,Mateo Musacchio,ARG,DF,Milan,Serie A,26,1990,13.4,22,15,13,7,2,8,16,50.0,8,9,3,6,12,34,58,1,0,2017-2018,0.8955223880597015,1.6417910447761193
1749,Charly Musonda Jr.,BEL,FW,Chelsea,Premier League,20,1996,0.4,1,0,0,0,1,1,1,100.0,0,0,0,0,0,1,0,0,0,2017-2018,0.0,2.5
1750,Shkodran Mustafi,GER,DF,Arsenal,Premier League,25,1992,25.3,64,46,42,18,4,28,54,51.9,26,23,15,8,57,121,175,2,0,2017-2018,2.2529644268774702,2.5296442687747036
1751,Yoshinori Mutō,JPN,FW,Mainz 05,Bundesliga,25,1992,21.2,21,15,6,8,7,5,14,35.7,9,16,0,16,6,27,12,0,0,2017-2018,0.2830188679245283,0.9905660377358491
1752,Fahad Al Muwallad,KSA,MF,Levante,La Liga,22,1994,0.3,0,0,0,0,0,0,1,0.0,1,0,0,0,1,1,0,0,0,2017-2018,3.3333333333333335,0.0
1753,Yvon Mvogo,SUI,GK,RB Leipzig,Bundesliga,23,1994,1.0,0,0,0,0,0,0,0,0.0,0,0,0,0,0,0,1,1,0,2017-2018,0.0,0.0
1754,Boaz Myhill,WAL,GK,West Brom,Premier League,34,1982,1.0,0,0,0,0,0,0,0,0.0,0,0,0,0,0,0,1,0,0,2017-2018,0.0,0.0
1755,Alfred N'Diaye,SEN,"DF,MF",Villarreal,La Liga,27,1990,1.1,3,1,1,1,1,1,1,100.0,0,0,0,0,3,6,3,0,0,2017-2018,2.727272727272727,2.727272727272727
1756,Kévin N'Doram,FRA,"MF,DF",Monaco,Ligue 1,21,1996,8.0,16,10,6,9,1,6,24,25.0,18,6,2,4,16,32,29,0,0,2017-2018,2.0,2.0
1757,Abdallah N'dour,SEN,DF,Strasbourg,Ligue 1,23,1993,2.8,9,5,6,3,0,5,10,50.0,5,6,1,5,2,11,5,0,0,2017-2018,0.7142857142857143,3.2142857142857144
1758,Clinton N'Jie,CMR,FW,Marseille,Ligue 1,23,1993,9.7,10,6,2,5,3,2,9,22.2,7,5,0,5,3,13,0,0,0,2017-2018,0.30927835051546393,1.0309278350515465
1759,Georges-Kévin N'Koudou,CMR,MF,Tottenham,Premier League,22,1995,0.0,0,0,0,0,0,0,0,0.0,0,0,0,0,0,0,1,0,0,2017-2018,,
1760,Georges-Kévin N'Koudou,CMR,"MF,FW",Burnley,Premier League,22,1995,2.5,7,6,5,1,1,3,8,37.5,5,4,0,4,1,8,1,0,0,2017-2018,0.4,2.8
1761,Stanley N'Soki,FRA,DF,Paris S-G,Ligue 1,18,1999,0.3,0,0,0,0,0,0,1,0.0,1,0,0,0,0,0,1,0,0,2017-2018,0.0,0.0
1762,Nacho,ESP,DF,Real Madrid,La Liga,27,1990,23.0,55,40,29,19,7,20,38,52.6,18,21,9,12,46,101,51,0,0,2017-2018,2.0,2.391304347826087
1763,Yuto Nagatomo,JPN,DF,Inter,Serie A,30,1986,8.8,10,6,4,5,1,5,14,35.7,9,8,3,5,10,20,28,0,0,2017-2018,1.1363636363636362,1.1363636363636362
1764,Ádám Nagy,HUN,MF,Bologna,Serie A,22,1995,7.9,16,9,6,8,2,7,13,53.8,6,11,0,11,7,23,5,0,0,2017-2018,0.8860759493670886,2.0253164556962022
1765,Matías Nahuel,ESP,"MF,FW",Betis,La Liga,20,1996,2.8,4,4,1,1,2,2,5,40.0,3,2,0,2,2,6,1,0,0,2017-2018,0.7142857142857143,1.4285714285714286
1766,Radja Nainggolan,BEL,MF,Roma,Serie A,29,1988,29.0,49,36,14,28,7,9,33,27.3,24,18,1,17,18,67,31,1,0,2017-2018,0.6206896551724138,1.6896551724137931
1767,Préjuce Nakoulma,BFA,FW,Nantes,Ligue 1,30,1987,12.8,10,8,3,6,1,2,7,28.6,5,2,0,2,5,15,0,0,0,2017-2018,0.390625,0.78125
1768,Naldo,BRA,DF,Espanyol,La Liga,28,1988,10.2,14,8,12,1,1,5,10,50.0,5,13,10,3,16,30,57,1,0,2017-2018,1.5686274509803924,1.3725490196078431
1769,Naldo,BRA,DF,Schalke 04,Bundesliga,34,1982,34.0,51,36,38,12,1,31,46,67.4,15,39,21,18,55,106,200,1,0,2017-2018,1.6176470588235294,1.5
1770,Andrea Nalini,ITA,"FW,MF",Crotone,Serie A,27,1990,18.2,43,32,22,16,5,16,25,64.0,9,25,2,23,15,58,19,1,0,2017-2018,0.8241758241758242,2.3626373626373627
1771,Nani,POR,"FW,MF",Lazio,Serie A,30,1986,4.3,9,6,2,2,5,3,9,33.3,6,8,0,8,2,11,0,0,0,2017-2018,0.46511627906976744,2.0930232558139537
1772,Nano,ESP,FW,Levante,La Liga,22,1995,3.1,7,6,2,4,1,1,1,100.0,0,4,0,4,0,7,0,0,0,2017-2018,0.0,2.258064516129032
1773,Naranjo,ESP,"MF,FW",Leganés,La Liga,23,1994,6.2,17,10,3,12,2,4,12,33.3,8,11,1,10,3,20,4,0,0,2017-2018,0.48387096774193544,2.7419354838709675
1774,Luciano Narsingh,NED,"FW,MF",Swansea City,Premier League,26,1990,6.9,7,5,1,5,1,2,7,28.6,5,7,0,7,3,10,3,0,0,2017-2018,0.43478260869565216,1.0144927536231882
1775,Nikolas Nartey,DEN,MF,Köln,Bundesliga,17,2000,0.1,0,0,0,0,0,0,0,0.0,0,0,0,0,0,0,0,0,0,2017-2018,0.0,0.0
1776,Juanjo Narváez,COL,MF,Betis,La Liga,22,1995,3.4,8,6,4,4,0,3,6,50.0,3,3,0,3,8,16,4,0,0,2017-2018,2.3529411764705883,2.3529411764705883
1777,Matija Nastasić,SRB,DF,Schalke 04,Bundesliga,24,1993,22.1,48,38,37,10,1,28,37,75.7,9,40,22,18,36,84,85,0,0,2017-2018,1.6289592760180995,2.171945701357466
1778,Nathan,BRA,MF,Amiens,Ligue 1,21,1996,0.1,0,0,0,0,0,0,0,0.0,0,0,0,0,0,0,0,0,0,2017-2018,0.0,0.0
1779,Kyle Naughton,ENG,DF,Swansea City,Premier League,28,1988,33.7,92,60,49,35,8,54,100,54.0,46,60,13,47,60,152,144,4,0,2017-2018,1.780415430267062,2.729970326409495
1780,Fernando Navarro,ESP,DF,La Coruña,La Liga,35,1982,11.6,32,22,24,7,1,16,25,64.0,9,13,3,10,29,61,49,0,0,2017-2018,2.5,2.7586206896551726
1781,Marc Navarro,ESP,DF,Espanyol,La Liga,22,1995,12.3,20,13,12,8,0,10,20,50.0,10,11,6,5,22,42,17,0,0,2017-2018,1.7886178861788617,1.6260162601626016
1782,Rafa Navarro,ESP,DF,Betis,La Liga,23,1994,1.5,3,2,3,0,0,0,4,0.0,4,0,0,0,1,4,6,0,0,2017-2018,0.6666666666666666,2.0
1783,Ximo Navarro,ESP,DF,Las Palmas,La Liga,27,1990,29.0,63,43,44,19,0,28,50,56.0,22,27,16,11,66,129,131,4,0,2017-2018,2.2758620689655173,2.1724137931034484
1784,Jesús Navas,ESP,"FW,DF",Sevilla,La Liga,31,1985,19.6,32,25,17,9,6,12,26,46.2,14,14,5,9,19,51,37,0,0,2017-2018,0.9693877551020408,1.6326530612244896
1785,Keylor Navas,CRC,GK,Real Madrid,La Liga,30,1986,27.0,2,1,2,0,0,1,1,100.0,0,0,0,0,3,5,10,2,0,2017-2018,0.1111111111111111,0.07407407407407407
1786,Raúl Navas,ESP,DF,Real Sociedad,La Liga,29,1988,19.9,22,15,18,4,0,14,26,53.8,12,23,13,10,30,52,73,0,0,2017-2018,1.5075376884422111,1.105527638190955
1787,Badou Ndiaye,SEN,MF,Stoke City,Premier League,26,1990,12.6,53,28,22,25,6,16,41,39.0,25,21,9,12,13,66,18,0,0,2017-2018,1.0317460317460319,4.2063492063492065
1788,Wilfred Ndidi,NGA,MF,Leicester City,Premier League,20,1996,32.2,138,89,68,65,5,45,119,37.8,74,67,10,57,51,189,103,2,0,2017-2018,1.5838509316770184,4.285714285714286
1789,Merveille Ndockyt,CGO,"MF,FW",Getafe,La Liga,19,1998,0.8,1,1,0,1,0,0,1,0.0,1,2,0,2,2,3,0,0,0,2017-2018,2.5,1.25
1790,Tanguy Ndombele,FRA,MF,Amiens,Ligue 1,20,1996,2.6,6,5,2,4,0,1,4,25.0,3,4,0,4,5,11,3,0,0,2017-2018,1.923076923076923,2.3076923076923075
1791,Tanguy Ndombele,FRA,MF,Lyon,Ligue 1,20,1996,26.1,62,39,23,31,8,11,40,27.5,29,53,8,45,36,98,9,0,0,2017-2018,1.379310344827586,2.375478927203065
1792,Reiss Nelson,ENG,"FW,MF",Arsenal,Premier League,17,1999,1.6,4,3,1,1,2,0,0,0.0,0,4,0,4,3,7,0,0,0,2017-2018,1.875,2.5
1793,Neto,BRA,GK,Valencia,La Liga,28,1989,33.0,1,1,1,0,0,1,2,50.0,1,1,0,1,1,2,8,3,0,2017-2018,0.030303030303030304,0.030303030303030304
1794,Manuel Neuer,GER,GK,Bayern Munich,Bundesliga,31,1986,3.0,0,0,0,0,0,0,0,0.0,0,0,0,0,0,0,1,0,0,2017-2018,0.0,0.0
1795,Neymar,BRA,FW,Paris S-G,Ligue 1,25,1992,19.8,20,14,3,11,6,7,40,17.5,33,4,0,4,5,25,2,0,0,2017-2018,0.25252525252525254,1.0101010101010102
1796,Yeni Ngbakoto,COD,"FW,MF",Guingamp,Ligue 1,25,1992,6.4,11,10,4,6,1,3,10,30.0,7,10,0,10,9,20,6,0,0,2017-2018,1.40625,1.71875
1797,Santy Ngom,SEN,"FW,MF",Nantes,Ligue 1,24,1993,5.2,10,5,5,5,0,1,8,12.5,7,9,1,8,2,12,2,0,0,2017-2018,0.3846153846153846,1.923076923076923
1798,Guy Ngosso,CMR,MF,Amiens,Ligue 1,32,1985,6.8,8,5,4,4,0,4,20,20.0,16,5,3,2,9,17,19,0,0,2017-2018,1.3235294117647058,1.1764705882352942
1799,Julien Ngoy,BEL,MF,Stoke City,Premier League,19,1997,0.2,1,1,0,1,0,1,2,50.0,1,0,0,0,0,1,0,0,0,2017-2018,0.0,5.0
1800,Opa Nguette,SEN,"FW,MF",Metz,Ligue 1,23,1994,11.4,27,22,11,12,4,5,21,23.8,16,10,0,10,18,45,13,0,0,2017-2018,1.5789473684210527,2.3684210526315788
1801,Moussa Niakhate,SEN,DF,Metz,Ligue 1,21,1996,34.5,57,38,44,12,1,22,37,59.5,15,27,14,13,55,112,139,1,0,2017-2018,1.5942028985507246,1.6521739130434783
1802,Adama Niane,MLI,FW,Troyes,Ligue 1,24,1993,24.0,22,12,5,10,7,6,26,23.1,20,11,2,9,9,31,13,0,0,2017-2018,0.375,0.9166666666666666
1803,Ibrahima Niane,SEN,"FW,MF",Metz,Ligue 1,18,1999,9.4,6,5,4,1,1,2,8,25.0,6,6,0,6,4,10,8,0,0,2017-2018,0.425531914893617,0.6382978723404255
1804,M'Baye Niang,SEN,FW,Torino,Serie A,22,1994,17.0,29,23,11,9,9,6,18,33.3,12,17,3,14,13,42,15,0,0,2017-2018,0.7647058823529411,1.7058823529411764
1805,Oumar Niasse,SEN,FW,Everton,Premier League,27,1990,12.1,10,6,2,5,3,4,19,21.1,15,3,2,1,2,12,6,0,0,2017-2018,0.1652892561983471,0.8264462809917356
1806,Florian Niederlechner,GER,"FW,MF",Freiburg,Bundesliga,26,1990,7.7,8,6,1,5,2,2,5,40.0,3,5,1,4,3,11,6,0,0,2017-2018,0.38961038961038963,1.0389610389610389
1807,Saúl Ñíguez,ESP,MF,Atlético Madrid,La Liga,22,1994,35.1,132,90,53,69,10,40,104,38.5,64,61,12,49,55,187,77,0,0,2017-2018,1.5669515669515668,3.7606837606837606
1808,Casimir Ninga,CHA,"FW,MF",Montpellier,Ligue 1,24,1993,14.3,12,7,1,6,5,2,10,20.0,8,12,2,10,4,16,13,0,0,2017-2018,0.2797202797202797,0.8391608391608392
1809,Benjamin Nivet,FRA,"MF,FW",Troyes,Ligue 1,40,1977,15.2,31,14,12,14,5,11,51,21.6,40,18,1,17,16,47,20,0,0,2017-2018,1.0526315789473684,2.0394736842105265
1810,Eddie Nketiah,ENG,FW,Arsenal,Premier League,18,1999,0.2,1,1,0,1,0,0,0,0.0,0,0,0,0,0,1,0,0,0,2017-2018,0.0,5.0
1811,Jordan Nkololo,COD,"MF,FW",Caen,Ligue 1,24,1992,4.7,9,6,4,5,0,1,4,25.0,3,7,1,6,1,10,0,0,0,2017-2018,0.2127659574468085,1.9148936170212765
1812,Nicolas Nkoulou,CMR,DF,Torino,Serie A,27,1990,36.2,56,40,40,15,1,22,33,66.7,11,44,22,22,57,113,163,1,0,2017-2018,1.5745856353591159,1.5469613259668507
1813,Christopher Nkunku,FRA,"FW,MF",Paris S-G,Ligue 1,19,1997,7.0,5,2,2,2,1,3,14,21.4,11,8,2,6,5,10,2,1,0,2017-2018,0.7142857142857143,0.7142857142857143
1814,Lukas Nmecha,GER,FW,Manchester City,Premier League,18,1998,0.2,0,0,0,0,0,0,0,0.0,0,0,0,0,0,0,0,0,0,2017-2018,0.0,0.0
1815,Mark Noble,ENG,MF,West Ham,Premier League,30,1987,26.7,61,36,32,22,7,16,76,21.1,60,28,10,18,47,108,32,1,0,2017-2018,1.7602996254681649,2.2846441947565546
1816,Vincent Nogueira,FRA,MF,Strasbourg,Ligue 1,29,1988,0.7,0,0,0,0,0,0,0,0.0,0,0,0,0,0,0,2,0,0,2017-2018,0.0,0.0
1817,Nolito,ESP,"FW,MF",Sevilla,La Liga,30,1986,17.8,49,36,21,21,7,14,33,42.4,19,17,2,15,10,59,17,0,0,2017-2018,0.5617977528089887,2.752808988764045
1818,Håvard Nordtveit,NOR,DF,Hoffenheim,Bundesliga,27,1990,10.8,19,16,10,9,0,13,18,72.2,5,19,8,11,10,29,50,0,0,2017-2018,0.9259259259259258,1.759259259259259
1819,Paul-Georges Ntep,CMR,"FW,MF",Saint-Étienne,Ligue 1,25,1992,5.7,14,8,8,5,1,8,17,47.1,9,4,1,3,3,17,4,0,0,2017-2018,0.5263157894736842,2.456140350877193
1820,Paul-Georges Ntep,CMR,"FW,MF",Wolfsburg,Bundesliga,25,1992,1.8,2,2,0,0,2,0,1,0.0,1,3,1,2,1,3,0,0,0,2017-2018,0.5555555555555556,1.1111111111111112
1821,Alexander Nübel,GER,GK,Schalke 04,Bundesliga,20,1996,0.5,0,0,0,0,0,0,0,0.0,0,0,0,0,0,0,0,0,0,2017-2018,0.0,0.0
1822,Unai Núñez,ESP,DF,Athletic Club,La Liga,20,1997,32.7,73,52,54,19,0,38,56,67.9,18,52,27,25,67,140,155,2,0,2017-2018,2.0489296636085625,2.2324159021406724
1823,Bram Nuytinck,NED,DF,Udinese,Serie A,27,1990,26.2,65,41,40,24,1,25,39,64.1,14,43,24,19,37,102,124,1,0,2017-2018,1.4122137404580153,2.480916030534351
1824,Simeon Nwankwo,NGA,FW,Crotone,Serie A,25,1992,13.5,12,9,1,5,6,1,12,8.3,11,16,3,13,1,13,20,0,0,2017-2018,0.07407407407407407,0.8888888888888888
1825,Gerzino Nyamsi,FRA,DF,Rennes,Ligue 1,20,1997,3.0,4,2,4,0,0,0,3,0.0,3,2,2,0,3,7,18,2,0,2017-2018,1.0,1.3333333333333333
1826,Allan Nyom,CMR,DF,West Brom,Premier League,29,1988,25.7,64,39,43,17,4,28,43,65.1,15,20,9,11,27,91,93,0,0,2017-2018,1.0505836575875487,2.490272373540856
1827,Steven Nzonzi,FRA,MF,Sevilla,La Liga,28,1988,24.6,39,26,14,19,6,20,30,66.7,10,27,8,19,28,67,36,2,0,2017-2018,1.1382113821138211,1.5853658536585364
1828,Aiden O'Neill,AUS,MF,Burnley,Premier League,19,1998,0.0,0,0,0,0,0,,0,0.0,0,0,0,0,0,0,0,0,0,2017-2018,,
1829,Michael Obafemi,IRL,FW,Southampton,Premier League,17,2000,0.1,0,0,0,0,0,0,0,0.0,0,0,0,0,0,0,0,0,0,2017-2018,0.0,0.0
1830,Joel Obi,NGA,MF,Torino,Serie A,26,1991,13.9,45,25,20,20,5,8,26,30.8,18,17,3,14,24,69,15,0,0,2017-2018,1.7266187050359711,3.237410071942446
1831,Johann Obiang,GAB,DF,Troyes,Ligue 1,24,1993,5.2,13,9,9,2,2,6,13,46.2,7,9,1,8,7,20,15,0,0,2017-2018,1.346153846153846,2.5
1832,Pedro Obiang,EQG,MF,West Ham,Premier League,25,1992,17.4,53,34,20,29,4,17,51,33.3,34,37,16,21,24,77,27,1,0,2017-2018,1.3793103448275863,3.0459770114942533
1833,Jan Oblak,SVN,GK,Atlético Madrid,La Liga,24,1993,37.0,0,0,0,0,0,0,0,0.0,0,0,0,0,2,2,7,0,0,2017-2018,0.05405405405405406,0.0
1834,Lucas Ocampos,ARG,FW,Marseille,Ligue 1,23,1994,22.6,83,57,30,44,9,30,93,32.3,63,42,3,39,30,113,26,0,0,2017-2018,1.327433628318584,3.6725663716814156
1835,Philipp Ochs,GER,"FW,DF",Hoffenheim,Bundesliga,20,1997,0.8,5,4,1,3,1,1,2,50.0,1,0,0,0,1,6,0,0,0,2017-2018,1.25,6.25
1836,Bastian Oczipka,GER,"DF,MF",Schalke 04,Bundesliga,28,1989,25.8,60,48,29,26,5,29,37,78.4,8,41,2,39,40,100,40,1,0,2017-2018,1.5503875968992247,2.3255813953488373
1837,Álvaro Odriozola,ESP,DF,Real Sociedad,La Liga,21,1995,32.4,41,27,22,15,4,20,35,57.1,15,25,7,18,26,67,50,0,0,2017-2018,0.8024691358024691,1.2654320987654322
1838,Ebenezer Ofori,GHA,MF,Stuttgart,Bundesliga,22,1995,0.1,0,0,0,0,0,0,1,0.0,1,1,0,1,0,0,0,0,0,2017-2018,0.0,0.0
1839,Angelo Ogbonna,ITA,DF,West Ham,Premier League,29,1988,32.0,30,24,18,10,2,8,18,44.4,10,40,27,13,58,88,197,1,0,2017-2018,1.8125,0.9375
1840,Marios Oikonomou,GRE,DF,SPAL,Serie A,24,1992,1.9,5,3,4,1,0,0,2,0.0,2,0,0,0,4,9,12,0,0,2017-2018,2.1052631578947367,2.6315789473684212
1841,Stefano Okaka,ITA,FW,Watford,Premier League,27,1989,5.0,6,4,0,6,0,3,6,50.0,3,3,0,3,0,6,0,0,0,2017-2018,0.0,1.2
1842,Shinji Okazaki,JPN,"FW,MF",Leicester City,Premier League,31,1986,14.7,25,16,3,18,4,4,28,14.3,24,15,1,14,8,33,6,0,0,2017-2018,0.54421768707483,1.7006802721088436
1843,Orji Okwonkwo,NGA,"FW,MF",Bologna,Serie A,19,1998,2.9,9,3,6,3,0,1,4,25.0,3,2,0,2,1,10,1,0,0,2017-2018,0.3448275862068966,3.103448275862069
1844,Kwasi Okyere Wriedt,GHA,MF,Bayern Munich,Bundesliga,23,1994,0.3,2,2,1,1,0,0,0,0.0,0,0,0,0,0,2,0,0,0,2017-2018,0.0,6.666666666666667
1845,Oier Olazábal,ESP,GK,Levante,La Liga,27,1989,26.0,0,0,0,0,0,0,2,0.0,2,1,0,1,1,1,12,3,0,2017-2018,0.038461538461538464,0.0
1846,Paulo Oliveira,POR,DF,Eibar,La Liga,25,1992,24.6,41,22,28,13,0,16,22,72.7,6,23,9,14,62,103,140,0,0,2017-2018,2.5203252032520322,1.6666666666666665
1847,Mathías Olivera,URU,MF,Getafe,La Liga,19,1997,1.1,3,1,1,0,2,3,5,60.0,2,3,0,3,1,4,2,0,0,2017-2018,0.9090909090909091,2.727272727272727
1848,Maximiliano Olivera,URU,DF,Fiorentina,Serie A,25,1992,4.6,12,9,5,4,3,3,8,37.5,5,4,1,3,11,23,11,0,0,2017-2018,2.3913043478260874,2.608695652173913
1849,Paweł Olkowski,POL,DF,Köln,Bundesliga,27,1990,5.0,17,12,9,8,0,5,9,55.6,4,11,2,9,3,20,17,0,0,2017-2018,0.6,3.4
1850,Martin Olsson,SWE,DF,Swansea City,Premier League,29,1988,35.0,34,26,18,10,6,12,29,41.4,17,21,4,17,31,65,81,0,0,2017-2018,0.8857142857142857,0.9714285714285714
1851,Michael Olunga,KEN,"FW,MF",Girona,La Liga,23,1994,4.8,6,5,1,3,2,1,3,33.3,2,5,0,5,3,9,5,0,0,2017-2018,0.625,1.25
1852,Stephane Omeonga,BEL,"MF,DF",Genoa,Serie A,21,1996,8.9,25,15,16,8,1,7,18,38.9,11,20,1,19,5,30,6,0,0,2017-2018,0.5617977528089887,2.8089887640449436
1853,Prince Oniangué,CGO,MF,Angers,Ligue 1,28,1988,11.7,16,11,5,9,2,8,31,25.8,23,20,4,16,11,27,8,0,0,2017-2018,0.9401709401709403,1.3675213675213675
1854,Karim Onisiwo,AUT,"DF,FW",Mainz 05,Bundesliga,25,1992,2.8,7,5,5,1,1,3,7,42.9,4,4,0,4,1,8,8,0,0,2017-2018,0.35714285714285715,2.5
1855,Javier Ontiveros,ESP,"MF,FW",Málaga,La Liga,19,1997,4.3,10,7,8,2,0,2,4,50.0,2,4,2,2,4,14,4,0,0,2017-2018,0.9302325581395349,2.3255813953488373
1856,Daniel Opare,GHA,DF,Augsburg,Bundesliga,26,1990,15.7,31,27,20,10,1,21,27,77.8,6,14,5,9,28,59,56,0,0,2017-2018,1.78343949044586,1.9745222929936306
1857,Willi Orban,HUN,DF,RB Leipzig,Bundesliga,24,1992,23.6,49,30,35,14,0,29,43,67.4,14,45,18,27,28,77,155,1,0,2017-2018,1.1864406779661016,2.0762711864406778
1858,Fabián Orellana,CHI,"MF,FW",Eibar,La Liga,31,1986,13.1,14,8,5,8,1,4,23,17.4,19,10,1,9,7,21,3,0,0,2017-2018,0.5343511450381679,1.0687022900763359
1859,Divock Origi,BEL,FW,Liverpool,Premier League,22,1995,0.1,0,0,0,0,0,0,0,0.0,0,0,0,0,0,0,0,0,0,2017-2018,0.0,0.0
1860,Divock Origi,BEL,FW,Wolfsburg,Bundesliga,22,1995,21.9,6,5,2,3,1,1,7,14.3,6,16,2,14,3,9,17,0,0,2017-2018,0.13698630136986303,0.27397260273972607
1861,Riccardo Orsolini,ITA,"FW,DF",Bologna,Serie A,20,1997,3.8,5,5,4,1,0,1,5,20.0,4,2,1,1,3,8,4,0,0,2017-2018,0.7894736842105263,1.3157894736842106
1862,Riccardo Orsolini,ITA,"MF,FW",Atalanta,Serie A,20,1997,1.4,3,2,3,0,0,1,1,100.0,0,1,0,1,0,3,0,0,0,2017-2018,0.0,2.142857142857143
1863,Yuya Osako,JPN,"FW,MF",Köln,Bundesliga,27,1990,21.1,13,10,4,9,0,4,18,22.2,14,13,2,11,8,21,22,0,0,2017-2018,0.3791469194312796,0.6161137440758293
1864,Victor Osimhen,NGA,"FW,MF",Wolfsburg,Bundesliga,18,1998,3.2,4,4,3,1,0,2,5,40.0,3,2,1,1,2,6,7,0,0,2017-2018,0.625,1.25
1865,David Ospina,COL,GK,Arsenal,Premier League,28,1988,4.2,0,0,0,0,0,0,0,0.0,0,0,0,0,0,0,1,0,0,2017-2018,0.0,0.0
1866,Matthias Ostrzolek,GER,"DF,MF",Hannover 96,Bundesliga,27,1990,26.4,68,53,43,20,5,38,57,66.7,19,39,10,29,30,98,58,1,0,2017-2018,1.1363636363636365,2.5757575757575757
1867,Nicolás Otamendi,ARG,DF,Manchester City,Premier League,29,1988,33.0,58,43,35,22,1,19,44,43.2,25,21,10,11,48,106,129,3,0,2017-2018,1.4545454545454546,1.7575757575757576
1868,Otávio,BRA,MF,Bordeaux,Ligue 1,23,1994,16.5,64,42,25,37,2,20,61,32.8,41,26,4,22,32,96,35,0,0,2017-2018,1.9393939393939394,3.878787878787879
1869,Anas Ouahim,GER,MF,Köln,Bundesliga,19,1997,0.2,1,1,0,1,0,1,1,100.0,0,0,0,0,0,1,0,0,0,2017-2018,0.0,5.0
1870,Alexandre Oukidja,ALG,GK,Strasbourg,Ligue 1,29,1988,16.2,0,0,0,0,0,0,1,0.0,1,0,0,0,3,3,9,1,0,2017-2018,0.1851851851851852,0.0
1871,Adam Ounas,ALG,FW,Napoli,Serie A,20,1996,1.1,4,3,0,2,2,1,4,25.0,3,2,0,2,0,4,2,0,0,2017-2018,0.0,3.6363636363636362
1872,Reece Oxford,ENG,MF,West Ham,Premier League,18,1998,0.1,2,1,1,1,0,1,1,100.0,0,0,0,0,0,2,0,0,0,2017-2018,0.0,20.0
1873,Reece Oxford,ENG,"DF,MF",Gladbach,Bundesliga,18,1998,5.1,8,6,3,4,1,3,4,75.0,1,4,0,4,9,17,26,1,0,2017-2018,1.7647058823529413,1.5686274509803924
1874,Alex Oxlade-Chamberlain,ENG,DF,Arsenal,Premier League,23,1993,2.7,5,3,2,2,1,2,3,66.7,1,5,2,3,6,11,8,0,0,2017-2018,2.222222222222222,1.8518518518518516
1875,Alex Oxlade-Chamberlain,ENG,"MF,FW",Liverpool,Premier League,23,1993,16.6,32,21,13,14,5,6,21,28.6,15,24,0,24,20,52,14,0,0,2017-2018,1.2048192771084336,1.9277108433734937
1876,Mikel Oyarzabal,ESP,"FW,MF",Real Sociedad,La Liga,20,1997,30.8,33,23,10,13,10,7,39,17.9,32,32,2,30,18,51,19,0,0,2017-2018,0.5844155844155844,1.0714285714285714
1877,Ambroise Oyongo,CMR,DF,Montpellier,Ligue 1,26,1991,2.2,2,1,1,1,0,0,1,0.0,1,2,1,1,6,8,6,0,0,2017-2018,2.727272727272727,0.9090909090909091
1878,Berkay Özcan,TUR,"MF,FW",Stuttgart,Bundesliga,19,1998,11.1,19,10,7,9,3,7,11,63.6,4,14,2,12,3,22,8,0,0,2017-2018,0.2702702702702703,1.7117117117117118
1879,Ramazan Özcan,AUT,GK,Leverkusen,Bundesliga,33,1984,1.0,0,0,0,0,0,0,1,0.0,1,0,0,0,0,0,0,0,0,2017-2018,0.0,0.0
1880,Salih Özcan,TUR,MF,Köln,Bundesliga,19,1998,18.6,56,42,24,29,3,28,54,51.9,26,27,5,22,29,85,22,1,0,2017-2018,1.5591397849462365,3.010752688172043
1881,Mesut Özil,GER,"MF,FW",Arsenal,Premier League,28,1988,24.0,20,13,6,10,4,5,22,22.7,17,11,1,10,12,32,9,0,0,2017-2018,0.5,0.8333333333333334
1882,Levin Öztunalı,GER,"FW,MF",Mainz 05,Bundesliga,21,1996,19.3,26,19,8,15,3,10,20,50.0,10,25,0,25,11,37,9,0,0,2017-2018,0.5699481865284974,1.3471502590673574
1883,Pablo,BRA,DF,Bordeaux,Ligue 1,26,1991,14.3,16,15,13,3,0,10,16,62.5,6,13,7,6,16,32,96,1,0,2017-2018,1.1188811188811187,1.1188811188811187
1884,Daniel Pacheco,ESP,"MF,FW",Getafe,La Liga,26,1991,1.9,4,4,1,2,1,0,1,0.0,1,2,0,2,2,6,1,0,0,2017-2018,1.0526315789473684,2.1052631578947367
1885,Fernando Pacheco,ESP,GK,Alavés,La Liga,25,1992,37.3,0,0,0,0,0,0,0,0.0,0,1,0,1,3,3,12,4,0,2017-2018,0.0804289544235925,0.0
1886,Simone Padoin,ITA,"DF,MF",Cagliari,Serie A,33,1984,34.5,22,18,8,10,4,12,28,42.9,16,38,14,24,24,46,74,0,0,2017-2018,0.6956521739130435,0.6376811594202898
1887,Vincent Pajot,FRA,MF,Saint-Étienne,Ligue 1,26,1990,14.3,24,16,9,13,2,3,17,17.6,14,21,9,12,24,48,34,0,0,2017-2018,1.6783216783216783,1.6783216783216783
1888,Rodrigo Palacio,ARG,"FW,MF",Bologna,Serie A,35,1982,22.9,25,18,6,12,7,10,28,35.7,18,16,2,14,12,37,14,0,0,2017-2018,0.5240174672489083,1.091703056768559
1889,Raffaele Palladino,ITA,"MF,FW",Genoa,Serie A,33,1984,2.6,1,1,1,0,0,0,1,0.0,1,0,0,0,1,2,0,0,0,2017-2018,0.3846153846153846,0.3846153846153846
1890,Nicolas Pallois,FRA,DF,Nantes,Ligue 1,29,1987,27.0,39,28,25,9,5,18,36,50.0,18,34,19,15,35,74,182,3,0,2017-2018,1.2962962962962963,1.4444444444444444
1891,Kasey Palmer,JAM,"MF,FW",Huddersfield,Premier League,20,1996,1.9,6,3,2,3,1,2,8,25.0,6,5,0,5,0,6,2,0,0,2017-2018,0.0,3.1578947368421053
1892,Emerson Palmieri,ITA,DF,Chelsea,Premier League,22,1994,3.1,6,4,4,2,0,5,5,100.0,0,2,0,2,2,8,10,0,0,2017-2018,0.6451612903225806,1.9354838709677418
1893,Emerson Palmieri,ITA,DF,Roma,Serie A,22,1994,0.2,0,0,0,0,0,0,0,0.0,0,0,0,0,0,0,0,0,0,2017-2018,0.0,0.0
1894,Julian Palmieri,FRA,DF,Metz,Ligue 1,30,1986,12.5,29,15,17,9,3,17,29,58.6,12,16,2,14,22,51,31,0,0,2017-2018,1.76,2.32
1895,Simone Palombi,ITA,FW,Lazio,Serie A,21,1996,0.7,0,0,0,0,0,0,0,0.0,0,0,0,0,0,0,0,0,0,2017-2018,0.0,0.0
1896,Alberto Paloschi,ITA,FW,SPAL,Serie A,27,1990,24.3,10,7,0,9,1,0,10,0.0,10,2,1,1,4,14,11,0,0,2017-2018,0.1646090534979424,0.411522633744856
1897,Goran Pandev,MKD,"FW,MF",Genoa,Serie A,34,1983,20.0,10,9,3,6,1,2,13,15.4,11,8,0,8,4,14,5,0,0,2017-2018,0.2,0.5
1898,Costel Pantilimon,ROU,GK,La Coruña,La Liga,30,1987,6.0,0,0,0,0,0,0,1,0.0,1,0,0,0,0,0,0,1,0,2017-2018,0.0,0.0
1899,Kyriakos Papadopoulos,GRE,DF,Hamburger SV,Bundesliga,25,1992,29.0,60,54,36,24,0,41,69,59.4,28,54,35,19,43,103,181,2,0,2017-2018,1.4827586206896552,2.0689655172413794
1900,Sokratis Papastathopoulos,GRE,DF,Dortmund,Bundesliga,29,1988,26.4,65,47,50,13,2,39,47,83.0,8,36,11,25,30,95,112,0,0,2017-2018,1.1363636363636365,2.4621212121212124
1901,Rubén Pardo,ESP,MF,Real Sociedad,La Liga,24,1992,2.5,1,0,0,1,0,1,2,50.0,1,5,0,5,5,6,1,0,0,2017-2018,2.0,0.4
1902,Nicolás Pareja,ARG,DF,Sevilla,La Liga,33,1984,4.5,11,8,7,3,1,3,5,60.0,2,8,1,7,13,24,24,0,0,2017-2018,2.888888888888889,2.4444444444444446
1903,Daniel Parejo,ESP,MF,Valencia,La Liga,28,1989,33.3,88,57,35,43,10,31,87,35.6,56,37,10,27,34,122,27,1,0,2017-2018,1.021021021021021,2.642642642642643
1904,Vittorio Parigini,ITA,"MF,FW",Benevento,Serie A,21,1996,9.5,18,11,11,6,1,6,17,35.3,11,8,1,7,5,23,1,0,0,2017-2018,0.5263157894736842,1.894736842105263
1905,Shawn Parker,GER,"FW,MF",Augsburg,Bundesliga,24,1993,0.5,0,0,0,0,0,0,0,0.0,0,0,0,0,0,0,0,0,0,2017-2018,0.0,0.0
1906,Marco Parolo,ITA,MF,Lazio,Serie A,32,1985,29.0,70,37,27,36,7,14,58,24.1,44,49,8,41,43,113,64,0,0,2017-2018,1.4827586206896552,2.413793103448276
1907,Thomas Partey,GHA,"MF,DF",Atlético Madrid,La Liga,24,1993,26.4,94,64,48,39,7,33,69,47.8,36,32,7,25,53,147,34,1,0,2017-2018,2.007575757575758,3.560606060606061
1908,Felix Passlack,GER,"FW,DF",Hoffenheim,Bundesliga,19,1998,0.7,2,2,2,0,0,2,3,66.7,1,0,0,0,0,2,2,0,0,2017-2018,0.0,2.857142857142857
1909,Felix Passlack,GER,DF,Dortmund,Bundesliga,19,1998,0.1,0,0,0,0,0,0,0,0.0,0,0,0,0,1,1,0,0,0,2017-2018,10.0,0.0
1910,Javier Pastore,ARG,"MF,FW",Paris S-G,Ligue 1,28,1989,15.0,33,21,9,16,8,5,23,21.7,18,13,0,13,10,43,14,1,0,2017-2018,0.6666666666666666,2.2
1911,Patric,ESP,DF,Lazio,Serie A,24,1993,6.6,11,6,8,2,1,4,6,66.7,2,3,0,3,3,14,32,0,0,2017-2018,0.4545454545454546,1.6666666666666667
1912,Paulinho,BRA,MF,Barcelona,La Liga,29,1988,21.6,39,28,17,15,7,11,38,28.9,27,25,3,22,15,54,16,1,0,2017-2018,0.6944444444444444,1.8055555555555554
1913,Gabriel Paulista,BRA,DF,Valencia,La Liga,26,1990,28.7,47,27,41,4,2,32,46,69.6,14,30,14,16,51,98,142,2,0,2017-2018,1.7770034843205575,1.637630662020906
1914,Benjamin Pavard,FRA,DF,Stuttgart,Bundesliga,21,1996,34.0,55,40,40,13,2,36,47,76.6,11,59,34,25,70,125,192,1,0,2017-2018,2.0588235294117645,1.6176470588235294
1915,Jiří Pavlenka,CZE,GK,Werder Bremen,Bundesliga,25,1992,34.0,1,1,1,0,0,0,0,0.0,0,2,0,2,0,1,17,4,0,2017-2018,0.0,0.029411764705882353
1916,Daniel Pavlović,BIH,DF,Crotone,Serie A,29,1988,8.4,10,5,9,0,1,5,10,50.0,5,4,3,1,5,15,22,0,0,2017-2018,0.5952380952380952,1.1904761904761905
1917,Daniel Pavlović,BIH,DF,Sampdoria,Serie A,29,1988,1.0,3,1,1,1,1,1,1,100.0,0,0,0,0,0,3,5,0,0,2017-2018,0.0,3.0
1918,Mateo Pavlović,BIH,DF,Angers,Ligue 1,27,1990,21.8,13,7,10,3,0,7,20,35.0,13,14,11,3,21,34,120,0,0,2017-2018,0.963302752293578,0.5963302752293578
1919,Leonardo Pavoletti,ITA,FW,Cagliari,Serie A,28,1988,30.2,27,13,5,14,8,2,21,9.5,19,13,5,8,13,40,28,0,0,2017-2018,0.43046357615894043,0.8940397350993378
1920,Dimitri Payet,FRA,"MF,FW",Marseille,Ligue 1,30,1987,26.1,22,11,5,13,4,8,37,21.6,29,19,2,17,19,41,7,1,0,2017-2018,0.7279693486590038,0.842911877394636
1921,Giampaolo Pazzini,ITA,FW,Hellas Verona,Serie A,32,1984,11.0,0,0,0,0,0,0,4,0.0,4,2,0,2,1,1,13,0,0,2017-2018,0.09090909090909091,0.0
1922,Giampaolo Pazzini,ITA,FW,Levante,La Liga,32,1984,4.9,0,0,0,0,0,0,0,0.0,0,1,0,1,1,1,1,0,0,2017-2018,0.2040816326530612,0.0
1923,Alfonso Pedraza,ESP,"MF,DF",Alavés,La Liga,21,1996,27.1,57,40,24,21,12,19,56,33.9,37,39,5,34,32,89,26,0,0,2017-2018,1.1808118081180812,2.103321033210332
1924,Pedro,ESP,"MF,FW",Chelsea,Premier League,30,1987,16.9,20,11,6,8,6,5,18,27.8,13,13,1,12,13,33,7,1,0,2017-2018,0.7692307692307693,1.183431952662722
1925,João Pedro,ITA,"MF,FW",Cagliari,Serie A,25,1992,18.4,15,9,4,9,2,0,12,0.0,12,9,1,8,11,26,24,0,0,2017-2018,0.5978260869565218,0.8152173913043479
1926,Stef Peeters,BEL,MF,Caen,Ligue 1,25,1992,12.3,22,11,6,14,2,6,31,19.4,25,17,3,14,7,29,11,0,0,2017-2018,0.5691056910569106,1.7886178861788617
1927,Gianluca Pegolo,ITA,GK,Sassuolo,Serie A,36,1981,1.2,0,0,0,0,0,0,0,0.0,0,0,0,0,0,0,0,0,0,2017-2018,0.0,0.0
1928,Peter Pekarík,SVK,DF,Hertha BSC,Bundesliga,30,1986,15.3,42,33,17,21,4,21,29,72.4,8,23,3,20,18,60,44,0,0,2017-2018,1.1764705882352942,2.7450980392156863
1929,Bryan Pelé,FRA,"FW,MF",Troyes,Ligue 1,25,1992,17.9,20,9,9,8,3,4,28,14.3,24,11,0,11,15,35,13,0,0,2017-2018,0.8379888268156426,1.11731843575419
1930,Yohann Pelé,FRA,GK,Marseille,Ligue 1,34,1982,8.2,0,0,0,0,0,0,1,0.0,1,0,0,0,1,1,2,0,0,2017-2018,0.12195121951219513,0.0
1931,Pietro Pellegri,ITA,FW,Genoa,Serie A,16,2001,3.1,1,0,0,0,1,0,5,0.0,5,3,0,3,2,3,1,0,0,2017-2018,0.6451612903225806,0.3225806451612903
1932,Pietro Pellegri,ITA,FW,Monaco,Ligue 1,16,2001,0.3,0,0,0,0,0,0,2,0.0,2,1,0,1,0,0,0,0,0,2017-2018,0.0,0.0
1933,Lorenzo Pellegrini,ITA,MF,Roma,Serie A,21,1996,20.0,36,20,16,11,9,10,35,28.6,25,21,2,19,41,77,21,1,0,2017-2018,2.05,1.8
1934,Théo Pellenard,FRA,DF,Bordeaux,Ligue 1,23,1994,15.9,32,20,13,15,4,10,28,35.7,18,15,6,9,32,64,31,0,0,2017-2018,2.0125786163522013,2.0125786163522013
1935,Sergio Pellissier,ITA,FW,Chievo,Serie A,38,1979,6.2,6,2,1,3,2,1,3,33.3,2,3,0,3,1,7,2,0,0,2017-2018,0.16129032258064516,0.9677419354838709
1936,Federico Peluso,ITA,DF,Sassuolo,Serie A,33,1984,28.8,46,34,29,13,4,14,26,53.8,12,39,13,26,40,86,132,1,0,2017-2018,1.3888888888888888,1.597222222222222
1937,Rubén Peña,ESP,"DF,MF",Eibar,La Liga,26,1991,19.2,41,28,20,17,4,20,42,47.6,22,24,6,18,30,71,31,0,0,2017-2018,1.5625,2.135416666666667
1938,Gabriel Peñalba,ARG,MF,Las Palmas,La Liga,32,1984,6.3,6,5,4,2,0,5,11,45.5,6,7,4,3,8,14,15,0,0,2017-2018,1.2698412698412698,0.9523809523809524
1939,Adalberto Peñaranda,VEN,"FW,MF",Málaga,La Liga,20,1997,8.9,10,6,2,6,2,2,3,66.7,1,8,1,7,0,10,1,0,0,2017-2018,0.0,1.1235955056179774
1940,Nicolas Pépé,CIV,"FW,MF",Lille,Ligue 1,22,1995,31.6,30,18,14,11,5,11,42,26.2,31,23,0,23,10,40,20,0,0,2017-2018,0.3164556962025316,0.9493670886075949
1941,Andreas Pereira,BRA,MF,Valencia,La Liga,21,1996,12.0,26,15,12,11,3,10,30,33.3,20,9,1,8,11,37,5,0,0,2017-2018,0.9166666666666666,2.1666666666666665
1942,Pedro Pereira,POR,DF,Genoa,Serie A,19,1998,4.2,5,4,2,1,2,3,5,60.0,2,5,2,3,5,10,15,0,0,2017-2018,1.1904761904761905,1.1904761904761905
1943,Bruno Peres,BRA,DF,Roma,Serie A,27,1990,12.8,26,17,16,7,3,10,23,43.5,13,9,2,7,22,48,28,1,0,2017-2018,1.71875,2.03125
1944,Roberto Pereyra,ARG,"MF,FW",Watford,Premier League,26,1991,18.0,10,8,4,5,1,2,13,15.4,11,16,0,16,9,19,6,0,0,2017-2018,0.5,0.5555555555555556
1945,Ayoze Pérez,ESP,"MF,FW",Newcastle Utd,Premier League,24,1993,27.7,39,21,11,15,13,12,54,22.2,42,36,1,35,24,63,28,0,0,2017-2018,0.8664259927797834,1.407942238267148
1946,Hernán Pérez,PAR,MF,Alavés,La Liga,28,1989,4.2,11,8,6,4,1,2,19,10.5,17,5,0,5,3,14,6,0,0,2017-2018,0.7142857142857143,2.619047619047619
1947,Hernán Pérez,PAR,"MF,DF",Espanyol,La Liga,28,1989,1.6,4,3,1,1,2,2,3,66.7,1,1,0,1,1,5,1,0,0,2017-2018,0.625,2.5
1948,Lucas Pérez,ESP,FW,La Coruña,La Liga,28,1988,31.1,17,12,5,8,4,1,32,3.1,31,19,1,18,9,26,1,0,0,2017-2018,0.28938906752411575,0.5466237942122186
1949,Rubén Pérez,ESP,MF,Leganés,La Liga,28,1989,28.0,99,61,47,48,4,48,101,47.5,53,30,5,25,77,176,40,0,0,2017-2018,2.75,3.5357142857142856
1950,Stipe Perica,CRO,FW,Udinese,Serie A,22,1995,10.5,8,5,2,5,1,2,13,15.4,11,7,1,6,3,11,9,0,0,2017-2018,0.2857142857142857,0.7619047619047619
1951,Mattia Perin,ITA,GK,Genoa,Serie A,24,1992,37.0,0,0,0,0,0,0,1,0.0,1,0,0,0,1,1,14,2,0,2017-2018,0.02702702702702703,0.0
1952,Ivan Perišić,CRO,FW,Inter,Serie A,28,1989,36.8,47,31,15,23,9,8,56,14.3,48,47,6,41,45,92,62,0,0,2017-2018,1.2228260869565217,1.2771739130434783
1953,Diego Perotti,ARG,"FW,MF",Roma,Serie A,29,1988,17.9,25,17,6,14,5,8,20,40.0,12,19,0,19,11,36,13,0,0,2017-2018,0.6145251396648045,1.3966480446927376
1954,Romain Perraud,FRA,FW,Nice,Ligue 1,19,1997,0.0,0,0,0,0,0,0,0,0.0,0,0,0,0,0,0,0,0,0,2017-2018,,
1955,Loïc Perrin,FRA,DF,Saint-Étienne,Ligue 1,31,1985,27.4,39,26,28,10,1,21,31,67.7,10,35,22,13,36,75,142,1,0,2017-2018,1.3138686131386863,1.4233576642335768
1956,Andrea Petagna,ITA,FW,Atalanta,Serie A,22,1995,18.0,8,3,2,4,2,1,11,9.1,10,14,3,11,4,12,5,0,0,2017-2018,0.2222222222222222,0.4444444444444444
1957,Nils Petersen,GER,FW,Freiburg,Bundesliga,28,1988,24.9,27,18,7,18,2,10,27,37.0,17,28,2,26,17,44,33,0,0,2017-2018,0.6827309236947792,1.0843373493975905
1958,Bruno Petković,CRO,FW,Hellas Verona,Serie A,22,1994,10.2,14,12,3,8,3,6,13,46.2,7,11,1,10,7,21,12,0,0,2017-2018,0.6862745098039216,1.3725490196078431
1959,Bruno Petković,CRO,"FW,MF",Bologna,Serie A,22,1994,3.7,7,6,0,5,2,1,1,100.0,0,3,0,3,4,11,5,0,0,2017-2018,1.081081081081081,1.8918918918918919
1960,Germán Pezzella,ARG,DF,Fiorentina,Serie A,26,1991,33.1,63,47,42,19,2,19,41,46.3,22,33,16,17,63,126,185,1,0,2017-2018,1.903323262839879,1.903323262839879
1961,Giuseppe Pezzella,ITA,"DF,FW",Udinese,Serie A,19,1997,10.0,19,11,10,4,5,7,19,36.8,12,8,1,7,6,25,32,0,0,2017-2018,0.6,1.9
1962,Maximilian Philipp,GER,FW,Dortmund,Bundesliga,23,1994,13.4,24,19,9,12,3,6,19,31.6,13,12,0,12,6,30,7,0,0,2017-2018,0.44776119402985076,1.791044776119403
1963,Chris Philipps,LUX,"MF,DF",Metz,Ligue 1,23,1994,9.4,22,12,10,10,2,5,26,19.2,21,13,5,8,30,52,18,0,0,2017-2018,3.1914893617021276,2.3404255319148937
1964,Matt Phillips,SCO,"MF,DF",West Brom,Premier League,26,1991,23.3,27,16,17,5,5,10,29,34.5,19,21,1,20,24,51,43,0,0,2017-2018,1.0300429184549356,1.1587982832618025
1965,Lebogang Phiri,RSA,MF,Guingamp,Ligue 1,22,1994,11.5,28,17,14,12,2,11,43,25.6,32,9,2,7,19,47,13,0,0,2017-2018,1.6521739130434783,2.4347826086956523
1966,Pablo Piatti,ARG,"MF,FW",Espanyol,La Liga,28,1989,19.3,45,32,14,21,10,17,57,29.8,40,28,3,25,22,67,16,0,0,2017-2018,1.1398963730569949,2.33160621761658
1967,Jordan Pickford,ENG,GK,Everton,Premier League,23,1994,38.0,0,0,0,0,0,0,2,0.0,2,0,0,0,2,2,26,5,0,2017-2018,0.05263157894736842,0.0
1968,Jérémy Pied,FRA,DF,Southampton,Premier League,28,1989,2.0,9,6,8,1,0,6,9,66.7,3,3,2,1,8,17,4,0,0,2017-2018,4.0,4.5
1969,Nicholas Pierini,ITA,"MF,FW",Sassuolo,Serie A,18,1998,0.5,1,1,0,0,1,0,0,0.0,0,1,0,1,1,2,0,0,0,2017-2018,2.0,2.0
1970,Ronaël Pierre-Gabriel,FRA,DF,Saint-Étienne,Ligue 1,19,1998,13.0,43,31,33,7,3,17,28,60.7,11,11,2,9,9,52,35,0,0,2017-2018,0.6923076923076923,3.3076923076923075
1971,Erik Pieters,NED,DF,Stoke City,Premier League,28,1988,30.2,71,47,43,26,2,24,51,47.1,27,70,25,45,61,132,127,5,0,2017-2018,2.019867549668874,2.350993377483444
1972,Tomás Pina Isla,ESP,MF,Alavés,La Liga,29,1987,26.5,71,49,27,38,6,20,40,50.0,20,28,10,18,43,114,37,0,0,2017-2018,1.6226415094339623,2.6792452830188678
1973,Andrea Pinamonti,ITA,FW,Inter,Serie A,18,1999,0.2,0,0,0,0,0,0,0,0.0,0,0,0,0,0,0,0,0,0,2017-2018,0.0,0.0
1974,Carlo Pinsoglio,ITA,GK,Juventus,Serie A,27,1990,0.3,0,0,0,0,0,0,0,0.0,0,0,0,0,0,0,0,0,0,2017-2018,0.0,0.0
1975,Gerard Piqué,ESP,DF,Barcelona,La Liga,30,1987,29.2,31,22,22,9,0,16,36,44.4,20,40,27,13,30,61,127,0,0,2017-2018,1.0273972602739727,1.0616438356164384
1976,Facundo Píriz,URU,MF,Montpellier,Ligue 1,27,1990,9.0,25,16,9,12,4,6,35,17.1,29,10,1,9,18,43,14,0,0,2017-2018,2.0,2.7777777777777777
1977,Fabio Pisacane,ITA,DF,Cagliari,Serie A,31,1986,21.4,52,39,36,13,3,15,41,36.6,26,29,16,13,38,90,105,1,0,2017-2018,1.7757009345794394,2.429906542056075
1978,Łukasz Piszczek,POL,DF,Dortmund,Bundesliga,32,1985,23.8,51,37,23,23,5,30,52,57.7,22,39,11,28,42,93,64,1,0,2017-2018,1.7647058823529411,2.142857142857143
1979,Claudio Pizarro,PER,"FW,MF",Köln,Bundesliga,38,1978,6.4,11,9,3,6,2,6,9,66.7,3,10,2,8,3,14,5,0,0,2017-2018,0.46875,1.71875
1980,Guido Pizarro,ARG,MF,Sevilla,La Liga,27,1990,19.5,75,47,36,36,3,29,67,43.3,38,20,7,13,26,101,48,0,0,2017-2018,1.3333333333333333,3.8461538461538463
1981,Marko Pjaca,CRO,"FW,MF",Schalke 04,Bundesliga,22,1995,2.9,5,3,2,3,0,4,6,66.7,2,3,0,3,1,6,2,0,0,2017-2018,0.3448275862068966,1.7241379310344829
1982,Miralem Pjanić,BIH,MF,Juventus,Serie A,27,1990,27.6,36,30,13,18,5,13,51,25.5,38,25,5,20,64,100,27,2,0,2017-2018,2.318840579710145,1.3043478260869565
1983,Carles Planas,ESP,DF,Girona,La Liga,26,1991,2.1,5,2,4,1,0,3,6,50.0,3,1,0,1,5,10,6,0,0,2017-2018,2.380952380952381,2.380952380952381
1984,Jaroslav Plašil,CZE,MF,Bordeaux,Ligue 1,35,1982,11.6,24,14,7,17,0,7,31,22.6,24,18,6,12,21,45,15,0,0,2017-2018,1.8103448275862069,2.0689655172413794
1985,Marvin Plattenhardt,GER,DF,Hertha BSC,Bundesliga,25,1992,33.0,57,43,39,15,3,35,50,70.0,15,24,7,17,27,84,92,0,0,2017-2018,0.8181818181818182,1.7272727272727273
1986,Alassane Pléa,FRA,FW,Nice,Ligue 1,24,1993,33.8,15,9,5,7,3,5,32,15.6,27,14,3,11,8,23,21,0,0,2017-2018,0.2366863905325444,0.44378698224852076
1987,Morgan Poaty,CGO,DF,Montpellier,Ligue 1,20,1997,1.9,0,0,0,0,0,0,1,0.0,1,5,3,2,1,1,2,0,0,2017-2018,0.5263157894736842,0.0
1988,Gerónimo Poblete,ARG,MF,Metz,Ligue 1,24,1993,18.4,58,37,23,29,6,25,66,37.9,41,19,0,19,24,82,22,1,0,2017-2018,1.3043478260869565,3.1521739130434785
1989,Florentin Pogba,GUI,DF,Saint-Étienne,Ligue 1,26,1990,3.6,6,0,4,2,0,3,5,60.0,2,2,2,0,1,7,12,0,0,2017-2018,0.2777777777777778,1.6666666666666665
1990,Paul Pogba,FRA,MF,Manchester Utd,Premier League,24,1993,23.9,33,23,13,15,5,5,33,15.2,28,16,0,16,21,54,26,0,0,2017-2018,0.8786610878661089,1.380753138075314
1991,Joel Pohjanpalo,FIN,"MF,FW",Leverkusen,Bundesliga,22,1994,1.3,0,0,0,0,0,0,2,0.0,2,1,1,0,0,0,2,0,0,2017-2018,0.0,0.0
1992,Eugen Polanski,POL,MF,Hoffenheim,Bundesliga,31,1986,2.9,8,7,3,4,1,5,6,83.3,1,6,1,5,4,12,4,0,0,2017-2018,1.3793103448275863,2.7586206896551726
1993,Andrea Poli,ITA,MF,Bologna,Serie A,27,1989,28.3,66,53,33,27,6,18,64,28.1,46,55,3,52,43,109,27,0,0,2017-2018,1.519434628975265,2.3321554770318023
1994,Matteo Politano,ITA,FW,Sassuolo,Serie A,23,1993,31.2,23,16,8,10,5,3,32,9.4,29,13,2,11,14,37,13,0,0,2017-2018,0.44871794871794873,0.7371794871794872
1995,Julian Pollersbeck,GER,GK,Hamburger SV,Bundesliga,22,1994,10.0,0,0,0,0,0,0,1,0.0,1,0,0,0,0,0,4,1,0,2017-2018,0.0,0.0
1996,Ezequiel Ponce,ARG,FW,Lille,Ligue 1,20,1997,12.2,9,8,3,5,1,0,7,0.0,7,2,1,1,3,12,11,0,0,2017-2018,0.24590163934426232,0.7377049180327869
1997,Pere Pons,ESP,MF,Girona,La Liga,24,1993,28.4,80,54,28,48,4,23,87,26.4,64,28,3,25,30,110,25,0,0,2017-2018,1.0563380281690142,2.8169014084507045
1998,Simone Pontisso,ITA,MF,Udinese,Serie A,20,1997,0.1,1,0,0,1,0,0,0,0.0,0,0,0,0,0,1,0,0,0,2017-2018,0.0,10.0
1999,Nick Pope,ENG,GK,Burnley,Premier League,25,1992,34.6,0,0,0,0,0,0,1,0.0,1,0,0,0,0,0,21,0,0,2017-2018,0.0,0.0
2000,Jérémie Porsan-Clémenté,FRA,DF,Montpellier,Ligue 1,19,1997,1.0,3,2,1,2,0,2,2,100.0,0,1,0,1,1,4,4,1,0,2017-2018,1.0,3.0
2001,Francisco Portillo,ESP,"MF,FW",Getafe,La Liga,27,1990,27.3,38,23,15,18,5,11,45,24.4,34,25,1,24,22,60,21,0,0,2017-2018,0.8058608058608059,1.3919413919413919
2002,Portu,ESP,MF,Girona,La Liga,25,1992,33.3,30,24,9,11,10,8,33,24.2,25,14,0,14,12,42,1,0,0,2017-2018,0.3603603603603604,0.900900900900901
2003,Stefan Posch,AUT,DF,Hoffenheim,Bundesliga,20,1997,8.4,28,21,18,7,3,15,27,55.6,12,15,4,11,24,52,30,0,0,2017-2018,2.857142857142857,3.333333333333333
2004,Sergio Postigo,ESP,DF,Levante,La Liga,28,1988,26.9,36,23,30,5,1,18,32,56.3,14,27,13,14,40,76,140,1,0,2017-2018,1.4869888475836432,1.338289962825279
2005,Yussuf Poulsen,DEN,FW,RB Leipzig,Bundesliga,23,1994,18.5,23,19,2,13,8,7,12,58.3,5,24,5,19,9,32,8,0,0,2017-2018,0.4864864864864865,1.2432432432432432
2006,Maxime Poundjé,FRA,DF,Bordeaux,Ligue 1,24,1992,18.9,53,29,32,16,5,28,51,54.9,23,14,6,8,35,88,63,1,0,2017-2018,1.851851851851852,2.8042328042328046
2007,Darío Poveda,ESP,MF,Villarreal,La Liga,20,1997,0.0,1,0,0,1,0,1,1,100.0,0,0,0,0,0,1,0,0,0,2017-2018,,inf
2008,Dennis Praet,BEL,MF,Sampdoria,Serie A,23,1994,29.5,85,57,34,36,15,38,73,52.1,35,49,1,48,37,122,22,0,0,2017-2018,1.2542372881355932,2.8813559322033897
2009,Sanjin Prcić,BIH,MF,Rennes,Ligue 1,23,1993,17.4,37,18,9,24,4,8,39,20.5,31,19,5,14,30,67,25,0,0,2017-2018,1.7241379310344829,2.1264367816091956
2010,Nicolas de Préville,FRA,FW,Bordeaux,Ligue 1,26,1991,21.5,34,27,10,15,9,9,33,27.3,24,25,4,21,21,55,12,0,0,2017-2018,0.9767441860465116,1.5813953488372092
2011,Nicolas de Préville,FRA,"FW,MF",Lille,Ligue 1,26,1991,3.2,3,3,0,1,2,1,5,20.0,4,3,0,3,0,3,2,0,0,2017-2018,0.0,0.9375
2012,Andrés Prieto,ESP,GK,Málaga,La Liga,23,1993,4.0,0,0,0,0,0,0,0,0.0,0,0,0,0,0,0,2,0,0,2017-2018,0.0,0.0
2013,Xabi Prieto,ESP,"MF,FW",Real Sociedad,La Liga,33,1983,21.4,18,14,5,9,4,2,10,20.0,8,8,2,6,7,25,20,0,0,2017-2018,0.3271028037383178,0.8411214953271029
2014,Jérôme Prior,FRA,GK,Bordeaux,Ligue 1,21,1995,2.0,0,0,0,0,0,0,0,0.0,0,0,0,0,0,0,2,2,0,2017-2018,0.0,0.0
2015,Alex Pritchard,ENG,"MF,FW",Huddersfield,Premier League,24,1993,11.1,18,8,2,6,10,10,21,47.6,11,6,1,5,5,23,11,0,0,2017-2018,0.45045045045045046,1.6216216216216217
2016,Sloan Privat,FRA,FW,Guingamp,Ligue 1,28,1989,0.0,0,0,0,0,0,0,0,0.0,0,0,0,0,0,0,0,0,0,2017-2018,,
2017,Sebastian Prödl,AUT,DF,Watford,Premier League,30,1987,17.4,22,17,19,3,0,8,15,53.3,7,20,9,11,31,53,92,1,0,2017-2018,1.781609195402299,1.264367816091954
2018,Davy Pröpper,NED,MF,Brighton,Premier League,25,1991,34.7,73,44,35,35,3,18,83,21.7,65,35,11,24,60,133,80,2,0,2017-2018,1.7291066282420748,2.1037463976945245
2019,Manuel Pucciarelli,ITA,"FW,MF",Chievo,Serie A,26,1991,15.3,23,14,3,11,9,8,21,38.1,13,15,0,15,7,30,4,0,0,2017-2018,0.45751633986928103,1.5032679738562091
2020,Christian Puggioni,ITA,GK,Benevento,Serie A,36,1981,13.1,0,0,0,0,0,0,0,0.0,0,0,0,0,0,0,5,1,0,2017-2018,0.0,0.0
2021,Christian Puggioni,ITA,GK,Sampdoria,Serie A,36,1981,9.0,0,0,0,0,0,0,0,0.0,0,0,0,0,0,0,6,1,0,2017-2018,0.0,0.0
2022,Marc Pugh,ENG,"MF,FW",Bournemouth,Premier League,30,1987,10.9,7,3,2,4,1,2,10,20.0,8,6,1,5,13,20,13,2,0,2017-2018,1.1926605504587156,0.6422018348623852
2023,Erick Pulgar,CHI,MF,Bologna,Serie A,23,1994,30.8,70,48,41,29,0,24,75,32.0,51,49,13,36,46,116,83,1,0,2017-2018,1.4935064935064934,2.2727272727272725
2024,Christian Pulisic,USA,"FW,DF",Dortmund,Bundesliga,18,1998,25.6,46,30,12,20,14,26,44,59.1,18,24,2,22,16,62,11,0,0,2017-2018,0.625,1.796875
2025,Jason Puncheon,ENG,MF,Crystal Palace,Premier League,31,1986,7.2,13,4,3,7,3,1,5,20.0,4,3,0,3,5,18,4,0,0,2017-2018,0.6944444444444444,1.8055555555555556
2026,George Pușcaș,ROU,"FW,MF",Benevento,Serie A,21,1996,7.8,0,0,0,0,0,0,3,0.0,3,0,0,0,1,1,13,0,0,2017-2018,0.12820512820512822,0.0
2027,Loïc Puyo,FRA,MF,Angers,Ligue 1,28,1988,1.9,9,5,2,5,2,3,4,75.0,1,7,3,4,4,13,2,0,0,2017-2018,2.1052631578947367,4.736842105263158
2028,Fabio Quagliarella,ITA,FW,Sampdoria,Serie A,34,1983,30.2,11,9,1,3,7,2,25,8.0,23,34,0,34,7,18,23,0,0,2017-2018,0.2317880794701987,0.3642384105960265
2029,Robin Quaison,SWE,FW,Mainz 05,Bundesliga,23,1993,15.7,17,14,1,10,6,7,11,63.6,4,16,2,14,7,24,9,0,0,2017-2018,0.445859872611465,1.0828025477707006
2030,Collin Quaner,GER,"FW,MF",Huddersfield,Premier League,26,1991,14.2,22,15,8,8,6,9,26,34.6,17,24,4,20,11,33,15,0,0,2017-2018,0.7746478873239437,1.5492957746478875
2031,Dani Raba,ESP,"MF,FW",Villarreal,La Liga,21,1995,12.3,25,21,9,12,4,9,45,20.0,36,21,1,20,17,42,10,0,0,2017-2018,1.3821138211382114,2.0325203252032518
2032,Adrien Rabiot,FRA,MF,Paris S-G,Ligue 1,22,1995,26.2,59,36,27,23,9,15,36,41.7,21,29,10,19,33,92,22,1,0,2017-2018,1.2595419847328244,2.2519083969465647
2033,Nemanja Radoja,SRB,MF,Celta Vigo,La Liga,24,1993,12.3,18,16,6,8,4,3,8,37.5,5,8,2,6,10,28,11,0,0,2017-2018,0.8130081300813008,1.4634146341463414
2034,Ivan Radovanović,SRB,MF,Chievo,Serie A,28,1988,34.9,55,35,30,22,3,18,48,37.5,30,39,16,23,47,102,107,1,0,2017-2018,1.346704871060172,1.5759312320916905
2035,Ștefan Radu,ROU,DF,Lazio,Serie A,30,1986,28.8,53,38,36,16,1,25,41,61.0,16,30,14,16,55,108,105,1,0,2017-2018,1.909722222222222,1.8402777777777777
2036,Rafael,BRA,GK,Cagliari,Serie A,35,1982,8.8,0,0,0,0,0,0,0,0.0,0,0,0,0,1,1,9,0,0,2017-2018,0.11363636363636363,0.0
2037,Rafael,BRA,DF,Lyon,Ligue 1,27,1990,20.1,54,28,30,18,6,22,43,51.2,21,20,3,17,42,96,53,0,0,2017-2018,2.08955223880597,2.6865671641791042
2038,Raffael,BRA,FW,Gladbach,Bundesliga,32,1985,23.0,40,32,12,23,5,17,36,47.2,19,18,0,18,8,48,2,0,0,2017-2018,0.34782608695652173,1.7391304347826086
2039,Rafinha,BRA,MF,Inter,Serie A,24,1993,11.6,14,9,1,10,3,3,16,18.8,13,15,0,15,7,21,9,0,0,2017-2018,0.603448275862069,1.206896551724138
2040,Rafinha,BRA,DF,Bayern Munich,Bundesliga,31,1985,20.6,39,33,24,11,4,28,47,59.6,19,17,6,11,32,71,30,0,0,2017-2018,1.5533980582524272,1.8932038834951455
2041,Andrea Raggi,ITA,DF,Monaco,Ligue 1,33,1984,17.9,20,10,15,4,1,10,27,37.0,17,12,6,6,31,51,66,0,0,2017-2018,1.7318435754189945,1.11731843575419
2042,Antonino Ragusa,ITA,"FW,MF",Sassuolo,Serie A,27,1990,9.2,17,7,11,4,2,8,23,34.8,15,12,1,11,6,23,16,0,0,2017-2018,0.6521739130434783,1.847826086956522
2043,Baba Rahman,GHA,DF,Schalke 04,Bundesliga,23,1994,0.4,1,0,0,1,0,0,0,0.0,0,2,0,2,2,3,1,0,0,2017-2018,5.0,2.5
2044,Ivan Rakitić,CRO,MF,Barcelona,La Liga,29,1988,31.5,52,31,16,30,6,15,45,33.3,30,42,7,35,44,96,16,0,0,2017-2018,1.3968253968253967,1.6507936507936507
2045,André Ramalho,BRA,"DF,FW",Leverkusen,Bundesliga,25,1992,0.4,3,1,2,1,0,2,2,100.0,0,1,0,1,1,4,1,0,0,2017-2018,2.5,7.5
2046,Jonás Ramalho,ESP,DF,Girona,La Liga,24,1993,25.5,25,16,20,5,0,15,24,62.5,9,25,11,14,35,60,115,0,0,2017-2018,1.3725490196078431,0.9803921568627451
2047,Adil Rami,FRA,DF,Marseille,Ligue 1,31,1985,32.8,39,29,22,15,2,22,41,53.7,19,25,19,6,45,84,163,3,0,2017-2018,1.3719512195121952,1.1890243902439026
2048,Benito Ramírez,ESP,"FW,DF",Las Palmas,La Liga,22,1995,1.8,6,3,2,3,1,1,5,20.0,4,0,0,0,2,8,3,0,0,2017-2018,1.1111111111111112,3.333333333333333
2049,Gastón Ramírez,URU,MF,Sampdoria,Serie A,26,1990,24.6,33,20,4,15,14,9,56,16.1,47,30,3,27,18,51,24,0,0,2017-2018,0.7317073170731707,1.3414634146341462
2050,Sandro Ramírez,ESP,"FW,MF",Everton,Premier League,22,1995,3.1,2,1,0,1,1,0,3,0.0,3,1,0,1,1,3,0,0,0,2017-2018,0.3225806451612903,0.6451612903225806
2051,Sandro Ramírez,ESP,"FW,MF",Sevilla,La Liga,22,1995,8.0,8,8,1,5,2,1,7,14.3,6,2,0,2,4,12,2,0,0,2017-2018,0.5,1.0
2052,Toño Ramírez,ESP,GK,Real Sociedad,La Liga,30,1986,3.5,0,0,0,0,0,0,1,0.0,1,0,0,0,0,0,1,3,0,2017-2018,0.0,0.0
2053,Iván Ramis,ESP,DF,Eibar,La Liga,32,1984,14.5,20,14,8,12,0,8,19,42.1,11,12,5,7,25,45,51,2,0,2017-2018,1.7241379310344827,1.3793103448275863
2054,Omar Ramos,ESP,"FW,MF",Leganés,La Liga,29,1988,16.1,22,14,6,8,8,9,22,40.9,13,16,1,15,14,36,15,0,0,2017-2018,0.8695652173913043,1.3664596273291925
2055,Sergio Ramos,ESP,DF,Real Madrid,La Liga,31,1986,25.4,40,29,22,18,0,19,28,67.9,9,22,12,10,47,87,91,0,0,2017-2018,1.8503937007874016,1.5748031496062993
2056,Aaron Ramsey,WAL,MF,Arsenal,Premier League,26,1990,20.5,35,27,18,17,0,8,44,18.2,36,14,3,11,24,59,6,1,0,2017-2018,1.170731707317073,1.7073170731707317
2057,Àngel Rangel,ESP,DF,Swansea City,Premier League,34,1982,1.7,4,3,2,2,0,1,3,33.3,2,0,0,0,3,7,4,0,0,2017-2018,1.7647058823529411,2.3529411764705883
2058,Andrea Ranocchia,ITA,DF,Inter,Serie A,29,1988,7.0,8,4,6,2,0,3,6,50.0,3,6,5,1,12,20,35,0,0,2017-2018,1.7142857142857142,1.1428571428571428
2059,Marcus Rashford,ENG,"FW,MF",Manchester Utd,Premier League,19,1997,20.1,14,11,4,5,5,6,18,33.3,12,18,0,18,8,22,19,0,0,2017-2018,0.3980099502487562,0.6965174129353233
2060,Milot Rashica,KVX,"FW,MF",Werder Bremen,Bundesliga,21,1996,4.3,2,2,1,1,0,1,8,12.5,7,3,0,3,3,5,4,0,0,2017-2018,0.6976744186046512,0.46511627906976744
2061,Konstantin Rausch,RUS,DF,Köln,Bundesliga,27,1990,10.3,21,16,13,7,1,11,26,42.3,15,9,2,7,17,38,25,0,0,2017-2018,1.6504854368932038,2.0388349514563107
2062,Yoric Ravet,FRA,"FW,MF",Freiburg,Bundesliga,27,1989,5.5,9,7,3,6,0,3,7,42.9,4,7,0,7,3,12,6,0,0,2017-2018,0.5454545454545454,1.6363636363636365
2063,Ante Rebić,CRO,FW,Eint Frankfurt,Bundesliga,23,1993,19.5,37,29,7,21,9,7,24,29.2,17,27,2,25,6,43,13,0,0,2017-2018,0.3076923076923077,1.8974358974358974
2064,Pedro Rebocho,POR,DF,Guingamp,Ligue 1,22,1995,19.1,29,22,18,8,3,12,28,42.9,16,20,6,14,19,48,76,0,0,2017-2018,0.9947643979057591,1.5183246073298429
2065,Recio,ESP,MF,Málaga,La Liga,26,1991,20.4,54,42,26,23,5,17,62,27.4,45,15,3,12,30,84,17,0,0,2017-2018,1.4705882352941178,2.647058823529412
2066,Nathan Redmond,ENG,"FW,MF",Southampton,Premier League,23,1994,21.6,32,17,16,14,2,12,31,38.7,19,20,0,20,15,47,17,2,0,2017-2018,0.6944444444444444,1.4814814814814814
2067,Alberto Redondo,ESP,DF,Getafe,La Liga,20,1997,1.0,4,3,4,0,0,2,4,50.0,2,2,1,1,0,4,1,0,0,2017-2018,0.0,4.0
2068,Fabian Reese,GER,"FW,MF",Schalke 04,Bundesliga,19,1997,0.8,2,2,1,1,0,1,2,50.0,1,1,0,1,2,4,1,0,0,2017-2018,2.5,2.5
2069,Vasco Regini,ITA,DF,Sampdoria,Serie A,26,1990,12.0,13,7,11,0,2,6,11,54.5,5,14,7,7,11,24,68,0,0,2017-2018,0.9166666666666666,1.0833333333333333
2070,Xesc Regis,ESP,FW,Eibar,La Liga,20,1996,0.0,1,1,0,1,0,0,0,0.0,0,0,0,0,0,1,0,0,0,2017-2018,,inf
2071,Winston Reid,NZL,DF,West Ham,Premier League,29,1988,16.1,11,9,7,4,0,4,15,26.7,11,27,14,13,22,33,104,0,0,2017-2018,1.3664596273291925,0.6832298136645962
2072,Pepe Reina,ESP,GK,Napoli,Serie A,34,1982,37.0,1,0,1,0,0,1,2,50.0,1,0,0,0,0,1,13,2,0,2017-2018,0.0,0.02702702702702703
2073,Jeff Reine-Adélaïde,FRA,MF,Angers,Ligue 1,19,1998,4.9,13,8,7,5,1,6,17,35.3,11,7,2,5,1,14,9,0,0,2017-2018,0.2040816326530612,2.6530612244897958
2074,Karim Rekik,NED,DF,Hertha BSC,Bundesliga,22,1994,25.6,38,29,32,6,0,24,26,92.3,2,27,11,16,28,66,116,2,0,2017-2018,1.09375,1.484375
2075,Loïc Rémy,FRA,FW,Las Palmas,La Liga,30,1987,8.5,4,3,1,3,0,0,1,0.0,1,0,0,0,1,5,2,0,0,2017-2018,0.11764705882352941,0.47058823529411764
2076,Loïc Rémy,FRA,"FW,MF",Getafe,La Liga,30,1987,5.1,4,2,1,3,0,1,5,20.0,4,4,0,4,1,5,2,0,0,2017-2018,0.19607843137254904,0.7843137254901962
2077,Jan Repas,SVN,"MF,FW",Caen,Ligue 1,20,1997,10.0,14,11,5,5,4,4,18,22.2,14,10,0,10,7,21,3,0,0,2017-2018,0.7,1.4
2078,Panagiotis Retsos,GRE,DF,Leverkusen,Bundesliga,18,1998,19.1,48,40,32,14,2,33,46,71.7,13,29,8,21,29,77,47,0,0,2017-2018,1.5183246073298429,2.513089005235602
2079,Marco Reus,GER,"MF,FW",Dortmund,Bundesliga,28,1989,10.3,16,8,2,12,2,5,12,41.7,7,16,3,13,4,20,9,0,0,2017-2018,0.3883495145631068,1.5533980582524272
2080,Elvis Rexhbeçaj,GER,"DF,MF",Wolfsburg,Bundesliga,19,1997,1.4,4,2,1,2,1,1,1,100.0,0,3,0,3,2,6,3,0,0,2017-2018,1.4285714285714286,2.857142857142857
2081,Baptiste Reynet,FRA,GK,Dijon,Ligue 1,26,1990,38.0,6,4,5,1,0,5,7,71.4,2,2,0,2,2,8,35,1,0,2017-2018,0.05263157894736842,0.15789473684210525
2082,Franck Ribéry,FRA,"FW,MF",Bayern Munich,Bundesliga,34,1983,13.4,19,16,9,5,5,13,17,76.5,4,11,0,11,7,26,3,0,0,2017-2018,0.5223880597014925,1.417910447761194
2083,Federico Ricca,URU,DF,Málaga,La Liga,22,1994,12.3,43,24,32,9,2,23,33,69.7,10,10,2,8,24,67,46,0,0,2017-2018,1.951219512195122,3.495934959349593
2084,Federico Ricci,ITA,FW,Crotone,Serie A,23,1994,10.2,25,18,9,10,6,9,28,32.1,19,14,0,14,11,36,5,0,0,2017-2018,1.0784313725490198,2.450980392156863
2085,Federico Ricci,ITA,MF,Genoa,Serie A,23,1994,2.4,2,2,2,0,0,1,3,33.3,2,2,0,2,1,3,1,0,0,2017-2018,0.4166666666666667,0.8333333333333334
2086,Declan Rice,ENG,"DF,MF",West Ham,Premier League,18,1999,15.9,36,24,25,10,1,15,25,60.0,10,19,13,6,27,63,77,1,0,2017-2018,1.6981132075471699,2.2641509433962264
2087,Richarlison,BRA,"FW,MF",Watford,Premier League,20,1997,31.4,64,44,26,28,10,10,39,25.6,29,39,5,34,24,88,32,1,0,2017-2018,0.7643312101910829,2.038216560509554
2088,Marco Richter,GER,FW,Augsburg,Bundesliga,19,1997,7.2,17,14,8,8,1,8,17,47.1,9,5,1,4,1,18,10,0,0,2017-2018,0.1388888888888889,2.361111111111111
2089,Diego Rico,ESP,DF,Leganés,La Liga,24,1993,24.8,68,43,37,21,10,36,53,67.9,17,30,6,24,76,144,61,0,0,2017-2018,3.064516129032258,2.7419354838709675
2090,Mikel Rico,ESP,MF,Athletic Club,La Liga,32,1984,13.0,24,13,7,16,1,12,34,35.3,22,15,5,10,23,47,12,1,0,2017-2018,1.7692307692307692,1.8461538461538463
2091,Sergio Rico,ESP,GK,Sevilla,La Liga,23,1993,24.0,1,1,1,0,0,0,2,0.0,2,0,0,0,1,2,5,3,0,2017-2018,0.041666666666666664,0.041666666666666664
2092,Jaïro Riedewald,NED,"MF,DF",Crystal Palace,Premier League,20,1996,4.9,11,8,6,4,1,0,2,0.0,2,7,1,6,12,23,13,0,0,2017-2018,2.4489795918367343,2.2448979591836733
2093,Asier Riesgo,ESP,GK,Eibar,La Liga,33,1983,1.0,0,0,0,0,0,0,0,0.0,0,0,0,0,0,0,0,0,0,2017-2018,0.0,0.0
2094,Luca Rigoni,ITA,MF,Genoa,Serie A,32,1984,17.5,32,22,11,20,1,7,35,20.0,28,24,2,22,19,51,13,0,0,2017-2018,1.0857142857142856,1.8285714285714285
2095,Nicola Rigoni,ITA,MF,Chievo,Serie A,26,1990,10.4,29,20,15,12,2,9,26,34.6,17,8,3,5,11,40,22,1,0,2017-2018,1.0576923076923077,2.7884615384615383
2096,Kévin Rimane,GUF,DF,Paris S-G,Ligue 1,26,1991,0.1,0,0,0,0,0,0,0,0.0,0,0,0,0,0,0,0,0,0,2017-2018,0.0,0.0
2097,Tomás Rincón,VEN,MF,Torino,Serie A,29,1988,33.3,66,40,30,34,2,24,66,36.4,42,33,8,25,57,123,61,1,0,2017-2018,1.7117117117117118,1.9819819819819822
2098,Birk Risa,NOR,FW,Köln,Bundesliga,19,1998,0.9,1,1,0,1,0,0,3,0.0,3,2,1,1,0,1,0,0,0,2017-2018,0.0,1.1111111111111112
2099,Marcel Risse,GER,"DF,MF",Köln,Bundesliga,27,1989,13.0,21,14,17,4,0,11,19,57.9,8,21,3,18,6,27,10,2,0,2017-2018,0.46153846153846156,1.6153846153846154
2100,Matt Ritchie,SCO,"MF,FW",Newcastle Utd,Premier League,27,1989,31.2,46,32,22,18,6,14,53,26.4,39,37,5,32,35,81,63,1,0,2017-2018,1.1217948717948718,1.4743589743589745
2101,Cristian Rivera,ESP,MF,Eibar,La Liga,20,1997,2.7,13,10,4,8,1,5,7,71.4,2,2,2,0,3,16,2,0,0,2017-2018,1.111111111111111,4.814814814814815
2102,Emmanuel Rivière,FRA,FW,Metz,Ligue 1,27,1990,22.3,10,3,1,6,3,1,12,8.3,11,8,0,8,2,12,5,0,0,2017-2018,0.08968609865470852,0.44843049327354256
2103,Jonathan Rivierez,MTQ,DF,Metz,Ligue 1,28,1989,22.9,81,59,50,26,5,41,80,51.3,39,21,7,14,39,120,73,0,0,2017-2018,1.7030567685589522,3.537117903930131
2104,Luca Rizzo,ITA,MF,SPAL,Serie A,25,1992,5.4,18,10,7,10,1,5,17,29.4,12,10,0,10,3,21,5,1,0,2017-2018,0.5555555555555555,3.333333333333333
2105,Arjen Robben,NED,"FW,MF",Bayern Munich,Bundesliga,33,1984,16.7,14,11,1,7,6,4,12,33.3,8,9,0,9,4,18,4,0,0,2017-2018,0.23952095808383234,0.8383233532934132
2106,Rober,ESP,"DF,MF",Levante,La Liga,22,1995,21.2,35,22,27,8,0,17,32,53.1,15,29,18,11,41,76,75,1,0,2017-2018,1.9339622641509435,1.650943396226415
2107,Roberto,ESP,GK,Málaga,La Liga,31,1986,34.0,0,0,0,0,0,0,0,0.0,0,0,0,0,2,2,15,0,0,2017-2018,0.058823529411764705,0.0
2108,Sergi Roberto,ESP,DF,Barcelona,La Liga,25,1992,24.7,63,40,30,25,8,25,49,51.0,24,18,8,10,39,102,30,1,0,2017-2018,1.5789473684210527,2.5506072874493926
2109,Connor Roberts,WAL,DF,Swansea City,Premier League,21,1995,3.0,6,4,5,1,0,3,3,100.0,0,2,0,2,3,9,6,0,0,2017-2018,1.0,2.0
2110,Andrew Robertson,SCO,DF,Liverpool,Premier League,23,1994,21.6,31,17,19,9,3,15,29,51.7,14,22,2,20,26,57,56,0,0,2017-2018,1.2037037037037037,1.4351851851851851
2111,Álex Robles,ESP,DF,Málaga,La Liga,18,1999,1.0,2,1,1,1,0,0,0,0.0,0,1,0,1,3,5,4,0,0,2017-2018,3.0,2.0
2112,Hal Robson-Kanu,WAL,"FW,MF",West Brom,Premier League,28,1989,9.2,5,4,1,2,2,0,13,0.0,13,9,3,6,4,9,9,0,0,2017-2018,0.4347826086956522,0.5434782608695653
2113,Marc Roca,ESP,MF,Espanyol,La Liga,20,1996,2.9,8,7,3,5,0,3,4,75.0,1,4,2,2,4,12,10,0,0,2017-2018,1.3793103448275863,2.7586206896551726
2114,Rubén Rochina,ESP,"MF,DF",Levante,La Liga,26,1991,1.7,8,5,5,2,1,4,6,66.7,2,0,0,0,2,10,0,0,0,2017-2018,1.1764705882352942,4.705882352941177
2115,Ronny Rodelin,FRA,"FW,MF",Caen,Ligue 1,27,1989,35.1,33,22,7,18,8,8,42,19.0,34,21,2,19,28,61,41,1,0,2017-2018,0.7977207977207977,0.9401709401709402
2116,Rodri,ESP,MF,Villarreal,La Liga,21,1996,35.9,104,71,50,48,6,30,86,34.9,56,49,21,28,52,156,100,1,0,2017-2018,1.4484679665738163,2.8969359331476325
2117,Rodrigo,ESP,FW,Valencia,La Liga,26,1991,29.8,23,13,9,12,2,3,21,14.3,18,14,2,12,17,40,11,1,0,2017-2018,0.5704697986577181,0.7718120805369127
2118,Kévin Rodrigues,POR,DF,Real Sociedad,La Liga,23,1994,18.2,44,32,18,20,6,19,34,55.9,15,22,6,16,27,71,39,0,0,2017-2018,1.4835164835164836,2.417582417582418
2119,Ángel Rodríguez,ESP,FW,Getafe,La Liga,30,1987,25.5,28,19,3,19,6,3,26,11.5,23,18,3,15,6,34,14,0,0,2017-2018,0.23529411764705882,1.0980392156862746
2120,Iván Rodríguez,ESP,DF,Málaga,La Liga,21,1996,0.2,1,1,0,1,0,0,0,0.0,0,0,0,0,1,2,1,0,0,2017-2018,5.0,5.0
2121,James Rodríguez,COL,"MF,FW",Bayern Munich,Bundesliga,26,1991,18.0,35,27,10,15,10,15,30,50.0,15,16,1,15,12,47,4,0,0,2017-2018,0.6666666666666666,1.9444444444444444
2122,Jay Rodriguez,ENG,"FW,MF",West Brom,Premier League,28,1989,31.2,31,21,12,11,8,9,50,18.0,41,32,2,30,19,50,41,0,0,2017-2018,0.608974358974359,0.9935897435897436
2123,Ricardo Rodríguez,SUI,DF,Milan,Serie A,24,1992,33.4,48,29,24,18,6,18,28,64.3,10,36,6,30,33,81,93,3,0,2017-2018,0.9880239520958084,1.437125748502994
2124,Marko Rog,CRO,"MF,FW",Napoli,Serie A,22,1995,3.2,11,7,3,6,2,1,11,9.1,10,4,1,3,2,13,1,0,0,2017-2018,0.625,3.4375
2125,Rogério,BRA,DF,Sassuolo,Serie A,19,1998,10.1,18,14,10,5,3,7,15,46.7,8,11,1,10,9,27,31,0,0,2017-2018,0.8910891089108911,1.7821782178217822
2126,Marcus Rohdén,SWE,MF,Crotone,Serie A,26,1991,18.1,33,19,21,10,2,14,50,28.0,36,14,1,13,18,51,30,0,0,2017-2018,0.9944751381215469,1.8232044198895025
2127,Marcos Rojo,ARG,DF,Manchester Utd,Premier League,27,1990,7.1,7,5,6,0,1,1,8,12.5,7,11,6,5,7,14,56,2,0,2017-2018,0.9859154929577465,0.9859154929577465
2128,Diego Rolán,URU,"FW,MF",Málaga,La Liga,24,1993,21.6,33,25,7,13,13,9,44,20.5,35,18,1,17,12,45,9,0,0,2017-2018,0.5555555555555555,1.5277777777777777
2129,Rolando,POR,DF,Marseille,Ligue 1,31,1985,27.9,44,29,28,15,1,23,40,57.5,17,22,14,8,37,81,126,0,0,2017-2018,1.3261648745519714,1.5770609318996416
2130,Esteban Rolón,ARG,MF,Málaga,La Liga,22,1995,4.6,6,4,4,2,0,2,4,50.0,2,7,1,6,9,15,8,1,0,2017-2018,1.956521739130435,1.3043478260869565
2131,Filippo Romagna,ITA,DF,Cagliari,Serie A,20,1997,21.0,33,18,20,12,1,16,26,61.5,10,20,11,9,33,66,96,0,0,2017-2018,1.5714285714285714,1.5714285714285714
2132,Alessio Romagnoli,ITA,DF,Milan,Serie A,22,1995,26.1,20,14,17,2,1,9,14,64.3,5,24,14,10,23,43,154,1,0,2017-2018,0.8812260536398467,0.7662835249042145
2133,Simone Romagnoli,ITA,DF,Bologna,Serie A,27,1990,6.2,12,9,10,2,0,4,9,44.4,5,12,8,4,7,19,41,2,0,2017-2018,1.129032258064516,1.9354838709677418
2134,Aristóteles Romero,VEN,"MF,FW",Crotone,Serie A,21,1995,1.0,11,7,7,4,0,3,5,60.0,2,3,0,3,5,16,0,0,0,2017-2018,5.0,11.0
2135,Óscar Romero,PAR,"MF,FW",Alavés,La Liga,25,1992,2.8,5,2,4,1,0,0,3,0.0,3,3,0,3,3,8,2,0,0,2017-2018,1.0714285714285714,1.7857142857142858
2136,Sergio Romero,ARG,GK,Manchester Utd,Premier League,30,1987,1.0,0,0,0,0,0,0,0,0.0,0,0,0,0,0,0,0,0,0,2017-2018,0.0,0.0
2137,Oriol Romeu,ESP,MF,Southampton,Premier League,25,1991,32.2,93,64,41,44,8,32,100,32.0,68,59,19,40,69,162,77,2,0,2017-2018,2.142857142857143,2.8881987577639747
2138,Rômulo,ITA,"MF,DF",Hellas Verona,Serie A,30,1987,35.2,58,44,23,29,6,13,54,24.1,41,29,2,27,43,101,41,0,0,2017-2018,1.221590909090909,1.6477272727272725
2139,Cristiano Ronaldo,POR,FW,Real Madrid,La Liga,32,1985,25.4,7,4,3,3,1,1,6,16.7,5,10,3,7,6,13,14,0,0,2017-2018,0.2362204724409449,0.2755905511811024
2140,Facundo Roncaglia,ARG,DF,Celta Vigo,La Liga,30,1987,16.6,35,25,30,5,0,22,36,61.1,14,18,6,12,31,66,50,1,0,2017-2018,1.8674698795180722,2.108433734939759
2141,Salomón Rondón,VEN,FW,West Brom,Premier League,27,1989,30.7,14,6,0,7,7,5,26,19.2,21,27,0,27,14,28,20,0,0,2017-2018,0.45602605863192186,0.45602605863192186
2142,Valentin Rongier,FRA,MF,Nantes,Ligue 1,22,1994,26.1,73,49,25,39,9,17,64,26.6,47,42,6,36,40,113,13,1,0,2017-2018,1.532567049808429,2.796934865900383
2143,Marten de Roon,NED,MF,Atalanta,Serie A,26,1991,28.6,77,50,27,44,6,29,82,35.4,53,40,5,35,46,123,36,0,0,2017-2018,1.6083916083916083,2.692307692307692
2144,Wayne Rooney,ENG,"MF,FW",Everton,Premier League,31,1985,25.2,28,19,11,13,4,10,42,23.8,32,25,6,19,16,44,43,2,0,2017-2018,0.6349206349206349,1.1111111111111112
2145,Roberto Rosales,VEN,DF,Málaga,La Liga,28,1988,34.7,104,69,52,40,12,50,84,59.5,34,37,13,24,58,162,104,1,0,2017-2018,1.6714697406340056,2.9971181556195963
2146,Danny Rose,ENG,DF,Tottenham,Premier League,27,1990,8.9,15,11,6,7,2,8,15,53.3,7,12,6,6,9,24,15,0,0,2017-2018,1.0112359550561798,1.6853932584269662
2147,Liam Rosenior,ENG,DF,Brighton,Premier League,33,1984,1.8,4,3,2,1,1,2,5,40.0,3,2,1,1,4,8,7,0,0,2017-2018,2.2222222222222223,2.2222222222222223
2148,Aleandro Rosi,ITA,DF,Genoa,Serie A,30,1987,18.9,24,17,7,13,4,5,19,26.3,14,24,5,19,20,44,61,1,0,2017-2018,1.0582010582010584,1.26984126984127
2149,Valentin Rosier,FRA,DF,Dijon,Ligue 1,20,1996,30.9,73,54,47,23,3,26,68,38.2,42,43,9,34,58,131,124,0,0,2017-2018,1.877022653721683,2.3624595469255665
2150,Luca Rossettini,ITA,DF,Genoa,Serie A,32,1985,22.5,16,8,12,3,1,6,17,35.3,11,31,21,10,29,45,151,1,0,2017-2018,1.288888888888889,0.7111111111111111
2151,Francesco Rossi,ITA,GK,Atalanta,Serie A,26,1991,0.1,0,0,0,0,0,0,0,0.0,0,0,0,0,0,0,0,0,0,2017-2018,0.0,0.0
2152,Giuseppe Rossi,ITA,"FW,MF",Genoa,Serie A,30,1987,2.9,1,1,0,1,0,0,3,0.0,3,2,0,2,1,2,1,0,0,2017-2018,0.3448275862068966,0.3448275862068966
2153,Jérôme Roussillon,FRA,DF,Montpellier,Ligue 1,24,1993,20.9,40,27,17,19,4,15,26,57.7,11,26,3,23,15,55,52,0,0,2017-2018,0.7177033492822967,1.9138755980861246
2154,Wayne Routledge,ENG,"MF,FW",Swansea City,Premier League,32,1985,4.8,10,5,2,6,2,2,8,25.0,6,5,0,5,2,12,5,0,0,2017-2018,0.4166666666666667,2.0833333333333335
2155,Nolan Roux,FRA,"FW,MF",Metz,Ligue 1,29,1988,31.5,24,17,8,10,6,7,38,18.4,31,32,2,30,25,49,22,0,0,2017-2018,0.7936507936507936,0.7619047619047619
2156,Rubén,ESP,GK,La Coruña,La Liga,33,1984,27.5,1,0,1,0,0,1,3,33.3,2,0,0,0,1,2,5,4,0,2017-2018,0.03636363636363636,0.03636363636363636
2157,Antonio Rüdiger,GER,DF,Chelsea,Premier League,24,1993,26.0,31,21,20,10,1,15,31,48.4,16,29,15,14,24,55,115,1,0,2017-2018,0.9230769230769231,1.1923076923076923
2158,Sebastian Rudy,GER,MF,Bayern Munich,Bundesliga,27,1990,16.8,50,40,12,33,5,28,55,50.9,27,11,1,10,18,68,7,1,0,2017-2018,1.0714285714285714,2.9761904761904763
2159,Stéphane Ruffier,FRA,GK,Saint-Étienne,Ligue 1,30,1986,34.6,0,0,0,0,0,0,0,0.0,0,0,0,0,0,0,14,1,0,2017-2018,0.0,0.0
2160,Vincent Rüfli,SUI,"DF,FW",Dijon,Ligue 1,29,1988,0.3,4,1,3,1,0,3,3,100.0,0,1,0,1,1,5,0,0,0,2017-2018,3.3333333333333335,13.333333333333334
2161,Daniele Rugani,ITA,DF,Juventus,Serie A,23,1994,21.5,18,12,11,5,2,7,13,53.8,6,18,14,4,20,38,87,1,0,2017-2018,0.9302325581395349,0.8372093023255814
2162,Mário Rui,POR,DF,Napoli,Serie A,26,1991,23.2,55,39,18,32,5,30,52,57.7,22,30,5,25,14,69,43,1,0,2017-2018,0.603448275862069,2.3706896551724137
2163,Aitor Ruibal,ESP,MF,Betis,La Liga,21,1996,0.1,0,0,0,0,0,0,0,0.0,0,0,0,0,0,0,0,0,0,2017-2018,0.0,0.0
2164,Fabián Ruiz Peña,ESP,MF,Betis,La Liga,21,1996,29.5,83,53,34,40,9,26,73,35.6,47,35,3,32,42,125,36,1,0,2017-2018,1.423728813559322,2.8135593220338984
2165,Víctor Ruiz,ESP,DF,Villarreal,La Liga,28,1989,26.8,33,22,29,4,0,13,25,52.0,12,27,18,9,58,91,134,1,0,2017-2018,2.1641791044776117,1.2313432835820894
2166,Antonio Rukavina,SRB,DF,Villarreal,La Liga,33,1984,14.1,25,22,12,9,4,17,25,68.0,8,11,3,8,16,41,68,0,0,2017-2018,1.1347517730496455,1.773049645390071
2167,Gerónimo Rulli,ARG,GK,Real Sociedad,La Liga,25,1992,26.0,2,1,2,0,0,2,6,33.3,4,0,0,0,0,2,10,2,0,2017-2018,0.0,0.07692307692307693
2168,Lukas Rupp,GER,"MF,FW",Hoffenheim,Bundesliga,26,1991,12.9,36,32,18,14,4,19,36,52.8,17,18,0,18,13,49,13,2,0,2017-2018,1.0077519379844961,2.7906976744186047
2169,Marco Russ,GER,DF,Eint Frankfurt,Bundesliga,31,1985,12.7,17,11,9,8,0,13,19,68.4,6,23,11,12,24,41,66,0,0,2017-2018,1.8897637795275593,1.3385826771653544
2170,Mathew Ryan,AUS,GK,Brighton,Premier League,25,1992,38.0,0,0,0,0,0,0,3,0.0,3,0,0,0,3,3,10,3,0,2017-2018,0.07894736842105263,0.0
2171,Idriss Saadi,ALG,FW,Strasbourg,Ligue 1,25,1992,10.5,6,5,2,3,1,2,11,18.2,9,3,2,1,5,11,1,0,0,2017-2018,0.47619047619047616,0.5714285714285714
2172,Youssouf Sabaly,SEN,DF,Bordeaux,Ligue 1,24,1993,34.4,93,61,54,34,5,43,68,63.2,25,26,6,20,54,147,104,0,0,2017-2018,1.5697674418604652,2.703488372093023
2173,Abdelhamid Sabiri,MAR,MF,Huddersfield,Premier League,20,1996,2.4,5,4,2,0,3,1,7,14.3,6,4,0,4,1,6,2,0,0,2017-2018,0.4166666666666667,2.0833333333333335
2174,Marcel Sabitzer,AUT,"MF,FW",RB Leipzig,Bundesliga,23,1994,19.9,38,28,12,20,6,23,49,46.9,26,23,2,21,24,62,21,1,0,2017-2018,1.206030150753769,1.9095477386934674
2175,Enric Saborit,ESP,DF,Athletic Club,La Liga,25,1992,15.9,50,27,31,17,2,19,29,65.5,10,17,5,12,24,74,55,0,0,2017-2018,1.5094339622641508,3.144654088050314
2176,Ihsan Sacko,FRA,"FW,MF",Nice,Ligue 1,20,1997,2.9,1,1,0,1,0,0,1,0.0,1,1,0,1,2,3,1,0,0,2017-2018,0.6896551724137931,0.3448275862068966
2177,Ihsan Sacko,FRA,"FW,MF",Strasbourg,Ligue 1,20,1997,7.9,10,8,6,0,4,2,10,20.0,8,2,0,2,5,15,6,0,0,2017-2018,0.6329113924050632,1.2658227848101264
2178,Mujaid Sadick,ESP,DF,La Coruña,La Liga,17,2000,1.2,4,2,2,2,0,2,3,66.7,1,3,2,1,1,5,4,0,0,2017-2018,0.8333333333333334,3.3333333333333335
2179,Armando Sadiku,ALB,FW,Levante,La Liga,26,1991,3.0,1,1,0,1,0,0,1,0.0,1,4,2,2,2,3,2,0,0,2017-2018,0.6666666666666666,0.3333333333333333
2180,Umar Sadiq,NGA,FW,Torino,Serie A,20,1997,2.5,0,0,0,0,0,0,3,0.0,3,1,0,1,1,1,2,0,0,2017-2018,0.4,0.0
2181,Bacary Sagna,FRA,DF,Benevento,Serie A,34,1983,10.6,9,7,5,3,1,1,7,14.3,6,9,2,7,20,29,28,0,0,2017-2018,1.8867924528301887,0.8490566037735849
2182,Adrián Sahibeddine,FRA,"FW,MF",Dijon,Ligue 1,22,1994,0.4,0,0,0,0,0,0,1,0.0,1,1,0,1,0,0,0,0,0,2017-2018,0.0,0.0
2183,Nuri Şahin,TUR,MF,Dortmund,Bundesliga,28,1988,13.6,40,34,9,28,3,15,39,38.5,24,12,0,12,20,60,29,1,0,2017-2018,1.4705882352941178,2.9411764705882355
2184,Wesley Saïd,FRA,"FW,MF",Dijon,Ligue 1,22,1995,20.4,33,22,17,11,5,7,26,26.9,19,15,1,14,15,48,4,0,0,2017-2018,0.7352941176470589,1.6176470588235294
2185,Allan Saint-Maximin,FRA,"FW,MF",Nice,Ligue 1,20,1997,25.0,18,14,13,2,3,12,28,42.9,16,12,1,11,11,29,10,0,0,2017-2018,0.44,0.72
2186,Allan Saint-Maximin,FRA,MF,Monaco,Ligue 1,20,1997,0.2,0,0,0,0,0,0,0,0.0,0,0,0,0,0,0,0,0,0,2017-2018,0.0,0.0
2187,Henri Saivet,SEN,MF,Newcastle Utd,Premier League,26,1990,0.9,5,3,4,1,0,2,5,40.0,3,0,0,0,4,9,8,1,0,2017-2018,4.444444444444445,5.555555555555555
2188,Gōtoku Sakai,JPN,"DF,MF",Hamburger SV,Bundesliga,26,1991,25.4,50,40,25,18,7,22,47,46.8,25,40,12,28,44,94,55,0,0,2017-2018,1.7322834645669292,1.968503937007874
2189,Hiroki Sakai,JPN,DF,Marseille,Ligue 1,27,1990,28.0,66,45,30,30,6,32,49,65.3,17,32,7,25,45,111,90,1,0,2017-2018,1.6071428571428572,2.357142857142857
2190,Diafra Sakho,SEN,FW,West Ham,Premier League,27,1989,3.4,5,2,1,4,0,0,3,0.0,3,3,0,3,1,6,2,0,0,2017-2018,0.29411764705882354,1.4705882352941178
2191,Diafra Sakho,SEN,FW,Rennes,Ligue 1,27,1989,8.6,5,4,1,2,2,0,7,0.0,7,4,0,4,2,7,11,0,0,2017-2018,0.23255813953488372,0.5813953488372093
2192,Mamadou Sakho,FRA,DF,Crystal Palace,Premier League,27,1990,17.8,21,14,15,5,1,9,16,56.3,7,19,11,8,30,51,101,3,0,2017-2018,1.6853932584269662,1.1797752808988764
2193,Bakary Sako,MLI,"FW,MF",Crystal Palace,Premier League,29,1988,5.3,7,6,5,0,2,2,9,22.2,7,2,0,2,1,8,2,0,0,2017-2018,0.18867924528301888,1.3207547169811322
2194,Emiliano Sala,ARG,FW,Nantes,Ligue 1,26,1990,33.7,19,11,3,9,7,5,33,15.2,28,27,3,24,9,28,50,0,0,2017-2018,0.2670623145400593,0.5637982195845697
2195,Jacopo Sala,ITA,DF,Sampdoria,Serie A,25,1991,11.0,17,10,12,4,1,4,10,40.0,6,9,1,8,8,25,28,2,0,2017-2018,0.7272727272727273,1.5454545454545454
2196,Mohamed Salah,EGY,FW,Liverpool,Premier League,25,1992,32.3,12,6,2,5,5,3,23,13.0,20,10,0,10,5,17,5,0,0,2017-2018,0.15479876160990713,0.3715170278637771
2197,Bartosz Salamon,POL,DF,SPAL,Serie A,26,1991,19.2,28,22,21,7,0,12,21,57.1,9,24,18,6,58,86,148,0,0,2017-2018,3.0208333333333335,1.4583333333333335
2198,Carlos Salcedo,MEX,DF,Eint Frankfurt,Bundesliga,23,1993,17.9,26,22,16,9,1,19,29,65.5,10,28,12,16,21,47,94,1,0,2017-2018,1.1731843575418994,1.452513966480447
2199,Eddie Salcedo,ITA,FW,Genoa,Serie A,15,2001,0.4,0,0,0,0,0,0,0,0.0,0,0,0,0,0,0,0,0,0,2017-2018,0.0,0.0
2200,Yannis Salibur,FRA,"FW,MF",Guingamp,Ligue 1,26,1991,16.9,11,9,4,6,1,4,15,26.7,11,7,1,6,7,18,2,0,0,2017-2018,0.4142011834319527,0.6508875739644971
2201,Sejad Salihović,BIH,MF,Hamburger SV,Bundesliga,32,1984,4.1,7,5,3,3,1,0,3,0.0,3,5,0,5,5,12,1,0,0,2017-2018,1.2195121951219514,1.707317073170732
2202,Yoann Salmier,GUF,DF,Strasbourg,Ligue 1,24,1992,12.3,15,13,10,5,0,5,12,41.7,7,11,6,5,26,41,62,1,0,2017-2018,2.113821138211382,1.2195121951219512
2203,Mamadou Samassa,MLI,GK,Troyes,Ligue 1,27,1990,21.0,0,0,0,0,0,0,2,0.0,2,0,0,0,0,0,12,3,0,2017-2018,0.0,0.0
2204,Brice Samba,FRA,GK,Caen,Ligue 1,23,1994,3.5,0,0,0,0,0,0,0,0.0,0,0,0,0,0,0,2,0,0,2017-2018,0.0,0.0
2205,Junior Sambia,FRA,MF,Montpellier,Ligue 1,20,1996,17.1,21,12,6,11,4,6,28,21.4,22,16,0,16,20,41,18,0,0,2017-2018,1.1695906432748537,1.2280701754385963
2206,Frédéric Sammaritano,FRA,"FW,MF",Dijon,Ligue 1,31,1986,15.9,29,25,17,9,3,10,36,27.8,26,14,0,14,5,34,15,0,0,2017-2018,0.31446540880503143,1.8238993710691824
2207,Sergi Samper,ESP,MF,Las Palmas,La Liga,22,1995,1.6,10,4,4,6,0,2,3,66.7,1,0,0,0,0,10,0,0,0,2017-2018,0.0,6.25
2208,Jairo Samperio,ESP,"FW,MF",Las Palmas,La Liga,24,1993,6.2,9,6,2,6,1,3,13,23.1,10,5,1,4,1,10,5,0,0,2017-2018,0.16129032258064516,1.4516129032258065
2209,Jairo Samperio,ESP,"MF,FW",Mainz 05,Bundesliga,24,1993,0.4,1,1,0,1,0,1,1,100.0,0,0,0,0,0,1,0,0,0,2017-2018,0.0,2.5
2210,Mario Sampirisi,ITA,DF,Crotone,Serie A,24,1992,24.4,44,32,29,12,3,13,22,59.1,9,27,14,13,43,87,116,2,0,2017-2018,1.7622950819672132,1.8032786885245902
2211,Mikel San José,ESP,MF,Athletic Club,La Liga,28,1989,23.9,52,37,19,23,10,19,73,26.0,54,43,13,30,41,93,30,0,0,2017-2018,1.7154811715481173,2.175732217573222
2212,Antonio Sanabria,PAR,FW,Betis,La Liga,21,1996,9.5,8,8,0,4,4,0,3,0.0,3,5,0,5,4,12,6,0,0,2017-2018,0.42105263157894735,0.8421052631578947
2213,Renato Sanches,POR,MF,Swansea City,Premier League,19,1997,7.8,12,7,6,6,0,6,18,33.3,12,9,1,8,7,19,5,1,0,2017-2018,0.8974358974358975,1.5384615384615385
2214,Alexis Sánchez,CHI,"MF,FW",Arsenal,Premier League,28,1988,16.7,20,9,9,4,7,7,32,21.9,25,5,2,3,6,26,1,0,0,2017-2018,0.3592814371257485,1.1976047904191618
2215,Alexis Sánchez,CHI,"FW,MF",Manchester Utd,Premier League,28,1988,11.6,21,17,10,4,7,4,27,14.8,23,8,0,8,17,38,0,0,0,2017-2018,1.4655172413793105,1.8103448275862069
2216,Carlos Sánchez,COL,"MF,DF",Fiorentina,Serie A,31,1986,4.1,7,6,2,5,0,4,6,66.7,2,3,1,2,8,15,10,0,0,2017-2018,1.9512195121951221,1.707317073170732
2217,Carlos Sánchez,COL,MF,Espanyol,La Liga,31,1986,12.5,25,12,6,16,3,9,24,37.5,15,13,5,8,18,43,24,2,0,2017-2018,1.44,2.0
2218,Davinson Sánchez,COL,DF,Tottenham,Premier League,21,1996,28.2,38,24,28,9,1,18,40,45.0,22,26,10,16,38,76,162,0,0,2017-2018,1.3475177304964538,1.3475177304964538
2219,Sergio Sánchez,ESP,DF,Espanyol,La Liga,31,1986,1.1,4,3,4,0,0,3,4,75.0,1,1,0,1,3,7,3,0,0,2017-2018,2.727272727272727,3.6363636363636362
2220,Víctor Sánchez,ESP,"MF,DF",Espanyol,La Liga,29,1987,27.3,106,72,56,45,5,49,113,43.4,64,38,14,24,79,185,73,1,0,2017-2018,2.8937728937728937,3.8827838827838828
2221,Jadon Sancho,ENG,FW,Dortmund,Bundesliga,17,2000,7.7,5,5,2,2,1,2,7,28.6,5,8,0,8,5,10,2,0,0,2017-2018,0.6493506493506493,0.6493506493506493
2222,Sandro,BRA,MF,Benevento,Serie A,28,1989,12.8,29,21,15,13,1,12,18,66.7,6,23,16,7,18,47,43,1,0,2017-2018,1.40625,2.265625
2223,Alex Sandro,BRA,DF,Juventus,Serie A,26,1991,23.5,57,31,33,17,7,20,39,51.3,19,21,1,20,30,87,45,0,0,2017-2018,1.2765957446808511,2.425531914893617
2224,Arona Sané,SEN,"MF,FW",Atlético Madrid,La Liga,22,1995,0.7,1,0,1,0,0,0,0,0.0,0,1,0,1,0,1,0,0,0,2017-2018,0.0,1.4285714285714286
2225,Lamine Sané,SEN,DF,Werder Bremen,Bundesliga,30,1987,8.7,19,14,15,4,0,8,10,80.0,2,8,6,2,20,39,49,1,0,2017-2018,2.298850574712644,2.1839080459770117
2226,Leroy Sané,GER,FW,Manchester City,Premier League,21,1996,26.9,27,21,14,7,6,8,22,36.4,14,22,1,21,13,40,6,0,0,2017-2018,0.483271375464684,1.0037174721189592
2227,Salif Sané,SEN,DF,Hannover 96,Bundesliga,26,1990,32.0,57,43,46,10,1,40,64,62.5,24,49,29,20,57,114,238,6,0,2017-2018,1.78125,1.78125
2228,Ibrahim Sangaré,CIV,MF,Toulouse,Ligue 1,19,1997,17.6,72,47,35,34,3,29,69,42.0,40,33,7,26,24,96,19,1,0,2017-2018,1.3636363636363635,4.090909090909091
2229,Younousse Sankharé,SEN,MF,Bordeaux,Ligue 1,27,1989,20.9,33,23,10,20,3,4,34,11.8,30,15,4,11,21,54,7,0,0,2017-2018,1.0047846889952154,1.5789473684210527
2230,Baissama Sankoh,GUI,"MF,DF",Caen,Ligue 1,25,1992,17.1,27,19,8,18,1,8,28,28.6,20,20,8,12,25,52,64,1,0,2017-2018,1.461988304093567,1.5789473684210524
2231,Siriki Sanogo,CIV,MF,Benevento,Serie A,15,2001,0.4,1,1,0,1,0,0,0,0.0,0,0,0,0,1,2,1,0,0,2017-2018,2.5,2.5
2232,Yaya Sanogo,FRA,FW,Toulouse,Ligue 1,24,1993,16.8,11,6,1,5,5,3,11,27.3,8,6,1,5,6,17,14,1,0,2017-2018,0.35714285714285715,0.6547619047619048
2233,Morgan Sanson,FRA,MF,Marseille,Ligue 1,22,1994,24.1,64,40,13,34,17,21,71,29.6,50,30,0,30,25,89,5,1,0,2017-2018,1.0373443983402488,2.6556016597510372
2234,Nicola Sansone,ITA,"FW,MF",Villarreal,La Liga,25,1991,7.1,8,4,2,4,2,2,17,11.8,15,1,0,1,1,9,2,0,0,2017-2018,0.14084507042253522,1.1267605633802817
2235,Baptiste Santamaria,FRA,MF,Angers,Ligue 1,22,1995,28.8,59,40,25,29,5,23,83,27.7,60,39,8,31,43,102,48,2,0,2017-2018,1.4930555555555556,2.048611111111111
2236,Ivan Santini,CRO,FW,Caen,Ligue 1,28,1989,30.9,19,12,5,8,6,4,29,13.8,25,13,5,8,4,23,33,0,0,2017-2018,0.12944983818770228,0.6148867313915858
2237,Davide Santon,ITA,DF,Inter,Serie A,26,1991,9.3,19,14,13,6,0,9,17,52.9,8,10,3,7,20,39,32,2,0,2017-2018,2.150537634408602,2.043010752688172
2238,Christian Santos,VEN,FW,Alavés,La Liga,29,1988,4.8,2,0,1,0,1,0,4,0.0,4,2,1,1,2,4,9,0,0,2017-2018,0.4166666666666667,0.4166666666666667
2239,Douglas Santos,BRA,DF,Hamburger SV,Bundesliga,23,1994,26.4,90,60,53,34,3,50,87,57.5,37,63,2,61,56,146,96,1,0,2017-2018,2.121212121212121,3.409090909090909
2240,Samir Santos,BRA,DF,Udinese,Serie A,22,1994,28.5,55,38,35,17,3,19,38,50.0,19,33,16,17,75,130,161,1,0,2017-2018,2.6315789473684212,1.9298245614035088
2241,Antonio Santurro,DOM,GK,Bologna,Serie A,25,1992,1.0,0,0,0,0,0,0,0,0.0,0,0,0,0,0,0,1,0,0,2017-2018,0.0,0.0
2242,Riccardo Saponara,ITA,"MF,FW",Fiorentina,Serie A,25,1991,10.0,12,8,2,8,2,2,11,18.2,9,3,1,2,1,13,5,0,0,2017-2018,0.1,1.2
2243,Pablo Sarabia,ESP,"FW,MF",Sevilla,La Liga,25,1992,26.6,27,19,10,13,4,11,49,22.4,38,39,1,38,30,57,34,1,0,2017-2018,1.1278195488721805,1.0150375939849623
2244,Yusuf Sari,TUR,FW,Marseille,Ligue 1,18,1998,0.0,0,0,0,0,0,0,0,0.0,0,0,0,0,0,0,0,0,0,2017-2018,,
2245,Bouna Sarr,SEN,"DF,FW",Marseille,Ligue 1,25,1992,19.9,65,42,42,20,3,22,38,57.9,16,20,4,16,32,97,53,2,0,2017-2018,1.6080402010050252,3.2663316582914574
2246,Ismaila Sarr,SEN,"FW,MF",Rennes,Ligue 1,19,1998,20.6,20,10,5,10,5,7,29,24.1,22,17,0,17,9,29,3,1,0,2017-2018,0.4368932038834951,0.9708737864077669
2247,Malang Sarr,FRA,DF,Nice,Ligue 1,18,1999,14.7,24,18,17,7,0,8,18,44.4,10,14,6,8,31,55,44,2,0,2017-2018,2.108843537414966,1.6326530612244898
2248,Imanol Sarriegi,ESP,"MF,FW",Eibar,La Liga,22,1995,0.5,2,2,1,0,1,2,3,66.7,1,2,0,2,1,3,0,0,0,2017-2018,2.0,4.0
2249,Marco Sau,ITA,"FW,MF",Cagliari,Serie A,29,1987,14.6,9,6,2,4,3,1,17,5.9,16,10,0,10,9,18,1,0,0,2017-2018,0.6164383561643836,0.6164383561643836
2250,Stefan Savić,MNE,DF,Atlético Madrid,La Liga,26,1991,25.5,30,20,23,7,0,16,39,41.0,23,38,23,15,45,75,150,1,0,2017-2018,1.7647058823529411,1.1764705882352942
2251,Gianluca Scamacca,ITA,"FW,MF",Sassuolo,Serie A,18,1999,0.3,0,0,0,0,0,0,0,0.0,0,1,0,1,0,0,0,0,0,2017-2018,0.0,0.0
2252,Fabian Schär,SUI,DF,La Coruña,La Liga,25,1991,24.7,59,45,45,14,0,32,61,52.5,29,36,20,16,45,104,141,1,0,2017-2018,1.8218623481781377,2.388663967611336
2253,Ezequiel Schelotto,ITA,DF,Brighton,Premier League,28,1989,14.6,20,13,14,6,0,12,27,44.4,15,7,3,4,19,39,58,2,0,2017-2018,1.3013698630136987,1.36986301369863
2254,Pasquale Schiattarella,ITA,MF,SPAL,Serie A,30,1987,22.1,40,31,20,15,5,13,43,30.2,30,7,2,5,24,64,26,0,0,2017-2018,1.085972850678733,1.8099547511312215
2255,Eros Schiavon,ITA,"MF,DF",SPAL,Serie A,34,1983,4.3,6,5,2,3,1,1,7,14.3,6,6,2,4,2,8,4,0,0,2017-2018,0.46511627906976744,1.3953488372093024
2256,Patrik Schick,CZE,"FW,MF",Roma,Serie A,21,1996,11.0,9,7,1,5,3,1,9,11.1,8,14,0,14,2,11,11,0,0,2017-2018,0.18181818181818182,0.8181818181818182
2257,Julian Schieber,GER,"MF,FW",Hertha BSC,Bundesliga,28,1989,0.6,1,1,0,0,1,1,1,100.0,0,1,0,1,0,1,2,0,0,2017-2018,0.0,1.6666666666666667
2258,Christopher Schindler,GER,DF,Huddersfield,Premier League,27,1990,36.3,83,61,56,27,0,24,41,58.5,17,54,30,24,75,158,275,1,0,2017-2018,2.066115702479339,2.2865013774104685
2259,Sven Schipplock,GER,"FW,MF",Hamburger SV,Bundesliga,28,1988,3.8,7,6,1,5,1,0,1,0.0,1,4,0,4,1,8,3,0,0,2017-2018,0.2631578947368421,1.842105263157895
2260,Jeffrey Schlupp,GHA,"DF,MF",Crystal Palace,Premier League,24,1992,19.4,57,36,35,20,2,23,43,53.5,20,34,8,26,24,81,67,0,0,2017-2018,1.2371134020618557,2.9381443298969074
2261,Kasper Schmeichel,DEN,GK,Leicester City,Premier League,30,1986,32.9,1,0,1,0,0,1,3,33.3,2,1,0,1,0,1,18,5,0,2017-2018,0.0,0.030395136778115502
2262,Marcel Schmelzer,GER,DF,Dortmund,Bundesliga,29,1988,16.6,35,27,21,12,2,20,30,66.7,10,27,6,21,30,65,57,1,0,2017-2018,1.8072289156626504,2.108433734939759
2263,Jonathan Schmid,FRA,"DF,FW",Augsburg,Bundesliga,27,1990,16.4,23,16,6,13,4,11,18,61.1,7,16,1,15,10,33,35,1,0,2017-2018,0.6097560975609757,1.402439024390244
2264,Manuel Schmiedebach,GER,MF,Hannover 96,Bundesliga,28,1988,1.8,5,5,5,0,0,4,9,44.4,5,2,0,2,5,10,6,0,0,2017-2018,2.7777777777777777,2.7777777777777777
2265,Benno Schmitz,GER,DF,RB Leipzig,Bundesliga,22,1994,0.9,3,2,2,1,0,2,3,66.7,1,0,0,0,0,3,1,0,0,2017-2018,0.0,3.333333333333333
2266,Morgan Schneiderlin,FRA,MF,Everton,Premier League,27,1989,23.7,58,40,34,21,3,15,44,34.1,29,18,7,11,61,119,59,1,0,2017-2018,2.5738396624472575,2.4472573839662446
2267,Alessandro Schöpf,AUT,"DF,FW",Schalke 04,Bundesliga,23,1994,9.0,22,17,10,9,3,11,23,47.8,12,16,0,16,15,37,13,1,0,2017-2018,1.6666666666666667,2.4444444444444446
2268,Nico Schulz,GER,"FW,MF",Hoffenheim,Bundesliga,24,1993,19.8,40,29,17,14,9,20,27,74.1,7,33,5,28,23,63,24,0,0,2017-2018,1.1616161616161615,2.0202020202020203
2269,André Schürrle,GER,FW,Dortmund,Bundesliga,26,1990,13.7,22,19,8,7,7,9,18,50.0,9,13,1,12,7,29,7,1,0,2017-2018,0.5109489051094891,1.6058394160583942
2270,Julian Schuster,GER,"DF,MF",Freiburg,Bundesliga,32,1985,14.5,14,10,6,7,1,6,11,54.5,5,17,10,7,19,33,56,0,0,2017-2018,1.3103448275862069,0.9655172413793104
2271,Pirmin Schwegler,SUI,MF,Hannover 96,Bundesliga,30,1987,25.8,81,57,25,55,1,42,70,60.0,28,33,9,24,49,130,46,1,0,2017-2018,1.8992248062015504,3.13953488372093
2272,Alexander Schwolow,GER,GK,Freiburg,Bundesliga,25,1992,32.3,0,0,0,0,0,0,1,0.0,1,0,0,0,0,0,9,1,0,2017-2018,0.0,0.0
2273,Simone Scuffet,ITA,GK,Udinese,Serie A,21,1996,6.0,0,0,0,0,0,0,0,0.0,0,0,0,0,1,1,1,1,0,2017-2018,0.16666666666666666,0.0
2274,Sergio Segura García,ESP,DF,Leganés,La Liga,21,1995,0.3,0,2,0,0,0,,0,0.0,0,0,0,0,1,0,0,0,0,2017-2018,3.3333333333333335,0.0
2275,Ernest Seka,GUI,DF,Strasbourg,Ligue 1,30,1987,24.2,60,47,41,14,5,40,61,65.6,21,25,8,17,51,111,98,1,0,2017-2018,2.1074380165289255,2.479338842975207
2276,Vahid Selimović,LUX,DF,Metz,Ligue 1,20,1997,11.7,20,14,10,9,1,11,14,78.6,3,10,8,2,17,37,58,1,0,2017-2018,1.4529914529914532,1.7094017094017095
2277,Davie Selke,GER,FW,Hertha BSC,Bundesliga,22,1995,21.0,13,10,1,5,7,4,9,44.4,5,26,5,21,2,15,20,1,0,2017-2018,0.09523809523809523,0.6190476190476191
2278,Ole Selnæs,NOR,MF,Saint-Étienne,Ligue 1,23,1994,22.9,73,45,29,42,2,18,61,29.5,43,37,15,22,34,107,53,1,0,2017-2018,1.4847161572052403,3.1877729257641922
2279,Nélson Semedo,POR,DF,Barcelona,La Liga,23,1993,16.6,34,25,19,11,4,17,29,58.6,12,16,2,14,22,56,26,1,0,2017-2018,1.325301204819277,2.048192771084337
2280,Rúben Semedo,POR,"DF,MF",Villarreal,La Liga,23,1994,2.6,6,5,6,0,0,4,6,66.7,2,5,1,4,5,11,13,2,0,2017-2018,1.923076923076923,2.3076923076923075
2281,Stefano Sensi,ITA,MF,Sassuolo,Serie A,21,1995,11.6,17,13,11,6,0,9,22,40.9,13,16,3,13,22,39,10,1,0,2017-2018,1.896551724137931,1.4655172413793105
2282,Luigi Sepe,ITA,GK,Napoli,Serie A,26,1991,1.0,0,0,0,0,0,0,0,0.0,0,0,0,0,0,0,1,0,0,2017-2018,0.0,0.0
2283,Suat Serdar,GER,MF,Mainz 05,Bundesliga,20,1997,18.9,59,47,21,26,12,27,64,42.2,37,38,3,35,21,80,17,1,0,2017-2018,1.1111111111111112,3.121693121693122
2284,Jean Seri,CIV,MF,Nice,Ligue 1,26,1991,29.1,25,14,9,12,4,9,56,16.1,47,16,4,12,26,51,15,4,0,2017-2018,0.8934707903780068,0.8591065292096219
2285,Julien Serrano,FRA,DF,Monaco,Ligue 1,19,1998,3.1,2,2,1,0,1,1,2,50.0,1,2,0,2,4,6,14,0,0,2017-2018,1.2903225806451613,0.6451612903225806
2286,Grégory Sertic,FRA,"DF,MF",Marseille,Ligue 1,27,1989,3.9,5,3,3,2,0,2,6,33.3,4,8,7,1,6,11,23,0,0,2017-2018,1.5384615384615385,1.2820512820512822
2287,Stéphane Sessègnon,BEN,"MF,FW",Montpellier,Ligue 1,33,1984,10.9,4,4,2,2,0,1,7,14.3,6,0,0,0,0,4,2,0,0,2017-2018,0.0,0.36697247706422015
2288,Lee Seung-woo,KOR,"MF,FW",Hellas Verona,Serie A,19,1998,4.0,3,2,0,1,2,0,6,0.0,6,1,0,1,2,5,0,0,0,2017-2018,0.5,0.75
2289,Stephan El Shaarawy,ITA,FW,Roma,Serie A,24,1992,23.9,22,16,9,8,5,5,21,23.8,16,16,1,15,24,46,8,0,0,2017-2018,1.00418410041841,0.9205020920502093
2290,Meritan Shabani,ALB,FW,Bayern Munich,Bundesliga,18,1999,0.6,2,1,1,0,1,1,2,50.0,1,1,0,1,0,2,0,1,0,2017-2018,0.0,3.3333333333333335
2291,Xherdan Shaqiri,SUI,"MF,FW",Stoke City,Premier League,25,1991,33.8,25,17,9,11,5,10,39,25.6,29,9,1,8,16,41,6,2,0,2017-2018,0.4733727810650888,0.7396449704142013
2292,Luke Shaw,ENG,DF,Manchester Utd,Premier League,22,1995,8.8,18,15,10,7,1,11,18,61.1,7,16,2,14,4,22,22,1,0,2017-2018,0.45454545454545453,2.0454545454545454
2293,Ryan Shawcross,ENG,DF,Stoke City,Premier League,29,1987,26.3,36,20,25,9,2,13,25,52.0,12,33,23,10,40,76,224,1,0,2017-2018,1.520912547528517,1.3688212927756653
2294,Jonjo Shelvey,ENG,MF,Newcastle Utd,Premier League,25,1992,25.2,39,24,17,21,1,8,26,30.8,18,26,5,21,28,67,33,0,0,2017-2018,1.1111111111111112,1.5476190476190477
2295,Gaku Shibasaki,JPN,"MF,FW",Getafe,La Liga,25,1992,11.1,21,10,8,10,3,6,21,28.6,15,6,1,5,19,40,9,0,0,2017-2018,1.7117117117117118,1.8918918918918919
2296,Djibril Sidibé,FRA,DF,Monaco,Ligue 1,25,1992,23.9,59,39,24,27,8,23,45,51.1,22,20,4,16,46,105,52,1,0,2017-2018,1.9246861924686194,2.468619246861925
2297,Sidnei,BRA,DF,La Coruña,La Liga,27,1989,19.8,41,28,30,11,0,18,25,72.0,7,26,9,17,31,72,101,1,0,2017-2018,1.5656565656565655,2.0707070707070705
2298,Jaime Sierra Mateos,ESP,"FW,MF",Leganés,La Liga,19,1998,0.3,1,1,1,0,0,0,1,0.0,1,0,0,0,1,2,0,0,0,2017-2018,3.3333333333333335,3.3333333333333335
2299,Vincent Sierro,SUI,"MF,FW",Freiburg,Bundesliga,21,1995,2.4,8,6,2,6,0,4,9,44.4,5,2,1,1,4,12,0,0,0,2017-2018,1.6666666666666667,3.3333333333333335
2300,Gylfi Sigurðsson,ISL,"MF,FW",Everton,Premier League,27,1989,25.1,38,26,15,14,9,16,57,28.1,41,37,7,30,34,72,36,0,0,2017-2018,1.3545816733067728,1.5139442231075697
2301,Kolbeinn Sigþórsson,ISL,FW,Nantes,Ligue 1,27,1990,0.3,0,0,0,0,0,0,0,0.0,0,0,0,0,1,1,0,0,0,2017-2018,3.3333333333333335,0.0
2302,Adrien Silva,POR,MF,Leicester City,Premier League,28,1989,8.5,22,13,8,13,1,6,28,21.4,22,12,2,10,14,36,0,0,0,2017-2018,1.6470588235294117,2.588235294117647
2303,André Silva,POR,FW,Milan,Serie A,21,1995,10.4,5,4,1,0,4,2,7,28.6,5,10,1,9,4,9,6,0,0,2017-2018,0.3846153846153846,0.4807692307692307
2304,Bernardo Silva,POR,"FW,MF",Manchester City,Premier League,22,1994,17.0,27,18,11,9,7,6,30,20.0,24,17,1,16,10,37,12,1,0,2017-2018,0.5882352941176471,1.588235294117647
2305,David Silva,ESP,MF,Manchester City,Premier League,31,1986,27.0,32,21,11,17,4,9,45,20.0,36,28,5,23,18,50,7,0,0,2017-2018,0.6666666666666666,1.1851851851851851
2306,Gabriel Silva,BRA,DF,Saint-Étienne,Ligue 1,26,1991,23.1,28,20,19,4,5,19,31,61.3,12,21,6,15,37,65,83,1,0,2017-2018,1.6017316017316017,1.2121212121212122
2307,Jonathan Silva,ARG,DF,Roma,Serie A,23,1994,1.2,0,0,0,0,0,0,1,0.0,1,1,1,0,3,3,1,0,0,2017-2018,2.5,0.0
2308,Thiago Silva,BRA,DF,Paris S-G,Ligue 1,32,1984,23.5,31,23,19,12,0,12,21,57.1,9,28,18,10,18,49,114,0,0,2017-2018,0.7659574468085106,1.3191489361702127
2309,Matías Silvestre,ARG,DF,Sampdoria,Serie A,32,1984,34.0,12,8,10,1,1,6,12,50.0,6,33,26,7,11,23,154,3,0,2017-2018,0.3235294117647059,0.35294117647058826
2310,Marco Silvestri,ITA,GK,Hellas Verona,Serie A,26,1991,2.0,0,0,0,0,0,0,0,0.0,0,0,0,0,1,1,0,0,0,2017-2018,0.5,0.0
2311,Giovanni Simeone,ARG,FW,Fiorentina,Serie A,22,1995,33.3,32,23,9,17,6,8,40,20.0,32,27,1,26,12,44,32,0,0,2017-2018,0.3603603603603604,0.9609609609609611
2312,Lorenco Šimić,CRO,DF,SPAL,Serie A,21,1996,3.5,5,3,5,0,0,3,4,75.0,1,7,4,3,11,16,15,0,0,2017-2018,3.142857142857143,1.4285714285714286
2313,Stefan Simić,CZE,DF,Crotone,Serie A,22,1995,6.2,13,8,11,2,0,10,11,90.9,1,6,3,3,10,23,44,0,0,2017-2018,1.6129032258064515,2.096774193548387
2314,David Simón,ESP,DF,Las Palmas,La Liga,28,1988,8.0,24,17,11,10,3,9,16,56.3,7,13,4,9,22,46,11,1,0,2017-2018,2.75,3.0
2315,Danny Simpson,ENG,DF,Leicester City,Premier League,30,1987,25.6,38,22,31,6,1,22,45,48.9,23,31,19,12,34,72,132,1,0,2017-2018,1.328125,1.484375
2316,Jack Simpson,ENG,DF,Bournemouth,Premier League,20,1996,0.8,1,1,1,0,0,0,1,0.0,1,1,0,1,0,1,4,0,0,2017-2018,0.0,1.25
2317,Josh Sims,ENG,"FW,MF",Southampton,Premier League,20,1997,1.8,4,3,1,2,1,2,7,28.6,5,5,0,5,1,5,0,0,0,2017-2018,0.5555555555555556,2.2222222222222223
2318,Jerome Sinclair,ENG,"MF,FW",Watford,Premier League,20,1996,0.3,0,0,0,0,0,0,1,0.0,1,0,0,0,1,1,0,0,0,2017-2018,3.3333333333333335,0.0
2319,Giovanni Sio,CIV,FW,Montpellier,Ligue 1,28,1989,24.4,14,8,2,9,3,0,20,0.0,20,11,0,11,6,20,23,1,0,2017-2018,0.24590163934426232,0.5737704918032788
2320,Dimitris Siovas,GRE,DF,Leganés,La Liga,28,1988,22.9,48,33,43,5,0,29,46,63.0,17,27,12,15,62,110,89,0,0,2017-2018,2.7074235807860263,2.096069868995633
2321,Tobias Sippel,GER,GK,Gladbach,Bundesliga,29,1988,4.8,1,1,1,0,0,1,2,50.0,1,0,0,0,0,1,5,1,0,2017-2018,0.0,0.20833333333333334
2322,Salvatore Sirigu,ITA,GK,Torino,Serie A,30,1987,37.0,0,0,0,0,0,0,0,0.0,0,0,0,0,1,1,35,3,0,2017-2018,0.02702702702702703,0.0
2323,Moussa Sissoko,FRA,"MF,FW",Tottenham,Premier League,27,1989,15.4,23,17,14,5,4,9,12,75.0,3,11,1,10,9,32,23,1,0,2017-2018,0.5844155844155844,1.4935064935064934
2324,Pione Sisto,DEN,"FW,MF",Celta Vigo,La Liga,22,1995,28.0,18,12,8,6,4,9,33,27.3,24,12,1,11,12,30,7,1,0,2017-2018,0.42857142857142855,0.6428571428571429
2325,Antonio Sivera,ESP,GK,Alavés,La Liga,20,1996,0.7,0,0,0,0,0,0,0,0.0,0,0,0,0,0,0,0,0,0,2017-2018,0.0,0.0
2326,Ellyes Skhiri,TUN,MF,Montpellier,Ligue 1,22,1995,33.9,89,54,34,47,8,37,88,42.0,51,59,10,49,77,166,57,4,0,2017-2018,2.2713864306784664,2.6253687315634218
2327,Łukasz Skorupski,POL,GK,Roma,Serie A,26,1991,1.0,0,0,0,0,0,0,0,0.0,0,0,0,0,0,0,1,0,0,2017-2018,0.0,0.0
2328,Milan Škriniar,SVK,DF,Inter,Serie A,22,1995,38.0,86,55,69,16,1,44,70,62.9,26,38,26,12,35,121,180,0,0,2017-2018,0.9210526315789473,2.263157894736842
2329,Islam Slimani,ALG,FW,Leicester City,Premier League,29,1988,2.8,2,2,1,1,0,1,4,25.0,3,2,0,2,0,2,2,0,0,2017-2018,0.0,0.7142857142857143
2330,Islam Slimani,ALG,FW,Newcastle Utd,Premier League,29,1988,1.5,0,0,0,0,0,0,2,0.0,2,0,0,0,1,1,1,0,0,2017-2018,0.6666666666666666,0.0
2331,Naïm Sliti,TUN,"FW,MF",Dijon,Ligue 1,25,1992,25.4,47,32,20,17,10,20,52,38.5,32,22,2,20,13,60,7,0,0,2017-2018,0.5118110236220472,1.8503937007874016
2332,Chris Smalling,ENG,DF,Manchester Utd,Premier League,27,1989,28.2,40,25,28,12,0,16,28,57.1,12,32,28,4,63,103,162,1,0,2017-2018,2.2340425531914896,1.4184397163120568
2333,Adam Smith,ENG,"DF,MF",Bournemouth,Premier League,26,1991,23.0,50,36,33,16,1,24,53,45.3,29,46,8,38,31,81,73,0,0,2017-2018,1.3478260869565217,2.1739130434782608
2334,Tommy Smith,ENG,DF,Huddersfield,Premier League,25,1992,21.2,38,27,18,14,6,23,36,63.9,13,22,6,16,26,64,80,3,0,2017-2018,1.2264150943396226,1.7924528301886793
2335,Wesley Sneijder,NED,"MF,FW",Nice,Ligue 1,33,1984,4.4,0,0,0,0,0,0,3,0.0,3,1,0,1,2,2,2,1,0,2017-2018,0.45454545454545453,0.0
2336,Cédric Soares,POR,DF,Southampton,Premier League,25,1991,31.0,54,34,40,10,4,22,31,71.0,9,32,8,24,24,78,109,2,0,2017-2018,0.7741935483870968,1.7419354838709677
2337,Ramadan Sobhi,EGY,"MF,FW",Stoke City,Premier League,20,1997,13.8,32,21,17,14,1,11,36,30.6,25,14,0,14,14,46,14,0,0,2017-2018,1.0144927536231882,2.318840579710145
2338,Rubén Sobrino,ESP,"FW,MF",Alavés,La Liga,25,1992,16.3,33,24,12,16,5,6,27,22.2,21,19,2,17,18,51,10,0,0,2017-2018,1.1042944785276072,2.0245398773006134
2339,Dominic Solanke,ENG,FW,Liverpool,Premier League,19,1997,6.6,7,4,0,6,1,1,4,25.0,3,5,1,4,2,9,9,0,0,2017-2018,0.30303030303030304,1.0606060606060606
2340,Carlos Soler,ESP,MF,Valencia,La Liga,20,1997,26.3,51,32,21,21,9,22,53,41.5,31,25,1,24,5,56,19,0,0,2017-2018,0.19011406844106463,1.9391634980988592
2341,Somália,BRA,"MF,FW",Toulouse,Ligue 1,28,1988,22.2,65,45,21,36,8,14,54,25.9,40,34,2,32,34,99,35,0,0,2017-2018,1.5315315315315317,2.927927927927928
2342,Yann Sommer,SUI,GK,Gladbach,Bundesliga,28,1988,29.2,0,0,0,0,0,0,0,0.0,0,0,0,0,3,3,6,3,0,2017-2018,0.10273972602739727,0.0
2343,Kévin Soni,CMR,MF,Girona,La Liga,19,1998,0.2,1,1,0,1,0,0,0,0.0,0,0,0,0,0,1,0,0,0,2017-2018,0.0,5.0
2344,Jérémy Sorbon,FRA,DF,Guingamp,Ligue 1,33,1983,29.0,32,19,24,7,1,10,32,31.3,22,37,24,13,53,85,152,4,0,2017-2018,1.8275862068965518,1.103448275862069
2345,Oliver Sorg,GER,"DF,MF",Hannover 96,Bundesliga,27,1990,18.7,46,28,27,18,1,23,53,43.4,30,24,7,17,42,88,71,0,0,2017-2018,2.2459893048128343,2.4598930481283423
2346,David Soria,ESP,GK,Sevilla,La Liga,24,1993,14.0,1,0,1,0,0,1,1,100.0,0,0,0,0,2,3,13,2,0,2017-2018,0.14285714285714285,0.07142857142857142
2347,Roberto Soriano,ITA,"MF,FW",Villarreal,La Liga,26,1991,12.7,30,20,10,16,4,3,16,18.8,13,14,0,14,4,34,9,0,0,2017-2018,0.31496062992125984,2.362204724409449
2348,Stefano Sorrentino,ITA,GK,Chievo,Serie A,38,1979,38.0,0,0,0,0,0,0,0,0.0,0,0,0,0,0,0,23,3,0,2017-2018,0.0,0.0
2349,Pape Souaré,SEN,DF,Crystal Palace,Premier League,27,1990,0.1,0,0,0,0,0,0,0,0.0,0,0,0,0,0,0,0,0,0,2017-2018,0.0,0.0
2350,Rayan Souici,FRA,MF,Saint-Étienne,Ligue 1,19,1998,0.1,0,0,0,0,0,0,0,0.0,0,1,0,1,0,0,0,0,0,2017-2018,0.0,0.0
2351,Adama Soumaoro,FRA,DF,Lille,Ligue 1,25,1992,13.2,9,5,7,2,0,2,3,66.7,1,22,16,6,16,25,50,1,0,2017-2018,1.2121212121212122,0.6818181818181819
2352,Boubakary Soumaré,FRA,MF,Lille,Ligue 1,18,1999,5.7,13,9,8,5,0,3,14,21.4,11,8,1,7,7,20,6,1,0,2017-2018,1.2280701754385965,2.280701754385965
2353,Samuel Souprayen,FRA,DF,Hellas Verona,Serie A,28,1989,17.6,29,19,25,3,1,12,19,63.2,7,18,9,9,22,51,67,1,0,2017-2018,1.25,1.6477272727272725
2354,Arnaud Souquet,FRA,DF,Nice,Ligue 1,25,1992,26.8,89,68,58,26,5,36,56,64.3,20,46,16,30,39,128,72,2,0,2017-2018,1.4552238805970148,3.3208955223880596
2355,Çağlar Söyüncü,TUR,DF,Freiburg,Bundesliga,21,1996,23.9,42,26,26,15,1,15,26,57.7,11,30,20,10,54,96,91,2,0,2017-2018,2.259414225941423,1.7573221757322177
2356,Luca Sparandeo,ITA,DF,Benevento,Serie A,17,1999,0.4,0,0,0,0,0,0,1,0.0,1,1,0,1,0,0,0,0,0,2017-2018,0.0,0.0
2357,Julián Speroni,ARG,GK,Crystal Palace,Premier League,38,1979,11.0,0,0,0,0,0,0,0,0.0,0,0,0,0,1,1,4,0,0,2017-2018,0.09090909090909091,0.0
2358,Leonardo Spinazzola,ITA,DF,Atalanta,Serie A,24,1993,16.7,14,5,9,4,1,7,15,46.7,8,25,6,19,18,32,44,1,0,2017-2018,1.0778443113772456,0.8383233532934132
2359,Nicolás Spolli,ARG,DF,Genoa,Serie A,34,1983,20.0,27,21,24,2,1,13,22,59.1,9,26,17,9,36,63,120,2,0,2017-2018,1.8,1.35
2360,Marco Sportiello,ITA,GK,Fiorentina,Serie A,25,1992,35.6,0,0,0,0,0,0,1,0.0,1,0,0,0,1,1,13,4,0,2017-2018,0.028089887640449437,0.0
2361,Bassem Srarfi,TUN,"FW,MF",Nice,Ligue 1,20,1997,9.7,17,11,6,9,2,4,14,28.6,10,12,0,12,7,24,6,1,0,2017-2018,0.7216494845360826,1.752577319587629
2362,Kostas Stafylidis,GRE,"DF,MF",Stoke City,Premier League,23,1993,3.7,12,6,6,4,2,6,9,66.7,3,7,2,5,5,17,19,0,0,2017-2018,1.3513513513513513,3.243243243243243
2363,Kostas Stafylidis,GRE,"FW,DF",Augsburg,Bundesliga,23,1993,0.4,1,1,1,0,0,0,0,0.0,0,1,0,1,0,1,2,0,0,2017-2018,0.0,2.5
2364,Benjamin Stambouli,FRA,"DF,MF",Schalke 04,Bundesliga,26,1990,24.4,95,75,45,48,2,49,74,66.2,25,39,7,32,64,159,76,1,0,2017-2018,2.6229508196721314,3.89344262295082
2365,Junior Stanislas,ENG,"MF,FW",Bournemouth,Premier League,27,1989,14.3,16,8,8,4,4,7,15,46.7,8,21,6,15,6,22,15,0,0,2017-2018,0.4195804195804196,1.1188811188811187
2366,Caleb Stanko,USA,DF,Freiburg,Bundesliga,24,1993,2.1,2,2,1,1,0,1,2,50.0,1,3,0,3,1,3,8,0,0,2017-2018,0.47619047619047616,0.9523809523809523
2367,Niklas Stark,GER,"DF,MF",Hertha BSC,Bundesliga,22,1995,24.6,49,31,32,17,0,22,30,73.3,8,39,14,25,34,83,165,0,0,2017-2018,1.3821138211382114,1.9918699186991868
2368,Tom Starke,GER,GK,Bayern Munich,Bundesliga,36,1981,2.0,0,0,0,0,0,0,0,0.0,0,0,0,0,0,0,0,0,0,2017-2018,0.0,0.0
2369,Timo Stavitski,FIN,"MF,FW",Caen,Ligue 1,18,1999,4.5,4,3,1,1,2,1,16,6.3,15,7,0,7,3,7,1,0,0,2017-2018,0.6666666666666666,0.8888888888888888
2370,Renato Steffen,SUI,"FW,MF",Wolfsburg,Bundesliga,25,1991,7.3,10,9,6,3,1,8,12,66.7,4,6,0,6,5,15,6,0,0,2017-2018,0.684931506849315,1.36986301369863
2371,Marc Stendera,GER,MF,Eint Frankfurt,Bundesliga,21,1995,4.1,23,20,6,15,2,8,20,40.0,12,10,1,9,8,31,2,0,0,2017-2018,1.9512195121951221,5.609756097560976
2372,Pascal Stenzel,GER,"MF,DF",Freiburg,Bundesliga,21,1996,21.6,62,45,35,25,2,34,57,59.6,23,20,3,17,35,97,51,1,0,2017-2018,1.6203703703703702,2.8703703703703702
2373,Dale Stephens,ENG,MF,Brighton,Premier League,28,1989,36.0,104,62,63,39,2,32,114,28.1,82,53,16,37,63,167,69,1,0,2017-2018,1.75,2.888888888888889
2374,Jack Stephens,ENG,DF,Southampton,Premier League,23,1994,22.0,29,20,24,5,0,13,25,52.0,12,30,18,12,41,70,108,2,0,2017-2018,1.8636363636363635,1.3181818181818181
2375,Mariusz Stępiński,POL,FW,Chievo,Serie A,22,1995,7.9,9,5,4,4,1,2,10,20.0,8,5,1,4,4,13,5,0,0,2017-2018,0.5063291139240506,1.1392405063291138
2376,Mariusz Stępiński,POL,FW,Nantes,Ligue 1,22,1995,0.0,0,0,0,0,0,0,0,0.0,0,0,0,0,0,0,0,0,0,2017-2018,,
2377,Raheem Sterling,ENG,FW,Manchester City,Premier League,22,1994,28.7,19,14,7,7,5,3,32,9.4,29,24,0,24,9,28,9,0,0,2017-2018,0.31358885017421606,0.662020905923345
2378,Ognjen Stijepović,MNE,"FW,MF",Sampdoria,Serie A,17,1999,0.1,0,0,0,0,0,0,0,0.0,0,0,0,0,0,0,0,0,0,2017-2018,0.0,0.0
2379,Lars Stindl,GER,"FW,MF",Gladbach,Bundesliga,28,1988,30.3,52,39,11,29,12,14,38,36.8,24,53,4,49,31,83,32,1,0,2017-2018,1.023102310231023,1.716171617161716
2380,Valentin Stocker,SUI,MF,Hertha BSC,Bundesliga,28,1989,0.6,1,0,0,1,0,0,0,0.0,0,1,0,1,0,1,0,0,0,2017-2018,0.0,1.6666666666666667
2381,Adrian Stoian,ROU,"MF,FW",Crotone,Serie A,26,1991,23.7,23,19,12,10,1,11,44,25.0,33,29,0,29,25,48,26,0,0,2017-2018,1.0548523206751055,0.9704641350210971
2382,John Stones,ENG,DF,Manchester City,Premier League,23,1994,14.5,15,11,11,4,0,4,11,36.4,7,8,5,3,19,34,44,0,0,2017-2018,1.3103448275862069,1.0344827586206897
2383,Thomas Strakosha,ALB,GK,Lazio,Serie A,22,1995,38.0,0,0,0,0,0,0,0,0.0,0,0,0,0,2,2,13,4,0,2017-2018,0.05263157894736842,0.0
2384,Ivan Strinić,CRO,DF,Sampdoria,Serie A,30,1987,13.9,35,24,22,12,1,17,38,44.7,21,21,2,19,22,57,46,2,0,2017-2018,1.5827338129496402,2.5179856115107913
2385,Tobias Strobl,GER,MF,Gladbach,Bundesliga,27,1990,1.3,3,1,0,2,1,0,1,0.0,1,2,0,2,6,9,2,0,0,2017-2018,4.615384615384615,2.3076923076923075
2386,Kevin Strootman,NED,MF,Roma,Serie A,27,1990,25.1,57,38,19,24,14,15,46,32.6,31,27,3,24,27,84,21,0,0,2017-2018,1.0756972111553784,2.2709163346613543
2387,Jens Stryger Larsen,DEN,DF,Udinese,Serie A,26,1991,28.1,36,27,25,10,1,21,39,53.8,18,35,14,21,31,67,82,2,0,2017-2018,1.103202846975089,1.281138790035587
2388,Cristhian Stuani,URU,FW,Girona,La Liga,30,1986,30.1,22,14,2,17,3,3,29,10.3,26,10,0,10,5,27,32,0,0,2017-2018,0.16611295681063123,0.7308970099667774
2389,Stefano Sturaro,ITA,"MF,DF",Juventus,Serie A,24,1993,6.8,17,11,5,9,3,4,11,36.4,7,9,2,7,5,22,18,1,0,2017-2018,0.7352941176470589,2.5
2390,Daniel Sturridge,ENG,FW,West Brom,Premier League,27,1989,1.3,0,0,0,0,0,0,0,0.0,0,0,0,0,0,0,0,0,0,2017-2018,0.0,0.0
2391,Daniel Sturridge,ENG,FW,Liverpool,Premier League,27,1989,4.8,0,0,0,0,0,0,1,0.0,1,1,0,1,0,0,1,0,0,2017-2018,0.0,0.0
2392,Damián Suárez,URU,DF,Getafe,La Liga,29,1988,32.0,86,64,54,21,11,44,90,48.9,46,34,8,26,46,132,76,1,0,2017-2018,1.4375,2.6875
2393,Denis Suárez,ESP,"MF,FW",Barcelona,La Liga,23,1994,6.6,11,9,3,8,0,3,8,37.5,5,7,0,7,2,13,3,0,0,2017-2018,0.30303030303030304,1.6666666666666667
2394,Leonardo Suárez,ARG,MF,Villarreal,La Liga,21,1996,0.3,0,0,0,0,0,0,0,0.0,0,0,0,0,0,0,1,0,0,2017-2018,0.0,0.0
2395,Luis Suárez,URU,FW,Barcelona,La Liga,30,1987,32.2,17,10,4,5,8,4,19,21.1,15,4,3,1,8,25,31,0,0,2017-2018,0.24844720496894407,0.5279503105590062
2396,Danijel Subašić,CRO,GK,Monaco,Ligue 1,32,1984,32.7,0,0,0,0,0,0,2,0.0,2,1,0,1,0,0,13,2,0,2017-2018,0.0,0.0
2397,Neven Subotić,SRB,DF,Saint-Étienne,Ligue 1,28,1988,16.0,23,14,16,7,0,10,27,37.0,17,13,9,4,18,41,96,1,0,2017-2018,1.125,1.4375
2398,Neven Subotić,SRB,DF,Dortmund,Bundesliga,28,1988,3.0,9,9,5,3,1,6,7,85.7,1,6,2,4,5,14,16,0,0,2017-2018,1.6666666666666667,3.0
2399,Isaac Success,NGA,"MF,FW",Málaga,La Liga,21,1996,5.5,9,7,4,4,1,3,8,37.5,5,2,0,2,5,14,0,0,0,2017-2018,0.9090909090909091,1.6363636363636365
2400,Niklas Süle,GER,DF,Bayern Munich,Bundesliga,21,1995,21.4,34,25,25,7,2,24,31,77.4,7,24,16,8,33,67,58,0,0,2017-2018,1.5420560747663552,1.5887850467289721
2401,Ki Sung-yueng,KOR,MF,Swansea City,Premier League,28,1989,20.8,25,18,10,13,2,4,16,25.0,12,16,1,15,32,57,23,0,0,2017-2018,1.5384615384615383,1.2019230769230769
2402,Gilles Sunu,TOG,"MF,FW",Angers,Ligue 1,26,1991,7.3,4,4,1,3,0,0,4,0.0,4,7,0,7,3,7,3,0,0,2017-2018,0.4109589041095891,0.547945205479452
2403,Andrew Surman,ENG,MF,Bournemouth,Premier League,30,1986,20.6,16,12,5,8,3,6,23,26.1,17,33,12,21,16,32,52,2,0,2017-2018,0.7766990291262136,0.7766990291262136
2404,Markel Susaeta,ESP,"FW,MF",Athletic Club,La Liga,29,1987,25.2,42,29,16,15,11,16,65,24.6,49,17,0,17,18,60,13,0,0,2017-2018,0.7142857142857143,1.6666666666666667
2405,Suso,ESP,"FW,MF",Milan,Serie A,23,1993,31.4,18,14,3,5,10,4,31,12.9,27,25,0,25,16,34,2,1,0,2017-2018,0.5095541401273885,0.5732484076433121
2406,Markus Suttner,AUT,DF,Brighton,Premier League,30,1987,13.1,25,15,18,4,3,10,22,45.5,12,16,2,14,12,37,49,1,0,2017-2018,0.916030534351145,1.9083969465648856
2407,Seydou Sy,SEN,GK,Monaco,Ligue 1,21,1995,2.8,0,0,0,0,0,0,0,0.0,0,0,0,0,0,0,2,0,0,2017-2018,0.0,0.0
2408,Issiaga Sylla,GUI,"DF,FW",Toulouse,Ligue 1,23,1994,17.8,44,32,22,16,6,19,47,40.4,28,31,4,27,34,78,65,1,0,2017-2018,1.9101123595505618,2.4719101123595504
2409,Moussa Sylla,MLI,FW,Monaco,Ligue 1,17,1999,3.4,0,0,0,0,0,0,2,0.0,2,2,0,2,0,0,1,0,0,2017-2018,0.0,0.0
2410,Ádám Szalai,HUN,FW,Hoffenheim,Bundesliga,29,1987,10.0,8,7,1,4,3,2,5,40.0,3,9,2,7,0,8,10,0,0,2017-2018,0.0,0.8
2411,Wojciech Szczęsny,POL,GK,Juventus,Serie A,27,1990,17.0,0,0,0,0,0,0,0,0.0,0,0,0,0,0,0,4,0,0,2017-2018,0.0,0.0
2412,Alexander Søderlund,NOR,FW,Saint-Étienne,Ligue 1,29,1987,4.0,1,1,1,0,0,0,2,0.0,2,1,0,1,2,3,2,0,0,2017-2018,0.5,0.25
2413,Frederik Sørensen,DEN,DF,Köln,Bundesliga,25,1992,22.2,56,45,40,14,2,30,41,73.2,11,35,17,18,37,93,130,3,0,2017-2018,1.6666666666666667,2.5225225225225225
2414,Lasse Sørensen,DEN,MF,Stoke City,Premier League,17,1999,0.8,2,2,2,0,0,1,5,20.0,4,2,0,2,0,2,3,0,0,2017-2018,0.0,2.5
2415,Alexander Sørloth,NOR,FW,Crystal Palace,Premier League,21,1995,4.0,6,3,1,4,1,4,12,33.3,8,5,0,5,2,8,5,0,0,2017-2018,0.5,1.5
2416,Adel Taarabt,MAR,"FW,MF",Genoa,Serie A,28,1989,17.9,18,11,5,11,2,7,16,43.8,9,13,3,10,12,30,7,0,0,2017-2018,0.670391061452514,1.005586592178771
2417,Franck Tabanou,FRA,DF,Guingamp,Ligue 1,28,1989,11.6,23,17,17,5,1,10,26,38.5,16,5,3,2,26,49,48,0,0,2017-2018,2.241379310344828,1.9827586206896552
2418,Dušan Tadić,SRB,"MF,FW",Southampton,Premier League,28,1988,31.0,46,29,16,22,8,11,35,31.4,24,38,2,36,19,65,29,1,0,2017-2018,0.6129032258064516,1.4838709677419355
2419,Jonathan Tah,GER,DF,Leverkusen,Bundesliga,21,1996,27.0,47,34,35,12,0,30,38,78.9,8,22,13,9,34,81,112,2,0,2017-2018,1.2592592592592593,1.7407407407407407
2420,Ervin Taha,FRA,FW,Bordeaux,Ligue 1,18,1999,0.4,1,1,0,1,0,0,1,0.0,1,0,0,0,0,1,0,0,0,2017-2018,0.0,2.5
2421,Mehdi Tahrat,ALG,MF,Angers,Ligue 1,27,1990,4.9,7,6,4,3,0,2,5,40.0,3,3,1,2,9,16,15,1,0,2017-2018,1.8367346938775508,1.4285714285714284
2422,Saphir Taïder,ALG,MF,Bologna,Serie A,25,1992,4.3,6,2,4,2,0,1,2,50.0,1,3,2,1,1,7,4,0,0,2017-2018,0.23255813953488372,1.3953488372093024
2423,Flavien Tait,FRA,MF,Angers,Ligue 1,24,1993,24.8,50,36,26,18,6,18,78,23.1,60,43,4,39,20,70,17,1,0,2017-2018,0.8064516129032258,2.0161290322580645
2424,Adrien Tameze,CMR,MF,Nice,Ligue 1,23,1994,18.7,58,36,32,21,5,26,47,55.3,21,26,5,21,41,99,22,1,0,2017-2018,2.192513368983957,3.1016042780748663
2425,Tana,ESP,"MF,FW",Las Palmas,La Liga,26,1990,17.2,31,24,13,14,4,12,36,33.3,24,8,0,8,23,54,5,0,0,2017-2018,1.3372093023255816,1.802325581395349
2426,Oussama Tannane,MAR,FW,Las Palmas,La Liga,23,1994,6.4,15,13,6,8,1,7,12,58.3,5,5,0,5,5,20,0,0,0,2017-2018,0.78125,2.34375
2427,Oussama Tannane,MAR,FW,Saint-Étienne,Ligue 1,23,1994,2.3,12,6,4,5,3,2,5,40.0,3,2,0,2,3,15,2,0,0,2017-2018,1.3043478260869565,5.217391304347826
2428,Matt Targett,ENG,DF,Southampton,Premier League,21,1995,1.8,6,3,5,0,1,1,3,33.3,2,3,2,1,3,9,7,1,0,2017-2018,1.6666666666666665,3.333333333333333
2429,James Tarkowski,ENG,DF,Burnley,Premier League,24,1992,31.0,46,26,36,10,0,17,38,44.7,21,55,43,12,50,96,223,2,0,2017-2018,1.6129032258064515,1.4838709677419355
2430,Ciprian Tătărușanu,ROU,GK,Nantes,Ligue 1,31,1986,37.0,1,0,1,0,0,1,2,50.0,1,0,0,0,1,2,12,3,0,2017-2018,0.02702702702702703,0.02702702702702703
2431,Júlio Tavares,CPV,FW,Dijon,Ligue 1,28,1988,22.8,3,1,1,1,1,1,11,9.1,10,11,6,5,3,6,36,0,0,2017-2018,0.13157894736842105,0.13157894736842105
2432,Taleb Tawatha,ISR,"DF,MF",Eint Frankfurt,Bundesliga,25,1992,4.9,12,7,7,5,0,5,9,55.6,4,7,1,6,6,18,18,0,0,2017-2018,1.2244897959183672,2.4489795918367343
2433,Charlie Taylor,ENG,DF,Burnley,Premier League,23,1993,10.6,16,4,9,6,1,7,12,58.3,5,13,5,8,15,31,52,0,0,2017-2018,1.4150943396226416,1.509433962264151
2434,Jordan Tell,GLP,"FW,MF",Rennes,Ligue 1,20,1997,1.3,4,4,1,3,0,0,1,0.0,1,0,0,0,1,5,0,0,0,2017-2018,0.7692307692307692,3.0769230769230766
2435,Cristian Tello,ESP,"FW,MF",Betis,La Liga,25,1991,18.8,32,24,12,14,6,7,37,18.9,30,19,0,19,16,48,4,1,0,2017-2018,0.851063829787234,1.702127659574468
2436,Marc-André ter Stegen,GER,GK,Barcelona,La Liga,25,1992,37.0,1,0,1,0,0,1,3,33.3,2,1,0,1,4,5,12,1,0,2017-2018,0.10810810810810811,0.02702702702702703
2437,Simon Terodde,GER,FW,Stuttgart,Bundesliga,29,1988,10.6,9,6,1,7,1,2,5,40.0,3,8,2,6,5,14,8,0,0,2017-2018,0.4716981132075472,0.8490566037735849
2438,Simon Terodde,GER,FW,Köln,Bundesliga,29,1988,12.9,11,9,3,8,0,4,11,36.4,7,3,0,3,4,15,7,0,0,2017-2018,0.31007751937984496,0.8527131782945736
2439,Marco Terrazzino,GER,"MF,FW",Freiburg,Bundesliga,26,1991,16.5,31,24,12,13,6,21,39,53.8,18,16,0,16,9,40,19,0,0,2017-2018,0.5454545454545454,1.878787878787879
2440,Martin Terrier,FRA,"FW,MF",Strasbourg,Ligue 1,20,1997,18.6,42,30,16,23,3,9,28,32.1,19,11,1,10,14,56,6,0,0,2017-2018,0.7526881720430108,2.258064516129032
2441,Kenny Tete,NED,DF,Lyon,Ligue 1,21,1995,17.9,37,25,24,10,3,15,26,57.7,11,20,7,13,29,66,52,0,0,2017-2018,1.6201117318435756,2.0670391061452515
2442,Cedric Teuchert,GER,FW,Schalke 04,Bundesliga,20,1997,0.4,0,0,0,0,0,0,0,0.0,0,1,0,1,0,0,0,0,0,2017-2018,0.0,0.0
2443,Florian Thauvin,FRA,FW,Marseille,Ligue 1,24,1993,32.8,44,28,16,20,8,15,46,32.6,31,22,1,21,17,61,20,0,0,2017-2018,0.5182926829268293,1.3414634146341464
2444,Kévin Théophile-Catherine,FRA,DF,Saint-Étienne,Ligue 1,27,1989,24.1,36,27,23,13,0,11,24,45.8,13,19,15,4,31,67,113,1,0,2017-2018,1.2863070539419086,1.4937759336099585
2445,Cyril Théréau,FRA,"FW,MF",Udinese,Serie A,34,1983,2.0,1,1,1,0,0,1,2,50.0,1,0,0,0,0,1,2,0,0,2017-2018,0.0,0.5
2446,Cyril Théréau,FRA,"FW,MF",Fiorentina,Serie A,34,1983,12.4,11,6,3,6,2,7,19,36.8,12,13,0,13,8,19,9,0,0,2017-2018,0.6451612903225806,0.8870967741935484
2447,Vincent Thill,LUX,MF,Metz,Ligue 1,17,2000,0.3,0,0,0,0,0,0,0,0.0,0,0,0,0,0,0,0,0,0,2017-2018,0.0,0.0
2448,Romain Thomas,FRA,DF,Angers,Ligue 1,29,1988,27.4,31,21,16,15,0,14,29,48.3,15,32,19,13,34,65,151,1,0,2017-2018,1.2408759124087592,1.1313868613138687
2449,Adrien Thomasson,FRA,"MF,FW",Nantes,Ligue 1,23,1993,28.6,71,52,41,23,7,22,73,30.1,51,58,4,54,18,89,20,0,0,2017-2018,0.6293706293706294,2.4825174825174825
2450,Erik Thommy,GER,FW,Augsburg,Bundesliga,22,1994,1.9,6,5,1,3,2,3,8,37.5,5,2,0,2,5,11,0,0,0,2017-2018,2.6315789473684212,3.1578947368421053
2451,Erik Thommy,GER,MF,Stuttgart,Bundesliga,22,1994,10.9,19,11,7,7,5,9,17,52.9,8,17,2,15,9,28,8,1,0,2017-2018,0.8256880733944953,1.7431192660550459
2452,Marcus Thuram,FRA,FW,Guingamp,Ligue 1,19,1997,21.4,20,15,6,10,4,6,25,24.0,19,14,0,14,5,25,12,0,0,2017-2018,0.23364485981308414,0.9345794392523366
2453,Youri Tielemans,BEL,MF,Monaco,Ligue 1,20,1997,17.4,47,24,14,28,5,17,55,30.9,38,24,5,19,34,81,20,1,0,2017-2018,1.9540229885057472,2.7011494252873565
2454,David Timor,ESP,"MF,DF",Girona,La Liga,27,1989,10.3,17,10,7,7,3,7,18,38.9,11,10,5,5,20,37,30,1,0,2017-2018,1.9417475728155338,1.6504854368932038
2455,Jonathan Tinhan,BEN,"MF,FW",Troyes,Ligue 1,28,1989,0.8,1,0,0,1,0,0,1,0.0,1,1,0,1,1,2,0,0,0,2017-2018,1.25,1.25
2456,Marcel Tisserand,COD,DF,Wolfsburg,Bundesliga,24,1993,13.9,15,10,10,4,1,7,14,50.0,7,18,13,5,31,46,50,0,0,2017-2018,2.2302158273381294,1.079136690647482
2457,Tito,ESP,DF,Leganés,La Liga,32,1985,6.8,8,5,5,3,0,6,18,33.3,12,12,5,7,12,20,16,0,0,2017-2018,1.7647058823529411,1.1764705882352942
2458,Ola Toivonen,SWE,"FW,MF",Toulouse,Ligue 1,31,1986,8.9,4,4,1,0,3,0,7,0.0,7,2,0,2,2,6,12,0,0,2017-2018,0.2247191011235955,0.449438202247191
2459,Karl Toko Ekambi,CMR,"FW,MF",Angers,Ligue 1,24,1992,33.8,17,8,2,5,10,5,29,17.2,24,13,0,13,15,32,2,0,0,2017-2018,0.44378698224852076,0.5029585798816568
2460,Hernán Toledo,ARG,"FW,MF",Las Palmas,La Liga,21,1996,6.9,5,5,2,2,1,1,11,9.1,10,2,0,2,5,10,5,0,0,2017-2018,0.7246376811594203,0.7246376811594203
2461,Corentin Tolisso,FRA,MF,Bayern Munich,Bundesliga,22,1994,17.5,33,22,8,18,7,14,32,43.8,18,13,3,10,16,49,8,0,0,2017-2018,0.9142857142857143,1.8857142857142857
2462,Jeremy Toljan,GER,"DF,FW",Hoffenheim,Bundesliga,22,1994,2.0,3,1,1,2,0,2,3,66.7,1,3,0,3,0,3,3,0,0,2017-2018,0.0,1.5
2463,Jeremy Toljan,GER,DF,Dortmund,Bundesliga,22,1994,13.5,29,20,17,11,1,19,32,59.4,13,17,2,15,12,41,45,0,0,2017-2018,0.8888888888888888,2.1481481481481484
2464,Rafael Tolói,ITA,DF,Atalanta,Serie A,26,1990,27.2,72,40,34,38,0,35,68,51.5,33,35,14,21,63,135,119,1,0,2017-2018,2.3161764705882355,2.6470588235294117
2465,James Tomkins,ENG,DF,Crystal Palace,Premier League,28,1989,26.5,47,26,36,10,1,16,31,51.6,15,24,12,12,63,110,216,1,0,2017-2018,2.3773584905660377,1.7735849056603774
2466,Nenad Tomović,SRB,DF,Fiorentina,Serie A,29,1987,1.5,2,1,1,1,0,0,2,0.0,2,0,0,0,3,5,5,1,0,2017-2018,2.0,1.3333333333333333
2467,Nenad Tomović,SRB,DF,Chievo,Serie A,29,1987,25.6,23,17,17,6,0,10,17,58.8,7,29,21,8,50,73,146,0,0,2017-2018,1.953125,0.8984375
2468,Lorenzo Tonelli,ITA,DF,Napoli,Serie A,27,1990,3.9,7,1,4,3,0,5,9,55.6,4,2,1,1,7,14,10,0,0,2017-2018,1.794871794871795,1.794871794871795
2469,Aleksandar Tonev,BUL,"FW,MF",Crotone,Serie A,27,1990,4.5,5,3,1,2,2,0,1,0.0,1,4,1,3,1,6,6,0,0,2017-2018,0.2222222222222222,1.1111111111111112
2470,Toño,ESP,DF,Levante,La Liga,27,1989,12.0,12,11,11,1,0,5,10,50.0,5,4,0,4,6,18,29,0,0,2017-2018,0.5,1.0
2471,Ömer Toprak,TUR,DF,Dortmund,Bundesliga,28,1989,22.4,36,25,29,6,1,26,29,89.7,3,27,16,11,21,57,104,1,0,2017-2018,0.9375000000000001,1.6071428571428572
2472,Vasilis Torosidis,GRE,DF,Bologna,Serie A,32,1985,9.1,8,7,5,2,1,4,9,44.4,5,8,3,5,15,23,42,0,0,2017-2018,1.6483516483516485,0.8791208791208791
2473,Emanuele Torrasi,ITA,MF,Milan,Serie A,18,1999,0.1,0,0,0,0,0,,0,0.0,0,0,0,0,0,0,0,0,0,2017-2018,0.0,0.0
2474,Emanuele Torrasi,ITA,MF,Milan,Serie A,18,1999,0.1,0,0,0,0,0,0,0,0.0,0,0,0,0,0,0,0,0,0,2017-2018,0.0,0.0
2475,Lucas Torreira,URU,MF,Sampdoria,Serie A,21,1996,35.3,101,73,36,57,8,30,77,39.0,47,52,17,35,72,173,36,1,0,2017-2018,2.039660056657224,2.861189801699717
2476,Daniel Torres,COL,MF,Alavés,La Liga,27,1989,13.5,19,11,14,5,0,7,31,22.6,24,15,7,8,19,38,32,2,0,2017-2018,1.4074074074074074,1.4074074074074074
2477,Fernando Torres,ESP,FW,Atlético Madrid,La Liga,33,1984,10.9,11,8,3,7,1,2,6,33.3,4,4,1,3,2,13,9,0,0,2017-2018,0.18348623853211007,1.0091743119266054
2478,Ferrán Torres,ESP,MF,Valencia,La Liga,17,2000,3.5,8,7,3,5,0,2,6,33.3,4,1,0,1,3,11,1,0,0,2017-2018,0.8571428571428571,2.2857142857142856
2479,Miguel Torres,ESP,DF,Málaga,La Liga,31,1986,7.5,16,13,13,3,0,6,14,42.9,8,9,7,2,13,29,35,0,0,2017-2018,1.7333333333333334,2.1333333333333333
2480,Pau Torres,ESP,DF,Villarreal,La Liga,20,1997,0.6,0,0,0,0,0,0,1,0.0,1,1,1,0,0,0,4,0,0,2017-2018,0.0,0.0
2481,Jordan Torunarigha,GER,DF,Hertha BSC,Bundesliga,19,1997,7.4,18,12,16,2,0,7,13,53.8,6,20,13,7,23,41,43,1,0,2017-2018,3.108108108108108,2.4324324324324325
2482,Alin Toșca,ROU,DF,Benevento,Serie A,25,1992,13.0,11,8,7,4,0,6,12,50.0,6,9,4,5,13,24,69,0,0,2017-2018,1.0,0.8461538461538461
2483,Alin Toșca,ROU,DF,Betis,La Liga,25,1992,4.7,12,9,7,5,0,5,9,55.6,4,7,1,6,5,17,17,1,0,2017-2018,1.0638297872340425,2.553191489361702
2484,Cenk Tosun,TUR,FW,Everton,Premier League,26,1991,11.0,6,3,2,2,2,1,11,9.1,10,9,4,5,1,7,13,0,0,2017-2018,0.09090909090909091,0.5454545454545454
2485,Jérémy Toulalan,FRA,DF,Bordeaux,Ligue 1,33,1983,21.0,43,25,35,7,1,17,39,43.6,22,25,16,9,28,71,121,0,0,2017-2018,1.3333333333333333,2.0476190476190474
2486,Abdoulaye Touré,GUI,MF,Nantes,Ligue 1,23,1994,31.2,74,52,28,38,8,23,67,34.3,44,40,10,30,62,136,49,1,0,2017-2018,1.9871794871794872,2.371794871794872
2487,Almamy Touré,MLI,DF,Monaco,Ligue 1,21,1996,13.9,51,29,31,13,7,18,30,60.0,12,15,2,13,22,73,61,0,0,2017-2018,1.5827338129496402,3.6690647482014387
2488,Thomas Touré,CIV,FW,Bordeaux,Ligue 1,23,1993,0.1,0,0,0,0,0,0,0,0.0,0,0,0,0,1,1,0,0,0,2017-2018,10.0,0.0
2489,Thomas Touré,CIV,MF,Angers,Ligue 1,23,1993,1.4,2,1,0,1,1,0,7,0.0,7,5,0,5,1,3,0,0,0,2017-2018,0.7142857142857143,1.4285714285714286
2490,Yaya Touré,CIV,MF,Manchester City,Premier League,34,1983,2.6,2,2,1,0,1,1,1,100.0,0,3,1,2,5,7,4,0,0,2017-2018,1.923076923076923,0.7692307692307692
2491,Lucas Tousart,FRA,MF,Lyon,Ligue 1,20,1997,34.8,98,59,41,55,2,38,98,38.8,60,41,16,25,52,150,79,0,0,2017-2018,1.4942528735632186,2.8160919540229887
2492,Andros Townsend,ENG,"FW,MF",Crystal Palace,Premier League,26,1991,34.7,60,34,35,12,13,24,75,32.0,51,49,1,48,35,95,28,0,0,2017-2018,1.0086455331412103,1.7291066282420748
2493,Adama Traoré,MLI,"MF,FW",Monaco,Ligue 1,22,1995,2.1,6,4,0,4,2,1,4,25.0,3,3,0,3,3,9,1,0,0,2017-2018,1.4285714285714286,2.857142857142857
2494,Bertrand Traoré,BFA,FW,Lyon,Ligue 1,21,1995,25.4,32,20,7,20,5,10,35,28.6,25,24,3,21,39,71,31,1,0,2017-2018,1.535433070866142,1.2598425196850394
2495,Charles Traore,MLI,DF,Troyes,Ligue 1,25,1992,33.3,60,32,46,9,5,26,56,46.4,30,52,16,36,57,117,171,0,0,2017-2018,1.7117117117117118,1.801801801801802
2496,Hamari Traoré,MLI,DF,Rennes,Ligue 1,25,1992,29.3,79,55,43,31,5,41,66,62.1,25,31,12,19,61,140,117,0,0,2017-2018,2.0819112627986347,2.696245733788396
2497,Ibrahima Traoré,GUI,MF,Gladbach,Bundesliga,29,1988,2.2,4,2,2,2,0,4,7,57.1,3,2,0,2,0,4,1,0,0,2017-2018,0.0,1.8181818181818181
2498,Ismaël Traoré,CIV,DF,Angers,Ligue 1,30,1986,31.7,54,32,40,13,1,14,29,48.3,15,25,10,15,52,106,132,2,0,2017-2018,1.640378548895899,1.7034700315457414
2499,Lacina Traoré,CIV,FW,Amiens,Ligue 1,27,1990,8.7,9,9,2,3,4,3,7,42.9,4,6,3,3,2,11,21,0,0,2017-2018,0.2298850574712644,1.0344827586206897
2500,Kevin Trapp,GER,GK,Paris S-G,Ligue 1,27,1990,4.0,0,0,0,0,0,0,0,0.0,0,0,0,0,0,0,1,0,0,2017-2018,0.0,0.0
2501,Manu Trigueros,ESP,MF,Villarreal,La Liga,25,1991,30.0,61,41,23,34,4,21,71,29.6,50,38,13,25,22,83,44,0,0,2017-2018,0.7333333333333333,2.033333333333333
2502,Kieran Trippier,ENG,DF,Tottenham,Premier League,26,1990,21.3,52,30,29,21,2,21,44,47.7,23,31,6,25,20,72,53,1,0,2017-2018,0.9389671361502347,2.44131455399061
2503,Marcello Trotta,ITA,FW,Crotone,Serie A,24,1992,25.1,39,21,12,18,9,10,55,18.2,45,22,2,20,14,53,20,0,0,2017-2018,0.5577689243027888,1.5537848605577689
2504,Philipp Tschauner,GER,GK,Hannover 96,Bundesliga,31,1985,31.0,1,0,1,0,0,1,2,50.0,1,2,0,2,0,1,8,5,0,2017-2018,0.0,0.03225806451612903
2505,Axel Tuanzebe,COD,FW,Manchester Utd,Premier League,19,1997,0.0,0,0,0,0,0,0,0,0.0,0,0,0,0,0,0,0,0,0,2017-2018,,
2506,Marco Tumminello,ITA,FW,Crotone,Serie A,18,1998,2.3,2,2,0,1,1,0,2,0.0,2,2,0,2,0,2,0,0,0,2017-2018,0.0,0.8695652173913044
2507,Marco Tumminello,ITA,FW,Roma,Serie A,18,1998,0.0,0,0,0,0,0,0,0,0.0,0,0,0,0,0,0,0,0,0,2017-2018,,
2508,Ľubomír Tupta,SVK,"MF,FW",Hellas Verona,Serie A,19,1998,0.4,0,0,0,0,0,0,3,0.0,3,0,0,0,0,0,0,0,0,2017-2018,0.0,0.0
2509,Josh Tymon,ENG,DF,Stoke City,Premier League,18,1999,1.8,5,1,4,1,0,2,3,66.7,1,1,0,1,1,6,3,0,0,2017-2018,0.5555555555555556,2.7777777777777777
2510,Przemysław Tytoń,POL,GK,La Coruña,La Liga,30,1987,1.1,0,0,0,0,0,0,0,0.0,0,0,0,0,0,0,0,0,0,2017-2018,0.0,0.0
2511,Matthieu Udol,FRA,DF,Metz,Ligue 1,21,1996,3.9,14,8,13,1,0,5,14,35.7,9,10,2,8,5,19,17,0,0,2017-2018,1.2820512820512822,3.58974358974359
2512,Anthony Ujah,NGA,FW,Mainz 05,Bundesliga,26,1990,2.3,4,3,0,2,2,1,1,100.0,0,2,0,2,0,4,6,0,0,2017-2018,0.0,1.7391304347826089
2513,Leonardo Ulloa,ARG,FW,Leicester City,Premier League,31,1986,0.2,1,0,0,0,1,0,0,0.0,0,0,0,0,0,1,1,0,0,2017-2018,0.0,5.0
2514,Leonardo Ulloa,ARG,FW,Brighton,Premier League,31,1986,3.0,3,1,0,1,2,1,7,14.3,6,1,0,1,0,3,3,0,0,2017-2018,0.0,1.0
2515,Sven Ulreich,GER,GK,Bayern Munich,Bundesliga,28,1988,29.0,1,0,1,0,0,1,1,100.0,0,0,0,0,3,4,6,1,0,2017-2018,0.10344827586206896,0.034482758620689655
2516,Samuel Umtiti,FRA,DF,Barcelona,La Liga,23,1993,24.3,50,35,35,15,0,20,29,69.0,9,25,17,8,37,87,72,3,0,2017-2018,1.522633744855967,2.05761316872428
2517,Enes Ünal,TUR,FW,Villarreal,La Liga,20,1997,12.5,9,5,0,4,5,0,12,0.0,12,16,3,13,4,13,11,0,0,2017-2018,0.32,0.72
2518,Enes Ünal,TUR,FW,Levante,La Liga,20,1997,6.6,6,6,2,2,2,1,10,10.0,9,7,1,6,2,8,5,0,0,2017-2018,0.30303030303030304,0.9090909090909092
2519,Cengiz Ünder,TUR,FW,Roma,Serie A,20,1997,13.9,10,6,4,6,0,3,18,16.7,15,8,1,7,9,19,10,0,0,2017-2018,0.6474820143884892,0.7194244604316546
2520,Dayot Upamecano,FRA,DF,RB Leipzig,Bundesliga,18,1998,25.2,57,43,36,17,4,31,45,68.9,14,32,9,23,55,112,141,1,0,2017-2018,2.182539682539683,2.261904761904762
2521,Mark Uth,GER,FW,Hoffenheim,Bundesliga,25,1991,24.2,32,23,4,21,7,5,22,22.7,17,30,3,27,9,41,19,0,0,2017-2018,0.37190082644628103,1.322314049586777
2522,Francis Uzoho,NGA,GK,La Coruña,La Liga,18,1998,2.0,0,0,0,0,0,0,0,0.0,0,0,0,0,0,0,1,0,0,2017-2018,0.0,0.0
2523,Valentín Vada,ARG,MF,Bordeaux,Ligue 1,21,1996,9.6,22,11,7,14,1,8,32,25.0,24,8,1,7,6,28,5,1,0,2017-2018,0.625,2.291666666666667
2524,Josha Vagnoman,GER,MF,Hamburger SV,Bundesliga,16,2000,0.2,1,1,0,1,0,1,1,100.0,0,0,0,0,0,1,0,0,0,2017-2018,0.0,5.0
2525,Sauli Väisänen,FIN,DF,SPAL,Serie A,23,1994,6.0,12,9,9,3,0,6,8,75.0,2,5,4,1,13,25,26,0,0,2017-2018,2.1666666666666665,2.0
2526,Mirko Valdifiori,ITA,MF,Torino,Serie A,31,1986,6.9,13,9,5,7,1,2,11,18.2,9,3,1,2,6,19,9,0,0,2017-2018,0.8695652173913043,1.8840579710144927
2527,Antonio Valencia,ECU,DF,Manchester Utd,Premier League,31,1985,30.4,57,32,21,28,8,16,36,44.4,20,47,6,41,48,105,80,0,0,2017-2018,1.5789473684210527,1.875
2528,Gerard Valentín,ESP,"DF,FW",La Coruña,La Liga,24,1993,1.8,5,4,4,0,1,1,2,50.0,1,1,0,1,3,8,3,0,0,2017-2018,1.6666666666666665,2.7777777777777777
2529,Borja Valero,ESP,MF,Inter,Serie A,32,1985,28.5,46,31,17,25,4,20,58,34.5,38,15,4,11,18,64,41,1,0,2017-2018,0.631578947368421,1.6140350877192982
2530,Borja Valle,ESP,"FW,MF",La Coruña,La Liga,25,1992,5.4,6,6,3,3,0,1,4,25.0,3,2,0,2,3,9,4,0,0,2017-2018,0.5555555555555555,1.111111111111111
2531,Jesús Vallejo,ESP,DF,Real Madrid,La Liga,20,1997,7.0,8,7,6,2,0,2,5,40.0,3,6,5,1,16,24,21,1,0,2017-2018,2.2857142857142856,1.1428571428571428
2532,Mattia Valoti,ITA,"MF,FW",Hellas Verona,Serie A,23,1993,17.5,62,41,21,35,6,11,53,20.8,42,25,3,22,41,103,37,1,0,2017-2018,2.342857142857143,3.5428571428571427
2533,Federico Valverde,URU,"MF,FW",La Coruña,La Liga,19,1998,13.7,25,16,12,10,3,8,15,53.3,7,12,1,11,21,46,17,0,0,2017-2018,1.5328467153284673,1.8248175182481752
2534,Virgil van Dijk,NED,DF,Southampton,Premier League,26,1991,11.0,10,7,6,2,2,2,3,66.7,1,14,13,1,29,39,81,1,0,2017-2018,2.6363636363636362,0.9090909090909091
2535,Virgil van Dijk,NED,DF,Liverpool,Premier League,26,1991,14.0,15,8,7,7,1,4,5,80.0,1,8,2,6,18,33,80,1,0,2017-2018,1.2857142857142858,1.0714285714285714
2536,Raphaël Varane,FRA,DF,Real Madrid,La Liga,24,1993,25.8,28,19,20,7,1,8,15,53.3,7,27,10,17,33,61,109,2,0,2017-2018,1.2790697674418605,1.0852713178294573
2537,Jamie Vardy,ENG,FW,Leicester City,Premier League,30,1987,36.1,15,9,3,7,5,1,8,12.5,7,21,1,20,2,17,17,0,0,2017-2018,0.055401662049861494,0.4155124653739612
2538,Cédric Varrault,FRA,DF,Dijon,Ligue 1,37,1980,9.8,13,7,6,7,0,9,12,75.0,3,14,11,3,16,29,72,0,0,2017-2018,1.6326530612244896,1.3265306122448979
2539,Franco Vázquez,ARG,MF,Sevilla,La Liga,28,1989,20.4,39,32,16,15,8,6,34,17.6,28,20,2,18,11,50,11,0,0,2017-2018,0.5392156862745099,1.911764705882353
2540,Lucas Vázquez,ESP,"MF,FW",Real Madrid,La Liga,26,1991,18.7,48,33,16,21,11,12,42,28.6,30,28,2,26,7,55,9,0,0,2017-2018,0.37433155080213903,2.5668449197860963
2541,Matías Vecino,URU,MF,Inter,Serie A,25,1991,23.7,54,34,15,30,9,19,49,38.8,30,28,6,22,20,74,31,0,0,2017-2018,0.8438818565400844,2.278481012658228
2542,Koke Vegas,ESP,GK,Levante,La Liga,21,1995,1.0,0,0,0,0,0,0,0,0.0,0,0,0,0,0,0,1,0,0,2017-2018,0.0,0.0
2543,Carlos Vela,MEX,FW,Real Sociedad,La Liga,28,1989,4.2,12,7,5,3,4,6,7,85.7,1,2,0,2,0,12,1,0,0,2017-2018,0.0,2.857142857142857
2544,Miloš Veljković,SRB,DF,Werder Bremen,Bundesliga,21,1995,29.5,45,32,30,13,2,30,52,57.7,22,34,12,22,34,79,134,1,0,2017-2018,1.152542372881356,1.5254237288135593
2545,Miguel Veloso,POR,MF,Genoa,Serie A,31,1986,19.3,40,29,18,19,3,11,41,26.8,30,26,3,23,13,53,35,0,0,2017-2018,0.6735751295336787,2.0725388601036268
2546,Lorenzo Venuti,ITA,DF,Benevento,Serie A,22,1995,26.6,44,34,26,12,6,16,37,43.2,21,40,16,24,40,84,105,3,0,2017-2018,1.5037593984962405,1.6541353383458646
2547,Rémy Vercoutre,FRA,GK,Caen,Ligue 1,37,1980,34.5,2,2,2,0,0,2,2,100.0,0,0,0,0,2,4,14,2,0,2017-2018,0.057971014492753624,0.057971014492753624
2548,Daniele Verde,ITA,"FW,MF",Hellas Verona,Serie A,21,1996,21.7,10,9,8,1,1,6,20,30.0,14,8,0,8,30,40,19,0,0,2017-2018,1.3824884792626728,0.4608294930875576
2549,Simone Verdi,ITA,"FW,MF",Bologna,Serie A,25,1992,31.4,33,24,17,13,3,11,43,25.6,32,20,1,19,36,69,12,0,0,2017-2018,1.1464968152866242,1.0509554140127388
2550,Olivier Verdon,BEN,DF,Bordeaux,Ligue 1,21,1995,0.1,0,0,0,0,0,0,0,0.0,0,0,0,0,0,0,3,0,0,2017-2018,0.0,0.0
2551,Jordan Veretout,FRA,MF,Fiorentina,Serie A,24,1993,35.7,65,45,34,23,8,20,69,29.0,49,39,4,35,37,102,59,0,0,2017-2018,1.0364145658263304,1.8207282913165264
2552,Paul Verhaegh,NED,DF,Wolfsburg,Bundesliga,33,1983,29.0,45,38,21,22,2,24,33,72.7,9,38,10,28,33,78,60,0,0,2017-2018,1.1379310344827587,1.5517241379310345
2553,Thomas Vermaelen,BEL,DF,Barcelona,La Liga,31,1985,11.3,13,9,7,5,1,5,11,45.5,6,10,3,7,18,31,28,0,0,2017-2018,1.5929203539823007,1.1504424778761062
2554,Marco Verratti,ITA,MF,Paris S-G,Ligue 1,24,1992,19.1,51,33,20,25,6,12,55,21.8,43,25,6,19,26,77,11,3,0,2017-2018,1.3612565445026177,2.670157068062827
2555,Valerio Verre,ITA,MF,Sampdoria,Serie A,23,1994,4.0,7,3,3,2,2,2,7,28.6,5,12,0,12,8,15,7,0,0,2017-2018,2.0,1.75
2556,Jan Vertonghen,BEL,DF,Tottenham,Premier League,30,1987,35.6,64,41,40,20,4,25,36,69.4,11,29,11,18,60,124,177,0,0,2017-2018,1.6853932584269662,1.797752808988764
2557,Mikel Vesga,ESP,MF,Athletic Club,La Liga,24,1993,9.0,17,8,6,11,0,4,25,16.0,21,14,3,11,8,25,15,0,0,2017-2018,0.8888888888888888,1.8888888888888888
2558,Jannik Vestergaard,DEN,DF,Gladbach,Bundesliga,24,1992,32.0,58,41,43,15,0,32,48,66.7,16,55,39,16,40,98,161,3,0,2017-2018,1.25,1.8125
2559,Rúben Vezo,POR,DF,Valencia,La Liga,23,1994,17.3,43,24,30,12,1,16,32,50.0,16,25,9,16,23,66,83,0,0,2017-2018,1.329479768786127,2.485549132947977
2560,Francesco Vicari,ITA,DF,SPAL,Serie A,22,1994,31.7,38,22,25,13,0,21,39,53.8,18,33,27,6,45,83,210,1,0,2017-2018,1.4195583596214512,1.1987381703470033
2561,Aleix Vidal,ESP,"MF,FW",Barcelona,La Liga,27,1989,5.1,6,4,2,3,1,1,10,10.0,9,4,0,4,9,15,1,0,0,2017-2018,1.7647058823529413,1.1764705882352942
2562,Arturo Vidal,CHI,MF,Bayern Munich,Bundesliga,30,1987,16.2,69,51,36,28,5,33,69,47.8,36,22,1,21,28,97,20,1,0,2017-2018,1.7283950617283952,4.2592592592592595
2563,Nacho Vidal,ESP,DF,Valencia,La Liga,22,1995,5.0,17,14,15,1,1,14,22,63.6,8,5,2,3,10,27,18,0,0,2017-2018,2.0,3.4
2564,Luca Vido,ITA,"FW,MF",Atalanta,Serie A,20,1997,0.8,5,5,2,3,0,1,1,100.0,0,1,0,1,0,5,0,0,0,2017-2018,0.0,6.25
2565,Jonathan Viera,ESP,MF,Las Palmas,La Liga,27,1989,22.1,36,25,10,22,4,3,28,10.7,25,21,0,21,11,47,2,0,0,2017-2018,0.4977375565610859,1.6289592760180995
2566,Luciano Vietto,ARG,FW,Atlético Madrid,La Liga,23,1993,3.0,5,4,1,2,2,0,3,0.0,3,3,0,3,3,8,3,0,0,2017-2018,1.0,1.6666666666666667
2567,Luciano Vietto,ARG,FW,Valencia,La Liga,23,1993,5.9,8,6,2,3,3,1,4,25.0,3,3,0,3,2,10,5,0,0,2017-2018,0.3389830508474576,1.3559322033898304
2568,Carlos Vigaray,ESP,DF,Alavés,La Liga,22,1994,9.9,27,16,16,9,2,11,16,68.8,5,5,1,4,14,41,13,0,0,2017-2018,1.4141414141414141,2.727272727272727
2569,Dídac Vilà,ESP,"DF,MF",Espanyol,La Liga,28,1989,8.1,29,26,15,9,5,13,18,72.2,5,14,3,11,14,43,27,0,0,2017-2018,1.7283950617283952,3.5802469135802473
2570,Julio Villalba,PAR,DF,Gladbach,Bundesliga,18,1998,0.1,0,0,0,0,0,0,0,0.0,0,0,0,0,0,0,0,0,0,2017-2018,0.0,0.0
2571,Nicolas Viola,ITA,MF,Benevento,Serie A,27,1989,20.6,37,27,20,14,3,15,39,38.5,24,29,8,21,24,61,23,2,0,2017-2018,1.1650485436893203,1.7961165048543688
2572,Mattia Vitale,ITA,"MF,FW",SPAL,Serie A,19,1997,1.1,2,1,2,0,0,0,0,0.0,0,1,0,1,3,5,1,0,0,2017-2018,2.727272727272727,1.8181818181818181
2573,Vitolo,ESP,"FW,MF",Las Palmas,La Liga,27,1989,7.7,15,12,9,5,1,4,17,23.5,13,10,3,7,6,21,9,0,0,2017-2018,0.7792207792207793,1.948051948051948
2574,Vitolo,ESP,"MF,FW",Atlético Madrid,La Liga,27,1989,6.9,9,6,4,3,2,3,15,20.0,12,10,1,9,6,15,5,0,0,2017-2018,0.8695652173913043,1.3043478260869565
2575,Federico Viviani,ITA,MF,SPAL,Serie A,25,1992,27.6,52,36,23,26,3,18,55,32.7,37,39,9,30,58,110,26,2,0,2017-2018,2.101449275362319,1.8840579710144927
2576,Emiliano Viviano,ITA,GK,Sampdoria,Serie A,31,1985,27.0,0,0,0,0,0,0,0,0.0,0,0,0,0,2,2,10,4,0,2017-2018,0.07407407407407407,0.0
2577,Oswaldo Vizcarrondo,VEN,DF,Troyes,Ligue 1,33,1984,19.1,21,15,17,3,1,14,37,37.8,23,18,16,2,20,41,129,2,0,2017-2018,1.0471204188481675,1.0994764397905759
2578,Nikola Vlašić,CRO,"MF,FW",Everton,Premier League,19,1997,6.4,9,5,3,6,0,2,9,22.2,7,14,2,12,9,18,10,0,0,2017-2018,1.40625,1.40625
2579,Kevin Vogt,GER,DF,Hoffenheim,Bundesliga,25,1991,31.0,38,28,30,7,1,23,34,67.6,11,37,23,14,25,63,114,2,0,2017-2018,0.8064516129032258,1.2258064516129032
2580,Sam Vokes,WAL,FW,Burnley,Premier League,27,1989,11.1,3,1,1,2,0,0,3,0.0,3,6,2,4,3,6,15,0,0,2017-2018,0.2702702702702703,0.2702702702702703
2581,Kevin Volland,GER,"FW,MF",Leverkusen,Bundesliga,25,1992,28.8,23,20,7,8,8,11,26,42.3,15,16,1,15,3,26,35,0,0,2017-2018,0.10416666666666666,0.798611111111111
2582,Giovanni Volpicelli,ITA,MF,Benevento,Serie A,17,1999,0.0,0,0,0,0,0,0,1,0.0,1,0,0,0,0,0,0,0,0,2017-2018,,
2583,Michel Vorm,NED,GK,Tottenham,Premier League,33,1983,1.0,0,0,0,0,0,0,0,0.0,0,0,0,0,0,0,1,0,0,2017-2018,0.0,0.0
2584,Stefan de Vrij,NED,DF,Lazio,Serie A,25,1992,33.7,31,22,14,17,0,14,23,60.9,9,43,24,19,71,102,156,1,0,2017-2018,2.1068249258160234,0.9198813056379821
2585,Šime Vrsaljko,CRO,DF,Atlético Madrid,La Liga,25,1992,18.8,48,30,25,17,6,26,40,65.0,14,24,8,16,36,84,63,0,0,2017-2018,1.9148936170212765,2.553191489361702
2586,Jagoš Vuković,SRB,DF,Hellas Verona,Serie A,29,1988,14.8,5,4,3,1,1,3,6,50.0,3,19,14,5,20,25,113,0,0,2017-2018,1.3513513513513513,0.33783783783783783
2587,Sandro Wagner,GER,FW,Hoffenheim,Bundesliga,29,1987,9.7,8,5,3,5,0,5,6,83.3,1,11,3,8,3,11,13,0,0,2017-2018,0.30927835051546393,0.8247422680412372
2588,Sandro Wagner,GER,FW,Bayern Munich,Bundesliga,29,1987,8.1,9,6,3,5,1,1,1,100.0,0,4,0,4,2,11,1,0,0,2017-2018,0.2469135802469136,1.1111111111111112
2589,Molla Wagué,MLI,DF,Watford,Premier League,26,1991,4.9,5,3,3,2,0,2,5,40.0,3,1,0,1,9,14,30,0,0,2017-2018,1.8367346938775508,1.0204081632653061
2590,Molla Wagué,MLI,DF,Udinese,Serie A,26,1991,0.6,1,0,0,1,0,0,0,0.0,0,0,0,0,2,3,5,0,0,2017-2018,3.3333333333333335,1.6666666666666667
2591,Wakaso,GHA,MF,Alavés,La Liga,27,1990,12.2,43,30,25,15,3,13,39,33.3,26,22,1,21,35,78,21,0,0,2017-2018,2.8688524590163937,3.5245901639344264
2592,Walace,BRA,MF,Hamburger SV,Bundesliga,22,1995,14.6,38,25,13,23,2,19,44,43.2,25,25,3,22,21,59,14,1,0,2017-2018,1.4383561643835616,2.6027397260273974
2593,Theo Walcott,ENG,"FW,MF",Arsenal,Premier League,28,1989,0.8,1,0,1,0,0,0,0,0.0,0,0,0,0,1,2,0,0,0,2017-2018,1.25,1.25
2594,Theo Walcott,ENG,FW,Everton,Premier League,28,1989,12.8,27,19,12,13,2,7,15,46.7,8,9,0,9,8,35,12,0,0,2017-2018,0.625,2.109375
2595,Luca Waldschmidt,GER,"MF,FW",Hamburger SV,Bundesliga,21,1996,8.8,10,6,1,8,1,3,10,30.0,7,11,0,11,3,13,2,0,0,2017-2018,0.3409090909090909,1.1363636363636362
2596,Kyle Walker,ENG,DF,Manchester City,Premier League,27,1990,30.9,47,31,20,21,6,18,31,58.1,13,21,2,19,29,76,75,2,0,2017-2018,0.9385113268608415,1.5210355987055018
2597,Kyle Walker-Peters,ENG,DF,Tottenham,Premier League,20,1997,2.1,5,4,4,1,0,2,4,50.0,2,2,0,2,3,8,8,0,0,2017-2018,1.4285714285714286,2.380952380952381
2598,Wallace,BRA,DF,Lazio,Serie A,22,1994,11.1,17,7,11,6,0,4,13,30.8,9,13,5,8,29,46,43,3,0,2017-2018,2.6126126126126126,1.5315315315315317
2599,Anthony Walongwa,,DF,Nantes,Ligue 1,23,1993,1.0,2,1,2,0,0,0,0,0.0,0,0,0,0,1,3,8,0,0,2017-2018,1.0,2.0
2600,Rémi Walter,FRA,"MF,FW",Nice,Ligue 1,22,1995,5.5,11,7,4,6,1,3,7,42.9,4,2,1,1,5,16,3,0,0,2017-2018,0.9090909090909091,2.0
2601,Rémi Walter,FRA,MF,Troyes,Ligue 1,22,1995,11.1,23,10,9,13,1,2,23,8.7,21,7,3,4,11,34,14,0,0,2017-2018,0.990990990990991,2.0720720720720722
2602,Jonathan Walters,IRL,FW,Burnley,Premier League,33,1983,0.4,0,0,0,0,0,0,0,0.0,0,0,0,0,0,0,1,0,0,2017-2018,0.0,0.0
2603,Aaron Wan-Bissaka,ENG,DF,Crystal Palace,Premier League,19,1997,7.0,30,19,20,7,3,15,19,78.9,4,18,7,11,15,45,45,0,0,2017-2018,2.142857142857143,4.285714285714286
2604,Victor Wanyama,KEN,MF,Tottenham,Premier League,26,1991,9.4,30,20,13,16,1,14,31,45.2,17,13,3,10,10,40,20,1,0,2017-2018,1.0638297872340425,3.1914893617021276
2605,Joel Ward,ENG,DF,Crystal Palace,Premier League,27,1989,17.9,35,30,23,12,0,16,28,57.1,12,27,11,16,28,63,76,0,0,2017-2018,1.564245810055866,1.9553072625698324
2606,Stephen Ward,IRL,DF,Burnley,Premier League,31,1985,27.3,39,31,27,8,4,20,42,47.6,22,27,12,15,42,81,126,0,0,2017-2018,1.5384615384615383,1.4285714285714286
2607,James Ward-Prowse,ENG,"FW,MF",Southampton,Premier League,22,1994,19.1,23,16,9,11,3,3,27,11.1,24,29,1,28,8,31,31,0,0,2017-2018,0.41884816753926696,1.2041884816753925
2608,Daniel Wass,DEN,"MF,DF",Celta Vigo,La Liga,28,1989,32.6,30,21,8,18,4,8,25,32.0,17,23,3,20,30,60,47,0,0,2017-2018,0.920245398773006,0.920245398773006
2609,Ben Watson,ENG,MF,Watford,Premier League,32,1985,5.1,19,9,9,9,1,10,31,32.3,21,6,1,5,7,26,10,0,0,2017-2018,1.3725490196078431,3.7254901960784315
2610,Timothy Weah,USA,FW,Paris S-G,Ligue 1,17,2000,1.4,1,1,1,0,0,1,1,100.0,0,0,0,0,0,1,0,0,0,2017-2018,0.0,0.7142857142857143
2611,Roman Weidenfeller,GER,GK,Dortmund,Bundesliga,36,1980,1.0,0,0,0,0,0,0,0,0.0,0,0,0,0,0,0,0,1,0,2017-2018,0.0,0.0
2612,Julian Weigl,GER,MF,Dortmund,Bundesliga,21,1995,21.6,69,49,20,42,7,42,66,63.6,24,26,6,20,34,103,29,2,0,2017-2018,1.574074074074074,3.194444444444444
2613,Mitchell Weiser,GER,"DF,FW",Hertha BSC,Bundesliga,23,1994,22.0,54,43,20,27,7,17,38,44.7,21,28,1,27,44,98,37,1,0,2017-2018,2.0,2.4545454545454546
2614,Danny Welbeck,ENG,"FW,MF",Arsenal,Premier League,26,1990,13.3,20,13,9,5,6,4,12,33.3,8,22,1,21,11,31,13,0,0,2017-2018,0.8270676691729323,1.5037593984962405
2615,Nahki Wells,BER,"FW,MF",Burnley,Premier League,27,1990,0.6,4,3,0,3,1,1,1,100.0,0,2,0,2,0,4,0,0,0,2017-2018,0.0,6.666666666666667
2616,Wendell,BRA,DF,Leverkusen,Bundesliga,24,1993,23.5,54,41,29,20,5,32,58,55.2,26,44,8,36,28,82,58,0,0,2017-2018,1.1914893617021276,2.297872340425532
2617,Oscar Wendt,SWE,DF,Gladbach,Bundesliga,31,1985,27.3,54,40,31,19,4,30,45,66.7,15,46,12,34,27,81,71,0,0,2017-2018,0.9890109890109889,1.9780219780219779
2618,Axel Werner,ARG,GK,Atlético Madrid,La Liga,21,1996,1.0,0,0,0,0,0,0,0,0.0,0,0,0,0,0,0,1,0,0,2017-2018,0.0,0.0
2619,Timo Werner,GER,FW,RB Leipzig,Bundesliga,21,1996,27.7,16,11,2,8,6,3,19,15.8,16,26,0,26,7,23,11,0,0,2017-2018,0.2527075812274368,0.5776173285198556
2620,Ashley Westwood,ENG,MF,Burnley,Premier League,27,1990,12.3,13,10,10,3,0,2,16,12.5,14,17,9,8,19,32,16,0,0,2017-2018,1.5447154471544715,1.056910569105691
2621,Dean Whitehead,ENG,MF,Huddersfield,Premier League,35,1982,0.8,0,0,0,0,0,0,1,0.0,1,1,0,1,2,2,0,0,0,2017-2018,2.5,0.0
2622,Silvan Widmer,SUI,"DF,FW",Udinese,Serie A,24,1993,18.1,45,32,30,15,0,22,40,55.0,18,22,5,17,28,73,59,0,0,2017-2018,1.5469613259668507,2.486187845303867
2623,Georginio Wijnaldum,NED,MF,Liverpool,Premier League,26,1990,26.5,34,23,13,16,5,11,23,47.8,12,20,2,18,25,59,20,0,0,2017-2018,0.9433962264150944,1.2830188679245282
2624,Jetro Willems,NED,"FW,DF",Eint Frankfurt,Bundesliga,23,1994,18.5,55,42,28,23,4,27,42,64.3,15,31,1,30,20,75,53,0,0,2017-2018,1.0810810810810811,2.972972972972973
2625,William,BRA,DF,Wolfsburg,Bundesliga,22,1995,17.9,76,61,43,26,7,46,86,53.5,40,41,6,35,46,122,65,1,0,2017-2018,2.569832402234637,4.245810055865922
2626,Ashley Williams,WAL,DF,Everton,Premier League,32,1984,20.4,23,13,17,6,0,9,18,50.0,9,31,23,8,36,59,173,3,0,2017-2018,1.7647058823529413,1.1274509803921569
2627,Danny Williams,USA,MF,Huddersfield,Premier League,28,1989,12.5,23,14,13,9,1,7,22,31.8,15,12,2,10,26,49,27,0,0,2017-2018,2.08,1.84
2628,Iñaki Williams,GHA,"FW,MF",Athletic Club,La Liga,23,1994,31.7,28,17,11,15,2,8,41,19.5,33,24,2,22,17,45,13,0,0,2017-2018,0.5362776025236593,0.8832807570977919
2629,Willian,BRA,"MF,FW",Chelsea,Premier League,28,1988,21.0,22,17,7,12,3,0,16,0.0,16,13,1,12,10,32,10,0,0,2017-2018,0.47619047619047616,1.0476190476190477
2630,Joe Willock,ENG,MF,Arsenal,Premier League,17,1999,0.9,4,2,4,0,0,1,1,100.0,0,3,0,3,1,5,2,0,0,2017-2018,1.1111111111111112,4.444444444444445
2631,Jack Wilshere,ENG,MF,Arsenal,Premier League,25,1992,13.3,15,10,3,7,5,4,20,20.0,16,10,2,8,8,23,5,0,0,2017-2018,0.6015037593984962,1.1278195488721805
2632,Callum Wilson,ENG,FW,Bournemouth,Premier League,25,1992,22.0,9,5,2,6,1,1,14,7.1,13,15,3,12,3,12,15,0,0,2017-2018,0.13636363636363635,0.4090909090909091
2633,Kevin Wimmer,AUT,DF,Stoke City,Premier League,24,1992,14.7,24,17,17,7,0,9,20,45.0,11,25,12,13,30,54,88,0,0,2017-2018,2.0408163265306123,1.6326530612244898
2634,Harry Winks,ENG,MF,Tottenham,Premier League,21,1996,8.6,15,12,8,5,2,8,16,50.0,8,12,2,10,11,26,10,1,0,2017-2018,1.2790697674418605,1.744186046511628
2635,Marius Wolf,GER,"MF,FW",Eint Frankfurt,Bundesliga,22,1995,26.3,37,28,15,18,4,18,46,39.1,28,45,1,44,27,64,46,0,0,2017-2018,1.026615969581749,1.4068441064638784
2636,Bobby Wood,USA,"FW,MF",Hamburger SV,Bundesliga,24,1992,17.9,13,8,2,4,7,3,9,33.3,6,4,0,4,2,15,13,0,0,2017-2018,0.111731843575419,0.7262569832402235
2637,Chris Wood,NZL,FW,Burnley,Premier League,25,1991,18.0,7,3,2,3,2,3,13,23.1,10,12,4,8,0,7,16,0,0,2017-2018,0.0,0.3888888888888889
2638,Ben Woodburn,WAL,FW,Liverpool,Premier League,17,1999,0.1,0,0,0,0,0,0,0,0.0,0,0,0,0,0,0,0,0,0,2017-2018,0.0,0.0
2639,Xeka,POR,MF,Dijon,Ligue 1,22,1994,15.5,25,14,10,11,4,10,38,26.3,28,13,2,11,16,41,21,0,0,2017-2018,1.032258064516129,1.6129032258064515
2640,Xeka,POR,MF,Lille,Ligue 1,22,1994,0.2,1,0,1,0,0,0,0,0.0,0,1,0,1,1,2,0,0,0,2017-2018,5.0,5.0
2641,Granit Xhaka,SUI,MF,Arsenal,Premier League,24,1992,36.2,78,57,35,40,3,26,69,37.7,43,30,9,21,37,115,68,4,0,2017-2018,1.022099447513812,2.154696132596685
2642,Claudio Yacob,ARG,MF,West Brom,Premier League,30,1987,10.0,36,27,23,13,0,13,27,48.1,14,14,6,8,16,52,25,2,0,2017-2018,1.6,3.6
2643,Steeve Yago,BFA,DF,Toulouse,Ligue 1,24,1992,17.5,49,36,28,17,4,20,37,54.1,17,16,7,9,34,83,64,1,0,2017-2018,1.9428571428571428,2.8
2644,Cédric Yamberé,CTA,DF,Dijon,Ligue 1,26,1990,31.4,58,42,46,12,0,16,34,47.1,18,24,16,8,54,112,138,5,0,2017-2018,1.7197452229299364,1.8471337579617835
2645,Jawad El Yamiq,MAR,DF,Genoa,Serie A,25,1992,4.0,8,5,7,1,0,6,8,75.0,2,11,5,6,5,13,22,1,0,2017-2018,1.25,2.0
2646,Mapou Yanga-Mbiwa,FRA,DF,Lyon,Ligue 1,28,1989,1.4,3,2,3,0,0,1,1,100.0,0,0,0,0,1,4,2,0,0,2017-2018,0.7142857142857143,2.142857142857143
2647,Andriy Yarmolenko,UKR,"FW,MF",Dortmund,Bundesliga,27,1989,11.5,17,12,6,6,5,7,16,43.8,9,4,0,4,7,24,4,0,0,2017-2018,0.6086956521739131,1.4782608695652173
2648,DeAndre Yedlin,USA,DF,Newcastle Utd,Premier League,24,1993,31.6,57,33,39,14,4,26,54,48.1,28,37,7,30,44,101,114,0,0,2017-2018,1.3924050632911391,1.8037974683544302
2649,Yoel,ESP,GK,Eibar,La Liga,28,1988,1.0,0,0,0,0,0,0,0,0.0,0,0,0,0,0,0,2,0,0,2017-2018,0.0,0.0
2650,Maya Yoshida,JPN,DF,Southampton,Premier League,28,1988,22.8,27,20,22,5,0,18,25,72.0,7,32,14,18,41,68,133,2,0,2017-2018,1.7982456140350878,1.1842105263157894
2651,Ashley Young,ENG,DF,Manchester Utd,Premier League,32,1985,27.1,53,32,30,17,6,18,47,38.3,29,24,5,19,57,110,86,1,0,2017-2018,2.103321033210332,1.955719557195572
2652,Zaydou Youssouf,FRA,FW,Bordeaux,Ligue 1,18,1999,1.5,3,1,2,1,0,1,2,50.0,1,1,0,1,1,4,1,0,0,2017-2018,0.6666666666666666,2.0
2653,Pablo Zabaleta,ARG,"DF,MF",West Ham,Premier League,32,1985,36.5,96,67,54,28,14,48,98,49.0,50,72,13,59,61,157,152,0,0,2017-2018,1.6712328767123288,2.6301369863013697
2654,Mattia Zaccagni,ITA,"MF,FW",Hellas Verona,Serie A,22,1995,1.7,7,5,4,0,3,2,3,66.7,1,0,0,0,5,12,0,0,0,2017-2018,2.9411764705882355,4.11764705882353
2655,Dan-Axel Zagadou,FRA,DF,Dortmund,Bundesliga,18,1999,7.3,9,8,5,3,1,6,7,85.7,1,9,0,9,11,20,20,1,0,2017-2018,1.5068493150684932,1.2328767123287672
2656,Wilfried Zaha,CIV,"FW,MF",Crystal Palace,Premier League,24,1992,28.3,30,23,9,13,8,4,23,17.4,19,24,0,24,7,37,4,0,0,2017-2018,0.24734982332155475,1.0600706713780919
2657,Denis Zakaria,SUI,MF,Gladbach,Bundesliga,20,1996,25.5,74,48,38,32,4,40,61,65.6,21,52,9,43,45,119,40,1,0,2017-2018,1.7647058823529411,2.9019607843137254
2658,Joseba Zaldúa,ESP,DF,Leganés,La Liga,25,1992,28.4,68,52,31,31,6,39,62,62.9,23,28,5,23,61,129,85,0,0,2017-2018,2.147887323943662,2.3943661971830985
2659,Andre-Frank Zambo Anguissa,CMR,MF,Marseille,Ligue 1,21,1995,27.1,88,65,23,57,8,32,94,34.0,62,50,7,43,67,155,46,3,0,2017-2018,2.4723247232472323,3.2472324723247232
2660,Francesco Zampano,ITA,DF,Udinese,Serie A,23,1993,4.6,9,7,5,3,1,5,10,50.0,5,4,0,4,6,15,7,0,0,2017-2018,1.3043478260869565,1.956521739130435
2661,Niccolò Zanellato,ITA,MF,Crotone,Serie A,19,1998,0.8,3,2,0,3,0,1,2,50.0,1,3,0,3,0,3,0,0,0,2017-2018,0.0,3.75
2662,Cristián Zapata,COL,DF,Milan,Serie A,30,1986,11.0,25,20,21,4,0,15,16,93.8,1,12,6,6,15,40,50,1,0,2017-2018,1.3636363636363635,2.272727272727273
2663,Duván Zapata,COL,FW,Sampdoria,Serie A,26,1991,23.4,12,7,1,7,4,1,6,16.7,5,13,0,13,5,17,22,1,0,2017-2018,0.2136752136752137,0.5128205128205129
2664,Davide Zappacosta,ITA,"DF,MF",Chelsea,Premier League,25,1992,12.2,26,11,14,9,3,11,25,44.0,14,11,2,9,6,32,26,0,0,2017-2018,0.49180327868852464,2.1311475409836067
2665,Davide Zappacosta,ITA,"DF,FW",Torino,Serie A,25,1992,1.1,1,0,1,0,0,0,0,0.0,0,0,0,0,2,3,1,0,0,2017-2018,1.8181818181818181,0.9090909090909091
2666,Simone Zaza,ITA,FW,Valencia,La Liga,26,1991,23.1,21,14,4,10,7,1,20,5.0,19,26,1,25,8,29,34,0,0,2017-2018,0.3463203463203463,0.9090909090909091
2667,Marvin Zeegelaar,NED,DF,Watford,Premier League,26,1990,11.0,23,18,15,3,5,11,24,45.8,13,5,1,4,20,43,30,0,0,2017-2018,1.8181818181818181,2.090909090909091
2668,Mehdi Zeffane,ALG,"DF,MF",Rennes,Ligue 1,25,1992,11.0,17,12,10,5,2,9,25,36.0,16,10,2,8,12,29,44,0,0,2017-2018,1.0909090909090908,1.5454545454545454
2669,Rafik Zekhnini,NOR,FW,Fiorentina,Serie A,19,1998,0.1,0,0,0,0,0,0,0,0.0,0,0,0,0,0,0,0,0,0,2017-2018,0.0,0.0
2670,Erwin Zelazny,FRA,GK,Troyes,Ligue 1,25,1991,17.0,1,1,1,0,0,1,2,50.0,1,0,0,0,2,3,10,1,0,2017-2018,0.11764705882352941,0.058823529411764705
2671,Robin Zentner,GER,GK,Mainz 05,Bundesliga,22,1994,15.0,0,0,0,0,0,0,1,0.0,1,0,0,0,1,1,10,2,0,2017-2018,0.06666666666666667,0.0
2672,Nabil El Zhar,MAR,"FW,MF",Leganés,La Liga,30,1986,22.0,11,6,4,6,1,3,18,16.7,15,14,1,13,18,29,3,0,0,2017-2018,0.8181818181818182,0.5
2673,Enzo Zidane,ESP,MF,Alavés,La Liga,22,1995,0.8,2,2,2,0,0,0,0,0.0,0,0,0,0,0,2,1,0,0,2017-2018,0.0,2.5
2674,Luca Zidane,FRA,GK,Real Madrid,La Liga,19,1998,1.0,0,0,0,0,0,0,1,0.0,1,0,0,0,0,0,0,0,0,2017-2018,0.0,0.0
2675,Ron-Robert Zieler,GER,GK,Stuttgart,Bundesliga,28,1989,34.0,1,1,1,0,0,1,1,100.0,0,2,0,2,1,2,14,5,0,2017-2018,0.029411764705882353,0.029411764705882353
2676,Piotr Zieliński,POL,"MF,FW",Napoli,Serie A,23,1994,18.5,31,19,7,21,3,9,24,37.5,15,32,3,29,13,44,19,1,0,2017-2018,0.7027027027027027,1.6756756756756757
2677,Matthias Zimmermann,GER,DF,Stuttgart,Bundesliga,25,1992,0.9,3,1,2,1,0,3,4,75.0,1,0,0,0,1,4,5,1,0,2017-2018,1.1111111111111112,3.333333333333333
2678,Oleksandr Zinchenko,UKR,DF,Manchester City,Premier League,20,1996,5.9,23,16,11,9,3,7,13,53.8,6,3,0,3,6,29,7,0,0,2017-2018,1.0169491525423728,3.8983050847457625
2679,Kévin Zohi,MLI,MF,Strasbourg,Ligue 1,20,1996,0.0,0,0,0,0,0,0,0,0.0,0,0,0,0,0,0,0,0,0,2017-2018,,
2680,Simon Zoller,GER,"MF,FW",Köln,Bundesliga,26,1991,10.7,11,7,3,6,2,7,10,70.0,3,5,2,3,8,19,9,0,0,2017-2018,0.7476635514018692,1.0280373831775702
2681,Kurt Zouma,FRA,DF,Stoke City,Premier League,22,1994,32.1,50,38,35,13,2,21,28,75.0,7,42,23,19,61,111,246,2,0,2017-2018,1.9003115264797508,1.557632398753894
2682,Igor Zubeldia,ESP,MF,Real Sociedad,La Liga,20,1997,17.6,39,29,17,16,6,14,42,33.3,28,20,5,15,32,71,31,0,0,2017-2018,1.8181818181818181,2.215909090909091
2683,Steven Zuber,SUI,"FW,DF",Hoffenheim,Bundesliga,25,1991,15.9,40,30,22,13,5,26,41,63.4,15,18,3,15,17,57,27,0,0,2017-2018,1.069182389937107,2.5157232704402515
2684,Bruno Zuculini,ARG,MF,Hellas Verona,Serie A,24,1993,13.5,68,49,37,28,3,20,48,41.7,28,35,8,27,38,106,31,0,0,2017-2018,2.814814814814815,5.037037037037037
2685,Franco Zuculini,ARG,"MF,FW",Hellas Verona,Serie A,26,1990,3.7,11,8,5,5,1,5,14,35.7,9,4,0,4,5,16,6,1,0,2017-2018,1.3513513513513513,2.972972972972973
2686,Ervin Zukanović,BIH,DF,Genoa,Serie A,30,1987,31.9,50,41,33,16,1,20,51,39.2,31,32,19,13,48,98,175,0,0,2017-2018,1.5047021943573669,1.567398119122257
2687,Robert Žulj,AUT,"MF,FW",Hoffenheim,Bundesliga,25,1992,2.3,3,3,1,2,0,1,1,100.0,0,3,0,3,0,3,2,0,0,2017-2018,0.0,1.3043478260869565
2688,Bongani Zungu,RSA,MF,Amiens,Ligue 1,24,1992,23.2,54,37,21,26,7,24,56,42.9,32,30,5,25,38,92,41,2,0,2017-2018,1.6379310344827587,2.3275862068965516
2689,David Zurutuza,ESP,MF,Real Sociedad,La Liga,31,1986,24.9,49,36,22,25,2,20,49,40.8,29,32,10,22,41,90,24,1,0,2017-2018,1.6465863453815262,1.9678714859437751
2690,Filip Đuričić,SRB,"MF,FW",Benevento,Serie A,25,1992,10.8,22,14,11,8,3,5,9,55.6,4,7,1,6,9,31,5,0,0,2017-2018,0.8333333333333333,2.0370370370370368
2691,Filip Đuričić,SRB,MF,Sampdoria,Serie A,25,1992,0.1,0,0,0,0,0,0,1,0.0,1,0,0,0,0,0,0,0,0,2017-2018,0.0,0.0
2692,Christian Rutjens,,,Benevento,Serie A,0,0,0.0,0,0,0,0,0,,0,0.0,0,0,0,0,0,0,0,0,0,2017-2018,,
1,Ismael Aaneba,FRA,DF,Strasbourg,Ligue 1,19,1999,2.3,12,6,7,5,0,5,10,50.0,5,5,0,5,8,20,9,0,0,2018-2019,3.4782608695652177,5.217391304347826
2,Patrick van Aanholt,NED,DF,Crystal Palace,Premier League,27,1990,35.5,48,24,35,11,2,24,40,60.0,16,33,9,24,40,88,91,2,0,2018-2019,1.1267605633802817,1.352112676056338
3,Ignazio Abate,ITA,DF,Milan,Serie A,31,1986,14.5,34,19,16,13,5,14,22,63.6,8,19,6,13,18,52,50,0,0,2018-2019,1.2413793103448276,2.3448275862068964
4,Yunis Abdelhamid,MAR,DF,Reims,Ligue 1,30,1987,38.0,60,33,48,11,1,30,40,75.0,10,44,24,20,65,125,196,0,0,2018-2019,1.7105263157894737,1.5789473684210527
5,Mehdi Abeid,ALG,MF,Dijon,Ligue 1,25,1992,22.5,51,33,27,16,8,15,45,33.3,30,33,7,26,29,80,23,1,0,2018-2019,1.288888888888889,2.2666666666666666
6,Charles Abi,FRA,"DF,FW",Saint-Étienne,Ligue 1,18,2000,0.4,4,4,2,1,1,2,2,100.0,0,1,0,1,0,4,1,0,0,2018-2019,0.0,10.0
7,David Abraham,ARG,DF,Eint Frankfurt,Bundesliga,32,1986,15.8,22,14,13,8,1,11,25,44.0,14,23,12,11,24,46,64,0,0,2018-2019,1.5189873417721518,1.3924050632911391
8,Amir Abrashi,ALB,MF,Freiburg,Bundesliga,28,1990,8.8,20,11,7,10,3,6,19,31.6,13,11,3,8,14,34,15,0,0,2018-2019,1.5909090909090908,2.2727272727272725
9,Francesco Acerbi,ITA,DF,Lazio,Serie A,30,1988,36.8,40,30,22,13,5,12,16,75.0,4,50,32,18,61,101,169,1,0,2018-2019,1.657608695652174,1.0869565217391306
10,Afriyie Acquah,GHA,MF,Empoli,Serie A,26,1992,16.8,27,9,9,12,6,4,11,36.4,7,11,1,10,12,39,16,0,0,2018-2019,0.7142857142857143,1.607142857142857
11,Tyler Adams,USA,MF,RB Leipzig,Bundesliga,19,1999,8.0,29,17,12,16,1,11,26,42.3,15,17,1,16,16,45,8,0,0,2018-2019,2.0,3.625
12,Antonio Adán,ESP,GK,Atlético Madrid,La Liga,31,1987,1.0,0,0,0,0,0,0,0,0.0,0,0,0,0,0,0,0,0,0,2018-2019,0.0,0.0
13,Aday,ESP,"DF,MF",Girona,La Liga,30,1987,7.2,9,8,2,5,2,6,7,85.7,1,1,0,1,7,16,17,1,0,2018-2019,0.9722222222222222,1.25
14,Khaled Adénon,BEN,DF,Amiens,Ligue 1,33,1985,22.2,31,22,20,11,0,16,28,57.1,12,26,11,15,31,62,101,0,0,2018-2019,1.3963963963963963,1.3963963963963963
15,Claud Adjapong,ITA,"MF,FW",Sassuolo,Serie A,20,1998,3.0,4,2,1,3,0,1,2,50.0,1,3,1,2,1,5,4,0,0,2018-2019,0.3333333333333333,1.3333333333333333
16,Yacine Adli,FRA,MF,Bordeaux,Ligue 1,18,2000,2.4,7,2,2,3,2,3,9,33.3,6,3,0,3,2,9,0,0,0,2018-2019,0.8333333333333334,2.916666666666667
17,Ali Adnan Kadhim,IRQ,DF,Atalanta,Serie A,24,1993,1.8,1,1,1,0,0,1,2,50.0,1,1,1,0,3,4,6,0,0,2018-2019,1.6666666666666665,0.5555555555555556
18,Aritz Aduriz,ESP,FW,Athletic Club,La Liga,37,1981,10.5,4,2,1,1,2,1,7,14.3,6,2,1,1,0,4,4,0,0,2018-2019,0.0,0.38095238095238093
19,Luis Advíncula,PER,DF,Rayo Vallecano,La Liga,28,1990,26.5,52,38,38,12,2,21,31,67.7,10,22,2,20,19,71,60,1,0,2018-2019,0.7169811320754716,1.9622641509433962
20,Martin Agirregabiria,ESP,DF,Alavés,La Liga,22,1996,22.6,45,29,32,10,3,28,46,60.9,18,33,11,22,27,72,65,1,0,2018-2019,1.1946902654867255,1.9911504424778759
21,Nayef Aguerd,MAR,DF,Dijon,Ligue 1,22,1996,11.7,17,12,8,9,0,8,19,42.1,11,20,11,9,14,31,59,1,0,2018-2019,1.1965811965811965,1.4529914529914532
22,Sergio Agüero,ARG,FW,Manchester City,Premier League,30,1988,27.3,17,9,1,10,6,5,9,55.6,4,15,1,14,9,26,3,0,0,2018-2019,0.32967032967032966,0.6227106227106227
23,Ruben Aguilar,FRA,DF,Montpellier,Ligue 1,25,1993,28.1,88,51,40,33,15,39,69,56.5,30,23,3,20,37,125,50,1,0,2018-2019,1.3167259786476868,3.1316725978647684
24,Juan Aguilera,ESP,MF,Huesca,La Liga,32,1985,3.8,2,2,0,1,1,1,4,25.0,3,4,2,2,4,6,2,0,0,2018-2019,1.0526315789473684,0.5263157894736842
25,Emmanuel Agyemang-Badu,GHA,MF,Udinese,Serie A,27,1990,1.8,4,0,1,2,1,1,1,100.0,0,2,0,2,1,5,2,0,0,2018-2019,0.5555555555555556,2.2222222222222223
Rk,Player,Nation,Pos,Squad,Comp,0,0,90.0,0,0,3,3,3,Tkl,0,0.0,0,0,0,0,0,0,0,0,0,2018-2019,0.0,0.0
26,Jean-Eudes Aholou,CIV,MF,Monaco,Ligue 1,24,1994,11.9,20,11,6,11,3,8,16,50.0,8,7,0,7,17,37,12,0,0,2018-2019,1.4285714285714286,1.680672268907563
27,Antonis Aidonis,GER,DF,Stuttgart,Bundesliga,17,2001,0.9,3,1,1,1,1,1,4,25.0,3,1,0,1,2,5,2,0,0,2018-2019,2.2222222222222223,3.333333333333333
28,Ola Aina,NGA,DF,Torino,Serie A,21,1996,24.0,54,36,32,20,2,23,48,47.9,25,30,3,27,39,93,59,2,0,2018-2019,1.625,2.25
29,Youssef Aït Bennasser,MAR,MF,Saint-Étienne,Ligue 1,22,1996,10.4,25,13,9,12,4,13,28,46.4,15,15,2,13,19,44,6,2,0,2018-2019,1.8269230769230769,2.4038461538461537
30,Youssef Aït Bennasser,MAR,MF,Monaco,Ligue 1,22,1996,11.9,33,16,14,18,1,13,29,44.8,16,15,5,10,15,48,19,0,0,2018-2019,1.2605042016806722,2.773109243697479
31,Rayan Aït-Nouri,ALG,"DF,MF",Angers,Ligue 1,17,2001,0.6,2,2,1,1,0,0,1,0.0,1,0,0,0,0,2,1,0,0,2018-2019,0.0,3.3333333333333335
32,Ludovic Ajorque,FRA,FW,Strasbourg,Ligue 1,24,1994,17.0,17,13,1,10,6,4,9,44.4,5,5,0,5,5,22,9,0,0,2018-2019,0.29411764705882354,1.0
33,Manuel Akanji,SUI,DF,Dortmund,Bundesliga,23,1995,24.5,29,19,14,13,2,14,25,56.0,11,22,13,9,27,56,92,2,0,2018-2019,1.1020408163265305,1.183673469387755
34,Carlos Akapo,EQG,DF,Huesca,La Liga,25,1993,11.4,28,15,18,8,2,19,33,57.6,14,12,2,10,23,51,36,0,0,2018-2019,2.017543859649123,2.456140350877193
35,Nathan Aké,NED,DF,Bournemouth,Premier League,23,1995,37.9,66,35,42,21,3,22,35,62.9,13,51,35,16,32,98,241,0,0,2018-2019,0.8443271767810027,1.741424802110818
36,Sergio Akieme,ESP,DF,Rayo Vallecano,La Liga,20,1997,2.0,3,3,3,0,0,2,2,100.0,0,0,0,0,1,4,5,0,0,2018-2019,0.5,1.5
37,Chadrac Akolo,COD,"MF,FW",Stuttgart,Bundesliga,23,1995,5.8,9,6,2,7,0,1,3,33.3,2,7,0,7,4,13,1,0,0,2018-2019,0.6896551724137931,1.5517241379310345
38,Kevin Akpoguma,NGA,DF,Hoffenheim,Bundesliga,23,1995,5.5,23,15,13,10,0,11,21,52.4,10,18,5,13,12,35,20,2,0,2018-2019,2.1818181818181817,4.181818181818182
39,Kevin Akpoguma,NGA,DF,Hannover 96,Bundesliga,23,1995,3.5,10,6,5,5,0,6,7,85.7,1,7,2,5,10,20,7,2,0,2018-2019,2.857142857142857,2.857142857142857
40,David Alaba,AUT,DF,Bayern Munich,Bundesliga,26,1992,28.1,34,21,13,13,8,17,26,65.4,9,24,3,21,31,65,40,0,0,2018-2019,1.103202846975089,1.2099644128113878
41,Sofiane Alakouch,MAR,DF,Nîmes,Ligue 1,20,1998,21.1,81,44,44,31,6,36,63,57.1,27,15,4,11,46,127,57,0,0,2018-2019,2.1800947867298577,3.838862559241706
42,Lucas Alario,ARG,"FW,MF",Leverkusen,Bundesliga,25,1992,14.1,15,8,5,6,4,4,14,28.6,10,9,0,9,1,16,16,0,0,2018-2019,0.07092198581560284,1.0638297872340425
43,Jordi Alba,ESP,DF,Barcelona,La Liga,29,1989,33.2,42,22,20,15,7,20,48,41.7,28,24,6,18,60,102,76,1,0,2018-2019,1.8072289156626504,1.2650602409638554
44,Luis Alberto,ESP,"MF,FW",Lazio,Serie A,25,1992,22.1,53,22,15,29,9,21,55,38.2,34,23,3,20,10,63,10,0,0,2018-2019,0.4524886877828054,2.3981900452488687
45,Raúl Albiol,ESP,DF,Napoli,Serie A,32,1985,19.0,16,8,12,4,0,8,15,53.3,7,19,16,3,20,36,90,1,0,2018-2019,1.0526315789473684,0.8421052631578947
46,Miiko Albornoz,CHI,"DF,MF",Hannover 96,Bundesliga,27,1990,18.4,46,26,31,10,5,21,45,46.7,24,23,3,20,16,62,37,1,0,2018-2019,0.8695652173913044,2.5
47,Marc Albrighton,ENG,"FW,MF",Leicester City,Premier League,28,1989,18.1,35,22,18,14,3,13,31,41.9,18,26,3,23,23,58,30,0,0,2018-2019,1.2707182320441988,1.9337016574585635
48,Paco Alcácer,ESP,FW,Dortmund,Bundesliga,24,1993,13.5,3,1,2,0,1,0,6,0.0,6,5,0,5,6,9,7,0,0,2018-2019,0.4444444444444444,0.2222222222222222
49,Pedro Alcalá,ESP,DF,Girona,La Liga,29,1989,20.8,32,23,23,9,0,15,23,65.2,8,21,18,3,36,68,120,0,0,2018-2019,1.7307692307692306,1.5384615384615383
50,Thiago Alcántara,ESP,MF,Bayern Munich,Bundesliga,27,1991,26.8,87,65,31,44,12,25,48,52.1,23,23,4,19,44,131,17,1,0,2018-2019,1.6417910447761193,3.246268656716418
Rk,Player,Nation,Pos,Squad,Comp,0,0,90.0,0,0,3,3,3,Tkl,0,0.0,0,0,0,0,0,0,0,0,0,2018-2019,0.0,0.0
51,Rubén Alcaraz,ESP,MF,Valladolid,La Liga,27,1991,33.1,96,54,50,40,6,32,89,36.0,57,59,10,49,38,134,52,1,0,2018-2019,1.148036253776435,2.900302114803625
52,Toby Alderweireld,BEL,DF,Tottenham,Premier League,29,1989,32.5,37,23,25,10,2,12,22,54.5,10,41,22,19,24,61,175,0,0,2018-2019,0.7384615384615385,1.1384615384615384
53,Álex Alegría,ESP,"FW,MF",Rayo Vallecano,La Liga,25,1992,1.6,1,1,0,1,0,0,3,0.0,3,1,0,1,0,1,0,0,0,2018-2019,0.0,0.625
54,Alexis Alegue,FRA,FW,Nantes,Ligue 1,21,1996,0.1,1,0,0,1,0,0,0,0.0,0,0,0,0,0,1,0,0,0,2018-2019,0.0,10.0
55,Iván Alejo,ESP,MF,Getafe,La Liga,23,1995,1.6,2,0,0,2,0,0,4,0.0,4,2,0,2,0,2,3,0,0,2018-2019,0.0,1.25
56,Carles Aleñá,ESP,MF,Barcelona,La Liga,20,1998,7.1,7,4,0,6,1,2,8,25.0,6,4,0,4,2,9,0,0,0,2018-2019,0.28169014084507044,0.9859154929577465
57,Rúnar Alex Rúnarsson,ISL,GK,Dijon,Ligue 1,23,1995,25.0,2,0,2,0,0,2,6,33.3,4,0,0,0,1,3,7,2,0,2018-2019,0.04,0.08
58,Alexander,ARG,FW,Leganés,La Liga,29,1988,0.1,1,0,1,0,0,1,1,100.0,0,0,0,0,0,1,0,0,0,2018-2019,0.0,10.0
59,Trent Alexander-Arnold,ENG,DF,Liverpool,Premier League,19,1998,27.4,61,39,31,22,8,36,68,52.9,32,19,3,16,35,96,68,0,0,2018-2019,1.2773722627737227,2.226277372262774
60,Alfonso,MOZ,MF,Hoffenheim,Bundesliga,18,1999,0.1,1,1,0,1,0,1,2,50.0,1,0,0,0,1,2,0,0,0,2018-2019,10.0,10.0
61,Rachid Alioui,MAR,FW,Nîmes,Ligue 1,26,1992,13.9,15,5,3,9,3,4,9,44.4,5,8,1,7,10,25,11,0,0,2018-2019,0.7194244604316546,1.079136690647482
62,Alisson,BRA,GK,Liverpool,Premier League,25,1992,38.0,2,1,2,0,0,2,2,100.0,0,0,0,0,1,3,14,6,0,2018-2019,0.02631578947368421,0.05263157894736842
63,Bobby Allain,FRA,GK,Dijon,Ligue 1,26,1991,13.0,0,0,0,0,0,0,1,0.0,1,1,0,1,0,0,16,1,0,2018-2019,0.0,0.0
64,Allan,BRA,MF,Napoli,Serie A,27,1991,29.1,106,70,39,55,12,36,107,33.6,71,55,13,42,36,142,28,0,0,2018-2019,1.2371134020618557,3.642611683848797
65,Allan,BRA,MF,Eint Frankfurt,Bundesliga,21,1997,2.0,4,4,2,2,0,0,4,0.0,4,4,2,2,0,4,1,0,0,2018-2019,0.0,2.0
66,Dele Alli,ENG,MF,Tottenham,Premier League,22,1996,20.3,33,19,6,14,13,5,24,20.8,19,33,5,28,19,52,20,0,0,2018-2019,0.9359605911330049,1.625615763546798
67,Miguel Almirón,PAR,MF,Newcastle Utd,Premier League,24,1994,8.4,20,12,7,10,3,4,10,40.0,6,14,1,13,8,28,5,0,0,2018-2019,0.9523809523809523,2.380952380952381
68,Júnior Alonso,PAR,"DF,MF",Celta Vigo,La Liga,25,1993,6.0,13,9,8,4,1,7,12,58.3,5,8,3,5,5,18,24,1,0,2018-2019,0.8333333333333334,2.1666666666666665
69,Marcos Alonso,ESP,DF,Chelsea,Premier League,27,1990,30.7,73,46,44,22,7,33,58,56.9,25,25,2,23,39,112,101,0,0,2018-2019,1.2703583061889252,2.3778501628664497
70,Mickaël Alphonse,GLP,DF,Dijon,Ligue 1,29,1989,6.3,10,5,6,1,3,3,4,75.0,1,3,1,2,9,19,30,0,0,2018-2019,1.4285714285714286,1.5873015873015874
71,Sergio Álvarez,ESP,"DF,MF",Eibar,La Liga,26,1992,11.9,34,25,12,20,2,13,23,56.5,10,9,4,5,17,51,43,0,0,2018-2019,1.4285714285714286,2.857142857142857
72,Sergio Álvarez,ESP,GK,Celta Vigo,La Liga,31,1986,13.0,0,0,0,0,0,0,0,0.0,0,0,0,0,0,0,4,0,0,2018-2019,0.0,0.0
73,Yeray Álvarez,ESP,DF,Athletic Club,La Liga,23,1995,29.0,55,30,39,14,2,19,33,57.6,14,35,16,19,63,118,149,1,0,2018-2019,2.1724137931034484,1.896551724137931
74,Bruno Alves,POR,DF,Parma,Serie A,36,1981,32.5,15,8,11,4,0,4,7,57.1,3,36,28,8,29,44,210,0,0,2018-2019,0.8923076923076924,0.46153846153846156
75,Dani Alves,BRA,"MF,DF",Paris S-G,Ligue 1,35,1983,18.0,42,22,16,23,3,13,38,34.2,25,18,5,13,8,50,11,0,0,2018-2019,0.4444444444444444,2.3333333333333335
Rk,Player,Nation,Pos,Squad,Comp,0,0,90.0,0,0,3,3,3,Tkl,0,0.0,0,0,0,0,0,0,0,0,0,2018-2019,0.0,0.0
76,Ibrahim Amadou,FRA,"MF,DF",Sevilla,La Liga,25,1993,8.5,27,20,9,15,3,2,9,22.2,7,7,4,3,11,38,24,0,0,2018-2019,1.2941176470588236,3.176470588235294
77,Romain Amalfitano,FRA,"MF,FW",Dijon,Ligue 1,28,1989,28.0,52,33,20,28,4,25,67,37.3,42,45,13,32,47,99,35,0,0,2018-2019,1.6785714285714286,1.8571428571428572
78,Daniel Amartey,GHA,DF,Leicester City,Premier League,23,1994,7.1,18,12,11,6,1,10,15,66.7,5,6,4,2,17,35,28,1,0,2018-2019,2.3943661971830985,2.535211267605634
79,Jordi Amat,IDN,DF,Rayo Vallecano,La Liga,26,1992,30.7,54,31,34,19,1,24,42,57.1,18,31,10,21,43,97,133,1,0,2018-2019,1.4006514657980456,1.7589576547231272
80,Amath,SEN,MF,Getafe,La Liga,22,1996,11.1,20,13,7,11,2,6,27,22.2,21,17,0,17,10,30,12,0,0,2018-2019,0.9009009009009009,1.8018018018018018
81,Jordan Amavi,FRA,DF,Marseille,Ligue 1,24,1994,24.2,74,50,34,26,14,35,56,62.5,21,24,8,16,46,120,93,4,0,2018-2019,1.9008264462809918,3.0578512396694215
82,Kelvin Amian,FRA,DF,Toulouse,Ligue 1,20,1998,32.0,68,45,54,12,2,20,30,66.7,10,36,13,23,36,104,113,1,0,2018-2019,1.125,2.125
83,Nadiem Amiri,GER,MF,Hoffenheim,Bundesliga,21,1996,8.4,14,9,8,4,2,3,13,23.1,10,11,0,11,7,21,4,0,0,2018-2019,0.8333333333333333,1.6666666666666665
84,Yanis Ammour,FRA,MF,Montpellier,Ligue 1,19,1999,0.0,0,0,0,0,0,0,0,0.0,0,0,0,0,0,0,0,0,0,2018-2019,,
85,Luke Amos,ENG,MF,Tottenham,Premier League,21,1997,0.0,1,0,0,1,0,0,0,0.0,0,0,0,0,0,1,0,0,0,2018-2019,,inf
86,Joachim Andersen,DEN,DF,Sampdoria,Serie A,22,1996,32.0,40,27,31,8,1,19,31,61.3,12,30,15,15,35,75,147,1,0,2018-2019,1.09375,1.25
87,Felipe Anderson,BRA,"MF,FW",West Ham,Premier League,25,1993,33.8,89,49,33,44,12,31,101,30.7,70,71,0,71,41,130,18,1,0,2018-2019,1.2130177514792901,2.6331360946745566
88,Florin Andone,ROU,FW,Brighton,Premier League,25,1993,9.8,10,2,3,4,3,1,6,16.7,5,9,1,8,3,13,12,0,0,2018-2019,0.3061224489795918,1.0204081632653061
89,Benjamin André,FRA,MF,Rennes,Ligue 1,27,1990,27.7,101,60,39,50,12,33,85,38.8,52,40,6,34,54,155,58,0,0,2018-2019,1.9494584837545126,3.6462093862815887
90,Marco Andreolli,ITA,DF,Cagliari,Serie A,32,1986,1.2,1,1,1,0,0,1,1,100.0,0,2,1,1,1,2,5,0,0,2018-2019,0.8333333333333334,0.8333333333333334
91,Marco Andreolli,ITA,DF,Chievo,Serie A,32,1986,7.2,10,6,7,2,1,6,10,60.0,4,4,2,2,6,16,33,0,0,2018-2019,0.8333333333333333,1.3888888888888888
92,Yoann Andreu,FRA,DF,Angers,Ligue 1,29,1989,0.0,1,0,1,0,0,0,1,0.0,1,0,0,0,1,2,0,0,0,2018-2019,inf,inf
93,José Ángel,ESP,DF,Eibar,La Liga,28,1989,33.6,66,46,36,23,7,31,56,55.4,25,24,5,19,41,107,113,1,0,2018-2019,1.2202380952380951,1.9642857142857142
94,Miguel Ángel Moyá,ESP,GK,Real Sociedad,La Liga,34,1984,11.0,1,1,1,0,0,1,2,50.0,1,0,0,0,1,2,9,2,0,2018-2019,0.09090909090909091,0.09090909090909091
95,Cristian Ansaldi,ARG,"DF,MF",Torino,Serie A,31,1986,20.1,50,26,19,21,10,15,30,50.0,15,21,4,17,15,65,31,0,0,2018-2019,0.7462686567164178,2.487562189054726
96,Mirco Antenucci,ITA,FW,SPAL,Serie A,33,1984,23.7,11,9,5,1,5,1,10,10.0,9,14,0,14,5,16,5,0,0,2018-2019,0.2109704641350211,0.4641350210970464
97,Waldemar Anton,GER,DF,Hannover 96,Bundesliga,22,1996,34.0,49,32,33,14,2,22,50,44.0,28,56,33,23,69,118,169,3,0,2018-2019,2.0294117647058822,1.4411764705882353
98,Luca Antonelli,ITA,DF,Empoli,Serie A,31,1987,8.4,13,11,4,5,4,7,17,41.2,10,19,4,15,16,29,25,1,0,2018-2019,1.9047619047619047,1.5476190476190474
99,Mauro Antonio Burruchaga,ARG,MF,Chievo,Serie A,20,1998,0.6,2,2,1,1,0,0,2,0.0,2,2,1,1,0,2,3,0,0,2018-2019,0.0,3.3333333333333335
100,Michail Antonio,JAM,"MF,FW",West Ham,Premier League,28,1990,23.4,23,14,12,6,5,6,12,50.0,6,38,3,35,18,41,26,1,0,2018-2019,0.7692307692307693,0.982905982905983
Rk,Player,Nation,Pos,Squad,Comp,0,0,90.0,0,0,3,3,3,Tkl,0,0.0,0,0,0,0,0,0,0,0,0,2018-2019,0.0,0.0
101,Antoñito,ESP,"DF,MF",Valladolid,La Liga,30,1987,20.7,35,21,16,15,4,18,42,42.9,24,21,8,13,18,53,31,0,0,2018-2019,0.8695652173913043,1.6908212560386473
102,Vitorino Antunes,POR,"DF,MF",Getafe,La Liga,31,1987,24.2,41,26,22,17,2,27,45,60.0,18,33,7,26,43,84,75,1,0,2018-2019,1.7768595041322315,1.694214876033058
103,Anuar,MAR,"MF,FW",Valladolid,La Liga,23,1995,12.0,33,19,15,16,2,6,14,42.9,8,14,1,13,11,44,25,1,0,2018-2019,0.9166666666666666,2.75
104,Dennis Aogo,GER,MF,Stuttgart,Bundesliga,31,1987,11.4,15,10,6,7,2,6,15,40.0,9,8,1,7,9,24,19,0,0,2018-2019,0.7894736842105263,1.3157894736842104
105,Houssem Aouar,ALG,MF,Lyon,Ligue 1,20,1998,34.0,63,38,28,25,10,17,61,27.9,44,33,6,27,32,95,25,3,0,2018-2019,0.9411764705882353,1.8529411764705883
106,Emmanuel Apeh,NGA,"FW,MF",Celta Vigo,La Liga,21,1996,0.2,0,0,0,0,0,0,1,0.0,1,0,0,0,0,0,0,0,0,2018-2019,0.0,0.0
107,Mauro Arambarri,URU,MF,Getafe,La Liga,22,1995,29.7,59,33,18,37,4,23,76,30.3,53,44,9,35,30,89,36,0,0,2018-2019,1.0101010101010102,1.9865319865319866
108,Guilherme Arana,BRA,DF,Sevilla,La Liga,21,1997,7.0,11,6,5,5,1,6,7,85.7,1,6,3,3,9,20,8,0,0,2018-2019,1.2857142857142858,1.5714285714285714
109,Charles Aránguiz,CHI,MF,Leverkusen,Bundesliga,29,1989,21.0,48,30,21,22,5,21,66,31.8,45,31,2,29,25,73,27,1,0,2018-2019,1.1904761904761905,2.2857142857142856
110,Luiz Araújo,BRA,"FW,MF",Lille,Ligue 1,22,1996,8.7,23,17,8,9,6,9,24,37.5,15,6,1,5,3,26,4,0,0,2018-2019,0.3448275862068966,2.6436781609195403
111,Néstor Araujo,MEX,DF,Celta Vigo,La Liga,26,1991,29.8,42,22,32,9,1,18,22,81.8,4,32,21,11,35,77,153,1,0,2018-2019,1.174496644295302,1.4093959731543624
112,Anaitz Arbilla,ESP,DF,Eibar,La Liga,31,1987,21.7,31,24,25,5,1,17,27,63.0,10,12,5,7,46,77,92,2,0,2018-2019,2.119815668202765,1.4285714285714286
113,Joaquín Ardaiz,URU,FW,Frosinone,Serie A,19,1999,0.2,0,0,0,0,0,0,0,0.0,0,0,0,0,0,0,0,0,0,2018-2019,0.0,0.0
114,Alphonse Areola,FRA,GK,Paris S-G,Ligue 1,25,1993,21.0,1,1,1,0,0,1,1,100.0,0,0,0,0,0,1,4,1,0,2018-2019,0.0,0.047619047619047616
115,Santiago Arias,COL,DF,Atlético Madrid,La Liga,26,1992,19.7,48,32,31,16,1,20,31,64.5,11,14,2,12,34,82,43,0,0,2018-2019,1.7258883248730965,2.436548223350254
116,Lorenzo Ariaudo,ITA,DF,Frosinone,Serie A,29,1989,18.7,20,14,15,4,1,6,10,60.0,4,31,20,11,14,34,103,0,0,2018-2019,0.7486631016042781,1.0695187165775402
117,Nicolò Armini,ITA,DF,Lazio,Serie A,17,2001,0.4,1,1,0,1,0,1,2,50.0,1,1,0,1,0,1,0,0,0,2018-2019,0.0,2.5
118,Yoël Armougom,FRA,DF,Caen,Ligue 1,20,1998,20.6,31,21,20,9,2,15,29,51.7,14,9,3,6,21,52,66,0,0,2018-2019,1.0194174757281553,1.5048543689320388
119,Stuart Armstrong,SCO,MF,Southampton,Premier League,26,1992,15.9,28,20,14,6,8,8,42,19.0,34,14,0,14,12,40,12,0,0,2018-2019,0.7547169811320754,1.7610062893081762
120,José Arnaiz,ESP,"MF,FW",Leganés,La Liga,23,1995,1.3,1,1,1,0,0,0,3,0.0,3,0,0,0,2,3,1,0,0,2018-2019,1.5384615384615383,0.7692307692307692
121,Marko Arnautović,AUT,FW,West Ham,Premier League,29,1989,22.1,9,5,4,3,2,1,7,14.3,6,4,2,2,3,12,6,0,0,2018-2019,0.13574660633484162,0.4072398190045249
122,Maximilian Arnold,GER,MF,Wolfsburg,Bundesliga,24,1994,31.9,52,30,21,27,4,21,61,34.4,40,31,10,21,35,87,48,1,0,2018-2019,1.09717868338558,1.6300940438871474
123,Kepa Arrizabalaga,ESP,GK,Chelsea,Premier League,23,1994,36.0,1,1,1,0,0,1,2,50.0,1,1,0,1,0,1,4,2,0,2018-2019,0.0,0.027777777777777776
124,Harry Arter,IRL,MF,Cardiff City,Premier League,28,1989,22.2,62,37,27,26,9,16,46,34.8,30,33,5,28,21,83,21,2,0,2018-2019,0.9459459459459459,2.7927927927927927
125,Kwadwo Asamoah,GHA,DF,Inter,Serie A,29,1988,29.7,44,26,22,14,8,29,51,56.9,22,21,4,17,40,84,46,1,0,2018-2019,1.3468013468013469,1.4814814814814816
Rk,Player,Nation,Pos,Squad,Comp,0,0,90.0,0,0,3,3,3,Tkl,0,0.0,0,0,0,0,0,0,0,0,0,2018-2019,0.0,0.0
126,Takuma Asano,JPN,"MF,FW",Hannover 96,Bundesliga,23,1994,7.8,5,3,1,1,3,1,6,16.7,5,9,0,9,2,7,2,0,0,2018-2019,0.25641025641025644,0.6410256410256411
127,Santiago Ascacíbar,ARG,MF,Stuttgart,Bundesliga,21,1997,27.0,78,50,43,29,6,34,74,45.9,40,48,10,38,43,121,34,1,0,2018-2019,1.5925925925925926,2.888888888888889
128,Sergio Asenjo,ESP,GK,Villarreal,La Liga,29,1989,32.0,0,0,0,0,0,0,1,0.0,1,0,0,0,3,3,26,2,0,2018-2019,0.09375,0.0
129,Marco Asensio,ESP,FW,Real Madrid,La Liga,22,1996,19.8,12,8,3,5,4,2,24,8.3,22,16,1,15,14,26,7,0,0,2018-2019,0.7070707070707071,0.6060606060606061
130,Iago Aspas,ESP,"FW,MF",Celta Vigo,La Liga,30,1987,25.0,16,11,4,8,4,4,20,20.0,16,14,0,14,16,32,5,0,0,2018-2019,0.64,0.64
131,Simon Asta,GER,DF,Augsburg,Bundesliga,17,2001,1.0,6,3,4,2,0,2,2,100.0,0,2,1,1,3,9,1,0,0,2018-2019,3.0,6.0
132,Youcef Atal,ALG,"DF,FW",Nice,Ligue 1,22,1996,25.1,68,44,34,25,9,34,67,50.7,33,38,8,30,56,124,42,0,0,2018-2019,2.231075697211155,2.7091633466135456
133,Christian Atsu,GHA,MF,Newcastle Utd,Premier League,26,1992,16.6,24,15,9,11,4,5,16,31.3,11,13,3,10,7,31,16,0,0,2018-2019,0.4216867469879518,1.4457831325301203
134,Pierre-Emerick Aubameyang,GAB,FW,Arsenal,Premier League,29,1989,30.3,21,17,6,9,6,8,28,28.6,20,26,0,26,8,29,22,0,0,2018-2019,0.264026402640264,0.693069306930693
135,Emil Audero,ITA,GK,Sampdoria,Serie A,21,1997,36.0,4,3,4,0,0,3,3,100.0,0,0,0,0,1,5,21,4,0,2018-2019,0.027777777777777776,0.1111111111111111
136,Jean-Kévin Augustin,FRA,FW,RB Leipzig,Bundesliga,21,1997,5.1,2,0,0,0,2,0,1,0.0,1,6,0,6,3,5,0,0,0,2018-2019,0.5882352941176471,0.3921568627450981
137,Ludwig Augustinsson,SWE,DF,Werder Bremen,Bundesliga,24,1994,33.6,53,31,25,22,6,23,39,59.0,16,37,11,26,38,91,86,1,0,2018-2019,1.130952380952381,1.5773809523809523
138,Serge Aurier,CIV,DF,Tottenham,Premier League,25,1992,6.3,20,12,12,4,4,8,15,53.3,7,8,2,6,7,27,20,0,0,2018-2019,1.1111111111111112,3.174603174603175
139,Charlie Austin,ENG,FW,Southampton,Premier League,29,1989,10.9,13,7,3,6,4,6,11,54.5,5,12,2,10,2,15,13,0,0,2018-2019,0.18348623853211007,1.1926605504587156
140,Ezequiel Ávila,ARG,"FW,MF",Huesca,La Liga,24,1994,22.2,18,10,7,7,4,4,26,15.4,22,21,2,19,13,31,22,0,0,2018-2019,0.5855855855855856,0.8108108108108109
141,Jordan Ayew,GHA,FW,Crystal Palace,Premier League,26,1991,13.1,38,23,12,19,7,6,20,30.0,14,16,0,16,7,45,6,0,0,2018-2019,0.5343511450381679,2.900763358778626
142,Kaan Ayhan,TUR,DF,Düsseldorf,Bundesliga,23,1994,27.2,53,29,38,15,0,23,47,48.9,24,34,16,18,59,112,118,3,0,2018-2019,2.1691176470588234,1.9485294117647058
143,Floyd Ayité,TOG,"FW,MF",Fulham,Premier League,29,1988,5.3,4,4,2,1,1,2,6,33.3,4,8,1,7,7,11,5,0,0,2018-2019,1.3207547169811322,0.7547169811320755
144,César Azpilicueta,ESP,DF,Chelsea,Premier League,28,1989,37.8,105,60,52,40,13,38,67,56.7,29,63,16,47,43,148,91,3,0,2018-2019,1.1375661375661377,2.777777777777778
145,Abdoulaye Ba,SEN,DF,Rayo Vallecano,La Liga,27,1991,23.4,46,33,37,8,1,29,39,74.4,10,32,18,14,29,75,165,4,0,2018-2019,1.2393162393162394,1.965811965811966
146,Florian Baak,GER,MF,Hertha BSC,Bundesliga,19,1999,0.0,0,0,0,0,0,0,0,0.0,0,0,0,0,0,0,0,0,0,2018-2019,,
147,Ludovic Baal,GUF,DF,Rennes,Ligue 1,32,1986,1.4,4,3,3,1,0,0,0,0.0,0,1,0,1,2,6,1,0,0,2018-2019,1.4285714285714286,2.857142857142857
148,Khouma Babacar,SEN,FW,Sassuolo,Serie A,25,1993,16.5,7,3,2,5,0,2,10,20.0,8,8,2,6,3,10,25,1,0,2018-2019,0.18181818181818182,0.42424242424242425
149,Ryan Babel,NED,"FW,MF",Fulham,Premier League,31,1986,13.9,8,4,1,5,2,3,9,33.3,6,12,0,12,6,14,13,1,0,2018-2019,0.4316546762589928,0.5755395683453237
150,Carlos Bacca,COL,FW,Villarreal,La Liga,31,1986,14.1,4,2,1,2,1,0,5,0.0,5,4,0,4,8,12,5,0,0,2018-2019,0.5673758865248227,0.28368794326241137
Rk,Player,Nation,Pos,Squad,Comp,0,0,90.0,0,0,3,3,3,Tkl,0,0.0,0,0,0,0,0,0,0,0,0,2018-2019,0.0,0.0
151,Juninho Bacuna,CUW,"MF,DF",Huddersfield,Premier League,20,1997,15.7,46,29,22,19,5,22,54,40.7,32,21,1,20,24,70,12,1,0,2018-2019,1.5286624203821657,2.9299363057324843
152,Leandro Bacuna,CUW,MF,Cardiff City,Premier League,26,1991,6.2,15,10,5,7,3,8,22,36.4,14,5,2,3,15,30,9,0,0,2018-2019,2.4193548387096775,2.4193548387096775
153,Milan Badelj,CRO,MF,Lazio,Serie A,29,1989,12.7,33,20,10,19,4,16,37,43.2,21,27,9,18,33,66,20,1,0,2018-2019,2.598425196850394,2.598425196850394
154,Benoît Badiashile,FRA,DF,Monaco,Ligue 1,17,2001,19.6,25,18,18,7,0,17,25,68.0,8,12,5,7,21,46,79,2,0,2018-2019,1.0714285714285714,1.2755102040816326
155,Holger Badstuber,GER,DF,Stuttgart,Bundesliga,29,1989,5.8,12,4,8,4,0,7,8,87.5,1,6,2,4,9,21,21,1,0,2018-2019,1.5517241379310345,2.0689655172413794
156,Stéphane Bahoken,CMR,FW,Angers,Ligue 1,26,1992,27.4,15,7,0,10,5,3,21,14.3,18,35,3,32,8,23,5,0,0,2018-2019,0.29197080291970806,0.5474452554744526
157,Daniel Baier,GER,MF,Augsburg,Bundesliga,34,1984,31.3,62,39,21,37,4,24,66,36.4,42,27,8,19,60,122,48,2,0,2018-2019,1.9169329073482428,1.9808306709265175
158,Leon Bailey,JAM,FW,Leverkusen,Bundesliga,20,1997,21.3,15,11,9,2,4,6,20,30.0,14,20,0,20,14,29,11,0,0,2018-2019,0.6572769953051643,0.704225352112676
159,Eric Bailly,CIV,DF,Manchester Utd,Premier League,24,1994,7.1,15,9,14,1,0,8,10,80.0,2,9,4,5,13,28,39,1,0,2018-2019,1.8309859154929577,2.1126760563380285
160,Leighton Baines,ENG,DF,Everton,Premier League,33,1984,4.2,8,6,4,3,1,4,6,66.7,2,2,0,2,2,10,8,0,0,2018-2019,0.47619047619047616,1.9047619047619047
161,Marvin Bakalorz,GER,MF,Hannover 96,Bundesliga,28,1989,16.3,18,11,7,9,2,6,36,16.7,30,29,4,25,28,46,47,0,0,2018-2019,1.7177914110429446,1.1042944785276072
162,Tiemoué Bakayoko,FRA,MF,Milan,Serie A,23,1994,25.6,69,43,22,40,7,26,62,41.9,36,34,5,29,50,119,42,2,0,2018-2019,1.953125,2.6953125
163,Ridle Baku,GER,MF,Mainz 05,Bundesliga,20,1998,10.4,18,9,6,9,3,2,7,28.6,5,13,1,12,8,26,9,0,0,2018-2019,0.7692307692307692,1.7307692307692306
164,Fabián Balbuena,PAR,DF,West Ham,Premier League,26,1991,22.4,40,20,34,6,0,16,42,38.1,26,23,15,8,53,93,175,0,0,2018-2019,2.366071428571429,1.7857142857142858
165,Keita Baldé,SEN,FW,Inter,Serie A,23,1995,9.9,10,6,4,2,4,2,9,22.2,7,8,0,8,3,13,1,0,0,2018-2019,0.30303030303030304,1.0101010101010102
166,Gareth Bale,WAL,FW,Real Madrid,La Liga,29,1989,19.8,16,8,5,7,4,6,20,30.0,14,19,3,16,11,27,13,0,0,2018-2019,0.5555555555555556,0.8080808080808081
167,Mikel Balenziaga,ESP,DF,Athletic Club,La Liga,30,1988,5.8,10,6,7,1,2,5,8,62.5,3,6,2,4,2,12,21,0,0,2018-2019,0.3448275862068966,1.7241379310344829
168,Andrija Balić,CRO,"FW,MF",Udinese,Serie A,20,1997,0.3,1,0,0,0,1,0,1,0.0,1,0,0,0,0,1,1,0,0,2018-2019,0.0,3.3333333333333335
169,Fodé Ballo-Touré,SEN,DF,Lille,Ligue 1,21,1997,17.7,47,35,26,19,2,21,32,65.6,11,25,7,18,27,74,42,2,0,2018-2019,1.5254237288135595,2.6553672316384183
170,Fodé Ballo-Touré,SEN,DF,Monaco,Ligue 1,21,1997,17.7,46,31,26,16,4,20,40,50.0,20,20,2,18,28,74,38,2,0,2018-2019,1.5819209039548023,2.598870056497175
171,Florent Balmont,FRA,MF,Dijon,Ligue 1,38,1980,12.0,29,16,16,10,3,9,36,25.0,27,13,2,11,6,35,8,0,0,2018-2019,0.5,2.4166666666666665
172,Leon Balogun,NGA,DF,Brighton,Premier League,30,1988,6.6,12,6,11,1,0,8,9,88.9,1,5,3,2,17,29,32,1,0,2018-2019,2.5757575757575757,1.8181818181818183
173,Mario Balotelli,ITA,FW,Nice,Ligue 1,27,1990,8.4,1,0,0,1,0,1,4,25.0,3,9,1,8,1,2,8,0,0,2018-2019,0.11904761904761904,0.11904761904761904
174,Mario Balotelli,ITA,FW,Marseille,Ligue 1,27,1990,10.4,5,3,1,3,1,2,7,28.6,5,8,2,6,3,8,6,0,0,2018-2019,0.28846153846153844,0.4807692307692307
175,Abdoulaye Bamba,CIV,DF,Angers,Ligue 1,28,1990,28.6,51,29,31,14,6,24,44,54.5,20,20,4,16,37,88,86,0,0,2018-2019,1.2937062937062938,1.7832167832167831
Rk,Player,Nation,Pos,Squad,Comp,0,0,90.0,0,0,3,3,3,Tkl,0,0.0,0,0,0,0,0,0,0,0,0,2018-2019,0.0,0.0
176,Jonathan Bamba,CIV,"FW,MF",Lille,Ligue 1,22,1996,33.4,29,19,7,17,5,13,39,33.3,26,24,1,23,41,70,18,0,0,2018-2019,1.2275449101796407,0.8682634730538923
177,Sol Bamba,CIV,DF,Cardiff City,Premier League,33,1985,27.5,74,42,44,30,0,31,55,56.4,24,72,32,40,82,156,181,3,0,2018-2019,2.981818181818182,2.690909090909091
178,Yacine Bammou,MAR,"FW,MF",Caen,Ligue 1,26,1991,10.3,14,7,7,4,3,3,8,37.5,5,14,3,11,9,23,17,0,0,2018-2019,0.8737864077669902,1.3592233009708736
179,Éver Banega,ARG,MF,Sevilla,La Liga,30,1988,29.6,71,50,32,35,4,20,70,28.6,50,26,5,21,28,99,28,0,0,2018-2019,0.9459459459459459,2.3986486486486487
180,Mattia Bani,ITA,DF,Chievo,Serie A,24,1993,29.0,67,40,46,21,0,27,40,67.5,13,51,35,16,57,124,162,2,0,2018-2019,1.9655172413793103,2.310344827586207
181,Léo Baptistão,BRA,"FW,MF",Espanyol,La Liga,25,1992,13.7,22,14,11,5,6,8,27,29.6,19,17,0,17,8,30,14,0,0,2018-2019,0.5839416058394161,1.6058394160583942
182,Antonín Barák,CZE,"MF,FW",Udinese,Serie A,23,1994,3.7,9,6,4,5,0,2,11,18.2,9,4,0,4,2,11,2,0,0,2018-2019,0.5405405405405405,2.4324324324324325
183,Federico Barba,ITA,DF,Chievo,Serie A,24,1993,27.6,30,14,21,9,0,8,21,38.1,13,29,15,14,65,95,129,0,0,2018-2019,2.3550724637681157,1.0869565217391304
184,Danilo Barbosa,BRA,MF,Nice,Ligue 1,22,1996,17.2,29,20,13,13,3,6,17,35.3,11,17,2,15,15,44,25,1,0,2018-2019,0.872093023255814,1.686046511627907
185,Enis Bardhi,MKD,MF,Levante,La Liga,23,1995,31.5,70,43,30,34,6,28,87,32.2,59,35,3,32,31,101,36,1,0,2018-2019,0.9841269841269841,2.2222222222222223
186,Francesco Bardi,ITA,GK,Frosinone,Serie A,26,1992,3.0,0,0,0,0,0,0,0,0.0,0,0,0,0,0,0,2,0,0,2018-2019,0.0,0.0
187,Phil Bardsley,SCO,DF,Burnley,Premier League,33,1985,18.6,32,19,15,14,3,12,21,57.1,9,25,12,13,31,63,68,1,0,2018-2019,1.6666666666666665,1.7204301075268815
188,Nicolò Barella,ITA,MF,Cagliari,Serie A,21,1997,34.5,99,65,38,41,20,30,82,36.6,52,61,2,59,38,137,27,0,0,2018-2019,1.1014492753623188,2.869565217391304
189,Philipp Bargfrede,GER,"MF,DF",Werder Bremen,Bundesliga,29,1989,12.0,23,15,9,12,2,10,28,35.7,18,35,11,24,34,57,45,1,0,2018-2019,2.8333333333333335,1.9166666666666667
190,Antonino Barillà,ITA,MF,Parma,Serie A,30,1988,29.1,64,36,40,17,7,19,53,35.8,34,40,13,27,36,100,50,1,0,2018-2019,1.2371134020618557,2.199312714776632
191,Ross Barkley,ENG,MF,Chelsea,Premier League,24,1993,13.8,15,10,5,7,3,4,14,28.6,10,8,1,7,9,24,17,2,0,2018-2019,0.6521739130434783,1.0869565217391304
192,Aymen Barkok,MAR,MF,Düsseldorf,Bundesliga,20,1998,5.7,13,6,4,9,0,4,19,21.1,15,8,1,7,4,17,3,0,0,2018-2019,0.7017543859649122,2.280701754385965
193,Ashley Barnes,ENG,FW,Burnley,Premier League,28,1989,26.5,28,17,4,17,7,6,29,20.7,23,29,8,21,2,30,25,0,0,2018-2019,0.07547169811320754,1.0566037735849056
194,Harvey Barnes,ENG,"MF,FW",Leicester City,Premier League,20,1997,11.2,10,6,5,4,1,4,6,66.7,2,7,1,6,3,13,7,0,0,2018-2019,0.26785714285714285,0.8928571428571429
195,Antonio Barragán,ESP,"DF,FW",Betis,La Liga,31,1987,10.4,14,8,9,4,1,2,12,16.7,10,15,4,11,5,19,30,2,0,2018-2019,0.4807692307692307,1.346153846153846
196,Antonio Barreca,ITA,DF,Newcastle Utd,Premier League,23,1995,0.1,0,0,0,0,0,0,0,0.0,0,0,0,0,0,0,0,0,0,2018-2019,0.0,0.0
197,Antonio Barreca,ITA,DF,Monaco,Ligue 1,23,1995,6.6,11,8,8,3,0,7,11,63.6,4,3,2,1,7,18,18,0,0,2018-2019,1.0606060606060606,1.6666666666666667
198,Leandro Barreiro Martins,LUX,MF,Mainz 05,Bundesliga,18,2000,1.0,4,4,2,0,2,1,2,50.0,1,0,0,0,2,6,1,0,0,2018-2019,2.0,4.0
199,Ander Barrenetxea,ESP,"FW,MF",Real Sociedad,La Liga,16,2001,4.4,7,2,2,0,5,2,8,25.0,6,8,0,8,4,11,1,0,0,2018-2019,0.9090909090909091,1.5909090909090908
200,Édgar Barreto,PAR,MF,Sampdoria,Serie A,34,1984,8.7,28,19,15,6,7,10,26,38.5,16,11,3,8,17,45,7,0,0,2018-2019,1.9540229885057472,3.218390804597701
Rk,Player,Nation,Pos,Squad,Comp,0,0,90.0,0,0,3,3,3,Tkl,0,0.0,0,0,0,0,0,0,0,0,0,2018-2019,0.0,0.0
201,Musa Barrow,GAM,FW,Atalanta,Serie A,19,1998,6.7,9,5,5,3,1,4,6,66.7,2,4,0,4,0,9,2,0,0,2018-2019,0.0,1.3432835820895521
202,Fin Bartels,GER,"MF,FW",Werder Bremen,Bundesliga,31,1987,0.3,0,0,0,0,0,0,1,0.0,1,0,0,0,1,1,0,0,0,2018-2019,3.3333333333333335,0.0
203,Marc Bartra,ESP,DF,Betis,La Liga,27,1991,32.5,86,55,55,26,5,41,76,53.9,35,46,21,25,60,146,132,2,0,2018-2019,1.8461538461538463,2.646153846153846
204,Andrea Barzagli,ITA,DF,Juventus,Serie A,37,1981,2.9,1,1,0,1,0,1,2,50.0,1,2,2,0,4,5,10,0,0,2018-2019,1.3793103448275863,0.3448275862068966
205,Daniele Baselli,ITA,MF,Torino,Serie A,26,1992,26.4,65,45,22,34,9,16,44,36.4,28,30,6,24,34,99,32,0,0,2018-2019,1.2878787878787878,2.4621212121212124
206,Toma Bašić,CRO,MF,Bordeaux,Ligue 1,21,1996,14.8,32,16,5,21,6,11,31,35.5,20,13,1,12,9,41,22,1,0,2018-2019,0.6081081081081081,2.162162162162162
207,Thomas Basila,FRA,DF,Nantes,Ligue 1,19,1999,1.0,2,1,1,1,0,0,0,0.0,0,2,1,1,0,2,8,0,0,2018-2019,0.0,2.0
208,Borja Bastón,ESP,FW,Alavés,La Liga,25,1992,16.0,16,7,4,9,3,2,24,8.3,22,16,5,11,4,20,10,0,0,2018-2019,0.25,1.0
209,Alessandro Bastoni,ITA,DF,Parma,Serie A,19,1999,18.8,25,12,20,5,0,6,15,40.0,9,26,18,8,22,47,96,0,0,2018-2019,1.1702127659574468,1.3297872340425532
210,Bastos,ANG,DF,Lazio,Serie A,27,1991,12.7,22,17,16,4,2,17,27,63.0,10,16,8,8,7,29,49,1,0,2018-2019,0.5511811023622047,1.7322834645669292
211,Michy Batshuayi,BEL,FW,Crystal Palace,Premier League,24,1993,8.3,2,1,1,1,0,1,2,50.0,1,8,3,5,3,5,0,0,0,2018-2019,0.36144578313253006,0.24096385542168672
212,Michy Batshuayi,BEL,FW,Valencia,La Liga,24,1993,5.9,1,1,0,1,0,0,3,0.0,3,5,2,3,0,1,3,0,0,2018-2019,0.0,0.1694915254237288
213,Robert Bauer,GER,DF,Nürnberg,Bundesliga,23,1995,19.1,48,29,32,13,3,20,39,51.3,19,19,5,14,28,76,80,0,0,2018-2019,1.4659685863874345,2.513089005235602
214,Oliver Baumann,GER,GK,Hoffenheim,Bundesliga,28,1990,33.0,0,0,0,0,0,0,0,0.0,0,0,0,0,2,2,11,5,0,2018-2019,0.06060606060606061,0.0
215,Timo Baumgartl,GER,DF,Stuttgart,Bundesliga,22,1996,18.0,33,23,21,12,0,11,19,57.9,8,31,22,9,26,59,100,0,0,2018-2019,1.4444444444444444,1.8333333333333333
216,Julian Baumgartlinger,AUT,MF,Leverkusen,Bundesliga,30,1988,17.3,52,30,24,20,8,20,45,44.4,25,18,6,12,26,78,21,1,0,2018-2019,1.5028901734104045,3.005780346820809
217,Christoph Baumgartner,AUT,MF,Hoffenheim,Bundesliga,18,1999,0.9,1,0,0,0,1,1,3,33.3,2,2,0,2,0,1,0,0,0,2018-2019,0.0,1.1111111111111112
218,Jon Bautista,ESP,FW,Real Sociedad,La Liga,23,1995,6.6,5,3,0,3,2,0,3,0.0,3,8,1,7,5,10,4,0,0,2018-2019,0.7575757575757576,0.7575757575757576
219,Paul Baysse,FRA,DF,Bordeaux,Ligue 1,30,1988,0.8,1,0,1,0,0,0,1,0.0,1,1,1,0,1,2,6,0,0,2018-2019,1.25,1.25
220,Paul Baysse,FRA,DF,Caen,Ligue 1,30,1988,19.9,25,14,20,5,0,13,18,72.2,5,25,20,5,31,56,113,1,0,2018-2019,1.5577889447236182,1.256281407035176
221,Noah Joel Sarenren Bazee,NGA,"FW,MF",Hannover 96,Bundesliga,21,1996,1.7,0,0,0,0,0,0,0,0.0,0,1,0,1,0,0,3,0,0,2018-2019,0.0,0.0
222,Claudio Beauvue,GLP,"FW,MF",Caen,Ligue 1,30,1988,16.7,18,11,7,9,2,1,14,7.1,13,11,2,9,10,28,21,0,0,2018-2019,0.5988023952095809,1.0778443113772456
223,Bebé,CPV,"FW,MF",Rayo Vallecano,La Liga,28,1990,14.5,19,9,10,4,5,9,19,47.4,10,16,1,15,9,28,16,1,0,2018-2019,0.6206896551724138,1.3103448275862069
224,Bebé,CPV,MF,Eibar,La Liga,28,1990,0.7,0,0,0,0,0,0,0,0.0,0,1,0,1,1,1,0,0,0,2018-2019,1.4285714285714286,0.0
225,Ihlas Bebou,TOG,"MF,FW",Hannover 96,Bundesliga,24,1994,11.8,15,9,4,10,1,4,9,44.4,5,18,2,16,9,24,9,0,0,2018-2019,0.7627118644067796,1.271186440677966
Rk,Player,Nation,Pos,Squad,Comp,0,0,90.0,0,0,3,3,3,Tkl,0,0.0,0,0,0,0,0,0,0,0,0,2018-2019,0.0,0.0
226,Uffe Bech,DEN,FW,Hannover 96,Bundesliga,25,1993,0.2,0,0,0,0,0,0,1,0.0,1,0,0,0,0,0,0,0,0,2018-2019,0.0,0.0
227,Andreas Beck,GER,DF,Stuttgart,Bundesliga,31,1987,19.7,35,19,17,17,1,11,27,40.7,16,32,6,26,22,57,54,0,0,2018-2019,1.116751269035533,1.7766497461928934
228,Jan Bednarek,POL,DF,Southampton,Premier League,22,1996,23.9,41,25,25,16,0,21,37,56.8,16,44,27,17,71,112,171,0,0,2018-2019,2.97071129707113,1.7154811715481173
229,Andrea Beghetto,ITA,DF,Frosinone,Serie A,23,1994,24.7,26,14,13,10,3,15,25,60.0,10,20,4,16,17,43,59,0,0,2018-2019,0.688259109311741,1.0526315789473684
230,Asmir Begović,BIH,GK,Bournemouth,Premier League,31,1987,24.0,0,0,0,0,0,0,3,0.0,3,1,0,1,1,1,15,7,0,2018-2019,0.041666666666666664,0.0
231,Valon Behrami,SUI,MF,Udinese,Serie A,33,1985,15.1,65,38,25,34,6,18,44,40.9,26,29,12,17,18,83,26,0,0,2018-2019,1.1920529801324504,4.304635761589404
232,Hanno Behrens,GER,MF,Nürnberg,Bundesliga,28,1990,29.3,46,26,29,17,0,21,47,44.7,26,43,13,30,33,79,49,0,0,2018-2019,1.1262798634812285,1.5699658703071673
233,Ishak Belfodil,ALG,"FW,MF",Hoffenheim,Bundesliga,26,1992,20.7,13,10,5,6,2,4,16,25.0,12,6,0,6,3,16,14,0,0,2018-2019,0.14492753623188406,0.6280193236714976
234,Stefan Bell,GER,DF,Mainz 05,Bundesliga,26,1991,25.0,31,20,18,13,0,15,34,44.1,19,31,11,20,54,85,122,1,0,2018-2019,2.16,1.24
235,Karim Bellarabi,GER,FW,Leverkusen,Bundesliga,28,1990,11.7,13,6,7,4,2,3,19,15.8,16,13,0,13,10,23,8,0,0,2018-2019,0.8547008547008548,1.1111111111111112
236,Héctor Bellerín,ESP,DF,Arsenal,Premier League,23,1995,17.0,15,12,8,4,3,6,13,46.2,7,17,5,12,20,35,37,3,0,2018-2019,1.1764705882352942,0.8823529411764706
237,Andrea Belotti,ITA,FW,Torino,Serie A,24,1993,36.7,33,22,8,15,10,6,30,20.0,24,36,5,31,15,48,23,0,0,2018-2019,0.4087193460490463,0.8991825613079019
238,Fran Beltrán,ESP,MF,Celta Vigo,La Liga,19,1999,16.9,23,17,8,12,3,13,31,41.9,18,19,2,17,19,42,15,1,0,2018-2019,1.124260355029586,1.3609467455621302
239,Hatem Ben Arfa,FRA,"FW,MF",Rennes,Ligue 1,31,1987,22.6,15,7,4,8,3,7,16,43.8,9,9,0,9,4,19,0,0,0,2018-2019,0.17699115044247787,0.663716814159292
240,Wissam Ben Yedder,FRA,FW,Sevilla,La Liga,27,1990,31.2,18,16,3,11,4,2,12,16.7,10,18,0,18,11,29,2,0,0,2018-2019,0.3525641025641026,0.576923076923077
241,Diego Benaglio,SUI,GK,Monaco,Ligue 1,34,1983,22.9,1,0,1,0,0,1,1,100.0,0,0,0,0,0,1,16,0,0,2018-2019,0.0,0.04366812227074236
242,Marco Benassi,ITA,MF,Fiorentina,Serie A,23,1994,25.4,30,19,8,15,7,14,41,34.1,27,16,3,13,9,39,27,1,0,2018-2019,0.35433070866141736,1.1811023622047245
243,Medhi Benatia,MAR,DF,Juventus,Serie A,31,1987,5.0,7,6,6,1,0,3,5,60.0,2,10,5,5,16,23,18,0,0,2018-2019,3.2,1.4
244,Lars Bender,GER,"MF,DF",Leverkusen,Bundesliga,29,1989,15.1,43,29,20,20,3,18,35,51.4,17,26,4,22,21,64,26,0,0,2018-2019,1.390728476821192,2.847682119205298
245,Sven Bender,GER,DF,Leverkusen,Bundesliga,29,1989,22.1,40,25,25,15,0,18,30,60.0,12,31,14,17,52,92,98,0,0,2018-2019,2.352941176470588,1.8099547511312215
246,László Bénes,SVK,"MF,FW",Gladbach,Bundesliga,20,1997,0.3,3,1,3,0,0,3,3,100.0,0,1,0,1,0,3,0,0,0,2018-2019,0.0,10.0
247,Nicolas Benezet,FRA,"MF,FW",Guingamp,Ligue 1,27,1991,18.5,32,19,14,15,3,5,19,26.3,14,12,0,12,19,51,4,0,0,2018-2019,1.027027027027027,1.7297297297297298
248,Walter Benítez,ARG,GK,Nice,Ligue 1,25,1993,35.0,1,0,1,0,0,1,2,50.0,1,0,0,0,2,3,6,2,0,2018-2019,0.05714285714285714,0.02857142857142857
249,Ismaël Bennacer,ALG,MF,Empoli,Serie A,20,1997,32.9,94,57,43,41,10,32,75,42.7,43,38,9,29,57,151,34,0,0,2018-2019,1.7325227963525838,2.857142857142857
250,Joe Bennett,ENG,DF,Cardiff City,Premier League,28,1990,29.3,50,29,34,16,0,22,38,57.9,16,30,8,22,60,110,93,0,0,2018-2019,2.04778156996587,1.706484641638225
Rk,Player,Nation,Pos,Squad,Comp,0,0,90.0,0,0,3,3,3,Tkl,0,0.0,0,0,0,0,0,0,0,0,0,2018-2019,0.0,0.0
251,Ryan Bennett,ENG,DF,Wolves,Premier League,28,1990,34.0,58,32,41,16,1,25,41,61.0,16,42,21,21,43,101,131,1,0,2018-2019,1.2647058823529411,1.7058823529411764
252,Yassine Benrahou,FRA,"MF,FW",Bordeaux,Ligue 1,19,1999,2.0,9,6,1,7,1,2,5,40.0,3,4,0,4,2,11,1,0,0,2018-2019,1.0,4.5
253,Ramy Bensebaini,ALG,DF,Rennes,Ligue 1,23,1995,23.9,69,48,42,19,8,40,58,69.0,18,24,10,14,41,110,98,0,0,2018-2019,1.7154811715481173,2.887029288702929
254,Nabil Bentaleb,ALG,MF,Schalke 04,Bundesliga,23,1994,19.9,32,17,8,21,3,4,18,22.2,14,28,8,20,35,67,19,0,0,2018-2019,1.7587939698492463,1.6080402010050252
255,Rodrigo Bentancur,URU,MF,Juventus,Serie A,21,1997,22.3,53,34,22,29,2,18,39,46.2,21,20,8,12,43,96,42,1,0,2018-2019,1.9282511210762332,2.3766816143497755
256,Christian Benteke,BEL,FW,Crystal Palace,Premier League,27,1990,9.0,5,1,0,4,1,1,4,25.0,3,7,2,5,0,5,14,0,0,2018-2019,0.0,0.5555555555555556
257,Karim Benzema,FRA,FW,Real Madrid,La Liga,30,1987,32.8,24,11,2,11,11,2,17,11.8,15,16,1,15,8,32,25,0,0,2018-2019,0.24390243902439027,0.7317073170731708
258,Yassine Benzia,ALG,MF,Lille,Ligue 1,23,1994,1.8,1,1,0,1,0,1,1,100.0,0,0,0,0,1,2,1,0,0,2018-2019,0.5555555555555556,0.5555555555555556
259,Domenico Berardi,ITA,"FW,MF",Sassuolo,Serie A,23,1994,31.9,38,21,16,9,13,15,73,20.5,58,31,2,29,27,65,24,0,0,2018-2019,0.8463949843260189,1.1912225705329154
260,Yuri Berchiche,ESP,"DF,FW",Athletic Club,La Liga,28,1990,34.7,46,31,26,11,9,23,46,50.0,23,34,9,25,42,88,82,0,0,2018-2019,1.2103746397694524,1.3256484149855907
261,Álex Berenguer,ESP,"MF,DF",Torino,Serie A,23,1995,16.5,31,20,12,17,2,14,34,41.2,20,20,1,19,8,39,14,0,0,2018-2019,0.48484848484848486,1.878787878787879
262,Bartosz Bereszyński,POL,DF,Sampdoria,Serie A,26,1992,24.4,46,30,27,15,4,24,51,47.1,27,22,7,15,31,77,76,0,0,2018-2019,1.2704918032786885,1.8852459016393444
263,Jóhann Berg Guðmundsson,ISL,MF,Burnley,Premier League,27,1990,19.5,27,11,14,10,3,16,34,47.1,18,25,4,21,33,60,34,0,0,2018-2019,1.6923076923076923,1.3846153846153846
264,Markel Bergara,ESP,MF,Getafe,La Liga,32,1986,0.6,2,2,0,1,1,2,3,66.7,1,3,0,3,1,3,2,0,0,2018-2019,1.6666666666666667,3.3333333333333335
265,Robert Berić,SVN,FW,Saint-Étienne,Ligue 1,27,1991,13.1,12,5,1,9,2,1,11,9.1,10,8,2,6,4,16,3,0,0,2018-2019,0.3053435114503817,0.916030534351145
266,Etrit Berisha,ALB,GK,Atalanta,Serie A,29,1989,18.0,0,0,0,0,0,0,2,0.0,2,0,0,0,0,0,5,3,0,2018-2019,0.0,0.0
267,Valon Berisha,KVX,"MF,FW",Lazio,Serie A,25,1993,2.2,8,5,1,6,1,4,6,66.7,2,6,0,6,4,12,3,0,0,2018-2019,1.8181818181818181,3.6363636363636362
268,Bernard,BRA,"FW,MF",Everton,Premier League,25,1992,23.5,49,30,19,22,8,15,55,27.3,40,37,2,35,27,76,14,1,0,2018-2019,1.148936170212766,2.0851063829787235
269,Federico Bernardeschi,ITA,"MF,FW",Juventus,Serie A,24,1994,16.4,14,8,5,6,3,7,18,38.9,11,9,0,9,6,20,10,0,0,2018-2019,0.3658536585365854,0.853658536585366
270,Bernardo,BRA,DF,Brighton,Premier League,23,1995,19.5,62,43,43,13,6,31,45,68.9,14,32,13,19,34,96,82,0,0,2018-2019,1.7435897435897436,3.1794871794871793
271,Paul Bernardoni,FRA,GK,Nîmes,Ligue 1,21,1997,38.0,1,1,1,0,0,1,2,50.0,1,0,0,0,1,2,20,1,0,2018-2019,0.02631578947368421,0.02631578947368421
272,Juan Bernat,ESP,"DF,MF",Paris S-G,Ligue 1,25,1993,20.4,47,32,22,19,6,22,46,47.8,24,19,5,14,20,67,41,1,0,2018-2019,0.9803921568627452,2.3039215686274512
273,Antoine Bernede,FRA,MF,Paris S-G,Ligue 1,19,1999,1.9,13,7,3,8,2,5,9,55.6,4,3,1,2,3,16,1,1,0,2018-2019,1.5789473684210527,6.842105263157895
274,Dimitry Bertaud,COD,GK,Montpellier,Ligue 1,20,1998,1.0,0,0,0,0,0,0,0,0.0,0,0,0,0,0,0,0,0,0,2018-2019,0.0,0.0
275,Ryan Bertrand,ENG,DF,Southampton,Premier League,28,1989,24.0,46,27,22,20,4,16,31,51.6,15,27,5,22,28,74,51,0,0,2018-2019,1.1666666666666667,1.9166666666666667
Rk,Player,Nation,Pos,Squad,Comp,0,0,90.0,0,0,3,3,3,Tkl,0,0.0,0,0,0,0,0,0,0,0,0,2018-2019,0.0,0.0
276,Daniel Bessa,ITA,MF,Genoa,Serie A,25,1993,27.1,60,35,28,23,9,11,39,28.2,28,30,4,26,19,79,16,1,0,2018-2019,0.7011070110701106,2.214022140221402
277,Marcus Bettinelli,ENG,GK,Fulham,Premier League,26,1992,7.0,0,0,0,0,0,0,0,0.0,0,0,0,0,0,0,5,0,0,2018-2019,0.0,0.0
278,Jordan Beyer,GER,DF,Gladbach,Bundesliga,18,2000,8.0,32,18,21,10,1,17,24,70.8,7,12,6,6,11,43,32,0,0,2018-2019,1.375,4.0
279,Jonathan Biabiany,FRA,FW,Parma,Serie A,30,1988,11.9,30,22,18,10,2,9,17,52.9,8,8,1,7,11,41,11,1,0,2018-2019,0.9243697478991596,2.5210084033613445
280,Giulian Biancone,FRA,DF,Monaco,Ligue 1,18,2000,1.0,4,3,4,0,0,1,3,33.3,2,0,0,0,3,7,2,0,0,2018-2019,3.0,4.0
281,Ermin Bičakčić,BIH,DF,Hoffenheim,Bundesliga,28,1990,19.9,32,19,18,11,3,13,22,59.1,9,36,15,21,56,88,79,1,0,2018-2019,2.814070351758794,1.6080402010050252
282,Pedro Bigas,ESP,DF,Eibar,La Liga,27,1990,6.5,4,3,2,0,2,1,5,20.0,4,6,2,4,8,12,22,0,0,2018-2019,1.2307692307692308,0.6153846153846154
283,Lucas Biglia,ARG,MF,Milan,Serie A,32,1986,12.4,60,33,31,25,4,20,45,44.4,25,19,3,16,22,82,21,1,0,2018-2019,1.7741935483870968,4.838709677419355
284,Philip Billing,DEN,MF,Huddersfield,Premier League,22,1996,24.3,73,44,26,39,8,19,42,45.2,23,57,16,41,53,126,43,0,0,2018-2019,2.1810699588477367,3.0041152263374484
285,Cristiano Biraghi,ITA,DF,Fiorentina,Serie A,25,1992,35.5,52,33,31,17,4,18,38,47.4,20,40,17,23,44,96,113,0,0,2018-2019,1.2394366197183098,1.4647887323943662
286,Davide Biraschi,ITA,DF,Genoa,Serie A,24,1994,31.6,58,38,37,19,2,25,42,59.5,17,32,13,19,64,122,107,1,0,2018-2019,2.0253164556962022,1.8354430379746836
287,Valter Birsa,SVN,"MF,FW",Cagliari,Serie A,31,1986,3.9,5,3,1,3,1,4,8,50.0,4,5,0,5,4,9,3,0,0,2018-2019,1.0256410256410258,1.2820512820512822
288,Valter Birsa,SVN,"MF,FW",Chievo,Serie A,31,1986,12.2,14,9,4,7,3,4,17,23.5,13,9,1,8,6,20,13,0,0,2018-2019,0.49180327868852464,1.1475409836065575
289,Yves Bissouma,MLI,MF,Brighton,Premier League,21,1996,19.7,62,30,33,27,2,20,38,52.6,18,21,5,16,33,95,29,2,0,2018-2019,1.6751269035532996,3.1472081218274113
290,Leonardo Bittencourt,GER,MF,Hoffenheim,Bundesliga,24,1993,11.9,37,26,9,22,6,8,32,25.0,24,22,1,21,13,50,7,0,0,2018-2019,1.0924369747899159,3.1092436974789917
291,Alejandro Blanco,ESP,"FW,MF",Alavés,La Liga,19,1998,0.2,1,1,1,0,0,1,3,33.3,2,1,0,1,0,1,0,0,0,2018-2019,0.0,5.0
292,Rubén Blanco,ESP,GK,Celta Vigo,La Liga,23,1995,25.0,1,0,1,0,0,1,2,50.0,1,1,0,1,2,3,13,2,0,2018-2019,0.08,0.04
293,Ludovic Blas,FRA,"MF,FW",Guingamp,Ligue 1,20,1997,26.4,62,38,22,32,8,20,43,46.5,23,44,7,37,26,88,14,0,0,2018-2019,0.9848484848484849,2.3484848484848486
294,Pablo de Blasis,ARG,"DF,MF",Eibar,La Liga,30,1988,16.9,32,19,17,8,7,12,32,37.5,20,18,0,18,13,45,20,0,0,2018-2019,0.7692307692307693,1.8934911242603552
295,Pablo de Blasis,ARG,FW,Mainz 05,Bundesliga,30,1988,1.0,2,0,0,1,1,2,3,66.7,1,0,0,0,1,3,0,0,0,2018-2019,1.0,2.0
296,Alexis Blin,FRA,MF,Amiens,Ligue 1,21,1996,22.1,77,45,33,36,8,35,89,39.3,54,39,14,25,33,110,48,1,0,2018-2019,1.4932126696832577,3.4841628959276014
297,Danny Blum,GER,MF,Eint Frankfurt,Bundesliga,27,1991,0.0,0,0,0,0,0,0,0,0.0,0,0,0,0,0,0,5,0,0,2018-2019,,
298,Emmanuel Boateng,GHA,FW,Levante,La Liga,22,1996,7.8,4,3,0,0,4,0,3,0.0,3,5,0,5,1,5,7,0,0,2018-2019,0.12820512820512822,0.5128205128205129
299,Jérôme Boateng,GER,DF,Bayern Munich,Bundesliga,29,1988,18.8,21,15,12,9,0,10,22,45.5,12,8,3,5,25,46,49,0,0,2018-2019,1.3297872340425532,1.1170212765957446
300,Kevin-Prince Boateng,GHA,FW,Sassuolo,Serie A,31,1987,10.4,5,4,0,4,1,1,4,25.0,3,7,3,4,3,8,13,0,0,2018-2019,0.28846153846153844,0.4807692307692307
Rk,Player,Nation,Pos,Squad,Comp,0,0,90.0,0,0,3,3,3,Tkl,0,0.0,0,0,0,0,0,0,0,0,0,2018-2019,0.0,0.0
301,Kevin-Prince Boateng,GHA,FW,Barcelona,La Liga,31,1987,2.7,3,2,0,1,2,0,1,0.0,1,1,0,1,1,4,4,0,0,2018-2019,0.37037037037037035,1.111111111111111
302,Antonin Bobichon,FRA,MF,Nîmes,Ligue 1,22,1995,23.9,34,16,17,12,5,16,58,27.6,42,15,3,12,15,49,13,0,0,2018-2019,0.6276150627615064,1.4225941422594144
303,Yann Bodiger,FRA,MF,Toulouse,Ligue 1,23,1995,0.1,0,0,0,0,0,0,1,0.0,1,0,0,0,0,0,0,0,0,2018-2019,0.0,0.0
304,Mathieu Bodmer,FRA,"MF,FW",Amiens,Ligue 1,35,1982,11.9,15,11,3,11,1,3,10,30.0,7,3,0,3,2,17,10,0,0,2018-2019,0.1680672268907563,1.2605042016806722
305,Adam Bodzek,GER,"MF,DF",Düsseldorf,Bundesliga,32,1985,17.7,44,27,27,16,1,17,43,39.5,26,15,6,9,26,70,39,0,0,2018-2019,1.4689265536723164,2.4858757062146895
306,Jean-Paul Boëtius,NED,MF,Mainz 05,Bundesliga,24,1994,23.6,51,32,21,25,5,16,44,36.4,28,59,2,57,37,88,13,0,0,2018-2019,1.5677966101694913,2.1610169491525424
307,Sacha Boey,FRA,DF,Rennes,Ligue 1,17,2000,0.2,0,0,0,0,0,0,0,0.0,0,0,0,0,0,0,0,0,0,2018-2019,0.0,0.0
308,Jeremie Boga,CIV,"FW,MF",Sassuolo,Serie A,21,1997,16.0,7,4,5,1,1,4,14,28.6,10,19,0,19,2,9,4,0,0,2018-2019,0.125,0.4375
309,Willy Boly,CIV,DF,Wolves,Premier League,27,1991,35.2,85,52,49,34,2,34,56,60.7,22,55,32,23,72,157,177,6,0,2018-2019,2.0454545454545454,2.414772727272727
310,Léo Bonatini,BRA,FW,Wolves,Premier League,24,1994,1.5,1,1,0,0,1,1,5,20.0,4,1,0,1,0,1,0,0,0,2018-2019,0.0,0.6666666666666666
311,Giacomo Bonaventura,ITA,MF,Milan,Serie A,28,1989,7.2,6,2,2,4,0,2,7,28.6,5,3,0,3,7,13,8,0,0,2018-2019,0.9722222222222222,0.8333333333333333
312,Daniele Bonera,ITA,DF,Villarreal,La Liga,37,1981,2.6,2,2,2,0,0,1,1,100.0,0,5,5,0,4,6,10,0,0,2018-2019,1.5384615384615383,0.7692307692307692
313,Gaëtan Bong,CMR,DF,Brighton,Premier League,30,1988,20.1,16,10,7,6,3,6,10,60.0,4,16,6,10,25,41,57,2,0,2018-2019,1.243781094527363,0.7960199004975124
314,Kevin Bonifazi,ITA,DF,SPAL,Serie A,22,1996,25.6,40,24,31,8,1,15,33,45.5,18,38,21,17,36,76,79,0,0,2018-2019,1.40625,1.5625
315,Leonardo Bonucci,ITA,DF,Juventus,Serie A,31,1987,27.5,18,9,11,6,1,10,13,76.9,3,32,21,11,38,56,88,3,0,2018-2019,1.3818181818181818,0.6545454545454545
316,Fabio Borini,ITA,"FW,DF",Milan,Serie A,27,1991,11.7,14,10,7,7,0,3,9,33.3,6,17,0,17,12,26,28,0,0,2018-2019,1.0256410256410258,1.1965811965811965
317,Robin Bormuth,GER,DF,Düsseldorf,Bundesliga,22,1995,6.8,7,4,7,0,0,5,10,50.0,5,6,4,2,10,17,49,1,0,2018-2019,1.4705882352941178,1.0294117647058825
318,Artur Boruc,POL,GK,Bournemouth,Premier League,38,1980,12.0,1,0,1,0,0,1,3,33.3,2,0,0,0,0,1,1,0,0,2018-2019,0.0,0.08333333333333333
319,Olivier Boscagli,FRA,DF,Nice,Ligue 1,20,1997,9.6,20,12,14,4,2,9,20,45.0,11,12,1,11,17,37,37,0,0,2018-2019,1.7708333333333335,2.0833333333333335
320,Gabriel Boschilia,BRA,"FW,MF",Nantes,Ligue 1,22,1996,14.7,33,23,11,9,13,8,33,24.2,25,14,2,12,8,41,7,0,0,2018-2019,0.54421768707483,2.2448979591836737
321,John Bostock,TRI,MF,Toulouse,Ligue 1,26,1992,10.9,24,14,14,10,0,9,30,30.0,21,12,2,10,17,41,11,0,0,2018-2019,1.5596330275229358,2.2018348623853212
322,Denis Bouanga,GAB,"MF,FW",Nîmes,Ligue 1,23,1994,29.3,52,32,21,22,9,13,61,21.3,48,24,3,21,20,72,16,0,0,2018-2019,0.68259385665529,1.7747440273037542
323,Zacharie Boucher,FRA,GK,Angers,Ligue 1,26,1992,2.0,0,0,0,0,0,0,0,0.0,0,1,0,1,0,0,1,0,0,2018-2019,0.0,0.0
324,Ryad Boudebouz,ALG,"MF,FW",Celta Vigo,La Liga,28,1990,8.0,14,4,4,6,4,3,8,37.5,5,9,1,8,3,17,9,0,0,2018-2019,0.375,1.75
325,Ryad Boudebouz,ALG,"MF,FW",Betis,La Liga,28,1990,6.0,8,4,4,1,3,4,10,40.0,6,5,1,4,5,13,2,0,0,2018-2019,0.8333333333333334,1.3333333333333333
Rk,Player,Nation,Pos,Squad,Comp,0,0,90.0,0,0,3,3,3,Tkl,0,0.0,0,0,0,0,0,0,0,0,0,2018-2019,0.0,0.0
326,Sofiane Boufal,MAR,"MF,FW",Celta Vigo,La Liga,24,1993,23.2,35,21,18,11,6,15,47,31.9,32,24,0,24,10,45,12,0,0,2018-2019,0.4310344827586207,1.5086206896551724
327,Nassim Boujellab,MAR,MF,Schalke 04,Bundesliga,19,1999,4.2,10,4,3,6,1,3,11,27.3,8,6,0,6,2,12,3,0,0,2018-2019,0.47619047619047616,2.380952380952381
328,Arnold Bouka Moutou,CGO,"DF,FW",Dijon,Ligue 1,29,1988,0.7,3,1,2,1,0,0,4,0.0,4,1,0,1,3,6,1,0,0,2018-2019,4.285714285714286,4.285714285714286
329,Yassine Bounou,MAR,GK,Girona,La Liga,27,1991,31.8,0,0,0,0,0,0,2,0.0,2,0,0,0,1,1,7,2,0,2018-2019,0.031446540880503145,0.0
330,Mehdi Bourabia,MAR,MF,Sassuolo,Serie A,26,1991,22.3,51,28,23,21,7,15,46,32.6,31,28,5,23,33,84,32,0,0,2018-2019,1.4798206278026906,2.286995515695067
331,Benjamin Bourigeaud,FRA,"MF,FW",Rennes,Ligue 1,24,1994,26.9,55,35,23,21,11,20,67,29.9,47,44,5,39,32,87,34,1,0,2018-2019,1.1895910780669146,2.0446096654275094
332,Bilal Boutobba,FRA,"FW,MF",Montpellier,Ligue 1,19,1998,0.4,0,0,0,0,0,0,2,0.0,2,0,0,0,0,0,0,0,0,2018-2019,0.0,0.0
333,Umut Bozok,TUR,FW,Nîmes,Ligue 1,21,1996,13.7,9,6,0,3,6,2,4,50.0,2,3,0,3,5,14,1,0,0,2018-2019,0.36496350364963503,0.6569343065693432
334,Filip Bradarić,CRO,MF,Cagliari,Serie A,26,1992,16.6,26,21,11,12,3,10,20,50.0,10,13,3,10,39,65,50,0,0,2018-2019,2.3493975903614457,1.5662650602409638
335,Robbie Brady,IRL,MF,Burnley,Premier League,26,1992,8.0,15,7,5,5,5,6,17,35.3,11,7,1,6,7,22,18,1,0,2018-2019,0.875,1.875
336,Martin Braithwaite,DEN,FW,Leganés,La Liga,27,1991,15.6,5,3,0,0,5,0,4,0.0,4,9,0,9,3,8,4,0,0,2018-2019,0.19230769230769232,0.32051282051282054
337,Julian Brandt,GER,"MF,FW",Leverkusen,Bundesliga,22,1996,29.6,27,16,13,10,4,7,43,16.3,36,27,1,26,17,44,12,1,0,2018-2019,0.5743243243243243,0.9121621621621622
338,Darko Brašanac,SRB,MF,Alavés,La Liga,26,1992,17.6,32,16,15,13,4,10,26,38.5,16,17,4,13,13,45,19,0,0,2018-2019,0.7386363636363635,1.8181818181818181
339,Pedro Brazão,POR,"MF,FW",Nice,Ligue 1,15,2002,0.2,0,0,0,0,0,0,1,0.0,1,0,0,0,0,0,0,0,0,2018-2019,0.0,0.0
340,Fabian Bredlow,GER,GK,Nürnberg,Bundesliga,23,1995,12.5,1,1,1,0,0,1,1,100.0,0,0,0,0,1,2,3,4,0,2018-2019,0.08,0.08
341,Josip Brekalo,CRO,"FW,MF",Wolfsburg,Bundesliga,20,1998,15.7,15,7,7,6,2,5,18,27.8,13,15,1,14,12,27,9,1,0,2018-2019,0.7643312101910829,0.9554140127388535
342,Gleison Bremer,BRA,DF,Torino,Serie A,21,1997,2.0,3,1,1,2,0,1,2,50.0,1,4,1,3,8,11,9,0,0,2018-2019,4.0,1.5
343,Joshua Brenet,CUW,DF,Hoffenheim,Bundesliga,24,1994,10.1,20,13,12,5,3,7,13,53.8,6,16,1,15,8,28,19,0,0,2018-2019,0.7920792079207921,1.9801980198019802
344,Rajko Brežančić,SRB,DF,Huesca,La Liga,28,1989,0.7,1,0,0,0,1,0,0,0.0,0,0,0,0,0,1,0,0,0,2018-2019,0.0,1.4285714285714286
345,Anthony Briançon,FRA,DF,Nîmes,Ligue 1,23,1994,32.5,46,27,36,10,0,27,50,54.0,23,51,38,13,70,116,184,1,0,2018-2019,2.1538461538461537,1.4153846153846155
346,Jimmy Briand,FRA,FW,Bordeaux,Ligue 1,32,1985,27.7,14,8,2,10,2,4,24,16.7,20,14,6,8,4,18,29,0,0,2018-2019,0.1444043321299639,0.5054151624548736
347,Nicolò Brighenti,ITA,DF,Frosinone,Serie A,28,1989,11.0,27,17,9,15,3,6,14,42.9,8,17,8,9,31,58,37,0,0,2018-2019,2.8181818181818183,2.4545454545454546
348,Matteo Brighi,ITA,MF,Empoli,Serie A,37,1981,2.6,11,4,2,9,0,2,9,22.2,7,2,0,2,3,14,4,0,0,2018-2019,1.1538461538461537,4.230769230769231
349,Enrico Brignola,ITA,"FW,MF",Sassuolo,Serie A,19,1999,1.9,2,2,2,0,0,0,2,0.0,2,0,0,0,1,3,1,0,0,2018-2019,0.5263157894736842,1.0526315789473684
350,Miguel Britos,URU,DF,Watford,Premier League,33,1985,2.1,4,2,4,0,0,2,4,50.0,2,1,1,0,3,7,11,1,0,2018-2019,1.4285714285714286,1.9047619047619047
Rk,Player,Nation,Pos,Squad,Comp,0,0,90.0,0,0,3,3,3,Tkl,0,0.0,0,0,0,0,0,0,0,0,0,2018-2019,0.0,0.0
351,David Brooks,WAL,"MF,FW",Bournemouth,Premier League,21,1997,25.1,37,26,12,19,6,19,44,43.2,25,36,7,29,24,61,28,0,0,2018-2019,0.9561752988047808,1.4741035856573705
352,John Brooks,USA,DF,Wolfsburg,Bundesliga,25,1993,29.0,29,15,18,9,2,13,27,48.1,14,28,13,15,37,66,135,3,0,2018-2019,1.2758620689655173,1.0
353,Daniel Brosinski,GER,DF,Mainz 05,Bundesliga,30,1988,24.5,27,16,16,10,1,18,33,54.5,15,30,9,21,26,53,58,0,0,2018-2019,1.0612244897959184,1.1020408163265305
354,Marcelo Brozović,CRO,MF,Inter,Serie A,25,1992,29.4,101,70,47,40,14,31,86,36.0,55,45,8,37,44,145,32,3,0,2018-2019,1.4965986394557824,3.435374149659864
355,Bruma,POR,MF,RB Leipzig,Bundesliga,23,1994,6.1,5,2,3,1,1,1,5,20.0,4,4,0,4,4,9,2,0,0,2018-2019,0.6557377049180328,0.819672131147541
356,Jeffrey Bruma,NED,DF,Schalke 04,Bundesliga,26,1991,6.9,12,11,8,4,0,6,12,50.0,6,8,2,6,4,16,35,0,0,2018-2019,0.5797101449275363,1.7391304347826086
357,Bruno,ESP,DF,Brighton,Premier League,37,1980,12.6,25,16,20,3,2,14,18,77.8,4,7,2,5,11,36,30,1,0,2018-2019,0.873015873015873,1.9841269841269842
358,Jacob Bruun Larsen,DEN,FW,Dortmund,Bundesliga,19,1998,14.1,15,9,8,2,5,7,17,41.2,10,15,1,14,13,28,12,0,0,2018-2019,0.9219858156028369,1.0638297872340425
359,Joe Bryan,ENG,"DF,MF",Fulham,Premier League,24,1993,26.1,61,41,35,21,5,24,42,57.1,18,34,12,22,31,92,82,1,0,2018-2019,1.1877394636015326,2.337164750957854
360,Gianluigi Buffon,ITA,GK,Paris S-G,Ligue 1,40,1978,17.0,0,0,0,0,0,0,1,0.0,1,0,0,0,0,0,5,0,0,2018-2019,0.0,0.0
361,Niko Bungert,GER,DF,Mainz 05,Bundesliga,31,1986,3.2,7,5,5,2,0,5,5,100.0,0,7,6,1,4,11,16,0,0,2018-2019,1.25,2.1875
362,Guido Burgstaller,AUT,FW,Schalke 04,Bundesliga,29,1989,17.0,11,9,2,5,4,3,8,37.5,5,5,0,5,2,13,10,0,0,2018-2019,0.11764705882352941,0.6470588235294118
363,Burgui,ESP,"MF,FW",Alavés,La Liga,24,1993,6.2,6,6,4,2,0,1,3,33.3,2,4,0,4,0,6,2,1,0,2018-2019,0.0,0.9677419354838709
364,Jonathan Burkardt,GER,"FW,MF",Mainz 05,Bundesliga,18,2000,2.9,4,4,2,1,1,1,2,50.0,1,2,0,2,3,7,5,0,0,2018-2019,1.0344827586206897,1.3793103448275863
365,Roman Bürki,SUI,GK,Dortmund,Bundesliga,27,1990,32.0,1,0,1,0,0,1,2,50.0,1,1,0,1,2,3,8,4,0,2018-2019,0.0625,0.03125
366,Patrick Burner,MTQ,DF,Nice,Ligue 1,22,1996,15.0,36,23,22,10,4,16,34,47.1,18,15,5,10,31,67,40,0,0,2018-2019,2.066666666666667,2.4
367,Sergio Busquets,ESP,MF,Barcelona,La Liga,30,1988,30.2,90,60,35,45,10,41,89,46.1,48,43,8,35,54,144,22,1,0,2018-2019,1.7880794701986755,2.980132450331126
368,Gaëtan Bussmann,FRA,DF,Mainz 05,Bundesliga,27,1991,1.0,2,1,2,0,0,2,5,40.0,3,0,0,0,1,3,2,0,0,2018-2019,1.0,2.0
369,Unai Bustinza,ESP,DF,Leganés,La Liga,26,1992,22.5,41,31,25,14,2,17,33,51.5,16,31,13,18,53,94,110,2,0,2018-2019,2.3555555555555556,1.8222222222222222
370,Ludovic Butelle,FRA,GK,Angers,Ligue 1,35,1983,36.0,1,0,1,0,0,1,1,100.0,0,0,0,0,1,2,31,1,0,2018-2019,0.027777777777777776,0.027777777777777776
371,David Button,ENG,GK,Brighton,Premier League,29,1989,4.0,0,0,0,0,0,0,0,0.0,0,0,0,0,0,0,2,0,0,2018-2019,0.0,0.0
372,Jakub Błaszczykowski,POL,MF,Wolfsburg,Bundesliga,32,1985,0.1,0,0,0,0,0,0,0,0.0,0,0,0,0,0,0,0,0,0,2018-2019,0.0,0.0
373,Erick Cabaco,URU,DF,Levante,La Liga,23,1995,18.1,22,13,19,3,0,12,29,41.4,17,29,14,15,29,51,69,0,0,2018-2019,1.6022099447513811,1.2154696132596685
374,Willy Caballero,ARG,GK,Chelsea,Premier League,36,1981,2.0,0,0,0,0,0,0,0,0.0,0,0,0,0,0,0,1,0,0,2018-2019,0.0,0.0
375,Rémy Cabella,FRA,"MF,FW",Saint-Étienne,Ligue 1,28,1990,33.3,88,51,31,38,19,30,87,34.5,57,39,1,38,19,107,5,3,0,2018-2019,0.5705705705705706,2.642642642642643
Rk,Player,Nation,Pos,Squad,Comp,0,0,90.0,0,0,3,3,3,Tkl,0,0.0,0,0,0,0,0,0,0,0,0,2018-2019,0.0,0.0
376,Gustavo Cabral,ARG,DF,Celta Vigo,La Liga,32,1985,21.1,37,26,28,7,2,17,27,63.0,10,31,11,20,33,70,102,1,0,2018-2019,1.5639810426540284,1.7535545023696681
377,Rafael Cabral,BRA,GK,Sampdoria,Serie A,28,1990,2.0,0,0,0,0,0,0,0,0.0,0,0,0,0,0,0,0,0,0,2018-2019,0.0,0.0
378,Leandro Cabrera,URU,DF,Getafe,La Liga,27,1991,31.0,47,26,28,17,2,24,41,58.5,17,29,16,13,52,99,216,2,0,2018-2019,1.6774193548387097,1.5161290322580645
379,Fabrizio Cacciatore,ITA,DF,Cagliari,Serie A,31,1986,6.4,9,7,7,0,2,1,5,20.0,4,6,4,2,7,16,17,0,0,2018-2019,1.09375,1.40625
380,Fabrizio Cacciatore,ITA,DF,Chievo,Serie A,31,1986,5.5,8,4,6,2,0,4,9,44.4,5,8,2,6,5,13,20,0,0,2018-2019,0.9090909090909091,1.4545454545454546
381,Martín Cáceres,URU,DF,Lazio,Serie A,31,1987,3.4,4,2,3,1,0,4,6,66.7,2,4,0,4,0,4,12,1,0,2018-2019,0.0,1.1764705882352942
382,Martín Cáceres,URU,DF,Juventus,Serie A,31,1987,7.0,7,3,6,0,1,4,4,100.0,0,6,3,3,4,11,14,0,0,2018-2019,0.5714285714285714,1.0
383,Anthony Caci,FRA,DF,Strasbourg,Ligue 1,21,1997,25.5,56,30,38,14,4,24,46,52.2,22,20,10,10,47,103,63,0,0,2018-2019,1.8431372549019607,2.196078431372549
384,Mathieu Cafaro,FRA,"FW,MF",Reims,Ligue 1,21,1997,23.3,59,28,29,24,6,18,63,28.6,45,28,0,28,20,79,14,0,0,2018-2019,0.8583690987124464,2.532188841201717
385,Gary Cahill,ENG,DF,Chelsea,Premier League,32,1985,0.3,0,0,0,0,0,0,0,0.0,0,0,0,0,0,0,1,0,0,2018-2019,0.0,0.0
386,Yannick Cahuzac,FRA,"MF,DF",Toulouse,Ligue 1,33,1985,15.9,33,19,15,15,3,17,32,53.1,15,16,4,12,24,57,55,0,0,2018-2019,1.5094339622641508,2.0754716981132075
387,Felipe Caicedo,ECU,FW,Lazio,Serie A,29,1988,15.2,16,12,4,6,6,1,8,12.5,7,9,2,7,5,21,5,0,0,2018-2019,0.32894736842105265,1.0526315789473684
388,Marc-Aurèle Caillard,FRA,GK,Guingamp,Ligue 1,24,1994,21.0,0,0,0,0,0,0,2,0.0,2,0,0,0,2,2,8,3,0,2018-2019,0.09523809523809523,0.0
389,Tom Cairney,SCO,"MF,FW",Fulham,Premier League,27,1991,24.4,37,21,9,22,6,12,16,75.0,4,21,5,16,10,47,13,1,0,2018-2019,0.4098360655737705,1.5163934426229508
390,Caiuby,BRA,"MF,FW",Augsburg,Bundesliga,30,1988,11.2,12,10,5,6,1,3,11,27.3,8,16,1,15,5,17,10,0,0,2018-2019,0.44642857142857145,1.0714285714285714
391,Arturo Calabresi,ITA,DF,Bologna,Serie A,22,1996,15.7,46,27,22,17,7,22,40,55.0,18,18,3,15,34,80,60,0,0,2018-2019,2.1656050955414012,2.9299363057324843
392,Davide Calabria,ITA,DF,Milan,Serie A,21,1996,21.7,79,51,58,16,5,37,67,55.2,30,33,1,32,32,111,78,1,0,2018-2019,1.4746543778801844,3.640552995391705
393,Jordi Calavera,ESP,DF,Eibar,La Liga,22,1995,0.0,0,0,0,0,0,0,0,0.0,0,0,0,0,0,0,0,0,0,2018-2019,,
394,Fernando Calero,ESP,DF,Valladolid,La Liga,22,1995,34.8,51,31,33,18,0,23,38,60.5,15,55,31,24,55,106,170,0,0,2018-2019,1.5804597701149428,1.4655172413793105
395,Duje Ćaleta-Car,CRO,DF,Marseille,Ligue 1,21,1996,17.2,22,16,14,8,0,14,18,77.8,4,15,9,6,20,42,86,2,0,2018-2019,1.1627906976744187,1.2790697674418605
396,Hakan Çalhanoğlu,TUR,"MF,FW",Milan,Serie A,24,1994,32.0,52,31,27,16,9,23,46,50.0,23,27,5,22,28,80,19,0,0,2018-2019,0.875,1.625
397,Daniel Caligiuri,ITA,"DF,FW",Schalke 04,Bundesliga,30,1988,30.6,93,52,55,29,9,44,103,42.7,59,66,10,56,50,143,72,1,0,2018-2019,1.6339869281045751,3.0392156862745097
398,José Callejón,ESP,"MF,FW",Napoli,Serie A,31,1987,29.4,34,18,12,14,8,18,57,31.6,39,34,5,29,22,56,11,0,0,2018-2019,0.7482993197278912,1.1564625850340136
399,Jonathan Calleri,ARG,FW,Alavés,La Liga,24,1993,31.9,20,13,3,11,6,1,24,4.2,23,34,7,27,7,27,53,0,0,2018-2019,0.219435736677116,0.6269592476489029
400,Jan-Ingwer Callsen-Bracker,GER,DF,Augsburg,Bundesliga,33,1984,0.1,0,0,0,0,0,0,0,0.0,0,0,0,0,0,0,0,0,0,2018-2019,0.0,0.0
Rk,Player,Nation,Pos,Squad,Comp,0,0,90.0,0,0,3,3,3,Tkl,0,0.0,0,0,0,0,0,0,0,0,0,2018-2019,0.0,0.0
401,Dominic Calvert-Lewin,ENG,FW,Everton,Premier League,21,1997,19.8,13,7,3,3,7,7,15,46.7,8,16,3,13,7,20,19,0,0,2018-2019,0.35353535353535354,0.6565656565656566
402,Ignacio Camacho,ESP,MF,Wolfsburg,Bundesliga,28,1990,6.0,15,9,9,6,0,3,7,42.9,4,7,2,5,18,33,12,0,0,2018-2019,3.0,2.5
403,Juanjo Camacho,ESP,"MF,DF",Huesca,La Liga,37,1980,0.4,1,1,1,0,0,1,1,100.0,0,0,0,0,0,1,1,0,0,2018-2019,0.0,2.5
404,Rafael Camacho,POR,DF,Liverpool,Premier League,18,2000,0.0,1,0,1,0,0,1,1,100.0,0,0,0,0,0,1,0,0,0,2018-2019,,inf
405,Mahdi Camara,FRA,FW,Saint-Étienne,Ligue 1,20,1998,0.1,0,0,0,0,0,0,0,0.0,0,0,0,0,0,0,2,0,0,2018-2019,0.0,0.0
406,Souleymane Camara,SEN,"FW,MF",Montpellier,Ligue 1,35,1982,1.5,0,0,0,0,0,0,2,0.0,2,0,0,0,0,0,3,0,0,2018-2019,0.0,0.0
407,Víctor Camarasa,ESP,MF,Cardiff City,Premier League,24,1994,28.5,28,15,8,15,5,6,31,19.4,25,17,2,15,33,61,28,1,0,2018-2019,1.1578947368421053,0.9824561403508771
408,Eduardo Camavinga,FRA,MF,Rennes,Ligue 1,15,2002,4.0,23,15,8,12,3,8,18,44.4,10,13,2,11,4,27,4,0,0,2018-2019,1.0,5.75
409,Sergio Camello,ESP,FW,Atlético Madrid,La Liga,17,2001,0.5,1,0,1,0,0,1,1,100.0,0,0,0,0,0,1,0,0,0,2018-2019,0.0,2.0
410,José Campaña,ESP,MF,Levante,La Liga,25,1993,35.7,65,45,31,29,5,27,86,31.4,59,51,7,44,48,113,46,1,0,2018-2019,1.3445378151260503,1.8207282913165264
411,Joel Campbell,CRC,"FW,MF",Frosinone,Serie A,26,1992,9.9,15,10,5,8,2,3,17,17.6,14,2,0,2,3,18,2,1,0,2018-2019,0.30303030303030304,1.5151515151515151
412,Emre Can,GER,MF,Juventus,Serie A,24,1994,20.1,64,38,28,27,9,24,40,60.0,16,43,13,30,28,92,36,2,0,2018-2019,1.3930348258706466,3.1840796019900495
413,Sergio Canales,ESP,MF,Betis,La Liga,27,1991,29.5,44,30,19,18,7,11,53,20.8,42,34,3,31,9,53,8,1,0,2018-2019,0.3050847457627119,1.4915254237288136
414,João Cancelo,POR,DF,Juventus,Serie A,24,1994,21.9,43,28,18,18,7,27,49,55.1,22,14,4,10,15,58,48,0,0,2018-2019,0.6849315068493151,1.9634703196347034
415,Antonio Candreva,ITA,"FW,MF",Inter,Serie A,31,1987,5.6,1,1,0,1,0,1,8,12.5,7,0,0,0,4,5,9,0,0,2018-2019,0.7142857142857143,0.17857142857142858
416,Ander Capa,ESP,"DF,FW",Athletic Club,La Liga,26,1992,18.2,43,27,32,8,3,13,27,48.1,14,20,2,18,30,73,47,0,0,2018-2019,1.6483516483516485,2.3626373626373627
417,Luan Capanni,BRA,FW,Lazio,Serie A,18,2000,0.1,1,1,0,0,1,0,0,0.0,0,0,0,0,0,1,0,0,0,2018-2019,0.0,10.0
418,Pierrick Capelle,FRA,"DF,MF",Angers,Ligue 1,31,1987,20.5,51,31,23,22,6,19,54,35.2,35,23,2,21,38,89,49,0,0,2018-2019,1.853658536585366,2.4878048780487805
419,Leonardo Capezzi,ITA,MF,Empoli,Serie A,23,1995,8.6,14,9,6,8,0,7,13,53.8,6,14,4,10,10,24,13,0,0,2018-2019,1.1627906976744187,1.627906976744186
420,Étienne Capoue,FRA,MF,Watford,Premier League,30,1988,32.7,91,56,36,48,7,33,87,37.9,54,50,13,37,85,176,96,1,0,2018-2019,2.5993883792048926,2.782874617737003
421,Gianluca Caprari,ITA,"FW,MF",Sampdoria,Serie A,25,1993,11.5,15,9,4,9,2,5,12,41.7,7,7,0,7,4,19,3,0,0,2018-2019,0.34782608695652173,1.3043478260869565
422,Marco Capuano,ITA,DF,Frosinone,Serie A,26,1991,25.6,53,33,37,15,1,26,46,56.5,20,44,31,13,34,87,101,2,0,2018-2019,1.328125,2.0703125
423,Francesco Caputo,ITA,FW,Empoli,Serie A,30,1987,38.0,13,9,2,4,7,3,10,30.0,7,11,1,10,2,15,11,0,0,2018-2019,0.05263157894736842,0.34210526315789475
424,Yoan Cardinale,FRA,GK,Nice,Ligue 1,24,1994,3.0,1,0,1,0,0,1,1,100.0,0,0,0,0,0,1,1,0,0,2018-2019,0.0,0.3333333333333333
425,Marc Cardona,ESP,"FW,MF",Eibar,La Liga,23,1995,6.7,7,5,2,1,4,2,6,33.3,4,7,0,7,1,8,3,0,0,2018-2019,0.14925373134328357,1.044776119402985
Rk,Player,Nation,Pos,Squad,Comp,0,0,90.0,0,0,3,3,3,Tkl,0,0.0,0,0,0,0,0,0,0,0,0,2018-2019,0.0,0.0
426,Diego Carlos,BRA,DF,Nantes,Ligue 1,25,1993,35.0,58,34,43,14,1,26,33,78.8,7,44,31,13,50,108,186,1,0,2018-2019,1.4285714285714286,1.6571428571428573
427,Jonas Carls,GER,FW,Schalke 04,Bundesliga,21,1997,1.0,5,2,4,0,1,5,5,100.0,0,0,0,0,1,6,0,0,0,2018-2019,1.0,5.0
428,Louis Carnot,FRA,MF,Guingamp,Ligue 1,17,2001,0.1,0,0,0,0,0,0,0,0.0,0,0,0,0,0,0,0,0,0,2018-2019,0.0,0.0
429,Lionel Carole,FRA,"DF,FW",Strasbourg,Ligue 1,27,1991,19.2,25,12,16,7,2,11,16,68.8,5,19,5,14,32,57,51,0,0,2018-2019,1.6666666666666667,1.3020833333333335
430,Daniel Carriço,POR,DF,Sevilla,La Liga,29,1988,23.7,35,18,23,11,1,12,20,60.0,8,19,12,7,31,66,104,1,0,2018-2019,1.3080168776371308,1.4767932489451476
431,Guido Carrillo,ARG,FW,Leganés,La Liga,27,1991,22.1,25,14,4,12,9,6,19,31.6,13,12,1,11,8,33,25,0,0,2018-2019,0.36199095022624433,1.1312217194570136
432,Andy Carroll,ENG,FW,West Ham,Premier League,29,1989,5.1,4,2,1,3,0,1,4,25.0,3,3,2,1,1,5,8,0,0,2018-2019,0.19607843137254904,0.7843137254901962
433,Dani Carvajal,ESP,DF,Real Madrid,La Liga,26,1992,23.4,40,24,17,15,8,18,41,43.9,23,31,7,24,26,66,35,0,0,2018-2019,1.1111111111111112,1.7094017094017095
434,William Carvalho,POR,MF,Betis,La Liga,26,1992,26.5,45,27,20,21,4,16,29,55.2,13,8,0,8,12,57,30,0,0,2018-2019,0.4528301886792453,1.6981132075471699
435,Casemiro,BRA,MF,Real Madrid,La Liga,26,1992,25.7,86,52,44,35,7,38,94,40.4,56,52,12,40,41,127,56,3,0,2018-2019,1.595330739299611,3.3463035019455254
436,Santiago Cáseres,ARG,MF,Villarreal,La Liga,21,1997,17.6,67,35,20,38,9,25,57,43.9,32,22,9,13,14,81,24,1,0,2018-2019,0.7954545454545454,3.8068181818181817
437,Moreto Cassamã,GNB,MF,Reims,Ligue 1,20,1998,0.7,3,3,1,2,0,1,7,14.3,6,1,0,1,1,4,2,0,0,2018-2019,1.4285714285714286,4.285714285714286
438,Francesco Cassata,ITA,MF,Frosinone,Serie A,21,1997,12.5,20,11,12,4,4,9,23,39.1,14,8,1,7,6,26,15,1,0,2018-2019,0.48,1.6
439,Timothy Castagne,BEL,DF,Atalanta,Serie A,22,1995,22.3,61,39,30,22,9,32,57,56.1,25,32,6,26,28,89,50,0,0,2018-2019,1.2556053811659191,2.7354260089686098
440,Koen Casteels,BEL,GK,Wolfsburg,Bundesliga,26,1992,25.5,1,0,1,0,0,1,2,50.0,1,1,0,1,0,1,11,1,0,2018-2019,0.0,0.0392156862745098
441,Samu Castillejo,ESP,"FW,MF",Milan,Serie A,23,1995,11.4,15,10,10,2,3,4,25,16.0,21,16,0,16,8,23,11,0,0,2018-2019,0.7017543859649122,1.3157894736842104
442,Gonzalo Castro,GER,MF,Stuttgart,Bundesliga,31,1987,18.8,50,28,21,25,4,19,43,44.2,24,23,5,18,29,79,22,1,0,2018-2019,1.5425531914893615,2.6595744680851063
443,Jonny Castro,ESP,"DF,MF",Wolves,Premier League,24,1994,30.8,79,43,42,33,4,31,60,51.7,29,45,8,37,60,139,64,2,0,2018-2019,1.948051948051948,2.564935064935065
444,Lucas Castro,ARG,MF,Cagliari,Serie A,29,1989,10.0,18,11,8,8,2,8,23,34.8,15,20,4,16,17,35,6,0,0,2018-2019,1.7,1.8
445,Danilo Cataldi,ITA,"MF,FW",Lazio,Serie A,23,1994,6.4,12,7,4,5,3,2,9,22.2,7,3,0,3,7,19,6,0,0,2018-2019,1.09375,1.875
446,Catena,ESP,DF,Rayo Vallecano,La Liga,23,1994,2.0,4,4,3,1,0,2,2,100.0,0,4,2,2,8,12,8,0,0,2018-2019,4.0,2.0
447,Craig Cathcart,NIR,DF,Watford,Premier League,29,1989,34.4,50,31,36,11,3,21,37,56.8,16,42,30,12,38,88,184,4,0,2018-2019,1.1046511627906976,1.4534883720930234
448,Ivan Cavaleiro,POR,"FW,MF",Wolves,Premier League,24,1993,7.7,5,4,3,1,1,1,14,7.1,13,12,0,12,4,9,5,0,0,2018-2019,0.5194805194805194,0.6493506493506493
449,Edinson Cavani,URU,FW,Paris S-G,Ligue 1,31,1987,18.6,11,8,1,4,6,3,13,23.1,10,11,2,9,6,17,16,0,0,2018-2019,0.3225806451612903,0.5913978494623655
450,Santi Cazorla,ESP,"MF,FW",Villarreal,La Liga,33,1984,29.4,69,34,32,26,11,24,69,34.8,45,35,6,29,28,97,17,1,0,2018-2019,0.9523809523809524,2.3469387755102042
Rk,Player,Nation,Pos,Squad,Comp,0,0,90.0,0,0,3,3,3,Tkl,0,0.0,0,0,0,0,0,0,0,0,0,2018-2019,0.0,0.0
451,Dani Ceballos,ESP,"MF,FW",Real Madrid,La Liga,21,1996,13.9,32,21,9,16,7,11,31,35.5,20,26,1,25,15,47,6,0,0,2018-2019,1.079136690647482,2.302158273381295
452,Federico Ceccherini,ITA,DF,Fiorentina,Serie A,26,1992,11.0,13,10,8,3,2,5,9,55.6,4,12,8,4,21,34,40,0,0,2018-2019,1.9090909090909092,1.1818181818181819
453,Petr Čech,CZE,GK,Arsenal,Premier League,36,1982,6.5,1,1,1,0,0,1,1,100.0,0,0,0,0,0,1,5,2,0,2018-2019,0.0,0.15384615384615385
454,Žan Celar,SVN,FW,Roma,Serie A,19,1999,0.1,0,0,0,0,0,0,0,0.0,0,0,0,0,0,0,0,0,0,2018-2019,0.0,0.0
455,Zeki Çelik,TUR,DF,Lille,Ligue 1,21,1997,33.0,90,59,40,39,11,36,89,40.4,53,34,5,29,34,124,89,1,0,2018-2019,1.0303030303030303,2.727272727272727
456,Luca Ceppitelli,ITA,DF,Cagliari,Serie A,28,1989,22.8,40,24,28,11,1,13,22,59.1,9,34,24,10,20,60,111,2,0,2018-2019,0.8771929824561403,1.7543859649122806
457,Fabio Ceravolo,ITA,FW,Parma,Serie A,31,1987,13.2,5,1,2,1,2,1,11,9.1,10,9,1,8,2,7,19,0,0,2018-2019,0.15151515151515152,0.3787878787878788
458,Alberto Cerri,ITA,FW,Cagliari,Serie A,22,1996,7.4,3,2,2,1,0,0,7,0.0,7,7,1,6,2,5,4,0,0,2018-2019,0.27027027027027023,0.4054054054054054
459,Boštjan Cesar,SVN,DF,Chievo,Serie A,36,1982,12.0,16,10,9,7,0,7,17,41.2,10,14,8,6,14,30,60,2,0,2018-2019,1.1666666666666667,1.3333333333333333
460,Nacer Chadli,BEL,"MF,DF",Monaco,Ligue 1,28,1989,7.7,11,5,4,4,3,3,8,37.5,5,7,1,6,3,14,7,0,0,2018-2019,0.38961038961038963,1.4285714285714286
461,Fouad Chafik,MAR,DF,Dijon,Ligue 1,31,1986,20.5,44,31,29,12,3,23,36,63.9,13,17,3,14,25,69,71,0,0,2018-2019,1.2195121951219512,2.1463414634146343
462,Nathaniel Chalobah,ENG,MF,Watford,Premier League,23,1994,3.0,3,2,1,2,0,2,7,28.6,5,2,1,1,5,8,7,0,0,2018-2019,1.6666666666666667,1.0
463,Calum Chambers,ENG,"MF,DF",Fulham,Premier League,23,1995,28.8,64,36,32,27,5,16,48,33.3,32,37,12,25,69,133,113,4,0,2018-2019,2.3958333333333335,2.2222222222222223
464,Timothy Chandler,USA,DF,Eint Frankfurt,Bundesliga,28,1990,0.2,0,0,0,0,0,0,0,0.0,0,0,0,0,0,0,0,0,0,2018-2019,0.0,0.0
465,Kwon Chang-hoon,KOR,"FW,MF",Dijon,Ligue 1,24,1994,10.4,7,4,3,2,2,0,12,0.0,12,16,0,16,8,15,8,0,0,2018-2019,0.7692307692307692,0.673076923076923
466,Charles,BRA,FW,Eibar,La Liga,34,1984,19.3,7,5,1,3,3,2,13,15.4,11,14,1,13,4,11,14,0,0,2018-2019,0.20725388601036268,0.3626943005181347
467,Xavier Chavalerin,FRA,MF,Reims,Ligue 1,27,1991,36.0,106,61,56,39,11,28,72,38.9,44,44,12,32,72,178,39,1,0,2018-2019,2.0,2.9444444444444446
468,Pablo Chavarría,ARG,FW,Reims,Ligue 1,30,1988,21.9,20,12,8,6,6,3,15,20.0,12,11,0,11,4,24,19,0,0,2018-2019,0.18264840182648404,0.9132420091324202
469,Chechu,ESP,DF,Rayo Vallecano,La Liga,36,1982,1.0,0,0,0,0,0,0,2,0.0,2,0,0,0,2,2,5,0,0,2018-2019,2.0,0.0
470,Pape Cheikh Diop,SEN,MF,Lyon,Ligue 1,20,1997,5.0,1,0,0,1,0,0,5,0.0,5,6,2,4,2,3,2,1,0,2018-2019,0.4,0.2
471,Chema,ESP,DF,Levante,La Liga,26,1992,13.9,27,19,16,9,2,13,19,68.4,6,19,11,8,19,46,83,0,0,2018-2019,1.3669064748201438,1.9424460431654675
472,Denis Cheryshev,RUS,MF,Valencia,La Liga,27,1990,19.0,46,32,15,22,9,17,37,45.9,20,35,3,32,15,61,16,0,0,2018-2019,0.7894736842105263,2.4210526315789473
473,Raman Chibsah,GHA,MF,Frosinone,Serie A,25,1993,29.1,46,27,25,19,2,16,54,29.6,38,45,10,35,32,78,28,1,0,2018-2019,1.099656357388316,1.5807560137457044
474,Leandro Chichizola,ARG,GK,Getafe,La Liga,28,1990,1.0,0,0,0,0,0,0,0,0.0,0,0,0,0,0,0,1,0,0,2018-2019,0.0,0.0
475,Giorgio Chiellini,ITA,DF,Juventus,Serie A,33,1984,22.1,24,13,20,2,2,5,8,62.5,3,22,15,7,30,54,96,1,0,2018-2019,1.3574660633484161,1.085972850678733
Rk,Player,Nation,Pos,Squad,Comp,0,0,90.0,0,0,3,3,3,Tkl,0,0.0,0,0,0,0,0,0,0,0,0,2018-2019,0.0,0.0
476,Federico Chiesa,ITA,FW,Fiorentina,Serie A,20,1997,33.7,46,27,8,17,21,10,40,25.0,30,24,1,23,10,56,12,0,0,2018-2019,0.29673590504451036,1.3649851632047476
477,Ben Chilwell,ENG,DF,Leicester City,Premier League,21,1996,36.0,55,29,34,18,3,24,55,43.6,31,37,7,30,38,93,156,0,0,2018-2019,1.0555555555555556,1.5277777777777777
478,Vlad Chiricheș,ROU,DF,Napoli,Serie A,28,1989,1.6,2,1,1,1,0,0,2,0.0,2,2,2,0,1,3,2,0,0,2018-2019,0.625,1.25
479,Tahith Chong,NED,FW,Manchester Utd,Premier League,18,1999,0.4,0,0,0,0,0,0,0,0.0,0,1,0,1,0,0,1,0,0,2018-2019,0.0,0.0
480,Hamza Choudhury,ENG,MF,Leicester City,Premier League,20,1997,6.6,24,10,13,10,1,9,15,60.0,6,12,3,9,15,39,13,0,0,2018-2019,2.272727272727273,3.6363636363636367
481,Andreas Christensen,DEN,DF,Chelsea,Premier League,22,1996,6.9,10,4,2,6,2,2,5,40.0,3,4,2,2,4,14,29,0,0,2018-2019,0.5797101449275363,1.4492753623188406
482,Cyrus Christie,IRL,"DF,MF",Fulham,Premier League,25,1992,21.6,43,23,26,13,4,18,41,43.9,23,25,11,14,29,72,96,1,0,2018-2019,1.3425925925925926,1.9907407407407407
483,Samuel Chukwueze,NGA,"MF,FW",Villarreal,La Liga,19,1999,19.0,19,11,7,10,2,9,31,29.0,22,11,2,9,10,29,2,0,0,2018-2019,0.5263157894736842,1.0
484,Camillo Ciano,ITA,"FW,MF",Frosinone,Serie A,28,1990,27.3,33,15,12,10,11,8,50,16.0,42,28,4,24,8,41,16,0,0,2018-2019,0.29304029304029305,1.2087912087912087
485,Amato Ciciretti,ITA,"FW,MF",Parma,Serie A,24,1993,1.5,1,0,1,0,0,0,0,0.0,0,3,0,3,3,4,0,0,0,2018-2019,2.0,0.6666666666666666
486,Luca Cigarini,ITA,MF,Cagliari,Serie A,32,1986,18.7,54,33,27,22,5,28,63,44.4,35,28,5,23,26,80,41,0,0,2018-2019,1.3903743315508021,2.8877005347593583
487,Per Ciljan Skjelbred,NOR,MF,Hertha BSC,Bundesliga,31,1987,11.1,26,18,13,12,1,5,22,22.7,17,10,1,9,20,46,14,0,0,2018-2019,1.8018018018018018,2.3423423423423424
488,Jasper Cillessen,NED,GK,Barcelona,La Liga,29,1989,3.0,0,0,0,0,0,0,0,0.0,0,0,0,0,0,0,3,2,0,2018-2019,0.0,0.0
489,Laurent Ciman,BEL,DF,Dijon,Ligue 1,32,1985,8.0,11,6,9,2,0,7,16,43.8,9,13,9,4,7,18,37,0,0,2018-2019,0.875,1.375
490,Daniel Ciofani,ITA,FW,Frosinone,Serie A,33,1985,18.0,8,6,2,5,1,3,7,42.9,4,4,0,4,3,11,9,0,0,2018-2019,0.16666666666666666,0.4444444444444444
491,Thiago Cionek,POL,DF,SPAL,Serie A,32,1986,28.2,75,44,46,25,4,29,56,51.8,27,34,22,12,55,130,144,0,0,2018-2019,1.950354609929078,2.6595744680851063
492,Ibrahima Cissé,GUI,MF,Fulham,Premier League,24,1994,1.0,0,0,0,0,0,0,1,0.0,1,0,0,0,3,3,4,0,0,2018-2019,3.0,0.0
493,Till Cissokho,FRA,DF,Bordeaux,Ligue 1,18,2000,0.9,1,0,1,0,0,0,0,0.0,0,0,0,0,2,3,3,0,0,2018-2019,2.2222222222222223,1.1111111111111112
494,Ciaran Clark,IRL,DF,Newcastle Utd,Premier League,28,1989,9.5,20,17,15,5,0,9,12,75.0,3,11,7,4,12,32,58,0,0,2018-2019,1.263157894736842,2.1052631578947367
495,Tom Cleverley,ENG,MF,Watford,Premier League,28,1989,5.3,17,9,11,4,2,6,22,27.3,16,4,0,4,5,22,11,0,0,2018-2019,0.9433962264150944,3.207547169811321
496,Nathaniel Clyne,ENG,DF,Bournemouth,Premier League,27,1991,12.7,33,18,16,14,3,11,23,47.8,12,13,3,10,16,49,33,1,0,2018-2019,1.2598425196850394,2.598425196850394
497,Nathaniel Clyne,ENG,DF,Liverpool,Premier League,27,1991,1.2,4,3,2,2,0,2,4,50.0,2,1,0,1,2,6,1,0,0,2018-2019,1.6666666666666667,3.3333333333333335
498,Conor Coady,ENG,DF,Wolves,Premier League,25,1993,38.0,31,19,26,5,0,17,32,53.1,15,35,27,8,30,61,133,3,0,2018-2019,0.7894736842105263,0.8157894736842105
499,Marcus Coco,FRA,"FW,MF",Guingamp,Ligue 1,22,1996,20.4,39,23,20,10,9,16,33,48.5,17,24,0,24,23,62,14,0,0,2018-2019,1.1274509803921569,1.911764705882353
500,Coke,ESP,DF,Levante,La Liga,31,1987,20.2,44,27,24,17,3,26,56,46.4,30,18,8,10,40,84,54,1,0,2018-2019,1.9801980198019802,2.1782178217821784
Rk,Player,Nation,Pos,Squad,Comp,0,0,90.0,0,0,3,3,3,Tkl,0,0.0,0,0,0,0,0,0,0,0,0,2018-2019,0.0,0.0
501,Joel Coleman,ENG,GK,Huddersfield,Premier League,22,1995,1.0,0,0,0,0,0,0,0,0.0,0,0,0,0,0,0,0,0,0,2018-2019,0.0,0.0
502,Séamus Coleman,IRL,DF,Everton,Premier League,29,1988,28.4,44,25,23,18,3,19,30,63.3,11,14,5,9,26,70,86,0,0,2018-2019,0.9154929577464789,1.5492957746478875
503,Álex Collado,ESP,FW,Barcelona,La Liga,19,1999,0.9,1,0,0,1,0,0,1,0.0,1,3,0,3,0,1,2,0,0,2018-2019,0.0,1.1111111111111112
504,Omar Colley,GAM,DF,Sampdoria,Serie A,25,1992,19.6,18,11,12,6,0,12,13,92.3,1,24,16,8,22,40,102,0,0,2018-2019,1.1224489795918366,0.9183673469387754
505,Racine Coly,SEN,"DF,MF",Nice,Ligue 1,22,1995,5.6,7,2,1,5,1,4,11,36.4,7,6,1,5,9,16,11,1,0,2018-2019,1.6071428571428572,1.25
506,Kingsley Coman,FRA,"FW,MF",Bayern Munich,Bundesliga,22,1996,15.3,11,6,4,4,3,6,19,31.6,13,20,0,20,5,16,3,0,0,2018-2019,0.32679738562091504,0.7189542483660131
507,Santi Comesaña,ESP,MF,Rayo Vallecano,La Liga,21,1996,22.6,56,35,29,25,2,22,61,36.1,39,30,5,25,30,86,45,2,0,2018-2019,1.327433628318584,2.47787610619469
508,Daniel Congré,FRA,DF,Montpellier,Ligue 1,33,1985,36.6,75,45,46,26,3,38,65,58.5,27,35,15,20,67,142,106,1,0,2018-2019,1.830601092896175,2.0491803278688523
509,Andrea Consigli,ITA,GK,Sassuolo,Serie A,31,1987,35.7,0,0,0,0,0,0,2,0.0,2,0,0,0,1,1,15,6,0,2018-2019,0.028011204481792715,0.0
510,Andrea Conti,ITA,DF,Milan,Serie A,24,1994,5.6,9,5,3,4,2,2,9,22.2,7,4,0,4,15,24,12,1,0,2018-2019,2.678571428571429,1.6071428571428572
511,Lewis Cook,ENG,MF,Bournemouth,Premier League,21,1997,8.0,13,6,6,7,0,8,19,42.1,11,8,2,6,8,21,7,1,0,2018-2019,1.0,1.625
512,Steve Cook,ENG,DF,Bournemouth,Premier League,27,1991,31.0,36,19,31,5,0,20,27,74.1,7,36,21,15,50,86,202,1,0,2018-2019,1.6129032258064515,1.1612903225806452
513,Duje Čop,CRO,FW,Valladolid,La Liga,28,1990,7.6,5,4,1,2,2,0,8,0.0,8,8,3,5,3,8,3,0,0,2018-2019,0.39473684210526316,0.6578947368421053
514,Francis Coquelin,FRA,MF,Valencia,La Liga,27,1991,19.6,46,31,25,14,7,17,35,48.6,18,21,5,16,49,95,29,1,0,2018-2019,2.5,2.346938775510204
515,Gabriele Corbo,ITA,DF,Bologna,Serie A,18,2000,0.1,0,0,0,0,0,0,0,0.0,0,0,0,0,0,0,0,0,0,2018-2019,0.0,0.0
516,Iñigo Córdoba,ESP,"FW,MF",Athletic Club,La Liga,21,1997,14.7,37,23,15,17,5,14,47,29.8,33,27,0,27,17,54,13,0,0,2018-2019,1.1564625850340136,2.5170068027210886
517,Sergio Córdova,VEN,FW,Augsburg,Bundesliga,20,1997,5.9,9,5,3,4,2,2,6,33.3,4,0,0,0,3,12,5,0,0,2018-2019,0.5084745762711864,1.5254237288135593
518,Benjamin Corgnet,FRA,"MF,FW",Strasbourg,Ligue 1,31,1987,7.5,21,12,7,9,5,4,11,36.4,7,1,0,1,6,27,9,0,0,2018-2019,0.8,2.8
519,Ante Ćorić,CRO,MF,Roma,Serie A,21,1997,0.3,0,0,0,0,0,0,0,0.0,0,0,0,0,0,0,0,0,0,2018-2019,0.0,0.0
520,Jack Cork,ENG,MF,Burnley,Premier League,29,1989,36.8,51,27,12,34,5,18,46,39.1,28,39,16,23,29,80,82,2,0,2018-2019,0.7880434782608696,1.3858695652173914
521,Andreas Cornelius,DEN,FW,Bordeaux,Ligue 1,25,1993,8.8,4,1,1,3,0,1,4,25.0,3,4,1,3,1,5,21,0,0,2018-2019,0.11363636363636363,0.45454545454545453
522,Maxwel Cornet,CIV,FW,Lyon,Ligue 1,21,1996,14.2,14,11,4,7,3,1,11,9.1,10,10,0,10,5,19,8,0,0,2018-2019,0.35211267605633806,0.9859154929577465
523,Quentin Cornette,FRA,"FW,MF",Amiens,Ligue 1,24,1994,2.3,5,1,2,2,1,3,6,50.0,3,3,0,3,1,6,5,0,0,2018-2019,0.4347826086956522,2.173913043478261
524,Ángel Correa,ARG,"MF,FW",Atlético Madrid,La Liga,23,1995,21.3,38,19,19,12,7,10,53,18.9,43,28,5,23,17,55,20,0,0,2018-2019,0.7981220657276995,1.784037558685446
525,Joaquín Correa,ARG,"FW,MF",Lazio,Serie A,23,1994,21.4,21,13,6,12,3,5,18,27.8,13,14,3,11,2,23,7,0,0,2018-2019,0.09345794392523366,0.9813084112149534
Rk,Player,Nation,Pos,Squad,Comp,0,0,90.0,0,0,3,3,3,Tkl,0,0.0,0,0,0,0,0,0,0,0,0,2018-2019,0.0,0.0
526,Danny da Costa,GER,"DF,FW",Eint Frankfurt,Bundesliga,25,1993,33.7,61,35,29,25,7,18,42,42.9,24,51,9,42,32,93,67,0,0,2018-2019,0.9495548961424332,1.8100890207715132
527,Diego Costa,ESP,FW,Atlético Madrid,La Liga,29,1988,12.4,4,1,0,4,0,1,8,12.5,7,5,0,5,2,6,6,0,0,2018-2019,0.16129032258064516,0.3225806451612903
528,Douglas Costa,BRA,"FW,MF",Juventus,Serie A,27,1990,6.9,10,8,2,8,0,4,9,44.4,5,8,0,8,4,14,2,0,0,2018-2019,0.5797101449275363,1.4492753623188406
529,Filippo Costa,ITA,"DF,FW",SPAL,Serie A,23,1995,6.3,15,13,6,6,3,4,9,44.4,5,10,3,7,8,23,31,1,0,2018-2019,1.2698412698412698,2.380952380952381
530,Hélder Costa,ANG,"FW,MF",Wolves,Premier League,24,1994,14.9,18,14,7,7,4,7,23,30.4,16,15,0,15,9,27,6,0,0,2018-2019,0.6040268456375839,1.2080536912751678
531,Jaume Costa,ESP,DF,Villarreal,La Liga,30,1988,16.6,33,21,26,5,2,20,33,60.6,13,12,3,9,21,54,61,0,0,2018-2019,1.2650602409638554,1.9879518072289155
532,Nuno da Costa,CPV,FW,Strasbourg,Ligue 1,27,1991,22.8,39,27,10,19,10,10,38,26.3,28,24,1,23,14,53,9,0,0,2018-2019,0.6140350877192983,1.7105263157894737
533,David Costas,ESP,DF,Celta Vigo,La Liga,23,1995,13.0,25,13,21,4,0,10,15,66.7,5,12,6,6,18,43,58,1,0,2018-2019,1.3846153846153846,1.9230769230769231
534,Benoît Costil,FRA,GK,Bordeaux,Ligue 1,31,1987,37.0,2,0,2,0,0,2,2,100.0,0,0,0,0,0,2,14,3,0,2018-2019,0.0,0.05405405405405406
535,Kalifa Coulibaly,MLI,FW,Nantes,Ligue 1,26,1991,19.5,15,7,1,10,4,4,11,36.4,7,8,1,7,4,19,22,0,0,2018-2019,0.20512820512820512,0.7692307692307693
536,Senou Coulibaly,MLI,DF,Dijon,Ligue 1,23,1994,4.6,13,7,10,3,0,3,8,37.5,5,8,2,6,11,24,20,0,0,2018-2019,2.3913043478260874,2.8260869565217392
537,Thibaut Courtois,BEL,GK,Real Madrid,La Liga,26,1992,27.0,0,0,0,0,0,0,2,0.0,2,0,0,0,2,2,5,0,0,2018-2019,0.07407407407407407,0.0
538,Philippe Coutinho,BRA,"FW,MF",Barcelona,La Liga,26,1992,22.4,16,11,1,6,9,7,22,31.8,15,21,2,19,12,28,8,0,0,2018-2019,0.5357142857142857,0.7142857142857143
539,Nicolas Cozza,FRA,DF,Montpellier,Ligue 1,19,1999,10.9,19,15,14,5,0,4,10,40.0,6,13,10,3,23,42,37,1,0,2018-2019,2.110091743119266,1.7431192660550459
540,Alessio Cragno,ITA,GK,Cagliari,Serie A,24,1994,38.0,0,0,0,0,0,0,1,0.0,1,0,0,0,2,2,19,1,0,2018-2019,0.05263157894736842,0.0
541,Aaron Cresswell,ENG,DF,West Ham,Premier League,28,1989,17.7,29,16,14,11,4,13,25,52.0,12,28,7,21,23,52,58,0,0,2018-2019,1.2994350282485876,1.6384180790960452
542,Domenico Criscito,ITA,DF,Genoa,Serie A,31,1986,34.1,111,75,64,36,11,57,83,68.7,26,40,11,29,70,181,142,0,0,2018-2019,2.0527859237536656,3.255131964809384
543,Lorenzo Crisetig,ITA,MF,Frosinone,Serie A,25,1993,5.6,14,11,4,8,2,6,15,40.0,9,8,3,5,12,26,12,0,0,2018-2019,2.142857142857143,2.5
544,Bryan Cristante,ITA,MF,Roma,Serie A,23,1995,26.9,63,34,21,35,7,19,49,38.8,30,37,5,32,29,92,48,0,0,2018-2019,1.0780669144981414,2.342007434944238
545,Sebastián Cristóforo,URU,MF,Getafe,La Liga,24,1993,5.0,15,8,4,8,3,5,14,35.7,9,13,0,13,8,23,5,0,0,2018-2019,1.6,3.0
546,Enzo Crivelli,FRA,FW,Caen,Ligue 1,23,1995,25.1,20,14,10,8,2,8,13,61.5,5,5,0,5,4,24,28,1,0,2018-2019,0.1593625498007968,0.796812749003984
547,Peter Crouch,ENG,FW,Burnley,Premier League,37,1981,1.0,1,1,0,1,0,1,1,100.0,0,0,0,0,0,1,2,0,0,2018-2019,0.0,1.0
548,Alessio da Cruz,,"FW,MF",Parma,Serie A,21,1997,1.6,2,1,0,2,0,0,1,0.0,1,0,0,0,0,2,0,0,0,2018-2019,0.0,1.25
549,Juan Cuadrado,COL,"MF,DF",Juventus,Serie A,30,1988,13.6,20,15,6,9,5,5,23,21.7,18,14,3,11,18,38,11,0,0,2018-2019,1.3235294117647058,1.4705882352941178
550,Cucho,COL,FW,Huesca,La Liga,19,1999,23.9,22,13,6,10,6,6,18,33.3,12,23,2,21,9,31,21,0,0,2018-2019,0.3765690376569038,0.9205020920502093
Rk,Player,Nation,Pos,Squad,Comp,0,0,90.0,0,0,3,3,3,Tkl,0,0.0,0,0,0,0,0,0,0,0,0,2018-2019,0.0,0.0
551,Marc Cucurella,ESP,"MF,FW",Eibar,La Liga,20,1998,26.2,49,37,13,21,15,10,23,43.5,13,36,3,33,20,69,24,0,0,2018-2019,0.7633587786259542,1.870229007633588
552,Iván Cuéllar,ESP,GK,Leganés,La Liga,34,1984,33.9,0,0,0,0,0,0,1,0.0,1,0,0,0,2,2,10,0,0,2018-2019,0.058997050147492625,0.0
553,Mickaël Cuisance,FRA,MF,Gladbach,Bundesliga,18,1999,3.1,11,6,6,3,2,3,8,37.5,5,3,0,3,5,16,4,0,0,2018-2019,1.6129032258064515,3.5483870967741935
554,Matheus Cunha,BRA,"FW,MF",RB Leipzig,Bundesliga,19,1999,9.5,10,6,3,5,2,3,13,23.1,10,13,1,12,4,14,8,0,0,2018-2019,0.42105263157894735,1.0526315789473684
555,Greg Cunningham,IRL,DF,Cardiff City,Premier League,27,1991,7.0,18,7,11,4,3,9,16,56.3,7,9,3,6,17,35,16,1,0,2018-2019,2.4285714285714284,2.5714285714285716
556,Patrick Cutrone,ITA,FW,Milan,Serie A,20,1998,16.2,9,5,0,3,6,2,16,12.5,14,13,2,11,7,16,13,0,0,2018-2019,0.4320987654320988,0.5555555555555556
557,Wylan Cyprien,FRA,MF,Nice,Ligue 1,23,1995,26.2,40,20,16,21,3,15,43,34.9,28,20,5,15,11,51,15,0,0,2018-2019,0.41984732824427484,1.5267175572519085
558,Marco D'Alessandro,ITA,DF,Udinese,Serie A,27,1991,16.6,55,34,34,15,6,29,49,59.2,20,24,2,22,9,64,50,1,0,2018-2019,0.5421686746987951,3.3132530120481927
559,Danilo D'Ambrosio,ITA,DF,Inter,Serie A,29,1988,28.7,69,40,34,27,8,24,57,42.1,33,25,8,17,27,96,39,0,0,2018-2019,0.9407665505226481,2.40418118466899
560,Damien Da Silva,FRA,DF,Rennes,Ligue 1,30,1988,31.9,41,25,31,9,1,18,24,75.0,6,42,36,6,39,80,152,0,0,2018-2019,1.2225705329153607,1.2852664576802508
561,Kouadio-Yves Dabila,CIV,DF,Lille,Ligue 1,21,1997,8.7,11,6,10,1,0,5,6,83.3,1,13,9,4,6,17,44,0,0,2018-2019,0.6896551724137931,1.264367816091954
562,Abdoulaye Dabo,FRA,FW,Nantes,Ligue 1,17,2001,1.3,3,1,1,0,2,0,0,0.0,0,0,0,0,0,3,0,0,0,2018-2019,0.0,2.3076923076923075
563,Bryan Dabo,BFA,"MF,DF",Fiorentina,Serie A,26,1992,9.2,10,6,1,8,1,1,6,16.7,5,11,6,5,10,20,21,0,0,2018-2019,1.0869565217391306,1.0869565217391306
564,Christoph Daferner,GER,FW,Freiburg,Bundesliga,20,1998,0.3,1,0,1,0,0,0,0,0.0,0,0,0,0,1,2,0,0,0,2018-2019,3.3333333333333335,3.3333333333333335
565,Colin Dagba,FRA,"DF,MF",Paris S-G,Ligue 1,19,1998,10.2,24,12,10,12,2,13,19,68.4,6,10,0,10,9,33,10,1,0,2018-2019,0.8823529411764707,2.3529411764705883
566,Mahmoud Dahoud,GER,MF,Dortmund,Bundesliga,22,1996,7.7,16,10,4,10,2,3,15,20.0,12,10,0,10,17,33,8,0,0,2018-2019,2.207792207792208,2.0779220779220777
567,Leon Dajaku,GER,"DF,MF",Stuttgart,Bundesliga,17,2001,0.3,2,1,0,1,1,0,0,0.0,0,1,0,1,0,2,0,0,0,2018-2019,0.0,6.666666666666667
568,Felipe dal Belo,BRA,DF,SPAL,Serie A,34,1984,26.2,36,25,21,13,2,16,32,50.0,16,29,18,11,17,53,88,1,0,2018-2019,0.648854961832061,1.3740458015267176
569,Nicola Dalmonte,ITA,"FW,MF",Genoa,Serie A,20,1997,0.5,2,2,0,2,0,0,0,0.0,0,0,0,0,0,2,0,0,0,2018-2019,0.0,4.0
570,Diogo Dalot,POR,"DF,FW",Manchester Utd,Premier League,19,1999,11.3,24,12,8,14,2,14,19,73.7,5,15,2,13,10,34,35,1,0,2018-2019,0.8849557522123893,2.1238938053097343
571,Matty Daly,ENG,MF,Huddersfield,Premier League,17,2001,0.8,0,0,0,0,0,0,0,0.0,0,0,0,0,0,0,0,0,0,2018-2019,0.0,0.0
572,Vitalie Damașcan,MDA,MF,Torino,Serie A,19,1999,0.0,1,1,0,1,0,1,1,100.0,0,0,0,0,0,1,0,0,0,2018-2019,,inf
573,Loïc Damour,FRA,MF,Cardiff City,Premier League,27,1991,0.3,0,0,0,0,0,0,1,0.0,1,0,0,0,0,0,0,0,0,2018-2019,0.0,0.0
574,Charlie Daniels,ENG,DF,Bournemouth,Premier League,31,1986,17.6,25,15,18,6,1,13,22,59.1,9,14,4,10,20,45,56,2,0,2018-2019,1.1363636363636362,1.4204545454545454
575,Danilo,BRA,DF,Manchester City,Premier League,27,1991,9.0,20,16,6,12,2,12,17,70.6,5,5,0,5,15,35,22,1,0,2018-2019,1.6666666666666667,2.2222222222222223
Rk,Player,Nation,Pos,Squad,Comp,0,0,90.0,0,0,3,3,3,Tkl,0,0.0,0,0,0,0,0,0,0,0,0,2018-2019,0.0,0.0
576,Scott Dann,ENG,DF,Crystal Palace,Premier League,31,1987,7.4,6,2,5,1,0,3,7,42.9,4,16,12,4,5,11,46,0,0,2018-2019,0.6756756756756757,0.8108108108108107
577,Kevin Danso,AUT,DF,Augsburg,Bundesliga,19,1998,13.9,25,14,21,3,1,11,14,78.6,3,25,17,8,19,44,72,0,0,2018-2019,1.3669064748201438,1.7985611510791366
578,Dante,BRA,DF,Nice,Ligue 1,34,1983,35.8,54,40,36,16,2,24,41,58.5,17,56,30,26,38,92,156,2,0,2018-2019,1.0614525139664805,1.5083798882681565
579,Palkó Dárdai,HUN,"FW,MF",Hertha BSC,Bundesliga,19,1999,1.3,1,1,1,0,0,0,0,0.0,0,1,0,1,0,1,0,0,0,2018-2019,0.0,0.7692307692307692
580,Sergi Darder,ESP,MF,Espanyol,La Liga,24,1993,30.1,60,35,23,32,5,25,69,36.2,44,18,3,15,22,82,30,0,0,2018-2019,0.7308970099667774,1.9933554817275747
581,Vladimír Darida,CZE,MF,Hertha BSC,Bundesliga,27,1990,4.2,8,5,3,4,1,2,3,66.7,1,5,0,5,8,16,5,0,0,2018-2019,1.9047619047619047,1.9047619047619047
582,Matteo Darmian,ITA,DF,Manchester Utd,Premier League,28,1989,4.9,14,8,10,4,0,4,11,36.4,7,9,0,9,7,21,20,0,0,2018-2019,1.4285714285714284,2.8571428571428568
583,Alphonso Davies,CAN,"MF,FW",Bayern Munich,Bundesliga,17,2000,0.9,1,1,1,0,0,0,0,0.0,0,2,0,2,2,3,1,0,0,2018-2019,2.2222222222222223,1.1111111111111112
584,Ben Davies,WAL,DF,Tottenham,Premier League,25,1993,20.5,56,30,39,13,4,38,54,70.4,16,23,10,13,23,79,68,1,0,2018-2019,1.1219512195121952,2.731707317073171
585,Tom Davies,ENG,MF,Everton,Premier League,20,1998,10.9,27,17,9,17,1,7,23,30.4,16,15,1,14,16,43,9,1,0,2018-2019,1.4678899082568806,2.477064220183486
586,Steven Davis,NIR,MF,Southampton,Premier League,33,1985,1.1,2,2,0,2,0,0,0,0.0,0,2,0,2,1,3,5,0,0,2018-2019,0.9090909090909091,1.8181818181818181
587,Kevin De Bruyne,BEL,MF,Manchester City,Premier League,27,1991,10.8,22,15,6,12,4,7,21,33.3,14,13,1,12,3,25,2,1,0,2018-2019,0.27777777777777773,2.0370370370370368
588,Sebastien De Maio,FRA,DF,Udinese,Serie A,31,1987,13.0,11,7,7,4,0,3,12,25.0,9,22,17,5,12,23,93,0,0,2018-2019,0.9230769230769231,0.8461538461538461
589,Sebastien De Maio,FRA,DF,Bologna,Serie A,31,1987,5.5,5,4,3,2,0,1,2,50.0,1,8,5,3,1,6,32,0,0,2018-2019,0.18181818181818182,0.9090909090909091
590,Rodrigo De Paul,ARG,"MF,FW",Udinese,Serie A,24,1994,35.4,53,33,21,27,5,13,42,31.0,29,35,2,33,32,85,28,0,0,2018-2019,0.903954802259887,1.497175141242938
591,Daniele De Rossi,ITA,MF,Roma,Serie A,35,1983,14.1,16,10,6,7,3,3,14,21.4,11,18,12,6,26,42,33,0,0,2018-2019,1.8439716312056738,1.1347517730496455
592,Mattia De Sciglio,ITA,DF,Juventus,Serie A,25,1992,19.4,40,28,24,14,2,17,28,60.7,11,18,6,12,26,66,58,1,0,2018-2019,1.3402061855670104,2.061855670103093
593,Lorenzo De Silvestri,ITA,DF,Torino,Serie A,30,1988,26.8,15,11,8,5,2,7,24,29.2,17,53,3,50,22,37,69,2,0,2018-2019,0.8208955223880596,0.5597014925373134
594,Lucas Deaux,FRA,MF,Guingamp,Ligue 1,29,1988,13.2,41,28,21,18,2,20,41,48.8,21,10,0,10,11,52,7,0,0,2018-2019,0.8333333333333334,3.1060606060606064
595,Mathieu Debuchy,FRA,DF,Saint-Étienne,Ligue 1,33,1985,21.6,43,26,25,13,5,22,37,59.5,15,17,7,10,47,90,64,0,0,2018-2019,2.1759259259259256,1.9907407407407407
596,Troy Deeney,ENG,FW,Watford,Premier League,30,1988,28.3,24,14,8,10,6,7,32,21.9,25,22,4,18,7,31,29,0,0,2018-2019,0.24734982332155475,0.8480565371024735
597,Jermain Defoe,ENG,FW,Bournemouth,Premier League,35,1982,0.3,0,0,0,0,0,0,0,0.0,0,0,0,0,0,0,0,0,0,2018-2019,0.0,0.0
598,Steven Defour,BEL,MF,Burnley,Premier League,30,1988,5.0,8,4,2,4,2,3,14,21.4,11,11,3,8,8,16,7,0,0,2018-2019,1.6,1.6
599,Grégoire Defrel,MTQ,"FW,MF",Sampdoria,Serie A,27,1991,26.0,40,29,10,16,14,9,21,42.9,12,15,0,15,3,43,9,0,0,2018-2019,0.11538461538461539,1.5384615384615385
600,Alessandro Deiola,ITA,MF,Cagliari,Serie A,22,1995,5.0,7,3,1,6,0,3,13,23.1,10,14,0,14,6,13,8,0,0,2018-2019,1.2,1.4
Rk,Player,Nation,Pos,Squad,Comp,0,0,90.0,0,0,3,3,3,Tkl,0,0.0,0,0,0,0,0,0,0,0,0,2018-2019,0.0,0.0
601,Alessandro Deiola,ITA,"MF,FW",Parma,Serie A,22,1995,6.1,12,8,4,7,1,4,10,40.0,6,15,4,11,11,23,10,0,0,2018-2019,1.8032786885245902,1.9672131147540985
602,Romain Del Castillo,FRA,"MF,FW",Rennes,Ligue 1,22,1996,14.9,36,20,15,13,8,13,37,35.1,24,19,0,19,20,56,7,1,0,2018-2019,1.342281879194631,2.4161073825503356
603,Thomas Delaney,DEN,MF,Dortmund,Bundesliga,26,1991,25.4,69,54,28,39,2,19,30,63.3,11,30,9,21,58,127,43,0,0,2018-2019,2.283464566929134,2.716535433070866
604,Moisés Delgado,ESP,DF,Valladolid,La Liga,24,1994,3.0,7,6,3,3,1,2,3,66.7,1,2,1,1,3,10,9,0,0,2018-2019,1.0,2.3333333333333335
605,Cristian Dell'Orco,ITA,DF,Empoli,Serie A,24,1994,11.5,18,11,11,5,2,4,11,36.4,7,13,7,6,17,35,44,0,0,2018-2019,1.4782608695652173,1.565217391304348
606,Cristian Dell'Orco,ITA,DF,Sassuolo,Serie A,24,1994,1.2,1,1,1,0,0,1,3,33.3,2,1,0,1,1,2,3,0,0,2018-2019,0.8333333333333334,0.8333333333333334
607,Andy Delort,ALG,FW,Montpellier,Ligue 1,26,1991,34.6,34,20,7,20,7,8,34,23.5,26,28,7,21,4,38,7,0,0,2018-2019,0.11560693641618497,0.9826589595375722
608,Fabian Delph,ENG,DF,Manchester City,Premier League,28,1989,8.1,23,14,11,7,5,12,23,52.2,11,3,0,3,13,36,19,1,0,2018-2019,1.6049382716049383,2.8395061728395063
609,Mousa Dembélé,BEL,MF,Tottenham,Premier League,31,1987,5.7,13,9,6,6,1,4,7,57.1,3,4,1,3,7,20,5,2,0,2018-2019,1.2280701754385965,2.280701754385965
610,Moussa Dembélé,FRA,FW,Lyon,Ligue 1,22,1996,22.4,12,4,0,8,4,4,14,28.6,10,15,2,13,2,14,13,0,0,2018-2019,0.08928571428571429,0.5357142857142857
611,Ousmane Dembélé,FRA,"FW,MF",Barcelona,La Liga,21,1997,18.5,23,15,4,13,6,6,18,33.3,12,13,0,13,5,28,4,0,0,2018-2019,0.2702702702702703,1.2432432432432432
612,Jessy Deminguet,FRA,MF,Caen,Ligue 1,20,1998,14.1,37,25,18,17,2,15,40,37.5,25,19,3,16,18,55,28,1,0,2018-2019,1.2765957446808511,2.624113475177305
613,Merih Demiral,TUR,DF,Sassuolo,Serie A,20,1998,14.0,24,16,23,1,0,10,13,76.9,3,16,11,5,19,43,80,0,0,2018-2019,1.3571428571428572,1.7142857142857142
614,Kerem Demirbay,GER,MF,Hoffenheim,Bundesliga,25,1993,22.4,57,35,20,27,10,11,51,21.6,40,34,10,24,22,79,25,0,0,2018-2019,0.9821428571428572,2.544642857142857
615,Diego Demme,GER,MF,RB Leipzig,Bundesliga,26,1991,22.8,75,47,24,43,8,33,67,49.3,34,36,3,33,26,101,15,0,0,2018-2019,1.1403508771929824,3.289473684210526
616,Jason Denayer,BEL,DF,Lyon,Ligue 1,23,1995,30.6,33,21,22,11,0,16,24,66.7,8,36,32,4,26,59,122,1,0,2018-2019,0.8496732026143791,1.0784313725490196
617,Leander Dendoncker,BEL,MF,Wolves,Premier League,23,1995,16.3,53,26,25,25,3,16,47,34.0,31,35,6,29,23,76,34,1,0,2018-2019,1.411042944785276,3.2515337423312882
618,Fabio Depaoli,ITA,DF,Chievo,Serie A,21,1997,27.4,74,43,37,32,5,34,67,50.7,33,42,16,26,35,109,99,3,0,2018-2019,1.2773722627737227,2.7007299270072993
619,Laurent Depoitre,BEL,FW,Huddersfield,Premier League,29,1988,11.9,6,4,2,3,1,0,3,0.0,3,9,0,9,2,8,8,0,0,2018-2019,0.1680672268907563,0.5042016806722689
620,Clément Depres,FRA,FW,Nîmes,Ligue 1,23,1994,4.9,2,2,1,1,0,1,4,25.0,3,3,0,3,0,2,6,0,0,2018-2019,0.0,0.4081632653061224
621,Kiril Despodov,BUL,"FW,MF",Cagliari,Serie A,21,1996,1.2,0,0,0,0,0,0,1,0.0,1,1,0,1,0,0,0,0,0,2018-2019,0.0,0.0
622,Daniele Dessena,ITA,MF,Cagliari,Serie A,31,1987,3.9,2,2,0,2,0,1,3,33.3,2,3,1,2,3,5,5,0,0,2018-2019,0.7692307692307693,0.5128205128205129
623,Mattia Destro,ITA,FW,Bologna,Serie A,27,1991,5.5,3,2,2,0,1,0,0,0.0,0,4,0,4,0,3,6,0,0,2018-2019,0.0,0.5454545454545454
624,Gerard Deulofeu,ESP,"FW,MF",Watford,Premier League,24,1994,23.0,11,6,5,3,3,4,26,15.4,22,16,0,16,14,25,3,0,0,2018-2019,0.6086956521739131,0.4782608695652174
625,Jacopo Dezi,ITA,MF,Parma,Serie A,26,1992,1.0,1,1,1,0,0,0,1,0.0,1,1,0,1,3,4,2,0,0,2018-2019,3.0,1.0
Rk,Player,Nation,Pos,Squad,Comp,0,0,90.0,0,0,3,3,3,Tkl,0,0.0,0,0,0,0,0,0,0,0,0,2018-2019,0.0,0.0
626,Federico Di Francesco,ITA,"FW,MF",Sassuolo,Serie A,24,1994,11.9,10,6,3,4,3,4,7,57.1,3,12,1,11,5,15,5,0,0,2018-2019,0.42016806722689076,0.8403361344537815
627,Antonio Di Gaudio,ITA,FW,Parma,Serie A,28,1989,7.8,2,0,0,1,1,1,5,20.0,4,6,1,5,3,5,5,0,0,2018-2019,0.38461538461538464,0.25641025641025644
628,Giovanni Di Lorenzo,ITA,"DF,FW",Empoli,Serie A,24,1993,37.0,66,43,38,23,5,24,44,54.5,20,34,13,21,36,102,93,3,0,2018-2019,0.972972972972973,1.7837837837837838
629,Ángel Di María,ARG,"FW,MF",Paris S-G,Ligue 1,30,1988,25.8,29,17,12,10,7,10,42,23.8,32,24,1,23,16,45,4,0,0,2018-2019,0.6201550387596899,1.124031007751938
630,Franco Di Santo,ARG,FW,Rayo Vallecano,La Liga,29,1989,1.9,2,2,1,0,1,1,2,50.0,1,0,0,0,0,2,2,0,0,2018-2019,0.0,1.0526315789473684
631,Franco Di Santo,ARG,"MF,FW",Schalke 04,Bundesliga,29,1989,2.7,2,1,0,2,0,1,4,25.0,3,3,1,2,1,3,3,0,0,2018-2019,0.37037037037037035,0.7407407407407407
632,Boulaye Dia,SEN,FW,Reims,Ligue 1,21,1996,8.3,12,6,3,8,1,5,11,45.5,6,4,2,2,4,16,9,0,0,2018-2019,0.48192771084337344,1.4457831325301203
633,Fousseni Diabaté,MLI,FW,Leicester City,Premier League,22,1995,0.6,2,0,2,0,0,0,1,0.0,1,2,0,2,0,2,0,0,0,2018-2019,0.0,3.3333333333333335
634,Moussa Diaby,FRA,"MF,DF",Paris S-G,Ligue 1,19,1999,12.7,14,8,7,2,5,2,11,18.2,9,7,1,6,12,26,6,0,0,2018-2019,0.9448818897637796,1.1023622047244095
635,Adama Diakhaby,FRA,"FW,MF",Huddersfield,Premier League,22,1996,6.1,6,3,4,1,1,3,11,27.3,8,7,0,7,1,7,2,0,0,2018-2019,0.1639344262295082,0.9836065573770493
636,Mouctar Diakhaby,GUI,DF,Valencia,La Liga,21,1996,17.6,14,8,10,4,0,5,10,50.0,5,24,16,8,20,34,94,1,0,2018-2019,1.1363636363636362,0.7954545454545454
637,Bafodé Diakité,FRA,DF,Toulouse,Ligue 1,17,2001,7.0,15,7,5,9,1,10,14,71.4,4,15,3,12,11,26,29,0,0,2018-2019,1.5714285714285714,2.142857142857143
638,Abdou Diallo,SEN,DF,Dortmund,Bundesliga,22,1996,26.4,36,20,20,13,3,11,15,73.3,4,28,15,13,26,62,91,1,0,2018-2019,0.9848484848484849,1.3636363636363638
639,Abdoulaye Diallo,SEN,GK,Rennes,Ligue 1,26,1992,5.5,1,1,1,0,0,1,1,100.0,0,0,0,0,0,1,1,0,0,2018-2019,0.0,0.18181818181818182
640,Mustapha Diallo,SEN,MF,Nîmes,Ligue 1,32,1986,5.1,16,11,6,9,1,5,13,38.5,8,7,1,6,10,26,14,1,0,2018-2019,1.9607843137254903,3.1372549019607847
641,Mohamed Diamé,SEN,MF,Newcastle Utd,Premier League,31,1987,24.1,76,46,35,36,5,16,54,29.6,38,42,9,33,30,106,39,1,0,2018-2019,1.2448132780082988,3.1535269709543567
642,Grady Diangana,COD,"MF,FW",West Ham,Premier League,20,1998,6.8,20,9,8,8,4,5,14,35.7,9,11,0,11,1,21,4,0,0,2018-2019,0.14705882352941177,2.9411764705882355
643,Lassana Diarra,FRA,MF,Paris S-G,Ligue 1,33,1985,1.8,2,1,0,2,0,0,1,0.0,1,0,0,0,2,4,3,0,0,2018-2019,1.1111111111111112,1.1111111111111112
644,Amadou Diawara,GUI,MF,Napoli,Serie A,21,1997,7.3,12,4,1,9,2,4,5,80.0,1,6,0,6,11,23,12,0,0,2018-2019,1.5068493150684932,1.6438356164383563
645,Brahim Díaz,MAR,FW,Real Madrid,La Liga,18,1999,4.2,9,7,5,4,0,3,8,37.5,5,2,0,2,0,9,0,0,0,2018-2019,0.0,2.142857142857143
646,Javier Díaz,ESP,GK,Sevilla,La Liga,21,1997,1.0,0,0,0,0,0,0,0,0.0,0,0,0,0,0,0,0,0,0,2018-2019,0.0,0.0
647,Bakaye Dibassy,MLI,DF,Amiens,Ligue 1,28,1989,32.7,38,26,18,16,4,18,27,66.7,9,40,21,19,44,82,102,0,0,2018-2019,1.3455657492354738,1.162079510703364
648,Lorenzo Dickmann,ITA,"DF,MF",SPAL,Serie A,21,1996,1.9,5,4,4,1,0,5,7,71.4,2,0,0,0,1,6,5,0,0,2018-2019,0.5263157894736842,2.6315789473684212
649,Daniel Didavi,GER,"MF,FW",Stuttgart,Bundesliga,28,1990,10.6,21,15,8,10,3,7,20,35.0,13,11,1,10,4,25,5,0,0,2018-2019,0.37735849056603776,1.9811320754716981
650,Étienne Didot,FRA,MF,Guingamp,Ligue 1,35,1983,23.4,41,29,12,27,2,17,44,38.6,27,37,10,27,37,78,35,0,0,2018-2019,1.5811965811965814,1.7521367521367524
Rk,Player,Nation,Pos,Squad,Comp,0,0,90.0,0,0,3,3,3,Tkl,0,0.0,0,0,0,0,0,0,0,0,0,2018-2019,0.0,0.0
651,Adrián Diéguez,ESP,DF,Huesca,La Liga,22,1996,8.3,16,10,11,4,1,9,16,56.3,7,9,4,5,12,28,46,1,0,2018-2019,1.4457831325301203,1.9277108433734937
652,Eric Dier,ENG,"MF,DF",Tottenham,Premier League,24,1994,16.7,26,16,7,15,4,19,47,40.4,28,27,12,15,21,47,46,1,0,2018-2019,1.25748502994012,1.5568862275449102
653,Tim Dierßen,GER,MF,Hannover 96,Bundesliga,22,1996,0.2,0,0,0,0,0,0,0,0.0,0,1,0,1,0,0,0,0,0,2018-2019,0.0,0.0
654,Lucas Digne,FRA,DF,Everton,Premier League,25,1993,32.9,71,46,45,18,8,28,45,62.2,17,43,9,34,60,131,116,0,0,2018-2019,1.8237082066869301,2.1580547112462005
655,Mitchell Dijks,NED,DF,Bologna,Serie A,25,1993,22.5,30,18,19,7,4,13,36,36.1,23,18,1,17,23,53,49,0,0,2018-2019,1.0222222222222221,1.3333333333333333
656,Javairô Dilrosun,NED,"FW,MF",Hertha BSC,Bundesliga,20,1998,10.0,14,10,7,5,2,3,7,42.9,4,18,2,16,7,21,9,0,0,2018-2019,0.7,1.4
657,Federico Dimarco,ITA,"DF,MF",Parma,Serie A,20,1997,9.9,22,7,10,8,4,10,20,50.0,10,13,6,7,15,37,27,0,0,2018-2019,1.5151515151515151,2.2222222222222223
658,Stole Dimitrievski,MKD,GK,Rayo Vallecano,La Liga,24,1993,21.0,0,0,0,0,0,0,1,0.0,1,0,0,0,0,0,8,1,0,2018-2019,0.0,0.0
659,Tristan Dingomé,CMR,MF,Reims,Ligue 1,27,1991,14.9,27,15,11,10,6,7,24,29.2,17,16,3,13,11,38,5,0,0,2018-2019,0.7382550335570469,1.8120805369127517
660,Ismaël Diomandé,CIV,"MF,DF",Caen,Ligue 1,25,1992,14.4,28,15,15,12,1,11,20,55.0,9,17,7,10,10,38,37,0,0,2018-2019,0.6944444444444444,1.9444444444444444
661,Federico Dionisi,ITA,"FW,MF",Frosinone,Serie A,31,1987,2.3,3,1,0,2,1,0,2,0.0,2,0,0,0,0,3,0,0,0,2018-2019,0.0,1.3043478260869565
662,Lois Diony,FRA,FW,Saint-Étienne,Ligue 1,25,1992,17.7,17,12,3,9,5,4,10,40.0,6,14,0,14,1,18,9,0,0,2018-2019,0.05649717514124294,0.96045197740113
663,Issa Diop,FRA,DF,West Ham,Premier League,21,1997,33.0,68,38,47,21,0,37,57,64.9,20,58,36,22,64,132,161,4,0,2018-2019,1.9393939393939394,2.0606060606060606
664,Papakouli Diop,SEN,MF,Eibar,La Liga,32,1986,26.1,66,40,14,44,8,14,34,41.2,20,21,1,20,37,103,27,0,0,2018-2019,1.417624521072797,2.528735632183908
665,Sofiane Diop,FRA,"MF,FW",Monaco,Ligue 1,18,2000,8.2,12,7,3,6,3,1,15,6.7,14,6,0,6,8,20,6,0,0,2018-2019,0.9756097560975611,1.4634146341463417
666,Assane Dioussé,SEN,MF,Chievo,Serie A,20,1997,9.9,24,16,11,8,5,10,23,43.5,13,14,4,10,19,43,13,2,0,2018-2019,1.9191919191919191,2.4242424242424243
667,Assane Dioussé,SEN,MF,Saint-Étienne,Ligue 1,20,1997,2.4,6,4,3,3,0,2,4,50.0,2,2,0,2,1,7,7,1,0,2018-2019,0.4166666666666667,2.5
668,Axel Disasi,FRA,DF,Reims,Ligue 1,20,1998,1.8,2,1,1,1,0,1,2,50.0,1,2,1,1,2,4,16,0,0,2018-2019,1.1111111111111112,1.1111111111111112
669,Djené,TOG,DF,Getafe,La Liga,26,1991,33.1,54,34,43,11,0,26,43,60.5,17,27,11,16,74,128,154,3,0,2018-2019,2.2356495468277946,1.6314199395770392
670,Koffi Djidji,CIV,DF,Torino,Serie A,25,1992,15.4,37,23,27,9,1,12,20,60.0,8,26,19,7,24,61,72,1,0,2018-2019,1.5584415584415585,2.4025974025974026
671,Koffi Djidji,CIV,DF,Nantes,Ligue 1,25,1992,1.0,1,1,1,0,0,0,0,0.0,0,1,1,0,1,2,3,0,0,2018-2019,1.0,1.0
672,Alexander Djiku,GHA,DF,Caen,Ligue 1,23,1994,30.6,48,37,33,13,2,23,43,53.5,20,56,31,25,83,131,183,3,0,2018-2019,2.7124183006535945,1.5686274509803921
673,Papy Djilobodji,SEN,DF,Guingamp,Ligue 1,29,1988,1.9,1,1,1,0,0,0,0,0.0,0,4,2,2,0,1,11,0,0,2018-2019,0.0,0.5263157894736842
674,Berat Djimsiti,ALB,DF,Atalanta,Serie A,25,1993,20.1,32,22,18,12,2,13,29,44.8,16,21,11,10,34,66,96,0,0,2018-2019,1.6915422885572138,1.5920398009950247
675,Johan Djourou,SUI,DF,SPAL,Serie A,31,1987,3.1,3,1,3,0,0,2,2,100.0,0,5,3,2,4,7,20,0,0,2018-2019,1.2903225806451613,0.9677419354838709
Rk,Player,Nation,Pos,Squad,Comp,0,0,90.0,0,0,3,3,3,Tkl,0,0.0,0,0,0,0,0,0,0,0,0,2018-2019,0.0,0.0
676,Marko Dmitrović,SRB,GK,Eibar,La Liga,26,1992,24.0,0,0,0,0,0,0,0,0.0,0,0,0,0,2,2,11,3,0,2018-2019,0.08333333333333333,0.0
677,Matt Doherty,IRL,"DF,MF",Wolves,Premier League,26,1992,34.9,67,42,48,15,4,35,58,60.3,23,49,7,42,60,127,107,2,0,2018-2019,1.7191977077363898,1.9197707736389686
678,Keagan Dolly,RSA,FW,Montpellier,Ligue 1,25,1993,1.0,1,1,0,1,0,0,3,0.0,3,0,0,0,0,1,0,0,0,2018-2019,0.0,1.0
679,Jaume Doménech,ESP,GK,Valencia,La Liga,27,1990,4.0,0,0,0,0,0,0,1,0.0,1,0,0,0,0,0,1,0,0,2018-2019,0.0,0.0
680,Giulio Donati,ITA,DF,Mainz 05,Bundesliga,28,1990,6.9,9,7,6,3,0,8,10,80.0,2,5,3,2,16,25,24,0,0,2018-2019,2.318840579710145,1.3043478260869565
681,Ji Dong-won,KOR,"MF,FW",Augsburg,Bundesliga,27,1991,9.9,10,6,5,3,2,6,16,37.5,10,13,2,11,8,18,10,0,0,2018-2019,0.8080808080808081,1.0101010101010102
682,Anastasios Donis,GRE,"FW,MF",Stuttgart,Bundesliga,21,1996,10.7,15,13,8,4,3,3,11,27.3,8,7,0,7,4,19,0,0,0,2018-2019,0.3738317757009346,1.4018691588785048
683,Gianluigi Donnarumma,ITA,GK,Milan,Serie A,19,1999,34.3,1,1,1,0,0,1,2,50.0,1,0,0,0,1,2,13,3,0,2018-2019,0.02915451895043732,0.02915451895043732
684,Godfred Donsah,GHA,MF,Bologna,Serie A,22,1996,1.7,3,1,3,0,0,3,5,60.0,2,4,2,2,0,3,7,0,0,2018-2019,0.0,1.7647058823529411
685,Riccardo Doratiotto,ITA,FW,Cagliari,Serie A,19,1999,0.9,1,1,0,0,1,0,0,0.0,0,0,0,0,0,1,0,0,0,2018-2019,0.0,1.1111111111111112
686,Mathieu Dossevi,TOG,"FW,MF",Toulouse,Ligue 1,30,1988,27.4,42,28,20,11,11,13,40,32.5,27,29,1,28,33,75,13,0,0,2018-2019,1.2043795620437956,1.5328467153284673
687,Abdoulaye Doucouré,MLI,MF,Watford,Premier League,25,1993,34.0,71,38,27,32,12,19,57,33.3,38,31,8,23,34,105,55,5,0,2018-2019,1.0,2.088235294117647
688,Cheick Doukouré,CIV,MF,Levante,La Liga,25,1992,3.5,13,7,3,7,3,4,15,26.7,11,10,2,8,3,16,3,1,0,2018-2019,0.8571428571428571,3.7142857142857144
689,Moussa Doumbia,MLI,"FW,MF",Reims,Ligue 1,23,1994,17.8,28,13,13,13,2,11,39,28.2,28,7,2,5,7,35,13,0,0,2018-2019,0.3932584269662921,1.5730337078651684
690,Seydou Doumbia,CIV,FW,Girona,La Liga,30,1987,6.0,5,1,1,2,2,0,2,0.0,2,2,0,2,3,8,1,0,0,2018-2019,0.5,0.8333333333333334
691,Souleyman Doumbia,CIV,DF,Rennes,Ligue 1,21,1996,6.7,11,7,9,2,0,6,10,60.0,4,6,1,5,4,15,20,0,0,2018-2019,0.5970149253731343,1.6417910447761193
692,Aleksandar Dragović,AUT,DF,Leverkusen,Bundesliga,27,1991,14.8,18,12,14,4,0,9,14,64.3,5,15,8,7,25,43,66,0,0,2018-2019,1.689189189189189,1.2162162162162162
693,Bartłomiej Drągowski,POL,GK,Fiorentina,Serie A,20,1997,2.5,0,0,0,0,0,0,0,0.0,0,0,0,0,0,0,2,0,0,2018-2019,0.0,0.0
694,Bartłomiej Drągowski,POL,GK,Empoli,Serie A,20,1997,14.0,0,0,0,0,0,0,1,0.0,1,0,0,0,0,0,7,1,0,2018-2019,0.0,0.0
695,Julian Draxler,GER,"MF,FW",Paris S-G,Ligue 1,24,1993,22.7,41,22,11,19,11,16,43,37.2,27,20,1,19,15,56,2,1,0,2018-2019,0.6607929515418502,1.8061674008810573
696,Luke Dreher,ENG,FW,Crystal Palace,Premier League,19,1998,0.0,0,0,0,0,0,0,0,0.0,0,0,0,0,0,0,0,0,0,2018-2019,,
697,Josip Drmić,SUI,FW,Gladbach,Bundesliga,25,1992,2.5,2,0,0,2,0,1,2,50.0,1,1,0,1,1,3,0,0,0,2018-2019,0.4,0.8
698,Jaroslav Drobný,CZE,GK,Düsseldorf,Bundesliga,38,1979,2.0,0,0,0,0,0,0,0,0.0,0,0,0,0,0,0,1,0,0,2018-2019,0.0,0.0
699,Óscar Duarte,CRC,"DF,MF",Espanyol,La Liga,29,1989,7.3,12,5,7,5,0,4,7,57.1,3,7,7,0,13,25,34,0,0,2018-2019,1.7808219178082192,1.6438356164383563
700,Rubén Duarte,ESP,DF,Alavés,La Liga,22,1995,30.8,72,35,45,20,7,34,64,53.1,30,46,12,34,57,129,130,1,0,2018-2019,1.8506493506493507,2.3376623376623376
Rk,Player,Nation,Pos,Squad,Comp,0,0,90.0,0,0,3,3,3,Tkl,0,0.0,0,0,0,0,0,0,0,0,0,2018-2019,0.0,0.0
701,Leo Dubois,FRA,DF,Lyon,Ligue 1,23,1994,22.7,51,22,25,21,5,20,35,57.1,15,30,10,20,22,73,61,1,0,2018-2019,0.9691629955947136,2.246696035242291
702,Martin Dúbravka,SVK,GK,Newcastle Utd,Premier League,29,1989,38.0,2,0,2,0,0,1,3,33.3,2,0,0,0,0,2,20,5,0,2018-2019,0.0,0.05263157894736842
703,Marvin Ducksch,GER,FW,Düsseldorf,Bundesliga,24,1994,9.1,3,1,0,2,1,1,5,20.0,4,4,0,4,4,7,11,0,0,2018-2019,0.43956043956043955,0.32967032967032966
704,Ondrej Duda,SVK,MF,Hertha BSC,Bundesliga,23,1994,28.5,54,33,13,35,6,15,55,27.3,40,36,4,32,15,69,17,1,0,2018-2019,0.5263157894736842,1.894736842105263
705,Shane Duffy,IRL,DF,Brighton,Premier League,26,1992,34.3,35,20,23,7,5,14,25,56.0,11,57,47,10,36,71,244,3,0,2018-2019,1.0495626822157436,1.0204081632653061
706,Demeaco Duhaney,ENG,DF,Huddersfield,Premier League,19,1998,0.5,1,0,1,0,0,1,3,33.3,2,2,0,2,1,2,1,0,0,2018-2019,2.0,2.0
707,Paul Dummett,WAL,DF,Newcastle Utd,Premier League,26,1991,22.1,34,22,24,9,1,19,32,59.4,13,25,11,14,37,71,133,0,0,2018-2019,1.67420814479638,1.5384615384615383
708,Alfred Duncan,GHA,MF,Sassuolo,Serie A,25,1993,20.5,33,21,15,15,3,19,48,39.6,29,20,6,14,15,48,18,0,0,2018-2019,0.7317073170731707,1.6097560975609757
709,Lewis Dunk,ENG,DF,Brighton,Premier League,26,1991,35.0,42,26,31,10,1,17,39,43.6,22,49,38,11,46,88,196,5,0,2018-2019,1.3142857142857143,1.2
710,Maxime Dupé,FRA,GK,Nantes,Ligue 1,25,1993,10.4,0,0,0,0,0,0,0,0.0,0,0,0,0,0,0,3,1,0,2018-2019,0.0,0.0
711,Erik Durm,GER,DF,Huddersfield,Premier League,26,1992,22.8,35,22,24,8,3,14,33,42.4,19,26,6,20,41,76,42,0,0,2018-2019,1.7982456140350878,1.5350877192982455
712,Jimmy Durmaz,SWE,"MF,FW",Toulouse,Ligue 1,29,1989,21.1,34,22,8,13,13,15,38,39.5,23,14,2,12,11,45,16,1,0,2018-2019,0.5213270142180094,1.6113744075829384
713,Riza Durmisi,DEN,DF,Lazio,Serie A,24,1994,3.6,4,4,2,0,2,2,3,66.7,1,0,0,0,1,5,9,0,0,2018-2019,0.2777777777777778,1.1111111111111112
714,Hugo Duro,ESP,"MF,FW",Getafe,La Liga,18,1999,4.6,6,4,1,2,3,3,6,50.0,3,6,1,5,3,9,4,0,0,2018-2019,0.6521739130434783,1.3043478260869565
715,Raphael Dwamena,GHA,FW,Levante,La Liga,22,1995,2.5,0,0,0,0,0,0,0,0.0,0,2,1,1,0,0,2,0,0,2018-2019,0.0,0.0
716,Paulo Dybala,ARG,"FW,MF",Juventus,Serie A,24,1993,23.7,17,8,3,9,5,7,23,30.4,16,20,2,18,14,31,1,0,0,2018-2019,0.5907172995780591,0.7172995780590717
717,Edin Džeko,BIH,FW,Roma,Serie A,32,1986,28.7,13,7,3,5,5,4,16,25.0,12,10,1,9,0,13,36,1,0,2018-2019,0.0,0.4529616724738676
718,Blerim Džemaili,SUI,MF,Bologna,Serie A,32,1986,19.4,44,27,22,19,3,19,58,32.8,39,22,1,21,17,61,12,1,0,2018-2019,0.8762886597938145,2.2680412371134024
719,Félix Eboa Eboa,CMR,DF,Guingamp,Ligue 1,21,1997,27.0,47,33,26,20,1,16,22,72.7,6,37,24,13,39,86,136,2,0,2018-2019,1.4444444444444444,1.7407407407407407
720,Dennis Eckert,GER,FW,Celta Vigo,La Liga,21,1997,2.4,3,2,0,1,2,0,2,0.0,2,1,0,1,2,5,3,0,0,2018-2019,0.8333333333333334,1.25
721,Bruno Ecuele Manga,GAB,DF,Cardiff City,Premier League,30,1988,37.5,69,36,48,16,5,29,58,50.0,29,62,28,34,81,150,179,4,0,2018-2019,2.16,1.84
722,Simone Edera,ITA,MF,Torino,Serie A,21,1997,0.9,0,0,0,0,0,0,1,0.0,1,1,0,1,1,1,0,0,0,2018-2019,1.1111111111111112,0.0
723,Simone Edera,ITA,FW,Bologna,Serie A,21,1997,2.2,4,4,3,0,1,1,3,33.3,2,5,1,4,0,4,1,0,0,2018-2019,0.0,1.8181818181818181
724,Ederson,BRA,GK,Manchester City,Premier League,24,1993,38.0,3,3,2,1,0,3,3,100.0,0,0,0,0,1,4,12,2,0,2018-2019,0.02631578947368421,0.07894736842105263
725,Johannes Eggestein,GER,"FW,MF",Werder Bremen,Bundesliga,20,1998,12.4,13,9,7,4,2,5,19,26.3,14,13,0,13,4,17,7,0,0,2018-2019,0.3225806451612903,1.0483870967741935
Rk,Player,Nation,Pos,Squad,Comp,0,0,90.0,0,0,3,3,3,Tkl,0,0.0,0,0,0,0,0,0,0,0,0,2018-2019,0.0,0.0
726,Maximilian Eggestein,GER,MF,Werder Bremen,Bundesliga,21,1996,33.9,68,42,29,34,5,24,54,44.4,30,49,10,39,30,98,69,0,0,2018-2019,0.8849557522123894,2.0058997050147496
727,Albin Ekdal,SWE,MF,Sampdoria,Serie A,29,1989,29.4,61,39,16,38,7,37,68,54.4,31,42,12,30,53,114,62,1,0,2018-2019,1.8027210884353742,2.0748299319727894
728,Josip Elez,CRO,DF,Hannover 96,Bundesliga,24,1994,7.2,8,3,5,3,0,2,11,18.2,9,13,4,9,6,14,27,0,0,2018-2019,0.8333333333333333,1.1111111111111112
729,Harvey Elliott,ENG,MF,Fulham,Premier League,15,2003,0.2,0,0,0,0,0,0,0,0.0,0,1,0,1,0,0,0,0,0,2018-2019,0.0,0.0
730,Mohamed Elneny,EGY,MF,Arsenal,Premier League,26,1992,4.2,13,4,9,1,3,1,2,50.0,1,7,4,3,2,15,8,0,0,2018-2019,0.47619047619047616,3.095238095238095
731,Aritz Elustondo,ESP,DF,Real Sociedad,La Liga,24,1994,25.0,47,29,31,14,2,26,41,63.4,15,23,7,16,39,86,150,0,0,2018-2019,1.56,1.88
732,Gorka Elustondo,ESP,"MF,DF",Rayo Vallecano,La Liga,31,1987,3.2,7,5,4,3,0,5,8,62.5,3,6,1,5,6,13,10,0,0,2018-2019,1.875,2.1875
733,Nico Elvedi,SUI,DF,Gladbach,Bundesliga,21,1996,29.1,41,19,34,7,0,23,33,69.7,10,30,13,17,47,88,135,6,0,2018-2019,1.6151202749140892,1.40893470790378
734,Rodrigo Ely,BRA,DF,Alavés,La Liga,24,1993,4.8,8,5,5,3,0,5,7,71.4,2,9,7,2,7,15,30,0,0,2018-2019,1.4583333333333335,1.6666666666666667
735,Mohamed Elyounoussi,NOR,MF,Southampton,Premier League,23,1994,8.8,16,12,7,6,3,6,19,31.6,13,11,1,10,6,22,5,0,0,2018-2019,0.6818181818181818,1.8181818181818181
736,Adri Embarba,ESP,"MF,FW",Rayo Vallecano,La Liga,26,1992,25.4,54,26,20,24,10,22,61,36.1,39,38,2,36,29,83,22,0,0,2018-2019,1.141732283464567,2.125984251968504
737,Breel Embolo,SUI,FW,Schalke 04,Bundesliga,21,1997,14.9,22,17,4,13,5,1,9,11.1,8,11,0,11,4,26,6,0,0,2018-2019,0.2684563758389262,1.4765100671140938
738,Emerson,BRA,"FW,DF",Betis,La Liga,19,1999,3.5,9,7,6,1,2,3,10,30.0,7,6,0,6,7,16,12,0,0,2018-2019,2.0,2.5714285714285716
739,Youssef En-Nesyri,MAR,FW,Leganés,La Liga,21,1997,23.4,16,8,6,5,5,4,24,16.7,20,18,3,15,6,22,23,0,0,2018-2019,0.25641025641025644,0.6837606837606838
740,Björn Engels,BEL,DF,Reims,Ligue 1,23,1994,33.0,11,8,6,5,0,6,16,37.5,10,30,24,6,44,55,181,3,0,2018-2019,1.3333333333333333,0.3333333333333333
741,Sergi Enrich,ESP,FW,Eibar,La Liga,28,1990,28.7,27,17,3,11,13,7,30,23.3,23,11,1,10,6,33,14,0,0,2018-2019,0.20905923344947736,0.9407665505226481
742,Javier Eraso,ESP,"MF,FW",Leganés,La Liga,28,1990,7.0,6,3,3,2,1,0,6,0.0,6,3,1,2,7,13,4,0,0,2018-2019,1.0,0.8571428571428571
743,Christian Eriksen,DEN,MF,Tottenham,Premier League,26,1992,30.8,41,25,8,20,13,17,59,28.8,42,26,3,23,15,56,13,0,0,2018-2019,0.487012987012987,1.3311688311688312
744,Patrick Erras,GER,MF,Nürnberg,Bundesliga,23,1995,13.6,15,10,7,7,1,7,19,36.8,12,24,13,11,23,38,45,0,0,2018-2019,1.6911764705882353,1.1029411764705883
745,Gonzalo Escalante,ARG,MF,Eibar,La Liga,25,1993,19.9,49,28,11,35,3,19,46,41.3,27,37,2,35,21,70,21,0,0,2018-2019,1.0552763819095479,2.462311557788945
746,Sergio Escudero,ESP,"DF,FW",Sevilla,La Liga,28,1989,17.2,43,29,20,18,5,18,35,51.4,17,22,4,18,24,67,52,0,0,2018-2019,1.3953488372093024,2.5
747,Bernardo Espinosa,COL,DF,Girona,La Liga,29,1989,30.3,20,14,16,4,0,8,17,47.1,9,46,31,15,40,60,197,5,0,2018-2019,1.3201320132013201,0.6600660066006601
748,Michael Esser,GER,GK,Hannover 96,Bundesliga,30,1987,32.0,3,2,3,0,0,2,5,40.0,3,1,0,1,1,4,15,0,0,2018-2019,0.03125,0.09375
749,Alexander Esswein,GER,"MF,FW",Stuttgart,Bundesliga,28,1990,13.9,17,11,6,4,7,6,21,28.6,15,17,0,17,12,29,16,0,0,2018-2019,0.8633093525179856,1.223021582733813
750,Neil Etheridge,PHI,GK,Cardiff City,Premier League,28,1990,38.0,1,1,1,0,0,1,2,50.0,1,0,0,0,7,8,19,1,0,2018-2019,0.18421052631578946,0.02631578947368421
Rk,Player,Nation,Pos,Squad,Comp,0,0,90.0,0,0,3,3,3,Tkl,0,0.0,0,0,0,0,0,0,0,0,0,2018-2019,0.0,0.0
751,Beñat Etxebarria,ESP,MF,Athletic Club,La Liga,31,1987,22.6,47,24,14,25,8,19,59,32.2,40,18,1,17,24,71,11,0,0,2018-2019,1.0619469026548671,2.079646017699115
752,Xabier Etxeita,ESP,DF,Huesca,La Liga,30,1987,29.7,47,23,32,12,3,26,47,55.3,21,38,25,13,39,86,163,3,0,2018-2019,1.3131313131313131,1.5824915824915826
753,Lucas Evangelista,BRA,"FW,MF",Nantes,Ligue 1,23,1995,8.0,30,17,11,12,7,14,25,56.0,11,10,0,10,9,39,6,0,0,2018-2019,1.125,3.75
754,Jonny Evans,NIR,DF,Leicester City,Premier League,30,1988,22.2,24,13,20,4,0,13,18,72.2,5,28,10,18,33,57,152,3,0,2018-2019,1.4864864864864866,1.0810810810810811
755,Ewerton,BRA,DF,Nürnberg,Bundesliga,29,1989,14.9,24,20,21,3,0,8,14,57.1,6,23,16,7,25,49,108,1,0,2018-2019,1.6778523489932886,1.610738255033557
756,Valentin Eysseric,FRA,"FW,MF",Fiorentina,Serie A,26,1992,4.0,6,5,3,2,1,2,4,50.0,2,6,1,5,4,10,1,0,0,2018-2019,1.0,1.5
757,Valentin Eysseric,FRA,"MF,FW",Nantes,Ligue 1,26,1992,2.3,1,1,0,1,0,0,2,0.0,2,2,0,2,0,1,0,0,0,2018-2019,0.0,0.4347826086956522
758,Marco Fabián,MEX,FW,Eint Frankfurt,Bundesliga,29,1989,0.7,3,2,2,1,0,1,1,100.0,0,0,0,0,3,6,0,0,0,2018-2019,4.285714285714286,4.285714285714286
759,Łukasz Fabiański,POL,GK,West Ham,Premier League,33,1985,38.0,1,0,1,0,0,1,3,33.3,2,0,0,0,1,2,10,1,0,2018-2019,0.02631578947368421,0.02631578947368421
760,Fabinho,BRA,MF,Liverpool,Premier League,24,1993,22.4,59,31,17,38,4,24,59,40.7,35,34,6,28,28,87,27,2,0,2018-2019,1.25,2.6339285714285716
761,Fábio,BRA,"DF,FW",Nantes,Ligue 1,28,1990,14.2,53,34,25,27,1,26,53,49.1,27,18,4,14,18,71,27,0,0,2018-2019,1.267605633802817,3.7323943661971835
762,Cesc Fàbregas,ESP,MF,Chelsea,Premier League,31,1987,2.0,6,4,4,2,0,1,5,20.0,4,2,1,1,1,7,0,0,0,2018-2019,0.5,3.0
763,Cesc Fàbregas,ESP,MF,Monaco,Ligue 1,31,1987,10.7,14,10,5,5,4,8,28,28.6,20,12,3,9,9,23,5,1,0,2018-2019,0.8411214953271029,1.3084112149532712
764,Fabricio,ESP,GK,Fulham,Premier League,30,1987,2.0,1,1,1,0,0,0,0,0.0,0,0,0,0,0,1,3,2,0,2018-2019,0.0,0.5
765,Ralf Fährmann,GER,GK,Schalke 04,Bundesliga,29,1988,16.3,0,0,0,0,0,0,0,0.0,0,0,0,0,2,2,10,4,0,2018-2019,0.12269938650306748,0.0
766,Romain Faivre,FRA,MF,Monaco,Ligue 1,20,1998,1.0,1,0,0,1,0,0,1,0.0,1,0,0,0,1,2,1,1,0,2018-2019,1.0,1.0
767,Fayçal Fajr,MAR,MF,Caen,Ligue 1,29,1988,36.0,65,32,22,33,10,25,66,37.9,41,27,6,21,29,94,19,2,0,2018-2019,0.8055555555555556,1.8055555555555556
768,Radamel Falcao,COL,FW,Monaco,Ligue 1,32,1986,28.4,34,15,6,16,12,8,27,29.6,19,11,6,5,3,37,23,2,0,2018-2019,0.10563380281690142,1.1971830985915493
769,Diego Falcinelli,ITA,FW,Bologna,Serie A,27,1991,7.8,8,5,1,3,4,2,3,66.7,1,4,1,3,1,9,5,0,0,2018-2019,0.12820512820512822,1.0256410256410258
770,Simon Falette,GUI,DF,Eint Frankfurt,Bundesliga,26,1992,6.7,9,6,7,1,1,2,6,33.3,4,11,5,6,14,23,32,0,0,2018-2019,2.08955223880597,1.3432835820895521
771,Iago Falque,ESP,"FW,MF",Torino,Serie A,28,1990,17.9,13,8,3,8,2,3,16,18.8,13,14,0,14,3,16,2,0,0,2018-2019,0.1675977653631285,0.7262569832402235
772,Paolo Faragò,ITA,"MF,DF",Cagliari,Serie A,25,1993,18.9,46,29,20,16,10,13,43,30.2,30,28,2,26,15,61,38,0,0,2018-2019,0.7936507936507937,2.433862433862434
773,Mohamed Fares,ALG,DF,SPAL,Serie A,22,1996,32.8,63,43,37,18,8,25,54,46.3,29,48,4,44,54,117,83,2,0,2018-2019,1.6463414634146343,1.9207317073170733
774,Diego Farias,BRA,FW,Empoli,Serie A,28,1990,13.3,11,4,2,8,1,3,10,30.0,7,7,1,6,0,11,4,0,0,2018-2019,0.0,0.8270676691729323
775,Diego Farias,BRA,FW,Cagliari,Serie A,28,1990,7.8,13,9,3,7,3,2,11,18.2,9,7,1,6,1,14,5,0,0,2018-2019,0.12820512820512822,1.6666666666666667
Rk,Player,Nation,Pos,Squad,Comp,0,0,90.0,0,0,3,3,3,Tkl,0,0.0,0,0,0,0,0,0,0,0,0,2018-2019,0.0,0.0
776,Andrea Favilli,ITA,"FW,DF",Genoa,Serie A,21,1997,1.9,1,1,0,0,1,0,1,0.0,1,1,0,1,0,1,1,0,0,2018-2019,0.0,0.5263157894736842
777,Federico Fazio,ARG,DF,Roma,Serie A,31,1987,31.2,28,20,14,11,3,12,25,48.0,13,45,33,12,53,81,171,2,0,2018-2019,1.6987179487179487,0.8974358974358975
778,Zouhair Feddal,MAR,DF,Betis,La Liga,29,1989,18.9,38,23,31,6,1,16,28,57.1,12,19,8,11,31,69,94,2,0,2018-2019,1.6402116402116402,2.0105820105820107
779,Nabil Fekir,FRA,MF,Lyon,Ligue 1,25,1993,22.1,51,31,16,19,16,13,38,34.2,25,42,0,42,7,58,3,0,0,2018-2019,0.3167420814479638,2.3076923076923075
780,Yassin Fekir,FRA,FW,Lyon,Ligue 1,21,1997,0.1,0,0,0,0,0,0,1,0.0,1,0,0,0,0,0,0,0,0,2018-2019,0.0,0.0
781,Felipe,BRA,DF,Hannover 96,Bundesliga,31,1987,12.2,23,15,21,2,0,9,17,52.9,8,17,9,8,35,58,71,0,0,2018-2019,2.8688524590163937,1.8852459016393444
782,Luiz Felipe,ITA,DF,Lazio,Serie A,21,1997,14.3,27,18,20,7,0,13,20,65.0,7,27,15,12,26,53,57,1,0,2018-2019,1.8181818181818181,1.8881118881118881
783,Ohis Felix Uduokhai,GER,DF,Wolfsburg,Bundesliga,20,1997,2.7,13,7,7,5,1,9,10,90.0,1,6,2,4,6,19,11,1,0,2018-2019,2.222222222222222,4.814814814814815
784,Marouane Fellaini,BEL,MF,Manchester Utd,Premier League,30,1987,8.4,21,13,11,9,1,9,17,52.9,8,9,5,4,4,25,34,1,0,2018-2019,0.47619047619047616,2.5
785,Kiko Femenía,ESP,DF,Watford,Premier League,27,1991,22.8,48,30,34,12,2,24,51,47.1,27,24,6,18,36,84,68,0,0,2018-2019,1.5789473684210527,2.1052631578947367
786,Edimilson Fernandes,SUI,MF,Fiorentina,Serie A,22,1996,21.9,36,24,17,16,3,14,36,38.9,22,31,6,25,26,62,31,0,0,2018-2019,1.1872146118721463,1.6438356164383563
787,Gelson Fernandes,SUI,MF,Eint Frankfurt,Bundesliga,31,1986,24.7,74,48,33,38,3,23,65,35.4,42,45,9,36,53,127,16,0,0,2018-2019,2.145748987854251,2.995951417004049
788,Aitor Fernández,ESP,GK,Levante,La Liga,27,1991,16.0,1,0,1,0,0,1,1,100.0,0,0,0,0,1,2,10,1,0,2018-2019,0.0625,0.0625
789,Andrés Fernández,ESP,GK,Villarreal,La Liga,31,1986,6.0,1,0,1,0,0,1,1,100.0,0,0,0,0,0,1,4,1,0,2018-2019,0.0,0.16666666666666666
790,Borja Fernández,ESP,"MF,DF",Valladolid,La Liga,37,1981,9.3,17,12,7,9,1,6,16,37.5,10,14,2,12,14,31,25,0,0,2018-2019,1.5053763440860215,1.8279569892473118
791,Federico Fernández,ARG,DF,Newcastle Utd,Premier League,29,1989,16.5,16,12,12,4,0,10,18,55.6,8,19,12,7,25,41,106,1,0,2018-2019,1.5151515151515151,0.9696969696969697
792,Joaquín Fernández,ESP,"DF,MF",Valladolid,La Liga,22,1996,9.3,16,9,14,1,1,8,16,50.0,8,9,7,2,17,33,45,0,0,2018-2019,1.8279569892473118,1.7204301075268815
793,Valery Fernández,ESP,"DF,FW",Girona,La Liga,18,1999,9.9,20,15,13,6,1,10,17,58.8,7,15,1,14,8,28,10,0,0,2018-2019,0.8080808080808081,2.0202020202020203
794,Fernandinho,BRA,MF,Manchester City,Premier League,33,1985,26.4,57,43,19,30,8,26,47,55.3,21,28,4,24,41,98,70,0,0,2018-2019,1.5530303030303032,2.159090909090909
795,Juan Ferney Otero,COL,"FW,MF",Amiens,Ligue 1,23,1995,24.2,29,13,11,12,6,13,46,28.3,33,23,3,20,22,51,18,0,0,2018-2019,0.9090909090909092,1.1983471074380165
796,Alex Ferrari,ITA,DF,Sampdoria,Serie A,24,1994,6.0,10,8,4,6,0,5,7,71.4,2,7,4,3,9,19,26,0,0,2018-2019,1.5,1.6666666666666667
797,David Ferreiro,ESP,"MF,FW",Huesca,La Liga,30,1988,25.3,36,22,13,19,4,11,64,17.2,53,27,1,26,24,60,14,2,0,2018-2019,0.9486166007905138,1.4229249011857708
798,Facundo Ferreyra,ARG,FW,Espanyol,La Liga,27,1991,2.3,5,2,0,4,1,1,3,33.3,2,3,0,3,0,5,5,0,0,2018-2019,0.0,2.173913043478261
799,Jordan Ferri,FRA,MF,Nîmes,Ligue 1,26,1992,20.8,52,31,22,23,7,26,62,41.9,36,27,2,25,15,67,9,1,0,2018-2019,0.7211538461538461,2.5
800,Jordan Ferri,FRA,MF,Lyon,Ligue 1,26,1992,1.3,5,3,3,1,1,1,4,25.0,3,4,2,2,1,6,3,0,0,2018-2019,0.7692307692307692,3.846153846153846
Rk,Player,Nation,Pos,Squad,Comp,0,0,90.0,0,0,3,3,3,Tkl,0,0.0,0,0,0,0,0,0,0,0,0,2018-2019,0.0,0.0
801,Oliver Fink,GER,MF,Düsseldorf,Bundesliga,36,1982,11.7,38,22,17,17,4,12,38,31.6,26,20,3,17,13,51,19,0,0,2018-2019,1.1111111111111112,3.247863247863248
802,Alfreð Finnbogason,ISL,FW,Augsburg,Bundesliga,29,1989,14.8,7,3,2,5,0,1,9,11.1,8,6,1,5,3,10,11,0,0,2018-2019,0.2027027027027027,0.47297297297297297
803,Roberto Firmino,BRA,"FW,MF",Liverpool,Premier League,26,1991,29.0,30,20,5,16,9,7,34,20.6,27,35,1,34,6,36,16,0,0,2018-2019,0.20689655172413793,1.0344827586206897
804,Junior Firpo,DOM,"DF,FW",Betis,La Liga,21,1996,21.5,38,25,16,14,8,10,24,41.7,14,27,2,25,23,61,48,0,0,2018-2019,1.069767441860465,1.7674418604651163
805,Mathieu Flamini,FRA,MF,Getafe,La Liga,34,1984,5.0,9,4,4,4,1,4,7,57.1,3,3,1,2,5,14,4,0,0,2018-2019,1.0,1.8
806,Mark Flekken,NED,GK,Freiburg,Bundesliga,25,1993,1.0,0,0,0,0,0,0,0,0.0,0,0,0,0,0,0,0,0,0,2018-2019,0.0,0.0
807,Sergio Floccari,ITA,FW,SPAL,Serie A,36,1981,10.8,13,5,1,5,7,1,7,14.3,6,6,2,4,2,15,6,0,0,2018-2019,0.18518518518518517,1.2037037037037037
808,Alessandro Florenzi,ITA,"DF,FW",Roma,Serie A,27,1991,24.2,38,21,22,11,5,17,37,45.9,20,27,5,22,46,84,58,0,0,2018-2019,1.9008264462809918,1.5702479338842976
809,Phil Foden,ENG,MF,Manchester City,Premier League,18,2000,3.7,7,6,1,3,3,2,9,22.2,7,1,0,1,4,11,1,0,0,2018-2019,1.081081081081081,1.8918918918918919
810,Guessouma Fofana,MTN,MF,Amiens,Ligue 1,25,1992,2.1,6,4,3,3,0,1,3,33.3,2,2,1,1,3,9,0,0,0,2018-2019,1.4285714285714286,2.857142857142857
811,Guessouma Fofana,MTN,MF,Guingamp,Ligue 1,25,1992,5.3,14,9,2,10,2,4,10,40.0,6,3,0,3,6,20,8,0,0,2018-2019,1.1320754716981132,2.6415094339622645
812,Seko Fofana,CIV,MF,Udinese,Serie A,23,1995,29.3,25,13,14,10,1,6,36,16.7,30,20,7,13,29,54,18,3,0,2018-2019,0.9897610921501706,0.8532423208191126
813,Wesley Fofana,FRA,DF,Saint-Étienne,Ligue 1,17,2000,1.8,7,6,5,2,0,6,13,46.2,7,1,0,1,4,11,9,0,0,2018-2019,2.2222222222222223,3.888888888888889
814,Youssouf Fofana,FRA,MF,Strasbourg,Ligue 1,19,1999,10.1,28,20,5,20,3,9,27,33.3,18,7,0,7,11,39,8,0,0,2018-2019,1.0891089108910892,2.7722772277227725
815,Thomas Foket,BEL,DF,Reims,Ligue 1,23,1994,32.0,91,52,55,23,13,42,69,60.9,27,30,4,26,49,140,80,1,0,2018-2019,1.53125,2.84375
816,Thomas Fontaine,MAD,"DF,MF",Reims,Ligue 1,27,1991,4.7,6,3,5,0,1,2,5,40.0,3,6,2,4,7,13,28,1,0,2018-2019,1.4893617021276595,1.276595744680851
817,José Fonte,POR,DF,Lille,Ligue 1,34,1983,34.6,27,15,15,9,3,17,24,70.8,7,33,26,7,37,64,153,1,0,2018-2019,1.069364161849711,0.7803468208092486
818,Rui Fonte,POR,"FW,MF",Lille,Ligue 1,28,1990,7.0,25,12,4,16,5,6,11,54.5,5,4,0,4,2,27,8,0,0,2018-2019,0.2857142857142857,3.5714285714285716
819,Pablo Fornals,ESP,"MF,FW",Villarreal,La Liga,22,1996,27.5,49,26,14,26,9,15,54,27.8,39,32,4,28,24,73,19,0,0,2018-2019,0.8727272727272727,1.7818181818181817
820,Emil Forsberg,SWE,"MF,FW",RB Leipzig,Bundesliga,26,1991,13.9,12,7,0,12,0,5,16,31.3,11,16,1,15,3,15,6,0,0,2018-2019,0.2158273381294964,0.8633093525179856
821,Fraser Forster,ENG,GK,Southampton,Premier League,30,1988,1.0,0,0,0,0,0,0,0,0.0,0,0,0,0,0,0,1,0,0,2018-2019,0.0,0.0
822,Steven Fortes,CPV,DF,Toulouse,Ligue 1,26,1992,1.5,3,1,1,2,0,0,0,0.0,0,1,1,0,2,5,9,2,0,2018-2019,1.3333333333333333,2.0
823,Iver Fossum,NOR,MF,Hannover 96,Bundesliga,22,1996,5.1,9,5,1,7,1,4,8,50.0,4,8,2,6,7,16,10,0,0,2018-2019,1.3725490196078431,1.7647058823529413
824,Ben Foster,ENG,GK,Watford,Premier League,35,1983,38.0,2,2,2,0,0,2,6,33.3,4,0,0,0,2,4,34,3,0,2018-2019,0.05263157894736842,0.05263157894736842
825,Timothy Fosu-Mensah,NED,DF,Fulham,Premier League,20,1998,8.8,18,7,12,6,0,8,13,61.5,5,11,5,6,12,30,30,1,0,2018-2019,1.3636363636363635,2.0454545454545454
Rk,Player,Nation,Pos,Squad,Comp,0,0,90.0,0,0,3,3,3,Tkl,0,0.0,0,0,0,0,0,0,0,0,0,2018-2019,0.0,0.0
826,Dimitri Foulquier,FRA,"MF,DF",Getafe,La Liga,25,1993,20.0,29,12,10,14,5,11,22,50.0,11,23,2,21,20,49,38,0,0,2018-2019,1.0,1.45
827,Juan Foyth,ARG,DF,Tottenham,Premier League,20,1998,9.9,31,17,20,11,0,14,19,73.7,5,12,5,7,10,41,50,1,0,2018-2019,1.0101010101010102,3.131313131313131
828,Raphael Framberger,GER,"DF,MF",Augsburg,Bundesliga,22,1995,6.1,8,6,4,4,0,0,3,0.0,3,10,3,7,11,19,15,1,0,2018-2019,1.8032786885245902,1.3114754098360657
829,Simon Francis,ENG,DF,Bournemouth,Premier League,33,1985,13.7,25,14,19,5,1,12,24,50.0,12,15,7,8,19,44,73,1,0,2018-2019,1.3868613138686132,1.8248175182481752
830,Mike Frantz,GER,"MF,FW",Freiburg,Bundesliga,31,1986,24.6,34,26,15,15,4,6,20,30.0,14,24,4,20,21,55,32,0,0,2018-2019,0.8536585365853658,1.3821138211382114
831,Ryan Fraser,SCO,"MF,FW",Bournemouth,Premier League,24,1994,35.2,19,11,9,8,2,10,32,31.3,22,23,6,17,22,41,33,0,0,2018-2019,0.625,0.5397727272727272
832,Pierluigi Frattali,ITA,GK,Parma,Serie A,32,1985,1.0,0,0,0,0,0,0,0,0.0,0,0,0,0,0,0,1,0,0,2018-2019,0.0,0.0
833,Fred,BRA,MF,Manchester Utd,Premier League,25,1993,11.6,29,17,12,16,1,15,33,45.5,18,26,2,24,16,45,14,2,0,2018-2019,1.3793103448275863,2.5
834,Ryan Fredericks,ENG,DF,West Ham,Premier League,25,1992,12.1,38,23,33,5,0,21,32,65.6,11,15,5,10,13,51,49,1,0,2018-2019,1.0743801652892562,3.1404958677685952
835,Remo Freuler,SUI,MF,Atalanta,Serie A,26,1992,33.6,84,45,34,34,16,30,70,42.9,40,62,12,50,38,122,45,0,0,2018-2019,1.130952380952381,2.5
836,Nicolas Frey,FRA,DF,Chievo,Serie A,34,1984,2.5,3,1,2,1,0,0,3,0.0,3,3,3,0,7,10,18,0,0,2018-2019,2.8,1.2
837,Marco Friedl,AUT,DF,Werder Bremen,Bundesliga,20,1998,5.3,8,6,4,3,1,3,11,27.3,8,9,6,3,13,21,21,0,0,2018-2019,2.452830188679245,1.509433962264151
838,Alexander Fuchs,GER,"MF,FW",Nürnberg,Bundesliga,21,1997,7.3,14,12,5,7,2,5,15,33.3,10,9,1,8,5,19,10,0,0,2018-2019,0.684931506849315,1.9178082191780823
839,Christian Fuchs,AUT,DF,Leicester City,Premier League,32,1986,2.3,4,3,0,4,0,1,2,50.0,1,0,0,0,4,8,8,0,0,2018-2019,1.7391304347826089,1.7391304347826089
840,Javi Fuego,ESP,MF,Villarreal,La Liga,34,1984,2.6,6,3,5,1,0,4,8,50.0,4,2,0,2,3,9,9,0,0,2018-2019,1.1538461538461537,2.3076923076923075
841,Angelo Fulgini,FRA,"MF,FW",Angers,Ligue 1,21,1996,18.2,38,22,18,13,7,12,31,38.7,19,21,3,18,28,66,15,0,0,2018-2019,1.5384615384615385,2.087912087912088
842,Niclas Füllkrug,GER,FW,Hannover 96,Bundesliga,25,1993,12.4,3,0,0,1,2,1,5,20.0,4,10,4,6,1,4,17,0,0,2018-2019,0.08064516129032258,0.24193548387096772
843,Ramiro Funes Mori,ARG,"DF,MF",Villarreal,La Liga,27,1991,29.2,41,29,30,9,2,19,44,43.2,25,36,24,12,42,83,149,2,0,2018-2019,1.4383561643835616,1.404109589041096
844,Manolo Gabbiadini,ITA,"FW,MF",Southampton,Premier League,26,1991,5.3,6,2,1,4,1,1,2,50.0,1,5,0,5,3,9,6,0,0,2018-2019,0.5660377358490566,1.1320754716981132
845,Manolo Gabbiadini,ITA,FW,Sampdoria,Serie A,26,1991,9.0,5,2,1,3,1,3,11,27.3,8,6,1,5,4,9,4,0,0,2018-2019,0.4444444444444444,0.5555555555555556
846,Mijat Gaćinović,SRB,MF,Eint Frankfurt,Bundesliga,23,1995,18.1,31,20,7,13,11,11,42,26.2,31,26,1,25,24,55,10,0,0,2018-2019,1.3259668508287292,1.7127071823204418
847,Gianluca Gaetano,ITA,"MF,FW",Napoli,Serie A,18,2000,0.1,0,0,0,0,0,0,0,0.0,0,0,0,0,0,0,0,0,0,2018-2019,0.0,0.0
848,Roberto Gagliardini,ITA,MF,Inter,Serie A,24,1994,12.1,23,14,13,8,2,10,27,37.0,17,21,3,18,16,39,19,0,0,2018-2019,1.322314049586777,1.9008264462809918
849,Riccardo Gagliolo,SWE,DF,Parma,Serie A,28,1990,33.8,69,45,52,15,2,33,68,48.5,35,60,33,27,66,135,213,2,0,2018-2019,1.9526627218934913,2.0414201183431953
850,Milan Gajić,SRB,DF,Bordeaux,Ligue 1,22,1996,1.0,2,1,1,0,1,1,1,100.0,0,0,0,0,1,3,7,0,0,2018-2019,1.0,2.0
Rk,Player,Nation,Pos,Squad,Comp,0,0,90.0,0,0,3,3,3,Tkl,0,0.0,0,0,0,0,0,0,0,0,0,2018-2019,0.0,0.0
851,Javi Galán,ESP,"DF,FW",Huesca,La Liga,23,1994,16.0,61,39,36,23,2,34,59,57.6,25,22,1,21,19,80,52,1,0,2018-2019,1.1875,3.8125
852,Sam Gallagher,ENG,FW,Southampton,Premier League,22,1995,0.4,0,0,0,0,0,0,0,0.0,0,1,0,1,0,0,1,0,0,2018-2019,0.0,0.0
853,Álex Gallar,ESP,"MF,FW",Huesca,La Liga,26,1992,11.2,15,9,6,5,4,8,19,42.1,11,9,1,8,9,24,5,0,0,2018-2019,0.8035714285714286,1.3392857142857144
854,Enric Gallego,ESP,FW,Huesca,La Liga,31,1986,17.1,21,15,3,13,5,3,19,15.8,16,17,2,15,8,29,32,0,0,2018-2019,0.4678362573099415,1.2280701754385963
855,Álex Gálvez,ESP,DF,Rayo Vallecano,La Liga,29,1989,15.7,38,28,25,13,0,14,28,50.0,14,7,2,5,45,83,69,1,0,2018-2019,2.8662420382165608,2.4203821656050954
856,Kévin Gameiro,FRA,FW,Valencia,La Liga,31,1987,17.9,14,9,4,6,4,1,6,16.7,5,12,2,10,5,19,3,0,0,2018-2019,0.2793296089385475,0.782122905027933
857,Idrissa Gana Gueye,SEN,MF,Everton,Premier League,28,1989,31.4,142,89,70,63,9,38,76,50.0,38,52,8,44,74,216,48,1,0,2018-2019,2.356687898089172,4.522292993630574
858,Ignatius Ganago,CMR,FW,Nice,Ligue 1,19,1999,11.5,3,1,0,2,1,0,7,0.0,7,2,0,2,1,4,7,0,0,2018-2019,0.08695652173913043,0.2608695652173913
859,Cristian Ganea,ROU,DF,Athletic Club,La Liga,26,1992,0.5,0,0,0,0,0,0,3,0.0,3,1,0,1,1,1,2,0,0,2018-2019,2.0,0.0
860,Ganso,BRA,"MF,FW",Amiens,Ligue 1,28,1989,5.8,12,8,2,8,2,2,15,13.3,13,5,1,4,6,18,0,0,0,2018-2019,1.0344827586206897,2.0689655172413794
861,Ezequiel Garay,ARG,DF,Valencia,La Liga,31,1986,23.7,20,17,15,3,2,9,18,50.0,9,30,23,7,16,36,140,0,0,2018-2019,0.6751054852320675,0.8438818565400844
862,Borja Garcés,ESP,FW,Atlético Madrid,La Liga,18,1999,0.2,0,0,0,0,0,0,0,0.0,0,0,0,0,0,0,0,0,0,2018-2019,0.0,0.0
863,Alberto García,ESP,GK,Rayo Vallecano,La Liga,33,1985,17.0,1,1,1,0,0,1,3,33.3,2,1,0,1,2,3,1,2,0,2018-2019,0.11764705882352941,0.058823529411764705
864,Aleix García,ESP,MF,Girona,La Liga,21,1997,18.5,37,19,17,20,0,13,36,36.1,23,21,6,15,21,58,18,0,0,2018-2019,1.135135135135135,2.0
865,Álvaro García,ESP,"FW,MF",Rayo Vallecano,La Liga,25,1992,19.6,22,19,11,7,4,4,25,16.0,21,24,0,24,19,41,30,0,0,2018-2019,0.9693877551020408,1.1224489795918366
866,Borja García,ESP,"MF,FW",Girona,La Liga,27,1990,29.2,39,27,17,15,7,22,44,50.0,22,23,2,21,38,77,17,0,0,2018-2019,1.3013698630136987,1.3356164383561644
867,Dani García,ESP,MF,Athletic Club,La Liga,28,1990,27.5,56,34,21,32,3,24,63,38.1,39,28,8,20,49,105,46,1,0,2018-2019,1.7818181818181817,2.036363636363636
868,Javi García,ESP,"DF,MF",Betis,La Liga,31,1987,5.8,3,1,3,0,0,2,3,66.7,1,5,1,4,5,8,27,0,0,2018-2019,0.8620689655172414,0.5172413793103449
869,Manu García,ESP,MF,Alavés,La Liga,32,1986,25.9,83,48,29,40,14,24,77,31.2,53,42,7,35,23,106,67,0,0,2018-2019,0.888030888030888,3.204633204633205
870,Manu García,ESP,MF,Toulouse,Ligue 1,20,1998,20.5,37,26,14,17,6,15,49,30.6,34,16,1,15,15,52,5,0,0,2018-2019,0.7317073170731707,1.8048780487804879
871,Raúl García,ESP,"MF,FW",Athletic Club,La Liga,32,1986,26.3,61,41,13,37,11,22,68,32.4,46,56,1,55,21,82,39,0,0,2018-2019,0.7984790874524714,2.3193916349809887
872,Raúl García,ESP,DF,Leganés,La Liga,29,1989,4.2,8,6,4,4,0,6,8,75.0,2,5,2,3,6,14,28,1,0,2018-2019,1.4285714285714286,1.9047619047619047
873,Raúl García,ESP,DF,Girona,La Liga,29,1989,9.4,21,12,11,7,3,11,16,68.8,5,14,4,10,11,32,35,1,0,2018-2019,1.1702127659574468,2.234042553191489
874,Sergio García,ESP,"FW,MF",Espanyol,La Liga,35,1983,16.5,18,10,4,11,3,3,16,18.8,13,6,1,5,10,28,4,0,0,2018-2019,0.6060606060606061,1.0909090909090908
875,James Garner,ENG,MF,Manchester Utd,Premier League,17,2001,0.0,0,0,0,0,0,0,0,0.0,0,0,0,0,0,0,0,0,0,2018-2019,,
Rk,Player,Nation,Pos,Squad,Comp,0,0,90.0,0,0,3,3,3,Tkl,0,0.0,0,0,0,0,0,0,0,0,0,2018-2019,0.0,0.0
876,Mario Gaspar,ESP,DF,Villarreal,La Liga,27,1990,28.9,62,43,39,17,6,29,49,59.2,20,48,11,37,42,104,91,0,0,2018-2019,1.453287197231834,2.1453287197231834
877,Paulo Gazzaniga,ARG,GK,Tottenham,Premier League,26,1992,3.0,0,0,0,0,0,0,0,0.0,0,0,0,0,0,0,1,0,0,2018-2019,0.0,0.0
878,Marcello Gazzola,ITA,"DF,MF",Parma,Serie A,33,1985,10.2,9,4,2,5,2,5,9,55.6,4,6,3,3,4,13,33,0,0,2018-2019,0.3921568627450981,0.8823529411764707
879,Jean-Philippe Gbamin,CIV,MF,Mainz 05,Bundesliga,22,1995,29.7,51,31,29,15,7,23,51,45.1,28,39,5,34,30,81,32,1,0,2018-2019,1.0101010101010102,1.7171717171717171
880,David de Gea,ESP,GK,Manchester Utd,Premier League,27,1990,38.0,0,0,0,0,0,0,2,0.0,2,1,0,1,0,0,11,4,0,2018-2019,0.0,0.0
881,Theodor Gebre Selassie,CZE,DF,Werder Bremen,Bundesliga,31,1986,31.3,53,38,27,16,10,22,51,43.1,29,33,8,25,69,122,100,0,0,2018-2019,2.2044728434504792,1.6932907348242812
882,Dennis Geiger,GER,MF,Hoffenheim,Bundesliga,20,1998,2.7,2,1,1,1,0,1,6,16.7,5,1,0,1,3,5,1,0,0,2018-2019,1.111111111111111,0.7407407407407407
883,Jérémy Gélin,FRA,"DF,MF",Rennes,Ligue 1,21,1997,14.2,30,16,18,10,2,18,34,52.9,16,14,6,8,19,49,29,0,0,2018-2019,1.3380281690140845,2.1126760563380285
884,Romain Genevois,HAI,DF,Caen,Ligue 1,30,1987,4.0,10,6,9,1,0,6,11,54.5,5,3,0,3,8,18,13,0,0,2018-2019,2.0,2.5
885,Christian Gentner,GER,"MF,FW",Stuttgart,Bundesliga,32,1985,22.4,61,38,29,26,6,16,50,32.0,34,30,3,27,31,92,41,1,0,2018-2019,1.3839285714285716,2.723214285714286
886,Yannick Gerhardt,GER,MF,Wolfsburg,Bundesliga,24,1994,27.3,52,34,22,20,10,16,43,37.2,27,35,7,28,30,82,34,0,0,2018-2019,1.0989010989010988,1.9047619047619047
887,Valère Germain,FRA,FW,Marseille,Ligue 1,28,1990,24.1,38,25,8,22,8,8,33,24.2,25,20,5,15,6,44,30,0,0,2018-2019,0.24896265560165973,1.5767634854771784
888,Gerson,BRA,"MF,FW",Fiorentina,Serie A,21,1997,27.0,42,26,22,15,5,12,38,31.6,26,46,9,37,16,58,32,0,0,2018-2019,0.5925925925925926,1.5555555555555556
889,Gervinho,CIV,FW,Parma,Serie A,31,1987,25.6,19,12,11,5,3,5,13,38.5,8,7,0,7,10,29,2,0,0,2018-2019,0.390625,0.7421875
890,Willem Geubbels,FRA,MF,Monaco,Ligue 1,16,2001,0.1,0,0,0,0,0,0,0,0.0,0,0,0,0,0,0,0,0,0,2018-2019,0.0,0.0
891,Lamine Ghezali,FRA,"FW,MF",Saint-Étienne,Ligue 1,19,1999,0.5,1,1,0,1,0,1,2,50.0,1,0,0,0,0,1,2,0,0,2018-2019,0.0,2.0
892,Rachid Ghezzal,ALG,"FW,MF",Leicester City,Premier League,26,1992,8.3,14,5,3,7,4,3,18,16.7,15,10,1,9,7,21,4,1,0,2018-2019,0.8433734939759036,1.686746987951807
893,Paolo Ghiglione,ITA,DF,Frosinone,Serie A,21,1997,5.7,8,4,6,1,1,6,14,42.9,8,2,0,2,4,12,22,0,0,2018-2019,0.7017543859649122,1.4035087719298245
894,Saman Ghoddos,IRN,"FW,MF",Amiens,Ligue 1,24,1993,20.3,33,17,14,15,4,13,32,40.6,19,15,2,13,7,40,13,0,0,2018-2019,0.3448275862068965,1.625615763546798
895,Faouzi Ghoulam,ALG,DF,Napoli,Serie A,27,1991,12.8,9,7,3,5,1,8,9,88.9,1,6,2,4,8,17,17,0,0,2018-2019,0.625,0.703125
896,Emanuele Giaccherini,ITA,"MF,FW",Chievo,Serie A,33,1985,22.3,14,8,5,7,2,6,31,19.4,25,21,2,19,16,30,10,2,0,2018-2019,0.7174887892376681,0.6278026905829596
897,Morgan Gibbs-White,ENG,"MF,FW",Wolves,Premier League,18,2000,7.4,6,3,2,4,0,1,4,25.0,3,6,0,6,1,7,0,0,0,2018-2019,0.13513513513513511,0.8108108108108107
898,Ben Gibson,ENG,DF,Burnley,Premier League,25,1993,0.7,1,1,1,0,0,0,0,0.0,0,1,1,0,0,1,2,0,0,2018-2019,0.0,1.4285714285714286
899,Fabian Giefer,GER,GK,Augsburg,Bundesliga,28,1990,4.0,0,0,0,0,0,0,2,0.0,2,0,0,0,0,0,1,2,0,2018-2019,0.0,0.0
900,Niko Gießelmann,GER,DF,Düsseldorf,Bundesliga,26,1991,28.8,57,37,38,14,5,26,59,44.1,33,25,6,19,36,93,85,1,0,2018-2019,1.25,1.9791666666666665
Rk,Player,Nation,Pos,Squad,Comp,0,0,90.0,0,0,3,3,3,Tkl,0,0.0,0,0,0,0,0,0,0,0,0,2018-2019,0.0,0.0
901,Bryan Gil,ESP,"MF,FW",Sevilla,La Liga,17,2001,1.9,6,4,4,1,1,1,5,20.0,4,0,0,0,1,7,0,0,0,2018-2019,0.5263157894736842,3.1578947368421053
902,Daniel Ginczek,GER,FW,Wolfsburg,Bundesliga,27,1991,14.2,9,7,4,3,2,5,19,26.3,14,12,2,10,3,12,23,1,0,2018-2019,0.21126760563380284,0.6338028169014085
903,Matthias Ginter,GER,DF,Gladbach,Bundesliga,24,1994,26.4,24,14,16,7,1,9,17,52.9,8,31,19,12,17,41,98,1,0,2018-2019,0.6439393939393939,0.9090909090909092
904,Andrei Girotto,BRA,MF,Nantes,Ligue 1,26,1992,16.4,57,40,18,36,3,20,44,45.5,24,22,6,16,29,86,43,1,0,2018-2019,1.7682926829268295,3.4756097560975614
905,Olivier Giroud,FRA,FW,Chelsea,Premier League,31,1986,9.4,3,2,0,1,2,1,4,25.0,3,6,1,5,3,6,7,0,0,2018-2019,0.3191489361702127,0.3191489361702127
906,Kamil Glik,POL,DF,Monaco,Ligue 1,30,1988,33.0,32,23,26,5,1,16,32,50.0,16,25,17,8,61,93,200,1,0,2018-2019,1.8484848484848484,0.9696969696969697
907,Serge Gnabry,GER,"FW,MF",Bayern Munich,Bundesliga,23,1995,19.6,36,20,12,13,11,5,30,16.7,25,18,0,18,11,47,3,0,0,2018-2019,0.5612244897959183,1.8367346938775508
908,Joris Gnagnon,FRA,"DF,MF",Sevilla,La Liga,21,1997,5.0,11,8,6,4,1,4,7,57.1,3,2,2,0,10,21,16,0,0,2018-2019,2.0,2.2
909,Eddy Gnahoré,FRA,MF,Amiens,Ligue 1,24,1993,24.9,39,27,17,17,5,9,39,23.1,30,29,4,25,23,62,23,1,0,2018-2019,0.9236947791164659,1.566265060240964
910,Massimo Gobbi,ITA,DF,Parma,Serie A,37,1980,13.1,14,7,5,5,4,8,25,32.0,17,16,8,8,9,23,48,0,0,2018-2019,0.6870229007633588,1.0687022900763359
911,Kevin Goden,GER,"DF,MF",Nürnberg,Bundesliga,19,1999,3.0,4,3,3,1,0,2,7,28.6,5,4,1,3,4,8,11,0,0,2018-2019,1.3333333333333333,1.3333333333333333
912,Diego Godín,URU,DF,Atlético Madrid,La Liga,32,1986,27.9,52,30,33,19,0,20,42,47.6,22,22,9,13,45,97,141,2,0,2018-2019,1.6129032258064517,1.863799283154122
913,Mauro Goicoechea,URU,GK,Toulouse,Ligue 1,30,1988,7.9,0,0,0,0,0,0,0,0.0,0,0,0,0,0,0,7,0,0,2018-2019,0.0,0.0
914,Edoardo Goldaniga,ITA,DF,Frosinone,Serie A,24,1993,29.0,43,28,34,7,2,19,32,59.4,13,29,16,13,57,100,119,0,0,2018-2019,1.9655172413793103,1.4827586206896552
915,Pierluigi Gollini,ITA,GK,Atalanta,Serie A,23,1995,20.0,2,2,2,0,0,1,2,50.0,1,0,0,0,0,2,3,2,0,2018-2019,0.0,0.1
916,Aleksandr Golovin,RUS,"MF,FW",Monaco,Ligue 1,22,1996,25.4,36,17,3,20,13,10,44,22.7,34,34,3,31,22,58,12,0,0,2018-2019,0.8661417322834646,1.4173228346456694
917,André Gomes,POR,MF,Everton,Premier League,25,1993,22.0,39,23,12,24,3,13,59,22.0,46,27,4,23,20,59,18,0,0,2018-2019,0.9090909090909091,1.7727272727272727
918,Angel Gomes,ENG,"MF,FW",Manchester Utd,Premier League,17,2000,0.3,1,0,0,0,1,0,0,0.0,0,0,0,0,0,1,0,0,0,2018-2019,0.0,3.3333333333333335
919,Ibai Gómez,ESP,FW,Athletic Club,La Liga,28,1989,6.4,6,3,3,2,1,4,9,44.4,5,8,1,7,2,8,8,0,0,2018-2019,0.3125,0.9375
920,Ibai Gómez,ESP,"MF,FW",Alavés,La Liga,28,1989,16.1,14,8,9,3,2,6,19,31.6,13,10,0,10,8,22,17,0,0,2018-2019,0.49689440993788814,0.8695652173913043
921,Joe Gomez,ENG,DF,Liverpool,Premier League,21,1997,11.8,18,11,10,7,1,9,15,60.0,6,10,5,5,14,32,42,0,0,2018-2019,1.1864406779661016,1.5254237288135593
922,Mario Gómez,GER,FW,Stuttgart,Bundesliga,33,1985,24.6,19,11,6,10,3,2,12,16.7,10,17,6,11,5,24,33,0,0,2018-2019,0.2032520325203252,0.7723577235772358
923,Maxi Gómez,URU,FW,Celta Vigo,La Liga,21,1996,32.9,6,4,1,4,1,1,12,8.3,11,3,0,3,2,8,43,0,0,2018-2019,0.060790273556231005,0.182370820668693
924,Moi Gómez,ESP,MF,Huesca,La Liga,24,1994,33.9,42,28,15,25,2,11,46,23.9,35,27,3,24,28,70,27,0,0,2018-2019,0.8259587020648967,1.2389380530973453
925,Papu Gómez,ARG,"MF,FW",Atalanta,Serie A,30,1988,32.2,19,14,5,10,4,6,30,20.0,24,21,0,21,16,35,4,0,0,2018-2019,0.49689440993788814,0.5900621118012421
Rk,Player,Nation,Pos,Squad,Comp,0,0,90.0,0,0,3,3,3,Tkl,0,0.0,0,0,0,0,0,0,0,0,0,2018-2019,0.0,0.0
926,Sergi Gómez,ESP,DF,Sevilla,La Liga,26,1992,30.7,49,38,33,12,4,18,28,64.3,10,30,20,10,40,89,135,1,0,2018-2019,1.3029315960912053,1.5960912052117264
927,Alfred Gomis,SEN,GK,SPAL,Serie A,24,1993,19.2,0,0,0,0,0,0,1,0.0,1,0,0,0,1,1,14,1,0,2018-2019,0.052083333333333336,0.0
928,Maxime Gonalons,FRA,MF,Sevilla,La Liga,29,1989,6.0,8,4,2,5,1,1,15,6.7,14,10,4,6,5,13,12,0,0,2018-2019,0.8333333333333334,1.3333333333333333
929,Anthony Gonçalves,FRA,"MF,FW",Strasbourg,Ligue 1,32,1986,11.8,22,15,12,8,2,7,22,31.8,15,21,2,19,10,32,17,0,0,2018-2019,0.847457627118644,1.8644067796610169
930,Jérôme Gondorf,GER,"MF,FW",Freiburg,Bundesliga,30,1988,14.4,33,18,12,19,2,14,28,50.0,14,29,5,24,19,52,23,1,0,2018-2019,1.3194444444444444,2.2916666666666665
931,Álvaro González,ESP,DF,Villarreal,La Liga,28,1990,32.9,49,35,33,14,2,25,35,71.4,10,34,24,10,37,86,177,2,0,2018-2019,1.1246200607902737,1.4893617021276597
932,Bruno González,ESP,DF,Getafe,La Liga,28,1990,18.9,23,10,14,8,1,9,18,50.0,9,13,6,7,22,45,110,0,0,2018-2019,1.1640211640211642,1.216931216931217
933,Cristo González,ESP,FW,Real Madrid,La Liga,20,1997,0.5,1,0,0,1,0,0,0,0.0,0,0,0,0,1,2,0,0,0,2018-2019,2.0,2.0
934,Giancarlo González,CRC,DF,Bologna,Serie A,30,1988,8.3,13,7,12,1,0,5,9,55.6,4,15,11,4,12,25,42,0,0,2018-2019,1.4457831325301203,1.5662650602409638
935,Nicolás González,ARG,"FW,MF",Stuttgart,Bundesliga,20,1998,24.0,19,14,3,7,9,9,19,47.4,10,32,2,30,11,30,27,0,0,2018-2019,0.4583333333333333,0.7916666666666666
936,Jon Gorenc Stanković,SVN,"MF,DF",Huddersfield,Premier League,22,1996,7.9,26,18,18,7,1,14,26,53.8,12,16,9,7,9,35,20,1,0,2018-2019,1.1392405063291138,3.291139240506329
937,Leon Goretzka,GER,MF,Bayern Munich,Bundesliga,23,1995,22.5,41,22,7,27,7,14,38,36.8,24,25,4,21,26,67,14,1,0,2018-2019,1.1555555555555554,1.8222222222222222
938,Mathieu Gorgelin,FRA,GK,Lyon,Ligue 1,27,1990,4.0,0,0,0,0,0,0,0,0.0,0,0,0,0,0,0,3,0,0,2018-2019,0.0,0.0
939,Mirko Gori,ITA,MF,Frosinone,Serie A,25,1993,3.7,16,13,7,9,0,5,16,31.3,11,2,0,2,4,20,9,0,0,2018-2019,1.081081081081081,4.324324324324324
940,Andoni Gorosabel,ESP,DF,Real Sociedad,La Liga,21,1996,5.1,16,9,10,5,1,8,13,61.5,5,5,1,4,4,20,20,1,0,2018-2019,0.7843137254901962,3.1372549019607847
941,Robin Gosens,GER,"DF,MF",Atalanta,Serie A,24,1994,21.6,63,46,32,26,5,37,54,68.5,17,41,3,38,38,101,60,0,0,2018-2019,1.759259259259259,2.9166666666666665
942,Dan Gosling,ENG,MF,Bournemouth,Premier League,28,1990,19.3,57,23,27,21,9,28,53,52.8,25,33,11,22,20,77,46,1,0,2018-2019,1.0362694300518134,2.9533678756476682
943,Felix Götze,GER,MF,Augsburg,Bundesliga,20,1998,1.4,4,2,2,2,0,3,3,100.0,0,1,0,1,3,7,7,0,0,2018-2019,2.142857142857143,2.857142857142857
944,Mario Götze,GER,"FW,MF",Dortmund,Bundesliga,26,1992,18.6,26,19,6,11,9,4,25,16.0,21,10,0,10,8,34,4,1,0,2018-2019,0.4301075268817204,1.3978494623655913
945,Prince-Désir Gouano,FRA,DF,Amiens,Ligue 1,24,1993,29.1,31,18,25,5,1,12,22,54.5,10,36,27,9,46,77,127,6,0,2018-2019,1.5807560137457044,1.0652920962199313
946,Yoann Gourcuff,FRA,"MF,FW",Dijon,Ligue 1,32,1986,1.5,0,0,0,0,0,0,2,0.0,2,1,1,0,0,0,1,0,0,2018-2019,0.0,0.0
947,Jeffrey Gouweleeuw,NED,DF,Augsburg,Bundesliga,27,1991,23.2,42,31,23,19,0,24,39,61.5,15,44,21,23,56,98,71,1,0,2018-2019,2.413793103448276,1.8103448275862069
948,Paolo Gozzi Iweru,ITA,DF,Juventus,Serie A,17,2001,1.0,3,2,2,1,0,0,0,0.0,0,0,0,0,3,6,3,0,0,2018-2019,3.0,3.0
949,Max Gradel,CIV,"FW,MF",Toulouse,Ligue 1,30,1987,36.0,58,35,34,19,5,24,70,34.3,46,53,9,44,18,76,41,0,0,2018-2019,0.5,1.6111111111111112
950,Jonathan Gradit,FRA,DF,Caen,Ligue 1,25,1992,22.3,52,28,30,21,1,28,52,53.8,24,40,15,25,45,97,82,3,0,2018-2019,2.0179372197309418,2.3318385650224216
Rk,Player,Nation,Pos,Squad,Comp,0,0,90.0,0,0,3,3,3,Tkl,0,0.0,0,0,0,0,0,0,0,0,0,2018-2019,0.0,0.0
951,Samuel Grandsir,FRA,"MF,FW",Strasbourg,Ligue 1,21,1996,2.6,9,6,5,3,1,3,7,42.9,4,2,0,2,1,10,0,0,0,2018-2019,0.3846153846153846,3.4615384615384612
952,Samuel Grandsir,FRA,"FW,MF",Monaco,Ligue 1,21,1996,5.2,12,7,4,5,3,2,10,20.0,8,11,0,11,1,13,5,1,0,2018-2019,0.1923076923076923,2.3076923076923075
953,Álex Granell,ESP,"MF,DF",Girona,La Liga,29,1988,26.6,64,28,30,31,3,34,83,41.0,49,34,5,29,35,99,36,1,0,2018-2019,1.3157894736842104,2.406015037593985
954,Esteban Granero,ESP,MF,Espanyol,La Liga,31,1987,22.4,50,32,26,18,6,17,50,34.0,33,42,8,34,26,76,34,2,0,2018-2019,1.1607142857142858,2.232142857142857
955,Karlan Grant,ENG,FW,Huddersfield,Premier League,20,1997,9.7,5,2,1,2,2,1,3,33.3,2,8,0,8,2,7,1,1,0,2018-2019,0.2061855670103093,0.5154639175257733
956,Alberto Grassi,ITA,MF,Parma,Serie A,23,1995,5.1,20,12,7,10,3,2,10,20.0,8,8,2,6,8,28,10,0,0,2018-2019,1.5686274509803924,3.9215686274509807
957,Andre Gray,JAM,FW,Watford,Premier League,27,1991,15.2,3,1,0,2,1,1,6,16.7,5,3,1,2,2,5,6,0,0,2018-2019,0.13157894736842105,0.19736842105263158
958,Demarai Gray,JAM,"FW,MF",Leicester City,Premier League,22,1996,22.1,25,12,7,14,4,6,16,37.5,10,19,0,19,9,34,15,0,0,2018-2019,0.4072398190045249,1.1312217194570136
959,Mason Greenwood,ENG,FW,Manchester Utd,Premier League,16,2001,1.3,3,3,2,0,1,2,3,66.7,1,2,0,2,0,3,1,0,0,2018-2019,0.0,2.3076923076923075
960,Michael Gregoritsch,AUT,"MF,FW",Augsburg,Bundesliga,24,1994,27.6,22,13,7,9,6,4,28,14.3,24,29,10,19,15,37,58,0,0,2018-2019,0.5434782608695652,0.7971014492753623
961,Clément Grenier,FRA,MF,Rennes,Ligue 1,27,1991,29.6,44,27,7,33,4,21,61,34.4,40,28,4,24,29,73,34,1,0,2018-2019,0.9797297297297297,1.4864864864864864
962,Antoine Griezmann,FRA,"FW,MF",Atlético Madrid,La Liga,27,1991,35.5,31,19,8,13,10,8,28,28.6,20,18,1,17,12,43,21,0,0,2018-2019,0.3380281690140845,0.8732394366197183
963,Vincenzo Grifo,ITA,"MF,FW",Hoffenheim,Bundesliga,25,1993,3.7,6,3,2,3,1,0,5,0.0,5,2,1,1,2,8,5,0,0,2018-2019,0.5405405405405405,1.6216216216216215
964,Vincenzo Grifo,ITA,"MF,FW",Freiburg,Bundesliga,25,1993,15.9,26,14,11,8,7,14,27,51.9,13,10,1,9,2,28,10,0,0,2018-2019,0.12578616352201258,1.6352201257861634
965,Florian Grillitsch,AUT,MF,Hoffenheim,Bundesliga,22,1995,26.6,77,49,30,38,9,36,80,45.0,44,34,8,26,72,149,56,1,0,2018-2019,2.706766917293233,2.894736842105263
966,Jérémy Grimm,FRA,MF,Strasbourg,Ligue 1,31,1987,1.9,4,2,2,2,0,3,5,60.0,2,1,0,1,4,8,5,0,0,2018-2019,2.1052631578947367,2.1052631578947367
967,Pascal Groß,GER,"MF,FW",Brighton,Premier League,27,1991,20.7,27,12,12,12,3,11,36,30.6,25,20,8,12,13,40,23,0,0,2018-2019,0.6280193236714976,1.3043478260869565
968,Sergej Grubac,MNE,FW,Chievo,Serie A,18,2000,1.7,2,1,1,0,1,1,1,100.0,0,1,0,1,0,2,1,0,0,2018-2019,0.0,1.1764705882352942
969,Marko Grujić,SRB,MF,Hertha BSC,Bundesliga,22,1996,19.8,45,33,17,20,8,13,38,34.2,25,29,6,23,29,74,51,1,0,2018-2019,1.4646464646464645,2.2727272727272725
970,Vicente Guaita,ESP,GK,Crystal Palace,Premier League,31,1987,19.5,0,0,0,0,0,0,0,0.0,0,0,0,0,0,0,5,2,0,2018-2019,0.0,0.0
971,Andrés Guardado,MEX,"MF,DF",Betis,La Liga,31,1986,25.9,24,15,9,12,3,11,47,23.4,36,27,1,26,28,52,28,1,0,2018-2019,1.0810810810810811,0.9266409266409267
972,Sergi Guardiola,ESP,FW,Valladolid,La Liga,27,1991,16.8,19,11,1,10,8,2,13,15.4,11,12,0,12,5,24,17,0,0,2018-2019,0.2976190476190476,1.130952380952381
973,Sergi Guardiola,ESP,"MF,FW",Getafe,La Liga,27,1991,0.3,1,1,0,1,0,0,0,0.0,0,0,0,0,0,1,0,0,0,2018-2019,0.0,3.3333333333333335
974,Metehan Güçlü,TUR,MF,Paris S-G,Ligue 1,19,1999,0.2,0,0,0,0,0,0,0,0.0,0,0,0,0,0,0,0,0,0,2018-2019,0.0,0.0
975,Gonçalo Guedes,POR,"MF,FW",Valencia,La Liga,21,1996,16.3,31,13,16,12,3,14,43,32.6,29,15,0,15,7,38,1,0,0,2018-2019,0.42944785276073616,1.901840490797546
Rk,Player,Nation,Pos,Squad,Comp,0,0,90.0,0,0,3,3,3,Tkl,0,0.0,0,0,0,0,0,0,0,0,0,2018-2019,0.0,0.0
976,Mattéo Guendouzi,FRA,MF,Arsenal,Premier League,19,1999,23.9,44,26,18,23,3,17,47,36.2,30,28,5,23,30,74,24,3,0,2018-2019,1.2552301255230127,1.8410041841004186
977,Javi Guerra,ESP,"FW,MF",Rayo Vallecano,La Liga,36,1982,2.6,3,3,1,1,1,0,3,0.0,3,2,0,2,1,4,0,0,0,2018-2019,0.3846153846153846,1.1538461538461537
978,Raphaël Guerreiro,POR,"FW,DF",Dortmund,Bundesliga,24,1993,17.0,25,12,11,7,7,12,23,52.2,11,7,1,6,18,43,12,1,0,2018-2019,1.0588235294117647,1.4705882352941178
979,Francis Guerrero,ESP,"DF,FW",Betis,La Liga,22,1996,19.8,51,28,25,16,10,23,41,56.1,18,15,1,14,21,72,47,4,0,2018-2019,1.0606060606060606,2.5757575757575757
980,Guido Guerrieri,ITA,GK,Lazio,Serie A,22,1996,1.0,0,0,0,0,0,0,0,0.0,0,0,0,0,0,0,2,0,0,2018-2019,0.0,0.0
981,Ander Guevara,ESP,MF,Real Sociedad,La Liga,21,1997,1.0,3,1,0,3,0,2,6,33.3,4,1,0,1,1,4,0,0,0,2018-2019,1.0,3.0
982,Makhtar Gueye,SEN,"FW,MF",Saint-Étienne,Ligue 1,20,1997,0.6,2,1,2,0,0,2,2,100.0,0,2,0,2,0,2,0,0,0,2018-2019,0.0,3.3333333333333335
983,John Guidetti,SWE,FW,Alavés,La Liga,26,1992,7.0,4,1,0,3,1,0,4,0.0,4,4,0,4,1,5,6,0,0,2018-2019,0.14285714285714285,0.5714285714285714
984,Josuha Guilavogui,FRA,MF,Wolfsburg,Bundesliga,27,1990,17.4,31,16,18,13,0,14,25,56.0,11,17,8,9,43,74,56,2,0,2018-2019,2.4712643678160924,1.781609195402299
985,Frederic Guilbert,FRA,DF,Caen,Ligue 1,23,1994,32.4,98,67,59,29,10,41,83,49.4,42,49,21,28,78,176,121,2,0,2018-2019,2.4074074074074074,3.0246913580246915
986,Baptiste Guillaume,BEL,FW,Nîmes,Ligue 1,23,1995,13.1,12,6,1,8,3,2,9,22.2,7,6,0,6,2,14,6,0,0,2018-2019,0.15267175572519084,0.916030534351145
987,Serhou Guirassy,GUI,FW,Amiens,Ligue 1,22,1996,12.3,7,5,1,5,1,0,4,0.0,4,7,0,7,4,11,14,0,0,2018-2019,0.3252032520325203,0.5691056910569106
988,Péter Gulácsi,HUN,GK,RB Leipzig,Bundesliga,28,1990,32.5,0,0,0,0,0,0,0,0.0,0,0,0,0,0,0,11,0,0,2018-2019,0.0,0.0
989,Manuel Gulde,GER,DF,Freiburg,Bundesliga,27,1991,19.0,24,16,18,5,1,12,16,75.0,4,25,13,12,26,50,90,0,0,2018-2019,1.368421052631579,1.263157894736842
990,Gerard Gumbau,ESP,MF,Leganés,La Liga,23,1994,13.3,22,16,9,13,0,6,25,24.0,19,15,2,13,13,35,13,0,0,2018-2019,0.9774436090225563,1.6541353383458646
991,İlkay Gündoğan,GER,MF,Manchester City,Premier League,27,1990,23.7,19,12,4,12,3,6,31,19.4,25,12,3,9,28,47,19,1,0,2018-2019,1.1814345991561181,0.8016877637130801
992,Angus Gunn,SCO,GK,Southampton,Premier League,22,1996,12.0,0,0,0,0,0,0,0,0.0,0,0,0,0,0,0,8,3,0,2018-2019,0.0,0.0
993,Aron Gunnarsson,ISL,MF,Cardiff City,Premier League,29,1989,25.2,51,29,23,25,3,23,84,27.4,61,40,12,28,38,89,55,1,0,2018-2019,1.507936507936508,2.0238095238095237
994,Christian Günter,GER,"DF,MF",Freiburg,Bundesliga,25,1993,32.0,38,26,16,16,6,20,43,46.5,23,31,7,24,14,52,55,0,0,2018-2019,0.4375,1.1875
995,Koray Günter,GER,DF,Genoa,Serie A,23,1994,9.3,18,13,13,3,2,9,16,56.3,7,9,7,2,18,36,34,0,0,2018-2019,1.9354838709677418,1.9354838709677418
996,Serdar Gürler,TUR,"MF,FW",Huesca,La Liga,26,1991,5.4,5,5,3,2,0,3,11,27.3,8,8,0,8,1,6,2,0,0,2018-2019,0.18518518518518517,0.9259259259259258
997,Ahmet Gürleyen,GER,DF,Mainz 05,Bundesliga,19,1999,0.1,0,0,0,0,0,0,0,0.0,0,0,0,0,0,0,1,0,0,2018-2019,0.0,0.0
998,Régis Gurtner,FRA,GK,Amiens,Ligue 1,31,1986,38.0,1,1,1,0,0,0,1,0.0,1,0,0,0,1,2,7,3,0,2018-2019,0.02631578947368421,0.02631578947368421
999,Gorka Guruzeta,ESP,"MF,FW",Athletic Club,La Liga,21,1996,0.6,1,1,1,0,0,0,2,0.0,2,1,0,1,2,3,0,0,0,2018-2019,3.3333333333333335,1.6666666666666667
1000,Luiz Gustavo,BRA,"MF,DF",Marseille,Ligue 1,31,1987,27.1,72,43,49,18,5,30,66,45.5,36,26,12,14,34,106,61,0,0,2018-2019,1.2546125461254611,2.6568265682656826
Rk,Player,Nation,Pos,Squad,Comp,0,0,90.0,0,0,3,3,3,Tkl,0,0.0,0,0,0,0,0,0,0,0,0,2018-2019,0.0,0.0
1001,Jonathan de Guzmán,NED,MF,Eint Frankfurt,Bundesliga,30,1987,17.4,34,24,11,20,3,13,28,46.4,15,18,2,16,11,45,16,0,0,2018-2019,0.632183908045977,1.9540229885057472
1002,Janik Haberer,GER,"MF,FW",Freiburg,Bundesliga,24,1994,26.0,71,47,37,24,10,30,75,40.0,45,31,4,27,36,107,49,0,0,2018-2019,1.3846153846153846,2.730769230769231
1003,Hacen,MTN,MF,Valladolid,La Liga,20,1997,0.0,0,0,0,0,0,0,0,0.0,0,1,0,1,1,1,1,0,0,2018-2019,inf,
1004,Alexander Hack,GER,DF,Mainz 05,Bundesliga,24,1993,11.3,29,13,20,9,0,19,28,67.9,9,26,15,11,41,70,59,2,0,2018-2019,3.6283185840707963,2.566371681415929
1005,Munir El Haddadi,MAR,"FW,MF",Sevilla,La Liga,22,1995,11.6,17,10,5,7,5,2,7,28.6,5,15,0,15,6,23,9,0,0,2018-2019,0.5172413793103449,1.4655172413793105
1006,Munir El Haddadi,MAR,FW,Barcelona,La Liga,22,1995,1.7,3,3,1,1,1,1,3,33.3,2,1,0,1,0,3,1,0,0,2018-2019,0.0,1.7647058823529411
1007,Oussama Haddadi,TUN,DF,Dijon,Ligue 1,26,1992,29.7,51,25,38,11,2,24,43,55.8,19,33,8,25,45,96,93,2,0,2018-2019,1.5151515151515151,1.7171717171717171
1008,Florent Hadergjonaj,KVX,"DF,MF",Huddersfield,Premier League,24,1994,20.5,30,17,10,18,2,13,37,35.1,24,21,7,14,21,51,37,1,0,2018-2019,1.024390243902439,1.4634146341463414
1009,Benjamin Hadžić,BIH,"FW,MF",Hannover 96,Bundesliga,19,1999,0.3,0,0,0,0,0,0,1,0.0,1,0,0,0,0,0,0,0,0,2018-2019,0.0,0.0
1010,André Hahn,GER,"FW,MF",Augsburg,Bundesliga,27,1990,22.8,64,38,22,39,3,22,53,41.5,31,28,2,26,27,91,32,0,0,2018-2019,1.1842105263157894,2.807017543859649
1011,Amadou Haidara,MLI,MF,RB Leipzig,Bundesliga,20,1998,4.2,13,11,4,8,1,8,14,57.1,6,9,1,8,4,17,7,0,0,2018-2019,0.9523809523809523,3.095238095238095
1012,Oualid El Hajjam,MAR,"DF,MF",Amiens,Ligue 1,27,1991,6.0,14,9,10,3,1,5,15,33.3,10,8,2,6,12,26,26,0,0,2018-2019,2.0,2.3333333333333335
1013,Achraf Hakimi,MAR,DF,Dortmund,Bundesliga,19,1998,19.3,34,19,25,8,1,17,36,47.2,19,27,4,23,29,63,45,2,0,2018-2019,1.5025906735751295,1.761658031088083
1014,Sébastien Haller,CIV,FW,Eint Frankfurt,Bundesliga,24,1994,24.2,24,11,7,10,7,8,21,38.1,13,21,1,20,15,39,23,0,0,2018-2019,0.6198347107438017,0.9917355371900827
1015,Emil Hallfreðsson,ISL,MF,Udinese,Serie A,34,1984,1.5,0,0,0,0,0,0,1,0.0,1,1,1,0,3,3,4,0,0,2018-2019,2.0,0.0
1016,Emil Hallfreðsson,ISL,MF,Frosinone,Serie A,34,1984,4.4,10,6,5,4,1,0,9,0.0,9,4,1,3,2,12,3,0,0,2018-2019,0.45454545454545453,2.2727272727272725
1017,Marcel Halstenberg,GER,"DF,FW",RB Leipzig,Bundesliga,26,1991,26.8,68,44,31,24,13,42,65,64.6,23,27,4,23,38,106,69,0,0,2018-2019,1.417910447761194,2.5373134328358207
1018,Ben Hamer,ENG,GK,Huddersfield,Premier League,30,1987,6.1,0,0,0,0,0,0,3,0.0,3,0,0,0,1,1,3,2,0,2018-2019,0.1639344262295082,0.0
1019,Romain Hamouma,FRA,"FW,MF",Saint-Étienne,Ligue 1,31,1987,17.6,30,19,6,18,6,12,32,37.5,20,12,1,11,9,39,7,0,0,2018-2019,0.5113636363636364,1.7045454545454544
1020,Marek Hamšík,SVK,MF,Napoli,Serie A,31,1987,10.2,7,5,2,4,1,0,11,0.0,11,8,1,7,12,19,14,1,0,2018-2019,1.1764705882352942,0.6862745098039216
1021,Dávid Hancko,SVK,DF,Fiorentina,Serie A,20,1997,3.1,7,6,4,3,0,6,9,66.7,3,3,1,2,3,10,12,0,0,2018-2019,0.9677419354838709,2.258064516129032
1022,Samir Handanović,SVN,GK,Inter,Serie A,34,1984,38.0,1,0,1,0,0,1,1,100.0,0,0,0,0,0,1,12,1,0,2018-2019,0.0,0.02631578947368421
1023,Genki Haraguchi,JPN,"MF,DF",Hannover 96,Bundesliga,27,1991,23.7,44,26,21,20,3,17,66,25.8,49,34,5,29,21,65,33,0,0,2018-2019,0.8860759493670887,1.8565400843881856
1024,Féthi Harek,ALG,DF,Nîmes,Ligue 1,35,1982,2.0,4,4,2,2,0,3,4,75.0,1,1,0,1,1,5,6,0,0,2018-2019,0.5,2.0
1025,Amine Harit,MAR,"MF,FW",Schalke 04,Bundesliga,21,1997,12.0,15,8,4,9,2,8,24,33.3,16,11,1,10,9,24,2,0,0,2018-2019,0.75,1.25
Rk,Player,Nation,Pos,Squad,Comp,0,0,90.0,0,0,3,3,3,Tkl,0,0.0,0,0,0,0,0,0,0,0,0,2018-2019,0.0,0.0
1026,Martin Harnik,AUT,"FW,MF",Werder Bremen,Bundesliga,31,1987,9.2,12,7,4,3,5,4,15,26.7,11,8,0,8,3,15,10,0,0,2018-2019,0.32608695652173914,1.3043478260869565
1027,Kadeem Harris,ENG,MF,Cardiff City,Premier League,25,1993,4.2,12,5,6,4,2,7,8,87.5,1,3,0,3,3,15,5,0,0,2018-2019,0.7142857142857143,2.857142857142857
1028,Joe Hart,ENG,GK,Burnley,Premier League,31,1987,19.0,0,0,0,0,0,0,1,0.0,1,0,0,0,0,0,11,3,0,2018-2019,0.0,0.0
1029,Makoto Hasebe,JPN,"DF,MF",Eint Frankfurt,Bundesliga,34,1984,28.0,52,34,35,17,0,25,42,59.5,17,43,22,21,40,92,101,3,0,2018-2019,1.4285714285714286,1.8571428571428572
1030,Hans Hateboer,NED,DF,Atalanta,Serie A,24,1994,33.0,43,31,19,19,5,17,34,50.0,17,29,5,24,23,66,47,1,0,2018-2019,0.696969696969697,1.303030303030303
1031,Kai Havertz,GER,"MF,FW",Leverkusen,Bundesliga,19,1999,32.2,26,17,10,11,5,8,32,25.0,24,31,4,27,16,42,29,0,0,2018-2019,0.49689440993788814,0.8074534161490683
1032,Isaac Hayden,ENG,MF,Newcastle Utd,Premier League,23,1995,20.7,73,43,19,45,9,23,41,56.1,18,32,4,28,40,113,30,0,0,2018-2019,1.9323671497584543,3.526570048309179
1033,Eden Hazard,BEL,FW,Chelsea,Premier League,27,1991,32.5,14,9,2,1,11,5,17,29.4,12,10,0,10,13,27,6,1,0,2018-2019,0.4,0.4307692307692308
1034,Thorgan Hazard,BEL,"FW,MF",Gladbach,Bundesliga,25,1993,31.9,50,33,22,20,8,17,48,35.4,31,35,2,33,27,77,12,0,0,2018-2019,0.8463949843260189,1.567398119122257
1035,Rhys Healey,WAL,FW,Cardiff City,Premier League,23,1994,0.6,1,0,0,1,0,0,1,0.0,1,0,0,0,0,1,0,0,0,2018-2019,0.0,1.6666666666666667
1036,Tom Heaton,ENG,GK,Burnley,Premier League,32,1986,19.0,0,0,0,0,0,0,2,0.0,2,0,0,0,0,0,8,2,0,2018-2019,0.0,0.0
1037,Dominique Heintz,GER,DF,Freiburg,Bundesliga,24,1993,33.9,41,21,34,6,1,18,32,56.3,14,45,22,23,45,86,214,0,0,2018-2019,1.3274336283185841,1.2094395280235988
1038,Filip Helander,SWE,DF,Bologna,Serie A,25,1993,19.0,42,26,25,13,4,19,23,82.6,4,27,16,11,14,56,84,0,0,2018-2019,0.7368421052631579,2.210526315789474
1039,Jordan Henderson,ENG,MF,Liverpool,Premier League,28,1990,22.1,46,36,20,22,4,16,39,41.0,23,27,3,24,30,76,17,0,0,2018-2019,1.3574660633484161,2.0814479638009047
1040,Jeff Hendrick,IRL,"MF,FW",Burnley,Premier League,26,1992,22.9,24,12,13,7,4,9,32,28.1,23,20,5,15,12,36,31,0,0,2018-2019,0.5240174672489083,1.0480349344978166
1041,Wayne Hennessey,WAL,GK,Crystal Palace,Premier League,31,1987,17.5,0,0,0,0,0,0,2,0.0,2,0,0,0,0,0,5,1,0,2018-2019,0.0,0.0
1042,Rouwen Hennings,GER,FW,Düsseldorf,Bundesliga,30,1987,20.4,14,10,1,8,5,2,13,15.4,11,16,1,15,4,18,20,0,0,2018-2019,0.19607843137254904,0.6862745098039216
1043,Benjamin Henrichs,GER,"DF,MF",Monaco,Ligue 1,21,1997,20.3,58,39,32,22,4,16,38,42.1,22,18,0,18,35,93,45,0,0,2018-2019,1.7241379310344827,2.857142857142857
1044,Benjamin Henrichs,GER,DF,Leverkusen,Bundesliga,21,1997,0.7,0,0,0,0,0,0,0,0.0,0,2,0,2,3,3,0,0,0,2018-2019,4.285714285714286,0.0
1045,Dalbert Henrique,BRA,DF,Inter,Serie A,24,1993,8.6,33,24,18,14,1,12,21,57.1,9,9,3,6,8,41,20,0,0,2018-2019,0.9302325581395349,3.8372093023255816
1046,Uche Henry Agbo,NGA,MF,Rayo Vallecano,La Liga,22,1995,4.1,7,4,3,4,0,5,10,50.0,5,3,1,2,6,13,1,0,0,2018-2019,1.4634146341463417,1.707317073170732
1047,Christophe Hérelle,MTQ,DF,Nice,Ligue 1,25,1992,32.6,72,52,51,19,2,40,50,80.0,10,39,16,23,61,133,158,2,0,2018-2019,1.871165644171779,2.2085889570552144
1048,Mario Hermoso,ESP,DF,Espanyol,La Liga,23,1995,31.2,38,24,29,7,2,21,39,53.8,18,34,25,9,37,75,175,2,0,2018-2019,1.185897435897436,1.217948717948718
1049,Javier Hernández,MEX,FW,West Ham,Premier League,30,1988,14.8,3,0,0,3,0,0,6,0.0,6,8,1,7,1,4,8,0,0,2018-2019,0.06756756756756756,0.2027027027027027
1050,Lucas Hernández,FRA,DF,Atlético Madrid,La Liga,22,1996,12.4,35,25,20,14,1,17,20,85.0,3,17,9,8,14,49,49,0,0,2018-2019,1.129032258064516,2.82258064516129
Rk,Player,Nation,Pos,Squad,Comp,0,0,90.0,0,0,3,3,3,Tkl,0,0.0,0,0,0,0,0,0,0,0,0,2018-2019,0.0,0.0
1051,Theo Hernández,FRA,DF,Real Sociedad,La Liga,20,1997,22.0,54,33,30,15,9,28,44,63.6,16,21,5,16,33,87,42,3,0,2018-2019,1.5,2.4545454545454546
1052,Ander Herrera,ESP,MF,Manchester Utd,Premier League,28,1989,15.6,54,28,24,22,8,21,61,34.4,40,38,6,32,37,91,25,1,0,2018-2019,2.371794871794872,3.4615384615384617
1053,Yangel Herrera,VEN,"MF,DF",Huesca,La Liga,20,1998,12.8,48,24,18,25,5,23,43,53.5,20,13,1,12,14,62,32,0,0,2018-2019,1.09375,3.75
1054,Iago Herrerín,ESP,GK,Athletic Club,La Liga,30,1988,31.0,0,0,0,0,0,0,2,0.0,2,0,0,0,0,0,11,2,0,2018-2019,0.0,0.0
1055,Patrick Herrmann,GER,"FW,DF",Gladbach,Bundesliga,27,1991,12.0,20,14,8,7,5,6,17,35.3,11,6,3,3,6,26,12,0,0,2018-2019,0.5,1.6666666666666667
1056,Pablo Hervías,ESP,MF,Valladolid,La Liga,25,1993,1.8,1,0,0,1,0,0,1,0.0,1,0,0,0,2,3,0,0,0,2018-2019,1.1111111111111112,0.5555555555555556
1057,Pablo Hervías,ESP,MF,Eibar,La Liga,25,1993,2.0,1,1,0,1,0,0,4,0.0,4,2,0,2,0,1,0,0,0,2018-2019,0.0,0.5
1058,Përparim Hetemaj,FIN,MF,Chievo,Serie A,31,1986,24.0,53,27,27,23,3,20,68,29.4,48,25,1,24,30,83,24,2,0,2018-2019,1.25,2.2083333333333335
1059,Son Heung-min,KOR,"FW,MF",Tottenham,Premier League,26,1992,22.7,23,12,7,12,4,10,34,29.4,24,26,2,24,8,31,4,1,0,2018-2019,0.3524229074889868,1.013215859030837
1060,Gonzalo Higuaín,ARG,FW,Chelsea,Premier League,30,1987,12.1,10,7,2,4,4,2,11,18.2,9,4,0,4,1,11,5,0,0,2018-2019,0.08264462809917356,0.8264462809917356
1061,Gonzalo Higuaín,ARG,FW,Milan,Serie A,30,1987,14.2,8,6,1,5,2,5,13,38.5,8,3,0,3,0,8,11,1,0,2018-2019,0.0,0.5633802816901409
1062,Oscar Hiljemark,SWE,MF,Genoa,Serie A,26,1992,13.3,16,9,8,7,1,5,16,31.3,11,13,3,10,13,29,14,0,0,2018-2019,0.9774436090225563,1.2030075187969924
1063,Vitorino Hilton,BRA,DF,Montpellier,Ligue 1,40,1977,35.9,33,13,28,5,0,12,30,40.0,18,31,15,16,66,99,198,2,0,2018-2019,1.8384401114206128,0.9192200557103064
1064,Martin Hinteregger,AUT,DF,Augsburg,Bundesliga,25,1992,17.5,48,35,31,16,1,24,35,68.6,11,24,13,11,22,70,68,0,0,2018-2019,1.2571428571428571,2.742857142857143
1065,Martin Hinteregger,AUT,DF,Eint Frankfurt,Bundesliga,25,1992,12.7,34,26,19,12,3,13,28,46.4,15,20,7,13,13,47,51,0,0,2018-2019,1.0236220472440944,2.677165354330709
1066,Marwin Hitz,SUI,GK,Dortmund,Bundesliga,30,1987,2.0,0,0,0,0,0,0,0,0.0,0,0,0,0,0,0,0,1,0,2018-2019,0.0,0.0
1067,Andrew Hjulsager,DEN,"MF,FW",Celta Vigo,La Liga,23,1995,4.0,16,10,11,2,3,2,18,11.1,16,4,0,4,2,18,1,0,0,2018-2019,0.5,4.0
1068,Wesley Hoedt,NED,DF,Southampton,Premier League,24,1994,13.0,28,12,23,5,0,17,26,65.4,9,20,13,7,23,51,79,2,0,2018-2019,1.7692307692307692,2.1538461538461537
1069,Wesley Hoedt,NED,DF,Celta Vigo,La Liga,24,1994,9.9,17,11,15,2,0,12,17,70.6,5,17,11,6,11,28,58,3,0,2018-2019,1.1111111111111112,1.7171717171717171
1070,André Hoffmann,GER,"DF,MF",Düsseldorf,Bundesliga,25,1993,11.7,22,14,12,10,0,9,25,36.0,16,17,12,5,21,43,44,0,0,2018-2019,1.794871794871795,1.8803418803418805
1071,Nicolas Höfler,GER,MF,Freiburg,Bundesliga,28,1990,17.9,45,22,19,22,4,14,36,38.9,22,21,4,17,32,77,41,0,0,2018-2019,1.787709497206704,2.5139664804469275
1072,Jonas Hofmann,GER,MF,Gladbach,Bundesliga,26,1992,21.2,37,18,11,19,7,9,37,24.3,28,33,2,31,16,53,14,1,0,2018-2019,0.7547169811320755,1.7452830188679247
1073,Jonathan Hogg,ENG,MF,Huddersfield,Premier League,29,1988,26.3,78,41,18,51,9,27,69,39.1,42,46,7,39,73,151,19,1,0,2018-2019,2.7756653992395437,2.9657794676806084
1074,Junior Hoilett,CAN,"MF,FW",Cardiff City,Premier League,28,1990,23.8,40,27,26,11,3,15,53,28.3,38,34,0,34,32,72,30,0,0,2018-2019,1.3445378151260503,1.680672268907563
1075,Rob Holding,ENG,DF,Arsenal,Premier League,22,1995,9.0,11,7,9,2,0,2,8,25.0,6,9,7,2,12,23,40,0,0,2018-2019,1.3333333333333333,1.2222222222222223
Rk,Player,Nation,Pos,Squad,Comp,0,0,90.0,0,0,3,3,3,Tkl,0,0.0,0,0,0,0,0,0,0,0,0,2018-2019,0.0,0.0
1076,José Holebas,GRE,DF,Watford,Premier League,34,1984,26.6,68,40,44,20,4,28,53,52.8,25,27,8,19,21,89,97,0,0,2018-2019,0.7894736842105263,2.556390977443609
1077,Lucas Höler,GER,FW,Freiburg,Bundesliga,24,1994,11.2,18,13,6,9,3,4,18,22.2,14,10,1,9,3,21,15,2,0,2018-2019,0.26785714285714285,1.6071428571428572
1078,Mason Holgate,ENG,DF,Everton,Premier League,21,1996,4.5,5,4,4,1,0,1,1,100.0,0,3,2,1,3,8,32,0,0,2018-2019,0.6666666666666666,1.1111111111111112
1079,Gerrit Holtmann,PHI,"FW,MF",Mainz 05,Bundesliga,23,1995,1.6,2,0,1,0,1,1,2,50.0,1,3,2,1,4,6,1,0,0,2018-2019,2.5,1.25
1080,Justin Hoogma,NED,"DF,MF",Hoffenheim,Bundesliga,20,1998,1.2,4,2,2,1,1,2,2,100.0,0,3,1,2,2,6,1,0,0,2018-2019,1.6666666666666667,3.3333333333333335
1081,Lukáš Hrádecký,FIN,GK,Leverkusen,Bundesliga,28,1989,32.0,0,0,0,0,0,0,1,0.0,1,0,0,0,1,1,9,1,0,2018-2019,0.03125,0.0
1082,Branimir Hrgota,SWE,FW,Eint Frankfurt,Bundesliga,25,1993,0.1,0,0,0,0,0,0,0,0.0,0,0,0,0,0,0,0,0,0,2018-2019,0.0,0.0
1083,Benjamin Hübner,GER,DF,Hoffenheim,Bundesliga,29,1989,9.0,29,18,18,9,2,14,18,77.8,4,16,7,9,21,50,35,0,0,2018-2019,2.3333333333333335,3.2222222222222223
1084,Tomáš Hubočan,SVK,DF,Marseille,Ligue 1,32,1985,0.8,3,2,3,0,0,3,4,75.0,1,0,0,0,2,5,5,0,0,2018-2019,2.5,3.75
1085,Callum Hudson-Odoi,ENG,FW,Chelsea,Premier League,17,2000,4.4,8,6,8,0,0,2,4,50.0,2,1,0,1,3,11,0,0,0,2018-2019,0.6818181818181818,1.8181818181818181
1086,Will Hughes,ENG,MF,Watford,Premier League,23,1995,26.9,74,43,27,35,12,25,59,42.4,34,55,6,49,25,99,30,0,0,2018-2019,0.929368029739777,2.7509293680297398
1087,Vitor Hugo,BRA,DF,Fiorentina,Serie A,27,1991,27.4,64,42,38,25,1,17,27,63.0,10,28,13,15,74,138,141,2,0,2018-2019,2.7007299270072993,2.3357664233576645
1088,Mats Hummels,GER,DF,Bayern Munich,Bundesliga,29,1988,19.7,26,17,19,6,1,9,24,37.5,15,20,8,12,34,60,50,1,0,2018-2019,1.7258883248730965,1.3197969543147208
1089,Adrien Hunou,FRA,"FW,MF",Rennes,Ligue 1,24,1994,13.8,11,7,3,5,3,2,9,22.2,7,14,0,14,5,16,8,0,0,2018-2019,0.36231884057971014,0.7971014492753623
1090,Emerson Hyndman,USA,MF,Bournemouth,Premier League,22,1996,0.4,6,2,6,0,0,2,3,66.7,1,0,0,0,1,7,0,0,0,2018-2019,2.5,15.0
1091,Elseid Hysaj,ALB,DF,Napoli,Serie A,24,1994,23.4,40,28,22,15,3,25,49,51.0,24,11,3,8,24,64,51,0,0,2018-2019,1.0256410256410258,1.7094017094017095
1092,Suk Hyun-jun,KOR,FW,Reims,Ligue 1,27,1991,8.8,11,8,1,6,4,0,8,0.0,8,2,1,1,2,13,4,1,0,2018-2019,0.22727272727272727,1.25
1093,Pierre Højbjerg,DEN,MF,Southampton,Premier League,22,1995,30.7,71,49,20,44,7,24,73,32.9,49,51,8,43,60,131,30,1,0,2018-2019,1.9543973941368078,2.3127035830618894
1094,Simone Iacoponi,ITA,DF,Parma,Serie A,31,1987,37.2,62,43,50,11,1,27,47,57.4,20,40,26,14,37,99,178,3,0,2018-2019,0.9946236559139784,1.6666666666666665
1095,Robert Ibáñez,ESP,MF,Getafe,La Liga,25,1993,0.8,2,2,1,1,0,0,1,0.0,1,3,0,3,0,2,0,0,0,2018-2019,0.0,2.5
1096,Roger Ibanez,BRA,"DF,FW",Atalanta,Serie A,19,1998,0.0,0,0,0,0,0,0,0,0.0,0,0,0,0,0,0,1,0,0,2018-2019,,
1097,Jordon Ibe,ENG,"MF,DF",Bournemouth,Premier League,22,1995,8.9,6,5,0,5,1,2,7,28.6,5,2,0,2,4,10,4,0,0,2018-2019,0.449438202247191,0.6741573033707865
1098,Vedad Ibišević,BIH,FW,Hertha BSC,Bundesliga,33,1984,20.1,12,8,2,5,5,0,10,0.0,10,10,4,6,3,15,20,0,0,2018-2019,0.14925373134328357,0.5970149253731343
1099,Vicente Iborra,ESP,MF,Leicester City,Premier League,30,1988,2.5,4,1,1,3,0,0,7,0.0,7,1,0,1,8,12,4,1,0,2018-2019,3.2,1.6
1100,Vicente Iborra,ESP,MF,Villarreal,La Liga,30,1988,18.5,31,18,22,5,4,14,37,37.8,23,25,7,18,22,53,41,1,0,2018-2019,1.1891891891891893,1.6756756756756757
Rk,Player,Nation,Pos,Squad,Comp,0,0,90.0,0,0,3,3,3,Tkl,0,0.0,0,0,0,0,0,0,0,0,0,2018-2019,0.0,0.0
1101,Didier Ibrahim Ndong,GAB,MF,Guingamp,Ligue 1,24,1994,8.3,16,11,3,13,0,5,13,38.5,8,15,3,12,15,31,6,1,0,2018-2019,1.8072289156626504,1.9277108433734937
1102,Mauro Icardi,ARG,FW,Inter,Serie A,25,1993,25.2,9,8,2,2,5,1,6,16.7,5,4,1,3,3,12,20,1,0,2018-2019,0.11904761904761905,0.35714285714285715
1103,Salvador Ichazo,URU,GK,Torino,Serie A,26,1992,2.8,0,0,0,0,0,0,0,0.0,0,0,0,0,0,0,0,0,0,2018-2019,0.0,0.0
1104,Edgar Ié,GNB,DF,Lille,Ligue 1,24,1994,2.7,5,4,3,2,0,3,5,60.0,2,2,1,1,7,12,17,0,0,2018-2019,2.5925925925925926,1.8518518518518516
1105,Edgar Ié,GNB,DF,Nantes,Ligue 1,24,1994,8.6,20,13,12,6,2,9,16,56.3,7,10,3,7,8,28,23,0,0,2018-2019,0.9302325581395349,2.3255813953488373
1106,Borja Iglesias,ESP,FW,Espanyol,La Liga,25,1993,34.2,23,14,7,8,8,5,24,20.8,19,14,6,8,7,30,41,0,0,2018-2019,0.2046783625730994,0.6725146198830408
1107,Kelechi Iheanacho,NGA,"FW,MF",Leicester City,Premier League,21,1996,10.5,6,5,4,1,1,1,5,20.0,4,5,0,5,2,8,3,0,0,2018-2019,0.19047619047619047,0.5714285714285714
1108,Jordan Ikoko,COD,DF,Guingamp,Ligue 1,24,1994,19.0,37,24,22,14,1,16,28,57.1,12,18,5,13,24,61,30,0,0,2018-2019,1.263157894736842,1.9473684210526316
1109,Jonathan Ikone,FRA,"MF,FW",Lille,Ligue 1,20,1998,31.1,25,14,7,12,6,8,30,26.7,22,24,2,22,6,31,4,0,0,2018-2019,0.19292604501607716,0.8038585209003215
1110,Ivo Iličević,CRO,MF,Nürnberg,Bundesliga,31,1986,0.4,1,0,0,1,0,1,2,50.0,1,1,0,1,0,1,0,0,0,2018-2019,0.0,2.5
1111,Josip Iličić,SVN,"FW,MF",Atalanta,Serie A,30,1988,23.8,15,7,2,7,6,5,20,25.0,15,20,1,19,5,20,2,0,0,2018-2019,0.21008403361344538,0.6302521008403361
1112,Asier Illarramendi,ESP,MF,Real Sociedad,La Liga,28,1990,20.2,39,24,22,14,3,21,51,41.2,30,36,9,27,31,70,46,1,0,2018-2019,1.5346534653465347,1.9306930693069309
1113,Stefan Ilsanker,AUT,"DF,MF",RB Leipzig,Bundesliga,29,1989,10.4,26,17,15,10,1,14,23,60.9,9,9,2,7,18,44,43,1,0,2018-2019,1.7307692307692306,2.5
1114,Giannelli Imbula,COD,MF,Rayo Vallecano,La Liga,25,1992,19.2,14,7,6,7,1,5,12,41.7,7,12,3,9,8,22,6,0,0,2018-2019,0.4166666666666667,0.7291666666666667
1115,Ciro Immobile,ITA,FW,Lazio,Serie A,28,1990,31.8,12,6,4,3,5,4,9,44.4,5,18,1,17,1,13,8,0,0,2018-2019,0.031446540880503145,0.3773584905660377
1116,Emmanuel Imorou,BEN,DF,Caen,Ligue 1,29,1988,12.4,18,13,10,7,1,11,17,64.7,6,14,4,10,28,46,49,1,0,2018-2019,2.258064516129032,1.4516129032258065
1117,Svante Ingelsson,SWE,"DF,MF",Udinese,Serie A,20,1998,1.1,1,1,1,0,0,0,0,0.0,0,2,0,2,0,1,4,0,0,2018-2019,0.0,0.9090909090909091
1118,Roberto Inglese,ITA,FW,Parma,Serie A,26,1991,21.8,20,14,7,7,6,1,13,7.7,12,26,2,24,6,26,27,0,0,2018-2019,0.27522935779816515,0.9174311926605504
1119,Danny Ings,ENG,FW,Southampton,Premier League,26,1992,18.3,30,14,5,19,6,11,28,39.3,17,30,2,28,5,35,9,0,0,2018-2019,0.27322404371584696,1.639344262295082
1120,Lorenzo Insigne,ITA,"FW,MF",Napoli,Serie A,27,1991,23.0,14,4,5,6,3,6,18,33.3,12,7,0,7,8,22,3,0,0,2018-2019,0.34782608695652173,0.6086956521739131
1121,Emiliano Insúa,ARG,DF,Stuttgart,Bundesliga,29,1989,23.5,51,33,26,18,7,25,42,59.5,17,29,2,27,31,82,55,1,0,2018-2019,1.3191489361702127,2.1702127659574466
1122,Pablo Insua,ESP,DF,Huesca,La Liga,24,1993,8.6,23,10,14,9,0,8,15,53.3,7,2,0,2,12,35,40,0,0,2018-2019,1.3953488372093024,2.674418604651163
1123,Takashi Inui,JPN,"MF,FW",Alavés,La Liga,30,1988,9.2,9,5,6,2,1,5,18,27.8,13,5,0,5,4,13,3,0,0,2018-2019,0.4347826086956522,0.9782608695652175
1124,Takashi Inui,JPN,MF,Betis,La Liga,30,1988,4.2,4,3,0,4,0,3,7,42.9,4,3,0,3,1,5,1,0,0,2018-2019,0.23809523809523808,0.9523809523809523
1125,Artur Ioniță,MDA,MF,Cagliari,Serie A,27,1990,33.0,67,38,23,31,13,16,57,28.1,41,40,5,35,27,94,30,0,0,2018-2019,0.8181818181818182,2.0303030303030303
Rk,Player,Nation,Pos,Squad,Comp,0,0,90.0,0,0,3,3,3,Tkl,0,0.0,0,0,0,0,0,0,0,0,0,2018-2019,0.0,0.0
1126,Gorka Iraizoz,ESP,GK,Girona,La Liga,37,1981,6.2,1,0,1,0,0,1,1,100.0,0,0,0,0,1,2,7,0,0,2018-2019,0.16129032258064516,0.16129032258064516
1127,Carlos Isaac,ESP,DF,Atlético Madrid,La Liga,20,1998,1.0,0,0,0,0,0,0,2,0.0,2,2,0,2,1,1,2,0,0,2018-2019,1.0,0.0
1128,Isco,ESP,"MF,FW",Real Madrid,La Liga,26,1992,13.2,29,14,14,8,7,14,34,41.2,20,9,1,8,6,35,3,0,0,2018-2019,0.4545454545454546,2.1969696969696972
1129,Mikael Ishak,SWE,FW,Nürnberg,Bundesliga,25,1993,21.3,9,6,3,6,0,3,16,18.8,13,8,3,5,3,12,10,0,0,2018-2019,0.14084507042253522,0.4225352112676056
1130,Wilson Isidor,FRA,FW,Monaco,Ligue 1,17,2000,0.5,0,0,0,0,0,0,0,0.0,0,1,1,0,0,0,1,0,0,2018-2019,0.0,0.0
1131,Abass Issah,GHA,FW,Mainz 05,Bundesliga,19,1998,0.1,0,0,0,0,0,0,0,0.0,0,0,0,0,0,0,0,0,0,2018-2019,0.0,0.0
1132,Gian-Luca Itter,GER,DF,Wolfsburg,Bundesliga,19,1999,1.0,4,3,3,1,0,1,2,50.0,1,2,0,2,1,5,2,0,0,2018-2019,1.0,4.0
1133,Manuel Iturra,CHI,MF,Villarreal,La Liga,34,1984,0.8,2,0,0,2,0,0,0,0.0,0,1,0,1,2,4,2,0,0,2018-2019,2.5,2.5
1134,Ander Iturraspe,ESP,MF,Athletic Club,La Liga,29,1989,1.1,2,2,1,1,0,1,1,100.0,0,0,0,0,6,8,2,0,0,2018-2019,5.454545454545454,1.8181818181818181
1135,Ivi,ESP,"MF,FW",Valladolid,La Liga,24,1994,0.2,0,0,0,0,0,0,0,0.0,0,0,0,0,0,0,0,0,0,2018-2019,0.0,0.0
1136,Alex Iwobi,NGA,"FW,MF",Arsenal,Premier League,22,1996,21.9,28,14,10,16,2,6,25,24.0,19,21,1,20,12,40,13,1,0,2018-2019,0.5479452054794521,1.2785388127853883
1137,José Izquierdo,COL,"MF,FW",Brighton,Premier League,26,1992,8.8,15,9,9,4,2,10,20,50.0,10,7,1,6,5,20,7,0,0,2018-2019,0.5681818181818181,1.7045454545454544
1138,Armando Izzo,ITA,DF,Torino,Serie A,26,1992,36.3,76,50,35,35,6,33,53,62.3,20,52,24,28,88,164,149,2,0,2018-2019,2.4242424242424243,2.0936639118457303
1139,Koo Ja-cheol,KOR,MF,Augsburg,Bundesliga,29,1989,18.2,36,23,10,20,6,12,30,40.0,18,28,5,23,27,63,21,0,0,2018-2019,1.4835164835164836,1.978021978021978
1140,Lukas Jäger,AUT,"FW,MF",Nürnberg,Bundesliga,24,1994,0.3,0,0,0,0,0,0,2,0.0,2,0,0,0,0,0,0,0,0,2018-2019,0.0,0.0
1141,Phil Jagielka,ENG,DF,Everton,Premier League,35,1982,3.7,7,5,3,4,0,1,4,25.0,3,1,0,1,2,9,14,0,0,2018-2019,0.5405405405405405,1.8918918918918919
1142,Alireza Jahanbakhsh,IRN,"FW,MF",Brighton,Premier League,24,1993,11.3,32,18,17,11,4,11,30,36.7,19,16,0,16,11,43,4,0,0,2018-2019,0.9734513274336283,2.831858407079646
1143,Christophe Jallet,FRA,DF,Nice,Ligue 1,34,1983,9.8,29,21,12,13,4,16,27,59.3,11,21,5,16,14,43,32,0,0,2018-2019,1.4285714285714284,2.9591836734693877
1144,Jandrei,BRA,GK,Genoa,Serie A,25,1993,1.0,0,0,0,0,0,0,1,0.0,1,0,0,0,0,0,0,0,0,2018-2019,0.0,0.0
1145,Christoph Janker,GER,"MF,FW",Augsburg,Bundesliga,33,1985,0.8,2,1,2,0,0,0,0,0.0,0,1,0,1,0,2,1,0,0,2018-2019,0.0,2.5
1146,Marko Janković,MNE,"DF,MF",SPAL,Serie A,23,1995,0.6,3,1,2,1,0,0,2,0.0,2,0,0,0,0,3,0,0,0,2018-2019,0.0,5.0
1147,Jakub Jankto,CZE,MF,Sampdoria,Serie A,22,1996,10.7,7,4,5,2,0,4,15,26.7,11,18,2,16,9,16,16,0,0,2018-2019,0.8411214953271029,0.6542056074766356
1148,Daryl Janmaat,NED,DF,Watford,Premier League,29,1989,16.9,36,24,23,11,2,20,29,69.0,9,16,6,10,33,69,71,0,0,2018-2019,1.9526627218934913,2.1301775147928996
1149,Vincent Janssen,NED,FW,Tottenham,Premier League,24,1994,0.4,2,1,0,2,0,0,0,0.0,0,0,0,0,0,2,1,0,0,2018-2019,0.0,5.0
1150,Tony Jantschke,GER,DF,Gladbach,Bundesliga,28,1990,10.4,15,10,9,5,1,6,8,75.0,2,10,7,3,27,42,51,1,0,2018-2019,2.5961538461538463,1.4423076923076923
Rk,Player,Nation,Pos,Squad,Comp,0,0,90.0,0,0,3,3,3,Tkl,0,0.0,0,0,0,0,0,0,0,0,0,2018-2019,0.0,0.0
1151,Adnan Januzaj,BEL,"FW,MF",Real Sociedad,La Liga,23,1995,13.9,11,8,5,2,4,3,13,23.1,10,7,0,7,6,17,6,0,0,2018-2019,0.4316546762589928,0.7913669064748201
1152,Nicolas Janvier,FRA,MF,Rennes,Ligue 1,19,1998,0.0,0,0,0,0,0,0,0,0.0,0,0,0,0,0,0,0,0,0,2018-2019,,
1153,Paweł Jaroszyński,POL,DF,Chievo,Serie A,23,1994,15.0,29,18,17,8,4,16,32,50.0,16,15,4,11,24,53,41,1,0,2018-2019,1.6,1.9333333333333333
1154,Rune Jarstein,NOR,GK,Hertha BSC,Bundesliga,33,1984,30.5,0,0,0,0,0,0,0,0.0,0,0,0,0,1,1,8,1,0,2018-2019,0.03278688524590164,0.0
1155,Jason,ESP,"DF,FW",Levante,La Liga,24,1994,25.9,44,25,22,11,11,20,71,28.2,51,25,4,21,46,90,27,0,0,2018-2019,1.776061776061776,1.698841698841699
1156,Dennis Jastrzembski,POL,"FW,DF",Hertha BSC,Bundesliga,18,2000,0.7,0,0,0,0,0,0,3,0.0,3,0,0,0,1,1,0,0,0,2018-2019,1.4285714285714286,0.0
1157,Assil Jaziri,TUN,FW,Nice,Ligue 1,18,1999,0.4,2,2,0,2,0,1,2,50.0,1,1,0,1,1,3,0,0,0,2018-2019,2.5,5.0
1158,Corentin Jean,FRA,"FW,MF",Toulouse,Ligue 1,23,1995,7.0,9,6,3,6,0,2,8,25.0,6,8,0,8,2,11,5,0,0,2018-2019,0.2857142857142857,1.2857142857142858
1159,Benjamin Jeannot,FRA,"FW,MF",Dijon,Ligue 1,26,1992,16.0,17,12,5,7,5,6,19,31.6,13,15,3,12,12,29,14,0,0,2018-2019,0.75,1.0625
1160,Tin Jedvaj,CRO,DF,Leverkusen,Bundesliga,22,1995,12.5,23,15,9,8,6,10,19,52.6,9,28,2,26,22,45,52,0,0,2018-2019,1.76,1.84
1161,Jemerson,BRA,"DF,MF",Monaco,Ligue 1,25,1992,24.7,54,38,34,19,1,29,46,63.0,17,29,17,12,25,79,121,1,0,2018-2019,1.0121457489878543,2.1862348178137654
1162,Carl Jenkinson,ENG,DF,Arsenal,Premier League,26,1992,1.8,3,2,2,0,1,2,3,66.7,1,4,3,1,0,3,2,0,0,2018-2019,0.0,1.6666666666666665
1163,Fredrik Jensen,FIN,"FW,MF",Augsburg,Bundesliga,20,1997,2.3,5,4,3,1,1,2,4,50.0,2,6,0,6,2,7,3,0,0,2018-2019,0.8695652173913044,2.173913043478261
1164,Mathias Jensen,DEN,"MF,FW",Celta Vigo,La Liga,22,1996,2.6,4,2,2,2,0,2,9,22.2,7,2,0,2,4,8,1,0,0,2018-2019,1.5384615384615383,1.5384615384615383
1165,Jesé,ESP,"FW,MF",Betis,La Liga,25,1993,8.7,7,4,3,3,1,2,8,25.0,6,8,0,8,1,8,1,0,0,2018-2019,0.1149425287356322,0.8045977011494253
1166,Gabriel Jesus,BRA,FW,Manchester City,Premier League,21,1997,11.5,10,3,5,2,3,0,5,0.0,5,16,2,14,3,13,4,0,0,2018-2019,0.2608695652173913,0.8695652173913043
1167,Juan Jesus,BRA,DF,Roma,Serie A,27,1991,15.6,37,29,30,5,2,17,30,56.7,13,20,12,8,16,53,41,0,0,2018-2019,1.0256410256410258,2.371794871794872
1168,Raúl Jiménez,MEX,FW,Wolves,Premier League,27,1991,34.6,30,18,5,17,8,6,23,26.1,17,25,3,22,26,56,40,0,0,2018-2019,0.7514450867052023,0.8670520231213873
1169,Joaquín,ESP,"FW,MF",Betis,La Liga,37,1981,18.8,10,4,4,2,4,3,7,42.9,4,13,2,11,14,24,31,1,0,2018-2019,0.7446808510638298,0.5319148936170213
1170,Joelinton,BRA,"FW,MF",Hoffenheim,Bundesliga,21,1996,23.7,35,22,9,20,6,10,30,33.3,20,36,3,33,14,49,8,0,0,2018-2019,0.5907172995780591,1.4767932489451476
1171,Aron Jóhannsson,USA,MF,Werder Bremen,Bundesliga,27,1990,0.0,0,0,0,0,0,0,0,0.0,0,0,0,0,0,0,0,0,0,2018-2019,,
1172,Stefan Johansen,NOR,MF,Fulham,Premier League,27,1991,4.6,11,3,4,7,0,5,8,62.5,3,5,0,5,3,14,6,0,0,2018-2019,0.6521739130434783,2.3913043478260874
1173,Jakob Johansson,SWE,MF,Rennes,Ligue 1,28,1990,7.9,17,9,5,12,0,10,20,50.0,10,7,3,4,3,20,17,1,0,2018-2019,0.37974683544303794,2.151898734177215
1174,Ben Johnson,ENG,DF,West Ham,Premier League,18,2000,0.7,1,0,1,0,0,0,1,0.0,1,0,0,0,1,2,5,0,0,2018-2019,1.4285714285714286,1.4285714285714286
1175,Fabian Johnson,USA,"DF,FW",Gladbach,Bundesliga,30,1987,11.2,13,5,2,8,3,6,8,75.0,2,8,3,5,10,23,16,0,0,2018-2019,0.8928571428571429,1.1607142857142858
Rk,Player,Nation,Pos,Squad,Comp,0,0,90.0,0,0,3,3,3,Tkl,0,0.0,0,0,0,0,0,0,0,0,0,2018-2019,0.0,0.0
1176,Tyreke Johnson,ENG,MF,Southampton,Premier League,19,1998,0.0,0,0,0,0,0,0,0,0.0,0,0,0,0,0,0,0,0,0,2018-2019,,
1177,Karl-Johan Johnsson,SWE,GK,Guingamp,Ligue 1,28,1990,17.0,0,0,0,0,0,0,1,0.0,1,0,0,0,0,0,4,1,0,2018-2019,0.0,0.0
1178,Jonathas,BRA,FW,Hannover 96,Bundesliga,29,1989,6.7,7,4,3,4,0,3,10,30.0,7,9,1,8,3,10,4,0,0,2018-2019,0.44776119402985076,1.044776119402985
1179,Phil Jones,ENG,DF,Manchester Utd,Premier League,26,1992,14.0,19,13,12,7,0,8,13,61.5,5,16,11,5,23,42,67,3,0,2018-2019,1.6428571428571428,1.3571428571428572
1180,Jony,ESP,"MF,FW",Alavés,La Liga,27,1991,33.0,20,14,6,7,7,7,37,18.9,30,18,0,18,22,42,12,2,0,2018-2019,0.6666666666666666,0.6060606060606061
1181,Joan Jordán,ESP,MF,Eibar,La Liga,24,1994,31.9,63,40,16,38,9,28,80,35.0,52,38,4,34,32,95,18,1,0,2018-2019,1.0031347962382446,1.974921630094044
1182,Bruno Jordão,POR,"MF,DF",Lazio,Serie A,19,1998,1.0,4,3,2,1,1,1,3,33.3,2,1,0,1,0,4,2,0,0,2018-2019,0.0,4.0
1183,Jorginho,ITA,MF,Chelsea,Premier League,26,1991,35.1,76,38,27,41,8,45,96,46.9,51,46,7,39,64,140,38,1,0,2018-2019,1.8233618233618234,2.165242165242165
1184,Willian José,BRA,FW,Real Sociedad,La Liga,26,1991,26.3,5,3,1,3,1,2,7,28.6,5,11,5,6,1,6,27,0,0,2018-2019,0.03802281368821293,0.19011406844106463
1185,Joselu,ESP,FW,Newcastle Utd,Premier League,28,1990,6.6,14,8,4,5,5,4,9,44.4,5,5,0,5,3,17,15,0,0,2018-2019,0.4545454545454546,2.121212121212121
1186,Evens Joseph,FRA,"MF,FW",Caen,Ligue 1,19,1999,3.8,5,2,1,2,2,1,3,33.3,2,3,0,3,2,7,1,0,0,2018-2019,0.5263157894736842,1.3157894736842106
1187,Diogo Jota,POR,"FW,MF",Wolves,Premier League,21,1996,26.2,28,16,11,11,6,10,38,26.3,28,20,1,19,13,41,11,0,0,2018-2019,0.4961832061068702,1.0687022900763359
1188,Aleksandar Jovanović,SRB,GK,Huesca,La Liga,25,1992,12.0,0,0,0,0,0,0,0,0.0,0,0,0,0,1,1,3,0,0,2018-2019,0.08333333333333333,0.0
1189,Vukašin Jovanović,SRB,DF,Bordeaux,Ligue 1,22,1996,15.3,26,21,21,5,0,13,19,68.4,6,23,12,11,36,62,105,0,0,2018-2019,2.3529411764705883,1.6993464052287581
1190,Stevan Jovetić,MNE,"MF,FW",Monaco,Ligue 1,28,1989,4.4,2,1,1,1,0,1,3,33.3,2,1,0,1,1,3,3,0,0,2018-2019,0.22727272727272727,0.45454545454545453
1191,Luka Jović,SRB,"FW,MF",Eint Frankfurt,Bundesliga,20,1997,24.9,10,5,1,8,1,1,12,8.3,11,8,0,8,3,13,30,0,0,2018-2019,0.12048192771084339,0.40160642570281124
1192,Jozabed,ESP,MF,Celta Vigo,La Liga,27,1991,12.8,19,10,8,8,3,8,24,33.3,16,8,2,6,9,28,13,2,0,2018-2019,0.703125,1.484375
1193,Miguel Juan Llambrich,ESP,"DF,FW",Villarreal,La Liga,22,1996,6.0,21,14,11,9,1,6,14,42.9,8,9,2,7,12,33,17,0,0,2018-2019,2.0,3.5
1194,Juanfran,ESP,"DF,FW",Leganés,La Liga,29,1988,16.2,20,12,13,5,2,9,16,56.3,7,9,4,5,19,39,37,0,0,2018-2019,1.1728395061728396,1.234567901234568
1195,Juanfran,ESP,DF,Atlético Madrid,La Liga,33,1985,17.9,35,22,27,5,3,24,38,63.2,14,13,5,8,19,54,36,1,0,2018-2019,1.0614525139664805,1.9553072625698324
1196,Juanmi,ESP,"FW,MF",Real Sociedad,La Liga,25,1993,16.9,21,12,7,11,3,8,22,36.4,14,12,0,12,16,37,13,0,0,2018-2019,0.9467455621301776,1.2426035502958581
1197,Juanpe,ESP,DF,Girona,La Liga,27,1991,30.7,48,25,32,15,1,24,45,53.3,21,31,15,16,57,105,138,0,0,2018-2019,1.8566775244299674,1.5635179153094463
1198,Juanpi,VEN,"MF,FW",Huesca,La Liga,24,1994,7.4,16,6,9,5,2,4,12,33.3,8,15,0,15,6,22,3,0,0,2018-2019,0.8108108108108107,2.162162162162162
1199,Nathaël Julan,FRA,"FW,MF",Guingamp,Ligue 1,22,1996,4.8,1,0,0,0,1,0,3,0.0,3,6,1,5,0,1,2,0,0,2018-2019,0.0,0.20833333333333334
1200,Christopher Jullien,FRA,DF,Toulouse,Ligue 1,25,1993,33.5,35,24,23,10,2,12,32,37.5,20,39,27,12,41,76,203,4,0,2018-2019,1.2238805970149254,1.044776119402985
Rk,Player,Nation,Pos,Squad,Comp,0,0,90.0,0,0,3,3,3,Tkl,0,0.0,0,0,0,0,0,0,0,0,0,2018-2019,0.0,0.0
1201,David Juncà,ESP,DF,Celta Vigo,La Liga,24,1993,19.5,55,30,40,13,2,28,46,60.9,18,27,6,21,35,90,63,1,0,2018-2019,1.794871794871795,2.8205128205128207
1202,Sebastian Jung,GER,DF,Wolfsburg,Bundesliga,28,1990,0.6,1,0,0,1,0,1,1,100.0,0,0,0,0,0,1,1,0,0,2018-2019,0.0,1.6666666666666667
1203,Hamed Junior Traorè,CIV,MF,Empoli,Serie A,18,2000,25.1,67,38,26,32,9,27,72,37.5,45,29,4,25,30,97,17,0,0,2018-2019,1.195219123505976,2.6693227091633465
1204,Vinicius Júnior,BRA,"FW,MF",Real Madrid,La Liga,18,2000,9.7,10,6,3,6,1,3,16,18.8,13,6,1,5,7,17,1,0,0,2018-2019,0.7216494845360826,1.0309278350515465
1205,Musa Juwara,GAM,FW,Chievo,Serie A,16,2001,0.1,0,0,0,0,0,0,0,0.0,0,0,0,0,1,1,0,0,0,2018-2019,10.0,0.0
1206,Mathias Jørgensen,DEN,DF,Huddersfield,Premier League,28,1990,23.9,49,31,27,21,1,27,46,58.7,19,29,14,15,69,118,83,0,0,2018-2019,2.887029288702929,2.0502092050209204
1207,Sory Kaba,GUI,"FW,MF",Dijon,Ligue 1,23,1995,2.6,1,1,1,0,0,1,3,33.3,2,2,0,2,0,1,1,0,0,2018-2019,0.0,0.3846153846153846
1208,Ozan Kabak,TUR,DF,Stuttgart,Bundesliga,18,2000,15.0,33,19,22,9,2,9,19,47.4,10,15,8,7,23,56,58,1,0,2018-2019,1.5333333333333334,2.2
1209,Christian Kabasele,BEL,DF,Watford,Premier League,27,1991,17.6,25,14,20,5,0,10,23,43.5,13,21,16,5,38,63,111,0,0,2018-2019,2.1590909090909087,1.4204545454545454
1210,Elias Kachunga,COD,"FW,MF",Huddersfield,Premier League,26,1992,13.1,22,9,8,12,2,9,25,36.0,16,16,1,15,4,26,10,0,0,2018-2019,0.3053435114503817,1.6793893129770994
1211,Pavel Kadeřábek,CZE,DF,Hoffenheim,Bundesliga,26,1992,27.9,30,19,12,13,5,11,24,45.8,13,37,10,27,34,64,71,1,0,2018-2019,1.2186379928315412,1.0752688172043012
1212,Shinji Kagawa,JPN,MF,Dortmund,Bundesliga,29,1989,1.1,0,0,0,0,0,0,0,0.0,0,0,0,0,0,0,0,0,0,2018-2019,0.0,0.0
1213,Florian Kainz,AUT,FW,Werder Bremen,Bundesliga,25,1992,4.1,6,5,5,1,0,3,6,50.0,3,4,1,3,3,9,5,0,0,2018-2019,0.7317073170731708,1.4634146341463417
1214,Gaël Kakuta,COD,"MF,FW",Rayo Vallecano,La Liga,27,1991,8.0,12,7,5,5,2,2,10,20.0,8,4,1,3,9,21,9,0,0,2018-2019,1.125,1.5
1215,Nikola Kalinić,CRO,FW,Atlético Madrid,La Liga,30,1988,7.1,6,4,2,4,0,1,3,33.3,2,1,0,1,2,8,2,0,0,2018-2019,0.28169014084507044,0.8450704225352114
1216,Salomon Kalou,CIV,"FW,MF",Hertha BSC,Bundesliga,32,1985,25.7,21,12,5,11,5,6,24,25.0,18,23,1,22,6,27,25,0,0,2018-2019,0.23346303501945526,0.8171206225680934
1217,Samuel Kalu,NGA,FW,Bordeaux,Ligue 1,20,1997,14.2,27,18,15,7,5,4,11,36.4,7,11,3,8,8,35,4,1,0,2018-2019,0.5633802816901409,1.9014084507042255
1218,François Kamano,GUI,"FW,MF",Bordeaux,Ligue 1,22,1996,28.5,29,18,6,17,6,11,30,36.7,19,27,0,27,17,46,6,1,0,2018-2019,0.5964912280701754,1.0175438596491229
1219,Aboubakar Kamara,MTN,FW,Fulham,Premier League,23,1995,7.7,8,4,1,5,2,3,7,42.9,4,6,0,6,1,9,6,0,0,2018-2019,0.12987012987012986,1.0389610389610389
1220,Boubacar Kamara,FRA,DF,Marseille,Ligue 1,18,1999,26.8,67,39,38,24,5,32,49,65.3,17,24,13,11,45,112,95,2,0,2018-2019,1.6791044776119401,2.5
1221,Hassane Kamara,CIV,"DF,FW",Reims,Ligue 1,24,1994,10.3,29,21,22,5,2,16,19,84.2,3,6,1,5,14,43,41,0,0,2018-2019,1.3592233009708736,2.815533980582524
1222,Marcin Kamiński,POL,DF,Düsseldorf,Bundesliga,26,1992,27.0,18,13,14,3,1,7,11,63.6,4,21,11,10,39,57,103,2,0,2018-2019,1.4444444444444444,0.6666666666666666
1223,Patrick Kammerbauer,GER,FW,Freiburg,Bundesliga,21,1997,0.0,0,0,0,0,0,0,0,0.0,0,0,0,0,1,1,1,0,0,2018-2019,inf,
1224,Kevin Kampl,SVN,MF,RB Leipzig,Bundesliga,27,1990,23.5,41,24,16,21,4,8,28,28.6,20,32,2,30,33,74,22,0,0,2018-2019,1.4042553191489362,1.7446808510638299
1225,Harry Kane,ENG,FW,Tottenham,Premier League,25,1993,26.9,10,6,2,8,0,1,14,7.1,13,16,6,10,1,11,14,0,0,2018-2019,0.03717472118959108,0.3717472118959108
Rk,Player,Nation,Pos,Squad,Comp,0,0,90.0,0,0,3,3,3,Tkl,0,0.0,0,0,0,0,0,0,0,0,0,2018-2019,0.0,0.0
1226,Lee Kang-in,KOR,"MF,FW",Valencia,La Liga,17,2001,0.3,2,0,1,1,0,1,3,33.3,2,0,0,0,1,3,0,0,0,2018-2019,3.3333333333333335,6.666666666666667
1227,Wilfried Kanga,CIV,FW,Angers,Ligue 1,20,1998,5.5,0,0,0,0,0,0,1,0.0,1,3,0,3,0,0,4,0,0,2018-2019,0.0,0.0
1228,N'Golo Kanté,FRA,MF,Chelsea,Premier League,27,1991,34.4,75,41,21,41,13,23,67,34.3,44,63,6,57,44,119,32,1,0,2018-2019,1.2790697674418605,2.1802325581395348
1229,Stefanos Kapino,GRE,GK,Werder Bremen,Bundesliga,24,1994,0.5,0,0,0,0,0,0,0,0.0,0,0,0,0,0,0,0,0,0,2018-2019,0.0,0.0
1230,Wilfrid Kaptoum,CMR,MF,Betis,La Liga,22,1996,8.6,15,6,4,10,1,5,11,45.5,6,9,1,8,10,25,6,2,0,2018-2019,1.1627906976744187,1.744186046511628
1231,Kenan Karaman,TUR,"FW,MF",Düsseldorf,Bundesliga,24,1994,10.2,13,9,3,10,0,7,12,58.3,5,5,1,4,2,15,8,0,0,2018-2019,0.19607843137254904,1.2745098039215688
1232,Yann Karamoh,FRA,"FW,MF",Inter,Serie A,20,1998,0.1,0,0,0,0,0,0,0,0.0,0,0,0,0,0,0,0,0,0,2018-2019,0.0,0.0
1233,Yann Karamoh,FRA,FW,Bordeaux,Ligue 1,20,1998,13.6,7,3,1,4,2,1,13,7.7,12,9,0,9,6,13,3,0,0,2018-2019,0.4411764705882353,0.5147058823529412
1234,Ibrahim Karamoko,FRA,MF,Chievo,Serie A,17,2001,0.7,0,0,0,0,0,0,0,0.0,0,1,0,1,0,0,1,0,0,2018-2019,0.0,0.0
1235,Orestis Karnezis,GRE,GK,Napoli,Serie A,33,1985,9.0,0,0,0,0,0,0,0,0.0,0,0,0,0,0,0,3,0,0,2018-2019,0.0,0.0
1236,Rick Karsdorp,NED,DF,Roma,Serie A,23,1995,6.6,9,6,3,5,1,5,11,45.5,6,4,2,2,12,21,12,1,0,2018-2019,1.8181818181818183,1.3636363636363638
1237,Grigoris Kastanos,CYP,MF,Juventus,Serie A,20,1998,0.7,3,1,3,0,0,0,0,0.0,0,3,1,2,0,3,0,0,0,2018-2019,0.0,4.285714285714286
1238,Eiji Kawashima,JPN,GK,Strasbourg,Ligue 1,35,1983,1.0,0,0,0,0,0,0,0,0.0,0,0,0,0,0,0,0,0,0,2018-2019,0.0,0.0
1239,Beram Kayal,ISR,MF,Brighton,Premier League,30,1988,10.4,28,17,16,11,1,5,21,23.8,16,17,10,7,15,43,25,0,0,2018-2019,1.4423076923076923,2.692307692307692
1240,Moise Kean,ITA,FW,Juventus,Serie A,18,2000,6.0,0,0,0,0,0,0,1,0.0,1,1,0,1,2,2,1,0,0,2018-2019,0.3333333333333333,0.0
1241,Michael Keane,ENG,DF,Everton,Premier League,25,1993,33.0,41,25,22,16,3,19,32,59.4,13,30,22,8,43,84,185,4,0,2018-2019,1.303030303030303,1.2424242424242424
1242,Neeskens Kebano,COD,"FW,MF",Fulham,Premier League,26,1992,1.2,3,1,2,1,0,1,1,100.0,0,3,0,3,0,3,3,0,0,2018-2019,0.0,2.5
1243,Thilo Kehrer,GER,DF,Paris S-G,Ligue 1,21,1996,21.1,64,43,27,31,6,31,55,56.4,24,32,17,15,31,95,69,1,0,2018-2019,1.4691943127962084,3.0331753554502368
1244,Jules Keita,GUI,"FW,MF",Dijon,Ligue 1,20,1998,5.1,10,4,0,3,7,5,12,41.7,7,2,0,2,2,12,1,0,0,2018-2019,0.3921568627450981,1.9607843137254903
1245,Naby Keïta,GUI,"MF,FW",Liverpool,Premier League,23,1995,15.4,37,15,13,19,5,14,42,33.3,28,29,4,25,12,49,16,1,0,2018-2019,0.7792207792207793,2.4025974025974026
1246,Keko,ESP,"MF,FW",Valladolid,La Liga,26,1991,17.0,42,18,21,15,6,18,50,36.0,32,20,1,19,14,56,17,0,0,2018-2019,0.8235294117647058,2.4705882352941178
1247,Martin Kelly,ENG,DF,Crystal Palace,Premier League,28,1990,12.3,21,13,18,2,1,14,19,73.7,5,18,12,6,11,32,88,1,0,2018-2019,0.8943089430894309,1.7073170731707317
1248,Marc-Oliver Kempf,GER,DF,Stuttgart,Bundesliga,23,1995,22.5,33,18,26,7,0,12,24,50.0,12,35,21,14,46,79,141,1,0,2018-2019,2.0444444444444443,1.4666666666666666
1249,Kenedy,BRA,"MF,DF",Newcastle Utd,Premier League,22,1996,15.0,30,22,11,16,3,12,29,41.4,17,10,0,10,32,62,24,1,0,2018-2019,2.1333333333333333,2.0
1250,Jonjoe Kenny,ENG,DF,Everton,Premier League,21,1997,8.8,21,16,16,4,1,10,18,55.6,8,13,2,11,17,38,36,1,0,2018-2019,1.9318181818181817,2.3863636363636362
Rk,Player,Nation,Pos,Squad,Comp,0,0,90.0,0,0,3,3,3,Tkl,0,0.0,0,0,0,0,0,0,0,0,0,2018-2019,0.0,0.0
1251,Christophe Kerbrat,FRA,DF,Guingamp,Ligue 1,31,1986,23.3,40,24,28,12,0,24,38,63.2,14,19,10,9,50,90,140,5,0,2018-2019,2.1459227467811157,1.7167381974248928
1252,Sebastian Kerk,GER,"MF,FW",Nürnberg,Bundesliga,24,1994,13.1,16,9,8,5,3,7,23,30.4,16,14,5,9,3,19,22,1,0,2018-2019,0.22900763358778625,1.2213740458015268
1253,Franck Kessié,CIV,MF,Milan,Serie A,21,1996,33.5,42,27,16,20,6,18,38,47.4,20,35,10,25,27,69,53,2,0,2018-2019,0.8059701492537313,1.2537313432835822
1254,Saîf-Eddine Khaoui,TUN,"MF,FW",Caen,Ligue 1,23,1995,15.0,20,14,5,11,4,8,27,29.6,19,9,1,8,20,40,4,0,0,2018-2019,1.3333333333333333,1.3333333333333333
1255,Wahbi Khazri,TUN,"FW,MF",Saint-Étienne,Ligue 1,27,1991,31.3,41,26,8,14,19,17,49,34.7,32,27,2,25,11,52,5,0,0,2018-2019,0.3514376996805112,1.3099041533546325
1256,Rani Khedira,GER,"DF,MF",Augsburg,Bundesliga,24,1994,29.2,56,39,22,28,6,18,36,50.0,18,44,22,22,80,136,95,1,0,2018-2019,2.73972602739726,1.9178082191780823
1257,Sami Khedira,GER,MF,Juventus,Serie A,31,1987,7.8,10,9,6,2,2,5,9,55.6,4,8,3,5,5,15,6,0,0,2018-2019,0.6410256410256411,1.2820512820512822
1258,Isaac Kiese Thelin,SWE,"FW,MF",Leverkusen,Bundesliga,26,1992,2.0,2,1,0,2,0,1,2,50.0,1,1,0,1,0,2,4,0,0,2018-2019,0.0,1.0
1259,Kiké,ESP,FW,Eibar,La Liga,28,1989,14.4,7,4,1,2,4,1,5,20.0,4,18,0,18,4,11,6,0,0,2018-2019,0.2777777777777778,0.4861111111111111
1260,Max Kilman,ENG,DF,Wolves,Premier League,21,1997,0.0,0,0,0,0,0,0,0,0.0,0,0,0,0,0,0,0,0,0,2018-2019,,
1261,Joshua Kimmich,GER,"DF,MF",Bayern Munich,Bundesliga,23,1995,34.0,46,26,17,22,7,25,54,46.3,29,35,9,26,34,80,41,3,0,2018-2019,1.0,1.3529411764705883
1262,Presnel Kimpembe,FRA,DF,Paris S-G,Ligue 1,22,1995,22.3,55,34,26,25,4,24,40,60.0,16,17,10,7,30,85,48,5,0,2018-2019,1.3452914798206277,2.4663677130044843
1263,Joshua King,NOR,"FW,MF",Bournemouth,Premier League,26,1992,32.9,30,19,7,19,4,8,29,27.6,21,28,4,24,7,37,14,0,0,2018-2019,0.2127659574468085,0.9118541033434651
1264,Sofian Kiyine,MAR,"MF,DF",Chievo,Serie A,20,1997,9.1,28,13,11,14,3,9,18,50.0,9,10,0,10,10,38,4,0,0,2018-2019,1.098901098901099,3.076923076923077
1265,Simon Kjær,DEN,DF,Sevilla,La Liga,29,1989,22.3,29,19,25,3,1,9,16,56.3,7,41,34,7,27,56,136,0,0,2018-2019,1.210762331838565,1.3004484304932735
1266,Davy Klaassen,NED,MF,Werder Bremen,Bundesliga,25,1993,31.3,64,47,24,33,7,14,49,28.6,35,44,9,35,47,111,47,0,0,2018-2019,1.5015974440894568,2.0447284345047922
1267,Felix Klaus,GER,"FW,MF",Wolfsburg,Bundesliga,25,1992,4.9,10,7,4,5,1,2,7,28.6,5,5,0,5,4,14,0,0,0,2018-2019,0.8163265306122448,2.0408163265306123
1268,Ragnar Klavan,EST,DF,Cagliari,Serie A,32,1985,13.7,9,8,5,3,1,5,11,45.5,6,19,13,6,10,19,68,1,0,2018-2019,0.7299270072992701,0.6569343065693432
1269,Tim Kleindienst,GER,FW,Freiburg,Bundesliga,22,1995,2.2,4,3,1,2,1,1,3,33.3,2,3,0,3,0,4,7,0,0,2018-2019,0.0,1.8181818181818181
1270,Lukas Klostermann,GER,DF,RB Leipzig,Bundesliga,22,1996,22.3,50,29,33,12,5,29,45,64.4,16,37,5,32,29,79,74,0,0,2018-2019,1.3004484304932735,2.242152466367713
1271,Justin Kluivert,NED,FW,Roma,Serie A,19,1999,14.9,28,27,12,9,7,10,23,43.5,13,17,0,17,7,35,12,0,0,2018-2019,0.4697986577181208,1.8791946308724832
1272,Lukas Klünter,GER,DF,Hertha BSC,Bundesliga,22,1996,6.6,11,8,6,5,0,4,5,80.0,1,6,2,4,12,23,20,0,0,2018-2019,1.8181818181818183,1.6666666666666667
1273,Robin Knoche,GER,DF,Wolfsburg,Bundesliga,26,1992,31.0,26,20,19,6,1,16,29,55.2,13,46,29,17,44,70,138,2,0,2018-2019,1.4193548387096775,0.8387096774193549
1274,Anthony Knockaert,FRA,"MF,FW",Brighton,Premier League,26,1991,20.4,33,21,12,15,6,13,30,43.3,17,13,0,13,29,62,11,0,0,2018-2019,1.4215686274509804,1.6176470588235294
1275,Törles Knöll,GER,"FW,MF",Nürnberg,Bundesliga,20,1997,4.1,3,2,1,1,1,0,4,0.0,4,5,1,4,0,3,2,0,0,2018-2019,0.0,0.7317073170731708
Rk,Player,Nation,Pos,Squad,Comp,0,0,90.0,0,0,3,3,3,Tkl,0,0.0,0,0,0,0,0,0,0,0,0,2018-2019,0.0,0.0
1276,Gregor Kobel,SUI,GK,Hoffenheim,Bundesliga,20,1997,1.0,0,0,0,0,0,0,0,0.0,0,0,0,0,0,0,0,0,0,2018-2019,0.0,0.0
1277,Gregor Kobel,SUI,GK,Augsburg,Bundesliga,20,1997,15.4,1,1,1,0,0,1,1,100.0,0,0,0,0,2,3,5,3,0,2018-2019,0.12987012987012986,0.06493506493506493
1278,Robin Koch,GER,"MF,DF",Freiburg,Bundesliga,22,1996,21.1,25,14,17,7,1,7,24,29.2,17,31,18,13,32,57,77,4,0,2018-2019,1.5165876777251184,1.1848341232227488
1279,Kenan Kodro,BIH,"FW,MF",Athletic Club,La Liga,24,1993,1.8,3,1,1,1,1,1,3,33.3,2,1,0,1,0,3,0,0,0,2018-2019,0.0,1.6666666666666665
1280,Dominik Kohr,GER,MF,Leverkusen,Bundesliga,24,1994,10.8,42,29,21,21,0,14,35,40.0,21,25,12,13,15,57,17,1,0,2018-2019,1.3888888888888888,3.888888888888889
1281,Djégui Koita,FRA,DF,Guingamp,Ligue 1,18,1999,1.9,8,6,8,0,0,3,4,75.0,1,5,3,2,0,8,9,0,0,2018-2019,0.0,4.2105263157894735
1282,Koke,ESP,MF,Atlético Madrid,La Liga,26,1992,28.7,84,46,41,32,11,34,86,39.5,52,25,5,20,31,115,37,1,0,2018-2019,1.0801393728222997,2.926829268292683
1283,Aleksandar Kolarov,SRB,DF,Roma,Serie A,32,1985,32.3,38,26,22,10,6,21,34,61.8,13,23,15,8,41,79,82,2,0,2018-2019,1.2693498452012384,1.1764705882352942
1284,Sead Kolašinac,BIH,"DF,MF",Arsenal,Premier League,25,1993,21.0,34,21,21,7,6,20,34,58.8,14,12,3,9,20,54,28,3,0,2018-2019,0.9523809523809523,1.619047619047619
1285,Randal Kolo Muani,FRA,FW,Nantes,Ligue 1,19,1998,1.4,2,0,1,1,0,0,1,0.0,1,2,0,2,0,2,2,0,0,2018-2019,0.0,1.4285714285714286
1286,Timothée Kolodziejczak,FRA,DF,Saint-Étienne,Ligue 1,26,1991,35.4,34,22,21,10,3,20,45,44.4,25,25,11,14,53,87,118,2,0,2018-2019,1.497175141242938,0.96045197740113
1287,Vincent Kompany,BEL,DF,Manchester City,Premier League,32,1986,13.6,16,10,11,3,2,8,9,88.9,1,11,8,3,16,32,55,0,0,2018-2019,1.1764705882352942,1.1764705882352942
1288,Ghislain Konan,CIV,DF,Reims,Ligue 1,22,1995,20.0,45,28,31,10,4,24,40,60.0,16,18,4,14,40,85,55,1,0,2018-2019,2.0,2.25
1289,Ibrahima Konaté,FRA,DF,RB Leipzig,Bundesliga,19,1999,27.0,44,32,30,14,0,17,27,63.0,10,29,18,11,58,102,126,0,0,2018-2019,2.1481481481481484,1.6296296296296295
1290,Moussa Konaté,SEN,FW,Amiens,Ligue 1,25,1993,20.8,10,8,3,3,4,2,12,16.7,10,14,3,11,5,15,15,0,0,2018-2019,0.24038461538461536,0.4807692307692307
1291,Geoffrey Kondogbia,CTA,MF,Valencia,La Liga,25,1993,13.8,47,33,18,23,6,12,27,44.4,15,20,7,13,27,74,22,2,0,2018-2019,1.9565217391304346,3.4057971014492754
1292,Lamine Koné,CIV,DF,Strasbourg,Ligue 1,29,1989,23.9,21,16,9,9,3,6,9,66.7,3,18,13,5,33,54,66,3,0,2018-2019,1.380753138075314,0.8786610878661089
1293,Manu Koné,FRA,MF,Toulouse,Ligue 1,17,2001,0.8,4,2,0,4,0,2,4,50.0,2,0,0,0,0,4,0,0,0,2018-2019,0.0,5.0
1294,Youssouf Koné,MLI,DF,Lille,Ligue 1,23,1995,19.0,67,38,45,19,3,41,65,63.1,24,31,3,28,39,106,52,1,0,2018-2019,2.0526315789473686,3.526315789473684
1295,Terence Kongolo,NED,DF,Huddersfield,Premier League,24,1994,30.2,74,46,44,26,4,27,47,57.4,20,42,16,26,65,139,106,1,0,2018-2019,2.152317880794702,2.4503311258278146
1296,Yevhen Konoplyanka,UKR,"FW,MF",Schalke 04,Bundesliga,28,1989,7.3,2,0,0,0,2,2,4,50.0,2,6,0,6,3,5,3,0,0,2018-2019,0.4109589041095891,0.273972602739726
1297,Pascal Köpke,GER,"FW,MF",Hertha BSC,Bundesliga,22,1995,0.8,1,0,1,0,0,1,2,50.0,1,0,0,0,0,1,0,0,0,2018-2019,0.0,1.25
1298,Julian Korb,GER,DF,Hannover 96,Bundesliga,26,1992,11.2,26,17,16,9,1,10,29,34.5,19,27,4,23,23,49,34,1,0,2018-2019,2.053571428571429,2.3214285714285716
1299,Laurent Koscielny,FRA,DF,Arsenal,Premier League,32,1985,14.8,19,11,9,9,1,10,16,62.5,6,20,15,5,30,49,72,0,0,2018-2019,2.0270270270270268,1.2837837837837838
1300,Filip Kostić,SRB,"DF,FW",Eint Frankfurt,Bundesliga,25,1992,32.8,64,42,35,22,7,23,65,35.4,42,80,6,74,23,87,50,0,0,2018-2019,0.701219512195122,1.9512195121951221
Rk,Player,Nation,Pos,Squad,Comp,0,0,90.0,0,0,3,3,3,Tkl,0,0.0,0,0,0,0,0,0,0,0,0,2018-2019,0.0,0.0
1301,Christian Kouamé,CIV,FW,Genoa,Serie A,20,1997,34.1,31,22,8,16,7,2,13,15.4,11,23,3,20,25,56,28,0,0,2018-2019,0.7331378299120235,0.9090909090909091
1302,Tomáš Koubek,CZE,GK,Rennes,Ligue 1,25,1992,32.5,0,0,0,0,0,0,1,0.0,1,0,0,0,0,0,26,4,0,2018-2019,0.0,0.0
1303,Kalidou Koulibaly,SEN,DF,Napoli,Serie A,27,1991,34.8,61,40,37,22,2,19,36,52.8,17,55,33,22,40,101,144,0,0,2018-2019,1.149425287356322,1.752873563218391
1304,Jules Koundé,FRA,DF,Bordeaux,Ligue 1,19,1998,37.0,48,31,37,11,0,27,41,65.9,14,44,23,21,50,98,193,7,0,2018-2019,1.3513513513513513,1.2972972972972974
1305,Cheikhou Kouyaté,SEN,MF,Crystal Palace,Premier League,28,1989,21.1,59,33,23,31,5,9,33,27.3,24,29,11,18,16,75,33,0,0,2018-2019,0.7582938388625592,2.796208530805687
1306,Mateo Kovačić,CRO,MF,Chelsea,Premier League,24,1994,19.3,45,29,23,19,3,20,46,43.5,26,19,2,17,8,53,18,1,0,2018-2019,0.41450777202072536,2.33160621761658
1307,Dawid Kownacki,POL,FW,Sampdoria,Serie A,21,1997,1.9,2,1,0,1,1,1,4,25.0,3,0,0,0,0,2,0,0,0,2018-2019,0.0,1.0526315789473684
1308,Dawid Kownacki,POL,"MF,FW",Düsseldorf,Bundesliga,21,1997,6.4,13,6,9,3,1,7,16,43.8,9,8,0,8,2,15,8,0,0,2018-2019,0.3125,2.03125
1309,Thomas Kraft,GER,GK,Hertha BSC,Bundesliga,30,1988,3.5,0,0,0,0,0,0,0,0.0,0,0,0,0,0,0,1,1,0,2018-2019,0.0,0.0
1310,Emil Krafth,SWE,DF,Amiens,Ligue 1,23,1994,33.0,55,35,34,14,7,32,65,49.2,33,27,12,15,23,78,94,4,0,2018-2019,0.696969696969697,1.6666666666666667
1311,Luka Krajnc,SVN,DF,Frosinone,Serie A,23,1994,8.8,10,8,6,3,1,5,6,83.3,1,11,3,8,11,21,42,0,0,2018-2019,1.25,1.1363636363636362
1312,Andrej Kramarić,CRO,"MF,FW",Hoffenheim,Bundesliga,27,1991,26.6,9,4,1,5,3,4,26,15.4,22,15,3,12,8,17,13,0,0,2018-2019,0.3007518796992481,0.3383458646616541
1313,Christoph Kramer,GER,MF,Gladbach,Bundesliga,27,1991,12.6,41,22,17,23,1,15,40,37.5,25,19,4,15,21,62,23,0,0,2018-2019,1.6666666666666667,3.253968253968254
1314,Vasyl Kravets,UKR,"DF,FW",Leganés,La Liga,20,1997,5.3,16,11,8,6,2,6,13,46.2,7,5,1,4,4,20,10,1,0,2018-2019,0.7547169811320755,3.018867924528302
1315,Ladislav Krejčí,CZE,"DF,MF",Bologna,Serie A,26,1992,11.8,16,12,6,9,1,7,12,58.3,5,8,2,6,6,22,18,0,0,2018-2019,0.5084745762711864,1.3559322033898304
1316,Rene Krhin,SVN,MF,Nantes,Ligue 1,28,1990,11.7,22,14,7,12,3,11,19,57.9,8,7,4,3,21,43,32,0,0,2018-2019,1.794871794871795,1.8803418803418805
1317,Toni Kroos,GER,MF,Real Madrid,La Liga,28,1990,24.7,51,35,18,24,9,14,57,24.6,43,25,4,21,14,65,13,1,0,2018-2019,0.5668016194331984,2.064777327935223
1318,Rade Krunić,BIH,MF,Empoli,Serie A,24,1993,30.8,38,23,21,14,3,14,41,34.1,27,35,12,23,24,62,32,0,0,2018-2019,0.7792207792207793,1.2337662337662338
1319,Max Kruse,GER,"FW,MF",Werder Bremen,Bundesliga,30,1988,31.5,17,5,2,13,2,6,38,15.8,32,16,1,15,8,25,6,2,0,2018-2019,0.25396825396825395,0.5396825396825397
1320,Lukas Kübler,GER,"DF,MF",Freiburg,Bundesliga,25,1992,13.2,35,22,23,12,0,16,26,61.5,10,15,5,10,30,65,50,1,0,2018-2019,2.272727272727273,2.651515151515152
1321,Yuya Kubo,JPN,"FW,MF",Nürnberg,Bundesliga,24,1993,15.1,21,11,6,10,5,12,33,36.4,21,11,0,11,10,31,6,0,0,2018-2019,0.6622516556291391,1.390728476821192
1322,Juraj Kucka,SVK,MF,Parma,Serie A,31,1987,17.1,51,32,17,29,5,19,53,35.8,34,27,7,20,17,68,37,1,0,2018-2019,0.9941520467836257,2.982456140350877
1323,Dejan Kulusevski,SWE,MF,Atalanta,Serie A,18,2000,1.2,3,3,0,2,1,1,3,33.3,2,1,0,1,0,3,0,0,0,2018-2019,0.0,2.5
1324,Pierre Kunde,CMR,MF,Mainz 05,Bundesliga,23,1995,21.2,48,29,20,26,2,16,27,59.3,11,34,14,20,24,72,49,1,0,2018-2019,1.1320754716981132,2.2641509433962264
1325,Jasmin Kurtić,SVN,MF,SPAL,Serie A,29,1989,28.4,35,20,19,13,3,13,41,31.7,28,30,3,27,20,55,52,0,0,2018-2019,0.7042253521126761,1.2323943661971832
Rk,Player,Nation,Pos,Squad,Comp,0,0,90.0,0,0,3,3,3,Tkl,0,0.0,0,0,0,0,0,0,0,0,0,2018-2019,0.0,0.0
1326,Layvin Kurzawa,FRA,"DF,MF",Paris S-G,Ligue 1,25,1992,11.2,19,11,6,5,8,6,16,37.5,10,10,2,8,10,29,16,0,0,2018-2019,0.8928571428571429,1.6964285714285716
1327,Rafał Kurzawa,POL,FW,Amiens,Ligue 1,25,1993,2.7,8,3,6,2,0,2,6,33.3,4,1,0,1,3,11,3,0,0,2018-2019,1.111111111111111,2.962962962962963
1328,Ahmed Kutucu,TUR,"FW,MF",Schalke 04,Bundesliga,18,2000,4.7,8,3,3,4,1,1,3,33.3,2,2,1,1,0,8,0,0,0,2018-2019,0.0,1.702127659574468
1329,Enock Kwateng,FRA,DF,Nantes,Ligue 1,21,1997,22.7,65,41,34,27,4,33,70,47.1,37,28,4,24,78,143,56,0,0,2018-2019,3.436123348017621,2.8634361233480177
1330,Grejohn Kyei,FRA,FW,Reims,Ligue 1,22,1995,0.0,0,0,0,0,0,0,1,0.0,1,0,0,0,0,0,0,0,0,2018-2019,,
1331,Antonino La Gumina,ITA,"FW,MF",Empoli,Serie A,22,1996,12.1,5,4,1,2,2,2,6,33.3,4,8,2,6,6,11,5,0,0,2018-2019,0.49586776859504134,0.4132231404958678
1332,Rajiv van La Parra,NED,"FW,MF",Huddersfield,Premier League,27,1991,4.5,8,5,1,7,0,1,6,16.7,5,0,0,0,4,12,3,1,0,2018-2019,0.8888888888888888,1.7777777777777777
1333,Gaëtan Laborde,FRA,FW,Bordeaux,Ligue 1,24,1994,1.0,4,3,0,1,3,2,4,50.0,2,0,0,0,0,4,0,0,0,2018-2019,0.0,4.0
1334,Gaëtan Laborde,FRA,"FW,MF",Montpellier,Ligue 1,24,1994,32.2,36,15,6,15,15,11,27,40.7,16,18,2,16,6,42,27,0,0,2018-2019,0.18633540372670807,1.1180124223602483
1335,Alexandre Lacazette,FRA,FW,Arsenal,Premier League,27,1991,27.8,35,16,6,19,10,5,28,17.9,23,27,1,26,15,50,31,0,0,2018-2019,0.539568345323741,1.2589928057553956
1336,Alban Lafont,FRA,GK,Fiorentina,Serie A,19,1999,33.5,0,0,0,0,0,0,0,0.0,0,0,0,0,1,1,16,4,0,2018-2019,0.029850746268656716,0.0
1337,Víctor Laguardia,ESP,DF,Alavés,La Liga,28,1989,36.0,47,34,37,10,0,24,33,72.7,9,42,19,23,53,100,232,0,0,2018-2019,1.4722222222222223,1.3055555555555556
1338,Abdou Lahat Diakhate,SEN,MF,Parma,Serie A,19,1998,0.0,0,0,0,0,0,0,0,0.0,0,0,0,0,0,0,0,0,0,2018-2019,,
1339,Konrad Laimer,AUT,"MF,DF",RB Leipzig,Bundesliga,21,1997,20.8,72,38,21,34,17,20,71,28.2,51,67,2,65,32,104,23,0,0,2018-2019,1.5384615384615383,3.4615384615384612
1340,Diego Lainez,MEX,"FW,MF",Betis,La Liga,18,2000,3.9,4,4,0,3,1,1,1,100.0,0,2,0,2,1,5,2,0,0,2018-2019,0.25641025641025644,1.0256410256410258
1341,Kenny Lala,MAD,"DF,FW",Strasbourg,Ligue 1,26,1991,34.0,78,45,48,23,7,30,53,56.6,23,26,9,17,28,106,62,2,0,2018-2019,0.8235294117647058,2.2941176470588234
1342,Adam Lallana,ENG,"MF,FW",Liverpool,Premier League,30,1988,5.2,16,9,6,7,3,5,12,41.7,7,10,1,9,5,21,4,0,0,2018-2019,0.9615384615384615,3.0769230769230766
1343,Érik Lamela,ARG,"MF,FW",Tottenham,Premier League,26,1992,10.8,17,13,6,7,4,5,14,35.7,9,14,0,14,7,24,1,0,0,2018-2019,0.6481481481481481,1.574074074074074
1344,Mohamed Lamine Diaby,FRA,FW,Nice,Ligue 1,17,2001,1.8,1,1,0,1,0,1,1,100.0,0,2,0,2,2,3,0,0,0,2018-2019,1.1111111111111112,0.5555555555555556
1345,Loïck Landre,FRA,DF,Nîmes,Ligue 1,26,1992,17.7,31,21,23,8,0,14,22,63.6,8,16,11,5,38,69,83,1,0,2018-2019,2.146892655367232,1.7514124293785311
1346,Michael Lang,SUI,DF,Gladbach,Bundesliga,27,1991,13.9,14,9,7,6,1,6,16,37.5,10,14,3,11,16,30,42,1,0,2018-2019,1.1510791366906474,1.0071942446043165
1347,Sebastian Langkamp,GER,DF,Werder Bremen,Bundesliga,30,1988,15.7,24,15,18,6,0,7,14,50.0,7,17,11,6,20,44,79,1,0,2018-2019,1.2738853503184715,1.5286624203821657
1348,Manuel Lanzini,ARG,MF,West Ham,Premier League,25,1993,7.6,12,7,5,6,1,5,18,27.8,13,3,1,2,9,21,7,1,0,2018-2019,1.1842105263157896,1.5789473684210527
1349,Gianluca Lapadula,PER,FW,Genoa,Serie A,28,1990,4.5,2,1,2,0,0,1,5,20.0,4,2,0,2,1,3,2,0,0,2018-2019,0.2222222222222222,0.4444444444444444
1350,Aymeric Laporte,ESP,DF,Manchester City,Premier League,24,1994,34.0,42,20,27,14,1,22,34,64.7,12,16,9,7,39,81,98,2,0,2018-2019,1.1470588235294117,1.2352941176470589
Rk,Player,Nation,Pos,Squad,Comp,0,0,90.0,0,0,3,3,3,Tkl,0,0.0,0,0,0,0,0,0,0,0,0,2018-2019,0.0,0.0
1351,Danilo Larangeira,BRA,DF,Bologna,Serie A,34,1984,34.2,40,26,29,11,0,20,30,66.7,10,52,39,13,37,77,182,3,0,2018-2019,1.0818713450292397,1.1695906432748537
1352,Johan Larsson,SWE,DF,Guingamp,Ligue 1,28,1990,1.0,1,1,0,1,0,1,2,50.0,1,0,0,0,1,2,1,1,0,2018-2019,1.0,1.0
1353,Kevin Lasagna,ITA,FW,Udinese,Serie A,25,1992,27.3,6,1,0,3,3,2,12,16.7,10,20,2,18,8,14,35,0,0,2018-2019,0.29304029304029305,0.21978021978021978
1354,Jamaal Lascelles,ENG,DF,Newcastle Utd,Premier League,24,1993,30.5,32,21,25,5,2,11,14,78.6,3,43,28,15,39,71,218,3,0,2018-2019,1.278688524590164,1.0491803278688525
1355,Paul Lasne,FRA,"MF,DF",Montpellier,Ligue 1,29,1989,19.9,53,33,32,16,5,24,43,55.8,19,22,2,20,22,75,23,1,0,2018-2019,1.105527638190955,2.663316582914573
1356,Toni Lato,ESP,DF,Valencia,La Liga,20,1997,3.0,6,4,4,1,1,1,5,20.0,4,9,3,6,6,12,13,0,0,2018-2019,2.0,2.0
1357,Danny Latza,GER,MF,Mainz 05,Bundesliga,28,1989,20.7,41,22,16,23,2,20,61,32.8,41,49,10,39,20,61,31,0,0,2018-2019,0.9661835748792271,1.9806763285024156
1358,Alexandre Lauray,FRA,DF,Bordeaux,Ligue 1,21,1997,2.9,11,6,9,2,0,6,8,75.0,2,2,0,2,4,15,10,0,0,2018-2019,1.3793103448275863,3.793103448275862
1359,Armand Lauriente,FRA,MF,Rennes,Ligue 1,19,1998,0.0,0,0,0,0,0,0,0,0.0,0,0,0,0,0,0,0,0,0,2018-2019,,
1360,Vincent Laurini,FRA,DF,Fiorentina,Serie A,29,1989,10.2,13,5,6,5,2,6,10,60.0,4,11,5,6,13,26,30,0,0,2018-2019,1.2745098039215688,1.2745098039215688
1361,Wesley Lautoa,NCL,"DF,MF",Dijon,Ligue 1,30,1987,33.6,81,55,46,31,4,34,75,45.3,41,37,14,23,87,168,110,1,0,2018-2019,2.589285714285714,2.4107142857142856
1362,Diego Laxalt,URU,"DF,MF",Milan,Serie A,25,1993,7.2,26,13,14,7,5,13,22,59.1,9,23,3,20,8,34,12,0,0,2018-2019,1.1111111111111112,3.611111111111111
1363,Miguel Layún,MEX,"MF,DF",Villarreal,La Liga,30,1988,5.6,8,2,0,7,1,2,6,33.3,4,8,2,6,1,9,10,0,0,2018-2019,0.17857142857142858,1.4285714285714286
1364,Valentino Lazaro,AUT,"DF,FW",Hertha BSC,Bundesliga,22,1996,30.5,46,31,23,17,6,21,53,39.6,32,52,12,40,44,90,65,0,0,2018-2019,1.4426229508196722,1.5081967213114753
1365,Darko Lazović,SRB,"DF,FW",Genoa,Serie A,27,1990,28.2,28,17,13,8,7,14,31,45.2,17,21,6,15,20,48,33,0,0,2018-2019,0.7092198581560284,0.9929078014184397
1366,Manuel Lazzari,ITA,DF,SPAL,Serie A,24,1993,31.5,29,17,16,10,3,13,24,54.2,11,26,5,21,20,49,51,1,0,2018-2019,0.6349206349206349,0.9206349206349206
1367,Mickaël Le Bihan,FRA,FW,Nice,Ligue 1,28,1990,2.3,1,1,0,1,0,1,2,50.0,1,1,0,1,1,2,1,0,0,2018-2019,0.4347826086956522,0.4347826086956522
1368,Maxime Le Marchand,FRA,DF,Fulham,Premier League,28,1989,25.0,56,36,45,11,0,23,47,48.9,24,30,16,14,54,110,129,2,0,2018-2019,2.16,2.24
1369,Robin Le Normand,ESP,DF,Real Sociedad,La Liga,21,1996,3.2,5,2,2,3,0,1,3,33.3,2,3,0,3,4,9,13,1,0,2018-2019,1.25,1.5625
1370,Damien Le Tallec,FRA,MF,Montpellier,Ligue 1,28,1990,31.2,95,58,42,43,10,33,89,37.1,56,35,8,27,59,154,50,0,0,2018-2019,1.891025641025641,3.044871794871795
1371,James Lea Siliki,CMR,"MF,FW",Rennes,Ligue 1,22,1996,13.6,26,17,13,10,3,12,35,34.3,23,14,1,13,10,36,7,1,0,2018-2019,0.7352941176470589,1.911764705882353
1372,Rafael Leão,POR,FW,Lille,Ligue 1,19,1999,14.3,5,2,0,4,1,2,15,13.3,13,13,4,9,4,9,12,0,0,2018-2019,0.2797202797202797,0.34965034965034963
1373,Mathew Leckie,AUS,"FW,MF",Hertha BSC,Bundesliga,27,1991,10.5,20,13,5,10,5,7,16,43.8,9,10,1,9,13,33,16,0,0,2018-2019,1.2380952380952381,1.9047619047619047
1374,Benjamin Lecomte,FRA,GK,Montpellier,Ligue 1,27,1991,37.0,1,0,1,0,0,1,3,33.3,2,0,0,0,5,6,24,3,0,2018-2019,0.13513513513513514,0.02702702702702703
1375,Pierre Lees-Melou,FRA,MF,Nice,Ligue 1,25,1993,26.6,74,46,31,36,7,25,62,40.3,37,44,8,36,36,110,37,0,0,2018-2019,1.3533834586466165,2.781954887218045
Rk,Player,Nation,Pos,Squad,Comp,0,0,90.0,0,0,3,3,3,Tkl,0,0.0,0,0,0,0,0,0,0,0,0,2018-2019,0.0,0.0
1376,Jordan Lefort,FRA,DF,Amiens,Ligue 1,24,1993,20.0,33,18,23,6,4,16,25,64.0,9,11,8,3,46,79,107,0,0,2018-2019,2.3,1.65
1377,Wu Lei,CHN,"FW,MF",Espanyol,La Liga,26,1991,11.8,13,6,5,6,2,5,16,31.3,11,9,0,9,7,20,7,0,0,2018-2019,0.5932203389830508,1.1016949152542372
1378,Tim Leibold,GER,DF,Nürnberg,Bundesliga,24,1993,30.7,62,42,45,16,1,33,71,46.5,38,23,3,20,38,100,57,0,0,2018-2019,1.237785016286645,2.019543973941368
1379,Lucas Leiva,BRA,MF,Lazio,Serie A,31,1987,22.1,91,54,40,46,5,38,79,48.1,41,27,11,16,52,143,43,3,0,2018-2019,2.352941176470588,4.117647058823529
1380,Florian Lejeune,FRA,DF,Newcastle Utd,Premier League,27,1991,11.7,25,15,17,7,1,11,24,45.8,13,16,5,11,21,46,49,0,0,2018-2019,1.794871794871795,2.1367521367521367
1381,Iñigo Lekue,ESP,DF,Athletic Club,La Liga,25,1993,2.3,5,2,3,2,0,2,7,28.6,5,4,0,4,4,9,11,0,0,2018-2019,1.7391304347826089,2.173913043478261
1382,Thomas Lemar,FRA,MF,Atlético Madrid,La Liga,22,1995,20.2,38,21,23,11,4,19,42,45.2,23,26,1,25,22,60,7,1,0,2018-2019,1.0891089108910892,1.8811881188118813
1383,Mario Lemina,GAB,MF,Southampton,Premier League,24,1993,17.9,49,32,23,23,3,15,34,44.1,19,27,3,24,43,92,31,1,0,2018-2019,2.4022346368715084,2.7374301675977657
1384,Mauricio Lemos,URU,DF,Sassuolo,Serie A,22,1995,2.0,2,1,2,0,0,1,2,50.0,1,2,1,1,3,5,10,1,0,2018-2019,1.5,1.0
1385,Clément Lenglet,FRA,DF,Barcelona,La Liga,23,1995,21.5,47,29,26,19,2,22,36,61.1,14,30,20,10,21,68,70,0,0,2018-2019,0.9767441860465116,2.186046511627907
1386,Aaron Lennon,ENG,MF,Burnley,Premier League,31,1987,13.5,26,16,11,12,3,6,14,42.9,8,24,0,24,10,36,18,0,0,2018-2019,0.7407407407407407,1.9259259259259258
1387,Bernd Leno,GER,GK,Arsenal,Premier League,26,1992,31.5,0,0,0,0,0,0,3,0.0,3,0,0,0,4,4,16,6,0,2018-2019,0.12698412698412698,0.0
1388,Pedro León,ESP,"MF,FW",Eibar,La Liga,31,1986,4.7,7,4,2,2,3,4,7,57.1,3,10,0,10,4,11,2,0,0,2018-2019,0.851063829787234,1.4893617021276595
1389,Sergio León,ESP,"FW,MF",Betis,La Liga,29,1989,7.1,4,2,2,1,1,2,8,25.0,6,4,0,4,2,6,6,0,0,2018-2019,0.28169014084507044,0.5633802816901409
1390,Lukas Lerager,DEN,MF,Genoa,Serie A,25,1993,12.5,34,18,12,20,2,13,42,31.0,29,11,1,10,18,52,12,0,0,2018-2019,1.44,2.72
1391,Lukas Lerager,DEN,MF,Bordeaux,Ligue 1,25,1993,14.4,38,21,14,23,1,18,43,41.9,25,22,10,12,32,70,26,1,0,2018-2019,2.2222222222222223,2.638888888888889
1392,Mehdi Léris,ALG,"MF,DF",Chievo,Serie A,20,1998,17.9,53,33,19,24,10,24,54,44.4,30,34,1,33,28,81,24,1,0,2018-2019,1.564245810055866,2.9608938547486034
1393,Jefferson Lerma,COL,MF,Bournemouth,Premier League,23,1994,27.8,45,31,20,20,5,14,54,25.9,40,35,19,16,54,99,88,1,0,2018-2019,1.9424460431654675,1.618705035971223
1394,Robert Lewandowski,POL,FW,Bayern Munich,Bundesliga,29,1988,32.9,12,9,0,8,4,3,11,27.3,8,11,1,10,7,19,15,0,0,2018-2019,0.2127659574468085,0.364741641337386
1395,Igor Lewczuk,POL,DF,Bordeaux,Ligue 1,33,1985,5.0,12,7,8,2,2,1,4,25.0,3,2,2,0,4,16,27,0,0,2018-2019,0.8,2.4
1396,Aaron Leya Iseka,BEL,FW,Toulouse,Ligue 1,20,1997,16.0,6,4,1,4,1,1,4,25.0,3,5,3,2,1,7,10,0,0,2018-2019,0.0625,0.375
1397,Stephan Lichtsteiner,SUI,DF,Arsenal,Premier League,34,1984,10.4,15,9,5,4,6,9,16,56.3,7,11,4,7,9,24,25,1,0,2018-2019,0.8653846153846153,1.4423076923076923
1398,Dimitri Liénard,FRA,"MF,DF",Strasbourg,Ligue 1,30,1988,14.3,33,18,20,9,4,21,45,46.7,24,11,2,9,18,51,22,0,0,2018-2019,1.2587412587412588,2.3076923076923075
1399,Philipp Lienhart,AUT,DF,Freiburg,Bundesliga,22,1996,6.8,6,6,4,2,0,3,6,50.0,3,9,7,2,11,17,42,0,0,2018-2019,1.6176470588235294,0.8823529411764706
1400,Lucas Lima,BRA,"DF,FW",Nantes,Ligue 1,26,1991,27.7,49,28,26,15,8,20,53,37.7,33,39,3,36,29,78,62,1,0,2018-2019,1.0469314079422383,1.7689530685920578
Rk,Player,Nation,Pos,Squad,Comp,0,0,90.0,0,0,3,3,3,Tkl,0,0.0,0,0,0,0,0,0,0,0,0,2018-2019,0.0,0.0
1401,Anthony Limbombe,BEL,FW,Nantes,Ligue 1,24,1994,13.7,12,10,4,6,2,7,16,43.8,9,5,0,5,8,20,10,0,0,2018-2019,0.5839416058394161,0.8759124087591241
1402,Victor Lindelöf,SWE,DF,Manchester Utd,Premier League,24,1994,28.9,40,27,28,12,0,13,23,56.5,10,21,12,9,24,64,121,3,0,2018-2019,0.8304498269896194,1.384083044982699
1403,Karol Linetty,POL,MF,Sampdoria,Serie A,23,1995,27.9,72,48,26,32,14,15,69,21.7,54,39,4,35,25,97,17,0,0,2018-2019,0.8960573476702509,2.5806451612903225
1404,Jesse Lingard,ENG,"FW,MF",Manchester Utd,Premier League,25,1992,18.5,29,18,8,11,10,7,28,25.0,21,18,2,16,10,39,9,1,0,2018-2019,0.5405405405405406,1.5675675675675675
1405,Pol Lirola,ESP,"DF,MF",Sassuolo,Serie A,20,1997,33.1,35,22,19,11,5,21,34,61.8,13,25,5,20,32,67,89,0,0,2018-2019,0.9667673716012084,1.0574018126888216
1406,Adem Ljajić,SRB,MF,Torino,Serie A,26,1991,0.3,0,0,0,0,0,0,1,0.0,1,0,0,0,0,0,0,0,0,2018-2019,0.0,0.0
1407,Diego Llorente,ESP,DF,Real Sociedad,La Liga,24,1993,19.5,26,15,16,8,2,17,29,58.6,12,27,15,12,26,52,83,2,0,2018-2019,1.3333333333333333,1.3333333333333333
1408,Fernando Llorente,ESP,FW,Tottenham,Premier League,33,1985,7.7,4,2,3,0,1,2,3,66.7,1,7,2,5,1,5,10,0,0,2018-2019,0.12987012987012986,0.5194805194805194
1409,Marcos Llorente,ESP,MF,Real Madrid,La Liga,23,1995,6.0,16,12,7,7,2,8,18,44.4,10,8,0,8,7,23,12,0,0,2018-2019,1.1666666666666667,2.6666666666666665
1410,Hugo Lloris,FRA,GK,Tottenham,Premier League,31,1986,33.0,1,0,1,0,0,0,2,0.0,2,0,0,0,0,1,13,5,0,2018-2019,0.0,0.030303030303030304
1411,Giovani Lo Celso,ARG,"MF,FW",Betis,La Liga,22,1996,26.6,52,31,16,28,8,9,35,25.7,26,24,1,23,17,69,8,0,0,2018-2019,0.6390977443609023,1.9548872180451127
1412,Giovani Lo Celso,ARG,MF,Paris S-G,Ligue 1,22,1996,0.1,1,1,0,0,1,0,1,0.0,1,0,0,0,0,1,0,0,0,2018-2019,0.0,10.0
1413,Stanislav Lobotka,SVK,MF,Celta Vigo,La Liga,23,1994,27.7,30,19,10,17,3,9,32,28.1,23,15,1,14,26,56,18,1,0,2018-2019,0.9386281588447654,1.0830324909747293
1414,Jürgen Locadia,CUW,"FW,MF",Brighton,Premier League,24,1993,13.7,15,10,5,8,2,3,7,42.9,4,8,0,8,9,24,13,0,0,2018-2019,0.6569343065693432,1.094890510948905
1415,Manuel Locatelli,ITA,MF,Sassuolo,Serie A,20,1998,20.5,44,28,19,15,10,13,29,44.8,16,21,3,18,27,71,33,1,0,2018-2019,1.3170731707317074,2.1463414634146343
1416,Ruben Loftus-Cheek,ENG,"MF,FW",Chelsea,Premier League,22,1996,11.1,18,12,7,7,4,3,12,25.0,9,10,4,6,11,29,5,0,0,2018-2019,0.990990990990991,1.6216216216216217
1417,Enzo Loiodice,FRA,MF,Dijon,Ligue 1,17,2000,9.4,25,14,8,15,2,10,21,47.6,11,7,0,7,11,36,7,0,0,2018-2019,1.1702127659574468,2.6595744680851063
1418,Kevin Long,IRL,DF,Burnley,Premier League,27,1990,5.7,18,10,13,5,0,7,17,41.2,10,7,5,2,7,25,35,1,0,2018-2019,1.2280701754385965,3.1578947368421053
1419,Shane Long,IRL,"FW,MF",Southampton,Premier League,31,1987,14.1,15,8,4,5,6,3,16,18.8,13,10,1,9,7,22,18,0,0,2018-2019,0.49645390070921985,1.0638297872340425
1420,Samuele Longo,ITA,FW,Huesca,La Liga,26,1992,6.2,4,3,2,2,0,0,6,0.0,6,4,0,4,1,5,7,0,0,2018-2019,0.16129032258064516,0.6451612903225806
1421,Sean Longstaff,ENG,MF,Newcastle Utd,Premier League,20,1997,7.6,17,13,6,11,0,9,24,37.5,15,19,4,15,10,27,7,0,0,2018-2019,1.3157894736842106,2.236842105263158
1422,Ademola Lookman,NGA,"FW,MF",Everton,Premier League,20,1997,6.9,15,7,7,5,3,4,6,66.7,2,10,0,10,7,22,2,0,0,2018-2019,1.0144927536231882,2.1739130434782608
1423,Anthony Lopes,POR,GK,Lyon,Ligue 1,27,1990,34.0,1,0,1,0,0,1,3,33.3,2,3,0,3,2,3,16,3,0,2018-2019,0.058823529411764705,0.029411764705882353
1424,Rony Lopes,POR,"FW,MF",Monaco,Ligue 1,22,1995,20.5,33,22,10,17,6,9,22,40.9,13,17,1,16,8,41,10,0,0,2018-2019,0.3902439024390244,1.6097560975609757
1425,Álex López,ESP,MF,Espanyol,La Liga,21,1997,1.2,3,1,1,2,0,2,3,66.7,1,0,0,0,3,6,1,0,0,2018-2019,2.5,2.5
Rk,Player,Nation,Pos,Squad,Comp,0,0,90.0,0,0,3,3,3,Tkl,0,0.0,0,0,0,0,0,0,0,0,0,2018-2019,0.0,0.0
1426,Cristian López,ESP,FW,Angers,Ligue 1,29,1989,4.1,6,3,1,2,3,1,8,12.5,7,4,0,4,1,7,2,0,0,2018-2019,0.24390243902439027,1.4634146341463417
1427,David López,ESP,DF,Espanyol,La Liga,28,1989,20.2,27,18,15,10,2,10,22,45.5,12,18,12,6,28,55,65,2,0,2018-2019,1.3861386138613863,1.3366336633663367
1428,Diego López,ESP,GK,Espanyol,La Liga,36,1981,38.0,0,0,0,0,0,0,0,0.0,0,0,0,0,2,2,9,3,0,2018-2019,0.05263157894736842,0.0
1429,Javi López,ESP,DF,Espanyol,La Liga,32,1986,21.6,63,40,37,22,4,28,60,46.7,32,27,5,22,40,103,90,0,0,2018-2019,1.8518518518518516,2.9166666666666665
1430,Lluis López,ESP,DF,Espanyol,La Liga,21,1997,5.8,5,3,4,1,0,3,6,50.0,3,6,2,4,7,12,21,0,0,2018-2019,1.206896551724138,0.8620689655172414
1431,Maxime Lopez,FRA,MF,Marseille,Ligue 1,20,1997,24.2,46,24,17,23,6,19,53,35.8,34,10,2,8,20,66,8,0,0,2018-2019,0.8264462809917356,1.9008264462809918
1432,Pedro López Muñoz,ESP,DF,Levante,La Liga,34,1983,5.2,5,3,5,0,0,3,7,42.9,4,8,3,5,8,13,7,0,0,2018-2019,1.5384615384615383,0.9615384615384615
1433,Pau López,ESP,GK,Betis,La Liga,23,1994,33.0,0,0,0,0,0,0,2,0.0,2,1,0,1,2,2,17,2,0,2018-2019,0.06060606060606061,0.0
1434,Roberto López,ESP,MF,Real Sociedad,La Liga,18,2000,0.3,0,0,0,0,0,0,1,0.0,1,1,0,1,1,1,2,0,0,2018-2019,3.3333333333333335,0.0
1435,Unai López,ESP,MF,Athletic Club,La Liga,22,1995,3.6,7,5,3,2,2,2,12,16.7,10,10,3,7,1,8,2,0,0,2018-2019,0.2777777777777778,1.9444444444444444
1436,Jonas Lössl,DEN,GK,Huddersfield,Premier League,29,1989,30.9,0,0,0,0,0,0,1,0.0,1,1,0,1,2,2,12,2,0,2018-2019,0.06472491909385114,0.0
1437,Albert Lottin,FRA,"MF,FW",Bordeaux,Ligue 1,16,2001,0.2,1,1,0,1,0,0,1,0.0,1,1,0,1,0,1,0,0,0,2018-2019,0.0,5.0
1438,Imran Louza,MAR,MF,Nantes,Ligue 1,19,1999,1.0,2,0,1,1,0,1,1,100.0,0,1,0,1,0,2,1,0,0,2018-2019,0.0,2.0
1439,Davor Lovren,CRO,MF,Düsseldorf,Bundesliga,19,1998,0.5,1,1,0,0,1,0,0,0.0,0,1,0,1,0,1,0,0,0,2018-2019,0.0,2.0
1440,Dejan Lovren,CRO,DF,Liverpool,Premier League,29,1989,11.0,15,9,10,5,0,7,15,46.7,8,11,7,4,11,26,51,2,0,2018-2019,1.0,1.3636363636363635
1441,Chris Löwe,GER,"DF,MF",Huddersfield,Premier League,29,1989,22.9,34,18,17,15,2,12,33,36.4,21,21,3,18,23,57,56,0,0,2018-2019,1.0043668122270744,1.4847161572052403
1442,Eduard Löwen,GER,"MF,FW",Nürnberg,Bundesliga,21,1997,18.0,30,22,14,13,3,11,34,32.4,23,15,2,13,8,38,23,0,0,2018-2019,0.4444444444444444,1.6666666666666667
1443,Matthew Lowton,ENG,DF,Burnley,Premier League,29,1989,19.4,56,35,21,31,4,32,60,53.3,28,29,7,22,30,86,80,1,0,2018-2019,1.5463917525773196,2.8865979381443303
1444,Anthony Lozano,HON,"FW,MF",Girona,La Liga,25,1993,8.1,6,5,3,3,0,0,6,0.0,6,7,1,6,0,6,6,0,0,2018-2019,0.0,0.7407407407407408
1445,Derrick Luckassen,NED,DF,Hertha BSC,Bundesliga,23,1995,2.8,4,2,4,0,0,1,3,33.3,2,1,0,1,0,4,13,0,0,2018-2019,0.0,1.4285714285714286
1446,Filipe Luís,BRA,DF,Atlético Madrid,La Liga,32,1985,22.6,66,36,33,25,8,32,58,55.2,26,18,3,15,44,110,47,0,0,2018-2019,1.9469026548672566,2.9203539823008846
1447,José Luis Gayà,ESP,DF,Valencia,La Liga,23,1995,34.9,83,59,56,20,7,46,80,57.5,34,48,6,42,43,126,105,1,0,2018-2019,1.2320916905444126,2.378223495702006
1448,José Luis Morales,ESP,"FW,MF",Levante,La Liga,31,1987,35.5,21,15,6,10,5,8,49,16.3,41,22,1,21,12,33,17,0,0,2018-2019,0.3380281690140845,0.5915492957746479
1449,José Luis Palomino,ARG,DF,Atalanta,Serie A,28,1990,25.1,49,31,31,15,3,23,38,60.5,15,34,17,17,68,117,79,0,0,2018-2019,2.7091633466135456,1.9521912350597608
1450,Luisinho,POR,DF,Huesca,La Liga,33,1985,5.6,14,10,9,5,0,10,17,58.8,7,6,1,5,16,30,17,0,0,2018-2019,2.857142857142857,2.5
Rk,Player,Nation,Pos,Squad,Comp,0,0,90.0,0,0,3,3,3,Tkl,0,0.0,0,0,0,0,0,0,0,0,0,2018-2019,0.0,0.0
1451,David Luiz,BRA,DF,Chelsea,Premier League,31,1987,36.0,41,31,27,13,1,21,28,75.0,7,33,18,15,35,76,149,1,0,2018-2019,0.9722222222222222,1.1388888888888888
1452,Douglas Luiz,BRA,MF,Girona,La Liga,20,1998,16.6,34,19,13,20,1,9,38,23.7,29,19,7,12,21,55,26,0,0,2018-2019,1.2650602409638554,2.048192771084337
1453,Everton Luiz,BRA,MF,SPAL,Serie A,30,1988,3.5,11,6,5,5,1,4,7,57.1,3,9,1,8,3,14,7,2,0,2018-2019,0.8571428571428571,3.142857142857143
1454,Jordan Lukaku,BEL,"DF,MF",Lazio,Serie A,24,1994,1.9,4,3,2,1,1,3,5,60.0,2,3,0,3,5,9,2,0,0,2018-2019,2.6315789473684212,2.1052631578947367
1455,Romelu Lukaku,BEL,FW,Manchester Utd,Premier League,25,1993,23.7,8,4,0,6,2,2,10,20.0,8,12,1,11,2,10,19,0,0,2018-2019,0.08438818565400844,0.33755274261603374
1456,Dodi Lukebakio,BEL,"FW,MF",Düsseldorf,Bundesliga,20,1997,21.9,25,17,11,6,8,8,15,53.3,7,13,0,13,9,34,19,0,0,2018-2019,0.4109589041095891,1.1415525114155252
1457,Saša Lukić,SRB,MF,Torino,Serie A,21,1996,11.0,21,11,5,11,5,5,16,31.3,11,13,4,9,12,33,11,0,0,2018-2019,1.0909090909090908,1.9090909090909092
1458,Senad Lulić,BIH,"DF,FW",Lazio,Serie A,32,1986,32.5,71,43,37,27,7,32,76,42.1,44,27,3,24,49,120,58,1,0,2018-2019,1.5076923076923077,2.1846153846153844
1459,Antonio Luna,ESP,"DF,FW",Levante,La Liga,27,1991,14.0,14,10,6,7,1,6,23,26.1,17,22,7,15,15,29,48,1,0,2018-2019,1.0714285714285714,1.0
1460,Andriy Lunin,UKR,GK,Leganés,La Liga,19,1999,4.1,0,0,0,0,0,0,0,0.0,0,0,0,0,0,0,0,0,0,2018-2019,0.0,0.0
1461,Sebastiano Luperto,ITA,DF,Napoli,Serie A,21,1996,8.1,8,6,5,2,1,2,5,40.0,3,7,3,4,13,21,30,0,0,2018-2019,1.6049382716049383,0.9876543209876544
1462,Fabian Lustenberger,SUI,"DF,MF",Hertha BSC,Bundesliga,30,1988,24.1,45,30,23,21,1,15,33,45.5,18,39,18,21,39,84,108,2,0,2018-2019,1.6182572614107882,1.867219917012448
1463,Andreas Luthe,GER,GK,Augsburg,Bundesliga,31,1987,14.6,0,0,0,0,0,0,0,0.0,0,0,0,0,0,0,4,0,0,2018-2019,0.0,0.0
1464,Lyanco,BRA,DF,Torino,Serie A,21,1997,1.0,1,1,1,0,0,0,0,0.0,0,1,1,0,4,5,5,0,0,2018-2019,4.0,1.0
1465,Lyanco,BRA,DF,Bologna,Serie A,21,1997,12.4,29,18,19,10,0,13,18,72.2,5,24,16,8,22,51,64,0,0,2018-2019,1.7741935483870968,2.338709677419355
1466,Hervé Lybohy,NIG,DF,Nîmes,Ligue 1,35,1983,16.4,22,13,13,9,0,11,16,68.8,5,17,11,6,14,36,70,0,0,2018-2019,0.853658536585366,1.3414634146341464
1467,Charalambos Lykogiannis,GRE,DF,Cagliari,Serie A,24,1993,9.2,14,8,8,3,3,6,11,54.5,5,18,3,15,19,33,33,0,0,2018-2019,2.065217391304348,1.5217391304347827
1468,Yann M'Vila,FRA,MF,Saint-Étienne,Ligue 1,28,1990,36.2,72,40,22,48,2,29,72,40.3,43,42,12,30,74,146,86,5,0,2018-2019,2.044198895027624,1.9889502762430937
1469,Darwin Machís,VEN,"FW,MF",Udinese,Serie A,25,1993,5.1,7,6,4,3,0,0,4,0.0,4,6,0,6,2,9,8,0,0,2018-2019,0.3921568627450981,1.3725490196078431
1470,James Maddison,ENG,"MF,FW",Leicester City,Premier League,21,1996,31.5,48,32,20,25,3,14,58,24.1,44,20,4,16,12,60,10,1,0,2018-2019,0.38095238095238093,1.5238095238095237
1471,Gary Madine,ENG,"FW,MF",Cardiff City,Premier League,27,1990,0.4,1,1,0,1,0,0,0,0.0,0,0,0,0,0,1,0,0,0,2018-2019,0.0,2.5
1472,Pablo Maffeo,ESP,"DF,MF",Stuttgart,Bundesliga,21,1997,6.6,15,13,10,5,0,6,13,46.2,7,8,4,4,13,28,17,0,0,2018-2019,1.9696969696969697,2.272727272727273
1473,Gabriel Magalhães,BRA,DF,Lille,Ligue 1,20,1997,11.8,18,11,13,4,1,4,7,57.1,3,14,6,8,19,37,60,2,0,2018-2019,1.6101694915254237,1.5254237288135593
1474,Francesco Magnanelli,ITA,MF,Sassuolo,Serie A,33,1984,20.7,52,33,29,22,1,22,49,44.9,27,18,5,13,24,76,38,2,0,2018-2019,1.1594202898550725,2.5120772946859904
1475,Giangiacomo Magnani,ITA,DF,Sassuolo,Serie A,22,1995,16.8,11,9,9,2,0,6,15,40.0,9,17,13,4,16,27,99,1,0,2018-2019,0.9523809523809523,0.6547619047619048
Rk,Player,Nation,Pos,Squad,Comp,0,0,90.0,0,0,3,3,3,Tkl,0,0.0,0,0,0,0,0,0,0,0,0,2018-2019,0.0,0.0
1476,Harry Maguire,ENG,DF,Leicester City,Premier League,25,1993,28.8,31,17,21,9,1,11,17,64.7,6,32,18,14,36,67,155,4,0,2018-2019,1.25,1.0763888888888888
1477,Riyad Mahrez,ALG,"FW,MF",Manchester City,Premier League,27,1991,14.9,14,7,3,7,4,6,18,33.3,12,18,1,17,9,23,3,1,0,2018-2019,0.6040268456375839,0.9395973154362416
1478,Thiago Maia,BRA,MF,Lille,Ligue 1,21,1997,11.3,32,19,17,13,2,13,33,39.4,20,14,5,9,23,55,23,0,0,2018-2019,2.0353982300884956,2.831858407079646
1479,Raffaele Maiello,ITA,MF,Frosinone,Serie A,27,1991,22.7,42,27,30,8,4,16,27,59.3,11,23,10,13,30,72,41,0,0,2018-2019,1.3215859030837005,1.8502202643171808
1480,Arne Maier,GER,MF,Hertha BSC,Bundesliga,19,1999,22.9,31,16,12,19,0,6,25,24.0,19,32,9,23,28,59,35,0,0,2018-2019,1.2227074235807862,1.3537117903930131
1481,Domenico Maietta,ITA,DF,Empoli,Serie A,35,1982,19.0,33,15,22,10,1,16,36,44.4,20,19,14,5,24,57,78,2,0,2018-2019,1.263157894736842,1.736842105263158
1482,Mike Maignan,FRA,GK,Lille,Ligue 1,23,1995,38.0,0,0,0,0,0,0,0,0.0,0,1,0,1,0,0,12,1,0,2018-2019,0.0,0.0
1483,Linton Maina,GER,"FW,MF",Hannover 96,Bundesliga,19,1999,15.7,28,14,13,10,5,12,23,52.2,11,20,0,20,14,42,4,0,0,2018-2019,0.89171974522293,1.78343949044586
1484,Ainsley Maitland-Niles,ENG,DF,Arsenal,Premier League,20,1997,11.0,33,22,19,12,2,14,28,50.0,14,22,4,18,19,52,15,2,0,2018-2019,1.7272727272727273,3.0
1485,Josh Maja,NGA,FW,Bordeaux,Ligue 1,19,1998,2.2,2,1,1,1,0,0,1,0.0,1,1,0,1,0,2,0,0,0,2018-2019,0.0,0.9090909090909091
1486,Abdul Majeed Waris,GHA,"FW,MF",Nantes,Ligue 1,26,1991,25.0,22,13,6,13,3,7,28,25.0,21,9,0,9,7,29,7,0,0,2018-2019,0.28,0.88
1487,Jean-Victor Makengo,FRA,"MF,FW",Nice,Ligue 1,20,1998,11.4,10,8,3,6,1,1,5,20.0,4,5,1,4,9,19,5,0,0,2018-2019,0.7894736842105263,0.8771929824561403
1488,Nemanja Maksimović,SRB,MF,Getafe,La Liga,23,1995,35.7,77,45,21,51,5,21,61,34.4,40,60,15,45,71,148,33,0,0,2018-2019,1.9887955182072827,2.156862745098039
1489,Nikola Maksimović,SRB,DF,Napoli,Serie A,26,1991,15.3,20,13,14,6,0,6,12,50.0,6,16,10,6,28,48,56,1,0,2018-2019,1.8300653594771241,1.3071895424836601
1490,Malcom,BRA,"FW,MF",Barcelona,La Liga,21,1997,6.8,3,2,0,1,2,2,3,66.7,1,7,0,7,1,4,1,0,0,2018-2019,0.14705882352941177,0.4411764705882353
1491,Kévin Malcuit,MAR,DF,Napoli,Serie A,27,1991,20.1,43,31,23,14,6,23,36,63.9,13,18,4,14,44,87,67,0,0,2018-2019,2.189054726368159,2.1393034825870645
1492,Yunus Mallı,TUR,"MF,FW",Wolfsburg,Bundesliga,26,1992,7.8,15,7,8,6,1,2,11,18.2,9,2,0,2,4,19,1,0,0,2018-2019,0.5128205128205129,1.9230769230769231
1493,Hugo Mallo,ESP,DF,Celta Vigo,La Liga,27,1991,34.4,73,41,41,27,5,27,52,51.9,25,44,13,31,50,123,135,1,0,2018-2019,1.4534883720930234,2.122093023255814
1494,Antonio Mance,CRO,FW,Nantes,Ligue 1,22,1995,0.6,1,1,0,0,1,1,2,50.0,1,0,0,0,0,1,0,0,0,2018-2019,0.0,1.6666666666666667
1495,Vincent Manceau,FRA,DF,Angers,Ligue 1,29,1989,31.0,98,65,64,23,11,33,62,53.2,29,41,10,31,44,142,87,0,0,2018-2019,1.4193548387096775,3.161290322580645
1496,Gianluca Mancini,ITA,DF,Atalanta,Serie A,22,1996,25.0,40,30,22,17,1,16,29,55.2,13,19,4,15,48,88,77,1,0,2018-2019,1.92,1.6
1497,Steve Mandanda,FRA,GK,Marseille,Ligue 1,33,1985,30.4,0,0,0,0,0,0,3,0.0,3,0,0,0,1,1,7,4,0,2018-2019,0.03289473684210526,0.0
1498,Reinildo Mandava,MOZ,DF,Lille,Ligue 1,24,1994,1.1,3,2,1,2,0,2,3,66.7,1,1,0,1,1,4,0,0,0,2018-2019,0.9090909090909091,2.727272727272727
1499,Aïssa Mandi,ALG,DF,Betis,La Liga,26,1991,34.0,52,34,27,20,5,12,29,41.4,17,39,23,16,41,93,71,2,0,2018-2019,1.2058823529411764,1.5294117647058822
1500,Rolando Mandragora,ITA,MF,Udinese,Serie A,21,1997,32.4,66,35,25,34,7,24,69,34.8,45,49,9,40,43,109,59,0,0,2018-2019,1.3271604938271606,2.037037037037037
Rk,Player,Nation,Pos,Squad,Comp,0,0,90.0,0,0,3,3,3,Tkl,0,0.0,0,0,0,0,0,0,0,0,0,2018-2019,0.0,0.0
1501,Mario Mandžukić,CRO,FW,Juventus,Serie A,32,1986,22.4,34,25,13,15,6,9,18,50.0,9,17,5,12,13,47,22,0,0,2018-2019,0.5803571428571429,1.517857142857143
1502,Sadio Mané,SEN,FW,Liverpool,Premier League,26,1992,34.2,35,29,12,17,6,14,43,32.6,29,28,4,24,15,50,10,1,0,2018-2019,0.43859649122807015,1.023391812865497
1503,Thomas Mangani,FRA,MF,Angers,Ligue 1,31,1987,17.8,42,27,13,26,3,19,62,30.6,43,13,2,11,23,65,24,0,0,2018-2019,1.2921348314606742,2.359550561797753
1504,Kostas Manolas,GRE,DF,Roma,Serie A,27,1991,25.8,32,24,23,8,1,17,26,65.4,9,34,25,9,50,82,117,2,0,2018-2019,1.937984496124031,1.2403100775193798
1505,Javier Manquillo,ESP,DF,Newcastle Utd,Premier League,24,1994,12.2,27,19,14,11,2,9,14,64.3,5,9,1,8,17,44,58,0,0,2018-2019,1.3934426229508197,2.2131147540983607
1506,Martín Mantovani,ARG,DF,Huesca,La Liga,34,1984,7.8,15,9,12,3,0,6,11,54.5,5,4,3,1,22,37,48,0,0,2018-2019,2.8205128205128207,1.9230769230769231
1507,Juan Manuel Valencia,COL,FW,Bologna,Serie A,20,1998,0.3,0,0,0,0,0,0,0,0.0,0,0,0,0,1,1,0,0,0,2018-2019,3.3333333333333335,0.0
1508,Harrison Manzala,COD,"MF,FW",Angers,Ligue 1,24,1994,0.8,2,2,1,0,1,0,0,0.0,0,0,0,0,0,2,1,0,0,2018-2019,0.0,2.5
1509,Fran Manzanara,ESP,"DF,MF",Levante,La Liga,21,1996,1.7,7,5,3,3,1,4,4,100.0,0,3,2,1,1,8,7,0,0,2018-2019,0.5882352941176471,4.11764705882353
1510,Myziane Maolida,COM,FW,Nice,Ligue 1,19,1999,10.6,12,8,5,5,2,2,4,50.0,2,5,0,5,1,13,5,0,0,2018-2019,0.09433962264150944,1.1320754716981132
1511,Faitout Maouassa,FRA,DF,Nîmes,Ligue 1,20,1998,23.7,55,30,35,15,5,23,39,59.0,16,24,5,19,23,78,81,1,0,2018-2019,0.9704641350210971,2.320675105485232
1512,Fernando Marçal,BRA,DF,Lyon,Ligue 1,29,1989,9.8,25,16,17,7,1,12,15,80.0,3,9,3,6,30,55,42,0,0,2018-2019,3.061224489795918,2.5510204081632653
1513,Iván Marcano,ESP,DF,Roma,Serie A,31,1987,9.0,8,4,4,4,0,5,8,62.5,3,13,6,7,24,32,45,0,0,2018-2019,2.6666666666666665,0.8888888888888888
1514,Marcelo,BRA,DF,Real Madrid,La Liga,30,1988,20.6,34,19,17,12,5,15,39,38.5,24,19,2,17,17,51,21,0,0,2018-2019,0.8252427184466019,1.6504854368932038
1515,Marcelo,BRA,DF,Lyon,Ligue 1,31,1987,32.0,48,33,29,17,2,19,24,79.2,5,30,22,8,62,110,152,2,0,2018-2019,1.9375,1.5
1516,Solly March,ENG,"FW,MF",Brighton,Premier League,24,1994,27.4,56,24,27,16,13,19,45,42.2,26,34,4,30,27,83,44,0,0,2018-2019,0.9854014598540146,2.0437956204379564
1517,Federico Marchetti,ITA,GK,Genoa,Serie A,35,1983,4.0,0,0,0,0,0,0,0,0.0,0,0,0,0,0,0,1,0,0,2018-2019,0.0,0.0
1518,Gian Marco Ferrari,ITA,DF,Sassuolo,Serie A,26,1992,31.0,41,23,27,12,2,12,16,75.0,4,36,20,16,36,77,97,1,0,2018-2019,1.1612903225806452,1.3225806451612903
1519,Óscar de Marcos,ESP,"DF,FW",Athletic Club,La Liga,29,1989,26.9,60,32,34,17,9,29,62,46.8,33,29,4,25,27,87,62,0,0,2018-2019,1.0037174721189592,2.2304832713754648
1520,Georg Margreitter,AUT,DF,Nürnberg,Bundesliga,29,1988,22.9,39,24,28,8,3,31,38,81.6,7,29,26,3,26,65,141,0,0,2018-2019,1.1353711790393013,1.7030567685589522
1521,Miguel Marí,ESP,MF,Eibar,La Liga,21,1997,0.8,0,0,0,0,0,0,2,0.0,2,0,0,0,1,1,2,0,0,2018-2019,1.25,0.0
1522,José María Giménez,URU,DF,Atlético Madrid,La Liga,23,1995,19.7,26,15,20,6,0,13,26,50.0,13,27,14,13,44,70,128,2,0,2018-2019,2.233502538071066,1.3197969543147208
1523,Mariano,DOM,FW,Real Madrid,La Liga,24,1993,5.0,2,1,1,1,0,0,3,0.0,3,2,0,2,0,2,2,0,0,2018-2019,0.0,0.4
1524,Mariano,DOM,FW,Lyon,Ligue 1,24,1993,1.6,0,0,0,0,0,0,0,0.0,0,0,0,0,1,1,0,0,0,2018-2019,0.625,0.0
1525,Adrian Mariappa,JAM,DF,Watford,Premier League,31,1986,21.4,35,22,29,6,0,16,32,50.0,16,23,15,8,26,61,120,2,0,2018-2019,1.2149532710280375,1.6355140186915889
Rk,Player,Nation,Pos,Squad,Comp,0,0,90.0,0,0,3,3,3,Tkl,0,0.0,0,0,0,0,0,0,0,0,0,2018-2019,0.0,0.0
1526,Jordan Marié,FRA,MF,Dijon,Ligue 1,26,1991,20.0,52,28,15,31,6,21,58,36.2,37,28,5,23,40,92,32,0,0,2018-2019,2.0,2.6
1527,Adrián Marín,ESP,"DF,MF",Alavés,La Liga,21,1997,3.2,13,8,8,5,0,4,7,57.1,3,1,0,1,7,20,13,0,0,2018-2019,2.1875,4.0625
1528,João Mário,POR,"MF,FW",Inter,Serie A,25,1993,12.0,28,16,9,15,4,9,31,29.0,22,14,0,14,6,34,4,1,0,2018-2019,0.5,2.3333333333333335
1529,Guillermo Maripán,CHI,DF,Alavés,La Liga,24,1994,22.3,46,26,34,12,0,26,38,68.4,12,35,19,16,40,86,133,2,0,2018-2019,1.7937219730941703,2.0627802690582957
1530,Lazar Marković,SRB,MF,Fulham,Premier League,24,1994,0.5,0,0,0,0,0,0,0,0.0,0,0,0,0,0,0,2,0,0,2018-2019,0.0,0.0
1531,Marlon,BRA,DF,Sassuolo,Serie A,22,1995,16.8,29,18,25,3,1,15,21,71.4,6,22,12,10,24,53,39,0,0,2018-2019,1.4285714285714286,1.726190476190476
1532,Marquinhos,BRA,"DF,MF",Paris S-G,Ligue 1,24,1994,29.9,65,41,34,28,3,31,52,59.6,21,30,13,17,44,109,84,1,0,2018-2019,1.4715719063545152,2.1739130434782608
1533,Roger Martí,ESP,FW,Levante,La Liga,27,1991,21.0,8,6,1,4,3,1,19,5.3,18,14,1,13,4,12,9,0,0,2018-2019,0.19047619047619047,0.38095238095238093
1534,Anthony Martial,FRA,FW,Manchester Utd,Premier League,22,1995,18.0,9,7,2,5,2,1,11,9.1,10,12,0,12,3,12,8,0,0,2018-2019,0.16666666666666666,0.5
1535,Aarón Martín,ESP,DF,Mainz 05,Bundesliga,21,1997,32.0,55,30,29,21,5,20,38,52.6,18,38,11,27,38,93,75,1,0,2018-2019,1.1875,1.71875
1536,Jonas Martin,FRA,MF,Strasbourg,Ligue 1,28,1990,22.9,46,28,23,18,5,17,33,51.5,16,30,12,18,30,76,42,0,0,2018-2019,1.310043668122271,2.0087336244541487
1537,Marvin Martin,FRA,MF,Reims,Ligue 1,30,1988,6.9,2,1,0,2,0,0,6,0.0,6,2,1,1,2,4,1,0,0,2018-2019,0.2898550724637681,0.2898550724637681
1538,Iñigo Martínez,ESP,DF,Athletic Club,La Liga,27,1991,32.2,53,26,36,16,1,23,37,62.2,14,24,14,10,69,122,144,0,0,2018-2019,2.142857142857143,1.6459627329192545
1539,Javi Martínez,ESP,MF,Bayern Munich,Bundesliga,29,1988,14.5,26,15,7,17,2,5,16,31.3,11,17,5,12,31,57,13,0,0,2018-2019,2.1379310344827585,1.793103448275862
1540,Lautaro Martínez,ARG,"FW,MF",Inter,Serie A,20,1997,14.9,6,5,0,2,4,2,6,33.3,4,16,0,16,3,9,7,0,0,2018-2019,0.20134228187919462,0.40268456375838924
1541,Pablo Martinez,FRA,DF,Strasbourg,Ligue 1,29,1989,31.3,51,34,34,17,0,30,49,61.2,19,37,23,14,52,103,132,1,0,2018-2019,1.6613418530351438,1.6293929712460065
1542,Gelson Martins,POR,"FW,MF",Atlético Madrid,La Liga,23,1995,2.5,5,3,3,1,1,3,4,75.0,1,1,0,1,1,6,1,0,0,2018-2019,0.4,2.0
1543,Gelson Martins,POR,"FW,MF",Monaco,Ligue 1,23,1995,15.4,20,12,8,7,5,13,32,40.6,19,9,1,8,8,28,7,0,0,2018-2019,0.5194805194805194,1.2987012987012987
1544,Adam Marušić,MNE,DF,Lazio,Serie A,25,1992,23.5,32,15,14,14,4,16,25,64.0,9,25,4,21,24,56,36,0,0,2018-2019,1.0212765957446808,1.3617021276595744
1545,Omar Mascarell,EQG,MF,Schalke 04,Bundesliga,25,1993,11.0,20,10,9,9,2,10,24,41.7,14,21,7,14,23,43,8,0,0,2018-2019,2.090909090909091,1.8181818181818181
1546,Andrea Masiello,ITA,DF,Atalanta,Serie A,32,1986,20.4,28,14,13,15,0,17,29,58.6,12,21,6,15,44,72,49,0,0,2018-2019,2.1568627450980395,1.3725490196078431
1547,Adam Masina,MAR,DF,Watford,Premier League,24,1994,11.2,30,17,16,13,1,13,25,52.0,12,19,4,15,17,47,40,0,0,2018-2019,1.517857142857143,2.678571428571429
1548,Jordi Masip,ESP,GK,Valladolid,La Liga,29,1989,35.0,1,1,1,0,0,0,0,0.0,0,1,0,1,1,2,3,3,0,2018-2019,0.02857142857142857,0.02857142857142857
1549,Han-Noah Massengo,FRA,MF,Monaco,Ligue 1,17,2001,0.7,2,2,2,0,0,2,5,40.0,3,0,0,0,2,4,1,0,0,2018-2019,2.857142857142857,2.857142857142857
1550,Arthur Masuaku,COD,DF,West Ham,Premier League,24,1993,19.5,57,25,38,13,6,31,56,55.4,25,27,6,21,36,93,72,0,0,2018-2019,1.8461538461538463,2.923076923076923
Rk,Player,Nation,Pos,Squad,Comp,0,0,90.0,0,0,3,3,3,Tkl,0,0.0,0,0,0,0,0,0,0,0,0,2018-2019,0.0,0.0
1551,Jaime Mata,ESP,"FW,MF",Getafe,La Liga,29,1988,27.0,30,21,8,14,8,7,26,26.9,19,14,0,14,17,47,27,0,0,2018-2019,0.6296296296296297,1.1111111111111112
1552,Juan Mata,ESP,"FW,MF",Manchester Utd,Premier League,30,1988,14.3,9,4,7,1,1,6,21,28.6,15,8,1,7,6,15,6,0,0,2018-2019,0.4195804195804196,0.6293706293706294
1553,Luca Matarese,ITA,FW,Frosinone,Serie A,20,1998,0.2,0,0,0,0,0,0,0,0.0,0,0,0,0,0,0,0,0,0,2018-2019,0.0,0.0
1554,Jean-Philippe Mateta,FRA,FW,Mainz 05,Bundesliga,21,1997,27.6,13,9,4,4,5,1,10,10.0,9,15,2,13,3,16,22,0,0,2018-2019,0.10869565217391304,0.47101449275362317
1555,Christian Mathenia,GER,GK,Nürnberg,Bundesliga,26,1992,21.5,0,0,0,0,0,0,0,0.0,0,1,0,1,1,1,18,2,0,2018-2019,0.046511627906976744,0.0
1556,Nemanja Matić,SRB,MF,Manchester Utd,Premier League,29,1988,27.1,50,30,27,19,4,30,59,50.8,29,39,18,21,31,81,53,4,0,2018-2019,1.1439114391143912,1.8450184501845017
1557,Joël Matip,CMR,DF,Liverpool,Premier League,26,1991,17.1,39,26,23,12,4,13,24,54.2,11,12,7,5,32,71,78,0,0,2018-2019,1.871345029239766,2.280701754385965
1558,Rabbi Matondo,WAL,"FW,MF",Schalke 04,Bundesliga,17,2000,2.1,4,1,4,0,0,1,5,20.0,4,2,0,2,0,4,1,0,0,2018-2019,0.0,1.9047619047619047
1559,Alessandro Matri,ITA,FW,Sassuolo,Serie A,33,1984,6.7,2,1,0,0,2,0,3,0.0,3,4,2,2,4,6,7,0,0,2018-2019,0.5970149253731343,0.29850746268656714
1560,Federico Mattiello,ITA,"DF,FW",Bologna,Serie A,23,1995,14.8,33,20,19,9,5,15,23,65.2,8,9,3,6,20,53,43,0,0,2018-2019,1.3513513513513513,2.22972972972973
1561,Blaise Matuidi,FRA,MF,Juventus,Serie A,31,1987,26.9,59,33,25,21,13,20,36,55.6,16,33,8,25,26,85,21,1,0,2018-2019,0.966542750929368,2.193308550185874
1562,José Mauri,ITA,MF,Milan,Serie A,22,1996,2.3,8,4,2,6,0,2,6,33.3,4,0,0,0,5,13,0,0,0,2018-2019,2.173913043478261,3.4782608695652177
1563,Stephy Mavididi,ENG,FW,Juventus,Serie A,20,1998,0.2,0,0,0,0,0,0,0,0.0,0,1,0,1,0,0,0,0,0,2018-2019,0.0,0.0
1564,Konstantinos Mavropanos,GRE,DF,Arsenal,Premier League,20,1997,1.6,1,0,0,1,0,1,1,100.0,0,1,1,0,7,8,5,0,0,2018-2019,4.375,0.625
1565,Alfie Mawson,ENG,DF,Fulham,Premier League,24,1994,12.6,11,7,7,4,0,6,10,60.0,4,20,17,3,19,30,64,1,0,2018-2019,1.507936507936508,0.873015873015873
1566,Philipp Max,GER,"DF,MF",Augsburg,Bundesliga,24,1993,28.5,35,24,17,15,3,21,39,53.8,18,16,3,13,22,57,46,1,0,2018-2019,0.7719298245614035,1.2280701754385965
1567,Alexandru Maxim,ROU,"MF,FW",Mainz 05,Bundesliga,28,1990,6.4,16,10,6,9,1,10,19,52.6,9,12,0,12,5,21,7,0,0,2018-2019,0.78125,2.5
1568,Eric Maxim Choupo-Moting,CMR,FW,Paris S-G,Ligue 1,29,1989,8.9,9,4,3,2,4,2,9,22.2,7,7,0,7,3,12,4,0,0,2018-2019,0.33707865168539325,1.0112359550561798
1569,Borja Mayoral,ESP,FW,Levante,La Liga,21,1997,18.0,9,4,1,6,2,5,16,31.3,11,10,1,9,5,14,5,0,0,2018-2019,0.2777777777777778,0.5
1570,Róbert Mazáň,SVK,DF,Celta Vigo,La Liga,24,1994,1.0,3,3,3,0,0,2,2,100.0,0,2,0,2,3,6,0,0,0,2018-2019,3.0,3.0
1571,Luca Mazzitelli,ITA,MF,Genoa,Serie A,22,1995,3.6,5,2,3,1,1,2,3,66.7,1,4,1,3,6,11,7,0,0,2018-2019,1.6666666666666665,1.3888888888888888
1572,Kylian Mbappé,FRA,FW,Paris S-G,Ligue 1,19,1998,26.0,8,4,2,1,5,1,6,16.7,5,2,0,2,5,13,2,0,0,2018-2019,0.19230769230769232,0.3076923076923077
1573,Ibrahima Mbaye,SEN,DF,Bologna,Serie A,23,1994,22.3,48,32,30,16,2,19,32,59.4,13,21,12,9,19,67,66,1,0,2018-2019,0.852017937219731,2.1524663677130045
1574,Loïc Mbe Soh,FRA,DF,Paris S-G,Ligue 1,17,2001,2.0,0,0,0,0,0,0,3,0.0,3,2,2,0,3,3,5,0,0,2018-2019,1.5,0.0
1575,Nolan Mbemba,CGO,"MF,DF",Reims,Ligue 1,23,1995,4.0,14,8,10,4,0,6,9,66.7,3,4,1,3,10,24,4,2,0,2018-2019,2.5,3.5
Rk,Player,Nation,Pos,Squad,Comp,0,0,90.0,0,0,3,3,3,Tkl,0,0.0,0,0,0,0,0,0,0,0,0,2018-2019,0.0,0.0
1576,Adama Mbengue,SEN,DF,Caen,Ligue 1,24,1993,8.2,48,32,34,12,2,19,26,73.1,7,15,4,11,7,55,22,0,0,2018-2019,0.853658536585366,5.853658536585367
1577,Isaac Mbenza,BEL,"FW,MF",Huddersfield,Premier League,22,1996,11.0,10,9,5,5,0,2,4,50.0,2,4,0,4,5,15,4,0,0,2018-2019,0.45454545454545453,0.9090909090909091
1578,Stéphane Mbia,CMR,"DF,MF",Toulouse,Ligue 1,32,1986,5.0,1,0,1,0,0,1,2,50.0,1,9,4,5,7,8,25,1,0,2018-2019,1.4,0.2
1579,Kara Mbodji,SEN,DF,Nantes,Ligue 1,28,1989,5.6,12,10,10,1,1,6,8,75.0,2,4,1,3,6,18,25,0,0,2018-2019,1.0714285714285714,2.142857142857143
1580,Jordi Mboula,ESP,"FW,MF",Monaco,Ligue 1,19,1999,3.1,3,0,0,1,2,3,6,50.0,3,1,0,1,1,4,5,0,0,2018-2019,0.3225806451612903,0.9677419354838709
1581,James McArthur,SCO,MF,Crystal Palace,Premier League,30,1987,34.0,84,51,38,32,14,30,78,38.5,48,64,22,42,39,123,55,0,0,2018-2019,1.1470588235294117,2.4705882352941178
1582,Alex McCarthy,ENG,GK,Southampton,Premier League,28,1989,25.0,0,0,0,0,0,0,0,0.0,0,0,0,0,0,0,6,2,0,2018-2019,0.0,0.0
1583,James McCarthy,IRL,MF,Everton,Premier League,27,1990,0.2,2,1,1,1,0,0,0,0.0,0,0,0,0,1,3,0,0,0,2018-2019,5.0,10.0
1584,Kevin McDonald,SCO,MF,Fulham,Premier League,29,1988,9.3,15,11,6,8,1,5,13,38.5,8,8,2,6,9,24,22,0,0,2018-2019,0.9677419354838709,1.6129032258064515
1585,Levan Mchedlidze,GEO,FW,Empoli,Serie A,28,1990,2.3,1,1,0,0,1,0,1,0.0,1,2,0,2,0,1,5,0,0,2018-2019,0.0,0.4347826086956522
1586,Weston McKennie,USA,"MF,FW",Schalke 04,Bundesliga,19,1998,19.4,28,14,5,17,6,11,35,31.4,24,28,9,19,36,64,46,1,0,2018-2019,1.8556701030927836,1.4432989690721651
1587,Dwight McNeil,ENG,MF,Burnley,Premier League,18,1999,17.7,36,22,16,17,3,13,44,29.5,31,30,3,27,13,49,35,0,0,2018-2019,0.7344632768361582,2.0338983050847457
1588,Scott McTominay,SCO,"MF,DF",Manchester Utd,Premier League,21,1996,9.6,10,9,3,6,1,4,10,40.0,6,9,4,5,15,25,16,0,0,2018-2019,1.5625,1.0416666666666667
1589,Iuri Medeiros,POR,"MF,FW",Genoa,Serie A,24,1994,1.2,2,2,0,1,1,1,2,50.0,1,2,0,2,0,2,1,0,0,2018-2019,0.0,1.6666666666666667
1590,Nicky Medja,SUI,"FW,MF",Fiorentina,Serie A,18,2000,0.5,1,0,0,0,1,1,2,50.0,1,0,0,0,0,1,0,0,0,2018-2019,0.0,2.0
1591,Álvaro Medrán,ESP,MF,Rayo Vallecano,La Liga,24,1994,12.8,15,8,5,6,4,6,21,28.6,15,10,1,9,17,32,9,0,0,2018-2019,1.328125,1.171875
1592,Ben Mee,ENG,DF,Burnley,Premier League,28,1989,38.0,55,24,38,17,0,35,44,79.5,9,59,50,9,48,103,235,4,0,2018-2019,1.263157894736842,1.4473684210526316
1593,Riccardo Meggiorini,ITA,FW,Chievo,Serie A,32,1985,17.2,17,13,5,9,3,1,10,10.0,9,20,2,18,8,25,26,0,0,2018-2019,0.46511627906976744,0.9883720930232559
1594,Admir Mehmedi,SUI,"FW,MF",Wolfsburg,Bundesliga,27,1991,18.8,46,28,19,19,8,18,44,40.9,26,25,0,25,12,58,9,0,0,2018-2019,0.6382978723404255,2.4468085106382977
1595,Soualiho Meïté,FRA,MF,Torino,Serie A,24,1994,29.5,46,21,13,22,11,23,46,50.0,23,46,6,40,29,75,26,0,0,2018-2019,0.9830508474576272,1.5593220338983051
1596,Farid El Melali,ALG,"MF,FW",Angers,Ligue 1,21,1997,3.6,8,4,3,4,1,3,12,25.0,9,2,0,2,5,13,1,0,0,2018-2019,1.3888888888888888,2.2222222222222223
1597,Óscar Melendo,ESP,"MF,FW",Espanyol,La Liga,20,1997,22.2,17,8,7,6,4,10,26,38.5,16,17,1,16,13,30,9,0,0,2018-2019,0.5855855855855856,0.7657657657657658
1598,Gonzalo Melero,ESP,MF,Huesca,La Liga,24,1994,14.9,26,23,5,19,2,11,48,22.9,37,14,4,10,2,28,23,0,0,2018-2019,0.1342281879194631,1.74496644295302
1599,Arthur Melo,BRA,MF,Barcelona,La Liga,21,1996,15.9,15,10,5,6,4,6,13,46.2,7,8,0,8,9,24,9,1,0,2018-2019,0.5660377358490566,0.9433962264150944
1600,Memphis,NED,"FW,MF",Lyon,Ligue 1,24,1994,30.4,12,9,0,7,5,5,21,23.8,16,16,2,14,9,21,1,0,0,2018-2019,0.2960526315789474,0.39473684210526316
Rk,Player,Nation,Pos,Squad,Comp,0,0,90.0,0,0,3,3,3,Tkl,0,0.0,0,0,0,0,0,0,0,0,0,2018-2019,0.0,0.0
1601,Pedro Mendes,POR,DF,Montpellier,Ligue 1,27,1990,29.6,71,42,56,13,2,31,47,66.0,16,42,22,20,48,119,73,1,0,2018-2019,1.6216216216216215,2.3986486486486487
1602,Thiago Mendes,BRA,MF,Lille,Ligue 1,26,1992,34.2,85,47,42,41,2,39,71,54.9,32,44,11,33,68,153,49,0,0,2018-2019,1.9883040935672514,2.485380116959064
1603,Brais Méndez,ESP,"MF,FW",Celta Vigo,La Liga,21,1997,26.1,61,31,23,29,9,14,53,26.4,39,32,3,29,24,85,24,0,0,2018-2019,0.9195402298850575,2.337164750957854
1604,Nathaniel Mendez-Laing,GUA,"MF,FW",Cardiff City,Premier League,26,1992,10.9,34,25,18,12,4,12,26,46.2,14,17,1,16,13,47,20,0,0,2018-2019,1.1926605504587156,3.1192660550458715
1605,Stiven Mendoza,COL,"FW,MF",Amiens,Ligue 1,26,1992,20.9,29,18,10,12,7,14,38,36.8,24,18,0,18,17,46,12,0,0,2018-2019,0.8133971291866029,1.3875598086124403
1606,Alexandre Mendy,GNB,FW,Guingamp,Ligue 1,24,1994,8.5,5,3,0,4,1,3,8,37.5,5,3,0,3,1,6,6,0,0,2018-2019,0.11764705882352941,0.5882352941176471
1607,Benjamin Mendy,FRA,DF,Manchester City,Premier League,24,1994,10.0,16,10,10,5,1,9,17,52.9,8,13,4,9,10,26,18,0,0,2018-2019,1.0,1.6
1608,Edouard Mendy,SEN,GK,Reims,Ligue 1,26,1992,38.0,0,0,0,0,0,0,1,0.0,1,1,0,1,2,2,16,3,0,2018-2019,0.05263157894736842,0.0
1609,Ferland Mendy,FRA,DF,Lyon,Ligue 1,23,1995,28.1,44,28,25,14,5,14,17,82.4,3,22,5,17,34,78,53,2,0,2018-2019,1.2099644128113878,1.5658362989323842
1610,Nampalys Mendy,SEN,MF,Leicester City,Premier League,26,1992,23.2,33,18,16,16,1,6,22,27.3,16,24,8,16,26,59,26,2,0,2018-2019,1.120689655172414,1.4224137931034484
1611,Hamza Mendyl,MAR,DF,Schalke 04,Bundesliga,20,1997,6.0,17,15,6,8,3,8,18,44.4,10,11,2,9,8,25,8,0,0,2018-2019,1.3333333333333333,2.8333333333333335
1612,Chris Mepham,WAL,DF,Bournemouth,Premier League,20,1997,9.4,9,3,9,0,0,7,11,63.6,4,12,5,7,14,23,57,2,0,2018-2019,1.4893617021276595,0.9574468085106382
1613,Gabriel Mercado,ARG,DF,Sevilla,La Liga,31,1987,19.3,35,23,21,12,2,18,36,50.0,18,24,12,12,26,61,75,1,0,2018-2019,1.3471502590673574,1.8134715025906736
1614,Alex Meret,ITA,GK,Napoli,Serie A,21,1997,12.8,0,0,0,0,0,0,0,0.0,0,0,0,0,0,0,3,1,0,2018-2019,0.0,0.0
1615,Mehdi Merghem,FRA,"FW,MF",Guingamp,Ligue 1,21,1997,8.0,25,18,15,7,3,11,21,52.4,10,14,1,13,9,34,6,0,0,2018-2019,1.125,3.125
1616,Mikel Merino,ESP,MF,Real Sociedad,La Liga,22,1996,22.8,50,28,19,25,6,14,52,26.9,38,37,2,35,29,79,37,1,0,2018-2019,1.2719298245614035,2.1929824561403506
1617,Sabin Merino,ESP,"FW,MF",Leganés,La Liga,26,1992,3.3,1,1,0,0,1,1,1,100.0,0,1,0,1,0,1,4,0,0,2018-2019,0.0,0.30303030303030304
1618,Martín Merquelanz,ESP,MF,Real Sociedad,La Liga,23,1995,0.1,0,0,0,0,0,0,0,0.0,0,0,0,0,0,0,0,0,0,2018-2019,0.0,0.0
1619,Dries Mertens,BEL,FW,Napoli,Serie A,31,1987,25.0,19,11,2,7,10,1,21,4.8,20,7,0,7,13,32,3,0,0,2018-2019,0.52,0.76
1620,Roque Mesa,ESP,MF,Sevilla,La Liga,29,1989,19.4,46,27,16,22,8,15,38,39.5,23,16,0,16,14,60,12,4,0,2018-2019,0.7216494845360826,2.3711340206185567
1621,Lionel Messi,ARG,FW,Barcelona,La Liga,31,1987,30.1,12,7,5,3,4,1,17,5.9,16,10,0,10,3,15,1,0,0,2018-2019,0.09966777408637874,0.39867109634551495
1622,Romain Métanire,MAD,DF,Reims,Ligue 1,28,1990,3.5,12,9,10,1,1,5,7,71.4,2,4,3,1,6,18,13,0,0,2018-2019,1.7142857142857142,3.4285714285714284
1623,Thomas Meunier,BEL,DF,Paris S-G,Ligue 1,26,1991,17.9,44,33,25,15,4,21,35,60.0,14,13,2,11,19,63,29,0,0,2018-2019,1.0614525139664805,2.458100558659218
1624,Mexer,MOZ,DF,Rennes,Ligue 1,29,1988,27.4,23,12,18,5,0,12,18,66.7,6,26,18,8,30,53,125,0,0,2018-2019,1.094890510948905,0.8394160583941607
1625,Max Meyer,GER,MF,Crystal Palace,Premier League,22,1995,15.7,33,18,14,18,1,11,20,55.0,9,6,0,6,15,48,19,0,0,2018-2019,0.9554140127388535,2.1019108280254777
Rk,Player,Nation,Pos,Squad,Comp,0,0,90.0,0,0,3,3,3,Tkl,0,0.0,0,0,0,0,0,0,0,0,0,2018-2019,0.0,0.0
1626,Matt Miazga,USA,DF,Nantes,Ligue 1,23,1995,8.0,12,11,11,1,0,7,9,77.8,2,11,7,4,12,24,41,1,0,2018-2019,1.5,1.5
1627,Míchel,ESP,MF,Valladolid,La Liga,30,1988,28.4,60,38,25,31,4,18,73,24.7,55,40,4,36,43,103,30,1,0,2018-2019,1.5140845070422535,2.1126760563380285
1628,Clément Michelin,FRA,DF,Toulouse,Ligue 1,21,1997,1.0,3,2,2,1,0,2,3,66.7,1,0,0,0,3,6,7,0,0,2018-2019,3.0,3.0
1629,Petar Mićin,SRB,MF,Udinese,Serie A,19,1998,0.0,0,0,0,0,0,0,0,0.0,0,0,0,0,0,0,0,0,0,2018-2019,,
1630,Miguel,ESP,FW,Valladolid,La Liga,18,1999,0.1,0,0,0,0,0,0,1,0.0,1,0,0,0,1,1,0,0,0,2018-2019,10.0,0.0
1631,Florian Miguel,FRA,DF,Nîmes,Ligue 1,21,1996,12.4,19,16,13,6,0,7,11,63.6,4,15,7,8,21,40,47,0,0,2018-2019,1.6935483870967742,1.532258064516129
1632,Nikola Milenković,SRB,DF,Fiorentina,Serie A,20,1997,33.4,59,40,36,21,2,17,33,51.5,16,39,21,18,48,107,143,0,0,2018-2019,1.437125748502994,1.7664670658682635
1633,Arkadiusz Milik,POL,FW,Napoli,Serie A,24,1994,26.6,19,9,1,8,10,1,20,5.0,19,7,2,5,3,22,15,0,0,2018-2019,0.11278195488721804,0.7142857142857143
1634,Sergej Milinković-Savić,SRB,MF,Lazio,Serie A,23,1995,26.6,44,28,17,21,6,23,60,38.3,37,28,4,24,27,71,48,0,0,2018-2019,1.0150375939849623,1.6541353383458646
1635,Vanja Milinković-Savić,SRB,GK,SPAL,Serie A,21,1997,1.8,0,0,0,0,0,0,0,0.0,0,0,0,0,0,0,1,0,0,2018-2019,0.0,0.0
1636,Luka Milivojević,SRB,MF,Crystal Palace,Premier League,27,1991,38.0,90,69,36,47,7,39,91,42.9,52,47,15,32,72,162,68,3,0,2018-2019,1.894736842105263,2.3684210526315788
1637,Pere Milla,ESP,"MF,FW",Eibar,La Liga,25,1992,3.8,7,6,1,5,1,0,5,0.0,5,4,1,3,2,9,1,0,0,2018-2019,0.5263157894736842,1.842105263157895
1638,Vincenzo Millico,ITA,MF,Torino,Serie A,17,2000,0.0,0,0,0,0,0,0,0,0.0,0,0,0,0,0,0,0,0,0,2018-2019,,
1639,James Milner,ENG,"MF,DF",Liverpool,Premier League,32,1986,19.9,43,23,14,24,5,15,41,36.6,26,40,5,35,18,61,30,0,0,2018-2019,0.9045226130653267,2.1608040201005028
1640,Santi Mina,ESP,FW,Valencia,La Liga,22,1995,20.6,17,10,1,15,1,3,25,12.0,22,19,2,17,4,21,20,0,0,2018-2019,0.1941747572815534,0.8252427184466019
1641,Yerry Mina,COL,DF,Everton,Premier League,23,1994,9.9,14,7,8,6,0,6,9,66.7,3,11,5,6,8,22,54,3,0,2018-2019,0.8080808080808081,1.4141414141414141
1642,Tyrone Mings,ENG,DF,Bournemouth,Premier League,25,1993,1.6,4,3,3,1,0,2,3,66.7,1,5,2,3,6,10,8,0,0,2018-2019,3.75,2.5
1643,Ignasi Miquel,ESP,DF,Getafe,La Liga,25,1992,3.5,1,0,0,1,0,1,2,50.0,1,4,4,0,5,6,25,0,0,2018-2019,1.4285714285714286,0.2857142857142857
1644,Kevin Mirallas,BEL,"FW,MF",Fiorentina,Serie A,30,1987,14.4,17,7,8,4,5,6,15,40.0,9,17,0,17,4,21,10,0,0,2018-2019,0.2777777777777778,1.1805555555555556
1645,Jorge Miramón,ESP,DF,Huesca,La Liga,29,1989,27.7,73,55,49,17,7,34,53,64.2,19,34,11,23,44,117,65,1,0,2018-2019,1.588447653429603,2.6353790613718413
1646,Miranda,BRA,DF,Inter,Serie A,33,1984,12.9,11,7,7,4,0,4,8,50.0,4,11,7,4,14,25,48,2,0,2018-2019,1.0852713178294573,0.8527131782945736
1647,Antonio Mirante,ITA,GK,Roma,Serie A,35,1983,11.0,0,0,0,0,0,0,0,0.0,0,0,0,0,0,0,6,1,0,2018-2019,0.0,0.0
1648,Virgil Misidjan,SUR,"MF,FW",Nürnberg,Bundesliga,25,1993,17.1,21,13,10,5,6,4,25,16.0,21,17,0,17,9,30,5,0,0,2018-2019,0.5263157894736842,1.2280701754385963
1649,Simone Missiroli,ITA,MF,SPAL,Serie A,32,1986,30.5,58,43,31,22,5,25,49,51.0,24,44,11,33,46,104,46,0,0,2018-2019,1.5081967213114753,1.901639344262295
1650,Kostas Mitroglou,GRE,FW,Marseille,Ligue 1,30,1988,6.4,0,0,0,0,0,0,3,0.0,3,0,0,0,0,0,5,0,0,2018-2019,0.0,0.0
Rk,Player,Nation,Pos,Squad,Comp,0,0,90.0,0,0,3,3,3,Tkl,0,0.0,0,0,0,0,0,0,0,0,0,2018-2019,0.0,0.0
1651,Aleksandar Mitrović,SRB,FW,Fulham,Premier League,23,1994,36.4,19,9,3,13,3,5,15,33.3,10,22,8,14,6,25,53,0,0,2018-2019,0.16483516483516483,0.521978021978022
1652,Stefan Mitrović,SRB,DF,Strasbourg,Ligue 1,28,1990,33.6,23,16,20,3,0,12,24,50.0,12,41,31,10,46,69,146,2,0,2018-2019,1.369047619047619,0.6845238095238095
1653,Maximilian Mittelstädt,GER,"DF,MF",Hertha BSC,Bundesliga,21,1997,20.0,61,37,33,23,5,23,49,46.9,26,32,4,28,46,107,64,0,0,2018-2019,2.3,3.05
1654,Henrikh Mkhitaryan,ARM,"FW,MF",Arsenal,Premier League,29,1989,18.2,28,22,8,17,3,6,22,27.3,16,34,2,32,16,44,13,0,0,2018-2019,0.8791208791208791,1.5384615384615385
1655,Luka Modrić,CRO,MF,Real Madrid,La Liga,32,1985,29.0,49,30,11,25,13,14,48,29.2,34,20,3,17,31,80,7,1,0,2018-2019,1.0689655172413792,1.6896551724137931
1656,Kevin Möhwald,GER,MF,Werder Bremen,Bundesliga,25,1993,9.7,16,10,3,11,2,3,20,15.0,17,14,0,14,17,33,14,0,0,2018-2019,1.752577319587629,1.6494845360824744
1657,Niklas Moisander,FIN,DF,Werder Bremen,Bundesliga,32,1985,29.3,34,23,26,8,0,22,51,43.1,29,42,19,23,39,73,140,2,0,2018-2019,1.3310580204778157,1.1604095563139931
1658,Johan Mojica,COL,"FW,MF",Girona,La Liga,25,1992,0.2,1,1,1,0,0,0,0,0.0,0,0,0,0,0,1,0,0,0,2018-2019,0.0,5.0
1659,Hakim El Mokeddem,,"FW,MF",Toulouse,Ligue 1,19,1999,0.3,1,1,1,0,0,0,1,0.0,1,0,0,0,0,1,1,0,0,2018-2019,0.0,3.3333333333333335
1660,Jorge Molina,ESP,FW,Getafe,La Liga,36,1982,29.4,12,9,1,4,7,2,15,13.3,13,22,0,22,7,19,26,1,0,2018-2019,0.2380952380952381,0.40816326530612246
1661,Cristian Molinaro,ITA,"DF,MF",Frosinone,Serie A,35,1983,12.9,15,10,7,7,1,3,9,33.3,6,11,4,7,15,30,43,0,0,2018-2019,1.1627906976744187,1.1627906976744187
1662,Victor Mollejo,ESP,"FW,DF",Atlético Madrid,La Liga,17,2001,0.7,0,0,0,0,0,0,2,0.0,2,0,0,0,0,0,0,0,0,2018-2019,0.0,0.0
1663,Florent Mollet,FRA,MF,Montpellier,Ligue 1,26,1991,28.5,36,20,8,20,8,13,51,25.5,38,32,1,31,23,59,7,0,0,2018-2019,0.8070175438596491,1.263157894736842
1664,Gabriele Moncini,ITA,MF,SPAL,Serie A,22,1996,0.1,1,1,1,0,0,0,0,0.0,0,0,0,0,0,1,0,0,0,2018-2019,0.0,10.0
1665,Thomas Monconduit,FRA,MF,Amiens,Ligue 1,27,1991,31.3,76,47,38,33,5,26,63,41.3,37,46,17,29,36,112,77,1,0,2018-2019,1.1501597444089458,2.428115015974441
1666,Kévin Monnet-Paquet,FRA,"DF,MF",Saint-Étienne,Ligue 1,29,1988,16.5,46,25,23,16,7,20,36,55.6,16,22,4,18,14,60,28,0,0,2018-2019,0.8484848484848485,2.787878787878788
1667,Nacho Monreal,ESP,DF,Arsenal,Premier League,32,1986,20.7,35,17,21,9,5,15,25,60.0,10,28,10,18,31,66,62,0,0,2018-2019,1.497584541062802,1.6908212560386473
1668,Francisco Montero,ESP,DF,Atlético Madrid,La Liga,19,1999,4.5,8,4,5,3,0,5,6,83.3,1,10,4,6,5,13,18,1,0,2018-2019,1.1111111111111112,1.7777777777777777
1669,Cristóbal Montiel,ESP,FW,Fiorentina,Serie A,18,2000,0.1,0,0,0,0,0,0,0,0.0,0,0,0,0,0,0,0,0,0,2018-2019,0.0,0.0
1670,Martín Montoya,ESP,DF,Brighton,Premier League,27,1991,24.1,58,35,29,21,8,32,55,58.2,23,30,10,20,48,106,76,1,0,2018-2019,1.9917012448132778,2.4066390041493775
1671,Aaron Mooy,AUS,"MF,FW",Huddersfield,Premier League,27,1990,25.9,62,42,19,27,16,21,52,40.4,31,43,7,36,14,76,22,0,0,2018-2019,0.5405405405405406,2.393822393822394
1672,Emre Mor,TUR,"FW,MF",Celta Vigo,La Liga,21,1997,4.1,7,4,1,3,3,2,7,28.6,5,5,0,5,3,10,1,0,0,2018-2019,0.7317073170731708,1.707317073170732
1673,Alfredo Morales,USA,MF,Düsseldorf,Bundesliga,28,1990,17.0,32,18,16,15,1,6,24,25.0,18,18,9,9,24,56,31,0,0,2018-2019,1.411764705882353,1.8823529411764706
1674,Álvaro Morata,ESP,FW,Chelsea,Premier League,25,1992,10.5,8,5,0,5,3,1,7,14.3,6,6,1,5,0,8,6,0,0,2018-2019,0.0,0.7619047619047619
1675,Álvaro Morata,ESP,FW,Atlético Madrid,La Liga,25,1992,12.0,20,14,2,7,11,3,10,30.0,7,7,0,7,5,25,13,0,0,2018-2019,0.4166666666666667,1.6666666666666667
Rk,Player,Nation,Pos,Squad,Comp,0,0,90.0,0,0,3,3,3,Tkl,0,0.0,0,0,0,0,0,0,0,0,0,2018-2019,0.0,0.0
1676,Jan Morávek,CZE,MF,Augsburg,Bundesliga,28,1989,8.4,38,21,17,16,5,19,42,45.2,23,21,1,20,9,47,13,0,0,2018-2019,1.0714285714285714,4.523809523809524
1677,Steven Moreira,CPV,"DF,MF",Toulouse,Ligue 1,23,1994,9.6,19,8,13,5,1,10,17,58.8,7,14,0,14,10,29,19,1,0,2018-2019,1.0416666666666667,1.9791666666666667
1678,Jérémy Morel,MAD,DF,Lyon,Ligue 1,34,1984,11.8,16,10,11,5,0,9,13,69.2,4,18,14,4,18,34,45,1,0,2018-2019,1.5254237288135593,1.3559322033898304
1679,Alberto Moreno,ESP,DF,Liverpool,Premier League,26,1992,1.7,3,2,1,2,0,1,3,33.3,2,1,0,1,2,5,0,0,0,2018-2019,1.1764705882352942,1.7647058823529411
1680,Álex Moreno,ESP,DF,Rayo Vallecano,La Liga,25,1993,34.8,63,40,41,18,4,29,53,54.7,24,35,9,26,41,104,97,0,0,2018-2019,1.17816091954023,1.810344827586207
1681,Gerard Moreno,ESP,FW,Villarreal,La Liga,26,1992,25.7,22,12,2,15,5,8,27,29.6,19,23,9,14,9,31,39,0,0,2018-2019,0.3501945525291829,0.8560311284046693
1682,Héctor Moreno,MEX,DF,Real Sociedad,La Liga,30,1988,21.5,16,9,12,4,0,9,17,52.9,8,34,19,15,31,47,73,0,0,2018-2019,1.441860465116279,0.7441860465116279
1683,Sergio Moreno,ESP,FW,Rayo Vallecano,La Liga,19,1999,0.2,0,0,0,0,0,0,0,0.0,0,0,0,0,0,0,0,0,0,2018-2019,0.0,0.0
1684,Emiliano Moretti,ITA,DF,Torino,Serie A,37,1981,22.3,30,21,21,9,0,13,20,65.0,7,14,6,8,24,54,65,1,0,2018-2019,1.0762331838565022,1.3452914798206277
1685,Wes Morgan,JAM,DF,Leicester City,Premier League,34,1984,21.4,27,15,14,12,1,6,7,85.7,1,24,10,14,32,59,109,1,0,2018-2019,1.4953271028037385,1.2616822429906542
1686,Manu Morlanes,ESP,MF,Villarreal,La Liga,19,1999,6.8,21,11,9,9,3,7,19,36.8,12,7,3,4,5,26,9,0,0,2018-2019,0.7352941176470589,3.088235294117647
1687,Loren Morón,ESP,FW,Betis,La Liga,24,1993,21.7,18,12,4,11,3,6,27,22.2,21,24,1,23,6,24,18,0,0,2018-2019,0.2764976958525346,0.8294930875576038
1688,Sean Morrison,ENG,DF,Cardiff City,Premier League,27,1991,33.8,35,17,29,4,2,15,28,53.6,13,47,30,17,52,87,204,5,0,2018-2019,1.5384615384615385,1.0355029585798818
1689,Victor Moses,NGA,FW,Chelsea,Premier League,27,1990,0.3,0,0,0,0,0,0,0,0.0,0,1,0,1,0,0,0,0,0,2018-2019,0.0,0.0
1690,Lebo Mothiba,RSA,FW,Strasbourg,Ligue 1,22,1996,19.7,10,9,2,7,1,0,8,0.0,8,5,1,4,0,10,6,0,0,2018-2019,0.0,0.5076142131979695
1691,Lebo Mothiba,RSA,FW,Lille,Ligue 1,22,1996,2.8,1,1,0,1,0,0,0,0.0,0,0,0,0,0,1,8,0,0,2018-2019,0.0,0.35714285714285715
1692,François Moubandje,SUI,DF,Toulouse,Ligue 1,28,1990,21.5,38,22,22,10,6,17,22,77.3,5,18,4,14,27,65,74,0,0,2018-2019,1.255813953488372,1.7674418604651163
1693,Jessy Moulin,FRA,GK,Saint-Étienne,Ligue 1,32,1986,1.0,1,0,1,0,0,1,1,100.0,0,0,0,0,0,1,2,0,0,2018-2019,0.0,1.0
1694,Steve Mounié,BEN,FW,Huddersfield,Premier League,23,1994,19.8,9,6,3,4,2,2,12,16.7,10,10,1,9,5,14,15,0,0,2018-2019,0.25252525252525254,0.45454545454545453
1695,Lucas Moura,BRA,"FW,MF",Tottenham,Premier League,25,1992,23.6,35,18,8,20,7,9,27,33.3,18,15,1,14,24,59,24,0,0,2018-2019,1.0169491525423728,1.483050847457627
1696,Herman Moussaki,FRA,"MF,FW",Caen,Ligue 1,19,1999,2.3,3,3,2,1,0,1,4,25.0,3,2,1,1,0,3,3,0,0,2018-2019,0.0,1.3043478260869565
1697,Lys Mousset,FRA,FW,Bournemouth,Premier League,22,1996,4.1,3,1,1,1,1,1,4,25.0,3,3,0,3,1,4,3,0,0,2018-2019,0.24390243902439027,0.7317073170731708
1698,João Moutinho,POR,MF,Wolves,Premier League,31,1986,33.7,113,58,50,56,7,44,126,34.9,82,56,11,45,40,153,50,0,0,2018-2019,1.1869436201780414,3.353115727002967
1699,Samuel Moutoussamy,COD,"MF,FW",Nantes,Ligue 1,21,1996,18.3,35,20,16,11,8,12,34,35.3,22,17,2,15,9,44,17,0,0,2018-2019,0.4918032786885246,1.9125683060109289
1700,Toni Moya,ESP,DF,Atlético Madrid,La Liga,20,1998,1.0,2,2,2,0,0,0,1,0.0,1,0,0,0,0,2,3,0,0,2018-2019,0.0,2.0
Rk,Player,Nation,Pos,Squad,Comp,0,0,90.0,0,0,3,3,3,Tkl,0,0.0,0,0,0,0,0,0,0,0,0,2018-2019,0.0,0.0
1701,Javi Moyano,ESP,DF,Valladolid,La Liga,32,1986,23.3,25,17,17,6,2,15,30,50.0,15,20,9,11,25,50,88,2,0,2018-2019,1.0729613733905579,1.0729613733905579
1702,Samuel Mráz,SVK,FW,Empoli,Serie A,21,1997,1.9,0,0,0,0,0,0,0,0.0,0,2,0,2,0,0,2,0,0,2018-2019,0.0,0.0
1703,Ndombe Mubele,COD,FW,Toulouse,Ligue 1,24,1994,5.2,9,4,5,2,2,4,9,44.4,5,4,0,4,2,11,2,0,0,2018-2019,0.3846153846153846,1.7307692307692306
1704,Lukas Mühl,GER,DF,Nürnberg,Bundesliga,21,1997,31.0,57,34,49,6,2,32,51,62.7,19,53,18,35,48,105,139,2,0,2018-2019,1.5483870967741935,1.8387096774193548
1705,Nordi Mukiele,FRA,DF,RB Leipzig,Bundesliga,20,1997,13.6,38,21,23,12,3,19,22,86.4,3,17,3,14,24,62,35,0,0,2018-2019,1.7647058823529411,2.794117647058824
1706,Florian Müller,GER,GK,Mainz 05,Bundesliga,20,1997,24.0,1,1,1,0,0,1,2,50.0,1,0,0,0,3,4,8,5,0,2018-2019,0.125,0.041666666666666664
1707,Nicolai Müller,GER,"MF,FW",Hannover 96,Bundesliga,30,1987,10.0,18,9,7,7,4,8,27,29.6,19,9,1,8,1,19,7,0,0,2018-2019,0.1,1.8
1708,Nicolai Müller,GER,"FW,MF",Eint Frankfurt,Bundesliga,30,1987,2.4,4,2,3,1,0,1,2,50.0,1,4,1,3,0,4,0,0,0,2018-2019,0.0,1.6666666666666667
1709,Thomas Müller,GER,"MF,FW",Bayern Munich,Bundesliga,28,1989,26.4,42,23,13,15,14,10,38,26.3,28,46,6,40,9,51,12,0,0,2018-2019,0.34090909090909094,1.590909090909091
1710,Gianni Munari,ITA,MF,Parma,Serie A,35,1983,0.0,0,0,0,0,0,0,0,0.0,0,0,0,0,0,0,0,0,0,2018-2019,,
1711,Iker Muniain,ESP,"MF,FW",Athletic Club,La Liga,25,1992,26.5,29,20,10,14,5,6,29,20.7,23,17,3,14,12,41,6,0,0,2018-2019,0.4528301886792453,1.0943396226415094
1712,Marc Muniesa,ESP,"DF,MF",Girona,La Liga,26,1992,15.6,49,34,27,17,5,15,28,53.6,13,18,6,12,37,86,49,1,0,2018-2019,2.371794871794872,3.141025641025641
1713,Aihen Muñoz,ESP,DF,Real Sociedad,La Liga,20,1997,10.6,13,8,11,2,0,10,19,52.6,9,19,9,10,7,20,26,0,0,2018-2019,0.6603773584905661,1.2264150943396226
1714,Ezequiel Muñoz,ARG,DF,Leganés,La Liga,27,1990,2.3,3,2,1,2,0,0,0,0.0,0,3,1,2,1,4,10,0,0,2018-2019,0.4347826086956522,1.3043478260869565
1715,Joaquín Muñoz,ESP,FW,Atlético Madrid,La Liga,19,1999,0.0,0,0,0,0,0,0,0,0.0,0,0,0,0,0,0,0,0,0,2018-2019,,
1716,Alessandro Murgia,ITA,MF,SPAL,Serie A,21,1996,11.9,22,15,9,12,1,7,32,21.9,25,14,2,12,19,41,12,1,0,2018-2019,1.5966386554621848,1.8487394957983192
1717,Alessandro Murgia,ITA,MF,Lazio,Serie A,21,1996,0.1,0,0,0,0,0,0,0,0.0,0,0,0,0,0,0,0,0,0,2018-2019,0.0,0.0
1718,Luis Muriel,COL,FW,Fiorentina,Serie A,27,1991,16.0,19,11,4,13,2,6,18,33.3,12,10,0,10,3,22,1,0,0,2018-2019,0.1875,1.1875
1719,Luis Muriel,COL,"MF,FW",Sevilla,La Liga,27,1991,1.4,0,0,0,0,0,0,6,0.0,6,3,0,3,0,0,1,0,0,2018-2019,0.0,0.0
1720,Jeison Murillo,COL,DF,Valencia,La Liga,26,1992,1.0,2,1,1,1,0,1,2,50.0,1,1,0,1,2,4,6,0,0,2018-2019,2.0,2.0
1721,Jeison Murillo,COL,DF,Barcelona,La Liga,26,1992,1.3,2,2,1,1,0,0,3,0.0,3,0,0,0,0,2,5,1,0,2018-2019,0.0,1.5384615384615383
1722,Jacob Murphy,ENG,"MF,DF",Newcastle Utd,Premier League,23,1995,3.4,6,2,4,2,0,2,4,50.0,2,5,2,3,1,7,7,0,0,2018-2019,0.29411764705882354,1.7647058823529411
1723,Josh Murphy,ENG,"MF,FW",Cardiff City,Premier League,23,1995,20.2,26,17,15,7,4,9,29,31.0,20,30,0,30,11,37,17,0,0,2018-2019,0.5445544554455446,1.2871287128712872
1724,Glenn Murray,ENG,FW,Brighton,Premier League,34,1983,27.9,17,7,4,7,6,4,20,20.0,16,20,3,17,2,19,17,1,0,2018-2019,0.07168458781362008,0.6093189964157706
1725,Nicola Murru,ITA,DF,Sampdoria,Serie A,23,1994,32.6,83,59,42,25,16,41,54,75.9,13,50,22,28,41,124,99,0,0,2018-2019,1.2576687116564416,2.5460122699386503
Rk,Player,Nation,Pos,Squad,Comp,0,0,90.0,0,0,3,3,3,Tkl,0,0.0,0,0,0,0,0,0,0,0,0,2018-2019,0.0,0.0
1726,Mateo Musacchio,ARG,DF,Milan,Serie A,27,1990,29.0,41,22,30,8,3,19,27,70.4,8,26,19,7,29,70,114,0,0,2018-2019,1.0,1.4137931034482758
1727,Florent Muslija,KVX,"MF,FW",Hannover 96,Bundesliga,20,1998,7.5,16,10,8,6,2,8,12,66.7,4,4,0,4,3,19,4,0,0,2018-2019,0.4,2.1333333333333333
1728,Juan Musso,ARG,GK,Udinese,Serie A,24,1994,29.0,0,0,0,0,0,0,1,0.0,1,0,0,0,0,0,10,4,0,2018-2019,0.0,0.0
1729,Shkodran Mustafi,GER,DF,Arsenal,Premier League,26,1992,29.0,62,45,42,17,3,31,40,77.5,9,34,17,17,58,120,168,1,0,2018-2019,2.0,2.1379310344827585
1730,Damián Musto,ARG,"MF,DF",Huesca,La Liga,31,1987,18.7,52,34,22,27,3,16,33,48.5,17,30,11,19,34,86,54,1,0,2018-2019,1.8181818181818183,2.7807486631016043
1731,Yoshinori Mutō,JPN,"FW,MF",Newcastle Utd,Premier League,26,1992,5.8,8,4,3,5,0,2,7,28.6,5,9,0,9,5,13,3,1,0,2018-2019,0.8620689655172414,1.3793103448275863
1732,Yvon Mvogo,SUI,GK,RB Leipzig,Bundesliga,24,1994,1.5,0,0,0,0,0,0,0,0.0,0,0,0,0,0,0,1,0,0,2018-2019,0.0,0.0
1733,Phillipp Mwene,AUT,"DF,MF",Mainz 05,Bundesliga,24,1994,3.0,7,2,3,4,0,5,6,83.3,1,6,0,6,6,13,10,0,0,2018-2019,2.0,2.3333333333333335
1734,Obite N'Dicka,CIV,DF,Eint Frankfurt,Bundesliga,18,1999,25.6,43,28,31,10,2,31,52,59.6,21,29,11,18,29,72,123,0,0,2018-2019,1.1328125,1.6796875
1735,Kévin N'Doram,FRA,"DF,MF",Monaco,Ligue 1,22,1996,2.2,5,4,1,4,0,3,5,60.0,2,1,1,0,5,10,8,1,0,2018-2019,2.2727272727272725,2.2727272727272725
1736,Abdallah N'dour,SEN,DF,Strasbourg,Ligue 1,24,1993,3.2,6,4,3,3,0,4,9,44.4,5,4,2,2,5,11,8,0,0,2018-2019,1.5625,1.875
1737,Cheikh N'Doye,SEN,MF,Angers,Ligue 1,32,1986,25.9,25,15,14,11,0,10,32,31.3,22,33,8,25,25,50,61,0,0,2018-2019,0.9652509652509653,0.9652509652509653
1738,Nathan N'Goumou,FRA,FW,Toulouse,Ligue 1,18,2000,0.8,1,1,0,1,0,0,1,0.0,1,1,0,1,0,1,3,0,0,2018-2019,0.0,1.25
1739,Clinton N'Jie,CMR,FW,Marseille,Ligue 1,24,1993,4.0,7,4,2,3,2,3,3,100.0,0,2,0,2,2,9,0,0,0,2018-2019,0.5,1.75
1740,Georges-Kévin N'Koudou,CMR,FW,Tottenham,Premier League,23,1995,0.1,0,0,0,0,0,0,0,0.0,0,0,0,0,0,0,0,0,0,2018-2019,0.0,0.0
1741,Georges-Kévin N'Koudou,CMR,FW,Monaco,Ligue 1,23,1995,0.3,2,1,0,0,2,1,1,100.0,0,2,0,2,0,2,0,0,0,2018-2019,0.0,6.666666666666667
1742,Stanley N'Soki,FRA,DF,Paris S-G,Ligue 1,19,1999,7.8,20,14,8,10,2,6,13,46.2,7,10,1,9,18,38,20,1,0,2018-2019,2.307692307692308,2.5641025641025643
1743,Nacho,ESP,DF,Valladolid,La Liga,29,1989,35.0,110,66,73,30,7,67,100,67.0,33,43,10,33,45,155,113,2,0,2018-2019,1.2857142857142858,3.142857142857143
1744,Nacho,ESP,DF,Real Madrid,La Liga,28,1990,18.9,26,19,14,7,5,11,22,50.0,11,19,7,12,32,58,65,1,0,2018-2019,1.6931216931216932,1.3756613756613758
1745,Ádám Nagy,HUN,MF,Bologna,Serie A,23,1995,10.8,29,21,15,13,1,11,21,52.4,10,13,5,8,25,54,12,2,0,2018-2019,2.314814814814815,2.685185185185185
1746,Radja Nainggolan,BEL,MF,Inter,Serie A,30,1988,21.9,35,26,7,20,8,10,24,41.7,14,17,2,15,8,43,5,0,0,2018-2019,0.36529680365296807,1.5981735159817352
1747,Naldo,BRA,DF,Espanyol,La Liga,29,1988,15.1,18,10,9,5,4,6,10,60.0,4,19,13,6,26,44,112,1,0,2018-2019,1.7218543046357617,1.1920529801324504
1748,Naldo,BRA,DF,Monaco,Ligue 1,35,1982,3.3,5,3,4,1,0,2,4,50.0,2,5,2,3,5,10,23,0,0,2018-2019,1.5151515151515151,1.5151515151515151
1749,Naldo,BRA,DF,Schalke 04,Bundesliga,35,1982,7.0,10,7,8,2,0,5,8,62.5,3,8,3,5,14,24,25,0,0,2018-2019,2.0,1.4285714285714286
1750,Samir Nasri,FRA,MF,West Ham,Premier League,31,1987,2.7,0,0,0,0,0,0,0,0.0,0,1,0,1,1,1,1,0,0,2018-2019,0.37037037037037035,0.0
Rk,Player,Nation,Pos,Squad,Comp,0,0,90.0,0,0,3,3,3,Tkl,0,0.0,0,0,0,0,0,0,0,0,0,2018-2019,0.0,0.0
1751,Matija Nastasić,SRB,DF,Schalke 04,Bundesliga,25,1993,27.2,35,23,22,13,0,20,29,69.0,9,32,20,12,38,73,114,1,0,2018-2019,1.397058823529412,1.286764705882353
1752,Marc Navarro,ESP,DF,Watford,Premier League,23,1995,0.9,4,2,3,1,0,3,4,75.0,1,0,0,0,0,4,4,0,0,2018-2019,0.0,4.444444444444445
1753,Ximo Navarro,ESP,DF,Alavés,La Liga,28,1990,28.1,57,35,44,12,1,32,45,71.1,13,25,11,14,47,104,143,1,0,2018-2019,1.6725978647686832,2.0284697508896796
1754,Jesús Navas,ESP,"DF,FW",Sevilla,La Liga,32,1985,30.1,28,21,15,11,2,16,24,66.7,8,23,5,18,29,57,62,0,0,2018-2019,0.9634551495016611,0.9302325581395349
1755,Keylor Navas,CRC,GK,Real Madrid,La Liga,31,1986,10.0,0,0,0,0,0,0,0,0.0,0,0,0,0,1,1,5,0,0,2018-2019,0.1,0.0
1756,Raúl Navas,ESP,DF,Real Sociedad,La Liga,30,1988,14.6,23,14,20,3,0,13,21,61.9,8,20,9,11,20,43,60,1,0,2018-2019,1.36986301369863,1.5753424657534247
1757,Wilfred Ndidi,NGA,MF,Leicester City,Premier League,21,1996,36.6,142,98,66,67,9,46,95,48.4,49,64,9,55,83,225,85,2,0,2018-2019,2.26775956284153,3.879781420765027
1758,Aly Ndom,FRA,MF,Caen,Ligue 1,22,1996,0.5,0,0,0,0,0,0,0,0.0,0,0,0,0,1,1,1,0,0,2018-2019,2.0,0.0
1759,Aly Ndom,FRA,MF,Reims,Ligue 1,22,1996,4.0,11,9,5,5,1,3,7,42.9,4,6,2,4,3,14,9,1,0,2018-2019,0.75,2.75
1760,Tanguy Ndombele,FRA,MF,Lyon,Ligue 1,21,1996,29.9,66,43,21,35,10,22,54,40.7,32,29,9,20,30,96,13,3,0,2018-2019,1.0033444816053512,2.207357859531773
1761,Angelo Ndrecka,ALB,DF,Chievo,Serie A,16,2001,1.0,1,1,1,0,0,1,2,50.0,1,3,2,1,0,1,1,0,0,2018-2019,0.0,1.0
1762,Reiss Nelson,ENG,"MF,FW",Hoffenheim,Bundesliga,18,1999,7.1,17,10,8,4,5,2,13,15.4,11,12,1,11,5,22,2,0,0,2018-2019,0.7042253521126761,2.3943661971830985
1763,Neto,BRA,GK,Valencia,La Liga,29,1989,34.0,2,0,2,0,0,2,3,66.7,1,0,0,0,1,3,9,3,0,2018-2019,0.029411764705882353,0.058823529411764705
1764,Pedro Neto,POR,"FW,DF",Lazio,Serie A,18,2000,0.5,0,0,0,0,0,0,0,0.0,0,1,0,1,0,0,0,0,0,2018-2019,0.0,0.0
1765,Manuel Neuer,GER,GK,Bayern Munich,Bundesliga,32,1986,25.6,1,1,1,0,0,0,1,0.0,1,1,0,1,0,1,8,3,0,2018-2019,0.0,0.0390625
1766,Florian Neuhaus,GER,MF,Gladbach,Bundesliga,21,1997,22.9,22,15,9,9,4,10,36,27.8,26,20,1,19,10,32,23,0,0,2018-2019,0.4366812227074236,0.9606986899563319
1767,Rúben Neves,POR,MF,Wolves,Premier League,21,1997,33.4,75,32,33,36,6,27,83,32.5,56,57,18,39,73,148,46,3,0,2018-2019,2.1856287425149703,2.245508982035928
1768,Neymar,BRA,"MF,FW",Paris S-G,Ligue 1,26,1992,16.0,14,9,3,10,1,4,21,19.0,17,8,0,8,5,19,1,1,0,2018-2019,0.3125,0.875
1769,Yeni Ngbakoto,COD,"MF,FW",Guingamp,Ligue 1,26,1992,6.3,9,4,4,3,2,4,8,50.0,4,7,0,7,4,13,2,0,0,2018-2019,0.6349206349206349,1.4285714285714286
1770,Moussa Niakhate,SEN,DF,Mainz 05,Bundesliga,22,1996,31.0,49,30,35,12,2,20,33,60.6,13,42,24,18,44,93,143,1,0,2018-2019,1.4193548387096775,1.5806451612903225
1771,M'Baye Niang,SEN,"FW,MF",Rennes,Ligue 1,23,1994,19.9,16,10,3,8,5,2,11,18.2,9,19,3,16,8,24,14,0,0,2018-2019,0.4020100502512563,0.8040201005025126
1772,Oumar Niasse,SEN,FW,Cardiff City,Premier League,28,1990,10.3,12,3,1,5,6,4,8,50.0,4,7,0,7,2,14,7,0,0,2018-2019,0.1941747572815534,1.1650485436893203
1773,Oumar Niasse,SEN,FW,Everton,Premier League,28,1990,0.7,0,0,0,0,0,0,1,0.0,1,0,0,0,0,0,0,0,0,2018-2019,0.0,0.0
1774,Hans Nicolussi Caviglia,ITA,MF,Juventus,Serie A,18,2000,0.6,2,1,0,2,0,0,2,0.0,2,2,1,1,0,2,0,0,0,2018-2019,0.0,3.3333333333333335
1775,Florian Niederlechner,GER,"FW,MF",Freiburg,Bundesliga,27,1990,10.8,7,5,1,4,2,0,5,0.0,5,12,4,8,6,13,10,0,0,2018-2019,0.5555555555555555,0.6481481481481481
Rk,Player,Nation,Pos,Squad,Comp,0,0,90.0,0,0,3,3,3,Tkl,0,0.0,0,0,0,0,0,0,0,0,0,2018-2019,0.0,0.0
1776,Saúl Ñíguez,ESP,"MF,DF",Atlético Madrid,La Liga,23,1994,32.5,83,56,35,41,7,32,81,39.5,49,57,10,47,42,125,86,1,0,2018-2019,1.2923076923076924,2.5538461538461537
1777,Dimitris Nikolaou,GRE,DF,Empoli,Serie A,19,1998,3.9,5,3,3,2,0,1,2,50.0,1,2,2,0,2,7,14,0,0,2018-2019,0.5128205128205129,1.2820512820512822
1778,Casimir Ninga,CHA,"FW,MF",Caen,Ligue 1,25,1993,27.4,53,30,23,21,9,20,49,40.8,29,22,1,21,22,75,12,0,0,2018-2019,0.8029197080291971,1.9343065693430659
1779,Eddie Nketiah,ENG,"MF,FW",Arsenal,Premier League,19,1999,0.7,1,1,0,1,0,0,0,0.0,0,0,0,0,0,1,1,0,0,2018-2019,0.0,1.4285714285714286
1780,Nicolas Nkoulou,CMR,DF,Torino,Serie A,28,1990,35.7,45,29,34,10,1,15,25,60.0,10,42,28,14,70,115,174,2,0,2018-2019,1.9607843137254901,1.2605042016806722
1781,Christopher Nkunku,FRA,"MF,FW",Paris S-G,Ligue 1,20,1997,12.8,21,16,8,10,3,7,16,43.8,9,12,2,10,9,30,7,1,0,2018-2019,0.703125,1.640625
1782,Mark Noble,ENG,MF,West Ham,Premier League,31,1987,25.5,47,26,19,24,4,17,52,32.7,35,17,2,15,21,68,13,0,0,2018-2019,0.8235294117647058,1.8431372549019607
1783,Peru Nolaskoain,ESP,DF,Athletic Club,La Liga,19,1998,5.2,11,8,7,4,0,5,9,55.6,4,11,6,5,10,21,18,0,0,2018-2019,1.923076923076923,2.1153846153846154
1784,Nolito,ESP,"FW,DF",Sevilla,La Liga,31,1986,0.8,3,2,1,1,1,1,2,50.0,1,2,0,2,0,3,1,0,0,2018-2019,0.0,3.75
1785,Arnaud Nordin,FRA,"FW,MF",Saint-Étienne,Ligue 1,20,1998,11.7,14,12,4,4,6,4,11,36.4,7,13,2,11,5,19,9,0,0,2018-2019,0.4273504273504274,1.1965811965811965
1786,Håvard Nordtveit,NOR,DF,Fulham,Premier League,28,1990,4.0,9,4,8,1,0,4,5,80.0,1,3,3,0,8,17,15,1,0,2018-2019,2.0,2.25
1787,Håvard Nordtveit,NOR,"MF,DF",Hoffenheim,Bundesliga,28,1990,5.2,8,5,2,4,2,3,7,42.9,4,8,5,3,4,12,14,0,0,2018-2019,0.7692307692307692,1.5384615384615383
1788,Will Norris,ENG,GK,Wolves,Premier League,24,1993,0.0,0,0,0,0,0,0,0,0.0,0,0,0,0,0,0,0,0,0,2018-2019,,
1789,Alexander Nübel,GER,GK,Schalke 04,Bundesliga,21,1996,17.6,0,0,0,0,0,0,1,0.0,1,0,0,0,1,1,4,1,0,2018-2019,0.056818181818181816,0.0
1790,Kasim Nuhu,GHA,DF,Hoffenheim,Bundesliga,23,1995,10.0,19,11,14,3,2,10,23,43.5,13,11,5,6,23,42,44,0,0,2018-2019,2.3,1.9
1791,Unai Núñez,ESP,DF,Athletic Club,La Liga,21,1997,11.8,15,11,11,4,0,7,11,63.6,4,20,12,8,28,43,60,2,0,2018-2019,2.3728813559322033,1.271186440677966
1792,Hans Nunoo Sarpei,GHA,"FW,MF",Stuttgart,Bundesliga,19,1998,0.5,1,1,0,1,0,0,0,0.0,0,0,0,0,0,1,0,0,0,2018-2019,0.0,2.0
1793,Bram Nuytinck,NED,DF,Udinese,Serie A,28,1990,23.6,50,35,34,13,3,25,33,75.8,8,44,27,17,29,79,126,0,0,2018-2019,1.2288135593220337,2.11864406779661
1794,Gerzino Nyamsi,FRA,DF,Rennes,Ligue 1,21,1997,6.0,6,3,5,1,0,4,9,44.4,5,8,4,4,4,10,17,0,0,2018-2019,0.6666666666666666,1.0
1795,Allan Nyom,CMR,"DF,FW",Leganés,La Liga,30,1988,19.0,32,24,20,10,2,12,17,70.6,5,7,2,5,20,52,35,0,0,2018-2019,1.0526315789473684,1.6842105263157894
1796,Steven Nzonzi,FRA,MF,Roma,Serie A,29,1988,29.1,66,45,24,36,6,21,34,61.8,13,40,24,16,27,93,55,2,0,2018-2019,0.9278350515463917,2.268041237113402
1797,Christian Nørgaard,DEN,MF,Fiorentina,Serie A,24,1994,3.6,4,2,1,2,1,2,5,40.0,3,2,0,2,10,14,16,0,0,2018-2019,2.7777777777777777,1.1111111111111112
1798,Michael Obafemi,IRL,FW,Southampton,Premier League,18,2000,1.5,1,1,0,0,1,0,0,0.0,0,1,1,0,1,2,0,0,0,2018-2019,0.6666666666666666,0.6666666666666666
1799,Dimitri Oberlin,SUI,FW,Empoli,Serie A,20,1997,1.5,1,1,0,0,1,0,3,0.0,3,1,0,1,0,1,1,0,0,2018-2019,0.0,0.6666666666666666
1800,Joel Obi,NGA,MF,Chievo,Serie A,27,1991,7.3,22,15,9,11,2,7,17,41.2,10,12,1,11,14,36,15,0,0,2018-2019,1.9178082191780823,3.0136986301369864
Rk,Player,Nation,Pos,Squad,Comp,0,0,90.0,0,0,3,3,3,Tkl,0,0.0,0,0,0,0,0,0,0,0,0,2018-2019,0.0,0.0
1801,Pedro Obiang,EQG,MF,West Ham,Premier League,26,1992,12.5,41,23,23,16,2,18,43,41.9,25,27,9,18,12,53,18,0,0,2018-2019,0.96,3.28
1802,Jan Oblak,SVN,GK,Atlético Madrid,La Liga,25,1993,37.0,1,0,1,0,0,1,1,100.0,0,0,0,0,1,2,13,1,0,2018-2019,0.02702702702702703,0.02702702702702703
1803,Lucas Ocampos,ARG,"FW,MF",Marseille,Ligue 1,24,1994,30.1,80,54,37,33,10,34,80,42.5,46,40,5,35,29,109,30,0,0,2018-2019,0.9634551495016611,2.6578073089700998
1804,Bastian Oczipka,GER,"DF,FW",Schalke 04,Bundesliga,29,1989,20.8,41,27,20,19,2,21,26,80.8,5,23,5,18,24,65,24,2,0,2018-2019,1.1538461538461537,1.971153846153846
1805,Jens Odgaard,DEN,FW,Sassuolo,Serie A,19,1999,0.2,0,0,0,0,0,0,0,0.0,0,1,0,1,0,0,1,0,0,2018-2019,0.0,0.0
1806,Denis Odoi,GHA,DF,Fulham,Premier League,30,1988,28.8,48,34,29,16,3,21,33,63.6,12,45,24,21,42,90,153,0,0,2018-2019,1.4583333333333333,1.6666666666666665
1807,Álvaro Odriozola,ESP,DF,Real Madrid,La Liga,22,1995,13.1,28,25,13,11,4,14,18,77.8,4,11,1,10,11,39,17,1,0,2018-2019,0.8396946564885497,2.1374045801526718
1808,Angelo Ogbonna,ITA,DF,West Ham,Premier League,30,1988,20.8,31,13,23,6,2,14,23,60.9,9,29,19,10,35,66,101,0,0,2018-2019,1.6826923076923077,1.4903846153846154
1809,Dani Ojeda,ESP,"MF,DF",Leganés,La Liga,23,1994,2.1,3,2,2,0,1,1,3,33.3,2,2,0,2,2,5,2,0,0,2018-2019,0.9523809523809523,1.4285714285714286
1810,Sheyi Ojo,ENG,"FW,MF",Reims,Ligue 1,21,1997,5.2,8,6,2,4,2,2,8,25.0,6,1,0,1,3,11,2,0,0,2018-2019,0.5769230769230769,1.5384615384615383
1811,Stefano Okaka,ITA,"FW,MF",Watford,Premier League,28,1989,0.3,0,0,0,0,0,0,0,0.0,0,1,0,1,0,0,0,0,0,2018-2019,0.0,0.0
1812,Stefano Okaka,ITA,FW,Udinese,Serie A,28,1989,10.8,13,7,4,5,4,2,8,25.0,6,6,1,5,0,13,16,1,0,2018-2019,0.0,1.2037037037037037
1813,Shinji Okazaki,JPN,"MF,FW",Leicester City,Premier League,32,1986,3.2,5,5,2,3,0,0,1,0.0,1,7,1,6,2,7,1,0,0,2018-2019,0.625,1.5625
1814,Chima Okoroji,NGA,"DF,MF",Freiburg,Bundesliga,21,1997,1.2,3,0,1,1,1,1,1,100.0,0,0,0,0,1,4,1,0,0,2018-2019,0.8333333333333334,2.5
1815,Orji Okwonkwo,NGA,FW,Bologna,Serie A,20,1998,2.9,4,3,1,2,1,2,2,100.0,0,0,0,0,1,5,0,0,0,2018-2019,0.3448275862068966,1.3793103448275863
1816,Lucas Olaza,URU,DF,Celta Vigo,La Liga,24,1994,10.0,29,18,19,8,2,14,18,77.8,4,13,6,7,8,37,18,0,0,2018-2019,0.8,2.9
1817,Oier Olazábal,ESP,GK,Levante,La Liga,28,1989,21.0,1,1,1,0,0,1,2,50.0,1,1,0,1,1,2,15,2,0,2018-2019,0.047619047619047616,0.047619047619047616
1818,Kiko Olivas,ESP,DF,Valladolid,La Liga,29,1988,34.4,51,38,35,15,1,22,48,45.8,26,31,18,13,46,97,173,2,0,2018-2019,1.3372093023255816,1.4825581395348837
1819,Paulo Oliveira,POR,DF,Eibar,La Liga,26,1992,24.9,49,39,33,16,0,28,44,63.6,16,25,10,15,36,85,116,0,0,2018-2019,1.4457831325301205,1.9678714859437751
1820,Mathías Olivera,URU,"DF,MF",Getafe,La Liga,20,1997,11.2,24,17,11,8,5,10,18,55.6,8,25,2,23,10,34,22,0,0,2018-2019,0.8928571428571429,2.142857142857143
1821,Alexandre Olliero,FRA,GK,Nantes,Ligue 1,22,1996,1.0,0,0,0,0,0,0,0,0.0,0,0,0,0,0,0,0,0,0,2018-2019,0.0,0.0
1822,Robin Olsen,SWE,GK,Roma,Serie A,28,1990,27.0,0,0,0,0,0,0,1,0.0,1,1,0,1,0,0,10,4,0,2018-2019,0.0,0.0
1823,Stephane Omeonga,BEL,MF,Genoa,Serie A,22,1996,0.6,1,1,1,0,0,0,1,0.0,1,1,0,1,0,1,2,0,0,2018-2019,0.0,1.6666666666666667
1824,Kenneth Omeruo,NGA,DF,Leganés,La Liga,24,1993,27.0,49,27,41,8,0,20,29,69.0,9,23,11,12,37,86,159,3,0,2018-2019,1.3703703703703705,1.8148148148148149
1825,Prince Oniangué,CGO,MF,Caen,Ligue 1,29,1988,26.0,59,33,22,34,3,24,57,42.1,33,30,10,20,29,88,42,0,0,2018-2019,1.1153846153846154,2.269230769230769
Rk,Player,Nation,Pos,Squad,Comp,0,0,90.0,0,0,3,3,3,Tkl,0,0.0,0,0,0,0,0,0,0,0,0,2018-2019,0.0,0.0
1826,Karim Onisiwo,AUT,"FW,MF",Mainz 05,Bundesliga,26,1992,12.9,23,15,6,12,5,4,12,33.3,8,14,3,11,9,32,13,0,0,2018-2019,0.6976744186046512,1.7829457364341086
1827,Nicholas Opoku,GHA,DF,Udinese,Serie A,20,1997,10.1,16,9,15,1,0,10,17,58.8,7,8,5,3,18,34,29,0,0,2018-2019,1.7821782178217822,1.5841584158415842
1828,Willi Orban,HUN,DF,RB Leipzig,Bundesliga,25,1992,22.8,49,26,31,15,3,24,38,63.2,14,33,15,18,36,85,140,0,0,2018-2019,1.5789473684210527,2.1491228070175437
1829,Fabián Orellana,CHI,"MF,FW",Eibar,La Liga,32,1986,30.4,44,21,14,16,14,9,42,21.4,33,17,0,17,19,63,4,0,0,2018-2019,0.625,1.4473684210526316
1830,Divock Origi,BEL,FW,Liverpool,Premier League,23,1995,4.1,6,1,2,3,1,1,4,25.0,3,2,0,2,0,6,2,0,0,2018-2019,0.0,1.4634146341463417
1831,Riccardo Orsolini,ITA,"FW,MF",Bologna,Serie A,21,1997,21.8,40,24,16,18,6,9,39,23.1,30,23,2,21,14,54,25,1,0,2018-2019,0.6422018348623852,1.8348623853211008
1832,Yuya Osako,JPN,"FW,MF",Werder Bremen,Bundesliga,28,1990,15.0,23,11,6,12,5,7,22,31.8,15,15,3,12,7,30,8,0,0,2018-2019,0.4666666666666667,1.5333333333333334
1833,David Ospina,COL,GK,Napoli,Serie A,29,1988,16.2,1,0,1,0,0,1,1,100.0,0,0,0,0,0,1,7,1,0,2018-2019,0.0,0.0617283950617284
1834,Matthias Ostrzolek,GER,DF,Hannover 96,Bundesliga,28,1990,16.3,32,18,24,8,0,20,33,60.6,13,20,5,15,26,58,44,2,0,2018-2019,1.5950920245398772,1.9631901840490797
1835,Nicolás Otamendi,ARG,DF,Manchester City,Premier League,30,1988,13.7,24,14,17,6,1,5,9,55.6,4,6,4,2,29,53,56,1,0,2018-2019,2.1167883211678835,1.7518248175182483
1836,Otávio,BRA,MF,Bordeaux,Ligue 1,24,1994,31.9,127,74,59,64,4,49,109,45.0,60,45,11,34,43,170,54,1,0,2018-2019,1.3479623824451412,3.981191222570533
1837,David Otto,GER,"MF,FW",Hoffenheim,Bundesliga,19,1999,0.3,2,1,1,1,0,0,1,0.0,1,0,0,0,0,2,0,0,0,2018-2019,0.0,6.666666666666667
1838,Remi Oudin,FRA,"FW,MF",Reims,Ligue 1,21,1996,29.0,51,32,25,18,8,20,45,44.4,25,29,5,24,42,93,34,0,0,2018-2019,1.4482758620689655,1.7586206896551724
1839,Adam Ounas,ALG,"MF,FW",Napoli,Serie A,21,1996,6.0,5,2,0,3,2,2,11,18.2,9,6,0,6,2,7,0,1,0,2018-2019,0.3333333333333333,0.8333333333333334
1840,Reece Oxford,ENG,DF,Augsburg,Bundesliga,19,1998,5.6,12,9,9,3,0,4,6,66.7,2,10,9,1,11,23,39,0,0,2018-2019,1.9642857142857144,2.142857142857143
1841,Alex Oxlade-Chamberlain,ENG,MF,Liverpool,Premier League,24,1993,0.2,1,1,0,1,0,1,1,100.0,0,0,0,0,1,2,0,0,0,2018-2019,5.0,5.0
1842,Mikel Oyarzabal,ESP,"FW,MF",Real Sociedad,La Liga,21,1997,35.0,36,20,15,15,6,12,49,24.5,37,54,3,51,14,50,26,0,0,2018-2019,0.4,1.0285714285714285
1843,Ambroise Oyongo,CMR,DF,Montpellier,Ligue 1,27,1991,23.7,44,21,23,16,5,20,38,52.6,18,26,6,20,38,82,60,0,0,2018-2019,1.6033755274261603,1.8565400843881856
1844,Berkay Özcan,TUR,"MF,DF",Stuttgart,Bundesliga,20,1998,0.6,0,0,0,0,0,0,0,0.0,0,1,0,1,0,0,0,0,0,2018-2019,0.0,0.0
1845,Ramazan Özcan,AUT,GK,Leverkusen,Bundesliga,34,1984,2.0,0,0,0,0,0,0,0,0.0,0,0,0,0,1,1,2,0,0,2018-2019,0.5,0.0
1846,Mesut Özil,GER,"MF,FW",Arsenal,Premier League,29,1988,19.3,12,5,6,3,3,3,21,14.3,18,10,2,8,4,16,5,0,0,2018-2019,0.20725388601036268,0.6217616580310881
1847,Levin Öztunalı,GER,"MF,FW",Mainz 05,Bundesliga,22,1996,10.2,17,7,5,9,3,4,18,22.2,14,14,2,12,7,24,10,0,0,2018-2019,0.6862745098039216,1.6666666666666667
1848,Pablo,BRA,DF,Bordeaux,Ligue 1,27,1991,21.5,26,15,22,3,1,13,23,56.5,10,28,22,6,32,58,173,2,0,2018-2019,1.4883720930232558,1.2093023255813953
1849,Fernando Pacheco,ESP,GK,Alavés,La Liga,26,1992,35.0,0,0,0,0,0,0,1,0.0,1,0,0,0,1,1,23,0,0,2018-2019,0.02857142857142857,0.0
1850,Gonçalo Paciência,POR,FW,Eint Frankfurt,Bundesliga,23,1994,4.3,3,2,0,2,1,1,2,50.0,1,8,1,7,0,3,1,0,0,2018-2019,0.0,0.6976744186046512
Rk,Player,Nation,Pos,Squad,Comp,0,0,90.0,0,0,3,3,3,Tkl,0,0.0,0,0,0,0,0,0,0,0,0,2018-2019,0.0,0.0
1851,Simone Padoin,ITA,"DF,MF",Cagliari,Serie A,34,1984,21.3,34,25,12,18,4,14,33,42.4,19,18,5,13,14,48,54,0,0,2018-2019,0.6572769953051643,1.596244131455399
1852,Luca Paganini,ITA,"DF,MF",Frosinone,Serie A,25,1993,12.5,25,13,8,13,4,8,23,34.8,15,19,4,15,19,44,17,1,0,2018-2019,1.52,2.0
1853,Marko Pajač,CRO,"FW,DF",Empoli,Serie A,25,1993,8.2,7,7,2,3,2,5,11,45.5,6,3,0,3,7,14,18,0,0,2018-2019,0.853658536585366,0.853658536585366
1854,Marko Pajač,CRO,DF,Cagliari,Serie A,25,1993,1.1,1,1,0,0,1,0,0,0.0,0,1,1,0,1,2,3,0,0,2018-2019,0.9090909090909091,0.9090909090909091
1855,Vincent Pajot,FRA,MF,Angers,Ligue 1,27,1990,7.9,18,14,6,8,4,4,14,28.6,10,9,0,9,8,26,6,0,0,2018-2019,1.0126582278481011,2.2784810126582276
1856,Rodrigo Palacio,ARG,FW,Bologna,Serie A,36,1982,25.9,24,13,8,12,4,4,34,11.8,30,35,0,35,5,29,13,0,0,2018-2019,0.19305019305019305,0.9266409266409267
1857,Federico Palacios Martínez,GER,"MF,FW",Nürnberg,Bundesliga,23,1995,10.5,21,10,11,8,2,10,20,50.0,10,10,0,10,9,30,4,0,0,2018-2019,0.8571428571428571,2.0
1858,Sergi Palencia,ESP,DF,Bordeaux,Ligue 1,22,1996,22.1,74,50,46,20,8,27,55,49.1,28,22,3,19,17,91,70,1,0,2018-2019,0.7692307692307692,3.34841628959276
1859,Nicolas Pallois,FRA,DF,Nantes,Ligue 1,30,1987,24.0,77,48,60,17,0,40,69,58.0,29,30,14,16,34,111,114,0,0,2018-2019,1.4166666666666667,3.2083333333333335
1860,Emerson Palmieri,ITA,DF,Chelsea,Premier League,23,1994,7.4,14,9,6,5,3,6,10,60.0,4,11,1,10,8,22,14,0,0,2018-2019,1.081081081081081,1.8918918918918919
1861,Alberto Paloschi,ITA,FW,SPAL,Serie A,28,1990,9.6,13,9,3,5,5,1,2,50.0,1,2,0,2,1,14,0,0,0,2018-2019,0.10416666666666667,1.3541666666666667
1862,Goran Pandev,MKD,"FW,MF",Genoa,Serie A,35,1983,12.5,14,10,0,10,4,2,8,25.0,6,7,0,7,1,15,3,0,0,2018-2019,0.08,1.12
1863,Mickaël Panos,FRA,DF,Saint-Étienne,Ligue 1,21,1997,0.3,1,0,0,1,0,1,2,50.0,1,2,0,2,1,2,0,0,0,2018-2019,3.3333333333333335,3.3333333333333335
1864,Sokratis Papastathopoulos,GRE,DF,Arsenal,Premier League,30,1988,24.4,42,25,30,11,1,15,28,53.6,13,34,17,17,26,68,112,1,0,2018-2019,1.0655737704918034,1.7213114754098362
1865,Elhadji Pape Diaw,SEN,DF,Angers,Ligue 1,23,1994,0.2,0,0,0,0,0,0,0,0.0,0,0,0,0,1,1,0,0,0,2018-2019,5.0,0.0
1866,Lucas Paquetá,BRA,MF,Milan,Serie A,20,1997,9.4,18,9,9,8,1,7,24,29.2,17,12,0,12,4,22,11,2,0,2018-2019,0.425531914893617,1.9148936170212765
1867,Gaëtan Paquiez,FRA,DF,Nîmes,Ligue 1,24,1994,14.8,43,29,30,10,3,23,48,47.9,25,24,6,18,22,65,50,0,0,2018-2019,1.4864864864864864,2.9054054054054053
1868,Rubén Pardo,ESP,"MF,FW",Real Sociedad,La Liga,25,1992,15.2,11,7,2,9,0,4,17,23.5,13,14,6,8,21,32,9,0,0,2018-2019,1.381578947368421,0.7236842105263158
1869,Leandro Paredes,ARG,MF,Paris S-G,Ligue 1,24,1994,13.9,34,19,16,15,3,13,30,43.3,17,17,5,12,14,48,20,2,0,2018-2019,1.0071942446043165,2.446043165467626
1870,Daniel Parejo,ESP,MF,Valencia,La Liga,29,1989,34.0,73,42,41,24,8,31,90,34.4,59,41,7,34,46,119,26,2,0,2018-2019,1.3529411764705883,2.1470588235294117
1871,Vittorio Parigini,ITA,"MF,DF",Torino,Serie A,22,1996,4.2,11,10,3,6,2,6,9,66.7,3,3,0,3,1,12,5,0,0,2018-2019,0.23809523809523808,2.619047619047619
1872,Marco Parolo,ITA,MF,Lazio,Serie A,33,1985,28.5,68,45,24,37,7,18,56,32.1,38,48,11,37,28,96,56,0,0,2018-2019,0.9824561403508771,2.3859649122807016
1873,Thomas Partey,GHA,MF,Atlético Madrid,La Liga,25,1993,23.0,66,42,32,25,9,21,49,42.9,28,26,5,21,49,115,22,2,0,2018-2019,2.130434782608696,2.869565217391304
1874,Mario Pašalić,CRO,MF,Atalanta,Serie A,23,1995,18.0,32,19,9,13,10,7,29,24.1,22,19,4,15,12,44,14,1,0,2018-2019,0.6666666666666666,1.7777777777777777
1875,Manuel Pasqual,ITA,DF,Empoli,Serie A,36,1982,14.9,26,19,12,11,3,17,45,37.8,28,7,0,7,11,37,31,0,0,2018-2019,0.7382550335570469,1.74496644295302
Rk,Player,Nation,Pos,Squad,Comp,0,0,90.0,0,0,3,3,3,Tkl,0,0.0,0,0,0,0,0,0,0,0,0,2018-2019,0.0,0.0
1876,Javier Pastore,ARG,"MF,FW",Roma,Serie A,29,1989,6.6,10,4,4,3,3,4,16,25.0,12,7,0,7,3,13,5,0,0,2018-2019,0.4545454545454546,1.5151515151515151
1877,Callum Paterson,SCO,"FW,MF",Cardiff City,Premier League,23,1994,22.2,21,14,7,7,7,5,26,19.2,21,23,2,21,8,29,29,0,0,2018-2019,0.3603603603603604,0.9459459459459459
1878,Patric,ESP,DF,Lazio,Serie A,25,1993,12.1,19,11,8,8,3,8,15,53.3,7,14,7,7,12,31,29,1,0,2018-2019,0.9917355371900827,1.5702479338842976
1879,Rui Patrício,POR,GK,Wolves,Premier League,30,1988,37.0,2,0,2,0,0,2,3,66.7,1,0,0,0,1,3,7,4,0,2018-2019,0.02702702702702703,0.05405405405405406
1880,Paulinho,BRA,"FW,MF",Leverkusen,Bundesliga,18,2000,2.0,4,4,2,2,0,1,2,50.0,1,3,0,3,2,6,0,1,0,2018-2019,1.0,2.0
1881,Gabriel Paulista,BRA,DF,Valencia,La Liga,27,1990,29.1,29,16,20,6,3,14,28,50.0,14,37,21,16,70,99,162,1,0,2018-2019,2.4054982817869415,0.9965635738831614
1882,Benjamin Pavard,FRA,DF,Stuttgart,Bundesliga,22,1996,29.0,28,20,21,6,1,12,19,63.2,7,27,19,8,48,76,189,2,0,2018-2019,1.6551724137931034,0.9655172413793104
1883,Jiří Pavlenka,CZE,GK,Werder Bremen,Bundesliga,26,1992,33.1,3,0,3,0,0,3,6,50.0,3,1,0,1,3,6,14,1,0,2018-2019,0.09063444108761329,0.09063444108761329
1884,Mateo Pavlović,BIH,DF,Angers,Ligue 1,28,1990,27.7,26,18,24,2,0,12,24,50.0,12,37,29,8,20,46,164,2,0,2018-2019,0.7220216606498195,0.9386281588447654
1885,Leonardo Pavoletti,ITA,FW,Cagliari,Serie A,29,1988,30.4,32,21,6,17,9,6,16,37.5,10,12,3,9,7,39,26,0,0,2018-2019,0.23026315789473686,1.0526315789473684
1886,Dimitri Payet,FRA,"MF,FW",Marseille,Ligue 1,31,1987,21.2,11,9,2,8,1,5,22,22.7,17,14,0,14,8,19,8,0,0,2018-2019,0.37735849056603776,0.5188679245283019
1887,Nehuén Paz,ARG,DF,Bologna,Serie A,25,1993,1.3,2,1,2,0,0,1,2,50.0,1,3,1,2,0,2,2,0,0,2018-2019,0.0,1.5384615384615383
1888,Alfonso Pedraza,ESP,"DF,FW",Villarreal,La Liga,22,1996,23.3,59,44,34,19,6,22,62,35.5,40,33,7,26,29,88,55,0,0,2018-2019,1.2446351931330473,2.532188841201717
1889,Pedro,ESP,FW,Chelsea,Premier League,31,1987,19.8,27,14,11,10,6,9,35,25.7,26,13,2,11,18,45,8,1,0,2018-2019,0.9090909090909091,1.3636363636363635
1890,João Pedro,ITA,"FW,MF",Cagliari,Serie A,26,1992,28.4,17,12,4,8,5,4,11,36.4,7,14,5,9,6,23,14,0,0,2018-2019,0.21126760563380284,0.5985915492957746
1891,Adrià Pedrosa,ESP,DF,Espanyol,La Liga,20,1998,8.5,14,9,11,2,1,7,14,50.0,7,10,4,6,8,22,27,0,0,2018-2019,0.9411764705882353,1.6470588235294117
1892,Stef Peeters,BEL,MF,Caen,Ligue 1,26,1992,4.5,15,8,8,4,3,4,11,36.4,7,1,0,1,6,21,1,0,0,2018-2019,1.3333333333333333,3.3333333333333335
1893,Jordan Pefok,USA,FW,Rennes,Ligue 1,22,1996,6.8,6,2,0,3,3,2,4,50.0,2,7,2,5,4,10,5,0,0,2018-2019,0.5882352941176471,0.8823529411764706
1894,Gianluca Pegolo,ITA,GK,Sassuolo,Serie A,37,1981,2.3,0,0,0,0,0,0,0,0.0,0,0,0,0,0,0,0,0,0,2018-2019,0.0,0.0
1895,Peter Pekarík,SVK,DF,Hertha BSC,Bundesliga,31,1986,2.4,2,1,1,1,0,1,3,33.3,2,2,1,1,1,3,5,0,0,2018-2019,0.4166666666666667,0.8333333333333334
1896,Pelé,GNB,MF,Monaco,Ligue 1,26,1991,5.2,8,7,3,5,0,2,6,33.3,4,2,1,1,3,11,10,0,0,2018-2019,0.5769230769230769,1.5384615384615383
1897,Yohann Pelé,FRA,GK,Marseille,Ligue 1,35,1982,7.6,0,0,0,0,0,0,2,0.0,2,0,0,0,0,0,1,1,0,2018-2019,0.0,0.0
1898,Maxime Pélican,FRA,"FW,MF",Nice,Ligue 1,20,1998,1.0,1,1,0,1,0,0,0,0.0,0,1,0,1,0,1,0,0,0,2018-2019,0.0,1.0
1899,Pietro Pellegri,ITA,"FW,MF",Monaco,Ligue 1,17,2001,0.9,1,1,0,0,1,0,0,0.0,0,0,0,0,0,1,0,0,0,2018-2019,0.0,1.1111111111111112
1900,Lorenzo Pellegrini,ITA,MF,Roma,Serie A,22,1996,20.2,39,23,16,18,5,10,30,33.3,20,20,2,18,12,51,21,0,0,2018-2019,0.594059405940594,1.9306930693069309
Rk,Player,Nation,Pos,Squad,Comp,0,0,90.0,0,0,3,3,3,Tkl,0,0.0,0,0,0,0,0,0,0,0,0,2018-2019,0.0,0.0
1901,Luca Pellegrini,ITA,DF,Cagliari,Serie A,19,1999,10.4,28,19,16,11,1,14,25,56.0,11,13,3,10,18,46,22,0,0,2018-2019,1.7307692307692306,2.692307692307692
1902,Luca Pellegrini,ITA,DF,Roma,Serie A,19,1999,1.8,1,1,1,0,0,1,2,50.0,1,2,1,1,3,4,2,0,0,2018-2019,1.6666666666666665,0.5555555555555556
1903,Théo Pellenard,FRA,DF,Angers,Ligue 1,24,1994,5.5,11,6,7,2,2,5,8,62.5,3,6,2,4,5,16,16,0,0,2018-2019,0.9090909090909091,2.0
1904,Sergio Pellissier,ITA,FW,Chievo,Serie A,39,1979,10.6,4,3,1,1,2,3,4,75.0,1,8,1,7,2,6,8,0,0,2018-2019,0.18867924528301888,0.37735849056603776
1905,Andy Pelmard,FRA,DF,Nice,Ligue 1,18,2000,3.1,5,5,3,2,0,1,4,25.0,3,0,0,0,3,8,3,0,0,2018-2019,0.9677419354838709,1.6129032258064515
1906,Lee Peltier,ENG,DF,Cardiff City,Premier League,31,1986,17.2,39,25,27,11,1,15,27,55.6,12,18,12,6,18,57,60,0,0,2018-2019,1.0465116279069768,2.2674418604651163
1907,Federico Peluso,ITA,DF,Sassuolo,Serie A,34,1984,15.1,23,14,15,5,3,13,16,81.3,3,8,3,5,23,46,70,0,0,2018-2019,1.5231788079470199,1.5231788079470199
1908,Rubén Peña,ESP,DF,Eibar,La Liga,27,1991,29.7,63,46,24,27,12,24,53,45.3,29,37,9,28,35,98,57,0,0,2018-2019,1.1784511784511784,2.121212121212121
1909,Nicolas Pépé,CIV,"FW,MF",Lille,Ligue 1,23,1995,36.9,27,10,6,15,6,8,35,22.9,27,33,0,33,13,40,11,1,0,2018-2019,0.3523035230352304,0.7317073170731707
1910,Pepín,EQG,MF,Parma,Serie A,21,1996,0.9,4,2,3,1,0,1,4,25.0,3,0,0,0,3,7,0,0,0,2018-2019,3.333333333333333,4.444444444444445
1911,Andreas Pereira,BRA,MF,Manchester Utd,Premier League,22,1996,6.7,8,6,5,2,1,4,15,26.7,11,9,2,7,11,19,8,1,0,2018-2019,1.6417910447761193,1.1940298507462686
1912,Matheus Pereira,POR,"MF,FW",Nürnberg,Bundesliga,22,1996,13.7,16,11,4,8,4,2,13,15.4,11,15,2,13,14,30,7,0,0,2018-2019,1.0218978102189782,1.1678832116788322
1913,Pedro Pereira,POR,"DF,FW",Genoa,Serie A,20,1998,15.4,20,14,15,2,3,11,19,57.9,8,10,5,5,14,34,55,1,0,2018-2019,0.9090909090909091,1.2987012987012987
1914,Ricardo Pereira,POR,"DF,FW",Leicester City,Premier League,24,1993,34.7,118,66,66,40,12,54,112,48.2,58,60,6,54,60,178,130,1,0,2018-2019,1.7291066282420748,3.4005763688760804
1915,Roberto Pereyra,ARG,MF,Watford,Premier League,27,1991,31.3,21,12,10,10,1,7,24,29.2,17,26,0,26,24,45,27,2,0,2018-2019,0.7667731629392971,0.6709265175718849
1916,Ayoze Pérez,ESP,"MF,FW",Newcastle Utd,Premier League,25,1993,32.4,59,22,24,28,7,17,63,27.0,46,55,4,51,42,101,33,1,0,2018-2019,1.2962962962962963,1.8209876543209877
1917,Carles Pérez,ESP,FW,Barcelona,La Liga,20,1998,0.2,0,0,0,0,0,0,0,0.0,0,1,0,1,0,0,0,0,0,2018-2019,0.0,0.0
1918,Hernán Pérez,PAR,"FW,MF",Espanyol,La Liga,29,1989,8.8,13,10,8,3,2,6,27,22.2,21,14,3,11,5,18,13,0,0,2018-2019,0.5681818181818181,1.477272727272727
1919,Lucas Pérez,ESP,"FW,MF",West Ham,Premier League,29,1988,5.3,6,4,3,2,1,1,3,33.3,2,2,1,1,2,8,2,0,0,2018-2019,0.37735849056603776,1.1320754716981132
1920,Rubén Pérez,ESP,MF,Leganés,La Liga,29,1989,27.5,71,42,27,40,4,32,80,40.0,48,35,8,27,40,111,34,1,0,2018-2019,1.4545454545454546,2.581818181818182
1921,Stipe Perica,CRO,FW,Frosinone,Serie A,23,1995,5.3,5,3,2,2,1,1,3,33.3,2,3,1,2,0,5,4,0,0,2018-2019,0.0,0.9433962264150944
1922,Mattia Perin,ITA,GK,Juventus,Serie A,25,1992,9.0,0,0,0,0,0,0,0,0.0,0,0,0,0,0,0,3,2,0,2018-2019,0.0,0.0
1923,Ivan Perišić,CRO,FW,Inter,Serie A,29,1989,30.0,34,26,7,20,7,16,51,31.4,35,40,4,36,23,57,55,0,0,2018-2019,0.7666666666666667,1.1333333333333333
1924,Diego Perotti,ARG,"FW,MF",Roma,Serie A,30,1988,7.4,14,12,5,5,4,6,19,31.6,13,4,0,4,4,18,2,0,0,2018-2019,0.5405405405405405,1.8918918918918919
1925,Loïc Perrin,FRA,DF,Saint-Étienne,Ligue 1,32,1985,30.0,53,36,34,17,2,20,33,60.6,13,37,24,13,44,97,118,2,0,2018-2019,1.4666666666666666,1.7666666666666666
Rk,Player,Nation,Pos,Squad,Comp,0,0,90.0,0,0,3,3,3,Tkl,0,0.0,0,0,0,0,0,0,0,0,0,2018-2019,0.0,0.0
1926,Pavao Pervan,AUT,GK,Wolfsburg,Bundesliga,30,1987,8.5,0,0,0,0,0,0,0,0.0,0,0,0,0,0,0,3,1,0,2018-2019,0.0,0.0
1927,Matteo Pessina,ITA,"MF,FW",Atalanta,Serie A,21,1997,2.6,4,2,0,4,0,2,3,66.7,1,2,1,1,0,4,4,0,0,2018-2019,0.0,1.5384615384615383
1928,Andrea Petagna,ITA,FW,SPAL,Serie A,23,1995,33.7,15,6,5,5,5,2,9,22.2,7,23,8,15,4,19,15,0,0,2018-2019,0.11869436201780414,0.4451038575667655
1929,Nils Petersen,GER,FW,Freiburg,Bundesliga,29,1988,21.4,29,21,10,16,3,4,24,16.7,20,28,2,26,13,42,34,0,0,2018-2019,0.6074766355140188,1.355140186915888
1930,Ondřej Petrák,CZE,MF,Nürnberg,Bundesliga,26,1992,18.0,36,24,17,18,1,14,25,56.0,11,18,4,14,40,76,22,0,0,2018-2019,2.2222222222222223,2.0
1931,Germán Pezzella,ARG,DF,Fiorentina,Serie A,27,1991,31.7,56,36,42,13,1,31,51,60.8,20,42,30,12,60,116,159,1,0,2018-2019,1.8927444794952681,1.7665615141955837
1932,Giuseppe Pezzella,ITA,DF,Udinese,Serie A,20,1997,2.0,5,4,4,1,0,2,8,25.0,6,2,1,1,1,6,9,0,0,2018-2019,0.5,2.5
1933,Giuseppe Pezzella,ITA,"DF,MF",Genoa,Serie A,20,1997,1.2,2,1,1,1,0,0,0,0.0,0,1,0,1,1,3,4,0,0,2018-2019,0.8333333333333334,1.6666666666666667
1934,Matthias Phaeton,GLP,"FW,MF",Guingamp,Ligue 1,18,2000,0.6,1,1,0,1,0,0,0,0.0,0,0,0,0,0,1,0,0,0,2018-2019,0.0,1.6666666666666667
1935,Maximilian Philipp,GER,"FW,MF",Dortmund,Bundesliga,24,1994,8.4,7,5,3,4,0,2,9,22.2,7,10,0,10,3,10,6,0,0,2018-2019,0.35714285714285715,0.8333333333333333
1936,Lebogang Phiri,RSA,MF,Guingamp,Ligue 1,23,1994,21.4,60,38,16,41,3,24,43,55.8,19,26,3,23,29,89,19,0,0,2018-2019,1.355140186915888,2.8037383177570097
1937,Krzysztof Piątek,POL,FW,Genoa,Serie A,23,1995,17.7,9,4,2,5,2,1,15,6.7,14,18,3,15,3,12,19,0,0,2018-2019,0.16949152542372883,0.5084745762711864
1938,Krzysztof Piątek,POL,FW,Milan,Serie A,23,1995,15.3,8,6,2,1,5,3,10,30.0,7,7,2,5,1,9,15,0,0,2018-2019,0.06535947712418301,0.5228758169934641
1939,Pablo Piatti,ARG,"FW,MF",Espanyol,La Liga,29,1989,8.3,21,15,8,10,3,8,16,50.0,8,15,0,15,2,23,8,0,0,2018-2019,0.24096385542168672,2.5301204819277108
1940,Lucas Piazon,BRA,"MF,FW",Chievo,Serie A,24,1994,0.9,2,0,1,1,0,0,2,0.0,2,1,0,1,1,3,0,0,0,2018-2019,1.1111111111111112,2.2222222222222223
1941,Cristiano Piccini,ITA,DF,Valencia,La Liga,25,1992,20.8,32,23,25,7,0,13,26,50.0,13,27,7,20,27,59,64,1,0,2018-2019,1.2980769230769231,1.5384615384615383
1942,Roberto Piccoli,ITA,"FW,MF",Atalanta,Serie A,17,2001,0.5,2,2,0,1,1,1,1,100.0,0,1,0,1,0,2,0,0,0,2018-2019,0.0,4.0
1943,Jordan Pickford,ENG,GK,Everton,Premier League,24,1994,38.0,0,0,0,0,0,0,0,0.0,0,0,0,0,0,0,20,8,0,2018-2019,0.0,0.0
1944,Jérémy Pied,FRA,DF,Lille,Ligue 1,29,1989,5.2,12,8,5,6,1,3,9,33.3,6,8,1,7,5,17,13,0,0,2018-2019,0.9615384615384615,2.3076923076923075
1945,Ronaël Pierre-Gabriel,FRA,DF,Monaco,Ligue 1,20,1998,3.9,13,8,10,2,1,9,10,90.0,1,3,1,2,3,16,18,0,0,2018-2019,0.7692307692307693,3.3333333333333335
1946,Erik Pieters,NED,DF,Amiens,Ligue 1,29,1988,14.0,49,28,28,18,3,25,33,75.8,8,21,13,8,17,66,56,0,0,2018-2019,1.2142857142857142,3.5
1947,Tomás Pina Isla,ESP,MF,Alavés,La Liga,30,1987,26.0,64,41,23,36,5,18,46,39.1,28,15,4,11,41,105,43,1,0,2018-2019,1.5769230769230769,2.4615384615384617
1948,Andrea Pinamonti,ITA,FW,Frosinone,Serie A,19,1999,18.1,14,6,6,5,3,4,20,20.0,16,16,3,13,5,19,17,0,0,2018-2019,0.2762430939226519,0.7734806629834253
1949,Carlo Pinsoglio,ITA,GK,Juventus,Serie A,28,1990,1.0,0,0,0,0,0,0,0,0.0,0,0,0,0,0,0,0,0,0,2018-2019,0.0,0.0
1950,Virgile Pinson,FRA,MF,Reims,Ligue 1,22,1996,0.1,0,0,0,0,0,0,0,0.0,0,0,0,0,0,0,0,0,0,2018-2019,0.0,0.0
Rk,Player,Nation,Pos,Squad,Comp,0,0,90.0,0,0,3,3,3,Tkl,0,0.0,0,0,0,0,0,0,0,0,0,2018-2019,0.0,0.0
1951,Lenny Pintor,FRA,FW,Lyon,Ligue 1,17,2000,0.0,0,0,0,0,0,0,0,0.0,0,0,0,0,0,0,0,0,0,2018-2019,,
1952,Gerard Piqué,ESP,DF,Barcelona,La Liga,31,1987,35.0,42,27,25,17,0,24,37,64.9,13,41,27,14,36,78,154,5,0,2018-2019,1.0285714285714285,1.2
1953,Facundo Píriz,URU,"MF,FW",Montpellier,Ligue 1,28,1990,1.3,9,6,3,4,2,4,9,44.4,5,2,1,1,0,9,2,0,0,2018-2019,0.0,6.9230769230769225
1954,Fabio Pisacane,ITA,DF,Cagliari,Serie A,32,1986,25.2,33,17,22,8,3,18,31,58.1,13,36,23,13,23,56,108,0,0,2018-2019,0.9126984126984127,1.3095238095238095
1955,Łukasz Piszczek,POL,DF,Dortmund,Bundesliga,33,1985,19.5,57,36,34,15,8,18,33,54.5,15,26,3,23,39,96,69,0,0,2018-2019,2.0,2.923076923076923
1956,Claudio Pizarro,PER,FW,Werder Bremen,Bundesliga,39,1978,7.7,10,6,4,2,4,4,7,57.1,3,14,1,13,1,11,7,0,0,2018-2019,0.12987012987012986,1.2987012987012987
1957,Marko Pjaca,CRO,"FW,MF",Fiorentina,Serie A,23,1995,8.3,9,4,3,4,2,2,6,33.3,4,2,0,2,7,16,6,0,0,2018-2019,0.8433734939759036,1.0843373493975903
1958,Miralem Pjanić,BIH,MF,Juventus,Serie A,28,1990,25.3,41,20,15,18,8,16,59,27.1,43,34,6,28,36,77,19,2,0,2018-2019,1.4229249011857708,1.6205533596837944
1959,Carles Planas,ESP,DF,Girona,La Liga,27,1991,4.7,12,6,7,5,0,4,11,36.4,7,2,0,2,4,16,15,0,0,2018-2019,0.851063829787234,2.553191489361702
1960,Óscar Plano,ESP,"MF,FW",Valladolid,La Liga,27,1991,29.9,63,45,23,28,12,14,48,29.2,34,19,3,16,22,85,28,1,0,2018-2019,0.7357859531772576,2.1070234113712374
1961,Jaroslav Plašil,CZE,MF,Bordeaux,Ligue 1,36,1982,16.0,34,26,11,20,3,18,44,40.9,26,21,5,16,19,53,28,1,0,2018-2019,1.1875,2.125
1962,Marvin Plattenhardt,GER,DF,Hertha BSC,Bundesliga,26,1992,21.4,27,21,12,10,5,14,21,66.7,7,18,3,15,7,34,56,0,0,2018-2019,0.3271028037383178,1.2616822429906542
1963,Stiven Plaza,ECU,"FW,MF",Valladolid,La Liga,19,1999,0.4,0,0,0,0,0,0,0,0.0,0,0,0,0,0,0,0,0,0,2018-2019,0.0,0.0
1964,Alassane Pléa,FRA,FW,Gladbach,Bundesliga,25,1993,27.8,14,10,7,4,3,5,22,22.7,17,17,2,15,3,17,15,2,0,2018-2019,0.1079136690647482,0.5035971223021583
1965,Luca Plogmann,GER,GK,Werder Bremen,Bundesliga,18,2000,0.4,0,0,0,0,0,0,0,0.0,0,0,0,0,0,0,0,0,0,2018-2019,0.0,0.0
1966,Morgan Poaty,CGO,MF,Montpellier,Ligue 1,21,1997,1.0,1,1,1,0,0,0,0,0.0,0,1,0,1,0,1,2,0,0,2018-2019,0.0,1.0
1967,Paul Pogba,FRA,MF,Manchester Utd,Premier League,25,1993,33.4,47,30,21,21,5,17,43,39.5,26,30,9,21,18,65,39,0,0,2018-2019,0.5389221556886228,1.407185628742515
1968,Denis-Will Poha,FRA,MF,Rennes,Ligue 1,21,1997,0.3,0,0,0,0,0,0,1,0.0,1,0,0,0,1,1,1,0,0,2018-2019,3.3333333333333335,0.0
1969,Andrea Poli,ITA,MF,Bologna,Serie A,28,1989,21.5,65,47,30,28,7,24,67,35.8,43,36,5,31,35,100,13,2,0,2018-2019,1.627906976744186,3.0232558139534884
1970,Matteo Politano,ITA,FW,Inter,Serie A,24,1993,28.3,18,7,9,4,5,8,30,26.7,22,18,0,18,14,32,10,1,0,2018-2019,0.4946996466431095,0.6360424028268551
1971,Pierre-Yves Polomat,FRA,DF,Saint-Étienne,Ligue 1,24,1993,10.6,18,13,11,6,1,10,18,55.6,8,4,2,2,21,39,27,0,0,2018-2019,1.9811320754716981,1.6981132075471699
1972,Giacomo Poluzzi,ITA,GK,SPAL,Serie A,30,1988,0.1,0,0,0,0,0,0,0,0.0,0,0,0,0,0,0,0,0,0,2018-2019,0.0,0.0
1973,Pere Pons,ESP,MF,Girona,La Liga,25,1993,31.0,83,46,34,38,11,30,82,36.6,52,48,12,36,35,118,39,0,0,2018-2019,1.1290322580645162,2.6774193548387095
1974,Pedro Porro,ESP,DF,Girona,La Liga,18,1999,24.6,51,31,28,16,7,32,80,40.0,48,36,2,34,39,90,60,1,0,2018-2019,1.5853658536585364,2.073170731707317
1975,Manolo Portanova,ITA,MF,Juventus,Serie A,18,2000,0.4,1,1,0,1,0,0,1,0.0,1,2,0,2,1,2,2,0,0,2018-2019,2.5,2.5
Rk,Player,Nation,Pos,Squad,Comp,0,0,90.0,0,0,3,3,3,Tkl,0,0.0,0,0,0,0,0,0,0,0,0,2018-2019,0.0,0.0
1976,Francisco Portillo,ESP,MF,Getafe,La Liga,28,1990,22.2,26,16,6,15,5,9,29,31.0,20,14,0,14,17,43,9,0,0,2018-2019,0.7657657657657658,1.1711711711711712
1977,Portu,ESP,"FW,MF",Girona,La Liga,26,1992,31.3,33,24,8,15,10,12,43,27.9,31,16,1,15,8,41,5,0,0,2018-2019,0.25559105431309903,1.0543130990415335
1978,Stefan Posch,AUT,DF,Hoffenheim,Bundesliga,21,1997,15.6,45,32,28,15,2,17,28,60.7,11,26,11,15,21,66,58,0,0,2018-2019,1.3461538461538463,2.8846153846153846
1979,Sergio Postigo,ESP,DF,Levante,La Liga,29,1988,16.1,25,15,22,3,0,15,19,78.9,4,21,12,9,20,45,77,0,0,2018-2019,1.2422360248447204,1.5527950310559004
1980,Yussuf Poulsen,DEN,FW,RB Leipzig,Bundesliga,24,1994,27.2,20,10,5,10,5,3,25,12.0,22,33,2,31,7,27,28,0,0,2018-2019,0.2573529411764706,0.7352941176470589
1981,Maxime Poundjé,FRA,DF,Bordeaux,Ligue 1,25,1992,28.2,48,35,34,12,2,31,62,50.0,31,24,5,19,29,77,79,0,0,2018-2019,1.0283687943262412,1.702127659574468
1982,Gaëtan Poussin,FRA,GK,Bordeaux,Ligue 1,19,1999,1.0,0,0,0,0,0,0,0,0.0,0,0,0,0,0,0,0,0,0,2018-2019,0.0,0.0
1983,José Pozo,ESP,MF,Rayo Vallecano,La Liga,22,1996,18.0,13,10,4,5,4,4,25,16.0,21,7,1,6,4,17,6,0,0,2018-2019,0.2222222222222222,0.7222222222222222
1984,Dennis Praet,BEL,MF,Sampdoria,Serie A,24,1994,32.1,62,44,30,25,7,27,51,52.9,24,33,4,29,36,98,31,0,0,2018-2019,1.1214953271028036,1.9314641744548287
1985,Sanjin Prcić,BIH,MF,Levante,La Liga,24,1993,5.9,18,13,7,9,2,5,11,45.5,6,11,7,4,11,29,11,1,0,2018-2019,1.8644067796610169,3.0508474576271185
1986,Sanjin Prcić,BIH,MF,Strasbourg,Ligue 1,24,1993,11.7,19,14,11,7,1,8,18,44.4,10,22,8,14,18,37,7,1,0,2018-2019,1.5384615384615385,1.623931623931624
1987,Nicolas de Préville,FRA,"FW,MF",Bordeaux,Ligue 1,27,1991,14.1,28,19,10,15,3,8,29,27.6,21,23,1,22,10,38,21,1,0,2018-2019,0.7092198581560284,1.9858156028368794
1988,Edgar Prib,GER,MF,Hannover 96,Bundesliga,28,1989,2.2,10,9,3,5,2,2,4,50.0,2,4,0,4,2,12,1,0,0,2018-2019,0.9090909090909091,4.545454545454545
1989,Alex Pritchard,ENG,"MF,FW",Huddersfield,Premier League,25,1993,23.1,36,24,10,18,8,10,35,28.6,25,26,2,24,17,53,9,0,0,2018-2019,0.7359307359307359,1.5584415584415583
1990,Sebastian Prödl,AUT,DF,Watford,Premier League,31,1987,0.1,0,0,0,0,0,0,0,0.0,0,0,0,0,0,0,0,0,0,2018-2019,0.0,0.0
1991,Quincy Promes,NED,"FW,DF",Sevilla,La Liga,26,1992,17.6,35,25,23,9,3,15,22,68.2,7,19,3,16,25,60,22,1,0,2018-2019,1.4204545454545454,1.9886363636363635
1992,Davy Pröpper,NED,MF,Brighton,Premier League,26,1991,28.3,50,28,23,21,6,16,52,30.8,36,21,6,15,53,103,37,0,0,2018-2019,1.872791519434629,1.7667844522968197
1993,Silvio Proto,BEL,GK,Lazio,Serie A,35,1983,2.0,0,0,0,0,0,0,1,0.0,1,0,0,0,0,0,1,0,0,2018-2019,0.0,0.0
1994,Ivan Provedel,ITA,GK,Empoli,Serie A,24,1994,16.0,0,0,0,0,0,0,1,0.0,1,0,0,0,0,0,4,0,0,2018-2019,0.0,0.0
1995,Javi Puado,ESP,"FW,MF",Espanyol,La Liga,20,1998,4.0,2,1,0,2,0,0,7,0.0,7,5,1,4,6,8,4,0,0,2018-2019,1.5,0.5
1996,Manuel Pucciarelli,ITA,FW,Chievo,Serie A,27,1991,3.4,4,2,2,1,1,2,5,40.0,3,5,0,5,3,7,4,0,0,2018-2019,0.8823529411764706,1.1764705882352942
1997,Riqui Puig,ESP,MF,Barcelona,La Liga,18,1999,1.7,3,3,0,2,1,2,3,66.7,1,0,0,0,0,3,1,0,0,2018-2019,0.0,1.7647058823529411
1998,Erick Pulgar,CHI,MF,Bologna,Serie A,24,1994,26.2,65,36,35,23,7,22,73,30.1,51,35,5,30,50,115,54,1,0,2018-2019,1.9083969465648856,2.480916030534351
1999,Jorge Pulido,ESP,DF,Huesca,La Liga,27,1991,30.9,63,42,40,19,4,32,51,62.7,19,39,18,21,50,113,158,0,0,2018-2019,1.6181229773462784,2.0388349514563107
2000,Christian Pulisic,USA,FW,Dortmund,Bundesliga,19,1998,10.4,10,6,2,6,2,2,6,33.3,4,12,2,10,6,16,10,0,0,2018-2019,0.5769230769230769,0.9615384615384615
Rk,Player,Nation,Pos,Squad,Comp,0,0,90.0,0,0,3,3,3,Tkl,0,0.0,0,0,0,0,0,0,0,0,0,2018-2019,0.0,0.0
2001,Jason Puncheon,ENG,MF,Crystal Palace,Premier League,32,1986,0.1,1,1,1,0,0,0,0,0.0,0,0,0,0,0,1,0,0,0,2018-2019,0.0,10.0
2002,Jason Puncheon,ENG,MF,Huddersfield,Premier League,32,1986,4.2,7,4,1,5,1,1,7,14.3,6,3,1,2,3,10,8,0,0,2018-2019,0.7142857142857143,1.6666666666666665
2003,Ignacio Pussetto,ARG,"FW,MF",Udinese,Serie A,22,1995,24.2,65,40,25,30,10,15,43,34.9,28,28,3,25,29,94,34,0,0,2018-2019,1.1983471074380165,2.6859504132231407
2004,Fabio Quagliarella,ITA,FW,Sampdoria,Serie A,35,1983,35.5,14,8,6,4,4,2,15,13.3,13,32,1,31,8,22,17,0,0,2018-2019,0.22535211267605634,0.39436619718309857
2005,Robin Quaison,SWE,"FW,MF",Mainz 05,Bundesliga,24,1993,24.4,19,12,3,10,6,5,12,41.7,7,9,1,8,7,26,4,0,0,2018-2019,0.2868852459016394,0.778688524590164
2006,Collin Quaner,GER,FW,Huddersfield,Premier League,27,1991,0.4,0,0,0,0,0,0,1,0.0,1,0,0,0,0,0,0,0,0,2018-2019,0.0,0.0
2007,Domingos Quina,POR,MF,Watford,Premier League,18,1999,3.8,9,7,3,5,1,3,11,27.3,8,6,0,6,3,12,1,0,0,2018-2019,0.7894736842105263,2.368421052631579
2008,Xavi Quintillà,ESP,DF,Villarreal,La Liga,21,1996,7.0,10,4,5,4,1,6,12,50.0,6,5,2,3,8,18,17,0,0,2018-2019,1.1428571428571428,1.4285714285714286
2009,Dani Raba,ESP,"MF,FW",Villarreal,La Liga,22,1995,2.1,6,5,1,2,3,1,5,20.0,4,1,0,1,1,7,0,0,0,2018-2019,0.47619047619047616,2.857142857142857
2010,Adrien Rabiot,FRA,MF,Paris S-G,Ligue 1,23,1995,11.8,35,20,13,17,5,9,12,75.0,3,9,2,7,10,45,20,0,0,2018-2019,0.847457627118644,2.966101694915254
2011,Nemanja Radonjić,SRB,"FW,MF",Marseille,Ligue 1,22,1996,7.6,8,5,1,5,2,5,16,31.3,11,3,0,3,5,13,4,0,0,2018-2019,0.6578947368421053,1.0526315789473684
2012,Ivan Radovanović,SRB,MF,Genoa,Serie A,29,1988,14.2,20,12,11,8,1,8,17,47.1,9,12,4,8,13,33,20,1,0,2018-2019,0.9154929577464789,1.4084507042253522
2013,Ivan Radovanović,SRB,MF,Chievo,Serie A,29,1988,19.0,27,22,20,7,0,11,31,35.5,20,19,7,12,26,53,36,0,0,2018-2019,1.368421052631579,1.4210526315789473
2014,Ionuț Radu,ROU,GK,Genoa,Serie A,21,1997,33.0,0,0,0,0,0,0,1,0.0,1,0,0,0,1,1,11,4,0,2018-2019,0.030303030303030304,0.0
2015,Ștefan Radu,ROU,DF,Lazio,Serie A,31,1986,24.9,43,27,24,15,4,25,38,65.8,13,20,14,6,42,85,85,1,0,2018-2019,1.6867469879518073,1.7269076305220885
2016,Rafael,BRA,DF,Lyon,Ligue 1,28,1990,11.4,31,19,14,12,5,17,24,70.8,7,19,2,17,15,46,30,2,0,2018-2019,1.3157894736842104,2.719298245614035
2017,Raffael,BRA,FW,Gladbach,Bundesliga,33,1985,6.0,8,4,2,4,2,2,7,28.6,5,5,0,5,1,9,0,0,0,2018-2019,0.16666666666666666,1.3333333333333333
2018,Rafinha,BRA,"FW,MF",Barcelona,La Liga,25,1993,2.5,8,6,2,3,3,2,2,100.0,0,5,1,4,1,9,2,0,0,2018-2019,0.4,3.2
2019,Rafinha,BRA,DF,Bayern Munich,Bundesliga,32,1985,10.0,15,7,6,6,3,6,14,42.9,8,8,3,5,19,34,11,0,0,2018-2019,1.9,1.5
2020,Andrea Raggi,ITA,DF,Monaco,Ligue 1,34,1984,5.5,7,5,7,0,0,6,6,100.0,0,1,0,1,7,14,21,0,0,2018-2019,1.2727272727272727,1.2727272727272727
2021,Baba Rahman,GHA,DF,Reims,Ligue 1,24,1994,10.7,26,20,17,8,1,18,21,85.7,3,21,3,18,16,42,37,2,0,2018-2019,1.4953271028037385,2.429906542056075
2022,Baba Rahman,GHA,DF,Schalke 04,Bundesliga,24,1994,1.8,3,1,1,1,1,1,1,100.0,0,3,0,3,2,5,2,0,0,2018-2019,1.1111111111111112,1.6666666666666665
2023,Ivan Rakitić,CRO,MF,Barcelona,La Liga,30,1988,29.4,30,24,10,14,6,12,37,32.4,25,32,8,24,51,81,33,0,0,2018-2019,1.7346938775510206,1.0204081632653061
2024,Joe Ralls,ENG,MF,Cardiff City,Premier League,24,1993,21.8,45,23,21,21,3,10,33,30.3,23,21,6,15,29,74,30,0,0,2018-2019,1.3302752293577982,2.0642201834862384
2025,Jonás Ramalho,ESP,DF,Girona,La Liga,25,1993,18.0,13,6,12,1,0,8,14,57.1,6,24,11,13,16,29,80,1,0,2018-2019,0.8888888888888888,0.7222222222222222
Rk,Player,Nation,Pos,Squad,Comp,0,0,90.0,0,0,3,3,3,Tkl,0,0.0,0,0,0,0,0,0,0,0,0,2018-2019,0.0,0.0
2026,Benito Raman,BEL,"MF,FW",Düsseldorf,Bundesliga,23,1994,18.7,35,20,14,16,5,11,53,20.8,42,30,2,28,15,50,8,0,0,2018-2019,0.8021390374331551,1.8716577540106953
2027,Adil Rami,FRA,DF,Marseille,Ligue 1,32,1985,15.7,14,9,12,2,0,8,12,66.7,4,14,14,0,18,32,52,3,0,2018-2019,1.1464968152866242,0.89171974522293
2028,Gastón Ramírez,URU,MF,Sampdoria,Serie A,27,1990,17.5,38,22,12,18,8,11,31,35.5,20,28,4,24,8,46,27,0,0,2018-2019,0.45714285714285713,2.1714285714285713
2029,Sandro Ramírez,ESP,"FW,MF",Real Sociedad,La Liga,23,1995,11.7,19,10,7,10,2,4,11,36.4,7,12,1,11,9,28,3,0,0,2018-2019,0.7692307692307693,1.623931623931624
2030,Iván Ramis,ESP,DF,Eibar,La Liga,33,1984,18.6,23,13,10,11,2,17,23,73.9,6,10,5,5,18,41,65,2,0,2018-2019,0.9677419354838709,1.2365591397849462
2031,Chris Ramos,ESP,FW,Valladolid,La Liga,21,1997,0.7,1,1,0,0,1,1,1,100.0,0,0,0,0,0,1,1,0,0,2018-2019,0.0,1.4285714285714286
2032,Sergio Ramos,ESP,DF,Real Madrid,La Liga,32,1986,27.5,41,32,25,12,4,22,39,56.4,17,29,15,14,37,78,90,2,0,2018-2019,1.3454545454545455,1.490909090909091
2033,Aaron Ramsey,WAL,MF,Arsenal,Premier League,27,1990,14.8,34,18,11,15,8,7,25,28.0,18,7,1,6,9,43,3,0,0,2018-2019,0.6081081081081081,2.2972972972972974
2034,Kayne Ramsey,ENG,DF,Southampton,Premier League,17,2000,1.0,0,0,0,0,0,0,0,0.0,0,0,0,0,0,0,7,0,0,2018-2019,0.0,0.0
2035,Andrea Ranocchia,ITA,"DF,FW",Inter,Serie A,30,1988,0.7,2,2,1,1,0,0,1,0.0,1,1,0,1,0,2,3,0,0,2018-2019,0.0,2.857142857142857
2036,Marcus Rashford,ENG,FW,Manchester Utd,Premier League,20,1997,25.9,24,12,4,12,8,7,29,24.1,22,27,0,27,3,27,24,0,0,2018-2019,0.11583011583011583,0.9266409266409267
2037,Milot Rashica,KVX,"FW,MF",Werder Bremen,Bundesliga,22,1996,17.2,24,16,8,11,5,9,24,37.5,15,16,2,14,6,30,6,1,0,2018-2019,0.3488372093023256,1.3953488372093024
2038,Jacob Rasmussen,DEN,"DF,MF",Empoli,Serie A,21,1997,11.3,18,12,10,6,2,5,14,35.7,9,18,13,5,12,30,55,1,0,2018-2019,1.0619469026548671,1.5929203539823007
2039,Giacomo Raspadori,ITA,DF,Sassuolo,Serie A,18,2000,0.0,0,0,0,0,0,0,0,0.0,0,0,0,0,0,0,0,0,0,2018-2019,,
2040,Yoric Ravet,FRA,"FW,MF",Freiburg,Bundesliga,28,1989,0.8,2,1,1,0,1,1,2,50.0,1,2,1,1,0,2,1,0,0,2018-2019,0.0,2.5
2041,Tim Ream,USA,DF,Fulham,Premier League,30,1987,22.7,23,14,16,7,0,14,28,50.0,14,19,10,9,25,48,80,2,0,2018-2019,1.1013215859030838,1.013215859030837
2042,Ante Rebić,CRO,"FW,MF",Eint Frankfurt,Bundesliga,24,1993,22.0,22,9,5,12,5,5,12,41.7,7,18,1,17,8,30,3,0,0,2018-2019,0.36363636363636365,1.0
2043,Pedro Rebocho,POR,DF,Guingamp,Ligue 1,23,1995,36.0,61,35,31,22,8,29,54,53.7,25,48,13,35,40,101,92,1,0,2018-2019,1.1111111111111112,1.6944444444444444
2044,Arkadiusz Reca,POL,DF,Atalanta,Serie A,23,1995,0.5,2,0,1,0,1,0,1,0.0,1,0,0,0,3,5,0,0,0,2018-2019,6.0,4.0
2045,Recio,ESP,MF,Leganés,La Liga,27,1991,14.3,30,21,14,13,3,6,24,25.0,18,14,2,12,14,44,14,0,0,2018-2019,0.979020979020979,2.097902097902098
2046,Nathan Redmond,ENG,"MF,FW",Southampton,Premier League,24,1994,36.3,45,22,14,19,12,14,41,34.1,27,54,2,52,20,65,23,1,0,2018-2019,0.5509641873278237,1.2396694214876034
2047,Vasco Regini,ITA,"DF,FW",SPAL,Serie A,27,1990,0.9,1,0,0,1,0,1,3,33.3,2,2,1,1,0,1,4,0,0,2018-2019,0.0,1.1111111111111112
2048,Sergio Reguilón,ESP,DF,Real Madrid,La Liga,21,1996,12.4,25,14,15,9,1,10,21,47.6,11,13,3,10,20,45,41,1,0,2018-2019,1.6129032258064515,2.0161290322580645
2049,Bobby Reid,JAM,"FW,MF",Cardiff City,Premier League,25,1993,15.8,16,9,6,7,3,3,8,37.5,5,13,0,13,3,19,12,0,0,2018-2019,0.18987341772151897,1.0126582278481011
2050,Pepe Reina,ESP,GK,Milan,Serie A,35,1982,3.7,0,0,0,0,0,0,0,0.0,0,0,0,0,0,0,1,0,0,2018-2019,0.0,0.0
Rk,Player,Nation,Pos,Squad,Comp,0,0,90.0,0,0,3,3,3,Tkl,0,0.0,0,0,0,0,0,0,0,0,0,2018-2019,0.0,0.0
2051,Jeff Reine-Adélaïde,FRA,"FW,MF",Angers,Ligue 1,20,1998,28.4,40,22,18,19,3,16,39,41.0,23,20,0,20,19,59,10,0,0,2018-2019,0.6690140845070423,1.4084507042253522
2052,Karim Rekik,NED,DF,Hertha BSC,Bundesliga,23,1994,23.0,36,22,23,12,1,12,18,66.7,6,24,16,8,34,70,88,0,0,2018-2019,1.4782608695652173,1.565217391304348
2053,Loïc Rémy,FRA,FW,Lille,Ligue 1,31,1987,13.4,2,1,0,2,0,0,3,0.0,3,3,1,2,2,4,17,1,0,2018-2019,0.14925373134328357,0.14925373134328357
2054,Michael Rensing,GER,GK,Düsseldorf,Bundesliga,34,1984,32.0,2,1,2,0,0,1,5,20.0,4,1,0,1,2,4,13,2,0,2018-2019,0.0625,0.0625
2055,Marco Reus,GER,"MF,FW",Dortmund,Bundesliga,29,1989,25.7,33,22,11,16,6,6,31,19.4,25,28,1,27,8,41,32,0,0,2018-2019,0.311284046692607,1.284046692607004
2056,Elvis Rexhbeçaj,GER,MF,Wolfsburg,Bundesliga,20,1997,12.7,28,18,11,12,5,12,24,50.0,12,18,2,16,14,42,21,0,0,2018-2019,1.1023622047244095,2.204724409448819
2057,Diego Reyes,MEX,DF,Leganés,La Liga,25,1992,3.6,7,4,4,3,0,3,4,75.0,1,4,4,0,7,14,17,1,0,2018-2019,1.9444444444444444,1.9444444444444444
2058,Baptiste Reynet,FRA,GK,Toulouse,Ligue 1,27,1990,30.0,0,0,0,0,0,0,3,0.0,3,0,0,0,1,1,14,2,0,2018-2019,0.03333333333333333,0.0
2059,Simon Rhein,GER,MF,Nürnberg,Bundesliga,20,1998,5.5,7,4,7,0,0,2,7,28.6,5,6,1,5,7,14,6,0,0,2018-2019,1.2727272727272727,1.2727272727272727
2060,Franck Ribéry,FRA,"MF,FW",Bayern Munich,Bundesliga,35,1983,13.0,15,7,7,6,2,4,10,40.0,6,9,0,9,7,22,1,0,0,2018-2019,0.5384615384615384,1.1538461538461537
2061,Declan Rice,ENG,MF,West Ham,Premier League,19,1999,33.4,98,60,35,58,5,38,88,43.2,50,51,12,39,52,150,56,0,0,2018-2019,1.5568862275449102,2.9341317365269464
2062,Jazz Richards,WAL,"DF,MF",Cardiff City,Premier League,27,1991,1.5,0,0,0,0,0,0,1,0.0,1,2,1,1,2,2,5,0,0,2018-2019,1.3333333333333333,0.0
2063,Richarlison,BRA,"FW,MF",Everton,Premier League,21,1997,29.6,49,34,19,20,10,8,24,33.3,16,30,2,28,16,65,39,0,0,2018-2019,0.5405405405405405,1.6554054054054053
2064,Marco Richter,GER,"MF,FW",Augsburg,Bundesliga,20,1997,15.8,13,8,4,5,4,7,20,35.0,13,16,1,15,13,26,9,1,0,2018-2019,0.8227848101265822,0.8227848101265822
2065,Diego Rico,ESP,"DF,MF",Bournemouth,Premier League,25,1993,6.8,14,9,8,2,4,4,12,33.3,8,13,2,11,14,28,20,0,0,2018-2019,2.058823529411765,2.058823529411765
2066,Mikel Rico,ESP,MF,Athletic Club,La Liga,33,1984,2.7,5,2,1,4,0,2,7,28.6,5,3,2,1,2,7,3,0,0,2018-2019,0.7407407407407407,1.8518518518518516
2067,Sergio Rico,ESP,GK,Fulham,Premier League,24,1993,29.0,1,1,1,0,0,1,1,100.0,0,0,0,0,1,2,13,5,0,2018-2019,0.034482758620689655,0.034482758620689655
2068,Asier Riesgo,ESP,GK,Eibar,La Liga,34,1983,14.0,1,1,1,0,0,1,3,33.3,2,0,0,0,0,1,8,1,0,2018-2019,0.0,0.07142857142857142
2069,Sascha Riether,GER,FW,Schalke 04,Bundesliga,35,1983,0.0,0,0,0,0,0,0,0,0.0,0,0,0,0,0,0,0,0,0,2018-2019,,
2070,Emiliano Rigoni,ARG,"FW,MF",Atalanta,Serie A,25,1993,5.8,6,1,2,2,2,2,6,33.3,4,3,0,3,3,9,3,0,0,2018-2019,0.5172413793103449,1.0344827586206897
2071,Luca Rigoni,ITA,MF,Parma,Serie A,33,1984,19.6,42,25,25,15,2,9,26,34.6,17,19,2,17,18,60,39,0,0,2018-2019,0.9183673469387754,2.142857142857143
2072,Nicola Rigoni,ITA,MF,Chievo,Serie A,27,1990,21.7,43,25,22,15,6,22,51,43.1,29,20,5,15,23,66,45,1,0,2018-2019,1.0599078341013826,1.9815668202764978
2073,Kévin Rimane,GUF,MF,Paris S-G,Ligue 1,27,1991,0.1,0,0,0,0,0,0,0,0.0,0,0,0,0,0,0,0,0,0,2018-2019,0.0,0.0
2074,Tomás Rincón,VEN,MF,Torino,Serie A,30,1988,31.1,75,44,25,41,9,31,68,45.6,37,35,5,30,42,117,71,1,0,2018-2019,1.35048231511254,2.4115755627009645
2075,Renaud Ripart,FRA,"FW,DF",Nîmes,Ligue 1,25,1993,33.4,76,49,41,22,13,32,76,42.1,44,43,7,36,27,103,79,0,0,2018-2019,0.8083832335329342,2.2754491017964074
Rk,Player,Nation,Pos,Squad,Comp,0,0,90.0,0,0,3,3,3,Tkl,0,0.0,0,0,0,0,0,0,0,0,0,2018-2019,0.0,0.0
2076,Mihailo Ristić,SRB,"DF,MF",Montpellier,Ligue 1,22,1995,3.6,14,9,8,5,1,6,10,60.0,4,11,3,8,9,23,6,0,0,2018-2019,2.5,3.888888888888889
2077,Matt Ritchie,SCO,"DF,MF",Newcastle Utd,Premier League,28,1989,32.5,70,44,35,27,8,19,47,40.4,28,34,11,23,51,121,76,1,0,2018-2019,1.5692307692307692,2.1538461538461537
2078,Cristian Rivera,ESP,MF,Huesca,La Liga,21,1997,18.8,38,25,18,19,1,11,25,44.0,14,21,4,17,31,69,31,0,0,2018-2019,1.6489361702127658,2.021276595744681
2079,Arjen Robben,NED,"FW,MF",Bayern Munich,Bundesliga,34,1984,6.3,3,1,0,3,0,0,1,0.0,1,6,1,5,3,6,0,0,0,2018-2019,0.4761904761904762,0.4761904761904762
2080,Rober,ESP,DF,Levante,La Liga,23,1995,31.7,41,29,33,6,2,24,48,50.0,24,52,36,16,51,92,129,2,0,2018-2019,1.608832807570978,1.2933753943217665
2081,Sergi Roberto,ESP,"DF,MF",Barcelona,La Liga,26,1992,23.2,28,20,15,9,4,16,24,66.7,8,18,3,15,43,71,31,0,0,2018-2019,1.853448275862069,1.206896551724138
2082,Patrick Roberts,ENG,"MF,FW",Girona,La Liga,21,1997,6.7,7,6,5,2,0,3,15,20.0,12,5,0,5,3,10,2,1,0,2018-2019,0.44776119402985076,1.044776119402985
2083,Andrew Robertson,SCO,DF,Liverpool,Premier League,24,1994,35.7,80,49,41,31,8,39,70,55.7,31,33,6,27,29,109,57,3,0,2018-2019,0.8123249299719887,2.2408963585434174
2084,Joel Robles,ESP,GK,Betis,La Liga,28,1990,5.0,1,0,1,0,0,1,1,100.0,0,0,0,0,0,1,5,1,0,2018-2019,0.0,0.2
2085,Marc Roca,ESP,MF,Espanyol,La Liga,21,1996,34.6,71,45,36,26,9,28,70,40.0,42,43,21,22,36,107,60,3,0,2018-2019,1.0404624277456647,2.052023121387283
2086,Christopher Rocchia,FRA,DF,Marseille,Ligue 1,20,1998,0.0,0,0,0,0,0,0,0,0.0,0,0,0,0,0,0,1,0,0,2018-2019,,
2087,Kenny Rocha Santos,CPV,MF,Saint-Étienne,Ligue 1,18,2000,0.0,0,0,0,0,0,0,0,0.0,0,0,0,0,0,0,0,0,0,2018-2019,,
2088,Rubén Rochina,ESP,MF,Levante,La Liga,27,1991,20.0,51,33,26,16,9,23,81,28.4,58,29,0,29,21,72,19,1,0,2018-2019,1.05,2.55
2089,Sebastian Rode,GER,MF,Eint Frankfurt,Bundesliga,27,1990,10.3,31,19,17,9,5,16,35,45.7,19,17,0,17,19,50,14,0,0,2018-2019,1.8446601941747571,3.0097087378640777
2090,Ronny Rodelin,FRA,"MF,FW",Guingamp,Ligue 1,28,1989,8.8,13,5,2,7,4,3,8,37.5,5,8,1,7,8,21,13,0,0,2018-2019,0.9090909090909091,1.477272727272727
2091,Rodri,ESP,MF,Atlético Madrid,La Liga,22,1996,30.4,103,70,45,50,8,39,75,52.0,36,35,11,24,41,144,68,0,0,2018-2019,1.348684210526316,3.3881578947368425
2092,Rodrigo,ESP,FW,Valencia,La Liga,27,1991,28.1,21,10,6,9,6,3,17,17.6,14,17,1,16,3,24,18,0,0,2018-2019,0.10676156583629892,0.7473309608540925
2093,Kévin Rodrigues,POR,DF,Real Sociedad,La Liga,24,1994,5.4,21,11,14,6,1,9,17,52.9,8,13,3,10,8,29,15,0,0,2018-2019,1.4814814814814814,3.888888888888889
2094,Alejandro Rodríguez,ESP,MF,Empoli,Serie A,27,1991,0.3,0,0,0,0,0,0,0,0.0,0,0,0,0,0,0,1,0,0,2018-2019,0.0,0.0
2095,Ángel Rodríguez,ESP,FW,Getafe,La Liga,31,1987,20.2,16,7,1,6,9,6,26,23.1,20,15,1,14,8,24,8,0,0,2018-2019,0.39603960396039606,0.7920792079207921
2096,Óscar Rodríguez Arnaiz,ESP,MF,Leganés,La Liga,20,1998,27.8,46,25,26,15,5,16,58,27.6,42,12,2,10,16,62,16,0,0,2018-2019,0.5755395683453237,1.6546762589928057
2097,James Rodríguez,COL,MF,Bayern Munich,Bundesliga,27,1991,12.6,12,8,3,4,5,5,19,26.3,14,9,0,9,4,16,1,0,0,2018-2019,0.31746031746031744,0.9523809523809524
2098,Ricardo Rodríguez,SUI,DF,Milan,Serie A,25,1992,33.9,57,32,34,21,2,32,39,82.1,7,25,5,20,38,95,98,0,0,2018-2019,1.12094395280236,1.68141592920354
2099,Marko Rog,CRO,MF,Napoli,Serie A,23,1995,3.7,12,9,3,7,2,5,11,45.5,6,8,2,6,5,17,1,0,0,2018-2019,1.3513513513513513,3.243243243243243
2100,Marko Rog,CRO,MF,Sevilla,La Liga,23,1995,4.0,12,11,4,8,0,5,9,55.6,4,4,0,4,8,20,1,0,0,2018-2019,2.0,3.0
Rk,Player,Nation,Pos,Squad,Comp,0,0,90.0,0,0,3,3,3,Tkl,0,0.0,0,0,0,0,0,0,0,0,0,2018-2019,0.0,0.0
2101,Rogério,BRA,"DF,MF",Sassuolo,Serie A,20,1998,29.7,55,38,35,13,7,30,55,54.5,25,32,7,25,37,92,109,1,0,2018-2019,1.245791245791246,1.8518518518518519
2102,Marcos Rojo,ARG,DF,Manchester Utd,Premier League,28,1990,2.4,5,3,3,2,0,1,6,16.7,5,3,2,1,6,11,9,1,0,2018-2019,2.5,2.0833333333333335
2103,Diego Rolán,URU,"MF,FW",Leganés,La Liga,25,1993,2.4,6,4,3,3,0,2,9,22.2,7,2,0,2,3,9,3,0,0,2018-2019,1.25,2.5
2104,Diego Rolán,URU,"MF,FW",Alavés,La Liga,25,1993,3.3,7,4,3,1,3,0,2,0.0,2,1,0,1,1,8,4,0,0,2018-2019,0.30303030303030304,2.121212121212121
2105,Rolando,POR,DF,Marseille,Ligue 1,32,1985,8.9,18,7,15,3,0,8,10,80.0,2,8,6,2,11,29,25,0,0,2018-2019,1.2359550561797752,2.0224719101123596
2106,Esteban Rolón,ARG,MF,Genoa,Serie A,23,1995,11.6,46,29,14,20,12,20,44,45.5,24,18,2,16,16,62,12,0,0,2018-2019,1.3793103448275863,3.9655172413793105
2107,Filippo Romagna,ITA,DF,Cagliari,Serie A,21,1997,16.4,14,9,10,4,0,4,8,50.0,4,20,12,8,19,33,68,0,0,2018-2019,1.1585365853658538,0.853658536585366
2108,Alessio Romagnoli,ITA,DF,Milan,Serie A,23,1995,31.6,34,19,26,6,2,16,19,84.2,3,48,32,16,37,71,173,1,0,2018-2019,1.1708860759493671,1.0759493670886076
2109,Alaixys Romao,TOG,MF,Reims,Ligue 1,34,1984,35.1,118,71,61,50,7,43,102,42.2,59,44,16,28,58,176,65,1,0,2018-2019,1.6524216524216524,3.3618233618233617
2110,Cristian Romero,ARG,DF,Genoa,Serie A,20,1998,26.0,61,35,38,18,5,27,40,67.5,13,49,27,22,37,98,128,1,0,2018-2019,1.4230769230769231,2.3461538461538463
2111,Oriol Romeu,ESP,MF,Southampton,Premier League,26,1991,23.7,81,46,39,38,4,32,77,41.6,45,43,17,26,52,133,44,1,0,2018-2019,2.1940928270042193,3.4177215189873418
2112,Rômulo,ITA,"MF,FW",Genoa,Serie A,31,1987,15.0,26,18,9,10,7,7,17,41.2,10,16,3,13,18,44,20,0,0,2018-2019,1.2,1.7333333333333334
2113,Rômulo,ITA,DF,Lazio,Serie A,31,1987,8.6,10,5,8,2,0,5,7,71.4,2,10,2,8,5,15,13,0,0,2018-2019,0.5813953488372093,1.1627906976744187
2114,Cristiano Ronaldo,POR,FW,Juventus,Serie A,33,1985,29.9,10,7,5,4,1,1,11,9.1,10,7,2,5,6,16,32,0,0,2018-2019,0.20066889632107024,0.33444816053511706
2115,Facundo Roncaglia,ARG,DF,Valencia,La Liga,31,1987,6.7,13,10,8,5,0,4,6,66.7,2,4,2,2,10,23,22,0,0,2018-2019,1.4925373134328357,1.9402985074626866
2116,Facundo Roncaglia,ARG,DF,Celta Vigo,La Liga,31,1987,11.9,34,22,26,8,0,17,24,70.8,7,12,5,7,20,54,51,2,0,2018-2019,1.680672268907563,2.857142857142857
2117,Salomón Rondón,VEN,FW,Newcastle Utd,Premier League,28,1989,28.9,8,3,2,4,2,4,24,16.7,20,14,3,11,5,13,39,0,0,2018-2019,0.17301038062283738,0.2768166089965398
2118,Valentin Rongier,FRA,MF,Nantes,Ligue 1,23,1994,35.8,86,54,24,46,16,26,65,40.0,39,46,6,40,33,119,19,0,0,2018-2019,0.9217877094972068,2.4022346368715084
2119,Marten de Roon,NED,MF,Atalanta,Serie A,27,1991,33.1,102,57,32,61,9,34,94,36.2,60,48,9,39,53,155,49,1,0,2018-2019,1.6012084592145015,3.0815709969788516
2120,Roberto Rosales,VEN,DF,Espanyol,La Liga,29,1988,19.4,48,31,22,16,10,21,44,47.7,23,19,7,12,22,70,68,0,0,2018-2019,1.1340206185567012,2.4742268041237114
2121,Danny Rose,ENG,DF,Tottenham,Premier League,28,1990,20.0,49,31,26,16,7,20,32,62.5,12,24,4,20,24,73,28,3,0,2018-2019,1.2,2.45
2122,Valentin Rosier,FRA,"DF,MF",Dijon,Ligue 1,21,1996,16.2,44,25,22,19,3,16,31,51.6,15,25,4,21,32,76,45,1,0,2018-2019,1.9753086419753088,2.7160493827160495
2123,Luca Rossettini,ITA,DF,Chievo,Serie A,33,1985,20.3,26,17,18,8,0,15,20,75.0,5,23,15,8,35,61,114,0,0,2018-2019,1.7241379310344827,1.2807881773399015
2124,Francesco Rossi,ITA,GK,Atalanta,Serie A,27,1991,0.0,0,0,0,0,0,0,0,0.0,0,0,0,0,0,0,0,0,0,2018-2019,,
2125,Jérôme Roussillon,FRA,DF,Wolfsburg,Bundesliga,25,1993,27.3,42,29,25,15,2,20,30,66.7,10,50,7,43,31,73,54,0,0,2018-2019,1.1355311355311355,1.5384615384615383
Rk,Player,Nation,Pos,Squad,Comp,0,0,90.0,0,0,3,3,3,Tkl,0,0.0,0,0,0,0,0,0,0,0,0,2018-2019,0.0,0.0
2126,Nolan Roux,FRA,FW,Guingamp,Ligue 1,30,1988,17.1,11,9,0,6,5,4,14,28.6,10,6,2,4,4,15,21,0,0,2018-2019,0.23391812865497075,0.6432748538011696
2127,Aaron Rowe,ENG,FW,Huddersfield,Premier League,17,2000,0.8,1,0,1,0,0,0,0,0.0,0,0,0,0,1,2,1,0,0,2018-2019,1.25,1.25
2128,Waldo Rubio,ESP,MF,Valladolid,La Liga,22,1995,5.5,4,2,3,1,0,1,6,16.7,5,2,0,2,1,5,8,1,0,2018-2019,0.18181818181818182,0.7272727272727273
2129,John Ruddy,ENG,GK,Wolves,Premier League,31,1986,1.0,0,0,0,0,0,0,0,0.0,0,0,0,0,0,0,0,0,0,2018-2019,0.0,0.0
2130,Antonio Rüdiger,GER,DF,Chelsea,Premier League,25,1993,31.9,34,16,27,6,1,15,27,55.6,12,15,8,7,32,66,96,1,0,2018-2019,1.0031347962382446,1.0658307210031348
2131,Sebastian Rudy,GER,MF,Schalke 04,Bundesliga,28,1990,15.1,44,24,11,27,6,11,41,26.8,30,23,2,21,15,59,15,0,0,2018-2019,0.9933774834437087,2.913907284768212
2132,Stéphane Ruffier,FRA,GK,Saint-Étienne,Ligue 1,31,1986,37.0,2,2,2,0,0,2,4,50.0,2,0,0,0,0,2,18,3,0,2018-2019,0.0,0.05405405405405406
2133,Daniele Rugani,ITA,DF,Juventus,Serie A,24,1994,15.0,8,5,5,3,0,2,5,40.0,3,19,14,5,16,24,51,1,0,2018-2019,1.0666666666666667,0.5333333333333333
2134,Mário Rui,POR,DF,Napoli,Serie A,27,1991,15.7,24,18,9,12,3,14,25,56.0,11,15,3,12,21,45,38,0,0,2018-2019,1.337579617834395,1.5286624203821657
2135,Abel Ruiz,ESP,FW,Barcelona,La Liga,18,2000,0.2,1,1,1,0,0,1,1,100.0,0,0,0,0,0,1,0,0,0,2018-2019,0.0,5.0
2136,Fabián Ruiz Peña,ESP,MF,Napoli,Serie A,22,1996,22.1,54,33,22,25,7,20,46,43.5,26,23,4,19,21,75,29,2,0,2018-2019,0.9502262443438914,2.443438914027149
2137,Víctor Ruiz,ESP,DF,Villarreal,La Liga,29,1989,21.9,28,19,20,6,2,13,18,72.2,5,28,16,12,38,66,67,1,0,2018-2019,1.7351598173515983,1.2785388127853883
2138,Gerónimo Rulli,ARG,GK,Real Sociedad,La Liga,26,1992,27.0,2,1,2,0,0,1,3,33.3,2,1,0,1,1,3,12,6,0,2018-2019,0.037037037037037035,0.07407407407407407
2139,Lukas Rupp,GER,"MF,DF",Hoffenheim,Bundesliga,27,1991,0.3,1,1,0,0,1,0,0,0.0,0,0,0,0,0,1,0,0,0,2018-2019,0.0,3.3333333333333335
2140,Marco Russ,GER,DF,Eint Frankfurt,Bundesliga,32,1985,4.2,7,2,5,2,0,4,6,66.7,2,2,2,0,7,14,8,0,0,2018-2019,1.6666666666666665,1.6666666666666665
2141,Mathew Ryan,AUS,GK,Brighton,Premier League,26,1992,34.0,1,0,1,0,0,1,2,50.0,1,0,0,0,0,1,13,1,0,2018-2019,0.0,0.029411764705882353
2142,Frederik Rønnow,DEN,GK,Eint Frankfurt,Bundesliga,25,1992,1.4,0,0,0,0,0,0,0,0.0,0,0,0,0,0,0,1,0,0,2018-2019,0.0,0.0
2143,Idriss Saadi,ALG,"FW,MF",Strasbourg,Ligue 1,26,1992,0.1,0,0,0,0,0,0,0,0.0,0,0,0,0,0,0,0,0,0,2018-2019,0.0,0.0
2144,Youssouf Sabaly,SEN,DF,Bordeaux,Ligue 1,25,1993,21.2,46,32,32,12,2,25,46,54.3,21,19,2,17,26,72,42,0,0,2018-2019,1.2264150943396226,2.169811320754717
2145,Abdelhamid Sabiri,MAR,FW,Huddersfield,Premier League,21,1996,0.5,2,1,1,1,0,0,0,0.0,0,1,0,1,1,3,0,0,0,2018-2019,2.0,4.0
2146,Marcel Sabitzer,AUT,MF,RB Leipzig,Bundesliga,24,1994,26.1,45,28,17,21,7,18,46,39.1,28,21,2,19,33,78,31,0,0,2018-2019,1.264367816091954,1.7241379310344827
2147,Ihsan Sacko,FRA,FW,Nice,Ligue 1,21,1997,4.9,7,2,2,5,0,2,5,40.0,3,5,0,5,2,9,2,0,0,2018-2019,0.4081632653061224,1.4285714285714284
2148,Nuri Şahin,TUR,MF,Werder Bremen,Bundesliga,29,1988,16.4,60,33,22,33,5,23,59,39.0,36,30,3,27,37,97,39,1,0,2018-2019,2.25609756097561,3.658536585365854
2149,Samuel Şahin-Radlinger,AUT,GK,Hannover 96,Bundesliga,25,1992,1.0,0,0,0,0,0,0,0,0.0,0,1,0,1,0,0,2,0,0,2018-2019,0.0,0.0
2150,Wesley Saïd,FRA,"FW,MF",Dijon,Ligue 1,23,1995,25.0,25,18,6,11,8,5,20,25.0,15,9,0,9,9,34,9,0,0,2018-2019,0.36,1.0
Rk,Player,Nation,Pos,Squad,Comp,0,0,90.0,0,0,3,3,3,Tkl,0,0.0,0,0,0,0,0,0,0,0,0,2018-2019,0.0,0.0
2151,Allan Saint-Maximin,FRA,FW,Nice,Ligue 1,21,1997,32.2,12,6,1,7,4,2,14,14.3,12,11,0,11,4,16,3,0,0,2018-2019,0.12422360248447203,0.37267080745341613
2152,Théo Sainte-Luce,FRA,MF,Nîmes,Ligue 1,19,1998,0.0,0,0,0,0,0,0,0,0.0,0,0,0,0,0,0,0,0,0,2018-2019,,
2153,Romain Saïss,MAR,"MF,DF",Wolves,Premier League,28,1990,12.8,39,26,23,14,2,20,37,54.1,17,25,12,13,26,65,61,0,0,2018-2019,2.03125,3.046875
2154,Samuel Sáiz,ESP,MF,Getafe,La Liga,27,1991,3.4,4,3,0,3,1,2,5,40.0,3,1,0,1,0,4,2,0,0,2018-2019,0.0,1.1764705882352942
2155,Bukayo Saka,ENG,FW,Arsenal,Premier League,16,2001,0.1,0,0,0,0,0,0,0,0.0,0,0,0,0,0,0,0,0,0,2018-2019,0.0,0.0
2156,Hiroki Sakai,JPN,DF,Marseille,Ligue 1,28,1990,26.4,59,41,30,23,6,29,54,53.7,25,25,10,15,37,96,77,0,0,2018-2019,1.4015151515151516,2.234848484848485
2157,Diafra Sakho,SEN,FW,Rennes,Ligue 1,28,1989,1.6,2,1,0,0,2,0,0,0.0,0,0,0,0,0,2,0,0,0,2018-2019,0.0,1.25
2158,Mamadou Sakho,FRA,DF,Crystal Palace,Premier League,28,1990,26.8,25,16,22,3,0,11,18,61.1,7,26,16,10,41,66,136,2,0,2018-2019,1.5298507462686566,0.9328358208955224
2159,Bakary Sako,MLI,FW,Crystal Palace,Premier League,30,1988,0.3,2,1,2,0,0,1,1,100.0,0,0,0,0,0,2,0,0,0,2018-2019,0.0,6.666666666666667
2160,Emiliano Sala,ARG,FW,Nantes,Ligue 1,27,1990,15.2,7,5,0,2,5,1,8,12.5,7,8,1,7,2,9,20,0,0,2018-2019,0.13157894736842105,0.46052631578947373
2161,Jacopo Sala,ITA,DF,Sampdoria,Serie A,26,1991,16.9,38,23,20,14,4,23,41,56.1,18,11,3,8,20,58,47,2,0,2018-2019,1.183431952662722,2.248520710059172
2162,Mohamed Salah,EGY,FW,Liverpool,Premier League,26,1992,36.1,21,9,3,11,7,5,16,31.3,11,9,0,9,5,26,6,0,0,2018-2019,0.13850415512465372,0.5817174515235457
2163,Bartosz Salamon,POL,DF,Frosinone,Serie A,27,1991,19.2,17,10,12,5,0,6,14,42.9,8,27,19,8,27,44,143,1,0,2018-2019,1.40625,0.8854166666666667
2164,Carlos Salcedo,MEX,DF,Eint Frankfurt,Bundesliga,24,1993,5.1,7,3,4,3,0,4,7,57.1,3,7,3,4,9,16,22,0,0,2018-2019,1.7647058823529413,1.3725490196078431
2165,William Saliba,FRA,DF,Saint-Étienne,Ligue 1,17,2001,14.2,32,20,28,4,0,16,24,66.7,8,11,10,1,28,60,44,2,0,2018-2019,1.971830985915493,2.2535211267605635
2166,Yannis Salibur,FRA,"FW,MF",Saint-Étienne,Ligue 1,27,1991,9.8,9,5,1,7,1,1,7,14.3,6,6,0,6,8,17,4,0,0,2018-2019,0.8163265306122448,0.9183673469387754
2167,Yannis Salibur,FRA,MF,Guingamp,Ligue 1,27,1991,0.2,0,0,0,0,0,0,0,0.0,0,0,0,0,0,0,0,0,0,2018-2019,0.0,0.0
2168,Roland Sallai,HUN,MF,Freiburg,Bundesliga,21,1997,5.9,12,7,5,5,2,5,13,38.5,8,3,0,3,3,15,8,0,0,2018-2019,0.5084745762711864,2.0338983050847457
2169,Edgar Salli,CMR,"FW,MF",Nürnberg,Bundesliga,25,1992,1.3,2,1,1,1,0,0,1,0.0,1,0,0,0,1,3,1,0,0,2018-2019,0.7692307692307692,1.5384615384615383
2170,Brice Samba,FRA,GK,Caen,Ligue 1,24,1994,38.0,1,0,1,0,0,0,1,0.0,1,0,0,0,1,2,12,4,0,2018-2019,0.02631578947368421,0.02631578947368421
2171,Junior Sambia,FRA,"MF,FW",Montpellier,Ligue 1,21,1996,10.3,15,7,7,7,1,6,15,40.0,9,14,2,12,5,20,3,0,0,2018-2019,0.48543689320388345,1.4563106796116503
2172,Paolo Sammarco,ITA,MF,Frosinone,Serie A,35,1983,6.1,16,7,7,6,3,6,9,66.7,3,5,0,5,3,19,1,2,0,2018-2019,0.49180327868852464,2.6229508196721314
2173,Frédéric Sammaritano,FRA,"FW,MF",Dijon,Ligue 1,32,1986,6.0,11,5,5,5,1,5,13,38.5,8,8,1,7,8,19,2,1,0,2018-2019,1.3333333333333333,1.8333333333333333
2174,Mikel San José,ESP,MF,Athletic Club,La Liga,29,1989,19.3,43,25,19,19,5,15,48,31.3,33,27,6,21,21,64,35,0,0,2018-2019,1.088082901554404,2.227979274611399
2175,Antonio Sanabria,PAR,FW,Genoa,Serie A,22,1996,8.5,6,3,1,1,4,0,1,0.0,1,8,0,8,4,10,3,0,0,2018-2019,0.47058823529411764,0.7058823529411765
Rk,Player,Nation,Pos,Squad,Comp,0,0,90.0,0,0,3,3,3,Tkl,0,0.0,0,0,0,0,0,0,0,0,0,2018-2019,0.0,0.0
2176,Antonio Sanabria,PAR,FW,Betis,La Liga,22,1996,9.0,8,6,0,5,3,1,6,16.7,5,8,2,6,3,11,4,0,0,2018-2019,0.3333333333333333,0.8888888888888888
2177,Renato Sanches,POR,MF,Bayern Munich,Bundesliga,20,1997,6.4,5,5,2,1,2,3,10,30.0,7,7,0,7,4,9,2,0,0,2018-2019,0.625,0.78125
2178,Alexis Sánchez,CHI,"FW,MF",Manchester Utd,Premier League,29,1988,9.8,17,10,5,9,3,5,13,38.5,8,7,0,7,9,26,2,0,0,2018-2019,0.9183673469387754,1.7346938775510203
2179,Carlos Sánchez,COL,MF,West Ham,Premier League,32,1986,2.7,4,3,4,0,0,3,8,37.5,5,1,0,1,1,5,5,2,0,2018-2019,0.37037037037037035,1.4814814814814814
2180,Davinson Sánchez,COL,DF,Tottenham,Premier League,22,1996,21.6,37,20,28,9,0,20,37,54.1,17,17,9,8,30,67,103,2,0,2018-2019,1.3888888888888888,1.7129629629629628
2181,Javi Sánchez,ESP,DF,Real Madrid,La Liga,21,1997,0.5,1,0,1,0,0,0,0,0.0,0,0,0,0,0,1,4,0,0,2018-2019,0.0,2.0
2182,Víctor Sánchez,ESP,MF,Espanyol,La Liga,30,1987,14.1,45,30,21,17,7,14,67,20.9,53,17,2,15,25,70,25,0,0,2018-2019,1.773049645390071,3.1914893617021276
2183,Jadon Sancho,ENG,"FW,MF",Dortmund,Bundesliga,18,2000,27.3,19,10,7,6,6,10,31,32.3,21,21,1,20,14,33,12,1,0,2018-2019,0.5128205128205128,0.6959706959706959
2184,Sandro,BRA,MF,Udinese,Serie A,29,1989,6.6,18,10,10,8,0,7,13,53.8,6,14,5,9,11,29,16,0,0,2018-2019,1.6666666666666667,2.7272727272727275
2185,Sandro,BRA,MF,Genoa,Serie A,29,1989,7.9,27,17,12,11,4,9,17,52.9,8,9,4,5,20,47,25,0,0,2018-2019,2.531645569620253,3.4177215189873418
2186,Alex Sandro,BRA,DF,Juventus,Serie A,27,1991,26.5,68,45,28,33,7,21,36,58.3,15,32,8,24,38,106,71,0,0,2018-2019,1.4339622641509433,2.5660377358490565
2187,Leroy Sané,GER,FW,Manchester City,Premier League,22,1996,20.7,24,15,8,7,9,2,23,8.7,21,21,2,19,8,32,2,0,0,2018-2019,0.3864734299516908,1.1594202898550725
2188,Salif Sané,SEN,DF,Schalke 04,Bundesliga,27,1990,29.0,54,37,34,19,1,27,46,58.7,19,44,29,15,68,122,146,3,0,2018-2019,2.3448275862068964,1.8620689655172413
2189,Luca Sangalli,ESP,"MF,FW",Real Sociedad,La Liga,23,1995,11.1,19,13,6,11,2,5,22,22.7,17,9,1,8,5,24,5,0,0,2018-2019,0.45045045045045046,1.7117117117117118
2190,Ibrahim Sangaré,CIV,MF,Toulouse,Ligue 1,20,1997,27.4,102,66,50,44,8,32,63,50.8,31,52,20,32,29,131,49,2,0,2018-2019,1.0583941605839418,3.7226277372262775
2191,Younousse Sankharé,SEN,MF,Bordeaux,Ligue 1,28,1989,16.4,25,12,2,19,4,6,19,31.6,13,14,0,14,9,34,4,0,0,2018-2019,0.5487804878048781,1.524390243902439
2192,Baissama Sankoh,GUI,"MF,FW",Caen,Ligue 1,26,1992,7.2,4,1,4,0,0,1,4,25.0,3,8,1,7,5,9,16,0,0,2018-2019,0.6944444444444444,0.5555555555555556
2193,Yaya Sanogo,FRA,FW,Toulouse,Ligue 1,25,1993,13.8,4,2,0,2,2,2,4,50.0,2,3,0,3,3,7,15,0,0,2018-2019,0.21739130434782608,0.2898550724637681
2194,Morgan Sanson,FRA,MF,Marseille,Ligue 1,23,1994,26.7,70,47,27,35,8,21,77,27.3,56,40,1,39,42,112,8,1,0,2018-2019,1.5730337078651686,2.6217228464419478
2195,Nicola Sansone,ITA,FW,Bologna,Serie A,26,1991,12.7,29,17,9,14,6,9,27,33.3,18,13,1,12,9,38,4,0,0,2018-2019,0.7086614173228347,2.283464566929134
2196,Nicola Sansone,ITA,"FW,MF",Villarreal,La Liga,26,1991,0.4,0,0,0,0,0,0,0,0.0,0,0,0,0,0,0,0,0,0,2018-2019,0.0,0.0
2197,Baptiste Santamaria,FRA,MF,Angers,Ligue 1,23,1995,36.1,118,60,48,63,7,51,106,48.1,55,41,4,37,57,175,57,2,0,2018-2019,1.5789473684210527,3.268698060941828
2198,Roberto Santamaría,ESP,GK,Huesca,La Liga,33,1985,20.0,0,0,0,0,0,0,0,0.0,0,0,0,0,1,1,12,1,0,2018-2019,0.05,0.0
2199,Federico Santander,PAR,FW,Bologna,Serie A,27,1991,22.9,18,10,6,8,4,2,23,8.7,21,20,2,18,9,27,30,0,0,2018-2019,0.39301310043668125,0.7860262008733625
2200,Davide Santon,ITA,DF,Roma,Serie A,27,1991,11.2,14,6,8,6,0,8,12,66.7,4,11,7,4,15,29,27,0,0,2018-2019,1.3392857142857144,1.25
Rk,Player,Nation,Pos,Squad,Comp,0,0,90.0,0,0,3,3,3,Tkl,0,0.0,0,0,0,0,0,0,0,0,0,2018-2019,0.0,0.0
2201,Michael Santos,URU,"FW,MF",Leganés,La Liga,25,1993,6.2,12,5,1,7,4,2,7,28.6,5,7,1,6,1,13,1,0,0,2018-2019,0.16129032258064516,1.9354838709677418
2202,Samir Santos,BRA,DF,Udinese,Serie A,23,1994,20.0,47,33,27,18,2,19,25,76.0,6,18,9,9,34,81,96,0,0,2018-2019,1.7,2.35
2203,Riccardo Saponara,ITA,MF,Sampdoria,Serie A,26,1991,10.1,12,6,2,6,4,3,12,25.0,9,5,1,4,4,16,10,0,0,2018-2019,0.39603960396039606,1.188118811881188
2204,Pablo Sarabia,ESP,"MF,FW",Sevilla,La Liga,26,1992,30.3,30,15,6,15,9,6,47,12.8,41,30,3,27,22,52,20,0,0,2018-2019,0.7260726072607261,0.9900990099009901
2205,Marcelo Saracchi,URU,DF,RB Leipzig,Bundesliga,20,1998,7.3,17,11,12,4,1,8,13,61.5,5,12,1,11,11,28,14,0,0,2018-2019,1.5068493150684932,2.328767123287671
2206,Josh Sargent,USA,FW,Werder Bremen,Bundesliga,18,2000,2.4,2,1,1,0,1,2,2,100.0,0,2,0,2,0,2,3,0,0,2018-2019,0.0,0.8333333333333334
2207,Bouna Sarr,SEN,"DF,MF",Marseille,Ligue 1,26,1992,24.9,67,48,27,27,13,26,42,61.9,16,28,3,25,39,106,56,1,0,2018-2019,1.566265060240964,2.6907630522088355
2208,Ismaila Sarr,SEN,"FW,MF",Rennes,Ligue 1,20,1998,31.0,35,24,16,15,4,17,34,50.0,17,17,2,15,14,49,4,0,0,2018-2019,0.45161290322580644,1.1290322580645162
2209,Malang Sarr,FRA,DF,Nice,Ligue 1,19,1999,33.3,59,36,38,17,4,31,57,54.4,26,29,12,17,68,127,107,2,0,2018-2019,2.042042042042042,1.771771771771772
2210,Lluís Sastre,ESP,MF,Huesca,La Liga,32,1986,1.3,5,3,0,5,0,0,1,0.0,1,0,0,0,1,6,0,0,0,2018-2019,0.7692307692307692,3.846153846153846
2211,Marco Sau,ITA,"MF,FW",Sampdoria,Serie A,30,1987,0.6,0,0,0,0,0,0,0,0.0,0,1,0,1,0,0,0,0,0,2018-2019,0.0,0.0
2212,Marco Sau,ITA,"FW,MF",Cagliari,Serie A,30,1987,6.2,4,2,0,2,2,0,3,0.0,3,5,0,5,1,5,4,0,0,2018-2019,0.16129032258064516,0.6451612903225806
2213,Téji Savanier,FRA,MF,Nîmes,Ligue 1,26,1991,31.8,95,58,35,52,8,43,116,37.1,73,32,15,17,64,159,53,2,0,2018-2019,2.0125786163522013,2.9874213836477987
2214,Stefan Savić,MNE,DF,Atlético Madrid,La Liga,27,1991,15.5,11,10,9,2,0,7,12,58.3,5,13,9,4,22,33,67,0,0,2018-2019,1.4193548387096775,0.7096774193548387
2215,Fabian Schär,SUI,DF,Newcastle Utd,Premier League,26,1991,22.2,60,39,37,19,4,24,50,48.0,26,40,16,24,67,127,145,2,0,2018-2019,3.0180180180180183,2.7027027027027026
2216,Ezequiel Schelotto,ITA,DF,Chievo,Serie A,29,1989,1.6,3,0,3,0,0,2,3,66.7,1,1,0,1,2,5,8,0,0,2018-2019,1.25,1.875
2217,Nicolás Schiappacasse,URU,"FW,MF",Parma,Serie A,19,1999,0.9,0,0,0,0,0,0,0,0.0,0,2,0,2,0,0,0,0,0,2018-2019,0.0,0.0
2218,Pasquale Schiattarella,ITA,MF,SPAL,Serie A,31,1987,20.5,43,27,18,21,4,13,38,34.2,25,17,5,12,22,65,25,1,0,2018-2019,1.0731707317073171,2.097560975609756
2219,Patrik Schick,CZE,"FW,MF",Roma,Serie A,22,1996,14.6,11,5,3,5,3,1,19,5.3,18,19,2,17,3,14,15,1,0,2018-2019,0.20547945205479454,0.7534246575342466
2220,Julian Schieber,GER,FW,Augsburg,Bundesliga,29,1989,2.9,3,2,1,2,0,0,1,0.0,1,1,0,1,1,4,3,0,0,2018-2019,0.3448275862068966,1.0344827586206897
2221,Christopher Schindler,GER,DF,Huddersfield,Premier League,28,1990,36.2,61,36,46,14,1,27,47,57.4,20,69,34,35,70,131,138,4,0,2018-2019,1.9337016574585635,1.6850828729281766
2222,Keven Schlotterbeck,GER,DF,Freiburg,Bundesliga,21,1997,8.6,22,16,19,2,1,8,12,66.7,4,17,11,6,13,35,26,0,0,2018-2019,1.5116279069767442,2.558139534883721
2223,Nico Schlotterbeck,GER,DF,Freiburg,Bundesliga,18,1999,2.5,6,6,6,0,0,2,2,100.0,0,3,1,2,5,11,10,0,0,2018-2019,2.0,2.4
2224,Jeffrey Schlupp,GHA,"MF,FW",Crystal Palace,Premier League,25,1992,18.6,41,20,18,18,5,10,27,37.0,17,30,8,22,19,60,27,1,0,2018-2019,1.021505376344086,2.204301075268817
2225,Kasper Schmeichel,DEN,GK,Leicester City,Premier League,31,1986,38.0,1,1,1,0,0,1,1,100.0,0,0,0,0,3,4,14,3,0,2018-2019,0.07894736842105263,0.02631578947368421
Rk,Player,Nation,Pos,Squad,Comp,0,0,90.0,0,0,3,3,3,Tkl,0,0.0,0,0,0,0,0,0,0,0,0,2018-2019,0.0,0.0
2226,Marcel Schmelzer,GER,DF,Dortmund,Bundesliga,30,1988,6.3,10,5,7,2,1,5,9,55.6,4,7,1,6,9,19,14,0,0,2018-2019,1.4285714285714286,1.5873015873015874
2227,Jonathan Schmid,FRA,DF,Augsburg,Bundesliga,28,1990,28.0,44,22,23,19,2,16,28,57.1,12,22,8,14,43,87,70,2,0,2018-2019,1.5357142857142858,1.5714285714285714
2228,Morgan Schneiderlin,FRA,MF,Everton,Premier League,28,1989,9.3,24,16,11,11,2,6,14,42.9,8,16,3,13,15,39,16,0,0,2018-2019,1.6129032258064515,2.5806451612903225
2229,Alessandro Schöpf,AUT,"MF,DF",Schalke 04,Bundesliga,24,1994,11.2,26,16,12,13,1,12,29,41.4,17,14,0,14,9,35,12,0,0,2018-2019,0.8035714285714286,2.3214285714285716
2230,Nico Schulz,GER,DF,Hoffenheim,Bundesliga,25,1993,28.2,34,20,19,12,3,15,36,41.7,21,32,4,28,24,58,36,0,0,2018-2019,0.851063829787234,1.2056737588652482
2231,André Schürrle,GER,"FW,MF",Fulham,Premier League,27,1990,18.2,30,19,14,10,6,12,42,28.6,30,16,1,15,8,38,17,1,0,2018-2019,0.43956043956043955,1.6483516483516485
2232,Pirmin Schwegler,SUI,MF,Hannover 96,Bundesliga,31,1987,23.1,63,34,30,29,4,34,60,56.7,26,21,5,16,41,104,54,0,0,2018-2019,1.7748917748917747,2.727272727272727
2233,Alexander Schwolow,GER,GK,Freiburg,Bundesliga,26,1992,33.0,0,0,0,0,0,0,1,0.0,1,0,0,0,0,0,13,2,0,2018-2019,0.0,0.0
2234,Matteo Scozzarella,ITA,MF,Parma,Serie A,30,1988,16.2,18,13,9,8,1,9,33,27.3,24,22,10,12,23,41,33,0,0,2018-2019,1.4197530864197532,1.1111111111111112
2235,Simone Scuffet,ITA,GK,Udinese,Serie A,22,1996,9.0,0,0,0,0,0,0,1,0.0,1,0,0,0,0,0,4,2,0,2018-2019,0.0,0.0
2236,Andrea Seculin,ITA,GK,Chievo,Serie A,28,1990,1.0,0,0,0,0,0,0,0,0.0,0,0,0,0,0,0,1,0,0,2018-2019,0.0,0.0
2237,Stanley Segarel,SMN,FW,Amiens,Ligue 1,24,1994,0.2,0,0,0,0,0,0,0,0.0,0,0,0,0,0,0,0,0,0,2018-2019,0.0,0.0
2238,Davie Selke,GER,FW,Hertha BSC,Bundesliga,23,1995,19.3,5,2,1,4,0,2,9,22.2,7,11,0,11,1,6,7,0,0,2018-2019,0.05181347150259067,0.25906735751295334
2239,Ole Selnæs,NOR,MF,Saint-Étienne,Ligue 1,24,1994,18.5,44,26,12,23,9,13,35,37.1,22,24,7,17,19,63,29,0,0,2018-2019,1.027027027027027,2.3783783783783785
2240,Matz Sels,BEL,GK,Strasbourg,Ligue 1,26,1992,37.0,0,0,0,0,0,0,1,0.0,1,0,0,0,1,1,24,1,0,2018-2019,0.02702702702702703,0.0
2241,Ken Sema,SWE,"MF,FW",Watford,Premier League,24,1993,8.4,15,7,7,5,3,9,21,42.9,12,7,0,7,8,23,5,0,0,2018-2019,0.9523809523809523,1.7857142857142856
2242,Alfa Semedo,GNB,MF,Espanyol,La Liga,20,1997,0.5,0,0,0,0,0,0,3,0.0,3,1,1,0,2,2,0,0,0,2018-2019,4.0,0.0
2243,Nélson Semedo,POR,DF,Barcelona,La Liga,24,1993,17.8,38,27,23,12,3,12,18,66.7,6,23,7,16,22,60,26,0,0,2018-2019,1.2359550561797752,2.134831460674157
2244,Rúben Semedo,POR,DF,Huesca,La Liga,24,1994,9.4,20,16,14,6,0,12,16,75.0,4,15,9,6,16,36,35,2,0,2018-2019,1.702127659574468,2.127659574468085
2245,Adrian Šemper,CRO,GK,Chievo,Serie A,20,1998,6.0,0,0,0,0,0,0,0,0.0,0,0,0,0,1,1,3,0,0,2018-2019,0.16666666666666666,0.0
2246,Stefano Sensi,ITA,MF,Sassuolo,Serie A,22,1995,21.9,36,20,15,18,3,6,30,20.0,24,36,7,29,33,69,17,0,0,2018-2019,1.5068493150684932,1.6438356164383563
2247,Luigi Sepe,ITA,GK,Parma,Serie A,27,1991,37.0,1,1,1,0,0,1,2,50.0,1,0,0,0,3,4,21,3,0,2018-2019,0.08108108108108109,0.02702702702702703
2248,Suat Serdar,GER,MF,Schalke 04,Bundesliga,21,1997,19.2,51,32,20,26,5,14,49,28.6,35,37,6,31,23,74,5,1,0,2018-2019,1.1979166666666667,2.65625
2249,Jean Seri,CIV,MF,Fulham,Premier League,27,1991,24.9,41,28,20,20,1,13,45,28.9,32,40,9,31,32,73,17,4,0,2018-2019,1.285140562248996,1.6465863453815262
2250,Leonardo Sernicola,ITA,FW,Sassuolo,Serie A,21,1997,0.1,0,0,0,0,0,0,0,0.0,0,0,0,0,0,0,0,0,0,2018-2019,0.0,0.0
Rk,Player,Nation,Pos,Squad,Comp,0,0,90.0,0,0,3,3,3,Tkl,0,0.0,0,0,0,0,0,0,0,0,0,2018-2019,0.0,0.0
2251,Julien Serrano,FRA,"MF,DF",Monaco,Ligue 1,20,1998,1.3,5,4,3,2,0,3,6,50.0,3,1,0,1,3,8,3,0,0,2018-2019,2.3076923076923075,3.846153846153846
2252,Grégory Sertic,FRA,MF,Marseille,Ligue 1,28,1989,1.2,2,0,1,1,0,0,1,0.0,1,2,1,1,1,3,2,0,0,2018-2019,0.8333333333333334,1.6666666666666667
2253,Ryan Sessegnon,ENG,"FW,DF",Fulham,Premier League,18,2000,25.6,22,14,8,8,6,6,22,27.3,16,25,2,23,19,41,49,1,0,2018-2019,0.7421875,0.859375
2254,Paik Seung-ho,KOR,"FW,MF",Girona,La Liga,21,1997,0.7,0,0,0,0,0,0,1,0.0,1,1,0,1,3,3,1,0,0,2018-2019,4.285714285714286,0.0
2255,Stephan El Shaarawy,ITA,"FW,MF",Roma,Serie A,25,1992,23.4,27,14,14,8,5,9,24,37.5,15,11,2,9,20,47,9,0,0,2018-2019,0.8547008547008548,1.153846153846154
2256,Meritan Shabani,ALB,MF,Bayern Munich,Bundesliga,19,1999,0.0,0,0,0,0,0,0,0,0.0,0,0,0,0,0,0,0,0,0,2018-2019,,
2257,Xherdan Shaqiri,SUI,"FW,MF",Liverpool,Premier League,26,1991,11.8,14,4,3,9,2,9,19,47.4,10,6,1,5,6,20,6,0,0,2018-2019,0.5084745762711864,1.1864406779661016
2258,Luke Shaw,ENG,DF,Manchester Utd,Premier League,23,1995,28.8,55,29,17,31,7,28,47,59.6,19,42,12,30,21,76,93,2,0,2018-2019,0.7291666666666666,1.909722222222222
2259,Jonjo Shelvey,ENG,MF,Newcastle Utd,Premier League,26,1992,10.5,22,12,10,9,3,8,17,47.1,9,10,3,7,7,29,15,0,0,2018-2019,0.6666666666666666,2.0952380952380953
2260,Gaku Shibasaki,JPN,"MF,FW",Getafe,La Liga,26,1992,4.3,7,3,2,4,1,3,6,50.0,3,2,0,2,3,10,4,0,0,2018-2019,0.6976744186046512,1.627906976744186
2261,Gen Shoji,JPN,DF,Toulouse,Ligue 1,25,1992,18.0,24,13,16,8,0,11,24,45.8,13,22,14,8,21,45,56,0,0,2018-2019,1.1666666666666667,1.3333333333333333
2262,Djibril Sidibé,FRA,"DF,MF",Monaco,Ligue 1,26,1992,23.1,50,34,27,12,11,26,48,54.2,22,25,9,16,30,80,51,0,0,2018-2019,1.2987012987012987,2.1645021645021645
2263,Kalidou Sidibé,FRA,MF,Toulouse,Ligue 1,19,1999,14.0,24,12,11,12,1,7,15,46.7,8,16,3,13,17,41,26,1,0,2018-2019,1.2142857142857142,1.7142857142857142
2264,Sidnei,BRA,DF,Betis,La Liga,28,1989,19.4,48,29,33,12,3,18,34,52.9,16,21,8,13,41,89,57,0,0,2018-2019,2.11340206185567,2.4742268041237114
2265,Francisco Sierralta,CHI,DF,Parma,Serie A,21,1997,3.0,11,8,8,3,0,4,6,66.7,2,1,1,0,4,15,27,0,0,2018-2019,1.3333333333333333,3.6666666666666665
2266,Gylfi Sigurðsson,ISL,MF,Everton,Premier League,28,1989,34.6,56,36,20,25,11,16,47,34.0,31,38,4,34,28,84,24,0,0,2018-2019,0.8092485549132947,1.6184971098265895
2267,Luca Siligardi,ITA,FW,Parma,Serie A,30,1988,18.2,30,20,10,13,7,8,23,34.8,15,19,3,16,15,45,11,0,0,2018-2019,0.8241758241758242,1.6483516483516485
2268,Adrien Silva,POR,MF,Leicester City,Premier League,29,1989,1.0,2,2,0,1,1,0,2,0.0,2,1,0,1,1,3,1,0,0,2018-2019,1.0,2.0
2269,Adrien Silva,POR,MF,Monaco,Ligue 1,29,1989,13.2,50,31,19,26,5,30,62,48.4,32,15,2,13,16,66,23,0,0,2018-2019,1.2121212121212122,3.787878787878788
2270,André Silva,POR,FW,Sevilla,La Liga,22,1995,24.0,8,5,1,4,3,1,11,9.1,10,17,1,16,3,11,32,0,0,2018-2019,0.125,0.3333333333333333
2271,Bernardo Silva,POR,"MF,FW",Manchester City,Premier League,23,1994,31.7,52,39,18,21,13,16,67,23.9,51,47,3,44,25,77,26,1,0,2018-2019,0.7886435331230284,1.640378548895899
2272,David Silva,ESP,MF,Manchester City,Premier League,32,1986,26.7,30,18,12,11,7,1,20,5.0,19,18,1,17,22,52,15,0,0,2018-2019,0.8239700374531835,1.1235955056179776
2273,Gabriel Silva,BRA,DF,Saint-Étienne,Ligue 1,27,1991,15.9,19,10,13,6,0,6,17,35.3,11,15,3,12,14,33,60,1,0,2018-2019,0.8805031446540881,1.1949685534591195
2274,Jonathan Silva,ARG,"DF,FW",Leganés,La Liga,24,1994,30.0,51,38,30,17,4,23,52,44.2,29,23,2,21,29,80,86,0,0,2018-2019,0.9666666666666667,1.7
2275,Matheus Pereira da Silva,BRA,MF,Juventus,Serie A,20,1998,1.0,3,2,0,2,1,2,4,50.0,2,1,0,1,0,3,1,0,0,2018-2019,0.0,3.0
Rk,Player,Nation,Pos,Squad,Comp,0,0,90.0,0,0,3,3,3,Tkl,0,0.0,0,0,0,0,0,0,0,0,0,2018-2019,0.0,0.0
2276,Thiago Silva,BRA,DF,Paris S-G,Ligue 1,33,1984,23.1,16,13,7,8,1,6,11,54.5,5,28,20,8,32,48,99,1,0,2018-2019,1.3852813852813852,0.6926406926406926
2277,Xande Silva,POR,FW,West Ham,Premier League,21,1997,0.2,0,0,0,0,0,0,0,0.0,0,1,0,1,0,0,0,0,0,2018-2019,0.0,0.0
2278,Matías Silvestre,ARG,DF,Empoli,Serie A,33,1984,34.0,31,17,22,5,4,17,26,65.4,9,29,24,5,21,52,165,0,0,2018-2019,0.6176470588235294,0.9117647058823529
2279,Giovanni Simeone,ARG,FW,Fiorentina,Serie A,23,1995,27.3,43,27,10,23,10,7,29,24.1,22,26,2,24,4,47,14,0,0,2018-2019,0.14652014652014653,1.575091575091575
2280,Lorenco Šimić,CRO,DF,SPAL,Serie A,22,1996,2.6,6,3,5,1,0,2,4,50.0,2,2,1,1,12,18,19,1,0,2018-2019,4.615384615384615,2.3076923076923075
2281,Moses Simon,NGA,"DF,MF",Levante,La Liga,23,1995,8.7,14,8,10,2,2,5,9,55.6,4,10,1,9,12,26,14,0,0,2018-2019,1.3793103448275863,1.6091954022988506
2282,Unai Simón,ESP,GK,Athletic Club,La Liga,21,1997,7.0,0,0,0,0,0,0,1,0.0,1,0,0,0,1,1,1,1,0,2018-2019,0.14285714285714285,0.0
2283,Danny Simpson,ENG,DF,Leicester City,Premier League,31,1987,3.2,11,3,8,3,0,3,5,60.0,2,7,3,4,6,17,20,0,0,2018-2019,1.875,3.4375
2284,Jack Simpson,ENG,DF,Bournemouth,Premier League,21,1996,4.5,9,5,8,1,0,6,9,66.7,3,5,4,1,9,18,25,2,0,2018-2019,2.0,2.0
2285,Josh Sims,ENG,MF,Southampton,Premier League,21,1997,2.4,1,0,1,0,0,1,3,33.3,2,2,0,2,1,2,1,0,0,2018-2019,0.4166666666666667,0.4166666666666667
2286,Giovanni Sio,CIV,FW,Montpellier,Ligue 1,29,1989,0.7,0,0,0,0,0,0,0,0.0,0,0,0,0,0,0,0,0,0,2018-2019,0.0,0.0
2287,Dimitris Siovas,GRE,DF,Leganés,La Liga,29,1988,32.9,57,32,38,18,1,27,47,57.4,20,32,15,17,65,122,155,1,0,2018-2019,1.9756838905775076,1.7325227963525838
2288,Salvatore Sirigu,ITA,GK,Torino,Serie A,31,1987,35.2,0,0,0,0,0,0,2,0.0,2,0,0,0,2,2,21,1,0,2018-2019,0.056818181818181816,0.0
2289,Ibrahima Sissoko,MLI,MF,Strasbourg,Ligue 1,20,1997,29.6,60,41,23,34,3,23,55,41.8,32,37,3,34,34,94,39,1,0,2018-2019,1.1486486486486487,2.0270270270270268
2290,Moussa Sissoko,FRA,"MF,FW",Tottenham,Premier League,28,1989,25.9,36,25,18,14,4,15,29,51.7,14,31,4,27,16,52,25,2,0,2018-2019,0.6177606177606177,1.38996138996139
2291,Pione Sisto,DEN,"FW,MF",Celta Vigo,La Liga,23,1995,9.4,4,3,4,0,0,0,9,0.0,9,5,0,5,3,7,3,0,0,2018-2019,0.3191489361702127,0.425531914893617
2292,Antonio Sivera,ESP,GK,Alavés,La Liga,21,1996,3.0,0,0,0,0,0,0,0,0.0,0,0,0,0,0,0,4,1,0,2018-2019,0.0,0.0
2293,Ellyes Skhiri,TUN,MF,Montpellier,Ligue 1,23,1995,34.3,105,58,31,64,10,43,91,47.3,48,60,7,53,60,165,41,0,0,2018-2019,1.7492711370262393,3.0612244897959187
2294,Oliver Skipp,ENG,MF,Tottenham,Premier League,17,2000,2.4,7,3,4,3,0,4,6,66.7,2,2,1,1,1,8,7,0,0,2018-2019,0.4166666666666667,2.916666666666667
2295,Łukasz Skorupski,POL,GK,Bologna,Serie A,27,1991,38.0,0,0,0,0,0,0,0,0.0,0,0,0,0,3,3,12,4,0,2018-2019,0.07894736842105263,0.0
2296,Milan Škriniar,SVK,DF,Inter,Serie A,23,1995,35.0,64,37,46,17,1,38,60,63.3,22,48,29,19,27,91,138,0,0,2018-2019,0.7714285714285715,1.8285714285714285
2297,Steven Skrzybski,GER,"FW,MF",Schalke 04,Bundesliga,25,1992,7.4,9,3,0,6,3,3,11,27.3,8,8,1,7,3,12,2,0,0,2018-2019,0.4054054054054054,1.2162162162162162
2298,Petar Škuletić,SRB,FW,Montpellier,Ligue 1,28,1990,6.7,9,5,4,2,3,1,15,6.7,14,7,1,6,3,12,14,1,0,2018-2019,0.44776119402985076,1.3432835820895521
2299,Callum Slattery,ENG,MF,Southampton,Premier League,19,1999,1.2,4,3,0,4,0,3,7,42.9,4,1,1,0,2,6,1,0,0,2018-2019,1.6666666666666667,3.3333333333333335
2300,Naïm Sliti,TUN,"MF,FW",Dijon,Ligue 1,26,1992,25.4,56,33,24,19,13,15,46,32.6,31,18,0,18,11,67,9,0,0,2018-2019,0.4330708661417323,2.204724409448819
Rk,Player,Nation,Pos,Squad,Comp,0,0,90.0,0,0,3,3,3,Tkl,0,0.0,0,0,0,0,0,0,0,0,0,2018-2019,0.0,0.0
2301,Chris Smalling,ENG,DF,Manchester Utd,Premier League,28,1989,23.6,30,17,21,9,0,11,17,64.7,6,37,25,12,26,56,109,1,0,2018-2019,1.1016949152542372,1.271186440677966
2302,Adam Smith,ENG,"DF,MF",Bournemouth,Premier League,27,1991,23.0,46,32,26,14,6,19,41,46.3,22,26,7,19,31,77,68,1,0,2018-2019,1.3478260869565217,2.0
2303,Emile Smith Rowe,ENG,MF,RB Leipzig,Bundesliga,18,2000,0.3,1,0,0,1,0,1,1,100.0,0,0,0,0,1,2,0,0,0,2018-2019,3.3333333333333335,3.3333333333333335
2304,Tommy Smith,ENG,DF,Huddersfield,Premier League,26,1992,12.7,26,13,14,11,1,10,25,40.0,15,12,4,8,18,44,25,0,0,2018-2019,1.4173228346456694,2.047244094488189
2305,Robert Snodgrass,SCO,MF,West Ham,Premier League,30,1987,24.7,44,27,18,24,2,13,46,28.3,33,24,4,20,11,55,23,0,0,2018-2019,0.4453441295546559,1.7813765182186236
2306,Cédric Soares,POR,DF,Southampton,Premier League,26,1991,16.6,22,16,15,6,1,9,15,60.0,6,21,5,16,22,44,60,2,0,2018-2019,1.325301204819277,1.325301204819277
2307,Cédric Soares,POR,DF,Inter,Serie A,26,1991,2.9,8,6,2,4,2,4,7,57.1,3,4,1,3,2,10,3,0,0,2018-2019,0.6896551724137931,2.7586206896551726
2308,Ramadan Sobhi,EGY,"FW,MF",Huddersfield,Premier League,21,1997,0.9,1,1,0,1,0,0,0,0.0,0,2,0,2,1,2,0,0,0,2018-2019,1.1111111111111112,1.1111111111111112
2309,Marcel Sobottka,GER,MF,Düsseldorf,Bundesliga,24,1994,10.5,30,20,12,18,0,10,19,52.6,9,13,5,8,24,54,17,0,0,2018-2019,2.2857142857142856,2.857142857142857
2310,Rubén Sobrino,ESP,"FW,MF",Alavés,La Liga,26,1992,10.7,16,11,7,6,3,5,13,38.5,8,16,1,15,2,18,13,0,0,2018-2019,0.1869158878504673,1.4953271028037385
2311,Rubén Sobrino,ESP,"FW,MF",Valencia,La Liga,26,1992,2.1,6,3,1,4,1,1,1,100.0,0,1,1,0,1,7,1,0,0,2018-2019,0.47619047619047616,2.857142857142857
2312,Danilo Soddimo,ITA,"MF,FW",Frosinone,Serie A,30,1987,2.8,11,9,3,6,2,3,6,50.0,3,2,1,1,7,18,3,0,0,2018-2019,2.5,3.928571428571429
2313,Alex Sola,ESP,DF,Real Sociedad,La Liga,19,1999,1.0,4,3,0,3,1,3,4,75.0,1,0,0,0,1,5,2,0,0,2018-2019,1.0,4.0
2314,Dominic Solanke,ENG,"FW,MF",Bournemouth,Premier League,20,1997,3.9,8,3,1,4,3,1,8,12.5,7,4,1,3,2,10,9,0,0,2018-2019,0.5128205128205129,2.0512820512820515
2315,Andrés Solano,COL,DF,Atlético Madrid,La Liga,20,1998,0.5,4,3,2,2,0,2,2,100.0,0,1,0,1,0,4,1,0,0,2018-2019,0.0,8.0
2316,Carlos Soler,ESP,MF,Valencia,La Liga,21,1997,27.3,41,28,15,23,3,16,65,24.6,49,46,6,40,19,60,37,0,0,2018-2019,0.6959706959706959,1.5018315018315018
2317,Oumar Solet,FRA,DF,Lyon,Ligue 1,18,2000,0.7,1,0,1,0,0,1,1,100.0,0,1,0,1,0,1,0,0,0,2018-2019,0.0,1.4285714285714286
2318,Yann Sommer,SUI,GK,Gladbach,Bundesliga,29,1988,34.0,2,2,2,0,0,2,2,100.0,0,1,0,1,1,3,12,5,0,2018-2019,0.029411764705882353,0.058823529411764705
2319,Kévin Soni,CMR,"FW,DF",Girona,La Liga,20,1998,0.9,3,2,0,2,1,2,4,50.0,2,3,0,3,1,4,0,0,0,2018-2019,1.1111111111111112,3.333333333333333
2320,Jérémy Sorbon,FRA,DF,Guingamp,Ligue 1,34,1983,29.4,33,20,23,10,0,14,22,63.6,8,33,23,10,34,67,105,2,0,2018-2019,1.1564625850340136,1.1224489795918369
2321,Oliver Sorg,GER,DF,Hannover 96,Bundesliga,28,1990,17.6,42,28,26,16,0,20,43,46.5,23,16,9,7,46,88,47,0,0,2018-2019,2.6136363636363633,2.3863636363636362
2322,David Soria,ESP,GK,Getafe,La Liga,25,1993,37.0,1,0,1,0,0,1,2,50.0,1,2,0,2,1,2,15,6,0,2018-2019,0.02702702702702703,0.02702702702702703
2323,Juan Soriano,ESP,GK,Sevilla,La Liga,20,1997,4.0,0,0,0,0,0,0,0,0.0,0,0,0,0,1,1,1,0,0,2018-2019,0.25,0.0
2324,Roberto Soriano,ITA,MF,Torino,Serie A,27,1991,5.2,9,5,0,5,4,1,8,12.5,7,9,0,9,6,15,1,0,0,2018-2019,1.1538461538461537,1.7307692307692306
2325,Roberto Soriano,ITA,MF,Bologna,Serie A,27,1991,16.5,27,18,14,10,3,8,24,33.3,16,21,2,19,3,30,11,0,0,2018-2019,0.18181818181818182,1.6363636363636365
Rk,Player,Nation,Pos,Squad,Comp,0,0,90.0,0,0,3,3,3,Tkl,0,0.0,0,0,0,0,0,0,0,0,0,2018-2019,0.0,0.0
2326,Stefano Sorrentino,ITA,GK,Chievo,Serie A,39,1979,31.0,1,1,1,0,0,1,2,50.0,1,0,0,0,3,4,10,1,0,2018-2019,0.0967741935483871,0.03225806451612903
2327,Borna Sosa,CRO,"DF,MF",Stuttgart,Bundesliga,20,1998,6.8,13,7,8,4,1,4,9,44.4,5,5,1,4,6,19,34,0,0,2018-2019,0.8823529411764706,1.911764705882353
2328,Sebastian Soto,USA,"MF,FW",Hannover 96,Bundesliga,18,2000,0.3,0,0,0,0,0,0,0,0.0,0,0,0,0,0,0,0,0,0,2018-2019,0.0,0.0
2329,Riccardo Sottil,ITA,"FW,MF",Fiorentina,Serie A,19,1999,0.2,1,1,0,1,0,1,1,100.0,0,0,0,0,0,1,0,0,0,2018-2019,0.0,5.0
2330,Pape Souaré,SEN,DF,Crystal Palace,Premier League,28,1990,0.0,0,0,0,0,0,0,0,0.0,0,0,0,0,1,1,0,0,0,2018-2019,inf,
2331,Adama Soumaoro,FRA,DF,Lille,Ligue 1,26,1992,19.1,14,11,12,2,0,4,6,66.7,2,21,18,3,21,35,92,1,0,2018-2019,1.0994764397905759,0.7329842931937173
2332,Boubakary Soumaré,FRA,MF,Lille,Ligue 1,19,1999,6.3,20,15,9,11,0,10,18,55.6,8,9,3,6,7,27,5,0,0,2018-2019,1.1111111111111112,3.174603174603175
2333,Çağlar Söyüncü,TUR,DF,Leicester City,Premier League,22,1996,4.1,5,2,4,1,0,3,6,50.0,3,8,5,3,7,12,22,3,0,2018-2019,1.707317073170732,1.2195121951219514
2334,Julián Speroni,ARG,GK,Crystal Palace,Premier League,39,1979,1.0,0,0,0,0,0,0,0,0.0,0,0,0,0,0,0,1,2,0,2018-2019,0.0,0.0
2335,Leonardo Spinazzola,ITA,DF,Juventus,Serie A,25,1993,6.7,9,4,4,2,3,4,8,50.0,4,5,0,5,3,12,7,0,0,2018-2019,0.44776119402985076,1.3432835820895521
2336,Nicolás Spolli,ARG,DF,Genoa,Serie A,35,1983,6.0,7,6,3,4,0,0,2,0.0,2,8,6,2,7,14,39,1,0,2018-2019,1.1666666666666667,1.1666666666666667
2337,Marco Sportiello,ITA,GK,Frosinone,Serie A,26,1992,35.0,1,0,1,0,0,1,1,100.0,0,1,0,1,0,1,8,2,0,2018-2019,0.0,0.02857142857142857
2338,Mattia Sprocati,ITA,"FW,MF",Parma,Serie A,25,1993,7.2,10,4,5,5,0,5,11,45.5,6,6,0,6,7,17,6,0,0,2018-2019,0.9722222222222222,1.3888888888888888
2339,Bassem Srarfi,TUN,"FW,MF",Nice,Ligue 1,21,1997,9.1,20,11,8,8,4,6,17,35.3,11,8,0,8,5,25,5,0,0,2018-2019,0.5494505494505495,2.197802197802198
2340,Darijo Srna,CRO,DF,Cagliari,Serie A,36,1982,23.2,24,16,6,13,5,9,14,64.3,5,24,5,19,18,42,66,0,0,2018-2019,0.7758620689655172,1.0344827586206897
2341,Kostas Stafylidis,GRE,DF,Augsburg,Bundesliga,24,1993,10.2,22,14,17,4,1,10,19,52.6,9,13,2,11,15,37,31,0,0,2018-2019,1.4705882352941178,2.1568627450980395
2342,Benjamin Stambouli,FRA,"DF,MF",Schalke 04,Bundesliga,27,1990,19.6,51,31,24,24,3,25,46,54.3,21,41,9,32,32,83,65,2,0,2018-2019,1.6326530612244896,2.6020408163265305
2343,Jozo Stanić,CRO,MF,Augsburg,Bundesliga,19,1999,0.0,0,0,0,0,0,0,0,0.0,0,0,0,0,0,0,0,0,0,2018-2019,,
2344,Junior Stanislas,ENG,"MF,FW",Bournemouth,Premier League,28,1989,11.5,12,6,5,4,3,3,7,42.9,4,8,1,7,2,14,15,0,0,2018-2019,0.17391304347826086,1.0434782608695652
2345,Niklas Stark,GER,DF,Hertha BSC,Bundesliga,23,1995,20.8,34,19,23,11,0,9,24,37.5,15,45,26,19,37,71,141,1,0,2018-2019,1.7788461538461537,1.6346153846153846
2346,Timo Stavitski,FIN,"MF,FW",Caen,Ligue 1,19,1999,0.2,0,0,0,0,0,0,1,0.0,1,0,0,0,0,0,0,0,0,2018-2019,0.0,0.0
2347,Renato Steffen,SUI,"FW,MF",Wolfsburg,Bundesliga,26,1991,16.7,26,17,5,17,4,7,17,41.2,10,13,2,11,16,42,14,0,0,2018-2019,0.9580838323353293,1.5568862275449102
2348,Marc Stendera,GER,MF,Eint Frankfurt,Bundesliga,22,1995,1.2,6,1,2,4,0,2,4,50.0,2,4,1,3,0,6,0,0,0,2018-2019,0.0,5.0
2349,Pascal Stenzel,GER,"DF,MF",Freiburg,Bundesliga,22,1996,16.1,42,26,26,14,2,24,43,55.8,19,16,3,13,30,72,48,1,0,2018-2019,1.8633540372670805,2.6086956521739126
2350,Dale Stephens,ENG,MF,Brighton,Premier League,29,1989,27.6,83,57,37,41,5,28,74,37.8,46,33,13,20,46,129,47,0,0,2018-2019,1.6666666666666665,3.0072463768115942
Rk,Player,Nation,Pos,Squad,Comp,0,0,90.0,0,0,3,3,3,Tkl,0,0.0,0,0,0,0,0,0,0,0,0,2018-2019,0.0,0.0
2351,Jack Stephens,ENG,DF,Southampton,Premier League,24,1994,18.9,25,13,17,7,1,16,28,57.1,12,25,13,12,37,62,96,2,0,2018-2019,1.957671957671958,1.3227513227513228
2352,Mariusz Stępiński,POL,FW,Chievo,Serie A,23,1995,27.5,18,13,1,11,6,1,17,5.9,16,10,2,8,5,23,20,0,0,2018-2019,0.18181818181818182,0.6545454545454545
2353,Raheem Sterling,ENG,FW,Manchester City,Premier League,23,1994,30.8,32,16,11,12,9,9,25,36.0,16,28,3,25,17,49,4,0,0,2018-2019,0.551948051948052,1.0389610389610389
2354,Lars Stindl,GER,"FW,MF",Gladbach,Bundesliga,29,1988,16.8,21,14,8,11,2,3,15,20.0,12,22,2,20,14,35,13,0,0,2018-2019,0.8333333333333333,1.25
2355,Kevin Stöger,AUT,MF,Düsseldorf,Bundesliga,24,1993,23.5,63,35,28,27,8,30,67,44.8,37,32,5,27,31,94,19,1,0,2018-2019,1.3191489361702127,2.6808510638297873
2356,John Stones,ENG,DF,Manchester City,Premier League,24,1994,19.6,16,11,9,5,2,4,9,44.4,5,15,9,6,14,30,64,1,0,2018-2019,0.7142857142857142,0.8163265306122448
2357,Thomas Strakosha,ALB,GK,Lazio,Serie A,23,1995,35.0,1,1,1,0,0,1,1,100.0,0,0,0,0,1,2,8,1,0,2018-2019,0.02857142857142857,0.02857142857142857
2358,Tobias Strobl,GER,"MF,DF",Gladbach,Bundesliga,28,1990,25.5,31,17,17,13,1,9,29,31.0,20,36,14,22,29,60,35,1,0,2018-2019,1.1372549019607843,1.2156862745098038
2359,Kevin Strootman,NED,MF,Roma,Serie A,28,1990,1.0,2,2,1,0,1,0,1,0.0,1,5,0,5,2,4,2,0,0,2018-2019,2.0,2.0
2360,Kevin Strootman,NED,MF,Marseille,Ligue 1,28,1990,21.6,76,40,21,47,8,20,52,38.5,32,24,6,18,24,100,26,0,0,2018-2019,1.111111111111111,3.518518518518518
2361,Jens Stryger Larsen,DEN,DF,Udinese,Serie A,27,1991,35.9,42,20,24,14,4,22,44,50.0,22,27,8,19,26,68,98,1,0,2018-2019,0.7242339832869081,1.16991643454039
2362,Cristhian Stuani,URU,FW,Girona,La Liga,31,1986,30.3,23,13,7,13,3,5,20,25.0,15,13,1,12,4,27,39,0,0,2018-2019,0.132013201320132,0.759075907590759
2363,Leo Štulac,SVN,MF,Parma,Serie A,23,1994,16.1,21,13,10,10,1,4,17,23.5,13,29,13,16,34,55,31,1,0,2018-2019,2.111801242236025,1.3043478260869563
2364,Stefano Sturaro,ITA,"MF,FW",Genoa,Serie A,25,1993,2.4,4,3,0,3,1,2,9,22.2,7,3,1,2,3,7,2,0,0,2018-2019,1.25,1.6666666666666667
2365,Daniel Sturridge,ENG,"FW,MF",Liverpool,Premier League,28,1989,5.7,3,3,1,1,1,2,3,66.7,1,4,0,4,1,4,0,0,0,2018-2019,0.17543859649122806,0.5263157894736842
2366,Damián Suárez,URU,DF,Getafe,La Liga,30,1988,36.0,96,62,43,41,12,53,120,44.2,67,47,6,41,46,142,57,2,0,2018-2019,1.2777777777777777,2.6666666666666665
2367,Denis Suárez,ESP,"MF,FW",Arsenal,Premier League,24,1994,0.8,1,1,0,1,0,0,5,0.0,5,0,0,0,1,2,0,0,0,2018-2019,1.25,1.25
2368,Denis Suárez,ESP,"MF,DF",Barcelona,La Liga,24,1994,0.2,0,0,0,0,0,0,0,0.0,0,1,0,1,0,0,0,0,0,2018-2019,0.0,0.0
2369,Leonardo Suárez,ARG,"FW,MF",Valladolid,La Liga,22,1996,5.7,3,3,2,0,1,2,4,50.0,2,7,1,6,1,4,4,0,0,2018-2019,0.17543859649122806,0.5263157894736842
2370,Luis Suárez,URU,FW,Barcelona,La Liga,31,1987,31.4,18,11,1,6,11,4,10,40.0,6,12,4,8,8,26,24,0,0,2018-2019,0.25477707006369427,0.5732484076433121
2371,Mario Suárez,ESP,MF,Rayo Vallecano,La Liga,31,1987,11.4,37,23,17,17,3,15,28,53.6,13,10,3,7,14,51,17,2,0,2018-2019,1.2280701754385965,3.245614035087719
2372,Mathías Suárez,URU,DF,Montpellier,Ligue 1,22,1996,6.1,20,11,7,10,3,10,23,43.5,13,11,0,11,9,29,18,0,0,2018-2019,1.4754098360655739,3.278688524590164
2373,Danijel Subašić,CRO,GK,Monaco,Ligue 1,33,1984,12.6,0,0,0,0,0,0,1,0.0,1,0,0,0,0,0,6,2,0,2018-2019,0.0,0.0
2374,Neven Subotić,SRB,DF,Saint-Étienne,Ligue 1,29,1988,23.9,44,23,36,7,1,20,39,51.3,19,14,6,8,38,82,107,3,0,2018-2019,1.589958158995816,1.8410041841004186
2375,Isaac Success,NGA,"FW,MF",Watford,Premier League,22,1996,11.7,15,12,4,8,3,2,5,40.0,3,6,0,6,2,17,11,0,0,2018-2019,0.17094017094017094,1.2820512820512822
Rk,Player,Nation,Pos,Squad,Comp,0,0,90.0,0,0,3,3,3,Tkl,0,0.0,0,0,0,0,0,0,0,0,0,2018-2019,0.0,0.0
2376,Niklas Süle,GER,DF,Bayern Munich,Bundesliga,22,1995,29.5,28,23,17,10,1,18,25,72.0,7,23,13,10,40,68,83,0,0,2018-2019,1.3559322033898304,0.9491525423728814
2377,Ki Sung-yueng,KOR,MF,Newcastle Utd,Premier League,29,1989,14.5,14,10,5,8,1,3,12,25.0,9,11,1,10,19,33,20,0,0,2018-2019,1.3103448275862069,0.9655172413793104
2378,Andrew Surman,ENG,MF,Bournemouth,Premier League,31,1986,16.0,11,6,6,5,0,3,13,23.1,10,20,7,13,10,21,34,1,0,2018-2019,0.625,0.6875
2379,Sam Surridge,ENG,"MF,FW",Bournemouth,Premier League,20,1998,0.1,1,0,0,0,1,0,0,0.0,0,0,0,0,0,1,0,0,0,2018-2019,0.0,10.0
2380,Markel Susaeta,ESP,"FW,MF",Athletic Club,La Liga,30,1987,15.3,17,10,4,6,7,3,23,13.0,20,10,1,9,12,29,5,0,0,2018-2019,0.7843137254901961,1.1111111111111112
2381,Suso,ESP,"FW,MF",Milan,Serie A,24,1993,33.5,28,18,10,14,4,10,41,24.4,31,26,1,25,16,44,3,0,0,2018-2019,0.47761194029850745,0.835820895522388
2382,Markus Suttner,AUT,"DF,MF",Düsseldorf,Bundesliga,31,1987,5.4,10,7,5,4,1,4,8,50.0,4,8,3,5,8,18,10,0,0,2018-2019,1.4814814814814814,1.8518518518518516
2383,Mattias Svanberg,SWE,MF,Bologna,Serie A,19,1999,13.1,22,11,14,7,1,11,25,44.0,14,25,6,19,11,33,16,2,0,2018-2019,0.8396946564885497,1.6793893129770994
2384,Sanasi Sy,FRA,MF,Amiens,Ligue 1,19,1999,0.0,0,0,0,0,0,0,0,0.0,0,0,0,0,0,0,0,0,0,2018-2019,,
2385,Seydou Sy,SEN,GK,Monaco,Ligue 1,22,1995,2.5,0,0,0,0,0,0,0,0.0,0,0,0,0,0,0,0,1,0,2018-2019,0.0,0.0
2386,Issiaga Sylla,GUI,"DF,MF",Toulouse,Ligue 1,24,1994,22.2,54,36,30,24,0,28,53,52.8,25,36,10,26,39,93,77,0,0,2018-2019,1.7567567567567568,2.4324324324324325
2387,Moussa Sylla,MLI,"FW,MF",Monaco,Ligue 1,18,1999,8.5,6,4,4,1,1,2,6,33.3,4,5,2,3,2,8,5,0,0,2018-2019,0.23529411764705882,0.7058823529411765
2388,Eddy Sylvestre,FRA,"FW,MF",Nice,Ligue 1,18,1999,3.0,3,2,0,3,0,3,9,33.3,6,1,0,1,0,3,0,0,0,2018-2019,0.0,1.0
2389,Ádám Szalai,HUN,FW,Hoffenheim,Bundesliga,30,1987,18.1,19,13,3,12,4,4,11,36.4,7,8,1,7,4,23,8,0,0,2018-2019,0.22099447513812154,1.0497237569060773
2390,Wojciech Szczęsny,POL,GK,Juventus,Serie A,28,1990,28.0,2,1,2,0,0,1,1,100.0,0,0,0,0,1,3,8,2,0,2018-2019,0.03571428571428571,0.07142857142857142
2391,Alexander Sørloth,NOR,FW,Crystal Palace,Premier League,22,1995,2.1,2,1,0,0,2,1,2,50.0,1,0,0,0,0,2,3,0,0,2018-2019,0.0,0.9523809523809523
2392,Franck Tabanou,FRA,DF,Guingamp,Ligue 1,29,1989,2.0,4,3,4,0,0,1,2,50.0,1,0,0,0,6,10,15,0,0,2018-2019,3.0,2.0
2393,Jonathan Tah,GER,DF,Leverkusen,Bundesliga,22,1996,32.6,44,30,30,10,4,17,32,53.1,15,39,26,13,45,89,142,1,0,2018-2019,1.3803680981595092,1.3496932515337423
2394,Flavien Tait,FRA,"MF,FW",Angers,Ligue 1,25,1993,33.2,58,35,33,16,9,23,59,39.0,36,29,2,27,28,86,15,0,0,2018-2019,0.8433734939759036,1.7469879518072287
2395,Adrien Tameze,CMR,MF,Nice,Ligue 1,24,1994,32.7,74,44,32,31,11,39,92,42.4,53,53,12,41,56,130,59,1,0,2018-2019,1.712538226299694,2.262996941896024
2396,Strahinja Tanasijević,SRB,"DF,MF",Chievo,Serie A,21,1997,0.2,0,0,0,0,0,0,0,0.0,0,0,0,0,0,0,0,0,0,2018-2019,0.0,0.0
2397,Matt Targett,ENG,DF,Southampton,Premier League,22,1995,13.2,27,19,15,7,5,12,26,46.2,14,19,3,16,27,54,42,0,0,2018-2019,2.0454545454545454,2.0454545454545454
2398,Rodrigo Tarín,ESP,DF,Leganés,La Liga,22,1996,15.9,22,14,15,5,2,7,10,70.0,3,11,5,6,31,53,79,0,0,2018-2019,1.949685534591195,1.3836477987421383
2399,James Tarkowski,ENG,DF,Burnley,Premier League,25,1992,34.3,71,36,52,18,1,29,50,58.0,21,72,56,16,42,113,240,2,0,2018-2019,1.2244897959183674,2.0699708454810497
2400,Ciprian Tătărușanu,ROU,GK,Nantes,Ligue 1,32,1986,26.6,0,0,0,0,0,0,0,0.0,0,0,0,0,2,2,20,0,0,2018-2019,0.07518796992481203,0.0
Rk,Player,Nation,Pos,Squad,Comp,0,0,90.0,0,0,3,3,3,Tkl,0,0.0,0,0,0,0,0,0,0,0,0,2018-2019,0.0,0.0
2401,Júlio Tavares,CPV,FW,Dijon,Ligue 1,29,1988,31.2,15,9,1,7,7,3,9,33.3,6,17,3,14,13,28,51,0,0,2018-2019,0.4166666666666667,0.4807692307692308
2402,Júnior Tavares,BRA,DF,Sampdoria,Serie A,21,1996,2.0,2,1,1,1,0,2,4,50.0,2,0,0,0,2,4,1,0,0,2018-2019,1.0,1.0
2403,Taleb Tawatha,ISR,"FW,DF",Eint Frankfurt,Bundesliga,26,1992,1.4,1,1,1,0,0,1,2,50.0,1,0,0,0,0,1,1,0,0,2018-2019,0.0,0.7142857142857143
2404,Charlie Taylor,ENG,DF,Burnley,Premier League,24,1993,36.0,55,26,37,15,3,24,50,48.0,26,74,35,39,40,95,120,0,0,2018-2019,1.1111111111111112,1.5277777777777777
2405,Malik Tchokounté,FRA,"FW,MF",Caen,Ligue 1,29,1988,16.4,21,13,6,12,3,5,10,50.0,5,11,0,11,6,27,26,0,0,2018-2019,0.3658536585365854,1.2804878048780488
2406,Aurélien Tchouaméni,FRA,MF,Bordeaux,Ligue 1,18,2000,7.8,24,12,10,14,0,7,18,38.9,11,11,5,6,21,45,14,0,0,2018-2019,2.6923076923076925,3.076923076923077
2407,Georg Teigl,AUT,"MF,FW",Augsburg,Bundesliga,27,1991,3.3,5,3,4,0,1,2,2,100.0,0,1,0,1,7,12,5,1,0,2018-2019,2.121212121212121,1.5151515151515151
2408,Cristian Tello,ESP,"DF,FW",Betis,La Liga,26,1991,17.5,32,20,18,9,5,17,35,48.6,18,19,0,19,16,48,17,1,0,2018-2019,0.9142857142857143,1.8285714285714285
2409,Łukasz Teodorczyk,POL,FW,Udinese,Serie A,27,1991,4.4,4,2,2,2,0,2,8,25.0,6,8,2,6,1,5,4,0,0,2018-2019,0.22727272727272727,0.9090909090909091
2410,Hidde ter Avest,NED,"DF,FW",Udinese,Serie A,21,1997,10.8,26,14,17,6,3,14,20,70.0,6,14,3,11,10,36,39,1,0,2018-2019,0.9259259259259258,2.4074074074074074
2411,Marc-André ter Stegen,GER,GK,Barcelona,La Liga,26,1992,35.0,0,0,0,0,0,0,3,0.0,3,0,0,0,2,2,5,2,0,2018-2019,0.05714285714285714,0.0
2412,Pietro Terracciano,ITA,GK,Fiorentina,Serie A,28,1990,2.0,0,0,0,0,0,0,0,0.0,0,0,0,0,0,0,1,1,0,2018-2019,0.0,0.0
2413,Pietro Terracciano,ITA,GK,Empoli,Serie A,28,1990,8.0,0,0,0,0,0,0,0,0.0,0,0,0,0,1,1,4,0,0,2018-2019,0.125,0.0
2414,Marco Terrazzino,GER,"MF,FW",Freiburg,Bundesliga,27,1991,5.7,6,3,4,2,0,1,7,14.3,6,5,2,3,3,9,2,0,0,2018-2019,0.5263157894736842,1.0526315789473684
2415,Martin Terrier,FRA,FW,Lyon,Ligue 1,21,1997,16.5,23,13,5,13,5,9,23,39.1,14,17,2,15,6,29,14,0,0,2018-2019,0.36363636363636365,1.393939393939394
2416,Kenny Tete,NED,DF,Lyon,Ligue 1,22,1995,11.6,30,23,11,16,3,13,19,68.4,6,13,5,8,18,48,29,0,0,2018-2019,1.5517241379310345,2.586206896551724
2417,Cedric Teuchert,GER,"FW,MF",Schalke 04,Bundesliga,21,1997,1.8,0,0,0,0,0,0,0,0.0,0,2,0,2,1,1,0,0,0,2018-2019,0.5555555555555556,0.0
2418,Florian Thauvin,FRA,"FW,MF",Marseille,Ligue 1,25,1993,29.0,42,23,10,21,11,16,35,45.7,19,19,1,18,8,50,4,0,0,2018-2019,0.27586206896551724,1.4482758620689655
2419,Cyril Théréau,FRA,"FW,MF",Fiorentina,Serie A,35,1983,0.3,0,0,0,0,0,0,0,0.0,0,0,0,0,0,0,1,0,0,2018-2019,0.0,0.0
2420,Cyril Théréau,FRA,FW,Cagliari,Serie A,35,1983,1.5,1,1,0,1,0,1,1,100.0,0,0,0,0,0,1,2,0,0,2018-2019,0.0,0.6666666666666666
2421,Sada Thioub,SEN,"MF,FW",Nîmes,Ligue 1,23,1995,27.5,30,19,13,10,7,20,45,44.4,25,29,1,28,16,46,11,0,0,2018-2019,0.5818181818181818,1.0909090909090908
2422,Romain Thomas,FRA,DF,Angers,Ligue 1,30,1988,26.6,35,26,25,10,0,14,19,73.7,5,31,24,7,29,64,133,1,0,2018-2019,1.0902255639097744,1.3157894736842104
2423,Adrien Thomasson,FRA,"MF,FW",Strasbourg,Ligue 1,24,1993,27.5,54,27,18,23,13,21,66,31.8,45,29,5,24,18,72,12,1,0,2018-2019,0.6545454545454545,1.9636363636363636
2424,Erik Thommy,GER,"MF,FW",Stuttgart,Bundesliga,23,1994,8.8,5,3,3,1,1,1,7,14.3,6,16,1,15,14,19,4,0,0,2018-2019,1.5909090909090908,0.5681818181818181
2425,Marcus Thuram,FRA,"FW,MF",Guingamp,Ligue 1,20,1997,28.6,45,28,23,15,7,20,43,46.5,23,24,1,23,10,55,14,0,0,2018-2019,0.34965034965034963,1.5734265734265733
Rk,Player,Nation,Pos,Squad,Comp,0,0,90.0,0,0,3,3,3,Tkl,0,0.0,0,0,0,0,0,0,0,0,0,2018-2019,0.0,0.0
2426,Youri Tielemans,BEL,MF,Leicester City,Premier League,21,1997,12.1,17,8,5,9,3,5,17,29.4,12,13,2,11,5,22,13,1,0,2018-2019,0.4132231404958678,1.4049586776859504
2427,Youri Tielemans,BEL,MF,Monaco,Ligue 1,21,1997,18.7,45,24,17,23,5,24,47,51.1,23,20,3,17,18,63,22,0,0,2018-2019,0.9625668449197862,2.4064171122994655
2428,Timmy Tillman,GER,"FW,MF",Nürnberg,Bundesliga,19,1999,2.3,0,0,0,0,0,0,4,0.0,4,3,0,3,3,3,0,2,0,2018-2019,1.3043478260869565,0.0
2429,Cheick Timite,CIV,"FW,MF",Amiens,Ligue 1,20,1997,16.2,18,13,5,7,6,3,16,18.8,13,14,2,12,12,30,13,0,0,2018-2019,0.7407407407407408,1.1111111111111112
2430,David Timor,ESP,MF,Girona,La Liga,28,1989,1.8,2,2,1,1,0,0,1,0.0,1,1,1,0,3,5,3,0,0,2018-2019,1.6666666666666665,1.1111111111111112
2431,George Timotheou,AUS,DF,Schalke 04,Bundesliga,21,1997,1.0,3,3,3,0,0,0,0,0.0,0,1,1,0,1,4,4,0,0,2018-2019,1.0,3.0
2432,Marcel Tisserand,COD,DF,Wolfsburg,Bundesliga,25,1993,9.8,14,9,9,5,0,10,13,76.9,3,12,5,7,20,34,42,1,0,2018-2019,2.0408163265306123,1.4285714285714284
2433,Tito,ESP,DF,Rayo Vallecano,La Liga,33,1985,12.2,14,9,12,2,0,7,22,31.8,15,22,2,20,17,31,41,0,0,2018-2019,1.3934426229508197,1.1475409836065575
2434,Jean-Clair Todibo,FRA,DF,Barcelona,La Liga,18,1999,1.7,7,2,4,3,0,5,6,83.3,1,1,0,1,3,10,8,0,0,2018-2019,1.7647058823529411,4.11764705882353
2435,Jean-Clair Todibo,FRA,DF,Toulouse,Ligue 1,18,1999,9.3,21,18,19,2,0,11,13,84.6,2,14,5,9,14,35,62,2,0,2018-2019,1.5053763440860215,2.258064516129032
2436,Karl Toko Ekambi,CMR,"FW,MF",Villarreal,La Liga,25,1992,23.8,11,8,1,6,4,2,14,14.3,12,8,0,8,11,22,9,1,0,2018-2019,0.4621848739495798,0.4621848739495798
2437,Corentin Tolisso,FRA,MF,Bayern Munich,Bundesliga,23,1994,0.6,0,0,0,0,0,0,2,0.0,2,1,1,0,0,0,0,0,0,2018-2019,0.0,0.0
2438,Rafael Tolói,ITA,DF,Atalanta,Serie A,27,1990,19.4,27,17,15,9,3,16,24,66.7,8,28,10,18,33,60,54,1,0,2018-2019,1.7010309278350517,1.3917525773195878
2439,Raúl de Tomás,ESP,FW,Rayo Vallecano,La Liga,23,1994,31.3,8,3,0,7,1,0,12,0.0,12,18,4,14,9,17,45,0,0,2018-2019,0.28753993610223644,0.25559105431309903
2440,James Tomkins,ENG,DF,Crystal Palace,Premier League,29,1989,28.4,34,20,27,7,0,15,28,53.6,13,23,10,13,34,68,184,3,0,2018-2019,1.1971830985915493,1.1971830985915493
2441,Nenad Tomović,SRB,DF,Chievo,Serie A,30,1987,8.2,9,7,5,4,0,7,10,70.0,3,5,1,4,13,22,34,0,0,2018-2019,1.5853658536585367,1.0975609756097562
2442,Lorenzo Tonelli,ITA,DF,Sampdoria,Serie A,28,1990,18.4,31,22,19,9,3,15,19,78.9,4,27,21,6,24,55,92,0,0,2018-2019,1.3043478260869565,1.6847826086956523
2443,Toño,ESP,"DF,FW",Levante,La Liga,28,1989,19.6,17,13,12,3,2,10,21,47.6,11,20,5,15,14,31,42,0,0,2018-2019,0.7142857142857142,0.8673469387755102
2444,Ömer Toprak,TUR,DF,Dortmund,Bundesliga,29,1989,2.6,1,1,0,1,0,0,1,0.0,1,1,1,0,0,1,7,0,0,2018-2019,0.0,0.3846153846153846
2445,Lucas Torreira,URU,MF,Arsenal,Premier League,22,1996,26.5,65,39,24,32,9,25,57,43.9,32,34,7,27,41,106,33,2,0,2018-2019,1.5471698113207548,2.452830188679245
2446,Daniel Torres,COL,MF,Alavés,La Liga,28,1989,0.8,2,1,2,0,0,0,3,0.0,3,0,0,0,2,4,0,0,0,2018-2019,2.5,2.5
2447,Ferrán Torres,ESP,MF,Valencia,La Liga,18,2000,9.4,15,8,4,8,3,5,11,45.5,6,10,1,9,10,25,9,0,0,2018-2019,1.0638297872340425,1.5957446808510638
2448,Lucas Torró,ESP,MF,Eint Frankfurt,Bundesliga,24,1994,6.2,14,7,5,7,2,5,11,45.5,6,12,1,11,14,28,13,0,0,2018-2019,2.258064516129032,2.258064516129032
2449,Jordan Torunarigha,GER,DF,Hertha BSC,Bundesliga,20,1997,12.9,34,30,23,10,1,18,28,64.3,10,19,7,12,29,63,55,0,0,2018-2019,2.248062015503876,2.635658914728682
2450,Cenk Tosun,TUR,FW,Everton,Premier League,27,1991,11.8,13,9,3,6,4,4,13,30.8,9,12,0,12,5,18,3,0,0,2018-2019,0.423728813559322,1.1016949152542372
Rk,Player,Nation,Pos,Squad,Comp,0,0,90.0,0,0,3,3,3,Tkl,0,0.0,0,0,0,0,0,0,0,0,0,2018-2019,0.0,0.0
2451,Abdoulaye Touré,GUI,MF,Nantes,Ligue 1,24,1994,30.5,48,31,14,28,6,19,56,33.9,37,25,10,15,47,95,29,1,0,2018-2019,1.540983606557377,1.5737704918032787
2452,Almamy Touré,MLI,DF,Monaco,Ligue 1,22,1996,3.8,13,6,6,7,0,3,10,30.0,7,3,1,2,11,24,12,0,0,2018-2019,2.8947368421052633,3.4210526315789473
2453,Almamy Touré,MLI,"DF,MF",Eint Frankfurt,Bundesliga,22,1996,5.8,18,11,7,11,0,5,8,62.5,3,4,1,3,9,27,25,0,0,2018-2019,1.5517241379310345,3.103448275862069
2454,Lucas Tousart,FRA,MF,Lyon,Ligue 1,21,1997,19.2,74,38,33,34,7,25,59,42.4,34,30,13,17,26,100,27,0,0,2018-2019,1.3541666666666667,3.854166666666667
2455,Andros Townsend,ENG,"FW,MF",Crystal Palace,Premier League,27,1991,33.4,62,35,38,16,8,35,89,39.3,54,48,5,43,38,100,28,0,0,2018-2019,1.1377245508982037,1.8562874251497006
2456,Adama Traoré,ESP,"FW,MF",Wolves,Premier League,22,1996,10.0,16,13,11,3,2,4,9,44.4,5,11,0,11,6,22,7,0,0,2018-2019,0.6,1.6
2457,Adama Traoré,MLI,MF,Monaco,Ligue 1,23,1995,2.7,2,1,1,0,1,1,4,25.0,3,4,0,4,3,5,1,0,0,2018-2019,1.111111111111111,0.7407407407407407
2458,Bertrand Traoré,BFA,FW,Lyon,Ligue 1,22,1995,23.5,36,22,19,13,4,12,26,46.2,14,23,5,18,15,51,18,0,0,2018-2019,0.6382978723404256,1.5319148936170213
2459,Charles Traore,MLI,"DF,FW",Nantes,Ligue 1,26,1992,12.9,40,20,22,16,2,23,34,67.6,11,16,3,13,19,59,46,0,0,2018-2019,1.4728682170542635,3.1007751937984493
2460,Cheick Traoré,MLI,DF,Guingamp,Ligue 1,23,1995,16.8,37,21,23,11,3,15,25,60.0,10,13,3,10,23,60,46,1,0,2018-2019,1.369047619047619,2.202380952380952
2461,Gaoussou Traoré,MLI,MF,Amiens,Ligue 1,18,1999,1.2,10,5,6,4,0,4,8,50.0,4,1,0,1,0,10,0,0,0,2018-2019,0.0,8.333333333333334
2462,Hamari Traoré,MLI,DF,Rennes,Ligue 1,26,1992,33.0,61,33,32,27,2,36,71,50.7,35,39,11,28,44,105,82,0,0,2018-2019,1.3333333333333333,1.8484848484848484
2463,Ibrahima Traoré,GUI,"FW,MF",Gladbach,Bundesliga,30,1988,6.1,12,6,8,2,2,3,11,27.3,8,3,1,2,3,15,1,0,0,2018-2019,0.49180327868852464,1.9672131147540985
2464,Ismaël Traoré,CIV,DF,Angers,Ligue 1,31,1986,29.3,27,11,19,8,0,9,24,37.5,15,27,16,11,42,69,120,2,0,2018-2019,1.4334470989761092,0.9215017064846416
2465,Kevin Trapp,GER,GK,Eint Frankfurt,Bundesliga,28,1990,32.6,0,0,0,0,0,0,2,0.0,2,0,0,0,0,0,17,1,0,2018-2019,0.0,0.0
2466,Mark Travers,IRL,GK,Bournemouth,Premier League,19,1999,2.0,0,0,0,0,0,0,0,0.0,0,0,0,0,0,0,2,0,0,2018-2019,0.0,0.0
2467,Óscar Trejo,ARG,"MF,FW",Rayo Vallecano,La Liga,30,1988,19.6,57,41,21,25,11,8,33,24.2,25,24,2,22,18,75,15,0,0,2018-2019,0.9183673469387754,2.9081632653061225
2468,Driss Trichard,FRA,DF,Bordeaux,Ligue 1,23,1995,1.0,2,2,2,0,0,1,1,100.0,0,1,0,1,1,3,4,0,0,2018-2019,1.0,2.0
2469,Manu Trigueros,ESP,MF,Villarreal,La Liga,26,1991,17.2,46,35,18,23,5,20,57,35.1,37,17,6,11,16,62,17,0,0,2018-2019,0.9302325581395349,2.674418604651163
2470,Kieran Trippier,ENG,DF,Tottenham,Premier League,27,1990,25.3,67,37,43,16,8,37,62,59.7,25,38,5,33,23,90,77,2,0,2018-2019,0.9090909090909091,2.6482213438735176
2471,William Troost-Ekong,NGA,DF,Udinese,Serie A,24,1993,34.0,31,15,21,9,1,13,24,54.2,11,53,41,12,40,71,200,2,0,2018-2019,1.1764705882352942,0.9117647058823529
2472,Marcello Trotta,ITA,FW,Frosinone,Serie A,25,1992,4.4,7,6,2,4,1,1,3,33.3,2,2,1,1,3,10,3,0,0,2018-2019,0.6818181818181818,1.5909090909090908
2473,Marcello Trotta,ITA,MF,Sassuolo,Serie A,25,1992,0.1,0,0,0,0,0,0,1,0.0,1,0,0,0,0,0,0,0,0,2018-2019,0.0,0.0
2474,Philipp Tschauner,GER,GK,Hannover 96,Bundesliga,32,1985,1.0,0,0,0,0,0,0,0,0.0,0,0,0,0,0,0,0,0,0,2018-2019,0.0,0.0
2475,Marco Tumminello,ITA,"FW,DF",Atalanta,Serie A,19,1998,0.1,0,0,0,0,0,0,0,0.0,0,0,0,0,0,0,0,0,0,2018-2019,0.0,0.0
Rk,Player,Nation,Pos,Squad,Comp,0,0,90.0,0,0,3,3,3,Tkl,0,0.0,0,0,0,0,0,0,0,0,0,2018-2019,0.0,0.0
2476,Patrick Twumasi,GHA,"MF,FW",Alavés,La Liga,24,1994,1.9,3,3,2,0,1,0,4,0.0,4,2,0,2,1,4,1,0,0,2018-2019,0.5263157894736842,1.5789473684210527
2477,Salih Uçan,TUR,MF,Empoli,Serie A,24,1994,2.9,10,4,3,5,2,3,10,30.0,7,4,0,4,6,16,2,0,0,2018-2019,2.0689655172413794,3.4482758620689657
2478,Anthony Ujah,NGA,FW,Mainz 05,Bundesliga,27,1990,8.2,2,0,0,1,1,1,2,50.0,1,7,2,5,1,3,10,0,0,2018-2019,0.12195121951219513,0.24390243902439027
2479,Sven Ulreich,GER,GK,Bayern Munich,Bundesliga,29,1988,8.4,0,0,0,0,0,0,0,0.0,0,0,0,0,0,0,2,1,0,2018-2019,0.0,0.0
2480,Samuel Umtiti,FRA,DF,Barcelona,La Liga,24,1993,13.2,8,5,3,4,1,4,6,66.7,2,10,8,2,18,26,28,2,0,2018-2019,1.3636363636363638,0.6060606060606061
2481,Enes Ünal,TUR,FW,Valladolid,La Liga,21,1997,23.9,17,10,3,4,10,4,24,16.7,20,17,4,13,2,19,18,0,0,2018-2019,0.08368200836820085,0.7112970711297072
2482,Cengiz Ünder,TUR,FW,Roma,Serie A,21,1997,15.3,6,3,3,3,0,2,11,18.2,9,7,0,7,13,19,5,0,0,2018-2019,0.8496732026143791,0.39215686274509803
2483,Joel Untersee,SUI,DF,Empoli,Serie A,24,1994,1.4,3,2,1,2,0,2,3,66.7,1,2,1,1,1,4,5,1,0,2018-2019,0.7142857142857143,2.142857142857143
2484,Dayot Upamecano,FRA,DF,RB Leipzig,Bundesliga,19,1998,14.4,22,16,14,8,0,15,18,83.3,3,19,5,14,33,55,47,0,0,2018-2019,2.2916666666666665,1.5277777777777777
2485,Takashi Usami,JPN,"MF,FW",Düsseldorf,Bundesliga,26,1992,9.8,18,12,7,11,0,9,26,34.6,17,15,2,13,8,26,13,1,0,2018-2019,0.8163265306122448,1.8367346938775508
2486,Mark Uth,GER,"FW,MF",Schalke 04,Bundesliga,26,1991,15.6,20,11,8,8,4,4,23,17.4,19,19,2,17,8,28,12,0,0,2018-2019,0.5128205128205129,1.2820512820512822
2487,Tomáš Vaclík,CZE,GK,Sevilla,La Liga,29,1989,33.0,0,0,0,0,0,0,1,0.0,1,0,0,0,0,0,9,6,0,2018-2019,0.0,0.0
2488,Valentín Vada,ARG,MF,Bordeaux,Ligue 1,22,1996,0.4,2,1,0,2,0,1,1,100.0,0,0,0,0,0,2,0,0,0,2018-2019,0.0,5.0
2489,Valentín Vada,ARG,MF,Saint-Étienne,Ligue 1,22,1996,4.5,7,4,4,3,0,3,12,25.0,9,4,1,3,7,14,4,0,0,2018-2019,1.5555555555555556,1.5555555555555556
2490,William Vainqueur,FRA,MF,Monaco,Ligue 1,29,1988,0.9,6,3,4,2,0,1,1,100.0,0,1,0,1,0,6,0,0,0,2018-2019,0.0,6.666666666666666
2491,Mirko Valdifiori,ITA,MF,SPAL,Serie A,32,1986,7.4,20,15,12,7,1,8,14,57.1,6,4,2,2,5,25,9,0,0,2018-2019,0.6756756756756757,2.7027027027027026
2492,Pierrick Valdivia,FRA,MF,Nîmes,Ligue 1,30,1988,0.3,1,1,0,1,0,1,2,50.0,1,1,0,1,1,2,0,0,0,2018-2019,3.3333333333333335,3.3333333333333335
2493,Antonio Valencia,ECU,DF,Manchester Utd,Premier League,32,1985,5.2,8,6,2,4,2,3,4,75.0,1,9,0,9,5,13,10,0,0,2018-2019,0.9615384615384615,1.5384615384615383
2494,Enrico Valentini,ITA,DF,Nürnberg,Bundesliga,29,1989,14.4,44,27,31,10,3,22,40,55.0,18,17,3,14,13,57,58,0,0,2018-2019,0.9027777777777778,3.0555555555555554
2495,Borja Valero,ESP,MF,Inter,Serie A,33,1985,13.7,22,19,9,10,3,8,30,26.7,22,11,1,10,16,38,27,2,0,2018-2019,1.1678832116788322,1.6058394160583942
2496,Yan Valery,TUN,DF,Southampton,Premier League,19,1999,19.0,42,36,26,10,6,16,29,55.2,13,24,3,21,22,64,72,1,0,2018-2019,1.1578947368421053,2.210526315789474
2497,Jesús Vallejo,ESP,DF,Real Madrid,La Liga,21,1997,3.5,6,5,4,2,0,5,6,83.3,1,4,4,0,7,13,12,0,0,2018-2019,2.0,1.7142857142857142
2498,Theo Valls,FRA,MF,Nîmes,Ligue 1,22,1995,19.7,37,21,16,19,2,15,43,34.9,28,17,4,13,22,59,15,0,0,2018-2019,1.116751269035533,1.8781725888324874
2499,Mattia Valoti,ITA,MF,SPAL,Serie A,24,1993,13.6,33,19,13,14,6,13,29,44.8,16,23,0,23,19,52,17,1,0,2018-2019,1.397058823529412,2.4264705882352944
2500,Federico Valverde,URU,MF,Real Madrid,La Liga,20,1998,7.3,12,8,3,7,2,5,11,45.5,6,10,2,8,21,33,10,0,0,2018-2019,2.8767123287671232,1.6438356164383563
Rk,Player,Nation,Pos,Squad,Comp,0,0,90.0,0,0,3,3,3,Tkl,0,0.0,0,0,0,0,0,0,0,0,0,2018-2019,0.0,0.0
2501,Luca Valzania,ITA,MF,Frosinone,Serie A,22,1996,10.0,21,12,7,10,4,13,33,39.4,20,18,0,18,16,37,8,1,0,2018-2019,1.6,2.1
2502,Luca Valzania,ITA,MF,Atalanta,Serie A,22,1996,0.8,5,4,2,3,0,3,5,60.0,2,0,0,0,1,6,0,0,0,2018-2019,1.25,6.25
2503,Virgil van Dijk,NED,DF,Liverpool,Premier League,27,1991,37.6,38,28,26,11,1,14,14,100.0,0,29,18,11,40,78,201,1,0,2018-2019,1.0638297872340425,1.0106382978723405
2504,Raphaël Varane,FRA,DF,Real Madrid,La Liga,25,1993,30.6,33,18,25,7,1,15,19,78.9,4,21,9,12,32,65,141,1,0,2018-2019,1.0457516339869282,1.0784313725490196
2505,Jamie Vardy,ENG,FW,Leicester City,Premier League,31,1987,30.3,14,8,3,6,5,4,17,23.5,13,16,1,15,6,20,28,0,0,2018-2019,0.198019801980198,0.46204620462046203
2506,Franco Vázquez,ARG,MF,Sevilla,La Liga,29,1989,25.3,51,37,21,21,9,23,66,34.8,43,25,2,23,23,74,27,1,0,2018-2019,0.9090909090909091,2.015810276679842
2507,Kevin Vázquez,ESP,DF,Celta Vigo,La Liga,25,1993,2.4,6,5,5,0,1,4,7,57.1,3,8,3,5,2,8,9,0,0,2018-2019,0.8333333333333334,2.5
2508,Lucas Vázquez,ESP,"FW,MF",Real Madrid,La Liga,27,1991,16.8,43,26,11,21,11,15,41,36.6,26,16,1,15,12,55,11,0,0,2018-2019,0.7142857142857143,2.5595238095238093
2509,Matías Vecino,URU,MF,Inter,Serie A,26,1991,22.4,50,39,18,23,9,26,53,49.1,27,38,9,29,17,67,22,0,0,2018-2019,0.7589285714285715,2.232142857142857
2510,Koke Vegas,ESP,GK,Levante,La Liga,22,1995,1.0,0,0,0,0,0,0,0,0.0,0,0,0,0,0,0,0,0,0,2018-2019,0.0,0.0
2511,Emiliano Velázquez,URU,DF,Rayo Vallecano,La Liga,24,1994,14.2,49,32,38,9,2,20,34,58.8,14,29,7,22,47,96,106,1,0,2018-2019,3.3098591549295775,3.450704225352113
2512,Miloš Veljković,SRB,DF,Werder Bremen,Bundesliga,22,1995,20.9,36,24,29,6,1,22,37,59.5,15,27,13,14,27,63,111,0,0,2018-2019,1.291866028708134,1.722488038277512
2513,Miguel Veloso,POR,MF,Genoa,Serie A,32,1986,14.0,31,20,14,13,4,9,26,34.6,17,12,1,11,13,44,21,0,0,2018-2019,0.9285714285714286,2.2142857142857144
2514,Daniele Verde,ITA,"MF,FW",Valladolid,La Liga,22,1996,7.3,6,3,2,2,2,1,6,16.7,5,3,0,3,7,13,3,1,0,2018-2019,0.9589041095890412,0.8219178082191781
2515,Francesco Verde,ITA,FW,Cagliari,Serie A,19,1999,0.1,1,0,0,1,0,0,0,0.0,0,0,0,0,0,1,0,0,0,2018-2019,0.0,10.0
2516,Simone Verdi,ITA,"MF,FW",Napoli,Serie A,26,1992,7.8,16,11,5,9,2,8,16,50.0,8,6,0,6,4,20,3,0,0,2018-2019,0.5128205128205129,2.0512820512820515
2517,Jordan Veretout,FRA,MF,Fiorentina,Serie A,25,1993,32.7,64,40,22,31,11,21,52,40.4,31,33,7,26,46,110,54,2,0,2018-2019,1.4067278287461773,1.9571865443425074
2518,Paul Verhaegh,NED,DF,Wolfsburg,Bundesliga,34,1983,2.0,1,0,0,0,1,1,2,50.0,1,5,0,5,1,2,7,1,0,2018-2019,0.5,0.5
2519,Thomas Vermaelen,BEL,DF,Barcelona,La Liga,32,1985,6.5,6,4,3,3,0,3,7,42.9,4,4,2,2,6,12,21,0,0,2018-2019,0.9230769230769231,0.9230769230769231
2520,Marco Verratti,ITA,MF,Paris S-G,Ligue 1,25,1992,20.9,72,42,25,39,8,36,81,44.4,45,26,1,25,18,90,8,2,0,2018-2019,0.861244019138756,3.444976076555024
2521,Jan Vertonghen,BEL,DF,Tottenham,Premier League,31,1987,21.2,39,24,17,20,2,14,24,58.3,10,18,11,7,32,71,81,0,0,2018-2019,1.509433962264151,1.839622641509434
2522,Freddie Veseli,ALB,DF,Empoli,Serie A,25,1992,28.2,34,21,16,15,3,19,27,70.4,8,28,17,11,30,64,99,1,0,2018-2019,1.0638297872340425,1.2056737588652482
2523,Mikel Vesga,ESP,MF,Leganés,La Liga,25,1993,23.0,50,32,27,15,8,20,82,24.4,62,42,4,38,39,89,26,0,0,2018-2019,1.6956521739130435,2.1739130434782608
2524,Jannik Vestergaard,DEN,DF,Southampton,Premier League,25,1992,22.5,53,33,37,13,3,28,45,62.2,17,35,20,15,35,88,174,1,0,2018-2019,1.5555555555555556,2.3555555555555556
2525,Rúben Vezo,POR,DF,Levante,La Liga,24,1994,14.9,26,17,17,8,1,14,22,63.6,8,23,20,3,19,45,88,0,0,2018-2019,1.2751677852348993,1.74496644295302
Rk,Player,Nation,Pos,Squad,Comp,0,0,90.0,0,0,3,3,3,Tkl,0,0.0,0,0,0,0,0,0,0,0,0,2018-2019,0.0,0.0
2526,Rúben Vezo,POR,DF,Valencia,La Liga,24,1994,2.2,2,1,2,0,0,2,4,50.0,2,2,1,1,2,4,10,0,0,2018-2019,0.9090909090909091,0.9090909090909091
2527,Francesco Vicari,ITA,DF,SPAL,Serie A,23,1994,25.9,28,24,21,7,0,18,28,64.3,10,31,24,7,34,62,139,1,0,2018-2019,1.3127413127413128,1.0810810810810811
2528,Aleix Vidal,ESP,"DF,MF",Sevilla,La Liga,28,1989,5.9,13,11,5,5,3,5,14,35.7,9,5,0,5,4,17,12,0,0,2018-2019,0.6779661016949152,2.2033898305084745
2529,Arturo Vidal,CHI,MF,Barcelona,La Liga,31,1987,21.4,78,44,32,37,9,30,69,43.5,39,46,5,41,29,107,23,1,0,2018-2019,1.355140186915888,3.6448598130841123
2530,Ronaldo Vieira,ENG,MF,Sampdoria,Serie A,20,1998,6.7,19,10,3,14,2,5,9,55.6,4,10,2,8,8,27,24,1,0,2018-2019,1.1940298507462686,2.835820895522388
2531,Luciano Vietto,ARG,"FW,MF",Fulham,Premier League,24,1993,11.0,15,11,5,5,5,4,19,21.1,15,9,0,9,6,21,5,0,0,2018-2019,0.5454545454545454,1.3636363636363635
2532,Carlos Vigaray,ESP,DF,Alavés,La Liga,23,1994,7.2,15,8,10,4,1,9,15,60.0,6,6,1,5,6,21,24,1,0,2018-2019,0.8333333333333333,2.0833333333333335
2533,Emanuel Vignato,ITA,"MF,FW",Chievo,Serie A,17,2000,7.3,8,4,4,3,1,0,6,0.0,6,4,0,4,10,18,0,0,0,2018-2019,1.36986301369863,1.095890410958904
2534,Dídac Vilà,ESP,DF,Espanyol,La Liga,29,1989,26.2,67,31,33,26,8,31,58,53.4,27,41,12,29,53,120,94,1,0,2018-2019,2.0229007633587788,2.5572519083969465
2535,Toni Villa,ESP,"MF,FW",Valladolid,La Liga,23,1995,19.6,51,32,24,18,9,20,47,42.6,27,15,0,15,12,63,10,0,0,2018-2019,0.6122448979591836,2.6020408163265305
2536,Rúben Vinagre,POR,"DF,MF",Wolves,Premier League,19,1999,7.9,14,9,7,7,0,2,5,40.0,3,10,2,8,14,28,16,1,0,2018-2019,1.7721518987341771,1.7721518987341771
2537,Carlos Vinícius,BRA,"FW,MF",Monaco,Ligue 1,23,1995,5.8,4,1,1,2,1,0,1,0.0,1,7,0,7,1,5,2,0,0,2018-2019,0.1724137931034483,0.6896551724137931
2538,Vitolo,ESP,"MF,FW",Atlético Madrid,La Liga,28,1989,8.4,17,13,8,6,3,6,19,31.6,13,8,1,7,10,27,6,0,0,2018-2019,1.1904761904761905,2.0238095238095237
2539,Federico Viviani,ITA,MF,Frosinone,Serie A,26,1992,3.7,6,5,2,3,1,3,8,37.5,5,6,3,3,8,14,2,0,0,2018-2019,2.162162162162162,1.6216216216216215
2540,Emiliano Viviano,ITA,GK,SPAL,Serie A,32,1985,16.9,0,0,0,0,0,0,0,0.0,0,0,0,0,0,0,5,2,0,2018-2019,0.0,0.0
2541,Felipe Vizeu,BRA,"FW,DF",Udinese,Serie A,21,1997,0.4,0,0,0,0,0,0,0,0.0,0,0,0,0,0,0,0,0,0,2018-2019,0.0,0.0
2542,Dušan Vlahović,SRB,FW,Fiorentina,Serie A,18,2000,1.8,0,0,0,0,0,0,0,0.0,0,2,0,2,0,0,4,0,0,2018-2019,0.0,0.0
2543,Rai Vloet,NED,MF,Frosinone,Serie A,23,1995,1.4,4,2,1,2,1,0,3,0.0,3,4,0,4,0,4,1,0,0,2018-2019,0.0,2.857142857142857
2544,Kevin Vogt,GER,DF,Hoffenheim,Bundesliga,26,1991,26.6,24,15,20,4,0,12,32,37.5,20,28,11,17,33,57,103,3,0,2018-2019,1.2406015037593985,0.9022556390977443
2545,Sam Vokes,WAL,FW,Burnley,Premier League,28,1989,10.2,4,2,1,2,1,0,0,0.0,0,2,1,1,0,4,17,0,0,2018-2019,0.0,0.3921568627450981
2546,Kevin Volland,GER,FW,Leverkusen,Bundesliga,26,1992,31.3,33,20,7,14,12,13,27,48.1,14,17,1,16,6,39,33,0,0,2018-2019,0.19169329073482427,1.0543130990415335
2547,Michel Vorm,NED,GK,Tottenham,Premier League,34,1983,2.0,0,0,0,0,0,0,0,0.0,0,0,0,0,0,0,1,0,0,2018-2019,0.0,0.0
2548,Stefan de Vrij,NED,DF,Inter,Serie A,26,1992,28.0,25,16,14,10,1,8,15,53.3,7,32,23,9,25,50,95,1,0,2018-2019,0.8928571428571429,0.8928571428571429
2549,Šime Vrsaljko,CRO,DF,Inter,Serie A,26,1992,8.1,20,14,8,6,6,9,14,64.3,5,5,1,4,11,31,27,1,0,2018-2019,1.3580246913580247,2.469135802469136
2550,Nikola Vukčević,MNE,MF,Levante,La Liga,26,1991,7.4,25,18,12,9,4,9,24,37.5,15,15,5,10,10,35,17,0,0,2018-2019,1.3513513513513513,3.378378378378378
Rk,Player,Nation,Pos,Squad,Comp,0,0,90.0,0,0,3,3,3,Tkl,0,0.0,0,0,0,0,0,0,0,0,0,2018-2019,0.0,0.0
2551,Matěj Vydra,CZE,FW,Burnley,Premier League,26,1992,3.5,2,1,0,1,1,0,3,0.0,3,4,1,3,1,3,6,0,0,2018-2019,0.2857142857142857,0.5714285714285714
2552,Paul Wade,FRA,MF,Nice,Ligue 1,18,2000,0.1,0,0,0,0,0,0,3,0.0,3,0,0,0,0,0,1,0,0,2018-2019,0.0,0.0
2553,Sandro Wagner,GER,FW,Bayern Munich,Bundesliga,30,1987,1.6,3,2,0,2,1,0,1,0.0,1,0,0,0,0,3,2,0,0,2018-2019,0.0,1.875
2554,Molla Wagué,MLI,DF,Udinese,Serie A,27,1991,1.1,1,1,1,0,0,0,1,0.0,1,1,0,1,4,5,5,0,0,2018-2019,3.6363636363636362,0.9090909090909091
2555,Moussa Wagué,SEN,"DF,FW",Barcelona,La Liga,19,1998,2.5,6,5,1,4,1,3,7,42.9,4,1,0,1,4,10,3,0,0,2018-2019,1.6,2.4
2556,Wakaso,GHA,MF,Alavés,La Liga,28,1990,18.5,46,30,23,19,4,12,36,33.3,24,37,9,28,16,62,19,2,0,2018-2019,0.8648648648648649,2.4864864864864864
2557,Walace,BRA,MF,Hannover 96,Bundesliga,23,1995,22.2,52,22,17,28,7,27,61,44.3,34,30,4,26,45,97,36,1,0,2018-2019,2.027027027027027,2.3423423423423424
2558,Theo Walcott,ENG,"FW,MF",Everton,Premier League,29,1989,23.5,27,17,11,9,7,10,22,45.5,12,17,1,16,22,49,8,0,0,2018-2019,0.9361702127659575,1.148936170212766
2559,Luca Waldschmidt,GER,"FW,MF",Freiburg,Bundesliga,22,1996,19.1,20,13,7,10,3,2,20,10.0,18,20,3,17,13,33,8,1,0,2018-2019,0.6806282722513088,1.0471204188481675
2560,Kyle Walker,ENG,DF,Manchester City,Premier League,28,1990,30.9,40,26,20,20,0,24,38,63.2,14,19,5,14,36,76,58,2,0,2018-2019,1.1650485436893205,1.2944983818770228
2561,Kyle Walker-Peters,ENG,DF,Tottenham,Premier League,21,1997,4.2,7,4,4,2,1,3,4,75.0,1,5,1,4,4,11,6,0,0,2018-2019,0.9523809523809523,1.6666666666666665
2562,Wallace,BRA,DF,Lazio,Serie A,23,1994,13.7,17,13,11,6,0,8,17,47.1,9,13,7,6,30,47,60,2,0,2018-2019,2.18978102189781,1.2408759124087592
2563,Anthony Walongwa,,DF,Nantes,Ligue 1,24,1993,1.0,0,0,0,0,0,0,0,0.0,0,3,2,1,1,1,2,0,0,2018-2019,1.0,0.0
2564,Rémi Walter,FRA,MF,Nice,Ligue 1,23,1995,9.3,20,12,7,10,3,5,15,33.3,10,9,1,8,6,26,11,0,0,2018-2019,0.6451612903225806,2.150537634408602
2565,Aaron Wan-Bissaka,ENG,DF,Crystal Palace,Premier League,20,1997,34.8,129,90,90,33,6,55,65,84.6,10,49,16,33,84,213,161,0,0,2018-2019,2.4137931034482762,3.7068965517241383
2566,Victor Wanyama,KEN,MF,Tottenham,Premier League,27,1991,5.7,13,13,8,5,0,6,12,50.0,6,9,3,6,7,20,11,0,0,2018-2019,1.2280701754385965,2.280701754385965
2567,Danny Ward,ENG,FW,Cardiff City,Premier League,26,1991,4.9,2,1,0,1,1,0,3,0.0,3,3,1,2,0,2,9,0,0,2018-2019,0.0,0.4081632653061224
2568,Joel Ward,ENG,DF,Crystal Palace,Premier League,28,1989,6.1,12,7,7,4,1,3,10,30.0,7,2,0,2,10,22,35,0,0,2018-2019,1.639344262295082,1.9672131147540985
2569,Stephen Ward,IRL,DF,Burnley,Premier League,32,1985,2.5,4,2,1,2,1,1,4,25.0,3,3,1,2,4,8,14,0,0,2018-2019,1.6,1.6
2570,James Ward-Prowse,ENG,"MF,DF",Southampton,Premier League,23,1994,21.6,36,17,19,13,4,14,43,32.6,29,30,6,24,27,63,59,0,0,2018-2019,1.25,1.6666666666666665
2571,Daniel Wass,DEN,"DF,MF",Valencia,La Liga,29,1989,26.2,35,25,9,19,7,20,42,47.6,22,23,4,19,34,69,49,0,0,2018-2019,1.297709923664122,1.33587786259542
2572,Timothy Weah,USA,FW,Paris S-G,Ligue 1,18,2000,0.6,0,0,0,0,0,0,0,0.0,0,0,0,0,0,0,0,0,0,2018-2019,0.0,0.0
2573,Wout Weghorst,NED,FW,Wolfsburg,Bundesliga,25,1992,32.5,30,23,10,12,8,7,35,20.0,28,27,3,24,9,39,33,0,0,2018-2019,0.27692307692307694,0.9230769230769231
2574,Julian Weigl,GER,"DF,MF",Dortmund,Bundesliga,22,1995,16.2,32,18,19,12,1,24,41,58.5,17,18,10,8,16,48,56,2,0,2018-2019,0.9876543209876544,1.9753086419753088
2575,Mitchell Weiser,GER,DF,Leverkusen,Bundesliga,24,1994,23.5,63,37,34,22,7,26,50,52.0,24,31,3,28,27,90,48,0,0,2018-2019,1.148936170212766,2.6808510638297873
Rk,Player,Nation,Pos,Squad,Comp,0,0,90.0,0,0,3,3,3,Tkl,0,0.0,0,0,0,0,0,0,0,0,0,2018-2019,0.0,0.0
2576,Danny Welbeck,ENG,"FW,MF",Arsenal,Premier League,27,1990,1.7,3,2,0,2,1,0,0,0.0,0,2,0,2,1,4,2,0,0,2018-2019,0.5882352941176471,1.7647058823529411
2577,Wendell,BRA,DF,Leverkusen,Bundesliga,25,1993,25.3,75,48,47,24,4,34,57,59.6,23,49,13,36,29,104,66,0,0,2018-2019,1.1462450592885376,2.9644268774703555
2578,Oscar Wendt,SWE,DF,Gladbach,Bundesliga,32,1985,30.3,45,34,34,8,3,31,53,58.5,22,37,11,26,19,64,90,0,0,2018-2019,0.6270627062706271,1.4851485148514851
2579,Axel Werner,ARG,GK,Huesca,La Liga,22,1996,6.0,0,0,0,0,0,0,0,0.0,0,0,0,0,0,0,2,0,0,2018-2019,0.0,0.0
2580,Timo Werner,GER,FW,RB Leipzig,Bundesliga,22,1996,27.9,18,12,6,8,4,3,16,18.8,13,18,2,16,3,21,7,0,0,2018-2019,0.10752688172043011,0.6451612903225806
2581,Ashley Westwood,ENG,MF,Burnley,Premier League,28,1990,31.4,58,30,24,27,7,14,39,35.9,25,38,9,29,47,105,42,2,0,2018-2019,1.496815286624204,1.8471337579617835
2582,Hendrik Weydandt,GER,FW,Hannover 96,Bundesliga,23,1995,19.1,18,12,7,8,3,3,24,12.5,21,14,4,10,5,23,44,0,0,2018-2019,0.2617801047120419,0.9424083769633507
2583,Connor Wickham,ENG,"FW,MF",Crystal Palace,Premier League,25,1993,0.7,0,0,0,0,0,0,0,0.0,0,0,0,0,0,0,2,0,0,2018-2019,0.0,0.0
2584,Georginio Wijnaldum,NED,MF,Liverpool,Premier League,27,1990,30.3,41,28,14,20,7,14,27,51.9,13,21,7,14,21,62,24,0,0,2018-2019,0.693069306930693,1.353135313531353
2585,Jetro Willems,NED,"MF,DF",Eint Frankfurt,Bundesliga,24,1994,8.1,20,15,10,8,2,9,15,60.0,6,10,4,6,10,30,14,0,0,2018-2019,1.234567901234568,2.469135802469136
2586,William,BRA,DF,Wolfsburg,Bundesliga,23,1995,29.7,82,57,52,21,9,35,75,46.7,40,41,2,39,85,167,127,3,0,2018-2019,2.861952861952862,2.760942760942761
2587,Danny Williams,USA,MF,Huddersfield,Premier League,29,1989,1.1,0,0,0,0,0,0,0,0.0,0,4,1,3,1,1,2,0,0,2018-2019,0.9090909090909091,0.0
2588,Iñaki Williams,GHA,FW,Athletic Club,La Liga,24,1994,33.6,27,18,9,7,11,5,22,22.7,17,22,1,21,7,34,33,0,0,2018-2019,0.20833333333333331,0.8035714285714285
2589,Willian,BRA,FW,Chelsea,Premier League,29,1988,23.3,35,21,11,15,9,9,25,36.0,16,16,1,15,14,49,12,2,0,2018-2019,0.6008583690987124,1.502145922746781
2590,Joe Willock,ENG,"MF,FW",Arsenal,Premier League,18,1999,0.7,1,0,0,1,0,0,0,0.0,0,1,0,1,1,2,0,0,0,2018-2019,1.4285714285714286,1.4285714285714286
2591,Ben Wilmot,ENG,"MF,DF",Watford,Premier League,18,1999,0.3,0,0,0,0,0,0,1,0.0,1,2,1,1,0,0,1,0,0,2018-2019,0.0,0.0
2592,Ben Wilmot,ENG,"DF,MF",Udinese,Serie A,18,1999,2.2,0,0,0,0,0,0,2,0.0,2,2,2,0,2,2,11,0,0,2018-2019,0.9090909090909091,0.0
2593,Jack Wilshere,ENG,MF,West Ham,Premier League,26,1992,4.4,7,4,1,4,2,2,6,33.3,4,3,1,2,7,14,0,0,0,2018-2019,1.5909090909090908,1.5909090909090908
2594,Callum Wilson,ENG,FW,Bournemouth,Premier League,26,1992,28.1,9,7,4,3,2,0,8,0.0,8,14,4,10,4,13,16,0,0,2018-2019,0.14234875444839856,0.32028469750889677
2595,Kevin Wimmer,AUT,DF,Hannover 96,Bundesliga,25,1992,18.7,25,17,17,6,2,15,27,55.6,12,30,23,7,41,66,63,0,0,2018-2019,2.192513368983957,1.3368983957219251
2596,Harry Winks,ENG,MF,Tottenham,Premier League,22,1996,17.7,22,13,12,9,1,5,30,16.7,25,19,3,16,21,43,19,0,0,2018-2019,1.1864406779661016,1.2429378531073447
2597,Axel Witsel,BEL,MF,Dortmund,Bundesliga,29,1989,31.9,47,33,19,24,4,17,28,60.7,11,33,6,27,47,94,49,0,0,2018-2019,1.4733542319749218,1.4733542319749218
2598,Maximilian Wöber,AUT,DF,Sevilla,La Liga,20,1998,6.0,12,9,8,2,2,3,6,50.0,3,6,0,6,7,19,16,0,0,2018-2019,1.1666666666666667,2.0
2599,Marius Wolf,GER,"DF,FW",Dortmund,Bundesliga,23,1995,9.2,14,10,11,3,0,5,13,38.5,8,6,0,6,13,27,12,0,0,2018-2019,1.4130434782608696,1.5217391304347827
2600,Jeong Woo-yeong,KOR,FW,Bayern Munich,Bundesliga,18,1999,0.1,0,0,0,0,0,0,1,0.0,1,0,0,0,0,0,0,0,0,2018-2019,0.0,0.0
Rk,Player,Nation,Pos,Squad,Comp,0,0,90.0,0,0,3,3,3,Tkl,0,0.0,0,0,0,0,0,0,0,0,0,2018-2019,0.0,0.0
2601,Bobby Wood,USA,"FW,MF",Hannover 96,Bundesliga,25,1992,13.1,13,10,2,10,1,5,8,62.5,3,2,0,2,4,17,6,0,0,2018-2019,0.3053435114503817,0.9923664122137404
2602,Chris Wood,NZL,FW,Burnley,Premier League,26,1991,28.8,12,8,0,7,5,5,17,29.4,12,17,4,13,3,15,26,0,0,2018-2019,0.10416666666666666,0.41666666666666663
2603,Haji Wright,USA,FW,Schalke 04,Bundesliga,20,1998,2.2,3,2,1,1,1,0,1,0.0,1,1,0,1,0,3,1,0,0,2018-2019,0.0,1.3636363636363635
2604,Xeka,POR,MF,Lille,Ligue 1,23,1994,25.1,59,31,25,27,7,18,57,31.6,39,20,2,18,21,80,30,4,0,2018-2019,0.8366533864541832,2.3505976095617527
2605,Granit Xhaka,SUI,"MF,DF",Arsenal,Premier League,25,1992,27.8,52,29,29,20,3,24,59,40.7,35,35,9,26,36,88,56,3,0,2018-2019,1.2949640287769784,1.870503597122302
2606,Cédric Yamberé,CTA,DF,Dijon,Ligue 1,27,1990,31.2,47,31,36,11,0,21,39,53.8,18,45,32,13,52,99,136,4,0,2018-2019,1.6666666666666667,1.5064102564102564
2607,Andriy Yarmolenko,UKR,"MF,FW",West Ham,Premier League,28,1989,5.1,4,1,2,1,1,4,6,66.7,2,4,1,3,2,6,4,2,0,2018-2019,0.3921568627450981,0.7843137254901962
2608,John Yeboah,ECU,"MF,FW",Wolfsburg,Bundesliga,18,2000,0.6,0,0,0,0,0,0,3,0.0,3,1,0,1,1,1,0,0,0,2018-2019,1.6666666666666667,0.0
2609,DeAndre Yedlin,USA,DF,Newcastle Utd,Premier League,25,1993,27.5,54,32,36,14,4,19,41,46.3,22,36,10,26,28,82,88,0,0,2018-2019,1.018181818181818,1.9636363636363636
2610,Yoel,ESP,GK,Valladolid,La Liga,29,1988,3.0,0,0,0,0,0,0,0,0.0,0,0,0,0,0,0,0,1,0,2018-2019,0.0,0.0
2611,Okay Yokuşlu,TUR,MF,Celta Vigo,La Liga,24,1994,24.4,61,39,31,28,2,28,45,62.2,17,32,11,21,37,98,53,2,0,2018-2019,1.5163934426229508,2.5
2612,Maya Yoshida,JPN,DF,Southampton,Premier League,29,1988,16.9,16,12,5,10,1,4,13,30.8,9,24,20,4,42,58,103,1,0,2018-2019,2.4852071005917162,0.9467455621301776
2613,Elie Youan,FRA,FW,Nantes,Ligue 1,19,1999,0.2,1,0,0,1,0,0,0,0.0,0,0,0,0,0,1,0,0,0,2018-2019,0.0,5.0
2614,Amin Younes,GER,"MF,FW",Napoli,Serie A,24,1993,5.5,11,6,3,6,2,3,6,50.0,3,7,0,7,2,13,0,0,0,2018-2019,0.36363636363636365,2.0
2615,Ashley Young,ENG,DF,Manchester Utd,Premier League,33,1985,28.5,52,32,34,16,2,20,39,51.3,19,36,10,26,55,107,74,0,0,2018-2019,1.9298245614035088,1.8245614035087718
2616,Zaydou Youssouf,FRA,"MF,FW",Bordeaux,Ligue 1,19,1999,4.7,7,5,3,4,0,3,7,42.9,4,5,1,4,5,12,0,0,0,2018-2019,1.0638297872340425,1.4893617021276595
2617,Pablo Zabaleta,ARG,DF,West Ham,Premier League,33,1985,23.2,47,24,26,15,6,17,44,38.6,27,39,15,24,48,95,96,3,0,2018-2019,2.0689655172413794,2.0258620689655173
2618,Dan-Axel Zagadou,FRA,DF,Dortmund,Bundesliga,19,1999,14.1,13,10,10,2,1,4,6,66.7,2,17,11,6,25,38,70,2,0,2018-2019,1.773049645390071,0.9219858156028369
2619,Wilfried Zaha,CIV,FW,Crystal Palace,Premier League,25,1992,33.7,39,20,11,23,5,12,34,35.3,22,19,0,19,10,49,4,0,0,2018-2019,0.29673590504451036,1.1572700296735905
2620,Younn Zahary,COM,DF,Caen,Ligue 1,19,1998,8.2,16,9,7,6,3,8,14,57.1,6,13,8,5,16,32,35,0,0,2018-2019,1.9512195121951221,1.9512195121951221
2621,Miha Zajc,SVN,"MF,FW",Empoli,Serie A,24,1994,13.0,6,4,1,1,4,2,11,18.2,9,15,4,11,5,11,8,0,0,2018-2019,0.38461538461538464,0.46153846153846156
2622,Denis Zakaria,SUI,MF,Gladbach,Bundesliga,21,1996,21.8,40,21,15,24,1,12,30,40.0,18,38,9,29,26,66,20,0,0,2018-2019,1.1926605504587156,1.8348623853211008
2623,Joseba Zaldúa,ESP,DF,Real Sociedad,La Liga,26,1992,23.8,36,27,23,10,3,15,32,46.9,17,19,3,16,38,74,72,0,0,2018-2019,1.5966386554621848,1.5126050420168067
2624,Andre-Frank Zambo Anguissa,CMR,MF,Fulham,Premier League,22,1995,16.9,48,29,23,20,5,18,52,34.6,34,25,6,19,34,82,32,0,0,2018-2019,2.0118343195266273,2.840236686390533
2625,Francesco Zampano,ITA,"DF,MF",Frosinone,Serie A,24,1993,23.4,35,25,23,9,3,15,31,48.4,16,24,4,20,13,48,48,0,0,2018-2019,0.5555555555555556,1.4957264957264957
Rk,Player,Nation,Pos,Squad,Comp,0,0,90.0,0,0,3,3,3,Tkl,0,0.0,0,0,0,0,0,0,0,0,0,2018-2019,0.0,0.0
2626,Nicolò Zaniolo,ITA,"MF,FW",Roma,Serie A,19,1999,19.6,35,21,7,18,10,7,37,18.9,30,14,0,14,13,48,8,0,0,2018-2019,0.6632653061224489,1.7857142857142856
2627,Cristián Zapata,COL,DF,Milan,Serie A,31,1986,11.4,23,16,15,7,1,9,10,90.0,1,18,15,3,8,31,59,0,0,2018-2019,0.7017543859649122,2.017543859649123
2628,Duván Zapata,COL,FW,Atalanta,Serie A,27,1991,32.2,9,5,3,2,4,1,9,11.1,8,26,6,20,4,13,25,0,0,2018-2019,0.12422360248447203,0.2795031055900621
2629,Davide Zappacosta,ITA,DF,Chelsea,Premier League,26,1992,1.4,0,0,0,0,0,0,1,0.0,1,0,0,0,3,3,5,0,0,2018-2019,2.142857142857143,0.0
2630,Simone Zaza,ITA,"FW,MF",Torino,Serie A,27,1991,16.0,20,9,3,12,5,1,8,12.5,7,12,1,11,4,24,9,0,0,2018-2019,0.25,1.25
2631,Marvin Zeegelaar,NED,DF,Udinese,Serie A,27,1990,10.6,30,23,21,6,3,16,24,66.7,8,11,2,9,17,47,38,0,0,2018-2019,1.6037735849056605,2.8301886792452833
2632,Mehdi Zeffane,ALG,"DF,MF",Rennes,Ligue 1,26,1992,13.5,19,13,12,7,0,10,26,38.5,16,14,5,9,18,37,35,1,0,2018-2019,1.3333333333333333,1.4074074074074074
2633,Arton Zekaj,KVX,FW,Lille,Ligue 1,18,2000,0.0,0,0,0,0,0,0,0,0.0,0,0,0,0,0,0,0,0,0,2018-2019,,
2634,Mootaz Zemzemi,TUN,"FW,MF",Strasbourg,Ligue 1,18,1999,0.0,1,0,0,0,1,0,0,0.0,0,0,0,0,0,1,0,0,0,2018-2019,,inf
2635,Arber Zeneli,KVX,FW,Reims,Ligue 1,23,1995,9.0,8,6,3,2,3,0,10,0.0,10,3,0,3,2,10,3,1,0,2018-2019,0.2222222222222222,0.8888888888888888
2636,Robin Zentner,GER,GK,Mainz 05,Bundesliga,23,1994,10.0,0,0,0,0,0,0,1,0.0,1,0,0,0,1,1,3,0,0,2018-2019,0.1,0.0
2637,Nabil El Zhar,MAR,"MF,FW",Leganés,La Liga,31,1986,10.7,8,4,2,4,2,0,5,0.0,5,4,0,4,4,12,1,0,0,2018-2019,0.3738317757009346,0.7476635514018692
2638,Luca Zidane,FRA,GK,Real Madrid,La Liga,20,1998,1.0,0,0,0,0,0,0,0,0.0,0,0,0,0,0,0,0,0,0,2018-2019,0.0,0.0
2639,Ron-Robert Zieler,GER,GK,Stuttgart,Bundesliga,29,1989,34.0,2,1,2,0,0,1,4,25.0,3,1,0,1,1,3,19,3,0,2018-2019,0.029411764705882353,0.058823529411764705
2640,Piotr Zieliński,POL,MF,Napoli,Serie A,24,1994,31.9,41,25,11,20,10,13,34,38.2,21,30,4,26,20,61,18,0,0,2018-2019,0.6269592476489029,1.2852664576802508
2641,Jean Zimmer,GER,"DF,FW",Düsseldorf,Bundesliga,24,1993,15.9,17,11,11,5,1,6,16,37.5,10,13,2,11,11,28,32,1,0,2018-2019,0.6918238993710691,1.069182389937107
2642,Matthias Zimmermann,GER,"DF,MF",Düsseldorf,Bundesliga,26,1992,33.9,97,64,69,24,4,45,90,50.0,45,51,18,33,67,164,90,2,0,2018-2019,1.976401179941003,2.8613569321533925
2643,Oleksandr Zinchenko,UKR,DF,Manchester City,Premier League,21,1996,12.8,34,20,13,15,6,14,33,42.4,19,14,3,11,20,54,19,1,0,2018-2019,1.5625,2.65625
2644,Kévin Zohi,MLI,"FW,MF",Strasbourg,Ligue 1,21,1996,7.0,14,10,6,6,2,5,9,55.6,4,8,0,8,7,21,5,0,0,2018-2019,1.0,2.0
2645,Kenneth Zohore,DEN,FW,Cardiff City,Premier League,24,1994,8.4,3,2,0,3,0,1,3,33.3,2,4,2,2,2,5,5,0,0,2018-2019,0.23809523809523808,0.35714285714285715
2646,Kurt Zouma,FRA,DF,Everton,Premier League,23,1994,29.0,32,21,16,14,2,4,11,36.4,7,27,12,15,54,86,126,2,0,2018-2019,1.8620689655172413,1.103448275862069
2647,Adam Zreľák,SVK,FW,Nürnberg,Bundesliga,24,1994,10.5,14,9,2,11,1,5,9,55.6,4,14,2,12,2,16,13,0,0,2018-2019,0.19047619047619047,1.3333333333333333
2648,Igor Zubeldia,ESP,MF,Real Sociedad,La Liga,21,1997,28.3,61,35,32,24,5,22,54,40.7,32,30,6,24,45,106,60,0,0,2018-2019,1.5901060070671378,2.15547703180212
2649,Steven Zuber,SUI,"MF,FW",Hoffenheim,Bundesliga,26,1991,6.3,12,9,5,6,1,6,13,46.2,7,5,1,4,5,17,4,0,0,2018-2019,0.7936507936507937,1.9047619047619049
2650,Steven Zuber,SUI,"MF,FW",Stuttgart,Bundesliga,26,1991,11.7,6,3,2,2,2,1,13,7.7,12,14,2,12,6,12,6,0,0,2018-2019,0.5128205128205129,0.5128205128205129
Rk,Player,Nation,Pos,Squad,Comp,0,0,90.0,0,0,3,3,3,Tkl,0,0.0,0,0,0,0,0,0,0,0,0,2018-2019,0.0,0.0
2651,Martín Zubimendi,ESP,MF,Real Sociedad,La Liga,19,1999,0.1,1,0,0,1,0,0,1,0.0,1,0,0,0,0,1,0,0,0,2018-2019,0.0,10.0
2652,Ervin Zukanović,BIH,DF,Genoa,Serie A,31,1987,21.8,28,16,20,7,1,17,30,56.7,13,17,9,8,19,47,96,0,0,2018-2019,0.8715596330275229,1.2844036697247705
2653,Bongani Zungu,RSA,MF,Amiens,Ligue 1,25,1992,2.6,3,2,0,1,2,2,8,25.0,6,0,0,0,2,5,5,0,0,2018-2019,0.7692307692307692,1.1538461538461537
2654,David Zurutuza,ESP,MF,Real Sociedad,La Liga,32,1986,13.6,27,16,9,15,3,8,22,36.4,14,19,4,15,24,51,26,1,0,2018-2019,1.7647058823529411,1.9852941176470589
2655,Filip Đorđević,SRB,FW,Chievo,Serie A,30,1987,7.0,11,6,3,6,2,3,12,25.0,9,7,1,6,2,13,8,1,0,2018-2019,0.2857142857142857,1.5714285714285714
2656,Filip Đuričić,SRB,"FW,MF",Sassuolo,Serie A,26,1992,13.9,17,13,2,11,4,5,22,22.7,17,20,1,19,8,25,8,1,0,2018-2019,0.5755395683453237,1.223021582733813
1,Patrick van Aanholt,NED,DF,Crystal Palace,Premier League,28,1990,27.9,43,23,31,10,2,23,50,46.0,27,31,9,22,45,88,52,1,0,2019-2020,1.6129032258064517,1.5412186379928317
2,Max Aarons,ENG,DF,Norwich City,Premier League,19,2000,36.0,48,30,33,9,6,18,36,50.0,18,46,29,17,37,85,97,1,0,2019-2020,1.0277777777777777,1.3333333333333333
3,Yunis Abdelhamid,MAR,DF,Reims,Ligue 1,31,1987,28.0,46,33,29,15,2,17,30,56.7,13,26,14,12,47,93,99,1,0,2019-2020,1.6785714285714286,1.6428571428571428
4,Suleiman Abdullahi,NGA,"FW,MF",Union Berlin,Bundesliga,22,1996,1.7,0,0,0,0,0,0,3,0.0,3,2,1,1,1,1,1,0,0,2019-2020,0.5882352941176471,0.0
5,Mehdi Abeid,ALG,MF,Nantes,Ligue 1,26,1992,20.2,55,29,18,32,5,20,53,37.7,33,16,3,13,23,78,8,1,0,2019-2020,1.1386138613861387,2.722772277227723
6,Charles Abi,FRA,FW,Saint-Étienne,Ligue 1,19,2000,6.9,9,9,2,5,2,2,7,28.6,5,2,0,2,4,13,4,0,0,2019-2020,0.5797101449275363,1.3043478260869565
7,David Abraham,ARG,DF,Eint Frankfurt,Bundesliga,33,1986,18.8,21,14,16,4,1,15,32,46.9,17,27,11,16,25,46,61,1,0,2019-2020,1.3297872340425532,1.1170212765957446
8,Tammy Abraham,ENG,FW,Chelsea,Premier League,21,1997,24.6,8,4,2,5,1,3,14,21.4,11,20,2,18,6,14,27,0,0,2019-2020,0.24390243902439024,0.3252032520325203
9,Amir Abrashi,ALB,MF,Freiburg,Bundesliga,29,1990,7.4,16,8,7,8,1,10,19,52.6,9,18,3,15,7,23,16,2,0,2019-2020,0.9459459459459459,2.162162162162162
10,Francesco Acerbi,ITA,DF,Lazio,Serie A,31,1988,35.1,59,29,42,12,5,14,20,70.0,6,40,27,13,42,101,109,1,0,2019-2020,1.1965811965811965,1.6809116809116809
11,Che Adams,SCO,FW,Southampton,Premier League,23,1996,12.3,6,4,1,5,0,1,4,25.0,3,9,1,8,2,8,10,0,0,2019-2020,0.16260162601626016,0.4878048780487805
12,Tyler Adams,USA,"MF,DF",RB Leipzig,Bundesliga,20,1999,10.6,22,15,13,8,1,12,25,48.0,13,16,1,15,14,36,14,0,0,2019-2020,1.3207547169811322,2.0754716981132075
13,Sargis Adamyan,ARM,"FW,MF",Hoffenheim,Bundesliga,26,1993,8.3,11,7,3,6,2,3,21,14.3,18,8,1,7,2,13,4,0,0,2019-2020,0.24096385542168672,1.325301204819277
14,Antonio Adán,ESP,GK,Atlético Madrid,La Liga,32,1987,0.3,0,0,0,0,0,0,0,0.0,0,0,0,0,0,0,0,0,0,2019-2020,0.0,0.0
15,Bobby Adekanye,NED,FW,Lazio,Serie A,20,1999,2.1,3,2,0,3,0,0,5,0.0,5,0,0,0,2,5,1,0,0,2019-2020,0.9523809523809523,1.4285714285714286
16,Claud Adjapong,ITA,DF,Hellas Verona,Serie A,21,1998,2.6,5,3,4,1,0,2,3,66.7,1,4,3,1,3,8,7,0,0,2019-2020,1.1538461538461537,1.923076923076923
17,Amine Adli,MAR,"MF,FW",Toulouse,Ligue 1,19,2000,0.5,0,0,0,0,0,0,1,0.0,1,0,0,0,1,1,0,0,0,2019-2020,2.0,0.0
18,Yacine Adli,FRA,MF,Bordeaux,Ligue 1,19,2000,11.3,22,14,4,15,3,11,34,32.4,23,10,0,10,8,30,3,0,0,2019-2020,0.7079646017699115,1.9469026548672566
19,Adrián,ESP,GK,Liverpool,Premier League,32,1987,9.7,1,1,1,0,0,1,1,100.0,0,0,0,0,0,1,8,3,0,2019-2020,0.0,0.10309278350515465
20,Aritz Aduriz,ESP,"FW,MF",Athletic Club,La Liga,38,1981,2.3,3,2,0,3,0,0,0,0.0,0,0,0,0,0,3,2,0,0,2019-2020,0.0,1.3043478260869565
21,Lumor Agbenyenu,GHA,DF,Mallorca,La Liga,22,1996,20.1,31,21,19,9,3,16,35,45.7,19,13,2,11,21,52,66,1,0,2019-2020,1.044776119402985,1.5422885572139302
22,Martin Agirregabiria,ESP,DF,Alavés,La Liga,23,1996,23.3,55,30,32,18,5,30,54,55.6,24,19,7,12,18,73,48,0,0,2019-2020,0.7725321888412017,2.360515021459227
23,Lucien Agoume,FRA,MF,Inter,Serie A,17,2002,0.8,3,2,0,2,1,0,0,0.0,0,3,1,2,0,3,0,0,0,2019-2020,0.0,3.75
24,Kevin Agudelo,COL,"MF,FW",Fiorentina,Serie A,20,1998,0.7,2,1,0,1,1,0,1,0.0,1,1,0,1,1,3,0,0,0,2019-2020,1.4285714285714286,2.857142857142857
25,Kevin Agudelo,COL,"MF,FW",Genoa,Serie A,20,1998,7.4,23,14,9,12,2,10,20,50.0,10,12,1,11,6,29,2,0,0,2019-2020,0.8108108108108107,3.108108108108108
Rk,Player,Nation,Pos,Squad,Comp,0,0,90.0,0,0,3,3,3,Tkl,0,0.0,0,0,0,0,0,0,0,0,0,2019-2020,0.0,0.0
26,Nayef Aguerd,MAR,DF,Dijon,Ligue 1,23,1996,10.6,13,9,7,5,1,8,12,66.7,4,11,11,0,18,31,54,0,0,2019-2020,1.6981132075471699,1.2264150943396226
27,Sergio Agüero,ARG,FW,Manchester City,Premier League,31,1988,16.1,7,4,0,4,3,1,8,12.5,7,9,1,8,3,10,2,0,0,2019-2020,0.18633540372670807,0.43478260869565216
28,Ruben Aguilar,FRA,DF,Monaco,Ligue 1,26,1993,11.9,36,22,19,15,2,19,28,67.9,9,6,2,4,11,47,21,0,0,2019-2020,0.9243697478991596,3.0252100840336134
29,Emmanuel Agyemang-Badu,GHA,MF,Hellas Verona,Serie A,28,1990,2.6,1,1,0,1,0,1,2,50.0,1,2,2,0,1,2,6,0,0,2019-2020,0.3846153846153846,0.3846153846153846
30,Jean-Eudes Aholou,CIV,MF,Saint-Étienne,Ligue 1,25,1994,7.0,16,12,2,11,3,3,9,33.3,6,6,1,5,15,31,10,0,0,2019-2020,2.142857142857143,2.2857142857142856
31,Joseph Aidoo,GHA,DF,Celta Vigo,La Liga,23,1995,27.8,43,27,30,11,2,13,27,48.1,14,31,14,17,45,88,124,3,0,2019-2020,1.618705035971223,1.5467625899280575
32,Ola Aina,NGA,DF,Torino,Serie A,22,1996,23.1,45,24,23,18,4,17,37,45.9,20,24,6,18,41,86,61,0,0,2019-2020,1.7748917748917747,1.948051948051948
33,Youssef Aït Bennasser,MAR,MF,Bordeaux,Ligue 1,23,1996,6.0,11,8,6,4,1,4,24,16.7,20,6,1,5,4,15,10,1,0,2019-2020,0.6666666666666666,1.8333333333333333
34,Rayan Aït-Nouri,ALG,DF,Angers,Ligue 1,18,2001,14.2,29,22,14,8,7,10,21,47.6,11,14,1,13,18,47,33,0,0,2019-2020,1.267605633802817,2.0422535211267605
35,Albian Ajeti,SUI,FW,West Ham,Premier League,22,1997,1.5,1,0,0,0,1,0,0,0.0,0,0,0,0,0,1,0,0,0,2019-2020,0.0,0.6666666666666666
36,Ludovic Ajorque,FRA,FW,Strasbourg,Ligue 1,25,1994,22.9,15,10,2,10,3,2,13,15.4,11,11,0,11,2,17,20,0,0,2019-2020,0.08733624454148473,0.6550218340611355
37,Manuel Akanji,SUI,DF,Dortmund,Bundesliga,24,1995,25.7,38,21,23,14,1,12,20,60.0,8,20,11,9,30,68,61,2,0,2019-2020,1.1673151750972763,1.4785992217898833
38,Marley Aké,FRA,"FW,MF",Marseille,Ligue 1,18,2001,1.1,2,2,1,1,0,1,3,33.3,2,0,0,0,1,3,1,0,0,2019-2020,0.9090909090909091,1.8181818181818181
39,Nathan Aké,NED,DF,Bournemouth,Premier League,24,1995,27.8,31,21,23,8,0,14,23,60.9,9,40,29,11,36,67,152,0,0,2019-2020,1.2949640287769784,1.1151079136690647
40,Chadrac Akolo,COD,"FW,MF",Amiens,Ligue 1,24,1995,6.0,16,8,8,6,2,5,12,41.7,7,6,1,5,5,21,5,0,0,2019-2020,0.8333333333333334,2.6666666666666665
41,Kevin Akpoguma,NGA,DF,Hoffenheim,Bundesliga,24,1995,12.7,24,16,20,4,0,13,24,54.2,11,21,11,10,13,37,48,0,0,2019-2020,1.0236220472440944,1.8897637795275593
42,David Alaba,AUT,DF,Bayern Munich,Bundesliga,27,1992,27.8,30,17,14,15,1,16,25,64.0,9,19,10,9,29,59,40,0,0,2019-2020,1.0431654676258992,1.079136690647482
43,Sofiane Alakouch,MAR,DF,Nîmes,Ligue 1,21,1998,15.6,45,26,25,13,7,25,48,52.1,23,13,2,11,23,68,39,3,0,2019-2020,1.4743589743589745,2.8846153846153846
44,Lucas Alario,ARG,FW,Leverkusen,Bundesliga,26,1992,13.0,6,3,0,4,2,1,8,12.5,7,12,2,10,1,7,9,0,0,2019-2020,0.07692307692307693,0.46153846153846156
45,Jordi Alba,ESP,DF,Barcelona,La Liga,30,1989,24.3,20,13,9,7,4,6,27,22.2,21,12,3,9,37,57,40,0,0,2019-2020,1.522633744855967,0.823045267489712
46,Luis Alberto,ESP,MF,Lazio,Serie A,26,1992,34.6,50,30,21,19,10,27,82,32.9,55,32,1,31,21,71,9,1,0,2019-2020,0.6069364161849711,1.445086705202312
47,Raúl Albiol,ESP,DF,Villarreal,La Liga,33,1985,36.0,43,23,27,16,0,18,27,66.7,9,29,21,8,42,85,175,2,0,2019-2020,1.1666666666666667,1.1944444444444444
48,Marc Albrighton,ENG,"MF,DF",Leicester City,Premier League,29,1989,9.6,24,17,10,13,1,9,30,30.0,21,19,2,17,10,34,8,0,0,2019-2020,1.0416666666666667,2.5
49,Paco Alcácer,ESP,FW,Villarreal,La Liga,25,1993,10.3,3,3,2,1,0,1,7,14.3,6,4,1,3,2,5,10,0,0,2019-2020,0.1941747572815534,0.2912621359223301
50,Paco Alcácer,ESP,FW,Dortmund,Bundesliga,25,1993,5.9,2,2,0,2,0,1,5,20.0,4,4,1,3,2,4,3,0,0,2019-2020,0.3389830508474576,0.3389830508474576
Rk,Player,Nation,Pos,Squad,Comp,0,0,90.0,0,0,3,3,3,Tkl,0,0.0,0,0,0,0,0,0,0,0,0,2019-2020,0.0,0.0
51,Thiago Alcántara,ESP,MF,Bayern Munich,Bundesliga,28,1991,19.7,45,26,17,23,5,12,33,36.4,21,12,3,9,45,90,13,1,0,2019-2020,2.284263959390863,2.284263959390863
52,Rubén Alcaraz,ESP,MF,Valladolid,La Liga,28,1991,21.4,61,30,37,20,4,30,63,47.6,33,46,15,31,15,76,41,0,0,2019-2020,0.7009345794392524,2.850467289719626
53,Toby Alderweireld,BEL,DF,Tottenham,Premier League,30,1989,32.9,40,29,24,13,3,11,24,45.8,13,48,32,16,31,71,172,2,0,2019-2020,0.9422492401215806,1.21580547112462
54,Haitam Aleesami,NOR,DF,Amiens,Ligue 1,28,1991,21.3,36,16,25,9,2,18,43,41.9,25,33,10,23,34,70,59,1,0,2019-2020,1.596244131455399,1.6901408450704225
55,Álex Alegría,ESP,FW,Mallorca,La Liga,26,1992,1.2,1,0,1,0,0,0,0,0.0,0,2,0,2,0,1,0,0,0,2019-2020,0.0,0.8333333333333334
56,Carles Aleñá,ESP,MF,Barcelona,La Liga,21,1998,1.9,2,1,1,1,0,1,4,25.0,3,1,0,1,0,2,0,0,0,2019-2020,0.0,1.0526315789473684
57,Carles Aleñá,ESP,"MF,FW",Betis,La Liga,21,1998,8.2,14,9,5,7,2,3,17,17.6,14,4,1,3,1,15,3,0,0,2019-2020,0.12195121951219513,1.707317073170732
58,Rúnar Alex Rúnarsson,ISL,GK,Dijon,Ligue 1,24,1995,10.0,0,0,0,0,0,0,2,0.0,2,0,0,0,0,0,3,3,0,2019-2020,0.0,0.0
59,Trent Alexander-Arnold,ENG,DF,Liverpool,Premier League,20,1998,35.3,55,34,35,17,3,36,78,46.2,42,27,9,18,45,100,84,3,0,2019-2020,1.274787535410765,1.558073654390935
60,Enrico Alfonso,ITA,GK,Brescia,Serie A,31,1988,3.1,0,0,0,0,0,0,0,0.0,0,0,0,0,0,0,2,0,0,2019-2020,0.0,0.0
61,Rachid Alioui,MAR,FW,Angers,Ligue 1,27,1992,17.4,8,5,0,7,1,2,13,15.4,11,3,0,3,2,10,9,0,0,2019-2020,0.1149425287356322,0.4597701149425288
62,Alisson,BRA,GK,Liverpool,Premier League,26,1992,28.3,0,0,0,0,0,0,2,0.0,2,0,0,0,1,1,13,3,0,2019-2020,0.0353356890459364,0.0
63,Allan,BRA,MF,Napoli,Serie A,28,1991,14.2,50,27,20,21,9,18,54,33.3,36,19,3,16,16,66,11,1,0,2019-2020,1.1267605633802817,3.5211267605633805
64,Dele Alli,ENG,"MF,FW",Tottenham,Premier League,23,1996,20.5,34,16,11,20,3,13,37,35.1,24,35,3,32,17,51,17,2,0,2019-2020,0.8292682926829268,1.6585365853658536
65,Miguel Almirón,PAR,"MF,FW",Newcastle Utd,Premier League,25,1994,33.6,60,39,32,20,8,19,52,36.5,33,25,1,24,31,91,25,0,0,2019-2020,0.9226190476190476,1.7857142857142856
66,Marcos Alonso,ESP,DF,Chelsea,Premier League,28,1990,15.9,28,16,20,6,2,14,33,42.4,19,18,2,16,20,48,32,0,0,2019-2020,1.2578616352201257,1.7610062893081762
67,Mickaël Alphonse,GLP,DF,Dijon,Ligue 1,30,1989,15.3,39,25,26,12,1,23,37,62.2,14,19,3,16,17,56,64,0,0,2019-2020,1.1111111111111112,2.549019607843137
68,Sergio Álvarez,ESP,"MF,DF",Eibar,La Liga,27,1992,12.7,37,22,11,24,2,8,24,33.3,16,16,2,14,17,54,26,1,0,2019-2020,1.3385826771653544,2.9133858267716537
69,Sergio Álvarez,ESP,GK,Celta Vigo,La Liga,32,1986,2.0,0,0,0,0,0,0,0,0.0,0,0,0,0,0,0,1,0,0,2019-2020,0.0,0.0
70,Yeray Álvarez,ESP,DF,Athletic Club,La Liga,24,1995,31.2,36,19,28,7,1,17,30,56.7,13,33,22,11,62,98,138,2,0,2019-2020,1.9871794871794872,1.153846153846154
71,Bruno Alves,POR,DF,Parma,Serie A,37,1981,29.7,17,11,12,5,0,8,13,61.5,5,30,21,9,25,42,150,2,0,2019-2020,0.8417508417508418,0.5723905723905724
72,Steven Alzate,COL,"MF,DF",Brighton,Premier League,20,1998,13.2,33,19,20,11,2,17,27,63.0,10,18,3,15,14,47,13,0,0,2019-2020,1.0606060606060606,2.5
73,Ibrahim Amadou,FRA,"DF,MF",Norwich City,Premier League,26,1993,8.4,18,11,9,8,1,3,11,27.3,8,8,5,3,16,34,55,1,0,2019-2020,1.9047619047619047,2.142857142857143
74,Ibrahim Amadou,FRA,MF,Leganés,La Liga,26,1993,8.6,16,9,5,9,2,4,11,36.4,7,5,0,5,12,28,6,0,0,2019-2020,1.3953488372093024,1.8604651162790697
75,Romain Amalfitano,FRA,MF,Dijon,Ligue 1,29,1989,18.8,43,27,18,21,4,21,61,34.4,40,23,9,14,36,79,14,2,0,2019-2020,1.9148936170212765,2.2872340425531914
Rk,Player,Nation,Pos,Squad,Comp,0,0,90.0,0,0,3,3,3,Tkl,0,0.0,0,0,0,0,0,0,0,0,0,2019-2020,0.0,0.0
76,Amath,SEN,MF,Getafe,La Liga,23,1996,0.7,2,1,1,1,0,0,5,0.0,5,2,0,2,0,2,0,0,0,2019-2020,0.0,2.857142857142857
77,Jordan Amavi,FRA,DF,Marseille,Ligue 1,25,1994,24.0,55,29,31,19,5,31,64,48.4,33,27,6,21,56,111,97,0,0,2019-2020,2.3333333333333335,2.2916666666666665
78,Thierry Ambrose,GLP,FW,Metz,Ligue 1,22,1997,6.1,7,5,2,2,3,2,7,28.6,5,3,0,3,3,10,3,0,0,2019-2020,0.49180327868852464,1.1475409836065575
79,Kelvin Amian,FRA,DF,Toulouse,Ligue 1,21,1998,18.1,27,21,21,5,1,14,25,56.0,11,14,7,7,18,45,56,0,0,2019-2020,0.9944751381215469,1.4917127071823204
80,Nadiem Amiri,GER,"MF,FW",Leverkusen,Bundesliga,22,1996,20.6,26,16,7,15,4,16,34,47.1,18,12,2,10,14,40,8,1,0,2019-2020,0.6796116504854368,1.262135922330097
81,Ethan Ampadu,WAL,DF,RB Leipzig,Bundesliga,18,2000,0.9,5,4,3,2,0,1,1,100.0,0,3,1,2,1,6,3,0,0,2019-2020,1.1111111111111112,5.555555555555555
82,Opoku Ampomah,GHA,"FW,MF",Düsseldorf,Bundesliga,23,1996,5.6,9,4,3,4,2,3,12,25.0,9,3,0,3,4,13,5,0,0,2019-2020,0.7142857142857143,1.6071428571428572
83,Sofyan Amrabat,MAR,MF,Hellas Verona,Serie A,22,1996,32.4,58,36,26,21,11,26,55,47.3,29,29,10,19,31,89,15,1,0,2019-2020,0.9567901234567902,1.7901234567901236
84,Joachim Andersen,DEN,DF,Lyon,Ligue 1,23,1996,17.0,17,9,15,2,0,7,19,36.8,12,16,12,4,10,27,74,2,0,2019-2020,0.5882352941176471,1.0
85,Djavan Anderson,NED,"FW,DF",Lazio,Serie A,24,1995,1.9,0,0,0,0,0,0,0,0.0,0,1,0,1,3,3,3,0,0,2019-2020,1.5789473684210527,0.0
86,Felipe Anderson,BRA,"MF,FW",West Ham,Premier League,26,1993,16.6,46,32,20,21,5,11,47,23.4,36,19,1,18,22,68,11,0,0,2019-2020,1.325301204819277,2.7710843373493974
87,Sebastian Andersson,SWE,FW,Union Berlin,Bundesliga,28,1991,29.8,20,10,0,12,8,4,19,21.1,15,19,3,16,5,25,36,0,0,2019-2020,0.16778523489932887,0.6711409395973155
88,Florin Andone,ROU,FW,Brighton,Premier League,26,1993,0.8,1,1,0,1,0,1,1,100.0,0,1,1,0,0,1,1,0,0,2019-2020,0.0,1.25
89,Benjamin André,FRA,MF,Lille,Ligue 1,28,1990,22.8,72,44,31,35,6,29,74,39.2,45,32,9,23,59,131,40,1,0,2019-2020,2.587719298245614,3.1578947368421053
90,Lorenzo Andrenacci,ITA,GK,Brescia,Serie A,24,1995,5.9,1,0,1,0,0,1,3,33.3,2,0,0,0,0,1,0,0,0,2019-2020,0.0,0.1694915254237288
91,Robert Andrich,GER,MF,Union Berlin,Bundesliga,24,1994,28.6,52,27,28,18,6,19,60,31.7,41,27,7,20,47,99,36,0,0,2019-2020,1.6433566433566433,1.8181818181818181
92,Victorien Angban,CIV,MF,Metz,Ligue 1,22,1996,11.4,23,18,11,11,1,11,24,45.8,13,9,2,7,8,31,5,0,0,2019-2020,0.7017543859649122,2.017543859649123
93,Miguel Ángel Guerrero,ESP,FW,Leganés,La Liga,29,1990,8.8,1,0,0,1,0,1,10,10.0,9,4,0,4,2,3,4,0,0,2019-2020,0.22727272727272727,0.11363636363636363
94,José Ángel,ESP,DF,Eibar,La Liga,29,1989,26.2,54,31,26,25,3,26,43,60.5,17,23,7,16,33,87,61,1,0,2019-2020,1.2595419847328244,2.0610687022900764
95,Miguel Ángel Moyá,ESP,GK,Real Sociedad,La Liga,35,1984,13.0,0,0,0,0,0,0,1,0.0,1,0,0,0,1,1,6,2,0,2019-2020,0.07692307692307693,0.0
96,Angeliño,ESP,DF,Manchester City,Premier League,22,1997,4.7,5,2,3,1,1,5,7,71.4,2,1,0,1,9,14,15,0,0,2019-2020,1.9148936170212765,1.0638297872340425
97,Angeliño,ESP,"DF,FW",RB Leipzig,Bundesliga,22,1997,12.2,15,9,7,5,3,5,15,33.3,10,14,1,13,19,34,24,0,0,2019-2020,1.557377049180328,1.2295081967213115
98,Faustino Anjorin,ENG,FW,Chelsea,Premier League,17,2001,0.2,0,0,0,0,0,0,0,0.0,0,1,0,1,0,0,0,0,0,2019-2020,0.0,0.0
99,Peter Ankersen,DEN,DF,Genoa,Serie A,28,1990,11.8,16,4,7,7,2,4,13,30.8,9,19,5,14,9,25,25,1,0,2019-2020,0.7627118644067796,1.3559322033898304
100,Cristian Ansaldi,ARG,"DF,MF",Torino,Serie A,32,1986,19.6,37,25,24,7,6,19,34,55.9,15,23,3,20,14,51,20,4,0,2019-2020,0.7142857142857142,1.887755102040816
Rk,Player,Nation,Pos,Squad,Comp,0,0,90.0,0,0,3,3,3,Tkl,0,0.0,0,0,0,0,0,0,0,0,0,2019-2020,0.0,0.0
101,Janis Antiste,FRA,MF,Toulouse,Ligue 1,16,2002,0.1,0,0,0,0,0,0,0,0.0,0,0,0,0,0,0,0,0,0,2019-2020,0.0,0.0
102,Michail Antonio,JAM,FW,West Ham,Premier League,29,1990,19.6,13,9,5,4,4,4,14,28.6,10,17,2,15,9,22,5,0,0,2019-2020,0.4591836734693877,0.6632653061224489
103,Antoñito,ESP,"DF,MF",Valladolid,La Liga,31,1987,11.4,26,18,19,7,0,12,20,60.0,8,9,0,9,15,41,20,1,0,2019-2020,1.3157894736842104,2.280701754385965
104,Mirko Antonucci,ITA,"FW,MF",Roma,Serie A,20,1999,0.9,4,3,1,0,3,3,3,100.0,0,2,0,2,2,6,1,0,0,2019-2020,2.2222222222222223,4.444444444444445
105,Vitorino Antunes,POR,MF,Getafe,La Liga,32,1987,0.1,0,0,0,0,0,0,0,0.0,0,0,0,0,0,0,1,0,0,2019-2020,0.0,0.0
106,Christopher Antwi-Adjei,GHA,"MF,FW",Paderborn 07,Bundesliga,25,1994,27.4,25,16,13,9,3,9,33,27.3,24,29,2,27,15,40,14,0,0,2019-2020,0.5474452554744526,0.9124087591240876
107,Anuar,MAR,"MF,FW",Valladolid,La Liga,24,1995,2.1,4,2,1,2,1,2,6,33.3,4,7,3,4,5,9,0,0,0,2019-2020,2.380952380952381,1.9047619047619047
108,Houssem Aouar,ALG,"MF,FW",Lyon,Ligue 1,21,1998,21.7,28,12,6,18,4,10,35,28.6,25,15,1,14,13,41,11,0,0,2019-2020,0.599078341013825,1.2903225806451613
109,Adil Aouchiche,FRA,MF,Paris S-G,Ligue 1,17,2002,0.7,3,2,1,2,0,2,4,50.0,2,3,0,3,0,3,0,0,0,2019-2020,0.0,4.285714285714286
110,Dennis Appiah,FRA,DF,Nantes,Ligue 1,27,1992,17.8,58,35,32,20,6,28,52,53.8,24,9,3,6,23,81,34,0,0,2019-2020,1.2921348314606742,3.258426966292135
111,Mauro Arambarri,URU,MF,Getafe,La Liga,23,1995,34.1,72,33,24,40,8,31,69,44.9,38,52,5,47,43,115,40,2,0,2019-2020,1.2609970674486803,2.1114369501466275
112,Guilherme Arana,BRA,DF,Atalanta,Serie A,22,1997,0.9,4,4,1,3,0,3,5,60.0,2,0,0,0,2,6,0,0,0,2019-2020,2.2222222222222223,4.444444444444445
113,Charles Aránguiz,CHI,MF,Leverkusen,Bundesliga,30,1989,23.5,56,37,19,29,8,27,74,36.5,47,27,6,21,22,78,21,1,0,2019-2020,0.9361702127659575,2.382978723404255
114,Luiz Araújo,BRA,"FW,MF",Lille,Ligue 1,23,1996,9.2,20,11,3,8,9,5,31,16.1,26,14,0,14,4,24,6,0,0,2019-2020,0.4347826086956522,2.173913043478261
115,Néstor Araujo,MEX,DF,Celta Vigo,La Liga,27,1991,32.1,44,27,35,8,1,22,36,61.1,14,26,18,8,52,96,142,0,0,2019-2020,1.6199376947040498,1.3707165109034267
116,Ronald Araújo,URU,DF,Barcelona,La Liga,20,1999,2.6,3,2,2,1,0,1,1,100.0,0,6,2,4,0,3,9,0,0,2019-2020,0.0,1.1538461538461537
117,Anaitz Arbilla,ESP,DF,Eibar,La Liga,32,1987,22.3,33,20,23,8,2,16,34,47.1,18,20,4,16,29,62,82,0,0,2019-2020,1.3004484304932735,1.4798206278026906
118,Alphonse Areola,FRA,GK,Real Madrid,La Liga,26,1993,4.0,0,0,0,0,0,0,0,0.0,0,0,0,0,0,0,0,0,0,2019-2020,0.0,0.0
119,Alphonse Areola,FRA,GK,Paris S-G,Ligue 1,26,1993,3.0,0,0,0,0,0,0,0,0.0,0,0,0,0,0,0,1,1,0,2019-2020,0.0,0.0
120,Santiago Arias,COL,DF,Atlético Madrid,La Liga,27,1992,12.0,36,24,20,12,4,10,18,55.6,8,12,7,5,19,55,20,1,0,2019-2020,1.5833333333333333,3.0
121,Nicolò Armini,ITA,DF,Lazio,Serie A,18,2001,0.0,1,1,1,0,0,1,1,100.0,0,0,0,0,0,1,1,0,0,2019-2020,,inf
122,Stuart Armstrong,SCO,MF,Southampton,Premier League,27,1992,19.1,32,19,19,11,2,9,38,23.7,29,22,4,18,11,43,23,1,0,2019-2020,0.5759162303664921,1.6753926701570678
123,José Arnaiz,ESP,"FW,MF",Osasuna,La Liga,24,1995,8.8,3,2,0,2,1,0,12,0.0,12,7,0,7,5,8,5,0,0,2019-2020,0.5681818181818181,0.3409090909090909
124,José Arnaiz,ESP,MF,Leganés,La Liga,24,1995,3.7,3,0,1,2,0,2,5,40.0,3,4,0,4,2,5,1,0,0,2019-2020,0.5405405405405405,0.8108108108108107
125,Maximilian Arnold,GER,MF,Wolfsburg,Bundesliga,25,1994,31.3,42,24,15,23,4,16,62,25.8,46,25,6,19,25,67,35,0,0,2019-2020,0.7987220447284344,1.3418530351437699
Rk,Player,Nation,Pos,Squad,Comp,0,0,90.0,0,0,3,3,3,Tkl,0,0.0,0,0,0,0,0,0,0,0,0,2019-2020,0.0,0.0
126,Kepa Arrizabalaga,ESP,GK,Chelsea,Premier League,24,1994,33.0,1,1,1,0,0,1,2,50.0,1,0,0,0,1,2,7,2,0,2019-2020,0.030303030303030304,0.030303030303030304
127,Kwadwo Asamoah,GHA,"DF,FW",Inter,Serie A,30,1988,7.1,10,8,4,5,1,6,14,42.9,8,8,1,7,9,19,13,0,0,2019-2020,1.267605633802817,1.4084507042253522
128,Santiago Ascacíbar,ARG,MF,Hertha BSC,Bundesliga,22,1997,7.0,26,13,15,11,0,11,28,39.3,17,13,2,11,16,42,13,0,0,2019-2020,2.2857142857142856,3.7142857142857144
129,Sergio Asenjo,ESP,GK,Villarreal,La Liga,30,1989,34.0,0,0,0,0,0,0,2,0.0,2,0,0,0,1,1,15,1,0,2019-2020,0.029411764705882353,0.0
130,Marco Asensio,ESP,FW,Real Madrid,La Liga,23,1996,3.7,4,3,3,1,0,1,4,25.0,3,2,0,2,1,5,4,0,0,2019-2020,0.27027027027027023,1.081081081081081
131,Kristoffer Askildsen,NOR,MF,Sampdoria,Serie A,18,2001,0.8,1,1,1,0,0,0,0,0.0,0,1,0,1,1,2,0,0,0,2019-2020,1.25,1.25
132,Iago Aspas,ESP,FW,Celta Vigo,La Liga,31,1987,36.2,29,19,7,9,13,12,45,26.7,33,16,1,15,22,51,7,0,0,2019-2020,0.6077348066298343,0.8011049723756906
133,Roger Assalé,CIV,"FW,MF",Leganés,La Liga,25,1993,5.9,3,2,1,0,2,1,9,11.1,8,8,0,8,0,3,1,0,0,2019-2020,0.0,0.5084745762711864
134,Youcef Atal,ALG,"FW,DF",Nice,Ligue 1,23,1996,11.1,24,11,15,6,3,13,31,41.9,18,12,1,11,24,48,11,1,0,2019-2020,2.1621621621621623,2.1621621621621623
135,Miguel Atienza,ESP,MF,Eibar,La Liga,20,1999,0.3,1,1,0,1,0,1,2,50.0,1,1,1,0,2,3,1,0,0,2019-2020,6.666666666666667,3.3333333333333335
136,Christian Atsu,GHA,"MF,FW",Newcastle Utd,Premier League,27,1992,8.3,10,8,5,5,0,5,14,35.7,9,19,0,19,5,15,9,0,0,2019-2020,0.6024096385542168,1.2048192771084336
137,Pierre-Emerick Aubameyang,GAB,FW,Arsenal,Premier League,30,1989,34.8,31,19,10,12,9,12,51,23.5,39,39,1,38,14,45,16,0,0,2019-2020,0.40229885057471265,0.8908045977011495
138,Emil Audero,ITA,GK,Sampdoria,Serie A,22,1997,36.0,1,1,1,0,0,1,3,33.3,2,0,0,0,0,1,21,1,0,2019-2020,0.0,0.027777777777777776
139,Tommaso Augello,ITA,DF,Sampdoria,Serie A,24,1994,12.6,14,9,6,3,5,5,7,71.4,2,8,0,8,15,29,21,1,0,2019-2020,1.1904761904761905,1.1111111111111112
140,Jean-Kévin Augustin,FRA,FW,Monaco,Ligue 1,22,1997,3.0,3,0,1,2,0,1,6,16.7,5,2,0,2,3,6,0,0,0,2019-2020,1.0,1.0
141,Ludwig Augustinsson,SWE,"DF,MF",Werder Bremen,Bundesliga,25,1994,10.3,29,12,15,9,5,12,23,52.2,11,19,5,14,10,39,29,0,0,2019-2020,0.9708737864077669,2.815533980582524
142,Serge Aurier,CIV,DF,Tottenham,Premier League,26,1992,30.0,93,69,58,27,8,39,69,56.5,30,38,6,32,47,140,98,2,0,2019-2020,1.5666666666666667,3.1
143,Mathias Autret,FRA,"MF,FW",Brest,Ligue 1,28,1991,13.6,23,17,5,11,7,8,25,32.0,17,14,1,13,10,33,3,0,0,2019-2020,0.7352941176470589,1.6911764705882353
144,Ezequiel Ávila,ARG,FW,Osasuna,La Liga,25,1994,17.7,17,12,6,7,4,6,18,33.3,12,12,0,12,3,20,5,0,0,2019-2020,0.16949152542372883,0.96045197740113
145,Javier Avilés,ESP,"MF,FW",Leganés,La Liga,21,1997,2.0,9,7,2,7,0,2,4,50.0,2,3,0,3,3,12,1,0,0,2019-2020,1.5,4.5
146,Chidozie Awaziem,NGA,DF,Leganés,La Liga,22,1997,22.2,34,22,29,5,0,16,27,59.3,11,26,15,11,28,62,73,1,0,2019-2020,1.2612612612612613,1.5315315315315317
147,Taiwo Awoniyi,NGA,"FW,MF",Mainz 05,Bundesliga,21,1997,5.4,2,0,0,2,0,0,4,0.0,4,4,2,2,2,4,3,0,0,2019-2020,0.37037037037037035,0.37037037037037035
148,Florian Ayé,FRA,"FW,MF",Brescia,Serie A,22,1997,15.3,17,9,9,5,3,6,13,46.2,7,17,2,15,4,21,18,1,0,2019-2020,0.26143790849673204,1.1111111111111112
149,Jordan Ayew,GHA,FW,Crystal Palace,Premier League,27,1991,35.0,48,30,10,22,16,17,49,34.7,32,29,4,25,15,63,21,0,0,2019-2020,0.42857142857142855,1.3714285714285714
150,Kaan Ayhan,TUR,DF,Düsseldorf,Bundesliga,24,1994,30.3,38,25,26,11,1,20,37,54.1,17,28,15,13,45,83,72,1,0,2019-2020,1.4851485148514851,1.2541254125412542
Rk,Player,Nation,Pos,Squad,Comp,0,0,90.0,0,0,3,3,3,Tkl,0,0.0,0,0,0,0,0,0,0,0,0,2019-2020,0.0,0.0
151,Ramon Azeez,NGA,MF,Granada,La Liga,26,1992,15.1,11,8,2,8,1,7,19,36.8,12,8,2,6,19,30,11,1,0,2019-2020,1.2582781456953642,0.728476821192053
152,César Azpilicueta,ESP,DF,Chelsea,Premier League,29,1989,35.9,86,56,40,32,14,35,69,50.7,34,56,21,35,67,153,94,0,0,2019-2020,1.8662952646239555,2.3955431754874654
153,Ludovic Baal,GUF,DF,Brest,Ligue 1,33,1986,9.2,27,15,13,12,2,10,22,45.5,12,9,3,6,17,44,20,0,0,2019-2020,1.847826086956522,2.9347826086956523
154,Iddrisu Baba,GHA,MF,Mallorca,La Liga,23,1996,32.3,59,37,26,29,4,20,70,28.6,50,31,8,23,39,98,42,0,0,2019-2020,1.2074303405572757,1.8266253869969042
155,Khouma Babacar,SEN,FW,Lecce,Serie A,26,1993,15.8,12,8,2,6,4,1,7,14.3,6,12,3,9,3,15,34,0,0,2019-2020,0.18987341772151897,0.7594936708860759
156,Carlos Bacca,COL,FW,Villarreal,La Liga,32,1986,7.6,5,1,1,2,2,2,6,33.3,4,4,0,4,0,5,7,0,0,2019-2020,0.0,0.6578947368421053
157,Milan Badelj,CRO,MF,Fiorentina,Serie A,30,1989,17.6,29,17,10,16,3,15,50,30.0,35,21,3,18,45,74,34,1,0,2019-2020,2.5568181818181817,1.6477272727272725
158,Matthias Bader,GER,DF,Köln,Bundesliga,22,1997,0.1,1,1,1,0,0,1,2,50.0,1,0,0,0,0,1,1,0,0,2019-2020,0.0,10.0
159,Benoît Badiashile,FRA,DF,Monaco,Ligue 1,18,2001,15.7,18,12,12,5,1,6,12,50.0,6,20,11,9,27,45,57,1,0,2019-2020,1.7197452229299364,1.1464968152866242
160,Bastian Badu,FRA,FW,Montpellier,Ligue 1,19,2000,0.1,0,0,0,0,0,0,0,0.0,0,0,0,0,0,0,0,0,0,2019-2020,0.0,0.0
161,Alex Baena,ESP,MF,Villarreal,La Liga,18,2001,0.2,0,0,0,0,0,0,0,0.0,0,1,0,1,0,0,0,0,0,2019-2020,0.0,0.0
162,Stéphane Bahoken,CMR,FW,Angers,Ligue 1,27,1992,10.1,7,4,1,2,4,1,7,14.3,6,4,1,3,2,9,2,0,0,2019-2020,0.19801980198019803,0.6930693069306931
163,Daniel Baier,GER,MF,Augsburg,Bundesliga,35,1984,21.6,33,17,14,14,5,15,43,34.9,28,19,7,12,58,91,27,0,0,2019-2020,2.685185185185185,1.5277777777777777
164,Leon Bailey,JAM,"FW,MF",Leverkusen,Bundesliga,21,1997,12.1,6,3,1,5,0,6,16,37.5,10,9,0,9,8,14,3,0,0,2019-2020,0.6611570247933884,0.49586776859504134
165,Eric Bailly,CIV,DF,Manchester Utd,Premier League,25,1994,1.7,0,0,0,0,0,0,1,0.0,1,3,3,0,4,4,7,1,0,2019-2020,2.3529411764705883,0.0
166,Dénys Bain,FRA,DF,Brest,Ligue 1,26,1993,14.1,21,14,15,6,0,9,9,100.0,0,13,10,3,28,49,66,0,0,2019-2020,1.9858156028368794,1.4893617021276595
167,Leighton Baines,ENG,DF,Everton,Premier League,34,1984,4.5,10,6,6,2,2,8,10,80.0,2,5,2,3,5,15,14,0,0,2019-2020,1.1111111111111112,2.2222222222222223
168,Stefan Bajic,FRA,GK,Saint-Étienne,Ligue 1,17,2001,1.0,0,0,0,0,0,0,0,0.0,0,1,0,1,0,0,2,0,0,2019-2020,0.0,0.0
169,Tiemoué Bakayoko,FRA,MF,Monaco,Ligue 1,24,1994,19.1,48,24,16,27,5,29,54,53.7,25,12,4,8,29,77,17,0,0,2019-2020,1.5183246073298429,2.513089005235602
170,Lewis Baker,ENG,MF,Düsseldorf,Bundesliga,24,1995,6.1,8,5,6,2,0,2,10,20.0,8,5,2,3,2,10,5,0,0,2019-2020,0.3278688524590164,1.3114754098360657
171,Mitchel Bakker,NED,DF,Paris S-G,Ligue 1,19,2000,1.0,2,2,1,1,0,1,1,100.0,0,0,0,0,0,2,2,0,0,2019-2020,0.0,2.0
172,Ridle Baku,GER,"DF,MF",Mainz 05,Bundesliga,21,1998,26.1,54,31,25,22,7,26,53,49.1,27,45,7,38,42,96,57,0,0,2019-2020,1.6091954022988504,2.068965517241379
173,Fabián Balbuena,PAR,DF,West Ham,Premier League,27,1991,13.1,17,12,13,3,1,9,25,36.0,16,15,5,10,26,43,75,3,0,2019-2020,1.984732824427481,1.297709923664122
174,Keita Baldé,SEN,"FW,MF",Monaco,Ligue 1,24,1995,9.5,6,5,1,1,4,3,9,33.3,6,4,1,3,2,8,7,1,0,2019-2020,0.21052631578947367,0.631578947368421
175,George Baldock,GRE,DF,Sheffield Utd,Premier League,26,1993,38.0,62,43,35,17,10,27,47,57.4,20,26,3,23,34,96,83,3,0,2019-2020,0.8947368421052632,1.631578947368421
Rk,Player,Nation,Pos,Squad,Comp,0,0,90.0,0,0,3,3,3,Tkl,0,0.0,0,0,0,0,0,0,0,0,0,2019-2020,0.0,0.0
176,Gareth Bale,WAL,"FW,MF",Real Madrid,La Liga,30,1989,12.1,9,5,5,2,2,3,14,21.4,11,8,2,6,6,15,9,0,0,2019-2020,0.49586776859504134,0.7438016528925621
177,Mikel Balenziaga,ESP,DF,Athletic Club,La Liga,31,1988,6.3,15,10,4,10,1,9,11,81.8,2,4,1,3,2,17,20,0,0,2019-2020,0.31746031746031744,2.380952380952381
178,Leonardo Balerdi,ARG,"DF,MF",Dortmund,Bundesliga,20,1999,1.5,2,1,1,1,0,2,2,100.0,0,0,0,0,4,6,3,0,0,2019-2020,2.6666666666666665,1.3333333333333333
179,Marco Ballarini,ITA,MF,Udinese,Serie A,18,2001,0.0,0,0,0,0,0,0,0,0.0,0,0,0,0,0,0,0,0,0,2019-2020,,
180,Fodé Ballo-Touré,SEN,DF,Monaco,Ligue 1,22,1997,18.7,36,25,21,11,4,17,32,53.1,15,10,1,9,24,60,45,0,0,2019-2020,1.2834224598930482,1.9251336898395723
181,Florent Balmont,FRA,MF,Dijon,Ligue 1,39,1980,4.5,12,6,5,7,0,7,12,58.3,5,6,0,6,1,13,3,0,0,2019-2020,0.2222222222222222,2.6666666666666665
182,Mario Balotelli,ITA,FW,Brescia,Serie A,28,1990,15.6,2,2,0,2,0,0,2,0.0,2,1,1,0,8,10,22,0,0,2019-2020,0.5128205128205129,0.12820512820512822
183,Abdoulaye Bamba,CIV,DF,Angers,Ligue 1,29,1990,6.2,10,7,7,1,2,8,15,53.3,7,4,1,3,4,14,18,0,0,2019-2020,0.6451612903225806,1.6129032258064515
184,Jonathan Bamba,CIV,"FW,MF",Lille,Ligue 1,23,1996,21.5,12,6,5,5,2,7,29,24.1,22,19,3,16,16,28,8,2,0,2019-2020,0.7441860465116279,0.5581395348837209
185,Éver Banega,ARG,MF,Sevilla,La Liga,31,1988,27.5,43,28,16,18,9,21,70,30.0,49,19,1,18,15,58,5,0,0,2019-2020,0.5454545454545454,1.5636363636363637
186,Mattia Bani,ITA,DF,Bologna,Serie A,25,1993,24.5,47,28,27,19,1,25,36,69.4,11,29,15,14,52,99,92,2,0,2019-2020,2.122448979591837,1.9183673469387754
187,Antonín Barák,CZE,"MF,FW",Udinese,Serie A,24,1994,2.2,5,4,3,0,2,1,5,20.0,4,6,1,5,0,5,4,0,0,2019-2020,0.0,2.2727272727272725
188,Antonín Barák,CZE,MF,Lecce,Serie A,24,1994,15.2,19,10,9,10,0,6,24,25.0,18,18,1,17,9,28,20,2,0,2019-2020,0.5921052631578948,1.25
189,Federico Barba,ITA,DF,Valladolid,La Liga,25,1993,5.0,12,6,10,2,0,7,9,77.8,2,5,2,3,8,20,12,0,0,2019-2020,1.6,2.4
190,Danilo Barbosa,BRA,"DF,MF",Nice,Ligue 1,23,1996,12.5,28,21,17,9,2,13,29,44.8,16,21,6,15,20,48,38,0,0,2019-2020,1.6,2.24
191,Melvin Bard,FRA,DF,Lyon,Ligue 1,18,2000,0.5,0,0,0,0,0,0,0,0.0,0,0,0,0,1,1,0,0,0,2019-2020,2.0,0.0
192,Enis Bardhi,MKD,MF,Levante,La Liga,24,1995,23.5,24,11,7,15,2,8,35,22.9,27,15,4,11,15,39,19,0,0,2019-2020,0.6382978723404256,1.0212765957446808
193,Phil Bardsley,SCO,DF,Burnley,Premier League,34,1985,21.0,49,36,16,24,9,24,37,64.9,13,24,11,13,30,79,73,0,0,2019-2020,1.4285714285714286,2.3333333333333335
194,Nicolò Barella,ITA,MF,Inter,Serie A,22,1997,22.4,36,21,14,15,7,8,37,21.6,29,20,5,15,14,50,14,0,0,2019-2020,0.625,1.6071428571428572
195,Philipp Bargfrede,GER,MF,Werder Bremen,Bundesliga,30,1989,6.5,15,12,8,5,2,6,23,26.1,17,8,2,6,16,31,15,0,0,2019-2020,2.4615384615384617,2.3076923076923075
196,Antonino Barillà,ITA,MF,Parma,Serie A,31,1988,18.8,43,31,22,19,2,16,45,35.6,29,26,8,18,17,60,32,0,0,2019-2020,0.9042553191489361,2.2872340425531914
197,Kike Barja,ESP,"MF,FW",Osasuna,La Liga,22,1997,3.5,1,1,1,0,0,1,1,100.0,0,3,1,2,0,1,2,0,0,2019-2020,0.0,0.2857142857142857
198,Ross Barkley,ENG,MF,Chelsea,Premier League,25,1993,12.3,16,9,6,6,4,5,18,27.8,13,7,2,5,7,23,7,0,0,2019-2020,0.5691056910569106,1.3008130081300813
199,Aymen Barkok,MAR,"FW,MF",Düsseldorf,Bundesliga,21,1998,0.9,1,1,0,0,1,0,2,0.0,2,2,0,2,3,4,1,0,0,2019-2020,3.333333333333333,1.1111111111111112
200,Ashley Barnes,ENG,FW,Burnley,Premier League,29,1989,15.0,10,5,3,5,2,3,9,33.3,6,7,2,5,6,16,9,0,0,2019-2020,0.4,0.6666666666666666
Rk,Player,Nation,Pos,Squad,Comp,0,0,90.0,0,0,3,3,3,Tkl,0,0.0,0,0,0,0,0,0,0,0,0,2019-2020,0.0,0.0
201,Harvey Barnes,ENG,"MF,FW",Leicester City,Premier League,21,1997,23.1,16,11,7,7,2,5,23,21.7,18,13,3,10,8,24,6,1,0,2019-2020,0.3463203463203463,0.6926406926406926
202,Antonio Barragán,ESP,DF,Betis,La Liga,32,1987,7.1,7,5,4,2,1,3,6,50.0,3,2,2,0,8,15,22,0,0,2019-2020,1.1267605633802817,0.9859154929577465
203,Antonio Barreca,ITA,"DF,FW",Genoa,Serie A,24,1995,12.2,10,7,5,3,2,4,5,80.0,1,12,7,5,1,11,22,0,0,2019-2020,0.0819672131147541,0.819672131147541
204,Leandro Barreiro Martins,LUX,MF,Mainz 05,Bundesliga,19,2000,10.4,38,21,16,19,3,14,29,48.3,15,18,3,15,9,47,18,1,0,2019-2020,0.8653846153846153,3.6538461538461537
205,Ander Barrenetxea,ESP,"FW,MF",Real Sociedad,La Liga,17,2001,4.9,12,9,5,5,2,4,10,40.0,6,3,0,3,3,15,4,0,0,2019-2020,0.6122448979591836,2.4489795918367343
206,Édgar Barreto,PAR,MF,Sampdoria,Serie A,35,1984,1.0,4,3,0,1,3,2,3,66.7,1,1,0,1,0,4,0,0,0,2019-2020,0.0,4.0
207,Musa Barrow,GAM,"FW,MF",Bologna,Serie A,20,1998,15.0,20,13,11,7,2,6,20,30.0,14,15,0,15,5,25,11,0,0,2019-2020,0.3333333333333333,1.3333333333333333
208,Musa Barrow,GAM,"FW,MF",Atalanta,Serie A,20,1998,2.1,1,1,0,0,1,1,4,25.0,3,4,0,4,0,1,1,0,0,2019-2020,0.0,0.47619047619047616
209,Fin Bartels,GER,"MF,FW",Werder Bremen,Bundesliga,32,1987,3.8,9,5,4,4,1,3,12,25.0,9,3,1,2,1,10,1,0,0,2019-2020,0.2631578947368421,2.368421052631579
210,Marc Bartra,ESP,"DF,MF",Betis,La Liga,28,1991,28.0,62,34,39,23,0,27,54,50.0,27,45,24,21,35,97,127,0,0,2019-2020,1.25,2.2142857142857144
211,Daniele Baselli,ITA,MF,Torino,Serie A,27,1992,14.2,43,23,17,19,7,13,40,32.5,27,20,4,16,25,68,25,0,0,2019-2020,1.7605633802816902,3.028169014084507
212,Chris Basham,ENG,DF,Sheffield Utd,Premier League,31,1988,36.0,85,48,58,20,7,48,81,59.3,33,38,15,23,77,162,173,1,0,2019-2020,2.138888888888889,2.361111111111111
213,Toma Bašić,CRO,MF,Bordeaux,Ligue 1,22,1996,11.0,26,22,9,16,1,12,27,44.4,15,14,2,12,9,35,12,1,0,2019-2020,0.8181818181818182,2.3636363636363638
214,Thomas Basila,FRA,DF,Nantes,Ligue 1,20,1999,4.6,6,3,2,4,0,4,4,100.0,0,0,0,0,4,10,14,0,0,2019-2020,0.8695652173913044,1.3043478260869565
215,Gil Bastião Dias,POR,"MF,DF",Granada,La Liga,22,1996,4.0,19,14,10,6,3,7,17,41.2,10,4,1,3,3,22,7,0,0,2019-2020,0.75,4.75
216,Gil Bastião Dias,POR,"DF,MF",Monaco,Ligue 1,22,1996,11.7,53,33,30,21,2,29,58,50.0,29,15,1,14,13,66,22,1,0,2019-2020,1.1111111111111112,4.52991452991453
217,Borja Bastón,ESP,"MF,FW",Aston Villa,Premier League,26,1992,0.2,1,0,0,1,0,0,2,0.0,2,1,0,1,0,1,0,1,0,2019-2020,0.0,5.0
218,Alessandro Bastoni,ITA,DF,Inter,Serie A,20,1999,21.3,32,17,14,11,7,15,24,62.5,9,18,9,9,26,58,54,0,0,2019-2020,1.220657276995305,1.5023474178403755
219,Bastos,ANG,DF,Lazio,Serie A,28,1991,8.5,9,5,6,3,0,4,11,36.4,7,13,8,5,13,22,26,0,0,2019-2020,1.5294117647058822,1.0588235294117647
220,Oliver Batista-Meier,GER,MF,Bayern Munich,Bundesliga,18,2001,0.1,0,0,0,0,0,0,2,0.0,2,0,0,0,0,0,0,0,0,2019-2020,0.0,0.0
221,Michy Batshuayi,BEL,FW,Chelsea,Premier League,25,1993,2.7,4,1,2,2,0,0,5,0.0,5,1,1,0,0,4,1,0,0,2019-2020,0.0,1.4814814814814814
222,Cristian Battocchio,ITA,MF,Brest,Ligue 1,27,1992,15.5,31,24,13,13,5,14,36,38.9,22,13,4,9,19,50,21,0,0,2019-2020,1.2258064516129032,2.0
223,Oliver Baumann,GER,GK,Hoffenheim,Bundesliga,29,1990,30.0,0,0,0,0,0,0,0,0.0,0,1,0,1,3,3,15,0,0,2019-2020,0.1,0.0
224,Julian Baumgartlinger,AUT,MF,Leverkusen,Bundesliga,31,1988,19.9,42,21,15,21,6,18,42,42.9,24,37,4,33,20,62,16,1,0,2019-2020,1.0050251256281408,2.1105527638190957
225,Christoph Baumgartner,AUT,"MF,FW",Hoffenheim,Bundesliga,19,1999,16.6,32,17,15,16,1,10,37,27.0,27,25,1,24,8,40,13,0,0,2019-2020,0.48192771084337344,1.9277108433734937
Rk,Player,Nation,Pos,Squad,Comp,0,0,90.0,0,0,3,3,3,Tkl,0,0.0,0,0,0,0,0,0,0,0,0,2019-2020,0.0,0.0
226,Noah Joel Sarenren Bazee,NGA,FW,Augsburg,Bundesliga,22,1996,4.2,4,3,0,4,0,1,4,25.0,3,2,1,1,5,9,4,0,0,2019-2020,1.1904761904761905,0.9523809523809523
227,Ihlas Bebou,TOG,"FW,MF",Hoffenheim,Bundesliga,25,1994,23.4,27,15,9,13,5,8,23,34.8,15,25,4,21,11,38,25,0,0,2019-2020,0.47008547008547014,1.153846153846154
228,Rodrigo Becão,BRA,DF,Udinese,Serie A,23,1996,24.6,56,25,34,19,3,26,46,56.5,20,40,20,20,45,101,77,0,0,2019-2020,1.8292682926829267,2.2764227642276422
229,Sheraldo Becker,SUR,"MF,FW",Union Berlin,Bundesliga,24,1995,6.0,2,1,2,0,0,1,3,33.3,2,1,0,1,0,2,1,0,0,2019-2020,0.0,0.3333333333333333
230,Timo Becker,GER,"DF,MF",Schalke 04,Bundesliga,22,1997,3.7,10,9,3,6,1,5,9,55.6,4,6,1,5,3,13,8,0,0,2019-2020,0.8108108108108107,2.7027027027027026
231,Jan Bednarek,POL,DF,Southampton,Premier League,23,1996,34.0,65,38,41,18,6,31,61,50.8,30,44,23,21,77,142,198,4,0,2019-2020,2.264705882352941,1.911764705882353
232,Asmir Begović,BIH,GK,Milan,Serie A,32,1987,1.4,0,0,0,0,0,0,0,0.0,0,0,0,0,0,0,0,0,0,2019-2020,0.0,0.0
233,Valon Behrami,SUI,MF,Genoa,Serie A,34,1985,12.3,34,26,13,17,4,8,32,25.0,24,25,10,15,9,43,16,0,0,2019-2020,0.7317073170731707,2.7642276422764227
234,Maximilian Beier,GER,FW,Hoffenheim,Bundesliga,16,2002,1.2,5,2,0,1,4,1,2,50.0,1,2,0,2,0,5,0,0,0,2019-2020,0.0,4.166666666666667
235,Gaëtan Belaud,FRA,DF,Brest,Ligue 1,32,1986,6.4,13,7,10,2,1,4,8,50.0,4,8,3,5,15,28,15,0,0,2019-2020,2.34375,2.03125
236,Ishak Belfodil,ALG,"FW,MF",Hoffenheim,Bundesliga,27,1992,3.0,0,0,0,0,0,0,1,0.0,1,0,0,0,0,0,2,0,0,2019-2020,0.0,0.0
237,Haris Belkebla,ALG,MF,Brest,Ligue 1,25,1994,20.2,44,24,17,17,10,10,28,35.7,18,25,5,20,53,97,21,2,0,2019-2020,2.623762376237624,2.1782178217821784
238,Raoul Bellanova,ITA,DF,Atalanta,Serie A,19,2000,0.2,0,0,0,0,0,0,0,0.0,0,0,0,0,0,0,0,0,0,2019-2020,0.0,0.0
239,Raoul Bellanova,ITA,DF,Bordeaux,Ligue 1,19,2000,0.7,1,1,1,0,0,0,1,0.0,1,0,0,0,0,1,0,0,0,2019-2020,0.0,1.4285714285714286
240,Karim Bellarabi,GER,"FW,DF",Leverkusen,Bundesliga,29,1990,15.8,19,11,9,7,3,9,28,32.1,19,16,0,16,10,29,4,0,0,2019-2020,0.6329113924050632,1.2025316455696202
241,Jean-Ricner Bellegarde,FRA,MF,Strasbourg,Ligue 1,21,1998,16.6,40,27,18,19,3,13,21,61.9,8,16,3,13,22,62,6,0,0,2019-2020,1.325301204819277,2.4096385542168672
242,Héctor Bellerín,ESP,"DF,MF",Arsenal,Premier League,24,1995,12.9,20,13,7,11,2,11,29,37.9,18,20,4,16,19,39,27,1,0,2019-2020,1.4728682170542635,1.5503875968992247
243,Andrea Belotti,ITA,FW,Torino,Serie A,25,1993,33.4,29,16,7,17,5,5,31,16.1,26,23,5,18,5,34,20,1,0,2019-2020,0.14970059880239522,0.8682634730538923
244,Fran Beltrán,ESP,MF,Celta Vigo,La Liga,20,1999,20.3,31,19,15,12,4,11,35,31.4,24,14,1,13,14,45,17,0,0,2019-2020,0.689655172413793,1.5270935960591132
245,Sami Ben Amar,MAR,FW,Nîmes,Ligue 1,21,1998,0.2,1,1,0,0,1,1,1,100.0,0,1,0,1,1,2,0,0,0,2019-2020,5.0,5.0
246,Hatem Ben Arfa,FRA,"MF,FW",Valladolid,La Liga,32,1987,1.8,0,0,0,0,0,0,4,0.0,4,1,0,1,0,0,0,0,0,2019-2020,0.0,0.0
247,Wissam Ben Yedder,FRA,FW,Monaco,Ligue 1,28,1990,24.0,22,16,2,12,8,8,19,42.1,11,12,0,12,4,26,1,0,0,2019-2020,0.16666666666666666,0.9166666666666666
248,Marco Benassi,ITA,MF,Fiorentina,Serie A,24,1994,10.9,18,12,9,5,4,10,24,41.7,14,11,1,10,4,22,9,0,0,2019-2020,0.36697247706422015,1.6513761467889907
249,Cristian Benavente,PER,"MF,FW",Nantes,Ligue 1,25,1994,3.9,8,5,2,5,1,2,8,25.0,6,1,0,1,3,11,0,0,0,2019-2020,0.7692307692307693,2.0512820512820515
250,Lars Bender,GER,"DF,MF",Leverkusen,Bundesliga,30,1989,15.3,42,26,17,20,5,19,38,50.0,19,32,6,26,24,66,30,0,0,2019-2020,1.5686274509803921,2.7450980392156863
Rk,Player,Nation,Pos,Squad,Comp,0,0,90.0,0,0,3,3,3,Tkl,0,0.0,0,0,0,0,0,0,0,0,0,2019-2020,0.0,0.0
251,Sven Bender,GER,DF,Leverkusen,Bundesliga,30,1989,30.3,53,34,29,17,7,23,48,47.9,25,42,13,29,67,120,88,2,0,2019-2020,2.211221122112211,1.749174917491749
252,Darío Benedetto,ARG,FW,Marseille,Ligue 1,29,1990,23.3,12,9,0,9,3,3,18,16.7,15,15,2,13,3,15,23,1,0,2019-2020,0.12875536480686695,0.5150214592274678
253,László Bénes,SVK,MF,Gladbach,Bundesliga,21,1997,10.0,15,8,3,5,7,6,19,31.6,13,6,2,4,8,23,3,1,0,2019-2020,0.8,1.5
254,Walter Benítez,ARG,GK,Nice,Ligue 1,26,1993,26.0,1,1,1,0,0,1,3,33.3,2,0,0,0,0,1,8,0,0,2019-2020,0.0,0.038461538461538464
255,Loris Benito,SUI,DF,Bordeaux,Ligue 1,27,1992,21.1,40,25,23,11,6,16,43,37.2,27,14,5,9,29,69,58,1,0,2019-2020,1.3744075829383886,1.895734597156398
256,Bilal Benkhedim,FRA,"MF,FW",Saint-Étienne,Ligue 1,18,2001,1.5,3,3,1,1,1,1,4,25.0,3,1,0,1,1,4,0,0,0,2019-2020,0.6666666666666666,2.0
257,Ismaël Bennacer,ALG,MF,Milan,Serie A,21,1997,27.6,67,47,21,34,12,29,73,39.7,44,25,7,18,54,121,15,2,0,2019-2020,1.9565217391304346,2.4275362318840576
258,Ryan Bennett,ENG,DF,Wolves,Premier League,29,1990,6.7,4,2,4,0,0,2,6,33.3,4,14,8,6,9,13,29,0,0,2019-2020,1.3432835820895521,0.5970149253731343
259,Ryan Bennett,ENG,DF,Leicester City,Premier League,29,1990,3.7,5,4,3,2,0,4,6,66.7,2,3,1,2,7,12,8,0,0,2019-2020,1.8918918918918919,1.3513513513513513
260,Keanan Bennetts,ENG,MF,Gladbach,Bundesliga,20,1999,0.0,0,0,0,0,0,0,1,0.0,1,0,0,0,0,0,0,0,0,2019-2020,,
261,Yassine Benrahou,FRA,"FW,MF",Bordeaux,Ligue 1,20,1999,1.9,3,0,1,1,1,2,5,40.0,3,1,0,1,2,5,1,0,0,2019-2020,1.0526315789473684,1.5789473684210527
262,Yassine Benrahou,FRA,"MF,FW",Nîmes,Ligue 1,20,1999,8.5,13,8,3,3,7,5,16,31.3,11,1,0,1,2,15,0,0,0,2019-2020,0.23529411764705882,1.5294117647058822
263,Ramy Bensebaini,ALG,DF,Gladbach,Bundesliga,24,1995,16.1,33,17,17,12,4,18,31,58.1,13,24,4,20,38,71,49,0,0,2019-2020,2.3602484472049685,2.0496894409937885
264,Nabil Bentaleb,ALG,MF,Newcastle Utd,Premier League,24,1994,8.3,23,13,14,9,0,7,25,28.0,18,9,2,7,19,42,9,1,0,2019-2020,2.2891566265060237,2.7710843373493974
265,Rodrigo Bentancur,URU,MF,Juventus,Serie A,22,1997,24.4,58,32,27,18,13,31,66,47.0,35,44,9,35,32,90,34,1,0,2019-2020,1.3114754098360657,2.377049180327869
266,Christian Benteke,BEL,FW,Crystal Palace,Premier League,28,1990,14.0,9,5,1,6,2,0,10,0.0,10,11,4,7,4,13,28,1,0,2019-2020,0.2857142857142857,0.6428571428571429
267,Romario Benzar,ROU,DF,Lecce,Serie A,27,1992,1.1,2,2,1,1,0,2,3,66.7,1,1,0,1,0,2,2,0,0,2019-2020,0.0,1.8181818181818181
268,Karim Benzema,FRA,FW,Real Madrid,La Liga,31,1987,34.9,18,8,3,11,4,2,16,12.5,14,16,4,12,7,25,30,1,0,2019-2020,0.2005730659025788,0.5157593123209169
269,Yassine Benzia,ALG,MF,Dijon,Ligue 1,24,1994,1.9,3,2,2,1,0,1,6,16.7,5,4,2,2,3,6,1,0,0,2019-2020,1.5789473684210527,1.5789473684210527
270,Domenico Berardi,ITA,FW,Sassuolo,Serie A,24,1994,27.7,32,16,19,8,5,13,59,22.0,46,31,3,28,33,65,27,0,0,2019-2020,1.1913357400722022,1.1552346570397112
271,Yuri Berchiche,ESP,DF,Athletic Club,La Liga,29,1990,31.7,48,35,32,15,1,21,40,52.5,19,26,4,22,30,78,73,1,0,2019-2020,0.9463722397476341,1.5141955835962146
272,Álex Berenguer,ESP,"MF,DF",Torino,Serie A,24,1995,20.3,20,6,6,13,1,8,33,24.2,25,17,1,16,18,38,17,0,0,2019-2020,0.8866995073891625,0.9852216748768473
273,Bartosz Bereszyński,POL,DF,Sampdoria,Serie A,27,1992,26.7,53,35,25,23,5,26,52,50.0,26,38,16,22,35,88,88,1,0,2019-2020,1.3108614232209739,1.9850187265917603
274,Jóhann Berg Guðmundsson,ISL,MF,Burnley,Premier League,28,1990,6.9,4,2,2,2,0,1,8,12.5,7,8,1,7,7,11,9,0,0,2019-2020,1.0144927536231882,0.5797101449275363
275,Markel Bergara,ESP,MF,Getafe,La Liga,33,1986,0.8,0,0,0,0,0,0,0,0.0,0,0,0,0,0,0,2,0,0,2019-2020,0.0,0.0
Rk,Player,Nation,Pos,Squad,Comp,0,0,90.0,0,0,3,3,3,Tkl,0,0.0,0,0,0,0,0,0,0,0,0,2019-2020,0.0,0.0
276,Sander Berge,NOR,MF,Sheffield Utd,Premier League,21,1998,10.5,22,15,3,14,5,5,10,50.0,5,15,1,14,10,32,16,0,0,2019-2020,0.9523809523809523,2.0952380952380953
277,Steven Bergwijn,NED,"FW,MF",Tottenham,Premier League,21,1997,7.8,10,6,3,6,1,4,12,33.3,8,12,0,12,1,11,5,0,0,2019-2020,0.12820512820512822,1.2820512820512822
278,Robert Berić,SVN,FW,Saint-Étienne,Ligue 1,28,1991,4.6,3,2,0,2,1,0,5,0.0,5,2,0,2,4,7,2,0,0,2019-2020,0.8695652173913044,0.6521739130434783
279,Etrit Berisha,ALB,GK,SPAL,Serie A,30,1989,26.0,3,2,3,0,0,2,3,66.7,1,0,0,0,1,4,9,0,0,2019-2020,0.038461538461538464,0.11538461538461539
280,Valon Berisha,KVX,MF,Lazio,Serie A,26,1993,0.4,1,1,0,1,0,1,2,50.0,1,0,0,0,0,1,1,0,0,2019-2020,0.0,2.5
281,Valon Berisha,KVX,MF,Düsseldorf,Bundesliga,26,1993,10.5,14,9,3,8,3,6,21,28.6,15,4,1,3,9,23,8,0,0,2019-2020,0.8571428571428571,1.3333333333333333
282,Sergio Bermejo,ESP,"MF,FW",Celta Vigo,La Liga,21,1997,0.1,0,0,0,0,0,0,0,0.0,0,0,0,0,0,0,0,0,0,2019-2020,0.0,0.0
283,Bernard,BRA,"MF,FW",Everton,Premier League,26,1992,14.2,32,22,12,14,6,13,44,29.5,31,22,2,20,16,48,7,0,0,2019-2020,1.1267605633802817,2.2535211267605635
284,Federico Bernardeschi,ITA,"MF,FW",Juventus,Serie A,25,1994,17.5,13,5,4,5,4,5,25,20.0,20,11,0,11,13,26,12,1,0,2019-2020,0.7428571428571429,0.7428571428571429
285,Bernardo,BRA,"DF,MF",Brighton,Premier League,24,1995,7.5,27,16,12,9,6,13,17,76.5,4,7,3,4,6,33,24,0,0,2019-2020,0.8,3.6
286,Paul Bernardoni,FRA,GK,Nîmes,Ligue 1,22,1997,24.5,0,0,0,0,0,0,1,0.0,1,0,0,0,0,0,11,1,0,2019-2020,0.0,0.0
287,Juan Bernat,ESP,"DF,MF",Paris S-G,Ligue 1,26,1993,15.4,42,27,19,16,7,20,51,39.2,31,13,1,12,10,52,26,0,0,2019-2020,0.6493506493506493,2.727272727272727
288,Dimitry Bertaud,COD,GK,Montpellier,Ligue 1,21,1998,2.2,0,0,0,0,0,0,0,0.0,0,0,0,0,0,0,0,0,0,2019-2020,0.0,0.0
289,Andrea Bertolacci,ITA,MF,Sampdoria,Serie A,28,1991,5.9,7,4,2,3,2,1,8,12.5,7,4,1,3,2,9,13,0,0,2019-2020,0.3389830508474576,1.1864406779661016
290,Ryan Bertrand,ENG,DF,Southampton,Premier League,29,1989,30.5,47,29,22,15,10,26,58,44.8,32,27,12,15,37,84,31,1,0,2019-2020,1.2131147540983607,1.540983606557377
291,Muhamed Bešić,BIH,MF,Sheffield Utd,Premier League,26,1992,2.8,8,6,4,4,0,2,5,40.0,3,4,0,4,1,9,6,0,0,2019-2020,0.35714285714285715,2.857142857142857
292,Jordan Beyer,GER,DF,Gladbach,Bundesliga,19,2000,1.2,3,1,3,0,0,0,1,0.0,1,4,2,2,1,4,4,0,0,2019-2020,0.8333333333333334,2.5
293,Ermin Bičakčić,BIH,DF,Hoffenheim,Bundesliga,29,1990,13.1,7,3,5,2,0,4,11,36.4,7,14,8,6,25,32,64,2,0,2019-2020,1.9083969465648856,0.5343511450381679
294,Pedro Bigas,ESP,DF,Eibar,La Liga,28,1990,19.7,18,9,11,7,0,9,19,47.4,10,16,10,6,36,54,82,0,0,2019-2020,1.8274111675126905,0.9137055837563453
295,Lucas Biglia,ARG,MF,Milan,Serie A,33,1986,7.6,13,7,7,6,0,4,15,26.7,11,12,4,8,7,20,10,1,0,2019-2020,0.9210526315789475,1.7105263157894737
296,El Bilal Touré,MLI,FW,Reims,Ligue 1,17,2001,5.0,3,3,1,0,2,0,0,0.0,0,6,0,6,1,4,1,0,0,2019-2020,0.2,0.6
297,Philip Billing,DEN,MF,Bournemouth,Premier League,23,1996,28.1,72,46,30,37,5,17,65,26.2,48,59,16,43,66,138,97,1,0,2019-2020,2.3487544483985765,2.562277580071174
298,Cristiano Biraghi,ITA,DF,Inter,Serie A,26,1992,17.5,22,6,10,8,4,10,24,41.7,14,21,7,14,13,35,41,0,0,2019-2020,0.7428571428571429,1.2571428571428571
299,Davide Biraschi,ITA,DF,Genoa,Serie A,25,1994,21.9,32,17,17,13,2,15,26,57.7,11,22,12,10,34,66,69,0,0,2019-2020,1.5525114155251143,1.4611872146118723
300,Valter Birsa,SVN,"MF,FW",Cagliari,Serie A,32,1986,4.8,10,6,3,6,1,7,21,33.3,14,6,1,5,4,14,3,0,0,2019-2020,0.8333333333333334,2.0833333333333335
Rk,Player,Nation,Pos,Squad,Comp,0,0,90.0,0,0,3,3,3,Tkl,0,0.0,0,0,0,0,0,0,0,0,0,2019-2020,0.0,0.0
301,Dimitri Bisoli,ITA,MF,Brescia,Serie A,25,1994,23.9,64,35,34,20,10,30,49,61.2,19,41,7,34,25,89,49,0,0,2019-2020,1.0460251046025104,2.677824267782427
302,Yves Bissouma,MLI,MF,Brighton,Premier League,22,1996,14.0,49,38,24,22,3,17,40,42.5,23,18,2,16,21,70,23,0,0,2019-2020,1.5,3.5
303,Leonardo Bittencourt,GER,MF,Hoffenheim,Bundesliga,25,1993,0.0,1,1,0,0,1,0,0,0.0,0,0,0,0,0,1,0,0,0,2019-2020,,inf
304,Leonardo Bittencourt,GER,"FW,MF",Werder Bremen,Bundesliga,25,1993,21.0,52,28,23,18,11,9,51,17.6,42,20,3,17,12,64,14,0,0,2019-2020,0.5714285714285714,2.4761904761904763
305,Birkir Bjarnason,ISL,"MF,FW",Brescia,Serie A,31,1988,8.9,5,3,1,3,1,2,13,15.4,11,9,4,5,5,10,4,0,0,2019-2020,0.5617977528089887,0.5617977528089887
306,Rubén Blanco,ESP,GK,Celta Vigo,La Liga,24,1995,32.9,1,1,1,0,0,1,1,100.0,0,0,0,0,0,1,14,1,0,2019-2020,0.0,0.030395136778115502
307,Ludovic Blas,FRA,"FW,MF",Nantes,Ligue 1,21,1997,20.5,26,18,7,15,4,5,26,19.2,21,17,1,16,14,40,11,0,0,2019-2020,0.6829268292682927,1.2682926829268293
308,Pablo de Blasis,ARG,"DF,MF",Eibar,La Liga,31,1988,17.8,41,32,22,13,6,30,63,47.6,33,13,0,13,24,65,21,0,0,2019-2020,1.348314606741573,2.303370786516854
309,Alejandro Blesa,ESP,MF,Levante,La Liga,17,2002,0.0,0,0,0,0,0,0,1,0.0,1,0,0,0,0,0,0,0,0,2019-2020,,
310,Alexis Blin,FRA,MF,Amiens,Ligue 1,22,1996,20.5,39,25,18,15,6,20,61,32.8,41,25,6,19,16,55,49,0,0,2019-2020,0.7804878048780488,1.9024390243902438
311,Jérôme Boateng,GER,DF,Bayern Munich,Bundesliga,30,1988,20.0,21,14,9,12,0,11,22,50.0,11,15,11,4,33,54,58,1,0,2019-2020,1.65,1.05
312,Kevin-Prince Boateng,GHA,FW,Fiorentina,Serie A,32,1987,6.7,3,1,0,2,1,2,8,25.0,6,3,0,3,1,4,7,0,0,2019-2020,0.14925373134328357,0.44776119402985076
313,Antonin Bobichon,FRA,MF,Nîmes,Ligue 1,23,1995,2.0,4,3,1,3,0,3,3,100.0,0,1,0,1,1,5,0,0,0,2019-2020,0.5,2.0
314,Antonin Bobichon,FRA,MF,Angers,Ligue 1,23,1995,7.2,9,4,4,5,0,2,19,10.5,17,7,0,7,7,16,4,0,0,2019-2020,0.9722222222222222,1.25
315,Salvatore Bocchetti,ITA,DF,Hellas Verona,Serie A,32,1986,3.4,5,3,3,2,0,2,3,66.7,1,2,2,0,17,22,23,0,0,2019-2020,5.0,1.4705882352941178
316,Mathieu Bodmer,FRA,"MF,FW",Amiens,Ligue 1,36,1982,1.0,0,0,0,0,0,0,1,0.0,1,1,1,0,1,1,1,0,0,2019-2020,1.0,0.0
317,Adam Bodzek,GER,MF,Düsseldorf,Bundesliga,33,1985,22.4,42,26,21,20,1,14,46,30.4,32,34,11,23,25,67,39,0,0,2019-2020,1.1160714285714286,1.8750000000000002
318,Jean-Paul Boëtius,NED,MF,Mainz 05,Bundesliga,25,1994,25.2,63,33,21,31,11,20,57,35.1,37,38,1,37,26,89,6,0,0,2019-2020,1.0317460317460319,2.5
319,Sacha Boey,FRA,DF,Rennes,Ligue 1,18,2000,1.9,6,4,3,1,2,4,8,50.0,4,0,0,0,2,8,5,0,0,2019-2020,1.0526315789473684,3.1578947368421053
320,Jeremie Boga,CIV,FW,Sassuolo,Serie A,22,1997,27.9,12,7,3,8,1,6,20,30.0,14,24,0,24,3,15,4,0,0,2019-2020,0.10752688172043011,0.43010752688172044
321,Melayro Bogarde,NED,DF,Hoffenheim,Bundesliga,17,2002,0.6,2,1,2,0,0,2,2,100.0,0,0,0,0,0,2,3,0,0,2019-2020,0.0,3.3333333333333335
322,Quentin Boisgard,FRA,"MF,FW",Toulouse,Ligue 1,22,1997,12.7,31,19,10,14,7,14,35,40.0,21,11,0,11,12,43,4,1,0,2019-2020,0.9448818897637796,2.440944881889764
323,Willy Boly,CIV,DF,Wolves,Premier League,28,1991,22.0,57,33,36,21,0,25,43,58.1,18,28,11,17,39,96,108,3,0,2019-2020,1.7727272727272727,2.590909090909091
324,Giacomo Bonaventura,ITA,"MF,FW",Milan,Serie A,29,1989,14.9,16,9,5,6,5,5,17,29.4,12,8,3,5,7,23,10,0,0,2019-2020,0.4697986577181208,1.0738255033557047
325,Federico Bonazzoli,ITA,FW,Sampdoria,Serie A,22,1997,8.3,7,5,1,4,2,0,7,0.0,7,3,0,3,5,12,2,0,0,2019-2020,0.6024096385542168,0.8433734939759036
Rk,Player,Nation,Pos,Squad,Comp,0,0,90.0,0,0,3,3,3,Tkl,0,0.0,0,0,0,0,0,0,0,0,0,2019-2020,0.0,0.0
326,Gaëtan Bong,CMR,"DF,MF",Brighton,Premier League,31,1988,0.7,1,0,0,0,1,0,0,0.0,0,1,1,0,0,1,0,0,0,2019-2020,0.0,1.4285714285714286
327,Kevin Bonifazi,ITA,DF,Torino,Serie A,23,1996,2.7,9,8,6,3,0,5,6,83.3,1,3,2,1,5,14,10,0,0,2019-2020,1.8518518518518516,3.333333333333333
328,Kevin Bonifazi,ITA,DF,SPAL,Serie A,23,1996,13.2,16,9,15,1,0,9,18,50.0,9,20,12,8,35,51,50,2,0,2019-2020,2.651515151515152,1.2121212121212122
329,Federico Bonini,ITA,DF,Bologna,Serie A,17,2001,0.1,0,0,0,0,0,0,0,0.0,0,0,0,0,0,0,0,0,0,2019-2020,0.0,0.0
330,Leonardo Bonucci,ITA,DF,Juventus,Serie A,32,1987,34.2,28,17,18,8,2,12,17,70.6,5,32,29,3,31,59,94,2,0,2019-2020,0.9064327485380116,0.8187134502923976
331,Fabio Borini,ITA,"MF,FW",Hellas Verona,Serie A,28,1991,9.0,2,1,2,0,0,0,4,0.0,4,3,0,3,13,15,6,0,0,2019-2020,1.4444444444444444,0.2222222222222222
332,Fabio Borini,ITA,MF,Milan,Serie A,28,1991,0.8,2,2,0,0,2,0,2,0.0,2,1,0,1,0,2,3,0,0,2019-2020,0.0,2.5
333,Dennis Borkowski,GER,FW,RB Leipzig,Bundesliga,17,2002,0.1,0,0,0,0,0,0,0,0.0,0,0,0,0,0,0,0,0,0,2019-2020,0.0,0.0
334,Robin Bormuth,GER,DF,Düsseldorf,Bundesliga,23,1995,2.0,2,1,2,0,0,2,3,66.7,1,6,5,1,0,2,12,0,0,2019-2020,0.0,1.0
335,Sebastiaan Bornauw,BEL,DF,Köln,Bundesliga,20,1999,27.2,37,24,24,12,1,20,39,51.3,19,32,12,20,42,79,99,0,0,2019-2020,1.5441176470588236,1.3602941176470589
336,Brandon Borrello,AUS,"MF,FW",Freiburg,Bundesliga,24,1995,3.3,10,4,6,4,0,4,10,40.0,6,7,1,6,1,11,1,0,0,2019-2020,0.30303030303030304,3.0303030303030303
337,Gabriel Boschilia,BRA,"MF,FW",Monaco,Ligue 1,23,1996,1.4,3,1,0,3,0,1,5,20.0,4,1,1,0,2,5,2,0,0,2019-2020,1.4285714285714286,2.142857142857143
338,Denis Bouanga,GAB,"FW,MF",Saint-Étienne,Ligue 1,24,1994,22.7,45,34,10,25,10,20,55,36.4,35,30,0,30,10,55,15,0,0,2019-2020,0.4405286343612335,1.9823788546255507
339,Hicham Boudaoui,ALG,"MF,FW",Nice,Ligue 1,19,1999,5.4,20,10,6,11,3,9,23,39.1,14,10,3,7,13,33,7,0,0,2019-2020,2.4074074074074074,3.7037037037037033
340,Ryad Boudebouz,ALG,"MF,FW",Saint-Étienne,Ligue 1,29,1990,17.7,25,16,9,14,2,8,25,32.0,17,14,1,13,7,32,5,0,0,2019-2020,0.3954802259887006,1.4124293785310735
341,Sofiane Boufal,MAR,"MF,FW",Southampton,Premier League,25,1993,8.5,16,8,6,5,5,6,15,40.0,9,17,0,17,4,20,1,0,0,2019-2020,0.47058823529411764,1.8823529411764706
342,Nassim Boujellab,MAR,"MF,FW",Schalke 04,Bundesliga,20,1999,4.7,12,10,5,4,3,5,14,35.7,9,8,1,7,7,19,5,0,0,2019-2020,1.4893617021276595,2.553191489361702
343,Farid Boulaya,ALG,FW,Metz,Ligue 1,26,1993,9.1,14,10,7,4,3,7,19,36.8,12,5,0,5,6,20,3,0,0,2019-2020,0.6593406593406593,1.5384615384615385
344,Yassine Bounou,MAR,GK,Sevilla,La Liga,28,1991,5.5,0,0,0,0,0,0,0,0.0,0,0,0,0,0,0,0,0,0,2019-2020,0.0,0.0
345,Mehdi Bourabia,MAR,MF,Sassuolo,Serie A,27,1991,10.3,19,9,8,10,1,9,22,40.9,13,12,2,10,22,41,23,0,0,2019-2020,2.1359223300970873,1.8446601941747571
346,Benjamin Bourigeaud,FRA,MF,Rennes,Ligue 1,25,1994,21.1,40,12,18,20,2,17,68,25.0,51,38,7,31,20,60,25,0,0,2019-2020,0.947867298578199,1.895734597156398
347,Bilal Boutobba,FRA,MF,Montpellier,Ligue 1,20,1998,0.1,0,0,0,0,0,0,1,0.0,1,0,0,0,0,0,0,0,0,2019-2020,0.0,0.0
348,Jarrod Bowen,ENG,"FW,MF",West Ham,Premier League,22,1996,10.2,19,15,7,9,3,4,17,23.5,13,6,0,6,16,35,8,0,0,2019-2020,1.5686274509803924,1.8627450980392157
349,Dedryck Boyata,BEL,DF,Hertha BSC,Bundesliga,28,1990,27.1,24,18,17,5,2,4,12,33.3,8,39,32,7,62,86,158,1,0,2019-2020,2.2878228782287824,0.8856088560885609
350,John Boye,GHA,DF,Metz,Ligue 1,32,1987,23.5,30,19,25,5,0,19,32,59.4,13,31,18,13,31,61,116,0,0,2019-2020,1.3191489361702127,1.2765957446808511
Rk,Player,Nation,Pos,Squad,Comp,0,0,90.0,0,0,3,3,3,Tkl,0,0.0,0,0,0,0,0,0,0,0,0,2019-2020,0.0,0.0
351,Can Bozdogan,GER,MF,Schalke 04,Bundesliga,18,2001,2.6,8,6,5,3,0,3,12,25.0,9,2,0,2,2,10,2,0,0,2019-2020,0.7692307692307692,3.0769230769230766
352,Domagoj Bradarić,CRO,DF,Lille,Ligue 1,19,1999,15.8,28,11,9,17,2,12,27,44.4,15,16,3,13,22,50,28,0,0,2019-2020,1.3924050632911391,1.7721518987341771
353,Filip Bradarić,CRO,MF,Celta Vigo,La Liga,27,1992,7.8,12,9,5,5,2,3,8,37.5,5,12,3,9,17,29,19,0,0,2019-2020,2.1794871794871797,1.5384615384615385
354,Robbie Brady,IRL,MF,Burnley,Premier League,27,1992,5.0,11,9,5,4,2,3,10,30.0,7,10,2,8,5,16,8,0,0,2019-2020,1.0,2.2
355,Martin Braithwaite,DEN,"FW,MF",Barcelona,La Liga,28,1991,4.5,2,2,2,0,0,0,8,0.0,8,3,0,3,1,3,1,0,0,2019-2020,0.2222222222222222,0.4444444444444444
356,Martin Braithwaite,DEN,"FW,MF",Leganés,La Liga,28,1991,21.5,13,7,4,5,4,4,12,33.3,8,10,2,8,4,17,9,0,0,2019-2020,0.18604651162790697,0.6046511627906976
357,Federico Brancolini,ITA,GK,Fiorentina,Serie A,18,2001,0.1,0,0,0,0,0,0,0,0.0,0,0,0,0,0,0,0,0,0,2019-2020,0.0,0.0
358,Brandon,ESP,FW,Osasuna,La Liga,24,1995,4.5,5,3,1,3,1,0,5,0.0,5,4,0,4,0,5,1,0,0,2019-2020,0.0,1.1111111111111112
359,Julian Brandt,GER,"MF,FW",Dortmund,Bundesliga,23,1996,24.5,48,33,15,21,12,25,55,45.5,30,35,2,33,16,64,10,1,0,2019-2020,0.6530612244897959,1.9591836734693877
360,Jarrad Branthwaite,ENG,DF,Everton,Premier League,17,2002,3.3,8,7,5,3,0,3,5,60.0,2,6,3,3,2,10,12,0,0,2019-2020,0.6060606060606061,2.4242424242424243
361,Darko Brašanac,SRB,MF,Osasuna,La Liga,27,1992,24.9,45,25,14,26,5,15,41,36.6,26,19,4,15,20,65,21,0,0,2019-2020,0.8032128514056225,1.8072289156626506
362,Claudio Bravo,CHI,GK,Manchester City,Premier League,36,1983,3.9,0,0,0,0,0,0,0,0.0,0,0,0,0,0,0,1,1,0,2019-2020,0.0,0.0
363,Josip Brekalo,CRO,"MF,FW",Wolfsburg,Bundesliga,21,1998,18.6,18,8,5,6,7,5,23,21.7,18,26,0,26,16,34,4,0,0,2019-2020,0.8602150537634408,0.9677419354838709
364,Gleison Bremer,BRA,DF,Torino,Serie A,22,1997,25.2,63,36,37,20,6,20,34,58.8,14,48,22,26,74,137,118,1,0,2019-2020,2.9365079365079367,2.5
365,Marco Brescianini,ITA,MF,Milan,Serie A,19,2000,0.3,1,1,1,0,0,0,0,0.0,0,0,0,0,2,3,0,0,0,2019-2020,6.666666666666667,3.3333333333333335
366,Anthony Briançon,FRA,DF,Nîmes,Ligue 1,24,1994,19.3,29,19,20,9,0,17,34,50.0,17,22,16,6,39,68,80,0,0,2019-2020,2.0207253886010363,1.5025906735751295
367,Jimmy Briand,FRA,FW,Bordeaux,Ligue 1,33,1985,16.9,12,8,5,4,3,3,13,23.1,10,8,4,4,6,18,12,0,0,2019-2020,0.3550295857988166,0.7100591715976332
368,Yan Brice Eteki,CMR,MF,Granada,La Liga,21,1997,16.7,37,21,14,18,5,15,31,48.4,16,17,4,13,24,61,20,1,0,2019-2020,1.437125748502994,2.215568862275449
369,Armando Broja,ALB,FW,Chelsea,Premier League,17,2001,0.1,0,0,0,0,0,0,0,0.0,0,0,0,0,0,0,0,0,0,2019-2020,0.0,0.0
370,Dylan Bronn,TUN,DF,Metz,Ligue 1,24,1995,9.0,7,5,6,1,0,4,7,57.1,3,11,9,2,6,13,42,0,0,2019-2020,0.6666666666666666,0.7777777777777778
371,David Brooks,WAL,"MF,FW",Bournemouth,Premier League,22,1997,5.6,5,5,1,2,2,2,14,14.3,12,5,1,4,2,7,1,0,0,2019-2020,0.35714285714285715,0.8928571428571429
372,John Brooks,USA,DF,Wolfsburg,Bundesliga,26,1993,24.7,38,27,27,9,2,24,49,49.0,25,31,12,19,41,79,93,0,0,2019-2020,1.659919028340081,1.5384615384615385
373,Daniel Brosinski,GER,DF,Mainz 05,Bundesliga,31,1988,19.0,40,27,13,23,4,15,34,44.1,19,16,2,14,14,54,58,0,0,2019-2020,0.7368421052631579,2.1052631578947367
374,Josh Brownhill,ENG,MF,Burnley,Premier League,23,1995,8.9,14,8,5,7,2,5,13,38.5,8,9,4,5,14,28,18,0,0,2019-2020,1.5730337078651684,1.5730337078651684
375,Marcelo Brozović,CRO,MF,Inter,Serie A,26,1992,30.0,67,35,26,31,10,19,71,26.8,52,26,9,17,46,113,46,2,0,2019-2020,1.5333333333333334,2.2333333333333334
Rk,Player,Nation,Pos,Squad,Comp,0,0,90.0,0,0,3,3,3,Tkl,0,0.0,0,0,0,0,0,0,0,0,0,2019-2020,0.0,0.0
376,Gastón Brugman,URU,MF,Parma,Serie A,26,1992,16.2,47,24,25,15,7,19,46,41.3,27,33,15,18,27,74,19,2,0,2019-2020,1.6666666666666667,2.9012345679012346
377,Jeffrey Bruma,NED,DF,Wolfsburg,Bundesliga,27,1991,9.0,9,5,4,5,0,7,13,53.8,6,6,3,3,13,22,51,1,0,2019-2020,1.4444444444444444,1.0
378,Jeffrey Bruma,NED,DF,Mainz 05,Bundesliga,27,1991,7.5,12,8,8,4,0,4,6,66.7,2,11,5,6,6,18,34,1,0,2019-2020,0.8,1.6
379,Jacob Bruun Larsen,DEN,"FW,MF",Hoffenheim,Bundesliga,20,1998,4.3,3,2,3,0,0,3,8,37.5,5,3,0,3,3,6,1,0,0,2019-2020,0.6976744186046512,0.6976744186046512
380,Jacob Bruun Larsen,DEN,FW,Dortmund,Bundesliga,20,1998,0.8,0,0,0,0,0,0,0,0.0,0,0,0,0,0,0,0,0,0,2019-2020,0.0,0.0
381,Lucas Buadés,FRA,"MF,FW",Nîmes,Ligue 1,21,1997,1.3,4,4,3,1,0,1,5,20.0,4,0,0,0,1,5,3,0,0,2019-2020,0.7692307692307692,3.0769230769230766
382,Ante Budimir,CRO,FW,Mallorca,La Liga,28,1991,30.7,31,15,4,22,5,7,29,24.1,22,21,4,17,8,39,29,0,0,2019-2020,0.26058631921824105,1.009771986970684
383,Emi Buendía,ARG,"FW,MF",Norwich City,Premier League,22,1996,27.4,82,39,57,21,4,38,118,32.2,80,58,5,53,23,105,32,2,0,2019-2020,0.8394160583941607,2.9927007299270074
384,Gianluigi Buffon,ITA,GK,Juventus,Serie A,41,1978,9.0,0,0,0,0,0,0,0,0.0,0,0,0,0,0,0,3,1,0,2019-2020,0.0,0.0
385,Marius Bülter,GER,"MF,FW",Union Berlin,Bundesliga,26,1993,25.8,38,22,19,13,6,17,54,31.5,37,37,3,34,11,49,20,1,0,2019-2020,0.4263565891472868,1.4728682170542635
386,Esteban Burgos,ARG,DF,Eibar,La Liga,27,1992,12.4,11,9,9,2,0,5,9,55.6,4,11,6,5,17,28,66,2,0,2019-2020,1.3709677419354838,0.8870967741935484
387,Guido Burgstaller,AUT,FW,Schalke 04,Bundesliga,30,1989,13.7,7,3,0,5,2,4,15,26.7,11,12,3,9,4,11,10,0,0,2019-2020,0.29197080291970806,0.5109489051094891
388,Burgui,ESP,MF,Alavés,La Liga,25,1993,0.2,0,0,0,0,0,0,0,0.0,0,0,0,0,0,0,0,0,0,2019-2020,0.0,0.0
389,Jonathan Burkardt,GER,"FW,MF",Mainz 05,Bundesliga,19,2000,2.8,9,4,2,5,2,3,8,37.5,5,6,1,5,0,9,1,0,0,2019-2020,0.0,3.2142857142857144
390,Oliver Burke,SCO,"MF,FW",Alavés,La Liga,22,1997,15.9,19,14,8,9,2,10,23,43.5,13,24,0,24,8,27,16,0,0,2019-2020,0.5031446540880503,1.1949685534591195
391,Roman Bürki,SUI,GK,Dortmund,Bundesliga,28,1990,30.8,2,2,2,0,0,2,3,66.7,1,1,0,1,2,4,13,1,0,2019-2020,0.06493506493506493,0.06493506493506493
392,Dan Burn,ENG,DF,Brighton,Premier League,27,1992,32.0,67,42,35,27,5,25,53,47.2,28,44,20,24,42,109,130,0,0,2019-2020,1.3125,2.09375
393,Patrick Burner,MTQ,DF,Nice,Ligue 1,23,1996,15.9,35,25,15,17,3,14,25,56.0,11,11,2,9,30,65,37,0,0,2019-2020,1.8867924528301887,2.20125786163522
394,Sergio Busquets,ESP,MF,Barcelona,La Liga,31,1988,27.6,80,44,23,43,14,41,71,57.7,30,36,5,31,44,124,24,2,0,2019-2020,1.5942028985507246,2.898550724637681
395,Unai Bustinza,ESP,DF,Leganés,La Liga,27,1992,29.8,66,40,40,19,7,32,53,60.4,21,30,9,21,65,131,77,0,0,2019-2020,2.1812080536912752,2.214765100671141
396,Ludovic Butelle,FRA,GK,Angers,Ligue 1,36,1983,26.0,1,1,1,0,0,1,2,50.0,1,1,0,1,0,1,10,4,0,2019-2020,0.0,0.038461538461538464
397,Marcin Bułka,POL,GK,Paris S-G,Ligue 1,19,1999,1.0,0,0,0,0,0,0,0,0.0,0,0,0,0,0,0,0,0,0,2019-2020,0.0,0.0
398,Sam Byram,ENG,DF,Norwich City,Premier League,25,1993,14.4,40,22,24,11,5,18,37,48.6,19,16,8,8,26,66,73,0,0,2019-2020,1.8055555555555556,2.7777777777777777
399,Erick Cabaco,URU,DF,Getafe,La Liga,24,1995,3.0,3,2,1,2,0,0,3,0.0,3,1,1,0,3,6,11,0,0,2019-2020,1.0,1.0
400,Erick Cabaco,URU,DF,Levante,La Liga,24,1995,9.0,12,9,9,3,0,4,6,66.7,2,12,7,5,12,24,50,1,0,2019-2020,1.3333333333333333,1.3333333333333333
Rk,Player,Nation,Pos,Squad,Comp,0,0,90.0,0,0,3,3,3,Tkl,0,0.0,0,0,0,0,0,0,0,0,0,2019-2020,0.0,0.0
401,Willy Caballero,ARG,GK,Chelsea,Premier League,37,1981,5.0,0,0,0,0,0,0,0,0.0,0,0,0,0,0,0,3,0,0,2019-2020,0.0,0.0
402,Yohan Cabaye,FRA,MF,Saint-Étienne,Ligue 1,33,1986,9.5,29,18,11,14,4,14,25,56.0,11,10,0,10,22,51,7,1,0,2019-2020,2.3157894736842106,3.0526315789473686
403,Manuel Cabit,MTQ,DF,Metz,Ligue 1,26,1993,3.0,3,1,1,2,0,2,10,20.0,8,5,0,5,4,7,5,0,0,2019-2020,1.3333333333333333,1.0
404,Ariday Cabrera,ESP,MF,Mallorca,La Liga,30,1988,0.4,1,1,1,0,0,0,1,0.0,1,2,0,2,0,1,0,0,0,2019-2020,0.0,2.5
405,Leandro Cabrera,URU,DF,Getafe,La Liga,28,1991,17.0,10,6,5,5,0,5,12,41.7,7,10,4,6,21,31,66,0,0,2019-2020,1.2352941176470589,0.5882352941176471
406,Leandro Cabrera,URU,DF,Espanyol,La Liga,28,1991,17.0,27,11,17,9,1,17,28,60.7,11,19,12,7,21,48,78,1,0,2019-2020,1.2352941176470589,1.588235294117647
407,Fabrizio Cacciatore,ITA,DF,Cagliari,Serie A,32,1986,12.8,14,4,9,4,1,6,9,66.7,3,10,6,4,16,30,44,0,0,2019-2020,1.25,1.09375
408,Martín Cáceres,URU,DF,Fiorentina,Serie A,32,1987,26.2,47,31,34,11,2,16,34,47.1,18,29,13,16,31,78,74,2,0,2019-2020,1.183206106870229,1.7938931297709924
409,Anthony Caci,FRA,DF,Strasbourg,Ligue 1,22,1997,7.7,29,17,19,9,1,8,17,47.1,9,15,5,10,19,48,15,1,0,2019-2020,2.4675324675324677,3.766233766233766
410,Jhonder Cádiz,VEN,"FW,MF",Dijon,Ligue 1,24,1995,8.9,16,8,6,7,3,3,7,42.9,4,4,2,2,1,17,9,0,0,2019-2020,0.11235955056179775,1.797752808988764
411,Mathieu Cafaro,FRA,"FW,MF",Reims,Ligue 1,22,1997,10.3,12,6,5,5,2,6,17,35.3,11,13,0,13,2,14,0,0,0,2019-2020,0.1941747572815534,1.1650485436893203
412,Jonathan Cafu,BRA,DF,Bordeaux,Ligue 1,28,1991,2.2,7,3,4,3,0,4,7,57.1,3,1,0,1,1,8,3,0,0,2019-2020,0.45454545454545453,3.1818181818181817
413,Gary Cahill,ENG,DF,Crystal Palace,Premier League,33,1985,24.1,15,8,11,4,0,7,15,46.7,8,34,25,9,18,33,114,1,0,2019-2020,0.7468879668049793,0.6224066390041494
414,Felipe Caicedo,ECU,FW,Lazio,Serie A,30,1988,15.6,17,10,4,7,6,2,11,18.2,9,9,1,8,4,21,2,0,0,2019-2020,0.25641025641025644,1.0897435897435899
415,Arturo Calabresi,ITA,DF,Amiens,Ligue 1,23,1996,20.9,53,33,29,20,4,33,75,44.0,42,24,11,13,29,82,60,0,0,2019-2020,1.3875598086124403,2.535885167464115
416,Davide Calabria,ITA,DF,Milan,Serie A,22,1996,18.0,52,33,28,22,2,17,41,41.5,24,23,5,18,21,73,47,1,0,2019-2020,1.1666666666666667,2.888888888888889
417,Riccardo Calafiori,ITA,DF,Roma,Serie A,17,2002,0.7,0,0,0,0,0,0,1,0.0,1,0,0,0,2,2,0,0,0,2019-2020,2.857142857142857,0.0
418,Mattia Caldara,ITA,DF,Atalanta,Serie A,25,1994,10.7,21,11,12,8,1,5,11,45.5,6,9,5,4,30,51,22,1,0,2019-2020,2.8037383177570097,1.9626168224299068
419,Marco Calderoni,ITA,DF,Lecce,Serie A,30,1989,22.9,38,25,22,13,3,20,39,51.3,19,27,10,17,37,75,54,1,0,2019-2020,1.6157205240174672,1.6593886462882097
420,Fernando Calero,ESP,DF,Espanyol,La Liga,23,1995,11.6,14,9,10,4,0,7,15,46.7,8,13,5,8,8,22,42,1,0,2019-2020,0.6896551724137931,1.206896551724138
421,Duje Ćaleta-Car,CRO,DF,Marseille,Ligue 1,22,1996,21.0,29,15,17,11,1,18,26,69.2,8,17,6,11,26,55,98,0,0,2019-2020,1.2380952380952381,1.380952380952381
422,Hakan Çalhanoğlu,TUR,"MF,FW",Milan,Serie A,25,1994,30.0,42,21,15,21,6,12,35,34.3,23,26,2,24,26,68,26,1,0,2019-2020,0.8666666666666667,1.4
423,Daniel Caligiuri,ITA,"MF,FW",Schalke 04,Bundesliga,31,1988,25.5,58,37,18,25,15,27,74,36.5,47,67,6,61,25,83,39,0,0,2019-2020,0.9803921568627451,2.2745098039215685
424,José Callejón,ESP,"FW,MF",Napoli,Serie A,32,1987,24.1,13,9,3,7,3,9,25,36.0,16,15,3,12,10,23,14,1,0,2019-2020,0.41493775933609955,0.5394190871369294
425,Jonathan Calleri,ARG,FW,Espanyol,La Liga,25,1993,20.1,12,8,6,4,2,3,24,12.5,21,11,3,8,7,19,22,0,0,2019-2020,0.34825870646766166,0.5970149253731343
Rk,Player,Nation,Pos,Squad,Comp,0,0,90.0,0,0,3,3,3,Tkl,0,0.0,0,0,0,0,0,0,0,0,0,2019-2020,0.0,0.0
426,Dominic Calvert-Lewin,ENG,FW,Everton,Premier League,22,1997,29.2,7,5,1,4,2,1,10,10.0,9,15,2,13,6,13,36,0,0,2019-2020,0.20547945205479454,0.2397260273972603
427,Mahdi Camara,FRA,MF,Saint-Étienne,Ligue 1,21,1998,10.0,33,20,12,16,5,18,32,56.3,14,20,2,18,18,51,5,0,0,2019-2020,1.8,3.3
428,Souleymane Camara,SEN,FW,Montpellier,Ligue 1,36,1982,1.8,0,0,0,0,0,0,2,0.0,2,0,0,0,0,0,1,0,0,2019-2020,0.0,0.0
429,Víctor Camarasa,ESP,FW,Crystal Palace,Premier League,25,1994,0.1,0,0,0,0,0,0,0,0.0,0,0,0,0,0,0,0,0,0,2019-2020,0.0,0.0
430,Víctor Camarasa,ESP,MF,Alavés,La Liga,25,1994,14.4,18,10,5,10,3,7,18,38.9,11,8,3,5,15,33,12,0,0,2019-2020,1.0416666666666667,1.25
431,Eduardo Camavinga,FRA,MF,Rennes,Ligue 1,16,2002,23.4,105,64,45,56,4,48,96,50.0,48,26,8,18,34,139,35,0,0,2019-2020,1.4529914529914532,4.487179487179487
432,Sergio Camello,ESP,FW,Atlético Madrid,La Liga,18,2001,0.3,0,0,0,0,0,0,0,0.0,0,0,0,0,0,0,0,0,0,2019-2020,0.0,0.0
433,José Campaña,ESP,MF,Levante,La Liga,26,1993,35.1,38,25,15,13,10,13,53,24.5,40,30,5,25,44,82,42,2,0,2019-2020,1.2535612535612535,1.0826210826210825
434,Xisco Campos,ESP,DF,Mallorca,La Liga,37,1982,5.3,7,4,5,2,0,5,9,55.6,4,8,5,3,11,18,23,0,0,2019-2020,2.0754716981132075,1.3207547169811322
435,Víctor Campuzano,ESP,FW,Espanyol,La Liga,22,1997,9.7,12,9,1,6,5,3,19,15.8,16,8,0,8,2,14,4,0,0,2019-2020,0.2061855670103093,1.2371134020618557
436,Emre Can,GER,MF,Juventus,Serie A,25,1994,3.2,10,7,5,3,2,3,10,30.0,7,4,0,4,2,12,3,0,0,2019-2020,0.625,3.125
437,Emre Can,GER,"MF,DF",Dortmund,Bundesliga,25,1994,10.6,19,12,11,7,1,5,12,41.7,7,14,6,8,19,38,15,0,0,2019-2020,1.7924528301886793,1.7924528301886793
438,Sergio Canales,ESP,"MF,FW",Betis,La Liga,28,1991,35.1,25,16,14,6,5,7,28,25.0,21,30,1,29,13,38,16,0,0,2019-2020,0.37037037037037035,0.7122507122507122
439,João Cancelo,POR,DF,Manchester City,Premier League,25,1994,13.4,40,24,21,12,7,24,40,60.0,16,9,2,7,21,61,18,0,0,2019-2020,1.5671641791044775,2.9850746268656714
440,Antonio Candreva,ITA,DF,Inter,Serie A,32,1987,22.1,11,6,9,1,1,7,29,24.1,22,26,10,16,14,25,33,1,0,2019-2020,0.6334841628959276,0.4977375565610859
441,Gianmarco Cangiano,ITA,"FW,MF",Bologna,Serie A,17,2001,0.2,1,1,0,1,0,0,0,0.0,0,0,0,0,1,2,0,0,0,2019-2020,5.0,5.0
442,Todd Cantwell,ENG,"FW,MF",Norwich City,Premier League,21,1998,27.7,51,31,19,27,5,26,73,35.6,47,38,2,36,18,69,35,1,0,2019-2020,0.6498194945848376,1.8411552346570397
443,Ander Capa,ESP,DF,Athletic Club,La Liga,27,1992,31.9,64,36,37,21,6,24,59,40.7,35,26,7,19,28,92,63,0,0,2019-2020,0.877742946708464,2.0062695924764893
444,Pierrick Capelle,FRA,"MF,DF",Angers,Ligue 1,32,1987,19.4,42,32,18,16,8,16,48,33.3,32,17,3,14,21,63,28,0,0,2019-2020,1.0824742268041239,2.1649484536082477
445,Étienne Capoue,FRA,MF,Watford,Premier League,31,1988,29.2,75,40,38,30,7,37,85,43.5,48,30,11,19,68,143,61,0,0,2019-2020,2.328767123287671,2.568493150684932
446,Gianluca Caprari,ITA,"FW,MF",Sampdoria,Serie A,26,1993,7.4,9,7,1,6,2,4,13,30.8,9,5,0,5,7,16,1,0,0,2019-2020,0.9459459459459459,1.2162162162162162
447,Gianluca Caprari,ITA,"FW,MF",Parma,Serie A,26,1993,6.5,1,1,0,1,0,0,5,0.0,5,7,2,5,4,5,2,0,0,2019-2020,0.6153846153846154,0.15384615384615385
448,Francesco Caputo,ITA,FW,Sassuolo,Serie A,31,1987,32.6,7,4,3,2,2,3,11,27.3,8,15,0,15,1,8,8,0,0,2019-2020,0.03067484662576687,0.21472392638036808
449,Maxence Caqueret,FRA,MF,Lyon,Ligue 1,19,2000,6.3,24,15,10,13,1,11,25,44.0,14,14,2,12,9,33,6,1,0,2019-2020,1.4285714285714286,3.8095238095238098
450,Andrea Carboni,ITA,DF,Cagliari,Serie A,18,2001,4.1,8,4,3,5,0,3,4,75.0,1,6,6,0,7,15,20,0,0,2019-2020,1.707317073170732,1.9512195121951221
Rk,Player,Nation,Pos,Squad,Comp,0,0,90.0,0,0,3,3,3,Tkl,0,0.0,0,0,0,0,0,0,0,0,0,2019-2020,0.0,0.0
451,Irvin Cardona,FRA,"FW,MF",Brest,Ligue 1,21,1997,16.1,13,8,5,6,2,9,32,28.1,23,8,0,8,1,14,7,0,0,2019-2020,0.06211180124223602,0.8074534161490683
452,Marc Cardona,ESP,FW,Osasuna,La Liga,24,1995,7.8,1,0,0,1,0,0,8,0.0,8,3,1,2,2,3,2,0,0,2019-2020,0.25641025641025644,0.12820512820512822
453,Diego Carlos,BRA,DF,Sevilla,La Liga,26,1993,34.8,35,23,25,9,1,15,25,60.0,10,33,24,9,37,72,176,1,0,2019-2020,1.0632183908045978,1.0057471264367817
454,Lionel Carole,FRA,DF,Strasbourg,Ligue 1,28,1991,14.1,23,8,15,6,2,13,17,76.5,4,2,1,1,19,42,22,0,0,2019-2020,1.3475177304964538,1.6312056737588654
455,Yannick Carrasco,BEL,"MF,FW",Atlético Madrid,La Liga,25,1993,7.0,11,7,4,4,3,7,21,33.3,14,9,0,9,5,16,2,0,0,2019-2020,0.7142857142857143,1.5714285714285714
456,Daniel Carriço,POR,DF,Sevilla,La Liga,30,1988,9.4,8,2,4,3,1,1,6,16.7,5,4,3,1,8,16,23,0,0,2019-2020,0.851063829787234,0.851063829787234
457,Guido Carrillo,ARG,FW,Leganés,La Liga,28,1991,13.5,13,10,3,6,4,2,14,14.3,12,9,1,8,3,16,22,0,0,2019-2020,0.2222222222222222,0.9629629629629629
458,Andy Carroll,ENG,FW,Newcastle Utd,Premier League,30,1989,7.0,5,3,3,2,0,2,8,25.0,6,2,1,1,2,7,24,1,0,2019-2020,0.2857142857142857,0.7142857142857143
459,Dani Carvajal,ESP,DF,Real Madrid,La Liga,27,1992,30.4,65,46,33,25,7,23,42,54.8,19,43,14,29,36,101,53,0,0,2019-2020,1.1842105263157896,2.138157894736842
460,Matis Carvalho,POR,GK,Montpellier,Ligue 1,20,1999,0.8,0,0,0,0,0,0,1,0.0,1,0,0,0,0,0,1,0,0,2019-2020,0.0,0.0
461,William Carvalho,POR,MF,Betis,La Liga,27,1992,9.9,7,4,4,2,1,4,14,28.6,10,7,5,2,4,11,8,1,0,2019-2020,0.40404040404040403,0.7070707070707071
462,Casemiro,BRA,MF,Real Madrid,La Liga,27,1992,34.3,96,60,43,45,8,39,99,39.4,60,53,10,43,68,164,72,0,0,2019-2020,1.9825072886297377,2.798833819241983
463,Moreto Cassamã,GNB,MF,Reims,Ligue 1,21,1998,6.6,17,11,2,13,2,5,7,71.4,2,7,2,5,5,22,6,0,0,2019-2020,0.7575757575757576,2.5757575757575757
464,Francesco Cassata,ITA,MF,Genoa,Serie A,22,1997,16.2,20,10,12,5,3,9,30,30.0,21,12,2,10,11,31,11,0,0,2019-2020,0.6790123456790124,1.234567901234568
465,Timothy Castagne,BEL,DF,Atalanta,Serie A,23,1995,19.7,31,20,9,16,6,13,25,52.0,12,34,5,29,17,48,23,0,0,2019-2020,0.8629441624365483,1.5736040609137056
466,Koen Casteels,BEL,GK,Wolfsburg,Bundesliga,27,1992,26.0,0,0,0,0,0,0,0,0.0,0,0,0,0,0,0,9,1,0,2019-2020,0.0,0.0
467,Jean-Charles Castelletto,CMR,DF,Brest,Ligue 1,24,1995,20.4,18,9,13,5,0,9,18,50.0,9,20,16,4,33,51,87,1,0,2019-2020,1.6176470588235294,0.8823529411764707
468,Samu Castillejo,ESP,"FW,MF",Milan,Serie A,24,1995,13.4,24,15,10,11,3,9,42,21.4,33,17,2,15,24,48,5,0,0,2019-2020,1.791044776119403,1.791044776119403
469,Jonny Castro,ESP,"MF,DF",Wolves,Premier League,25,1994,32.1,91,55,54,26,11,29,82,35.4,53,45,10,35,53,144,45,2,0,2019-2020,1.6510903426791277,2.8348909657320873
470,Lucas Castro,ARG,MF,SPAL,Serie A,30,1989,4.7,13,5,5,5,3,2,4,50.0,2,4,0,4,2,15,3,0,0,2019-2020,0.425531914893617,2.7659574468085104
471,Lucas Castro,ARG,MF,Cagliari,Serie A,30,1989,6.7,7,3,3,4,0,1,12,8.3,11,6,1,5,8,15,14,0,0,2019-2020,1.1940298507462686,1.044776119402985
472,Gaetano Castrovilli,ITA,MF,Fiorentina,Serie A,22,1997,29.7,59,31,25,23,11,18,53,34.0,35,29,2,27,15,74,31,1,0,2019-2020,0.5050505050505051,1.9865319865319866
473,Danilo Cataldi,ITA,MF,Lazio,Serie A,24,1994,6.6,17,11,10,5,2,10,20,50.0,10,7,1,6,13,30,10,0,0,2019-2020,1.9696969696969697,2.5757575757575757
474,Craig Cathcart,NIR,DF,Watford,Premier League,30,1989,27.6,41,26,25,15,1,10,24,41.7,14,19,16,3,25,66,136,1,0,2019-2020,0.9057971014492753,1.4855072463768115
475,Edinson Cavani,URU,FW,Paris S-G,Ligue 1,32,1987,6.7,5,1,0,2,3,0,3,0.0,3,7,0,7,1,6,2,0,0,2019-2020,0.14925373134328357,0.7462686567164178
Rk,Player,Nation,Pos,Squad,Comp,0,0,90.0,0,0,3,3,3,Tkl,0,0.0,0,0,0,0,0,0,0,0,0,2019-2020,0.0,0.0
476,Santi Cazorla,ESP,MF,Villarreal,La Liga,34,1984,27.2,48,25,14,21,13,20,57,35.1,37,23,1,22,19,67,16,2,0,2019-2020,0.698529411764706,1.7647058823529411
477,Dani Ceballos,ESP,MF,Arsenal,Premier League,22,1996,18.8,45,23,26,14,5,18,61,29.5,43,14,3,11,32,77,16,1,0,2019-2020,1.702127659574468,2.3936170212765955
478,Federico Ceccherini,ITA,DF,Fiorentina,Serie A,27,1992,9.3,14,8,11,3,0,10,10,100.0,0,9,5,4,13,27,37,1,0,2019-2020,1.3978494623655913,1.5053763440860215
479,Christian Celesia,ITA,DF,Torino,Serie A,17,2002,0.0,0,0,0,0,0,0,0,0.0,0,0,0,0,0,0,0,0,0,2019-2020,,
480,Zeki Çelik,TUR,DF,Lille,Ligue 1,22,1997,23.0,53,28,18,28,7,27,60,45.0,33,24,4,20,26,79,39,0,0,2019-2020,1.1304347826086956,2.3043478260869565
481,Fabien Centonze,FRA,DF,Metz,Ligue 1,23,1996,28.0,76,49,53,22,1,34,57,59.6,23,30,11,19,59,135,98,0,0,2019-2020,2.107142857142857,2.7142857142857144
482,Luca Ceppitelli,ITA,DF,Cagliari,Serie A,29,1989,13.8,22,15,16,6,0,6,11,54.5,5,23,17,6,23,45,66,2,0,2019-2020,1.6666666666666665,1.5942028985507246
483,Alberto Cerri,ITA,FW,SPAL,Serie A,23,1996,4.7,2,1,0,2,0,1,3,33.3,2,1,0,1,0,2,3,0,0,2019-2020,0.0,0.425531914893617
484,Alberto Cerri,ITA,FW,Cagliari,Serie A,23,1996,2.7,3,1,1,0,2,2,6,33.3,4,1,0,1,2,5,4,0,0,2019-2020,0.7407407407407407,1.111111111111111
485,Julian Chabot,GER,DF,Sampdoria,Serie A,21,1998,6.3,11,7,6,5,0,6,11,54.5,5,3,2,1,15,26,26,0,0,2019-2020,2.380952380952381,1.746031746031746
486,Florian Chabrolle,FRA,MF,Marseille,Ligue 1,21,1998,0.2,0,0,0,0,0,0,0,0.0,0,0,0,0,0,0,0,0,0,2019-2020,0.0,0.0
487,Fouad Chafik,MAR,DF,Dijon,Ligue 1,32,1986,17.0,32,21,22,7,3,17,36,47.2,19,12,5,7,26,58,36,0,0,2019-2020,1.5294117647058822,1.8823529411764706
488,Sofian Chakla,MAR,DF,Villarreal,La Liga,25,1993,2.0,0,0,0,0,0,0,1,0.0,1,2,1,1,3,3,7,1,0,2019-2020,1.5,0.0
489,Nathaniel Chalobah,ENG,MF,Watford,Premier League,24,1994,10.3,30,11,13,13,4,12,27,44.4,15,10,4,6,18,48,20,0,0,2019-2020,1.7475728155339805,2.9126213592233006
490,Calum Chambers,ENG,DF,Arsenal,Premier League,24,1995,12.2,26,10,12,8,6,11,16,68.8,5,13,7,6,16,42,43,1,0,2019-2020,1.3114754098360657,2.1311475409836067
491,Jhon Chancellor,VEN,DF,Brescia,Serie A,27,1992,24.9,30,14,22,8,0,11,22,50.0,11,34,29,5,34,64,145,3,0,2019-2020,1.3654618473895583,1.2048192771084338
492,Timothy Chandler,USA,"DF,MF",Eint Frankfurt,Bundesliga,29,1990,13.6,22,10,9,8,5,9,16,56.3,7,9,4,5,13,35,21,0,0,2019-2020,0.9558823529411765,1.6176470588235294
493,Kwon Chang-hoon,KOR,"MF,FW",Freiburg,Bundesliga,25,1994,7.5,7,4,2,3,2,1,10,10.0,9,5,1,4,7,14,14,0,0,2019-2020,0.9333333333333333,0.9333333333333333
494,Gaëtan Charbonnier,FRA,"FW,MF",Brest,Ligue 1,30,1988,22.9,36,16,11,11,14,10,35,28.6,25,19,6,13,7,43,33,1,0,2019-2020,0.30567685589519655,1.572052401746725
495,Brendan Chardonnet,FRA,DF,Brest,Ligue 1,24,1994,9.1,12,6,10,2,0,7,12,58.3,5,8,5,3,15,27,50,0,0,2019-2020,1.6483516483516485,1.3186813186813187
496,Charles,BRA,FW,Eibar,La Liga,35,1984,14.5,10,5,0,6,4,4,22,18.2,18,7,2,5,7,17,6,0,0,2019-2020,0.4827586206896552,0.6896551724137931
497,Xavier Chavalerin,FRA,MF,Reims,Ligue 1,28,1991,23.9,71,52,29,33,9,19,49,38.8,30,23,8,15,36,107,36,0,0,2019-2020,1.5062761506276152,2.97071129707113
498,Pablo Chavarría,ARG,"FW,MF",Mallorca,La Liga,31,1988,2.3,1,1,0,1,0,0,4,0.0,4,1,1,0,1,2,2,0,0,2019-2020,0.4347826086956522,0.4347826086956522
499,Aurélien Chedjou,CMR,DF,Amiens,Ligue 1,34,1985,21.9,27,19,18,9,0,10,22,45.5,12,15,11,4,40,67,120,3,0,2019-2020,1.8264840182648403,1.2328767123287672
500,Pape Cheikh Diop,SEN,MF,Celta Vigo,La Liga,21,1997,6.7,10,4,6,3,1,2,12,16.7,10,4,2,2,5,15,3,0,0,2019-2020,0.7462686567164178,1.4925373134328357
Rk,Player,Nation,Pos,Squad,Comp,0,0,90.0,0,0,3,3,3,Tkl,0,0.0,0,0,0,0,0,0,0,0,0,2019-2020,0.0,0.0
501,Chema,ESP,DF,Getafe,La Liga,27,1992,3.4,4,3,1,3,0,1,2,50.0,1,1,0,1,5,9,12,0,0,2019-2020,1.4705882352941178,1.1764705882352942
502,Rayan Cherki,FRA,"MF,FW",Lyon,Ligue 1,15,2003,1.6,3,2,0,1,2,3,4,75.0,1,3,0,3,0,3,0,0,0,2019-2020,0.0,1.875
503,Denis Cheryshev,RUS,"MF,FW",Valencia,La Liga,28,1990,10.3,16,9,5,4,7,3,17,17.6,14,15,1,14,7,23,10,0,0,2019-2020,0.6796116504854368,1.5533980582524272
504,Giorgio Chiellini,ITA,DF,Juventus,Serie A,34,1984,2.2,3,0,3,0,0,1,1,100.0,0,2,2,0,1,4,9,0,0,2019-2020,0.45454545454545453,1.3636363636363635
505,Federico Chiesa,ITA,"FW,DF",Fiorentina,Serie A,21,1997,29.3,38,22,13,15,10,10,52,19.2,42,19,0,19,6,44,6,0,0,2019-2020,0.20477815699658702,1.2969283276450512
506,Ben Chilwell,ENG,DF,Leicester City,Premier League,22,1996,26.4,43,26,28,13,2,23,52,44.2,29,30,6,24,28,71,68,2,0,2019-2020,1.0606060606060606,1.628787878787879
507,Vlad Chiricheș,ROU,DF,Sassuolo,Serie A,29,1989,7.9,14,9,12,2,0,7,10,70.0,3,13,8,5,11,25,28,2,0,2019-2020,1.3924050632911391,1.7721518987341771
508,Tahith Chong,NED,"FW,DF",Manchester Utd,Premier League,19,1999,0.4,0,0,0,0,0,0,0,0.0,0,0,0,0,0,0,0,0,0,2019-2020,0.0,0.0
509,Joris Chotard,FRA,MF,Montpellier,Ligue 1,17,2001,13.9,30,18,13,17,0,15,35,42.9,20,12,5,7,20,50,12,1,0,2019-2020,1.4388489208633093,2.158273381294964
510,Hamza Choudhury,ENG,MF,Leicester City,Premier League,21,1997,9.9,17,8,7,8,2,3,25,12.0,22,15,6,9,24,41,13,0,0,2019-2020,2.4242424242424243,1.7171717171717171
511,Mounir Chouiar,FRA,"MF,FW",Dijon,Ligue 1,20,1999,16.7,36,23,13,18,5,12,42,28.6,30,8,0,8,13,49,13,0,0,2019-2020,0.7784431137724551,2.155688622754491
512,Andreas Christensen,DEN,DF,Chelsea,Premier League,23,1996,19.5,38,21,25,12,1,15,21,71.4,6,12,8,4,29,67,56,0,0,2019-2020,1.4871794871794872,1.9487179487179487
513,Samuel Chukwueze,NGA,"FW,MF",Villarreal,La Liga,20,1999,22.8,23,14,12,6,5,13,30,43.3,17,15,1,14,10,33,14,1,0,2019-2020,0.43859649122807015,1.0087719298245614
514,Darko Churlinov,MKD,MF,Köln,Bundesliga,19,2000,0.2,1,1,1,0,0,1,2,50.0,1,0,0,0,1,2,0,0,0,2019-2020,5.0,5.0
515,Churripi,ESP,GK,Valladolid,La Liga,25,1994,2.7,1,1,1,0,0,1,1,100.0,0,0,0,0,0,1,2,0,0,2019-2020,0.0,0.37037037037037035
516,Luca Cigarini,ITA,MF,Cagliari,Serie A,33,1986,17.8,37,20,23,13,1,16,40,40.0,24,28,10,18,20,57,29,0,0,2019-2020,1.1235955056179774,2.0786516853932584
517,Per Ciljan Skjelbred,NOR,MF,Hertha BSC,Bundesliga,32,1987,18.1,50,30,18,29,3,17,41,41.5,24,14,3,11,23,73,17,0,0,2019-2020,1.2707182320441988,2.762430939226519
518,Jasper Cillessen,NED,GK,Valencia,La Liga,30,1989,23.3,0,0,0,0,0,0,1,0.0,1,0,0,0,3,3,3,1,0,2019-2020,0.12875536480686695,0.0
519,Thiago Cionek,POL,DF,SPAL,Serie A,33,1986,24.1,53,32,36,12,5,22,53,41.5,31,30,11,19,46,99,91,2,0,2019-2020,1.908713692946058,2.1991701244813275
520,Ibrahim Cissé,CIV,DF,Nice,Ligue 1,20,1999,0.6,1,1,1,0,0,0,0,0.0,0,0,0,0,0,1,6,0,0,2019-2020,0.0,1.6666666666666667
521,Ibrahim Cissé,SEN,DF,Angers,Ligue 1,23,1996,0.7,2,1,0,2,0,0,0,0.0,0,0,0,0,0,2,2,0,0,2019-2020,0.0,2.857142857142857
522,Andrea Cistana,ITA,DF,Brescia,Serie A,22,1997,20.4,20,8,13,7,0,6,17,35.3,11,38,34,4,33,53,96,1,0,2019-2020,1.6176470588235294,0.9803921568627452
523,Ciaran Clark,IRL,DF,Newcastle Utd,Premier League,29,1989,13.2,20,12,18,2,0,9,15,60.0,6,18,14,4,11,31,82,0,0,2019-2020,0.8333333333333334,1.5151515151515151
524,Leon Clarke,ENG,"FW,MF",Sheffield Utd,Premier League,34,1985,0.4,0,0,0,0,0,0,0,0.0,0,0,0,0,0,0,2,0,0,2019-2020,0.0,0.0
525,Alexis Claude-Maurice,FRA,"FW,MF",Nice,Ligue 1,21,1998,18.1,26,16,8,11,7,13,35,37.1,22,20,4,16,11,37,4,0,0,2019-2020,0.6077348066298343,1.43646408839779
Rk,Player,Nation,Pos,Squad,Comp,0,0,90.0,0,0,3,3,3,Tkl,0,0.0,0,0,0,0,0,0,0,0,0,2019-2020,0.0,0.0
526,Christian Clemens,GER,FW,Köln,Bundesliga,27,1991,0.2,0,0,0,0,0,0,0,0.0,0,1,1,0,0,0,0,0,0,2019-2020,0.0,0.0
527,Óscar Clemente,ESP,MF,Atlético Madrid,La Liga,20,1999,0.0,0,0,0,0,0,0,0,0.0,0,1,0,1,0,0,0,0,0,2019-2020,,
528,Yannis Clementia,MTQ,GK,Nice,Ligue 1,22,1997,2.0,0,0,0,0,0,0,0,0.0,0,0,0,0,0,0,0,0,0,2019-2020,0.0,0.0
529,Denilho Cleonise,NED,FW,Genoa,Serie A,17,2001,0.5,1,0,1,0,0,0,0,0.0,0,0,0,0,1,2,0,0,0,2019-2020,2.0,2.0
530,Carlos Clerc,ESP,DF,Levante,La Liga,27,1992,20.5,28,16,14,13,1,12,20,60.0,8,22,9,13,22,50,61,0,0,2019-2020,1.0731707317073171,1.3658536585365855
531,Tom Cleverley,ENG,MF,Watford,Premier League,29,1989,10.8,28,15,8,14,6,9,36,25.0,27,13,1,12,10,38,15,0,0,2019-2020,0.9259259259259258,2.5925925925925926
532,Conor Coady,ENG,DF,Wolves,Premier League,26,1993,38.0,36,23,30,6,0,15,30,50.0,15,22,15,7,28,64,119,2,0,2019-2020,0.7368421052631579,0.9473684210526315
533,Marcus Coco,FRA,FW,Nantes,Ligue 1,23,1996,0.2,1,0,1,0,0,1,1,100.0,0,0,0,0,0,1,0,0,0,2019-2020,0.0,5.0
534,Renaud Cohade,FRA,MF,Metz,Ligue 1,34,1984,8.5,28,20,11,12,5,12,28,42.9,16,14,3,11,8,36,6,0,0,2019-2020,0.9411764705882353,3.2941176470588234
535,Coke,ESP,DF,Levante,La Liga,32,1987,11.0,25,18,14,8,3,14,30,46.7,16,9,2,7,13,38,19,0,0,2019-2020,1.1818181818181819,2.272727272727273
536,Séamus Coleman,IRL,DF,Everton,Premier League,30,1988,20.4,42,31,24,14,4,19,25,76.0,6,21,9,12,24,66,43,1,0,2019-2020,1.1764705882352942,2.058823529411765
537,Álex Collado,ESP,FW,Barcelona,La Liga,20,1999,0.1,0,0,0,0,0,0,0,0.0,0,0,0,0,0,0,0,0,0,2019-2020,0.0,0.0
538,Ebrima Colley,GAM,FW,Atalanta,Serie A,19,2000,0.9,2,1,1,0,1,1,2,50.0,1,1,0,1,1,3,0,0,0,2019-2020,1.1111111111111112,2.2222222222222223
539,Omar Colley,GAM,DF,Sampdoria,Serie A,26,1992,30.8,42,26,27,14,1,12,24,50.0,12,33,22,11,59,101,155,1,0,2019-2020,1.9155844155844155,1.3636363636363635
540,Jamilu Collins,NGA,DF,Paderborn 07,Bundesliga,24,1994,29.6,69,43,44,21,4,37,62,59.7,25,53,19,34,70,139,91,1,0,2019-2020,2.364864864864865,2.331081081081081
541,Simone Colombi,ITA,GK,Parma,Serie A,28,1991,4.0,0,0,0,0,0,0,0,0.0,0,0,0,0,0,0,1,0,0,2019-2020,0.0,0.0
542,Lorenzo Colombo,ITA,FW,Milan,Serie A,17,2002,0.1,0,0,0,0,0,0,0,0.0,0,0,0,0,0,0,0,0,0,2019-2020,0.0,0.0
543,Racine Coly,SEN,"DF,FW",Nice,Ligue 1,23,1995,7.2,21,13,15,5,1,9,17,52.9,8,5,0,5,12,33,23,0,0,2019-2020,1.6666666666666665,2.9166666666666665
544,Kingsley Coman,FRA,"FW,MF",Bayern Munich,Bundesliga,23,1996,16.7,19,11,6,7,6,12,27,44.4,15,9,0,9,4,23,3,0,0,2019-2020,0.23952095808383234,1.1377245508982037
545,Daniel Congré,FRA,DF,Montpellier,Ligue 1,34,1985,21.6,37,27,20,16,1,18,38,47.4,20,8,7,1,47,84,66,1,0,2019-2020,2.1759259259259256,1.7129629629629628
546,Aaron Connolly,IRL,FW,Brighton,Premier League,19,2000,14.0,7,6,1,4,2,3,10,30.0,7,11,0,11,0,7,3,0,0,2019-2020,0.0,0.5
547,Andrea Consigli,ITA,GK,Sassuolo,Serie A,32,1987,31.0,0,0,0,0,0,0,1,0.0,1,0,0,0,4,4,19,2,0,2019-2020,0.12903225806451613,0.0
548,Andrea Conti,ITA,DF,Milan,Serie A,25,1994,19.2,41,25,23,15,3,21,49,42.9,28,21,8,13,43,84,42,1,0,2019-2020,2.2395833333333335,2.135416666666667
549,Lewis Cook,ENG,"MF,FW",Bournemouth,Premier League,22,1997,15.0,27,14,15,9,3,10,47,21.3,37,17,5,12,17,44,17,1,0,2019-2020,1.1333333333333333,1.8
550,Steve Cook,ENG,DF,Bournemouth,Premier League,28,1991,27.0,22,11,18,4,0,8,20,40.0,12,32,23,9,44,66,153,1,0,2019-2020,1.6296296296296295,0.8148148148148148
Rk,Player,Nation,Pos,Squad,Comp,0,0,90.0,0,0,3,3,3,Tkl,0,0.0,0,0,0,0,0,0,0,0,0,2019-2020,0.0,0.0
551,Francis Coquelin,FRA,MF,Valencia,La Liga,28,1991,21.2,37,21,25,11,1,16,38,42.1,22,19,9,10,38,75,25,0,0,2019-2020,1.7924528301886793,1.7452830188679247
552,Gabriele Corbo,ITA,DF,Bologna,Serie A,19,2000,1.4,1,1,1,0,0,0,3,0.0,3,2,2,0,4,5,5,0,0,2019-2020,2.857142857142857,0.7142857142857143
553,Sébastien Corchia,FRA,DF,Espanyol,La Liga,28,1990,3.0,2,1,2,0,0,2,4,50.0,2,5,2,3,5,7,8,0,0,2019-2020,1.6666666666666667,0.6666666666666666
554,Iñigo Córdoba,ESP,FW,Athletic Club,La Liga,22,1997,16.0,33,20,16,12,5,14,52,26.9,38,30,2,28,16,49,13,0,0,2019-2020,1.0,2.0625
555,Jhon Córdoba,COL,FW,Köln,Bundesliga,26,1993,22.2,9,6,1,5,3,3,13,23.1,10,19,1,18,5,14,17,0,0,2019-2020,0.22522522522522523,0.40540540540540543
556,Sergio Córdova,VEN,FW,Augsburg,Bundesliga,21,1997,4.1,3,0,0,2,1,1,10,10.0,9,0,0,0,0,3,3,0,0,2019-2020,0.0,0.7317073170731708
557,Benjamin Corgnet,FRA,"MF,FW",Strasbourg,Ligue 1,32,1987,2.9,1,1,1,0,0,1,3,33.3,2,2,0,2,2,3,3,0,0,2019-2020,0.6896551724137931,0.3448275862068966
558,Jack Cork,ENG,MF,Burnley,Premier League,30,1989,29.0,35,24,10,20,5,12,62,19.4,50,34,12,22,28,63,49,0,0,2019-2020,0.9655172413793104,1.206896551724138
559,Andreas Cornelius,DEN,FW,Parma,Serie A,26,1993,16.6,9,4,2,5,2,4,11,36.4,7,7,0,7,2,11,26,0,0,2019-2020,0.12048192771084336,0.5421686746987951
560,Maxwel Cornet,CIV,"FW,DF",Lyon,Ligue 1,22,1996,14.8,30,19,18,8,4,13,23,56.5,10,16,1,15,21,51,19,1,0,2019-2020,1.4189189189189189,2.0270270270270268
561,Quentin Cornette,FRA,"FW,MF",Amiens,Ligue 1,25,1994,3.9,8,3,3,2,3,3,9,33.3,6,7,1,6,6,14,5,0,0,2019-2020,1.5384615384615385,2.0512820512820515
562,Ángel Correa,ARG,"MF,FW",Atlético Madrid,La Liga,24,1995,22.9,25,9,7,9,9,9,36,25.0,27,23,5,18,14,39,21,0,0,2019-2020,0.6113537117903931,1.091703056768559
563,Joaquín Correa,ARG,FW,Lazio,Serie A,24,1994,22.2,13,7,3,7,3,5,24,20.8,19,5,1,4,7,20,10,0,0,2019-2020,0.3153153153153153,0.5855855855855856
564,Rober Correa,ESP,DF,Eibar,La Liga,26,1992,10.3,13,6,8,3,2,6,10,60.0,4,6,4,2,16,29,31,0,0,2019-2020,1.5533980582524272,1.262135922330097
565,Edmilson Correia,GNB,"FW,DF",Saint-Étienne,Ligue 1,19,2000,0.5,0,0,0,0,0,0,1,0.0,1,1,0,1,1,1,0,0,0,2019-2020,2.0,0.0
566,Thierry Correia,POR,DF,Valencia,La Liga,20,1999,2.9,8,3,5,3,0,1,2,50.0,1,5,0,5,2,10,10,0,0,2019-2020,0.6896551724137931,2.7586206896551726
567,Antonio Cortés,ESP,"FW,MF",Granada,La Liga,19,2000,2.0,1,1,0,1,0,0,1,0.0,1,0,0,0,0,1,2,0,0,2019-2020,0.0,0.5
568,Danny da Costa,GER,"DF,FW",Eint Frankfurt,Bundesliga,26,1993,15.4,26,17,14,8,4,6,16,37.5,10,16,1,15,15,41,26,0,0,2019-2020,0.974025974025974,1.6883116883116882
569,Diego Costa,ESP,FW,Atlético Madrid,La Liga,30,1988,15.0,9,5,1,4,4,1,10,10.0,9,4,2,2,3,12,10,0,0,2019-2020,0.2,0.6
570,Douglas Costa,BRA,"FW,MF",Juventus,Serie A,28,1990,8.9,2,1,1,1,0,1,12,8.3,11,7,0,7,5,7,5,0,0,2019-2020,0.5617977528089887,0.2247191011235955
571,Jaume Costa,ESP,DF,Valencia,La Liga,31,1988,15.4,27,23,17,8,2,14,28,50.0,14,11,6,5,24,51,52,1,0,2019-2020,1.5584415584415585,1.7532467532467533
572,Angelo da Costa Júnior,BRA,GK,Bologna,Serie A,35,1983,1.0,0,0,0,0,0,0,0,0.0,0,0,0,0,0,0,0,0,0,2019-2020,0.0,0.0
573,Nuno da Costa,CPV,FW,Strasbourg,Ligue 1,28,1991,5.9,15,10,3,8,4,4,10,40.0,6,7,0,7,4,19,3,0,0,2019-2020,0.6779661016949152,2.542372881355932
574,David Costas,ESP,DF,Celta Vigo,La Liga,24,1995,3.8,4,3,3,1,0,2,4,50.0,2,3,3,0,8,12,12,0,0,2019-2020,2.1052631578947367,1.0526315789473684
575,Benoît Costil,FRA,GK,Bordeaux,Ligue 1,32,1987,28.0,0,0,0,0,0,0,3,0.0,3,0,0,0,2,2,9,0,0,2019-2020,0.07142857142857142,0.0
Rk,Player,Nation,Pos,Squad,Comp,0,0,90.0,0,0,3,3,3,Tkl,0,0.0,0,0,0,0,0,0,0,0,0,2019-2020,0.0,0.0
576,Kalifa Coulibaly,MLI,FW,Nantes,Ligue 1,27,1991,18.0,11,7,0,5,6,3,5,60.0,2,3,1,2,6,17,32,0,0,2019-2020,0.3333333333333333,0.6111111111111112
577,Senou Coulibaly,MLI,DF,Dijon,Ligue 1,24,1994,7.4,14,7,11,3,0,2,4,50.0,2,11,10,1,10,24,44,1,0,2019-2020,1.3513513513513513,1.8918918918918919
578,Yoann Court,FRA,"FW,MF",Brest,Ligue 1,29,1990,16.3,48,26,28,17,3,20,64,31.3,44,21,0,21,15,63,14,0,0,2019-2020,0.920245398773006,2.9447852760736195
579,Thibaut Courtois,BEL,GK,Real Madrid,La Liga,27,1992,34.0,0,0,0,0,0,0,2,0.0,2,0,0,0,2,2,18,2,0,2019-2020,0.058823529411764705,0.0
580,Philippe Coutinho,BRA,"MF,FW",Bayern Munich,Bundesliga,27,1992,15.7,21,15,1,13,7,2,13,15.4,11,9,2,7,6,27,0,0,0,2019-2020,0.3821656050955414,1.337579617834395
581,Nicolas Cozza,FRA,DF,Montpellier,Ligue 1,20,1999,6.2,5,5,3,2,0,2,3,66.7,1,8,6,2,9,14,18,0,0,2019-2020,1.4516129032258065,0.8064516129032258
582,Alessio Cragno,ITA,GK,Cagliari,Serie A,25,1994,16.0,0,0,0,0,0,0,0,0.0,0,0,0,0,0,0,10,0,0,2019-2020,0.0,0.0
583,Aaron Cresswell,ENG,DF,West Ham,Premier League,29,1989,30.3,43,26,21,18,4,23,46,50.0,23,33,10,23,35,78,75,2,0,2019-2020,1.155115511551155,1.4191419141914192
584,Domenico Criscito,ITA,DF,Genoa,Serie A,32,1986,22.8,53,33,34,12,7,24,56,42.9,32,25,13,12,53,106,81,1,0,2019-2020,2.324561403508772,2.324561403508772
585,Bryan Cristante,ITA,MF,Roma,Serie A,24,1995,18.0,25,15,6,14,5,8,27,29.6,19,13,4,9,22,47,23,0,0,2019-2020,1.2222222222222223,1.3888888888888888
586,Sebastián Cristóforo,URU,MF,Fiorentina,Serie A,25,1993,1.0,5,5,2,2,1,1,5,20.0,4,2,1,1,1,6,0,0,0,2019-2020,1.0,5.0
587,Sebastián Cristóforo,URU,MF,Eibar,La Liga,25,1993,9.7,35,19,11,14,10,13,32,40.6,19,25,3,22,8,43,2,0,0,2019-2020,0.8247422680412372,3.6082474226804124
588,Juan Cuadrado,COL,"DF,FW",Juventus,Serie A,31,1988,29.5,67,43,32,28,7,35,62,56.5,27,22,8,14,35,102,47,0,0,2019-2020,1.1864406779661016,2.2711864406779663
589,Cucho,COL,"FW,MF",Mallorca,La Liga,20,1999,16.5,15,8,6,8,1,6,21,28.6,15,14,1,13,10,25,15,0,0,2019-2020,0.6060606060606061,0.9090909090909091
590,Marc Cucurella,ESP,"MF,DF",Getafe,La Liga,21,1998,36.0,74,51,23,38,13,24,76,31.6,52,58,8,50,36,110,28,1,0,2019-2020,1.0,2.0555555555555554
591,Iván Cuéllar,ESP,GK,Leganés,La Liga,35,1984,27.0,0,0,0,0,0,0,2,0.0,2,0,0,0,0,0,28,2,0,2019-2020,0.0,0.0
592,Jaume Cuéllar,BOL,"MF,FW",SPAL,Serie A,17,2001,0.8,1,0,0,0,1,0,1,0.0,1,0,0,0,0,1,0,0,0,2019-2020,0.0,1.25
593,Mickaël Cuisance,FRA,"MF,FW",Bayern Munich,Bundesliga,19,1999,3.4,2,1,0,2,0,1,9,11.1,8,1,1,0,3,5,0,0,0,2019-2020,0.8823529411764706,0.5882352941176471
594,Matheus Cunha,BRA,"FW,MF",Hertha BSC,Bundesliga,20,1999,8.3,10,5,6,4,0,4,11,36.4,7,11,1,10,10,20,1,0,0,2019-2020,1.2048192771084336,1.2048192771084336
595,Matheus Cunha,BRA,"FW,MF",RB Leipzig,Bundesliga,20,1999,3.1,6,2,0,1,5,0,2,0.0,2,5,1,4,1,7,0,0,0,2019-2020,0.3225806451612903,1.9354838709677418
596,Felipe Curcio,BRA,DF,Brescia,Serie A,25,1993,0.1,0,0,0,0,0,0,0,0.0,0,0,0,0,0,0,0,0,0,2019-2020,0.0,0.0
597,Patrick Cutrone,ITA,FW,Wolves,Premier League,21,1998,3.3,4,2,2,1,1,1,5,20.0,4,1,1,0,2,6,1,0,0,2019-2020,0.6060606060606061,1.2121212121212122
598,Patrick Cutrone,ITA,FW,Fiorentina,Serie A,21,1998,9.3,4,2,2,1,1,1,15,6.7,14,6,1,5,2,6,6,0,0,2019-2020,0.2150537634408602,0.4301075268817204
599,Wylan Cyprien,FRA,MF,Nice,Ligue 1,24,1995,19.7,17,11,5,12,0,7,27,25.9,20,8,2,6,19,36,16,3,0,2019-2020,0.9644670050761421,0.8629441624365483
600,Rafael Czichos,GER,DF,Köln,Bundesliga,29,1990,24.5,43,34,26,16,1,22,45,48.9,23,24,13,11,35,78,110,1,0,2019-2020,1.4285714285714286,1.7551020408163265
Rk,Player,Nation,Pos,Squad,Comp,0,0,90.0,0,0,3,3,3,Tkl,0,0.0,0,0,0,0,0,0,0,0,0,2019-2020,0.0,0.0
601,Lennart-Marten Czyborra,GER,DF,Atalanta,Serie A,20,1999,0.2,0,0,0,0,0,0,0,0.0,0,2,0,2,0,0,0,0,0,2019-2020,0.0,0.0
602,Marco D'Alessandro,ITA,"MF,DF",SPAL,Serie A,28,1991,8.7,11,8,5,3,3,5,8,62.5,3,11,0,11,5,16,6,0,0,2019-2020,0.574712643678161,1.264367816091954
603,Danilo D'Ambrosio,ITA,DF,Inter,Serie A,30,1988,15.6,30,16,16,12,2,16,33,48.5,17,15,4,11,14,44,25,0,0,2019-2020,0.8974358974358975,1.9230769230769231
604,Felice D'Amico,ITA,MF,Sampdoria,Serie A,18,2000,0.0,1,1,0,0,1,0,0,0.0,0,0,0,0,0,1,0,0,0,2019-2020,,inf
605,Lucas Da Cunha,FRA,MF,Rennes,Ligue 1,18,2001,0.8,1,0,1,0,0,1,1,100.0,0,0,0,0,0,1,0,0,0,2019-2020,0.0,1.25
606,Jacopo Da Riva,ITA,MF,Atalanta,Serie A,18,2000,0.0,0,0,0,0,0,0,0,0.0,0,0,0,0,0,0,0,0,0,2019-2020,,
607,Damien Da Silva,FRA,DF,Rennes,Ligue 1,31,1988,24.9,27,14,20,5,2,10,19,52.6,9,21,13,8,26,53,143,1,0,2019-2020,1.0441767068273093,1.0843373493975905
608,Moanes Dabbur,ISR,FW,Sevilla,La Liga,27,1992,0.3,1,1,0,0,1,0,0,0.0,0,1,0,1,0,1,0,0,0,2019-2020,0.0,3.3333333333333335
609,Moanes Dabbur,ISR,FW,Hoffenheim,Bundesliga,27,1992,8.5,8,5,1,3,4,3,10,30.0,7,6,2,4,4,12,1,0,0,2019-2020,0.47058823529411764,0.9411764705882353
610,Bryan Dabo,BFA,MF,SPAL,Serie A,27,1992,12.5,18,10,13,4,1,5,15,33.3,10,13,2,11,9,27,14,0,0,2019-2020,0.72,1.44
611,Colin Dagba,FRA,DF,Paris S-G,Ligue 1,20,1998,7.4,10,4,2,4,4,5,9,55.6,4,6,1,5,6,16,9,0,0,2019-2020,0.8108108108108107,1.3513513513513513
612,Mahmoud Dahoud,GER,MF,Dortmund,Bundesliga,23,1996,6.2,10,6,4,4,2,6,18,33.3,12,8,2,6,8,18,4,0,0,2019-2020,1.2903225806451613,1.6129032258064515
613,Leon Dajaku,GER,"DF,MF",Bayern Munich,Bundesliga,18,2001,0.1,0,0,0,0,0,0,1,0.0,1,0,0,0,0,0,0,0,0,2019-2020,0.0,0.0
614,Felipe dal Belo,BRA,DF,SPAL,Serie A,35,1984,11.1,13,6,9,4,0,9,15,60.0,6,14,12,2,9,22,30,0,0,2019-2020,0.8108108108108109,1.1711711711711712
615,Christian Dalle Mura,ITA,FW,Fiorentina,Serie A,17,2002,0.0,0,0,0,0,0,0,0,0.0,0,0,0,0,0,0,0,0,0,2019-2020,,
616,Diogo Dalot,POR,"DF,MF",Manchester Utd,Premier League,20,1999,0.7,3,2,3,0,0,3,4,75.0,1,1,0,1,2,5,1,0,0,2019-2020,2.857142857142857,4.285714285714286
617,Charlie Daniels,ENG,DF,Bournemouth,Premier League,32,1986,1.4,1,1,0,1,0,0,1,0.0,1,2,0,2,1,2,5,1,0,2019-2020,0.7142857142857143,0.7142857142857143
618,Danilo,BRA,DF,Juventus,Serie A,28,1991,16.0,30,20,16,12,2,18,30,60.0,12,12,3,9,26,56,44,0,0,2019-2020,1.625,1.875
619,Arnaut Danjuma,NED,MF,Bournemouth,Premier League,22,1997,7.0,4,2,3,1,0,1,4,25.0,3,2,0,2,8,12,4,1,0,2019-2020,1.1428571428571428,0.5714285714285714
620,Scott Dann,ENG,DF,Crystal Palace,Premier League,32,1987,14.1,8,4,7,1,0,8,14,57.1,6,9,7,2,14,22,67,0,0,2019-2020,0.9929078014184397,0.5673758865248227
621,Kevin Danso,AUT,DF,Southampton,Premier League,20,1998,3.1,6,4,3,3,0,4,7,57.1,3,7,3,4,2,8,7,0,0,2019-2020,0.6451612903225806,1.9354838709677418
622,Dante,BRA,DF,Nice,Ligue 1,35,1983,21.0,34,21,24,10,0,17,25,68.0,8,27,16,11,26,60,79,0,0,2019-2020,1.2380952380952381,1.619047619047619
623,Andrea Danzi,ITA,MF,Hellas Verona,Serie A,20,1999,0.0,0,0,0,0,0,0,0,0.0,0,0,0,0,0,0,0,0,0,2019-2020,,
624,Sergi Darder,ESP,MF,Espanyol,La Liga,25,1993,29.5,47,23,11,26,10,17,58,29.3,41,30,1,29,24,71,23,1,0,2019-2020,0.8135593220338984,1.5932203389830508
625,Vladimír Darida,CZE,MF,Hertha BSC,Bundesliga,28,1990,25.1,50,27,14,31,5,11,48,22.9,37,44,7,37,27,77,19,2,0,2019-2020,1.0756972111553784,1.99203187250996
Rk,Player,Nation,Pos,Squad,Comp,0,0,90.0,0,0,3,3,3,Tkl,0,0.0,0,0,0,0,0,0,0,0,0,2019-2020,0.0,0.0
626,Matteo Darmian,ITA,DF,Parma,Serie A,29,1989,29.8,81,42,48,30,3,40,83,48.2,43,38,16,22,25,106,78,1,0,2019-2020,0.8389261744966443,2.7181208053691273
627,Alphonso Davies,CAN,DF,Bayern Munich,Bundesliga,18,2000,24.8,70,43,35,24,11,38,58,65.5,20,35,6,29,31,101,51,0,0,2019-2020,1.25,2.82258064516129
628,Ben Davies,WAL,DF,Tottenham,Premier League,26,1993,15.9,28,15,13,11,4,7,21,33.3,14,28,12,16,22,50,47,0,0,2019-2020,1.3836477987421383,1.7610062893081762
629,Tom Davies,ENG,MF,Everton,Premier League,21,1998,22.5,38,17,12,22,4,17,55,30.9,38,12,4,8,35,73,28,0,0,2019-2020,1.5555555555555556,1.6888888888888889
630,Keinan Davis,ENG,FW,Aston Villa,Premier League,21,1998,6.1,1,1,0,1,0,0,3,0.0,3,4,0,4,0,1,3,0,0,2019-2020,0.0,0.1639344262295082
631,Paweł Dawidowicz,POL,DF,Hellas Verona,Serie A,24,1995,7.7,15,12,11,4,0,5,11,45.5,6,6,5,1,12,27,26,0,0,2019-2020,1.5584415584415585,1.948051948051948
632,Craig Dawson,ENG,DF,Watford,Premier League,29,1990,26.2,29,18,16,13,0,17,31,54.8,14,41,32,9,34,63,116,0,0,2019-2020,1.297709923664122,1.1068702290076335
633,Kevin De Bruyne,BEL,MF,Manchester City,Premier League,28,1991,31.0,45,24,8,20,17,18,66,27.3,48,26,4,22,18,63,24,2,0,2019-2020,0.5806451612903226,1.4516129032258065
634,Sebastien De Maio,FRA,DF,Udinese,Serie A,32,1987,16.7,18,11,11,7,0,7,11,63.6,4,28,20,8,32,50,86,2,0,2019-2020,1.9161676646706587,1.0778443113772456
635,Rodrigo De Paul,ARG,MF,Udinese,Serie A,25,1994,31.4,61,31,31,26,4,27,65,41.5,38,38,3,35,29,90,8,1,0,2019-2020,0.9235668789808917,1.9426751592356688
636,Mattia De Sciglio,ITA,DF,Juventus,Serie A,26,1992,5.2,10,8,6,4,0,6,14,42.9,8,5,2,3,8,18,18,1,0,2019-2020,1.5384615384615383,1.923076923076923
637,Lorenzo De Silvestri,ITA,DF,Torino,Serie A,31,1988,24.9,15,8,4,7,4,11,27,40.7,16,20,7,13,19,34,72,0,0,2019-2020,0.7630522088353414,0.6024096385542169
638,Lucas Deaux,FRA,MF,Nîmes,Ligue 1,30,1988,14.8,49,26,16,29,4,16,45,35.6,29,20,4,16,15,64,19,0,0,2019-2020,1.0135135135135134,3.3108108108108105
639,Mathieu Debuchy,FRA,DF,Saint-Étienne,Ligue 1,34,1985,19.7,44,26,22,15,7,24,47,51.1,23,21,11,10,43,87,59,0,0,2019-2020,2.182741116751269,2.233502538071066
640,Troy Deeney,ENG,FW,Watford,Premier League,31,1988,24.7,19,12,6,10,3,6,29,20.7,23,13,1,12,11,30,27,0,0,2019-2020,0.4453441295546559,0.7692307692307693
641,Grégoire Defrel,MTQ,"FW,MF",Sassuolo,Serie A,28,1991,10.9,12,8,4,6,2,4,15,26.7,11,9,0,9,3,15,5,0,0,2019-2020,0.27522935779816515,1.1009174311926606
642,Alessandro Deiola,ITA,MF,Cagliari,Serie A,23,1995,0.0,0,0,0,0,0,0,0,0.0,0,0,0,0,1,1,0,0,0,2019-2020,inf,
643,Alessandro Deiola,ITA,MF,Lecce,Serie A,23,1995,8.0,16,9,9,7,0,9,24,37.5,15,12,4,8,8,24,14,1,0,2019-2020,1.0,2.0
644,Romain Del Castillo,FRA,"FW,MF",Rennes,Ligue 1,23,1996,13.8,20,14,5,11,4,6,27,22.2,21,12,2,10,7,27,7,0,0,2019-2020,0.5072463768115941,1.4492753623188406
645,Thomas Delaine,FRA,DF,Metz,Ligue 1,27,1992,13.9,25,16,18,6,1,12,21,57.1,9,17,1,16,15,40,28,0,0,2019-2020,1.079136690647482,1.7985611510791366
646,Thomas Delaney,DEN,MF,Dortmund,Bundesliga,27,1991,9.2,22,10,10,11,1,9,15,60.0,6,16,7,9,26,48,26,0,0,2019-2020,2.8260869565217392,2.3913043478260874
647,Paul Delecroix,FRA,GK,Metz,Ligue 1,30,1988,1.5,0,0,0,0,0,0,0,0.0,0,0,0,0,0,0,0,0,0,2019-2020,0.0,0.0
648,Cristian Dell'Orco,ITA,DF,Lecce,Serie A,25,1994,11.2,22,12,14,7,1,8,14,57.1,6,11,7,4,16,38,33,0,0,2019-2020,1.4285714285714286,1.9642857142857144
649,Andy Delort,ALG,FW,Montpellier,Ligue 1,27,1991,25.3,28,18,11,9,8,7,27,25.9,20,21,6,15,3,31,10,0,0,2019-2020,0.11857707509881422,1.1067193675889329
650,Fabian Delph,ENG,MF,Everton,Premier League,29,1989,13.2,26,12,10,13,3,9,22,40.9,13,12,3,9,15,41,19,1,0,2019-2020,1.1363636363636365,1.9696969696969697
Rk,Player,Nation,Pos,Squad,Comp,0,0,90.0,0,0,3,3,3,Tkl,0,0.0,0,0,0,0,0,0,0,0,0,2019-2020,0.0,0.0
651,Moussa Dembélé,FRA,FW,Lyon,Ligue 1,23,1996,24.3,12,7,2,5,5,4,14,28.6,10,14,3,11,5,17,31,0,0,2019-2020,0.205761316872428,0.49382716049382713
652,Ousmane Dembélé,FRA,FW,Barcelona,La Liga,22,1997,4.0,2,2,1,1,0,2,5,40.0,3,4,0,4,0,2,0,1,0,2019-2020,0.0,0.5
653,Merih Demiral,TUR,DF,Juventus,Serie A,21,1998,4.6,8,7,5,3,0,1,3,33.3,2,4,3,1,4,12,16,1,0,2019-2020,0.8695652173913044,1.7391304347826089
654,Kerem Demirbay,GER,MF,Leverkusen,Bundesliga,26,1993,17.5,35,19,10,21,4,12,31,38.7,19,19,5,14,22,57,7,1,0,2019-2020,1.2571428571428571,2.0
655,Diego Demme,GER,MF,Napoli,Serie A,27,1991,10.0,18,8,14,3,1,8,23,34.8,15,9,1,8,8,26,9,0,0,2019-2020,0.8,1.8
656,Diego Demme,GER,MF,RB Leipzig,Bundesliga,27,1991,13.5,41,18,17,19,5,17,42,40.5,25,14,2,12,15,56,14,0,0,2019-2020,1.1111111111111112,3.037037037037037
657,Jason Denayer,BEL,DF,Lyon,Ligue 1,24,1995,23.7,17,13,12,5,0,10,14,71.4,4,32,29,3,20,37,83,0,0,2019-2020,0.8438818565400844,0.7172995780590717
658,Leander Dendoncker,BEL,"MF,DF",Wolves,Premier League,24,1995,31.1,68,31,41,19,8,28,67,41.8,39,39,12,27,38,106,64,2,0,2019-2020,1.2218649517684887,2.1864951768488745
659,Kévin Denkey,TOG,FW,Nîmes,Ligue 1,18,2000,6.7,10,5,1,8,1,6,10,60.0,4,7,0,7,2,12,1,1,0,2019-2020,0.29850746268656714,1.4925373134328357
660,Stefano Denswil,SUR,DF,Bologna,Serie A,26,1993,24.9,49,28,29,19,1,26,44,59.1,18,23,8,15,31,80,68,0,0,2019-2020,1.244979919678715,1.9678714859437751
661,Fabio Depaoli,ITA,"MF,DF",Sampdoria,Serie A,22,1997,20.6,41,28,26,10,5,17,31,54.8,14,29,3,26,16,57,39,0,0,2019-2020,0.7766990291262136,1.9902912621359221
662,Kastriot Dermaku,ALB,DF,Parma,Serie A,27,1992,11.4,13,5,10,3,0,3,5,60.0,2,20,16,4,12,25,61,1,0,2019-2020,1.0526315789473684,1.1403508771929824
663,Daniele Dessena,ITA,MF,Brescia,Serie A,32,1987,20.8,21,11,5,14,2,6,25,24.0,19,11,1,10,11,32,21,0,0,2019-2020,0.5288461538461539,1.0096153846153846
664,Mattia Destro,ITA,FW,Bologna,Serie A,28,1991,2.1,3,2,1,2,0,1,3,33.3,2,1,0,1,0,3,0,0,0,2019-2020,0.0,1.4285714285714286
665,Mattia Destro,ITA,"FW,MF",Genoa,Serie A,28,1991,1.7,0,0,0,0,0,0,0,0.0,0,0,0,0,0,0,1,0,0,2019-2020,0.0,0.0
666,Gerard Deulofeu,ESP,FW,Watford,Premier League,25,1994,23.3,33,16,18,9,6,12,59,20.3,47,10,0,10,25,58,6,0,0,2019-2020,1.0729613733905579,1.4163090128755365
667,Deyverson,BRA,FW,Getafe,La Liga,28,1991,2.3,0,0,0,0,0,0,1,0.0,1,2,1,1,0,0,5,0,0,2019-2020,0.0,0.0
668,Samuel Di Carmine,ITA,"FW,MF",Hellas Verona,Serie A,30,1988,14.4,2,1,0,0,2,0,8,0.0,8,3,0,3,1,3,10,0,0,2019-2020,0.06944444444444445,0.1388888888888889
669,Federico Di Francesco,ITA,FW,SPAL,Serie A,25,1994,12.0,11,5,2,6,3,3,15,20.0,12,9,1,8,3,14,2,1,0,2019-2020,0.25,0.9166666666666666
670,Giovanni Di Lorenzo,ITA,DF,Napoli,Serie A,25,1993,33.0,59,35,27,19,13,32,61,52.5,29,27,11,16,28,87,54,0,0,2019-2020,0.8484848484848485,1.7878787878787878
671,Ángel Di María,ARG,"FW,MF",Paris S-G,Ligue 1,31,1988,22.2,17,12,2,8,7,4,34,11.8,30,14,3,11,11,28,1,3,0,2019-2020,0.4954954954954955,0.7657657657657658
672,Boulaye Dia,SEN,FW,Reims,Ligue 1,22,1996,20.1,15,9,7,6,2,3,10,30.0,7,9,2,7,7,22,16,0,0,2019-2020,0.34825870646766166,0.7462686567164178
673,Fousseni Diabaté,MLI,"FW,MF",Amiens,Ligue 1,23,1995,13.2,16,10,6,6,4,5,16,31.3,11,11,0,11,8,24,3,1,0,2019-2020,0.6060606060606061,1.2121212121212122
674,Moussa Diaby,FRA,"FW,MF",Leverkusen,Bundesliga,20,1999,19.7,10,8,3,7,0,5,15,33.3,10,6,0,6,9,19,4,0,0,2019-2020,0.4568527918781726,0.5076142131979695
675,Mouctar Diakhaby,GUI,DF,Valencia,La Liga,22,1996,16.0,11,8,7,3,1,5,8,62.5,3,17,15,2,11,22,73,0,0,2019-2020,0.6875,0.6875
Rk,Player,Nation,Pos,Squad,Comp,0,0,90.0,0,0,3,3,3,Tkl,0,0.0,0,0,0,0,0,0,0,0,0,2019-2020,0.0,0.0
676,Bafodé Diakité,FRA,DF,Toulouse,Ligue 1,18,2001,15.2,23,19,15,8,0,7,13,53.8,6,18,9,9,20,43,75,0,0,2019-2020,1.3157894736842106,1.5131578947368423
677,Abdou Diallo,SEN,DF,Paris S-G,Ligue 1,23,1996,13.3,20,11,9,10,1,8,14,57.1,6,9,5,4,10,30,32,0,0,2019-2020,0.7518796992481203,1.5037593984962405
678,Amad Diallo,CIV,FW,Atalanta,Serie A,17,2002,0.3,1,1,0,1,0,0,0,0.0,0,0,0,0,0,1,0,0,0,2019-2020,0.0,3.3333333333333335
679,Habib Diallo,SEN,FW,Metz,Ligue 1,24,1995,24.4,2,1,0,2,0,0,6,0.0,6,6,5,1,4,6,43,0,0,2019-2020,0.1639344262295082,0.0819672131147541
680,Ibrahima Diallo,FRA,MF,Brest,Ligue 1,20,1999,17.3,38,24,15,22,1,12,29,41.4,17,9,2,7,23,61,16,3,0,2019-2020,1.329479768786127,2.1965317919075145
681,Moussa Diarra,MLI,DF,Toulouse,Ligue 1,18,2000,1.0,3,3,2,1,0,1,1,100.0,0,0,0,0,3,6,2,0,0,2019-2020,3.0,3.0
682,Lucas Dias,FRA,GK,Nîmes,Ligue 1,20,1999,3.5,1,1,1,0,0,1,1,100.0,0,0,0,0,0,1,2,0,0,2019-2020,0.0,0.2857142857142857
683,Amadou Diawara,GUI,MF,Roma,Serie A,22,1997,16.9,40,25,14,20,6,8,30,26.7,22,10,1,9,33,73,16,2,0,2019-2020,1.9526627218934913,2.366863905325444
684,Brahim Díaz,MAR,FW,Real Madrid,La Liga,19,1999,0.7,1,0,0,1,0,0,2,0.0,2,2,0,2,0,1,0,0,0,2019-2020,0.0,1.4285714285714286
685,Víctor Díaz,ESP,DF,Granada,La Liga,31,1988,32.0,74,43,38,31,5,31,60,51.7,29,53,23,30,48,122,94,1,0,2019-2020,1.5,2.3125
686,Bakaye Dibassy,MLI,DF,Amiens,Ligue 1,29,1989,20.8,26,14,17,8,1,15,20,75.0,5,29,18,11,37,63,78,2,0,2019-2020,1.7788461538461537,1.25
687,Eric Dier,ENG,"DF,MF",Tottenham,Premier League,25,1994,14.9,21,12,10,10,1,10,20,50.0,10,14,9,5,21,42,65,0,0,2019-2020,1.4093959731543624,1.4093959731543624
688,Lucas Digne,FRA,DF,Everton,Premier League,26,1993,33.7,73,49,49,19,5,33,68,48.5,35,39,10,29,42,115,108,0,0,2019-2020,1.2462908011869436,2.166172106824926
689,Mitchell Dijks,NED,DF,Bologna,Serie A,26,1993,11.2,13,10,6,5,2,8,12,66.7,4,5,1,4,10,23,23,0,0,2019-2020,0.8928571428571429,1.1607142857142858
690,Javairô Dilrosun,NED,"MF,FW",Hertha BSC,Bundesliga,21,1998,14.5,15,8,11,1,3,5,13,38.5,8,20,0,20,18,33,10,0,0,2019-2020,1.2413793103448276,1.0344827586206897
691,Federico Dimarco,ITA,DF,Hellas Verona,Serie A,21,1997,5.8,11,5,4,4,3,6,10,60.0,4,3,2,1,4,15,11,0,0,2019-2020,0.6896551724137931,1.896551724137931
692,Federico Dimarco,ITA,DF,Inter,Serie A,21,1997,0.3,1,0,0,1,0,0,0,0.0,0,0,0,0,1,2,1,0,0,2019-2020,3.3333333333333335,3.3333333333333335
693,Tristan Dingomé,CMR,MF,Reims,Ligue 1,28,1991,9.9,10,4,3,6,1,2,12,16.7,10,6,0,6,6,16,1,0,0,2019-2020,0.6060606060606061,1.0101010101010102
694,Lois Diony,FRA,FW,Saint-Étienne,Ligue 1,26,1992,7.4,15,5,0,11,4,5,9,55.6,4,3,0,3,1,16,0,0,0,2019-2020,0.13513513513513511,2.0270270270270268
695,Issa Diop,FRA,DF,West Ham,Premier League,22,1997,30.7,27,15,18,9,0,16,25,64.0,9,37,21,16,47,74,166,2,0,2019-2020,1.5309446254071661,0.8794788273615636
696,Papakouli Diop,SEN,MF,Eibar,La Liga,33,1986,25.0,39,26,13,22,4,18,42,42.9,24,24,7,17,34,73,38,0,0,2019-2020,1.36,1.56
697,Assane Dioussé,SEN,MF,Saint-Étienne,Ligue 1,21,1997,1.3,1,1,0,1,0,0,3,0.0,3,0,0,0,0,1,2,0,0,2019-2020,0.0,0.7692307692307692
698,Axel Disasi,FRA,DF,Reims,Ligue 1,21,1998,27.0,32,21,18,13,1,17,27,63.0,10,29,24,5,26,58,97,0,0,2019-2020,0.9629629629629629,1.1851851851851851
699,Tiago Djaló,POR,DF,Lille,Ligue 1,19,2000,7.3,9,4,5,3,1,2,7,28.6,5,3,2,1,11,20,28,0,0,2019-2020,1.5068493150684932,1.2328767123287672
700,Djené,TOG,DF,Getafe,La Liga,27,1991,34.0,42,32,27,15,0,17,30,56.7,13,20,7,13,34,76,105,1,0,2019-2020,1.0,1.2352941176470589
Rk,Player,Nation,Pos,Squad,Comp,0,0,90.0,0,0,3,3,3,Tkl,0,0.0,0,0,0,0,0,0,0,0,0,2019-2020,0.0,0.0
701,Moussa Djenepo,MLI,"MF,DF",Southampton,Premier League,21,1998,10.3,27,21,13,9,5,11,21,52.4,10,15,1,14,9,36,9,0,0,2019-2020,0.8737864077669902,2.6213592233009706
702,Koffi Djidji,CIV,DF,Torino,Serie A,26,1992,9.5,27,12,19,8,0,8,18,44.4,10,28,23,5,15,42,53,1,0,2019-2020,1.5789473684210527,2.8421052631578947
703,Alexander Djiku,GHA,"DF,MF",Strasbourg,Ligue 1,24,1994,22.9,46,32,27,19,0,21,29,72.4,8,14,8,6,55,101,82,4,0,2019-2020,2.4017467248908297,2.0087336244541487
704,Berat Djimsiti,ALB,DF,Atalanta,Serie A,26,1993,30.9,42,23,17,23,2,22,39,56.4,17,21,14,7,49,91,92,0,0,2019-2020,1.5857605177993528,1.3592233009708738
705,Naïs Djouahra,FRA,FW,Real Sociedad,La Liga,19,1999,0.3,0,0,0,0,0,0,0,0.0,0,0,0,0,0,0,0,0,0,2019-2020,0.0,0.0
706,Marko Dmitrović,SRB,GK,Eibar,La Liga,27,1992,35.0,3,2,3,0,0,3,5,60.0,2,1,0,1,3,6,24,0,0,2019-2020,0.08571428571428572,0.08571428571428572
707,Matt Doherty,IRL,"MF,DF",Wolves,Premier League,27,1992,31.5,55,29,34,17,4,27,41,65.9,14,34,4,30,40,95,52,1,0,2019-2020,1.2698412698412698,1.746031746031746
708,Kasper Dolberg,DEN,FW,Nice,Ligue 1,21,1997,21.0,10,6,0,3,7,4,17,23.5,13,18,2,16,10,20,24,0,0,2019-2020,0.47619047619047616,0.47619047619047616
709,Keagan Dolly,RSA,MF,Montpellier,Ligue 1,26,1993,1.6,6,3,1,3,2,2,5,40.0,3,1,0,1,1,7,0,0,0,2019-2020,0.625,3.75
710,Jaume Doménech,ESP,GK,Valencia,La Liga,28,1990,14.7,0,0,0,0,0,0,1,0.0,1,0,0,0,1,1,3,1,0,2019-2020,0.06802721088435375,0.0
711,Nicolás Domínguez,ARG,MF,Bologna,Serie A,21,1998,7.8,21,14,15,5,1,7,18,38.9,11,12,2,10,12,33,7,0,0,2019-2020,1.5384615384615385,2.6923076923076925
712,Giulio Donati,ITA,DF,Lecce,Serie A,29,1990,19.6,32,21,22,8,2,15,28,53.6,13,19,10,9,25,57,42,0,0,2019-2020,1.2755102040816326,1.6326530612244896
713,Ji Dong-won,KOR,"FW,MF",Mainz 05,Bundesliga,28,1991,1.1,0,0,0,0,0,0,1,0.0,1,1,0,1,0,0,0,0,0,2019-2020,0.0,0.0
714,Anastasios Donis,GRE,FW,Reims,Ligue 1,22,1996,6.8,3,2,2,1,0,1,9,11.1,8,2,0,2,1,4,3,0,0,2019-2020,0.14705882352941177,0.4411764705882353
715,Alfredo Donnarumma,ITA,FW,Brescia,Serie A,28,1990,18.7,17,9,3,9,5,6,18,33.3,12,7,0,7,5,22,1,0,0,2019-2020,0.26737967914438504,0.9090909090909092
716,Gianluigi Donnarumma,ITA,GK,Milan,Serie A,20,1999,35.6,1,0,1,0,0,1,2,50.0,1,0,0,0,3,4,25,7,0,2019-2020,0.08426966292134831,0.028089887640449437
717,Mathieu Dossevi,TOG,"MF,FW",Toulouse,Ligue 1,31,1988,19.5,32,20,7,17,8,15,30,50.0,15,17,0,17,14,46,7,0,0,2019-2020,0.717948717948718,1.641025641025641
718,Bas Dost,NED,FW,Eint Frankfurt,Bundesliga,30,1989,16.4,11,7,1,7,3,3,7,42.9,4,6,2,4,5,16,22,0,0,2019-2020,0.30487804878048785,0.6707317073170732
719,Abdoulaye Doucouré,MLI,MF,Watford,Premier League,26,1993,35.1,64,30,29,29,6,16,57,28.1,41,46,8,38,31,95,32,0,0,2019-2020,0.8831908831908831,1.8233618233618234
720,Mamadou Doucouré,FRA,MF,Gladbach,Bundesliga,21,1998,0.0,0,0,0,0,0,0,0,0.0,0,0,0,0,0,0,0,0,0,2019-2020,,
721,Moussa Doumbia,MLI,"FW,MF",Reims,Ligue 1,24,1994,19.1,16,8,5,6,5,7,24,29.2,17,14,1,13,9,25,5,0,0,2019-2020,0.47120418848167533,0.8376963350785339
722,Souleyman Doumbia,CIV,DF,Angers,Ligue 1,22,1996,5.0,10,4,7,2,1,5,6,83.3,1,5,0,5,6,16,18,0,0,2019-2020,1.2,2.0
723,Souleyman Doumbia,CIV,DF,Rennes,Ligue 1,22,1996,1.0,1,1,1,0,0,1,1,100.0,0,2,2,0,0,1,3,0,0,2019-2020,0.0,1.0
724,Tommy Doyle,ENG,MF,Manchester City,Premier League,17,2001,0.2,0,0,0,0,0,0,1,0.0,1,0,0,0,0,0,0,0,0,2019-2020,0.0,0.0
725,Mohamed Dräger,TUN,DF,Paderborn 07,Bundesliga,23,1996,16.2,32,21,22,8,2,14,33,42.4,19,17,5,12,18,50,39,0,0,2019-2020,1.1111111111111112,1.9753086419753088
Rk,Player,Nation,Pos,Squad,Comp,0,0,90.0,0,0,3,3,3,Tkl,0,0.0,0,0,0,0,0,0,0,0,0,2019-2020,0.0,0.0
726,Aleksandar Dragović,AUT,DF,Leverkusen,Bundesliga,28,1991,11.4,18,11,11,6,1,10,21,47.6,11,9,3,6,15,33,39,0,0,2019-2020,1.3157894736842104,1.5789473684210527
727,Bartłomiej Drągowski,POL,GK,Fiorentina,Serie A,21,1997,31.0,0,0,0,0,0,0,1,0.0,1,0,0,0,3,3,8,1,0,2019-2020,0.0967741935483871,0.0
728,Julian Draxler,GER,MF,Paris S-G,Ligue 1,25,1993,7.6,13,10,2,9,2,7,15,46.7,8,7,1,6,10,23,1,0,0,2019-2020,1.3157894736842106,1.7105263157894737
729,Dominick Drexler,GER,"MF,FW",Köln,Bundesliga,29,1990,17.6,34,25,12,19,3,8,32,25.0,24,11,5,6,26,60,11,0,0,2019-2020,1.477272727272727,1.9318181818181817
730,Danny Drinkwater,ENG,MF,Aston Villa,Premier League,29,1990,2.9,5,3,3,2,0,2,18,11.1,16,5,0,5,5,10,5,1,0,2019-2020,1.7241379310344829,1.7241379310344829
731,Danny Drinkwater,ENG,MF,Burnley,Premier League,29,1990,0.6,2,1,1,1,0,0,1,0.0,1,0,0,0,1,3,0,0,0,2019-2020,1.6666666666666667,3.3333333333333335
732,Josip Drmić,SUI,FW,Norwich City,Premier League,26,1992,7.2,3,2,1,2,0,0,8,0.0,8,6,0,6,1,4,5,1,0,2019-2020,0.1388888888888889,0.41666666666666663
733,Domingos Duarte,POR,DF,Granada,La Liga,24,1995,34.3,30,19,24,5,1,11,20,55.0,9,34,24,10,34,64,153,1,0,2019-2020,0.9912536443148688,0.8746355685131196
734,Léo Duarte,BRA,DF,Milan,Serie A,23,1996,4.5,4,3,0,3,1,1,4,25.0,3,9,6,3,3,7,9,0,0,2019-2020,0.6666666666666666,0.8888888888888888
735,Óscar Duarte,CRC,DF,Levante,La Liga,30,1989,5.4,12,3,11,1,0,3,4,75.0,1,7,6,1,6,18,29,0,0,2019-2020,1.111111111111111,2.222222222222222
736,Rubén Duarte,ESP,DF,Alavés,La Liga,23,1995,29.6,61,32,30,28,3,34,60,56.7,26,30,8,22,47,108,71,0,0,2019-2020,1.5878378378378377,2.0608108108108105
737,Edgaras Dubickas,LTU,DF,Lecce,Serie A,21,1998,0.0,0,0,0,0,0,0,0,0.0,0,0,0,0,0,0,0,0,0,2019-2020,,
738,Leo Dubois,FRA,DF,Lyon,Ligue 1,24,1994,15.0,32,23,20,9,3,13,22,59.1,9,12,4,8,18,50,34,1,0,2019-2020,1.2,2.1333333333333333
739,Martin Dúbravka,SVK,GK,Newcastle Utd,Premier League,30,1989,38.0,1,1,1,0,0,1,2,50.0,1,2,0,2,1,2,17,5,0,2019-2020,0.02631578947368421,0.02631578947368421
740,Ondrej Duda,SVK,MF,Norwich City,Premier League,24,1994,8.0,18,11,9,6,3,7,16,43.8,9,10,2,8,6,24,8,0,0,2019-2020,0.75,2.25
741,Ondrej Duda,SVK,MF,Hertha BSC,Bundesliga,24,1994,5.0,6,4,1,2,3,1,10,10.0,9,3,1,2,5,11,5,0,0,2019-2020,1.0,1.2
742,Shane Duffy,IRL,DF,Brighton,Premier League,27,1992,13.8,18,9,14,4,0,6,17,35.3,11,13,7,6,21,39,72,0,0,2019-2020,1.5217391304347825,1.3043478260869565
743,Haris Duljević,BIH,"FW,MF",Nîmes,Ligue 1,25,1993,5.8,11,6,3,7,1,4,12,33.3,8,5,0,5,2,13,1,0,0,2019-2020,0.3448275862068966,1.896551724137931
744,Paul Dummett,WAL,DF,Newcastle Utd,Premier League,27,1991,13.6,27,17,19,7,1,21,27,77.8,6,23,9,14,23,50,69,0,0,2019-2020,1.6911764705882353,1.9852941176470589
745,Alfred Duncan,GHA,MF,Fiorentina,Serie A,26,1993,9.9,12,9,11,1,0,2,19,10.5,17,4,0,4,5,17,12,0,0,2019-2020,0.5050505050505051,1.2121212121212122
746,Alfred Duncan,GHA,MF,Sassuolo,Serie A,26,1993,9.4,19,12,8,7,4,6,16,37.5,10,7,0,7,9,28,13,0,0,2019-2020,0.9574468085106382,2.021276595744681
747,Lewis Dunk,ENG,DF,Brighton,Premier League,27,1991,35.9,40,24,23,17,0,15,34,44.1,19,55,33,22,55,95,125,2,0,2019-2020,1.532033426183844,1.1142061281337048
748,Erik Durm,GER,"DF,FW",Eint Frankfurt,Bundesliga,27,1992,5.7,13,6,9,2,2,9,17,52.9,8,11,2,9,3,16,11,0,0,2019-2020,0.5263157894736842,2.280701754385965
749,Riza Durmisi,DEN,"DF,MF",Nice,Ligue 1,25,1994,1.8,1,1,1,0,0,0,0,0.0,0,2,1,1,1,2,3,0,0,2019-2020,0.5555555555555556,0.5555555555555556
750,Hugo Duro,ESP,"FW,MF",Getafe,La Liga,19,1999,4.2,6,5,2,2,2,4,8,50.0,4,3,0,3,1,7,3,0,0,2019-2020,0.23809523809523808,1.4285714285714286
Rk,Player,Nation,Pos,Squad,Comp,0,0,90.0,0,0,3,3,3,Tkl,0,0.0,0,0,0,0,0,0,0,0,0,2019-2020,0.0,0.0
751,Jean-Kevin Duverne,HAI,DF,Brest,Ligue 1,22,1997,13.1,12,8,5,6,1,2,6,33.3,4,23,8,15,20,32,50,0,0,2019-2020,1.5267175572519085,0.916030534351145
752,Paulo Dybala,ARG,"FW,MF",Juventus,Serie A,25,1993,23.9,19,10,6,9,4,9,39,23.1,30,15,0,15,13,32,3,0,0,2019-2020,0.5439330543933055,0.794979079497908
753,Edin Džeko,BIH,FW,Roma,Serie A,33,1986,31.7,16,11,2,7,7,2,13,15.4,11,11,4,7,6,22,33,0,0,2019-2020,0.18927444794952683,0.5047318611987381
754,Blerim Džemaili,SUI,MF,Bologna,Serie A,33,1986,7.8,19,12,3,13,3,4,22,18.2,18,9,3,6,7,26,6,0,0,2019-2020,0.8974358974358975,2.435897435897436
755,Bruno Ecuele Manga,GAB,DF,Dijon,Ligue 1,31,1988,28.0,22,15,17,5,0,9,20,45.0,11,34,23,11,37,59,112,2,0,2019-2020,1.3214285714285714,0.7857142857142857
756,Simone Edera,ITA,"MF,FW",Torino,Serie A,22,1997,4.4,13,5,3,7,3,2,12,16.7,10,1,0,1,1,14,3,0,0,2019-2020,0.22727272727272727,2.954545454545454
757,Ederson,BRA,GK,Manchester City,Premier League,25,1993,34.1,2,2,2,0,0,2,5,40.0,3,0,0,0,3,5,16,6,0,2019-2020,0.0879765395894428,0.05865102639296187
758,John Egan,IRL,DF,Sheffield Utd,Premier League,26,1992,35.4,44,27,34,10,0,25,45,55.6,20,39,27,12,58,102,171,4,0,2019-2020,1.6384180790960452,1.2429378531073447
759,Johannes Eggestein,GER,"MF,FW",Werder Bremen,Bundesliga,21,1998,5.7,8,6,2,2,4,3,12,25.0,9,6,0,6,2,10,4,0,0,2019-2020,0.3508771929824561,1.4035087719298245
760,Maximilian Eggestein,GER,MF,Werder Bremen,Bundesliga,22,1996,31.7,40,28,20,18,2,15,43,34.9,28,37,8,29,36,76,57,0,0,2019-2020,1.135646687697161,1.2618296529968454
761,Kingsley Ehizibue,NED,DF,Köln,Bundesliga,24,1995,25.9,79,53,44,30,5,33,53,62.3,20,28,8,20,39,118,79,1,0,2019-2020,1.505791505791506,3.0501930501930503
762,Albin Ekdal,SWE,MF,Sampdoria,Serie A,30,1989,26.5,51,25,18,31,2,24,68,35.3,44,35,14,21,33,84,46,1,0,2019-2020,1.2452830188679245,1.9245283018867925
763,Harvey Elliott,ENG,DF,Liverpool,Premier League,16,2003,0.1,0,0,0,0,0,0,0,0.0,0,0,0,0,0,0,0,0,0,2019-2020,0.0,0.0
764,Elif Elmas,MKD,MF,Napoli,Serie A,19,1999,12.6,16,7,5,6,5,5,20,25.0,15,11,1,10,11,27,4,0,0,2019-2020,0.873015873015873,1.2698412698412698
765,Ilay Elmkies,ISR,MF,Hoffenheim,Bundesliga,19,2000,0.0,1,1,1,0,0,0,0,0.0,0,0,0,0,0,1,0,0,0,2019-2020,,inf
766,Ahmed Elmohamady,EGY,DF,Aston Villa,Premier League,31,1987,11.5,19,9,10,7,2,10,21,47.6,11,11,5,6,13,32,25,1,0,2019-2020,1.1304347826086956,1.6521739130434783
767,Aritz Elustondo,ESP,DF,Real Sociedad,La Liga,25,1994,16.8,28,17,19,8,1,13,23,56.5,10,21,8,13,15,43,67,0,0,2019-2020,0.8928571428571428,1.6666666666666665
768,Nico Elvedi,SUI,DF,Gladbach,Bundesliga,22,1996,29.1,45,27,37,8,0,19,38,50.0,19,32,15,17,62,107,112,0,0,2019-2020,2.1305841924398625,1.5463917525773194
769,Rodrigo Ely,BRA,DF,Alavés,La Liga,25,1993,23.6,22,13,15,7,0,13,29,44.8,16,23,19,4,32,54,116,0,0,2019-2020,1.3559322033898304,0.9322033898305084
770,Adri Embarba,ESP,"MF,FW",Espanyol,La Liga,27,1992,15.2,37,22,16,16,5,16,33,48.5,17,28,4,24,16,53,11,0,0,2019-2020,1.0526315789473684,2.4342105263157894
771,Breel Embolo,SUI,"FW,MF",Gladbach,Bundesliga,22,1997,17.2,22,11,2,15,5,4,15,26.7,11,12,1,11,8,30,5,0,0,2019-2020,0.46511627906976744,1.2790697674418605
772,Emerson,BRA,DF,Betis,La Liga,20,1999,31.5,74,46,49,19,6,36,79,45.6,43,30,9,21,31,105,57,1,0,2019-2020,0.9841269841269841,2.3492063492063493
773,Renaud Emond,BEL,FW,Nantes,Ligue 1,27,1991,3.2,3,1,0,2,1,1,5,20.0,4,0,0,0,0,3,7,0,0,2019-2020,0.0,0.9375
774,Alan Empereur,BRA,DF,Hellas Verona,Serie A,25,1994,9.5,16,8,11,4,1,6,10,60.0,4,19,12,7,22,38,36,0,0,2019-2020,2.3157894736842106,1.6842105263157894
775,Youssef En-Nesyri,MAR,FW,Leganés,La Liga,22,1997,15.4,9,7,1,2,6,3,17,17.6,14,15,2,13,5,14,22,0,0,2019-2020,0.3246753246753247,0.5844155844155844
Rk,Player,Nation,Pos,Squad,Comp,0,0,90.0,0,0,3,3,3,Tkl,0,0.0,0,0,0,0,0,0,0,0,0,2019-2020,0.0,0.0
776,Youssef En-Nesyri,MAR,FW,Sevilla,La Liga,22,1997,8.8,7,5,1,6,0,3,10,30.0,7,9,3,6,5,12,7,0,0,2019-2020,0.5681818181818181,0.7954545454545454
777,Björn Engels,BEL,DF,Aston Villa,Premier League,24,1994,16.1,11,6,8,2,1,8,13,61.5,5,18,17,1,28,39,86,3,0,2019-2020,1.7391304347826086,0.6832298136645962
778,Sergi Enrich,ESP,FW,Eibar,La Liga,29,1990,20.7,17,6,4,8,5,4,21,19.0,17,16,2,14,9,26,12,0,0,2019-2020,0.43478260869565216,0.821256038647343
779,Javier Eraso,ESP,MF,Leganés,La Liga,29,1990,9.1,11,5,4,5,2,5,15,33.3,10,5,0,5,7,18,5,0,0,2019-2020,0.7692307692307693,1.208791208791209
780,Christian Eriksen,DEN,"MF,FW",Tottenham,Premier League,27,1992,12.2,19,9,10,8,1,7,24,29.2,17,10,1,9,12,31,16,0,0,2019-2020,0.9836065573770493,1.557377049180328
781,Christian Eriksen,DEN,MF,Inter,Serie A,27,1992,7.8,11,6,2,8,1,5,20,25.0,15,3,0,3,0,11,0,0,0,2019-2020,0.0,1.4102564102564104
782,Gonzalo Escalante,ARG,MF,Eibar,La Liga,26,1993,18.6,41,22,15,17,9,24,41,58.5,17,22,4,18,29,70,14,0,0,2019-2020,1.5591397849462365,2.204301075268817
783,Aarón Escandell,ESP,GK,Granada,La Liga,23,1995,3.0,1,1,1,0,0,1,1,100.0,0,0,0,0,0,1,0,0,0,2019-2020,0.0,0.3333333333333333
784,Sergio Escudero,ESP,DF,Sevilla,La Liga,29,1989,8.6,29,16,17,10,2,19,28,67.9,9,11,1,10,13,42,35,0,0,2019-2020,1.5116279069767442,3.372093023255814
785,Bernardo Espinosa,COL,DF,Espanyol,La Liga,30,1989,25.1,24,16,18,4,2,16,28,57.1,12,19,11,8,24,48,108,2,0,2019-2020,0.9561752988047808,0.9561752988047808
786,Sebastiano Esposito,ITA,FW,Inter,Serie A,17,2002,2.2,3,2,0,2,1,0,5,0.0,5,3,0,3,3,6,1,0,0,2019-2020,1.3636363636363635,1.3636363636363635
787,Vicente Esquerdo,ESP,"MF,FW",Valencia,La Liga,20,1999,0.2,1,0,1,0,0,0,0,0.0,0,1,0,1,0,1,1,0,0,2019-2020,0.0,5.0
788,Alexander Esswein,GER,"FW,MF",Hertha BSC,Bundesliga,29,1990,2.4,6,4,4,2,0,3,8,37.5,5,8,1,7,7,13,7,1,0,2019-2020,2.916666666666667,2.5
789,Pervis Estupiñán,ECU,DF,Osasuna,La Liga,21,1998,33.1,84,45,53,27,4,42,77,54.5,35,30,7,23,58,142,61,6,0,2019-2020,1.7522658610271902,2.537764350453172
790,Oghenekaro Etebo,NGA,MF,Getafe,La Liga,23,1995,6.4,12,4,5,7,0,7,12,58.3,5,10,1,9,11,23,4,1,0,2019-2020,1.71875,1.875
791,Beñat Etxebarria,ESP,MF,Athletic Club,La Liga,32,1987,4.4,6,1,2,3,1,2,13,15.4,11,6,1,5,4,10,6,0,0,2019-2020,0.9090909090909091,1.3636363636363635
792,Xabier Etxeita,ESP,DF,Getafe,La Liga,31,1987,16.1,20,11,11,9,0,12,23,52.2,11,9,5,4,17,37,68,0,0,2019-2020,1.0559006211180124,1.2422360248447204
793,Antony Evans,ENG,"MF,DF",Paderborn 07,Bundesliga,20,1998,1.7,5,4,1,3,1,1,5,20.0,4,1,1,0,2,7,4,0,0,2019-2020,1.1764705882352942,2.9411764705882355
794,Jonny Evans,NIR,DF,Leicester City,Premier League,31,1988,37.6,48,34,33,14,1,28,39,71.8,11,33,18,15,57,105,174,4,0,2019-2020,1.5159574468085106,1.276595744680851
795,Edu Expósito,ESP,MF,Eibar,La Liga,22,1996,25.7,52,28,12,31,9,18,49,36.7,31,20,6,14,31,83,18,1,0,2019-2020,1.206225680933852,2.0233463035019454
796,Valentin Eysseric,FRA,"MF,FW",Hellas Verona,Serie A,27,1992,3.9,4,4,1,2,1,0,4,0.0,4,3,0,3,1,5,2,0,0,2019-2020,0.25641025641025644,1.0256410256410258
797,Valentin Eysseric,FRA,"FW,MF",Fiorentina,Serie A,27,1992,0.5,0,0,0,0,0,0,0,0.0,0,1,0,1,0,0,0,0,0,2019-2020,0.0,0.0
798,Łukasz Fabiański,POL,GK,West Ham,Premier League,34,1985,23.5,2,2,2,0,0,2,4,50.0,2,0,0,0,1,3,5,3,0,2019-2020,0.0425531914893617,0.0851063829787234
799,Fabinho,BRA,MF,Liverpool,Premier League,25,1993,23.1,62,35,20,35,7,26,67,38.8,41,25,2,23,34,96,19,1,0,2019-2020,1.4718614718614718,2.6839826839826837
800,Fábio,BRA,DF,Nantes,Ligue 1,29,1990,9.3,38,22,18,20,0,25,35,71.4,10,10,5,5,18,56,19,0,0,2019-2020,1.9354838709677418,4.086021505376344
Rk,Player,Nation,Pos,Squad,Comp,0,0,90.0,0,0,3,3,3,Tkl,0,0.0,0,0,0,0,0,0,0,0,0,2019-2020,0.0,0.0
801,Cesc Fàbregas,ESP,MF,Monaco,Ligue 1,32,1987,10.3,11,4,6,3,2,6,29,20.7,23,8,1,7,7,18,3,0,0,2019-2020,0.6796116504854368,1.0679611650485437
802,Fabricio,ESP,GK,Mallorca,La Liga,31,1987,1.0,0,0,0,0,0,0,0,0.0,0,0,0,0,0,0,0,1,0,2019-2020,0.0,0.0
803,Ralf Fährmann,GER,GK,Norwich City,Premier League,30,1988,0.2,0,0,0,0,0,0,0,0.0,0,0,0,0,0,0,0,0,0,2019-2020,0.0,0.0
804,Fayçal Fajr,MAR,MF,Getafe,La Liga,30,1988,4.5,1,1,0,1,0,0,3,0.0,3,4,0,4,4,5,1,0,0,2019-2020,0.8888888888888888,0.2222222222222222
805,Luca Falbo,ITA,DF,Lazio,Serie A,19,2000,0.0,0,0,0,0,0,0,0,0.0,0,0,0,0,0,0,0,0,0,2019-2020,,
806,Filippo Falco,ITA,"FW,MF",Lecce,Serie A,27,1992,22.4,13,7,4,5,4,5,18,27.8,13,11,1,10,2,15,1,0,0,2019-2020,0.08928571428571429,0.5803571428571429
807,Eliseo Falcon,ESP,DF,Levante,La Liga,22,1997,0.8,0,0,0,0,0,0,0,0.0,0,0,0,0,0,0,2,0,0,2019-2020,0.0,0.0
808,Wladimiro Falcone,ITA,GK,Sampdoria,Serie A,24,1995,2.0,0,0,0,0,0,0,0,0.0,0,0,0,0,0,0,0,0,0,2019-2020,0.0,0.0
809,Simon Falette,GUI,DF,Eint Frankfurt,Bundesliga,27,1992,1.0,0,0,0,0,0,0,1,0.0,1,3,3,0,3,3,5,0,0,2019-2020,3.0,0.0
810,Iago Falque,ESP,"FW,MF",Torino,Serie A,29,1990,1.1,0,0,0,0,0,0,1,0.0,1,1,0,1,0,0,0,0,0,2019-2020,0.0,0.0
811,Iago Falque,ESP,MF,Genoa,Serie A,29,1990,5.8,7,3,1,4,2,4,8,50.0,4,7,0,7,1,8,4,0,0,2019-2020,0.1724137931034483,1.206896551724138
812,Akin Famewo,ENG,MF,Norwich City,Premier League,20,1998,0.0,0,0,0,0,0,0,0,0.0,0,0,0,0,0,0,0,0,0,2019-2020,,
813,Andri Fannar Baldursson,ISL,MF,Bologna,Serie A,17,2002,1.6,1,0,0,1,0,0,1,0.0,1,2,0,2,1,2,3,0,0,2019-2020,0.625,0.625
814,Paolo Faragò,ITA,"DF,MF",Cagliari,Serie A,26,1993,14.9,41,28,21,15,5,23,46,50.0,23,18,9,9,10,51,58,0,0,2019-2020,0.6711409395973155,2.751677852348993
815,Davide Faraoni,ITA,DF,Hellas Verona,Serie A,27,1991,35.9,67,37,43,19,5,30,67,44.8,37,50,15,35,36,103,115,0,0,2019-2020,1.0027855153203342,1.8662952646239555
816,Mohamed Fares,ALG,"DF,MF",SPAL,Serie A,23,1996,4.7,6,4,3,2,1,2,10,20.0,8,5,3,2,5,11,8,0,0,2019-2020,1.0638297872340425,1.276595744680851
817,Diego Farias,BRA,"MF,FW",Lecce,Serie A,29,1990,9.2,9,6,3,5,1,5,18,27.8,13,7,0,7,4,13,4,0,0,2019-2020,0.4347826086956522,0.9782608695652175
818,Ansu Fati,ESP,FW,Barcelona,La Liga,16,2002,11.4,16,8,4,7,5,5,15,33.3,10,14,1,13,8,24,3,0,0,2019-2020,0.7017543859649122,1.4035087719298245
819,Julien Faussurier,FRA,DF,Brest,Ligue 1,32,1987,22.0,36,22,23,13,0,21,53,39.6,32,22,7,15,33,69,46,1,0,2019-2020,1.5,1.6363636363636365
820,Andrea Favilli,ITA,FW,Genoa,Serie A,22,1997,7.3,8,7,2,3,3,4,11,36.4,7,5,1,4,0,8,7,0,0,2019-2020,0.0,1.095890410958904
821,Federico Fazio,ARG,DF,Roma,Serie A,32,1987,13.5,19,11,12,6,1,6,11,54.5,5,8,6,2,19,38,52,0,0,2019-2020,1.4074074074074074,1.4074074074074074
822,Aleix Febas,ESP,"MF,FW",Mallorca,La Liga,23,1996,18.8,36,24,13,19,4,12,36,33.3,24,15,0,15,17,53,6,0,0,2019-2020,0.9042553191489361,1.9148936170212765
823,Zouhair Feddal,MAR,DF,Betis,La Liga,30,1989,15.9,20,13,14,5,1,10,14,71.4,4,15,9,6,23,43,74,0,0,2019-2020,1.4465408805031446,1.2578616352201257
824,Ljubomir Fejsa,SRB,MF,Alavés,La Liga,30,1988,8.7,19,13,8,10,1,6,23,26.1,17,8,1,7,6,25,13,0,0,2019-2020,0.6896551724137931,2.1839080459770117
825,Nabil Fekir,FRA,"MF,FW",Betis,La Liga,26,1993,29.3,41,26,14,19,8,12,37,32.4,25,27,3,24,10,51,3,0,0,2019-2020,0.341296928327645,1.3993174061433447
Rk,Player,Nation,Pos,Squad,Comp,0,0,90.0,0,0,3,3,3,Tkl,0,0.0,0,0,0,0,0,0,0,0,0,2019-2020,0.0,0.0
826,Felipe,BRA,DF,Atlético Madrid,La Liga,30,1989,23.4,27,19,21,6,0,14,24,58.3,10,18,13,5,40,67,130,0,0,2019-2020,1.7094017094017095,1.153846153846154
827,Luiz Felipe,ITA,DF,Lazio,Serie A,22,1997,22.5,42,24,24,15,3,19,32,59.4,13,39,30,9,41,83,69,2,0,2019-2020,1.8222222222222222,1.8666666666666667
828,Lucas Felippe,BRA,"MF,DF",Hellas Verona,Serie A,19,2000,0.3,1,1,1,0,0,1,1,100.0,0,0,0,0,0,1,0,0,0,2019-2020,0.0,3.3333333333333335
829,João Félix,POR,"FW,MF",Atlético Madrid,La Liga,19,1999,19.4,9,3,3,3,3,4,14,28.6,10,4,0,4,10,19,4,1,0,2019-2020,0.5154639175257733,0.4639175257731959
830,Ohis Felix Uduokhai,GER,DF,Augsburg,Bundesliga,21,1997,21.8,43,26,30,12,1,19,29,65.5,10,40,30,10,36,79,125,2,0,2019-2020,1.6513761467889907,1.9724770642201834
831,Kiko Femenía,ESP,DF,Watford,Premier League,28,1991,24.9,68,38,49,17,2,43,80,53.8,37,16,2,14,36,104,49,0,0,2019-2020,1.4457831325301205,2.7309236947791167
832,Zinedine Ferhat,ALG,"FW,MF",Nîmes,Ligue 1,26,1993,25.0,26,16,5,16,5,15,46,32.6,31,15,3,12,16,42,18,0,0,2019-2020,0.64,1.04
833,Bruno Fernandes,POR,MF,Manchester Utd,Premier League,24,1994,13.2,22,12,9,9,4,5,38,13.2,33,6,0,6,11,33,16,0,0,2019-2020,0.8333333333333334,1.6666666666666667
834,Edimilson Fernandes,SUI,"MF,DF",Mainz 05,Bundesliga,23,1996,16.5,33,20,12,15,6,15,33,45.5,18,17,9,8,32,65,47,1,0,2019-2020,1.9393939393939394,2.0
835,Gedson Fernandes,POR,"MF,DF",Tottenham,Premier League,20,1999,0.8,2,0,2,0,0,0,2,0.0,2,2,0,2,1,3,0,0,0,2019-2020,1.25,2.5
836,Gelson Fernandes,SUI,MF,Eint Frankfurt,Bundesliga,32,1986,8.6,30,18,13,17,0,7,21,33.3,14,11,3,8,16,46,9,2,0,2019-2020,1.8604651162790697,3.488372093023256
837,Matheus Fernandes,BRA,"MF,FW",Valladolid,La Liga,21,1998,1.8,6,2,2,2,2,3,5,60.0,2,4,0,4,2,8,2,0,0,2019-2020,1.1111111111111112,3.333333333333333
838,Aitor Fernández,ESP,GK,Levante,La Liga,28,1991,36.0,1,1,1,0,0,1,1,100.0,0,0,0,0,2,3,18,3,0,2019-2020,0.05555555555555555,0.027777777777777776
839,Andrés Fernández,ESP,GK,Villarreal,La Liga,32,1986,4.0,0,0,0,0,0,0,0,0.0,0,0,0,0,0,0,2,0,0,2019-2020,0.0,0.0
840,Carlos Fernández,ESP,"FW,MF",Granada,La Liga,23,1996,24.5,24,15,7,11,6,3,32,9.4,29,25,2,23,11,35,30,0,0,2019-2020,0.4489795918367347,0.9795918367346939
841,Federico Fernández,ARG,DF,Newcastle Utd,Premier League,30,1989,29.1,42,25,30,10,2,23,46,50.0,23,41,28,13,24,66,190,2,0,2019-2020,0.8247422680412371,1.443298969072165
842,Gabriel Fernández,URU,"FW,MF",Celta Vigo,La Liga,25,1994,6.2,1,0,0,1,0,1,3,33.3,2,5,1,4,2,3,2,0,0,2019-2020,0.3225806451612903,0.16129032258064516
843,Joaquín Fernández,ESP,"MF,DF",Valladolid,La Liga,23,1996,18.4,30,24,17,10,3,9,30,30.0,21,14,10,4,32,62,57,0,0,2019-2020,1.7391304347826089,1.6304347826086958
844,Fernandinho,BRA,DF,Manchester City,Premier League,34,1985,26.6,50,35,32,16,2,29,48,60.4,19,28,16,12,25,75,82,0,0,2019-2020,0.9398496240601504,1.8796992481203008
845,Fernando,BRA,MF,Sevilla,La Liga,32,1987,29.5,62,33,37,24,1,34,58,58.6,24,38,15,23,67,129,73,1,0,2019-2020,2.2711864406779663,2.1016949152542375
846,Juan Ferney Otero,COL,"FW,MF",Amiens,Ligue 1,24,1995,13.4,17,10,6,9,2,8,24,33.3,16,12,1,11,19,36,10,0,0,2019-2020,1.417910447761194,1.2686567164179103
847,Alex Ferrari,ITA,DF,Sampdoria,Serie A,25,1994,11.2,18,13,13,5,0,7,12,58.3,5,13,8,5,12,30,31,0,0,2019-2020,1.0714285714285714,1.6071428571428572
848,Facundo Ferreyra,ARG,"FW,MF",Espanyol,La Liga,28,1991,6.4,9,4,4,5,0,3,10,30.0,7,4,0,4,2,11,5,0,0,2019-2020,0.3125,1.40625
849,Jordan Ferri,FRA,MF,Montpellier,Ligue 1,27,1992,12.8,22,13,7,12,3,13,44,29.5,31,9,0,9,10,32,10,0,0,2019-2020,0.78125,1.71875
850,Oliver Fink,GER,"MF,FW",Düsseldorf,Bundesliga,37,1982,7.5,21,12,7,11,3,5,16,31.3,11,12,1,11,15,36,7,0,0,2019-2020,2.0,2.8
Rk,Player,Nation,Pos,Squad,Comp,0,0,90.0,0,0,3,3,3,Tkl,0,0.0,0,0,0,0,0,0,0,0,0,2019-2020,0.0,0.0
851,Alfreð Finnbogason,ISL,FW,Augsburg,Bundesliga,30,1989,10.7,11,6,1,9,1,2,7,28.6,5,8,2,6,3,14,8,0,0,2019-2020,0.28037383177570097,1.0280373831775702
852,Roberto Firmino,BRA,FW,Liverpool,Premier League,27,1991,33.2,37,19,8,14,15,10,43,23.3,33,34,3,31,7,44,11,1,0,2019-2020,0.2108433734939759,1.114457831325301
853,Junior Firpo,DOM,DF,Barcelona,La Liga,22,1996,11.3,23,15,12,8,3,11,17,64.7,6,15,3,12,17,40,12,1,0,2019-2020,1.5044247787610618,2.0353982300884956
854,John Fleck,SCO,MF,Sheffield Utd,Premier League,27,1991,28.0,36,25,13,14,9,22,64,34.4,42,25,3,22,24,60,26,0,0,2019-2020,0.8571428571428571,1.2857142857142858
855,Mark Flekken,NED,GK,Freiburg,Bundesliga,26,1993,10.0,0,0,0,0,0,0,1,0.0,1,0,0,0,0,0,2,2,0,2019-2020,0.0,0.0
856,Sergio Floccari,ITA,FW,SPAL,Serie A,37,1981,10.5,8,3,3,1,4,0,13,0.0,13,9,1,8,5,13,1,0,0,2019-2020,0.47619047619047616,0.7619047619047619
857,Alessandro Florenzi,ITA,"DF,FW",Roma,Serie A,28,1991,11.1,14,11,8,4,2,7,20,35.0,13,9,3,6,16,30,19,0,0,2019-2020,1.4414414414414416,1.2612612612612613
858,Alessandro Florenzi,ITA,DF,Valencia,La Liga,28,1991,8.4,13,9,9,4,0,8,18,44.4,10,11,1,10,14,27,21,0,0,2019-2020,1.6666666666666665,1.5476190476190474
859,Phil Foden,ENG,"FW,MF",Manchester City,Premier League,19,2000,10.0,14,10,4,6,4,6,19,31.6,13,5,0,5,6,20,2,0,0,2019-2020,0.6,1.4
860,Mamadou Fofana,MLI,"DF,MF",Metz,Ligue 1,21,1998,17.6,57,35,38,15,4,21,41,51.2,20,22,10,12,22,79,61,1,0,2019-2020,1.25,3.2386363636363633
861,Seko Fofana,CIV,MF,Udinese,Serie A,24,1995,25.0,17,12,8,8,1,9,35,25.7,26,20,1,19,17,34,19,0,0,2019-2020,0.68,0.68
862,Wesley Fofana,FRA,DF,Saint-Étienne,Ligue 1,18,2000,13.5,25,15,16,9,0,12,18,66.7,6,10,5,5,36,61,55,4,0,2019-2020,2.6666666666666665,1.8518518518518519
863,Youssouf Fofana,FRA,MF,Strasbourg,Ligue 1,20,1999,11.2,25,17,10,12,3,13,30,43.3,17,11,0,11,14,39,7,0,0,2019-2020,1.25,2.232142857142857
864,Youssouf Fofana,FRA,MF,Monaco,Ligue 1,20,1999,6.8,16,9,6,10,0,8,15,53.3,7,12,2,10,8,24,9,0,0,2019-2020,1.1764705882352942,2.3529411764705883
865,Thomas Foket,BEL,DF,Reims,Ligue 1,24,1994,27.0,61,36,31,23,7,30,48,62.5,18,15,4,11,39,100,59,1,0,2019-2020,1.4444444444444444,2.259259259259259
866,Lamine Fomba,FRA,MF,Nîmes,Ligue 1,21,1998,15.3,65,31,20,37,8,21,43,48.8,22,29,4,25,25,90,11,1,0,2019-2020,1.6339869281045751,4.248366013071895
867,José Fonte,POR,DF,Lille,Ligue 1,35,1983,24.5,19,11,11,7,1,11,22,50.0,11,19,11,8,28,47,90,1,0,2019-2020,1.1428571428571428,0.7755102040816326
868,Pablo Fornals,ESP,"MF,FW",West Ham,Premier League,23,1996,24.1,46,28,21,18,7,19,64,29.7,45,35,1,34,25,71,15,0,0,2019-2020,1.0373443983402488,1.908713692946058
869,Emil Forsberg,SWE,MF,RB Leipzig,Bundesliga,27,1991,12.7,16,10,5,8,3,6,26,23.1,20,15,0,15,5,21,3,0,0,2019-2020,0.3937007874015748,1.2598425196850394
870,Hernâni Fortes,POR,"MF,FW",Levante,La Liga,27,1991,7.3,5,2,4,0,1,1,3,33.3,2,3,0,3,4,9,9,0,0,2019-2020,0.547945205479452,0.684931506849315
871,Ben Foster,ENG,GK,Watford,Premier League,36,1983,38.0,1,0,1,0,0,1,3,33.3,2,1,0,1,0,1,16,2,0,2019-2020,0.0,0.02631578947368421
872,Lyle Foster,RSA,FW,Monaco,Ligue 1,18,2000,0.7,0,0,0,0,0,0,1,0.0,1,0,0,0,0,0,1,0,0,2019-2020,0.0,0.0
873,Timothy Fosu-Mensah,NED,DF,Manchester Utd,Premier League,21,1998,1.5,1,1,0,1,0,1,4,25.0,3,0,0,0,4,5,1,0,0,2019-2020,2.6666666666666665,0.6666666666666666
874,Dimitri Foulquier,FRA,"DF,MF",Watford,Premier League,26,1993,0.7,1,0,1,0,0,0,0,0.0,0,1,0,1,2,3,2,0,0,2019-2020,2.857142857142857,1.4285714285714286
875,Dimitri Foulquier,FRA,"DF,MF",Granada,La Liga,26,1993,12.4,25,11,13,9,3,11,20,55.0,9,8,3,5,16,41,32,0,0,2019-2020,1.2903225806451613,2.0161290322580645
Rk,Player,Nation,Pos,Squad,Comp,0,0,90.0,0,0,3,3,3,Tkl,0,0.0,0,0,0,0,0,0,0,0,0,2019-2020,0.0,0.0
876,Juan Foyth,ARG,DF,Tottenham,Premier League,21,1998,0.8,7,3,5,2,0,3,4,75.0,1,1,0,1,1,8,3,1,0,2019-2020,1.25,8.75
877,Gianluca Frabotta,ITA,DF,Juventus,Serie A,20,1999,1.0,3,1,0,2,1,2,2,100.0,0,2,0,2,1,4,2,0,0,2019-2020,1.0,3.0
878,Raphael Framberger,GER,DF,Augsburg,Bundesliga,23,1995,13.1,43,25,23,16,4,21,29,72.4,8,23,9,14,20,63,26,0,0,2019-2020,1.5267175572519085,3.282442748091603
879,Simon Francis,ENG,DF,Bournemouth,Premier League,34,1985,10.8,13,9,11,2,0,11,21,52.4,10,17,12,5,20,33,71,0,0,2019-2020,1.8518518518518516,1.2037037037037037
880,Mike Frantz,GER,MF,Freiburg,Bundesliga,32,1986,3.9,4,2,1,3,0,2,9,22.2,7,5,3,2,1,5,4,0,0,2019-2020,0.25641025641025644,1.0256410256410258
881,Ryan Fraser,SCO,"MF,FW",Bournemouth,Premier League,25,1994,23.0,12,6,5,5,2,7,22,31.8,15,15,3,12,15,27,24,0,0,2019-2020,0.6521739130434783,0.5217391304347826
882,Fred,BRA,MF,Manchester Utd,Premier League,26,1993,24.0,60,32,33,22,5,25,100,25.0,75,44,8,36,38,98,32,0,0,2019-2020,1.5833333333333333,2.5
883,Ryan Fredericks,ENG,DF,West Ham,Premier League,26,1992,24.9,82,56,59,18,5,41,64,64.1,23,20,10,10,24,106,73,1,0,2019-2020,0.9638554216867471,3.2931726907630523
884,Kieron Freeman,WAL,FW,Sheffield Utd,Premier League,27,1992,0.1,0,0,0,0,0,0,0,0.0,0,0,0,0,0,0,0,0,0,2019-2020,0.0,0.0
885,Luke Freeman,ENG,MF,Sheffield Utd,Premier League,27,1992,4.1,6,4,2,2,2,2,8,25.0,6,1,0,1,10,16,6,0,0,2019-2020,2.439024390243903,1.4634146341463417
886,Remo Freuler,SUI,MF,Atalanta,Serie A,27,1992,26.0,51,30,18,25,8,22,63,34.9,41,41,6,35,28,79,26,0,0,2019-2020,1.0769230769230769,1.9615384615384615
887,Marco Friedl,AUT,"DF,MF",Werder Bremen,Bundesliga,21,1998,24.3,61,39,42,15,4,29,54,53.7,25,29,9,20,34,95,78,0,0,2019-2020,1.3991769547325101,2.5102880658436213
888,Marvin Friedrich,GER,DF,Union Berlin,Bundesliga,23,1995,31.0,45,31,30,14,1,12,37,32.4,25,46,24,22,42,87,110,0,0,2019-2020,1.3548387096774193,1.4516129032258065
889,Samúel Friðjónsson,ISL,MF,Paderborn 07,Bundesliga,23,1996,2.1,4,1,3,1,0,1,3,33.3,2,4,1,3,4,8,4,0,0,2019-2020,1.9047619047619047,1.9047619047619047
890,Jorge de Frutos,ESP,"MF,DF",Valladolid,La Liga,22,1997,0.7,2,2,2,0,0,1,2,50.0,1,0,0,0,0,2,1,0,0,2019-2020,0.0,2.857142857142857
891,Christian Fuchs,AUT,DF,Leicester City,Premier League,33,1986,8.6,14,9,8,6,0,8,19,42.1,11,8,3,5,17,31,33,1,0,2019-2020,1.9767441860465118,1.627906976744186
892,Angelo Fulgini,FRA,MF,Angers,Ligue 1,22,1996,17.5,28,18,8,15,5,12,23,52.2,11,6,1,5,19,47,10,0,0,2019-2020,1.0857142857142856,1.6
893,Niclas Füllkrug,GER,FW,Werder Bremen,Bundesliga,26,1993,4.5,2,2,1,1,0,1,3,33.3,2,3,0,3,3,5,6,0,0,2019-2020,0.6666666666666666,0.4444444444444444
894,Ramiro Funes Mori,ARG,DF,Villarreal,La Liga,28,1991,5.0,5,2,2,3,0,0,2,0.0,2,8,2,6,3,8,9,1,0,2019-2020,0.6,1.0
895,Daniel Fuzato,BRA,GK,Roma,Serie A,22,1997,1.0,0,0,0,0,0,0,0,0.0,0,0,0,0,0,0,0,0,0,2019-2020,0.0,0.0
896,Matteo Gabbia,ITA,DF,Milan,Serie A,19,1999,7.6,7,5,5,2,0,5,8,62.5,3,6,6,0,9,16,21,0,0,2019-2020,1.1842105263157896,0.9210526315789475
897,Manolo Gabbiadini,ITA,FW,Sampdoria,Serie A,27,1991,22.6,9,7,2,3,4,1,7,14.3,6,12,0,12,10,19,11,0,0,2019-2020,0.44247787610619466,0.3982300884955752
898,Gabriel,BRA,GK,Lecce,Serie A,26,1992,33.3,2,1,2,0,0,2,3,66.7,1,0,0,0,0,2,11,10,0,2019-2020,0.0,0.060060060060060066
899,Ruben Gabrielsen,NOR,DF,Toulouse,Ligue 1,27,1992,7.3,3,2,3,0,0,2,4,50.0,2,5,3,2,8,11,41,0,0,2019-2020,1.095890410958904,0.4109589041095891
900,Mijat Gaćinović,SRB,"MF,FW",Eint Frankfurt,Bundesliga,24,1995,11.6,19,11,7,8,4,6,25,24.0,19,26,2,24,15,34,6,0,0,2019-2020,1.293103448275862,1.6379310344827587
Rk,Player,Nation,Pos,Squad,Comp,0,0,90.0,0,0,3,3,3,Tkl,0,0.0,0,0,0,0,0,0,0,0,0,2019-2020,0.0,0.0
901,Luca Gagliano,ITA,FW,Cagliari,Serie A,19,2000,0.6,0,0,0,0,0,0,0,0.0,0,0,0,0,1,1,0,0,0,2019-2020,1.6666666666666667,0.0
902,Roberto Gagliardini,ITA,MF,Inter,Serie A,25,1994,20.0,38,19,12,18,8,14,41,34.1,27,28,8,20,30,68,20,1,0,2019-2020,1.5,1.9
903,Riccardo Gagliolo,SWE,DF,Parma,Serie A,29,1990,28.9,57,32,37,12,8,30,60,50.0,30,35,18,17,53,110,100,0,0,2019-2020,1.8339100346020762,1.972318339100346
904,Nicolás Gaitán,ARG,"MF,FW",Lille,Ligue 1,31,1988,0.6,1,0,0,1,0,1,1,100.0,0,1,0,1,0,1,1,0,0,2019-2020,0.0,1.6666666666666667
905,Marvin Gakpa,FRA,"MF,FW",Metz,Ligue 1,25,1993,5.2,10,6,3,4,3,4,8,50.0,4,3,0,3,5,15,1,0,0,2019-2020,0.9615384615384615,1.923076923076923
906,Enric Gallego,ESP,FW,Osasuna,La Liga,32,1986,9.8,9,5,1,5,3,0,4,0.0,4,10,2,8,4,13,8,0,0,2019-2020,0.4081632653061224,0.9183673469387754
907,Enric Gallego,ESP,FW,Getafe,La Liga,32,1986,1.8,3,1,1,1,1,2,4,50.0,2,2,0,2,2,5,1,0,0,2019-2020,1.1111111111111112,1.6666666666666665
908,Kévin Gameiro,FRA,FW,Valencia,La Liga,32,1987,17.6,17,9,7,6,4,5,21,23.8,16,10,1,9,5,22,5,0,0,2019-2020,0.28409090909090906,0.9659090909090908
909,Fran Gámez,ESP,DF,Mallorca,La Liga,28,1991,19.6,64,42,32,27,5,33,74,44.6,41,31,11,20,29,93,41,0,0,2019-2020,1.4795918367346939,3.265306122448979
910,Idrissa Gana Gueye,SEN,MF,Paris S-G,Ligue 1,29,1989,18.4,65,34,30,25,10,18,43,41.9,25,29,4,25,33,98,15,0,0,2019-2020,1.7934782608695654,3.5326086956521743
911,Ignatius Ganago,CMR,"FW,MF",Nice,Ligue 1,20,1999,13.8,10,6,4,3,3,3,18,16.7,15,8,1,7,4,14,13,0,0,2019-2020,0.2898550724637681,0.7246376811594203
912,Ezequiel Garay,ARG,DF,Valencia,La Liga,32,1986,16.0,12,8,9,2,1,7,11,63.6,4,19,17,2,14,26,71,0,0,2019-2020,0.875,0.75
913,Dani García,ESP,MF,Athletic Club,La Liga,29,1990,33.7,59,30,30,27,2,30,86,34.9,56,25,7,18,52,111,56,1,0,2019-2020,1.5430267062314538,1.750741839762611
914,David García,ESP,DF,Osasuna,La Liga,25,1994,31.0,28,16,15,12,1,14,31,45.2,17,20,16,4,48,76,123,2,0,2019-2020,1.5483870967741935,0.9032258064516129
915,Eric García,ESP,DF,Manchester City,Premier League,18,2001,8.8,6,1,4,2,0,5,9,55.6,4,2,0,2,18,24,33,0,0,2019-2020,2.0454545454545454,0.6818181818181818
916,Javi García,ESP,MF,Betis,La Liga,32,1987,4.2,2,2,2,0,0,2,3,66.7,1,1,0,1,4,6,15,0,0,2019-2020,0.9523809523809523,0.47619047619047616
917,Manu García,ESP,MF,Alavés,La Liga,33,1986,21.9,46,23,11,31,4,17,72,23.6,55,28,12,16,28,74,32,1,0,2019-2020,1.2785388127853883,2.1004566210045663
918,Raúl García,ESP,"DF,MF",Valladolid,La Liga,30,1989,11.2,20,12,11,7,2,9,22,40.9,13,12,2,10,8,28,30,0,0,2019-2020,0.7142857142857143,1.7857142857142858
919,Raúl García,ESP,"MF,FW",Athletic Club,La Liga,33,1986,31.9,57,37,19,26,12,16,76,21.1,60,46,6,40,24,81,44,0,0,2019-2020,0.7523510971786834,1.786833855799373
920,Raúl García,ESP,DF,Getafe,La Liga,30,1989,2.7,5,3,2,3,0,3,6,50.0,3,3,1,2,4,9,10,0,0,2019-2020,1.4814814814814814,1.8518518518518516
921,Rubén García,ESP,"MF,FW",Osasuna,La Liga,26,1993,24.3,55,30,22,26,7,18,46,39.1,28,34,5,29,11,66,23,1,0,2019-2020,0.45267489711934156,2.263374485596708
922,Unai García,ESP,DF,Osasuna,La Liga,27,1992,6.0,9,6,4,4,1,5,9,55.6,4,13,9,4,8,17,31,0,0,2019-2020,1.3333333333333333,1.5
923,Víctor García,ESP,"FW,MF",Valladolid,La Liga,21,1997,1.0,0,0,0,0,0,0,1,0.0,1,1,0,1,0,0,1,0,0,2019-2020,0.0,0.0
924,James Garner,ENG,MF,Manchester Utd,Premier League,18,2001,0.1,0,0,0,0,0,0,1,0.0,1,0,0,0,0,0,1,0,0,2019-2020,0.0,0.0
925,Manuel Garrido,ESP,FW,Leganés,La Liga,18,2000,1.3,0,0,0,0,0,0,6,0.0,6,3,1,2,1,1,0,0,0,2019-2020,0.7692307692307692,0.0
Rk,Player,Nation,Pos,Squad,Comp,0,0,90.0,0,0,3,3,3,Tkl,0,0.0,0,0,0,0,0,0,0,0,0,2019-2020,0.0,0.0
926,Mario Gaspar,ESP,DF,Villarreal,La Liga,28,1990,21.8,35,20,16,16,3,15,31,48.4,16,25,10,15,26,61,69,0,0,2019-2020,1.1926605504587156,1.6055045871559632
927,Daniele Gastaldello,ITA,DF,Brescia,Serie A,36,1983,4.3,8,5,5,3,0,2,3,66.7,1,6,3,3,5,13,29,1,0,2019-2020,1.1627906976744187,1.8604651162790697
928,Dwight Gayle,ENG,FW,Newcastle Utd,Premier League,28,1990,9.4,12,10,4,6,2,4,8,50.0,4,5,0,5,2,14,9,0,0,2019-2020,0.2127659574468085,1.276595744680851
929,Paulo Gazzaniga,ARG,GK,Tottenham,Premier League,27,1992,17.9,0,0,0,0,0,0,0,0.0,0,0,0,0,1,1,4,1,0,2019-2020,0.0558659217877095,0.0
930,Jean-Philippe Gbamin,CIV,MF,Everton,Premier League,23,1995,1.5,4,3,1,1,2,1,2,50.0,1,1,0,1,1,5,4,0,0,2019-2020,0.6666666666666666,2.6666666666666665
931,Yann Gboho,FRA,FW,Rennes,Ligue 1,18,2001,2.5,2,2,1,0,1,0,2,0.0,2,1,0,1,1,3,0,0,0,2019-2020,0.4,0.8
932,David de Gea,ESP,GK,Manchester Utd,Premier League,28,1990,38.0,0,0,0,0,0,0,0,0.0,0,0,0,0,0,0,7,4,0,2019-2020,0.0,0.0
933,Theodor Gebre Selassie,CZE,"DF,MF",Werder Bremen,Bundesliga,32,1986,27.0,36,27,23,10,3,17,35,48.6,18,26,9,17,63,99,81,0,0,2019-2020,2.3333333333333335,1.3333333333333333
934,Dennis Geiger,GER,MF,Hoffenheim,Bundesliga,21,1998,12.6,12,5,4,6,2,2,16,12.5,14,9,2,7,6,18,4,0,0,2019-2020,0.4761904761904762,0.9523809523809524
935,Jérémy Gélin,FRA,"DF,MF",Rennes,Ligue 1,22,1997,10.3,14,5,10,2,2,8,13,61.5,5,14,7,7,15,29,33,1,0,2019-2020,1.4563106796116503,1.3592233009708736
936,Christian Gentner,GER,MF,Union Berlin,Bundesliga,33,1985,27.1,53,28,16,32,5,22,73,30.1,51,46,8,38,54,107,50,0,0,2019-2020,1.9926199261992619,1.955719557195572
937,Yannick Gerhardt,GER,MF,Wolfsburg,Bundesliga,25,1994,9.2,28,18,7,15,6,8,21,38.1,13,11,3,8,12,40,9,0,0,2019-2020,1.3043478260869565,3.0434782608695654
938,Valère Germain,FRA,FW,Marseille,Ligue 1,29,1990,15.0,22,12,6,11,5,6,31,19.4,25,16,3,13,8,30,26,0,0,2019-2020,0.5333333333333333,1.4666666666666666
939,Gervinho,CIV,FW,Parma,Serie A,32,1987,25.2,12,6,5,6,1,6,17,35.3,11,4,0,4,5,17,3,0,0,2019-2020,0.19841269841269843,0.4761904761904762
940,Anwar El Ghazi,NED,"FW,MF",Aston Villa,Premier League,24,1995,22.8,20,11,12,5,3,8,26,30.8,18,10,1,9,13,33,16,1,0,2019-2020,0.5701754385964912,0.8771929824561403
941,Rachid Ghezzal,ALG,"MF,FW",Fiorentina,Serie A,27,1992,9.2,27,15,14,10,3,10,33,30.3,23,6,0,6,11,38,9,0,0,2019-2020,1.1956521739130437,2.9347826086956523
942,Andrea Ghezzi,ITA,"FW,MF",Brescia,Serie A,18,2001,0.4,2,0,0,1,1,1,1,100.0,0,0,0,0,0,2,0,0,0,2019-2020,0.0,5.0
943,Paolo Ghiglione,ITA,"DF,FW",Genoa,Serie A,22,1997,19.1,31,16,15,13,3,18,35,51.4,17,17,2,15,9,40,42,1,0,2019-2020,0.47120418848167533,1.6230366492146595
944,Andrea Ghion,ITA,"FW,MF",Sassuolo,Serie A,19,2000,0.5,3,1,1,2,0,1,1,100.0,0,0,0,0,0,3,0,0,0,2019-2020,0.0,6.0
945,Saman Ghoddos,IRN,FW,Amiens,Ligue 1,25,1993,2.6,2,2,0,1,1,1,2,50.0,1,5,0,5,2,4,3,0,0,2019-2020,0.7692307692307692,0.7692307692307692
946,Faouzi Ghoulam,ALG,DF,Napoli,Serie A,28,1991,4.2,6,4,1,4,1,2,5,40.0,3,3,2,1,4,10,8,0,0,2019-2020,0.9523809523809523,1.4285714285714286
947,Morgan Gibbs-White,ENG,"MF,FW",Wolves,Premier League,19,2000,1.4,0,0,0,0,0,0,0,0.0,0,0,0,0,2,2,0,0,0,2019-2020,1.4285714285714286,0.0
948,Niko Gießelmann,GER,DF,Düsseldorf,Bundesliga,27,1991,22.9,46,31,31,11,4,22,45,48.9,23,23,6,17,27,73,55,1,0,2019-2020,1.1790393013100438,2.0087336244541487
949,Rafał Gikiewicz,POL,GK,Union Berlin,Bundesliga,31,1987,33.0,1,0,1,0,0,1,4,25.0,3,0,0,0,2,3,26,4,0,2019-2020,0.06060606060606061,0.030303030303030304
950,Bryan Gil,ESP,"MF,FW",Leganés,La Liga,18,2001,6.2,8,4,3,4,1,1,8,12.5,7,6,0,6,3,11,1,0,0,2019-2020,0.48387096774193544,1.2903225806451613
Rk,Player,Nation,Pos,Squad,Comp,0,0,90.0,0,0,3,3,3,Tkl,0,0.0,0,0,0,0,0,0,0,0,0,2019-2020,0.0,0.0
951,Bryan Gil,ESP,FW,Sevilla,La Liga,18,2001,0.7,1,1,0,1,0,0,1,0.0,1,0,0,0,0,1,0,0,0,2019-2020,0.0,1.4285714285714286
952,Billy Gilmour,SCO,MF,Chelsea,Premier League,18,2001,2.2,5,2,3,2,0,2,4,50.0,2,2,0,2,3,8,3,1,0,2019-2020,1.3636363636363635,2.2727272727272725
953,Daniel Ginczek,GER,FW,Wolfsburg,Bundesliga,28,1991,8.5,4,3,3,1,0,1,11,9.1,10,3,1,2,1,5,3,0,0,2019-2020,0.11764705882352941,0.47058823529411764
954,Matthias Ginter,GER,DF,Gladbach,Bundesliga,25,1994,30.9,34,20,19,14,1,17,31,54.8,14,27,22,5,34,68,125,3,0,2019-2020,1.1003236245954693,1.1003236245954693
955,Andrei Girotto,BRA,DF,Nantes,Ligue 1,27,1992,24.2,76,53,45,29,2,39,71,54.9,32,32,17,15,34,110,111,1,0,2019-2020,1.4049586776859504,3.1404958677685952
956,Olivier Giroud,FRA,FW,Chelsea,Premier League,32,1986,11.0,8,3,2,5,1,1,11,9.1,10,14,1,13,2,10,13,0,0,2019-2020,0.18181818181818182,0.7272727272727273
957,Klaus Gjasula,ALB,MF,Paderborn 07,Bundesliga,29,1989,25.3,69,39,30,35,4,30,61,49.2,31,33,6,27,32,101,50,2,0,2019-2020,1.2648221343873518,2.727272727272727
958,Kamil Glik,POL,DF,Monaco,Ligue 1,31,1988,23.0,26,14,15,11,0,13,21,61.9,8,23,17,6,27,53,118,0,0,2019-2020,1.173913043478261,1.1304347826086956
959,Serge Gnabry,GER,"FW,MF",Bayern Munich,Bundesliga,24,1995,24.4,36,16,4,19,13,9,29,31.0,20,17,0,17,16,52,2,1,0,2019-2020,0.6557377049180328,1.4754098360655739
960,Joris Gnagnon,FRA,DF,Rennes,Ligue 1,22,1997,14.2,16,13,14,2,0,10,11,90.9,1,21,17,4,18,34,61,0,0,2019-2020,1.267605633802817,1.1267605633802817
961,Eddy Gnahoré,FRA,MF,Amiens,Ligue 1,25,1993,12.6,24,12,7,15,2,8,28,28.6,20,25,4,21,9,33,25,0,0,2019-2020,0.7142857142857143,1.9047619047619049
962,Ben Godfrey,ENG,DF,Norwich City,Premier League,21,1998,29.4,22,14,18,3,1,10,18,55.6,8,41,37,4,25,47,152,3,0,2019-2020,0.8503401360544218,0.7482993197278912
963,Diego Godín,URU,DF,Inter,Serie A,33,1986,18.1,38,29,19,16,3,18,32,56.3,14,17,7,10,45,83,60,1,0,2019-2020,2.486187845303867,2.0994475138121547
964,Akaki Gogia,GER,"MF,FW",Union Berlin,Bundesliga,27,1992,1.3,2,1,0,0,2,0,2,0.0,2,2,2,0,0,2,0,0,0,2019-2020,0.0,1.5384615384615383
965,Mauro Goicoechea,URU,GK,Toulouse,Ligue 1,31,1988,2.0,0,0,0,0,0,0,0,0.0,0,0,0,0,0,0,1,2,0,2019-2020,0.0,0.0
966,Edoardo Goldaniga,ITA,DF,Genoa,Serie A,25,1993,8.7,4,3,3,1,0,2,5,40.0,3,11,6,5,18,22,25,1,0,2019-2020,2.0689655172413794,0.4597701149425288
967,Benjamin Goller,GER,"FW,MF",Werder Bremen,Bundesliga,20,1999,3.2,8,3,3,4,1,3,10,30.0,7,3,0,3,1,9,1,0,0,2019-2020,0.3125,2.5
968,Pierluigi Gollini,ITA,GK,Atalanta,Serie A,24,1995,32.0,0,0,0,0,0,0,2,0.0,2,0,0,0,0,0,13,2,0,2019-2020,0.0,0.0
969,Aleksandr Golovin,RUS,MF,Monaco,Ligue 1,23,1996,22.9,49,27,17,26,6,14,69,20.3,55,28,0,28,31,80,22,0,0,2019-2020,1.3537117903930131,2.139737991266376
970,André Gomes,POR,MF,Everton,Premier League,26,1993,16.2,22,15,7,11,4,8,62,12.9,54,20,3,17,7,29,7,0,0,2019-2020,0.4320987654320988,1.3580246913580247
971,Angel Gomes,ENG,MF,Manchester Utd,Premier League,18,2000,0.2,0,0,0,0,0,0,0,0.0,0,1,0,1,0,0,0,0,0,2019-2020,0.0,0.0
972,Ibai Gómez,ESP,FW,Athletic Club,La Liga,29,1989,7.7,5,3,2,2,1,3,8,37.5,5,4,0,4,3,8,6,0,0,2019-2020,0.38961038961038963,0.6493506493506493
973,Joe Gomez,ENG,DF,Liverpool,Premier League,22,1997,22.3,23,16,17,6,0,9,20,45.0,11,15,8,7,38,61,64,2,0,2019-2020,1.704035874439462,1.0313901345291479
974,Maxi Gómez,URU,FW,Valencia,La Liga,22,1996,23.8,9,7,1,6,2,4,8,50.0,4,8,1,7,5,14,14,0,0,2019-2020,0.21008403361344538,0.37815126050420167
975,Moi Gómez,ESP,"FW,MF",Villarreal,La Liga,25,1994,25.8,30,22,9,14,7,11,33,33.3,22,22,2,20,25,55,23,0,0,2019-2020,0.9689922480620154,1.1627906976744187
Rk,Player,Nation,Pos,Squad,Comp,0,0,90.0,0,0,3,3,3,Tkl,0,0.0,0,0,0,0,0,0,0,0,0,2019-2020,0.0,0.0
976,Papu Gómez,ARG,"MF,FW",Atalanta,Serie A,31,1988,31.6,27,13,5,13,9,13,45,28.9,32,24,0,24,17,44,6,1,0,2019-2020,0.5379746835443038,0.8544303797468354
977,Sergi Gómez,ESP,DF,Sevilla,La Liga,27,1992,8.0,9,7,7,2,0,4,4,100.0,0,6,6,0,7,16,30,0,0,2019-2020,0.875,1.125
978,Victor Gomez,ESP,"DF,FW",Espanyol,La Liga,19,2000,14.1,13,5,8,4,1,7,20,35.0,13,10,0,10,21,34,31,0,0,2019-2020,1.4893617021276595,0.9219858156028369
979,Alfred Gomis,SEN,GK,Dijon,Ligue 1,25,1993,18.0,1,0,1,0,0,1,2,50.0,1,2,0,2,0,1,14,2,0,2019-2020,0.0,0.05555555555555555
980,Maxime Gonalons,FRA,MF,Granada,La Liga,30,1989,16.7,62,38,25,35,2,22,54,40.7,32,27,3,24,20,82,20,1,0,2019-2020,1.1976047904191618,3.712574850299401
981,Mathieu Goncalves,FRA,DF,Toulouse,Ligue 1,18,2001,3.5,5,3,5,0,0,2,8,25.0,6,4,3,1,4,9,10,0,0,2019-2020,1.1428571428571428,1.4285714285714286
982,Jérôme Gondorf,GER,MF,Freiburg,Bundesliga,31,1988,1.3,9,6,7,1,1,3,6,50.0,3,3,2,1,0,9,2,0,0,2019-2020,0.0,6.9230769230769225
983,Álvaro González,ESP,DF,Marseille,Ligue 1,29,1990,18.1,19,13,14,4,1,9,13,69.2,4,7,4,3,18,37,65,0,0,2019-2020,0.9944751381215469,1.0497237569060773
984,Bruno González,ESP,DF,Getafe,La Liga,29,1990,2.0,3,2,3,0,0,1,1,100.0,0,2,0,2,0,3,3,0,0,2019-2020,0.0,1.5
985,Bruno González,ESP,DF,Levante,La Liga,29,1990,5.1,10,8,7,2,1,2,4,50.0,2,7,4,3,2,12,32,0,0,2019-2020,0.3921568627450981,1.9607843137254903
986,Édgar González,ESP,MF,Betis,La Liga,22,1997,7.6,8,3,3,5,0,2,14,14.3,12,4,2,2,10,18,16,0,0,2019-2020,1.3157894736842106,1.0526315789473684
987,Gonzalo,ESP,DF,Levante,La Liga,22,1997,0.1,1,0,0,1,0,0,0,0.0,0,0,0,0,0,1,0,0,0,2019-2020,0.0,10.0
988,Anthony Gordon,ENG,"MF,FW",Everton,Premier League,18,2001,4.9,11,7,5,6,0,5,15,33.3,10,6,2,4,8,19,4,0,0,2019-2020,1.6326530612244896,2.2448979591836733
989,Leon Goretzka,GER,MF,Bayern Munich,Bundesliga,24,1995,16.8,28,15,7,18,3,10,32,31.3,22,18,2,16,24,52,8,0,0,2019-2020,1.4285714285714286,1.6666666666666665
990,Andoni Gorosabel,ESP,DF,Real Sociedad,La Liga,22,1996,7.9,14,8,9,3,2,10,20,50.0,10,13,1,12,13,27,21,0,0,2019-2020,1.6455696202531644,1.7721518987341771
991,Robin Gosens,GER,DF,Atalanta,Serie A,25,1994,29.1,53,27,19,26,8,23,51,45.1,28,38,10,28,39,92,40,0,0,2019-2020,1.3402061855670102,1.8213058419243986
992,Dan Gosling,ENG,MF,Bournemouth,Premier League,29,1990,14.0,26,10,14,9,3,6,27,22.2,21,31,11,20,20,46,26,0,0,2019-2020,1.4285714285714286,1.8571428571428572
993,Mario Götze,GER,FW,Dortmund,Bundesliga,27,1992,5.8,10,7,0,6,4,3,12,25.0,9,3,0,3,2,12,1,0,0,2019-2020,0.3448275862068966,1.7241379310344829
994,Prince-Désir Gouano,FRA,DF,Amiens,Ligue 1,25,1993,3.0,3,1,0,3,0,0,0,0.0,0,6,3,3,2,5,15,0,0,2019-2020,0.6666666666666666,1.0
995,Amine Gouiri,ALG,FW,Lyon,Ligue 1,19,2000,0.0,0,0,0,0,0,0,0,0.0,0,0,0,0,0,0,0,0,0,2019-2020,,
996,Jeffrey Gouweleeuw,NED,DF,Augsburg,Bundesliga,28,1991,18.3,28,16,22,5,1,12,21,57.1,9,15,8,7,37,65,97,0,0,2019-2020,2.021857923497268,1.530054644808743
997,Max Gradel,CIV,"MF,FW",Toulouse,Ligue 1,31,1987,18.2,36,20,17,14,5,12,47,25.5,35,11,1,10,11,47,23,0,0,2019-2020,0.6043956043956045,1.978021978021978
998,Samuel Grandsir,FRA,"FW,MF",Brest,Ligue 1,22,1996,16.6,34,22,13,16,5,11,30,36.7,19,9,0,9,14,48,5,0,0,2019-2020,0.8433734939759036,2.048192771084337
999,Esteban Granero,ESP,MF,Espanyol,La Liga,32,1987,5.3,10,4,5,3,2,5,11,45.5,6,3,2,1,2,12,5,0,0,2019-2020,0.37735849056603776,1.8867924528301887
1000,Alberto Grassi,ITA,MF,Parma,Serie A,24,1995,7.1,10,4,7,3,0,5,13,38.5,8,5,2,3,19,29,9,1,0,2019-2020,2.676056338028169,1.4084507042253522
Rk,Player,Nation,Pos,Squad,Comp,0,0,90.0,0,0,3,3,3,Tkl,0,0.0,0,0,0,0,0,0,0,0,0,2019-2020,0.0,0.0
1001,Andre Gray,JAM,FW,Watford,Premier League,28,1991,8.4,4,3,0,2,2,1,3,33.3,2,4,1,3,1,5,2,0,0,2019-2020,0.11904761904761904,0.47619047619047616
1002,Demarai Gray,JAM,"MF,FW",Leicester City,Premier League,23,1996,6.9,12,6,6,6,0,6,12,50.0,6,7,0,7,5,17,4,0,0,2019-2020,0.7246376811594203,1.7391304347826086
1003,Jack Grealish,ENG,"FW,MF",Aston Villa,Premier League,23,1995,35.9,29,19,12,12,5,13,34,38.2,21,33,12,21,22,51,22,1,0,2019-2020,0.6128133704735377,0.807799442896936
1004,Mason Greenwood,ENG,FW,Manchester Utd,Premier League,17,2001,14.7,17,11,5,6,6,5,20,25.0,15,9,0,9,6,23,6,1,0,2019-2020,0.40816326530612246,1.1564625850340136
1005,Michael Gregoritsch,AUT,"MF,FW",Augsburg,Bundesliga,25,1994,3.4,2,2,0,2,0,0,4,0.0,4,4,1,3,3,5,7,0,0,2019-2020,0.8823529411764706,0.5882352941176471
1006,Michael Gregoritsch,AUT,FW,Schalke 04,Bundesliga,25,1994,9.2,8,5,0,6,2,0,9,0.0,9,9,1,8,2,10,10,0,0,2019-2020,0.2173913043478261,0.8695652173913044
1007,Clément Grenier,FRA,MF,Rennes,Ligue 1,28,1991,9.3,21,12,6,15,0,11,40,27.5,29,7,2,5,7,28,16,0,0,2019-2020,0.7526881720430108,2.258064516129032
1008,Antoine Griezmann,FRA,FW,Barcelona,La Liga,28,1991,28.3,33,18,12,11,10,9,34,26.5,25,22,3,19,12,45,20,1,0,2019-2020,0.42402826855123676,1.1660777385159011
1009,Vincenzo Grifo,ITA,MF,Hoffenheim,Bundesliga,26,1993,0.2,0,0,0,0,0,0,0,0.0,0,0,0,0,0,0,0,0,0,2019-2020,0.0,0.0
1010,Vincenzo Grifo,ITA,"MF,FW",Freiburg,Bundesliga,26,1993,18.0,15,10,9,3,3,6,25,24.0,19,13,1,12,14,29,18,1,0,2019-2020,0.7777777777777778,0.8333333333333334
1011,Florian Grillitsch,AUT,"MF,DF",Hoffenheim,Bundesliga,23,1995,26.8,59,29,34,24,1,29,61,47.5,32,33,6,27,49,108,41,1,0,2019-2020,1.828358208955224,2.201492537313433
1012,Jérémy Grimm,FRA,MF,Strasbourg,Ligue 1,32,1987,0.0,0,0,0,0,0,0,0,0.0,0,0,0,0,0,0,0,0,0,2019-2020,,
1013,Christian Groß,GER,"DF,MF",Werder Bremen,Bundesliga,30,1989,9.7,23,17,16,5,2,9,16,56.3,7,13,7,6,14,37,50,1,0,2019-2020,1.4432989690721651,2.3711340206185567
1014,Pascal Groß,GER,"MF,FW",Brighton,Premier League,28,1991,20.0,36,13,8,21,7,14,39,35.9,25,25,3,22,9,45,7,0,0,2019-2020,0.45,1.8
1015,Carlos Gruezo,ECU,MF,Augsburg,Bundesliga,24,1995,9.8,28,12,12,15,1,5,24,20.8,19,5,0,5,6,34,5,0,0,2019-2020,0.6122448979591836,2.8571428571428568
1016,Marko Grujić,SRB,MF,Hertha BSC,Bundesliga,23,1996,26.8,56,34,21,30,5,19,63,30.2,44,43,9,34,22,78,69,0,0,2019-2020,0.8208955223880596,2.08955223880597
1017,Vicente Guaita,ESP,GK,Crystal Palace,Premier League,32,1987,35.0,1,1,1,0,0,1,2,50.0,1,0,0,0,0,1,18,3,0,2019-2020,0.0,0.02857142857142857
1018,Andrés Guardado,MEX,MF,Betis,La Liga,32,1986,22.7,30,14,15,11,4,15,41,36.6,26,15,4,11,18,48,22,1,0,2019-2020,0.7929515418502203,1.3215859030837005
1019,Sergi Guardiola,ESP,FW,Valladolid,La Liga,28,1991,29.5,14,6,3,7,4,4,24,16.7,20,23,0,23,6,20,18,1,0,2019-2020,0.2033898305084746,0.4745762711864407
1020,Nemanja Gudelj,SRB,"MF,DF",Sevilla,La Liga,27,1991,13.5,20,14,11,8,1,6,19,31.6,13,17,8,9,12,32,35,1,0,2019-2020,0.8888888888888888,1.4814814814814814
1021,Gonçalo Guedes,POR,"MF,FW",Valencia,La Liga,22,1996,14.1,19,11,11,7,1,9,32,28.1,23,10,1,9,7,26,1,0,0,2019-2020,0.49645390070921985,1.3475177304964538
1022,Mattéo Guendouzi,FRA,MF,Arsenal,Premier League,20,1999,19.4,31,16,14,13,4,14,43,32.6,29,21,7,14,29,60,38,2,0,2019-2020,1.4948453608247423,1.597938144329897
1023,Raphaël Guerreiro,POR,"DF,MF",Dortmund,Bundesliga,25,1993,25.9,44,24,18,21,5,20,32,62.5,12,27,3,24,42,86,26,0,0,2019-2020,1.6216216216216217,1.698841698841699
1024,Adrián Guerrero,ESP,DF,Valencia,La Liga,21,1998,1.4,2,2,1,1,0,2,3,66.7,1,0,0,0,2,4,1,0,0,2019-2020,1.4285714285714286,1.4285714285714286
1025,Ander Guevara,ESP,MF,Real Sociedad,La Liga,22,1997,10.4,27,11,9,17,1,12,30,40.0,18,13,3,10,8,35,15,1,0,2019-2020,0.7692307692307692,2.5961538461538463
Rk,Player,Nation,Pos,Squad,Comp,0,0,90.0,0,0,3,3,3,Tkl,0,0.0,0,0,0,0,0,0,0,0,0,2019-2020,0.0,0.0
1026,Babacar Guèye,SEN,FW,Paderborn 07,Bundesliga,24,1994,1.2,2,0,0,0,2,0,1,0.0,1,1,1,0,0,2,3,0,0,2019-2020,0.0,1.6666666666666667
1027,John Guidetti,SWE,"FW,MF",Alavés,La Liga,27,1992,1.1,2,1,0,1,1,0,0,0.0,0,1,0,1,0,2,0,0,0,2019-2020,0.0,1.8181818181818181
1028,Josuha Guilavogui,FRA,"MF,DF",Wolfsburg,Bundesliga,28,1990,22.9,41,26,17,23,1,10,30,33.3,20,35,9,26,45,86,64,2,0,2019-2020,1.9650655021834063,1.7903930131004369
1029,Frederic Guilbert,FRA,"DF,MF",Aston Villa,Premier League,24,1994,22.7,74,43,48,20,6,36,67,53.7,31,33,10,23,49,123,74,2,0,2019-2020,2.158590308370044,3.2599118942731278
1030,Hugo Guillamón,ESP,DF,Valencia,La Liga,19,2000,5.5,8,3,5,2,1,5,10,50.0,5,3,2,1,5,13,29,0,0,2019-2020,0.9090909090909091,1.4545454545454546
1031,Bruno Guimarães,BRA,MF,Lyon,Ligue 1,21,1997,3.0,12,7,5,6,1,5,10,50.0,5,1,0,1,4,16,1,0,0,2019-2020,1.3333333333333333,4.0
1032,Serhou Guirassy,GUI,FW,Amiens,Ligue 1,23,1996,21.3,7,3,1,4,2,2,7,28.6,5,13,6,7,4,11,21,0,0,2019-2020,0.18779342723004694,0.32863849765258213
1033,Rafik Guitane,FRA,MF,Rennes,Ligue 1,20,1999,0.2,0,0,0,0,0,0,0,0.0,0,0,0,0,0,0,0,0,0,2019-2020,0.0,0.0
1034,Péter Gulácsi,HUN,GK,RB Leipzig,Bundesliga,29,1990,32.0,0,0,0,0,0,0,0,0.0,0,0,0,0,1,1,18,6,0,2019-2020,0.03125,0.0
1035,Manuel Gulde,GER,DF,Freiburg,Bundesliga,28,1991,15.2,28,16,17,9,2,15,24,62.5,9,23,13,10,22,50,80,1,0,2019-2020,1.4473684210526316,1.842105263157895
1036,Sinan Gümüş,,"FW,MF",Genoa,Serie A,25,1994,1.1,0,0,0,0,0,0,4,0.0,4,0,0,0,0,0,1,0,0,2019-2020,0.0,0.0
1037,İlkay Gündoğan,GER,MF,Manchester City,Premier League,28,1990,22.4,27,16,9,11,7,9,41,22.0,32,17,5,12,31,58,13,0,0,2019-2020,1.3839285714285716,1.205357142857143
1038,Angus Gunn,SCO,GK,Southampton,Premier League,23,1996,10.0,1,1,1,0,0,1,3,33.3,2,0,0,0,0,1,1,0,0,2019-2020,0.0,0.1
1039,Christian Günter,GER,DF,Freiburg,Bundesliga,26,1993,33.7,25,11,17,7,1,12,35,34.3,23,29,13,16,14,39,40,0,0,2019-2020,0.4154302670623145,0.7418397626112759
1040,Koray Günter,GER,DF,Hellas Verona,Serie A,24,1994,30.4,39,25,22,15,2,19,29,65.5,10,45,39,6,55,94,131,1,0,2019-2020,1.8092105263157896,1.2828947368421053
1041,Régis Gurtner,FRA,GK,Amiens,Ligue 1,32,1986,28.0,1,1,1,0,0,1,2,50.0,1,0,0,0,0,1,10,4,0,2019-2020,0.0,0.03571428571428571
1042,Luiz Gustavo,BRA,MF,Marseille,Ligue 1,32,1987,2.1,6,3,3,3,0,3,5,60.0,2,5,2,3,5,11,6,0,0,2019-2020,2.380952380952381,2.857142857142857
1043,Jonathan de Guzmán,NED,MF,Eint Frankfurt,Bundesliga,31,1987,1.0,1,1,0,1,0,1,7,14.3,6,2,0,2,1,2,0,0,0,2019-2020,1.0,1.0
1044,Erling Haaland,NOR,FW,Dortmund,Bundesliga,19,2000,11.8,4,2,1,0,3,0,4,0.0,4,7,4,3,4,8,4,0,0,2019-2020,0.3389830508474576,0.3389830508474576
1045,Janik Haberer,GER,"MF,FW",Freiburg,Bundesliga,25,1994,19.1,26,18,8,14,4,12,45,26.7,33,25,4,21,25,51,23,0,0,2019-2020,1.3089005235602094,1.3612565445026177
1046,Alexander Hack,GER,DF,Mainz 05,Bundesliga,25,1993,8.9,26,10,19,6,1,16,27,59.3,11,20,9,11,23,49,60,1,0,2019-2020,2.5842696629213484,2.9213483146067416
1047,Munir El Haddadi,MAR,FW,Sevilla,La Liga,23,1995,13.9,19,17,6,11,2,4,21,19.0,17,8,0,8,7,26,8,0,0,2019-2020,0.5035971223021583,1.3669064748201438
1048,André Hahn,GER,"FW,MF",Augsburg,Bundesliga,28,1990,7.8,15,9,7,5,3,5,21,23.8,16,23,5,18,13,28,14,0,0,2019-2020,1.6666666666666667,1.9230769230769231
1049,Amadou Haidara,MLI,MF,RB Leipzig,Bundesliga,21,1998,8.4,26,16,7,17,2,10,24,41.7,14,14,2,12,8,34,10,1,0,2019-2020,0.9523809523809523,3.095238095238095
1050,Achraf Hakimi,MAR,"DF,MF",Dortmund,Bundesliga,20,1998,30.2,60,41,38,14,8,27,64,42.2,37,26,2,24,30,90,27,2,0,2019-2020,0.9933774834437087,1.9867549668874174
Rk,Player,Nation,Pos,Squad,Comp,0,0,90.0,0,0,3,3,3,Tkl,0,0.0,0,0,0,0,0,0,0,0,0,2019-2020,0.0,0.0
1051,Sébastien Haller,CIV,FW,West Ham,Premier League,25,1994,25.2,22,15,8,10,4,3,30,10.0,27,19,5,14,8,30,27,0,0,2019-2020,0.31746031746031744,0.873015873015873
1052,Marcel Halstenberg,GER,DF,RB Leipzig,Bundesliga,27,1991,28.0,46,31,27,17,2,28,58,48.3,30,37,11,26,46,92,72,2,0,2019-2020,1.6428571428571428,1.6428571428571428
1053,Romain Hamouma,FRA,"FW,MF",Saint-Étienne,Ligue 1,32,1987,9.6,12,9,1,5,6,2,12,16.7,10,12,0,12,0,12,4,0,0,2019-2020,0.0,1.25
1054,Samir Handanović,SVN,GK,Inter,Serie A,35,1984,35.0,1,1,1,0,0,0,1,0.0,1,0,0,0,0,1,8,3,0,2019-2020,0.0,0.02857142857142857
1055,Grant Hanley,SCO,DF,Norwich City,Premier League,27,1991,14.0,24,15,17,7,0,8,14,57.1,6,25,18,7,31,55,77,1,0,2019-2020,2.2142857142857144,1.7142857142857142
1056,Lukáš Haraslín,SVK,FW,Sassuolo,Serie A,23,1996,4.3,5,2,1,3,1,2,9,22.2,7,5,0,5,4,9,1,0,0,2019-2020,0.9302325581395349,1.1627906976744187
1057,Amine Harit,MAR,"MF,FW",Schalke 04,Bundesliga,22,1997,23.4,16,7,8,5,3,6,25,24.0,19,13,0,13,7,23,2,1,0,2019-2020,0.29914529914529914,0.6837606837606838
1058,Martin Harnik,AUT,"MF,FW",Werder Bremen,Bundesliga,32,1987,0.1,0,0,0,0,0,0,0,0.0,0,0,0,0,0,0,0,0,0,2019-2020,0.0,0.0
1059,Makoto Hasebe,JPN,"DF,MF",Eint Frankfurt,Bundesliga,35,1984,21.9,28,20,16,9,3,18,39,46.2,21,38,10,28,26,54,38,0,0,2019-2020,1.1872146118721463,1.2785388127853883
1060,Hans Hateboer,NED,DF,Atalanta,Serie A,25,1994,26.2,36,23,20,9,7,18,38,47.4,20,22,7,15,10,46,32,1,0,2019-2020,0.3816793893129771,1.3740458015267176
1061,Kortney Hause,ENG,DF,Aston Villa,Premier League,24,1995,17.2,21,9,15,5,1,8,15,53.3,7,27,19,8,20,41,98,4,0,2019-2020,1.1627906976744187,1.2209302325581395
1062,Kai Havertz,GER,"MF,FW",Leverkusen,Bundesliga,20,1999,27.3,21,15,5,10,6,6,39,15.4,33,22,0,22,2,23,22,0,0,2019-2020,0.07326007326007326,0.7692307692307692
1063,Isaac Hayden,ENG,MF,Newcastle Utd,Premier League,24,1995,24.7,55,27,33,17,5,20,50,40.0,30,24,7,17,38,93,38,0,0,2019-2020,1.5384615384615385,2.2267206477732793
1064,Eden Hazard,BEL,"FW,MF",Real Madrid,La Liga,28,1991,12.0,7,3,2,3,2,3,15,20.0,12,5,0,5,6,13,0,0,0,2019-2020,0.5,0.5833333333333334
1065,Thorgan Hazard,BEL,"FW,MF",Dortmund,Bundesliga,26,1993,26.4,40,27,17,14,9,12,50,24.0,38,29,0,29,13,53,2,1,0,2019-2020,0.49242424242424243,1.5151515151515151
1066,Tom Heaton,ENG,GK,Aston Villa,Premier League,33,1986,19.9,3,2,3,0,0,3,4,75.0,1,0,0,0,0,3,6,0,0,2019-2020,0.0,0.15075376884422112
1067,Jonas Hector,GER,"MF,DF",Köln,Bundesliga,29,1990,27.0,76,49,37,34,5,24,75,32.0,51,44,10,34,46,122,38,1,0,2019-2020,1.7037037037037037,2.814814814814815
1068,Dominique Heintz,GER,DF,Freiburg,Bundesliga,25,1993,27.0,47,30,40,6,1,17,43,39.5,26,38,25,13,41,88,131,1,0,2019-2020,1.5185185185185186,1.7407407407407407
1069,Dean Henderson,ENG,GK,Sheffield Utd,Premier League,22,1997,36.0,0,0,0,0,0,0,0,0.0,0,0,0,0,1,1,13,1,0,2019-2020,0.027777777777777776,0.0
1070,Jordan Henderson,ENG,MF,Liverpool,Premier League,29,1990,24.9,63,41,18,33,12,22,55,40.0,33,22,4,18,30,93,21,2,0,2019-2020,1.2048192771084338,2.5301204819277108
1071,Liam Henderson,SCO,MF,Hellas Verona,Serie A,23,1996,2.2,3,2,0,3,0,2,3,66.7,1,1,0,1,0,3,4,0,0,2019-2020,0.0,1.3636363636363635
1072,Jeff Hendrick,IRL,MF,Burnley,Premier League,27,1992,21.5,18,10,7,8,3,7,27,25.9,20,21,8,13,20,38,20,0,0,2019-2020,0.9302325581395349,0.8372093023255814
1073,Wayne Hennessey,WAL,GK,Crystal Palace,Premier League,32,1987,3.0,0,0,0,0,0,0,0,0.0,0,0,0,0,1,1,3,1,0,2019-2020,0.3333333333333333,0.0
1074,Rouwen Hennings,GER,FW,Düsseldorf,Bundesliga,31,1987,27.3,11,5,2,7,2,3,18,16.7,15,12,0,12,2,13,33,0,0,2019-2020,0.07326007326007326,0.40293040293040294
1075,Benjamin Henrichs,GER,"DF,MF",Monaco,Ligue 1,22,1997,9.9,26,20,16,9,1,14,33,42.4,19,19,4,15,14,40,18,0,0,2019-2020,1.4141414141414141,2.6262626262626263
Rk,Player,Nation,Pos,Squad,Comp,0,0,90.0,0,0,3,3,3,Tkl,0,0.0,0,0,0,0,0,0,0,0,0,2019-2020,0.0,0.0
1076,Dalbert Henrique,BRA,"DF,MF",Fiorentina,Serie A,25,1993,27.6,52,25,35,12,5,18,51,35.3,33,34,4,30,19,71,65,0,0,2019-2020,0.6884057971014492,1.8840579710144927
1077,Christophe Hérelle,MTQ,DF,Nice,Ligue 1,26,1992,12.3,14,11,10,4,0,3,7,42.9,4,14,8,6,17,31,26,1,0,2019-2020,1.3821138211382114,1.1382113821138211
1078,Mario Hermoso,ESP,DF,Atlético Madrid,La Liga,24,1995,13.5,15,8,12,2,1,11,20,55.0,9,11,5,6,12,27,61,0,0,2019-2020,0.8888888888888888,1.1111111111111112
1079,Aridane Hernández,ESP,DF,Osasuna,La Liga,30,1989,29.0,35,23,22,13,0,15,19,78.9,4,24,15,9,34,69,137,2,0,2019-2020,1.1724137931034482,1.206896551724138
1080,Javier Hernández,MEX,FW,West Ham,Premier League,31,1988,1.2,0,0,0,0,0,0,1,0.0,1,0,0,0,1,1,0,0,0,2019-2020,0.8333333333333334,0.0
1081,Javier Hernández,MEX,FW,Sevilla,La Liga,31,1988,5.0,6,4,0,4,2,1,6,16.7,5,5,0,5,5,11,1,0,0,2019-2020,1.0,1.2
1082,Juan Hernández,ESP,"FW,MF",Celta Vigo,La Liga,24,1994,1.0,0,0,0,0,0,0,0,0.0,0,0,0,0,1,1,0,0,0,2019-2020,1.0,0.0
1083,Lucas Hernández,FRA,DF,Bayern Munich,Bundesliga,23,1996,10.2,18,9,13,3,2,9,15,60.0,6,6,1,5,15,33,17,0,0,2019-2020,1.4705882352941178,1.7647058823529413
1084,Onel Hernández,CUB,"FW,MF",Norwich City,Premier League,26,1993,15.4,27,19,13,11,3,9,31,29.0,22,12,1,11,19,46,10,0,0,2019-2020,1.2337662337662338,1.7532467532467533
1085,Theo Hernández,FRA,DF,Milan,Serie A,21,1997,31.3,56,39,32,18,6,33,53,62.3,20,34,6,28,43,99,62,2,0,2019-2020,1.3738019169329072,1.7891373801916932
1086,Hernani,BRA,MF,Parma,Serie A,25,1994,26.9,61,31,25,31,5,30,112,26.8,82,53,11,42,50,111,51,1,0,2019-2020,1.858736059479554,2.2676579925650557
1087,Ander Herrera,ESP,"MF,DF",Paris S-G,Ligue 1,29,1989,6.1,19,11,9,9,1,5,14,35.7,9,10,2,8,6,25,4,0,0,2019-2020,0.9836065573770493,3.114754098360656
1088,Héctor Herrera,MEX,MF,Atlético Madrid,La Liga,29,1990,12.5,31,21,9,18,4,13,32,40.6,19,16,7,9,17,48,13,2,0,2019-2020,1.36,2.48
1089,Sergio Herrera,ESP,GK,Osasuna,La Liga,26,1993,18.4,1,1,1,0,0,1,4,25.0,3,0,0,0,1,2,13,3,0,2019-2020,0.05434782608695653,0.05434782608695653
1090,Yangel Herrera,VEN,MF,Granada,La Liga,21,1998,26.3,88,49,25,53,10,36,80,45.0,44,38,9,29,34,122,28,0,0,2019-2020,1.2927756653992395,3.3460076045627374
1091,Iago Herrerín,ESP,GK,Athletic Club,La Liga,31,1988,4.7,0,0,0,0,0,0,0,0.0,0,0,0,0,0,0,0,0,0,2019-2020,0.0,0.0
1092,Patrick Herrmann,GER,"FW,MF",Gladbach,Bundesliga,28,1991,16.1,24,11,8,10,6,5,16,31.3,11,21,4,17,11,35,8,0,0,2019-2020,0.6832298136645962,1.4906832298136645
1093,Pablo Hervías,ESP,"MF,FW",Valladolid,La Liga,26,1993,11.3,24,20,8,14,2,12,22,54.5,10,8,0,8,5,29,0,0,0,2019-2020,0.44247787610619466,2.1238938053097343
1094,Son Heung-min,KOR,FW,Tottenham,Premier League,27,1992,27.5,23,15,10,11,2,9,57,15.8,48,23,0,23,19,42,18,1,0,2019-2020,0.6909090909090909,0.8363636363636363
1095,Gonzalo Higuaín,ARG,FW,Juventus,Serie A,31,1987,20.7,13,7,2,6,5,4,31,12.9,27,12,0,12,6,19,14,0,0,2019-2020,0.2898550724637681,0.6280193236714976
1096,Vitorino Hilton,BRA,DF,Montpellier,Ligue 1,41,1977,27.9,27,17,20,7,0,13,28,46.4,15,22,18,4,49,76,121,1,0,2019-2020,1.756272401433692,0.967741935483871
1097,Martin Hinteregger,AUT,DF,Eint Frankfurt,Bundesliga,26,1992,30.2,66,51,33,30,3,28,57,49.1,29,41,21,20,36,102,96,0,0,2019-2020,1.1920529801324504,2.185430463576159
1098,George Hirst,ENG,"MF,DF",Leicester City,Premier League,20,1999,0.1,0,0,0,0,0,0,0,0.0,0,0,0,0,0,0,0,0,0,2019-2020,0.0,0.0
1099,Marwin Hitz,SUI,GK,Dortmund,Bundesliga,31,1987,3.2,0,0,0,0,0,0,0,0.0,0,0,0,0,0,0,0,0,0,2019-2020,0.0,0.0
1100,André Hoffmann,GER,DF,Düsseldorf,Bundesliga,26,1993,27.0,48,22,30,18,0,16,50,32.0,34,22,9,13,56,104,90,0,0,2019-2020,2.074074074074074,1.7777777777777777
Rk,Player,Nation,Pos,Squad,Comp,0,0,90.0,0,0,3,3,3,Tkl,0,0.0,0,0,0,0,0,0,0,0,0,2019-2020,0.0,0.0
1101,Nicolas Höfler,GER,MF,Freiburg,Bundesliga,29,1990,30.9,65,40,31,28,6,22,64,34.4,42,58,18,40,71,136,59,3,0,2019-2020,2.2977346278317152,2.103559870550162
1102,Jonas Hofmann,GER,"MF,FW",Gladbach,Bundesliga,27,1992,18.1,43,27,22,12,9,22,76,28.9,54,28,3,25,18,61,14,0,0,2019-2020,0.9944751381215469,2.3756906077348066
1103,Jonas Hofmann,GER,MF,Schalke 04,Bundesliga,22,1997,0.0,0,0,0,0,0,0,0,0.0,0,0,0,0,0,0,2,0,0,2019-2020,,
1104,Marco Höger,GER,MF,Köln,Bundesliga,29,1989,7.5,10,6,4,5,1,6,16,37.5,10,14,4,10,6,16,15,0,0,2019-2020,0.8,1.3333333333333333
1105,Rob Holding,ENG,DF,Arsenal,Premier League,23,1995,6.5,4,2,3,1,0,1,3,33.3,2,10,6,4,5,9,45,1,0,2019-2020,0.7692307692307693,0.6153846153846154
1106,José Holebas,GRE,DF,Watford,Premier League,35,1984,11.4,26,15,19,7,0,9,28,32.1,19,11,4,7,3,29,33,0,0,2019-2020,0.2631578947368421,2.280701754385965
1107,Lucas Höler,GER,"FW,MF",Freiburg,Bundesliga,25,1994,27.6,35,15,11,16,8,11,46,23.9,35,30,9,21,12,47,38,0,0,2019-2020,0.43478260869565216,1.2681159420289854
1108,Mason Holgate,ENG,DF,Everton,Premier League,22,1996,22.8,44,26,30,13,1,21,31,67.7,10,26,13,13,34,78,97,0,0,2019-2020,1.4912280701754386,1.9298245614035088
1109,Nathan Holland,ENG,MF,West Ham,Premier League,21,1998,0.4,3,1,2,1,0,0,0,0.0,0,1,0,1,0,3,0,0,0,2019-2020,0.0,7.5
1110,Gerrit Holtmann,PHI,"MF,DF",Paderborn 07,Bundesliga,24,1995,11.8,24,14,14,6,4,15,37,40.5,22,21,1,20,6,30,8,0,0,2019-2020,0.5084745762711864,2.0338983050847457
1111,Josué Homawoo,FRA,DF,Nantes,Ligue 1,21,1997,0.5,6,2,3,3,0,2,2,100.0,0,3,2,1,2,8,2,0,0,2019-2020,4.0,12.0
1112,Franck Honorat,FRA,"FW,DF",Saint-Étienne,Ligue 1,22,1996,9.4,16,11,7,8,1,8,23,34.8,15,12,1,11,5,21,13,1,0,2019-2020,0.5319148936170213,1.702127659574468
1113,Luca Horn,GER,DF,Wolfsburg,Bundesliga,20,1998,0.1,0,0,0,0,0,0,0,0.0,0,0,0,0,0,0,0,0,0,2019-2020,0.0,0.0
1114,Timo Horn,GER,GK,Köln,Bundesliga,26,1993,34.0,0,0,0,0,0,0,5,0.0,5,0,0,0,2,2,15,1,0,2019-2020,0.058823529411764705,0.0
1115,Krisztofer Horváth,HUN,"FW,DF",SPAL,Serie A,17,2002,0.5,1,1,0,1,0,0,0,0.0,0,0,0,0,0,1,0,0,0,2019-2020,0.0,2.0
1116,Conor Hourihane,IRL,MF,Aston Villa,Premier League,28,1991,17.0,16,10,4,8,4,10,25,40.0,15,19,4,15,9,25,31,0,0,2019-2020,0.5294117647058824,0.9411764705882353
1117,Lukáš Hrádecký,FIN,GK,Leverkusen,Bundesliga,29,1989,34.0,0,0,0,0,0,0,1,0.0,1,0,0,0,2,2,19,2,0,2019-2020,0.058823529411764705,0.0
1118,Benjamin Hübner,GER,DF,Hoffenheim,Bundesliga,30,1989,23.0,42,26,33,9,0,23,45,51.1,22,18,13,5,30,72,98,2,0,2019-2020,1.3043478260869565,1.826086956521739
1119,Florian Hübner,GER,DF,Union Berlin,Bundesliga,28,1991,9.4,16,14,12,4,0,7,17,41.2,10,11,7,4,16,32,39,0,0,2019-2020,1.702127659574468,1.702127659574468
1120,Callum Hudson-Odoi,ENG,"FW,MF",Chelsea,Premier League,18,2000,9.6,10,4,4,5,1,1,7,14.3,6,9,0,9,5,15,4,1,0,2019-2020,0.5208333333333334,1.0416666666666667
1121,Will Hughes,ENG,MF,Watford,Premier League,24,1995,25.0,75,47,24,41,10,25,67,37.3,42,48,8,40,37,112,28,0,0,2019-2020,1.48,3.0
1122,Mats Hummels,GER,DF,Dortmund,Bundesliga,30,1988,28.7,57,30,30,26,1,20,38,52.6,18,41,18,23,59,116,110,1,0,2019-2020,2.0557491289198606,1.986062717770035
1123,Uwe Hünemeier,GER,DF,Paderborn 07,Bundesliga,33,1986,13.4,20,15,9,11,0,10,20,50.0,10,22,12,10,24,44,63,0,0,2019-2020,1.791044776119403,1.4925373134328357
1124,Adrien Hunou,FRA,"FW,MF",Rennes,Ligue 1,25,1994,13.4,21,18,5,11,5,4,21,19.0,17,16,1,15,5,26,5,0,0,2019-2020,0.3731343283582089,1.5671641791044775
1125,Jannik Huth,GER,GK,Paderborn 07,Bundesliga,25,1994,6.0,0,0,0,0,0,0,1,0.0,1,0,0,0,0,0,2,0,0,2019-2020,0.0,0.0
Rk,Player,Nation,Pos,Squad,Comp,0,0,90.0,0,0,3,3,3,Tkl,0,0.0,0,0,0,0,0,0,0,0,0,2019-2020,0.0,0.0
1126,Elseid Hysaj,ALB,DF,Napoli,Serie A,25,1994,16.5,18,9,13,4,1,12,26,46.2,14,16,3,13,24,42,26,0,0,2019-2020,1.4545454545454546,1.0909090909090908
1127,Suk Hyun-jun,KOR,"FW,MF",Reims,Ligue 1,28,1991,2.9,3,3,1,1,1,1,2,50.0,1,1,0,1,1,4,2,0,0,2019-2020,0.3448275862068966,1.0344827586206897
1128,Pierre Højbjerg,DEN,MF,Southampton,Premier League,23,1995,30.6,80,49,34,38,8,39,91,42.9,52,44,5,39,46,126,54,2,0,2019-2020,1.5032679738562091,2.6143790849673203
1129,Simone Iacoponi,ITA,DF,Parma,Serie A,32,1987,33.9,49,25,36,12,1,26,42,61.9,16,37,29,8,35,84,140,2,0,2019-2020,1.032448377581121,1.4454277286135693
1130,Iago,BRA,"DF,MF",Augsburg,Bundesliga,22,1997,7.5,19,12,12,7,0,9,18,50.0,9,6,2,4,14,33,27,0,0,2019-2020,1.8666666666666667,2.533333333333333
1131,Robert Ibáñez,ESP,"MF,FW",Osasuna,La Liga,26,1993,6.0,13,8,4,5,4,7,20,35.0,13,7,0,7,5,18,5,0,0,2019-2020,0.8333333333333334,2.1666666666666665
1132,Roger Ibanez,BRA,DF,Roma,Serie A,20,1998,6.8,11,8,6,3,2,5,7,71.4,2,9,6,3,18,29,21,1,0,2019-2020,2.6470588235294117,1.6176470588235294
1133,Jordon Ibe,ENG,DF,Bournemouth,Premier League,23,1995,0.6,2,2,2,0,0,1,1,100.0,0,0,0,0,0,2,1,0,0,2019-2020,0.0,3.3333333333333335
1134,Vedad Ibišević,BIH,FW,Hertha BSC,Bundesliga,34,1984,14.0,4,3,0,1,3,0,3,0.0,3,4,0,4,1,5,15,0,0,2019-2020,0.07142857142857142,0.2857142857142857
1135,Vicente Iborra,ESP,MF,Villarreal,La Liga,31,1988,29.4,61,42,31,25,5,30,67,44.8,37,35,16,19,40,101,63,1,0,2019-2020,1.3605442176870748,2.0748299319727894
1136,Didier Ibrahim Ndong,GAB,MF,Dijon,Ligue 1,25,1994,26.5,62,35,30,31,1,30,59,50.8,29,27,6,21,49,111,31,0,0,2019-2020,1.849056603773585,2.339622641509434
1137,Zlatan Ibrahimović,SWE,FW,Milan,Serie A,37,1981,15.1,5,1,0,2,3,1,13,7.7,12,4,3,1,5,10,21,0,0,2019-2020,0.33112582781456956,0.33112582781456956
1138,Mauro Icardi,ARG,FW,Paris S-G,Ligue 1,26,1993,14.1,4,2,1,3,0,1,10,10.0,9,7,1,6,2,6,11,0,0,2019-2020,0.14184397163120568,0.28368794326241137
1139,Adam Idah,IRL,"FW,MF",Norwich City,Premier League,18,2001,2.5,2,2,1,0,1,2,3,66.7,1,4,0,4,0,2,1,0,0,2019-2020,0.0,0.8
1140,Odion Ighalo,NGA,FW,Manchester Utd,Premier League,30,1989,1.1,2,2,0,2,0,1,3,33.3,2,1,1,0,0,2,0,0,0,2019-2020,0.0,1.8181818181818181
1141,Borja Iglesias,ESP,FW,Betis,La Liga,26,1993,21.4,7,5,1,4,2,0,9,0.0,9,7,4,3,5,12,18,0,0,2019-2020,0.23364485981308414,0.3271028037383178
1142,Igor,BRA,DF,SPAL,Serie A,21,1998,14.9,24,16,13,10,1,14,20,70.0,6,17,9,8,24,48,37,1,0,2019-2020,1.610738255033557,1.610738255033557
1143,Igor,BRA,DF,Fiorentina,Serie A,21,1998,6.8,12,10,8,2,2,6,7,85.7,1,10,4,6,7,19,16,0,0,2019-2020,1.0294117647058825,1.7647058823529411
1144,Kelechi Iheanacho,NGA,FW,Leicester City,Premier League,22,1996,10.7,3,1,1,2,0,1,9,11.1,8,8,1,7,3,6,8,0,0,2019-2020,0.28037383177570097,0.28037383177570097
1145,Luc Ihorst,GER,FW,Werder Bremen,Bundesliga,19,2000,0.1,1,1,0,0,1,0,0,0.0,0,1,0,1,0,1,0,0,0,2019-2020,0.0,10.0
1146,Jonathan Ikone,FRA,"MF,FW",Lille,Ligue 1,21,1998,22.9,15,7,3,7,5,6,24,25.0,18,26,2,24,5,20,3,0,0,2019-2020,0.2183406113537118,0.6550218340611355
1147,Yun Il-lok,KOR,"MF,FW",Montpellier,Ligue 1,27,1992,1.3,1,1,0,1,0,0,4,0.0,4,0,0,0,0,1,0,0,0,2019-2020,0.0,0.7692307692307692
1148,Josip Iličić,SVN,"FW,MF",Atalanta,Serie A,31,1988,18.5,26,19,7,10,9,7,28,25.0,21,9,0,9,9,35,4,0,0,2019-2020,0.4864864864864865,1.4054054054054055
1149,Asier Illarramendi,ESP,MF,Real Sociedad,La Liga,29,1990,2.4,2,2,1,0,1,2,6,33.3,4,2,1,1,5,7,6,0,0,2019-2020,2.0833333333333335,0.8333333333333334
1150,Stefan Ilsanker,AUT,DF,RB Leipzig,Bundesliga,30,1989,4.6,3,1,3,0,0,3,6,50.0,3,6,3,3,7,10,21,0,0,2019-2020,1.5217391304347827,0.6521739130434783
Rk,Player,Nation,Pos,Squad,Comp,0,0,90.0,0,0,3,3,3,Tkl,0,0.0,0,0,0,0,0,0,0,0,0,2019-2020,0.0,0.0
1151,Stefan Ilsanker,AUT,"DF,MF",Eint Frankfurt,Bundesliga,30,1989,9.3,23,15,16,7,0,10,23,43.5,13,8,1,7,19,42,26,0,0,2019-2020,2.043010752688172,2.4731182795698925
1152,Giannelli Imbula,COD,MF,Lecce,Serie A,26,1992,1.4,2,0,2,0,0,0,1,0.0,1,4,1,3,2,4,0,0,0,2019-2020,1.4285714285714286,1.4285714285714286
1153,Ciro Immobile,ITA,FW,Lazio,Serie A,29,1990,35.2,8,6,2,4,2,0,24,0.0,24,10,2,8,11,19,7,0,0,2019-2020,0.3125,0.22727272727272727
1154,Roberto Inglese,ITA,FW,Parma,Serie A,27,1991,8.5,9,6,2,2,5,2,10,20.0,8,8,2,6,2,11,1,0,0,2019-2020,0.23529411764705882,1.0588235294117647
1155,Danny Ings,ENG,FW,Southampton,Premier League,27,1992,31.2,42,25,16,16,10,13,67,19.4,54,62,4,58,9,51,30,1,0,2019-2020,0.2884615384615385,1.3461538461538463
1156,Marcus Ingvartsen,DEN,"MF,FW",Union Berlin,Bundesliga,23,1996,19.1,20,14,5,7,8,9,28,32.1,19,16,1,15,16,36,16,0,0,2019-2020,0.8376963350785339,1.0471204188481675
1157,Lorenzo Insigne,ITA,"FW,MF",Napoli,Serie A,28,1991,31.2,21,15,6,8,7,6,35,17.1,29,13,0,13,30,51,4,1,0,2019-2020,0.9615384615384616,0.6730769230769231
1158,Takashi Inui,JPN,"MF,FW",Eibar,La Liga,31,1988,21.8,20,10,7,8,5,11,34,32.4,23,23,4,19,18,38,12,0,0,2019-2020,0.8256880733944953,0.9174311926605504
1159,Artur Ioniță,MDA,MF,Cagliari,Serie A,28,1990,21.1,38,23,12,22,4,12,37,32.4,25,32,10,22,18,56,24,2,0,2019-2020,0.8530805687203791,1.8009478672985781
1160,Alexander Isak,SWE,FW,Real Sociedad,La Liga,19,1999,16.7,7,2,0,3,4,1,8,12.5,7,8,0,8,3,10,6,0,0,2019-2020,0.17964071856287425,0.4191616766467066
1161,Isco,ESP,"FW,MF",Real Madrid,La Liga,27,1992,13.1,13,9,2,10,1,5,14,35.7,9,9,0,9,7,20,4,1,0,2019-2020,0.5343511450381679,0.9923664122137404
1162,Nicolas Isimat-Mirin,FRA,DF,Toulouse,Ligue 1,27,1991,14.0,14,8,8,6,0,5,11,45.5,6,18,12,6,22,36,71,0,0,2019-2020,1.5714285714285714,1.0
1163,Jakub Iskra,POL,DF,SPAL,Serie A,16,2002,0.9,0,0,0,0,0,0,0,0.0,0,0,0,0,1,1,2,0,0,2019-2020,1.1111111111111112,0.0
1164,Ismael,ESP,MF,Betis,La Liga,18,2000,0.9,2,1,1,1,0,1,2,50.0,1,2,1,1,2,4,2,0,0,2019-2020,2.2222222222222223,2.2222222222222223
1165,Gian-Luca Itter,GER,"DF,MF",Freiburg,Bundesliga,20,1999,0.4,1,1,1,0,0,1,1,100.0,0,0,0,0,1,2,4,0,0,2019-2020,2.5,2.5
1166,Ander Iturraspe,ESP,MF,Espanyol,La Liga,30,1989,2.7,2,0,1,1,0,2,5,40.0,3,0,0,0,1,3,7,0,0,2019-2020,0.37037037037037035,0.7407407407407407
1167,Alex Iwobi,NGA,"MF,FW",Everton,Premier League,23,1996,17.7,25,17,8,15,2,12,33,36.4,21,18,2,16,14,39,10,1,0,2019-2020,0.7909604519774012,1.4124293785310735
1168,Armando Izzo,ITA,DF,Torino,Serie A,27,1992,29.8,42,24,24,14,4,17,35,48.6,18,44,29,15,71,113,121,1,0,2019-2020,2.38255033557047,1.4093959731543624
1169,Jacobo,ESP,"DF,MF",Celta Vigo,La Liga,22,1997,0.9,3,3,2,1,0,1,1,100.0,0,0,0,0,0,3,2,0,0,2019-2020,0.0,3.333333333333333
1170,Phil Jagielka,ENG,DF,Sheffield Utd,Premier League,36,1982,2.7,5,4,3,2,0,1,3,33.3,2,5,5,0,4,9,19,0,0,2019-2020,1.4814814814814814,1.8518518518518516
1171,Filip Jagiełło,POL,MF,Genoa,Serie A,21,1997,6.1,7,2,0,3,4,3,7,42.9,4,4,0,4,5,12,4,0,0,2019-2020,0.819672131147541,1.1475409836065575
1172,Alireza Jahanbakhsh,IRN,"FW,MF",Brighton,Premier League,25,1993,3.5,8,4,3,2,3,0,2,0.0,2,5,0,5,3,11,2,0,0,2019-2020,0.8571428571428571,2.2857142857142856
1173,Mato Jajalo,BIH,MF,Udinese,Serie A,31,1988,18.3,44,19,19,22,3,14,38,36.8,24,20,7,13,19,63,19,2,0,2019-2020,1.0382513661202186,2.4043715846994536
1174,Ismail Jakobs,SEN,"FW,DF",Köln,Bundesliga,19,1999,18.6,34,23,18,9,7,10,23,43.5,13,25,3,22,24,58,30,0,0,2019-2020,1.2903225806451613,1.8279569892473118
1175,Christophe Jallet,FRA,DF,Amiens,Ligue 1,35,1983,9.5,24,16,14,8,2,14,37,37.8,23,8,2,6,18,42,29,0,0,2019-2020,1.894736842105263,2.526315789473684
Rk,Player,Nation,Pos,Squad,Comp,0,0,90.0,0,0,3,3,3,Tkl,0,0.0,0,0,0,0,0,0,0,0,0,2019-2020,0.0,0.0
1176,Daniel James,WAL,FW,Manchester Utd,Premier League,21,1997,25.4,20,10,5,10,5,7,45,15.6,38,23,4,19,7,27,12,0,0,2019-2020,0.2755905511811024,0.7874015748031497
1177,Matty James,ENG,MF,Leicester City,Premier League,28,1991,0.1,0,0,0,0,0,0,0,0.0,0,0,0,0,0,0,0,0,0,2019-2020,0.0,0.0
1178,Reece James,ENG,DF,Chelsea,Premier League,19,1999,16.8,36,23,18,14,4,11,29,37.9,18,19,8,11,22,58,28,0,0,2019-2020,1.3095238095238095,2.142857142857143
1179,Marko Janković,MNE,"FW,DF",SPAL,Serie A,24,1995,1.3,2,1,0,0,2,1,2,50.0,1,2,1,1,0,2,0,0,0,2019-2020,0.0,1.5384615384615383
1180,Jakub Jankto,CZE,"MF,FW",Sampdoria,Serie A,23,1996,23.3,27,13,14,10,3,10,42,23.8,32,30,3,27,22,49,22,0,0,2019-2020,0.944206008583691,1.1587982832618025
1181,Daryl Janmaat,NED,DF,Watford,Premier League,30,1989,6.7,14,10,8,6,0,6,13,46.2,7,7,2,5,7,21,23,0,0,2019-2020,1.044776119402985,2.08955223880597
1182,Laurent Jans,LUX,DF,Paderborn 07,Bundesliga,26,1992,17.5,42,25,30,8,4,22,48,45.8,26,25,10,15,19,61,49,1,0,2019-2020,1.0857142857142856,2.4
1183,Tony Jantschke,GER,DF,Gladbach,Bundesliga,29,1990,11.2,33,21,23,10,0,15,24,62.5,9,20,11,9,27,60,48,0,0,2019-2020,2.410714285714286,2.9464285714285716
1184,Adnan Januzaj,BEL,"FW,MF",Real Sociedad,La Liga,24,1995,13.0,8,7,3,2,3,3,16,18.8,13,9,1,8,7,15,2,0,0,2019-2020,0.5384615384615384,0.6153846153846154
1185,Rune Jarstein,NOR,GK,Hertha BSC,Bundesliga,34,1984,28.3,4,1,4,0,0,2,3,66.7,1,0,0,0,1,5,11,3,0,2019-2020,0.0353356890459364,0.1413427561837456
1186,Jason,ESP,MF,Getafe,La Liga,25,1994,13.1,29,20,8,16,5,15,33,45.5,18,18,3,15,18,47,9,0,0,2019-2020,1.3740458015267176,2.213740458015267
1187,Dennis Jastrzembski,POL,"MF,FW",Paderborn 07,Bundesliga,19,2000,2.0,2,0,1,1,0,0,1,0.0,1,3,0,3,3,5,0,0,0,2019-2020,1.5,1.0
1188,Corentin Jean,FRA,DF,Toulouse,Ligue 1,24,1995,0.1,0,0,0,0,0,0,0,0.0,0,0,0,0,0,0,1,0,0,2019-2020,0.0,0.0
1189,Benjamin Jeannot,FRA,"MF,FW",Dijon,Ligue 1,27,1992,1.9,2,1,0,1,1,0,4,0.0,4,2,0,2,2,4,4,0,0,2019-2020,1.0526315789473684,1.0526315789473684
1190,Tin Jedvaj,CRO,DF,Augsburg,Bundesliga,23,1995,29.3,44,26,25,19,0,23,47,48.9,24,36,18,18,60,104,123,1,0,2019-2020,2.04778156996587,1.5017064846416381
1191,Jemerson,BRA,"DF,MF",Monaco,Ligue 1,26,1992,11.7,28,17,13,14,1,10,21,47.6,11,8,3,5,16,44,24,0,0,2019-2020,1.3675213675213675,2.393162393162393
1192,Fredrik Jensen,FIN,"MF,FW",Augsburg,Bundesliga,21,1997,5.1,3,1,2,1,0,2,7,28.6,5,7,1,6,1,4,3,0,0,2019-2020,0.19607843137254904,0.5882352941176471
1193,Jesé,ESP,FW,Paris S-G,Ligue 1,26,1993,0.0,0,0,0,0,0,0,0,0.0,0,0,0,0,0,0,0,0,0,2019-2020,,
1194,Gabriel Jesus,BRA,FW,Manchester City,Premier League,22,1997,22.6,17,10,4,5,8,7,25,28.0,18,26,1,25,11,28,6,0,0,2019-2020,0.48672566371681414,0.7522123893805309
1195,Juan Jesus,BRA,DF,Roma,Serie A,28,1991,1.5,2,1,2,0,0,0,3,0.0,3,1,0,1,1,3,7,0,0,2019-2020,0.6666666666666666,1.3333333333333333
1196,Raúl Jiménez,MEX,FW,Wolves,Premier League,28,1991,36.0,20,12,6,10,4,3,31,9.7,28,26,0,26,16,36,34,1,0,2019-2020,0.4444444444444444,0.5555555555555556
1197,João Pedro,BRA,"FW,MF",Watford,Premier League,17,2001,0.3,0,0,0,0,0,0,0,0.0,0,0,0,0,0,0,0,0,0,2019-2020,0.0,0.0
1198,Joaquín,ESP,"MF,FW",Betis,La Liga,38,1981,22.9,14,7,4,8,2,4,11,36.4,7,10,2,8,15,29,22,1,0,2019-2020,0.6550218340611355,0.6113537117903931
1199,Joelinton,BRA,FW,Newcastle Utd,Premier League,22,1996,29.8,34,20,7,22,5,9,32,28.1,23,32,6,26,11,45,30,0,0,2019-2020,0.36912751677852346,1.1409395973154361
1200,Ben Johnson,ENG,DF,West Ham,Premier League,19,2000,3.0,8,4,7,1,0,7,10,70.0,3,5,2,3,3,11,11,0,0,2019-2020,1.0,2.6666666666666665
Rk,Player,Nation,Pos,Squad,Comp,0,0,90.0,0,0,3,3,3,Tkl,0,0.0,0,0,0,0,0,0,0,0,0,2019-2020,0.0,0.0
1201,Fabian Johnson,USA,"MF,DF",Gladbach,Bundesliga,31,1987,3.0,5,3,2,2,1,2,4,50.0,2,4,1,3,2,7,3,0,0,2019-2020,0.6666666666666666,1.6666666666666667
1202,Curtis Jones,ENG,MF,Liverpool,Premier League,18,2001,1.4,4,4,0,1,3,3,4,75.0,1,2,0,2,2,6,1,0,0,2019-2020,1.4285714285714286,2.857142857142857
1203,Phil Jones,ENG,DF,Manchester Utd,Premier League,27,1992,1.5,2,2,1,1,0,1,1,100.0,0,2,0,2,2,4,9,1,0,2019-2020,1.3333333333333333,1.3333333333333333
1204,Frenkie de Jong,NED,MF,Barcelona,La Liga,22,1997,23.5,26,19,7,12,7,7,22,31.8,15,17,7,10,21,47,9,0,0,2019-2020,0.8936170212765957,1.1063829787234043
1205,Luuk de Jong,NED,FW,Sevilla,La Liga,28,1990,22.9,21,10,4,8,9,6,17,35.3,11,12,1,11,7,28,22,0,0,2019-2020,0.30567685589519655,0.9170305676855895
1206,Jony,ESP,"DF,FW",Lazio,Serie A,28,1991,13.1,13,9,7,4,2,5,23,21.7,18,11,2,9,14,27,17,0,0,2019-2020,1.0687022900763359,0.9923664122137404
1207,Joan Jordán,ESP,MF,Sevilla,La Liga,25,1994,25.0,64,34,27,31,6,21,76,27.6,55,25,5,20,26,90,20,4,0,2019-2020,1.04,2.56
1208,Bruno Jordão,POR,FW,Wolves,Premier League,20,1998,0.1,0,0,0,0,0,0,0,0.0,0,1,0,1,0,0,0,0,0,2019-2020,0.0,0.0
1209,Jorginho,ITA,MF,Chelsea,Premier League,27,1991,26.4,66,40,24,34,8,35,91,38.5,56,30,5,25,64,130,27,2,0,2019-2020,2.4242424242424243,2.5
1210,Jesse Joronen,FIN,GK,Brescia,Serie A,26,1993,29.0,3,1,3,0,0,3,3,100.0,0,0,0,0,6,9,22,0,0,2019-2020,0.20689655172413793,0.10344827586206896
1211,Willian José,BRA,FW,Real Sociedad,La Liga,27,1991,22.3,5,2,0,4,1,2,8,25.0,6,10,4,6,1,6,16,0,0,2019-2020,0.04484304932735426,0.22421524663677128
1212,Joselu,ESP,FW,Alavés,La Liga,29,1990,30.9,26,17,4,12,10,4,32,12.5,28,36,5,31,13,39,46,0,0,2019-2020,0.42071197411003236,0.8414239482200647
1213,Jota,ESP,"FW,MF",Aston Villa,Premier League,28,1991,3.7,3,1,2,0,1,2,5,40.0,3,1,0,1,3,6,6,0,0,2019-2020,0.8108108108108107,0.8108108108108107
1214,Diogo Jota,POR,FW,Wolves,Premier League,22,1996,25.4,28,15,16,10,2,12,48,25.0,36,17,0,17,9,37,10,2,0,2019-2020,0.35433070866141736,1.1023622047244095
1215,Vukašin Jovanović,SRB,DF,Bordeaux,Ligue 1,23,1996,6.4,18,11,12,6,0,14,21,66.7,7,5,3,2,15,33,15,0,0,2019-2020,2.34375,2.8125
1216,Dejan Joveljić,SRB,FW,Eint Frankfurt,Bundesliga,19,1999,1.7,2,2,1,1,0,0,1,0.0,1,0,0,0,0,2,1,0,0,2019-2020,0.0,1.1764705882352942
1217,Stevan Jovetić,MNE,"FW,MF",Monaco,Ligue 1,29,1989,5.3,2,1,0,1,1,1,5,20.0,4,1,0,1,1,3,5,0,0,2019-2020,0.18867924528301888,0.37735849056603776
1218,Luka Jović,SRB,FW,Real Madrid,La Liga,21,1997,4.8,2,1,0,0,2,1,2,50.0,1,1,0,1,2,4,0,0,0,2019-2020,0.4166666666666667,0.4166666666666667
1219,Juanmi,ESP,"FW,MF",Betis,La Liga,26,1993,2.9,4,1,1,2,1,1,4,25.0,3,1,0,1,0,4,0,0,0,2019-2020,0.0,1.3793103448275863
1220,David Juncà,ESP,DF,Celta Vigo,La Liga,25,1993,2.9,6,5,4,1,1,2,3,66.7,1,4,1,3,2,8,3,0,0,2019-2020,0.6896551724137931,2.0689655172413794
1221,Lago Junior,CIV,"MF,FW",Mallorca,La Liga,28,1990,24.3,32,19,12,11,9,12,29,41.4,17,23,5,18,14,46,25,0,0,2019-2020,0.5761316872427983,1.316872427983539
1222,Hamed Junior Traorè,CIV,"MF,FW",Sassuolo,Serie A,19,2000,17.4,31,15,10,15,6,14,39,35.9,25,22,1,21,11,42,7,0,0,2019-2020,0.632183908045977,1.781609195402299
1223,Vinicius Júnior,BRA,"FW,MF",Real Madrid,La Liga,19,2000,15.2,26,16,13,8,5,8,32,25.0,24,14,0,14,3,29,2,0,0,2019-2020,0.19736842105263158,1.7105263157894737
1224,James Justin,ENG,"DF,MF",Leicester City,Premier League,21,1998,11.2,36,17,22,14,0,15,25,60.0,10,15,7,8,11,47,30,0,0,2019-2020,0.9821428571428572,3.2142857142857144
1225,Musa Juwara,GAM,"FW,MF",Bologna,Serie A,17,2001,1.7,4,2,1,1,2,1,5,20.0,4,2,1,1,0,4,1,0,0,2019-2020,0.0,2.3529411764705883
Rk,Player,Nation,Pos,Squad,Comp,0,0,90.0,0,0,3,3,3,Tkl,0,0.0,0,0,0,0,0,0,0,0,0,2019-2020,0.0,0.0
1226,Mathias Jørgensen,DEN,DF,Düsseldorf,Bundesliga,29,1990,5.5,4,3,3,1,0,2,4,50.0,2,7,3,4,13,17,33,0,0,2019-2020,2.3636363636363638,0.7272727272727273
1227,Ozan Kabak,TUR,DF,Schalke 04,Bundesliga,19,2000,19.7,37,23,28,9,0,14,21,66.7,7,33,19,14,37,74,97,0,0,2019-2020,1.8781725888324874,1.8781725888324874
1228,Christian Kabasele,BEL,DF,Watford,Premier League,28,1991,25.0,37,24,26,11,0,17,32,53.1,15,31,23,8,36,73,127,0,0,2019-2020,1.44,1.48
1229,Abdoul Kader Bamba,FRA,"FW,MF",Nantes,Ligue 1,25,1994,16.3,19,15,5,9,5,9,30,30.0,21,8,2,6,16,35,8,0,0,2019-2020,0.9815950920245399,1.165644171779141
1230,Pavel Kadeřábek,CZE,"DF,FW",Hoffenheim,Bundesliga,27,1992,27.5,32,22,17,13,2,13,30,43.3,17,29,7,22,27,59,55,1,0,2019-2020,0.9818181818181818,1.1636363636363636
1231,Florian Kainz,AUT,"FW,MF",Köln,Bundesliga,26,1992,17.3,21,13,12,6,3,15,33,45.5,18,26,2,24,13,34,11,0,0,2019-2020,0.7514450867052023,1.2138728323699421
1232,Gaël Kakuta,COD,"MF,FW",Amiens,Ligue 1,28,1991,22.2,46,27,13,27,6,17,48,35.4,31,15,1,14,16,62,8,2,0,2019-2020,0.7207207207207208,2.0720720720720722
1233,Lovre Kalinić,CRO,GK,Toulouse,Ligue 1,29,1990,3.4,0,0,0,0,0,0,1,0.0,1,0,0,0,0,0,0,0,0,2019-2020,0.0,0.0
1234,Nikola Kalinić,CRO,FW,Roma,Serie A,31,1988,6.3,2,1,0,2,0,0,0,0.0,0,2,0,2,1,3,1,0,0,2019-2020,0.15873015873015872,0.31746031746031744
1235,Salomon Kalou,CIV,"FW,MF",Hertha BSC,Bundesliga,33,1985,1.6,1,0,1,0,0,0,2,0.0,2,2,0,2,0,1,1,0,0,2019-2020,0.0,0.625
1236,Samuel Kalu,NGA,"DF,FW",Bordeaux,Ligue 1,21,1997,15.1,33,17,19,12,2,16,36,44.4,20,13,1,12,24,57,10,0,0,2019-2020,1.589403973509934,2.185430463576159
1237,Daichi Kamada,JPN,"MF,FW",Eint Frankfurt,Bundesliga,22,1996,21.9,29,20,7,17,5,8,42,19.0,34,16,1,15,10,39,6,0,0,2019-2020,0.4566210045662101,1.3242009132420092
1238,François Kamano,GUI,"DF,MF",Bordeaux,Ligue 1,23,1996,7.2,12,6,5,4,3,8,15,53.3,7,5,0,5,3,15,2,0,0,2019-2020,0.41666666666666663,1.6666666666666665
1239,Boubacar Kamara,FRA,"DF,MF",Marseille,Ligue 1,19,1999,23.8,67,34,37,27,3,27,57,47.4,30,27,14,13,34,101,53,1,0,2019-2020,1.4285714285714286,2.815126050420168
1240,Hassane Kamara,CIV,"DF,FW",Reims,Ligue 1,25,1994,19.0,58,47,40,14,4,24,35,68.6,11,17,2,15,58,116,58,0,0,2019-2020,3.0526315789473686,3.0526315789473686
1241,Kevin Kampl,SVN,MF,RB Leipzig,Bundesliga,28,1990,7.5,17,11,7,10,0,7,23,30.4,16,7,2,5,16,33,6,0,0,2019-2020,2.1333333333333333,2.2666666666666666
1242,Harry Kane,ENG,FW,Tottenham,Premier League,26,1993,28.7,18,12,3,12,3,4,17,23.5,13,17,7,10,6,24,30,0,0,2019-2020,0.20905923344947736,0.6271777003484321
1243,Lee Kang-in,KOR,"MF,FW",Valencia,La Liga,18,2001,5.0,3,1,0,2,1,3,6,50.0,3,5,0,5,3,6,0,0,0,2019-2020,0.6,0.6
1244,Wilfried Kanga,CIV,FW,Angers,Ligue 1,21,1998,0.8,0,0,0,0,0,0,1,0.0,1,0,0,0,0,0,0,0,0,2019-2020,0.0,0.0
1245,N'Golo Kanté,FRA,MF,Chelsea,Premier League,28,1991,19.2,44,20,22,14,8,17,36,47.2,19,29,5,24,44,88,32,2,0,2019-2020,2.291666666666667,2.291666666666667
1246,Stefanos Kapino,GRE,GK,Werder Bremen,Bundesliga,25,1994,1.0,0,0,0,0,0,0,0,0.0,0,0,0,0,1,1,0,0,0,2019-2020,1.0,0.0
1247,Wilfrid Kaptoum,CMR,MF,Betis,La Liga,23,1996,2.2,5,2,3,2,0,3,3,100.0,0,4,1,3,1,6,3,0,0,2019-2020,0.45454545454545453,2.2727272727272725
1248,Kenan Karaman,TUR,"FW,MF",Düsseldorf,Bundesliga,25,1994,15.0,11,5,2,5,4,4,9,44.4,5,9,4,5,2,13,7,0,0,2019-2020,0.13333333333333333,0.7333333333333333
1249,Yann Karamoh,FRA,"FW,MF",Parma,Serie A,21,1998,6.4,10,7,5,4,1,3,9,33.3,6,5,0,5,2,12,3,0,0,2019-2020,0.3125,1.5625
1250,Mamoudou Karamoko,FRA,MF,Wolfsburg,Bundesliga,19,1999,0.1,0,0,0,0,0,0,0,0.0,0,0,0,0,0,0,0,0,0,2019-2020,0.0,0.0
Rk,Player,Nation,Pos,Squad,Comp,0,0,90.0,0,0,3,3,3,Tkl,0,0.0,0,0,0,0,0,0,0,0,0,2019-2020,0.0,0.0
1251,Florian Kastenmeier,GER,GK,Düsseldorf,Bundesliga,22,1997,17.0,1,1,1,0,0,0,0,0.0,0,0,0,0,2,3,3,1,0,2019-2020,0.11764705882352941,0.058823529411764705
1252,Noah Katterbach,GER,DF,Köln,Bundesliga,18,2001,14.6,29,23,21,8,0,11,28,39.3,17,12,1,11,29,58,26,0,0,2019-2020,1.9863013698630136,1.9863013698630136
1253,Moise Kean,ITA,FW,Everton,Premier League,19,2000,9.5,6,6,5,1,0,0,0,0.0,0,4,0,4,5,11,1,1,0,2019-2020,0.5263157894736842,0.631578947368421
1254,Michael Keane,ENG,DF,Everton,Premier League,26,1993,28.4,31,16,18,12,1,14,24,58.3,10,35,28,7,44,75,152,0,0,2019-2020,1.5492957746478875,1.091549295774648
1255,Thilo Kehrer,GER,DF,Paris S-G,Ligue 1,22,1996,5.3,10,7,4,5,1,5,10,50.0,5,2,0,2,1,11,2,1,0,2019-2020,0.18867924528301888,1.8867924528301887
1256,Jules Keita,GUI,"MF,FW",Dijon,Ligue 1,21,1998,1.8,4,3,2,1,1,1,6,16.7,5,1,0,1,3,7,0,0,0,2019-2020,1.6666666666666665,2.2222222222222223
1257,Naby Keïta,GUI,MF,Liverpool,Premier League,24,1995,9.1,30,14,8,16,6,11,26,42.3,15,18,0,18,10,40,4,0,0,2019-2020,1.098901098901099,3.296703296703297
1258,Yannik Keitel,GER,MF,Freiburg,Bundesliga,19,2000,1.9,2,1,1,1,0,0,6,0.0,6,3,1,2,4,6,4,0,0,2019-2020,2.1052631578947367,1.0526315789473684
1259,Lloyd Kelly,ENG,DF,Bournemouth,Premier League,20,1998,7.1,7,3,3,4,0,6,7,85.7,1,9,5,4,6,13,15,1,0,2019-2020,0.8450704225352114,0.9859154929577465
1260,Martin Kelly,ENG,DF,Crystal Palace,Premier League,29,1990,17.2,23,18,19,4,0,14,31,45.2,17,18,10,8,16,39,86,1,0,2019-2020,0.9302325581395349,1.3372093023255816
1261,Kenedy,BRA,MF,Getafe,La Liga,23,1996,6.5,9,5,3,3,3,2,5,40.0,3,10,0,10,11,20,4,0,0,2019-2020,1.6923076923076923,1.3846153846153846
1262,Jonjoe Kenny,ENG,DF,Schalke 04,Bundesliga,22,1997,30.2,49,29,24,19,6,26,51,51.0,25,45,10,35,26,75,79,0,0,2019-2020,0.8609271523178809,1.6225165562913908
1263,Franck Kessié,CIV,MF,Milan,Serie A,22,1996,32.3,54,29,28,18,8,16,52,30.8,36,34,5,29,34,88,32,2,0,2019-2020,1.0526315789473686,1.6718266253869971
1264,Saîf-Eddine Khaoui,TUN,"MF,FW",Marseille,Ligue 1,24,1995,1.2,3,1,0,3,0,2,5,40.0,3,2,0,2,1,4,4,0,0,2019-2020,0.8333333333333334,2.5
1265,Wahbi Khazri,TUN,"FW,MF",Saint-Étienne,Ligue 1,28,1991,12.8,17,9,5,7,5,9,27,33.3,18,11,0,11,4,21,0,0,0,2019-2020,0.3125,1.328125
1266,Rani Khedira,GER,MF,Augsburg,Bundesliga,25,1994,29.4,60,36,21,35,4,18,45,40.0,27,47,12,35,48,108,62,0,0,2019-2020,1.6326530612244898,2.0408163265306123
1267,Sami Khedira,GER,MF,Juventus,Serie A,32,1987,7.6,14,7,3,8,3,4,19,21.1,15,12,1,11,3,17,13,0,0,2019-2020,0.39473684210526316,1.842105263157895
1268,Kiké,ESP,FW,Eibar,La Liga,29,1989,19.6,13,7,0,5,8,4,12,33.3,8,15,1,14,1,14,9,0,0,2019-2020,0.0510204081632653,0.6632653061224489
1269,Luca Kilian,GER,DF,Paderborn 07,Bundesliga,19,1999,14.0,33,24,27,6,0,22,41,53.7,19,20,9,11,12,45,67,0,0,2019-2020,0.8571428571428571,2.357142857142857
1270,Max Kilman,ENG,DF,Wolves,Premier League,22,1997,2.1,4,2,1,3,0,2,2,100.0,0,1,1,0,4,8,7,0,0,2019-2020,1.9047619047619047,1.9047619047619047
1271,Joshua Kimmich,GER,"MF,DF",Bayern Munich,Bundesliga,24,1995,31.3,52,29,21,20,11,22,55,40.0,33,38,9,29,29,81,29,0,0,2019-2020,0.926517571884984,1.6613418530351438
1272,Presnel Kimpembe,FRA,DF,Paris S-G,Ligue 1,23,1995,13.6,33,25,25,8,0,14,20,70.0,6,7,3,4,21,54,33,1,0,2019-2020,1.5441176470588236,2.4264705882352944
1273,Joshua King,NOR,"FW,MF",Bournemouth,Premier League,27,1992,22.3,16,6,4,8,4,4,16,25.0,12,20,3,17,8,24,9,0,0,2019-2020,0.35874439461883406,0.7174887892376681
1274,Simon Kjær,DEN,DF,Atalanta,Serie A,30,1989,3.2,9,6,1,8,0,3,4,75.0,1,5,4,1,7,16,10,1,0,2019-2020,2.1875,2.8125
1275,Simon Kjær,DEN,DF,Milan,Serie A,30,1989,13.8,22,13,17,5,0,10,18,55.6,8,20,16,4,15,37,52,0,0,2019-2020,1.0869565217391304,1.5942028985507246
Rk,Player,Nation,Pos,Squad,Comp,0,0,90.0,0,0,3,3,3,Tkl,0,0.0,0,0,0,0,0,0,0,0,0,2019-2020,0.0,0.0
1276,Davy Klaassen,NED,MF,Werder Bremen,Bundesliga,26,1993,32.6,55,43,19,23,13,19,57,33.3,38,46,18,28,38,93,45,2,0,2019-2020,1.165644171779141,1.687116564417178
1277,Felix Klaus,GER,"MF,FW",Wolfsburg,Bundesliga,26,1992,7.4,24,16,4,13,7,7,19,36.8,12,10,2,8,3,27,5,0,0,2019-2020,0.4054054054054054,3.243243243243243
1278,Ragnar Klavan,EST,DF,Cagliari,Serie A,33,1985,26.2,29,16,20,9,0,14,28,50.0,14,29,19,10,25,54,118,1,0,2019-2020,0.9541984732824428,1.1068702290076335
1279,Timm Klose,SUI,DF,Norwich City,Premier League,31,1988,6.5,8,2,5,2,1,7,11,63.6,4,6,6,0,7,15,29,0,0,2019-2020,1.0769230769230769,1.2307692307692308
1280,Lukas Klostermann,GER,DF,RB Leipzig,Bundesliga,23,1996,29.4,45,26,24,16,5,18,31,58.1,13,34,16,18,26,71,101,2,0,2019-2020,0.8843537414965987,1.5306122448979593
1281,Justin Kluivert,NED,FW,Roma,Serie A,20,1999,16.8,17,11,4,8,5,7,16,43.8,9,15,0,15,6,23,7,0,0,2019-2020,0.35714285714285715,1.0119047619047619
1282,Lukas Klünter,GER,DF,Hertha BSC,Bundesliga,23,1996,20.9,44,31,26,16,2,20,30,66.7,10,16,4,12,27,71,61,1,0,2019-2020,1.291866028708134,2.105263157894737
1283,Robin Knoche,GER,DF,Wolfsburg,Bundesliga,27,1992,17.7,29,14,24,5,0,17,30,56.7,13,19,11,8,27,56,77,1,0,2019-2020,1.5254237288135595,1.6384180790960452
1284,Robin Koch,GER,"DF,MF",Freiburg,Bundesliga,23,1996,30.1,34,20,20,13,1,11,26,42.3,15,30,22,8,45,79,94,4,0,2019-2020,1.495016611295681,1.1295681063122922
1285,Giorgi Kochorashvili,GEO,MF,Levante,La Liga,20,1999,0.0,0,0,0,0,0,0,0,0.0,0,0,0,0,0,0,0,0,0,2019-2020,,
1286,Jonathan Kodjia,CIV,FW,Aston Villa,Premier League,29,1989,1.3,0,0,0,0,0,0,1,0.0,1,0,0,0,0,0,1,0,0,2019-2020,0.0,0.0
1287,Kenan Kodro,BIH,"FW,MF",Athletic Club,La Liga,25,1993,4.0,1,0,0,0,1,0,2,0.0,2,1,0,1,0,1,4,0,0,2019-2020,0.0,0.25
1288,Dominik Kohr,GER,MF,Eint Frankfurt,Bundesliga,25,1994,16.1,44,35,15,25,4,18,53,34.0,35,31,11,20,30,74,16,0,0,2019-2020,1.8633540372670805,2.732919254658385
1289,Koke,ESP,MF,Atlético Madrid,La Liga,27,1992,30.0,70,42,27,30,13,29,89,32.6,60,33,8,25,29,99,28,2,0,2019-2020,0.9666666666666667,2.3333333333333335
1290,Aleksandar Kolarov,SRB,DF,Roma,Serie A,33,1985,30.4,37,28,16,16,5,20,37,54.1,17,20,9,11,31,68,57,0,0,2019-2020,1.0197368421052633,1.2171052631578947
1291,Sead Kolašinac,BIH,DF,Arsenal,Premier League,26,1993,18.9,29,16,18,6,5,12,23,52.2,11,14,4,10,25,54,34,1,0,2019-2020,1.3227513227513228,1.5343915343915344
1292,Timothée Kolodziejczak,FRA,DF,Saint-Étienne,Ligue 1,27,1991,14.5,17,10,13,4,0,9,21,42.9,12,8,3,5,30,47,44,2,0,2019-2020,2.0689655172413794,1.1724137931034482
1293,Ghislain Konan,CIV,DF,Reims,Ligue 1,23,1995,14.8,43,26,28,14,1,19,28,67.9,9,13,3,10,24,67,34,0,0,2019-2020,1.6216216216216215,2.9054054054054053
1294,Ibrahima Konaté,FRA,DF,RB Leipzig,Bundesliga,20,1999,6.3,11,6,10,1,0,2,7,28.6,5,9,4,5,5,16,35,1,0,2019-2020,0.7936507936507937,1.746031746031746
1295,Moussa Konaté,SEN,FW,Amiens,Ligue 1,26,1993,6.8,3,0,0,3,0,0,2,0.0,2,2,0,2,1,4,1,0,0,2019-2020,0.14705882352941177,0.4411764705882353
1296,Geoffrey Kondogbia,CTA,MF,Valencia,La Liga,26,1993,20.1,63,40,40,18,5,19,51,37.3,32,25,6,19,57,120,36,2,0,2019-2020,2.835820895522388,3.134328358208955
1297,Lamine Koné,CIV,DF,Strasbourg,Ligue 1,30,1989,16.4,31,21,20,10,1,12,17,70.6,5,8,5,3,25,56,47,1,0,2019-2020,1.524390243902439,1.8902439024390245
1298,Manu Koné,FRA,MF,Toulouse,Ligue 1,18,2001,9.7,35,20,17,14,4,13,30,43.3,17,15,1,14,19,54,10,1,0,2019-2020,1.9587628865979383,3.6082474226804124
1299,Moussa Koné,SEN,"FW,MF",Nîmes,Ligue 1,22,1996,1.6,2,0,1,1,0,1,3,33.3,2,1,0,1,1,3,0,0,0,2019-2020,0.625,1.25
1300,Youssouf Koné,MLI,DF,Lyon,Ligue 1,24,1995,9.1,22,14,17,3,2,12,20,60.0,8,2,1,1,8,30,15,0,0,2019-2020,0.8791208791208791,2.417582417582418
Rk,Player,Nation,Pos,Squad,Comp,0,0,90.0,0,0,3,3,3,Tkl,0,0.0,0,0,0,0,0,0,0,0,0,2019-2020,0.0,0.0
1301,Ezri Konsa,ENG,DF,Aston Villa,Premier League,21,1997,22.7,18,9,12,6,0,7,16,43.8,9,34,24,10,25,43,70,2,0,2019-2020,1.1013215859030838,0.7929515418502203
1302,Pascal Köpke,GER,FW,Hertha BSC,Bundesliga,23,1995,1.3,0,0,0,0,0,0,0,0.0,0,0,0,0,0,0,0,0,0,2019-2020,0.0,0.0
1303,Laurent Koscielny,FRA,DF,Bordeaux,Ligue 1,33,1985,24.3,28,13,24,4,0,10,20,50.0,10,23,19,4,26,54,104,0,0,2019-2020,1.0699588477366255,1.1522633744855966
1304,Filip Kostić,SRB,"DF,FW",Eint Frankfurt,Bundesliga,26,1992,32.9,59,38,30,20,9,22,59,37.3,37,45,2,43,23,82,16,0,0,2019-2020,0.6990881458966566,1.7933130699088147
1305,Christian Kouamé,CIV,"FW,MF",Fiorentina,Serie A,21,1997,3.3,3,2,0,3,0,0,1,0.0,1,5,1,4,1,4,1,0,0,2019-2020,0.30303030303030304,0.9090909090909092
1306,Christian Kouamé,CIV,FW,Genoa,Serie A,21,1997,10.2,2,1,0,1,1,0,8,0.0,8,8,2,6,1,3,13,0,0,2019-2020,0.09803921568627452,0.19607843137254904
1307,Tomáš Koubek,CZE,GK,Augsburg,Bundesliga,26,1992,24.0,3,2,3,0,0,3,11,27.3,8,1,0,1,1,4,23,3,0,2019-2020,0.041666666666666664,0.125
1308,Kalidou Koulibaly,SEN,DF,Napoli,Serie A,28,1991,23.4,51,33,30,17,4,17,28,60.7,11,28,16,12,31,82,61,1,0,2019-2020,1.324786324786325,2.1794871794871797
1309,Efthimis Koulouris,GRE,FW,Toulouse,Ligue 1,23,1996,17.1,13,8,5,5,3,3,13,23.1,10,8,4,4,3,16,16,0,0,2019-2020,0.17543859649122806,0.7602339181286549
1310,Jules Koundé,FRA,DF,Sevilla,La Liga,20,1998,25.7,23,12,14,5,4,10,18,55.6,8,16,12,4,23,46,91,2,0,2019-2020,0.8949416342412452,0.8949416342412452
1311,Leonardo Koutris,GRE,DF,Mallorca,La Liga,24,1995,1.0,1,1,0,0,1,1,2,50.0,1,1,1,0,1,2,6,0,0,2019-2020,1.0,1.0
1312,Cheikhou Kouyaté,SEN,"MF,DF",Crystal Palace,Premier League,29,1989,28.1,67,32,43,20,4,26,48,54.2,22,35,11,24,43,110,58,1,0,2019-2020,1.5302491103202847,2.3843416370106763
1313,Mateo Kovačić,CRO,MF,Chelsea,Premier League,25,1994,23.0,63,38,29,32,2,26,65,40.0,39,15,1,14,22,85,16,1,0,2019-2020,0.9565217391304348,2.739130434782609
1314,Dawid Kownacki,POL,"FW,MF",Düsseldorf,Bundesliga,22,1997,12.1,13,8,5,7,1,9,20,45.0,11,13,2,11,6,19,8,0,0,2019-2020,0.49586776859504134,1.0743801652892562
1315,İsmail Köybaşı,TUR,"DF,FW",Granada,La Liga,30,1989,2.6,4,4,3,1,0,0,2,0.0,2,4,0,4,5,9,2,0,0,2019-2020,1.923076923076923,1.5384615384615383
1316,Thomas Kraft,GER,GK,Hertha BSC,Bundesliga,31,1988,4.0,0,0,0,0,0,0,0,0.0,0,0,0,0,1,1,0,0,0,2019-2020,0.25,0.0
1317,Emil Krafth,SWE,DF,Newcastle Utd,Premier League,24,1994,11.3,18,12,15,2,1,9,20,45.0,11,11,8,3,8,26,45,0,0,2019-2020,0.7079646017699115,1.5929203539823007
1318,Andrej Kramarić,CRO,"FW,MF",Hoffenheim,Bundesliga,28,1991,15.8,2,1,1,0,1,1,7,14.3,6,6,0,6,3,5,4,0,0,2019-2020,0.18987341772151897,0.12658227848101264
1319,Christoph Kramer,GER,MF,Gladbach,Bundesliga,28,1991,16.3,45,29,19,21,5,19,49,38.8,30,22,3,19,14,59,19,0,0,2019-2020,0.8588957055214723,2.7607361963190185
1320,Tom Krauß,GER,MF,RB Leipzig,Bundesliga,18,2001,0.0,1,1,0,1,0,1,2,50.0,1,0,0,0,0,1,0,0,0,2019-2020,,inf
1321,Ladislav Krejčí,CZE,DF,Bologna,Serie A,27,1992,11.7,15,10,6,7,2,9,19,47.4,10,7,4,3,10,25,23,0,0,2019-2020,0.8547008547008548,1.2820512820512822
1322,Rene Krhin,SVN,"DF,MF",Nantes,Ligue 1,29,1990,3.6,4,3,1,3,0,2,2,100.0,0,1,0,1,6,10,17,0,0,2019-2020,1.6666666666666665,1.1111111111111112
1323,Felix Kroos,GER,"MF,DF",Union Berlin,Bundesliga,28,1991,4.2,17,9,9,6,2,8,15,53.3,7,6,3,3,3,20,13,1,0,2019-2020,0.7142857142857143,4.0476190476190474
1324,Toni Kroos,GER,MF,Real Madrid,La Liga,29,1990,29.5,56,28,18,29,9,18,70,25.7,52,27,0,27,23,79,15,0,0,2019-2020,0.7796610169491526,1.8983050847457628
1325,Tim Krul,NED,GK,Norwich City,Premier League,31,1988,36.0,0,0,0,0,0,0,1,0.0,1,2,0,2,1,1,13,1,0,2019-2020,0.027777777777777776,0.0
Rk,Player,Nation,Pos,Squad,Comp,0,0,90.0,0,0,3,3,3,Tkl,0,0.0,0,0,0,0,0,0,0,0,0,2019-2020,0.0,0.0
1326,Rade Krunić,BIH,"MF,FW",Milan,Serie A,25,1993,6.0,16,8,8,5,3,9,16,56.3,7,5,0,5,9,25,5,0,0,2019-2020,1.5,2.6666666666666665
1327,Lukas Kübler,GER,DF,Freiburg,Bundesliga,26,1992,2.3,1,1,0,1,0,1,5,20.0,4,2,0,2,1,2,6,0,0,2019-2020,0.4347826086956522,0.4347826086956522
1328,Takefusa Kubo,JPN,"MF,FW",Mallorca,La Liga,18,2001,25.7,34,22,16,12,6,15,44,34.1,29,19,1,18,23,57,10,0,0,2019-2020,0.8949416342412452,1.3229571984435797
1329,Juraj Kucka,SVK,"MF,FW",Parma,Serie A,32,1987,21.5,43,22,21,16,6,14,61,23.0,47,21,4,17,29,72,36,0,0,2019-2020,1.3488372093023255,2.0
1330,Dejan Kulusevski,SWE,"FW,MF",Parma,Serie A,19,2000,32.6,41,21,10,24,7,19,64,29.7,45,25,1,24,23,64,17,0,0,2019-2020,0.705521472392638,1.2576687116564416
1331,Marash Kumbulla,ALB,DF,Hellas Verona,Serie A,19,2000,21.7,40,24,21,17,2,19,36,52.8,17,33,24,9,50,90,86,3,0,2019-2020,2.3041474654377883,1.8433179723502304
1332,Pierre Kunde,CMR,MF,Mainz 05,Bundesliga,24,1995,20.7,34,17,15,18,1,12,30,40.0,18,16,4,12,26,60,55,0,0,2019-2020,1.2560386473429952,1.642512077294686
1333,Jasmin Kurtić,SVN,MF,SPAL,Serie A,30,1989,15.7,20,7,8,8,4,6,27,22.2,21,14,2,12,10,30,20,1,0,2019-2020,0.6369426751592357,1.2738853503184715
1334,Jasmin Kurtić,SVN,"MF,FW",Parma,Serie A,30,1989,18.5,32,23,19,10,3,13,35,37.1,22,19,5,14,15,47,27,2,0,2019-2020,0.8108108108108109,1.7297297297297298
1335,Layvin Kurzawa,FRA,DF,Paris S-G,Ligue 1,26,1992,9.5,23,16,5,14,4,11,23,47.8,12,12,1,11,18,41,24,1,0,2019-2020,1.894736842105263,2.4210526315789473
1336,Dereck Kutesa,SUI,"FW,MF",Reims,Ligue 1,21,1997,5.9,6,5,3,2,1,3,9,33.3,6,5,0,5,1,7,1,0,0,2019-2020,0.1694915254237288,1.0169491525423728
1337,Ahmed Kutucu,TUR,"FW,MF",Schalke 04,Bundesliga,19,2000,7.5,11,7,3,6,2,4,15,26.7,11,5,0,5,2,13,5,0,0,2019-2020,0.26666666666666666,1.4666666666666666
1338,Enock Kwateng,FRA,DF,Bordeaux,Ligue 1,22,1997,10.9,36,22,17,17,2,22,47,46.8,25,16,6,10,22,58,41,0,0,2019-2020,2.018348623853211,3.3027522935779814
1339,Giorgos Kyriakopoulos,GRE,DF,Sassuolo,Serie A,23,1996,18.3,35,18,22,7,6,18,32,56.3,14,19,6,13,18,53,41,0,0,2019-2020,0.9836065573770492,1.9125683060109289
1340,Antonino La Gumina,ITA,FW,Sampdoria,Serie A,23,1996,2.1,0,0,0,0,0,0,0,0.0,0,0,0,0,0,0,1,0,0,2019-2020,0.0,0.0
1341,Andrea La Mantia,ITA,FW,Lecce,Serie A,28,1991,6.1,1,0,1,0,0,1,5,20.0,4,3,0,3,7,8,11,0,0,2019-2020,1.1475409836065575,0.1639344262295082
1342,Gaëtan Laborde,FRA,FW,Montpellier,Ligue 1,25,1994,24.9,21,12,4,10,7,9,38,23.7,29,21,0,21,7,28,32,1,0,2019-2020,0.28112449799196787,0.8433734939759037
1343,Alexandre Lacazette,FRA,FW,Arsenal,Premier League,28,1991,20.8,31,16,8,21,2,9,24,37.5,15,14,0,14,7,38,15,0,0,2019-2020,0.3365384615384615,1.4903846153846154
1344,Riccardo Ladinetti,ITA,MF,Cagliari,Serie A,18,2000,1.4,2,2,0,2,0,1,1,100.0,0,0,0,0,4,6,0,1,0,2019-2020,2.857142857142857,1.4285714285714286
1345,Alban Lafont,FRA,GK,Nantes,Ligue 1,20,1999,27.0,1,1,1,0,0,1,1,100.0,0,0,0,0,0,1,12,0,0,2019-2020,0.0,0.037037037037037035
1346,Víctor Laguardia,ESP,DF,Alavés,La Liga,29,1989,29.5,21,15,15,6,0,16,30,53.3,14,24,18,6,37,58,131,1,0,2019-2020,1.2542372881355932,0.711864406779661
1347,Jack Lahne,SWE,FW,Amiens,Ligue 1,17,2001,0.1,1,1,0,0,1,0,0,0.0,0,0,0,0,0,1,0,0,0,2019-2020,0.0,10.0
1348,Konrad Laimer,AUT,MF,RB Leipzig,Bundesliga,22,1997,23.5,91,45,30,46,15,43,102,42.2,59,51,8,43,34,125,14,0,0,2019-2020,1.446808510638298,3.872340425531915
1349,Stefan Lainer,AUT,DF,Gladbach,Bundesliga,26,1992,30.1,51,30,25,19,7,24,54,44.4,30,38,7,31,29,80,71,0,0,2019-2020,0.9634551495016611,1.6943521594684385
1350,Diego Lainez,MEX,"MF,FW",Betis,La Liga,19,2000,3.9,6,5,2,4,0,5,8,62.5,3,6,0,6,1,7,1,0,0,2019-2020,0.25641025641025644,1.5384615384615385
Rk,Player,Nation,Pos,Squad,Comp,0,0,90.0,0,0,3,3,3,Tkl,0,0.0,0,0,0,0,0,0,0,0,0,2019-2020,0.0,0.0
1351,Kenny Lala,MAD,"DF,MF",Strasbourg,Ligue 1,27,1991,22.7,29,16,17,11,1,11,27,40.7,16,14,5,9,20,49,40,1,0,2019-2020,0.881057268722467,1.277533039647577
1352,Adam Lallana,ENG,"MF,FW",Liverpool,Premier League,31,1988,4.2,19,9,7,9,3,6,21,28.6,15,7,0,7,5,24,3,0,0,2019-2020,1.1904761904761905,4.523809523809524
1353,Érik Lamela,ARG,"MF,FW",Tottenham,Premier League,27,1992,13.5,24,20,9,13,2,2,21,9.5,19,12,3,9,8,32,10,0,0,2019-2020,0.5925925925925926,1.7777777777777777
1354,Tariq Lamptey,GHA,DF,Chelsea,Premier League,18,2000,0.4,2,2,1,1,0,2,2,100.0,0,0,0,0,0,2,0,0,0,2019-2020,0.0,5.0
1355,Tariq Lamptey,GHA,DF,Brighton,Premier League,18,2000,6.5,7,6,6,1,0,2,9,22.2,7,6,0,6,16,23,17,0,0,2019-2020,2.4615384615384617,1.0769230769230769
1356,Loïck Landre,FRA,DF,Nîmes,Ligue 1,27,1992,10.3,16,9,12,3,1,7,11,63.6,4,12,9,3,17,33,34,0,0,2019-2020,1.6504854368932038,1.5533980582524272
1357,Michael Lang,SUI,"DF,FW",Werder Bremen,Bundesliga,28,1991,6.0,8,5,3,5,0,6,12,50.0,6,5,1,4,7,15,22,0,0,2019-2020,1.1666666666666667,1.3333333333333333
1358,Sebastian Langkamp,GER,DF,Werder Bremen,Bundesliga,31,1988,3.5,3,2,3,0,0,2,4,50.0,2,5,3,2,3,6,11,1,0,2019-2020,0.8571428571428571,0.8571428571428571
1359,Henri Lansbury,ENG,MF,Aston Villa,Premier League,28,1990,2.2,6,2,3,1,2,2,8,25.0,6,4,0,4,0,6,3,0,0,2019-2020,0.0,2.727272727272727
1360,Manuel Lanzini,ARG,"MF,FW",West Ham,Premier League,26,1993,15.3,14,9,6,6,2,7,39,17.9,32,9,1,8,10,24,3,0,0,2019-2020,0.6535947712418301,0.9150326797385621
1361,Gianluca Lapadula,PER,FW,Lecce,Serie A,29,1990,19.8,15,8,6,8,1,5,16,31.3,11,2,0,2,1,16,14,0,0,2019-2020,0.050505050505050504,0.7575757575757576
1362,Aymeric Laporte,ESP,DF,Manchester City,Premier League,25,1994,12.2,13,6,6,7,0,4,9,44.4,5,6,5,1,20,33,26,1,0,2019-2020,1.639344262295082,1.0655737704918034
1363,Danilo Larangeira,BRA,DF,Bologna,Serie A,35,1984,29.3,34,17,19,15,0,16,28,57.1,12,54,39,15,30,64,99,0,0,2019-2020,1.023890784982935,1.1604095563139931
1364,Larra,ESP,"FW,MF",Athletic Club,La Liga,21,1997,2.8,2,2,0,1,1,0,0,0.0,0,1,0,1,0,2,0,0,0,2019-2020,0.0,0.7142857142857143
1365,Gautier Larsonneur,FRA,GK,Brest,Ligue 1,22,1997,26.6,2,1,2,0,0,2,4,50.0,2,1,0,1,4,6,14,3,0,2019-2020,0.15037593984962405,0.07518796992481203
1366,Kevin Lasagna,ITA,FW,Udinese,Serie A,26,1992,28.5,27,14,7,13,7,6,31,19.4,25,23,1,22,10,37,18,1,0,2019-2020,0.3508771929824561,0.9473684210526315
1367,Jamaal Lascelles,ENG,DF,Newcastle Utd,Premier League,25,1993,23.1,14,3,10,4,0,4,9,44.4,5,23,20,3,28,42,116,1,0,2019-2020,1.2121212121212122,0.6060606060606061
1368,Paul Lasne,FRA,"MF,FW",Brest,Ligue 1,30,1989,13.6,25,13,13,11,1,6,20,30.0,14,7,2,5,7,32,5,0,0,2019-2020,0.5147058823529412,1.8382352941176472
1369,Toni Lato,ESP,"DF,MF",Osasuna,La Liga,21,1997,5.2,22,15,11,8,3,9,10,90.0,1,9,1,8,8,30,13,1,0,2019-2020,1.5384615384615383,4.230769230769231
1370,Danny Latza,GER,MF,Mainz 05,Bundesliga,29,1989,15.3,33,19,15,17,1,16,49,32.7,33,22,5,17,17,50,24,0,0,2019-2020,1.1111111111111112,2.156862745098039
1371,Vincent Laurini,FRA,DF,Parma,Serie A,30,1989,9.8,26,22,11,11,4,14,18,77.8,4,10,3,7,11,37,29,0,0,2019-2020,1.1224489795918366,2.6530612244897958
1372,Wesley Lautoa,NCL,"MF,DF",Dijon,Ligue 1,31,1987,20.8,54,29,24,28,2,28,63,44.4,35,31,16,15,42,96,48,2,0,2019-2020,2.019230769230769,2.5961538461538463
1373,Diego Laxalt,URU,"DF,MF",Torino,Serie A,26,1993,6.6,19,10,10,6,3,6,20,30.0,14,12,4,8,6,25,20,0,0,2019-2020,0.9090909090909092,2.878787878787879
1374,Diego Laxalt,URU,DF,Milan,Serie A,26,1993,1.9,3,3,3,0,0,1,3,33.3,2,4,0,4,0,3,3,0,0,2019-2020,0.0,1.5789473684210527
1375,Valentino Lazaro,AUT,"DF,MF",Newcastle Utd,Premier League,23,1996,5.3,13,9,11,2,0,11,18,61.1,7,2,0,2,3,16,4,0,0,2019-2020,0.5660377358490566,2.452830188679245
Rk,Player,Nation,Pos,Squad,Comp,0,0,90.0,0,0,3,3,3,Tkl,0,0.0,0,0,0,0,0,0,0,0,0,2019-2020,0.0,0.0
1376,Valentino Lazaro,AUT,DF,Inter,Serie A,23,1996,3.6,6,5,3,2,1,4,8,50.0,4,5,0,5,1,7,8,1,0,2019-2020,0.2777777777777778,1.6666666666666665
1377,Darko Lazović,SRB,DF,Hellas Verona,Serie A,28,1990,36.0,26,16,14,8,4,14,27,51.9,13,15,4,11,23,49,53,0,0,2019-2020,0.6388888888888888,0.7222222222222222
1378,Manuel Lazzari,ITA,DF,Lazio,Serie A,25,1993,28.3,20,11,10,7,3,10,31,32.3,21,11,1,10,8,28,34,0,0,2019-2020,0.2826855123674912,0.7067137809187279
1379,Mickaël Le Bihan,FRA,"FW,DF",Nice,Ligue 1,29,1990,1.1,0,0,0,0,0,0,2,0.0,2,0,0,0,0,0,2,0,0,2019-2020,0.0,0.0
1380,Robin Le Normand,ESP,DF,Real Sociedad,La Liga,22,1996,26.6,48,27,33,15,0,26,35,74.3,9,20,7,13,20,68,99,0,0,2019-2020,0.7518796992481203,1.8045112781954886
1381,Damien Le Tallec,FRA,"MF,DF",Montpellier,Ligue 1,29,1990,27.3,52,27,20,28,4,24,69,34.8,45,38,18,20,38,90,59,0,0,2019-2020,1.3919413919413919,1.9047619047619047
1382,James Lea Siliki,CMR,MF,Rennes,Ligue 1,23,1996,12.0,28,16,19,9,0,16,29,55.2,13,15,4,11,12,40,12,0,0,2019-2020,1.0,2.3333333333333335
1383,Rafael Leão,POR,FW,Milan,Serie A,20,1999,15.6,7,4,2,5,0,3,9,33.3,6,4,0,4,0,7,5,0,0,2019-2020,0.0,0.44871794871794873
1384,Adrien Lebeau,FRA,"MF,FW",Strasbourg,Ligue 1,20,1999,0.1,1,1,1,0,0,0,1,0.0,1,1,0,1,0,1,0,0,0,2019-2020,0.0,10.0
1385,Mathew Leckie,AUS,"DF,FW",Hertha BSC,Bundesliga,28,1991,2.2,3,1,1,2,0,2,3,66.7,1,6,0,6,2,5,2,1,0,2019-2020,0.9090909090909091,1.3636363636363635
1386,Benjamin Lecomte,FRA,GK,Monaco,Ligue 1,28,1991,28.0,0,0,0,0,0,0,1,0.0,1,1,0,1,0,0,10,5,0,2019-2020,0.0,0.0
1387,Pierre Lees-Melou,FRA,MF,Nice,Ligue 1,26,1993,25.0,63,27,34,21,8,31,88,35.2,57,38,12,26,32,95,43,0,0,2019-2020,1.28,2.52
1388,Jordan Lefort,FRA,DF,Amiens,Ligue 1,25,1993,9.4,3,2,2,1,0,3,5,60.0,2,4,1,3,9,12,29,0,0,2019-2020,0.9574468085106382,0.3191489361702127
1389,Wu Lei,CHN,"FW,MF",Espanyol,La Liga,27,1991,19.1,13,8,5,6,2,4,38,10.5,34,32,1,31,15,28,19,1,0,2019-2020,0.7853403141361256,0.6806282722513088
1390,Toni Leistner,GER,DF,Köln,Bundesliga,28,1990,11.2,19,12,10,9,0,5,13,38.5,8,16,7,9,32,51,57,0,0,2019-2020,2.857142857142857,1.6964285714285716
1391,Moritz Leitner,GER,MF,Norwich City,Premier League,26,1992,7.6,16,9,8,7,1,9,25,36.0,16,14,4,10,9,25,10,1,0,2019-2020,1.1842105263157896,2.1052631578947367
1392,Lucas Leiva,BRA,MF,Lazio,Serie A,32,1987,20.1,60,35,25,31,4,28,72,38.9,44,29,6,23,47,107,34,1,0,2019-2020,2.3383084577114426,2.9850746268656714
1393,Florian Lejeune,FRA,DF,Newcastle Utd,Premier League,28,1991,4.9,8,2,6,2,0,4,7,57.1,3,6,2,4,10,18,15,2,0,2019-2020,2.0408163265306123,1.6326530612244896
1394,Iñigo Lekue,ESP,"FW,DF",Athletic Club,La Liga,26,1993,6.9,22,12,14,6,2,11,14,78.6,3,7,0,7,3,25,11,0,0,2019-2020,0.43478260869565216,3.1884057971014492
1395,Nicolas Lemaître,FRA,GK,Reims,Ligue 1,22,1997,1.0,0,0,0,0,0,0,1,0.0,1,0,0,0,1,1,1,1,0,2019-2020,1.0,0.0
1396,Thomas Lemar,FRA,MF,Atlético Madrid,La Liga,23,1995,10.3,12,8,4,5,3,2,11,18.2,9,14,1,13,6,18,6,0,0,2019-2020,0.5825242718446602,1.1650485436893203
1397,Tim Lemperle,GER,MF,Köln,Bundesliga,17,2002,0.2,0,0,0,0,0,0,0,0.0,0,0,0,0,0,0,0,0,0,2019-2020,0.0,0.0
1398,Clément Lenglet,FRA,DF,Barcelona,La Liga,24,1995,26.9,44,31,29,15,0,16,32,50.0,16,29,15,14,35,79,79,1,0,2019-2020,1.3011152416356877,1.6356877323420076
1399,Aaron Lennon,ENG,MF,Burnley,Premier League,32,1987,5.5,14,8,7,4,3,7,10,70.0,3,6,1,5,8,22,3,0,0,2019-2020,1.4545454545454546,2.5454545454545454
1400,Bernd Leno,GER,GK,Arsenal,Premier League,27,1992,29.4,0,0,0,0,0,0,2,0.0,2,0,0,0,0,0,9,2,0,2019-2020,0.0,0.0
Rk,Player,Nation,Pos,Squad,Comp,0,0,90.0,0,0,3,3,3,Tkl,0,0.0,0,0,0,0,0,0,0,0,0,2019-2020,0.0,0.0
1401,Christopher Lenz,GER,"DF,MF",Union Berlin,Bundesliga,24,1994,25.2,63,37,37,20,6,26,49,53.1,23,46,11,35,43,106,65,0,0,2019-2020,1.7063492063492065,2.5
1402,Donovan Léon,GUF,GK,Brest,Ligue 1,26,1992,1.4,0,0,0,0,0,0,0,0.0,0,1,0,1,0,0,0,0,0,2019-2020,0.0,0.0
1403,Pedro León,ESP,"MF,FW",Eibar,La Liga,32,1986,21.1,28,20,8,9,11,12,25,48.0,13,18,1,17,19,47,7,0,0,2019-2020,0.9004739336492891,1.3270142180094786
1404,Sergio León,ESP,FW,Levante,La Liga,30,1989,7.5,3,3,0,3,0,2,4,50.0,2,3,0,3,1,4,2,0,0,2019-2020,0.13333333333333333,0.4
1405,Lukas Lerager,DEN,MF,Genoa,Serie A,26,1993,15.4,29,19,13,12,4,10,34,29.4,24,20,5,15,8,37,15,1,0,2019-2020,0.5194805194805194,1.883116883116883
1406,Mehdi Léris,ALG,"MF,FW",Sampdoria,Serie A,21,1998,5.7,13,11,4,2,7,7,19,36.8,12,12,4,8,6,19,6,0,0,2019-2020,1.0526315789473684,2.280701754385965
1407,Jefferson Lerma,COL,MF,Bournemouth,Premier League,24,1994,30.0,54,32,17,31,6,22,48,45.8,26,28,12,16,57,111,54,1,0,2019-2020,1.9,1.8
1408,Karlo Letica,CRO,GK,SPAL,Serie A,22,1997,10.0,0,0,0,0,0,0,2,0.0,2,0,0,0,0,0,4,3,0,2019-2020,0.0,0.0
1409,Robert Lewandowski,POL,FW,Bayern Munich,Bundesliga,30,1988,30.7,18,9,3,9,6,3,15,20.0,12,13,1,12,7,25,13,0,0,2019-2020,0.22801302931596093,0.5863192182410424
1410,Jamal Lewis,NIR,DF,Norwich City,Premier League,21,1998,25.6,51,35,42,6,3,22,36,61.1,14,27,12,15,25,76,68,0,0,2019-2020,0.9765625,1.9921875
1411,Aaron Leya Iseka,BEL,FW,Toulouse,Ligue 1,21,1997,8.6,2,0,0,2,0,0,3,0.0,3,5,0,5,1,3,7,0,0,2019-2020,0.11627906976744186,0.23255813953488372
1412,Stephan Lichtsteiner,SUI,DF,Augsburg,Bundesliga,35,1984,14.9,23,14,16,5,2,10,22,45.5,12,15,7,8,16,39,35,0,0,2019-2020,1.0738255033557047,1.5436241610738255
1413,Dimitri Liénard,FRA,MF,Strasbourg,Ligue 1,31,1988,16.5,37,24,10,22,5,18,39,46.2,21,18,4,14,17,54,25,0,0,2019-2020,1.0303030303030303,2.242424242424242
1414,Philipp Lienhart,AUT,DF,Freiburg,Bundesliga,23,1996,20.2,11,4,10,1,0,6,13,46.2,7,24,17,7,28,39,86,0,0,2019-2020,1.3861386138613863,0.5445544554455446
1415,Matthijs de Ligt,NED,DF,Juventus,Serie A,19,1999,27.2,25,15,14,10,1,13,23,56.5,10,30,23,7,25,50,101,2,0,2019-2020,0.9191176470588236,0.9191176470588236
1416,Isaac Lihadji,FRA,MF,Marseille,Ligue 1,17,2002,0.3,0,0,0,0,0,0,0,0.0,0,0,0,0,0,0,0,0,0,2019-2020,0.0,0.0
1417,Lillo,ESP,DF,Osasuna,La Liga,30,1989,2.2,4,2,2,2,0,1,1,100.0,0,2,1,1,2,6,8,0,0,2019-2020,0.9090909090909091,1.8181818181818181
1418,Anderson Lima,BRA,"MF,DF",Lazio,Serie A,19,1999,0.7,4,0,3,1,0,1,1,100.0,0,4,0,4,0,4,0,0,0,2019-2020,0.0,5.714285714285714
1419,Lucas Lima,BRA,"FW,DF",Nantes,Ligue 1,27,1991,3.0,7,2,4,3,0,2,5,40.0,3,2,0,2,1,8,3,0,0,2019-2020,0.3333333333333333,2.3333333333333335
1420,Anthony Limbombe,BEL,"FW,MF",Nantes,Ligue 1,25,1994,1.7,3,2,1,2,0,1,1,100.0,0,1,0,1,0,3,3,0,0,2019-2020,0.0,1.7647058823529411
1421,Victor Lindelöf,SWE,DF,Manchester Utd,Premier League,25,1994,34.4,29,15,16,12,1,17,20,85.0,3,25,16,9,26,55,129,0,0,2019-2020,0.7558139534883721,0.8430232558139535
1422,Karol Linetty,POL,MF,Sampdoria,Serie A,24,1995,22.4,61,32,24,25,12,21,65,32.3,44,26,3,23,26,87,17,0,0,2019-2020,1.1607142857142858,2.723214285714286
1423,Jesse Lingard,ENG,"MF,FW",Manchester Utd,Premier League,26,1992,10.4,15,8,6,4,5,5,18,27.8,13,5,0,5,3,18,0,0,0,2019-2020,0.28846153846153844,1.4423076923076923
1424,Pol Lirola,ESP,DF,Fiorentina,Serie A,21,1997,29.4,34,20,18,10,6,21,38,55.3,17,16,4,12,26,60,52,0,0,2019-2020,0.8843537414965987,1.1564625850340136
1425,Diego Llorente,ESP,DF,Real Sociedad,La Liga,25,1993,25.9,30,14,20,9,1,16,28,57.1,12,14,7,7,28,58,101,5,0,2019-2020,1.0810810810810811,1.1583011583011584
Rk,Player,Nation,Pos,Squad,Comp,0,0,90.0,0,0,3,3,3,Tkl,0,0.0,0,0,0,0,0,0,0,0,0,2019-2020,0.0,0.0
1426,Fernando Llorente,ESP,FW,Napoli,Serie A,34,1985,5.6,0,0,0,0,0,0,1,0.0,1,4,0,4,1,1,3,0,0,2019-2020,0.17857142857142858,0.0
1427,Marcos Llorente,ESP,"MF,FW",Atlético Madrid,La Liga,24,1995,15.2,29,15,7,16,6,7,21,33.3,14,24,4,20,14,43,9,0,0,2019-2020,0.9210526315789475,1.9078947368421053
1428,Gautier Lloris,FRA,DF,Nice,Ligue 1,24,1995,3.0,5,3,5,0,0,4,5,80.0,1,3,3,0,2,7,11,0,0,2019-2020,0.6666666666666666,1.6666666666666667
1429,Hugo Lloris,FRA,GK,Tottenham,Premier League,32,1986,20.1,0,0,0,0,0,0,0,0.0,0,0,0,0,1,1,3,2,0,2019-2020,0.04975124378109452,0.0
1430,Giovani Lo Celso,ARG,"MF,FW",Tottenham,Premier League,23,1996,16.6,51,29,12,33,6,12,59,20.3,47,20,4,16,9,60,19,0,0,2019-2020,0.5421686746987951,3.0722891566265056
1431,Stanislav Lobotka,SVK,MF,Napoli,Serie A,24,1994,8.4,11,9,3,5,3,5,12,41.7,7,3,1,2,9,20,2,0,0,2019-2020,1.0714285714285714,1.3095238095238095
1432,Stanislav Lobotka,SVK,MF,Celta Vigo,La Liga,24,1994,15.4,19,11,13,5,1,4,19,21.1,15,8,2,6,8,27,7,0,0,2019-2020,0.5194805194805194,1.2337662337662338
1433,Jürgen Locadia,CUW,"FW,MF",Brighton,Premier League,25,1993,1.0,0,0,0,0,0,0,0,0.0,0,0,0,0,0,0,0,0,0,2019-2020,0.0,0.0
1434,Jürgen Locadia,CUW,FW,Hoffenheim,Bundesliga,25,1993,5.9,5,4,0,4,1,1,4,25.0,3,1,0,1,0,5,3,0,0,2019-2020,0.0,0.847457627118644
1435,Manuel Locatelli,ITA,MF,Sassuolo,Serie A,21,1998,28.7,76,50,35,37,4,33,69,47.8,36,42,14,28,33,109,36,0,0,2019-2020,1.1498257839721255,2.64808362369338
1436,Renan Lodi,BRA,DF,Atlético Madrid,La Liga,21,1998,26.6,73,46,28,35,10,40,65,61.5,25,28,7,21,38,111,56,0,0,2019-2020,1.4285714285714286,2.744360902255639
1437,Ruben Loftus-Cheek,ENG,"MF,FW",Chelsea,Premier League,23,1996,2.3,0,0,0,0,0,0,2,0.0,2,1,1,0,2,2,2,0,0,2019-2020,0.8695652173913044,0.0
1438,Enzo Loiodice,FRA,MF,Dijon,Ligue 1,18,2000,2.1,6,4,1,4,1,1,3,33.3,2,2,0,2,2,8,1,0,0,2019-2020,0.9523809523809523,2.857142857142857
1439,Kevin Long,IRL,DF,Burnley,Premier League,28,1990,6.3,7,5,6,1,0,4,9,44.4,5,9,7,2,4,11,31,0,0,2019-2020,0.6349206349206349,1.1111111111111112
1440,Shane Long,IRL,FW,Southampton,Premier League,32,1987,15.5,19,10,5,8,6,7,19,36.8,12,12,0,12,4,23,16,0,0,2019-2020,0.25806451612903225,1.2258064516129032
1441,Matthew Longstaff,ENG,MF,Newcastle Utd,Premier League,19,2000,6.4,3,1,2,1,0,3,14,21.4,11,4,1,3,5,8,3,0,0,2019-2020,0.78125,0.46875
1442,Sean Longstaff,ENG,MF,Newcastle Utd,Premier League,21,1997,15.3,35,19,17,16,2,20,50,40.0,30,23,5,18,19,54,20,2,0,2019-2020,1.2418300653594772,2.287581699346405
1443,Ademola Lookman,NGA,"FW,MF",RB Leipzig,Bundesliga,21,1997,3.4,6,4,3,1,2,1,1,100.0,0,3,0,3,1,7,0,1,0,2019-2020,0.29411764705882354,1.7647058823529411
1444,Anthony Lopes,POR,GK,Lyon,Ligue 1,28,1990,26.0,0,0,0,0,0,0,0,0.0,0,0,0,0,1,1,11,0,0,2019-2020,0.038461538461538464,0.0
1445,Rony Lopes,POR,FW,Sevilla,La Liga,23,1995,1.5,0,0,0,0,0,0,0,0.0,0,0,0,0,2,2,0,0,0,2019-2020,1.3333333333333333,0.0
1446,Rony Lopes,POR,FW,Monaco,Ligue 1,23,1995,0.9,1,0,0,1,0,0,0,0.0,0,0,0,0,0,1,0,0,0,2019-2020,0.0,1.1111111111111112
1447,Adrián López,ESP,FW,Osasuna,La Liga,31,1988,16.0,7,5,1,5,1,2,19,10.5,17,6,2,4,4,11,8,0,0,2019-2020,0.25,0.4375
1448,David López,ESP,"DF,MF",Espanyol,La Liga,29,1989,27.3,38,20,15,20,3,13,41,31.7,28,28,13,15,35,73,63,3,0,2019-2020,1.282051282051282,1.3919413919413919
1449,Diego López,ESP,GK,Espanyol,La Liga,37,1981,35.9,2,2,2,0,0,1,2,50.0,1,0,0,0,2,4,8,1,0,2019-2020,0.05571030640668524,0.05571030640668524
1450,Javi López,ESP,DF,Alavés,La Liga,17,2002,1.0,6,5,4,2,0,4,5,80.0,1,1,1,0,1,7,5,0,0,2019-2020,1.0,6.0
Rk,Player,Nation,Pos,Squad,Comp,0,0,90.0,0,0,3,3,3,Tkl,0,0.0,0,0,0,0,0,0,0,0,0,2019-2020,0.0,0.0
1451,Javi López,ESP,DF,Espanyol,La Liga,33,1986,15.4,47,34,23,18,6,19,40,47.5,21,12,6,6,21,68,38,2,0,2019-2020,1.3636363636363635,3.051948051948052
1452,Lluis López,ESP,DF,Espanyol,La Liga,22,1997,3.3,4,2,3,1,0,2,2,100.0,0,4,0,4,1,5,6,1,0,2019-2020,0.30303030303030304,1.2121212121212122
1453,Maxime Lopez,FRA,"MF,FW",Marseille,Ligue 1,21,1997,12.3,16,10,5,8,3,4,26,15.4,22,8,2,6,8,24,1,0,0,2019-2020,0.6504065040650406,1.3008130081300813
1454,Pau López,ESP,GK,Roma,Serie A,24,1994,32.0,1,0,1,0,0,1,5,20.0,4,0,0,0,1,2,10,3,0,2019-2020,0.03125,0.03125
1455,Roberto López,ESP,"FW,MF",Real Sociedad,La Liga,19,2000,0.6,4,2,1,1,2,2,2,100.0,0,0,0,0,0,4,0,0,0,2019-2020,0.0,6.666666666666667
1456,Unai López,ESP,MF,Athletic Club,La Liga,23,1995,19.9,30,22,8,18,4,10,41,24.4,31,13,2,11,18,48,12,1,0,2019-2020,0.9045226130653267,1.5075376884422111
1457,Iker Losada,ESP,"MF,FW",Celta Vigo,La Liga,17,2001,0.1,0,0,0,0,0,0,0,0.0,0,0,0,0,0,0,0,0,0,2019-2020,0.0,0.0
1458,Albert Lottin,FRA,MF,Bordeaux,Ligue 1,17,2001,0.5,2,0,2,0,0,1,4,25.0,3,0,0,0,2,4,2,0,0,2019-2020,4.0,4.0
1459,Imran Louza,MAR,"MF,FW",Nantes,Ligue 1,20,1999,22.3,53,27,18,27,8,19,46,41.3,27,18,2,16,17,70,7,0,0,2019-2020,0.7623318385650224,2.3766816143497755
1460,Matteo Lovato,ITA,DF,Hellas Verona,Serie A,19,2000,0.1,0,0,0,0,0,0,0,0.0,0,0,0,0,0,0,1,0,0,2019-2020,0.0,0.0
1461,Dejan Lovren,CRO,DF,Liverpool,Premier League,30,1989,8.6,13,8,10,3,0,7,12,58.3,5,9,6,3,10,23,42,0,0,2019-2020,1.1627906976744187,1.5116279069767442
1462,Eduard Löwen,GER,MF,Augsburg,Bundesliga,22,1997,7.5,10,8,6,2,2,6,18,33.3,12,11,2,9,5,15,7,0,0,2019-2020,0.6666666666666666,1.3333333333333333
1463,Eduard Löwen,GER,MF,Hertha BSC,Bundesliga,22,1997,3.5,9,6,3,6,0,5,11,45.5,6,2,1,1,7,16,2,0,0,2019-2020,2.0,2.5714285714285716
1464,Matthew Lowton,ENG,DF,Burnley,Premier League,30,1989,17.0,41,22,20,18,3,22,33,66.7,11,20,6,14,27,68,57,1,0,2019-2020,1.588235294117647,2.411764705882353
1465,Hirving Lozano,MEX,"FW,MF",Napoli,Serie A,24,1995,11.4,6,4,1,5,0,2,15,13.3,13,13,0,13,5,11,5,0,0,2019-2020,0.43859649122807015,0.5263157894736842
1466,Pol Lozano,ESP,MF,Espanyol,La Liga,19,1999,1.9,5,3,3,2,0,3,7,42.9,4,3,0,3,1,6,2,0,0,2019-2020,0.5263157894736842,2.6315789473684212
1467,Jan Luca Rumpf,GER,DF,Paderborn 07,Bundesliga,20,1999,1.0,0,0,0,0,0,0,0,0.0,0,0,0,0,0,0,2,0,0,2019-2020,0.0,0.0
1468,Jean Lucas,BRA,MF,Lyon,Ligue 1,21,1998,2.2,16,7,8,5,3,2,9,22.2,7,2,2,0,2,18,0,0,0,2019-2020,0.9090909090909091,7.2727272727272725
1469,Fabio Lucioni,ITA,DF,Lecce,Serie A,31,1987,34.8,29,13,20,9,0,14,32,43.8,18,48,38,10,36,65,169,5,0,2019-2020,1.0344827586206897,0.8333333333333334
1470,José Luis Gayà,ESP,DF,Valencia,La Liga,24,1995,22.1,44,30,29,12,3,28,41,68.3,13,22,9,13,18,62,48,1,0,2019-2020,0.8144796380090498,1.9909502262443437
1471,José Luis Morales,ESP,"FW,MF",Levante,La Liga,32,1987,28.0,17,8,5,9,3,6,34,17.6,28,14,1,13,6,23,5,1,0,2019-2020,0.21428571428571427,0.6071428571428571
1472,José Luis Palomino,ARG,DF,Atalanta,Serie A,29,1990,27.6,81,44,46,33,2,28,54,51.9,26,39,14,25,61,142,74,2,0,2019-2020,2.210144927536232,2.934782608695652
1473,José Luis Rodríguez,PAN,FW,Alavés,La Liga,21,1998,0.2,0,0,0,0,0,0,2,0.0,2,0,0,0,0,0,0,0,0,2019-2020,0.0,0.0
1474,David Luiz,BRA,DF,Arsenal,Premier League,32,1987,31.2,28,16,14,14,0,13,24,54.2,11,42,37,5,32,60,133,2,0,2019-2020,1.0256410256410258,0.8974358974358975
1475,Douglas Luiz,BRA,MF,Aston Villa,Premier League,21,1998,29.0,46,24,25,17,4,19,65,29.2,46,42,15,27,36,82,54,1,0,2019-2020,1.2413793103448276,1.5862068965517242
Rk,Player,Nation,Pos,Squad,Comp,0,0,90.0,0,0,3,3,3,Tkl,0,0.0,0,0,0,0,0,0,0,0,0,2019-2020,0.0,0.0
1476,Jordan Lukaku,BEL,DF,Lazio,Serie A,25,1994,4.4,4,2,1,1,2,2,4,50.0,2,2,1,1,0,4,9,0,0,2019-2020,0.0,0.9090909090909091
1477,Romelu Lukaku,BEL,FW,Inter,Serie A,26,1993,33.1,13,7,4,7,2,3,10,30.0,7,14,6,8,1,14,28,0,0,2019-2020,0.030211480362537763,0.39274924471299094
1478,Dodi Lukebakio,BEL,"FW,MF",Hertha BSC,Bundesliga,21,1997,22.6,25,18,13,8,4,10,28,35.7,18,22,4,18,10,35,14,0,0,2019-2020,0.44247787610619466,1.1061946902654867
1479,Saša Lukić,SRB,MF,Torino,Serie A,22,1996,20.7,29,17,8,19,2,10,35,28.6,25,21,7,14,29,58,15,0,0,2019-2020,1.4009661835748792,1.4009661835748792
1480,Senad Lulić,BIH,DF,Lazio,Serie A,33,1986,17.5,21,13,10,7,4,11,41,26.8,30,20,4,16,21,42,28,1,0,2019-2020,1.2,1.2
1481,John Lundstram,ENG,MF,Sheffield Utd,Premier League,25,1994,27.3,46,30,18,21,7,21,65,32.3,44,18,4,14,33,79,46,1,0,2019-2020,1.2087912087912087,1.684981684981685
1482,Sebastiano Luperto,ITA,DF,Napoli,Serie A,22,1996,5.9,12,9,7,3,2,6,9,66.7,3,5,3,2,6,18,16,0,0,2019-2020,1.0169491525423728,2.0338983050847457
1483,Arnaud Lusamba,COD,"MF,FW",Nice,Ligue 1,22,1997,10.9,20,11,8,10,2,7,23,30.4,16,9,0,9,5,25,6,1,0,2019-2020,0.4587155963302752,1.8348623853211008
1484,Andreas Luthe,GER,GK,Augsburg,Bundesliga,32,1987,10.0,1,0,1,0,0,1,2,50.0,1,0,0,0,0,1,5,1,0,2019-2020,0.0,0.1
1485,Lyanco,BRA,DF,Torino,Serie A,22,1997,13.1,23,13,9,12,2,7,13,53.8,6,29,19,10,23,46,54,2,0,2019-2020,1.7557251908396947,1.7557251908396947
1486,Charalambos Lykogiannis,GRE,DF,Cagliari,Serie A,25,1993,14.9,14,9,9,3,2,7,18,38.9,11,25,9,16,23,37,71,0,0,2019-2020,1.5436241610738255,0.9395973154362416
1487,Yann M'Vila,FRA,"MF,DF",Saint-Étienne,Ligue 1,29,1990,21.6,29,14,12,16,1,12,43,27.9,31,14,4,10,40,69,47,1,0,2019-2020,1.8518518518518516,1.3425925925925926
1488,Alexis Mac Allister,ARG,"MF,FW",Brighton,Premier League,20,1998,3.9,9,5,4,3,2,5,9,55.6,4,12,0,12,1,10,2,0,0,2019-2020,0.25641025641025644,2.307692307692308
1489,Darwin Machís,VEN,"FW,MF",Granada,La Liga,26,1993,23.7,23,13,11,8,4,8,23,34.8,15,22,4,18,31,54,9,0,0,2019-2020,1.3080168776371308,0.9704641350210971
1490,Yvann Macon,FRA,DF,Saint-Étienne,Ligue 1,20,1998,1.1,0,0,0,0,0,0,1,0.0,1,2,0,2,3,3,4,0,0,2019-2020,2.727272727272727,0.0
1491,James Maddison,ENG,MF,Leicester City,Premier League,22,1996,29.2,59,30,13,31,15,23,68,33.8,45,16,0,16,9,68,7,1,0,2019-2020,0.3082191780821918,2.0205479452054793
1492,Gabriel Magalhães,BRA,DF,Lille,Ligue 1,21,1997,23.2,41,29,27,11,3,15,22,68.2,7,27,18,9,22,63,86,2,0,2019-2020,0.9482758620689655,1.767241379310345
1493,Lisandro Magallán,ARG,DF,Alavés,La Liga,25,1993,13.3,22,15,10,12,0,8,14,57.1,6,17,6,11,16,38,43,1,0,2019-2020,1.2030075187969924,1.6541353383458646
1494,Francesco Magnanelli,ITA,MF,Sassuolo,Serie A,34,1984,15.5,25,13,9,12,4,11,35,31.4,24,12,6,6,19,44,23,1,0,2019-2020,1.2258064516129032,1.6129032258064515
1495,Giangiacomo Magnani,ITA,DF,Brescia,Serie A,23,1995,1.3,0,0,0,0,0,0,1,0.0,1,2,2,0,2,2,6,0,0,2019-2020,1.5384615384615383,0.0
1496,Giangiacomo Magnani,ITA,DF,Sassuolo,Serie A,23,1995,1.6,0,0,0,0,0,0,0,0.0,0,2,1,1,2,2,7,0,0,2019-2020,1.25,0.0
1497,Hugo Magnetti,FRA,MF,Brest,Ligue 1,21,1998,2.6,16,10,7,7,2,5,9,55.6,4,4,0,4,7,23,4,0,0,2019-2020,2.692307692307692,6.153846153846153
1498,Harry Maguire,ENG,DF,Manchester Utd,Premier League,26,1993,38.0,37,23,23,14,0,18,34,52.9,16,31,22,9,72,109,159,0,0,2019-2020,1.894736842105263,0.9736842105263158
1499,Abdallahi Mahmoud,MTN,MF,Alavés,La Liga,19,2000,1.7,4,4,2,1,1,1,6,16.7,5,0,0,0,5,9,2,0,0,2019-2020,2.9411764705882355,2.3529411764705883
1500,Riyad Mahrez,ALG,"FW,MF",Manchester City,Premier League,28,1991,21.6,28,14,11,9,8,11,38,28.9,27,31,1,30,18,46,8,2,0,2019-2020,0.8333333333333333,1.2962962962962963
Rk,Player,Nation,Pos,Squad,Comp,0,0,90.0,0,0,3,3,3,Tkl,0,0.0,0,0,0,0,0,0,0,0,0,2019-2020,0.0,0.0
1501,Thiago Maia,BRA,MF,Lille,Ligue 1,22,1997,0.5,4,4,1,3,0,0,1,0.0,1,0,0,0,1,5,1,0,0,2019-2020,2.0,8.0
1502,Arne Maier,GER,MF,Hertha BSC,Bundesliga,20,1999,5.9,9,7,6,1,2,1,10,10.0,9,5,0,5,7,16,2,1,0,2019-2020,1.1864406779661016,1.5254237288135593
1503,Habib Maïga,CIV,MF,Metz,Ligue 1,23,1996,25.2,84,50,36,38,10,24,64,37.5,40,39,4,35,34,118,39,2,0,2019-2020,1.3492063492063493,3.3333333333333335
1504,Mike Maignan,FRA,GK,Lille,Ligue 1,24,1995,28.0,0,0,0,0,0,0,0,0.0,0,0,0,0,2,2,5,0,0,2019-2020,0.07142857142857142,0.0
1505,Ainsley Maitland-Niles,ENG,DF,Arsenal,Premier League,21,1997,15.4,41,23,34,5,2,22,43,51.2,21,12,3,9,28,69,38,0,0,2019-2020,1.8181818181818181,2.6623376623376624
1506,Josh Maja,NGA,FW,Bordeaux,Ligue 1,20,1998,8.2,5,2,0,2,3,1,10,10.0,9,8,4,4,1,6,3,0,0,2019-2020,0.12195121951219513,0.6097560975609757
1507,Abdul Majeed Waris,GHA,FW,Strasbourg,Ligue 1,27,1991,4.1,6,4,4,2,0,3,8,37.5,5,2,0,2,4,10,0,0,0,2019-2020,0.9756097560975611,1.4634146341463417
1508,Žan Majer,SVN,MF,Lecce,Serie A,27,1992,18.5,39,18,19,12,8,17,56,30.4,39,27,6,21,26,65,18,1,0,2019-2020,1.4054054054054055,2.108108108108108
1509,Jean-Victor Makengo,FRA,MF,Toulouse,Ligue 1,21,1998,11.0,14,11,3,10,1,4,13,30.8,9,7,1,6,3,17,5,1,0,2019-2020,0.2727272727272727,1.2727272727272727
1510,Nemanja Maksimović,SRB,MF,Getafe,La Liga,24,1995,32.2,49,28,12,31,6,10,44,22.7,34,37,7,30,56,105,30,1,0,2019-2020,1.7391304347826086,1.5217391304347825
1511,Nikola Maksimović,SRB,DF,Napoli,Serie A,27,1991,20.0,35,24,21,14,0,10,21,47.6,11,19,11,8,30,65,64,1,0,2019-2020,1.5,1.75
1512,Kévin Malcuit,MAR,DF,Napoli,Serie A,28,1991,2.8,8,6,4,3,1,5,6,83.3,1,4,1,3,3,11,2,0,0,2019-2020,1.0714285714285714,2.857142857142857
1513,Daniel Maldini,ITA,"FW,MF",Milan,Serie A,17,2001,0.3,0,0,0,0,0,0,2,0.0,2,1,0,1,1,1,0,0,0,2019-2020,3.3333333333333335,0.0
1514,Ruslan Malinovskyi,UKR,"MF,FW",Atalanta,Serie A,26,1993,17.1,22,14,2,17,3,9,31,29.0,22,13,2,11,5,27,5,0,0,2019-2020,0.29239766081871343,1.286549707602339
1515,Yunus Mallı,TUR,"MF,FW",Union Berlin,Bundesliga,27,1992,7.5,8,3,1,5,2,5,10,50.0,5,2,0,2,7,15,7,0,0,2019-2020,0.9333333333333333,1.0666666666666667
1516,Hugo Mallo,ESP,DF,Celta Vigo,La Liga,28,1991,21.8,62,42,44,16,2,27,48,56.3,21,24,8,16,22,84,97,1,0,2019-2020,1.0091743119266054,2.8440366972477062
1517,Streli Mamba,GER,FW,Paderborn 07,Bundesliga,25,1994,16.9,15,9,0,9,6,1,13,7.7,12,12,2,10,6,21,2,0,0,2019-2020,0.3550295857988166,0.8875739644970415
1518,Hianga Mananga Mbock,FRA,MF,Brest,Ligue 1,19,1999,1.6,1,1,1,0,0,0,0,0.0,0,0,0,0,4,5,0,0,0,2019-2020,2.5,0.625
1519,Vincent Manceau,FRA,DF,Angers,Ligue 1,30,1989,22.0,34,22,18,13,3,16,36,44.4,20,16,3,13,22,56,51,0,0,2019-2020,1.0,1.5454545454545454
1520,Gianluca Mancini,ITA,"DF,MF",Roma,Serie A,23,1996,30.4,49,26,26,18,5,22,44,50.0,22,32,15,17,60,109,98,1,0,2019-2020,1.973684210526316,1.611842105263158
1521,Marco Mancosu,ITA,"MF,FW",Lecce,Serie A,30,1988,27.1,32,18,11,16,5,10,46,21.7,36,34,9,25,16,48,15,1,0,2019-2020,0.5904059040590406,1.1808118081180812
1522,Steve Mandanda,FRA,GK,Marseille,Ligue 1,34,1985,26.3,3,1,3,0,0,3,4,75.0,1,0,0,0,1,4,2,4,0,2019-2020,0.03802281368821293,0.11406844106463879
1523,Reinildo Mandava,MOZ,"DF,MF",Lille,Ligue 1,25,1994,12.3,37,21,23,11,3,25,41,61.0,16,16,1,15,19,56,20,0,0,2019-2020,1.5447154471544715,3.0081300813008127
1524,Aïssa Mandi,ALG,DF,Betis,La Liga,27,1991,28.6,33,15,22,8,3,18,28,64.3,10,29,15,14,38,71,93,0,0,2019-2020,1.3286713286713285,1.1538461538461537
1525,Rolando Mandragora,ITA,MF,Udinese,Serie A,22,1997,22.8,47,24,15,25,7,15,55,27.3,40,30,5,25,26,73,25,0,0,2019-2020,1.1403508771929824,2.06140350877193
Rk,Player,Nation,Pos,Squad,Comp,0,0,90.0,0,0,3,3,3,Tkl,0,0.0,0,0,0,0,0,0,0,0,0,2019-2020,0.0,0.0
1526,Sadio Mané,SEN,FW,Liverpool,Premier League,27,1992,30.5,44,32,9,20,15,13,40,32.5,27,19,0,19,13,57,11,2,0,2019-2020,0.4262295081967213,1.4426229508196722
1527,Eliaquim Mangala,FRA,DF,Valencia,La Liga,28,1991,7.5,4,4,3,1,0,1,2,50.0,1,7,6,1,7,11,40,0,0,2019-2020,0.9333333333333333,0.5333333333333333
1528,Thomas Mangani,FRA,MF,Angers,Ligue 1,32,1987,20.8,33,23,15,16,2,14,47,29.8,33,17,2,15,12,45,20,1,0,2019-2020,0.5769230769230769,1.5865384615384615
1529,Massimiliano Mangraviti,ITA,DF,Brescia,Serie A,21,1998,10.8,8,6,1,6,1,3,6,50.0,3,11,6,5,8,16,43,0,0,2019-2020,0.7407407407407407,0.7407407407407407
1530,Kostas Manolas,GRE,DF,Napoli,Serie A,28,1991,24.2,23,15,13,10,0,10,17,58.8,7,19,14,5,25,48,76,1,0,2019-2020,1.0330578512396695,0.9504132231404959
1531,Javier Manquillo,ESP,DF,Newcastle Utd,Premier League,25,1994,17.8,39,26,27,8,4,24,38,63.2,14,14,2,12,18,57,56,0,0,2019-2020,1.0112359550561798,2.191011235955056
1532,Giacomo Manzari,ITA,"FW,MF",Sassuolo,Serie A,18,2000,0.2,0,0,0,0,0,0,0,0.0,0,0,0,0,0,0,0,0,0,2019-2020,0.0,0.0
1533,Myziane Maolida,COM,"FW,MF",Nice,Ligue 1,20,1999,7.5,14,10,5,6,3,5,12,41.7,7,8,0,8,3,17,3,0,0,2019-2020,0.4,1.8666666666666667
1534,Faitout Maouassa,FRA,DF,Rennes,Ligue 1,21,1998,20.0,51,33,27,20,4,14,26,53.8,12,13,5,8,23,74,59,0,0,2019-2020,1.15,2.55
1535,Fernando Marçal,BRA,DF,Lyon,Ligue 1,30,1989,9.2,28,18,18,7,3,13,26,50.0,13,7,3,4,26,54,32,0,0,2019-2020,2.8260869565217392,3.0434782608695654
1536,Marcelo,BRA,DF,Real Madrid,La Liga,31,1988,14.4,19,11,8,8,3,9,28,32.1,19,19,2,17,18,37,21,0,0,2019-2020,1.25,1.3194444444444444
1537,Marcelo,BRA,DF,Lyon,Ligue 1,32,1987,16.7,27,18,18,8,1,16,23,69.6,7,12,11,1,22,49,77,0,0,2019-2020,1.3173652694610778,1.6167664670658684
1538,Solly March,ENG,"FW,MF",Brighton,Premier League,25,1994,12.7,25,12,16,6,3,9,19,47.4,10,16,4,12,20,45,14,2,0,2019-2020,1.5748031496062993,1.968503937007874
1539,Gian Marco Ferrari,ITA,DF,Sassuolo,Serie A,27,1992,21.1,9,5,6,3,0,4,8,50.0,4,25,22,3,26,35,41,1,0,2019-2020,1.2322274881516586,0.42654028436018954
1540,Óscar de Marcos,ESP,"DF,FW",Athletic Club,La Liga,30,1989,6.0,5,3,2,1,2,3,6,50.0,3,6,0,6,8,13,8,0,0,2019-2020,1.3333333333333333,0.8333333333333334
1541,Dario Maresic,AUT,DF,Reims,Ligue 1,19,1999,1.0,0,0,0,0,0,0,0,0.0,0,1,1,0,1,1,6,0,0,2019-2020,1.0,0.0
1542,Miguel Marí,ESP,MF,Eibar,La Liga,22,1997,0.1,0,0,0,0,0,0,0,0.0,0,0,0,0,0,0,0,0,0,2019-2020,0.0,0.0
1543,Pablo Marí,ESP,DF,Arsenal,Premier League,25,1993,1.3,2,1,2,0,0,0,0,0.0,0,0,0,0,1,3,10,0,0,2019-2020,0.7692307692307692,1.5384615384615383
1544,José María Giménez,URU,DF,Atlético Madrid,La Liga,24,1995,19.5,20,16,18,1,1,7,11,63.6,4,14,7,7,23,43,75,1,0,2019-2020,1.1794871794871795,1.0256410256410255
1545,Mariano,DOM,"FW,MF",Real Madrid,La Liga,25,1993,0.5,0,0,0,0,0,0,1,0.0,1,0,0,0,0,0,0,0,0,2019-2020,0.0,0.0
1546,Adrian Mariappa,JAM,DF,Watford,Premier League,32,1986,16.8,20,14,15,4,1,11,30,36.7,19,22,7,15,11,31,73,0,0,2019-2020,0.6547619047619048,1.1904761904761905
1547,Jordan Marié,FRA,"MF,FW",Dijon,Ligue 1,27,1991,2.2,7,5,4,3,0,4,9,44.4,5,3,1,2,4,11,2,0,0,2019-2020,1.8181818181818181,3.1818181818181817
1548,Federico Marigosu,ITA,MF,Cagliari,Serie A,18,2001,0.3,0,0,0,0,0,0,0,0.0,0,0,0,0,0,0,1,0,0,2019-2020,0.0,0.0
1549,Adrián Marín,ESP,DF,Alavés,La Liga,22,1997,9.5,22,15,14,6,2,13,15,86.7,2,13,4,9,13,35,32,0,0,2019-2020,1.368421052631579,2.3157894736842106
1550,Guillermo Maripán,CHI,DF,Alavés,La Liga,25,1994,1.0,1,1,1,0,0,1,2,50.0,1,0,0,0,2,3,10,0,0,2019-2020,2.0,1.0
Rk,Player,Nation,Pos,Squad,Comp,0,0,90.0,0,0,3,3,3,Tkl,0,0.0,0,0,0,0,0,0,0,0,0,2019-2020,0.0,0.0
1551,Guillermo Maripán,CHI,DF,Monaco,Ligue 1,25,1994,19.5,42,26,28,13,1,24,41,58.5,17,30,13,17,25,67,69,2,0,2019-2020,1.2820512820512822,2.1538461538461537
1552,Marlon,BRA,DF,Sassuolo,Serie A,23,1995,20.2,40,23,24,15,1,17,27,63.0,10,20,13,7,35,75,69,0,0,2019-2020,1.7326732673267327,1.9801980198019802
1553,Omar Marmoush,EGY,"MF,FW",Wolfsburg,Bundesliga,20,1999,0.9,1,1,1,0,0,0,0,0.0,0,1,0,1,1,2,0,0,0,2019-2020,1.1111111111111112,1.1111111111111112
1554,Gonzalo Maroni,ARG,"MF,FW",Sampdoria,Serie A,20,1999,2.0,3,1,1,1,1,3,7,42.9,4,1,0,1,3,6,0,0,0,2019-2020,1.5,1.5
1555,Marquinhos,BRA,"MF,DF",Paris S-G,Ligue 1,25,1994,16.4,39,20,17,18,4,11,26,42.3,15,25,8,17,25,64,31,1,0,2019-2020,1.524390243902439,2.378048780487805
1556,Bruno Martella,ITA,DF,Brescia,Serie A,26,1992,14.1,18,9,14,3,1,9,16,56.3,7,13,7,6,17,35,48,1,0,2019-2020,1.2056737588652482,1.2765957446808511
1557,Roger Martí,ESP,FW,Levante,La Liga,28,1991,25.2,18,11,8,7,3,7,29,24.1,22,14,0,14,6,24,17,0,0,2019-2020,0.2380952380952381,0.7142857142857143
1558,Anthony Martial,FRA,FW,Manchester Utd,Premier League,23,1995,29.2,15,12,1,4,10,1,16,6.3,15,18,1,17,5,20,17,0,0,2019-2020,0.17123287671232876,0.5136986301369864
1559,Aarón Martín,ESP,DF,Mainz 05,Bundesliga,22,1997,19.9,29,15,17,8,4,9,22,40.9,13,11,5,6,30,59,36,0,0,2019-2020,1.5075376884422111,1.4572864321608041
1560,Daniel Martín,ESP,GK,Betis,La Liga,21,1998,5.9,0,0,0,0,0,0,0,0.0,0,0,0,0,0,0,3,0,0,2019-2020,0.0,0.0
1561,David Martin,ENG,GK,West Ham,Premier League,33,1986,4.8,0,0,0,0,0,0,0,0.0,0,0,0,0,0,0,1,1,0,2019-2020,0.0,0.0
1562,Jonas Martin,FRA,MF,Rennes,Ligue 1,29,1990,1.3,6,2,4,0,2,1,1,100.0,0,2,2,0,0,6,0,0,0,2019-2020,0.0,4.615384615384615
1563,Jonas Martin,FRA,MF,Strasbourg,Ligue 1,29,1990,2.7,5,3,4,0,1,1,3,33.3,2,3,0,3,1,6,3,0,0,2019-2020,0.37037037037037035,1.8518518518518516
1564,Josh Martin,ENG,"FW,MF",Norwich City,Premier League,17,2001,0.4,1,0,0,0,1,0,0,0.0,0,1,0,1,1,2,0,0,0,2019-2020,2.5,2.5
1565,Gabriel Martinelli,BRA,FW,Arsenal,Premier League,18,2001,7.4,20,15,10,6,4,7,20,35.0,13,15,1,14,3,23,8,0,0,2019-2020,0.4054054054054054,2.7027027027027026
1566,Álex Martínez,ESP,DF,Granada,La Liga,28,1990,0.2,0,0,0,0,0,0,0,0.0,0,0,0,0,0,0,0,0,0,2019-2020,0.0,0.0
1567,Emiliano Martínez,ARG,GK,Arsenal,Premier League,26,1992,8.6,0,0,0,0,0,0,0,0.0,0,0,0,0,0,0,1,0,0,2019-2020,0.0,0.0
1568,Iñigo Martínez,ESP,DF,Athletic Club,La Liga,28,1991,33.0,48,30,33,13,2,27,47,57.4,20,28,13,15,39,87,140,0,0,2019-2020,1.1818181818181819,1.4545454545454546
1569,Javi Martínez,ESP,MF,Osasuna,La Liga,19,1999,0.1,0,0,0,0,0,0,0,0.0,0,0,0,0,0,0,1,0,0,2019-2020,0.0,0.0
1570,Javi Martínez,ESP,"DF,MF",Bayern Munich,Bundesliga,30,1988,7.5,16,12,9,7,0,9,11,81.8,2,9,8,1,18,34,30,0,0,2019-2020,2.4,2.1333333333333333
1571,José Martínez,ESP,DF,Granada,La Liga,26,1993,13.2,21,16,12,8,1,14,25,56.0,11,6,4,2,18,39,46,0,0,2019-2020,1.3636363636363638,1.590909090909091
1572,Lautaro Martínez,ARG,FW,Inter,Serie A,21,1997,27.2,22,7,2,8,12,4,34,11.8,30,30,2,28,15,37,11,0,0,2019-2020,0.5514705882352942,0.8088235294117647
1573,Pablo Martínez,ESP,MF,Levante,La Liga,21,1998,0.4,2,0,1,1,0,0,1,0.0,1,0,0,0,0,2,2,0,0,2019-2020,0.0,5.0
1574,Pablo Martinez,FRA,DF,Nîmes,Ligue 1,30,1989,26.0,42,21,26,15,1,21,40,52.5,19,34,22,12,58,100,97,0,0,2019-2020,2.230769230769231,1.6153846153846154
1575,Gelson Martins,POR,"DF,FW",Monaco,Ligue 1,24,1995,18.6,30,22,11,15,4,17,42,40.5,25,9,2,7,19,49,10,1,0,2019-2020,1.021505376344086,1.6129032258064515
Rk,Player,Nation,Pos,Squad,Comp,0,0,90.0,0,0,3,3,3,Tkl,0,0.0,0,0,0,0,0,0,0,0,0,2019-2020,0.0,0.0
1576,Adam Marušić,MNE,DF,Lazio,Serie A,26,1992,10.5,11,6,7,4,0,4,11,36.4,7,14,2,12,14,25,16,0,0,2019-2020,1.3333333333333333,1.0476190476190477
1577,Omar Mascarell,EQG,MF,Schalke 04,Bundesliga,26,1993,22.5,42,23,17,22,3,21,57,36.8,36,46,14,32,62,104,40,0,0,2019-2020,2.7555555555555555,1.8666666666666667
1578,Andrea Masiello,ITA,DF,Genoa,Serie A,33,1986,14.7,26,15,17,8,1,16,32,50.0,16,8,2,6,26,52,55,2,0,2019-2020,1.7687074829931975,1.7687074829931975
1579,Andrea Masiello,ITA,DF,Atalanta,Serie A,33,1986,6.0,11,4,6,4,1,7,14,50.0,7,6,4,2,10,21,13,0,0,2019-2020,1.6666666666666667,1.8333333333333333
1580,Adam Masina,MAR,DF,Watford,Premier League,25,1994,20.2,38,22,24,11,3,14,37,37.8,23,26,12,14,28,66,66,0,0,2019-2020,1.3861386138613863,1.8811881188118813
1581,Jordi Masip,ESP,GK,Valladolid,La Liga,30,1989,35.0,1,1,1,0,0,0,2,0.0,2,0,0,0,1,2,7,3,0,2019-2020,0.02857142857142857,0.02857142857142857
1582,Arthur Masuaku,COD,DF,West Ham,Premier League,25,1993,10.4,41,23,24,13,4,23,39,59.0,16,19,5,14,14,55,23,0,0,2019-2020,1.346153846153846,3.942307692307692
1583,Jaime Mata,ESP,FW,Getafe,La Liga,30,1988,30.5,21,13,3,11,7,3,20,15.0,17,16,1,15,7,28,15,0,0,2019-2020,0.22950819672131148,0.6885245901639344
1584,Juan Mata,ESP,"MF,FW",Manchester Utd,Premier League,31,1988,8.4,7,3,1,5,1,2,7,28.6,5,5,1,4,0,7,2,0,0,2019-2020,0.0,0.8333333333333333
1585,Aleš Matějů,CZE,DF,Brescia,Serie A,23,1996,28.3,48,27,33,9,6,23,45,51.1,22,41,24,17,37,85,109,3,0,2019-2020,1.3074204946996466,1.696113074204947
1586,Jean-Philippe Mateta,FRA,FW,Mainz 05,Bundesliga,22,1997,11.7,2,2,0,2,0,0,6,0.0,6,3,2,1,1,3,11,0,0,2019-2020,0.08547008547008547,0.17094017094017094
1587,Nemanja Matić,SRB,MF,Manchester Utd,Premier League,30,1988,17.6,46,24,23,19,4,20,43,46.5,23,21,8,13,22,68,28,1,0,2019-2020,1.25,2.6136363636363633
1588,Joël Matip,CMR,DF,Liverpool,Premier League,27,1991,7.8,13,9,4,7,2,4,11,36.4,7,8,4,4,12,25,38,0,0,2019-2020,1.5384615384615385,1.6666666666666667
1589,Rabbi Matondo,WAL,"FW,MF",Schalke 04,Bundesliga,18,2000,12.9,10,3,3,2,5,3,13,23.1,10,4,0,4,5,15,1,0,0,2019-2020,0.38759689922480617,0.7751937984496123
1590,Alessandro Matri,ITA,"FW,MF",Brescia,Serie A,34,1984,1.0,1,0,0,0,1,0,0,0.0,0,1,0,1,0,1,1,0,0,2019-2020,0.0,1.0
1591,Federico Mattiello,ITA,DF,Cagliari,Serie A,24,1995,10.3,30,21,19,7,4,11,27,40.7,16,20,7,13,18,48,22,0,0,2019-2020,1.7475728155339805,2.9126213592233006
1592,Blaise Matuidi,FRA,MF,Juventus,Serie A,32,1987,24.9,48,27,13,27,8,13,34,38.2,21,35,6,29,22,70,16,0,0,2019-2020,0.8835341365461847,1.9277108433734942
1593,Neal Maupay,FRA,FW,Brighton,Premier League,22,1996,30.7,20,12,1,13,6,9,29,31.0,20,24,0,24,4,24,10,0,0,2019-2020,0.13029315960912052,0.6514657980456027
1594,Stephy Mavididi,ENG,"FW,MF",Dijon,Ligue 1,21,1998,15.5,18,11,7,8,3,10,26,38.5,16,11,0,11,7,25,5,0,0,2019-2020,0.45161290322580644,1.1612903225806452
1595,Philipp Max,GER,DF,Augsburg,Bundesliga,25,1993,30.1,42,29,22,16,4,20,45,44.4,25,19,4,15,26,68,50,0,0,2019-2020,0.8637873754152824,1.3953488372093024
1596,Alexandru Maxim,ROU,"MF,DF",Mainz 05,Bundesliga,29,1990,1.3,4,2,1,2,1,1,3,33.3,2,0,0,0,1,5,1,0,0,2019-2020,0.7692307692307692,3.0769230769230766
1597,Eric Maxim Choupo-Moting,CMR,"FW,MF",Paris S-G,Ligue 1,30,1989,5.0,12,9,3,4,5,4,8,50.0,4,3,0,3,1,13,3,0,0,2019-2020,0.2,2.4
1598,Kévin Mayi,GAB,"FW,MF",Brest,Ligue 1,26,1993,0.0,0,0,0,0,0,0,0,0.0,0,0,0,0,0,0,0,0,0,2019-2020,,
1599,Borja Mayoral,ESP,FW,Levante,La Liga,22,1997,23.8,12,3,4,6,2,2,13,15.4,11,11,0,11,4,16,6,0,0,2019-2020,0.1680672268907563,0.5042016806722689
1600,Luca Mazzitelli,ITA,MF,Sassuolo,Serie A,23,1995,0.1,1,1,0,1,0,1,1,100.0,0,0,0,0,0,1,0,0,0,2019-2020,0.0,10.0
Rk,Player,Nation,Pos,Squad,Comp,0,0,90.0,0,0,3,3,3,Tkl,0,0.0,0,0,0,0,0,0,0,0,0,2019-2020,0.0,0.0
1601,Kevin Mbabu,SUI,DF,Wolfsburg,Bundesliga,24,1995,18.8,69,48,39,24,6,35,54,64.8,19,33,10,23,23,92,53,0,0,2019-2020,1.2234042553191489,3.6702127659574466
1602,Kylian Mbappé,FRA,FW,Paris S-G,Ligue 1,20,1998,16.8,7,2,1,5,1,3,10,30.0,7,4,0,4,3,10,0,0,0,2019-2020,0.17857142857142858,0.41666666666666663
1603,Ibrahima Mbaye,SEN,DF,Bologna,Serie A,24,1994,16.7,19,10,13,4,2,7,17,41.2,10,22,11,11,15,34,42,0,0,2019-2020,0.8982035928143713,1.1377245508982037
1604,Loïc Mbe Soh,FRA,DF,Paris S-G,Ligue 1,18,2001,0.6,2,2,2,0,0,2,2,100.0,0,0,0,0,1,3,0,0,0,2019-2020,1.6666666666666667,3.3333333333333335
1605,Isaac Mbenza,BEL,FW,Amiens,Ligue 1,23,1996,0.9,0,0,0,0,0,0,1,0.0,1,0,0,0,0,0,0,0,0,2019-2020,0.0,0.0
1606,Nathanael Mbuku,FRA,"FW,MF",Reims,Ligue 1,17,2002,4.4,4,2,2,2,0,0,3,0.0,3,0,0,0,2,6,1,0,0,2019-2020,0.45454545454545453,0.9090909090909091
1607,James McArthur,SCO,MF,Crystal Palace,Premier League,31,1987,34.3,88,51,43,34,11,37,106,34.9,69,69,19,50,60,148,56,0,0,2019-2020,1.7492711370262393,2.565597667638484
1608,Oliver McBurnie,SCO,FW,Sheffield Utd,Premier League,23,1996,23.5,37,22,6,27,4,11,40,27.5,29,25,3,22,15,52,43,0,0,2019-2020,0.6382978723404256,1.574468085106383
1609,Alex McCarthy,ENG,GK,Southampton,Premier League,29,1989,28.0,1,1,1,0,0,1,1,100.0,0,1,0,1,0,1,11,3,0,2019-2020,0.0,0.03571428571428571
1610,James McCarthy,IRL,MF,Crystal Palace,Premier League,28,1990,18.7,82,47,36,36,10,40,76,52.6,36,24,5,19,24,106,11,0,0,2019-2020,1.2834224598930482,4.385026737967914
1611,John McGinn,SCO,MF,Aston Villa,Premier League,24,1994,25.7,53,35,19,23,11,18,62,29.0,44,25,1,24,25,78,18,0,0,2019-2020,0.9727626459143969,2.0622568093385216
1612,David McGoldrick,IRL,FW,Sheffield Utd,Premier League,31,1987,20.2,41,26,9,24,8,5,20,25.0,15,14,2,12,3,44,23,0,0,2019-2020,0.1485148514851485,2.0297029702970297
1613,Michael McGovern,NIR,GK,Norwich City,Premier League,35,1984,1.8,0,0,0,0,0,0,0,0.0,0,0,0,0,0,0,1,1,0,2019-2020,0.0,0.0
1614,Weston McKennie,USA,"MF,DF",Schalke 04,Bundesliga,20,1998,23.0,38,20,17,16,5,13,40,32.5,27,38,12,26,46,84,39,0,0,2019-2020,2.0,1.6521739130434783
1615,Kenny McLean,SCO,MF,Norwich City,Premier League,27,1992,33.0,44,29,20,18,6,14,42,33.3,28,32,7,25,38,82,67,2,0,2019-2020,1.1515151515151516,1.3333333333333333
1616,Dwight McNeil,ENG,MF,Burnley,Premier League,19,1999,37.1,47,33,18,22,7,23,71,32.4,48,60,8,52,30,77,34,0,0,2019-2020,0.8086253369272237,1.2668463611859837
1617,Scott McTominay,SCO,MF,Manchester Utd,Premier League,22,1996,19.7,43,22,14,25,4,17,32,53.1,15,25,5,20,31,74,34,2,0,2019-2020,1.5736040609137056,2.182741116751269
1618,Biagio Meccariello,ITA,DF,Lecce,Serie A,28,1991,8.5,23,13,15,6,2,12,29,41.4,17,14,2,12,10,33,25,0,0,2019-2020,1.1764705882352942,2.7058823529411766
1619,Gary Medel,CHI,MF,Bologna,Serie A,31,1987,19.8,43,22,15,24,4,16,43,37.2,27,24,8,16,34,77,31,2,0,2019-2020,1.7171717171717171,2.1717171717171717
1620,Ben Mee,ENG,DF,Burnley,Premier League,29,1989,32.0,41,22,25,16,0,17,29,58.6,12,42,31,11,42,83,165,2,0,2019-2020,1.3125,1.28125
1621,Joshua Mees,GER,"MF,FW",Union Berlin,Bundesliga,23,1996,3.6,8,5,3,4,1,4,12,33.3,8,3,0,3,2,10,4,0,0,2019-2020,0.5555555555555556,2.2222222222222223
1622,Admir Mehmedi,SUI,"MF,FW",Wolfsburg,Bundesliga,28,1991,13.3,14,6,2,9,3,4,15,26.7,11,10,0,10,5,19,4,0,0,2019-2020,0.37593984962406013,1.0526315789473684
1623,Soualiho Meïté,FRA,MF,Torino,Serie A,25,1994,24.5,32,18,14,13,5,12,35,34.3,23,31,6,25,24,56,36,0,0,2019-2020,0.9795918367346939,1.3061224489795917
1624,Farid El Melali,ALG,"MF,FW",Angers,Ligue 1,22,1997,3.4,7,5,2,2,3,4,14,28.6,10,5,0,5,2,9,4,0,0,2019-2020,0.5882352941176471,2.058823529411765
1625,Óscar Melendo,ESP,"MF,FW",Espanyol,La Liga,21,1997,12.4,10,4,4,4,2,4,12,33.3,8,7,2,5,2,12,3,0,0,2019-2020,0.16129032258064516,0.8064516129032258
Rk,Player,Nation,Pos,Squad,Comp,0,0,90.0,0,0,3,3,3,Tkl,0,0.0,0,0,0,0,0,0,0,0,0,2019-2020,0.0,0.0
1626,Gonzalo Melero,ESP,MF,Levante,La Liga,25,1994,13.7,20,13,9,9,2,7,27,25.9,20,12,3,9,9,29,15,1,0,2019-2020,0.6569343065693432,1.4598540145985401
1627,Arthur Melo,BRA,MF,Barcelona,La Liga,22,1996,13.1,15,10,4,7,4,4,12,33.3,8,9,0,9,4,19,5,2,0,2019-2020,0.3053435114503817,1.1450381679389314
1628,Memphis,NED,"FW,MF",Lyon,Ligue 1,25,1994,11.3,4,3,2,0,2,0,5,0.0,5,0,0,0,2,6,2,0,0,2019-2020,0.17699115044247787,0.35398230088495575
1629,Pedro Mendes,POR,DF,Montpellier,Ligue 1,28,1990,15.3,28,17,15,13,0,15,24,62.5,9,19,12,7,28,56,42,1,0,2019-2020,1.8300653594771241,1.8300653594771241
1630,Thiago Mendes,BRA,MF,Lyon,Ligue 1,27,1992,20.1,43,29,20,19,4,21,45,46.7,24,21,7,14,46,89,36,0,0,2019-2020,2.288557213930348,2.1393034825870645
1631,Brais Méndez,ESP,"MF,FW",Celta Vigo,La Liga,22,1997,16.4,26,11,14,9,3,12,39,30.8,27,20,0,20,12,38,23,1,0,2019-2020,0.7317073170731708,1.5853658536585367
1632,Édgar Méndez,ESP,"MF,FW",Alavés,La Liga,29,1990,9.6,11,7,4,6,1,5,13,38.5,8,10,2,8,5,16,7,0,0,2019-2020,0.5208333333333334,1.1458333333333335
1633,Stiven Mendoza,COL,"FW,MF",Amiens,Ligue 1,27,1992,12.2,12,7,4,5,3,4,22,18.2,18,13,2,11,9,21,3,1,0,2019-2020,0.7377049180327869,0.9836065573770493
1634,Alexandre Mendy,GNB,FW,Brest,Ligue 1,25,1994,10.0,5,1,1,0,4,1,4,25.0,3,4,1,3,0,5,10,0,0,2019-2020,0.0,0.5
1635,Benjamin Mendy,FRA,DF,Manchester City,Premier League,25,1994,16.6,18,15,7,7,4,9,27,33.3,18,10,2,8,16,34,21,3,0,2019-2020,0.9638554216867469,1.0843373493975903
1636,Edouard Mendy,SEN,GK,Rennes,Ligue 1,27,1992,24.0,0,0,0,0,0,0,0,0.0,0,0,0,0,0,0,5,1,0,2019-2020,0.0,0.0
1637,Ferland Mendy,FRA,DF,Real Madrid,La Liga,24,1995,20.1,32,26,20,9,3,14,18,77.8,4,19,5,14,22,54,30,1,0,2019-2020,1.0945273631840795,1.5920398009950247
1638,Nampalys Mendy,SEN,MF,Leicester City,Premier League,27,1992,3.2,7,5,4,1,2,4,5,80.0,1,4,1,3,6,13,6,0,0,2019-2020,1.875,2.1875
1639,Hamza Mendyl,MAR,DF,Dijon,Ligue 1,21,1997,16.0,49,32,31,14,4,29,46,63.0,17,16,4,12,23,72,47,0,0,2019-2020,1.4375,3.0625
1640,Chris Mepham,WAL,DF,Bournemouth,Premier League,21,1997,10.1,20,9,13,7,0,11,14,78.6,3,17,11,6,17,37,62,1,0,2019-2020,1.6831683168316833,1.9801980198019802
1641,Levent Mercan,GER,"MF,FW",Schalke 04,Bundesliga,18,2000,0.8,0,0,0,0,0,0,0,0.0,0,0,0,0,0,0,2,1,0,2019-2020,0.0,0.0
1642,Jorge Meré,ESP,DF,Köln,Bundesliga,22,1997,6.9,6,5,2,4,0,1,2,50.0,1,13,11,2,14,20,30,0,0,2019-2020,2.0289855072463765,0.8695652173913043
1643,Alex Meret,ITA,GK,Napoli,Serie A,22,1997,21.7,0,0,0,0,0,0,2,0.0,2,1,0,1,1,1,7,2,0,2019-2020,0.04608294930875576,0.0
1644,Fran Mérida,ESP,MF,Osasuna,La Liga,29,1990,12.9,27,15,11,10,6,9,27,33.3,18,15,4,11,25,52,10,0,0,2019-2020,1.937984496124031,2.093023255813953
1645,Mikel Merino,ESP,MF,Real Sociedad,La Liga,23,1996,34.9,79,52,20,44,15,28,86,32.6,58,46,8,38,51,130,52,0,0,2019-2020,1.4613180515759312,2.2636103151862463
1646,Sabin Merino,ESP,FW,Leganés,La Liga,27,1992,0.9,0,0,0,0,0,0,0,0.0,0,0,0,0,0,0,0,0,0,2019-2020,0.0,0.0
1647,Yıldırım Mert Çetin,TUR,DF,Roma,Serie A,22,1997,2.9,5,1,4,1,0,3,5,60.0,2,4,3,1,4,9,8,1,0,2019-2020,1.3793103448275863,1.7241379310344829
1648,Dries Mertens,BEL,FW,Napoli,Serie A,32,1987,18.8,13,9,1,8,4,2,27,7.4,25,10,1,9,7,20,4,0,0,2019-2020,0.3723404255319149,0.6914893617021276
1649,Roque Mesa,ESP,MF,Leganés,La Liga,30,1989,22.4,40,21,17,18,5,13,44,29.5,31,13,4,9,11,51,8,0,0,2019-2020,0.4910714285714286,1.7857142857142858
1650,Lionel Messi,ARG,FW,Barcelona,La Liga,32,1987,32.0,21,10,4,7,10,3,21,14.3,18,9,0,9,7,28,1,0,0,2019-2020,0.21875,0.65625
Rk,Player,Nation,Pos,Squad,Comp,0,0,90.0,0,0,3,3,3,Tkl,0,0.0,0,0,0,0,0,0,0,0,0,2019-2020,0.0,0.0
1651,Thomas Meunier,BEL,DF,Paris S-G,Ligue 1,27,1991,13.8,27,21,9,12,6,16,26,61.5,10,17,5,12,18,45,19,1,0,2019-2020,1.3043478260869565,1.9565217391304346
1652,Mexer,MOZ,DF,Bordeaux,Ligue 1,30,1988,16.5,16,11,14,1,1,10,30,33.3,20,14,13,1,15,31,47,0,0,2019-2020,0.9090909090909091,0.9696969696969697
1653,Max Meyer,GER,"MF,FW",Crystal Palace,Premier League,23,1995,7.3,19,11,10,9,0,8,18,44.4,10,6,1,5,7,26,4,0,0,2019-2020,0.9589041095890412,2.6027397260273974
1654,Kingsley Michael,NGA,MF,Bologna,Serie A,19,1999,0.8,2,1,0,2,0,0,0,0.0,0,0,0,0,1,3,1,0,0,2019-2020,1.25,2.5
1655,Míchel,ESP,MF,Valladolid,La Liga,31,1988,24.2,50,28,26,19,5,22,75,29.3,53,22,4,18,33,83,41,1,0,2019-2020,1.3636363636363638,2.066115702479339
1656,Sven Michel,GER,FW,Paderborn 07,Bundesliga,29,1990,15.3,14,12,3,5,6,3,20,15.0,17,13,2,11,7,21,7,0,0,2019-2020,0.45751633986928103,0.9150326797385621
1657,Miguel,ESP,FW,Valladolid,La Liga,19,1999,2.6,2,1,1,0,1,1,2,50.0,1,3,1,2,0,2,1,0,0,2019-2020,0.0,0.7692307692307692
1658,Florian Miguel,FRA,DF,Nîmes,Ligue 1,22,1996,22.8,51,25,27,20,4,31,52,59.6,21,19,4,15,33,84,32,0,0,2019-2020,1.4473684210526316,2.236842105263158
1659,Georges Mikautadze,GEO,FW,Metz,Ligue 1,18,2000,0.1,1,0,0,0,1,0,0,0.0,0,0,0,0,0,1,0,0,0,2019-2020,0.0,10.0
1660,Nikola Milenković,SRB,DF,Fiorentina,Serie A,21,1997,36.2,46,25,30,16,0,11,31,35.5,20,39,21,18,29,75,129,1,0,2019-2020,0.8011049723756906,1.2707182320441988
1661,Arkadiusz Milik,POL,FW,Napoli,Serie A,25,1994,19.4,12,5,4,1,7,3,11,27.3,8,11,1,10,2,14,12,0,0,2019-2020,0.10309278350515465,0.6185567010309279
1662,Sergej Milinković-Savić,SRB,MF,Lazio,Serie A,24,1995,33.7,60,35,25,24,11,15,79,19.0,64,67,16,51,37,97,60,1,0,2019-2020,1.0979228486646884,1.780415430267062
1663,Éder Militão,BRA,DF,Real Madrid,La Liga,21,1998,11.4,25,15,15,9,1,10,17,58.8,7,12,6,6,20,45,42,0,0,2019-2020,1.7543859649122806,2.1929824561403506
1664,Luka Milivojević,SRB,MF,Crystal Palace,Premier League,28,1991,27.9,61,32,32,25,4,35,84,41.7,49,30,7,23,42,103,39,4,0,2019-2020,1.5053763440860215,2.186379928315412
1665,Vincenzo Millico,ITA,"MF,FW",Torino,Serie A,18,2000,2.4,1,0,1,0,0,1,3,33.3,2,2,0,2,0,1,1,0,0,2019-2020,0.0,0.4166666666666667
1666,James Milner,ENG,"MF,DF",Liverpool,Premier League,33,1986,10.4,16,10,3,10,3,6,26,23.1,20,12,3,9,7,23,17,1,0,2019-2020,0.673076923076923,1.5384615384615383
1667,Santi Mina,ESP,"FW,MF",Celta Vigo,La Liga,23,1995,21.6,13,8,8,5,0,5,38,13.2,33,19,2,17,10,23,27,0,0,2019-2020,0.4629629629629629,0.6018518518518519
1668,Yerry Mina,COL,DF,Everton,Premier League,24,1994,25.4,39,22,25,12,2,18,24,75.0,6,20,14,6,28,67,102,1,0,2019-2020,1.1023622047244095,1.535433070866142
1669,Takumi Minamino,JPN,"FW,MF",Liverpool,Premier League,24,1995,2.8,3,3,0,2,1,2,10,20.0,8,3,0,3,0,3,3,0,0,2019-2020,0.0,1.0714285714285714
1670,Tyrone Mings,ENG,DF,Aston Villa,Premier League,26,1993,32.2,15,11,11,3,1,10,13,76.9,3,56,48,8,30,45,190,4,0,2019-2020,0.9316770186335402,0.4658385093167701
1671,Jorge Miramón,ESP,DF,Levante,La Liga,30,1989,27.0,52,27,35,13,4,26,45,57.8,19,30,8,22,46,98,61,1,0,2019-2020,1.7037037037037037,1.9259259259259258
1672,Juan Miranda,ESP,DF,Schalke 04,Bundesliga,19,2000,8.7,14,10,8,6,0,6,18,33.3,12,12,4,8,10,24,27,1,0,2019-2020,1.149425287356322,1.6091954022988506
1673,Antonio Mirante,ITA,GK,Roma,Serie A,36,1983,5.0,0,0,0,0,0,0,1,0.0,1,0,0,0,0,0,2,1,0,2019-2020,0.0,0.0
1674,Simone Missiroli,ITA,MF,SPAL,Serie A,33,1986,31.1,42,27,18,20,4,13,43,30.2,30,42,27,15,54,96,62,1,0,2019-2020,1.7363344051446945,1.35048231511254
1675,Tyrick Mitchell,ENG,DF,Crystal Palace,Premier League,19,1999,2.2,5,2,2,2,1,1,7,14.3,6,2,0,2,2,7,3,0,0,2019-2020,0.9090909090909091,2.2727272727272725
Rk,Player,Nation,Pos,Squad,Comp,0,0,90.0,0,0,3,3,3,Tkl,0,0.0,0,0,0,0,0,0,0,0,0,2019-2020,0.0,0.0
1676,Stefan Mitrović,SRB,DF,Strasbourg,Ligue 1,29,1990,22.8,15,9,10,5,0,6,14,42.9,8,14,9,5,23,38,90,3,0,2019-2020,1.0087719298245614,0.6578947368421052
1677,Maximilian Mittelstädt,GER,"DF,FW",Hertha BSC,Bundesliga,22,1997,21.0,61,38,31,25,5,26,54,48.1,28,38,6,32,53,114,64,0,0,2019-2020,2.5238095238095237,2.9047619047619047
1678,Henrikh Mkhitaryan,ARM,FW,Arsenal,Premier League,30,1989,1.2,0,0,0,0,0,0,2,0.0,2,3,0,3,0,0,1,0,0,2019-2020,0.0,0.0
1679,Henrikh Mkhitaryan,ARM,"MF,FW",Roma,Serie A,30,1989,17.0,32,22,10,17,5,19,45,42.2,26,27,3,24,11,43,6,0,0,2019-2020,0.6470588235294118,1.8823529411764706
1680,Anthony Modeste,FRA,FW,Köln,Bundesliga,31,1988,12.6,10,5,1,5,4,1,10,10.0,9,5,3,2,0,10,19,0,0,2019-2020,0.0,0.7936507936507937
1681,Luka Modrić,CRO,MF,Real Madrid,La Liga,33,1985,22.2,37,18,9,15,13,16,41,39.0,25,10,2,8,22,59,12,0,0,2019-2020,0.990990990990991,1.6666666666666667
1682,Kevin Möhwald,GER,MF,Werder Bremen,Bundesliga,26,1993,0.8,2,1,1,1,0,1,2,50.0,1,0,0,0,0,2,1,0,0,2019-2020,0.0,2.5
1683,Niklas Moisander,FIN,DF,Werder Bremen,Bundesliga,33,1985,22.0,27,15,19,6,2,11,26,42.3,15,37,19,18,49,76,85,0,0,2019-2020,2.227272727272727,1.2272727272727273
1684,Jorge Molina,ESP,FW,Getafe,La Liga,37,1982,21.0,8,2,0,4,4,0,12,0.0,12,13,2,11,4,12,18,0,0,2019-2020,0.19047619047619047,0.38095238095238093
1685,Florent Mollet,FRA,"MF,FW",Montpellier,Ligue 1,27,1991,18.7,13,11,3,8,2,7,28,25.0,21,9,1,8,9,22,2,0,0,2019-2020,0.4812834224598931,0.6951871657754011
1686,Jon Moncayola,ESP,"MF,DF",Osasuna,La Liga,21,1998,16.6,52,30,26,22,4,27,54,50.0,27,29,5,24,16,68,23,1,0,2019-2020,0.9638554216867469,3.1325301204819276
1687,Gabriele Moncini,ITA,"FW,MF",SPAL,Serie A,23,1996,1.7,1,0,0,1,0,0,0,0.0,0,2,1,1,1,2,0,0,0,2019-2020,0.5882352941176471,0.5882352941176471
1688,Thomas Monconduit,FRA,MF,Amiens,Ligue 1,28,1991,15.2,26,12,6,18,2,9,26,34.6,17,11,4,7,10,36,25,3,0,2019-2020,0.6578947368421053,1.7105263157894737
1689,Nacho Monreal,ESP,DF,Arsenal,Premier League,33,1986,3.0,1,1,1,0,0,1,3,33.3,2,3,1,2,3,4,10,0,0,2019-2020,1.0,0.3333333333333333
1690,Nacho Monreal,ESP,DF,Real Sociedad,La Liga,33,1986,26.6,38,16,26,9,3,22,42,52.4,20,20,4,16,43,81,66,0,0,2019-2020,1.6165413533834585,1.4285714285714286
1691,Joan Monterde,ESP,MF,Levante,La Liga,21,1997,0.1,0,0,0,0,0,0,0,0.0,0,0,0,0,0,0,0,0,0,2019-2020,0.0,0.0
1692,Ilario Monterisi,ITA,DF,Lecce,Serie A,17,2001,0.0,0,0,0,0,0,0,0,0.0,0,0,0,0,0,0,0,0,0,2019-2020,,
1693,Ángel Montoro,ESP,MF,Granada,La Liga,31,1988,10.8,19,8,8,9,2,3,13,23.1,10,10,1,9,13,32,15,0,0,2019-2020,1.2037037037037037,1.759259259259259
1694,Martín Montoya,ESP,"DF,MF",Brighton,Premier League,28,1991,21.1,57,29,31,20,6,30,56,53.6,26,19,5,14,24,81,40,0,0,2019-2020,1.1374407582938388,2.701421800947867
1695,Simon Moore,ENG,GK,Sheffield Utd,Premier League,29,1990,2.0,1,0,1,0,0,1,1,100.0,0,0,0,0,0,1,0,1,0,2019-2020,0.0,0.5
1696,Aaron Mooy,AUS,"MF,FW",Brighton,Premier League,28,1990,23.2,37,24,9,18,10,6,40,15.0,34,36,7,29,23,60,32,1,0,2019-2020,0.9913793103448276,1.5948275862068966
1697,Wesley Moraes,BRA,FW,Aston Villa,Premier League,22,1996,19.8,15,8,3,8,4,0,5,0.0,5,10,2,8,4,19,23,0,0,2019-2020,0.20202020202020202,0.7575757575757576
1698,Alfredo Morales,USA,MF,Düsseldorf,Bundesliga,29,1990,19.2,31,15,11,16,4,11,35,31.4,24,17,6,11,18,49,37,0,0,2019-2020,0.9375,1.6145833333333335
1699,Álvaro Morata,ESP,FW,Atlético Madrid,La Liga,26,1992,23.3,17,8,4,9,4,1,13,7.7,12,12,2,10,5,22,23,0,0,2019-2020,0.2145922746781116,0.7296137339055794
1700,Jan Morávek,CZE,MF,Augsburg,Bundesliga,29,1989,5.3,23,12,9,14,0,11,24,45.8,13,4,1,3,8,31,11,0,0,2019-2020,1.509433962264151,4.339622641509434
Rk,Player,Nation,Pos,Squad,Comp,0,0,90.0,0,0,3,3,3,Tkl,0,0.0,0,0,0,0,0,0,0,0,0,2019-2020,0.0,0.0
1701,Steven Moreira,CPV,DF,Toulouse,Ligue 1,24,1994,15.4,37,25,21,15,1,19,31,61.3,12,16,3,13,16,53,29,0,0,2019-2020,1.0389610389610389,2.4025974025974026
1702,Jérémy Morel,MAD,DF,Rennes,Ligue 1,35,1984,20.1,15,9,13,1,1,9,20,45.0,11,21,17,4,17,32,59,1,0,2019-2020,0.8457711442786069,0.7462686567164178
1703,Alberto Moreno,ESP,DF,Villarreal,La Liga,27,1992,16.3,27,16,15,11,1,9,25,36.0,16,15,3,12,25,52,36,0,0,2019-2020,1.5337423312883436,1.656441717791411
1704,Álex Moreno,ESP,DF,Betis,La Liga,26,1993,25.2,37,20,27,8,2,12,32,37.5,20,21,8,13,23,60,47,1,0,2019-2020,0.9126984126984127,1.4682539682539684
1705,Gerard Moreno,ESP,"FW,MF",Villarreal,La Liga,27,1992,30.5,19,8,4,10,5,5,46,10.9,41,19,3,16,10,29,51,0,0,2019-2020,0.32786885245901637,0.6229508196721312
1706,Mateu Morey,ESP,"DF,MF",Dortmund,Bundesliga,19,2000,2.2,7,3,2,4,1,4,10,40.0,6,4,0,4,5,12,3,0,0,2019-2020,2.2727272727272725,3.1818181818181817
1707,Wes Morgan,JAM,DF,Leicester City,Premier League,35,1984,4.8,4,1,3,1,0,0,3,0.0,3,5,3,2,7,11,19,0,0,2019-2020,1.4583333333333335,0.8333333333333334
1708,Manu Morlanes,ESP,MF,Villarreal,La Liga,20,1999,2.8,7,3,3,4,0,2,9,22.2,7,1,1,0,2,9,2,0,0,2019-2020,0.7142857142857143,2.5
1709,Raúl Moro,ESP,FW,Lazio,Serie A,16,2002,0.0,0,0,0,0,0,0,0,0.0,0,0,0,0,0,0,0,0,0,2019-2020,,
1710,Loren Morón,ESP,FW,Betis,La Liga,25,1993,22.6,18,12,6,7,5,9,23,39.1,14,25,6,19,9,27,13,0,0,2019-2020,0.3982300884955752,0.7964601769911503
1711,Leonardo Morosini,ITA,"FW,DF",Brescia,Serie A,23,1995,0.3,1,1,1,0,0,0,0,0.0,0,1,0,1,1,2,1,0,0,2019-2020,3.3333333333333335,3.3333333333333335
1712,Ravel Morrison,JAM,MF,Sheffield Utd,Premier League,26,1993,0.1,0,0,0,0,0,0,0,0.0,0,0,0,0,0,0,0,0,0,2019-2020,0.0,0.0
1713,Victor Moses,NGA,DF,Inter,Serie A,28,1990,4.7,4,3,1,2,1,2,8,25.0,6,4,0,4,0,4,4,0,0,2019-2020,0.0,0.851063829787234
1714,Lebo Mothiba,RSA,FW,Strasbourg,Ligue 1,23,1996,11.6,4,3,1,1,2,1,6,16.7,5,5,0,5,3,7,1,0,0,2019-2020,0.25862068965517243,0.3448275862068966
1715,Harold Moukoudi,CMR,DF,Saint-Étienne,Ligue 1,21,1997,11.0,28,19,20,7,1,11,14,78.6,3,16,10,6,16,44,42,2,0,2019-2020,1.4545454545454546,2.5454545454545454
1716,Jessy Moulin,FRA,GK,Saint-Étienne,Ligue 1,33,1986,5.0,0,0,0,0,0,0,0,0.0,0,0,0,0,1,1,2,0,0,2019-2020,0.2,0.0
1717,Mason Mount,ENG,"MF,FW",Chelsea,Premier League,20,1999,31.9,37,17,8,19,10,9,42,21.4,33,25,3,22,16,53,18,0,0,2019-2020,0.5015673981191223,1.1598746081504703
1718,Lucas Moura,BRA,"FW,MF",Tottenham,Premier League,26,1992,24.9,57,33,25,22,10,16,58,27.6,42,29,2,27,15,72,27,0,0,2019-2020,0.6024096385542169,2.289156626506024
1719,Lys Mousset,FRA,FW,Sheffield Utd,Premier League,23,1996,13.8,9,5,0,5,4,3,7,42.9,4,3,0,3,4,13,2,0,0,2019-2020,0.2898550724637681,0.6521739130434783
1720,Wesley Moustache,FRA,DF,Nantes,Ligue 1,20,1999,0.5,0,0,0,0,0,0,0,0.0,0,1,0,1,0,0,2,0,0,2019-2020,0.0,0.0
1721,João Moutinho,POR,MF,Wolves,Premier League,32,1986,34.5,93,50,43,41,9,46,139,33.1,93,43,13,30,50,143,18,1,0,2019-2020,1.4492753623188406,2.6956521739130435
1722,Samuel Moutoussamy,COD,"DF,MF",Nantes,Ligue 1,22,1996,5.8,4,1,2,1,1,2,7,28.6,5,2,0,2,4,8,7,0,0,2019-2020,0.6896551724137931,0.6896551724137931
1723,Toni Moya,ESP,MF,Atlético Madrid,La Liga,21,1998,0.0,0,0,0,0,0,0,0,0.0,0,0,0,0,0,0,0,0,0,2019-2020,,
1724,Javi Moyano,ESP,DF,Valladolid,La Liga,33,1986,24.7,19,8,11,8,0,8,20,40.0,12,18,5,13,27,46,63,0,0,2019-2020,1.0931174089068827,0.7692307692307693
1725,Nordi Mukiele,FRA,"DF,FW",RB Leipzig,Bundesliga,21,1997,19.8,61,39,39,12,10,25,38,65.8,13,26,4,22,47,108,57,0,0,2019-2020,2.3737373737373737,3.080808080808081
Rk,Player,Nation,Pos,Squad,Comp,0,0,90.0,0,0,3,3,3,Tkl,0,0.0,0,0,0,0,0,0,0,0,0,2019-2020,0.0,0.0
1726,Mert Müldür,TUR,DF,Sassuolo,Serie A,20,1999,14.1,47,27,33,8,6,27,42,64.3,15,10,0,10,22,69,42,0,0,2019-2020,1.5602836879432624,3.3333333333333335
1727,Florian Müller,GER,GK,Mainz 05,Bundesliga,21,1997,12.5,0,0,0,0,0,0,0,0.0,0,0,0,0,2,2,3,1,0,2019-2020,0.16,0.0
1728,Thomas Müller,GER,"MF,FW",Bayern Munich,Bundesliga,29,1989,25.1,45,27,7,26,12,22,69,31.9,47,27,3,24,12,57,8,0,0,2019-2020,0.4780876494023904,1.792828685258964
1729,Marshall Munetsi,ZIM,MF,Reims,Ligue 1,23,1996,9.3,27,19,12,12,3,6,12,50.0,6,13,7,6,12,39,20,1,0,2019-2020,1.2903225806451613,2.9032258064516125
1730,Iker Muniain,ESP,"FW,MF",Athletic Club,La Liga,26,1992,26.5,26,19,11,10,5,4,24,16.7,20,9,0,9,12,38,7,0,0,2019-2020,0.4528301886792453,0.9811320754716981
1731,Aihen Muñoz,ESP,DF,Real Sociedad,La Liga,21,1997,10.9,28,18,13,12,3,18,27,66.7,9,13,2,11,2,30,19,0,0,2019-2020,0.18348623853211007,2.568807339449541
1732,Javier Muñoz,ESP,"FW,MF",Alavés,La Liga,24,1995,0.6,0,0,0,0,0,0,0,0.0,0,1,1,0,0,0,0,0,0,2019-2020,0.0,0.0
1733,Simone Muratore,ITA,MF,Juventus,Serie A,21,1998,1.8,2,0,0,1,1,1,3,33.3,2,1,0,1,3,5,0,0,0,2019-2020,1.6666666666666665,1.1111111111111112
1734,Alessandro Murgia,ITA,MF,SPAL,Serie A,22,1996,19.4,27,17,16,8,3,14,34,41.2,20,10,3,7,18,45,15,0,0,2019-2020,0.9278350515463918,1.3917525773195878
1735,Luis Muriel,COL,FW,Atalanta,Serie A,28,1991,14.0,15,9,3,8,4,3,14,21.4,11,12,0,12,4,19,0,0,0,2019-2020,0.2857142857142857,1.0714285714285714
1736,Jeison Murillo,COL,DF,Sampdoria,Serie A,27,1992,7.4,18,6,14,4,0,10,19,52.6,9,8,4,4,10,28,28,0,0,2019-2020,1.3513513513513513,2.4324324324324325
1737,Jeison Murillo,COL,DF,Celta Vigo,La Liga,27,1992,17.0,37,20,30,6,1,18,27,66.7,9,13,9,4,20,57,74,2,0,2019-2020,1.1764705882352942,2.176470588235294
1738,Glenn Murray,ENG,FW,Brighton,Premier League,35,1983,8.9,5,2,0,3,2,2,9,22.2,7,6,2,4,1,6,12,0,0,2019-2020,0.11235955056179775,0.5617977528089887
1739,Nicola Murru,ITA,DF,Sampdoria,Serie A,24,1994,25.1,40,22,24,8,8,21,41,51.2,20,22,4,18,27,67,58,0,0,2019-2020,1.0756972111553784,1.593625498007968
1740,Mateo Musacchio,ARG,DF,Milan,Serie A,28,1990,16.3,15,8,11,4,0,7,20,35.0,13,10,7,3,22,37,50,0,0,2019-2020,1.3496932515337423,0.920245398773006
1741,Torben Müsel,GER,FW,Gladbach,Bundesliga,20,1999,0.0,0,0,0,0,0,0,0,0.0,0,0,0,0,1,1,0,0,0,2019-2020,inf,
1742,Jamal Musiala,GER,MF,Bayern Munich,Bundesliga,16,2003,0.0,0,0,0,0,0,0,0,0.0,0,0,0,0,0,0,0,0,0,2019-2020,,
1743,Juan Musso,ARG,GK,Udinese,Serie A,25,1994,38.0,0,0,0,0,0,0,1,0.0,1,0,0,0,1,1,18,2,0,2019-2020,0.02631578947368421,0.0
1744,Shkodran Mustafi,GER,DF,Arsenal,Premier League,27,1992,13.4,17,10,11,5,1,6,12,50.0,6,10,6,4,18,35,72,0,0,2019-2020,1.3432835820895521,1.2686567164179103
1745,Yoshinori Mutō,JPN,"MF,FW",Newcastle Utd,Premier League,27,1992,2.4,3,2,1,2,0,1,2,50.0,1,0,0,0,0,3,0,0,0,2019-2020,0.0,1.25
1746,Yvon Mvogo,SUI,GK,RB Leipzig,Bundesliga,25,1994,2.0,0,0,0,0,0,0,0,0.0,0,0,0,0,0,0,0,1,0,2019-2020,0.0,0.0
1747,Phillipp Mwene,AUT,DF,Mainz 05,Bundesliga,25,1994,3.5,11,5,9,2,0,7,12,58.3,5,10,1,9,3,14,11,0,0,2019-2020,0.8571428571428571,3.142857142857143
1748,Obite N'Dicka,CIV,DF,Eint Frankfurt,Bundesliga,19,1999,19.1,27,13,13,11,3,15,28,53.6,13,28,6,22,29,56,57,0,0,2019-2020,1.5183246073298429,1.413612565445026
1749,Kévin N'Doram,FRA,MF,Metz,Ligue 1,23,1996,18.3,43,28,19,21,3,17,40,42.5,23,20,8,12,26,69,23,0,0,2019-2020,1.4207650273224044,2.349726775956284
1750,Abdallah N'dour,SEN,DF,Strasbourg,Ligue 1,25,1993,4.1,5,4,2,3,0,5,10,50.0,5,4,1,3,4,9,5,1,0,2019-2020,0.9756097560975611,1.2195121951219514
Rk,Player,Nation,Pos,Squad,Comp,0,0,90.0,0,0,3,3,3,Tkl,0,0.0,0,0,0,0,0,0,0,0,0,2019-2020,0.0,0.0
1751,Ferris N'Goma,FRA,"MF,FW",Brest,Ligue 1,26,1993,0.3,0,0,0,0,0,0,0,0.0,0,1,0,1,0,0,0,0,0,2019-2020,0.0,0.0
1752,Nathan N'Goumou,FRA,FW,Toulouse,Ligue 1,19,2000,0.1,0,0,0,0,0,0,0,0.0,0,0,0,0,0,0,1,0,0,2019-2020,0.0,0.0
1753,Georges-Kévin N'Koudou,CMR,FW,Tottenham,Premier League,24,1995,0.0,0,0,0,0,0,0,1,0.0,1,0,0,0,0,0,0,0,0,2019-2020,,
1754,Stanley N'Soki,FRA,DF,Nice,Ligue 1,20,1999,14.1,40,29,24,16,0,23,42,54.8,19,14,6,8,32,72,37,0,0,2019-2020,2.269503546099291,2.8368794326241136
1755,Nacho,ESP,DF,Valladolid,La Liga,30,1989,21.0,43,22,24,15,4,17,48,35.4,31,36,8,28,25,68,61,0,0,2019-2020,1.1904761904761905,2.0476190476190474
1756,Nacho,ESP,DF,Real Madrid,La Liga,29,1990,4.9,11,6,6,3,2,6,10,60.0,4,5,3,2,12,23,18,1,0,2019-2020,2.4489795918367343,2.2448979591836733
1757,Radja Nainggolan,BEL,MF,Cagliari,Serie A,31,1988,23.0,30,18,9,12,9,9,29,31.0,20,25,6,19,13,43,30,0,0,2019-2020,0.5652173913043478,1.3043478260869565
1758,Marvelous Nakamba,ZIM,MF,Aston Villa,Premier League,25,1994,20.4,55,28,28,20,7,24,67,35.8,43,50,11,39,39,94,38,3,0,2019-2020,1.911764705882353,2.696078431372549
1759,Naldo,BRA,DF,Espanyol,La Liga,30,1988,14.8,24,13,15,9,0,7,15,46.7,8,11,7,4,21,45,50,1,0,2019-2020,1.4189189189189189,1.6216216216216215
1760,Nahitan Nández,URU,"MF,DF",Cagliari,Serie A,23,1995,32.2,58,38,37,17,4,25,69,36.2,44,30,1,29,25,83,26,0,0,2019-2020,0.7763975155279502,1.8012422360248446
1761,Matija Nastasić,SRB,DF,Schalke 04,Bundesliga,26,1993,15.2,26,16,17,9,0,14,17,82.4,3,28,16,12,22,48,79,0,0,2019-2020,1.4473684210526316,1.7105263157894737
1762,Marc Navarro,ESP,"FW,DF",Leganés,La Liga,24,1995,2.4,3,3,2,1,0,1,1,100.0,0,2,1,1,0,3,3,0,0,2019-2020,0.0,1.25
1763,Ximo Navarro,ESP,DF,Alavés,La Liga,29,1990,21.1,34,19,17,15,2,16,28,57.1,12,20,7,13,52,86,76,2,0,2019-2020,2.4644549763033172,1.6113744075829384
1764,Jesús Navas,ESP,DF,Sevilla,La Liga,33,1985,37.4,27,15,16,7,4,15,32,46.9,17,20,7,13,31,58,70,0,0,2019-2020,0.8288770053475936,0.7219251336898396
1765,Keylor Navas,CRC,GK,Paris S-G,Ligue 1,32,1986,21.0,0,0,0,0,0,0,0,0.0,0,1,0,1,0,0,4,2,0,2019-2020,0.0,0.0
1766,Raúl Navas,ESP,DF,Osasuna,La Liga,31,1988,7.9,10,5,4,6,0,4,13,30.8,9,10,4,6,18,28,30,0,0,2019-2020,2.2784810126582276,1.2658227848101264
1767,Michel Ndary Adopo,FRA,"DF,MF",Torino,Serie A,19,2000,0.0,0,0,0,0,0,0,0,0.0,0,1,1,0,0,0,0,0,0,2019-2020,,
1768,Papa Ndiaga Yade,MTN,FW,Metz,Ligue 1,19,2000,0.0,0,0,0,0,0,0,0,0.0,0,0,0,0,0,0,0,0,0,2019-2020,,
1769,Wilfred Ndidi,NGA,MF,Leicester City,Premier League,22,1996,29.7,128,67,56,61,11,45,91,49.5,46,52,6,46,80,208,69,3,0,2019-2020,2.6936026936026938,4.30976430976431
1770,Emanuele Ndoj,ALB,MF,Brescia,Serie A,22,1996,6.2,9,6,2,6,1,3,13,23.1,10,7,0,7,5,14,5,0,0,2019-2020,0.8064516129032258,1.4516129032258065
1771,Tanguy Ndombele,FRA,MF,Tottenham,Premier League,22,1996,11.2,24,16,10,13,1,9,22,40.9,13,20,3,17,14,38,7,0,0,2019-2020,1.25,2.142857142857143
1772,Reiss Nelson,ENG,FW,Arsenal,Premier League,19,1999,7.0,11,8,5,4,2,7,17,41.2,10,13,2,11,3,14,3,0,0,2019-2020,0.42857142857142855,1.5714285714285714
1773,Ilija Nestorovski,MKD,FW,Udinese,Serie A,29,1990,13.9,10,7,5,5,0,6,21,28.6,15,13,2,11,4,14,12,0,0,2019-2020,0.28776978417266186,0.7194244604316546
1774,Neto,BRA,GK,Barcelona,La Liga,30,1989,2.0,0,0,0,0,0,0,0,0.0,0,0,0,0,0,0,1,0,0,2019-2020,0.0,0.0
1775,Pedro Neto,POR,"FW,MF",Wolves,Premier League,19,2000,10.4,9,4,3,6,0,4,15,26.7,11,2,0,2,6,15,4,0,0,2019-2020,0.5769230769230769,0.8653846153846153
Rk,Player,Nation,Pos,Squad,Comp,0,0,90.0,0,0,3,3,3,Tkl,0,0.0,0,0,0,0,0,0,0,0,0,2019-2020,0.0,0.0
1776,Manuel Neuer,GER,GK,Bayern Munich,Bundesliga,33,1986,33.0,2,1,1,0,1,2,4,50.0,2,0,0,0,0,2,15,4,0,2019-2020,0.0,0.06060606060606061
1777,Florian Neuhaus,GER,MF,Gladbach,Bundesliga,22,1997,26.2,42,23,13,22,7,12,54,22.2,42,24,4,20,27,69,8,0,0,2019-2020,1.0305343511450382,1.6030534351145038
1778,Carlos Neva,ESP,DF,Granada,La Liga,23,1996,24.5,16,11,12,3,1,9,21,42.9,12,15,2,13,28,44,60,0,0,2019-2020,1.1428571428571428,0.6530612244897959
1779,Rúben Neves,POR,MF,Wolves,Premier League,22,1997,34.0,62,33,27,32,3,34,86,39.5,52,38,9,29,56,118,34,1,0,2019-2020,1.6470588235294117,1.8235294117647058
1780,Neymar,BRA,"MF,FW",Paris S-G,Ligue 1,27,1992,14.6,12,7,1,9,2,3,21,14.3,18,10,0,10,4,16,1,0,0,2019-2020,0.273972602739726,0.8219178082191781
1781,Jeremy Ngakia,ENG,DF,West Ham,Premier League,18,2000,4.9,15,7,10,5,0,9,21,42.9,12,6,1,5,7,22,16,0,0,2019-2020,1.4285714285714284,3.061224489795918
1782,Jessic Ngankam,GER,"FW,MF",Hertha BSC,Bundesliga,19,2000,0.9,2,2,1,1,0,2,2,100.0,0,2,0,2,0,2,1,0,0,2019-2020,0.0,2.2222222222222223
1783,Muzinga Ngonda,COD,DF,Dijon,Ligue 1,24,1994,6.0,15,6,10,3,2,7,10,70.0,3,5,4,1,11,26,23,0,0,2019-2020,1.8333333333333333,2.5
1784,Ahmad Ngouyamsa,CMR,DF,Dijon,Ligue 1,18,2000,0.6,1,0,1,0,0,0,3,0.0,3,1,1,0,1,2,5,0,0,2019-2020,1.6666666666666667,1.6666666666666667
1785,Opa Nguette,SEN,FW,Metz,Ligue 1,25,1994,20.3,44,28,23,15,6,11,39,28.2,28,17,3,14,12,56,12,0,0,2019-2020,0.5911330049261083,2.167487684729064
1786,Moussa Niakhate,SEN,DF,Mainz 05,Bundesliga,23,1996,33.0,35,22,29,6,0,16,29,55.2,13,40,26,14,40,75,124,4,0,2019-2020,1.2121212121212122,1.0606060606060606
1787,Ibrahima Niane,SEN,FW,Metz,Ligue 1,20,1999,10.6,8,7,2,5,1,5,16,31.3,11,5,1,4,10,18,11,1,0,2019-2020,0.9433962264150944,0.7547169811320755
1788,M'Baye Niang,SEN,FW,Rennes,Ligue 1,24,1994,23.6,17,10,3,11,3,6,21,28.6,15,10,1,9,5,22,20,0,0,2019-2020,0.211864406779661,0.7203389830508474
1789,Tanguy Nianzou,FRA,"DF,MF",Paris S-G,Ligue 1,17,2002,5.0,2,1,0,1,1,1,3,33.3,2,4,2,2,3,5,6,0,0,2019-2020,0.6,0.4
1790,Cheikh Niasse,SEN,MF,Lille,Ligue 1,19,2000,0.2,0,0,0,0,0,0,0,0.0,0,0,0,0,0,0,0,0,0,2019-2020,0.0,0.0
1791,Oumar Niasse,SEN,FW,Everton,Premier League,29,1990,0.2,4,0,0,2,2,0,0,0.0,0,0,0,0,1,5,0,0,0,2019-2020,5.0,20.0
1792,Moritz Nicolas,GER,GK,Union Berlin,Bundesliga,21,1997,1.0,0,0,0,0,0,0,0,0.0,0,0,0,0,0,0,0,0,0,2019-2020,0.0,0.0
1793,Florian Niederlechner,GER,"FW,MF",Augsburg,Bundesliga,28,1990,30.2,21,13,7,9,5,4,21,19.0,17,21,5,16,8,29,38,0,0,2019-2020,0.26490066225165565,0.695364238410596
1794,Saúl Ñíguez,ESP,"MF,DF",Atlético Madrid,La Liga,24,1994,34.1,95,59,44,42,9,39,88,44.3,49,58,13,45,55,150,68,1,0,2019-2020,1.6129032258064515,2.785923753665689
1795,Casimir Ninga,CHA,"MF,FW",Angers,Ligue 1,26,1993,7.6,5,5,4,0,1,1,5,20.0,4,5,0,5,3,8,2,0,0,2019-2020,0.39473684210526316,0.6578947368421053
1796,Fernando Niño,ESP,FW,Villarreal,La Liga,18,2000,0.9,1,0,0,1,0,1,2,50.0,1,0,0,0,0,1,2,0,0,2019-2020,0.0,1.1111111111111112
1797,Timothée Nkada,FRA,FW,Reims,Ligue 1,20,1999,1.6,1,0,1,0,0,0,1,0.0,1,0,0,0,0,1,1,0,0,2019-2020,0.0,0.625
1798,Eddie Nketiah,ENG,FW,Arsenal,Premier League,20,1999,7.0,7,5,3,4,0,2,6,33.3,4,9,0,9,2,9,5,0,0,2019-2020,0.2857142857142857,1.0
1799,Nicolas Nkoulou,CMR,DF,Torino,Serie A,29,1990,29.9,34,24,21,11,2,16,22,72.7,6,40,18,22,70,104,138,2,0,2019-2020,2.3411371237458196,1.1371237458193981
1800,Christopher Nkunku,FRA,"MF,FW",RB Leipzig,Bundesliga,21,1997,21.4,21,13,4,11,6,9,33,27.3,24,25,2,23,20,41,8,0,0,2019-2020,0.9345794392523366,0.9813084112149534
Rk,Player,Nation,Pos,Squad,Comp,0,0,90.0,0,0,3,3,3,Tkl,0,0.0,0,0,0,0,0,0,0,0,0,2019-2020,0.0,0.0
1801,Lukas Nmecha,GER,"MF,FW",Wolfsburg,Bundesliga,20,1998,1.5,0,0,0,0,0,0,0,0.0,0,0,0,0,0,0,0,0,0,2019-2020,0.0,0.0
1802,Mark Noble,ENG,MF,West Ham,Premier League,32,1987,29.7,52,30,19,28,5,22,64,34.4,42,20,6,14,20,72,10,1,0,2019-2020,0.6734006734006734,1.7508417508417509
1803,Nolito,ESP,FW,Sevilla,La Liga,32,1986,10.0,21,12,5,11,5,7,20,35.0,13,7,0,7,1,22,1,0,0,2019-2020,0.1,2.1
1804,Nolito,ESP,"MF,FW",Celta Vigo,La Liga,32,1986,3.6,7,5,5,2,0,3,8,37.5,5,4,1,3,1,8,4,0,0,2019-2020,0.2777777777777778,1.9444444444444444
1805,Arnaud Nordin,FRA,"FW,MF",Saint-Étienne,Ligue 1,21,1998,10.1,7,3,3,3,1,4,13,30.8,9,11,1,10,4,11,6,0,0,2019-2020,0.39603960396039606,0.6930693069306931
1806,Håvard Nordtveit,NOR,DF,Hoffenheim,Bundesliga,29,1990,7.8,4,1,3,1,0,3,7,42.9,4,17,12,5,13,17,45,0,0,2019-2020,1.6666666666666667,0.5128205128205129
1807,Oliver Norwood,NIR,MF,Sheffield Utd,Premier League,28,1991,34.3,66,37,35,24,7,28,97,28.9,69,34,12,22,47,113,40,1,0,2019-2020,1.370262390670554,1.924198250728863
1808,Alexander Nübel,GER,GK,Schalke 04,Bundesliga,22,1996,25.7,0,0,0,0,0,0,0,0.0,0,0,0,0,2,2,9,6,0,2019-2020,0.07782101167315175,0.0
1809,Kasim Nuhu,GHA,DF,Düsseldorf,Bundesliga,24,1995,11.1,14,7,12,1,1,9,19,47.4,10,16,12,4,25,39,54,0,0,2019-2020,2.2522522522522523,1.2612612612612613
1810,Unai Núñez,ESP,DF,Athletic Club,La Liga,22,1997,17.5,13,10,10,2,1,6,16,37.5,10,25,17,8,23,36,71,0,0,2019-2020,1.3142857142857143,0.7428571428571429
1811,Bram Nuytinck,NED,DF,Udinese,Serie A,29,1990,24.7,46,32,30,13,3,17,27,63.0,10,50,32,18,27,73,96,1,0,2019-2020,1.0931174089068827,1.8623481781376519
1812,Gerzino Nyamsi,FRA,DF,Rennes,Ligue 1,22,1997,1.3,1,0,1,0,0,0,0,0.0,0,1,0,1,1,2,5,0,0,2019-2020,0.7692307692307692,0.7692307692307692
1813,Ørjan Nyland,NOR,GK,Aston Villa,Premier League,28,1990,6.0,0,0,0,0,0,0,0,0.0,0,0,0,0,0,0,1,1,0,2019-2020,0.0,0.0
1814,Allan Nyom,CMR,"DF,MF",Getafe,La Liga,31,1988,26.9,45,25,26,15,4,20,37,54.1,17,24,5,19,14,59,50,1,0,2019-2020,0.5204460966542751,1.6728624535315986
1815,Steven Nzonzi,FRA,MF,Rennes,Ligue 1,30,1988,4.3,5,4,3,1,1,1,2,50.0,1,2,2,0,4,9,18,0,0,2019-2020,0.9302325581395349,1.1627906976744187
1816,Jack O'Connell,ENG,DF,Sheffield Utd,Premier League,25,1994,32.4,23,14,15,6,2,10,20,50.0,10,38,17,21,42,65,154,1,0,2019-2020,1.2962962962962963,0.7098765432098766
1817,Michael Obafemi,IRL,FW,Southampton,Premier League,19,2000,7.4,7,3,1,3,3,2,14,14.3,12,3,0,3,6,13,0,0,0,2019-2020,0.8108108108108107,0.9459459459459459
1818,Pedro Obiang,EQG,MF,Sassuolo,Serie A,27,1992,18.6,46,31,21,19,6,19,40,47.5,21,24,10,14,21,67,31,1,0,2019-2020,1.129032258064516,2.4731182795698925
1819,Jan Oblak,SVN,GK,Atlético Madrid,La Liga,26,1993,37.7,0,0,0,0,0,0,0,0.0,0,0,0,0,1,1,4,2,0,2019-2020,0.02652519893899204,0.0
1820,Rafel Obrador,ESP,DF,Mallorca,La Liga,15,2004,0.0,0,0,0,0,0,0,1,0.0,1,0,0,0,0,0,1,0,0,2019-2020,,
1821,Lucas Ocampos,ARG,"FW,MF",Sevilla,La Liga,25,1994,30.5,54,31,30,19,5,30,72,41.7,42,33,2,31,22,76,27,0,0,2019-2020,0.7213114754098361,1.7704918032786885
1822,Bastian Oczipka,GER,DF,Schalke 04,Bundesliga,30,1989,33.5,72,50,42,21,9,36,62,58.1,26,35,6,29,37,109,68,0,0,2019-2020,1.1044776119402986,2.1492537313432836
1823,Álvaro Odriozola,ESP,DF,Real Madrid,La Liga,23,1995,3.8,5,2,4,0,1,5,8,62.5,3,4,0,4,2,7,8,0,0,2019-2020,0.5263157894736842,1.3157894736842106
1824,Álvaro Odriozola,ESP,DF,Bayern Munich,Bundesliga,23,1995,1.7,2,2,1,0,1,2,3,66.7,1,1,0,1,1,3,2,0,0,2019-2020,0.5882352941176471,1.1764705882352942
1825,Kelvin Ofori,GHA,MF,Düsseldorf,Bundesliga,18,2001,0.4,0,0,0,0,0,0,0,0.0,0,0,0,0,0,0,0,0,0,2019-2020,0.0,0.0
Rk,Player,Nation,Pos,Squad,Comp,0,0,90.0,0,0,3,3,3,Tkl,0,0.0,0,0,0,0,0,0,0,0,0,2019-2020,0.0,0.0
1826,Angelo Ogbonna,ITA,DF,West Ham,Premier League,31,1988,31.0,38,24,20,14,4,18,32,56.3,14,50,32,18,27,65,134,1,0,2019-2020,0.8709677419354839,1.2258064516129032
1827,Stefano Okaka,ITA,FW,Udinese,Serie A,29,1989,26.8,19,11,6,8,5,7,27,25.9,20,23,2,21,8,27,28,0,0,2019-2020,0.29850746268656714,0.708955223880597
1828,Kwasi Okyere Wriedt,GHA,FW,Bayern Munich,Bundesliga,25,1994,0.2,0,0,0,0,0,0,0,0.0,0,0,0,0,0,0,0,0,0,2019-2020,0.0,0.0
1829,Lucas Olaza,URU,DF,Celta Vigo,La Liga,25,1994,34.9,56,39,36,17,3,39,59,66.1,20,37,10,27,31,87,60,1,0,2019-2020,0.8882521489971347,1.6045845272206305
1830,Oier Olazábal,ESP,GK,Espanyol,La Liga,29,1989,2.0,0,0,0,0,0,0,0,0.0,0,1,0,1,0,0,0,0,0,2019-2020,0.0,0.0
1831,Christian Oliva,URU,MF,Cagliari,Serie A,23,1996,5.2,13,7,9,4,0,5,15,33.3,10,5,0,5,7,20,14,0,0,2019-2020,1.346153846153846,2.5
1832,Kiko Olivas,ESP,DF,Valladolid,La Liga,30,1988,32.7,33,16,25,7,1,13,35,37.1,22,30,16,14,61,94,112,2,0,2019-2020,1.8654434250764524,1.0091743119266054
1833,Paulo Oliveira,POR,DF,Eibar,La Liga,27,1992,23.2,31,19,22,8,1,18,30,60.0,12,23,13,10,42,73,107,1,0,2019-2020,1.8103448275862069,1.3362068965517242
1834,Cauly Oliveira Souza,BRA,"MF,FW",Paderborn 07,Bundesliga,23,1995,8.0,11,7,5,5,1,3,11,27.3,8,9,0,9,6,17,1,0,0,2019-2020,0.75,1.375
1835,Mathías Olivera,URU,DF,Getafe,La Liga,21,1997,20.8,64,40,34,16,14,27,45,60.0,18,32,3,29,23,87,44,0,0,2019-2020,1.1057692307692308,3.0769230769230766
1836,Maximiliano Olivera,URU,MF,Fiorentina,Serie A,27,1992,0.1,1,0,1,0,0,0,0,0.0,0,0,0,0,0,1,0,0,0,2019-2020,0.0,10.0
1837,Marco Olivieri,ITA,FW,Juventus,Serie A,20,1999,0.3,1,1,1,0,0,1,2,50.0,1,0,0,0,0,1,0,0,0,2019-2020,0.0,3.3333333333333335
1838,Dani Olmo,ESP,"MF,FW",RB Leipzig,Bundesliga,21,1998,8.3,20,14,5,10,5,1,13,7.7,12,7,1,6,4,24,6,0,0,2019-2020,0.48192771084337344,2.4096385542168672
1839,Robin Olsen,SWE,GK,Cagliari,Serie A,29,1990,16.9,0,0,0,0,0,0,1,0.0,1,0,0,0,0,0,8,0,0,2019-2020,0.0,0.0
1840,Kenneth Omeruo,NGA,DF,Leganés,La Liga,25,1993,20.8,28,17,25,3,0,11,18,61.1,7,21,12,9,36,64,112,2,0,2019-2020,1.7307692307692306,1.346153846153846
1841,Jean Onana,CMR,MF,Lille,Ligue 1,19,2000,0.9,0,0,0,0,0,0,2,0.0,2,1,0,1,1,1,0,0,0,2019-2020,1.1111111111111112,0.0
1842,Karim Onisiwo,AUT,FW,Mainz 05,Bundesliga,27,1992,19.2,27,19,6,10,11,5,13,38.5,8,20,3,17,7,34,11,0,0,2019-2020,0.36458333333333337,1.40625
1843,Javier Ontiveros,ESP,"FW,MF",Villarreal,La Liga,21,1997,9.9,29,14,13,14,2,8,35,22.9,27,13,1,12,5,34,7,0,0,2019-2020,0.5050505050505051,2.929292929292929
1844,Henry Onyekuru,NGA,"MF,FW",Monaco,Ligue 1,22,1997,1.8,1,1,1,0,0,0,0,0.0,0,1,0,1,1,2,0,0,0,2019-2020,0.5555555555555556,0.5555555555555556
1845,Nicholas Opoku,GHA,DF,Udinese,Serie A,21,1997,5.3,13,8,8,3,2,6,11,54.5,5,6,4,2,4,17,19,0,0,2019-2020,0.7547169811320755,2.452830188679245
1846,Nicholas Opoku,GHA,DF,Amiens,Ligue 1,21,1997,7.0,7,5,6,1,0,7,14,50.0,7,6,2,4,7,14,32,0,0,2019-2020,1.0,1.0
1847,Willi Orban,HUN,DF,RB Leipzig,Bundesliga,26,1992,9.5,20,12,13,7,0,12,20,60.0,8,14,3,11,16,36,52,1,0,2019-2020,1.6842105263157894,2.1052631578947367
1848,Fabián Orellana,CHI,"MF,FW",Eibar,La Liga,33,1986,26.6,29,18,10,6,13,14,52,26.9,38,9,0,9,20,49,2,0,0,2019-2020,0.7518796992481203,1.0902255639097744
1849,Divock Origi,BEL,FW,Liverpool,Premier League,24,1995,8.0,12,9,2,5,5,4,9,44.4,5,2,0,2,4,16,5,0,0,2019-2020,0.5,1.5
1850,Aimar Oroz,ESP,FW,Osasuna,La Liga,17,2001,0.1,0,0,0,0,0,0,0,0.0,0,1,0,1,0,0,0,0,0,2019-2020,0.0,0.0
Rk,Player,Nation,Pos,Squad,Comp,0,0,90.0,0,0,3,3,3,Tkl,0,0.0,0,0,0,0,0,0,0,0,0,2019-2020,0.0,0.0
1851,Riccardo Orsolini,ITA,"FW,MF",Bologna,Serie A,22,1997,29.8,36,22,21,10,5,12,47,25.5,35,23,1,22,16,52,20,0,0,2019-2020,0.5369127516778524,1.2080536912751678
1852,Yuya Osako,JPN,"FW,MF",Werder Bremen,Bundesliga,29,1990,20.5,29,16,5,19,5,3,29,10.3,26,10,1,9,6,35,13,1,0,2019-2020,0.2926829268292683,1.4146341463414633
1853,Ben Osborn,ENG,"MF,DF",Sheffield Utd,Premier League,24,1994,6.6,15,10,11,3,1,3,16,18.8,13,6,1,5,6,21,7,0,0,2019-2020,0.9090909090909092,2.272727272727273
1854,Victor Osimhen,NGA,FW,Lille,Ligue 1,20,1998,25.4,8,4,1,0,7,1,11,9.1,10,8,0,8,11,19,32,0,0,2019-2020,0.4330708661417323,0.31496062992125984
1855,David Ospina,COL,GK,Napoli,Serie A,30,1988,16.3,0,0,0,0,0,0,0,0.0,0,0,0,0,0,0,2,1,0,2019-2020,0.0,0.0
1856,Nicolás Otamendi,ARG,DF,Manchester City,Premier League,31,1988,19.1,28,14,21,6,1,16,33,48.5,17,15,9,6,21,49,76,2,0,2019-2020,1.0994764397905759,1.4659685863874345
1857,Otávio,BRA,MF,Bordeaux,Ligue 1,25,1994,24.6,80,45,23,52,5,35,82,42.7,47,26,9,17,41,121,40,6,0,2019-2020,1.6666666666666665,3.252032520325203
1858,Paulo Otávio,BRA,DF,Wolfsburg,Bundesliga,24,1994,4.2,21,16,11,9,1,10,13,76.9,3,12,2,10,9,30,11,0,0,2019-2020,2.142857142857143,5.0
1859,Abou Ouattara,BFA,FW,Lille,Ligue 1,19,1999,0.1,0,0,0,0,0,0,0,0.0,0,0,0,0,0,0,1,0,0,2019-2020,0.0,0.0
1860,Remi Oudin,FRA,"FW,MF",Bordeaux,Ligue 1,22,1996,6.2,9,6,4,4,1,4,14,28.6,10,7,1,6,9,18,5,0,0,2019-2020,1.4516129032258065,1.4516129032258065
1861,Remi Oudin,FRA,"FW,MF",Reims,Ligue 1,22,1996,15.5,15,7,8,5,2,6,19,31.6,13,16,1,15,18,33,18,1,0,2019-2020,1.1612903225806452,0.967741935483871
1862,Alexandre Oukidja,ALG,GK,Metz,Ligue 1,31,1988,26.5,0,0,0,0,0,0,1,0.0,1,1,0,1,0,0,15,1,0,2019-2020,0.0,0.0
1863,Zinédine Ould Khaled,FRA,MF,Angers,Ligue 1,19,2000,0.7,2,1,0,2,0,2,4,50.0,2,0,0,0,4,6,0,0,0,2019-2020,5.714285714285714,2.857142857142857
1864,Adam Ounas,ALG,"FW,MF",Nice,Ligue 1,22,1996,12.5,10,5,2,6,2,5,13,38.5,8,9,1,8,11,21,8,1,0,2019-2020,0.88,0.8
1865,Reece Oxford,ENG,MF,Augsburg,Bundesliga,20,1998,4.2,7,4,2,4,1,2,8,25.0,6,8,5,3,5,12,10,1,0,2019-2020,1.1904761904761905,1.6666666666666665
1866,Alex Oxlade-Chamberlain,ENG,"MF,FW",Liverpool,Premier League,25,1993,16.5,18,9,4,6,8,5,21,23.8,16,26,1,25,22,40,10,0,0,2019-2020,1.3333333333333333,1.0909090909090908
1867,Mikel Oyarzabal,ESP,"FW,MF",Real Sociedad,La Liga,22,1997,33.9,36,15,13,15,8,16,46,34.8,30,32,2,30,13,49,19,1,0,2019-2020,0.3834808259587021,1.0619469026548674
1868,Ambroise Oyongo,CMR,"DF,FW",Montpellier,Ligue 1,28,1991,20.2,25,10,16,6,3,16,28,57.1,12,8,0,8,17,42,35,0,0,2019-2020,0.8415841584158417,1.2376237623762376
1869,Mesut Özil,GER,MF,Arsenal,Premier League,30,1988,16.0,17,8,9,7,1,4,23,17.4,19,4,0,4,5,22,1,0,0,2019-2020,0.3125,1.0625
1870,Levin Öztunalı,GER,"MF,FW",Mainz 05,Bundesliga,23,1996,19.8,28,19,13,12,3,12,35,34.3,23,27,1,26,9,37,14,2,0,2019-2020,0.45454545454545453,1.4141414141414141
1871,Pablo,BRA,DF,Bordeaux,Ligue 1,28,1991,24.1,27,15,22,5,0,16,31,51.6,15,25,14,11,40,67,130,2,0,2019-2020,1.6597510373443982,1.120331950207469
1872,Fernando Pacheco,ESP,GK,Alavés,La Liga,27,1992,26.2,1,0,1,0,0,1,3,33.3,2,0,0,0,0,1,10,0,0,2019-2020,0.0,0.03816793893129771
1873,Jon Pacheco,ESP,DF,Real Sociedad,La Liga,18,2001,0.9,0,0,0,0,0,0,0,0.0,0,1,0,1,0,0,2,0,0,2019-2020,0.0,0.0
1874,Gonçalo Paciência,POR,FW,Eint Frankfurt,Bundesliga,24,1994,14.3,9,5,1,4,4,3,13,23.1,10,9,1,8,1,10,11,0,0,2019-2020,0.06993006993006992,0.6293706293706294
1875,Daniele Padelli,ITA,GK,Inter,Serie A,33,1985,3.0,0,0,0,0,0,0,0,0.0,0,0,0,0,0,0,1,1,0,2019-2020,0.0,0.0
Rk,Player,Nation,Pos,Squad,Comp,0,0,90.0,0,0,3,3,3,Tkl,0,0.0,0,0,0,0,0,0,0,0,0,2019-2020,0.0,0.0
1876,Marko Pajač,CRO,"DF,FW",Genoa,Serie A,26,1993,8.4,8,4,4,3,1,7,16,43.8,9,6,0,6,8,16,9,0,0,2019-2020,0.9523809523809523,0.9523809523809523
1877,Vincent Pajot,FRA,MF,Angers,Ligue 1,28,1990,1.3,2,2,1,1,0,1,1,100.0,0,3,0,3,5,7,0,0,0,2019-2020,3.846153846153846,1.5384615384615383
1878,Vincent Pajot,FRA,MF,Metz,Ligue 1,28,1990,5.8,16,11,8,7,1,2,4,50.0,2,5,1,4,9,25,13,0,0,2019-2020,1.5517241379310345,2.7586206896551726
1879,Rodrigo Palacio,ARG,FW,Bologna,Serie A,37,1982,28.0,19,11,0,9,10,4,27,14.8,23,17,3,14,5,24,38,2,0,2019-2020,0.17857142857142858,0.6785714285714286
1880,Exequiel Palacios,ARG,MF,Leverkusen,Bundesliga,20,1998,2.0,8,7,4,4,0,2,5,40.0,3,2,0,2,1,9,0,0,0,2019-2020,0.5,4.0
1881,Sergi Palencia,ESP,DF,Saint-Étienne,Ligue 1,23,1996,5.2,16,10,6,10,0,5,7,71.4,2,6,1,5,8,24,4,0,0,2019-2020,1.5384615384615383,3.0769230769230766
1882,Nicolas Pallois,FRA,DF,Nantes,Ligue 1,31,1987,21.0,47,36,28,17,2,31,55,56.4,24,18,13,5,40,87,77,1,0,2019-2020,1.9047619047619047,2.238095238095238
1883,Emerson Palmieri,ITA,DF,Chelsea,Premier League,24,1994,11.4,23,12,8,11,4,10,15,66.7,5,13,1,12,18,41,19,0,0,2019-2020,1.5789473684210527,2.017543859649123
1884,Alberto Paloschi,ITA,FW,SPAL,Serie A,29,1990,4.9,3,0,3,0,0,2,8,25.0,6,3,0,3,0,3,2,0,0,2019-2020,0.0,0.6122448979591836
1885,Alberto Paloschi,ITA,"FW,MF",Cagliari,Serie A,29,1990,2.3,0,0,0,0,0,0,1,0.0,1,1,0,1,1,1,3,0,0,2019-2020,0.4347826086956522,0.0
1886,Martin Palumbo,NOR,MF,Udinese,Serie A,17,2002,0.0,0,0,0,0,0,0,0,0.0,0,0,0,0,0,0,0,0,0,2019-2020,,
1887,Goran Pandev,MKD,"FW,MF",Genoa,Serie A,36,1983,18.7,12,8,2,7,3,3,25,12.0,22,4,1,3,0,12,5,1,0,2019-2020,0.0,0.6417112299465241
1888,Jonathan Panzo,ENG,DF,Monaco,Ligue 1,18,2000,1.2,2,2,2,0,0,1,1,100.0,0,3,1,2,3,5,7,0,0,2019-2020,2.5,1.6666666666666667
1889,Sokratis Papastathopoulos,GRE,DF,Arsenal,Premier League,31,1988,18.8,25,16,17,7,1,10,21,47.6,11,30,24,6,17,42,68,1,0,2019-2020,0.9042553191489361,1.3297872340425532
1890,Andrea Papetti,ITA,DF,Brescia,Serie A,17,2002,10.2,9,7,8,1,0,4,14,28.6,10,15,11,4,15,24,39,0,0,2019-2020,1.4705882352941178,0.8823529411764707
1891,Lucas Paquetá,BRA,"MF,FW",Milan,Serie A,21,1997,12.3,33,19,12,17,4,14,37,37.8,23,17,2,15,8,41,9,0,0,2019-2020,0.6504065040650406,2.6829268292682924
1892,Gaëtan Paquiez,FRA,DF,Nîmes,Ligue 1,25,1994,17.0,36,25,14,13,9,17,47,36.2,30,18,5,13,33,69,43,0,0,2019-2020,1.9411764705882353,2.1176470588235294
1893,Rubén Pardo,ESP,MF,Bordeaux,Ligue 1,26,1992,2.1,3,2,2,1,0,2,3,66.7,1,0,0,0,1,4,2,1,0,2019-2020,0.47619047619047616,1.4285714285714286
1894,Leandro Paredes,ARG,MF,Paris S-G,Ligue 1,25,1994,9.0,22,14,7,14,1,13,29,44.8,16,7,1,6,15,37,7,0,0,2019-2020,1.6666666666666667,2.4444444444444446
1895,Daniel Parejo,ESP,MF,Valencia,La Liga,30,1989,33.6,67,41,29,32,6,32,101,31.7,69,38,11,27,22,89,20,2,0,2019-2020,0.6547619047619048,1.994047619047619
1896,Michael Parensen,GER,DF,Union Berlin,Bundesliga,33,1986,7.0,11,6,5,6,0,5,10,50.0,5,14,8,6,12,23,17,0,0,2019-2020,1.7142857142857142,1.5714285714285714
1897,Miquel Parera,ESP,GK,Mallorca,La Liga,23,1996,1.0,0,0,0,0,0,0,0,0.0,0,0,0,0,0,0,0,0,0,2019-2020,0.0,0.0
1898,Marco Parolo,ITA,MF,Lazio,Serie A,34,1985,18.9,54,26,19,27,8,18,46,39.1,28,44,15,29,26,80,49,0,0,2019-2020,1.3756613756613758,2.857142857142857
1899,Troy Parrott,IRL,FW,Tottenham,Premier League,17,2002,0.1,0,0,0,0,0,0,0,0.0,0,0,0,0,0,0,0,0,0,2019-2020,0.0,0.0
1900,Thomas Partey,GHA,MF,Atlético Madrid,La Liga,26,1993,28.3,70,41,34,30,6,26,58,44.8,32,32,8,24,48,118,41,7,0,2019-2020,1.696113074204947,2.4734982332155475
Rk,Player,Nation,Pos,Squad,Comp,0,0,90.0,0,0,3,3,3,Tkl,0,0.0,0,0,0,0,0,0,0,0,0,2019-2020,0.0,0.0
1901,Mario Pašalić,CRO,MF,Atalanta,Serie A,24,1995,26.9,47,21,17,18,12,16,52,30.8,36,27,7,20,27,74,22,2,0,2019-2020,1.0037174721189592,1.7472118959107807
1902,Javier Pastore,ARG,MF,Roma,Serie A,30,1989,5.7,14,10,3,5,6,5,12,41.7,7,4,0,4,5,19,5,0,0,2019-2020,0.8771929824561403,2.456140350877193
1903,Patric,ESP,DF,Lazio,Serie A,26,1993,18.6,34,20,24,7,3,18,25,72.0,7,19,9,10,15,49,45,0,0,2019-2020,0.8064516129032258,1.8279569892473118
1904,Rui Patrício,POR,GK,Wolves,Premier League,31,1988,38.0,0,0,0,0,0,0,2,0.0,2,2,0,2,2,2,5,2,0,2019-2020,0.05263157894736842,0.0
1905,Paulinho,BRA,"MF,FW",Leverkusen,Bundesliga,19,2000,3.4,4,3,3,1,0,1,2,50.0,1,5,1,4,1,5,0,0,0,2019-2020,0.29411764705882354,1.1764705882352942
1906,Paulino,ESP,"FW,MF",Alavés,La Liga,22,1997,0.8,0,0,0,0,0,0,1,0.0,1,1,0,1,1,1,0,0,0,2019-2020,1.25,0.0
1907,Gabriel Paulista,BRA,DF,Valencia,La Liga,28,1990,31.1,22,14,17,2,3,15,25,60.0,10,36,29,7,48,70,151,3,0,2019-2020,1.5434083601286173,0.7073954983922829
1908,Benjamin Pavard,FRA,DF,Bayern Munich,Bundesliga,23,1996,31.0,34,22,15,10,9,16,28,57.1,12,28,10,18,52,86,60,0,0,2019-2020,1.6774193548387097,1.096774193548387
1909,Jiří Pavlenka,CZE,GK,Werder Bremen,Bundesliga,27,1992,33.0,1,0,1,0,0,1,2,50.0,1,1,0,1,5,6,11,3,0,2019-2020,0.15151515151515152,0.030303030303030304
1910,Mateo Pavlović,BIH,DF,Angers,Ligue 1,29,1990,9.0,8,2,6,2,0,5,7,71.4,2,4,2,2,5,13,38,1,0,2019-2020,0.5555555555555556,0.8888888888888888
1911,Leonardo Pavoletti,ITA,FW,Cagliari,Serie A,30,1988,0.5,0,0,0,0,0,0,0,0.0,0,0,0,0,1,1,3,0,0,2019-2020,2.0,0.0
1912,Dimitri Payet,FRA,"FW,MF",Marseille,Ligue 1,32,1987,21.4,22,12,8,8,6,10,26,38.5,16,8,1,7,8,30,12,0,0,2019-2020,0.3738317757009346,1.0280373831775702
1913,Nehuén Paz,ARG,DF,Bologna,Serie A,26,1993,1.3,1,1,0,1,0,0,2,0.0,2,3,3,0,5,6,12,0,0,2019-2020,3.846153846153846,0.7692307692307692
1914,Nehuén Paz,ARG,DF,Lecce,Serie A,26,1993,9.4,14,5,11,3,0,10,12,83.3,2,12,6,6,20,34,38,1,0,2019-2020,2.127659574468085,1.4893617021276595
1915,Giampaolo Pazzini,ITA,"FW,MF",Hellas Verona,Serie A,34,1984,3.4,1,0,0,1,0,0,4,0.0,4,2,0,2,1,2,4,0,0,2019-2020,0.29411764705882354,0.29411764705882354
1916,Mads Pedersen,DEN,DF,Augsburg,Bundesliga,22,1996,1.1,4,2,3,0,1,2,6,33.3,4,3,1,2,2,6,0,0,0,2019-2020,1.8181818181818181,3.6363636363636362
1917,Alfonso Pedraza,ESP,DF,Betis,La Liga,23,1996,15.0,30,19,16,11,3,19,33,57.6,14,18,6,12,16,46,26,1,0,2019-2020,1.0666666666666667,2.0
1918,Marc Pedraza,ESP,MF,Mallorca,La Liga,32,1987,1.4,1,1,1,0,0,1,5,20.0,4,0,0,0,4,5,1,0,0,2019-2020,2.857142857142857,0.7142857142857143
1919,Pedro,ESP,"FW,MF",Chelsea,Premier League,32,1987,7.3,15,7,5,9,1,3,15,20.0,12,9,0,9,9,24,1,0,0,2019-2020,1.2328767123287672,2.0547945205479454
1920,Pedro,BRA,FW,Fiorentina,Serie A,22,1997,0.7,1,1,0,0,1,0,0,0.0,0,1,0,1,0,1,0,0,0,2019-2020,0.0,1.4285714285714286
1921,João Pedro,ITA,"FW,MF",Cagliari,Serie A,27,1992,35.0,17,11,5,7,5,4,24,16.7,20,35,8,27,9,26,39,0,0,2019-2020,0.2571428571428571,0.4857142857142857
1922,Adrià Pedrosa,ESP,"DF,MF",Espanyol,La Liga,21,1998,12.1,19,13,8,9,2,7,25,28.0,18,12,1,11,11,30,32,0,0,2019-2020,0.9090909090909092,1.5702479338842976
1923,Daouda Peeters,BEL,MF,Juventus,Serie A,20,1999,0.2,1,0,0,1,0,1,1,100.0,0,0,0,0,0,1,0,0,0,2019-2020,0.0,5.0
1924,Jordan Pefok,USA,FW,Rennes,Ligue 1,23,1996,4.9,7,6,1,4,2,0,2,0.0,2,3,0,3,1,8,2,0,0,2019-2020,0.2040816326530612,1.4285714285714284
1925,Gianluca Pegolo,ITA,GK,Sassuolo,Serie A,38,1981,5.0,0,0,0,0,0,0,0,0.0,0,0,0,0,0,0,4,0,0,2019-2020,0.0,0.0
Rk,Player,Nation,Pos,Squad,Comp,0,0,90.0,0,0,3,3,3,Tkl,0,0.0,0,0,0,0,0,0,0,0,0,2019-2020,0.0,0.0
1926,Peter Pekarík,SVK,"DF,FW",Hertha BSC,Bundesliga,32,1986,8.5,14,7,7,3,4,8,20,40.0,12,11,4,7,7,21,31,0,0,2019-2020,0.8235294117647058,1.6470588235294117
1927,Yohann Pelé,FRA,GK,Marseille,Ligue 1,36,1982,1.7,0,0,0,0,0,0,0,0.0,0,0,0,0,0,0,0,0,0,2019-2020,0.0,0.0
1928,Lorenzo Pellegrini,ITA,MF,Roma,Serie A,23,1996,23.3,30,13,9,13,8,12,33,36.4,21,28,0,28,15,45,18,0,0,2019-2020,0.6437768240343348,1.2875536480686696
1929,Luca Pellegrini,ITA,DF,Cagliari,Serie A,20,1999,21.2,31,15,20,7,4,15,38,39.5,23,19,2,17,21,52,45,2,0,2019-2020,0.9905660377358491,1.4622641509433962
1930,Théo Pellenard,FRA,DF,Angers,Ligue 1,25,1994,5.1,11,8,6,3,2,6,13,46.2,7,4,0,4,5,16,8,0,0,2019-2020,0.9803921568627452,2.1568627450980395
1931,Andy Pelmard,FRA,DF,Nice,Ligue 1,19,2000,8.5,22,14,13,9,0,9,11,81.8,2,12,4,8,15,37,28,1,0,2019-2020,1.7647058823529411,2.588235294117647
1932,Federico Peluso,ITA,DF,Sassuolo,Serie A,35,1984,16.8,19,16,8,8,3,8,9,88.9,1,14,9,5,22,41,58,1,0,2019-2020,1.3095238095238095,1.130952380952381
1933,Rubén Peña,ESP,DF,Villarreal,La Liga,28,1991,21.2,42,24,23,19,0,17,50,34.0,33,25,8,17,35,77,58,2,0,2019-2020,1.650943396226415,1.9811320754716981
1934,Philipp Pentke,GER,GK,Hoffenheim,Bundesliga,34,1985,4.0,0,0,0,0,0,0,0,0.0,0,0,0,0,0,0,2,0,0,2019-2020,0.0,0.0
1935,Nicolas Pépé,CIV,FW,Arsenal,Premier League,24,1995,22.3,32,17,15,13,4,8,16,50.0,8,15,2,13,8,40,5,0,0,2019-2020,0.35874439461883406,1.4349775784753362
1936,Luis Perea,ESP,FW,Osasuna,La Liga,21,1997,0.2,0,0,0,0,0,0,0,0.0,0,0,0,0,0,0,1,0,0,2019-2020,0.0,0.0
1937,Andreas Pereira,BRA,"MF,FW",Manchester Utd,Premier League,23,1996,16.5,24,13,8,9,7,10,39,25.6,29,13,0,13,7,31,7,0,0,2019-2020,0.42424242424242425,1.4545454545454546
1938,Mathias Pereira Lage,POR,MF,Angers,Ligue 1,22,1996,17.1,30,18,16,13,1,12,37,32.4,25,19,0,19,17,47,9,0,0,2019-2020,0.9941520467836257,1.7543859649122806
1939,Ricardo Pereira,POR,DF,Leicester City,Premier League,25,1993,28.0,119,68,65,36,18,53,106,50.0,53,38,6,32,49,168,86,0,0,2019-2020,1.75,4.25
1940,Gastón Pereiro,URU,"MF,FW",Cagliari,Serie A,24,1995,3.9,2,2,2,0,0,1,4,25.0,3,1,0,1,0,2,1,1,0,2019-2020,0.0,0.5128205128205129
1941,Bruno Peres,BRA,DF,Roma,Serie A,29,1990,11.7,14,10,10,3,1,8,21,38.1,13,12,3,9,15,29,19,2,0,2019-2020,1.2820512820512822,1.1965811965811965
1942,Roberto Pereyra,ARG,"FW,MF",Watford,Premier League,28,1991,18.3,20,8,11,7,2,9,28,32.1,19,21,0,21,14,34,12,1,0,2019-2020,0.7650273224043715,1.0928961748633879
1943,Ayoze Pérez,ESP,"MF,FW",Leicester City,Premier League,26,1993,22.3,45,28,14,26,5,8,54,14.8,46,33,1,32,14,59,9,1,0,2019-2020,0.6278026905829596,2.0179372197309418
1944,Carles Pérez,ESP,"FW,MF",Roma,Serie A,21,1998,6.3,12,8,4,6,2,3,10,30.0,7,6,1,5,3,15,1,0,0,2019-2020,0.4761904761904762,1.9047619047619049
1945,Carles Pérez,ESP,FW,Barcelona,La Liga,21,1998,5.3,7,4,2,2,3,3,15,20.0,12,5,2,3,1,8,1,0,0,2019-2020,0.18867924528301888,1.3207547169811322
1946,Iñigo Pérez,ESP,MF,Osasuna,La Liga,31,1988,12.0,15,11,3,7,5,8,22,36.4,14,7,1,6,12,27,6,0,0,2019-2020,1.0,1.25
1947,Juan Pérez,ESP,GK,Osasuna,La Liga,23,1996,2.0,1,1,1,0,0,1,2,50.0,1,0,0,0,0,1,0,0,0,2019-2020,0.0,0.5
1948,Kike Pérez,ESP,"MF,FW",Valladolid,La Liga,22,1997,2.4,6,1,1,3,2,3,7,42.9,4,1,0,1,10,16,4,0,0,2019-2020,4.166666666666667,2.5
1949,Lucas Pérez,ESP,FW,Alavés,La Liga,30,1988,27.7,12,6,2,8,2,3,13,23.1,10,13,2,11,2,14,0,0,0,2019-2020,0.07220216606498195,0.4332129963898917
1950,Rubén Pérez,ESP,MF,Leganés,La Liga,30,1989,24.4,50,27,21,23,6,16,47,34.0,31,21,4,17,38,88,33,0,0,2019-2020,1.557377049180328,2.0491803278688527
Rk,Player,Nation,Pos,Squad,Comp,0,0,90.0,0,0,3,3,3,Tkl,0,0.0,0,0,0,0,0,0,0,0,0,2019-2020,0.0,0.0
1951,Samu Pérez,ESP,GK,Valladolid,La Liga,22,1997,0.3,0,0,0,0,0,0,0,0.0,0,0,0,0,0,0,0,0,0,2019-2020,0.0,0.0
1952,Mattia Perin,ITA,GK,Genoa,Serie A,26,1992,21.0,1,1,1,0,0,1,1,100.0,0,1,0,1,0,1,5,1,0,2019-2020,0.0,0.047619047619047616
1953,Ivan Perišić,CRO,"FW,MF",Bayern Munich,Bundesliga,30,1989,13.4,16,12,5,6,5,8,33,24.2,25,14,3,11,4,20,8,0,0,2019-2020,0.29850746268656714,1.1940298507462686
1954,Diego Perotti,ARG,"FW,MF",Roma,Serie A,31,1988,9.7,16,13,5,8,3,5,20,25.0,15,14,0,14,3,19,6,0,0,2019-2020,0.30927835051546393,1.6494845360824744
1955,Romain Perraud,FRA,DF,Brest,Ligue 1,21,1997,18.6,29,14,18,9,2,14,28,50.0,14,24,9,15,27,56,50,0,0,2019-2020,1.4516129032258063,1.5591397849462365
1956,Loïc Perrin,FRA,DF,Saint-Étienne,Ligue 1,33,1985,19.0,27,20,16,11,0,11,14,78.6,3,23,17,6,39,66,59,0,0,2019-2020,2.0526315789473686,1.4210526315789473
1957,Lucas Perrin,FRA,DF,Marseille,Ligue 1,20,1998,4.0,5,2,3,2,0,2,7,28.6,5,3,2,1,10,15,17,0,0,2019-2020,2.5,1.25
1958,Pavao Pervan,AUT,GK,Wolfsburg,Bundesliga,31,1987,8.0,0,0,0,0,0,0,1,0.0,1,0,0,0,0,0,4,0,0,2019-2020,0.0,0.0
1959,Matteo Pessina,ITA,MF,Hellas Verona,Serie A,22,1997,27.7,35,21,9,20,6,12,33,36.4,21,28,8,20,25,60,40,2,0,2019-2020,0.9025270758122744,1.263537906137184
1960,Andrea Petagna,ITA,FW,SPAL,Serie A,24,1995,33.7,9,4,2,7,0,3,17,17.6,14,11,5,6,1,10,27,0,0,2019-2020,0.029673590504451036,0.2670623145400593
1961,Nils Petersen,GER,"FW,MF",Freiburg,Bundesliga,30,1988,27.1,19,14,7,9,3,10,28,35.7,18,32,6,26,10,29,67,0,0,2019-2020,0.36900369003690037,0.7011070110701106
1962,Danijel Petković,MNE,GK,Angers,Ligue 1,26,1993,2.0,0,0,0,0,0,0,0,0.0,0,0,0,0,0,0,2,0,0,2019-2020,0.0,0.0
1963,Denis Petrić,SRB,GK,Nantes,Ligue 1,31,1988,1.0,1,1,1,0,0,1,1,100.0,0,0,0,0,0,1,0,0,0,2019-2020,0.0,1.0
1964,Jacopo Petriccione,ITA,MF,Lecce,Serie A,24,1995,23.8,38,20,29,9,0,15,57,26.3,42,20,7,13,28,66,25,2,0,2019-2020,1.1764705882352942,1.5966386554621848
1965,Germán Pezzella,ARG,DF,Fiorentina,Serie A,28,1991,31.4,36,18,26,9,1,14,32,43.8,18,31,20,11,55,91,134,1,0,2019-2020,1.7515923566878981,1.1464968152866242
1966,Giuseppe Pezzella,ITA,DF,Udinese,Serie A,21,1997,0.9,0,0,0,0,0,0,0,0.0,0,0,0,0,1,1,4,0,0,2019-2020,1.1111111111111112,0.0
1967,Giuseppe Pezzella,ITA,DF,Parma,Serie A,21,1997,10.5,20,12,17,3,0,11,19,57.9,8,13,9,4,6,26,30,0,0,2019-2020,0.5714285714285714,1.9047619047619047
1968,Rayan Philippe,FRA,FW,Dijon,Ligue 1,18,2000,0.3,0,0,0,0,0,0,1,0.0,1,0,0,0,1,1,1,1,0,2019-2020,3.3333333333333335,0.0
1969,Romain Philippoteaux,FRA,"FW,MF",Nîmes,Ligue 1,31,1988,22.2,23,12,11,11,1,9,43,20.9,34,22,1,21,13,36,10,0,0,2019-2020,0.5855855855855856,1.0360360360360361
1970,Krzysztof Piątek,POL,FW,Milan,Serie A,24,1995,13.1,9,4,0,7,2,3,11,27.3,8,5,2,3,3,12,10,0,0,2019-2020,0.22900763358778625,0.6870229007633588
1971,Krzysztof Piątek,POL,FW,Hertha BSC,Bundesliga,24,1995,10.1,5,4,1,1,3,0,11,0.0,11,7,0,7,5,10,3,0,0,2019-2020,0.49504950495049505,0.49504950495049505
1972,Pablo Piatti,ARG,"DF,MF",Espanyol,La Liga,30,1989,0.6,2,2,1,1,0,1,2,50.0,1,1,0,1,0,2,1,0,0,2019-2020,0.0,3.3333333333333335
1973,Cristiano Piccini,ITA,DF,Valencia,La Liga,26,1992,0.8,5,4,1,0,4,4,4,100.0,0,0,0,0,2,7,1,0,0,2019-2020,2.5,6.25
1974,Stefano Piccinini,ITA,DF,Sassuolo,Serie A,16,2002,0.1,0,0,0,0,0,0,0,0.0,0,0,0,0,0,0,0,0,0,2019-2020,0.0,0.0
1975,Roberto Piccoli,ITA,FW,Atalanta,Serie A,18,2001,0.2,0,0,0,0,0,0,0,0.0,0,1,0,1,0,0,0,0,0,2019-2020,0.0,0.0
Rk,Player,Nation,Pos,Squad,Comp,0,0,90.0,0,0,3,3,3,Tkl,0,0.0,0,0,0,0,0,0,0,0,0,2019-2020,0.0,0.0
1976,Jordan Pickford,ENG,GK,Everton,Premier League,25,1994,38.0,0,0,0,0,0,0,4,0.0,4,0,0,0,3,3,12,6,0,2019-2020,0.07894736842105263,0.0
1977,Jérémy Pied,FRA,DF,Lille,Ligue 1,30,1989,5.0,18,10,6,11,1,11,16,68.8,5,8,0,8,7,25,10,0,0,2019-2020,1.4,3.6
1978,Ronaël Pierre-Gabriel,FRA,DF,Mainz 05,Bundesliga,21,1998,6.4,16,10,9,6,1,7,13,53.8,6,7,0,7,8,24,31,1,0,2019-2020,1.25,2.5
1979,Brandon Pierrick,ENG,"MF,FW",Crystal Palace,Premier League,17,2001,0.2,0,0,0,0,0,0,0,0.0,0,0,0,0,0,0,1,0,0,2019-2020,0.0,0.0
1980,Erik Pieters,NED,"DF,MF",Burnley,Premier League,30,1988,20.9,54,32,18,29,7,28,69,40.6,41,30,4,26,28,82,60,1,0,2019-2020,1.3397129186602872,2.583732057416268
1981,Tomás Pina Isla,ESP,MF,Alavés,La Liga,31,1987,14.9,37,22,13,21,3,12,24,50.0,12,15,5,10,16,53,31,0,0,2019-2020,1.0738255033557047,2.483221476510067
1982,Andrea Pinamonti,ITA,FW,Genoa,Serie A,20,1999,24.8,19,12,1,7,11,5,25,20.0,20,19,2,17,9,28,25,0,0,2019-2020,0.3629032258064516,0.7661290322580645
1983,Simone Pinna,ITA,DF,Cagliari,Serie A,21,1997,1.0,1,1,0,1,0,0,0,0.0,0,3,1,2,5,6,4,1,0,2019-2020,5.0,1.0
1984,Carlo Pinsoglio,ITA,GK,Juventus,Serie A,29,1990,0.2,0,0,0,0,0,0,0,0.0,0,0,0,0,0,0,0,0,0,2019-2020,0.0,0.0
1985,Pipa,ESP,"DF,FW",Espanyol,La Liga,21,1998,5.3,9,8,5,4,0,4,6,66.7,2,8,0,8,6,15,17,0,0,2019-2020,1.1320754716981132,1.6981132075471699
1986,Gerard Piqué,ESP,DF,Barcelona,La Liga,32,1987,34.4,32,23,20,11,1,16,26,61.5,10,39,24,15,36,68,157,0,0,2019-2020,1.0465116279069768,0.9302325581395349
1987,Lorenzo Pirola,ITA,DF,Inter,Serie A,17,2002,0.1,0,0,0,0,0,0,0,0.0,0,0,0,0,1,1,0,0,0,2019-2020,10.0,0.0
1988,Fabio Pisacane,ITA,DF,Cagliari,Serie A,33,1986,27.1,32,21,22,10,0,21,37,56.8,16,36,28,8,27,59,110,2,0,2019-2020,0.9963099630996309,1.1808118081180812
1989,Łukasz Piszczek,POL,DF,Dortmund,Bundesliga,34,1985,23.4,45,32,27,16,2,28,50,56.0,22,27,11,16,26,71,47,1,0,2019-2020,1.1111111111111112,1.9230769230769231
1990,Claudio Pizarro,PER,"FW,MF",Werder Bremen,Bundesliga,40,1978,2.6,2,1,0,1,1,0,1,0.0,1,2,0,2,2,4,2,0,0,2019-2020,0.7692307692307692,0.7692307692307692
1991,Miralem Pjanić,BIH,MF,Juventus,Serie A,29,1990,25.3,46,21,16,23,7,21,63,33.3,42,29,12,17,32,78,30,0,0,2019-2020,1.2648221343873518,1.8181818181818181
1992,Óscar Plano,ESP,MF,Valladolid,La Liga,28,1991,27.8,48,30,25,19,4,20,61,32.8,41,36,3,33,35,83,29,0,0,2019-2020,1.2589928057553956,1.7266187050359711
1993,Marvin Plattenhardt,GER,DF,Hertha BSC,Bundesliga,27,1992,15.5,18,12,13,4,1,12,17,70.6,5,18,7,11,11,29,47,0,0,2019-2020,0.7096774193548387,1.1612903225806452
1994,Alassane Pléa,FRA,FW,Gladbach,Bundesliga,26,1993,23.8,16,7,5,6,5,8,28,28.6,20,21,2,19,9,25,7,0,0,2019-2020,0.37815126050420167,0.6722689075630252
1995,Thomas Pledl,GER,"MF,FW",Düsseldorf,Bundesliga,25,1994,1.0,4,2,2,2,0,0,1,0.0,1,0,0,0,0,4,1,0,0,2019-2020,0.0,4.0
1996,Daniel Podence,POR,"FW,MF",Wolves,Premier League,23,1995,3.2,3,3,2,0,1,0,2,0.0,2,4,1,3,2,5,1,0,0,2019-2020,0.625,0.9375
1997,Paul Pogba,FRA,MF,Manchester Utd,Premier League,26,1993,13.4,20,9,8,8,4,8,16,50.0,8,12,4,8,7,27,10,2,0,2019-2020,0.5223880597014925,1.4925373134328357
1998,Joel Pohjanpalo,FIN,MF,Leverkusen,Bundesliga,24,1994,0.0,0,0,0,0,0,0,0,0.0,0,0,0,0,0,0,0,0,0,2019-2020,,
1999,Andrea Poli,ITA,MF,Bologna,Serie A,29,1989,21.3,44,24,19,21,4,16,52,30.8,36,19,3,16,40,84,11,0,0,2019-2020,1.8779342723004695,2.0657276995305165
2000,Matteo Politano,ITA,FW,Napoli,Serie A,25,1993,8.3,12,6,8,2,2,5,14,35.7,9,6,0,6,5,17,3,0,0,2019-2020,0.6024096385542168,1.4457831325301203
Rk,Player,Nation,Pos,Squad,Comp,0,0,90.0,0,0,3,3,3,Tkl,0,0.0,0,0,0,0,0,0,0,0,0,2019-2020,0.0,0.0
2001,Matteo Politano,ITA,"FW,MF",Inter,Serie A,25,1993,2.9,0,0,0,0,0,0,2,0.0,2,1,0,1,0,0,1,0,0,2019-2020,0.0,0.0
2002,Sebastian Polter,GER,FW,Union Berlin,Bundesliga,28,1991,3.7,2,2,0,1,1,1,3,33.3,2,2,0,2,1,3,1,0,0,2019-2020,0.27027027027027023,0.5405405405405405
2003,Marin Pongračić,CRO,DF,Wolfsburg,Bundesliga,21,1997,10.3,14,9,11,2,1,9,10,90.0,1,11,7,4,19,33,21,1,0,2019-2020,1.8446601941747571,1.3592233009708736
2004,Pere Pons,ESP,MF,Alavés,La Liga,26,1993,12.1,28,16,14,12,2,12,26,46.2,14,16,3,13,12,40,8,1,0,2019-2020,0.9917355371900827,2.31404958677686
2005,Nick Pope,ENG,GK,Burnley,Premier League,27,1992,38.0,1,1,1,0,0,1,2,50.0,1,0,0,0,3,4,15,3,0,2019-2020,0.07894736842105263,0.02631578947368421
2006,Pedro Porro,ESP,"DF,MF",Valladolid,La Liga,19,1999,8.2,18,10,11,7,0,10,18,55.6,8,3,0,3,7,25,19,1,0,2019-2020,0.853658536585366,2.1951219512195124
2007,Francisco Portillo,ESP,MF,Getafe,La Liga,29,1990,4.2,11,6,3,6,2,4,12,33.3,8,2,0,2,2,13,3,0,0,2019-2020,0.47619047619047616,2.619047619047619
2008,Portu,ESP,"FW,MF",Real Sociedad,La Liga,27,1992,26.6,32,21,10,15,7,13,33,39.4,20,28,3,25,13,45,5,0,0,2019-2020,0.48872180451127817,1.2030075187969924
2009,Stefan Posch,AUT,DF,Hoffenheim,Bundesliga,22,1997,25.6,63,34,35,27,1,35,63,55.6,28,57,25,32,40,103,101,1,0,2019-2020,1.5625,2.4609375
2010,Sergio Postigo,ESP,DF,Levante,La Liga,30,1988,26.4,32,15,23,7,2,11,18,61.1,7,24,15,9,34,66,132,1,0,2019-2020,1.2878787878787878,1.2121212121212122
2011,Florent Poulolo,MTQ,DF,Getafe,La Liga,22,1997,0.0,0,0,0,0,0,0,0,0.0,0,0,0,0,0,0,1,0,0,2019-2020,,
2012,Yussuf Poulsen,DEN,FW,RB Leipzig,Bundesliga,25,1994,13.6,14,10,2,10,2,4,21,19.0,17,12,0,12,4,18,15,0,0,2019-2020,0.29411764705882354,1.0294117647058825
2013,Maxime Poundjé,FRA,DF,Bordeaux,Ligue 1,26,1992,0.0,0,0,0,0,0,0,0,0.0,0,0,0,0,0,0,0,0,0,2019-2020,,
2014,Darío Poveda,ESP,MF,Atlético Madrid,La Liga,22,1997,0.1,1,0,0,1,0,0,0,0.0,0,0,0,0,0,1,0,0,0,2019-2020,0.0,10.0
2015,Alejandro Pozo Pozo,ESP,DF,Mallorca,La Liga,20,1999,16.6,38,24,30,6,2,19,38,50.0,19,23,2,21,23,61,29,1,0,2019-2020,1.3855421686746987,2.2891566265060237
2016,Alejandro Pozo Pozo,ESP,"MF,FW",Sevilla,La Liga,20,1999,0.4,1,1,1,0,0,1,1,100.0,0,0,0,0,0,1,1,0,0,2019-2020,0.0,2.5
2017,Percy Prado,PER,DF,Nantes,Ligue 1,23,1996,2.1,6,5,3,2,1,5,9,55.6,4,1,0,1,1,7,5,0,0,2019-2020,0.47619047619047616,2.857142857142857
2018,Dennis Praet,BEL,MF,Leicester City,Premier League,25,1994,12.6,33,18,8,21,4,9,29,31.0,20,19,1,18,17,50,12,0,0,2019-2020,1.3492063492063493,2.619047619047619
2019,Abdón Prats,ESP,FW,Mallorca,La Liga,26,1992,3.1,1,1,0,0,1,0,1,0.0,1,1,0,1,0,1,1,0,0,2019-2020,0.0,0.3225806451612903
2020,Sanjin Prcić,BIH,"MF,FW",Strasbourg,Ligue 1,25,1993,0.9,1,0,0,0,1,1,2,50.0,1,1,1,0,1,2,0,0,0,2019-2020,1.1111111111111112,1.1111111111111112
2021,Nicolas de Préville,FRA,"MF,FW",Bordeaux,Ligue 1,28,1991,22.2,35,21,9,22,4,18,56,32.1,38,15,3,12,6,41,19,0,0,2019-2020,0.2702702702702703,1.5765765765765767
2022,Sebastian Prödl,AUT,DF,Watford,Premier League,32,1987,0.6,0,0,0,0,0,0,0,0.0,0,0,0,0,0,0,4,0,0,2019-2020,0.0,0.0
2023,Kai Pröger,GER,"MF,FW",Paderborn 07,Bundesliga,27,1992,23.1,43,22,21,17,5,17,58,29.3,41,34,6,28,14,57,20,1,0,2019-2020,0.6060606060606061,1.8614718614718613
2024,Grischa Prömel,GER,MF,Union Berlin,Bundesliga,24,1995,10.3,14,11,6,6,2,7,19,36.8,12,10,2,8,14,28,9,0,0,2019-2020,1.3592233009708736,1.3592233009708736
2025,Davy Pröpper,NED,MF,Brighton,Premier League,27,1991,31.4,64,35,28,28,8,23,74,31.1,51,27,8,19,38,102,36,4,0,2019-2020,1.2101910828025477,2.038216560509554
Rk,Player,Nation,Pos,Squad,Comp,0,0,90.0,0,0,3,3,3,Tkl,0,0.0,0,0,0,0,0,0,0,0,0,2019-2020,0.0,0.0
2026,Antonio Puertas,ESP,"FW,MF",Granada,La Liga,27,1992,28.5,37,24,8,18,11,16,53,30.2,37,21,3,18,12,49,21,0,0,2019-2020,0.42105263157894735,1.2982456140350878
2027,Riqui Puig,ESP,MF,Barcelona,La Liga,19,1999,5.7,11,7,1,9,1,5,17,29.4,12,2,0,2,5,16,1,0,0,2019-2020,0.8771929824561403,1.9298245614035088
2028,Teemu Pukki,FIN,FW,Norwich City,Premier League,29,1990,32.1,12,6,3,5,4,1,23,4.3,22,13,0,13,6,18,7,0,0,2019-2020,0.18691588785046728,0.37383177570093457
2029,Erick Pulgar,CHI,MF,Fiorentina,Serie A,25,1994,32.8,73,46,25,41,7,22,96,22.9,74,45,15,30,49,122,53,1,0,2019-2020,1.4939024390243905,2.225609756097561
2030,Christian Pulisic,USA,FW,Chelsea,Premier League,20,1998,19.1,23,11,13,4,6,7,24,29.2,17,15,0,15,6,29,11,0,0,2019-2020,0.31413612565445026,1.2041884816753925
2031,Ignacio Pussetto,ARG,"FW,MF",Watford,Premier League,23,1995,0.8,7,4,4,2,1,3,8,37.5,5,2,1,1,3,10,4,0,0,2019-2020,3.75,8.75
2032,Ignacio Pussetto,ARG,"FW,MF",Udinese,Serie A,23,1995,3.8,8,4,4,3,1,1,4,25.0,3,3,0,3,4,12,7,0,0,2019-2020,1.0526315789473684,2.1052631578947367
2033,Fabio Quagliarella,ITA,FW,Sampdoria,Serie A,36,1983,25.3,9,5,0,6,3,2,30,6.7,28,13,0,13,8,17,15,0,0,2019-2020,0.31620553359683795,0.3557312252964427
2034,Robin Quaison,SWE,"FW,MF",Mainz 05,Bundesliga,25,1993,28.9,25,17,15,7,3,11,32,34.4,21,27,5,22,11,36,8,0,0,2019-2020,0.3806228373702422,0.8650519031141869
2035,Domingos Quina,POR,"MF,FW",Watford,Premier League,19,1999,0.2,2,0,1,1,0,1,2,50.0,1,3,0,3,0,2,0,0,0,2019-2020,0.0,10.0
2036,Quini,ESP,DF,Granada,La Liga,29,1989,8.0,25,14,16,7,2,13,22,59.1,9,5,1,4,10,35,14,0,0,2019-2020,1.25,3.125
2037,Xavi Quintillà,ESP,DF,Villarreal,La Liga,22,1996,17.5,22,12,14,4,4,10,20,50.0,10,11,4,7,12,34,35,0,0,2019-2020,0.6857142857142857,1.2571428571428571
2038,Quique,ESP,"FW,MF",Eibar,La Liga,29,1990,5.4,2,1,1,0,1,0,0,0.0,0,3,0,3,0,2,3,0,0,2019-2020,0.0,0.37037037037037035
2039,Adrien Rabiot,FRA,MF,Juventus,Serie A,24,1995,21.2,47,31,16,19,12,15,41,36.6,26,36,6,30,32,79,19,0,0,2019-2020,1.509433962264151,2.216981132075472
2040,Nemanja Radoja,SRB,MF,Levante,La Liga,26,1993,22.1,43,19,27,16,0,15,46,32.6,31,21,4,17,23,66,24,0,0,2019-2020,1.0407239819004523,1.9457013574660633
2041,Nemanja Radonjić,SRB,"FW,MF",Marseille,Ligue 1,23,1996,9.8,10,3,4,3,3,6,17,35.3,11,7,0,7,2,12,7,0,0,2019-2020,0.2040816326530612,1.0204081632653061
2042,Ivan Radovanović,SRB,MF,Genoa,Serie A,30,1988,14.6,27,14,18,9,0,10,26,38.5,16,17,3,14,8,35,39,0,0,2019-2020,0.547945205479452,1.8493150684931507
2043,Ionuț Radu,ROU,GK,Genoa,Serie A,22,1997,17.0,0,0,0,0,0,0,2,0.0,2,0,0,0,1,1,7,1,0,2019-2020,0.058823529411764705,0.0
2044,Ștefan Radu,ROU,DF,Lazio,Serie A,32,1986,25.6,43,25,24,15,4,28,43,65.1,15,19,9,10,34,77,85,0,0,2019-2020,1.328125,1.6796875
2045,Boris Radunović,SRB,GK,Hellas Verona,Serie A,23,1996,3.0,0,0,0,0,0,0,0,0.0,0,0,0,0,0,0,1,0,0,2019-2020,0.0,0.0
2046,Rafael,BRA,GK,Cagliari,Serie A,37,1982,5.0,0,0,0,0,0,0,0,0.0,0,0,0,0,0,0,3,0,0,2019-2020,0.0,0.0
2047,Rafael,BRA,DF,Lyon,Ligue 1,29,1990,7.8,24,16,12,8,4,10,18,55.6,8,6,3,3,10,34,14,0,0,2019-2020,1.2820512820512822,3.076923076923077
2048,Raffael,BRA,"MF,FW",Gladbach,Bundesliga,34,1985,0.7,0,0,0,0,0,0,2,0.0,2,2,0,2,0,0,0,0,0,2019-2020,0.0,0.0
2049,Rafinha,BRA,"FW,MF",Barcelona,La Liga,26,1993,2.1,3,2,1,1,1,1,2,50.0,1,0,0,0,1,4,0,0,0,2019-2020,0.47619047619047616,1.4285714285714286
2050,Rafinha,BRA,MF,Celta Vigo,La Liga,26,1993,23.5,71,37,29,37,5,20,62,32.3,42,37,4,33,33,104,25,0,0,2019-2020,1.4042553191489362,3.021276595744681
Rk,Player,Nation,Pos,Squad,Comp,0,0,90.0,0,0,3,3,3,Tkl,0,0.0,0,0,0,0,0,0,0,0,0,2019-2020,0.0,0.0
2051,Daniele Ragatzu,ITA,"MF,FW",Cagliari,Serie A,27,1991,3.5,3,2,0,2,1,1,3,33.3,2,1,0,1,1,4,5,0,0,2019-2020,0.2857142857142857,0.8571428571428571
2052,Baba Rahman,GHA,DF,Mallorca,La Liga,25,1994,1.2,3,2,2,0,1,0,0,0.0,0,2,1,1,1,4,2,0,0,2019-2020,0.8333333333333334,2.5
2053,Antonio Raillo,ESP,DF,Mallorca,La Liga,27,1991,30.8,31,21,24,7,0,13,19,68.4,6,31,26,5,22,53,112,1,0,2019-2020,0.7142857142857143,1.0064935064935066
2054,Predrag Rajković,SRB,GK,Reims,Ligue 1,23,1995,27.0,1,1,1,0,0,1,1,100.0,0,0,0,0,1,2,9,0,0,2019-2020,0.037037037037037035,0.037037037037037035
2055,Ivan Rakitić,CRO,MF,Barcelona,La Liga,31,1988,17.7,27,14,8,15,4,10,28,35.7,18,19,6,13,15,42,18,1,0,2019-2020,0.8474576271186441,1.5254237288135595
2056,Benito Raman,BEL,FW,Schalke 04,Bundesliga,24,1994,17.8,18,9,4,9,5,7,24,29.2,17,11,1,10,7,25,1,0,0,2019-2020,0.3932584269662921,1.0112359550561798
2057,Gastón Ramírez,URU,"MF,FW",Sampdoria,Serie A,28,1990,15.5,32,21,7,16,9,8,30,26.7,22,28,2,26,11,43,10,0,0,2019-2020,0.7096774193548387,2.064516129032258
2058,Sandro Ramírez,ESP,"FW,MF",Valladolid,La Liga,24,1995,14.5,12,10,2,6,4,2,20,10.0,18,11,1,10,7,19,2,0,0,2019-2020,0.4827586206896552,0.8275862068965517
2059,Iván Ramis,ESP,DF,Eibar,La Liga,34,1984,5.1,3,2,2,1,0,1,4,25.0,3,2,0,2,4,7,23,2,0,2019-2020,0.7843137254901962,0.5882352941176471
2060,Adrián Ramos,COL,"FW,MF",Granada,La Liga,33,1986,2.5,6,2,0,2,4,2,3,66.7,1,2,0,2,1,7,1,0,0,2019-2020,0.4,2.4
2061,Sergio Ramos,ESP,DF,Real Madrid,La Liga,33,1986,33.5,46,31,26,17,3,20,42,47.6,22,22,9,13,49,95,102,4,0,2019-2020,1.462686567164179,1.373134328358209
2062,Aaron Ramsdale,ENG,GK,Bournemouth,Premier League,21,1998,37.0,4,3,4,0,0,3,3,100.0,0,0,0,0,0,4,25,1,0,2019-2020,0.0,0.10810810810810811
2063,Aaron Ramsey,WAL,MF,Juventus,Serie A,28,1990,11.7,20,15,6,8,6,6,24,25.0,18,18,3,15,11,31,12,0,0,2019-2020,0.9401709401709403,1.7094017094017095
2064,Darren Randolph,IRL,GK,West Ham,Premier League,32,1987,2.0,0,0,0,0,0,0,0,0.0,0,0,0,0,0,0,2,0,0,2019-2020,0.0,0.0
2065,Luca Ranieri,ITA,DF,Fiorentina,Serie A,20,1999,2.6,2,2,2,0,0,2,3,66.7,1,1,0,1,2,4,7,0,0,2019-2020,0.7692307692307692,0.7692307692307692
2066,Andrea Ranocchia,ITA,DF,Inter,Serie A,31,1988,5.8,17,10,10,7,0,5,8,62.5,3,11,6,5,8,25,18,0,0,2019-2020,1.3793103448275863,2.931034482758621
2067,Raphinha,BRA,"MF,FW",Rennes,Ligue 1,22,1996,18.8,22,18,5,12,5,10,32,31.3,22,23,1,22,17,39,14,1,0,2019-2020,0.9042553191489361,1.1702127659574468
2068,Tobias Raschl,GER,MF,Dortmund,Bundesliga,19,2000,0.3,0,0,0,0,0,0,1,0.0,1,1,0,1,0,0,0,0,0,2019-2020,0.0,0.0
2069,Marcus Rashford,ENG,FW,Manchester Utd,Premier League,21,1997,29.4,13,9,1,6,6,9,23,39.1,14,23,0,23,10,23,19,0,0,2019-2020,0.3401360544217687,0.44217687074829937
2070,Milot Rashica,KVX,FW,Werder Bremen,Bundesliga,23,1996,25.2,21,14,13,6,2,9,33,27.3,24,15,2,13,6,27,16,1,0,2019-2020,0.2380952380952381,0.8333333333333334
2071,Giacomo Raspadori,ITA,"MF,FW",Sassuolo,Serie A,19,2000,2.9,8,6,5,2,1,3,4,75.0,1,5,0,5,1,9,0,0,0,2019-2020,0.3448275862068966,2.7586206896551726
2072,Raúl,ESP,"FW,MF",Betis,La Liga,18,2000,0.2,0,0,0,0,0,0,2,0.0,2,0,0,0,0,0,0,0,0,2019-2020,0.0,0.0
2073,Ante Rebić,CRO,"FW,MF",Milan,Serie A,25,1993,15.5,16,11,4,9,3,7,34,20.6,27,14,1,13,3,19,12,0,0,2019-2020,0.1935483870967742,1.032258064516129
2074,Ante Rebić,CRO,"FW,MF",Eint Frankfurt,Bundesliga,25,1993,1.0,1,0,0,1,0,0,0,0.0,0,0,0,0,0,1,1,0,0,2019-2020,0.0,1.0
2075,Arkadiusz Reca,POL,DF,SPAL,Serie A,24,1995,21.4,38,23,22,10,6,13,39,33.3,26,15,2,13,32,70,48,1,0,2019-2020,1.4953271028037385,1.7757009345794394
Rk,Player,Nation,Pos,Squad,Comp,0,0,90.0,0,0,3,3,3,Tkl,0,0.0,0,0,0,0,0,0,0,0,0,2019-2020,0.0,0.0
2076,Recio,ESP,MF,Leganés,La Liga,28,1991,17.4,30,19,13,12,5,10,40,25.0,30,14,3,11,22,52,9,0,0,2019-2020,1.264367816091954,1.7241379310344829
2077,Daishawn Redan,NED,MF,Hertha BSC,Bundesliga,18,2001,0.2,0,0,0,0,0,0,1,0.0,1,0,0,0,0,0,0,0,0,2019-2020,0.0,0.0
2078,Nathan Redmond,ENG,"MF,FW",Southampton,Premier League,25,1994,30.7,49,29,17,23,9,21,57,36.8,36,39,2,37,16,65,16,0,0,2019-2020,0.5211726384364821,1.5960912052117264
2079,Fabian Reese,GER,FW,Schalke 04,Bundesliga,21,1997,1.0,1,1,1,0,0,0,0,0.0,0,1,1,0,0,1,1,0,0,2019-2020,0.0,1.0
2080,Vasco Regini,ITA,DF,Sampdoria,Serie A,28,1990,1.9,4,2,3,1,0,0,0,0.0,0,4,2,2,1,5,6,0,0,2019-2020,0.5263157894736842,2.1052631578947367
2081,Vasco Regini,ITA,DF,Parma,Serie A,28,1990,0.6,0,0,0,0,0,0,0,0.0,0,0,0,0,0,0,3,0,0,2019-2020,0.0,0.0
2082,Sergio Reguilón,ESP,DF,Sevilla,La Liga,22,1996,27.9,57,30,28,25,4,27,64,42.2,37,25,5,20,33,90,53,0,0,2019-2020,1.1827956989247312,2.043010752688172
2083,Ken Reichel,GER,DF,Union Berlin,Bundesliga,32,1986,5.9,6,3,2,3,1,3,13,23.1,10,8,1,7,9,15,12,0,0,2019-2020,1.5254237288135593,1.0169491525423728
2084,Manolo Reina,ESP,GK,Mallorca,La Liga,34,1985,36.0,0,0,0,0,0,0,1,0.0,1,2,0,2,5,5,9,1,0,2019-2020,0.1388888888888889,0.0
2085,Pepe Reina,ESP,GK,Aston Villa,Premier League,36,1982,12.0,0,0,0,0,0,0,2,0.0,2,0,0,0,0,0,9,1,0,2019-2020,0.0,0.0
2086,Pepe Reina,ESP,GK,Milan,Serie A,36,1982,1.0,0,0,0,0,0,0,0,0.0,0,0,0,0,0,0,0,1,0,2019-2020,0.0,0.0
2087,Jeff Reine-Adélaïde,FRA,MF,Angers,Ligue 1,21,1998,0.9,3,1,1,2,0,1,1,100.0,0,1,0,1,0,3,1,0,0,2019-2020,0.0,3.333333333333333
2088,Jeff Reine-Adélaïde,FRA,"MF,FW",Lyon,Ligue 1,21,1998,8.7,10,8,3,3,4,5,13,38.5,8,3,1,2,7,17,4,0,0,2019-2020,0.8045977011494253,1.149425287356322
2089,Karim Rekik,NED,DF,Hertha BSC,Bundesliga,24,1994,14.0,16,10,10,6,0,3,6,50.0,3,23,15,8,18,34,44,0,0,2019-2020,1.2857142857142858,1.1428571428571428
2090,Álex Remiro,ESP,GK,Real Sociedad,La Liga,24,1995,25.0,0,0,0,0,0,0,1,0.0,1,0,0,0,0,0,25,1,0,2019-2020,0.0,0.0
2091,Loïc Rémy,FRA,FW,Lille,Ligue 1,32,1987,10.7,4,1,0,3,1,0,4,0.0,4,1,1,0,0,4,7,0,0,2019-2020,0.0,0.3738317757009346
2092,Panagiotis Retsos,GRE,DF,Leverkusen,Bundesliga,20,1998,1.3,6,3,4,2,0,1,4,25.0,3,2,0,2,2,8,2,0,0,2019-2020,1.5384615384615383,4.615384615384615
2093,Marco Reus,GER,"MF,FW",Dortmund,Bundesliga,30,1989,16.6,26,16,5,11,10,3,19,15.8,16,17,2,15,9,35,11,0,0,2019-2020,0.5421686746987951,1.5662650602409638
2094,Elvis Rexhbeçaj,GER,MF,Köln,Bundesliga,21,1997,6.9,16,12,9,5,2,5,13,38.5,8,7,0,7,3,19,4,0,0,2019-2020,0.43478260869565216,2.318840579710145
2095,Gio Reyna,USA,"MF,FW",Dortmund,Bundesliga,16,2002,3.9,6,2,1,5,0,1,4,25.0,3,3,0,3,0,6,2,0,0,2019-2020,0.0,1.5384615384615385
2096,Baptiste Reynet,FRA,GK,Toulouse,Ligue 1,28,1990,22.6,1,1,1,0,0,1,3,33.3,2,0,0,0,0,1,12,0,0,2019-2020,0.0,0.04424778761061947
2097,Nico Ribaudo,ESP,"FW,MF",Espanyol,La Liga,18,2001,2.0,3,1,1,0,2,2,6,33.3,4,1,0,1,1,4,0,0,0,2019-2020,0.5,1.5
2098,Lucas Ribeiro,BRA,MF,Hoffenheim,Bundesliga,20,1999,0.7,1,0,1,0,0,0,3,0.0,3,1,0,1,1,2,1,0,0,2019-2020,1.4285714285714286,1.4285714285714286
2099,Franck Ribéry,FRA,FW,Fiorentina,Serie A,36,1983,15.7,20,14,7,10,3,4,20,20.0,16,9,0,9,3,23,3,0,0,2019-2020,0.1910828025477707,1.2738853503184715
2100,Davide Riccardi,ITA,DF,Lecce,Serie A,23,1996,0.2,0,0,0,0,0,0,1,0.0,1,0,0,0,0,0,1,0,0,2019-2020,0.0,0.0
Rk,Player,Nation,Pos,Squad,Comp,0,0,90.0,0,0,3,3,3,Tkl,0,0.0,0,0,0,0,0,0,0,0,0,2019-2020,0.0,0.0
2101,Declan Rice,ENG,MF,West Ham,Premier League,20,1999,38.0,116,60,64,48,4,47,98,48.0,51,41,9,32,77,193,55,0,0,2019-2020,2.026315789473684,3.0526315789473686
2102,Chris Richards,USA,DF,Bayern Munich,Bundesliga,19,2000,0.1,0,0,0,0,0,0,0,0.0,0,0,0,0,0,0,1,0,0,2019-2020,0.0,0.0
2103,Richarlison,BRA,"FW,MF",Everton,Premier League,22,1997,34.1,70,47,28,28,14,27,56,48.2,29,34,4,30,12,82,42,0,0,2019-2020,0.3519061583577712,2.0527859237536656
2104,Marco Richter,GER,"MF,FW",Augsburg,Bundesliga,21,1997,25.3,21,16,7,9,5,14,51,27.5,37,15,0,15,24,45,17,0,0,2019-2020,0.9486166007905138,0.8300395256916996
2105,Diego Rico,ESP,DF,Bournemouth,Premier League,26,1993,25.9,61,39,32,24,5,29,59,49.2,30,31,7,24,84,145,91,0,0,2019-2020,3.2432432432432434,2.3552123552123554
2106,Sergio Rico,ESP,GK,Paris S-G,Ligue 1,25,1993,2.0,0,0,0,0,0,0,0,0.0,0,0,0,0,0,0,1,2,0,2019-2020,0.0,0.0
2107,Jaïro Riedewald,NED,"DF,MF",Crystal Palace,Premier League,22,1996,8.5,14,10,4,10,0,7,11,63.6,4,7,2,5,17,31,23,1,0,2019-2020,2.0,1.6470588235294117
2108,Emiliano Rigoni,ARG,"MF,FW",Sampdoria,Serie A,26,1993,4.8,5,4,2,1,2,3,10,30.0,7,5,1,4,3,8,1,0,0,2019-2020,0.625,1.0416666666666667
2109,Tomás Rincón,VEN,MF,Torino,Serie A,31,1988,30.0,56,25,23,25,8,23,65,35.4,42,20,3,17,36,92,62,0,0,2019-2020,1.2,1.8666666666666667
2110,Luis Rioja,ESP,MF,Alavés,La Liga,25,1993,18.2,18,12,11,6,1,8,25,32.0,17,21,0,21,16,34,6,0,0,2019-2020,0.8791208791208791,0.989010989010989
2111,Renaud Ripart,FRA,"FW,DF",Nîmes,Ligue 1,26,1993,22.5,39,23,17,20,2,18,46,39.1,28,17,2,15,12,51,37,0,0,2019-2020,0.5333333333333333,1.7333333333333334
2112,Rodrigo Riquelme,ESP,"FW,MF",Atlético Madrid,La Liga,19,2000,0.1,0,0,0,0,0,0,0,0.0,0,0,0,0,0,0,0,0,0,2019-2020,0.0,0.0
2113,Andrea Rispoli,ITA,DF,Lecce,Serie A,30,1988,21.2,24,18,14,9,1,15,30,50.0,15,28,7,21,32,56,62,1,0,2019-2020,1.509433962264151,1.1320754716981132
2114,Marcel Risse,GER,"MF,FW",Köln,Bundesliga,29,1989,1.5,3,2,3,0,0,1,1,100.0,0,1,0,1,1,4,1,0,0,2019-2020,0.6666666666666666,2.0
2115,Mihailo Ristić,SRB,"DF,MF",Montpellier,Ligue 1,23,1995,9.0,18,14,7,11,0,9,20,45.0,11,7,2,5,7,25,18,0,0,2019-2020,0.7777777777777778,2.0
2116,Matt Ritchie,SCO,"DF,MF",Newcastle Utd,Premier League,29,1989,14.6,22,15,9,10,3,3,15,20.0,12,20,5,15,14,36,31,1,0,2019-2020,0.9589041095890412,1.5068493150684932
2117,Marlon Ritter,GER,MF,Paderborn 07,Bundesliga,24,1994,4.8,7,5,5,2,0,4,9,44.4,5,7,0,7,8,15,3,0,0,2019-2020,1.6666666666666667,1.4583333333333335
2118,Cristian Rivera,ESP,MF,Leganés,La Liga,22,1997,3.5,6,4,3,2,1,2,4,50.0,2,4,3,1,4,10,7,0,0,2019-2020,1.1428571428571428,1.7142857142857142
2119,Maxence Rivera,FRA,"MF,FW",Saint-Étienne,Ligue 1,17,2002,0.3,0,0,0,0,0,0,1,0.0,1,1,0,1,0,0,0,0,0,2019-2020,0.0,0.0
2120,Rober,ESP,DF,Levante,La Liga,24,1995,2.1,3,1,2,0,1,2,2,100.0,0,0,0,0,3,6,2,0,0,2019-2020,1.4285714285714286,1.4285714285714286
2121,Roberto,ESP,GK,West Ham,Premier League,33,1986,7.6,0,0,0,0,0,0,0,0.0,0,0,0,0,0,0,2,2,0,2019-2020,0.0,0.0
2122,Roberto,ESP,GK,Alavés,La Liga,33,1986,8.8,1,1,1,0,0,1,1,100.0,0,0,0,0,0,1,2,0,0,2019-2020,0.0,0.11363636363636363
2123,Sergi Roberto,ESP,"DF,MF",Barcelona,La Liga,27,1992,26.0,35,22,16,11,8,15,25,60.0,10,12,3,9,33,68,36,0,0,2019-2020,1.2692307692307692,1.3461538461538463
2124,Patrick Roberts,ENG,"FW,MF",Norwich City,Premier League,22,1997,0.3,0,0,0,0,0,0,0,0.0,0,0,0,0,0,0,0,0,0,2019-2020,0.0,0.0
2125,Andrew Robertson,SCO,DF,Liverpool,Premier League,25,1994,34.6,54,31,17,25,12,27,61,44.3,34,29,7,22,38,92,72,1,0,2019-2020,1.0982658959537572,1.560693641618497
Rk,Player,Nation,Pos,Squad,Comp,0,0,90.0,0,0,3,3,3,Tkl,0,0.0,0,0,0,0,0,0,0,0,0,2019-2020,0.0,0.0
2126,Callum Robinson,IRL,"FW,MF",Sheffield Utd,Premier League,24,1995,7.5,6,3,2,2,2,2,7,28.6,5,3,0,3,7,13,3,0,0,2019-2020,0.9333333333333333,0.8
2127,Jack Robinson,ENG,DF,Sheffield Utd,Premier League,25,1993,5.6,10,5,5,5,0,1,6,16.7,5,12,5,7,8,18,24,0,0,2019-2020,1.4285714285714286,1.7857142857142858
2128,Joel Robles,ESP,GK,Betis,La Liga,29,1990,32.1,0,0,0,0,0,0,2,0.0,2,0,0,0,0,0,13,2,0,2019-2020,0.0,0.0
2129,Marc Roca,ESP,MF,Espanyol,La Liga,22,1996,33.4,82,52,29,44,9,29,82,35.4,53,28,10,18,31,113,53,2,0,2019-2020,0.9281437125748503,2.4550898203592815
2130,Rubén Rochina,ESP,MF,Levante,La Liga,28,1991,20.8,41,26,22,9,10,19,52,36.5,33,16,0,16,12,53,19,1,0,2019-2020,0.5769230769230769,1.971153846153846
2131,Sebastian Rode,GER,MF,Eint Frankfurt,Bundesliga,28,1990,21.5,58,33,27,27,4,17,59,28.8,42,32,5,27,34,92,13,0,0,2019-2020,1.5813953488372092,2.697674418604651
2132,Rodri,ESP,MF,Manchester City,Premier League,23,1996,27.6,50,30,17,25,8,23,63,36.5,40,19,5,14,26,76,35,0,0,2019-2020,0.9420289855072463,1.8115942028985506
2133,Rodrigo,ESP,FW,Valencia,La Liga,28,1991,20.9,10,6,4,5,1,2,23,8.7,21,9,1,8,9,19,13,0,0,2019-2020,0.430622009569378,0.47846889952153115
2134,Kévin Rodrigues,POR,"DF,MF",Leganés,La Liga,25,1994,21.5,56,31,31,17,8,25,46,54.3,21,30,3,27,31,87,26,1,0,2019-2020,1.441860465116279,2.604651162790698
2135,Kévin Rodrigues,POR,DF,Real Sociedad,La Liga,25,1994,0.1,1,0,1,0,0,1,1,100.0,0,0,0,0,0,1,0,0,0,2019-2020,0.0,10.0
2136,Ángel Rodríguez,ESP,FW,Getafe,La Liga,32,1987,15.6,14,8,2,8,4,2,18,11.1,16,10,1,9,3,17,10,0,0,2019-2020,0.19230769230769232,0.8974358974358975
2137,Óscar Rodríguez Arnaiz,ESP,"MF,FW",Leganés,La Liga,21,1998,21.3,23,10,11,7,5,13,41,31.7,28,19,0,19,14,37,13,0,0,2019-2020,0.6572769953051643,1.07981220657277
2138,Dani Rodríguez,ESP,"MF,FW",Mallorca,La Liga,31,1988,33.8,59,32,24,28,7,18,61,29.5,43,35,3,32,38,97,27,1,0,2019-2020,1.124260355029586,1.745562130177515
2139,Guido Rodríguez,ARG,MF,Betis,La Liga,25,1994,10.4,24,16,11,11,2,15,25,60.0,10,13,4,9,10,34,21,0,0,2019-2020,0.9615384615384615,2.3076923076923075
2140,James Rodríguez,COL,"MF,FW",Real Madrid,La Liga,28,1991,4.7,17,13,6,8,3,6,12,50.0,6,3,0,3,3,20,1,0,0,2019-2020,0.6382978723404255,3.6170212765957444
2141,Jay Rodriguez,ENG,FW,Burnley,Premier League,30,1989,22.4,29,19,4,13,12,8,33,24.2,25,33,6,27,5,34,12,0,0,2019-2020,0.22321428571428573,1.2946428571428572
2142,Mario Rodriguez,ESP,MF,Granada,La Liga,22,1997,0.0,0,0,0,0,0,0,0,0.0,0,0,0,0,0,0,0,0,0,2019-2020,,
2143,Ricardo Rodríguez,SUI,DF,Milan,Serie A,26,1992,4.3,6,1,2,2,2,2,6,33.3,4,3,2,1,5,11,17,0,0,2019-2020,1.1627906976744187,1.3953488372093024
2144,Rodrygo,BRA,FW,Real Madrid,La Liga,18,2001,11.3,6,1,2,3,1,2,21,9.5,19,13,0,13,10,16,5,0,0,2019-2020,0.8849557522123893,0.5309734513274336
2145,Jack Rodwell,ENG,MF,Sheffield Utd,Premier League,28,1991,0.2,0,0,0,0,0,0,0,0.0,0,0,0,0,0,0,1,0,0,2019-2020,0.0,0.0
2146,Marko Rog,CRO,MF,Cagliari,Serie A,24,1995,25.7,69,47,31,29,9,22,84,26.2,62,40,12,28,22,91,23,0,0,2019-2020,0.8560311284046693,2.6848249027237356
2147,Agustín Rogel,URU,DF,Toulouse,Ligue 1,21,1997,9.5,15,8,12,3,0,7,13,53.8,6,13,10,3,11,26,35,2,0,2019-2020,1.1578947368421053,1.5789473684210527
2148,Rogério,BRA,DF,Sassuolo,Serie A,21,1998,11.3,22,14,12,8,2,16,23,69.6,7,13,3,10,9,31,34,0,0,2019-2020,0.7964601769911503,1.9469026548672566
2149,Marcos Rojo,ARG,DF,Manchester Utd,Premier League,29,1990,1.4,3,1,2,1,0,1,2,50.0,1,2,1,1,0,3,6,0,0,2019-2020,0.0,2.142857142857143
2150,Filippo Romagna,ITA,DF,Sassuolo,Serie A,22,1997,16.4,7,6,2,5,0,5,6,83.3,1,24,17,7,10,17,69,0,0,2019-2020,0.6097560975609757,0.426829268292683
Rk,Player,Nation,Pos,Squad,Comp,0,0,90.0,0,0,3,3,3,Tkl,0,0.0,0,0,0,0,0,0,0,0,0,2019-2020,0.0,0.0
2151,Alessio Romagnoli,ITA,DF,Milan,Serie A,24,1995,34.3,46,25,28,15,3,16,27,59.3,11,32,18,14,56,102,157,1,0,2019-2020,1.6326530612244898,1.3411078717201168
2152,Alaixys Romao,TOG,MF,Reims,Ligue 1,35,1984,19.8,46,29,31,14,1,17,57,29.8,40,12,3,9,26,72,38,3,0,2019-2020,1.3131313131313131,2.323232323232323
2153,Cristian Romero,ARG,DF,Genoa,Serie A,21,1998,28.6,52,35,36,12,4,12,41,29.3,29,59,33,26,75,127,116,2,0,2019-2020,2.622377622377622,1.8181818181818181
2154,Luka Romero,ARG,FW,Mallorca,La Liga,14,2004,0.1,0,0,0,0,0,0,0,0.0,0,0,0,0,0,0,0,0,0,2019-2020,0.0,0.0
2155,Oriol Romeu,ESP,MF,Southampton,Premier League,27,1991,20.7,55,35,23,30,2,27,75,36.0,48,35,13,22,34,89,32,0,0,2019-2020,1.642512077294686,2.6570048309178746
2156,Rômulo,ITA,MF,Brescia,Serie A,32,1987,19.1,30,19,12,14,4,12,34,35.3,22,18,1,17,8,38,12,1,0,2019-2020,0.41884816753926696,1.5706806282722512
2157,Rômulo,ITA,DF,Genoa,Serie A,32,1987,0.2,2,1,1,1,0,0,0,0.0,0,0,0,0,0,2,1,0,0,2019-2020,0.0,10.0
2158,Cristiano Ronaldo,POR,FW,Juventus,Serie A,34,1985,32.4,14,10,3,3,8,4,20,20.0,16,10,3,7,6,20,21,1,0,2019-2020,0.1851851851851852,0.4320987654320988
2159,Facundo Roncaglia,ARG,DF,Osasuna,La Liga,32,1987,14.2,24,20,12,10,2,11,20,55.0,9,18,3,15,22,46,46,0,0,2019-2020,1.5492957746478875,1.6901408450704227
2160,Valentin Rongier,FRA,MF,Marseille,Ligue 1,24,1994,19.9,76,51,25,41,10,22,63,34.9,41,30,4,26,36,112,16,2,0,2019-2020,1.8090452261306533,3.819095477386935
2161,Valentin Rongier,FRA,MF,Nantes,Ligue 1,24,1994,3.0,5,4,0,2,3,3,5,60.0,2,4,0,4,2,7,0,0,0,2019-2020,0.6666666666666666,1.6666666666666667
2162,Marten de Roon,NED,"MF,DF",Atalanta,Serie A,28,1991,30.2,77,43,36,29,12,34,75,45.3,41,32,8,24,46,123,45,0,0,2019-2020,1.5231788079470199,2.5496688741721854
2163,Roberto Rosales,VEN,DF,Leganés,La Liga,30,1988,20.8,42,23,23,17,2,19,43,44.2,24,17,4,13,30,72,48,0,0,2019-2020,1.4423076923076923,2.019230769230769
2164,Antonio Rosati,ITA,GK,Torino,Serie A,36,1983,1.0,0,0,0,0,0,0,0,0.0,0,0,0,0,0,0,0,1,0,2019-2020,0.0,0.0
2165,Danny Rose,ENG,DF,Tottenham,Premier League,29,1990,9.9,18,11,6,10,2,9,20,45.0,11,14,6,8,8,26,34,2,0,2019-2020,0.8080808080808081,1.8181818181818181
2166,Danny Rose,ENG,DF,Newcastle Utd,Premier League,29,1990,9.6,21,12,11,8,2,12,21,57.1,9,11,4,7,10,31,14,1,0,2019-2020,1.0416666666666667,2.1875
2167,Luca Rossettini,ITA,DF,Lecce,Serie A,34,1985,25.1,25,14,18,7,0,17,34,50.0,17,31,22,9,35,60,126,1,0,2019-2020,1.394422310756972,0.99601593625498
2168,Francesco Rossi,ITA,GK,Atalanta,Serie A,28,1991,0.1,0,0,0,0,0,0,0,0.0,0,0,0,0,0,0,0,0,0,2019-2020,0.0,0.0
2169,Jérôme Roussillon,FRA,DF,Wolfsburg,Bundesliga,26,1993,26.3,48,29,26,18,4,15,29,51.7,14,33,5,28,30,78,58,0,0,2019-2020,1.1406844106463878,1.8250950570342206
2170,Nolan Roux,FRA,FW,Nîmes,Ligue 1,31,1988,6.5,5,2,1,3,1,1,3,33.3,2,2,0,2,4,9,5,0,0,2019-2020,0.6153846153846154,0.7692307692307693
2171,Nicolò Rovella,ITA,MF,Genoa,Serie A,17,2001,1.2,0,0,0,0,0,0,1,0.0,1,0,0,0,4,4,0,0,0,2019-2020,3.3333333333333335,0.0
2172,Amir Rrahmani,KVX,DF,Hellas Verona,Serie A,25,1994,35.9,50,31,26,19,5,26,46,56.5,20,50,31,19,30,80,151,1,0,2019-2020,0.8356545961002786,1.392757660167131
2173,Rubén,ESP,GK,Osasuna,La Liga,35,1984,17.6,1,1,1,0,0,1,1,100.0,0,0,0,0,0,1,9,1,0,2019-2020,0.0,0.056818181818181816
2174,Waldo Rubio,ESP,"MF,FW",Valladolid,La Liga,23,1995,9.8,13,8,10,3,0,5,31,16.1,26,12,0,12,7,20,7,0,0,2019-2020,0.7142857142857142,1.3265306122448979
2175,Antonio Rüdiger,GER,DF,Chelsea,Premier League,26,1993,19.0,28,18,19,7,2,16,25,64.0,9,15,9,6,16,44,59,1,0,2019-2020,0.8421052631578947,1.4736842105263157
Rk,Player,Nation,Pos,Squad,Comp,0,0,90.0,0,0,3,3,3,Tkl,0,0.0,0,0,0,0,0,0,0,0,0,2019-2020,0.0,0.0
2176,Sebastian Rudy,GER,"MF,DF",Hoffenheim,Bundesliga,29,1990,30.4,73,49,31,29,13,28,75,37.3,47,26,5,21,27,100,38,0,0,2019-2020,0.8881578947368421,2.4013157894736845
2177,Stéphane Ruffier,FRA,GK,Saint-Étienne,Ligue 1,32,1986,22.0,0,0,0,0,0,0,0,0.0,0,0,0,0,0,0,5,3,0,2019-2020,0.0,0.0
2178,Dion Ruffo Luci,ITA,MF,Bologna,Serie A,18,2001,0.0,0,0,0,0,0,0,0,0.0,0,0,0,0,0,0,0,0,0,2019-2020,,
2179,Daniele Rugani,ITA,DF,Juventus,Serie A,25,1994,7.7,8,6,4,4,0,4,5,80.0,1,4,4,0,11,19,18,0,0,2019-2020,1.4285714285714286,1.0389610389610389
2180,Mário Rui,POR,DF,Napoli,Serie A,28,1991,21.8,31,17,12,12,7,11,29,37.9,18,24,5,19,21,52,43,0,0,2019-2020,0.963302752293578,1.4220183486238531
2181,Aitor Ruibal,ESP,"DF,MF",Leganés,La Liga,23,1996,13.6,27,17,14,11,2,16,39,41.0,23,18,1,17,8,35,11,0,0,2019-2020,0.5882352941176471,1.9852941176470589
2182,Fabián Ruiz Peña,ESP,MF,Napoli,Serie A,23,1996,29.8,43,26,19,18,6,24,65,36.9,41,32,4,28,32,75,18,2,0,2019-2020,1.0738255033557047,1.4429530201342282
2183,Gerónimo Rulli,ARG,GK,Montpellier,Ligue 1,27,1992,25.0,3,1,3,0,0,3,4,75.0,1,1,0,1,2,5,9,1,0,2019-2020,0.08,0.12
2184,Lukas Rupp,GER,"FW,MF",Norwich City,Premier League,28,1991,7.7,15,9,7,5,3,5,17,29.4,12,11,0,11,15,30,4,0,0,2019-2020,1.948051948051948,1.948051948051948
2185,Lukas Rupp,GER,MF,Hoffenheim,Bundesliga,28,1991,3.8,9,4,3,5,1,3,6,50.0,3,5,0,5,5,14,3,0,0,2019-2020,1.3157894736842106,2.368421052631579
2186,Mathew Ryan,AUS,GK,Brighton,Premier League,27,1992,38.0,1,1,1,0,0,1,4,25.0,3,0,0,0,2,3,13,2,0,2019-2020,0.05263157894736842,0.02631578947368421
2187,Julian Ryerson,NOR,"DF,MF",Union Berlin,Bundesliga,21,1997,4.1,7,5,2,1,4,3,6,50.0,3,5,3,2,5,12,9,0,0,2019-2020,1.2195121951219514,1.707317073170732
2188,Frederik Rønnow,DEN,GK,Eint Frankfurt,Bundesliga,26,1992,9.0,0,0,0,0,0,0,1,0.0,1,0,0,0,0,0,1,0,0,2019-2020,0.0,0.0
2189,João Victor Santos Sá,BRA,"MF,FW",Wolfsburg,Bundesliga,25,1994,18.1,35,22,12,17,6,10,38,26.3,28,31,1,30,9,44,9,0,0,2019-2020,0.49723756906077343,1.9337016574585635
2190,Roli Pereira de Sa,FRA,MF,Nantes,Ligue 1,22,1996,0.1,0,0,0,0,0,0,0,0.0,0,0,0,0,0,0,0,0,0,2019-2020,0.0,0.0
2191,Youssouf Sabaly,SEN,DF,Bordeaux,Ligue 1,26,1993,10.1,18,11,9,4,5,6,22,27.3,16,8,1,7,18,36,23,0,0,2019-2020,1.7821782178217822,1.7821782178217822
2192,Stefano Sabelli,ITA,DF,Brescia,Serie A,26,1993,35.2,83,44,51,28,4,50,106,47.2,56,40,13,27,58,141,107,0,0,2019-2020,1.6477272727272725,2.3579545454545454
2193,Abdelhamid Sabiri,MAR,MF,Paderborn 07,Bundesliga,22,1996,11.6,20,16,6,11,3,9,27,33.3,18,9,2,7,8,28,18,1,0,2019-2020,0.6896551724137931,1.7241379310344829
2194,Marcel Sabitzer,AUT,"MF,FW",RB Leipzig,Bundesliga,25,1994,27.8,39,25,15,18,6,19,56,33.9,37,27,4,23,23,62,25,0,0,2019-2020,0.8273381294964028,1.4028776978417266
2195,Ihsan Sacko,FRA,FW,Nice,Ligue 1,22,1997,1.6,1,1,1,0,0,0,1,0.0,1,0,0,0,0,1,0,0,0,2019-2020,0.0,0.625
2196,Alexis Saelemaekers,BEL,"FW,DF",Milan,Serie A,20,1999,7.6,14,8,5,7,2,6,20,30.0,14,13,1,12,8,22,1,0,0,2019-2020,1.0526315789473684,1.842105263157895
2197,Jorge Sáenz,ESP,DF,Celta Vigo,La Liga,22,1996,4.1,6,1,4,2,0,3,5,60.0,2,5,2,3,10,16,15,0,0,2019-2020,2.439024390243903,1.4634146341463417
2198,Nuri Şahin,TUR,MF,Werder Bremen,Bundesliga,30,1988,13.9,27,16,10,14,3,11,35,31.4,24,15,7,8,37,64,38,0,0,2019-2020,2.661870503597122,1.9424460431654675
2199,Wesley Saïd,FRA,"MF,FW",Toulouse,Ligue 1,24,1995,12.9,20,9,8,10,2,2,13,15.4,11,6,0,6,9,29,8,0,0,2019-2020,0.6976744186046512,1.5503875968992247
2200,Allan Saint-Maximin,FRA,"MF,FW",Newcastle Utd,Premier League,22,1997,20.7,13,8,7,4,2,4,18,22.2,14,5,2,3,9,22,6,0,0,2019-2020,0.43478260869565216,0.6280193236714976
Rk,Player,Nation,Pos,Squad,Comp,0,0,90.0,0,0,3,3,3,Tkl,0,0.0,0,0,0,0,0,0,0,0,0,2019-2020,0.0,0.0
2201,Théo Sainte-Luce,FRA,"MF,DF",Nîmes,Ligue 1,20,1998,0.2,0,0,0,0,0,0,0,0.0,0,0,0,0,0,0,0,0,0,2019-2020,0.0,0.0
2202,Borja Sainz,ESP,"MF,FW",Alavés,La Liga,18,2001,6.4,16,9,4,9,3,8,26,30.8,18,14,0,14,3,19,0,0,0,2019-2020,0.46875,2.5
2203,Romain Saïss,MAR,DF,Wolves,Premier League,29,1990,30.1,55,38,37,15,3,32,46,69.6,14,31,16,15,55,110,127,3,0,2019-2020,1.8272425249169435,1.8272425249169435
2204,Bukayo Saka,ENG,"DF,FW",Arsenal,Premier League,17,2001,19.5,36,21,21,8,7,19,37,51.4,18,12,3,9,12,48,19,0,0,2019-2020,0.6153846153846154,1.8461538461538463
2205,Hiroki Sakai,JPN,DF,Marseille,Ligue 1,29,1990,18.0,57,36,26,24,7,25,40,62.5,15,20,5,15,23,80,34,1,0,2019-2020,1.2777777777777777,3.1666666666666665
2206,Mamadou Sakho,FRA,DF,Crystal Palace,Premier League,29,1990,10.3,7,5,5,1,1,2,5,40.0,3,12,5,7,20,27,46,2,0,2019-2020,1.9417475728155338,0.6796116504854368
2207,Jacopo Sala,ITA,DF,SPAL,Serie A,27,1991,9.5,29,24,17,11,1,17,31,54.8,14,4,0,4,13,42,15,1,0,2019-2020,1.368421052631579,3.0526315789473686
2208,Mohamed Salah,EGY,FW,Liverpool,Premier League,27,1992,32.0,16,6,1,4,11,5,22,22.7,17,3,1,2,8,24,2,1,0,2019-2020,0.25,0.5
2209,Bartosz Salamon,POL,DF,SPAL,Serie A,28,1991,3.8,2,1,2,0,0,1,2,50.0,1,4,4,0,6,8,14,0,0,2019-2020,1.5789473684210527,0.5263157894736842
2210,Eddie Salcedo,ITA,"FW,MF",Hellas Verona,Serie A,17,2001,7.6,3,1,2,0,1,0,5,0.0,5,4,0,4,1,4,2,0,0,2019-2020,0.13157894736842105,0.39473684210526316
2211,William Saliba,FRA,DF,Saint-Étienne,Ligue 1,18,2001,11.0,19,9,15,3,1,5,10,50.0,5,13,4,9,21,40,36,1,0,2019-2020,1.9090909090909092,1.7272727272727273
2212,Yannis Salibur,FRA,"MF,FW",Mallorca,La Liga,28,1991,0.9,0,0,0,0,0,0,4,0.0,4,0,0,0,1,1,1,0,0,2019-2020,1.1111111111111112,0.0
2213,Romain Salin,FRA,GK,Rennes,Ligue 1,35,1984,4.0,0,0,0,0,0,0,1,0.0,1,0,0,0,0,0,3,0,0,2019-2020,0.0,0.0
2214,Mohammed Salisu,GHA,DF,Valladolid,La Liga,20,1999,30.3,41,24,28,13,0,21,34,61.8,13,32,26,6,35,76,158,3,0,2019-2020,1.155115511551155,1.353135313531353
2215,Roland Sallai,HUN,"MF,FW",Freiburg,Bundesliga,22,1997,12.9,17,10,4,9,4,7,20,35.0,13,12,2,10,7,24,4,0,0,2019-2020,0.5426356589147286,1.317829457364341
2216,Lazar Samardzic,SRB,"MF,FW",Hertha BSC,Bundesliga,17,2002,0.4,4,4,2,2,0,1,4,25.0,3,2,1,1,0,4,0,0,0,2019-2020,0.0,10.0
2217,Diadie Samassékou,MLI,MF,Hoffenheim,Bundesliga,23,1996,14.6,37,18,14,17,6,12,34,35.3,22,25,8,17,40,77,27,1,0,2019-2020,2.73972602739726,2.5342465753424657
2218,Mbwana Samatta,TAN,FW,Aston Villa,Premier League,26,1992,10.5,6,4,0,3,3,1,8,12.5,7,7,0,7,1,7,6,0,0,2019-2020,0.09523809523809523,0.5714285714285714
2219,Mama Samba Baldé,GNB,"FW,MF",Dijon,Ligue 1,23,1995,18.6,24,13,9,8,7,7,30,23.3,23,17,0,17,7,31,24,0,0,2019-2020,0.3763440860215054,1.2903225806451613
2220,Junior Sambia,FRA,"DF,MF",Montpellier,Ligue 1,22,1996,6.5,8,6,4,2,2,3,13,23.1,10,4,0,4,8,16,6,0,0,2019-2020,1.2307692307692308,1.2307692307692308
2221,Frédéric Sammaritano,FRA,"MF,FW",Dijon,Ligue 1,33,1986,5.8,9,7,4,4,1,4,11,36.4,7,6,1,5,2,11,3,1,0,2019-2020,0.3448275862068966,1.5517241379310345
2222,Fede San Emeterio,ESP,MF,Valladolid,La Liga,22,1997,19.5,26,13,18,6,2,7,29,24.1,22,20,8,12,28,54,13,1,0,2019-2020,1.435897435897436,1.3333333333333333
2223,Mikel San José,ESP,MF,Athletic Club,La Liga,30,1989,4.0,9,4,2,4,3,2,10,20.0,8,3,1,2,9,18,12,0,0,2019-2020,2.25,2.25
2224,Antonio Sanabria,PAR,FW,Genoa,Serie A,23,1996,15.4,14,11,2,7,5,3,14,21.4,11,13,1,12,5,19,12,1,0,2019-2020,0.3246753246753247,0.9090909090909091
2225,Oihan Sancet,ESP,"MF,FW",Athletic Club,La Liga,19,2000,8.2,11,7,5,4,2,4,11,36.4,7,6,0,6,2,13,2,0,0,2019-2020,0.24390243902439027,1.3414634146341464
Rk,Player,Nation,Pos,Squad,Comp,0,0,90.0,0,0,3,3,3,Tkl,0,0.0,0,0,0,0,0,0,0,0,0,2019-2020,0.0,0.0
2226,Renato Sanches,POR,"MF,FW",Lille,Ligue 1,21,1997,16.5,28,15,9,15,4,8,33,24.2,25,19,1,18,15,43,10,1,0,2019-2020,0.9090909090909091,1.696969696969697
2227,Renato Sanches,POR,MF,Bayern Munich,Bundesliga,21,1997,0.1,0,0,0,0,0,0,0,0.0,0,0,0,0,0,0,0,0,0,2019-2020,0.0,0.0
2228,Alexis Sánchez,CHI,FW,Inter,Serie A,30,1988,10.3,9,7,1,4,4,5,13,38.5,8,7,0,7,3,12,1,0,0,2019-2020,0.2912621359223301,0.8737864077669902
2229,Carlos Sánchez,COL,MF,West Ham,Premier League,33,1986,1.3,1,0,0,1,0,1,1,100.0,0,1,0,1,2,3,1,0,0,2019-2020,1.5384615384615383,0.7692307692307692
2230,Davinson Sánchez,COL,DF,Tottenham,Premier League,23,1996,27.0,44,27,32,12,0,22,44,50.0,22,40,28,12,34,78,128,5,0,2019-2020,1.2592592592592593,1.6296296296296295
2231,Germán Sánchez,ESP,DF,Granada,La Liga,32,1986,25.5,16,10,12,4,0,6,16,37.5,10,29,23,6,33,49,115,2,0,2019-2020,1.2941176470588236,0.6274509803921569
2232,Javi Sánchez,ESP,DF,Valladolid,La Liga,22,1997,5.5,5,4,3,2,0,1,3,33.3,2,4,2,2,4,9,24,0,0,2019-2020,0.7272727272727273,0.9090909090909091
2233,Manu Sánchez,ESP,DF,Atlético Madrid,La Liga,18,2000,3.6,13,7,2,7,4,8,15,53.3,7,3,0,3,7,20,1,0,0,2019-2020,1.9444444444444444,3.611111111111111
2234,Víctor Sánchez,ESP,MF,Espanyol,La Liga,31,1987,18.8,66,36,36,23,7,30,71,42.3,41,31,8,23,27,93,23,1,0,2019-2020,1.4361702127659575,3.5106382978723403
2235,Jadon Sancho,ENG,"FW,MF",Dortmund,Bundesliga,19,2000,25.4,14,11,6,6,2,8,24,33.3,16,8,0,8,14,28,6,0,0,2019-2020,0.5511811023622047,0.5511811023622047
2236,Alex Sandro,BRA,DF,Juventus,Serie A,28,1991,26.5,44,26,23,14,7,12,33,36.4,21,26,6,20,47,91,46,3,0,2019-2020,1.7735849056603774,1.6603773584905661
2237,Leroy Sané,GER,FW,Manchester City,Premier League,23,1996,0.1,0,0,0,0,0,0,0,0.0,0,0,0,0,0,0,0,0,0,2019-2020,0.0,0.0
2238,Salif Sané,SEN,DF,Schalke 04,Bundesliga,28,1990,12.5,16,9,12,4,0,11,19,57.9,8,19,7,12,21,37,50,0,0,2019-2020,1.68,1.28
2239,Luca Sangalli,ESP,MF,Real Sociedad,La Liga,24,1995,4.1,1,0,0,1,0,1,8,12.5,7,3,0,3,1,2,0,0,0,2019-2020,0.24390243902439027,0.24390243902439027
2240,Ibrahim Sangaré,CIV,MF,Toulouse,Ligue 1,21,1997,24.2,84,54,37,42,5,33,74,44.6,41,28,10,18,39,123,49,4,0,2019-2020,1.6115702479338843,3.4710743801652892
2241,Oier Sanjurjo,ESP,MF,Osasuna,La Liga,33,1986,25.8,65,34,21,34,10,28,64,43.8,36,33,8,25,35,100,39,1,0,2019-2020,1.3565891472868217,2.5193798449612403
2242,Yaya Sanogo,FRA,FW,Toulouse,Ligue 1,26,1993,10.1,6,3,2,3,1,1,2,50.0,1,4,1,3,7,13,14,0,0,2019-2020,0.6930693069306931,0.594059405940594
2243,Morgan Sanson,FRA,MF,Marseille,Ligue 1,24,1994,24.1,60,28,20,29,11,13,52,25.0,39,39,5,34,23,83,9,0,0,2019-2020,0.954356846473029,2.4896265560165975
2244,Nicola Sansone,ITA,"FW,MF",Bologna,Serie A,27,1991,25.2,34,20,12,18,4,15,59,25.4,44,21,0,21,11,45,9,0,0,2019-2020,0.4365079365079365,1.3492063492063493
2245,Baptiste Santamaria,FRA,MF,Angers,Ligue 1,24,1995,27.8,91,53,39,43,9,35,79,44.3,44,27,5,22,43,134,36,0,0,2019-2020,1.5467625899280575,3.273381294964029
2246,Federico Santander,PAR,FW,Bologna,Serie A,28,1991,8.6,13,8,3,0,10,1,4,25.0,3,3,0,3,7,20,12,0,0,2019-2020,0.813953488372093,1.5116279069767442
2247,Davide Santon,ITA,DF,Roma,Serie A,28,1991,6.9,11,6,6,5,0,6,17,35.3,11,2,1,1,11,22,13,0,0,2019-2020,1.5942028985507246,1.5942028985507246
2248,Samir Santos,BRA,DF,Udinese,Serie A,24,1994,17.2,35,27,24,8,3,12,23,52.2,11,16,6,10,33,68,64,1,0,2019-2020,1.9186046511627908,2.0348837209302326
2249,Riccardo Saponara,ITA,"MF,FW",Genoa,Serie A,27,1991,1.9,4,3,2,2,0,0,2,0.0,2,2,1,1,0,4,2,0,0,2019-2020,0.0,2.1052631578947367
2250,Riccardo Saponara,ITA,"MF,FW",Lecce,Serie A,27,1991,10.5,12,8,4,8,0,6,13,46.2,7,2,0,2,5,17,7,0,0,2019-2020,0.47619047619047616,1.1428571428571428
Rk,Player,Nation,Pos,Squad,Comp,0,0,90.0,0,0,3,3,3,Tkl,0,0.0,0,0,0,0,0,0,0,0,0,2019-2020,0.0,0.0
2251,Ivan Šaponjić,SRB,"DF,FW",Atlético Madrid,La Liga,21,1997,0.1,0,0,0,0,0,0,0,0.0,0,0,0,0,0,0,0,0,0,2019-2020,0.0,0.0
2252,Pablo Sarabia,ESP,"FW,MF",Paris S-G,Ligue 1,27,1992,12.9,12,7,3,6,3,4,25,16.0,21,19,1,18,10,22,5,0,0,2019-2020,0.7751937984496123,0.9302325581395349
2253,Marcelo Saracchi,URU,DF,RB Leipzig,Bundesliga,21,1998,2.0,8,6,2,5,1,5,6,83.3,1,3,1,2,1,9,5,0,0,2019-2020,0.5,4.0
2254,Josh Sargent,USA,FW,Werder Bremen,Bundesliga,19,2000,15.7,11,6,5,4,2,2,12,16.7,10,17,1,16,14,25,21,0,0,2019-2020,0.89171974522293,0.7006369426751593
2255,Bouna Sarr,SEN,"DF,FW",Marseille,Ligue 1,27,1992,24.0,60,37,30,19,11,30,53,56.6,23,17,1,16,32,92,38,0,0,2019-2020,1.3333333333333333,2.5
2256,Ismaila Sarr,SEN,"FW,MF",Watford,Premier League,21,1998,22.5,11,10,5,2,4,5,23,21.7,18,9,1,8,18,29,10,0,0,2019-2020,0.8,0.4888888888888889
2257,Malang Sarr,FRA,DF,Nice,Ligue 1,20,1999,16.2,19,11,13,6,0,9,22,40.9,13,10,4,6,38,57,31,4,0,2019-2020,2.345679012345679,1.1728395061728396
2258,Sidy Sarr,SEN,MF,Nîmes,Ligue 1,23,1996,12.9,35,18,15,16,4,11,34,32.4,23,13,3,10,15,50,18,0,0,2019-2020,1.1627906976744187,2.7131782945736433
2259,Joan Sastre Vanrell,ESP,DF,Mallorca,La Liga,22,1997,15.1,30,17,26,3,1,17,39,43.6,22,8,2,6,23,53,27,1,0,2019-2020,1.5231788079470199,1.9867549668874174
2260,Téji Savanier,FRA,MF,Montpellier,Ligue 1,27,1991,16.9,52,39,16,30,6,25,77,32.5,52,10,0,10,35,87,21,1,0,2019-2020,2.0710059171597637,3.076923076923077
2261,Stefan Savić,MNE,DF,Atlético Madrid,La Liga,28,1991,22.0,22,17,11,10,1,11,18,61.1,7,16,9,7,24,46,91,1,0,2019-2020,1.0909090909090908,1.0
2262,Fabian Schär,SUI,"DF,MF",Newcastle Utd,Premier League,27,1991,18.6,39,21,25,14,0,19,40,47.5,21,35,18,17,47,86,74,2,0,2019-2020,2.5268817204301075,2.096774193548387
2263,Louis Schaub,AUT,MF,Köln,Bundesliga,24,1994,6.9,15,12,2,9,4,5,14,35.7,9,10,1,9,3,18,2,0,0,2019-2020,0.43478260869565216,2.1739130434782608
2264,Ezequiel Schelotto,ITA,DF,Brighton,Premier League,30,1989,4.0,4,3,1,2,1,2,8,25.0,6,3,0,3,7,11,14,0,0,2019-2020,1.75,1.0
2265,Patrik Schick,CZE,FW,RB Leipzig,Bundesliga,23,1996,14.4,7,3,1,3,3,2,9,22.2,7,8,2,6,2,9,17,0,0,2019-2020,0.1388888888888889,0.4861111111111111
2266,Julian Schieber,GER,FW,Augsburg,Bundesliga,30,1989,0.5,1,1,0,1,0,0,0,0.0,0,0,0,0,0,1,0,0,0,2019-2020,0.0,2.0
2267,Kingsley Schindler,GHA,"FW,MF",Köln,Bundesliga,26,1993,9.4,8,5,3,5,0,4,12,33.3,8,6,1,5,6,14,17,0,0,2019-2020,0.6382978723404255,0.851063829787234
2268,Xaver Schlager,AUT,MF,Wolfsburg,Bundesliga,21,1997,19.1,47,29,13,30,4,14,44,31.8,30,16,2,14,17,64,12,0,0,2019-2020,0.8900523560209423,2.4607329842931933
2269,Keven Schlotterbeck,GER,DF,Union Berlin,Bundesliga,22,1997,21.5,52,27,36,15,1,17,29,58.6,12,40,21,19,40,92,113,1,0,2019-2020,1.8604651162790697,2.4186046511627906
2270,Nico Schlotterbeck,GER,DF,Freiburg,Bundesliga,19,1999,4.1,6,3,4,2,0,2,5,40.0,3,7,5,2,3,9,20,1,0,2019-2020,0.7317073170731708,1.4634146341463417
2271,Jeffrey Schlupp,GHA,"FW,MF",Crystal Palace,Premier League,26,1992,11.5,18,9,10,7,1,6,16,37.5,10,11,3,8,13,31,15,0,0,2019-2020,1.1304347826086956,1.565217391304348
2272,Kasper Schmeichel,DEN,GK,Leicester City,Premier League,32,1986,38.0,1,1,1,0,0,1,2,50.0,1,0,0,0,1,2,4,2,0,2019-2020,0.02631578947368421,0.02631578947368421
2273,Marcel Schmelzer,GER,DF,Dortmund,Bundesliga,31,1988,0.7,2,1,1,1,0,1,1,100.0,0,0,0,0,1,3,2,0,0,2019-2020,1.4285714285714286,2.857142857142857
2274,Jonathan Schmid,FRA,DF,Freiburg,Bundesliga,29,1990,31.5,42,27,19,19,4,19,37,51.4,18,23,8,15,35,77,84,0,0,2019-2020,1.1111111111111112,1.3333333333333333
2275,Manuel Schmiedebach,GER,MF,Union Berlin,Bundesliga,30,1988,2.0,4,1,0,3,1,1,7,14.3,6,1,1,0,3,7,3,0,0,2019-2020,1.5,2.0
Rk,Player,Nation,Pos,Squad,Comp,0,0,90.0,0,0,3,3,3,Tkl,0,0.0,0,0,0,0,0,0,0,0,0,2019-2020,0.0,0.0
2276,Benno Schmitz,GER,DF,Köln,Bundesliga,24,1994,12.9,28,17,13,11,4,16,36,44.4,20,11,1,10,16,44,27,0,0,2019-2020,1.2403100775193798,2.1705426356589146
2277,Morgan Schneiderlin,FRA,MF,Everton,Premier League,29,1989,11.1,31,22,13,16,2,8,24,33.3,16,13,3,10,21,52,20,1,0,2019-2020,1.8918918918918919,2.7927927927927927
2278,Lasse Schöne,DEN,MF,Genoa,Serie A,33,1986,27.0,42,26,16,22,4,15,48,31.3,33,22,6,16,37,79,25,2,0,2019-2020,1.3703703703703705,1.5555555555555556
2279,Sebastian Schonlau,GER,DF,Paderborn 07,Bundesliga,24,1994,23.0,64,43,50,14,0,41,66,62.1,25,36,15,21,40,104,138,1,0,2019-2020,1.7391304347826086,2.782608695652174
2280,Alessandro Schöpf,AUT,MF,Schalke 04,Bundesliga,25,1994,15.9,29,16,11,10,8,12,33,36.4,21,17,1,16,26,55,8,0,0,2019-2020,1.6352201257861634,1.8238993710691824
2281,Jerdy Schouten,NED,MF,Bologna,Serie A,22,1997,12.0,26,16,13,11,2,10,26,38.5,16,19,7,12,26,52,22,0,0,2019-2020,2.1666666666666665,2.1666666666666665
2282,Markus Schubert,GER,GK,Schalke 04,Bundesliga,21,1998,8.2,0,0,0,0,0,0,1,0.0,1,0,0,0,0,0,9,4,0,2019-2020,0.0,0.0
2283,Nico Schulz,GER,"DF,MF",Dortmund,Bundesliga,26,1993,6.6,11,7,3,6,2,8,13,61.5,5,14,4,10,9,20,9,0,0,2019-2020,1.3636363636363638,1.6666666666666667
2284,Alexander Schwolow,GER,GK,Freiburg,Bundesliga,27,1992,23.2,0,0,0,0,0,0,0,0.0,0,2,0,2,1,1,8,3,0,2019-2020,0.04310344827586207,0.0
2285,Matteo Scozzarella,ITA,MF,Parma,Serie A,31,1988,10.2,23,15,8,13,2,14,29,48.3,15,19,14,5,27,50,28,0,0,2019-2020,2.647058823529412,2.2549019607843137
2286,Aleksandar Sedlar,SRB,DF,Mallorca,La Liga,27,1991,9.0,13,6,10,2,1,7,11,63.6,4,17,11,6,16,29,31,0,0,2019-2020,1.7777777777777777,1.4444444444444444
2287,Davie Selke,GER,FW,Hertha BSC,Bundesliga,24,1995,10.7,6,3,2,2,2,4,7,57.1,3,7,1,6,1,7,11,0,0,2019-2020,0.09345794392523366,0.5607476635514019
2288,Davie Selke,GER,FW,Werder Bremen,Bundesliga,24,1995,5.1,2,0,1,1,0,0,2,0.0,2,1,0,1,0,2,2,0,0,2019-2020,0.0,0.3921568627450981
2289,Matz Sels,BEL,GK,Strasbourg,Ligue 1,27,1992,27.0,0,0,0,0,0,0,1,0.0,1,0,0,0,1,1,6,0,0,2019-2020,0.037037037037037035,0.0
2290,Ken Sema,SWE,"DF,MF",Udinese,Serie A,25,1993,27.3,59,41,43,15,1,36,68,52.9,32,26,6,20,17,76,41,1,0,2019-2020,0.6227106227106227,2.161172161172161
2291,Nélson Semedo,POR,DF,Barcelona,La Liga,25,1993,23.3,51,30,27,18,6,21,36,58.3,15,18,3,15,22,73,30,0,0,2019-2020,0.944206008583691,2.188841201716738
2292,Alessandro Semprini,ITA,DF,Brescia,Serie A,21,1998,7.0,10,4,7,3,0,7,9,77.8,2,10,3,7,9,19,16,0,0,2019-2020,1.2857142857142858,1.4285714285714286
2293,Josep Señé,ESP,MF,Mallorca,La Liga,27,1991,1.7,2,1,2,0,0,2,5,40.0,3,2,1,1,0,2,2,0,0,2019-2020,0.0,1.1764705882352942
2294,Stefano Sensi,ITA,MF,Inter,Serie A,23,1995,8.0,18,10,10,7,1,6,22,27.3,16,15,1,14,9,27,4,0,0,2019-2020,1.125,2.25
2295,Luigi Sepe,ITA,GK,Parma,Serie A,28,1991,34.0,1,0,1,0,0,1,2,50.0,1,0,0,0,0,1,6,2,0,2019-2020,0.0,0.029411764705882353
2296,Suat Serdar,GER,MF,Schalke 04,Bundesliga,22,1997,17.8,56,37,16,33,7,18,61,29.5,43,39,7,32,24,80,7,0,0,2019-2020,1.348314606741573,3.1460674157303368
2297,Ryan Sessegnon,ENG,"DF,FW",Tottenham,Premier League,19,2000,3.8,6,4,2,4,0,3,6,50.0,3,0,0,0,3,9,12,0,0,2019-2020,0.7894736842105263,1.5789473684210527
2298,Salva Sevilla,ESP,MF,Mallorca,La Liga,35,1984,28.5,27,21,11,16,0,9,30,30.0,21,17,5,12,29,56,17,1,0,2019-2020,1.0175438596491229,0.9473684210526315
2299,Yevhen Shakhov,UKR,"MF,FW",Lecce,Serie A,28,1990,12.1,28,16,12,13,3,8,27,29.6,19,11,3,8,14,42,9,1,0,2019-2020,1.15702479338843,2.31404958677686
2300,Xherdan Shaqiri,SUI,"FW,MF",Liverpool,Premier League,27,1991,2.1,1,0,0,1,0,0,1,0.0,1,0,0,0,0,1,0,0,0,2019-2020,0.0,0.47619047619047616
Rk,Player,Nation,Pos,Squad,Comp,0,0,90.0,0,0,3,3,3,Tkl,0,0.0,0,0,0,0,0,0,0,0,0,2019-2020,0.0,0.0
2301,Billy Sharp,ENG,FW,Sheffield Utd,Premier League,33,1986,11.7,6,5,2,1,3,1,6,16.7,5,2,0,2,1,7,2,0,0,2019-2020,0.08547008547008547,0.5128205128205129
2302,Luke Shaw,ENG,DF,Manchester Utd,Premier League,24,1995,19.3,34,18,19,11,4,19,33,57.6,14,26,6,20,24,58,56,1,0,2019-2020,1.2435233160621761,1.761658031088083
2303,Khiry Shelton,USA,FW,Paderborn 07,Bundesliga,26,1993,0.4,1,1,1,0,0,0,0,0.0,0,0,0,0,0,1,0,0,0,2019-2020,0.0,2.5
2304,Jonjo Shelvey,ENG,MF,Newcastle Utd,Premier League,27,1992,23.5,29,19,17,12,0,11,42,26.2,31,14,5,9,23,52,38,0,0,2019-2020,0.9787234042553191,1.2340425531914894
2305,Gen Shoji,JPN,DF,Toulouse,Ligue 1,26,1992,0.5,2,2,2,0,0,1,1,100.0,0,0,0,0,0,2,2,0,0,2019-2020,0.0,4.0
2306,Djibril Sidibé,FRA,"DF,MF",Everton,Premier League,27,1992,20.3,83,44,48,25,10,43,72,59.7,29,19,3,16,40,123,41,0,0,2019-2020,1.9704433497536946,4.088669950738916
2307,Kalidou Sidibé,FRA,MF,Toulouse,Ligue 1,20,1999,1.0,3,3,0,3,0,2,5,40.0,3,0,0,0,1,4,0,0,0,2019-2020,1.0,3.0
2308,Sidnei,BRA,DF,Betis,La Liga,29,1989,13.1,23,19,17,6,0,9,14,64.3,5,15,12,3,21,44,57,0,0,2019-2020,1.6030534351145038,1.7557251908396947
2309,Kaj Sierhuis,NED,FW,Reims,Ligue 1,21,1998,0.1,0,0,0,0,0,0,0,0.0,0,0,0,0,0,0,0,0,0,2019-2020,0.0,0.0
2310,Gylfi Sigurðsson,ISL,MF,Everton,Premier League,29,1989,28.4,50,26,15,24,11,19,70,27.1,51,30,4,26,37,87,17,1,0,2019-2020,1.3028169014084507,1.7605633802816902
2311,Luca Siligardi,ITA,"MF,FW",Parma,Serie A,31,1988,3.7,6,2,3,2,1,4,8,50.0,4,3,0,3,3,9,5,0,0,2019-2020,0.8108108108108107,1.6216216216216215
2312,Adrien Silva,POR,MF,Monaco,Ligue 1,30,1989,13.6,37,22,14,19,4,10,37,27.0,27,19,6,13,12,49,14,2,0,2019-2020,0.8823529411764706,2.7205882352941178
2313,André Silva,POR,FW,Milan,Serie A,23,1995,0.7,2,1,0,0,2,0,1,0.0,1,0,0,0,0,2,0,0,0,2019-2020,0.0,2.857142857142857
2314,André Silva,POR,FW,Eint Frankfurt,Bundesliga,23,1995,17.5,7,2,0,5,2,2,14,14.3,12,9,0,9,8,15,4,0,0,2019-2020,0.45714285714285713,0.4
2315,Bernardo Silva,POR,"FW,MF",Manchester City,Premier League,24,1994,22.6,36,18,8,21,7,13,44,29.5,31,25,1,24,24,60,13,0,0,2019-2020,1.0619469026548671,1.5929203539823007
2316,David Silva,ESP,MF,Manchester City,Premier League,33,1986,20.3,26,14,3,15,8,10,28,35.7,18,18,3,15,13,39,5,0,0,2019-2020,0.6403940886699507,1.2807881773399015
2317,Gabriel Silva,BRA,DF,Saint-Étienne,Ligue 1,28,1991,2.6,4,1,1,2,1,2,3,66.7,1,2,0,2,4,8,8,0,0,2019-2020,1.5384615384615383,1.5384615384615383
2318,Jonathan Silva,ARG,DF,Leganés,La Liga,25,1994,30.9,60,34,32,22,6,27,52,51.9,25,12,4,8,34,94,46,0,0,2019-2020,1.1003236245954693,1.941747572815534
2319,Matheus Pereira da Silva,BRA,"MF,FW",Dijon,Ligue 1,21,1998,5.2,10,6,1,6,3,4,10,40.0,6,11,0,11,6,16,5,0,0,2019-2020,1.1538461538461537,1.923076923076923
2320,Rui Silva,POR,GK,Granada,La Liga,25,1994,35.0,2,1,2,0,0,2,2,100.0,0,0,0,0,2,4,22,3,0,2019-2020,0.05714285714285714,0.05714285714285714
2321,Thiago Silva,BRA,DF,Paris S-G,Ligue 1,34,1984,17.5,28,16,15,13,0,13,16,81.3,3,18,15,3,26,54,54,0,0,2019-2020,1.4857142857142858,1.6
2322,Marco Silvestri,ITA,GK,Hellas Verona,Serie A,28,1991,35.0,1,0,1,0,0,1,2,50.0,1,0,0,0,4,5,11,1,0,2019-2020,0.11428571428571428,0.02857142857142857
2323,Mohamed Simakan,FRA,DF,Strasbourg,Ligue 1,19,2000,16.7,54,32,35,16,3,22,34,64.7,12,14,3,11,31,85,25,0,0,2019-2020,1.8562874251497006,3.2335329341317367
2324,Giovanni Simeone,ARG,FW,Cagliari,Serie A,24,1995,32.5,24,13,9,10,5,5,32,15.6,27,24,7,17,11,35,16,1,0,2019-2020,0.3384615384615385,0.7384615384615385
2325,Moses Simon,NGA,"FW,MF",Nantes,Ligue 1,24,1995,24.2,15,7,5,4,6,6,21,28.6,15,6,0,6,8,23,6,0,0,2019-2020,0.3305785123966942,0.6198347107438017
Rk,Player,Nation,Pos,Squad,Comp,0,0,90.0,0,0,3,3,3,Tkl,0,0.0,0,0,0,0,0,0,0,0,0,2019-2020,0.0,0.0
2326,Unai Simón,ESP,GK,Athletic Club,La Liga,22,1997,33.2,0,0,0,0,0,0,1,0.0,1,1,0,1,1,1,10,1,0,2019-2020,0.03012048192771084,0.0
2327,Jack Simpson,ENG,DF,Bournemouth,Premier League,22,1996,2.7,5,2,4,1,0,2,8,25.0,6,1,0,1,2,7,12,1,0,2019-2020,0.7407407407407407,1.8518518518518516
2328,Sarpreet Singh,NZL,"FW,MF",Bayern Munich,Bundesliga,20,1999,0.8,1,0,0,1,0,0,1,0.0,1,0,0,0,0,1,0,0,0,2019-2020,0.0,1.25
2329,Wilfried Singo,CIV,DF,Torino,Serie A,18,2000,1.5,1,0,0,1,0,0,0,0.0,0,0,0,0,1,2,2,0,0,2019-2020,0.6666666666666666,0.6666666666666666
2330,Daley Sinkgraven,NED,"DF,MF",Leverkusen,Bundesliga,24,1995,10.1,20,16,11,6,3,8,24,33.3,16,12,3,9,10,30,16,0,0,2019-2020,0.9900990099009901,1.9801980198019802
2331,Dimitris Siovas,GRE,DF,Leganés,La Liga,30,1988,21.3,42,31,24,15,3,19,28,67.9,9,14,1,13,46,88,69,0,0,2019-2020,2.15962441314554,1.971830985915493
2332,Salvatore Sirigu,ITA,GK,Torino,Serie A,32,1987,36.0,0,0,0,0,0,0,0,0.0,0,0,0,0,2,2,12,0,0,2019-2020,0.05555555555555555,0.0
2333,Ibrahima Sissoko,MLI,MF,Strasbourg,Ligue 1,21,1997,17.8,46,27,21,21,4,16,48,33.3,32,14,5,9,20,66,25,0,0,2019-2020,1.1235955056179774,2.5842696629213484
2334,Moussa Sissoko,FRA,MF,Tottenham,Premier League,29,1989,27.2,39,25,25,12,2,20,48,41.7,28,19,4,15,27,66,43,2,0,2019-2020,0.9926470588235294,1.4338235294117647
2335,Sambou Sissoko,FRA,"MF,FW",Reims,Ligue 1,20,1999,0.4,0,0,0,0,0,0,0,0.0,0,0,0,0,1,1,2,0,0,2019-2020,2.5,0.0
2336,Pione Sisto,DEN,"FW,MF",Celta Vigo,La Liga,24,1995,9.9,17,8,5,6,6,4,19,21.1,15,18,0,18,6,23,4,1,0,2019-2020,0.6060606060606061,1.7171717171717171
2337,Antonio Sivera,ESP,GK,Alavés,La Liga,22,1996,3.0,0,0,0,0,0,0,0,0.0,0,0,0,0,0,0,2,0,0,2019-2020,0.0,0.0
2338,Ellyes Skhiri,TUN,MF,Köln,Bundesliga,24,1995,29.7,74,52,30,37,7,29,77,37.7,48,47,9,38,67,141,33,0,0,2019-2020,2.255892255892256,2.491582491582492
2339,Oliver Skipp,ENG,MF,Tottenham,Premier League,18,2000,0.9,2,2,0,2,0,1,4,25.0,3,3,2,1,0,2,0,0,0,2019-2020,0.0,2.2222222222222223
2340,Łukasz Skorupski,POL,GK,Bologna,Serie A,28,1991,37.0,1,0,1,0,0,0,1,0.0,1,0,0,0,2,3,15,5,0,2019-2020,0.05405405405405406,0.02702702702702703
2341,Andreas Skov Olsen,DEN,"FW,MF",Bologna,Serie A,19,1999,8.4,11,8,5,5,1,4,12,33.3,8,10,1,9,8,19,5,0,0,2019-2020,0.9523809523809523,1.3095238095238095
2342,Robert Skov,DEN,"DF,FW",Hoffenheim,Bundesliga,23,1996,29.0,41,28,30,9,2,26,50,52.0,24,26,6,20,20,61,40,0,0,2019-2020,0.6896551724137931,1.4137931034482758
2343,Simon Skrabb,FIN,"FW,MF",Brescia,Serie A,24,1995,2.9,7,6,2,4,1,6,12,50.0,6,4,1,3,0,7,3,0,0,2019-2020,0.0,2.413793103448276
2344,Milan Škriniar,SVK,DF,Inter,Serie A,24,1995,29.2,39,20,24,14,1,14,33,42.4,19,19,11,8,28,67,85,1,0,2019-2020,0.9589041095890412,1.3356164383561644
2345,Steven Skrzybski,GER,"FW,MF",Düsseldorf,Bundesliga,26,1992,5.9,4,4,2,1,1,0,16,0.0,16,10,0,10,10,14,4,0,0,2019-2020,1.694915254237288,0.6779661016949152
2346,Petar Škuletić,SRB,"FW,MF",Montpellier,Ligue 1,29,1990,1.2,6,4,2,2,2,2,4,50.0,2,0,0,0,0,6,1,0,0,2019-2020,0.0,5.0
2347,Islam Slimani,ALG,FW,Monaco,Ligue 1,31,1988,14.3,8,4,0,2,6,4,15,26.7,11,5,0,5,1,9,11,1,0,2019-2020,0.06993006993006992,0.5594405594405594
2348,William Smallbone,IRL,MF,Southampton,Premier League,19,2000,4.4,10,5,2,8,0,5,10,50.0,5,7,1,6,1,11,2,0,0,2019-2020,0.22727272727272727,2.2727272727272725
2349,Chris Smalling,ENG,DF,Roma,Serie A,29,1989,28.5,25,16,15,9,1,10,13,76.9,3,44,35,9,56,81,126,2,0,2019-2020,1.9649122807017543,0.8771929824561403
2350,Dennis Smarsch,GER,GK,Hertha BSC,Bundesliga,20,1999,1.7,0,0,0,0,0,0,0,0.0,0,0,0,0,0,0,1,0,0,2019-2020,0.0,0.0
Rk,Player,Nation,Pos,Squad,Comp,0,0,90.0,0,0,3,3,3,Tkl,0,0.0,0,0,0,0,0,0,0,0,0,2019-2020,0.0,0.0
2351,Adam Smith,ENG,DF,Bournemouth,Premier League,28,1991,22.8,47,32,29,16,2,23,50,46.0,27,27,6,21,25,72,64,1,0,2019-2020,1.0964912280701753,2.06140350877193
2352,Emile Smith Rowe,ENG,MF,Arsenal,Premier League,19,2000,1.1,1,1,1,0,0,1,3,33.3,2,0,0,0,1,2,2,0,0,2019-2020,0.9090909090909091,0.9090909090909091
2353,Fyodor Smolov,RUS,FW,Celta Vigo,La Liga,29,1990,8.3,2,1,0,2,0,1,9,11.1,8,6,0,6,7,9,9,0,0,2019-2020,0.8433734939759036,0.24096385542168672
2354,Robert Snodgrass,SCO,"MF,FW",West Ham,Premier League,31,1987,16.8,29,16,17,10,2,13,44,29.5,31,12,1,11,4,33,11,0,0,2019-2020,0.23809523809523808,1.726190476190476
2355,Cédric Soares,POR,"MF,DF",Arsenal,Premier League,27,1991,2.8,8,6,2,6,0,1,3,33.3,2,3,0,3,3,11,4,0,0,2019-2020,1.0714285714285714,2.857142857142857
2356,Cédric Soares,POR,DF,Southampton,Premier League,27,1991,14.5,45,26,19,24,2,25,41,61.0,16,18,4,14,19,64,51,0,0,2019-2020,1.3103448275862069,3.103448275862069
2357,Rafa Soares,POR,DF,Eibar,La Liga,24,1995,4.8,6,5,5,0,1,5,11,45.5,6,1,0,1,2,8,6,0,0,2019-2020,0.4166666666666667,1.25
2358,Lasse Sobiech,GER,DF,Köln,Bundesliga,28,1991,1.0,1,0,0,0,1,0,0,0.0,0,0,0,0,4,5,6,0,0,2019-2020,4.0,1.0
2359,Marcel Sobottka,GER,MF,Düsseldorf,Bundesliga,25,1994,7.8,15,10,6,8,1,4,13,30.8,9,9,1,8,9,24,12,0,0,2019-2020,1.153846153846154,1.9230769230769231
2360,Rubén Sobrino,ESP,"FW,MF",Valencia,La Liga,27,1992,1.9,7,5,3,2,2,2,3,66.7,1,1,0,1,0,7,1,0,0,2019-2020,0.0,3.68421052631579
2361,Dominic Solanke,ENG,FW,Bournemouth,Premier League,21,1997,18.3,8,4,2,5,1,5,33,15.2,28,9,1,8,8,16,18,1,0,2019-2020,0.4371584699453552,0.4371584699453552
2362,Roberto Soldado,ESP,FW,Granada,La Liga,34,1985,26.1,16,9,2,7,7,7,24,29.2,17,16,4,12,4,20,16,0,0,2019-2020,0.1532567049808429,0.6130268199233716
2363,Carlos Soler,ESP,MF,Valencia,La Liga,22,1997,23.0,21,10,10,10,1,9,39,23.1,30,16,6,10,9,30,14,0,0,2019-2020,0.391304347826087,0.9130434782608695
2364,Oumar Solet,FRA,DF,Lyon,Ligue 1,19,2000,0.1,0,0,0,0,0,0,0,0.0,0,1,1,0,0,0,1,0,0,2019-2020,0.0,0.0
2365,Yann Sommer,SUI,GK,Gladbach,Bundesliga,30,1988,34.0,0,0,0,0,0,0,1,0.0,1,0,0,0,1,1,11,6,0,2019-2020,0.029411764705882353,0.0
2366,Kévin Soni,CMR,FW,Espanyol,La Liga,21,1998,0.0,0,0,0,0,0,0,0,0.0,0,0,0,0,0,0,0,0,0,2019-2020,,
2367,David Soria,ESP,GK,Getafe,La Liga,26,1993,38.0,2,1,2,0,0,2,4,50.0,2,0,0,0,3,5,17,5,0,2019-2020,0.07894736842105263,0.05263157894736842
2368,Bruno Soriano,ESP,"MF,FW",Villarreal,La Liga,35,1984,2.9,4,0,1,2,1,1,1,100.0,0,4,0,4,1,5,7,0,0,2019-2020,0.3448275862068966,1.3793103448275863
2369,Juan Soriano,ESP,GK,Leganés,La Liga,21,1997,11.0,0,0,0,0,0,0,0,0.0,0,0,0,0,0,0,1,1,0,2019-2020,0.0,0.0
2370,Roberto Soriano,ITA,MF,Bologna,Serie A,28,1991,27.4,43,25,15,21,7,10,46,21.7,36,19,0,19,17,60,23,1,0,2019-2020,0.6204379562043796,1.5693430656934306
2371,Riccardo Sottil,ITA,"FW,DF",Fiorentina,Serie A,20,1999,5.7,6,4,4,2,0,3,10,30.0,7,4,0,4,0,6,0,0,0,2019-2020,0.0,1.0526315789473684
2372,Tomáš Souček,CZE,MF,West Ham,Premier League,24,1995,11.6,29,15,13,15,1,10,23,43.5,13,7,1,6,22,51,35,0,0,2019-2020,1.896551724137931,2.5
2373,Adama Soumaoro,FRA,DF,Genoa,Serie A,27,1992,7.1,3,2,3,0,0,1,3,33.3,2,12,12,0,11,14,32,0,0,2019-2020,1.5492957746478875,0.4225352112676057
2374,Adama Soumaoro,FRA,DF,Lille,Ligue 1,27,1992,4.6,1,1,0,1,0,0,0,0.0,0,6,5,1,4,5,17,0,0,2019-2020,0.8695652173913044,0.2173913043478261
2375,Boubakary Soumaré,FRA,MF,Lille,Ligue 1,20,1999,13.5,19,12,6,13,0,9,19,47.4,10,6,0,6,16,35,9,0,0,2019-2020,1.1851851851851851,1.4074074074074074
Rk,Player,Nation,Pos,Squad,Comp,0,0,90.0,0,0,3,3,3,Tkl,0,0.0,0,0,0,0,0,0,0,0,0,2019-2020,0.0,0.0
2376,Bryan Soumaré,FRA,"MF,FW",Dijon,Ligue 1,20,1999,4.3,12,1,6,5,1,6,9,66.7,3,1,0,1,2,14,1,0,0,2019-2020,0.46511627906976744,2.7906976744186047
2377,Arnaud Souquet,FRA,"DF,FW",Montpellier,Ligue 1,27,1992,22.4,62,40,45,13,4,30,67,44.8,37,20,6,14,17,79,44,0,0,2019-2020,0.7589285714285715,2.7678571428571432
2378,Djibril Sow,SUI,MF,Eint Frankfurt,Bundesliga,22,1997,19.4,56,33,26,17,13,16,47,34.0,31,15,3,12,30,86,9,0,0,2019-2020,1.5463917525773196,2.8865979381443303
2379,Çağlar Söyüncü,TUR,DF,Leicester City,Premier League,23,1996,33.7,60,40,41,18,1,27,46,58.7,19,35,19,16,43,103,156,1,0,2019-2020,1.2759643916913945,1.780415430267062
2380,Nikolas Špalek,SVK,"MF,FW",Brescia,Serie A,22,1997,17.5,24,10,6,11,7,7,31,22.6,24,15,1,14,6,30,10,0,0,2019-2020,0.34285714285714286,1.3714285714285714
2381,Leonardo Spinazzola,ITA,DF,Roma,Serie A,26,1993,17.2,24,12,11,8,5,12,21,57.1,9,13,5,8,20,44,41,0,0,2019-2020,1.1627906976744187,1.3953488372093024
2382,Marco Sportiello,ITA,GK,Atalanta,Serie A,27,1992,5.8,0,0,0,0,0,0,0,0.0,0,0,0,0,0,0,3,0,0,2019-2020,0.0,0.0
2383,Mattia Sprocati,ITA,"FW,MF",Parma,Serie A,26,1993,6.6,4,2,3,1,0,0,1,0.0,1,5,1,4,2,6,2,0,0,2019-2020,0.30303030303030304,0.6060606060606061
2384,Bassem Srarfi,TUN,"FW,MF",Nice,Ligue 1,22,1997,1.5,0,0,0,0,0,0,2,0.0,2,0,0,0,2,2,0,0,0,2019-2020,1.3333333333333333,0.0
2385,Dennis Srbeny,GER,"MF,FW",Norwich City,Premier League,25,1994,0.5,5,5,3,2,0,1,3,33.3,2,1,0,1,0,5,1,0,0,2019-2020,0.0,10.0
2386,Dennis Srbeny,GER,"FW,MF",Paderborn 07,Bundesliga,25,1994,12.4,11,6,4,4,3,5,18,27.8,13,11,1,10,3,14,9,0,0,2019-2020,0.24193548387096772,0.8870967741935484
2387,Jerry St. Juste,NED,DF,Mainz 05,Bundesliga,22,1996,23.5,46,25,34,10,2,14,34,41.2,20,35,19,16,52,98,86,1,0,2019-2020,2.2127659574468086,1.9574468085106382
2388,Jack Stacey,ENG,DF,Bournemouth,Premier League,23,1996,17.2,21,11,9,11,1,8,22,36.4,14,27,11,16,18,39,64,1,0,2019-2020,1.0465116279069768,1.2209302325581395
2389,Kostas Stafylidis,GRE,DF,Hoffenheim,Bundesliga,25,1993,4.4,10,3,7,2,1,4,10,40.0,6,10,3,7,2,12,17,0,0,2019-2020,0.45454545454545453,2.2727272727272725
2390,Benjamin Stambouli,FRA,DF,Schalke 04,Bundesliga,28,1990,9.0,31,19,14,15,2,11,21,52.4,10,16,6,10,12,43,28,1,0,2019-2020,1.3333333333333333,3.4444444444444446
2391,Junior Stanislas,ENG,"MF,FW",Bournemouth,Premier League,29,1989,7.9,10,7,2,3,5,3,8,37.5,5,6,0,6,4,14,6,0,0,2019-2020,0.5063291139240506,1.2658227848101264
2392,Niklas Stark,GER,DF,Hertha BSC,Bundesliga,24,1995,19.2,36,20,24,10,2,9,21,42.9,12,27,12,15,21,57,97,2,0,2019-2020,1.09375,1.875
2393,Jed Steer,ENG,GK,Aston Villa,Premier League,26,1992,0.1,0,0,0,0,0,0,0,0.0,0,0,0,0,0,0,0,0,0,2019-2020,0.0,0.0
2394,Renato Steffen,SUI,"MF,FW",Wolfsburg,Bundesliga,27,1991,17.6,25,18,4,14,7,14,39,35.9,25,25,2,23,23,48,10,0,0,2019-2020,1.3068181818181817,1.4204545454545454
2395,Zack Steffen,USA,GK,Düsseldorf,Bundesliga,24,1995,17.0,0,0,0,0,0,0,0,0.0,0,0,0,0,0,0,5,4,0,2019-2020,0.0,0.0
2396,Dale Stephens,ENG,MF,Brighton,Premier League,30,1989,28.1,73,44,30,37,6,25,75,33.3,50,31,11,20,58,131,42,2,0,2019-2020,2.0640569395017794,2.597864768683274
2397,Jack Stephens,ENG,DF,Southampton,Premier League,25,1994,27.2,44,27,30,13,1,24,46,52.2,22,38,22,16,31,75,120,2,0,2019-2020,1.1397058823529411,1.6176470588235294
2398,Mariusz Stępiński,POL,"FW,MF",Hellas Verona,Serie A,24,1995,7.8,5,3,2,1,2,1,2,50.0,1,3,1,2,1,6,7,0,0,2019-2020,0.12820512820512822,0.6410256410256411
2399,Raheem Sterling,ENG,FW,Manchester City,Premier League,24,1994,29.5,27,15,8,10,9,6,28,21.4,22,16,2,14,15,42,4,0,0,2019-2020,0.5084745762711864,0.9152542372881356
2400,Enda Stevens,IRL,DF,Sheffield Utd,Premier League,29,1990,37.2,81,46,48,26,7,42,96,43.8,54,27,8,19,35,116,71,3,0,2019-2020,0.9408602150537634,2.1774193548387095
Rk,Player,Nation,Pos,Squad,Comp,0,0,90.0,0,0,3,3,3,Tkl,0,0.0,0,0,0,0,0,0,0,0,0,2019-2020,0.0,0.0
2401,Marco Stiepermann,GER,MF,Norwich City,Premier League,28,1991,13.1,20,8,8,9,3,5,21,23.8,16,11,3,8,5,25,16,0,0,2019-2020,0.3816793893129771,1.5267175572519085
2402,Lars Stindl,GER,"MF,FW",Gladbach,Bundesliga,30,1988,15.9,27,16,4,15,8,10,28,35.7,18,18,2,16,10,37,7,0,0,2019-2020,0.6289308176100629,1.6981132075471699
2403,Kevin Stöger,AUT,MF,Düsseldorf,Bundesliga,25,1993,14.1,21,15,10,7,4,6,24,25.0,18,24,2,22,26,47,7,1,0,2019-2020,1.8439716312056738,1.4893617021276595
2404,Vlatko Stojanovski,MKD,FW,Nîmes,Ligue 1,22,1997,1.4,3,3,0,3,0,1,1,100.0,0,0,0,0,0,3,1,0,0,2019-2020,0.0,2.142857142857143
2405,John Stones,ENG,DF,Manchester City,Premier League,25,1994,12.5,16,10,8,7,1,3,5,60.0,2,5,3,2,9,25,32,2,0,2019-2020,0.72,1.28
2406,Thomas Strakosha,ALB,GK,Lazio,Serie A,24,1995,38.0,0,0,0,0,0,0,1,0.0,1,0,0,0,0,0,7,2,0,2019-2020,0.0,0.0
2407,Gabriel Strefezza,BRA,"DF,MF",SPAL,Serie A,22,1997,23.4,64,40,28,26,10,22,54,40.7,32,29,3,26,21,85,17,0,0,2019-2020,0.8974358974358975,2.735042735042735
2408,Tobias Strobl,GER,"MF,DF",Gladbach,Bundesliga,29,1990,6.8,9,6,5,4,0,3,8,37.5,5,8,4,4,11,20,5,0,0,2019-2020,1.6176470588235294,1.3235294117647058
2409,Christian Strohdiek,GER,DF,Paderborn 07,Bundesliga,31,1988,15.1,26,22,21,5,0,20,42,47.6,22,16,10,6,25,51,92,0,0,2019-2020,1.6556291390728477,1.7218543046357617
2410,Kevin Strootman,NED,MF,Marseille,Ligue 1,29,1990,15.7,39,27,13,23,3,20,49,40.8,29,16,1,15,17,56,24,0,0,2019-2020,1.0828025477707006,2.484076433121019
2411,Jens Stryger Larsen,DEN,DF,Udinese,Serie A,28,1991,31.0,27,19,15,9,3,17,30,56.7,13,20,5,15,20,47,52,0,0,2019-2020,0.6451612903225806,0.8709677419354839
2412,Stefano Sturaro,ITA,MF,Genoa,Serie A,26,1993,13.9,38,22,14,19,5,15,39,38.5,24,16,4,12,10,48,26,1,0,2019-2020,0.7194244604316546,2.7338129496402876
2413,Damián Suárez,URU,DF,Getafe,La Liga,31,1988,28.8,62,32,32,21,9,38,72,52.8,34,25,2,23,27,89,41,0,0,2019-2020,0.9375,2.1527777777777777
2414,Denis Suárez,ESP,"MF,FW",Celta Vigo,La Liga,25,1994,18.1,22,15,14,7,1,10,37,27.0,27,9,1,8,14,36,12,1,0,2019-2020,0.7734806629834253,1.2154696132596685
2415,Luis Suárez,URU,FW,Barcelona,La Liga,32,1987,22.2,4,0,0,1,3,2,12,16.7,10,6,1,5,1,5,11,0,0,2019-2020,0.04504504504504505,0.1801801801801802
2416,Mathías Suárez,URU,DF,Montpellier,Ligue 1,23,1996,0.7,2,2,2,0,0,2,3,66.7,1,0,0,0,1,3,3,0,0,2019-2020,1.4285714285714286,2.857142857142857
2417,Neven Subotić,SRB,DF,Union Berlin,Bundesliga,30,1988,21.8,30,18,12,16,2,8,32,25.0,24,21,8,13,34,64,89,0,0,2019-2020,1.5596330275229358,1.3761467889908257
2418,Isaac Success,NGA,"FW,MF",Watford,Premier League,23,1996,0.8,0,0,0,0,0,0,0,0.0,0,0,0,0,1,1,0,0,0,2019-2020,1.25,0.0
2419,Marek Suchý,CZE,DF,Augsburg,Bundesliga,31,1988,4.4,7,5,7,0,0,4,6,66.7,2,4,1,3,6,13,15,0,0,2019-2020,1.3636363636363635,1.5909090909090908
2420,Niklas Süle,GER,DF,Bayern Munich,Bundesliga,23,1995,7.1,10,6,8,2,0,4,5,80.0,1,8,6,2,8,18,22,1,0,2019-2020,1.1267605633802817,1.4084507042253522
2421,Ki Sung-yueng,KOR,MF,Newcastle Utd,Premier League,30,1989,1.5,1,1,0,1,0,1,3,33.3,2,1,0,1,3,4,2,0,0,2019-2020,2.0,0.6666666666666666
2422,Ki Sung-yueng,KOR,MF,Mallorca,La Liga,30,1989,0.1,0,0,0,0,0,0,1,0.0,1,0,0,0,0,0,0,0,0,2019-2020,0.0,0.0
2423,Stoppila Sunzu,ZAM,DF,Metz,Ligue 1,30,1989,15.0,16,8,12,4,0,10,15,66.7,5,22,15,7,24,40,63,0,0,2019-2020,1.6,1.0666666666666667
2424,Andrew Surman,ENG,MF,Bournemouth,Premier League,32,1986,2.6,4,2,2,2,0,1,3,33.3,2,1,0,1,1,5,5,1,0,2019-2020,0.3846153846153846,1.5384615384615383
2425,Sam Surridge,ENG,"FW,MF",Bournemouth,Premier League,21,1998,0.3,0,0,0,0,0,0,0,0.0,0,1,0,1,1,1,0,0,0,2019-2020,3.3333333333333335,0.0
Rk,Player,Nation,Pos,Squad,Comp,0,0,90.0,0,0,3,3,3,Tkl,0,0.0,0,0,0,0,0,0,0,0,0,2019-2020,0.0,0.0
2426,Suso,ESP,"FW,MF",Milan,Serie A,25,1993,15.1,7,3,2,3,2,2,10,20.0,8,5,0,5,8,15,3,0,0,2019-2020,0.5298013245033113,0.4635761589403974
2427,Suso,ESP,"FW,MF",Sevilla,La Liga,25,1993,8.7,9,4,4,4,1,7,16,43.8,9,6,0,6,2,11,0,0,0,2019-2020,0.2298850574712644,1.0344827586206897
2428,Bosko Sutalo,CRO,DF,Atalanta,Serie A,19,2000,3.1,3,2,2,1,0,0,2,0.0,2,4,0,4,6,9,6,1,0,2019-2020,1.9354838709677418,0.9677419354838709
2429,Markus Suttner,AUT,DF,Düsseldorf,Bundesliga,32,1987,14.9,21,16,11,9,1,11,24,45.8,13,22,7,15,13,34,33,0,0,2019-2020,0.87248322147651,1.4093959731543624
2430,Mattias Svanberg,SWE,MF,Bologna,Serie A,20,1999,11.7,13,8,9,4,0,6,31,19.4,25,15,4,11,13,26,10,0,0,2019-2020,1.1111111111111112,1.1111111111111112
2431,Issiaga Sylla,GUI,DF,Toulouse,Ligue 1,25,1994,28.0,73,49,44,21,8,40,69,58.0,29,31,7,24,67,140,90,2,0,2019-2020,2.392857142857143,2.607142857142857
2432,Moussa Sylla,MLI,FW,Monaco,Ligue 1,19,1999,0.1,0,0,0,0,0,0,0,0.0,0,0,0,0,0,0,0,0,0,2019-2020,0.0,0.0
2433,Eddy Sylvestre,FRA,MF,Nice,Ligue 1,19,1999,0.4,0,0,0,0,0,0,1,0.0,1,0,0,0,0,0,0,0,0,2019-2020,0.0,0.0
2434,Ádám Szalai,HUN,FW,Mainz 05,Bundesliga,31,1987,12.7,8,4,0,6,2,1,11,9.1,10,9,0,9,2,10,14,0,0,2019-2020,0.15748031496062992,0.6299212598425197
2435,Wojciech Szczęsny,POL,GK,Juventus,Serie A,29,1990,28.8,0,0,0,0,0,0,0,0.0,0,0,0,0,1,1,10,1,0,2019-2020,0.034722222222222224,0.0
2436,Andrea Tabanelli,ITA,MF,Lecce,Serie A,29,1990,10.7,22,13,10,9,3,8,28,28.6,20,13,2,11,11,33,19,0,0,2019-2020,1.0280373831775702,2.0560747663551404
2437,Tachi,ESP,DF,Alavés,La Liga,21,1997,2.6,2,1,2,0,0,1,4,25.0,3,5,4,1,4,6,12,0,0,2019-2020,1.5384615384615383,0.7692307692307692
2438,Panagiotis Tachtsidis,GRE,MF,Lecce,Serie A,28,1991,22.3,52,27,26,20,6,20,56,35.7,36,27,11,16,35,87,32,2,0,2019-2020,1.569506726457399,2.3318385650224216
2439,Jonathan Tah,GER,DF,Leverkusen,Bundesliga,23,1996,23.2,36,26,23,11,2,18,29,62.1,11,25,13,12,27,63,98,2,0,2019-2020,1.1637931034482758,1.5517241379310345
2440,Flavien Tait,FRA,"MF,FW",Rennes,Ligue 1,26,1993,9.8,20,13,12,6,2,9,28,32.1,19,7,0,7,9,29,5,1,0,2019-2020,0.9183673469387754,2.0408163265306123
2441,Madih Talal,FRA,FW,Amiens,Ligue 1,21,1997,0.2,0,0,0,0,0,0,1,0.0,1,1,0,1,0,0,2,0,0,2019-2020,0.0,0.0
2442,Adrien Tameze,CMR,MF,Atalanta,Serie A,25,1994,2.3,4,3,1,1,2,1,2,50.0,1,3,1,2,3,7,4,1,0,2019-2020,1.3043478260869565,1.7391304347826089
2443,Adrien Tameze,CMR,MF,Nice,Ligue 1,25,1994,5.8,6,2,2,3,1,4,16,25.0,12,7,2,5,7,13,1,1,0,2019-2020,1.206896551724138,1.0344827586206897
2444,Japhet Tanganga,ENG,DF,Tottenham,Premier League,20,1999,5.8,17,9,10,6,1,10,17,58.8,7,7,6,1,11,28,31,2,0,2019-2020,1.896551724137931,2.931034482758621
2445,Adil Taoui,FRA,MF,Toulouse,Ligue 1,17,2001,0.3,2,2,0,2,0,0,2,0.0,2,0,0,0,2,4,0,0,0,2019-2020,6.666666666666667,6.666666666666667
2446,Edmond Tapsoba,BFA,DF,Leverkusen,Bundesliga,20,1999,11.8,24,15,17,5,2,15,25,60.0,10,9,5,4,9,33,44,0,0,2019-2020,0.7627118644067796,2.0338983050847457
2447,Matt Targett,ENG,"DF,MF",Aston Villa,Premier League,23,1995,25.5,52,29,37,11,4,22,53,41.5,31,28,8,20,56,108,82,0,0,2019-2020,2.196078431372549,2.0392156862745097
2448,Rodrigo Tarín,ESP,DF,Leganés,La Liga,23,1996,10.6,10,7,8,2,0,9,14,64.3,5,7,3,4,9,19,51,0,0,2019-2020,0.8490566037735849,0.9433962264150944
2449,James Tarkowski,ENG,DF,Burnley,Premier League,26,1992,38.0,66,43,47,19,0,31,54,57.4,23,63,47,16,63,129,204,4,0,2019-2020,1.6578947368421053,1.736842105263158
2450,Ciprian Tătărușanu,ROU,GK,Lyon,Ligue 1,33,1986,2.0,0,0,0,0,0,0,0,0.0,0,0,0,0,0,0,0,1,0,2019-2020,0.0,0.0
Rk,Player,Nation,Pos,Squad,Comp,0,0,90.0,0,0,3,3,3,Tkl,0,0.0,0,0,0,0,0,0,0,0,0,2019-2020,0.0,0.0
2451,Júlio Tavares,CPV,FW,Dijon,Ligue 1,30,1988,22.2,12,8,1,6,5,4,17,23.5,13,9,2,7,8,20,29,0,0,2019-2020,0.3603603603603604,0.5405405405405406
2452,Charlie Taylor,ENG,DF,Burnley,Premier League,25,1993,21.6,39,24,26,9,4,19,39,48.7,20,29,9,20,29,68,78,1,0,2019-2020,1.3425925925925926,1.8055555555555554
2453,Neil Taylor,WAL,DF,Aston Villa,Premier League,30,1989,12.1,16,11,12,4,0,11,20,55.0,9,15,5,10,20,36,43,0,0,2019-2020,1.6528925619834711,1.322314049586777
2454,Aurélien Tchouaméni,FRA,MF,Bordeaux,Ligue 1,19,2000,12.3,30,14,15,13,2,11,27,40.7,16,11,3,8,13,43,19,1,0,2019-2020,1.056910569105691,2.4390243902439024
2455,Aurélien Tchouaméni,FRA,MF,Monaco,Ligue 1,19,2000,0.7,0,0,0,0,0,0,2,0.0,2,0,0,0,0,0,2,1,0,2019-2020,0.0,0.0
2456,Georg Teigl,AUT,"DF,MF",Augsburg,Bundesliga,28,1991,1.2,3,1,1,2,0,2,4,50.0,2,0,0,0,3,6,1,0,0,2019-2020,2.5,2.5
2457,Álvaro Tejero,ESP,DF,Eibar,La Liga,23,1996,16.1,30,18,17,10,3,14,23,60.9,9,17,4,13,28,58,38,0,0,2019-2020,1.7391304347826086,1.8633540372670805
2458,Bernard Tekpetey,GHA,"FW,MF",Düsseldorf,Bundesliga,21,1997,5.0,4,4,1,2,1,0,2,0.0,2,5,0,5,2,6,0,0,0,2019-2020,0.4,0.8
2459,Nathan Tella,NGA,FW,Southampton,Premier League,20,1999,0.0,0,0,0,0,0,0,0,0.0,0,0,0,0,0,0,0,0,0,2019-2020,,
2460,Cristian Tello,ESP,"MF,FW",Betis,La Liga,27,1991,8.7,8,5,2,2,4,4,8,50.0,4,5,0,5,4,12,0,0,0,2019-2020,0.4597701149425288,0.9195402298850576
2461,Lino Tempelmann,GER,MF,Freiburg,Bundesliga,20,1999,0.4,1,0,1,0,0,1,1,100.0,0,1,1,0,0,1,0,0,0,2019-2020,0.0,2.5
2462,Łukasz Teodorczyk,POL,FW,Udinese,Serie A,28,1991,2.5,7,5,1,5,1,3,7,42.9,4,2,0,2,0,7,1,0,0,2019-2020,0.0,2.8
2463,Hidde ter Avest,NED,DF,Udinese,Serie A,22,1997,7.6,18,9,13,3,2,14,17,82.4,3,6,1,5,9,27,27,0,0,2019-2020,1.1842105263157896,2.368421052631579
2464,Marc-André ter Stegen,GER,GK,Barcelona,La Liga,27,1992,36.0,2,2,2,0,0,2,3,66.7,1,0,0,0,2,4,17,6,0,2019-2020,0.05555555555555555,0.05555555555555555
2465,Simon Terodde,GER,FW,Köln,Bundesliga,31,1988,9.0,8,5,4,3,1,3,13,23.1,10,14,3,11,2,10,14,0,0,2019-2020,0.2222222222222222,0.8888888888888888
2466,Pietro Terracciano,ITA,GK,Fiorentina,Serie A,29,1990,6.9,0,0,0,0,0,0,0,0.0,0,0,0,0,0,0,4,0,0,2019-2020,0.0,0.0
2467,Martin Terrier,FRA,"FW,MF",Lyon,Ligue 1,22,1997,13.3,20,15,7,10,3,3,14,21.4,11,14,1,13,10,30,11,0,0,2019-2020,0.7518796992481203,1.5037593984962405
2468,Aleksa Terzić,SRB,MF,Fiorentina,Serie A,19,1999,0.1,0,0,0,0,0,0,0,0.0,0,0,0,0,0,0,0,0,0,2019-2020,0.0,0.0
2469,Kenny Tete,NED,DF,Lyon,Ligue 1,23,1995,11.9,33,21,12,16,5,15,23,65.2,8,12,3,9,19,52,34,0,0,2019-2020,1.5966386554621848,2.773109243697479
2470,Alexander Tettey,NOR,"MF,DF",Norwich City,Premier League,33,1986,26.0,23,18,7,16,0,11,39,28.2,28,20,9,11,43,66,72,1,0,2019-2020,1.6538461538461537,0.8846153846153846
2471,Florian Thauvin,FRA,FW,Marseille,Ligue 1,26,1993,0.2,1,0,0,1,0,0,1,0.0,1,0,0,0,0,1,0,0,0,2019-2020,0.0,5.0
2472,Demba Thiam,SEN,GK,SPAL,Serie A,21,1998,2.0,0,0,0,0,0,0,0,0.0,0,0,0,0,1,1,0,0,0,2019-2020,0.5,0.0
2473,Malick Thiaw,GER,DF,Schalke 04,Bundesliga,17,2001,0.8,2,0,1,1,0,1,2,50.0,1,2,2,0,2,4,4,1,0,2019-2020,2.5,2.5
2474,Niclas Thiede,GER,GK,Freiburg,Bundesliga,20,1999,0.8,0,0,0,0,0,0,0,0.0,0,0,0,0,0,0,1,0,0,2019-2020,0.0,0.0
2475,Jan Thielmann,GER,"FW,MF",Köln,Bundesliga,17,2002,6.2,9,6,2,6,1,5,12,41.7,7,8,0,8,8,17,6,0,0,2019-2020,1.2903225806451613,1.4516129032258065
Rk,Player,Nation,Pos,Squad,Comp,0,0,90.0,0,0,3,3,3,Tkl,0,0.0,0,0,0,0,0,0,0,0,0,2019-2020,0.0,0.0
2476,Sada Thioub,SEN,"MF,FW",Angers,Ligue 1,24,1995,16.8,20,12,8,9,3,5,18,27.8,13,9,1,8,4,24,5,0,0,2019-2020,0.23809523809523808,1.1904761904761905
2477,Jordan Thomas,ENG,FW,Norwich City,Premier League,18,2001,0.0,0,0,0,0,0,0,0,0.0,0,0,0,0,0,0,0,0,0,2019-2020,,
2478,Luke Thomas,ENG,"MF,DF",Leicester City,Premier League,18,2001,3.0,1,0,0,1,0,0,3,0.0,3,2,0,2,3,4,7,0,0,2019-2020,1.0,0.3333333333333333
2479,Romain Thomas,FRA,DF,Angers,Ligue 1,31,1988,26.0,24,17,16,7,1,8,18,44.4,10,35,18,17,39,63,118,1,0,2019-2020,1.5,0.9230769230769231
2480,Adrien Thomasson,FRA,"MF,FW",Strasbourg,Ligue 1,25,1993,23.0,36,21,11,16,9,15,47,31.9,32,21,1,20,9,45,9,0,0,2019-2020,0.391304347826087,1.565217391304348
2481,Erik Thommy,GER,"MF,FW",Düsseldorf,Bundesliga,24,1994,25.1,40,23,16,16,8,15,39,38.5,24,23,2,21,16,56,20,1,0,2019-2020,0.6374501992031872,1.593625498007968
2482,Max Thompson,ENG,FW,Burnley,Premier League,17,2002,0.0,0,0,0,0,0,0,0,0.0,0,0,0,0,0,0,0,0,0,2019-2020,,
2483,Morten Thorsby,NOR,"MF,DF",Sampdoria,Serie A,23,1996,20.7,53,34,17,23,13,27,52,51.9,25,24,6,18,17,70,34,0,0,2019-2020,0.821256038647343,2.560386473429952
2484,Khéphren Thuram,FRA,MF,Nice,Ligue 1,18,2001,6.6,22,7,14,8,0,6,17,35.3,11,12,2,10,7,29,13,0,0,2019-2020,1.0606060606060606,3.3333333333333335
2485,Marcus Thuram,FRA,FW,Gladbach,Bundesliga,21,1997,24.5,26,18,7,8,11,11,29,37.9,18,20,1,19,12,38,18,0,0,2019-2020,0.4897959183673469,1.0612244897959184
2486,Youri Tielemans,BEL,MF,Leicester City,Premier League,22,1997,31.4,52,29,17,30,5,24,74,32.4,50,43,4,39,22,74,18,0,0,2019-2020,0.7006369426751593,1.6560509554140128
2487,Kieran Tierney,SCO,"DF,MF",Arsenal,Premier League,22,1997,11.0,20,16,13,6,1,11,15,73.3,4,10,4,6,9,29,37,1,0,2019-2020,0.8181818181818182,1.8181818181818181
2488,Cheick Timite,CIV,"MF,FW",Amiens,Ligue 1,21,1997,1.3,1,0,0,1,0,0,1,0.0,1,0,0,0,2,3,1,0,0,2019-2020,1.5384615384615383,0.7692307692307692
2489,David Timor,ESP,"MF,DF",Getafe,La Liga,29,1989,10.5,9,6,4,5,0,5,16,31.3,11,8,3,5,18,27,23,0,0,2019-2020,1.7142857142857142,0.8571428571428571
2490,Marcel Tisserand,COD,DF,Wolfsburg,Bundesliga,26,1993,13.4,21,10,14,5,2,7,12,58.3,5,13,4,9,32,53,49,2,0,2019-2020,2.388059701492537,1.5671641791044775
2491,Jean-Clair Todibo,FRA,DF,Barcelona,La Liga,19,1999,0.9,1,0,1,0,0,0,1,0.0,1,0,0,0,0,1,6,0,0,2019-2020,0.0,1.1111111111111112
2492,Jean-Clair Todibo,FRA,DF,Schalke 04,Bundesliga,19,1999,4.1,15,10,10,5,0,8,9,88.9,1,2,0,2,15,30,24,0,0,2019-2020,3.658536585365854,3.658536585365854
2493,Karl Toko Ekambi,CMR,FW,Villarreal,La Liga,26,1992,11.0,5,3,0,3,2,1,4,25.0,3,2,0,2,3,8,2,0,0,2019-2020,0.2727272727272727,0.45454545454545453
2494,Karl Toko Ekambi,CMR,"FW,MF",Lyon,Ligue 1,26,1992,6.0,5,2,0,1,4,3,5,60.0,2,2,0,2,5,10,1,0,0,2019-2020,0.8333333333333334,0.8333333333333334
2495,Corentin Tolisso,FRA,MF,Bayern Munich,Bundesliga,24,1994,7.1,9,4,4,3,2,1,9,11.1,8,9,3,6,4,13,2,1,0,2019-2020,0.5633802816901409,1.267605633802817
2496,Jeremy Toljan,GER,DF,Sassuolo,Serie A,24,1994,24.3,37,21,24,10,3,18,35,51.4,17,23,12,11,18,55,58,1,0,2019-2020,0.7407407407407407,1.522633744855967
2497,Rafael Tolói,ITA,DF,Atalanta,Serie A,28,1990,29.0,56,29,28,23,5,33,76,43.4,43,31,17,14,45,101,80,0,0,2019-2020,1.5517241379310345,1.9310344827586208
2498,Raúl de Tomás,ESP,FW,Espanyol,La Liga,24,1994,11.9,9,7,3,4,2,4,13,30.8,9,8,1,7,10,19,4,0,0,2019-2020,0.8403361344537815,0.7563025210084033
2499,Takehiro Tomiyasu,JPN,DF,Bologna,Serie A,20,1998,28.1,42,24,25,13,4,22,41,53.7,19,34,9,25,49,91,78,1,0,2019-2020,1.7437722419928825,1.494661921708185
2500,James Tomkins,ENG,DF,Crystal Palace,Premier League,30,1989,17.6,29,17,21,8,0,18,25,72.0,7,17,15,2,21,50,103,0,0,2019-2020,1.1931818181818181,1.6477272727272725
Rk,Player,Nation,Pos,Squad,Comp,0,0,90.0,0,0,3,3,3,Tkl,0,0.0,0,0,0,0,0,0,0,0,0,2019-2020,0.0,0.0
2501,Fikayo Tomori,ENG,DF,Chelsea,Premier League,21,1997,14.3,29,16,21,8,0,10,15,66.7,5,13,7,6,22,51,48,2,0,2019-2020,1.5384615384615383,2.027972027972028
2502,Nenad Tomović,SRB,DF,SPAL,Serie A,31,1987,19.5,26,19,18,6,2,10,21,47.6,11,32,23,9,30,56,65,1,0,2019-2020,1.5384615384615385,1.3333333333333333
2503,Sandro Tonali,ITA,MF,Brescia,Serie A,19,2000,33.5,39,25,16,20,3,16,55,29.1,39,36,14,22,41,80,42,0,0,2019-2020,1.2238805970149254,1.164179104477612
2504,Lorenzo Tonelli,ITA,DF,Sampdoria,Serie A,29,1990,7.8,13,9,13,0,0,4,10,40.0,6,10,7,3,4,17,23,0,0,2019-2020,0.5128205128205129,1.6666666666666667
2505,Toño,ESP,DF,Levante,La Liga,29,1989,17.7,26,19,18,7,1,15,28,53.6,13,11,3,8,13,39,34,1,0,2019-2020,0.7344632768361582,1.4689265536723164
2506,Ömer Toprak,TUR,DF,Werder Bremen,Bundesliga,30,1989,7.9,7,2,4,2,1,3,6,50.0,3,6,4,2,12,19,41,0,0,2019-2020,1.5189873417721518,0.8860759493670886
2507,Ernesto Torregrossa,VEN,FW,Brescia,Serie A,27,1992,20.5,17,7,5,10,2,6,22,27.3,16,10,2,8,5,22,22,0,0,2019-2020,0.24390243902439024,0.8292682926829268
2508,Lucas Torreira,URU,MF,Arsenal,Premier League,23,1996,16.8,31,16,11,15,5,16,39,41.0,23,24,8,16,34,65,24,0,0,2019-2020,2.0238095238095237,1.8452380952380951
2509,Ferrán Torres,ESP,"MF,FW",Valencia,La Liga,19,2000,25.0,23,15,6,16,1,8,30,26.7,22,20,3,17,14,37,12,0,0,2019-2020,0.56,0.92
2510,Óliver Torres,ESP,"MF,FW",Sevilla,La Liga,24,1994,17.7,45,27,12,26,7,23,60,38.3,37,23,1,22,13,58,9,1,0,2019-2020,0.7344632768361582,2.542372881355932
2511,Pau Torres,ESP,DF,Villarreal,La Liga,22,1997,33.0,34,21,24,10,0,16,24,66.7,8,39,23,16,27,61,153,1,0,2019-2020,0.8181818181818182,1.0303030303030303
2512,Roberto Torres,ESP,"MF,FW",Osasuna,La Liga,30,1989,30.2,33,16,12,18,3,21,49,42.9,28,41,2,39,31,64,37,0,0,2019-2020,1.0264900662251655,1.0927152317880795
2513,Lucas Torró,ESP,MF,Eint Frankfurt,Bundesliga,25,1994,3.7,12,7,6,6,0,8,16,50.0,8,2,1,1,8,20,3,0,0,2019-2020,2.162162162162162,3.243243243243243
2514,Jordan Torunarigha,GER,DF,Hertha BSC,Bundesliga,21,1997,16.2,32,19,21,11,0,18,27,66.7,9,33,18,15,31,63,75,0,0,2019-2020,1.9135802469135803,1.9753086419753088
2515,Cenk Tosun,TUR,FW,Crystal Palace,Premier League,28,1991,2.0,2,2,2,0,0,0,2,0.0,2,0,0,0,0,2,1,0,0,2019-2020,0.0,1.0
2516,Cenk Tosun,TUR,FW,Everton,Premier League,28,1991,3.2,2,0,0,0,2,0,1,0.0,1,1,0,1,0,2,1,0,0,2019-2020,0.0,0.625
2517,Abdoulaye Touré,GUI,MF,Nantes,Ligue 1,25,1994,24.7,32,21,10,21,1,10,30,33.3,20,31,11,20,29,61,18,1,0,2019-2020,1.174089068825911,1.2955465587044535
2518,Almamy Touré,MLI,DF,Eint Frankfurt,Bundesliga,23,1996,16.6,32,19,18,11,3,11,22,50.0,11,18,7,11,23,55,54,1,0,2019-2020,1.3855421686746987,1.9277108433734937
2519,Lucas Tousart,FRA,MF,Lyon,Ligue 1,22,1997,19.6,58,32,19,34,5,17,56,30.4,39,19,7,12,31,89,27,1,0,2019-2020,1.5816326530612244,2.9591836734693877
2520,Andros Townsend,ENG,"FW,MF",Crystal Palace,Premier League,28,1991,14.4,34,21,12,17,5,15,37,40.5,22,18,0,18,15,49,10,1,0,2019-2020,1.0416666666666667,2.361111111111111
2521,Aleksandar Trajkovski,MKD,"MF,FW",Mallorca,La Liga,26,1992,3.7,2,0,1,1,0,1,7,14.3,6,2,0,2,3,5,1,0,0,2019-2020,0.8108108108108107,0.5405405405405405
2522,Adama Traoré,ESP,"FW,DF",Wolves,Premier League,23,1996,28.9,33,21,6,14,13,8,23,34.8,15,19,3,16,13,46,14,2,0,2019-2020,0.44982698961937717,1.1418685121107266
2523,Adama Traoré,MLI,"FW,MF",Metz,Ligue 1,24,1995,11.2,3,1,1,2,0,3,12,25.0,9,7,2,5,3,6,5,0,0,2019-2020,0.26785714285714285,0.26785714285714285
2524,Adama Traoré,MLI,MF,Monaco,Ligue 1,24,1995,0.3,0,0,0,0,0,0,0,0.0,0,0,0,0,1,1,0,0,0,2019-2020,3.3333333333333335,0.0
2525,Bertrand Traoré,BFA,"FW,MF",Lyon,Ligue 1,23,1995,13.9,27,14,8,12,7,8,19,42.1,11,17,2,15,21,48,16,0,0,2019-2020,1.5107913669064748,1.9424460431654675
Rk,Player,Nation,Pos,Squad,Comp,0,0,90.0,0,0,3,3,3,Tkl,0,0.0,0,0,0,0,0,0,0,0,0,2019-2020,0.0,0.0
2526,Charles Traore,MLI,DF,Nantes,Ligue 1,27,1992,19.3,48,35,27,19,2,36,61,59.0,25,21,4,17,39,87,64,0,0,2019-2020,2.0207253886010363,2.4870466321243523
2527,Hamari Traoré,MLI,DF,Rennes,Ligue 1,27,1992,26.8,55,26,34,18,3,32,64,50.0,32,22,5,17,48,103,59,1,0,2019-2020,1.791044776119403,2.0522388059701493
2528,Ibrahima Traoré,GUI,"FW,MF",Gladbach,Bundesliga,31,1988,1.7,4,3,1,1,2,1,7,14.3,6,1,0,1,1,5,3,0,0,2019-2020,0.5882352941176471,2.3529411764705883
2529,Ismaël Traoré,CIV,DF,Angers,Ligue 1,32,1986,22.8,23,12,14,7,2,10,17,58.8,7,23,13,10,27,50,85,1,0,2019-2020,1.1842105263157894,1.0087719298245614
2530,Kevin Trapp,GER,GK,Eint Frankfurt,Bundesliga,29,1990,22.0,0,0,0,0,0,0,1,0.0,1,0,0,0,3,3,5,0,0,2019-2020,0.13636363636363635,0.0
2531,Miguel Trauco,PER,DF,Saint-Étienne,Ligue 1,26,1992,16.4,32,20,16,12,4,19,44,43.2,25,8,1,7,23,55,25,0,0,2019-2020,1.402439024390244,1.9512195121951221
2532,Mark Travers,IRL,GK,Bournemouth,Premier League,20,1999,1.0,0,0,0,0,0,0,0,0.0,0,0,0,0,0,0,1,1,0,2019-2020,0.0,0.0
2533,Luca Tremolada,ITA,MF,Brescia,Serie A,27,1991,0.2,0,0,0,0,0,0,0,0.0,0,0,0,0,0,0,0,0,0,2019-2020,0.0,0.0
2534,Trézéguet,EGY,"FW,MF",Aston Villa,Premier League,24,1994,21.7,38,16,18,15,5,9,44,20.5,35,23,2,21,25,63,18,0,0,2019-2020,1.1520737327188941,1.7511520737327189
2535,Manu Trigueros,ESP,MF,Villarreal,La Liga,27,1991,17.2,34,21,10,17,7,12,45,26.7,33,23,12,11,4,38,21,0,0,2019-2020,0.23255813953488372,1.9767441860465118
2536,Christopher Trimmel,AUT,"DF,MF",Union Berlin,Bundesliga,32,1987,31.8,71,41,35,32,4,32,54,59.3,22,31,10,21,51,122,88,1,0,2019-2020,1.6037735849056602,2.2327044025157234
2537,Alessandro Tripaldelli,ITA,DF,Sassuolo,Serie A,20,1999,1.5,4,4,1,3,0,1,3,33.3,2,1,0,1,3,7,3,0,0,2019-2020,2.0,2.6666666666666665
2538,Kieran Trippier,ENG,DF,Atlético Madrid,La Liga,28,1990,22.0,52,34,24,21,7,34,53,64.2,19,33,7,26,24,76,46,0,0,2019-2020,1.0909090909090908,2.3636363636363638
2539,William Troost-Ekong,NGA,DF,Udinese,Serie A,25,1993,28.6,37,19,25,12,0,10,18,55.6,8,41,29,12,31,68,135,2,0,2019-2020,1.083916083916084,1.2937062937062938
2540,Leandro Trossard,BEL,"FW,MF",Brighton,Premier League,24,1994,22.3,22,17,7,12,3,6,38,15.8,32,16,1,15,9,31,8,0,0,2019-2020,0.40358744394618834,0.9865470852017937
2541,Tom Trybull,GER,MF,Norwich City,Premier League,26,1993,12.6,39,25,15,18,6,16,60,26.7,44,20,5,15,16,55,35,0,0,2019-2020,1.2698412698412698,3.0952380952380953
2542,Axel Tuanzebe,COD,DF,Manchester Utd,Premier League,21,1997,2.1,2,2,0,2,0,1,2,50.0,1,1,0,1,5,7,5,1,0,2019-2020,2.380952380952381,0.9523809523809523
2543,Georgi Tunjov,EST,MF,SPAL,Serie A,18,2001,3.2,4,4,3,1,0,1,11,9.1,10,3,1,2,1,5,0,0,0,2019-2020,0.3125,1.25
2544,Stefano Turati,ITA,GK,Sassuolo,Serie A,17,2001,2.0,0,0,0,0,0,0,0,0.0,0,0,0,0,0,0,1,0,0,2019-2020,0.0,0.0
2545,Gennaro Tutino,ITA,"FW,MF",Hellas Verona,Serie A,22,1996,2.5,0,0,0,0,0,0,0,0.0,0,0,0,0,2,2,1,0,0,2019-2020,0.8,0.0
2546,Matthieu Udol,FRA,DF,Metz,Ligue 1,23,1996,12.2,29,19,19,8,2,13,24,54.2,11,21,4,17,23,52,43,0,0,2019-2020,1.8852459016393444,2.377049180327869
2547,Hwang Ui-jo,KOR,"FW,MF",Bordeaux,Ligue 1,26,1992,18.1,9,7,2,5,2,4,20,20.0,16,7,0,7,5,14,5,0,0,2019-2020,0.2762430939226519,0.49723756906077343
2548,Anthony Ujah,NGA,"FW,MF",Union Berlin,Bundesliga,28,1990,10.5,8,6,4,2,2,1,6,16.7,5,0,0,0,3,11,10,0,0,2019-2020,0.2857142857142857,0.7619047619047619
2549,Samir Ujkani,KVX,GK,Torino,Serie A,31,1988,1.0,0,0,0,0,0,0,0,0.0,0,0,0,0,0,0,1,0,0,2019-2020,0.0,0.0
2550,Sven Ulreich,GER,GK,Bayern Munich,Bundesliga,30,1988,1.0,0,0,0,0,0,0,0,0.0,0,0,0,0,0,0,0,0,0,2019-2020,0.0,0.0
Rk,Player,Nation,Pos,Squad,Comp,0,0,90.0,0,0,3,3,3,Tkl,0,0.0,0,0,0,0,0,0,0,0,0,2019-2020,0.0,0.0
2551,Samuel Umtiti,FRA,DF,Barcelona,La Liga,25,1993,10.5,11,5,5,5,1,5,8,62.5,3,4,2,2,22,33,32,0,0,2019-2020,2.0952380952380953,1.0476190476190477
2552,Enes Ünal,TUR,FW,Valladolid,La Liga,22,1997,26.0,20,12,6,11,3,6,28,21.4,22,17,5,12,6,26,13,0,0,2019-2020,0.23076923076923078,0.7692307692307693
2553,Cengiz Ünder,TUR,FW,Roma,Serie A,22,1997,9.7,10,6,4,4,2,2,9,22.2,7,7,2,5,8,18,7,0,0,2019-2020,0.8247422680412372,1.0309278350515465
2554,Dayot Upamecano,FRA,DF,RB Leipzig,Bundesliga,20,1998,26.2,52,31,37,15,0,23,43,53.5,20,31,17,14,43,95,88,1,0,2019-2020,1.6412213740458015,1.984732824427481
2555,Mark Uth,GER,"MF,FW",Köln,Bundesliga,27,1991,12.9,19,12,4,10,5,9,32,28.1,23,15,0,15,7,26,3,0,0,2019-2020,0.5426356589147286,1.4728682170542635
2556,Mark Uth,GER,"FW,MF",Schalke 04,Bundesliga,27,1991,3.9,3,2,1,1,1,0,3,0.0,3,4,0,4,1,4,0,0,0,2019-2020,0.25641025641025644,0.7692307692307693
2557,Tomáš Vaclík,CZE,GK,Sevilla,La Liga,30,1989,32.5,0,0,0,0,0,0,1,0.0,1,0,0,0,0,0,7,0,0,2019-2020,0.0,0.0
2558,Álvaro Vadillo,ESP,"FW,MF",Granada,La Liga,24,1994,13.5,16,11,6,8,2,9,16,56.3,7,12,0,12,7,23,2,0,0,2019-2020,0.5185185185185185,1.1851851851851851
2559,William Vainqueur,FRA,MF,Toulouse,Ligue 1,30,1988,19.1,68,36,30,32,6,22,60,36.7,38,21,5,16,29,97,23,0,0,2019-2020,1.5183246073298429,3.5602094240837694
2560,Mirko Valdifiori,ITA,MF,SPAL,Serie A,33,1986,15.6,31,15,14,17,0,16,33,48.5,17,8,3,5,4,35,25,0,0,2019-2020,0.25641025641025644,1.9871794871794872
2561,Pierrick Valdivia,FRA,MF,Nîmes,Ligue 1,31,1988,0.8,1,1,0,0,1,0,1,0.0,1,0,0,0,0,1,0,0,0,2019-2020,0.0,1.25
2562,Germán Valera,ESP,FW,Atlético Madrid,La Liga,17,2002,0.0,0,0,0,0,0,0,0,0.0,0,1,0,1,0,0,0,0,0,2019-2020,,
2563,Antoine Valerio,FRA,MF,Nîmes,Ligue 1,19,1999,1.0,1,1,0,1,0,0,2,0.0,2,2,0,2,3,4,1,0,0,2019-2020,3.0,1.0
2564,Borja Valero,ESP,MF,Inter,Serie A,34,1985,10.3,18,7,9,3,6,6,24,25.0,18,12,3,9,8,26,9,0,0,2019-2020,0.7766990291262136,1.7475728155339805
2565,Yan Valery,TUN,DF,Southampton,Premier League,20,1999,8.7,20,7,9,7,4,11,19,57.9,8,9,1,8,13,33,32,2,0,2019-2020,1.4942528735632186,2.298850574712644
2566,Martin Valjent,SVK,DF,Mallorca,La Liga,23,1995,35.4,25,17,14,10,1,13,25,52.0,12,39,27,12,37,62,146,1,0,2019-2020,1.0451977401129944,0.7062146892655368
2567,Jesús Vallejo,ESP,DF,Wolves,Premier League,22,1997,1.8,1,1,1,0,0,1,2,50.0,1,4,3,1,2,3,8,1,0,2019-2020,1.1111111111111112,0.5555555555555556
2568,Jesús Vallejo,ESP,DF,Granada,La Liga,22,1997,7.0,6,5,4,2,0,3,4,75.0,1,7,4,3,5,11,28,0,0,2019-2020,0.7142857142857143,0.8571428571428571
2569,Manu Vallejo,ESP,"MF,FW",Valencia,La Liga,22,1997,4.6,7,3,0,3,4,5,9,55.6,4,4,0,4,2,9,2,0,0,2019-2020,0.4347826086956522,1.5217391304347827
2570,Luca Valls,FRA,MF,Nîmes,Ligue 1,20,1998,0.1,1,0,1,0,0,1,1,100.0,0,1,0,1,0,1,0,0,0,2019-2020,0.0,10.0
2571,Theo Valls,FRA,MF,Nîmes,Ligue 1,23,1995,18.1,39,16,12,26,1,16,50,32.0,34,17,0,17,13,52,6,0,0,2019-2020,0.718232044198895,2.154696132596685
2572,Mattia Valoti,ITA,"MF,FW",SPAL,Serie A,25,1993,17.0,48,30,21,25,2,16,43,37.2,27,27,6,21,16,64,18,0,0,2019-2020,0.9411764705882353,2.823529411764706
2573,Federico Valverde,URU,MF,Real Madrid,La Liga,21,1998,21.2,38,19,9,19,10,12,36,33.3,24,38,4,34,21,59,12,2,0,2019-2020,0.9905660377358491,1.7924528301886793
2574,Virgil van Dijk,NED,DF,Liverpool,Premier League,28,1991,38.0,23,12,18,5,0,6,13,46.2,7,20,15,5,40,63,166,2,0,2019-2020,1.0526315789473684,0.6052631578947368
2575,Raphaël Varane,FRA,DF,Real Madrid,La Liga,26,1993,31.4,30,17,15,14,1,12,23,52.2,11,32,16,16,31,61,124,0,0,2019-2020,0.9872611464968153,0.9554140127388535
Rk,Player,Nation,Pos,Squad,Comp,0,0,90.0,0,0,3,3,3,Tkl,0,0.0,0,0,0,0,0,0,0,0,0,2019-2020,0.0,0.0
2576,Jamie Vardy,ENG,FW,Leicester City,Premier League,32,1987,33.7,15,12,0,9,6,2,4,50.0,2,22,4,18,2,17,22,0,0,2019-2020,0.05934718100890207,0.4451038575667655
2577,Matías Vargas,ARG,"FW,MF",Espanyol,La Liga,22,1997,11.4,13,5,7,3,3,4,23,17.4,19,12,2,10,3,16,5,0,0,2019-2020,0.2631578947368421,1.1403508771929824
2578,Ruben Vargas,SUI,"FW,MF",Augsburg,Bundesliga,20,1998,28.1,32,16,18,7,7,8,36,22.2,28,26,1,25,26,58,35,0,0,2019-2020,0.9252669039145907,1.1387900355871885
2579,Thibaut Vargas,FRA,"DF,MF",Montpellier,Ligue 1,19,2000,1.7,3,1,3,0,0,2,5,40.0,3,1,1,0,0,3,3,0,0,2019-2020,0.0,1.7647058823529411
2580,Sebastian Vasiliadis,GRE,MF,Paderborn 07,Bundesliga,21,1997,31.2,73,45,34,31,8,28,81,34.6,53,47,6,41,34,107,50,0,0,2019-2020,1.0897435897435899,2.33974358974359
2581,Indiana Vassilev,USA,"FW,MF",Aston Villa,Premier League,18,2001,0.6,0,0,0,0,0,0,0,0.0,0,0,0,0,0,0,0,0,0,2019-2020,0.0,0.0
2582,Denis Vavro,SVK,DF,Lazio,Serie A,23,1996,3.6,3,3,2,1,0,1,3,33.3,2,8,6,2,5,8,10,0,0,2019-2020,1.3888888888888888,0.8333333333333333
2583,Franco Vázquez,ARG,"MF,FW",Sevilla,La Liga,30,1989,12.2,25,17,9,14,2,6,36,16.7,30,13,0,13,10,35,10,0,0,2019-2020,0.819672131147541,2.0491803278688527
2584,Kevin Vázquez,ESP,DF,Celta Vigo,La Liga,26,1993,14.7,26,15,16,6,4,15,28,53.6,13,18,1,17,26,52,28,0,0,2019-2020,1.7687074829931975,1.7687074829931975
2585,Lucas Vázquez,ESP,"MF,FW",Real Madrid,La Liga,28,1991,9.4,23,17,10,13,0,11,26,42.3,15,10,0,10,10,33,8,1,0,2019-2020,1.0638297872340425,2.4468085106382977
2586,Matías Vecino,URU,MF,Inter,Serie A,27,1991,14.2,31,20,14,11,6,9,36,25.0,27,20,3,17,15,46,26,0,0,2019-2020,1.0563380281690142,2.183098591549296
2587,Koke Vegas,ESP,GK,Levante,La Liga,23,1995,2.0,0,0,0,0,0,0,1,0.0,1,0,0,0,0,0,3,0,0,2019-2020,0.0,0.0
2588,Miloš Veljković,SRB,DF,Werder Bremen,Bundesliga,23,1995,22.8,55,33,36,18,1,33,53,62.3,20,25,11,14,26,81,92,1,0,2019-2020,1.1403508771929824,2.4122807017543857
2589,Miguel Veloso,POR,MF,Hellas Verona,Serie A,33,1986,31.2,52,29,20,28,4,18,60,30.0,42,36,12,24,32,84,46,1,0,2019-2020,1.0256410256410258,1.6666666666666667
2590,Unai Vencedor Paris,ESP,MF,Athletic Club,La Liga,18,2000,0.8,0,0,0,0,0,0,0,0.0,0,0,0,0,0,0,0,0,0,2019-2020,0.0,0.0
2591,Lorenzo Venuti,ITA,"DF,MF",Fiorentina,Serie A,24,1995,9.5,20,10,12,6,2,13,19,68.4,6,5,1,4,11,31,15,0,0,2019-2020,1.1578947368421053,2.1052631578947367
2592,Brayan Vera,COL,"DF,FW",Lecce,Serie A,20,1999,1.7,4,1,2,1,1,3,7,42.9,4,1,0,1,1,5,4,0,0,2019-2020,0.5882352941176471,2.3529411764705883
2593,Simone Verdi,ITA,"MF,FW",Torino,Serie A,27,1992,23.0,19,10,4,12,3,9,38,23.7,29,14,0,14,7,26,1,0,0,2019-2020,0.30434782608695654,0.8260869565217391
2594,Jordan Veretout,FRA,MF,Roma,Serie A,26,1993,29.2,36,18,13,16,7,14,43,32.6,29,35,5,30,18,54,31,1,0,2019-2020,0.6164383561643836,1.2328767123287672
2595,Marco Verratti,ITA,MF,Paris S-G,Ligue 1,26,1992,16.5,54,32,22,22,10,20,56,35.7,36,23,3,20,19,73,9,0,0,2019-2020,1.1515151515151516,3.272727272727273
2596,Valerio Verre,ITA,"MF,FW",Hellas Verona,Serie A,25,1994,19.7,25,15,4,11,10,9,23,39.1,14,5,0,5,13,38,9,0,0,2019-2020,0.6598984771573604,1.2690355329949239
2597,Birger Verstraete,BEL,MF,Köln,Bundesliga,25,1994,7.4,20,11,9,10,1,11,21,52.4,10,8,1,7,4,24,10,1,0,2019-2020,0.5405405405405405,2.7027027027027026
2598,Jan Vertonghen,BEL,DF,Tottenham,Premier League,32,1987,18.3,40,24,25,14,1,20,31,64.5,11,18,10,8,33,73,68,0,0,2019-2020,1.8032786885245902,2.1857923497267757
2599,Mikel Vesga,ESP,MF,Athletic Club,La Liga,26,1993,14.1,25,17,7,12,6,9,45,20.0,36,18,7,11,31,56,24,1,0,2019-2020,2.198581560283688,1.773049645390071
2600,Jannik Vestergaard,DEN,DF,Southampton,Premier League,26,1992,16.6,19,12,14,5,0,11,28,39.3,17,15,9,6,26,45,99,2,0,2019-2020,1.5662650602409638,1.1445783132530118
Rk,Player,Nation,Pos,Squad,Comp,0,0,90.0,0,0,3,3,3,Tkl,0,0.0,0,0,0,0,0,0,0,0,0,2019-2020,0.0,0.0
2601,Rúben Vezo,POR,DF,Levante,La Liga,25,1994,29.0,41,24,28,13,0,19,35,54.3,16,37,29,8,42,83,144,2,0,2019-2020,1.4482758620689655,1.4137931034482758
2602,Francesco Vicari,ITA,DF,SPAL,Serie A,24,1994,32.2,27,13,20,6,1,12,25,48.0,13,48,37,11,38,65,145,1,0,2019-2020,1.1801242236024843,0.8385093167701863
2603,Fede Vico,ESP,"MF,FW",Granada,La Liga,25,1994,9.7,5,1,2,3,0,2,11,18.2,9,12,1,11,5,10,2,0,0,2019-2020,0.5154639175257733,0.5154639175257733
2604,Aleix Vidal,ESP,MF,Alavés,La Liga,29,1989,24.1,21,14,8,11,2,8,37,21.6,29,14,1,13,23,44,18,0,0,2019-2020,0.954356846473029,0.871369294605809
2605,Arturo Vidal,CHI,MF,Barcelona,La Liga,32,1987,18.6,63,38,22,30,11,24,58,41.4,34,31,7,24,17,80,16,1,0,2019-2020,0.9139784946236559,3.387096774193548
2606,Clément Vidal,FRA,DF,Montpellier,Ligue 1,19,2000,1.0,0,0,0,0,0,0,2,0.0,2,1,1,0,0,0,6,0,0,2019-2020,0.0,0.0
2607,Nacho Vidal,ESP,DF,Osasuna,La Liga,24,1995,25.9,45,29,26,13,6,21,38,55.3,17,24,6,18,44,89,70,1,0,2019-2020,1.698841698841699,1.7374517374517375
2608,Ronaldo Vieira,ENG,MF,Sampdoria,Serie A,21,1998,20.2,33,19,13,17,3,6,28,21.4,22,14,2,12,21,54,31,0,0,2019-2020,1.0396039603960396,1.6336633663366338
2609,Mauro Vigorito,ITA,GK,Lecce,Serie A,29,1990,4.7,0,0,0,0,0,0,0,0.0,0,0,0,0,0,0,3,1,0,2019-2020,0.0,0.0
2610,Dídac Vilà,ESP,DF,Espanyol,La Liga,30,1989,27.7,73,42,44,23,6,25,61,41.0,36,31,5,26,40,113,63,0,0,2019-2020,1.444043321299639,2.6353790613718413
2611,Toni Villa,ESP,MF,Valladolid,La Liga,24,1995,15.0,31,16,13,14,4,13,50,26.0,37,16,1,15,8,39,11,0,0,2019-2020,0.5333333333333333,2.066666666666667
2612,Asier Villalibre,ESP,FW,Athletic Club,La Liga,21,1997,5.9,0,0,0,0,0,0,3,0.0,3,3,0,3,1,1,4,0,0,2019-2020,0.1694915254237288,0.0
2613,Gonzalo Villar,ESP,MF,Roma,Serie A,21,1998,3.3,5,3,4,0,1,2,4,50.0,2,2,0,2,2,7,3,0,0,2019-2020,0.6060606060606061,1.5151515151515151
2614,Iván Villar,ESP,GK,Celta Vigo,La Liga,22,1997,3.1,0,0,0,0,0,0,0,0.0,0,0,0,0,0,0,5,0,0,2019-2020,0.0,0.0
2615,Juan Villar,ESP,FW,Osasuna,La Liga,31,1988,2.7,1,0,0,1,0,0,2,0.0,2,4,1,3,1,2,0,0,0,2019-2020,0.37037037037037035,0.37037037037037035
2616,Rúben Vinagre,POR,"MF,DF",Wolves,Premier League,20,1999,7.2,23,13,15,6,2,12,15,80.0,3,7,2,5,11,34,22,0,0,2019-2020,1.5277777777777777,3.194444444444444
2617,Luigi Vitale,ITA,DF,Hellas Verona,Serie A,31,1987,0.5,1,0,0,1,0,0,0,0.0,0,1,0,1,0,1,0,0,0,2019-2020,0.0,2.0
2618,Vitolo,ESP,"FW,MF",Atlético Madrid,La Liga,29,1989,13.6,15,12,7,7,1,5,17,29.4,12,9,0,9,10,25,9,0,0,2019-2020,0.7352941176470589,1.1029411764705883
2619,Mattia Viviani,ITA,MF,Brescia,Serie A,18,2000,3.8,3,1,0,3,0,1,8,12.5,7,3,3,0,9,12,2,1,0,2019-2020,2.368421052631579,0.7894736842105263
2620,Dušan Vlahović,SRB,FW,Fiorentina,Serie A,19,2000,16.7,6,2,1,4,1,4,13,30.8,9,5,2,3,7,13,6,0,0,2019-2020,0.4191616766467066,0.3592814371257485
2621,Kevin Vogt,GER,DF,Hoffenheim,Bundesliga,27,1991,10.7,7,5,4,3,0,3,9,33.3,6,12,6,6,8,15,52,1,0,2019-2020,0.7476635514018692,0.6542056074766356
2622,Kevin Vogt,GER,"DF,MF",Werder Bremen,Bundesliga,27,1991,12.3,14,10,8,6,0,8,16,50.0,8,15,12,3,25,39,37,1,0,2019-2020,2.0325203252032518,1.1382113821138211
2623,Jake Vokins,ENG,DF,Southampton,Premier League,19,2000,1.0,2,2,0,0,2,1,1,100.0,0,0,0,0,0,2,1,0,0,2019-2020,0.0,2.0
2624,Kevin Volland,GER,FW,Leverkusen,Bundesliga,27,1992,22.7,16,6,5,6,5,5,16,31.3,11,14,2,12,5,21,7,0,0,2019-2020,0.22026431718061676,0.7048458149779736
2625,Mario Vrančić,BIH,MF,Norwich City,Premier League,30,1989,7.1,27,16,14,11,2,16,27,59.3,11,9,0,9,10,37,4,2,0,2019-2020,1.4084507042253522,3.802816901408451
Rk,Player,Nation,Pos,Squad,Comp,0,0,90.0,0,0,3,3,3,Tkl,0,0.0,0,0,0,0,0,0,0,0,0,2019-2020,0.0,0.0
2626,Stefan de Vrij,NED,DF,Inter,Serie A,27,1992,31.4,33,18,20,12,1,14,27,51.9,13,34,24,10,52,85,121,1,0,2019-2020,1.6560509554140128,1.0509554140127388
2627,Giacomo Vrioni,ALB,FW,Juventus,Serie A,20,1998,0.1,0,0,0,0,0,0,0,0.0,0,0,0,0,0,0,0,0,0,2019-2020,0.0,0.0
2628,Šime Vrsaljko,CRO,DF,Atlético Madrid,La Liga,27,1992,4.0,6,5,6,0,0,5,6,83.3,1,5,3,2,8,14,11,0,0,2019-2020,2.0,1.5
2629,Nikola Vukčević,MNE,MF,Levante,La Liga,27,1991,17.4,41,26,17,17,7,15,40,37.5,25,19,7,12,12,53,16,0,0,2019-2020,0.6896551724137931,2.35632183908046
2630,Matěj Vydra,CZE,FW,Burnley,Premier League,27,1992,9.1,4,3,0,3,1,3,6,50.0,3,7,3,4,1,5,6,0,0,2019-2020,0.10989010989010989,0.43956043956043955
2631,Molla Wagué,MLI,DF,Nantes,Ligue 1,28,1991,7.6,15,12,11,4,0,7,7,100.0,0,10,8,2,15,30,42,0,0,2019-2020,1.973684210526316,1.973684210526316
2632,Moussa Wagué,SEN,DF,Barcelona,La Liga,20,1998,1.0,2,1,1,0,1,1,1,100.0,0,0,0,0,1,3,0,0,0,2019-2020,1.0,2.0
2633,Moussa Wagué,SEN,"DF,MF",Nice,Ligue 1,20,1998,2.2,6,4,3,3,0,2,3,66.7,1,2,1,1,2,8,2,0,0,2019-2020,0.9090909090909091,2.727272727272727
2634,Wakaso,GHA,MF,Alavés,La Liga,29,1990,14.3,54,31,25,24,5,16,33,48.5,17,23,5,18,17,71,17,1,0,2019-2020,1.1888111888111887,3.7762237762237763
2635,Walace,BRA,MF,Udinese,Serie A,24,1995,12.7,28,9,19,6,3,13,42,31.0,29,14,6,8,33,61,19,0,0,2019-2020,2.598425196850394,2.204724409448819
2636,Theo Walcott,ENG,"MF,FW",Everton,Premier League,30,1989,14.3,13,8,6,5,2,3,15,20.0,12,13,0,13,8,21,1,0,0,2019-2020,0.5594405594405594,0.9090909090909091
2637,Luca Waldschmidt,GER,"FW,MF",Freiburg,Bundesliga,23,1996,14.1,10,7,3,5,2,2,18,11.1,16,11,2,9,4,14,4,0,0,2019-2020,0.28368794326241137,0.7092198581560284
2638,Kyle Walker,ENG,DF,Manchester City,Premier League,29,1990,26.6,28,18,12,15,1,12,29,41.4,17,15,6,9,28,56,42,1,0,2019-2020,1.0526315789473684,1.0526315789473684
2639,Kyle Walker-Peters,ENG,DF,Southampton,Premier League,22,1997,7.8,13,8,5,6,2,6,16,37.5,10,10,3,7,14,27,21,1,0,2019-2020,1.794871794871795,1.6666666666666667
2640,Kyle Walker-Peters,ENG,DF,Tottenham,Premier League,22,1997,2.7,8,5,8,0,0,5,9,55.6,4,4,2,2,3,11,5,1,0,2019-2020,1.111111111111111,2.962962962962963
2641,Rémi Walter,FRA,MF,Nice,Ligue 1,24,1995,0.6,1,1,0,1,0,1,1,100.0,0,0,0,0,0,1,0,0,0,2019-2020,0.0,1.6666666666666667
2642,Sebastian Walukiewicz,POL,DF,Cagliari,Serie A,19,2000,12.9,25,11,17,8,0,14,22,63.6,8,21,14,7,14,39,41,0,0,2019-2020,1.0852713178294573,1.937984496124031
2643,Aaron Wan-Bissaka,ENG,DF,Manchester Utd,Premier League,21,1997,34.1,129,80,71,50,8,64,86,74.4,22,46,13,33,66,195,83,0,0,2019-2020,1.9354838709677418,3.782991202346041
2644,Victor Wanyama,KEN,MF,Tottenham,Premier League,28,1991,0.3,0,0,0,0,0,0,0,0.0,0,0,0,0,0,0,0,0,0,2019-2020,0.0,0.0
2645,Joel Ward,ENG,DF,Crystal Palace,Premier League,29,1989,26.5,69,42,48,16,5,39,56,69.6,17,13,6,7,48,117,93,1,0,2019-2020,1.8113207547169812,2.6037735849056602
2646,James Ward-Prowse,ENG,"MF,DF",Southampton,Premier League,24,1994,38.0,92,48,39,39,14,39,94,41.5,55,48,14,34,60,152,75,1,0,2019-2020,1.5789473684210527,2.4210526315789473
2647,Daniel Wass,DEN,"DF,MF",Valencia,La Liga,30,1989,30.4,44,25,25,13,6,25,57,43.9,32,22,5,17,31,75,91,1,0,2019-2020,1.0197368421052633,1.4473684210526316
2648,Kelland Watts,ENG,DF,Newcastle Utd,Premier League,19,1999,0.2,1,0,1,0,0,1,1,100.0,0,0,0,0,0,1,0,0,0,2019-2020,0.0,5.0
2649,Timothy Weah,USA,"MF,FW",Lille,Ligue 1,19,2000,0.9,0,0,0,0,0,0,1,0.0,1,0,0,0,0,0,1,0,0,2019-2020,0.0,0.0
2650,Adam Webster,ENG,DF,Brighton,Premier League,24,1995,29.6,30,17,21,8,1,14,32,43.8,18,43,26,17,45,75,110,2,0,2019-2020,1.5202702702702702,1.0135135135135134
Rk,Player,Nation,Pos,Squad,Comp,0,0,90.0,0,0,3,3,3,Tkl,0,0.0,0,0,0,0,0,0,0,0,0,2019-2020,0.0,0.0
2651,Wout Weghorst,NED,FW,Wolfsburg,Bundesliga,26,1992,30.4,15,8,4,5,6,1,17,5.9,16,17,4,13,2,17,30,0,0,2019-2020,0.06578947368421052,0.493421052631579
2652,Julian Weigl,GER,"MF,DF",Dortmund,Bundesliga,23,1995,11.3,16,9,12,3,1,9,16,56.3,7,10,0,10,8,24,21,0,0,2019-2020,0.7079646017699115,1.415929203539823
2653,Mitchell Weiser,GER,"DF,MF",Leverkusen,Bundesliga,25,1994,13.0,41,29,20,17,4,18,30,60.0,12,19,2,17,24,65,22,1,0,2019-2020,1.8461538461538463,3.1538461538461537
2654,Danny Welbeck,ENG,"FW,MF",Watford,Premier League,28,1990,9.1,14,6,6,5,3,3,11,27.3,8,12,1,11,5,19,7,0,0,2019-2020,0.5494505494505495,1.5384615384615385
2655,Wendell,BRA,"DF,MF",Leverkusen,Bundesliga,26,1993,21.1,64,42,26,26,12,41,66,62.1,25,30,4,26,36,100,36,0,0,2019-2020,1.7061611374407581,3.0331753554502368
2656,Oscar Wendt,SWE,DF,Gladbach,Bundesliga,33,1985,18.7,26,14,16,8,2,12,31,38.7,19,27,6,21,20,46,45,0,0,2019-2020,1.0695187165775402,1.3903743315508021
2657,Timo Werner,GER,FW,RB Leipzig,Bundesliga,23,1996,31.1,20,9,6,7,7,3,16,18.8,13,16,0,16,5,25,2,0,0,2019-2020,0.1607717041800643,0.6430868167202572
2658,Ashley Westwood,ENG,MF,Burnley,Premier League,29,1990,35.0,54,33,15,32,7,17,48,35.4,31,23,11,12,32,86,32,3,0,2019-2020,0.9142857142857143,1.542857142857143
2659,Connor Wickham,ENG,"FW,MF",Crystal Palace,Premier League,26,1993,1.1,1,1,1,0,0,0,0,0.0,0,1,0,1,1,2,0,0,0,2019-2020,0.9090909090909091,0.9090909090909091
2660,Felix Wiedwald,GER,GK,Eint Frankfurt,Bundesliga,29,1990,3.0,0,0,0,0,0,0,0,0.0,0,0,0,0,0,0,2,1,0,2019-2020,0.0,0.0
2661,Georginio Wijnaldum,NED,MF,Liverpool,Premier League,28,1990,32.6,38,20,12,21,5,10,40,25.0,30,18,4,14,17,55,34,3,0,2019-2020,0.5214723926380368,1.165644171779141
2662,Jetro Willems,NED,DF,Newcastle Utd,Premier League,25,1994,16.6,37,19,29,6,2,18,39,46.2,21,20,5,15,17,54,42,1,0,2019-2020,1.0240963855421685,2.228915662650602
2663,William,BRA,DF,Wolfsburg,Bundesliga,24,1995,15.2,55,26,34,14,7,27,59,45.8,32,10,3,7,24,79,38,1,0,2019-2020,1.5789473684210527,3.618421052631579
2664,Brandon Williams,ENG,DF,Manchester Utd,Premier League,18,2000,11.2,21,15,11,6,4,9,29,31.0,20,9,4,5,16,37,27,0,0,2019-2020,1.4285714285714286,1.8750000000000002
2665,Iñaki Williams,GHA,FW,Athletic Club,La Liga,25,1994,32.7,15,5,0,7,8,5,18,27.8,13,18,2,16,5,20,29,0,0,2019-2020,0.1529051987767584,0.4587155963302752
2666,Neco Williams,WAL,DF,Liverpool,Premier League,18,2001,2.6,5,3,1,3,1,4,5,80.0,1,3,1,2,9,14,6,0,0,2019-2020,3.4615384615384612,1.923076923076923
2667,Willian,BRA,"FW,MF",Chelsea,Premier League,30,1988,28.9,45,27,14,24,7,14,43,32.6,29,15,0,15,20,65,7,0,0,2019-2020,0.6920415224913495,1.5570934256055364
2668,Joe Willock,ENG,"MF,FW",Arsenal,Premier League,19,1999,9.5,25,16,9,12,4,8,21,38.1,13,16,2,14,4,29,11,2,0,2019-2020,0.42105263157894735,2.6315789473684212
2669,Jack Wilshere,ENG,MF,West Ham,Premier League,27,1992,2.4,1,0,1,0,0,0,4,0.0,4,3,0,3,1,2,0,0,0,2019-2020,0.4166666666666667,0.4166666666666667
2670,Callum Wilson,ENG,FW,Bournemouth,Premier League,27,1992,32.3,12,9,3,6,3,2,17,11.8,15,16,2,14,4,16,16,0,0,2019-2020,0.12383900928792571,0.3715170278637771
2671,Harry Wilson,WAL,"MF,FW",Bournemouth,Premier League,22,1997,18.3,23,13,8,10,5,11,34,32.4,23,26,2,24,11,34,15,1,0,2019-2020,0.6010928961748634,1.256830601092896
2672,Harry Winks,ENG,MF,Tottenham,Premier League,23,1996,24.7,40,24,18,20,2,17,54,31.5,37,27,8,19,36,76,32,1,0,2019-2020,1.45748987854251,1.6194331983805668
2673,Florian Wirtz,GER,FW,Leverkusen,Bundesliga,16,2003,4.1,4,2,0,4,0,2,4,50.0,2,4,0,4,2,6,1,0,0,2019-2020,0.48780487804878053,0.9756097560975611
2674,Axel Witsel,BEL,MF,Dortmund,Bundesliga,30,1989,24.9,28,20,10,17,1,14,33,42.4,19,26,7,19,31,59,19,1,0,2019-2020,1.244979919678715,1.1244979919678715
2675,Hannes Wolf,AUT,"FW,MF",RB Leipzig,Bundesliga,20,1999,0.6,3,0,0,1,2,1,4,25.0,3,0,0,0,0,3,0,0,0,2019-2020,0.0,5.0
Rk,Player,Nation,Pos,Squad,Comp,0,0,90.0,0,0,3,3,3,Tkl,0,0.0,0,0,0,0,0,0,0,0,0,2019-2020,0.0,0.0
2676,Marius Wolf,GER,"FW,MF",Hertha BSC,Bundesliga,24,1995,15.7,19,11,9,7,3,10,27,37.0,17,14,1,13,17,36,13,0,0,2019-2020,1.0828025477707006,1.2101910828025477
2677,Nick Woltemade,GER,"FW,MF",Werder Bremen,Bundesliga,17,2002,1.0,2,1,0,2,0,0,1,0.0,1,1,0,1,0,2,2,0,0,2019-2020,0.0,2.0
2678,Chris Wood,NZL,FW,Burnley,Premier League,27,1991,27.1,7,4,2,4,1,5,15,33.3,10,15,2,13,4,11,18,0,0,2019-2020,0.14760147601476015,0.25830258302583026
2679,Xeka,POR,MF,Lille,Ligue 1,24,1994,7.9,18,10,3,13,2,9,29,31.0,20,11,1,10,4,22,7,1,0,2019-2020,0.5063291139240506,2.2784810126582276
2680,Granit Xhaka,SUI,MF,Arsenal,Premier League,26,1992,28.7,45,25,20,19,6,25,55,45.5,30,32,16,16,21,66,59,3,0,2019-2020,0.7317073170731707,1.5679442508710801
2681,Jawad El Yamiq,MAR,DF,Genoa,Serie A,27,1992,2.2,3,2,3,0,0,1,4,25.0,3,3,2,1,1,4,3,0,0,2019-2020,0.45454545454545453,1.3636363636363635
2682,Andriy Yarmolenko,UKR,"MF,FW",West Ham,Premier League,29,1989,11.0,13,8,5,6,2,5,20,25.0,15,3,1,2,6,19,4,0,0,2019-2020,0.5454545454545454,1.1818181818181819
2683,Yusuf Yazıcı,TUR,"MF,FW",Lille,Ligue 1,22,1997,9.4,17,8,2,11,4,5,13,38.5,8,6,1,5,5,22,1,1,0,2019-2020,0.5319148936170213,1.8085106382978722
2684,DeAndre Yedlin,USA,DF,Newcastle Utd,Premier League,26,1993,10.4,18,13,10,6,2,8,16,50.0,8,13,7,6,10,28,20,0,0,2019-2020,0.9615384615384615,1.7307692307692306
2685,Yoel,ESP,GK,Eibar,La Liga,30,1988,3.0,0,0,0,0,0,0,0,0.0,0,0,0,0,1,1,1,0,0,2019-2020,0.3333333333333333,0.0
2686,Okay Yokuşlu,TUR,MF,Celta Vigo,La Liga,25,1994,21.9,41,27,18,21,2,20,42,47.6,22,12,5,7,28,69,71,1,0,2019-2020,1.2785388127853883,1.8721461187214614
2687,Maya Yoshida,JPN,DF,Southampton,Premier League,30,1988,6.2,8,5,4,1,3,3,7,42.9,4,6,2,4,4,12,27,1,0,2019-2020,0.6451612903225806,1.2903225806451613
2688,Maya Yoshida,JPN,DF,Sampdoria,Serie A,30,1988,13.2,4,3,2,2,0,2,6,33.3,4,15,12,3,27,31,72,0,0,2019-2020,2.0454545454545454,0.30303030303030304
2689,Elie Youan,FRA,"FW,MF",Nantes,Ligue 1,20,1999,1.8,0,0,0,0,0,0,7,0.0,7,2,0,2,0,0,3,0,0,2019-2020,0.0,0.0
2690,Amin Younes,GER,"FW,MF",Napoli,Serie A,25,1993,2.0,3,2,1,2,0,2,4,50.0,2,2,0,2,0,3,1,0,0,2019-2020,0.0,1.5
2691,Ashley Young,ENG,DF,Manchester Utd,Premier League,34,1985,10.6,14,7,7,4,3,5,17,29.4,12,8,2,6,11,25,29,0,0,2019-2020,1.0377358490566038,1.3207547169811322
2692,Ashley Young,ENG,DF,Inter,Serie A,34,1985,13.2,11,5,3,5,3,6,19,31.6,13,11,3,8,14,25,24,0,0,2019-2020,1.0606060606060606,0.8333333333333334
2693,Zaydou Youssouf,FRA,MF,Saint-Étienne,Ligue 1,20,1999,12.0,40,22,12,26,2,15,35,42.9,20,7,1,6,16,56,13,0,0,2019-2020,1.3333333333333333,3.3333333333333335
2694,Pablo Zabaleta,ARG,DF,West Ham,Premier League,34,1985,6.6,18,10,12,5,1,6,13,46.2,7,5,3,2,14,32,21,0,0,2019-2020,2.121212121212121,2.7272727272727275
2695,Mattia Zaccagni,ITA,"MF,FW",Hellas Verona,Serie A,24,1995,23.5,20,11,10,5,5,3,15,20.0,12,14,3,11,20,40,21,0,0,2019-2020,0.851063829787234,0.851063829787234
2696,Dan-Axel Zagadou,FRA,DF,Dortmund,Bundesliga,20,1999,10.9,16,10,12,4,0,6,8,75.0,2,12,8,4,15,31,38,0,0,2019-2020,1.3761467889908257,1.4678899082568806
2697,Arthur Zagre,FRA,MF,Paris S-G,Ligue 1,17,2001,0.3,1,0,1,0,0,0,0,0.0,0,1,0,1,1,2,0,0,0,2019-2020,3.3333333333333335,3.3333333333333335
2698,Wilfried Zaha,CIV,"FW,MF",Crystal Palace,Premier League,26,1992,36.4,43,19,18,12,13,12,49,24.5,37,22,2,20,18,61,4,0,0,2019-2020,0.4945054945054945,1.1813186813186813
2699,Denis Zakaria,SUI,"MF,DF",Gladbach,Bundesliga,22,1996,21.6,49,30,23,23,3,20,39,51.3,19,39,12,27,37,86,31,1,0,2019-2020,1.7129629629629628,2.268518518518518
2700,Joseba Zaldúa,ESP,DF,Real Sociedad,La Liga,27,1992,28.3,62,43,39,18,5,31,59,52.5,28,31,7,24,37,99,71,0,0,2019-2020,1.3074204946996466,2.1908127208480566
Rk,Player,Nation,Pos,Squad,Comp,0,0,90.0,0,0,3,3,3,Tkl,0,0.0,0,0,0,0,0,0,0,0,0,2019-2020,0.0,0.0
2701,Andre-Frank Zambo Anguissa,CMR,MF,Villarreal,La Liga,23,1995,28.7,76,49,29,40,7,26,78,33.3,52,42,6,36,44,120,30,0,0,2019-2020,1.5331010452961673,2.64808362369338
2702,Luca Zanimacchia,ITA,"FW,MF",Juventus,Serie A,21,1998,1.3,5,1,1,2,2,1,2,50.0,1,1,0,1,0,5,0,0,0,2019-2020,0.0,3.846153846153846
2703,Nicolò Zaniolo,ITA,"FW,MF",Roma,Serie A,20,1999,16.7,15,11,4,7,4,3,24,12.5,21,14,0,14,5,20,5,0,0,2019-2020,0.29940119760479045,0.8982035928143713
2704,Cristián Zapata,COL,DF,Genoa,Serie A,32,1986,19.1,23,17,16,7,0,8,16,50.0,8,29,17,12,24,47,75,0,0,2019-2020,1.256544502617801,1.2041884816753925
2705,Duván Zapata,COL,FW,Atalanta,Serie A,28,1991,22.5,7,3,1,2,4,1,6,16.7,5,18,7,11,2,9,11,0,0,2019-2020,0.08888888888888889,0.3111111111111111
2706,Davide Zappacosta,ITA,DF,Roma,Serie A,27,1992,5.0,7,3,2,3,2,4,8,50.0,4,3,1,2,6,13,8,1,0,2019-2020,1.2,1.4
2707,Simone Zaza,ITA,FW,Torino,Serie A,28,1991,18.2,15,10,6,4,5,3,10,30.0,7,11,0,11,9,24,13,1,0,2019-2020,0.4945054945054945,0.8241758241758242
2708,Marvin Zeegelaar,NED,DF,Udinese,Serie A,28,1990,6.6,15,9,8,4,3,6,11,54.5,5,9,2,7,5,20,10,0,0,2019-2020,0.7575757575757576,2.272727272727273
2709,Mootaz Zemzemi,TUN,MF,Strasbourg,Ligue 1,19,1999,0.3,0,0,0,0,0,0,0,0.0,0,0,0,0,1,1,0,0,0,2019-2020,3.3333333333333335,0.0
2710,Arber Zeneli,KVX,MF,Reims,Ligue 1,24,1995,0.1,0,0,0,0,0,0,0,0.0,0,0,0,0,0,0,0,0,0,2019-2020,0.0,0.0
2711,Robin Zentner,GER,GK,Mainz 05,Bundesliga,24,1994,21.5,1,1,1,0,0,1,1,100.0,0,0,0,0,0,1,11,0,0,2019-2020,0.0,0.046511627906976744
2712,Piotr Zieliński,POL,MF,Napoli,Serie A,25,1994,32.5,26,16,10,11,5,12,30,40.0,18,28,5,23,21,47,15,0,0,2019-2020,0.6461538461538462,0.8
2713,Jean Zimmer,GER,"DF,FW",Düsseldorf,Bundesliga,25,1993,8.0,11,6,5,5,1,5,10,50.0,5,3,1,2,3,14,0,0,0,2019-2020,0.375,1.375
2714,Christoph Zimmermann,GER,DF,Norwich City,Premier League,26,1993,15.9,32,21,26,6,0,21,30,70.0,9,22,18,4,19,51,87,2,0,2019-2020,1.1949685534591195,2.0125786163522013
2715,Matthias Zimmermann,GER,"DF,MF",Düsseldorf,Bundesliga,27,1992,32.5,62,47,26,27,9,31,64,48.4,33,41,15,26,43,105,59,0,0,2019-2020,1.323076923076923,1.9076923076923078
2716,Oleksandr Zinchenko,UKR,DF,Manchester City,Premier League,22,1996,14.2,31,19,16,11,4,17,32,53.1,15,9,0,9,17,48,21,1,0,2019-2020,1.1971830985915493,2.183098591549296
2717,Leopold Zingerle,GER,GK,Paderborn 07,Bundesliga,25,1994,28.0,3,1,3,0,0,2,4,50.0,2,0,0,0,0,3,7,2,0,2019-2020,0.0,0.10714285714285714
2718,Joshua Zirkzee,NED,FW,Bayern Munich,Bundesliga,18,2001,3.3,5,2,0,2,3,2,4,50.0,2,2,0,2,1,6,0,0,0,2019-2020,0.30303030303030304,1.5151515151515151
2719,Richairo Živković,CUW,FW,Sheffield Utd,Premier League,22,1996,1.2,2,2,0,2,0,1,2,50.0,1,1,0,1,0,2,0,0,0,2019-2020,0.0,1.6666666666666667
2720,Jaromír Zmrhal,CZE,MF,Brescia,Serie A,25,1993,12.5,10,4,2,5,3,5,18,27.8,13,8,1,7,4,14,11,0,0,2019-2020,0.32,0.8
2721,Kévin Zohi,MLI,"FW,MF",Strasbourg,Ligue 1,22,1996,5.9,8,6,3,3,2,3,6,50.0,3,1,0,1,4,12,2,0,0,2019-2020,0.6779661016949152,1.3559322033898304
2722,Ben Zolinski,GER,"FW,MF",Paderborn 07,Bundesliga,27,1992,13.4,17,9,7,9,1,7,27,25.9,20,12,0,12,8,25,4,0,0,2019-2020,0.5970149253731343,1.2686567164179103
2723,Kurt Zouma,FRA,DF,Chelsea,Premier League,24,1994,26.0,23,14,17,6,0,9,16,56.3,7,22,14,8,58,81,116,2,0,2019-2020,2.230769230769231,0.8846153846153846
2724,Igor Zubeldia,ESP,"MF,DF",Real Sociedad,La Liga,22,1997,29.3,42,21,18,19,5,17,35,48.6,18,38,21,17,26,68,82,2,0,2019-2020,0.8873720136518771,1.4334470989761092
2725,Steven Zuber,SUI,"DF,FW",Hoffenheim,Bundesliga,27,1991,8.3,11,10,7,2,2,9,19,47.4,10,4,1,3,9,20,12,0,0,2019-2020,1.0843373493975903,1.325301204819277
Rk,Player,Nation,Pos,Squad,Comp,0,0,90.0,0,0,3,3,3,Tkl,0,0.0,0,0,0,0,0,0,0,0,0,2019-2020,0.0,0.0
2726,Martín Zubimendi,ESP,MF,Real Sociedad,La Liga,20,1999,5.8,16,12,9,7,0,6,12,50.0,6,7,0,7,9,25,2,0,0,2019-2020,1.5517241379310345,2.7586206896551726
2727,Ervin Zukanović,BIH,DF,SPAL,Serie A,32,1987,2.3,1,0,0,0,1,1,1,100.0,0,3,1,2,3,4,15,0,0,2019-2020,1.3043478260869565,0.4347826086956522
2728,Bongani Zungu,RSA,MF,Amiens,Ligue 1,26,1992,11.0,27,11,10,13,4,18,31,58.1,13,8,2,6,16,43,21,0,0,2019-2020,1.4545454545454546,2.4545454545454546
2729,Szymon Żurkowski,POL,MF,Fiorentina,Serie A,21,1997,0.1,1,0,0,0,1,0,2,0.0,2,0,0,0,0,1,1,0,0,2019-2020,0.0,10.0
2730,David Zurutuza,ESP,MF,Real Sociedad,La Liga,33,1986,1.7,4,3,0,3,1,1,2,50.0,1,1,0,1,4,8,3,0,0,2019-2020,2.3529411764705883,2.3529411764705883
2731,Martin Ødegaard,NOR,MF,Real Sociedad,La Liga,20,1998,28.1,27,19,5,14,8,7,34,20.6,27,13,0,13,17,44,5,0,0,2019-2020,0.6049822064056939,0.9608540925266903
2732,Filip Đuričić,SRB,"MF,FW",Sassuolo,Serie A,27,1992,18.1,23,14,2,10,11,3,19,15.8,16,20,3,17,8,31,14,0,0,2019-2020,0.4419889502762431,1.2707182320441988
1,Ismael Aaneba,FRA,DF,Strasbourg,Ligue 1,21,1999,0.1,0,0,0,0,0,0,0,0.0,0,0,0,0,1,1,1,0,0,2020-2021,10.0,0.0
2,Patrick van Aanholt,NED,DF,Crystal Palace,Premier League,29,1990,19.7,35,22,18,17,0,19,43,44.2,24,18,6,12,30,65,40,2,0,2020-2021,1.5228426395939088,1.7766497461928934
3,Yunis Abdelhamid,MAR,DF,Reims,Ligue 1,32,1987,32.1,59,37,36,23,0,26,42,61.9,16,34,15,19,61,120,132,0,0,2020-2021,1.9003115264797508,1.838006230529595
4,Sabit Abdulai,GHA,MF,Getafe,La Liga,21,1999,0.7,2,0,1,1,0,1,3,33.3,2,0,0,0,0,2,0,0,0,2020-2021,0.0,2.857142857142857
5,Mehdi Abeid,ALG,MF,Nantes,Ligue 1,27,1992,14.7,34,19,16,14,4,15,30,50.0,15,9,2,7,20,54,10,0,0,2020-2021,1.3605442176870748,2.312925170068027
6,Laurent Abergel,FRA,MF,Lorient,Ligue 1,27,1993,32.9,145,84,64,69,12,54,162,33.3,108,64,6,58,46,191,12,0,0,2020-2021,1.3981762917933132,4.407294832826748
7,Charles Abi,FRA,"FW,MF",Saint-Étienne,Ligue 1,20,2000,10.1,8,2,5,0,3,3,12,25.0,9,6,2,4,4,12,5,0,0,2020-2021,0.39603960396039606,0.7920792079207921
8,Matthis Abline,FRA,FW,Rennes,Ligue 1,17,2003,0.0,0,0,0,0,0,0,0,0.0,0,0,0,0,0,0,0,0,0,2020-2021,,
9,Pape Abou Cissé,SEN,DF,Saint-Étienne,Ligue 1,24,1995,14.0,15,13,10,5,0,6,10,60.0,4,7,4,3,27,42,87,0,0,2020-2021,1.9285714285714286,1.0714285714285714
10,David Abraham,ARG,DF,Eint Frankfurt,Bundesliga,34,1986,13.6,18,12,13,3,2,11,17,64.7,6,13,4,9,17,35,34,0,0,2020-2021,1.25,1.3235294117647058
11,Tammy Abraham,ENG,FW,Chelsea,Premier League,22,1997,11.6,7,5,3,3,1,1,7,14.3,6,6,0,6,5,12,17,0,0,2020-2021,0.4310344827586207,0.603448275862069
12,Amir Abrashi,ALB,"MF,DF",Freiburg,Bundesliga,30,1990,0.7,1,1,1,0,0,0,0,0.0,0,1,1,0,2,3,1,0,0,2020-2021,2.857142857142857,1.4285714285714286
13,Gennaro Acampora,ITA,"MF,FW",Spezia,Serie A,26,1994,4.9,6,4,1,4,1,2,7,28.6,5,4,1,3,4,10,4,0,0,2020-2021,0.8163265306122448,1.2244897959183672
14,Francesco Acerbi,ITA,DF,Lazio,Serie A,32,1988,31.3,51,32,34,13,4,18,40,45.0,22,24,15,9,76,127,121,2,0,2020-2021,2.428115015974441,1.6293929712460065
15,Ragnar Ache,GER,"FW,DF",Eint Frankfurt,Bundesliga,22,1998,1.1,2,0,0,1,1,0,0,0.0,0,1,0,1,1,3,1,0,0,2020-2021,0.9090909090909091,1.8181818181818181
16,Marcos Acuña,ARG,DF,Sevilla,La Liga,28,1991,25.9,62,42,34,20,8,23,41,56.1,18,23,2,21,23,85,30,1,0,2020-2021,0.888030888030888,2.393822393822394
17,Che Adams,SCO,FW,Southampton,Premier League,24,1996,29.6,25,16,4,15,6,6,17,35.3,11,20,2,18,4,29,19,1,0,2020-2021,0.13513513513513511,0.8445945945945945
18,Tyler Adams,USA,"MF,DF",RB Leipzig,Bundesliga,21,1999,20.6,35,24,12,15,8,17,31,54.8,14,22,5,17,29,64,30,0,0,2020-2021,1.407766990291262,1.6990291262135921
19,Sargis Adamyan,ARM,"FW,MF",Hoffenheim,Bundesliga,27,1993,5.3,9,4,4,3,2,7,14,50.0,7,2,0,2,6,15,1,0,0,2020-2021,1.1320754716981132,1.6981132075471699
20,Tosin Adarabioyo,ENG,DF,Fulham,Premier League,22,1997,32.8,37,19,30,6,1,19,40,47.5,21,26,20,6,42,79,197,2,0,2020-2021,1.2804878048780488,1.128048780487805
21,Bobby Adekanye,NED,"FW,MF",Cádiz,La Liga,21,1999,0.4,0,0,0,0,0,0,1,0.0,1,0,0,0,0,0,1,0,0,2020-2021,0.0,0.0
22,Yacine Adli,FRA,MF,Bordeaux,Ligue 1,20,2000,26.9,74,37,30,33,11,35,92,38.0,57,27,2,25,39,113,17,2,0,2020-2021,1.449814126394052,2.7509293680297398
23,Andrea Adorante,ITA,FW,Parma,Serie A,20,2000,0.1,0,0,0,0,0,0,0,0.0,0,0,0,0,0,0,0,0,0,2020-2021,0.0,0.0
24,Adrián,ESP,GK,Liverpool,Premier League,33,1987,3.0,0,0,0,0,0,0,0,0.0,0,0,0,0,0,0,3,1,0,2020-2021,0.0,0.0
25,Martin Agirregabiria,ESP,"DF,MF",Alavés,La Liga,24,1996,17.3,32,18,17,12,3,17,33,51.5,16,9,3,6,27,59,36,0,0,2020-2021,1.560693641618497,1.8497109826589595
Rk,Player,Nation,Pos,Squad,Comp,0,0,90.0,0,0,3,3,3,Tkl,0,0.0,0,0,0,0,0,0,0,0,0,2020-2021,0.0,0.0
26,Lucien Agoume,FRA,MF,Spezia,Serie A,18,2002,8.9,18,10,11,7,0,6,19,31.6,13,10,5,5,15,33,10,0,0,2020-2021,1.6853932584269662,2.0224719101123596
27,Felix Agu,GER,DF,Werder Bremen,Bundesliga,20,1999,7.8,20,9,10,9,1,10,18,55.6,8,14,3,11,12,32,18,0,0,2020-2021,1.5384615384615385,2.5641025641025643
28,Kevin Agudelo,COL,FW,Spezia,Serie A,21,1998,15.1,39,28,9,15,15,12,34,35.3,22,30,0,30,10,49,2,0,0,2020-2021,0.6622516556291391,2.5827814569536423
29,Nayef Aguerd,MAR,DF,Rennes,Ligue 1,24,1996,35.0,37,30,28,9,0,21,33,63.6,12,34,22,12,47,84,102,0,0,2020-2021,1.3428571428571427,1.0571428571428572
30,Sergio Agüero,ARG,FW,Manchester City,Premier League,32,1988,6.2,4,1,0,2,2,2,11,18.2,9,2,0,2,2,6,0,0,0,2020-2021,0.3225806451612903,0.6451612903225806
31,Ruben Aguilar,FRA,"DF,MF",Monaco,Ligue 1,27,1993,24.7,63,37,32,21,10,32,52,61.5,20,30,3,27,47,110,43,1,0,2020-2021,1.902834008097166,2.5506072874493926
32,Naouirou Ahamada,FRA,MF,Stuttgart,Bundesliga,18,2002,2.8,4,1,3,1,0,1,1,100.0,0,2,0,2,1,5,1,0,0,2020-2021,0.35714285714285715,1.4285714285714286
33,Matteo Ahlinvi,BEN,MF,Nîmes,Ligue 1,21,1999,10.0,26,20,10,14,2,11,39,28.2,28,6,0,6,2,28,8,0,0,2020-2021,0.2,2.6
34,Jean-Eudes Aholou,CIV,MF,Strasbourg,Ligue 1,26,1994,23.8,46,25,18,25,3,19,48,39.6,29,17,5,12,53,99,32,0,0,2020-2021,2.226890756302521,1.9327731092436975
35,Jean-Eudes Aholou,CIV,MF,Monaco,Ligue 1,26,1994,0.4,1,0,0,1,0,1,3,33.3,2,0,0,0,1,2,1,0,0,2020-2021,2.5,2.5
36,Joseph Aidoo,GHA,DF,Celta Vigo,La Liga,24,1995,14.3,26,17,17,9,0,12,21,57.1,9,7,4,3,25,51,88,1,0,2020-2021,1.7482517482517481,1.8181818181818181
37,Ola Aina,NGA,DF,Fulham,Premier League,23,1996,29.6,37,20,22,7,8,21,43,48.8,22,22,6,16,45,82,94,2,0,2020-2021,1.5202702702702702,1.25
38,Rayan Aït-Nouri,ALG,DF,Wolves,Premier League,19,2001,15.6,29,16,18,10,1,13,27,48.1,14,14,1,13,15,44,25,0,0,2020-2021,0.9615384615384616,1.858974358974359
39,Rayan Aït-Nouri,ALG,DF,Angers,Ligue 1,19,2001,2.1,3,2,1,2,0,3,5,60.0,2,2,1,1,4,7,1,0,0,2020-2021,1.9047619047619047,1.4285714285714286
40,Semi Ajayi,NGA,DF,West Brom,Premier League,26,1993,30.9,40,14,34,6,0,23,41,56.1,18,51,32,19,42,82,122,2,0,2020-2021,1.3592233009708738,1.2944983818770228
41,Ludovic Ajorque,FRA,FW,Strasbourg,Ligue 1,26,1994,33.0,30,18,6,18,6,7,31,22.6,24,14,5,9,11,41,54,0,0,2020-2021,0.3333333333333333,0.9090909090909091
42,Manuel Akanji,SUI,DF,Dortmund,Bundesliga,25,1995,26.1,41,22,23,12,6,19,31,61.3,12,23,10,13,49,90,70,1,0,2020-2021,1.8773946360153255,1.5708812260536398
43,Carlos Akapo,EQG,DF,Cádiz,La Liga,27,1993,9.6,18,14,14,4,0,10,18,55.6,8,16,3,13,19,37,33,0,0,2020-2021,1.9791666666666667,1.875
44,Marley Aké,FRA,FW,Marseille,Ligue 1,19,2001,1.6,3,3,1,0,2,0,1,0.0,1,2,0,2,0,3,1,0,0,2020-2021,0.0,1.875
45,Nathan Aké,NED,DF,Manchester City,Premier League,25,1995,8.9,10,5,3,6,1,3,4,75.0,1,2,1,1,9,19,23,0,0,2020-2021,1.0112359550561798,1.1235955056179774
46,Paul Akouokou,CIV,MF,Betis,La Liga,22,1997,4.2,11,8,2,8,1,5,8,62.5,3,3,1,2,6,17,7,0,0,2020-2021,1.4285714285714286,2.619047619047619
47,Jean-Daniel Akpa-Akpro,CIV,MF,Lazio,Serie A,27,1992,11.7,38,25,13,22,3,8,27,29.6,19,24,6,18,18,56,13,0,0,2020-2021,1.5384615384615385,3.247863247863248
48,Kevin Akpoguma,NGA,DF,Hoffenheim,Bundesliga,25,1995,13.2,18,12,11,6,1,8,14,57.1,6,28,15,13,13,31,32,2,0,2020-2021,0.9848484848484849,1.3636363636363638
49,David Alaba,AUT,"DF,MF",Bayern Munich,Bundesliga,28,1992,29.7,37,21,14,19,4,17,32,53.1,15,29,13,16,43,80,60,0,0,2020-2021,1.4478114478114479,1.245791245791246
50,Sofiane Alakouch,MAR,DF,Nîmes,Ligue 1,22,1998,16.7,53,33,30,16,7,29,45,64.4,16,17,2,15,21,74,38,0,0,2020-2021,1.25748502994012,3.1736526946107784
Rk,Player,Nation,Pos,Squad,Comp,0,0,90.0,0,0,3,3,3,Tkl,0,0.0,0,0,0,0,0,0,0,0,0,2020-2021,0.0,0.0
51,Jony Álamo,ESP,MF,Elche,La Liga,18,2001,0.8,2,1,1,0,1,0,1,0.0,1,0,0,0,1,3,0,0,0,2020-2021,1.25,2.5
52,Lucas Alario,ARG,FW,Leverkusen,Bundesliga,27,1992,13.8,8,2,2,5,1,2,4,50.0,2,9,1,8,2,10,10,0,0,2020-2021,0.14492753623188406,0.5797101449275363
53,Jordi Alba,ESP,"DF,FW",Barcelona,La Liga,31,1989,33.6,45,30,22,16,7,24,52,46.2,28,21,2,19,49,94,48,0,0,2020-2021,1.4583333333333333,1.3392857142857142
54,Luis Alberto,ESP,MF,Lazio,Serie A,27,1992,29.1,43,24,15,19,9,15,73,20.5,58,41,2,39,13,56,11,1,0,2020-2021,0.4467353951890034,1.4776632302405497
55,Raúl Albiol,ESP,DF,Villarreal,La Liga,34,1985,34.6,22,15,19,3,0,13,18,72.2,5,32,22,10,22,44,146,2,0,2020-2021,0.6358381502890174,0.6358381502890174
56,Marc Albrighton,ENG,"DF,FW",Leicester City,Premier League,30,1989,19.4,33,19,14,15,4,16,45,35.6,29,29,3,26,17,50,27,1,0,2020-2021,0.8762886597938145,1.7010309278350517
57,Paco Alcácer,ESP,FW,Villarreal,La Liga,26,1993,17.2,6,3,1,2,3,3,7,42.9,4,8,0,8,9,15,6,0,0,2020-2021,0.5232558139534884,0.3488372093023256
58,Pedro Alcalá,ESP,DF,Cádiz,La Liga,31,1989,10.1,8,4,6,2,0,3,5,60.0,2,19,13,6,16,24,50,0,0,2020-2021,1.5841584158415842,0.7920792079207921
59,Thiago Alcántara,ESP,MF,Liverpool,Premier League,29,1991,20.6,61,36,20,30,11,17,49,34.7,32,26,0,26,30,91,14,0,0,2020-2021,1.4563106796116503,2.9611650485436893
60,Rubén Alcaraz,ESP,MF,Valladolid,La Liga,29,1991,24.1,54,29,32,21,1,30,80,37.5,50,35,8,27,31,85,28,0,0,2020-2021,1.2863070539419086,2.240663900414938
61,Omar Alderete,PAR,DF,Hertha BSC,Bundesliga,23,1996,14.4,16,10,11,5,0,7,16,43.8,9,14,10,4,21,37,61,1,0,2020-2021,1.4583333333333333,1.1111111111111112
62,Toby Alderweireld,BEL,DF,Tottenham,Premier League,31,1989,24.9,35,22,22,11,2,18,30,60.0,12,40,28,12,10,45,121,0,0,2020-2021,0.40160642570281124,1.4056224899598395
63,Iván Alejo,ESP,"MF,FW",Cádiz,La Liga,25,1995,9.2,14,10,8,4,2,4,23,17.4,19,14,1,13,3,17,10,0,0,2020-2021,0.32608695652173914,1.5217391304347827
64,Carles Aleñá,ESP,MF,Barcelona,La Liga,22,1998,0.5,1,0,1,0,0,0,0,0.0,0,0,0,0,0,1,0,0,0,2020-2021,0.0,2.0
65,Carles Aleñá,ESP,"MF,FW",Getafe,La Liga,22,1998,15.2,15,10,3,9,3,7,25,28.0,18,14,1,13,2,17,2,0,0,2020-2021,0.13157894736842105,0.986842105263158
66,Rúnar Alex Rúnarsson,ISL,GK,Arsenal,Premier League,25,1995,0.2,0,0,0,0,0,0,0,0.0,0,0,0,0,0,0,0,0,0,2020-2021,0.0,0.0
67,Trent Alexander-Arnold,ENG,DF,Liverpool,Premier League,21,1998,33.7,56,33,31,18,7,36,56,64.3,20,24,3,21,49,105,50,3,0,2020-2021,1.4540059347181007,1.661721068249258
68,Alfon,ESP,MF,Celta Vigo,La Liga,21,1999,0.4,0,0,0,0,0,0,0,0.0,0,0,0,0,0,0,0,0,0,2020-2021,0.0,0.0
69,Mohamed Ali Cho,FRA,"FW,MF",Angers,Ligue 1,16,2004,3.9,9,7,2,6,1,4,9,44.4,5,4,0,4,3,12,0,0,0,2020-2021,0.7692307692307693,2.307692307692308
70,Ezgjan Alioski,MKD,"DF,MF",Leeds United,Premier League,28,1992,27.3,74,31,38,28,8,32,74,43.2,42,17,2,15,23,97,50,2,0,2020-2021,0.8424908424908425,2.7106227106227108
71,Rachid Alioui,MAR,FW,Angers,Ligue 1,28,1992,0.2,0,0,0,0,0,0,1,0.0,1,0,0,0,0,0,0,0,0,2020-2021,0.0,0.0
72,Alisson,BRA,GK,Liverpool,Premier League,27,1992,33.0,3,2,3,0,0,3,4,75.0,1,0,0,0,2,5,26,7,0,2020-2021,0.06060606060606061,0.09090909090909091
73,Saturnin Allagbé,BEN,GK,Dijon,Ligue 1,26,1993,12.0,0,0,0,0,0,0,1,0.0,1,0,0,0,0,0,9,3,0,2020-2021,0.0,0.0
74,Allan,BRA,MF,Everton,Premier League,29,1991,22.8,80,45,39,37,4,28,95,29.5,67,31,12,19,19,99,25,1,0,2020-2021,0.8333333333333333,3.508771929824561
75,Dele Alli,ENG,MF,Tottenham,Premier League,24,1996,6.9,18,11,8,6,4,7,19,36.8,12,9,0,9,7,25,3,0,0,2020-2021,1.0144927536231882,2.608695652173913
Rk,Player,Nation,Pos,Squad,Comp,0,0,90.0,0,0,3,3,3,Tkl,0,0.0,0,0,0,0,0,0,0,0,0,2020-2021,0.0,0.0
76,Miguel Almirón,PAR,"MF,FW",Newcastle Utd,Premier League,26,1994,27.0,49,29,21,25,3,14,56,25.0,42,23,4,19,25,74,20,1,0,2020-2021,0.9259259259259259,1.8148148148148149
77,Marcos Alonso,ESP,DF,Chelsea,Premier League,29,1990,10.7,13,3,6,4,3,7,14,50.0,7,12,1,11,12,25,30,0,0,2020-2021,1.1214953271028039,1.2149532710280375
78,Sergio Álvarez,ESP,"MF,DF",Eibar,La Liga,28,1992,17.4,42,25,13,26,3,8,22,36.4,14,22,5,17,22,64,24,2,0,2020-2021,1.264367816091954,2.4137931034482762
79,Yeray Álvarez,ESP,DF,Athletic Club,La Liga,25,1995,21.6,19,12,11,8,0,9,21,42.9,12,12,5,7,53,72,73,0,0,2020-2021,2.4537037037037037,0.8796296296296295
80,Bruno Alves,POR,DF,Parma,Serie A,38,1981,18.1,13,10,10,3,0,7,9,77.8,2,17,12,5,26,39,81,0,0,2020-2021,1.43646408839779,0.718232044198895
81,Steven Alzate,COL,MF,Brighton,Premier League,21,1998,10.0,17,8,10,4,3,6,15,40.0,9,8,1,7,8,25,10,0,0,2020-2021,0.8,1.7
82,Ibrahim Amadou,FRA,MF,Angers,Ligue 1,27,1993,16.7,39,26,18,19,2,15,38,39.5,23,14,4,10,23,62,25,0,0,2020-2021,1.377245508982036,2.3353293413173652
83,Romain Amalfitano,FRA,"FW,DF",Dijon,Ligue 1,30,1989,1.3,4,2,3,1,0,1,3,33.3,2,2,1,1,1,5,1,0,0,2020-2021,0.7692307692307692,3.0769230769230766
84,Emmanuel Amankwaa Akurugu,GHA,DF,Getafe,La Liga,18,2001,0.5,0,0,0,0,0,0,1,0.0,1,1,0,1,2,2,1,0,0,2020-2021,4.0,0.0
85,Daniel Amartey,GHA,DF,Leicester City,Premier League,25,1994,8.0,11,7,6,4,1,8,12,66.7,4,8,4,4,12,23,26,0,0,2020-2021,1.5,1.375
86,Jordan Amavi,FRA,DF,Marseille,Ligue 1,26,1994,9.0,11,9,9,1,1,9,12,75.0,3,12,2,10,27,38,33,1,0,2020-2021,3.0,1.2222222222222223
87,Thierry Ambrose,GLP,FW,Metz,Ligue 1,23,1997,8.4,7,4,1,1,5,2,12,16.7,10,2,0,2,2,9,4,0,0,2020-2021,0.23809523809523808,0.8333333333333333
88,Wisdom Amey,ITA,DF,Bologna,Serie A,14,2005,0.0,0,0,0,0,0,0,0,0.0,0,0,0,0,0,0,0,0,0,2020-2021,,
89,Nadiem Amiri,GER,MF,Leverkusen,Bundesliga,23,1996,21.0,12,7,4,8,0,7,33,21.2,26,18,3,15,12,24,7,0,0,2020-2021,0.5714285714285714,0.5714285714285714
90,Ethan Ampadu,WAL,"DF,MF",Sheffield Utd,Premier League,19,2000,23.2,57,36,31,24,2,20,46,43.5,26,40,19,21,49,106,87,3,0,2020-2021,2.1120689655172415,2.456896551724138
91,Sofyan Amrabat,MAR,MF,Fiorentina,Serie A,23,1996,27.1,39,22,11,24,4,18,48,37.5,30,30,5,25,23,62,12,0,0,2020-2021,0.8487084870848708,1.4391143911439113
92,Jon Ander Garrido,ESP,MF,Cádiz,La Liga,30,1989,8.9,18,10,8,7,3,10,26,38.5,16,12,4,8,14,32,13,0,0,2020-2021,1.5730337078651684,2.0224719101123596
93,Joachim Andersen,DEN,DF,Fulham,Premier League,24,1996,30.3,33,19,18,11,4,15,28,53.6,13,24,13,11,44,77,151,1,0,2020-2021,1.4521452145214522,1.0891089108910892
94,Joachim Andersen,DEN,DF,Lyon,Ligue 1,24,1996,2.1,2,1,1,1,0,2,2,100.0,0,1,1,0,2,4,6,0,0,2020-2021,0.9523809523809523,0.9523809523809523
95,Djavan Anderson,NED,DF,Lazio,Serie A,25,1995,0.8,0,0,0,0,0,0,1,0.0,1,1,0,1,1,1,0,0,0,2020-2021,1.25,0.0
96,Elliot Anderson,SCO,MF,Newcastle Utd,Premier League,17,2002,0.0,0,0,0,0,0,0,0,0.0,0,0,0,0,0,0,0,0,0,2020-2021,,
97,Felipe Anderson,BRA,"FW,MF",West Ham,Premier League,27,1993,0.0,1,1,0,1,0,0,0,0.0,0,0,0,0,0,1,0,0,0,2020-2021,,inf
98,Sebastian Andersson,SWE,FW,Köln,Bundesliga,29,1991,12.5,3,2,0,3,0,1,8,12.5,7,10,3,7,2,5,9,0,0,2020-2021,0.16,0.24
99,Nícolas Andrade,BRA,GK,Udinese,Serie A,32,1988,2.0,0,0,0,0,0,0,0,0.0,0,0,0,0,0,0,0,0,0,2020-2021,0.0,0.0
100,Benjamin André,FRA,MF,Lille,Ligue 1,29,1990,32.1,114,68,47,61,6,53,122,43.4,69,39,10,29,76,190,49,0,0,2020-2021,2.367601246105919,3.5514018691588785
Rk,Player,Nation,Pos,Squad,Comp,0,0,90.0,0,0,3,3,3,Tkl,0,0.0,0,0,0,0,0,0,0,0,0,2020-2021,0.0,0.0
101,Marcos André,BRA,FW,Valladolid,La Liga,23,1996,13.1,8,2,2,2,4,0,8,0.0,8,15,2,13,2,10,9,0,0,2020-2021,0.15267175572519084,0.6106870229007634
102,Robert Andrich,GER,MF,Union Berlin,Bundesliga,25,1994,28.1,51,24,22,27,2,24,53,45.3,29,40,6,34,51,102,31,2,0,2020-2021,1.8149466192170818,1.8149466192170818
103,Victorien Angban,CIV,MF,Metz,Ligue 1,23,1996,18.6,36,24,17,15,4,17,42,40.5,25,17,4,13,19,55,9,1,0,2020-2021,1.021505376344086,1.9354838709677418
104,Ángel,ESP,GK,Granada,La Liga,18,2002,1.0,0,0,0,0,0,0,0,0.0,0,0,0,0,0,0,1,0,0,2020-2021,0.0,0.0
105,José Ángel,ESP,DF,Eibar,La Liga,30,1989,10.0,15,8,9,4,2,8,12,66.7,4,7,0,7,13,28,17,1,0,2020-2021,1.3,1.5
106,Miguel Ángel Rubio,ESP,DF,Valladolid,La Liga,22,1998,1.5,0,0,0,0,0,0,0,0.0,0,2,2,0,3,3,11,0,0,2020-2021,2.0,0.0
107,Angeliño,ESP,"DF,FW",RB Leipzig,Bundesliga,23,1997,24.0,31,19,10,18,3,13,24,54.2,11,22,1,21,30,61,40,0,0,2020-2021,1.25,1.2916666666666667
108,Davide Angelo Ghislandi,ITA,DF,Atalanta,Serie A,19,2001,0.1,0,0,0,0,0,0,0,0.0,0,0,0,0,0,0,1,0,0,2020-2021,0.0,0.0
109,Philip Ankhrah,GHA,MF,Hellas Verona,Serie A,17,2002,0.1,0,0,0,0,0,0,0,0.0,0,1,0,1,0,0,0,0,0,2020-2021,0.0,0.0
110,Cristian Ansaldi,ARG,"DF,FW",Torino,Serie A,33,1986,21.6,48,33,25,14,9,24,38,63.2,14,21,7,14,16,64,38,0,0,2020-2021,0.7407407407407407,2.222222222222222
111,Waldemar Anton,GER,DF,Stuttgart,Bundesliga,24,1996,30.1,31,20,17,14,0,12,31,38.7,19,28,18,10,47,78,114,0,0,2020-2021,1.5614617940199336,1.0299003322259135
112,Michail Antonio,JAM,FW,West Ham,Premier League,30,1990,21.9,7,4,1,5,1,1,7,14.3,6,20,3,17,7,14,7,0,0,2020-2021,0.31963470319634707,0.31963470319634707
113,José Antonio Miranda,EQG,"MF,DF",Getafe,La Liga,22,1998,0.3,0,0,0,0,0,0,1,0.0,1,1,0,1,0,0,0,0,0,2020-2021,0.0,0.0
114,Valentin Antov,BUL,DF,Bologna,Serie A,19,2000,2.6,4,2,3,1,0,3,10,30.0,7,6,5,1,4,8,13,0,0,2020-2021,1.5384615384615383,1.5384615384615383
115,Houssem Aouar,ALG,"MF,FW",Lyon,Ligue 1,22,1998,19.8,17,12,0,13,4,8,25,32.0,17,17,1,16,17,34,4,0,0,2020-2021,0.8585858585858586,0.8585858585858586
116,Adil Aouchiche,FRA,"MF,FW",Saint-Étienne,Ligue 1,18,2002,19.2,38,20,12,17,9,13,49,26.5,36,15,1,14,10,48,6,0,0,2020-2021,0.5208333333333334,1.9791666666666667
117,Dennis Appiah,FRA,DF,Nantes,Ligue 1,28,1992,17.3,55,34,33,15,7,32,59,54.2,27,23,6,17,25,80,43,0,0,2020-2021,1.445086705202312,3.179190751445087
118,Aritz Arambarri,ESP,DF,Real Sociedad,La Liga,22,1998,0.3,1,1,0,1,0,1,2,50.0,1,0,0,0,0,1,0,0,0,2020-2021,0.0,3.3333333333333335
119,Mauro Arambarri,URU,MF,Getafe,La Liga,24,1995,33.1,64,39,22,35,7,23,80,28.8,57,40,5,35,42,106,28,0,0,2020-2021,1.268882175226586,1.9335347432024168
120,Charles Aránguiz,CHI,MF,Leverkusen,Bundesliga,31,1989,18.5,41,23,16,21,4,17,43,39.5,26,32,4,28,33,74,17,0,0,2020-2021,1.7837837837837838,2.2162162162162162
121,Luiz Araújo,BRA,MF,Lille,Ligue 1,24,1996,16.6,38,25,12,18,8,8,28,28.6,20,23,1,22,11,49,3,0,0,2020-2021,0.6626506024096385,2.2891566265060237
122,Néstor Araujo,MEX,DF,Celta Vigo,La Liga,28,1991,27.0,24,16,14,9,1,7,15,46.7,8,23,18,5,43,67,89,2,0,2020-2021,1.5925925925925926,0.8888888888888888
123,Ronald Araújo,URU,DF,Barcelona,La Liga,21,1999,16.8,22,11,12,8,2,9,9,100.0,0,24,15,9,20,42,47,1,0,2020-2021,1.1904761904761905,1.3095238095238095
124,Anaitz Arbilla,ESP,DF,Eibar,La Liga,33,1987,31.2,45,26,31,11,3,27,54,50.0,27,36,11,25,69,114,73,1,0,2020-2021,2.2115384615384617,1.4423076923076923
125,Alphonse Areola,FRA,GK,Fulham,Premier League,27,1993,36.0,1,0,1,0,0,1,5,20.0,4,0,0,0,1,2,13,3,0,2020-2021,0.027777777777777776,0.027777777777777776
Rk,Player,Nation,Pos,Squad,Comp,0,0,90.0,0,0,3,3,3,Tkl,0,0.0,0,0,0,0,0,0,0,0,0,2020-2021,0.0,0.0
126,Santiago Arias,COL,DF,Leverkusen,Bundesliga,28,1992,1.0,2,1,0,1,1,1,1,100.0,0,0,0,0,1,3,4,0,0,2020-2021,1.0,2.0
127,Karim Aribi,ALG,FW,Nîmes,Ligue 1,26,1994,3.3,2,2,0,1,1,0,5,0.0,5,1,0,1,0,2,3,0,0,2020-2021,0.0,0.6060606060606061
128,Unai Arietaleanizbeaskoa,ESP,"FW,MF",Eibar,La Liga,21,1999,0.5,1,0,0,0,1,0,0,0.0,0,0,0,0,0,1,0,0,0,2020-2021,0.0,2.0
129,Nicolò Armini,ITA,DF,Lazio,Serie A,19,2001,0.1,0,0,0,0,0,0,0,0.0,0,0,0,0,0,0,0,0,0,2020-2021,0.0,0.0
130,Stuart Armstrong,SCO,MF,Southampton,Premier League,28,1992,30.7,60,41,19,32,9,27,75,36.0,48,26,1,25,24,84,19,0,0,2020-2021,0.7817589576547231,1.9543973941368078
131,Maximilian Arnold,GER,MF,Wolfsburg,Bundesliga,26,1994,28.7,47,32,20,26,1,18,49,36.7,31,24,3,21,49,96,57,0,0,2020-2021,1.7073170731707317,1.637630662020906
132,Tolu Arokodare,NGA,"FW,MF",Köln,Bundesliga,19,2000,1.2,1,1,0,0,1,0,0,0.0,0,1,0,1,1,2,0,0,0,2020-2021,0.8333333333333334,0.8333333333333334
133,Sergio Arribas,ESP,"MF,FW",Real Madrid,La Liga,18,2001,1.5,3,1,2,1,0,1,3,33.3,2,2,0,2,4,7,2,0,0,2020-2021,2.6666666666666665,2.0
134,Kepa Arrizabalaga,ESP,GK,Chelsea,Premier League,25,1994,6.5,0,0,0,0,0,0,1,0.0,1,0,0,0,0,0,0,3,0,2020-2021,0.0,0.0
135,Tolgay Arslan,GER,MF,Udinese,Serie A,29,1990,20.2,52,32,24,24,4,25,54,46.3,29,22,2,20,22,74,15,1,0,2020-2021,1.0891089108910892,2.5742574257425743
136,Kwadwo Asamoah,GHA,"DF,MF",Cagliari,Serie A,31,1988,2.5,4,3,2,2,0,2,3,66.7,1,5,1,4,4,8,2,1,0,2020-2021,1.6,1.6
137,Santiago Ascacíbar,ARG,MF,Hertha BSC,Bundesliga,23,1997,8.5,30,15,15,14,1,15,28,53.6,13,23,2,21,13,43,14,0,0,2020-2021,1.5294117647058822,3.5294117647058822
138,Sergio Asenjo,ESP,GK,Villarreal,La Liga,31,1989,36.0,0,0,0,0,0,0,1,0.0,1,0,0,0,0,0,13,2,0,2020-2021,0.0,0.0
139,Marco Asensio,ESP,"FW,MF",Real Madrid,La Liga,24,1996,20.8,12,6,7,4,1,3,24,12.5,21,15,0,15,11,23,10,0,0,2020-2021,0.5288461538461539,0.5769230769230769
140,Kristoffer Askildsen,NOR,MF,Sampdoria,Serie A,19,2001,1.1,0,0,0,0,0,0,0,0.0,0,2,0,2,3,3,3,0,0,2020-2021,2.727272727272727,0.0
141,Iago Aspas,ESP,FW,Celta Vigo,La Liga,32,1987,31.8,11,3,2,7,2,2,23,8.7,21,25,2,23,16,27,21,0,0,2020-2021,0.5031446540880503,0.34591194968553457
142,Roger Assalé,CIV,"FW,MF",Dijon,Ligue 1,26,1993,9.2,10,8,3,5,2,4,12,33.3,8,7,3,4,2,12,2,0,0,2020-2021,0.2173913043478261,1.0869565217391306
143,Youcef Atal,ALG,"DF,FW",Nice,Ligue 1,24,1996,10.6,25,12,11,14,0,13,26,50.0,13,10,2,8,26,51,12,0,0,2020-2021,2.452830188679245,2.358490566037736
144,Miguel Atienza,ESP,MF,Eibar,La Liga,21,1999,9.3,20,9,5,15,0,8,23,34.8,15,14,1,13,9,29,12,0,0,2020-2021,0.9677419354838709,2.150537634408602
145,Pierre-Emerick Aubameyang,GAB,FW,Arsenal,Premier League,31,1989,25.9,12,8,7,4,1,3,20,15.0,17,18,0,18,7,19,17,0,0,2020-2021,0.2702702702702703,0.46332046332046334
146,Emil Audero,ITA,GK,Sampdoria,Serie A,23,1997,37.0,1,1,1,0,0,1,2,50.0,1,0,0,0,1,2,16,0,0,2020-2021,0.02702702702702703,0.02702702702702703
147,Tommaso Augello,ITA,DF,Sampdoria,Serie A,25,1994,35.7,42,30,27,10,5,23,39,59.0,16,22,2,20,32,74,76,1,0,2020-2021,0.8963585434173669,1.176470588235294
148,Jean-Kévin Augustin,FRA,FW,Nantes,Ligue 1,23,1997,0.4,2,0,0,2,0,2,2,100.0,0,0,0,0,0,2,0,0,0,2020-2021,0.0,5.0
149,Ludwig Augustinsson,SWE,"DF,FW",Werder Bremen,Bundesliga,26,1994,21.7,37,20,19,14,4,17,29,58.6,12,21,7,14,20,57,62,0,0,2020-2021,0.9216589861751152,1.7050691244239633
150,Serge Aurier,CIV,DF,Tottenham,Premier League,27,1992,17.8,55,33,33,17,5,15,40,37.5,25,28,5,23,19,74,44,3,0,2020-2021,1.0674157303370786,3.089887640449438
Rk,Player,Nation,Pos,Squad,Comp,0,0,90.0,0,0,3,3,3,Tkl,0,0.0,0,0,0,0,0,0,0,0,0,2020-2021,0.0,0.0
151,Charlie Austin,ENG,"FW,MF",West Brom,Premier League,31,1989,1.5,4,2,1,2,1,1,3,33.3,2,0,0,0,3,7,4,0,0,2020-2021,2.0,2.6666666666666665
152,Ezequiel Ávila,ARG,"FW,MF",Osasuna,La Liga,26,1994,2.2,6,2,3,1,2,2,4,50.0,2,1,0,1,1,7,0,0,0,2020-2021,0.45454545454545453,2.727272727272727
153,Taiwo Awoniyi,NGA,FW,Union Berlin,Bundesliga,22,1997,15.1,5,3,2,3,0,1,14,7.1,13,9,0,9,3,8,4,0,0,2020-2021,0.19867549668874174,0.33112582781456956
154,Mehmet Aydin,GER,DF,Schalke 04,Bundesliga,18,2002,5.6,15,7,9,6,0,4,10,40.0,6,6,1,5,6,21,16,0,0,2020-2021,1.0714285714285714,2.678571428571429
155,Jordan Ayew,GHA,"FW,MF",Crystal Palace,Premier League,28,1991,23.3,38,26,8,16,14,16,44,36.4,28,28,2,26,16,54,12,0,0,2020-2021,0.6866952789699571,1.630901287553648
156,Kaan Ayhan,TUR,DF,Sassuolo,Serie A,25,1994,8.8,15,9,8,5,2,8,13,61.5,5,9,5,4,16,31,33,0,0,2020-2021,1.8181818181818181,1.7045454545454544
157,Luke Ayling,ENG,DF,Leeds United,Premier League,28,1991,37.8,108,61,69,30,9,49,87,56.3,38,53,36,17,36,144,96,5,0,2020-2021,0.9523809523809524,2.857142857142857
158,Ramon Azeez,NGA,MF,Granada,La Liga,27,1992,1.1,1,1,0,1,0,0,0,0.0,0,0,0,0,1,2,1,0,0,2020-2021,0.9090909090909091,0.9090909090909091
159,César Azpilicueta,ESP,DF,Chelsea,Premier League,30,1989,24.3,53,28,22,24,7,19,37,51.4,18,30,5,25,28,81,62,2,0,2020-2021,1.1522633744855966,2.1810699588477367
160,Ludovic Baal,GUF,"DF,MF",Brest,Ligue 1,34,1986,3.3,6,5,4,1,1,2,5,40.0,3,4,1,3,5,11,5,0,0,2020-2021,1.5151515151515151,1.8181818181818183
161,Carlos Bacca,COL,FW,Villarreal,La Liga,33,1986,8.7,9,5,5,3,1,3,5,60.0,2,5,0,5,3,12,2,0,0,2020-2021,0.3448275862068966,1.0344827586206897
162,Loïc Bade,FRA,DF,Lens,Ligue 1,20,2000,29.0,57,34,47,10,0,30,55,54.5,25,43,17,26,74,131,135,2,0,2020-2021,2.5517241379310347,1.9655172413793103
163,Milan Badelj,CRO,MF,Genoa,Serie A,31,1989,26.8,56,27,27,22,7,26,84,31.0,58,51,10,41,87,143,45,1,0,2020-2021,3.246268656716418,2.08955223880597
164,Édgar Badía,ESP,GK,Elche,La Liga,28,1992,30.0,1,0,1,0,0,1,3,33.3,2,0,0,0,0,1,17,3,0,2020-2021,0.0,0.03333333333333333
165,Benoît Badiashile,FRA,DF,Monaco,Ligue 1,19,2001,31.9,24,17,15,9,0,13,28,46.4,15,21,12,9,58,82,102,4,0,2020-2021,1.8181818181818183,0.7523510971786834
166,Alex Baena,ESP,MF,Villarreal,La Liga,19,2001,1.5,4,3,1,2,1,1,3,33.3,2,1,1,0,1,5,1,0,0,2020-2021,0.6666666666666666,2.6666666666666665
167,Miguel Baeza,ESP,"MF,FW",Celta Vigo,La Liga,20,2000,6.0,7,6,5,2,0,5,13,38.5,8,3,0,3,3,10,2,0,0,2020-2021,0.5,1.1666666666666667
168,Stéphane Bahoken,CMR,FW,Angers,Ligue 1,28,1992,18.0,9,6,1,7,1,4,12,33.3,8,9,0,9,9,18,9,0,0,2020-2021,0.5,0.5
169,Leon Bailey,JAM,"FW,MF",Leverkusen,Bundesliga,22,1997,23.8,14,8,3,7,4,4,15,26.7,11,13,0,13,9,23,3,0,0,2020-2021,0.37815126050420167,0.5882352941176471
170,Eric Bailly,CIV,DF,Manchester Utd,Premier League,26,1994,10.2,5,5,3,1,1,0,1,0.0,1,13,11,2,13,18,36,2,0,2020-2021,1.2745098039215688,0.4901960784313726
171,Stefan Bajic,FRA,GK,Saint-Étienne,Ligue 1,18,2001,1.0,0,0,0,0,0,0,0,0.0,0,0,0,0,0,0,1,0,0,2020-2021,0.0,0.0
172,Tiemoué Bakayoko,FRA,MF,Napoli,Serie A,25,1994,21.8,69,41,21,41,7,23,40,57.5,17,24,2,22,36,105,13,2,0,2020-2021,1.6513761467889907,3.165137614678899
173,Mitchel Bakker,NED,DF,Paris S-G,Ligue 1,20,2000,18.8,38,30,15,14,9,17,26,65.4,9,22,2,20,22,60,20,0,0,2020-2021,1.1702127659574468,2.021276595744681
174,Ridle Baku,GER,"FW,DF",Wolfsburg,Bundesliga,22,1998,29.8,50,31,20,20,10,22,53,41.5,31,54,4,50,40,90,33,1,0,2020-2021,1.342281879194631,1.6778523489932886
175,Ridle Baku,GER,DF,Mainz 05,Bundesliga,22,1998,2.0,4,2,3,1,0,2,6,33.3,4,3,1,2,3,7,6,0,0,2020-2021,1.5,2.0
Rk,Player,Nation,Pos,Squad,Comp,0,0,90.0,0,0,3,3,3,Tkl,0,0.0,0,0,0,0,0,0,0,0,0,2020-2021,0.0,0.0
176,Dilane Bakwa,FRA,"FW,MF",Bordeaux,Ligue 1,17,2002,0.6,2,2,1,1,0,0,1,0.0,1,2,0,2,1,3,0,0,0,2020-2021,1.6666666666666667,3.3333333333333335
177,Fabián Balbuena,PAR,DF,West Ham,Premier League,28,1991,13.3,24,12,23,1,0,14,23,60.9,9,23,6,17,25,49,63,0,0,2020-2021,1.8796992481203008,1.8045112781954886
178,Keita Baldé,SEN,FW,Sampdoria,Serie A,25,1995,13.3,9,6,2,6,1,4,10,40.0,6,10,1,9,0,9,3,0,0,2020-2021,0.0,0.6766917293233082
179,George Baldock,GRE,DF,Sheffield Utd,Premier League,27,1993,31.0,47,34,28,14,5,21,50,42.0,29,26,7,19,25,72,70,1,0,2020-2021,0.8064516129032258,1.5161290322580645
180,Gareth Bale,WAL,FW,Tottenham,Premier League,31,1989,10.2,17,10,4,9,4,7,14,50.0,7,13,2,11,8,25,16,0,0,2020-2021,0.7843137254901962,1.6666666666666667
181,Mikel Balenziaga,ESP,DF,Athletic Club,La Liga,32,1988,18.8,26,15,11,12,3,9,18,50.0,9,22,7,15,7,33,46,0,0,2020-2021,0.3723404255319149,1.3829787234042552
182,Leonardo Balerdi,ARG,DF,Marseille,Ligue 1,21,1999,18.2,29,18,19,7,3,14,31,45.2,17,17,9,8,28,57,65,3,0,2020-2021,1.5384615384615385,1.5934065934065935
183,Fodé Ballo-Touré,SEN,DF,Monaco,Ligue 1,23,1997,7.4,21,17,9,11,1,6,13,46.2,7,7,0,7,6,27,11,1,0,2020-2021,0.8108108108108107,2.8378378378378377
184,Botond Balogh,HUN,DF,Parma,Serie A,18,2002,1.8,9,7,9,0,0,2,5,40.0,3,4,3,1,2,11,8,0,0,2020-2021,1.1111111111111112,5.0
185,Abdoulaye Bamba,CIV,DF,Angers,Ligue 1,30,1990,15.0,27,17,19,7,1,19,28,67.9,9,7,1,6,19,46,34,0,0,2020-2021,1.2666666666666666,1.8
186,Jonathan Bamba,CIV,MF,Lille,Ligue 1,24,1996,33.2,45,23,15,19,11,24,84,28.6,60,24,2,22,24,69,15,0,0,2020-2021,0.7228915662650601,1.355421686746988
187,Robson Bambu,BRA,DF,Nice,Ligue 1,22,1997,11.6,16,11,14,2,0,11,14,78.6,3,8,7,1,10,26,57,0,0,2020-2021,0.8620689655172414,1.3793103448275863
188,Patrick Bamford,ENG,FW,Leeds United,Premier League,26,1993,33.9,21,9,2,11,8,8,27,29.6,19,14,4,10,10,31,37,0,0,2020-2021,0.2949852507374631,0.6194690265486726
189,Mattia Bani,ITA,DF,Genoa,Serie A,26,1993,10.2,10,5,5,5,0,5,12,41.7,7,16,11,5,27,37,44,0,0,2020-2021,2.647058823529412,0.9803921568627452
190,Mattia Bani,ITA,DF,Parma,Serie A,26,1993,12.7,20,11,15,4,1,4,8,50.0,4,10,6,4,33,53,50,0,0,2020-2021,2.598425196850394,1.5748031496062993
191,Simon Banza,COD,FW,Lens,Ligue 1,23,1996,15.2,13,6,0,4,9,1,14,7.1,13,16,1,15,7,20,15,0,0,2020-2021,0.46052631578947373,0.8552631578947368
192,Antonín Barák,CZE,MF,Hellas Verona,Serie A,25,1994,30.7,30,19,8,16,6,14,47,29.8,33,26,7,19,12,42,38,1,0,2020-2021,0.39087947882736157,0.9771986970684039
193,Federico Barba,ITA,DF,Benevento,Serie A,26,1993,29.5,31,16,22,8,1,21,35,60.0,14,39,18,21,48,79,94,4,0,2020-2021,1.6271186440677967,1.0508474576271187
194,Danilo Barbosa,BRA,DF,Nice,Ligue 1,24,1996,2.8,6,3,5,1,0,4,6,66.7,2,2,1,1,2,8,11,2,0,2020-2021,0.7142857142857143,2.142857142857143
195,Barcia,ESP,DF,Granada,La Liga,19,2000,1.0,1,1,1,0,0,0,0,0.0,0,1,1,0,3,4,9,0,0,2020-2021,3.0,1.0
196,Melvin Bard,FRA,DF,Lyon,Ligue 1,19,2000,4.8,12,8,7,4,1,6,11,54.5,5,10,2,8,6,18,14,0,0,2020-2021,1.25,2.5
197,Enis Bardhi,MKD,MF,Levante,La Liga,25,1995,18.7,28,12,8,16,4,10,36,27.8,26,8,2,6,21,49,14,0,0,2020-2021,1.1229946524064172,1.4973262032085561
198,Phil Bardsley,SCO,DF,Burnley,Premier League,35,1985,3.0,6,5,4,2,0,3,6,50.0,3,3,1,2,6,12,12,0,0,2020-2021,2.0,2.0
199,Nicolò Barella,ITA,MF,Inter,Serie A,23,1997,32.2,58,31,23,29,6,23,72,31.9,49,29,4,25,26,84,14,0,0,2020-2021,0.8074534161490683,1.8012422360248446
200,Philipp Bargfrede,GER,MF,Werder Bremen,Bundesliga,31,1989,0.3,0,0,0,0,0,0,0,0.0,0,0,0,0,0,0,3,0,0,2020-2021,0.0,0.0
Rk,Player,Nation,Pos,Squad,Comp,0,0,90.0,0,0,3,3,3,Tkl,0,0.0,0,0,0,0,0,0,0,0,0,2020-2021,0.0,0.0
201,Kike Barja,ESP,"MF,FW",Osasuna,La Liga,23,1997,15.9,10,5,6,1,3,5,24,20.8,19,10,1,9,16,26,8,0,0,2020-2021,1.0062893081761006,0.6289308176100629
202,Ross Barkley,ENG,MF,Aston Villa,Premier League,26,1993,17.0,6,2,2,4,0,3,15,20.0,12,9,1,8,5,11,6,1,0,2020-2021,0.29411764705882354,0.35294117647058826
203,Ross Barkley,ENG,"FW,MF",Chelsea,Premier League,26,1993,0.5,0,0,0,0,0,0,0,0.0,0,0,0,0,0,0,0,0,0,2020-2021,0.0,0.0
204,Aymen Barkok,MAR,"MF,DF",Eint Frankfurt,Bundesliga,22,1998,10.9,29,15,11,9,9,10,31,32.3,21,15,1,14,10,39,9,1,0,2020-2021,0.9174311926605504,2.6605504587155964
205,Ashley Barnes,ENG,FW,Burnley,Premier League,30,1989,14.8,12,6,2,6,4,3,13,23.1,10,14,2,12,5,17,11,0,0,2020-2021,0.33783783783783783,0.8108108108108107
206,Harvey Barnes,ENG,"FW,MF",Leicester City,Premier League,22,1997,21.6,19,9,11,3,5,5,22,22.7,17,16,3,13,8,27,11,0,0,2020-2021,0.37037037037037035,0.8796296296296295
207,Marc Baró,ESP,DF,Cádiz,La Liga,20,1999,1.0,2,1,2,0,0,0,2,0.0,2,1,0,1,2,4,2,1,0,2020-2021,2.0,2.0
208,Antonio Barragán,ESP,DF,Elche,La Liga,33,1987,24.8,28,14,21,5,2,12,21,57.1,9,22,8,14,33,61,67,1,0,2020-2021,1.3306451612903225,1.129032258064516
209,Antonio Barreca,ITA,DF,Fiorentina,Serie A,25,1995,0.9,1,0,0,1,0,1,1,100.0,0,0,0,0,0,1,1,0,0,2020-2021,0.0,1.1111111111111112
210,Leandro Barreiro Martins,LUX,MF,Mainz 05,Bundesliga,20,2000,25.6,58,32,19,26,13,20,50,40.0,30,34,9,25,57,115,55,0,0,2020-2021,2.2265625,2.265625
211,Ander Barrenetxea,ESP,"MF,FW",Real Sociedad,La Liga,18,2001,14.5,29,19,5,18,6,9,24,37.5,15,20,0,20,6,35,8,0,0,2020-2021,0.41379310344827586,2.0
212,Jacob Barrett Laursen,DEN,DF,Arminia,Bundesliga,25,1994,12.3,23,12,13,8,2,10,16,62.5,6,14,4,10,24,47,37,0,0,2020-2021,1.951219512195122,1.8699186991869918
213,Musa Barrow,GAM,"FW,MF",Bologna,Serie A,21,1998,32.5,26,10,8,10,8,10,25,40.0,15,37,2,35,11,37,15,0,0,2020-2021,0.3384615384615385,0.8
214,Kyle Bartley,ENG,DF,West Brom,Premier League,29,1991,28.7,27,16,14,10,3,11,23,47.8,12,50,35,15,38,65,159,1,0,2020-2021,1.32404181184669,0.9407665505226481
215,Paolo Bartolomei,ITA,MF,Spezia,Serie A,30,1989,3.6,6,2,3,1,2,4,7,57.1,3,1,0,1,1,7,2,0,0,2020-2021,0.2777777777777778,1.6666666666666665
216,Marc Bartra,ESP,DF,Betis,La Liga,29,1991,18.8,27,16,18,8,1,12,22,54.5,10,19,5,14,40,67,74,3,0,2020-2021,2.127659574468085,1.4361702127659575
217,Daniele Baselli,ITA,MF,Torino,Serie A,28,1992,4.4,12,7,3,6,3,6,10,60.0,4,2,0,2,9,21,5,0,0,2020-2021,2.0454545454545454,2.727272727272727
218,Chris Basham,ENG,"DF,MF",Sheffield Utd,Premier League,32,1988,28.6,69,42,41,23,5,41,67,61.2,26,36,15,21,49,118,105,1,0,2020-2021,1.7132867132867131,2.4125874125874125
219,Toma Bašić,CRO,MF,Bordeaux,Ligue 1,23,1996,28.9,33,22,15,16,2,16,58,27.6,42,21,5,16,32,65,42,1,0,2020-2021,1.1072664359861593,1.1418685121107266
220,Álvaro Bastida,ESP,MF,Cádiz,La Liga,16,2004,0.4,0,0,0,0,0,0,0,0.0,0,0,0,0,0,0,0,0,0,2020-2021,0.0,0.0
221,Alessandro Bastoni,ITA,DF,Inter,Serie A,21,1999,32.5,36,22,13,21,2,17,27,63.0,10,34,16,18,40,76,75,0,0,2020-2021,1.2307692307692308,1.1076923076923078
222,Simone Bastoni,ITA,DF,Spezia,Serie A,23,1996,16.9,50,29,26,22,2,27,52,51.9,25,19,1,18,16,66,31,0,0,2020-2021,0.9467455621301776,2.958579881656805
223,Bastos,ANG,DF,Lazio,Serie A,29,1991,0.7,3,1,2,0,1,3,5,60.0,2,1,0,1,0,3,3,0,0,2020-2021,0.0,4.285714285714286
224,Michy Batshuayi,BEL,FW,Crystal Palace,Premier League,26,1993,8.1,5,3,1,2,2,1,9,11.1,8,5,1,4,4,9,5,0,0,2020-2021,0.4938271604938272,0.617283950617284
225,Rodrigo Battaglia,ARG,MF,Alavés,La Liga,29,1991,27.7,38,16,21,14,3,16,50,32.0,34,30,14,16,29,67,40,1,0,2020-2021,1.0469314079422383,1.371841155234657
Rk,Player,Nation,Pos,Squad,Comp,0,0,90.0,0,0,3,3,3,Tkl,0,0.0,0,0,0,0,0,0,0,0,0,2020-2021,0.0,0.0
226,Cristian Battocchio,ITA,MF,Brest,Ligue 1,28,1992,3.9,5,2,1,4,0,2,9,22.2,7,0,0,0,4,9,5,0,0,2020-2021,1.0256410256410258,1.2820512820512822
227,Oliver Baumann,GER,GK,Hoffenheim,Bundesliga,30,1990,31.0,0,0,0,0,0,0,1,0.0,1,0,0,0,2,2,14,0,0,2020-2021,0.06451612903225806,0.0
228,Julian Baumgartlinger,AUT,MF,Leverkusen,Bundesliga,32,1988,11.9,43,20,14,26,3,16,31,51.6,15,12,0,12,12,55,10,1,0,2020-2021,1.0084033613445378,3.6134453781512605
229,Christoph Baumgartner,AUT,"MF,FW",Hoffenheim,Bundesliga,20,1999,26.3,44,31,13,24,7,14,51,27.5,37,40,8,32,24,68,24,0,0,2020-2021,0.9125475285171103,1.6730038022813687
230,Jon Bautista,ESP,FW,Real Sociedad,La Liga,25,1995,4.1,5,3,0,2,3,0,3,0.0,3,3,1,2,2,7,4,0,0,2020-2021,0.48780487804878053,1.2195121951219514
231,Paul Baysse,FRA,DF,Bordeaux,Ligue 1,32,1988,29.0,35,18,21,13,1,16,21,76.2,5,33,24,9,52,87,123,1,0,2020-2021,1.793103448275862,1.206896551724138
232,Noah Joel Sarenren Bazee,NGA,"FW,MF",Augsburg,Bundesliga,23,1996,0.4,0,0,0,0,0,0,1,0.0,1,0,0,0,1,1,0,0,0,2020-2021,2.5,0.0
233,Ihlas Bebou,TOG,"FW,MF",Hoffenheim,Bundesliga,26,1994,24.4,24,9,5,10,9,8,14,57.1,6,18,4,14,17,41,16,0,0,2020-2021,0.6967213114754098,0.9836065573770493
234,Rodrigo Becão,BRA,DF,Udinese,Serie A,24,1996,30.9,59,33,36,20,3,27,49,55.1,22,48,27,21,68,127,94,2,0,2020-2021,2.2006472491909386,1.9093851132686086
235,Sheraldo Becker,SUR,"FW,MF",Union Berlin,Bundesliga,25,1995,12.3,5,4,2,2,1,3,5,60.0,2,4,0,4,6,11,7,0,0,2020-2021,0.4878048780487805,0.4065040650406504
236,Timo Becker,GER,DF,Schalke 04,Bundesliga,23,1997,18.2,34,23,28,6,0,16,25,64.0,9,18,4,14,22,56,58,0,0,2020-2021,1.208791208791209,1.8681318681318682
237,Jan Bednarek,POL,DF,Southampton,Premier League,24,1996,34.4,37,19,25,11,1,25,49,51.0,24,44,27,17,84,121,132,0,0,2020-2021,2.441860465116279,1.0755813953488373
238,Donny van de Beek,NED,"MF,FW",Manchester Utd,Premier League,23,1997,5.8,15,10,2,11,2,7,15,46.7,8,10,1,9,6,21,7,0,0,2020-2021,1.0344827586206897,2.586206896551724
239,Valon Behrami,SUI,MF,Genoa,Serie A,35,1985,9.9,21,9,9,10,2,9,26,34.6,17,13,5,8,9,30,13,0,0,2020-2021,0.9090909090909091,2.121212121212121
240,Brian Behrendt,GER,DF,Arminia,Bundesliga,28,1991,0.9,0,0,0,0,0,0,1,0.0,1,0,0,0,0,0,1,0,0,2020-2021,0.0,0.0
241,Maximilian Beier,GER,"FW,DF",Hoffenheim,Bundesliga,17,2002,0.1,0,0,0,0,0,0,1,0.0,1,0,0,0,0,0,0,0,0,2020-2021,0.0,0.0
242,Ishak Belfodil,ALG,"FW,MF",Hoffenheim,Bundesliga,28,1992,6.6,3,2,0,0,3,0,2,0.0,2,1,0,1,1,4,3,0,0,2020-2021,0.15151515151515152,0.4545454545454546
243,Erwan Belhadji,FRA,MF,Dijon,Ligue 1,19,2001,0.3,3,0,3,0,0,3,5,60.0,2,1,0,1,0,3,0,0,0,2020-2021,0.0,10.0
244,Haris Belkebla,ALG,MF,Brest,Ligue 1,26,1994,30.3,69,39,32,28,9,31,66,47.0,35,26,5,21,57,126,34,0,0,2020-2021,1.881188118811881,2.277227722772277
245,Stefan Bell,GER,DF,Mainz 05,Bundesliga,28,1991,14.1,24,18,15,9,0,14,23,60.9,9,19,11,8,27,51,76,1,0,2020-2021,1.9148936170212767,1.702127659574468
246,Karim Bellarabi,GER,"FW,MF",Leverkusen,Bundesliga,30,1990,8.9,12,10,3,4,5,4,17,23.5,13,12,0,12,12,24,4,0,0,2020-2021,1.348314606741573,1.348314606741573
247,Jean-Ricner Bellegarde,FRA,"MF,FW",Strasbourg,Ligue 1,22,1998,23.2,56,39,22,25,9,14,23,60.9,9,20,2,18,19,75,16,0,0,2020-2021,0.8189655172413793,2.413793103448276
248,Héctor Bellerín,ESP,"DF,MF",Arsenal,Premier League,25,1995,23.2,29,19,14,12,3,12,41,29.3,29,26,8,18,33,62,33,0,0,2020-2021,1.4224137931034484,1.25
249,Jude Bellingham,ENG,MF,Dortmund,Bundesliga,17,2003,18.9,49,31,11,29,9,19,46,41.3,27,37,5,32,24,73,13,0,0,2020-2021,1.26984126984127,2.592592592592593
250,Andrea Belotti,ITA,FW,Torino,Serie A,26,1993,32.1,30,18,4,16,10,11,35,31.4,24,27,4,23,12,42,21,0,0,2020-2021,0.37383177570093457,0.9345794392523364
Rk,Player,Nation,Pos,Squad,Comp,0,0,90.0,0,0,3,3,3,Tkl,0,0.0,0,0,0,0,0,0,0,0,0,2020-2021,0.0,0.0
251,Fran Beltrán,ESP,"MF,FW",Celta Vigo,La Liga,21,1999,15.5,30,22,15,12,3,8,24,33.3,16,14,1,13,16,46,24,0,0,2020-2021,1.032258064516129,1.935483870967742
252,Sami Ben Amar,MAR,MF,Nîmes,Ligue 1,22,1998,0.1,0,0,0,0,0,0,0,0.0,0,1,0,1,0,0,0,0,0,2020-2021,0.0,0.0
253,Hatem Ben Arfa,FRA,"MF,FW",Bordeaux,Ligue 1,33,1987,18.9,11,7,1,7,3,2,9,22.2,7,3,0,3,2,13,0,0,0,2020-2021,0.10582010582010583,0.5820105820105821
254,Salim Ben Seghir,FRA,DF,Nice,Ligue 1,17,2003,0.1,0,0,0,0,0,0,0,0.0,0,0,0,0,0,0,0,0,0,2020-2021,0.0,0.0
255,Wissam Ben Yedder,FRA,FW,Monaco,Ligue 1,29,1990,29.0,18,9,2,10,6,3,13,23.1,10,16,0,16,13,31,3,0,0,2020-2021,0.4482758620689655,0.6206896551724138
256,Ahmad Benali,LBY,MF,Crotone,Serie A,28,1992,13.5,19,11,10,9,0,11,38,28.9,27,15,2,13,6,25,15,0,0,2020-2021,0.4444444444444444,1.4074074074074074
257,Samy Benchamma,FRA,"DF,MF",Montpellier,Ligue 1,20,2000,0.5,1,1,1,0,0,0,0,0.0,0,0,0,0,0,1,1,0,0,2020-2021,0.0,2.0
258,Lars Bender,GER,DF,Leverkusen,Bundesliga,31,1989,10.4,19,13,12,6,1,9,21,42.9,12,19,5,14,16,35,19,0,0,2020-2021,1.5384615384615383,1.8269230769230769
259,Sven Bender,GER,DF,Leverkusen,Bundesliga,31,1989,13.0,17,9,8,8,1,7,20,35.0,13,20,9,11,21,38,41,1,0,2020-2021,1.6153846153846154,1.3076923076923077
260,Darío Benedetto,ARG,FW,Marseille,Ligue 1,30,1990,17.5,6,4,1,4,1,5,13,38.5,8,9,2,7,3,9,17,0,0,2020-2021,0.17142857142857143,0.34285714285714286
261,László Bénes,SVK,MF,Augsburg,Bundesliga,22,1997,7.3,8,6,4,4,0,2,8,25.0,6,6,2,4,7,15,1,1,0,2020-2021,0.9589041095890412,1.095890410958904
262,László Bénes,SVK,MF,Gladbach,Bundesliga,22,1997,1.7,6,2,5,1,0,2,4,50.0,2,0,0,0,2,8,1,0,0,2020-2021,1.1764705882352942,3.5294117647058822
263,Walter Benítez,ARG,GK,Nice,Ligue 1,27,1993,38.0,1,1,1,0,0,1,3,33.3,2,1,0,1,1,2,7,2,0,2020-2021,0.02631578947368421,0.02631578947368421
264,Loris Benito,SUI,DF,Bordeaux,Ligue 1,28,1992,29.5,42,26,27,12,3,22,48,45.8,26,33,10,23,42,84,70,0,0,2020-2021,1.423728813559322,1.423728813559322
265,Sergio Benito,ESP,FW,Valladolid,La Liga,21,1999,0.0,0,0,0,0,0,0,0,0.0,0,0,0,0,0,0,0,0,0,2020-2021,,
266,Bilal Benkhedim,FRA,FW,Saint-Étienne,Ligue 1,19,2001,0.8,0,0,0,0,0,0,1,0.0,1,1,0,1,0,0,0,0,0,2020-2021,0.0,0.0
267,Djamel Benlamri,ALG,DF,Lyon,Ligue 1,30,1989,1.7,5,3,5,0,0,3,6,50.0,3,3,2,1,6,11,11,0,0,2020-2021,3.5294117647058822,2.9411764705882355
268,Ismaël Bennacer,ALG,MF,Milan,Serie A,22,1997,14.7,39,18,17,21,1,15,32,46.9,17,10,1,9,20,59,12,0,0,2020-2021,1.3605442176870748,2.653061224489796
269,Saïd Benrahma,ALG,"FW,MF",West Ham,Premier League,24,1995,15.5,24,15,8,11,5,8,28,28.6,20,10,0,10,8,32,8,0,0,2020-2021,0.5161290322580645,1.5483870967741935
270,Yassine Benrahou,FRA,MF,Nîmes,Ligue 1,21,1999,13.8,16,9,8,6,2,7,25,28.0,18,9,0,9,4,20,5,1,0,2020-2021,0.2898550724637681,1.1594202898550725
271,Ramy Bensebaini,ALG,DF,Gladbach,Bundesliga,25,1995,20.1,43,24,27,13,3,26,42,61.9,16,39,7,32,47,90,66,0,0,2020-2021,2.3383084577114426,2.1393034825870645
272,Josh Benson,ENG,MF,Burnley,Premier League,20,1999,2.9,5,1,3,0,2,1,6,16.7,5,3,0,3,3,8,2,0,0,2020-2021,1.0344827586206897,1.7241379310344829
273,Nabil Bentaleb,ALG,MF,Schalke 04,Bundesliga,25,1994,6.1,14,8,7,6,1,4,15,26.7,11,5,2,3,6,20,8,0,0,2020-2021,0.9836065573770493,2.295081967213115
274,Rodrigo Bentancur,URU,MF,Juventus,Serie A,23,1997,25.8,63,33,21,37,5,20,59,33.9,39,35,12,23,47,110,46,1,0,2020-2021,1.821705426356589,2.441860465116279
275,Christian Benteke,BEL,FW,Crystal Palace,Premier League,29,1990,20.2,15,7,1,7,7,2,9,22.2,7,17,6,11,4,19,39,0,0,2020-2021,0.19801980198019803,0.7425742574257426
Rk,Player,Nation,Pos,Squad,Comp,0,0,90.0,0,0,3,3,3,Tkl,0,0.0,0,0,0,0,0,0,0,0,0,2020-2021,0.0,0.0
276,Karim Benzema,FRA,FW,Real Madrid,La Liga,32,1987,32.2,8,6,4,2,2,5,15,33.3,10,9,2,7,8,16,24,0,0,2020-2021,0.24844720496894407,0.24844720496894407
277,Yassine Benzia,ALG,"MF,FW",Dijon,Ligue 1,25,1994,4.5,10,5,5,3,2,2,10,20.0,8,3,0,3,6,16,2,0,0,2020-2021,1.3333333333333333,2.2222222222222223
278,Alessandro Berardi,ITA,GK,Hellas Verona,Serie A,29,1991,0.3,0,0,0,0,0,0,0,0.0,0,0,0,0,0,0,0,0,0,2020-2021,0.0,0.0
279,Domenico Berardi,ITA,FW,Sassuolo,Serie A,25,1994,27.5,42,22,17,11,14,21,62,33.9,41,23,1,22,26,68,34,0,0,2020-2021,0.9454545454545454,1.5272727272727273
280,Gaetano Berardi,SUI,DF,Leeds United,Premier League,31,1988,1.3,2,2,1,0,1,0,0,0.0,0,2,1,1,1,3,2,0,0,2020-2021,0.7692307692307692,1.5384615384615383
281,Yuri Berchiche,ESP,DF,Athletic Club,La Liga,30,1990,18.7,24,19,14,5,5,10,24,41.7,14,14,0,14,11,35,29,0,0,2020-2021,0.5882352941176471,1.2834224598930482
282,Álex Berenguer,ESP,MF,Torino,Serie A,25,1995,1.5,2,0,0,0,2,2,5,40.0,3,2,0,2,0,2,1,0,0,2020-2021,0.0,1.3333333333333333
283,Álex Berenguer,ESP,"MF,FW",Athletic Club,La Liga,25,1995,25.3,47,31,21,20,6,9,51,17.6,42,48,3,45,18,65,27,0,0,2020-2021,0.7114624505928854,1.8577075098814229
284,Bartosz Bereszyński,POL,DF,Sampdoria,Serie A,28,1992,29.0,66,44,37,22,7,41,73,56.2,32,40,20,20,42,108,88,0,0,2020-2021,1.4482758620689655,2.2758620689655173
285,Jóhann Berg Guðmundsson,ISL,MF,Burnley,Premier League,29,1990,15.1,19,11,6,9,4,11,23,47.8,12,11,2,9,17,36,19,0,0,2020-2021,1.1258278145695364,1.2582781456953642
286,Sander Berge,NOR,MF,Sheffield Utd,Premier League,22,1998,12.4,16,7,8,5,3,7,15,46.7,8,11,2,9,4,20,18,0,0,2020-2021,0.3225806451612903,1.2903225806451613
287,Steven Bergwijn,NED,"FW,MF",Tottenham,Premier League,22,1997,13.4,15,7,8,3,4,7,20,35.0,13,7,1,6,5,20,9,0,0,2020-2021,0.3731343283582089,1.1194029850746268
288,Valon Berisha,KVX,MF,Reims,Ligue 1,27,1993,18.3,40,23,19,17,4,11,47,23.4,36,14,2,12,25,65,21,1,0,2020-2021,1.366120218579235,2.1857923497267757
289,Bernard,BRA,"MF,FW",Everton,Premier League,27,1992,5.1,8,3,3,3,2,7,15,46.7,8,5,0,5,8,16,6,0,0,2020-2021,1.5686274509803924,1.5686274509803924
290,Federico Bernardeschi,ITA,"MF,DF",Juventus,Serie A,26,1994,10.8,9,4,3,5,1,4,20,20.0,16,6,2,4,14,23,7,1,0,2020-2021,1.2962962962962963,0.8333333333333333
291,Bernardo,BRA,"DF,MF",Brighton,Premier League,25,1995,2.3,10,8,8,1,1,4,6,66.7,2,2,0,2,1,11,1,0,0,2020-2021,0.4347826086956522,4.347826086956522
292,Paul Bernardoni,FRA,GK,Angers,Ligue 1,23,1997,38.0,1,1,1,0,0,1,2,50.0,1,0,0,0,2,3,23,1,0,2020-2021,0.05263157894736842,0.02631578947368421
293,Juan Bernat,ESP,DF,Paris S-G,Ligue 1,27,1993,2.2,5,3,0,4,1,3,5,60.0,2,4,0,4,1,6,6,0,0,2020-2021,0.45454545454545453,2.2727272727272725
294,Dimitry Bertaud,COD,GK,Montpellier,Ligue 1,22,1998,8.3,0,0,0,0,0,0,0,0.0,0,0,0,0,1,1,2,0,0,2020-2021,0.12048192771084336,0.0
295,Marco Bertini,ITA,MF,Lazio,Serie A,17,2002,0.1,1,0,1,0,0,0,0,0.0,0,0,0,0,0,1,0,0,0,2020-2021,0.0,10.0
296,Ryan Bertrand,ENG,DF,Southampton,Premier League,30,1989,28.9,60,32,26,27,7,30,48,62.5,18,19,1,18,30,90,41,1,0,2020-2021,1.0380622837370244,2.0761245674740487
297,Daniel Bessa,ITA,MF,Hellas Verona,Serie A,27,1993,6.8,15,8,3,11,1,6,14,42.9,8,5,1,4,2,17,0,0,0,2020-2021,0.29411764705882354,2.2058823529411766
298,Loïc Bessile,TOG,DF,Bordeaux,Ligue 1,21,1999,1.0,0,0,0,0,0,0,0,0.0,0,2,1,1,1,1,3,0,0,2020-2021,1.0,0.0
299,Jordan Beyer,GER,DF,Gladbach,Bundesliga,20,2000,2.1,2,1,2,0,0,1,2,50.0,1,5,4,1,5,7,5,0,0,2020-2021,2.380952380952381,0.9523809523809523
300,Giulian Biancone,FRA,"DF,MF",Monaco,Ligue 1,20,2000,1.0,3,3,1,1,1,2,3,66.7,1,1,0,1,1,4,4,0,0,2020-2021,1.0,3.0
Rk,Player,Nation,Pos,Squad,Comp,0,0,90.0,0,0,3,3,3,Tkl,0,0.0,0,0,0,0,0,0,0,0,0,2020-2021,0.0,0.0
301,Bartosz Białek,POL,"FW,MF",Wolfsburg,Bundesliga,18,2001,3.0,6,5,1,4,1,4,4,100.0,0,5,1,4,3,9,4,0,0,2020-2021,1.0,2.0
302,Ermin Bičakčić,BIH,DF,Hoffenheim,Bundesliga,30,1990,1.4,1,1,0,1,0,1,1,100.0,0,1,1,0,3,4,9,0,0,2020-2021,2.142857142857143,0.7142857142857143
303,Pedro Bigas,ESP,DF,Eibar,La Liga,29,1990,17.0,11,9,7,4,0,7,14,50.0,7,12,6,6,23,34,54,0,0,2020-2021,1.3529411764705883,0.6470588235294118
304,El Bilal Touré,MLI,FW,Reims,Ligue 1,18,2001,13.8,22,12,3,16,3,8,18,44.4,10,8,3,5,6,28,10,1,0,2020-2021,0.43478260869565216,1.5942028985507246
305,Cristiano Biraghi,ITA,DF,Fiorentina,Serie A,27,1992,31.1,42,23,19,15,8,27,45,60.0,18,23,9,14,27,69,56,3,0,2020-2021,0.8681672025723473,1.35048231511254
306,Davide Biraschi,ITA,DF,Genoa,Serie A,26,1994,10.2,17,9,12,5,0,5,10,50.0,5,12,6,6,21,38,26,0,0,2020-2021,2.058823529411765,1.6666666666666667
307,Yves Bissouma,MLI,MF,Brighton,Premier League,23,1996,34.6,104,68,50,48,6,33,67,49.3,34,42,6,36,64,168,67,0,0,2020-2021,1.8497109826589595,3.005780346820809
308,Leonardo Bittencourt,GER,"MF,FW",Werder Bremen,Bundesliga,26,1993,16.8,58,32,24,28,6,16,51,31.4,35,29,2,27,13,71,10,0,0,2020-2021,0.7738095238095237,3.452380952380952
309,Alejandro Blanco,ESP,MF,Valencia,La Liga,21,1998,6.4,8,4,4,4,0,3,18,16.7,15,5,0,5,8,16,9,0,0,2020-2021,1.25,1.25
310,Antonio Blanco,ESP,"MF,FW",Real Madrid,La Liga,20,2000,2.4,7,2,4,2,1,3,7,42.9,4,6,2,4,3,10,5,0,0,2020-2021,1.25,2.916666666666667
311,Rubén Blanco,ESP,GK,Celta Vigo,La Liga,25,1995,18.2,0,0,0,0,0,0,0,0.0,0,0,0,0,0,0,7,3,0,2020-2021,0.0,0.0
312,Ludovic Blas,FRA,"MF,FW",Nantes,Ligue 1,22,1997,31.0,58,30,18,37,3,23,54,42.6,31,33,4,29,21,79,19,0,0,2020-2021,0.6774193548387096,1.8709677419354838
313,Alejandro Blesa,ESP,MF,Levante,La Liga,18,2002,0.1,0,0,0,0,0,0,0,0.0,0,0,0,0,0,0,0,0,0,2020-2021,0.0,0.0
314,Jérôme Boateng,GER,DF,Bayern Munich,Bundesliga,31,1988,26.3,26,16,17,8,1,14,32,43.8,18,24,17,7,40,66,63,1,0,2020-2021,1.520912547528517,0.9885931558935361
315,Antonin Bobichon,FRA,"MF,FW",Angers,Ligue 1,24,1995,10.1,23,14,10,8,5,9,15,60.0,6,4,1,3,2,25,1,0,0,2020-2021,0.19801980198019803,2.2772277227722775
316,Yann Bodiger,FRA,MF,Cádiz,La Liga,25,1995,2.8,2,2,1,1,0,1,6,16.7,5,7,3,4,8,10,4,0,0,2020-2021,2.857142857142857,0.7142857142857143
317,Jean-Paul Boëtius,NED,"MF,FW",Mainz 05,Bundesliga,26,1994,22.9,42,28,13,15,14,17,47,36.2,30,37,3,34,33,75,14,0,0,2020-2021,1.4410480349344978,1.834061135371179
318,Sacha Boey,FRA,DF,Dijon,Ligue 1,19,2000,20.7,54,40,30,23,1,27,55,49.1,28,25,5,20,41,95,62,0,0,2020-2021,1.9806763285024156,2.608695652173913
319,Sacha Boey,FRA,DF,Rennes,Ligue 1,19,2000,1.4,3,3,2,1,0,3,4,75.0,1,0,0,0,2,5,2,0,0,2020-2021,1.4285714285714286,2.142857142857143
320,Jeremie Boga,CIV,"FW,MF",Sassuolo,Serie A,23,1997,19.8,11,9,5,0,6,3,11,27.3,8,10,0,10,8,19,7,0,0,2020-2021,0.40404040404040403,0.5555555555555556
321,Melayro Bogarde,NED,"DF,MF",Hoffenheim,Bundesliga,18,2002,3.1,7,3,3,3,1,5,9,55.6,4,0,0,0,5,12,1,0,0,2020-2021,1.6129032258064515,2.258064516129032
322,Jayden Bogle,ENG,"DF,MF",Sheffield Utd,Premier League,20,2000,12.3,33,23,21,10,2,20,39,51.3,19,14,4,10,14,47,22,0,0,2020-2021,1.1382113821138211,2.6829268292682924
323,Quentin Boisgard,FRA,"MF,FW",Lorient,Ligue 1,23,1997,14.6,24,17,3,15,6,11,24,45.8,13,17,2,15,15,39,1,0,0,2020-2021,1.0273972602739727,1.6438356164383563
324,Willy Boly,CIV,DF,Wolves,Premier League,29,1991,20.9,33,20,26,7,0,13,24,54.2,11,18,12,6,32,65,84,1,0,2020-2021,1.5311004784688995,1.5789473684210527
325,Giacomo Bonaventura,ITA,MF,Fiorentina,Serie A,30,1989,25.1,34,19,16,13,5,16,53,30.2,37,26,2,24,39,73,12,0,0,2020-2021,1.5537848605577689,1.3545816733067728
Rk,Player,Nation,Pos,Squad,Comp,0,0,90.0,0,0,3,3,3,Tkl,0,0.0,0,0,0,0,0,0,0,0,0,2020-2021,0.0,0.0
326,Federico Bonazzoli,ITA,FW,Torino,Serie A,23,1997,6.3,6,4,0,4,2,2,13,15.4,11,3,0,3,2,8,3,0,0,2020-2021,0.31746031746031744,0.9523809523809524
327,Federico Bonazzoli,ITA,FW,Sampdoria,Serie A,23,1997,1.5,0,0,0,0,0,0,0,0.0,0,1,0,1,0,0,0,0,0,2020-2021,0.0,0.0
328,Kevin Bonifazi,ITA,DF,Udinese,Serie A,24,1996,27.4,32,21,24,6,2,8,23,34.8,15,33,20,13,50,82,85,1,0,2020-2021,1.8248175182481752,1.1678832116788322
329,Leonardo Bonucci,ITA,DF,Juventus,Serie A,33,1987,22.5,19,14,10,8,1,6,14,42.9,8,24,13,11,33,52,67,0,0,2020-2021,1.4666666666666666,0.8444444444444444
330,Elias Bördner,GER,GK,Eint Frankfurt,Bundesliga,18,2002,1.0,1,0,1,0,0,1,1,100.0,0,0,0,0,2,3,1,0,0,2020-2021,2.0,1.0
331,Dennis Borkowski,GER,"MF,FW",RB Leipzig,Bundesliga,18,2002,0.1,0,0,0,0,0,0,0,0.0,0,1,0,1,0,0,0,0,0,2020-2021,0.0,0.0
332,Sebastiaan Bornauw,BEL,DF,Köln,Bundesliga,21,1999,23.1,29,20,25,4,0,14,25,56.0,11,33,26,7,40,69,104,0,0,2020-2021,1.7316017316017316,1.2554112554112553
333,Sven Botman,NED,DF,Lille,Ligue 1,20,2000,36.8,31,21,18,12,1,14,26,53.8,12,31,21,10,57,88,126,2,0,2020-2021,1.548913043478261,0.8423913043478262
334,Denis Bouanga,GAB,"MF,FW",Saint-Étienne,Ligue 1,25,1994,30.2,52,28,22,24,6,16,58,27.6,42,32,3,29,20,72,36,0,0,2020-2021,0.6622516556291391,1.7218543046357617
335,Hicham Boudaoui,ALG,MF,Nice,Ligue 1,20,1999,19.3,52,35,20,24,8,26,68,38.2,42,14,4,10,23,75,26,1,0,2020-2021,1.1917098445595855,2.694300518134715
336,Ryad Boudebouz,ALG,"MF,FW",Saint-Étienne,Ligue 1,30,1990,7.2,9,4,1,7,1,4,8,50.0,4,3,0,3,5,14,5,0,0,2020-2021,0.6944444444444444,1.25
337,Sofiane Boufal,MAR,"FW,MF",Angers,Ligue 1,26,1993,8.1,17,11,8,6,3,8,28,28.6,20,8,0,8,3,20,1,0,0,2020-2021,0.3703703703703704,2.0987654320987654
338,Nassim Boujellab,MAR,"MF,FW",Schalke 04,Bundesliga,21,1999,6.7,13,9,2,10,1,2,12,16.7,10,10,3,7,7,20,9,0,0,2020-2021,1.044776119402985,1.9402985074626866
339,Farid Boulaya,ALG,"MF,FW",Metz,Ligue 1,27,1993,31.3,24,16,4,17,3,13,51,25.5,38,19,3,16,12,36,7,0,0,2020-2021,0.38338658146964855,0.7667731629392971
340,Yassine Bounou,MAR,GK,Sevilla,La Liga,29,1991,33.0,1,1,1,0,0,0,2,0.0,2,0,0,0,0,1,12,2,0,2020-2021,0.0,0.030303030303030304
341,Ismaëlben Boura,COM,DF,Lens,Ligue 1,19,2000,9.1,11,7,8,2,1,3,9,33.3,6,7,2,5,21,32,12,0,0,2020-2021,2.307692307692308,1.208791208791209
342,Mehdi Bourabia,MAR,MF,Sassuolo,Serie A,28,1991,5.9,6,5,1,4,1,2,7,28.6,5,14,6,8,12,18,8,0,0,2020-2021,2.0338983050847457,1.0169491525423728
343,Benjamin Bourigeaud,FRA,"MF,FW",Rennes,Ligue 1,26,1994,28.4,40,23,17,16,7,21,71,29.6,50,37,1,36,19,59,25,0,0,2020-2021,0.6690140845070423,1.4084507042253522
344,Edoardo Bove,ITA,MF,Roma,Serie A,18,2002,0.1,0,0,0,0,0,0,1,0.0,1,0,0,0,0,0,0,0,0,2020-2021,0.0,0.0
345,Jarrod Bowen,ENG,"FW,MF",West Ham,Premier League,23,1996,28.5,26,15,12,7,7,10,29,34.5,19,19,1,18,22,48,10,0,0,2020-2021,0.7719298245614035,0.9122807017543859
346,Dedryck Boyata,BEL,DF,Hertha BSC,Bundesliga,29,1990,17.2,14,7,10,3,1,7,15,46.7,8,23,20,3,26,40,68,1,0,2020-2021,1.5116279069767442,0.813953488372093
347,John Boye,GHA,DF,Metz,Ligue 1,33,1987,33.8,58,34,43,13,2,31,54,57.4,23,36,20,16,80,138,146,1,0,2020-2021,2.366863905325444,1.7159763313609468
348,Lucas Boyé,ARG,FW,Elche,La Liga,24,1996,29.9,47,31,13,27,7,10,49,20.4,39,37,2,35,19,66,21,0,0,2020-2021,0.6354515050167224,1.5719063545150502
349,Can Bozdogan,GER,"MF,FW",Schalke 04,Bundesliga,19,2001,7.2,13,5,6,6,1,4,15,26.7,11,10,2,8,7,20,5,0,0,2020-2021,0.9722222222222222,1.8055555555555556
350,Umut Bozok,TUR,"MF,FW",Lorient,Ligue 1,23,1996,0.7,0,0,0,0,0,0,2,0.0,2,0,0,0,0,0,0,0,0,2020-2021,0.0,0.0
Rk,Player,Nation,Pos,Squad,Comp,0,0,90.0,0,0,3,3,3,Tkl,0,0.0,0,0,0,0,0,0,0,0,0,2020-2021,0.0,0.0
351,Jayden Braaf,NED,FW,Udinese,Serie A,17,2002,1.3,0,0,0,0,0,0,1,0.0,1,0,0,0,0,0,0,0,0,2020-2021,0.0,0.0
352,Domagoj Bradarić,CRO,DF,Lille,Ligue 1,20,1999,14.0,28,18,11,13,4,12,27,44.4,15,14,4,10,26,54,21,0,0,2020-2021,1.8571428571428572,2.0
353,Robbie Brady,IRL,MF,Burnley,Premier League,28,1992,11.7,22,15,12,6,4,12,35,34.3,23,16,0,16,9,31,29,1,0,2020-2021,0.7692307692307693,1.8803418803418805
354,Martin Braithwaite,DEN,FW,Barcelona,La Liga,29,1991,13.1,8,4,2,3,3,1,6,16.7,5,2,0,2,6,14,7,0,0,2020-2021,0.4580152671755725,0.6106870229007634
355,Julian Brandt,GER,"FW,MF",Dortmund,Bundesliga,24,1996,16.6,27,14,13,9,5,12,43,27.9,31,25,1,24,17,44,7,1,0,2020-2021,1.0240963855421685,1.6265060240963853
356,Darko Brašanac,SRB,MF,Osasuna,La Liga,28,1992,10.1,10,6,6,4,0,5,16,31.3,11,8,1,7,7,17,10,0,0,2020-2021,0.6930693069306931,0.9900990099009901
357,Lilian Brassier,FRA,DF,Brest,Ligue 1,20,1999,10.7,19,10,12,4,3,7,11,63.6,4,13,6,7,23,42,38,1,0,2020-2021,2.149532710280374,1.7757009345794394
358,Álvaro Bravo,ESP,MF,Granada,La Liga,22,1998,0.2,1,1,1,0,0,1,2,50.0,1,0,0,0,1,2,0,0,0,2020-2021,5.0,5.0
359,Claudio Bravo,CHI,GK,Betis,La Liga,37,1983,20.0,0,0,0,0,0,0,1,0.0,1,0,0,0,0,0,11,0,0,2020-2021,0.0,0.0
360,Fabian Bredlow,GER,GK,Stuttgart,Bundesliga,25,1995,1.0,0,0,0,0,0,0,0,0.0,0,0,0,0,0,0,0,0,0,2020-2021,0.0,0.0
361,Josip Brekalo,CRO,FW,Wolfsburg,Bundesliga,22,1998,20.2,22,10,10,7,5,8,29,27.6,21,18,0,18,17,39,3,1,0,2020-2021,0.8415841584158417,1.0891089108910892
362,Gleison Bremer,BRA,DF,Torino,Serie A,23,1997,32.6,51,34,36,14,1,21,36,58.3,15,54,21,33,70,121,142,1,0,2020-2021,2.147239263803681,1.5644171779141103
363,Joshua Brenet,CUW,DF,Hoffenheim,Bundesliga,26,1994,0.0,0,0,0,0,0,0,0,0.0,0,0,0,0,0,0,0,0,0,2020-2021,,
364,Rhian Brewster,ENG,"FW,MF",Sheffield Utd,Premier League,20,2000,12.5,8,5,1,4,3,1,13,7.7,12,15,2,13,5,13,5,0,0,2020-2021,0.4,0.64
365,Anthony Briançon,FRA,DF,Nîmes,Ligue 1,25,1994,13.6,12,7,9,3,0,9,19,47.4,10,19,12,7,33,45,57,2,0,2020-2021,2.4264705882352944,0.8823529411764706
366,Jimmy Briand,FRA,FW,Bordeaux,Ligue 1,34,1985,6.3,7,3,3,2,2,1,1,100.0,0,2,0,2,1,8,3,0,0,2020-2021,0.15873015873015872,1.1111111111111112
367,Yan Brice Eteki,CMR,MF,Granada,La Liga,22,1997,14.7,23,15,10,12,1,8,19,42.1,11,13,3,10,13,36,16,1,0,2020-2021,0.8843537414965987,1.5646258503401362
368,Nathan Broadhead,WAL,FW,Everton,Premier League,22,1998,0.0,1,1,0,1,0,0,0,0.0,0,0,0,0,0,1,0,0,0,2020-2021,,inf
369,Dylan Bronn,TUN,DF,Metz,Ligue 1,25,1995,37.9,57,37,38,19,0,24,44,54.5,20,31,14,17,44,101,112,0,0,2020-2021,1.1609498680738786,1.503957783641161
370,John Brooks,USA,DF,Wolfsburg,Bundesliga,27,1993,30.8,47,29,33,14,0,30,54,55.6,24,35,10,25,55,102,134,0,0,2020-2021,1.7857142857142856,1.525974025974026
371,Daniel Brosinski,GER,"DF,FW",Mainz 05,Bundesliga,32,1988,15.9,19,14,10,7,2,12,31,38.7,19,18,1,17,14,33,33,0,0,2020-2021,0.8805031446540881,1.1949685534591195
372,Josh Brownhill,ENG,MF,Burnley,Premier League,24,1995,31.3,45,27,9,29,7,15,44,34.1,29,33,11,22,69,114,39,0,0,2020-2021,2.2044728434504792,1.4376996805111821
373,Marcelo Brozović,CRO,MF,Inter,Serie A,27,1992,28.7,54,29,23,24,7,20,61,32.8,41,43,17,26,40,94,38,0,0,2020-2021,1.3937282229965158,1.8815331010452963
374,Gastón Brugman,URU,MF,Parma,Serie A,27,1992,18.0,35,19,18,15,2,11,44,25.0,33,33,4,29,45,80,34,0,0,2020-2021,2.5,1.9444444444444444
375,Juan Brunet,ARG,MF,Granada,La Liga,22,1998,0.3,0,0,0,0,0,0,0,0.0,0,0,0,0,0,0,1,0,0,2020-2021,0.0,0.0
Rk,Player,Nation,Pos,Squad,Comp,0,0,90.0,0,0,3,3,3,Tkl,0,0.0,0,0,0,0,0,0,0,0,0,2020-2021,0.0,0.0
376,Juan Brunetta,ARG,"FW,MF",Parma,Serie A,23,1997,5.3,2,2,0,2,0,1,6,16.7,5,5,0,5,1,3,2,0,0,2020-2021,0.18867924528301888,0.37735849056603776
377,Cédric Brunner,SUI,DF,Arminia,Bundesliga,26,1994,29.5,42,22,24,15,3,27,40,67.5,13,30,10,20,42,84,96,0,0,2020-2021,1.423728813559322,1.423728813559322
378,Jacob Bruun Larsen,DEN,"MF,FW",Hoffenheim,Bundesliga,21,1998,1.0,0,0,0,0,0,0,0,0.0,0,0,0,0,0,0,0,0,0,2020-2021,0.0,0.0
379,Joe Bryan,ENG,"DF,MF",Fulham,Premier League,26,1993,7.4,15,8,7,5,3,7,12,58.3,5,8,2,6,14,29,16,0,0,2020-2021,1.8918918918918919,2.0270270270270268
380,Kean Bryan,ENG,DF,Sheffield Utd,Premier League,23,1996,11.2,20,10,9,11,0,9,19,47.4,10,16,10,6,13,33,39,1,0,2020-2021,1.1607142857142858,1.7857142857142858
381,Lucas Buadés,FRA,MF,Nîmes,Ligue 1,22,1997,0.2,1,0,0,1,0,0,0,0.0,0,0,0,0,0,1,0,0,0,2020-2021,0.0,5.0
382,Ante Budimir,CRO,FW,Osasuna,La Liga,29,1991,18.1,20,12,2,11,7,4,15,26.7,11,17,4,13,2,22,17,1,0,2020-2021,0.11049723756906077,1.1049723756906076
383,Gianluigi Buffon,ITA,GK,Juventus,Serie A,42,1978,8.0,0,0,0,0,0,0,0,0.0,0,0,0,0,0,0,3,1,0,2020-2021,0.0,0.0
384,Marius Bülter,GER,"FW,MF",Union Berlin,Bundesliga,27,1993,10.9,15,8,6,6,3,5,17,29.4,12,17,2,15,12,27,11,0,0,2020-2021,1.1009174311926606,1.3761467889908257
385,Alessandro Buongiorno,ITA,DF,Torino,Serie A,21,1999,9.5,12,5,8,4,0,7,12,58.3,5,15,9,6,11,23,44,1,0,2020-2021,1.1578947368421053,1.263157894736842
386,Esteban Burgos,ARG,DF,Eibar,La Liga,28,1992,12.3,7,6,4,3,0,1,5,20.0,4,8,7,1,23,30,54,2,0,2020-2021,1.8699186991869918,0.5691056910569106
387,Burgui,ESP,MF,Alavés,La Liga,26,1993,0.2,3,1,2,1,0,1,1,100.0,0,0,0,0,0,3,0,0,0,2020-2021,0.0,15.0
388,Jonathan Burkardt,GER,"FW,MF",Mainz 05,Bundesliga,20,2000,15.3,27,13,15,10,2,11,19,57.9,8,20,3,17,8,35,15,0,0,2020-2021,0.5228758169934641,1.7647058823529411
389,Nishan Burkart,SUI,MF,Freiburg,Bundesliga,20,2000,0.2,0,0,0,0,0,0,1,0.0,1,0,0,0,0,0,0,0,0,2020-2021,0.0,0.0
390,Oliver Burke,SCO,FW,Sheffield Utd,Premier League,23,1997,14.1,16,8,6,9,1,5,24,20.8,19,24,0,24,2,18,6,0,0,2020-2021,0.14184397163120568,1.1347517730496455
391,Roman Bürki,SUI,GK,Dortmund,Bundesliga,29,1990,18.5,0,0,0,0,0,0,0,0.0,0,0,0,0,0,0,5,1,0,2020-2021,0.0,0.0
392,Dan Burn,ENG,DF,Brighton,Premier League,28,1992,22.9,50,26,33,14,3,27,53,50.9,26,30,7,23,31,81,75,0,0,2020-2021,1.3537117903930131,2.183406113537118
393,Patrick Burner,MTQ,DF,Nice,Ligue 1,24,1996,0.0,0,0,0,0,0,0,0,0.0,0,0,0,0,0,0,0,0,0,2020-2021,,
394,Patrick Burner,MTQ,DF,Nîmes,Ligue 1,24,1996,14.6,25,11,14,10,1,13,26,50.0,13,10,3,7,24,49,41,1,0,2020-2021,1.6438356164383563,1.7123287671232876
395,Maxime Busi,BEL,DF,Parma,Serie A,20,1999,13.3,23,13,19,3,1,11,28,39.3,17,14,1,13,16,39,32,0,0,2020-2021,1.2030075187969924,1.7293233082706767
396,Sergio Busquets,ESP,MF,Barcelona,La Liga,32,1988,28.0,63,35,21,29,13,27,76,35.5,49,27,4,23,53,116,18,2,0,2020-2021,1.8928571428571428,2.25
397,Jack Butland,ENG,GK,Crystal Palace,Premier League,27,1993,1.0,0,0,0,0,0,0,0,0.0,0,0,0,0,0,0,0,0,0,2020-2021,0.0,0.0
398,David Button,ENG,GK,West Brom,Premier League,31,1989,1.0,0,0,0,0,0,0,0,0.0,0,0,0,0,0,0,0,0,0,2020-2021,0.0,0.0
399,Oskar Buur,DEN,DF,Wolves,Premier League,22,1998,0.2,0,0,0,0,0,0,2,0.0,2,0,0,0,0,0,0,0,0,2020-2021,0.0,0.0
400,Marcin Bułka,POL,GK,Paris S-G,Ligue 1,20,1999,1.0,0,0,0,0,0,0,0,0.0,0,0,0,0,0,0,0,1,0,2020-2021,0.0,0.0
Rk,Player,Nation,Pos,Squad,Comp,0,0,90.0,0,0,3,3,3,Tkl,0,0.0,0,0,0,0,0,0,0,0,0,2020-2021,0.0,0.0
401,Erick Cabaco,URU,DF,Getafe,La Liga,25,1995,14.7,24,14,11,12,1,12,22,54.5,10,8,6,2,13,37,51,1,0,2020-2021,0.8843537414965987,1.6326530612244898
402,Willy Caballero,ARG,GK,Chelsea,Premier League,38,1981,1.0,0,0,0,0,0,0,0,0.0,0,0,0,0,0,0,0,0,0,2020-2021,0.0,0.0
403,Jimmy Cabot,FRA,"FW,MF",Angers,Ligue 1,26,1994,10.5,26,13,8,14,4,11,36,30.6,25,8,0,8,12,38,6,0,0,2020-2021,1.1428571428571428,2.4761904761904763
404,Martín Cáceres,URU,DF,Fiorentina,Serie A,33,1987,24.9,28,12,16,11,1,15,35,42.9,20,20,14,6,14,42,52,1,0,2020-2021,0.5622489959839357,1.1244979919678715
405,Anthony Caci,FRA,DF,Strasbourg,Ligue 1,23,1997,31.1,80,46,47,27,6,35,69,50.7,34,30,4,26,55,135,65,1,0,2020-2021,1.7684887459807073,2.572347266881029
406,Mathieu Cafaro,FRA,"MF,FW",Reims,Ligue 1,23,1997,23.0,40,17,15,19,6,13,43,30.2,30,11,0,11,17,57,12,0,0,2020-2021,0.7391304347826086,1.7391304347826086
407,Gary Cahill,ENG,DF,Crystal Palace,Premier League,34,1985,20.0,13,9,10,3,0,7,11,63.6,4,27,22,5,13,26,88,0,0,2020-2021,0.65,0.65
408,Yannick Cahuzac,FRA,MF,Lens,Ligue 1,35,1985,25.0,26,12,12,10,4,9,27,33.3,18,18,5,13,33,59,72,0,0,2020-2021,1.32,1.04
409,Felipe Caicedo,ECU,FW,Lazio,Serie A,31,1988,10.3,10,7,4,4,2,1,8,12.5,7,7,0,7,4,14,2,0,0,2020-2021,0.3883495145631068,0.9708737864077669
410,Marc-Aurèle Caillard,FRA,GK,Metz,Ligue 1,26,1994,4.0,0,0,0,0,0,0,0,0.0,0,0,0,0,0,0,2,0,0,2020-2021,0.0,0.0
411,Tom Cairney,SCO,MF,Fulham,Premier League,29,1991,8.4,9,3,1,4,4,1,4,25.0,3,6,0,6,0,9,3,0,0,2020-2021,0.0,1.0714285714285714
412,Cala,ESP,DF,Cádiz,La Liga,30,1989,25.2,21,12,15,6,0,11,21,52.4,10,18,8,10,35,56,91,0,0,2020-2021,1.3888888888888888,0.8333333333333334
413,Arturo Calabresi,ITA,"DF,FW",Bologna,Serie A,24,1996,0.2,0,0,0,0,0,0,0,0.0,0,0,0,0,0,0,2,0,0,2020-2021,0.0,0.0
414,Arturo Calabresi,ITA,DF,Cagliari,Serie A,24,1996,0.2,0,0,0,0,0,0,1,0.0,1,0,0,0,0,0,0,0,0,2020-2021,0.0,0.0
415,Davide Calabria,ITA,DF,Milan,Serie A,23,1996,29.4,101,64,61,32,8,54,90,60.0,36,42,9,33,37,138,82,1,0,2020-2021,1.2585034013605443,3.435374149659864
416,Riccardo Calafiori,ITA,DF,Roma,Serie A,18,2002,0.7,1,0,1,0,0,1,4,25.0,3,1,0,1,0,1,0,0,0,2020-2021,0.0,1.4285714285714286
417,Mattia Caldara,ITA,DF,Atalanta,Serie A,26,1994,1.2,1,0,0,1,0,1,1,100.0,0,3,2,1,4,5,3,0,0,2020-2021,3.3333333333333335,0.8333333333333334
418,Luca Caldirola,ITA,DF,Benevento,Serie A,29,1991,17.5,21,13,13,6,2,10,22,45.5,12,20,15,5,20,41,56,0,0,2020-2021,1.1428571428571428,1.2
419,Duje Ćaleta-Car,CRO,DF,Marseille,Ligue 1,23,1996,31.3,29,17,19,9,1,17,30,56.7,13,29,22,7,44,73,130,0,0,2020-2021,1.4057507987220448,0.926517571884984
420,Hakan Çalhanoğlu,TUR,"MF,FW",Milan,Serie A,26,1994,29.0,26,7,3,17,6,7,28,25.0,21,21,6,15,15,41,24,1,0,2020-2021,0.5172413793103449,0.896551724137931
421,Kerim Calhanoglu,GER,DF,Schalke 04,Bundesliga,17,2002,3.3,3,3,1,1,1,0,3,0.0,3,4,0,4,7,10,6,0,0,2020-2021,2.121212121212121,0.9090909090909092
422,Fabrizio Caligara,ITA,"MF,FW",Cagliari,Serie A,20,2000,2.0,6,4,2,2,2,6,9,66.7,3,9,2,7,3,9,3,0,0,2020-2021,1.5,3.0
423,Daniel Caligiuri,ITA,"MF,FW",Augsburg,Bundesliga,32,1988,29.6,71,46,29,31,11,29,92,31.5,63,45,6,39,38,109,41,0,0,2020-2021,1.2837837837837838,2.3986486486486487
424,José Callejón,ESP,"FW,MF",Fiorentina,Serie A,33,1987,7.4,10,7,0,6,4,5,9,55.6,4,4,1,3,4,14,5,0,0,2020-2021,0.5405405405405405,1.3513513513513513
425,Jonathan Calleri,ARG,FW,Osasuna,La Liga,26,1993,17.2,15,6,2,4,9,3,17,17.6,14,18,2,16,1,16,10,1,0,2020-2021,0.05813953488372093,0.872093023255814
Rk,Player,Nation,Pos,Squad,Comp,0,0,90.0,0,0,3,3,3,Tkl,0,0.0,0,0,0,0,0,0,0,0,0,2020-2021,0.0,0.0
426,Dominic Calvert-Lewin,ENG,FW,Everton,Premier League,23,1997,31.9,17,8,1,8,8,6,12,50.0,6,22,6,16,6,23,33,0,0,2020-2021,0.18808777429467086,0.5329153605015674
427,Dani Calvo,ESP,DF,Elche,La Liga,26,1994,19.8,20,13,13,7,0,7,10,70.0,3,18,12,6,11,31,71,0,0,2020-2021,0.5555555555555556,1.0101010101010102
428,Drissa Camara,CIV,MF,Parma,Serie A,18,2002,0.2,0,0,0,0,0,0,0,0.0,0,0,0,0,0,0,0,0,0,2020-2021,0.0,0.0
429,Mahdi Camara,FRA,"MF,DF",Saint-Étienne,Ligue 1,22,1998,36.6,99,67,43,46,10,33,60,55.0,27,50,12,38,78,177,51,0,0,2020-2021,2.1311475409836063,2.7049180327868854
430,Eduardo Camavinga,FRA,MF,Rennes,Ligue 1,17,2002,26.7,98,58,39,48,11,38,77,49.4,39,36,2,34,23,121,15,1,0,2020-2021,0.8614232209737828,3.6704119850187267
431,José Campaña,ESP,MF,Levante,La Liga,27,1993,8.3,14,6,3,6,5,5,14,35.7,9,2,0,2,13,27,4,0,0,2020-2021,1.5662650602409638,1.686746987951807
432,Emre Can,GER,"DF,MF",Dortmund,Bundesliga,26,1994,23.7,43,34,20,20,3,20,37,54.1,17,35,10,25,48,91,52,0,0,2020-2021,2.0253164556962027,1.8143459915611815
433,Sergio Canales,ESP,"MF,FW",Betis,La Liga,29,1991,27.8,16,9,9,6,1,3,21,14.3,18,18,0,18,13,29,5,0,0,2020-2021,0.4676258992805755,0.5755395683453237
434,João Cancelo,POR,"DF,MF",Manchester City,Premier League,26,1994,25.5,68,41,42,19,7,43,83,51.8,40,23,2,21,41,109,33,2,0,2020-2021,1.607843137254902,2.6666666666666665
435,Antonio Candreva,ITA,MF,Sampdoria,Serie A,33,1987,27.8,28,19,17,9,2,21,53,39.6,32,24,3,21,9,37,27,1,0,2020-2021,0.3237410071942446,1.0071942446043165
436,Álex Cantero,ESP,FW,Levante,La Liga,20,2000,2.6,2,1,0,2,0,1,2,50.0,1,1,0,1,0,2,3,0,0,2020-2021,0.0,0.7692307692307692
437,Ander Capa,ESP,DF,Athletic Club,La Liga,28,1992,23.7,37,18,22,13,2,18,37,48.6,19,21,8,13,25,62,57,0,0,2020-2021,1.0548523206751055,1.5611814345991561
438,Pierrick Capelle,FRA,"MF,DF",Angers,Ligue 1,33,1987,22.8,53,28,24,17,12,31,79,39.2,48,25,1,24,47,100,32,0,0,2020-2021,2.06140350877193,2.324561403508772
439,Étienne Capoue,FRA,MF,Villarreal,La Liga,32,1988,13.2,20,10,14,6,0,8,18,44.4,10,7,1,6,20,40,23,0,0,2020-2021,1.5151515151515151,1.5151515151515151
440,Elio Capradossi,UGA,DF,Spezia,Serie A,24,1996,1.0,2,1,2,0,0,2,2,100.0,0,0,0,0,1,3,5,0,0,2020-2021,1.0,2.0
441,Gianluca Caprari,ITA,"MF,FW",Benevento,Serie A,27,1993,20.7,16,11,5,5,6,6,31,19.4,25,19,1,18,18,34,8,0,0,2020-2021,0.8695652173913043,0.7729468599033816
442,Francesco Caputo,ITA,FW,Sassuolo,Serie A,32,1987,18.9,0,0,0,0,0,0,2,0.0,2,4,0,4,1,1,3,0,0,2020-2021,0.052910052910052914,0.0
443,Maxence Caqueret,FRA,MF,Lyon,Ligue 1,20,2000,19.6,72,45,17,39,16,35,106,33.0,71,35,3,32,23,95,5,2,0,2020-2021,1.173469387755102,3.6734693877551017
444,Andrea Carboni,ITA,DF,Cagliari,Serie A,19,2001,12.1,34,23,23,11,0,15,28,53.6,13,15,4,11,14,48,52,0,0,2020-2021,1.15702479338843,2.809917355371901
445,Isaac Carcelen,ESP,DF,Cádiz,La Liga,27,1993,28.7,68,43,36,25,7,33,60,55.0,27,37,12,25,49,117,89,0,0,2020-2021,1.7073170731707317,2.3693379790940767
446,Cárdenas,ESP,GK,Levante,La Liga,23,1997,8.0,0,0,0,0,0,0,1,0.0,1,0,0,0,3,3,5,1,0,2020-2021,0.375,0.0
447,Irvin Cardona,FRA,FW,Brest,Ligue 1,22,1997,22.5,10,5,3,6,1,4,22,18.2,18,17,3,14,9,19,23,2,0,2020-2021,0.4,0.4444444444444444
448,Marc Cardona,ESP,"FW,DF",Osasuna,La Liga,25,1995,0.6,1,0,1,0,0,1,1,100.0,0,0,0,0,0,1,0,0,0,2020-2021,0.0,1.6666666666666667
449,Diego Carlos,BRA,DF,Sevilla,La Liga,27,1993,31.0,22,13,17,4,1,8,16,50.0,8,35,27,8,31,53,114,1,0,2020-2021,1.0,0.7096774193548387
450,Juan Carlos,ESP,"MF,FW",Huesca,La Liga,29,1991,3.2,5,3,4,1,0,2,15,13.3,13,7,0,7,1,6,1,0,0,2020-2021,0.3125,1.5625
Rk,Player,Nation,Pos,Squad,Comp,0,0,90.0,0,0,3,3,3,Tkl,0,0.0,0,0,0,0,0,0,0,0,0,2020-2021,0.0,0.0
451,Lionel Carole,FRA,DF,Strasbourg,Ligue 1,29,1991,14.9,37,25,18,14,5,16,29,55.2,13,3,1,2,38,75,28,0,0,2020-2021,2.5503355704697985,2.483221476510067
452,Yannick Carrasco,BEL,"DF,MF",Atlético Madrid,La Liga,26,1993,24.2,27,15,14,6,7,15,34,44.1,19,24,0,24,17,44,16,1,0,2020-2021,0.7024793388429752,1.115702479338843
453,Sergio Carreira,ESP,DF,Celta Vigo,La Liga,19,2000,2.9,3,0,2,1,0,1,1,100.0,0,2,0,2,1,4,7,0,0,2020-2021,0.3448275862068966,1.0344827586206897
454,Guido Carrillo,ARG,FW,Elche,La Liga,29,1991,11.1,9,8,1,7,1,2,8,25.0,6,2,1,1,4,13,14,0,0,2020-2021,0.3603603603603604,0.8108108108108109
455,Andy Carroll,ENG,FW,Newcastle Utd,Premier League,31,1989,4.4,3,1,1,1,1,1,8,12.5,7,1,0,1,0,3,14,0,0,2020-2021,0.0,0.6818181818181818
456,Scott Carson,ENG,GK,Manchester City,Premier League,34,1985,1.0,0,0,0,0,0,0,0,0.0,0,0,0,0,0,0,0,0,0,2020-2021,0.0,0.0
457,Dani Carvajal,ESP,DF,Real Madrid,La Liga,28,1992,10.6,27,20,12,10,5,11,20,55.0,9,19,1,18,13,40,27,0,0,2020-2021,1.2264150943396226,2.547169811320755
458,Fabio Carvalho,POR,"MF,FW",Fulham,Premier League,17,2002,2.8,9,6,4,4,1,5,9,55.6,4,2,0,2,1,10,1,1,0,2020-2021,0.35714285714285715,3.2142857142857144
459,William Carvalho,POR,MF,Betis,La Liga,28,1992,13.6,19,12,7,11,1,5,21,23.8,16,11,3,8,11,30,14,1,0,2020-2021,0.8088235294117647,1.397058823529412
460,Casemiro,BRA,MF,Real Madrid,La Liga,28,1992,32.2,84,49,50,30,4,33,73,45.2,40,50,17,33,70,154,62,0,0,2020-2021,2.1739130434782608,2.6086956521739126
461,Matty Cash,POL,DF,Aston Villa,Premier League,22,1997,26.4,71,40,43,22,6,41,74,55.4,33,50,11,39,60,131,95,0,0,2020-2021,2.272727272727273,2.6893939393939394
462,Kiko Casilla,ESP,GK,Leeds United,Premier League,33,1986,3.0,0,0,0,0,0,0,0,0.0,0,0,0,0,0,0,0,0,0,2020-2021,0.0,0.0
463,Giuseppe Caso,ITA,"DF,FW",Genoa,Serie A,21,1998,0.6,0,0,0,0,0,0,0,0.0,0,0,0,0,0,0,0,0,0,2020-2021,0.0,0.0
464,Moreto Cassamã,GNB,MF,Reims,Ligue 1,22,1998,22.6,49,36,24,23,2,27,49,55.1,22,19,6,13,36,85,33,4,0,2020-2021,1.5929203539823007,2.168141592920354
465,Francesco Cassata,ITA,"DF,FW",Genoa,Serie A,23,1997,2.5,7,6,7,0,0,4,7,57.1,3,0,0,0,3,10,1,0,0,2020-2021,1.2,2.8
466,Timothy Castagne,BEL,DF,Leicester City,Premier League,24,1995,26.1,52,32,29,18,5,24,44,54.5,20,29,5,24,29,81,62,1,0,2020-2021,1.1111111111111112,1.9923371647509578
467,Koen Casteels,BEL,GK,Wolfsburg,Bundesliga,28,1992,32.0,0,0,0,0,0,0,1,0.0,1,1,0,1,2,2,9,2,0,2020-2021,0.0625,0.0
468,Jean-Charles Castelletto,CMR,DF,Nantes,Ligue 1,25,1995,21.6,32,18,20,11,1,18,31,58.1,13,25,19,6,42,74,79,0,0,2020-2021,1.9444444444444444,1.4814814814814814
469,Samu Castillejo,ESP,FW,Milan,Serie A,25,1995,13.1,24,12,9,14,1,14,40,35.0,26,21,0,21,6,30,9,0,0,2020-2021,0.4580152671755725,1.83206106870229
470,Gonzalo Castro,GER,MF,Stuttgart,Bundesliga,33,1987,19.2,21,7,6,9,6,8,23,34.8,15,16,3,13,8,29,12,0,0,2020-2021,0.4166666666666667,1.09375
471,Jonny Castro,ESP,"MF,DF",Wolves,Premier League,26,1994,5.5,11,5,6,4,1,6,13,46.2,7,9,3,6,9,20,7,0,0,2020-2021,1.6363636363636365,2.0
472,Gaetano Castrovilli,ITA,MF,Fiorentina,Serie A,23,1997,25.9,33,19,15,11,7,11,42,26.2,31,25,2,23,34,67,14,0,0,2020-2021,1.3127413127413128,1.2741312741312742
473,Danilo Cataldi,ITA,MF,Lazio,Serie A,25,1994,6.3,7,2,1,5,1,4,18,22.2,14,3,1,2,9,16,7,0,0,2020-2021,1.4285714285714286,1.1111111111111112
474,Ivan Cavaleiro,POR,FW,Fulham,Premier League,26,1993,27.5,23,14,9,11,3,12,34,35.3,22,25,1,24,19,42,14,0,0,2020-2021,0.6909090909090909,0.8363636363636363
475,Edinson Cavani,URU,FW,Manchester Utd,Premier League,33,1987,15.3,12,8,1,8,3,2,13,15.4,11,2,0,2,6,18,11,0,0,2020-2021,0.39215686274509803,0.7843137254901961
Rk,Player,Nation,Pos,Squad,Comp,0,0,90.0,0,0,3,3,3,Tkl,0,0.0,0,0,0,0,0,0,0,0,0,2020-2021,0.0,0.0
476,Dani Ceballos,ESP,MF,Arsenal,Premier League,23,1996,17.9,37,22,20,11,6,21,51,41.2,30,23,6,17,35,72,14,1,0,2020-2021,1.9553072625698324,2.0670391061452515
477,Federico Ceccherini,ITA,DF,Hellas Verona,Serie A,28,1992,19.3,16,12,10,6,0,2,7,28.6,5,15,8,7,40,56,60,0,0,2020-2021,2.0725388601036268,0.8290155440414507
478,Federico Ceccherini,ITA,DF,Fiorentina,Serie A,28,1992,3.0,4,1,1,3,0,1,1,100.0,0,6,5,1,7,11,15,0,0,2020-2021,2.3333333333333335,1.3333333333333333
479,Zeki Çelik,TUR,DF,Lille,Ligue 1,23,1997,26.5,72,33,30,30,12,44,81,54.3,37,32,6,26,38,110,52,0,0,2020-2021,1.4339622641509433,2.7169811320754715
480,Bersant Celina,KVX,"MF,FW",Dijon,Ligue 1,23,1996,25.5,20,12,8,8,4,7,38,18.4,31,20,2,18,8,28,10,0,0,2020-2021,0.3137254901960784,0.7843137254901961
481,Fabien Centonze,FRA,DF,Metz,Ligue 1,24,1996,35.8,104,68,64,30,10,43,73,58.9,30,62,17,45,112,216,119,1,0,2020-2021,3.128491620111732,2.905027932960894
482,Luca Ceppitelli,ITA,DF,Cagliari,Serie A,30,1989,16.3,25,19,13,10,2,14,26,53.8,12,23,12,11,25,50,58,1,0,2020-2021,1.5337423312883436,1.5337423312883436
483,Alberto Cerri,ITA,FW,Cagliari,Serie A,24,1996,4.1,3,2,0,2,1,0,5,0.0,5,4,2,2,2,5,6,0,0,2020-2021,0.48780487804878053,0.7317073170731708
484,Sava Cestic,SRB,DF,Köln,Bundesliga,19,2001,10.0,20,9,12,6,2,8,17,47.1,9,13,4,9,18,38,40,0,0,2020-2021,1.8,2.0
485,Julian Chabot,GER,DF,Spezia,Serie A,22,1998,18.4,48,34,28,16,4,23,37,62.2,14,25,13,12,37,85,43,1,0,2020-2021,2.0108695652173916,2.608695652173913
486,Nassim Chadli,FRA,"FW,MF",Nîmes,Ligue 1,19,2001,0.3,2,1,2,0,0,0,1,0.0,1,1,0,1,0,2,0,0,0,2020-2021,0.0,6.666666666666667
487,Fouad Chafik,MAR,DF,Dijon,Ligue 1,33,1986,18.0,39,24,29,8,2,16,35,45.7,19,19,10,9,21,60,41,0,0,2020-2021,1.1666666666666667,2.1666666666666665
488,Mehdi Chahiri,MAR,"FW,MF",Strasbourg,Ligue 1,24,1996,8.9,18,8,7,5,6,8,20,40.0,12,9,0,9,6,24,5,0,0,2020-2021,0.6741573033707865,2.0224719101123596
489,Sofian Chakla,MAR,DF,Villarreal,La Liga,26,1993,0.1,0,0,0,0,0,0,0,0.0,0,0,0,0,0,0,0,0,0,2020-2021,0.0,0.0
490,Sofian Chakla,MAR,DF,Getafe,La Liga,26,1993,10.0,12,8,10,1,1,5,7,71.4,2,3,2,1,14,26,48,1,0,2020-2021,1.4,1.2
491,Aníbal Chalá,ECU,DF,Dijon,Ligue 1,24,1996,8.3,10,7,6,3,1,6,12,50.0,6,5,3,2,14,24,15,1,0,2020-2021,1.686746987951807,1.2048192771084336
492,Trevoh Chalobah,ENG,"DF,MF",Lorient,Ligue 1,21,1999,24.9,45,26,32,13,0,24,50,48.0,26,20,7,13,69,114,56,0,0,2020-2021,2.771084337349398,1.8072289156626506
493,Calum Chambers,ENG,DF,Arsenal,Premier League,25,1995,8.4,7,3,3,2,2,3,8,37.5,5,6,2,4,10,17,37,0,0,2020-2021,1.1904761904761905,0.8333333333333333
494,Timothy Chandler,USA,DF,Eint Frankfurt,Bundesliga,30,1990,4.8,4,0,2,1,1,1,4,25.0,3,5,2,3,3,7,5,0,0,2020-2021,0.625,0.8333333333333334
495,Kwon Chang-hoon,KOR,"MF,FW",Freiburg,Bundesliga,26,1994,2.4,3,1,1,0,2,1,3,33.3,2,3,1,2,7,10,2,1,0,2020-2021,2.916666666666667,1.25
496,Gaëtan Charbonnier,FRA,"MF,FW",Brest,Ligue 1,31,1988,17.4,24,15,6,11,7,12,32,37.5,20,15,1,14,9,33,19,0,0,2020-2021,0.5172413793103449,1.3793103448275863
497,Brendan Chardonnet,FRA,DF,Brest,Ligue 1,25,1994,30.2,51,29,31,19,1,27,41,65.9,14,54,41,13,64,115,151,0,0,2020-2021,2.119205298013245,1.6887417218543046
498,Xavier Chavalerin,FRA,MF,Reims,Ligue 1,29,1991,28.3,92,50,47,38,7,26,74,35.1,48,43,9,34,43,135,29,1,0,2020-2021,1.519434628975265,3.2508833922261484
499,Pape Cheikh Diop,SEN,MF,Dijon,Ligue 1,22,1997,12.1,24,14,15,6,3,13,33,39.4,20,14,2,12,6,30,6,0,0,2020-2021,0.49586776859504134,1.9834710743801653
500,Chema,ESP,"DF,MF",Getafe,La Liga,28,1992,6.2,11,5,6,5,0,5,7,71.4,2,1,0,1,10,21,23,0,0,2020-2021,1.6129032258064515,1.7741935483870968
Rk,Player,Nation,Pos,Squad,Comp,0,0,90.0,0,0,3,3,3,Tkl,0,0.0,0,0,0,0,0,0,0,0,0,2020-2021,0.0,0.0
501,Rayan Cherki,FRA,"FW,MF",Lyon,Ligue 1,16,2003,7.8,5,3,0,3,2,1,11,9.1,10,3,0,3,4,9,0,0,0,2020-2021,0.5128205128205129,0.6410256410256411
502,Denis Cheryshev,RUS,MF,Valencia,La Liga,29,1990,12.2,19,15,6,7,6,6,26,23.1,20,15,1,14,12,31,15,0,0,2020-2021,0.9836065573770493,1.557377049180328
503,Giorgio Chiellini,ITA,DF,Juventus,Serie A,35,1984,15.4,12,9,9,3,0,5,11,45.5,6,18,13,5,27,39,56,0,0,2020-2021,1.7532467532467533,0.7792207792207793
504,Federico Chiesa,ITA,DF,Fiorentina,Serie A,22,1997,2.7,6,2,2,2,2,3,8,37.5,5,3,1,2,1,7,3,0,0,2020-2021,0.37037037037037035,2.222222222222222
505,Federico Chiesa,ITA,"MF,DF",Juventus,Serie A,22,1997,24.6,47,26,21,14,12,19,50,38.0,31,23,1,22,12,59,16,0,0,2020-2021,0.4878048780487805,1.9105691056910568
506,Ben Chilwell,ENG,DF,Chelsea,Premier League,23,1996,25.4,42,22,16,22,4,15,33,45.5,18,28,3,25,24,66,58,0,0,2020-2021,0.9448818897637796,1.6535433070866143
507,Vlad Chiricheș,ROU,DF,Sassuolo,Serie A,30,1989,20.4,38,23,34,3,1,21,35,60.0,14,31,21,10,50,88,59,2,0,2020-2021,2.450980392156863,1.8627450980392157
508,Pedro Chirivella,ESP,MF,Nantes,Ligue 1,23,1997,25.3,26,8,7,13,6,14,49,28.6,35,23,4,19,41,67,19,0,0,2020-2021,1.6205533596837944,1.0276679841897234
509,Tahith Chong,NED,"MF,FW",Werder Bremen,Bundesliga,20,1999,4.3,11,6,1,9,1,4,8,50.0,4,4,0,4,5,16,1,0,0,2020-2021,1.1627906976744187,2.558139534883721
510,Joris Chotard,FRA,MF,Montpellier,Ligue 1,18,2001,12.9,12,8,5,6,1,6,31,19.4,25,12,3,9,11,23,15,0,0,2020-2021,0.8527131782945736,0.9302325581395349
511,Hamza Choudhury,ENG,MF,Leicester City,Premier League,22,1997,3.5,8,7,3,5,0,4,10,40.0,6,4,1,3,4,12,9,1,0,2020-2021,1.1428571428571428,2.2857142857142856
512,Mounir Chouiar,FRA,"FW,MF",Dijon,Ligue 1,21,1999,14.3,22,12,10,9,3,6,18,33.3,12,10,0,10,11,33,8,0,0,2020-2021,0.7692307692307692,1.5384615384615383
513,Andreas Christensen,DEN,DF,Chelsea,Premier League,24,1996,15.2,11,6,8,3,0,0,8,0.0,8,19,14,5,20,31,51,1,0,2020-2021,1.3157894736842106,0.7236842105263158
514,Carney Chukwuemeka,ENG,"MF,FW",Aston Villa,Premier League,16,2003,0.2,2,2,1,0,1,1,3,33.3,2,0,0,0,0,2,0,0,0,2020-2021,0.0,10.0
515,Samuel Chukwueze,NGA,"MF,FW",Villarreal,La Liga,21,1999,15.2,12,7,4,4,4,3,17,17.6,14,8,0,8,10,22,3,0,0,2020-2021,0.6578947368421053,0.7894736842105263
516,Darko Churlinov,MKD,"DF,MF",Stuttgart,Bundesliga,20,2000,2.4,2,2,2,0,0,1,3,33.3,2,5,1,4,0,2,2,0,0,2020-2021,0.0,0.8333333333333334
517,Víctor Chust,ESP,DF,Real Madrid,La Liga,20,2000,1.1,1,1,0,1,0,0,2,0.0,2,2,2,0,1,2,5,0,0,2020-2021,0.9090909090909091,0.9090909090909091
518,Sébastien Cibois,FRA,GK,Brest,Ligue 1,22,1998,3.0,0,0,0,0,0,0,0,0.0,0,0,0,0,0,0,0,1,0,2020-2021,0.0,0.0
519,Cifu,ESP,DF,Elche,La Liga,29,1990,5.0,10,7,7,3,0,7,13,53.8,6,5,1,4,8,18,10,0,0,2020-2021,1.6,2.0
520,Alberto Cifuentes,ESP,GK,Cádiz,La Liga,41,1979,2.0,0,0,0,0,0,0,0,0.0,0,0,0,0,0,0,0,0,0,2020-2021,0.0,0.0
521,Luca Cigarini,ITA,MF,Crotone,Serie A,34,1986,10.3,26,14,11,12,3,12,28,42.9,16,10,1,9,12,38,9,0,0,2020-2021,1.1650485436893203,2.524271844660194
522,Jasper Cillessen,NED,GK,Valencia,La Liga,31,1989,10.0,0,0,0,0,0,0,0,0.0,0,0,0,0,0,0,0,0,0,2020-2021,0.0,0.0
523,Antonio Cioffi,ITA,FW,Napoli,Serie A,17,2002,0.1,0,0,0,0,0,0,0,0.0,0,1,0,1,1,1,0,0,0,2020-2021,10.0,0.0
524,Tim Civeja,ALB,MF,Augsburg,Bundesliga,18,2002,0.4,0,0,0,0,0,0,1,0.0,1,0,0,0,3,3,0,0,0,2020-2021,7.5,0.0
525,Ciaran Clark,IRL,DF,Newcastle Utd,Premier League,30,1989,21.0,24,14,15,6,3,6,13,46.2,7,27,20,7,29,53,104,1,0,2020-2021,1.380952380952381,1.1428571428571428
Rk,Player,Nation,Pos,Squad,Comp,0,0,90.0,0,0,3,3,3,Tkl,0,0.0,0,0,0,0,0,0,0,0,0,2020-2021,0.0,0.0
526,Alexis Claude-Maurice,FRA,"MF,FW",Nice,Ligue 1,22,1998,21.2,40,19,17,14,9,14,48,29.2,34,16,2,14,14,54,3,0,0,2020-2021,0.6603773584905661,1.8867924528301887
527,Jonathan Clauss,FRA,DF,Lens,Ligue 1,27,1992,28.0,43,20,12,20,11,17,38,44.7,21,24,1,23,45,88,46,0,0,2020-2021,1.6071428571428572,1.5357142857142858
528,Carlos Clerc,ESP,DF,Levante,La Liga,28,1992,30.9,56,29,33,16,7,22,39,56.4,17,26,4,22,37,93,55,1,0,2020-2021,1.197411003236246,1.8122977346278317
529,Nathaniel Clyne,ENG,DF,Crystal Palace,Premier League,29,1991,12.7,17,10,8,8,1,9,16,56.3,7,7,2,5,18,35,25,1,0,2020-2021,1.4173228346456694,1.3385826771653544
530,Conor Coady,ENG,DF,Wolves,Premier League,27,1993,36.7,35,23,25,10,0,19,35,54.3,16,40,32,8,27,62,134,2,0,2020-2021,0.7356948228882834,0.9536784741144413
531,Marcus Coco,FRA,"MF,FW",Nantes,Ligue 1,24,1996,16.4,36,21,17,15,4,16,36,44.4,20,16,3,13,20,56,17,0,0,2020-2021,1.2195121951219514,2.1951219512195124
532,Coke,ESP,DF,Levante,La Liga,33,1987,9.3,24,10,14,7,3,14,27,51.9,13,13,1,12,14,38,27,0,0,2020-2021,1.5053763440860215,2.5806451612903225
533,Séamus Coleman,IRL,"DF,MF",Everton,Premier League,31,1988,17.9,39,26,21,14,4,21,30,70.0,9,22,6,16,13,52,37,2,0,2020-2021,0.7262569832402235,2.1787709497206706
534,Ebrima Colley,GAM,"MF,FW",Hellas Verona,Serie A,20,2000,8.2,11,4,2,6,3,3,11,27.3,8,6,0,6,6,17,1,0,0,2020-2021,0.7317073170731708,1.3414634146341464
535,Omar Colley,GAM,DF,Sampdoria,Serie A,27,1992,28.8,28,16,19,8,1,13,23,56.5,10,43,29,14,68,96,133,1,0,2020-2021,2.361111111111111,0.9722222222222222
536,Simone Colombi,ITA,GK,Parma,Serie A,29,1991,2.0,0,0,0,0,0,0,0,0.0,0,0,0,0,0,0,2,0,0,2020-2021,0.0,0.0
537,Lorenzo Colombo,ITA,FW,Milan,Serie A,18,2002,1.0,2,1,1,1,0,0,3,0.0,3,0,0,0,0,2,3,0,0,2020-2021,0.0,2.0
538,Racine Coly,SEN,MF,Nice,Ligue 1,24,1995,0.2,0,0,0,0,0,0,0,0.0,0,0,0,0,0,0,0,0,0,2020-2021,0.0,0.0
539,Kingsley Coman,FRA,"FW,MF",Bayern Munich,Bundesliga,24,1996,19.5,14,8,6,7,1,2,21,9.5,19,22,0,22,4,18,3,0,0,2020-2021,0.20512820512820512,0.717948717948718
540,Daniel Congré,FRA,DF,Montpellier,Ligue 1,35,1985,36.6,59,35,45,12,2,36,70,51.4,34,50,33,17,69,128,144,3,0,2020-2021,1.8852459016393441,1.6120218579234973
541,Aaron Connolly,IRL,FW,Brighton,Premier League,20,2000,8.8,6,3,1,3,2,0,2,0.0,2,4,0,4,0,6,2,0,0,2020-2021,0.0,0.6818181818181818
542,Andrea Consigli,ITA,GK,Sassuolo,Serie A,33,1987,37.0,2,2,2,0,0,2,2,100.0,0,0,0,0,0,2,14,4,0,2020-2021,0.0,0.05405405405405406
543,Andrea Conti,ITA,DF,Milan,Serie A,26,1994,0.3,1,1,1,0,0,0,1,0.0,1,0,0,0,1,2,0,0,0,2020-2021,3.3333333333333335,3.3333333333333335
544,Andrea Conti,ITA,DF,Parma,Serie A,26,1994,9.0,21,10,16,4,1,13,26,50.0,13,13,4,9,16,37,23,0,0,2020-2021,1.7777777777777777,2.3333333333333335
545,Liam Cooper,SCO,DF,Leeds United,Premier League,28,1991,24.3,68,45,39,27,2,37,59,62.7,22,39,32,7,61,129,70,1,0,2020-2021,2.5102880658436213,2.7983539094650203
546,Francis Coquelin,FRA,MF,Villarreal,La Liga,29,1991,8.2,19,14,4,12,3,8,19,42.1,11,8,2,6,21,40,11,1,0,2020-2021,2.5609756097560976,2.3170731707317076
547,Theo Corbeanu,CAN,FW,Wolves,Premier League,18,2002,0.1,2,1,0,2,0,1,1,100.0,0,0,0,0,1,3,0,0,0,2020-2021,10.0,20.0
548,Sébastien Corchia,FRA,DF,Nantes,Ligue 1,29,1990,23.0,55,30,29,17,9,33,60,55.0,27,28,10,18,38,93,40,1,0,2020-2021,1.6521739130434783,2.391304347826087
549,Alex Cordaz,ITA,GK,Crotone,Serie A,37,1983,36.0,0,0,0,0,0,0,0,0.0,0,0,0,0,1,1,7,2,0,2020-2021,0.027777777777777776,0.0
550,Iñigo Córdoba,ESP,"FW,MF",Athletic Club,La Liga,23,1997,1.1,0,0,0,0,0,0,3,0.0,3,4,0,4,2,2,1,0,0,2020-2021,1.8181818181818181,0.0
Rk,Player,Nation,Pos,Squad,Comp,0,0,90.0,0,0,3,3,3,Tkl,0,0.0,0,0,0,0,0,0,0,0,0,2020-2021,0.0,0.0
551,Iñigo Córdoba,ESP,MF,Alavés,La Liga,23,1997,2.4,6,4,1,3,2,2,10,20.0,8,7,0,7,3,9,2,0,0,2020-2021,1.25,2.5
552,Jhon Córdoba,COL,FW,Hertha BSC,Bundesliga,27,1993,17.1,9,4,1,5,3,2,4,50.0,2,13,2,11,6,15,4,0,0,2020-2021,0.3508771929824561,0.5263157894736842
553,Sergio Córdova,VEN,"FW,MF",Arminia,Bundesliga,22,1997,12.1,16,8,0,10,6,2,15,13.3,13,14,3,11,9,25,9,0,0,2020-2021,0.7438016528925621,1.322314049586777
554,Jack Cork,ENG,MF,Burnley,Premier League,31,1989,15.0,26,10,5,17,4,11,31,35.5,20,15,4,11,16,42,20,0,0,2020-2021,1.0666666666666667,1.7333333333333334
555,Andreas Cornelius,DEN,FW,Parma,Serie A,27,1993,21.1,11,4,1,5,5,2,12,16.7,10,9,2,7,1,12,25,1,0,2020-2021,0.04739336492890995,0.5213270142180094
556,Maxwel Cornet,CIV,"DF,FW",Lyon,Ligue 1,23,1996,27.2,70,41,39,24,7,33,58,56.9,25,23,5,18,43,113,47,2,0,2020-2021,1.5808823529411764,2.573529411764706
557,Ángel Correa,ARG,"FW,MF",Atlético Madrid,La Liga,25,1995,26.6,38,21,10,23,5,15,45,33.3,30,18,1,17,22,60,16,0,0,2020-2021,0.8270676691729323,1.4285714285714286
558,Joaquín Correa,ARG,FW,Lazio,Serie A,25,1994,21.5,21,12,6,11,4,7,25,28.0,18,14,0,14,7,28,12,0,0,2020-2021,0.32558139534883723,0.9767441860465116
559,Rober Correa,ESP,DF,Eibar,La Liga,27,1992,12.6,16,9,8,6,2,8,12,66.7,4,9,1,8,20,36,31,0,0,2020-2021,1.5873015873015874,1.2698412698412698
560,Félix Correia,POR,MF,Juventus,Serie A,19,2001,0.1,0,0,0,0,0,0,0,0.0,0,0,0,0,0,0,1,0,0,2020-2021,0.0,0.0
561,Thierry Correia,POR,DF,Valencia,La Liga,21,1999,23.7,47,27,32,10,5,21,43,48.8,22,24,6,18,42,89,63,1,0,2020-2021,1.7721518987341773,1.9831223628691983
562,Danny da Costa,GER,"DF,FW",Mainz 05,Bundesliga,27,1993,13.4,22,16,6,9,7,13,27,48.1,14,17,2,15,17,39,27,0,0,2020-2021,1.2686567164179103,1.6417910447761193
563,Danny da Costa,GER,DF,Eint Frankfurt,Bundesliga,27,1993,1.2,0,0,0,0,0,0,1,0.0,1,3,1,2,0,0,4,0,0,2020-2021,0.0,0.0
564,David Pereira da Costa,POR,"MF,FW",Lens,Ligue 1,19,2001,1.8,4,4,1,2,1,2,3,66.7,1,2,0,2,0,4,4,0,0,2020-2021,0.0,2.2222222222222223
565,Diego Costa,ESP,FW,Atlético Madrid,La Liga,31,1988,2.3,1,0,1,0,0,1,3,33.3,2,0,0,0,0,1,2,0,0,2020-2021,0.0,0.4347826086956522
566,Douglas Costa,BRA,"MF,FW",Juventus,Serie A,29,1990,0.5,1,0,1,0,0,1,3,33.3,2,0,0,0,0,1,0,0,0,2020-2021,0.0,2.0
567,Douglas Costa,BRA,"FW,MF",Bayern Munich,Bundesliga,29,1990,3.6,2,1,1,1,0,1,3,33.3,2,7,0,7,2,4,1,0,0,2020-2021,0.5555555555555556,0.5555555555555556
568,Hélder Costa,ANG,"MF,FW",Leeds United,Premier League,26,1994,12.8,25,11,12,5,8,11,32,34.4,21,11,0,11,3,28,5,1,0,2020-2021,0.234375,1.953125
569,Jaume Costa,ESP,"DF,MF",Villarreal,La Liga,32,1988,3.9,10,6,4,6,0,7,9,77.8,2,7,1,6,6,16,8,0,0,2020-2021,1.5384615384615385,2.5641025641025643
570,Angelo da Costa Júnior,BRA,GK,Bologna,Serie A,36,1983,6.0,0,0,0,0,0,0,0,0.0,0,0,0,0,0,0,2,3,0,2020-2021,0.0,0.0
571,Charles Costes,FRA,MF,Dijon,Ligue 1,17,2002,0.0,0,0,0,0,0,0,0,0.0,0,0,0,0,0,0,0,0,0,2020-2021,,
572,Benoît Costil,FRA,GK,Bordeaux,Ligue 1,33,1987,38.0,1,1,1,0,0,1,3,33.3,2,1,0,1,1,2,17,0,0,2020-2021,0.02631578947368421,0.02631578947368421
573,Vladimír Coufal,CZE,DF,West Ham,Premier League,27,1992,33.9,73,36,50,15,8,52,89,58.4,37,41,7,34,41,114,102,1,0,2020-2021,1.2094395280235988,2.1533923303834808
574,Kalifa Coulibaly,MLI,FW,Nantes,Ligue 1,28,1991,10.9,3,1,0,1,2,2,8,25.0,6,3,1,2,2,5,12,0,0,2020-2021,0.18348623853211007,0.27522935779816515
575,Lassana Coulibaly,MLI,MF,Angers,Ligue 1,24,1996,18.7,78,41,33,34,11,39,75,52.0,36,29,4,25,33,111,17,0,0,2020-2021,1.7647058823529413,4.171122994652406
Rk,Player,Nation,Pos,Squad,Comp,0,0,90.0,0,0,3,3,3,Tkl,0,0.0,0,0,0,0,0,0,0,0,0,2020-2021,0.0,0.0
576,Mamadou Coulibaly,SEN,MF,Udinese,Serie A,21,1999,2.0,10,8,5,5,0,0,0,0.0,0,2,0,2,1,11,0,0,0,2020-2021,0.5,5.0
577,Senou Coulibaly,MLI,DF,Dijon,Ligue 1,25,1994,21.5,33,21,23,10,0,12,24,50.0,12,18,12,6,30,63,89,0,0,2020-2021,1.3953488372093024,1.5348837209302326
578,Tanguy Coulibaly,FRA,"DF,FW",Stuttgart,Bundesliga,19,2001,16.7,26,15,10,7,9,11,23,47.8,12,20,0,20,10,36,11,0,0,2020-2021,0.5988023952095809,1.5568862275449102
579,Thibaut Courtois,BEL,GK,Real Madrid,La Liga,28,1992,38.0,0,0,0,0,0,0,1,0.0,1,1,0,1,1,1,17,2,0,2020-2021,0.02631578947368421,0.0
580,Philippe Coutinho,BRA,"MF,FW",Barcelona,La Liga,28,1992,7.3,8,6,2,5,1,3,9,33.3,6,7,0,7,2,10,1,0,0,2020-2021,0.273972602739726,1.095890410958904
581,Nicolas Cozza,FRA,DF,Montpellier,Ligue 1,21,1999,15.2,39,30,27,11,1,20,40,50.0,20,20,11,9,26,65,62,0,0,2020-2021,1.7105263157894737,2.5657894736842106
582,Alessio Cragno,ITA,GK,Cagliari,Serie A,26,1994,34.0,0,0,0,0,0,0,1,0.0,1,0,0,0,1,1,10,0,0,2020-2021,0.029411764705882353,0.0
583,Gian Crespi,ITA,GK,Crotone,Serie A,19,2001,1.0,0,0,0,0,0,0,0,0.0,0,0,0,0,0,0,0,0,0,2020-2021,0.0,0.0
584,Aaron Cresswell,ENG,DF,West Ham,Premier League,30,1989,35.2,32,13,15,15,2,18,32,56.3,14,29,14,15,32,64,79,2,0,2020-2021,0.9090909090909091,0.9090909090909091
585,Domenico Criscito,ITA,DF,Genoa,Serie A,33,1986,19.2,43,22,29,11,3,22,39,56.4,17,27,14,13,44,87,51,0,0,2020-2021,2.291666666666667,2.2395833333333335
586,Bryan Cristante,ITA,"DF,MF",Roma,Serie A,25,1995,23.9,27,20,10,14,3,10,28,35.7,18,21,7,14,40,67,61,1,0,2020-2021,1.6736401673640169,1.1297071129707115
587,Giovanni Crociata,ITA,DF,Crotone,Serie A,22,1997,0.3,1,0,0,1,0,0,1,0.0,1,1,0,1,0,1,0,0,0,2020-2021,0.0,3.3333333333333335
588,Juan Cruz Armada,ESP,DF,Osasuna,La Liga,28,1992,21.8,36,22,17,16,3,19,35,54.3,16,19,5,14,15,51,50,0,0,2020-2021,0.6880733944954128,1.6513761467889907
589,Juan Cuadrado,COL,"DF,MF",Juventus,Serie A,32,1988,24.2,43,25,22,15,6,29,60,48.3,31,16,2,14,43,86,22,2,0,2020-2021,1.7768595041322315,1.7768595041322315
590,Andrés Cubas,PAR,MF,Nîmes,Ligue 1,24,1996,24.9,80,47,30,44,6,33,74,44.6,41,37,10,27,50,130,29,3,0,2020-2021,2.0080321285140563,3.21285140562249
591,Sergio Cubero Ezcurra,ESP,MF,Eibar,La Liga,20,1999,0.0,0,0,0,0,0,0,0,0.0,0,0,0,0,0,0,0,0,0,2020-2021,,
592,Cucho,COL,"FW,MF",Getafe,La Liga,21,1999,16.3,19,10,1,14,4,2,23,8.7,21,18,1,17,6,25,8,0,0,2020-2021,0.36809815950920244,1.165644171779141
593,Marc Cucurella,ESP,MF,Getafe,La Liga,22,1998,36.0,64,51,19,40,5,25,66,37.9,41,45,4,41,40,104,27,0,0,2020-2021,1.1111111111111112,1.7777777777777777
594,Mickaël Cuisance,FRA,MF,Marseille,Ligue 1,20,1999,11.4,24,11,2,15,7,10,33,30.3,23,13,1,12,3,27,4,0,0,2020-2021,0.2631578947368421,2.1052631578947367
595,Mickaël Cuisance,FRA,FW,Bayern Munich,Bundesliga,20,1999,0.2,0,0,0,0,0,0,0,0.0,0,1,0,1,0,0,0,0,0,2020-2021,0.0,0.0
596,Matheus Cunha,BRA,"FW,MF",Hertha BSC,Bundesliga,21,1999,23.9,36,16,10,19,7,13,49,26.5,36,29,2,27,31,67,9,0,0,2020-2021,1.2970711297071131,1.5062761506276152
597,Giuseppe Cuomo,ITA,DF,Crotone,Serie A,22,1998,8.9,26,19,17,9,0,9,14,64.3,5,10,2,8,18,44,19,1,0,2020-2021,2.0224719101123596,2.9213483146067416
598,Patrick Cutrone,ITA,FW,Wolves,Premier League,22,1998,0.3,0,0,0,0,0,0,0,0.0,0,0,0,0,0,0,0,0,0,2020-2021,0.0,0.0
599,Patrick Cutrone,ITA,FW,Fiorentina,Serie A,22,1998,2.2,4,3,1,2,1,1,2,50.0,1,1,0,1,1,5,0,0,0,2020-2021,0.45454545454545453,1.8181818181818181
600,Patrick Cutrone,ITA,FW,Valencia,La Liga,22,1998,1.2,0,0,0,0,0,0,1,0.0,1,0,0,0,1,1,0,0,0,2020-2021,0.8333333333333334,0.0
Rk,Player,Nation,Pos,Squad,Comp,0,0,90.0,0,0,3,3,3,Tkl,0,0.0,0,0,0,0,0,0,0,0,0,2020-2021,0.0,0.0
601,Wylan Cyprien,FRA,MF,Parma,Serie A,25,1995,4.6,9,4,5,3,1,2,4,50.0,2,13,8,5,5,14,6,1,0,2020-2021,1.0869565217391306,1.956521739130435
602,Rafael Czichos,GER,DF,Köln,Bundesliga,30,1990,25.1,48,24,33,13,2,23,42,54.8,19,25,9,16,53,101,109,0,0,2020-2021,2.1115537848605577,1.9123505976095616
603,Lennart-Marten Czyborra,GER,DF,Genoa,Serie A,21,1999,13.0,19,10,7,7,5,11,19,57.9,8,6,1,5,17,36,27,0,0,2020-2021,1.3076923076923077,1.4615384615384615
604,Danilo D'Ambrosio,ITA,DF,Inter,Serie A,31,1988,7.8,15,9,6,7,2,6,15,40.0,9,9,7,2,4,19,15,0,0,2020-2021,0.5128205128205129,1.9230769230769231
605,Damien Da Silva,FRA,DF,Rennes,Ligue 1,32,1988,29.6,22,13,13,8,1,12,18,66.7,6,17,13,4,44,66,99,1,0,2020-2021,1.4864864864864864,0.7432432432432432
606,Moanes Dabbur,ISR,"FW,MF",Hoffenheim,Bundesliga,28,1992,11.1,6,3,3,1,2,1,13,7.7,12,6,0,6,9,15,7,0,0,2020-2021,0.8108108108108109,0.5405405405405406
607,Bryan Dabo,BFA,MF,Benevento,Serie A,28,1992,12.4,11,8,5,3,3,5,16,31.3,11,7,1,6,13,24,16,0,0,2020-2021,1.0483870967741935,0.8870967741935484
608,Colin Dagba,FRA,DF,Paris S-G,Ligue 1,21,1998,15.1,23,11,4,17,2,14,19,73.7,5,18,5,13,16,39,18,1,0,2020-2021,1.0596026490066226,1.5231788079470199
609,Finn Dahmen,GER,GK,Mainz 05,Bundesliga,22,1998,3.0,0,0,0,0,0,0,1,0.0,1,0,0,0,0,0,1,0,0,2020-2021,0.0,0.0
610,Mahmoud Dahoud,GER,MF,Dortmund,Bundesliga,24,1996,14.0,30,18,9,20,1,14,38,36.8,24,23,5,18,18,48,11,1,0,2020-2021,1.2857142857142858,2.142857142857143
611,Leon Dajaku,GER,FW,Union Berlin,Bundesliga,19,2001,0.4,0,0,0,0,0,0,0,0.0,0,0,0,0,0,0,0,0,0,2020-2021,0.0,0.0
612,Stuart Dallas,NIR,"MF,DF",Leeds United,Premier League,29,1991,37.9,74,45,46,22,6,30,88,34.1,58,41,3,38,44,118,52,1,0,2020-2021,1.1609498680738786,1.9525065963060686
613,Diogo Dalot,POR,DF,Milan,Serie A,21,1999,12.1,32,17,23,6,3,17,34,50.0,17,18,5,13,25,57,42,0,0,2020-2021,2.066115702479339,2.644628099173554
614,Mikkel Damsgaard,DEN,"MF,FW",Sampdoria,Serie A,20,2000,19.7,42,21,14,20,8,22,70,31.4,48,40,4,36,24,66,17,0,0,2020-2021,1.218274111675127,2.1319796954314723
615,Flavius Daniliuc,AUT,DF,Nice,Ligue 1,19,2001,16.4,23,15,15,5,3,10,21,47.6,11,17,6,11,14,37,32,0,0,2020-2021,0.853658536585366,1.402439024390244
616,Danilo,BRA,"DF,MF",Juventus,Serie A,29,1991,32.4,62,31,37,16,9,35,66,53.0,31,32,12,20,66,128,68,2,0,2020-2021,2.037037037037037,1.9135802469135803
617,Scott Dann,ENG,DF,Crystal Palace,Premier League,33,1987,15.0,6,4,5,1,0,4,11,36.4,7,16,14,2,18,24,59,1,0,2020-2021,1.2,0.4
618,Tiago Dantas,POR,MF,Bayern Munich,Bundesliga,19,2000,0.8,1,1,0,0,1,0,0,0.0,0,0,0,0,0,1,0,0,0,2020-2021,0.0,1.25
619,Dante,BRA,DF,Nice,Ligue 1,36,1983,8.6,10,5,6,4,0,3,7,42.9,4,6,4,2,10,20,20,0,0,2020-2021,1.1627906976744187,1.1627906976744187
620,Andrea Danzi,ITA,DF,Hellas Verona,Serie A,21,1999,1.2,0,0,0,0,0,0,1,0.0,1,0,0,0,3,3,1,0,0,2020-2021,2.5,0.0
621,Ebrima Darboe,GAM,MF,Roma,Serie A,19,2001,3.6,5,2,3,1,1,3,10,30.0,7,3,0,3,8,13,0,1,0,2020-2021,2.2222222222222223,1.3888888888888888
622,Márton Dárdai,HUN,"DF,MF",Hertha BSC,Bundesliga,18,2002,9.1,17,10,10,6,1,9,16,56.3,7,7,3,4,16,33,31,0,0,2020-2021,1.7582417582417582,1.8681318681318682
623,Vladimír Darida,CZE,MF,Hertha BSC,Bundesliga,29,1990,21.1,34,19,11,19,4,9,31,29.0,22,34,2,32,27,61,18,0,0,2020-2021,1.2796208530805686,1.6113744075829384
624,Karl Darlow,ENG,GK,Newcastle Utd,Premier League,29,1990,25.0,0,0,0,0,0,0,0,0.0,0,0,0,0,0,0,17,0,0,2020-2021,0.0,0.0
625,Matteo Darmian,ITA,DF,Parma,Serie A,30,1989,2.3,6,5,3,3,0,4,7,57.1,3,2,0,2,6,12,7,0,0,2020-2021,2.608695652173913,2.608695652173913
Rk,Player,Nation,Pos,Squad,Comp,0,0,90.0,0,0,3,3,3,Tkl,0,0.0,0,0,0,0,0,0,0,0,0,2020-2021,0.0,0.0
626,Matteo Darmian,ITA,DF,Inter,Serie A,30,1989,12.9,30,16,12,7,11,16,28,57.1,12,9,2,7,17,47,35,0,0,2020-2021,1.317829457364341,2.3255813953488373
627,Jonathan David,CAN,FW,Lille,Ligue 1,20,2000,26.2,17,10,5,5,7,9,24,37.5,15,19,1,18,3,20,9,0,0,2020-2021,0.11450381679389313,0.648854961832061
628,Alphonso Davies,CAN,DF,Bayern Munich,Bundesliga,19,2000,19.6,39,27,16,17,6,28,40,70.0,12,21,1,20,28,67,33,1,0,2020-2021,1.4285714285714284,1.9897959183673468
629,Ben Davies,WAL,DF,Tottenham,Premier League,27,1993,15.0,27,17,10,11,6,13,30,43.3,17,10,5,5,18,45,49,2,0,2020-2021,1.2,1.8
630,Tom Davies,ENG,MF,Everton,Premier League,22,1998,15.8,31,18,17,12,2,16,39,41.0,23,15,9,6,34,65,21,2,0,2020-2021,2.151898734177215,1.9620253164556962
631,Keinan Davis,ENG,"FW,MF",Aston Villa,Premier League,22,1998,3.1,2,1,1,0,1,0,1,0.0,1,1,0,1,0,2,2,0,0,2020-2021,0.0,0.6451612903225806
632,Leif Davis,ENG,DF,Leeds United,Premier League,20,2000,0.4,0,0,0,0,0,0,3,0.0,3,1,0,1,1,1,0,0,0,2020-2021,2.5,0.0
633,Paweł Dawidowicz,POL,DF,Hellas Verona,Serie A,25,1995,20.7,42,28,30,10,2,14,24,58.3,10,28,19,9,27,69,62,1,0,2020-2021,1.3043478260869565,2.028985507246377
634,Craig Dawson,ENG,DF,West Ham,Premier League,30,1990,21.4,11,8,7,4,0,5,12,41.7,7,26,22,4,32,43,88,3,0,2020-2021,1.4953271028037385,0.5140186915887851
635,Kevin De Bruyne,BEL,MF,Manchester City,Premier League,29,1991,22.2,34,21,6,18,10,13,48,27.1,35,26,1,25,9,43,10,0,0,2020-2021,0.40540540540540543,1.5315315315315317
636,Sebastien De Maio,FRA,DF,Udinese,Serie A,33,1987,9.5,15,10,6,9,0,4,5,80.0,1,16,9,7,18,33,41,0,0,2020-2021,1.894736842105263,1.5789473684210527
637,Rodrigo De Paul,ARG,MF,Udinese,Serie A,26,1994,35.6,41,24,17,22,2,15,60,25.0,45,32,1,31,17,58,20,1,0,2020-2021,0.47752808988764045,1.151685393258427
638,Mattia De Sciglio,ITA,DF,Juventus,Serie A,27,1992,0.3,0,0,0,0,0,0,0,0.0,0,0,0,0,0,0,1,0,0,2020-2021,0.0,0.0
639,Mattia De Sciglio,ITA,DF,Lyon,Ligue 1,27,1992,16.3,29,17,15,11,3,18,27,66.7,9,13,4,9,27,56,44,0,0,2020-2021,1.656441717791411,1.7791411042944785
640,Lorenzo De Silvestri,ITA,DF,Bologna,Serie A,32,1988,23.8,34,24,18,13,3,16,37,43.2,21,37,10,27,30,64,62,3,0,2020-2021,1.2605042016806722,1.4285714285714286
641,Thibault De Smet,BEL,DF,Reims,Ligue 1,22,1998,5.5,11,6,8,3,0,6,15,40.0,9,8,1,7,6,17,16,0,0,2020-2021,1.0909090909090908,2.0
642,Lucas Deaux,FRA,"MF,DF",Nîmes,Ligue 1,31,1988,19.5,47,32,20,22,5,16,49,32.7,33,20,3,17,20,67,30,4,0,2020-2021,1.0256410256410255,2.41025641025641
643,Mathieu Debuchy,FRA,DF,Saint-Étienne,Ligue 1,35,1985,23.4,58,33,37,17,4,40,62,64.5,22,27,9,18,45,103,61,0,0,2020-2021,1.9230769230769231,2.4786324786324787
644,Grégoire Defrel,MTQ,"MF,FW",Sassuolo,Serie A,29,1991,14.8,13,8,5,5,3,5,13,38.5,8,9,0,9,7,20,5,0,0,2020-2021,0.47297297297297297,0.8783783783783783
645,Alessandro Deiola,ITA,MF,Spezia,Serie A,24,1995,4.0,6,3,2,3,1,5,13,38.5,8,3,1,2,3,9,1,0,0,2020-2021,0.75,1.5
646,Alessandro Deiola,ITA,MF,Cagliari,Serie A,24,1995,6.8,13,5,5,4,4,8,23,34.8,15,7,2,5,11,24,11,0,0,2020-2021,1.6176470588235294,1.911764705882353
647,Romain Del Castillo,FRA,"MF,FW",Rennes,Ligue 1,24,1996,7.2,30,11,5,14,11,5,25,20.0,20,6,0,6,3,33,4,1,0,2020-2021,0.41666666666666663,4.166666666666667
648,Lorenzo Del Pinto,ITA,MF,Benevento,Serie A,30,1990,0.1,0,0,0,0,0,0,2,0.0,2,0,0,0,0,0,0,0,0,2020-2021,0.0,0.0
649,Thomas Delaine,FRA,"DF,FW",Metz,Ligue 1,28,1992,19.8,32,18,19,11,2,20,35,57.1,15,22,5,17,24,56,30,1,0,2020-2021,1.2121212121212122,1.6161616161616161
650,Thomas Delaney,DEN,MF,Dortmund,Bundesliga,28,1991,14.3,40,30,15,20,5,11,31,35.5,20,28,10,18,22,62,15,1,0,2020-2021,1.5384615384615383,2.797202797202797
Rk,Player,Nation,Pos,Squad,Comp,0,0,90.0,0,0,3,3,3,Tkl,0,0.0,0,0,0,0,0,0,0,0,0,2020-2021,0.0,0.0
651,Liam Delap,ENG,FW,Manchester City,Premier League,17,2003,0.4,0,0,0,0,0,0,0,0.0,0,0,0,0,0,0,0,0,0,2020-2021,0.0,0.0
652,Jonathan Delaplace,FRA,DF,Lorient,Ligue 1,34,1986,10.1,8,5,5,1,2,7,13,53.8,6,12,5,7,17,25,19,1,0,2020-2021,1.6831683168316833,0.7920792079207921
653,Sacha Delaye,FRA,MF,Montpellier,Ligue 1,18,2002,0.1,0,0,0,0,0,0,1,0.0,1,0,0,0,1,1,1,0,0,2020-2021,10.0,0.0
654,Cristian Dell'Orco,ITA,DF,Spezia,Serie A,26,1994,2.9,1,0,1,0,0,1,3,33.3,2,8,5,3,7,8,9,1,0,2020-2021,2.413793103448276,0.3448275862068966
655,Andy Delort,ALG,FW,Montpellier,Ligue 1,28,1991,27.6,12,7,1,9,2,8,18,44.4,10,11,1,10,4,16,34,0,0,2020-2021,0.14492753623188406,0.43478260869565216
656,Fabian Delph,ENG,"MF,DF",Everton,Premier League,30,1989,3.0,5,2,3,2,0,1,3,33.3,2,2,0,2,4,9,8,1,0,2020-2021,1.3333333333333333,1.6666666666666667
657,Moussa Dembélé,FRA,FW,Atlético Madrid,La Liga,24,1996,1.1,0,0,0,0,0,0,1,0.0,1,0,0,0,1,1,0,0,0,2020-2021,0.9090909090909091,0.0
658,Moussa Dembélé,FRA,FW,Lyon,Ligue 1,24,1996,7.5,2,2,0,1,1,0,4,0.0,4,4,2,2,5,7,9,0,0,2020-2021,0.6666666666666666,0.26666666666666666
659,Ousmane Dembélé,FRA,FW,Barcelona,La Liga,23,1997,19.7,14,9,4,9,1,6,17,35.3,11,10,0,10,9,23,3,1,0,2020-2021,0.4568527918781726,0.7106598984771574
660,Merih Demiral,TUR,DF,Juventus,Serie A,22,1998,10.4,12,9,8,4,0,5,13,38.5,8,16,9,7,21,33,40,0,0,2020-2021,2.019230769230769,1.1538461538461537
661,Kerem Demirbay,GER,MF,Leverkusen,Bundesliga,27,1993,19.4,46,31,15,26,5,19,38,50.0,19,21,4,17,8,54,6,1,0,2020-2021,0.4123711340206186,2.3711340206185567
662,Ermedin Demirović,BIH,FW,Freiburg,Bundesliga,22,1998,16.6,15,9,4,6,5,2,16,12.5,14,29,5,24,0,15,27,0,0,2020-2021,0.0,0.9036144578313252
663,Diego Demme,GER,MF,Napoli,Serie A,28,1991,17.7,56,32,26,22,8,23,63,36.5,40,14,1,13,11,67,15,1,0,2020-2021,0.6214689265536724,3.1638418079096047
664,Jason Denayer,BEL,DF,Lyon,Ligue 1,25,1995,29.0,25,16,16,9,0,6,13,46.2,7,36,25,11,27,52,91,1,0,2020-2021,0.9310344827586207,0.8620689655172413
665,Leander Dendoncker,BEL,"MF,DF",Wolves,Premier League,25,1995,27.8,54,29,29,22,3,31,60,51.7,29,38,15,23,27,81,52,2,0,2020-2021,0.9712230215827338,1.9424460431654675
666,Kévin Denkey,TOG,FW,Nîmes,Ligue 1,19,2000,5.8,4,2,0,3,1,0,3,0.0,3,2,0,2,1,5,2,0,0,2020-2021,0.1724137931034483,0.6896551724137931
667,Emmanuel Dennis,NGA,FW,Köln,Bundesliga,22,1997,5.3,13,7,6,5,2,1,6,16.7,5,6,0,6,0,13,0,1,0,2020-2021,0.0,2.452830188679245
668,Stefano Denswil,SUR,DF,Bologna,Serie A,27,1993,1.3,2,1,1,1,0,0,1,0.0,1,1,0,1,1,3,1,0,0,2020-2021,0.7692307692307692,1.5384615384615383
669,Fabio Depaoli,ITA,DF,Benevento,Serie A,23,1997,12.4,25,13,15,6,4,15,32,46.9,17,16,4,12,12,37,38,0,0,2020-2021,0.9677419354838709,2.0161290322580645
670,Fabio Depaoli,ITA,MF,Sampdoria,Serie A,23,1997,0.9,1,0,0,1,0,0,2,0.0,2,0,0,0,1,2,1,0,0,2020-2021,1.1111111111111112,1.1111111111111112
671,Fabio Depaoli,ITA,DF,Atalanta,Serie A,23,1997,2.1,3,2,0,1,2,1,2,50.0,1,4,0,4,3,6,2,0,0,2020-2021,1.4285714285714286,1.4285714285714286
672,Clément Depres,FRA,FW,Nîmes,Ligue 1,25,1994,0.2,0,0,0,0,0,0,0,0.0,0,0,0,0,0,0,0,0,0,2020-2021,0.0,0.0
673,Mike van der Hoorn,NED,DF,Arminia,Bundesliga,27,1992,15.1,8,4,3,5,0,1,3,33.3,2,12,8,4,27,35,73,0,0,2020-2021,1.7880794701986755,0.5298013245033113
674,Kastriot Dermaku,ALB,DF,Parma,Serie A,28,1992,1.1,1,1,1,0,0,0,0,0.0,0,2,1,1,2,3,8,0,0,2020-2021,1.8181818181818181,0.9090909090909091
675,Kiril Despodov,BUL,FW,Cagliari,Serie A,23,1996,0.1,1,1,0,1,0,1,1,100.0,0,0,0,0,0,1,0,0,0,2020-2021,0.0,10.0
Rk,Player,Nation,Pos,Squad,Comp,0,0,90.0,0,0,3,3,3,Tkl,0,0.0,0,0,0,0,0,0,0,0,0,2020-2021,0.0,0.0
676,Sergiño Dest,USA,"DF,FW",Barcelona,La Liga,19,2000,21.2,31,16,23,6,2,18,32,56.3,14,25,4,21,10,41,24,1,0,2020-2021,0.4716981132075472,1.4622641509433962
677,Mattia Destro,ITA,FW,Genoa,Serie A,29,1991,17.8,6,3,0,3,3,2,9,22.2,7,11,0,11,4,10,8,0,0,2020-2021,0.2247191011235955,0.33707865168539325
678,Gerard Deulofeu,ESP,"FW,MF",Udinese,Serie A,26,1994,6.6,2,2,1,1,0,2,12,16.7,10,2,0,2,3,5,0,0,0,2020-2021,0.4545454545454546,0.30303030303030304
679,Deyverson,BRA,FW,Alavés,La Liga,29,1991,9.7,6,4,3,1,2,2,13,15.4,11,9,0,9,9,15,13,0,0,2020-2021,0.9278350515463918,0.6185567010309279
680,Jacopo Dezi,ITA,"FW,MF",Parma,Serie A,28,1992,0.9,4,3,0,2,2,3,6,50.0,3,2,0,2,0,4,0,0,0,2020-2021,0.0,4.444444444444445
681,Samuel Di Carmine,ITA,FW,Hellas Verona,Serie A,31,1988,5.6,1,2,0,1,0,0,3,0.0,3,1,0,1,0,1,5,0,0,2020-2021,0.0,0.17857142857142858
682,Samuel Di Carmine,ITA,FW,Crotone,Serie A,31,1988,5.3,2,2,1,0,1,1,3,33.3,2,2,0,2,0,2,5,0,0,2020-2021,0.0,0.37735849056603776
683,Giovanni Di Lorenzo,ITA,DF,Napoli,Serie A,26,1993,36.0,79,50,54,21,4,43,75,57.3,32,37,13,24,35,114,64,1,0,2020-2021,0.9722222222222222,2.1944444444444446
684,Ángel Di María,ARG,"FW,MF",Paris S-G,Ligue 1,32,1988,20.6,26,17,6,8,12,11,45,24.4,34,14,1,13,6,32,7,0,0,2020-2021,0.2912621359223301,1.262135922330097
685,Alessandro Di Pardo,ITA,"FW,DF",Juventus,Serie A,21,1999,0.2,0,0,0,0,0,0,0,0.0,0,1,1,0,0,0,0,0,0,2020-2021,0.0,0.0
686,Giuseppe Di Serio,ITA,"FW,MF",Benevento,Serie A,19,2001,3.2,2,2,1,1,0,0,4,0.0,4,5,0,5,0,2,4,0,0,2020-2021,0.0,0.625
687,Boulaye Dia,SEN,"FW,MF",Reims,Ligue 1,23,1996,32.6,23,12,3,11,9,4,22,18.2,18,19,5,14,12,35,37,1,0,2020-2021,0.36809815950920244,0.705521472392638
688,Abdoulay Diaby,MLI,DF,Getafe,La Liga,29,1991,0.2,2,0,0,2,0,0,0,0.0,0,2,0,2,0,2,0,0,0,2020-2021,0.0,10.0
689,Moussa Diaby,FRA,"FW,MF",Leverkusen,Bundesliga,21,1999,26.5,10,6,4,5,1,6,20,30.0,14,11,0,11,12,22,5,0,0,2020-2021,0.4528301886792453,0.37735849056603776
690,Mbaye Diagne,SEN,FW,West Brom,Premier League,28,1991,13.2,4,3,3,0,1,1,4,25.0,3,2,1,1,1,5,16,0,0,2020-2021,0.07575757575757576,0.30303030303030304
691,Mouctar Diakhaby,GUI,DF,Valencia,La Liga,23,1996,23.1,16,8,10,6,0,8,12,66.7,4,28,21,7,27,43,102,1,0,2020-2021,1.1688311688311688,0.6926406926406926
692,Abdou Diallo,SEN,DF,Paris S-G,Ligue 1,24,1996,16.6,16,11,9,5,2,8,13,61.5,5,15,8,7,25,41,36,0,0,2020-2021,1.506024096385542,0.9638554216867469
693,Amad Diallo,CIV,FW,Manchester Utd,Premier League,18,2002,1.8,3,3,1,2,0,0,0,0.0,0,2,1,1,0,3,1,0,0,2020-2021,0.0,1.6666666666666665
694,Amad Diallo,CIV,MF,Atalanta,Serie A,18,2002,0.2,0,0,0,0,0,0,0,0.0,0,0,0,0,0,0,0,0,0,2020-2021,0.0,0.0
695,Habib Diallo,SEN,FW,Strasbourg,Ligue 1,25,1995,25.8,11,6,3,6,2,7,18,38.9,11,12,2,10,13,24,12,0,0,2020-2021,0.5038759689922481,0.4263565891472868
696,Habib Diallo,SEN,"FW,MF",Metz,Ligue 1,25,1995,1.6,1,1,0,1,0,1,1,100.0,0,0,0,0,0,1,5,0,0,2020-2021,0.0,0.625
697,Ibrahima Diallo,FRA,MF,Southampton,Premier League,21,1999,11.3,29,16,11,17,1,9,16,56.3,7,10,1,9,10,39,12,2,0,2020-2021,0.8849557522123893,2.566371681415929
698,Ibrahima Diallo,FRA,MF,Brest,Ligue 1,21,1999,4.9,14,9,2,9,3,4,8,50.0,4,4,0,4,3,17,3,0,0,2020-2021,0.6122448979591836,2.8571428571428568
699,Amadou Diambo,GHA,FW,Benevento,Serie A,19,2001,0.0,0,0,0,0,0,0,0,0.0,0,0,0,0,0,0,0,0,0,2020-2021,,
700,Grady Diangana,COD,"MF,FW",West Brom,Premier League,22,1998,13.7,35,19,19,9,7,19,43,44.2,24,16,2,14,16,51,9,0,0,2020-2021,1.1678832116788322,2.5547445255474455
Rk,Player,Nation,Pos,Squad,Comp,0,0,90.0,0,0,3,3,3,Tkl,0,0.0,0,0,0,0,0,0,0,0,0,2020-2021,0.0,0.0
701,Stéphane Diarra,FRA,"MF,FW",Lorient,Ligue 1,21,1998,2.2,0,0,0,0,0,0,7,0.0,7,6,1,5,4,4,1,0,0,2020-2021,1.8181818181818181,0.0
702,Rúben Dias,POR,DF,Manchester City,Premier League,23,1997,31.6,24,13,13,8,3,4,16,25.0,12,31,23,8,35,59,92,0,0,2020-2021,1.1075949367088607,0.7594936708860759
703,Krépin Diatta,SEN,"MF,DF",Monaco,Ligue 1,21,1999,4.3,4,3,1,1,2,1,3,33.3,2,5,1,4,4,8,1,0,0,2020-2021,0.9302325581395349,0.9302325581395349
704,Amadou Diawara,GUI,MF,Roma,Serie A,23,1997,7.3,10,8,4,6,0,2,8,25.0,6,11,2,9,12,22,4,0,0,2020-2021,1.6438356164383563,1.36986301369863
705,Brahim Díaz,MAR,"MF,FW",Milan,Serie A,20,1999,13.6,18,10,7,7,4,10,23,43.5,13,10,0,10,2,20,2,0,0,2020-2021,0.14705882352941177,1.3235294117647058
706,Víctor Díaz,ESP,DF,Granada,La Liga,32,1988,9.2,21,10,13,6,2,10,19,52.6,9,14,8,6,16,37,39,0,0,2020-2021,1.7391304347826089,2.2826086956521743
707,Daniel Didavi,GER,"MF,FW",Stuttgart,Bundesliga,30,1990,10.8,16,6,2,9,5,7,12,58.3,5,10,0,10,3,19,8,0,0,2020-2021,0.27777777777777773,1.4814814814814814
708,Bamba Dieng,SEN,"FW,DF",Marseille,Ligue 1,20,2000,1.4,5,3,3,2,0,2,4,50.0,2,2,0,2,0,5,0,0,0,2020-2021,0.0,3.5714285714285716
709,Eric Dier,ENG,DF,Tottenham,Premier League,26,1994,28.0,23,14,13,10,0,11,18,61.1,7,37,31,6,23,46,123,3,0,2020-2021,0.8214285714285714,0.8214285714285714
710,Daan Dierckx,BEL,DF,Parma,Serie A,17,2003,5.2,5,4,5,0,0,3,5,60.0,2,10,6,4,13,18,21,0,0,2020-2021,2.5,0.9615384615384615
711,Lucas Digne,FRA,"DF,MF",Everton,Premier League,27,1993,29.8,63,38,40,16,7,29,54,53.7,25,42,4,38,31,94,87,0,0,2020-2021,1.0402684563758389,2.1140939597315436
712,Mitchell Dijks,NED,DF,Bologna,Serie A,27,1993,16.5,21,14,15,5,1,12,21,57.1,9,17,2,15,17,38,35,0,0,2020-2021,1.0303030303030303,1.2727272727272727
713,Javairô Dilrosun,NED,"FW,MF",Hertha BSC,Bundesliga,22,1998,5.9,5,3,2,2,1,1,6,16.7,5,5,0,5,4,9,3,0,0,2020-2021,0.6779661016949152,0.847457627118644
714,Federico Dimarco,ITA,DF,Hellas Verona,Serie A,22,1997,29.0,32,19,23,7,2,13,28,46.4,15,18,9,9,47,79,50,1,0,2020-2021,1.6206896551724137,1.103448275862069
715,Junior Dina Ebimbe,FRA,"FW,MF",Dijon,Ligue 1,19,2000,23.8,38,25,14,19,5,15,45,33.3,30,17,1,16,14,52,9,0,0,2020-2021,0.5882352941176471,1.5966386554621848
716,Tristan Dingomé,CMR,MF,Reims,Ligue 1,29,1991,0.2,0,0,0,0,0,0,1,0.0,1,0,0,0,0,0,0,0,0,2020-2021,0.0,0.0
717,Eren Dinkçi,GER,"MF,FW",Werder Bremen,Bundesliga,18,2001,1.2,1,1,1,0,0,0,1,0.0,1,4,0,4,2,3,1,0,0,2020-2021,1.6666666666666667,0.8333333333333334
718,Sinaly Diomande,CIV,DF,Lyon,Ligue 1,19,2001,12.6,10,7,8,1,1,5,14,35.7,9,19,15,4,33,43,53,1,0,2020-2021,2.619047619047619,0.7936507936507937
719,Lois Diony,FRA,FW,Angers,Ligue 1,27,1992,19.4,15,10,3,9,3,4,18,22.2,14,6,3,3,5,20,16,0,0,2020-2021,0.2577319587628866,0.7731958762886598
720,Issa Diop,FRA,DF,West Ham,Premier League,23,1997,15.3,20,14,12,8,0,7,18,38.9,11,32,22,10,22,42,59,0,0,2020-2021,1.4379084967320261,1.3071895424836601
721,Papakouli Diop,SEN,MF,Eibar,La Liga,34,1986,25.8,43,29,15,22,6,12,41,29.3,29,23,5,18,39,82,34,1,0,2020-2021,1.5116279069767442,1.6666666666666665
722,Sofiane Diop,FRA,"MF,FW",Monaco,Ligue 1,20,2000,22.5,49,34,17,25,7,18,53,34.0,35,25,1,24,31,80,15,0,0,2020-2021,1.3777777777777778,2.1777777777777776
723,Andy Diouf,FRA,FW,Rennes,Ligue 1,17,2003,0.1,0,0,0,0,0,0,0,0.0,0,0,0,0,0,0,0,0,0,2020-2021,0.0,0.0
724,Yehvann Diouf,FRA,GK,Reims,Ligue 1,20,1999,1.5,0,0,0,0,0,0,0,0.0,0,0,0,0,0,0,0,0,0,2020-2021,0.0,0.0
725,Assane Dioussé,SEN,DF,Saint-Étienne,Ligue 1,22,1997,0.0,0,0,0,0,0,0,0,0.0,0,0,0,0,0,0,0,0,0,2020-2021,,
Rk,Player,Nation,Pos,Squad,Comp,0,0,90.0,0,0,3,3,3,Tkl,0,0.0,0,0,0,0,0,0,0,0,0,2020-2021,0.0,0.0
726,Jonas Dirkner,GER,MF,Hertha BSC,Bundesliga,18,2002,0.2,0,0,0,0,0,0,0,0.0,0,0,0,0,0,0,0,0,0,2020-2021,0.0,0.0
727,Axel Disasi,FRA,DF,Monaco,Ligue 1,22,1998,22.3,29,20,17,12,0,20,35,57.1,15,18,11,7,26,55,66,1,0,2020-2021,1.1659192825112108,1.3004484304932735
728,Tiago Djaló,POR,DF,Lille,Ligue 1,20,2000,9.7,22,13,14,5,3,15,23,65.2,8,10,4,6,9,31,23,0,0,2020-2021,0.9278350515463918,2.2680412371134024
729,Djené,TOG,DF,Getafe,La Liga,28,1991,32.7,61,39,31,26,4,26,34,76.5,8,24,11,13,42,103,96,0,0,2020-2021,1.2844036697247705,1.8654434250764524
730,Moussa Djenepo,MLI,MF,Southampton,Premier League,22,1998,13.8,52,27,27,17,8,28,63,44.4,35,24,2,22,10,62,14,0,0,2020-2021,0.7246376811594203,3.7681159420289854
731,Koffi Djidji,CIV,DF,Crotone,Serie A,27,1992,16.9,39,28,30,8,1,10,20,50.0,10,35,20,15,28,67,73,0,0,2020-2021,1.656804733727811,2.307692307692308
732,Alexander Djiku,GHA,"DF,MF",Strasbourg,Ligue 1,25,1994,28.4,60,41,45,13,2,32,52,61.5,20,28,10,18,91,151,104,0,0,2020-2021,3.204225352112676,2.1126760563380285
733,Berat Djimsiti,ALB,DF,Atalanta,Serie A,27,1993,29.2,41,29,27,12,2,17,34,50.0,17,34,20,14,62,103,89,1,0,2020-2021,2.1232876712328768,1.404109589041096
734,Marko Dmitrović,SRB,GK,Eibar,La Liga,28,1992,34.7,4,3,4,0,0,2,4,50.0,2,0,0,0,0,4,16,2,0,2020-2021,0.0,0.11527377521613832
735,Ritsu Doan,JPN,"MF,FW",Arminia,Bundesliga,22,1998,30.8,53,31,22,19,12,19,52,36.5,33,42,1,41,31,84,11,0,0,2020-2021,1.0064935064935066,1.7207792207792207
736,Mihai Dobre,ROU,FW,Dijon,Ligue 1,21,1998,5.9,12,5,6,2,4,7,14,50.0,7,5,0,5,10,22,3,0,0,2020-2021,1.694915254237288,2.0338983050847457
737,Matt Doherty,IRL,DF,Tottenham,Premier League,28,1992,13.8,29,15,15,10,4,13,33,39.4,20,20,5,15,23,52,46,0,0,2020-2021,1.6666666666666665,2.101449275362319
738,Jeremy Doku,BEL,"MF,FW",Rennes,Ligue 1,18,2002,25.7,44,25,9,24,11,11,26,42.3,15,18,1,17,11,55,1,0,0,2020-2021,0.42801556420233466,1.7120622568093387
739,Kasper Dolberg,DEN,FW,Nice,Ligue 1,22,1997,21.4,6,2,1,3,2,2,11,18.2,9,11,2,9,6,12,19,1,0,2020-2021,0.28037383177570097,0.28037383177570097
740,Keagan Dolly,RSA,MF,Montpellier,Ligue 1,27,1993,5.0,7,2,6,0,1,4,8,50.0,4,3,0,3,5,12,2,0,0,2020-2021,1.0,1.4
741,Jaume Doménech,ESP,GK,Valencia,La Liga,29,1990,28.0,1,1,1,0,0,1,2,50.0,1,1,0,1,0,1,16,2,0,2020-2021,0.0,0.03571428571428571
742,Carlos Dominguez,ESP,DF,Celta Vigo,La Liga,19,2001,4.0,5,4,4,1,0,3,6,50.0,3,5,3,2,6,11,24,0,0,2020-2021,1.5,1.25
743,Nicolás Domínguez,ARG,MF,Bologna,Serie A,22,1998,13.9,48,28,26,17,5,15,37,40.5,22,26,7,19,24,72,20,0,0,2020-2021,1.7266187050359711,3.4532374100719423
744,John Donald,ESP,"DF,MF",Elche,La Liga,19,2000,0.6,0,0,0,0,0,0,0,0.0,0,0,0,0,0,0,1,0,0,2020-2021,0.0,0.0
745,Ji Dong-won,KOR,FW,Mainz 05,Bundesliga,29,1991,0.7,1,1,1,0,0,0,0,0.0,0,1,0,1,2,3,0,0,0,2020-2021,2.857142857142857,1.4285714285714286
746,Anastasios Donis,GRE,MF,Reims,Ligue 1,23,1996,1.1,4,1,2,0,2,1,1,100.0,0,0,0,0,0,4,0,0,0,2020-2021,0.0,3.6363636363636362
747,Gianluigi Donnarumma,ITA,GK,Milan,Serie A,21,1999,37.0,0,0,0,0,0,0,1,0.0,1,1,0,1,1,1,23,2,0,2020-2021,0.02702702702702703,0.0
748,Bas Dost,NED,FW,Eint Frankfurt,Bundesliga,31,1989,9.1,3,2,1,1,1,2,5,40.0,3,5,1,4,2,5,8,0,0,2020-2021,0.21978021978021978,0.32967032967032966
749,Abdoulaye Doucouré,MLI,MF,Everton,Premier League,27,1993,27.1,52,32,25,19,8,14,43,32.6,29,24,7,17,39,91,31,1,0,2020-2021,1.4391143911439113,1.918819188191882
750,Cheick Doucouré,MLI,MF,Lens,Ligue 1,20,2000,29.2,87,47,40,42,5,32,65,49.2,33,20,4,16,52,139,26,1,0,2020-2021,1.7808219178082192,2.9794520547945207
Rk,Player,Nation,Pos,Squad,Comp,0,0,90.0,0,0,3,3,3,Tkl,0,0.0,0,0,0,0,0,0,0,0,0,2020-2021,0.0,0.0
751,Fodé Doucouré,MLI,DF,Reims,Ligue 1,19,2001,3.7,11,8,7,4,0,4,9,44.4,5,2,0,2,4,15,11,0,0,2020-2021,1.081081081081081,2.972972972972973
752,Mahamadou Doucouré,MLI,"FW,MF",Nîmes,Ligue 1,20,2000,0.5,1,1,1,0,0,1,1,100.0,0,0,0,0,0,1,0,0,0,2020-2021,0.0,2.0
753,Cheick Doukouré,CIV,"MF,FW",Levante,La Liga,27,1992,1.1,5,4,2,1,2,3,4,75.0,1,2,0,2,3,8,0,0,0,2020-2021,2.727272727272727,4.545454545454545
754,Idrissa Doumbia,CIV,MF,Huesca,La Liga,22,1998,8.7,15,8,6,7,2,5,13,38.5,8,6,3,3,7,22,9,0,0,2020-2021,0.8045977011494253,1.7241379310344829
755,Moussa Doumbia,MLI,"MF,FW",Reims,Ligue 1,25,1994,10.0,10,6,4,4,2,4,22,18.2,18,5,1,4,10,20,4,0,0,2020-2021,1.0,1.0
756,Souleyman Doumbia,CIV,DF,Angers,Ligue 1,23,1996,24.7,48,33,25,19,4,22,36,61.1,14,18,4,14,42,90,50,0,0,2020-2021,1.7004048582995952,1.9433198380566803
757,Aleksandar Dragović,AUT,DF,Leverkusen,Bundesliga,29,1991,12.6,11,7,5,5,1,9,13,69.2,4,17,5,12,13,24,33,0,0,2020-2021,1.0317460317460319,0.873015873015873
758,Bartłomiej Drągowski,POL,GK,Fiorentina,Serie A,22,1997,35.0,1,0,1,0,0,1,1,100.0,0,0,0,0,1,2,13,1,0,2020-2021,0.02857142857142857,0.02857142857142857
759,Denis Drăguș,ROU,"FW,MF",Crotone,Serie A,21,1999,2.0,3,1,0,0,3,0,4,0.0,4,4,0,4,1,4,0,0,0,2020-2021,0.5,1.5
760,Radu Drăgușin,ROU,DF,Juventus,Serie A,18,2002,0.0,0,0,0,0,0,0,0,0.0,0,0,0,0,0,0,0,0,0,2020-2021,,
761,Mouhamadou Drammeh,FRA,MF,Reims,Ligue 1,21,1999,1.9,0,0,0,0,0,0,2,0.0,2,0,0,0,2,2,7,0,0,2020-2021,1.0526315789473684,0.0
762,Julian Draxler,GER,"MF,FW",Paris S-G,Ligue 1,26,1993,11.8,13,6,5,6,2,5,20,25.0,15,4,0,4,14,27,0,0,0,2020-2021,1.1864406779661016,1.1016949152542372
763,Dominick Drexler,GER,"MF,FW",Köln,Bundesliga,30,1990,13.7,36,26,15,18,3,12,30,40.0,18,5,1,4,14,50,15,0,0,2020-2021,1.0218978102189782,2.6277372262773726
764,Matthieu Dreyer,FRA,GK,Lorient,Ligue 1,31,1989,15.0,0,0,0,0,0,0,0,0.0,0,0,0,0,0,0,4,2,0,2020-2021,0.0,0.0
765,Domingos Duarte,POR,DF,Granada,La Liga,25,1995,26.3,32,20,18,12,2,14,21,66.7,7,29,20,9,29,61,86,0,0,2020-2021,1.1026615969581748,1.2167300380228137
766,Léo Duarte,BRA,DF,Milan,Serie A,24,1996,0.2,1,1,0,1,0,0,0,0.0,0,0,0,0,1,2,0,0,0,2020-2021,5.0,5.0
767,Óscar Duarte,CRC,DF,Levante,La Liga,31,1989,22.9,22,13,17,5,0,10,18,55.6,8,23,15,8,36,58,97,1,0,2020-2021,1.572052401746725,0.9606986899563319
768,Rubén Duarte,ESP,DF,Alavés,La Liga,24,1995,28.3,55,30,28,21,6,23,52,44.2,29,44,6,38,66,121,72,0,0,2020-2021,2.3321554770318023,1.9434628975265018
769,Leo Dubois,FRA,DF,Lyon,Ligue 1,25,1994,32.3,38,26,19,16,3,18,36,50.0,18,27,9,18,31,69,69,2,0,2020-2021,0.9597523219814242,1.1764705882352942
770,Martin Dúbravka,SVK,GK,Newcastle Utd,Premier League,31,1989,13.0,0,0,0,0,0,0,0,0.0,0,0,0,0,0,0,3,0,0,2020-2021,0.0,0.0
771,Ondrej Duda,SVK,"FW,MF",Köln,Bundesliga,25,1994,28.2,36,14,13,18,5,8,39,20.5,31,28,2,26,19,55,20,0,0,2020-2021,0.6737588652482269,1.2765957446808511
772,Unai Dufur,ESP,DF,Eibar,La Liga,21,1999,0.7,2,2,2,0,0,2,4,50.0,2,0,0,0,1,3,0,0,0,2020-2021,1.4285714285714286,2.857142857142857
773,Haris Duljević,BIH,"MF,FW",Nîmes,Ligue 1,26,1993,8.6,15,9,4,7,4,6,22,27.3,16,3,0,3,8,23,1,0,0,2020-2021,0.9302325581395349,1.744186046511628
774,Paul Dummett,WAL,DF,Newcastle Utd,Premier League,28,1991,13.9,16,7,11,5,0,13,21,61.9,8,12,7,5,16,32,74,0,0,2020-2021,1.1510791366906474,1.1510791366906474
775,Alfred Duncan,GHA,MF,Fiorentina,Serie A,27,1993,1.8,3,0,1,1,1,0,2,0.0,2,2,0,2,2,5,0,0,0,2020-2021,1.1111111111111112,1.6666666666666665
Rk,Player,Nation,Pos,Squad,Comp,0,0,90.0,0,0,3,3,3,Tkl,0,0.0,0,0,0,0,0,0,0,0,0,2020-2021,0.0,0.0
776,Alfred Duncan,GHA,MF,Cagliari,Serie A,27,1993,11.9,18,10,8,9,1,4,21,19.0,17,8,0,8,16,34,8,1,0,2020-2021,1.3445378151260503,1.5126050420168067
777,Lewis Dunk,ENG,DF,Brighton,Premier League,28,1991,32.6,30,15,20,8,2,16,23,69.6,7,29,20,9,32,62,106,0,0,2020-2021,0.9815950920245399,0.920245398773006
778,Jimmy Dunne,IRL,DF,Burnley,Premier League,22,1997,3.0,3,3,2,1,0,1,2,50.0,1,3,2,1,6,9,16,1,0,2020-2021,2.0,1.0
779,Erik Durm,GER,DF,Eint Frankfurt,Bundesliga,28,1992,16.4,17,13,7,9,1,8,21,38.1,13,19,5,14,29,46,26,0,0,2020-2021,1.7682926829268295,1.0365853658536586
780,Hugo Duro,ESP,FW,Real Madrid,La Liga,20,1999,0.6,0,0,0,0,0,0,0,0.0,0,1,0,1,0,0,0,0,0,2020-2021,0.0,0.0
781,Jean-Kevin Duverne,HAI,DF,Brest,Ligue 1,23,1997,22.5,38,21,24,14,0,15,32,46.9,17,24,16,8,30,68,70,0,0,2020-2021,1.3333333333333333,1.6888888888888889
782,Paulo Dybala,ARG,FW,Juventus,Serie A,26,1993,12.6,14,8,3,4,7,2,14,14.3,12,15,0,15,1,15,1,0,0,2020-2021,0.07936507936507936,1.1111111111111112
783,Edin Džeko,BIH,FW,Roma,Serie A,34,1986,20.3,8,6,2,3,3,3,9,33.3,6,9,4,5,1,9,11,0,0,2020-2021,0.04926108374384236,0.3940886699507389
784,Steeve-Mike Ebongue,FRA,MF,Genoa,Serie A,19,2001,0.6,2,1,1,0,1,0,3,0.0,3,1,0,1,0,2,0,0,0,2020-2021,0.0,3.3333333333333335
785,Enzo Ebosse,CMR,DF,Angers,Ligue 1,21,1999,2.9,5,3,5,0,0,3,4,75.0,1,1,1,0,2,7,13,0,0,2020-2021,0.6896551724137931,1.7241379310344829
786,Bruno Ecuele Manga,GAB,DF,Dijon,Ligue 1,32,1988,38.0,52,38,46,6,0,29,40,72.5,11,50,33,17,57,109,165,3,0,2020-2021,1.5,1.368421052631579
787,Simone Edera,ITA,"DF,MF",Torino,Serie A,23,1997,0.6,3,1,2,1,0,3,4,75.0,1,0,0,0,1,4,1,0,0,2020-2021,1.6666666666666667,5.0
788,Ederson,BRA,GK,Manchester City,Premier League,26,1993,36.0,3,1,3,0,0,3,4,75.0,1,0,0,0,0,3,11,4,0,2020-2021,0.0,0.08333333333333333
789,Kyle Edwards,ENG,"MF,FW",West Brom,Premier League,22,1998,1.3,3,2,1,1,1,0,0,0.0,0,2,0,2,1,4,0,0,0,2020-2021,0.7692307692307692,2.3076923076923075
790,John Egan,IRL,DF,Sheffield Utd,Premier League,27,1992,29.2,41,21,29,12,0,22,39,56.4,17,43,31,12,41,82,131,0,0,2020-2021,1.404109589041096,1.404109589041096
791,Johannes Eggestein,GER,"FW,MF",Werder Bremen,Bundesliga,22,1998,0.4,0,0,0,0,0,0,1,0.0,1,0,0,0,1,1,2,0,0,2020-2021,2.5,0.0
792,Maximilian Eggestein,GER,MF,Werder Bremen,Bundesliga,23,1996,32.7,57,42,22,29,6,21,46,45.7,25,30,5,25,43,100,36,0,0,2020-2021,1.3149847094801221,1.7431192660550456
793,Lilian Egloff,GER,MF,Stuttgart,Bundesliga,17,2002,0.2,0,0,0,0,0,0,0,0.0,0,0,0,0,0,0,0,0,0,2020-2021,0.0,0.0
794,Kingsley Ehizibue,NED,DF,Köln,Bundesliga,25,1995,12.6,32,19,22,9,1,10,17,58.8,7,19,5,14,18,50,42,0,0,2020-2021,1.4285714285714286,2.5396825396825395
795,Albin Ekdal,SWE,MF,Sampdoria,Serie A,31,1989,25.5,56,29,21,32,3,23,65,35.4,42,31,12,19,49,105,35,0,0,2020-2021,1.9215686274509804,2.196078431372549
796,Hugo Ekitike,FRA,"FW,MF",Reims,Ligue 1,18,2002,1.0,1,1,0,0,1,0,1,0.0,1,0,0,0,0,1,0,0,0,2020-2021,0.0,1.0
797,Anthony Elanga,SWE,FW,Manchester Utd,Premier League,18,2002,1.7,4,2,3,1,0,4,5,80.0,1,1,1,0,1,5,1,0,0,2020-2021,0.5882352941176471,2.3529411764705883
798,Niclas Eliasson,SWE,"MF,FW",Nîmes,Ligue 1,24,1995,20.0,28,14,9,12,7,11,24,45.8,13,20,1,19,23,51,16,0,0,2020-2021,1.15,1.4
799,Elif Elmas,MKD,"MF,FW",Napoli,Serie A,20,1999,8.2,15,4,3,6,6,7,12,58.3,5,11,1,10,2,17,10,0,0,2020-2021,0.24390243902439027,1.829268292682927
800,Ahmed Elmohamady,EGY,DF,Aston Villa,Premier League,32,1987,9.3,17,13,12,4,1,9,14,64.3,5,6,3,3,17,34,26,0,0,2020-2021,1.8279569892473118,1.8279569892473118
Rk,Player,Nation,Pos,Squad,Comp,0,0,90.0,0,0,3,3,3,Tkl,0,0.0,0,0,0,0,0,0,0,0,0,2020-2021,0.0,0.0
801,Mohamed Elneny,EGY,MF,Arsenal,Premier League,28,1992,17.2,14,6,7,7,0,7,28,25.0,21,11,4,7,24,38,20,2,0,2020-2021,1.3953488372093024,0.813953488372093
802,Aritz Elustondo,ESP,DF,Real Sociedad,La Liga,26,1994,20.9,30,16,21,7,2,18,22,81.8,4,12,5,7,15,45,63,0,0,2020-2021,0.7177033492822967,1.4354066985645935
803,Nico Elvedi,SUI,DF,Gladbach,Bundesliga,23,1996,28.2,49,35,36,12,1,25,37,67.6,12,38,22,16,65,114,123,0,0,2020-2021,2.3049645390070923,1.7375886524822695
804,Rodrigo Ely,BRA,DF,Alavés,La Liga,26,1993,5.2,5,2,3,2,0,3,4,75.0,1,2,1,1,7,12,23,1,0,2020-2021,1.346153846153846,0.9615384615384615
805,Breel Embolo,SUI,"FW,MF",Gladbach,Bundesliga,23,1997,16.0,15,10,1,13,1,0,6,0.0,6,16,1,15,8,23,8,0,0,2020-2021,0.5,0.9375
806,Emerson,BRA,DF,Betis,La Liga,21,1999,33.2,91,52,62,25,4,43,78,55.1,35,33,6,27,61,152,102,2,0,2020-2021,1.8373493975903612,2.7409638554216866
807,Renaud Emond,BEL,"FW,MF",Nantes,Ligue 1,28,1991,3.9,0,0,0,0,0,0,1,0.0,1,2,0,2,0,0,1,0,0,2020-2021,0.0,0.0
808,Alan Empereur,BRA,DF,Hellas Verona,Serie A,26,1994,2.4,0,0,0,0,0,0,0,0.0,0,1,1,0,6,6,7,1,0,2020-2021,2.5,0.0
809,Youssef En-Nesyri,MAR,FW,Sevilla,La Liga,23,1997,25.7,17,11,2,9,6,4,21,19.0,17,15,0,15,8,25,23,0,0,2020-2021,0.311284046692607,0.6614785992217899
810,Keita Endo,JPN,"MF,FW",Union Berlin,Bundesliga,22,1997,5.1,8,3,1,5,2,3,9,33.3,6,5,2,3,6,14,4,0,0,2020-2021,1.1764705882352942,1.5686274509803924
811,Wataru Endo,JPN,MF,Stuttgart,Bundesliga,27,1993,32.8,65,44,25,34,6,29,71,40.8,42,53,14,39,51,116,59,0,0,2020-2021,1.5548780487804879,1.981707317073171
812,Sergi Enrich,ESP,FW,Eibar,La Liga,30,1990,15.6,21,15,6,7,8,9,22,40.9,13,11,0,11,6,27,5,0,0,2020-2021,0.38461538461538464,1.3461538461538463
813,Christian Eriksen,DEN,MF,Inter,Serie A,28,1992,15.4,12,6,6,4,2,7,20,35.0,13,16,1,15,9,21,13,1,0,2020-2021,0.5844155844155844,0.7792207792207793
814,Martin Erlic,CRO,DF,Spezia,Serie A,22,1998,20.0,23,14,16,6,1,11,20,55.0,9,22,16,6,41,64,71,2,0,2020-2021,2.05,1.15
815,Patrick Erras,GER,"FW,MF",Werder Bremen,Bundesliga,25,1995,0.3,0,0,0,0,0,0,1,0.0,1,0,0,0,0,0,0,0,0,2020-2021,0.0,0.0
816,Gonzalo Escalante,ARG,MF,Lazio,Serie A,27,1993,8.1,26,13,11,14,1,8,28,28.6,20,10,3,7,19,45,13,0,0,2020-2021,2.345679012345679,3.2098765432098766
817,Aarón Escandell,ESP,GK,Granada,La Liga,24,1995,5.0,1,1,1,0,0,1,1,100.0,0,0,0,0,0,1,6,0,0,2020-2021,0.0,0.2
818,Dani Escriche,ESP,"FW,MF",Huesca,La Liga,22,1998,9.5,9,7,5,2,2,3,10,30.0,7,11,0,11,8,17,5,0,0,2020-2021,0.8421052631578947,0.9473684210526315
819,Sergio Escudero,ESP,DF,Sevilla,La Liga,30,1989,6.3,12,8,6,5,1,6,12,50.0,6,5,2,3,9,21,7,0,0,2020-2021,1.4285714285714286,1.9047619047619049
820,Alfonso Espino,URU,DF,Cádiz,La Liga,28,1992,28.9,92,48,63,28,1,43,85,50.6,42,30,5,25,41,133,74,0,0,2020-2021,1.4186851211072664,3.183391003460208
821,Vicente Esquerdo,ESP,MF,Valencia,La Liga,21,1999,2.6,7,4,5,2,0,4,6,66.7,2,4,2,2,8,15,1,0,0,2020-2021,3.0769230769230766,2.692307692307692
822,Nahuel Estévez,ARG,MF,Spezia,Serie A,24,1995,19.6,13,5,4,6,3,5,32,15.6,27,23,5,18,20,33,22,1,0,2020-2021,1.0204081632653061,0.6632653061224489
823,Pervis Estupiñán,ECU,DF,Villarreal,La Liga,22,1998,13.0,37,17,23,12,2,14,23,60.9,9,10,2,8,35,72,14,2,0,2020-2021,2.6923076923076925,2.8461538461538463
824,Yoann Etienne,FRA,DF,Lorient,Ligue 1,23,1997,1.0,2,0,1,1,0,1,1,100.0,0,1,0,1,1,3,2,0,0,2020-2021,1.0,2.0
825,Xabier Etxeita,ESP,DF,Getafe,La Liga,32,1987,9.8,8,4,5,3,0,7,14,50.0,7,6,3,3,13,21,38,0,0,2020-2021,1.3265306122448979,0.8163265306122448
Rk,Player,Nation,Pos,Squad,Comp,0,0,90.0,0,0,3,3,3,Tkl,0,0.0,0,0,0,0,0,0,0,0,0,2020-2021,0.0,0.0
826,Jonny Evans,NIR,DF,Leicester City,Premier League,32,1988,27.5,25,12,22,2,1,14,20,70.0,6,8,3,5,46,71,98,1,0,2020-2021,1.6727272727272726,0.9090909090909091
827,Edu Expósito,ESP,MF,Eibar,La Liga,23,1996,27.3,51,30,16,31,4,20,66,30.3,46,25,4,21,22,73,17,0,0,2020-2021,0.8058608058608059,1.8681318681318682
828,Valentin Eysseric,FRA,"MF,FW",Fiorentina,Serie A,28,1992,8.1,14,8,6,7,1,5,11,45.5,6,11,0,11,7,21,8,0,0,2020-2021,0.8641975308641976,1.7283950617283952
829,Eberechi Eze,ENG,MF,Crystal Palace,Premier League,22,1998,28.4,27,14,11,13,3,16,35,45.7,19,19,3,16,24,51,9,1,0,2020-2021,0.8450704225352114,0.9507042253521127
830,Jokin Ezkieta,ESP,GK,Athletic Club,La Liga,23,1996,1.0,0,0,0,0,0,0,0,0.0,0,0,0,0,0,0,0,0,0,2020-2021,0.0,0.0
831,Łukasz Fabiański,POL,GK,West Ham,Premier League,35,1985,35.0,1,0,1,0,0,1,1,100.0,0,1,0,1,1,2,12,3,0,2020-2021,0.02857142857142857,0.02857142857142857
832,Fabinho,BRA,"DF,MF",Liverpool,Premier League,26,1993,28.5,58,31,21,29,8,27,54,50.0,27,28,10,18,44,102,66,1,0,2020-2021,1.543859649122807,2.0350877192982457
833,Fábio,BRA,DF,Nantes,Ligue 1,30,1990,16.7,62,37,37,23,2,35,61,57.4,26,29,8,21,37,99,49,0,0,2020-2021,2.215568862275449,3.712574850299401
834,Cesc Fàbregas,ESP,"MF,FW",Monaco,Ligue 1,33,1987,9.7,20,12,6,9,5,9,22,40.9,13,11,1,10,13,33,3,0,0,2020-2021,1.3402061855670104,2.061855670103093
835,Bandiougou Fadiga,FRA,"FW,MF",Paris S-G,Ligue 1,19,2001,0.7,1,0,1,0,0,0,0,0.0,0,0,0,0,0,1,0,0,0,2020-2021,0.0,1.4285714285714286
836,Bandiougou Fadiga,FRA,"MF,FW",Brest,Ligue 1,19,2001,0.5,0,0,0,0,0,0,2,0.0,2,0,0,0,0,0,0,0,0,2020-2021,0.0,0.0
837,Wout Faes,BEL,DF,Reims,Ligue 1,22,1998,32.2,35,22,26,9,0,20,39,51.3,19,40,31,9,68,103,144,1,0,2020-2021,2.111801242236025,1.0869565217391304
838,Nicolò Fagioli,ITA,MF,Juventus,Serie A,19,2001,0.2,0,0,0,0,0,0,0,0.0,0,0,0,0,0,0,1,0,0,2020-2021,0.0,0.0
839,Ralf Fährmann,GER,GK,Schalke 04,Bundesliga,31,1988,20.8,2,1,2,0,0,1,2,50.0,1,0,0,0,1,3,9,3,0,2020-2021,0.04807692307692307,0.09615384615384615
840,Romain Faivre,FRA,"MF,FW",Brest,Ligue 1,22,1998,32.1,54,27,26,23,5,21,54,38.9,33,30,0,30,30,84,18,0,0,2020-2021,0.9345794392523364,1.6822429906542056
841,Fali,ESP,"DF,MF",Cádiz,La Liga,26,1993,29.3,42,25,24,15,3,16,37,43.2,21,28,15,13,32,74,119,0,0,2020-2021,1.0921501706484642,1.4334470989761092
842,Iago Falque,ESP,"MF,FW",Benevento,Serie A,30,1990,4.0,4,2,2,2,0,1,6,16.7,5,4,1,3,0,4,1,0,0,2020-2021,0.0,1.0
843,Andri Fannar Baldursson,ISL,MF,Bologna,Serie A,18,2002,2.4,6,6,1,2,3,1,3,33.3,2,3,1,2,3,9,7,0,0,2020-2021,1.25,2.5
844,Paolo Faragò,ITA,DF,Bologna,Serie A,27,1993,0.3,1,1,1,0,0,1,2,50.0,1,1,0,1,0,1,0,0,0,2020-2021,0.0,3.3333333333333335
845,Paolo Faragò,ITA,DF,Cagliari,Serie A,27,1993,4.1,13,9,10,3,0,9,20,45.0,11,3,2,1,6,19,15,0,0,2020-2021,1.4634146341463417,3.1707317073170733
846,Davide Faraoni,ITA,DF,Hellas Verona,Serie A,28,1991,32.1,62,33,36,19,7,28,51,54.9,23,48,17,31,49,111,83,1,0,2020-2021,1.5264797507788161,1.9314641744548287
847,Mohamed Fares,ALG,DF,Lazio,Serie A,24,1996,12.7,20,15,9,7,4,11,19,57.9,8,14,1,13,16,36,21,0,0,2020-2021,1.2598425196850394,1.5748031496062993
848,Diego Farias,BRA,FW,Spezia,Serie A,30,1990,16.8,9,5,4,1,4,4,21,19.0,17,12,0,12,13,22,3,0,0,2020-2021,0.7738095238095237,0.5357142857142857
849,Wuilker Faríñez,VEN,GK,Lens,Ligue 1,22,1998,1.2,0,0,0,0,0,0,0,0.0,0,0,0,0,0,0,1,0,0,2020-2021,0.0,0.0
850,Noah Fatar,FRA,"FW,MF",Angers,Ligue 1,18,2002,0.2,1,0,0,0,1,0,0,0.0,0,0,0,0,0,1,0,0,0,2020-2021,0.0,5.0
Rk,Player,Nation,Pos,Squad,Comp,0,0,90.0,0,0,3,3,3,Tkl,0,0.0,0,0,0,0,0,0,0,0,0,2020-2021,0.0,0.0
851,Ansu Fati,ESP,FW,Barcelona,La Liga,17,2002,4.8,9,4,2,4,3,2,10,20.0,8,4,0,4,3,12,1,0,0,2020-2021,0.625,1.875
852,Julien Faussurier,FRA,DF,Brest,Ligue 1,33,1987,10.6,16,11,6,8,2,11,25,44.0,14,12,4,8,9,25,10,0,0,2020-2021,0.8490566037735849,1.509433962264151
853,Andrea Favilli,ITA,FW,Hellas Verona,Serie A,23,1997,3.8,3,1,0,1,2,2,3,66.7,1,2,0,2,0,3,2,0,0,2020-2021,0.0,0.7894736842105263
854,Federico Fazio,ARG,DF,Roma,Serie A,33,1987,4.5,3,2,3,0,0,3,4,75.0,1,3,3,0,7,10,18,1,0,2020-2021,1.5555555555555556,0.6666666666666666
855,Nabil Fekir,FRA,"MF,FW",Betis,La Liga,27,1993,29.1,45,23,9,22,14,7,43,16.3,36,31,2,29,8,53,2,0,0,2020-2021,0.274914089347079,1.5463917525773194
856,Felipe,BRA,DF,Atlético Madrid,La Liga,31,1989,22.9,29,17,19,10,0,18,23,78.3,5,30,15,15,36,65,128,2,0,2020-2021,1.572052401746725,1.2663755458515285
857,Luiz Felipe,ITA,DF,Lazio,Serie A,23,1997,10.1,32,20,19,11,2,16,24,66.7,8,20,9,11,21,53,29,1,0,2020-2021,2.0792079207920793,3.1683168316831685
858,João Félix,POR,"FW,MF",Atlético Madrid,La Liga,20,1999,17.5,8,4,1,6,1,4,17,23.5,13,3,0,3,5,13,2,0,0,2020-2021,0.2857142857142857,0.45714285714285713
859,Ohis Felix Uduokhai,GER,DF,Augsburg,Bundesliga,22,1997,29.0,33,24,19,10,4,18,27,66.7,9,48,25,23,54,87,164,2,0,2020-2021,1.8620689655172413,1.1379310344827587
860,Zinedine Ferhat,ALG,"FW,MF",Nîmes,Ligue 1,27,1993,32.9,36,21,18,9,9,18,39,46.2,21,22,0,22,32,68,38,0,0,2020-2021,0.9726443768996961,1.0942249240121582
861,Bruno Fernandes,POR,MF,Manchester Utd,Premier League,25,1994,34.4,57,30,16,29,12,26,100,26.0,74,38,0,38,26,83,29,0,0,2020-2021,0.7558139534883721,1.6569767441860466
862,Edimilson Fernandes,SUI,"MF,FW",Mainz 05,Bundesliga,24,1996,9.3,8,4,4,4,0,4,7,57.1,3,12,4,8,29,37,25,0,0,2020-2021,3.118279569892473,0.8602150537634408
863,Aitor Fernández,ESP,GK,Levante,La Liga,29,1991,29.0,0,0,0,0,0,0,0,0.0,0,0,0,0,2,2,17,1,0,2020-2021,0.06896551724137931,0.0
864,Álex Fernández,ESP,MF,Cádiz,La Liga,27,1992,21.6,19,9,8,8,3,8,30,26.7,22,14,1,13,22,41,15,0,0,2020-2021,1.0185185185185184,0.8796296296296295
865,Álvaro Fernández,ESP,GK,Huesca,La Liga,22,1998,22.0,1,1,0,1,0,1,3,33.3,2,0,0,0,2,3,7,0,0,2020-2021,0.09090909090909091,0.045454545454545456
866,Andrés Fernández,ESP,GK,Huesca,La Liga,33,1986,16.0,0,0,0,0,0,0,0,0.0,0,0,0,0,0,0,3,2,0,2020-2021,0.0,0.0
867,Augusto Fernández,ARG,MF,Cádiz,La Liga,34,1986,4.1,11,3,5,6,0,2,13,15.4,11,5,1,4,9,20,5,0,0,2020-2021,2.1951219512195124,2.682926829268293
868,Carlos Fernández,ESP,FW,Sevilla,La Liga,24,1996,1.6,1,0,1,0,0,0,2,0.0,2,3,1,2,1,2,0,0,0,2020-2021,0.625,0.625
869,Carlos Fernández,ESP,"FW,MF",Real Sociedad,La Liga,24,1996,4.3,3,2,0,2,1,1,8,12.5,7,6,1,5,0,3,6,0,0,2020-2021,0.0,0.6976744186046512
870,Federico Fernández,ARG,DF,Newcastle Utd,Premier League,31,1989,23.1,29,22,23,5,1,17,21,81.0,4,41,31,10,17,46,147,0,0,2020-2021,0.7359307359307359,1.2554112554112553
871,Joaquín Fernández,ESP,DF,Valladolid,La Liga,24,1996,23.0,30,16,21,8,1,12,21,57.1,9,24,15,9,43,73,113,0,0,2020-2021,1.8695652173913044,1.3043478260869565
872,Fernandinho,BRA,MF,Manchester City,Premier League,35,1985,13.2,31,17,8,14,9,20,43,46.5,23,11,2,9,23,54,17,0,0,2020-2021,1.7424242424242424,2.3484848484848486
873,Fernando,BRA,MF,Sevilla,La Liga,33,1987,28.3,54,28,24,25,5,23,43,53.5,20,25,11,14,41,95,70,0,0,2020-2021,1.448763250883392,1.9081272084805654
874,Alex Ferrari,ITA,DF,Sampdoria,Serie A,26,1994,9.8,27,15,16,9,2,15,24,62.5,9,18,6,12,23,50,26,0,0,2020-2021,2.346938775510204,2.7551020408163263
875,David Ferreiro,ESP,"MF,FW",Huesca,La Liga,32,1988,28.1,25,12,12,8,5,8,49,16.3,41,21,1,20,25,50,15,0,0,2020-2021,0.889679715302491,0.889679715302491
Rk,Player,Nation,Pos,Squad,Comp,0,0,90.0,0,0,3,3,3,Tkl,0,0.0,0,0,0,0,0,0,0,0,0,2020-2021,0.0,0.0
876,Salvador Ferrer,ESP,DF,Spezia,Serie A,22,1998,13.2,20,10,10,8,2,8,22,36.4,14,13,4,9,24,44,37,1,0,2020-2021,1.8181818181818183,1.5151515151515151
877,Facundo Ferreyra,ARG,FW,Celta Vigo,La Liga,29,1991,3.3,4,3,1,2,1,0,2,0.0,2,5,0,5,2,6,2,0,0,2020-2021,0.6060606060606061,1.2121212121212122
878,Jordan Ferri,FRA,MF,Montpellier,Ligue 1,28,1992,28.6,58,40,34,22,2,31,103,30.1,72,30,5,25,8,66,18,1,0,2020-2021,0.2797202797202797,2.027972027972028
879,Marco Festa,ITA,GK,Crotone,Serie A,28,1992,1.0,0,0,0,0,0,0,0,0.0,0,0,0,0,0,0,0,0,0,2020-2021,0.0,0.0
880,Fidel,ESP,"MF,DF",Elche,La Liga,30,1989,26.6,46,30,28,15,3,25,64,39.1,39,22,2,20,16,62,14,0,0,2020-2021,0.6015037593984962,1.7293233082706767
881,Sam Field,ENG,MF,West Brom,Premier League,22,1998,0.7,5,5,3,2,0,0,0,0.0,0,4,1,3,2,7,4,0,0,2020-2021,2.857142857142857,7.142857142857143
882,Alfreð Finnbogason,ISL,FW,Augsburg,Bundesliga,31,1989,6.0,2,1,0,1,1,0,1,0.0,1,7,1,6,1,3,4,0,0,2020-2021,0.16666666666666666,0.3333333333333333
883,Roberto Firmino,BRA,FW,Liverpool,Premier League,28,1991,31.5,33,15,3,17,13,6,32,18.8,26,42,5,37,11,44,12,0,0,2020-2021,0.3492063492063492,1.0476190476190477
884,Junior Firpo,DOM,"DF,MF",Barcelona,La Liga,23,1996,3.2,1,1,1,0,0,0,1,0.0,1,5,3,2,4,5,7,0,0,2020-2021,1.25,0.3125
885,Will Fish,ENG,FW,Manchester Utd,Premier League,17,2003,0.0,0,0,0,0,0,0,0,0.0,0,0,0,0,0,0,0,0,0,2020-2021,,
886,John Fleck,SCO,MF,Sheffield Utd,Premier League,28,1991,28.6,51,33,28,18,5,26,83,31.3,57,26,4,22,28,79,12,1,0,2020-2021,0.979020979020979,1.7832167832167831
887,Mark Flekken,NED,GK,Freiburg,Bundesliga,27,1993,3.0,0,0,0,0,0,0,0,0.0,0,0,0,0,0,0,1,0,0,2020-2021,0.0,0.0
888,Florian Flick,GER,MF,Schalke 04,Bundesliga,20,2000,4.0,10,7,4,6,0,7,16,43.8,9,4,3,1,7,17,5,1,0,2020-2021,1.75,2.5
889,Alexis Flips,FRA,"MF,FW",Reims,Ligue 1,20,2000,0.5,0,0,0,0,0,0,2,0.0,2,0,0,0,0,0,1,0,0,2020-2021,0.0,0.0
890,Alessandro Florenzi,ITA,DF,Paris S-G,Ligue 1,29,1991,17.1,24,16,9,9,6,12,29,41.4,17,7,1,6,17,41,25,0,0,2020-2021,0.9941520467836257,1.4035087719298245
891,Kingsley Fobi,GHA,DF,Granada,La Liga,21,1998,0.5,0,0,0,0,0,0,0,0.0,0,0,0,0,1,1,1,0,0,2020-2021,2.0,0.0
892,Phil Foden,ENG,"FW,MF",Manchester City,Premier League,20,2000,18.0,22,11,12,8,2,9,23,39.1,14,9,0,9,11,33,11,0,0,2020-2021,0.6111111111111112,1.2222222222222223
893,Mamadou Fofana,MLI,"MF,DF",Metz,Ligue 1,22,1998,11.9,25,11,17,8,0,7,31,22.6,24,14,2,12,18,43,36,0,0,2020-2021,1.5126050420168067,2.100840336134454
894,Seko Fofana,CIV,MF,Lens,Ligue 1,25,1995,25.7,16,8,3,10,3,4,26,15.4,22,16,5,11,34,50,23,1,0,2020-2021,1.3229571984435797,0.622568093385214
895,Wesley Fofana,FRA,DF,Leicester City,Premier League,19,2000,25.1,51,37,27,22,2,31,46,67.4,15,28,16,12,61,112,94,0,0,2020-2021,2.4302788844621515,2.0318725099601593
896,Wesley Fofana,FRA,DF,Saint-Étienne,Ligue 1,19,2000,3.5,6,4,6,0,0,3,4,75.0,1,3,3,0,8,14,14,1,0,2020-2021,2.2857142857142856,1.7142857142857142
897,Youssouf Fofana,FRA,MF,Monaco,Ligue 1,21,1999,31.9,90,51,31,51,8,42,82,51.2,40,43,7,36,34,124,14,2,0,2020-2021,1.0658307210031348,2.8213166144200628
898,Thomas Foket,BEL,DF,Reims,Ligue 1,25,1994,36.9,77,43,50,20,7,40,69,58.0,29,28,7,21,69,146,92,2,0,2020-2021,1.869918699186992,2.086720867208672
899,Ramón Folch,ESP,MF,Elche,La Liga,30,1989,0.0,0,0,0,0,0,0,0,0.0,0,0,0,0,0,0,0,0,0,2020-2021,,
900,Lamine Fomba,FRA,MF,Nîmes,Ligue 1,22,1998,24.2,66,36,30,25,11,30,65,46.2,35,48,19,29,59,125,39,2,0,2020-2021,2.43801652892562,2.7272727272727275
Rk,Player,Nation,Pos,Squad,Comp,0,0,90.0,0,0,3,3,3,Tkl,0,0.0,0,0,0,0,0,0,0,0,0,2020-2021,0.0,0.0
901,Thomas Fontaine,MAD,DF,Lorient,Ligue 1,29,1991,3.6,5,2,5,0,0,2,2,100.0,0,3,2,1,5,10,14,0,0,2020-2021,1.3888888888888888,1.3888888888888888
902,José Fontán,ESP,DF,Celta Vigo,La Liga,20,2000,7.2,12,9,8,4,0,5,11,45.5,6,4,3,1,13,25,27,0,0,2020-2021,1.8055555555555556,1.6666666666666665
903,José Fonte,POR,DF,Lille,Ligue 1,36,1983,35.4,40,29,28,10,2,27,33,81.8,6,36,23,13,36,76,137,1,0,2020-2021,1.0169491525423728,1.1299435028248588
904,Fernando Forestieri,ITA,"FW,MF",Udinese,Serie A,30,1990,6.1,9,7,4,4,1,3,7,42.9,4,7,0,7,2,11,0,0,0,2020-2021,0.3278688524590164,1.4754098360655739
905,Pablo Fornals,ESP,"FW,MF",West Ham,Premier League,24,1996,28.6,44,26,14,24,6,11,73,15.1,62,43,1,42,36,80,9,0,0,2020-2021,1.2587412587412588,1.5384615384615383
906,Emil Forsberg,SWE,"FW,MF",RB Leipzig,Bundesliga,28,1991,17.1,11,6,1,6,4,5,27,18.5,22,10,1,9,11,22,4,0,0,2020-2021,0.6432748538011696,0.6432748538011696
907,Fraser Forster,ENG,GK,Southampton,Premier League,32,1988,8.0,1,0,1,0,0,1,2,50.0,1,0,0,0,0,1,9,0,0,2020-2021,0.0,0.125
908,Philipp Förster,GER,MF,Stuttgart,Bundesliga,25,1995,16.8,22,13,7,12,3,6,25,24.0,19,18,1,17,15,37,2,0,0,2020-2021,0.8928571428571428,1.3095238095238095
909,Steven Fortes,CPV,DF,Lens,Ligue 1,28,1992,15.9,33,20,20,10,3,16,22,72.7,6,25,10,15,27,60,52,0,0,2020-2021,1.6981132075471699,2.0754716981132075
910,Yassin Fortune,FRA,FW,Angers,Ligue 1,21,1999,0.2,0,0,0,0,0,0,0,0.0,0,0,0,0,0,0,0,0,0,2020-2021,0.0,0.0
911,Timothy Fosu-Mensah,NED,DF,Manchester Utd,Premier League,22,1998,0.9,2,0,1,1,0,1,1,100.0,0,0,0,0,3,5,1,0,0,2020-2021,3.333333333333333,2.2222222222222223
912,Timothy Fosu-Mensah,NED,DF,Leverkusen,Bundesliga,22,1998,4.5,4,2,1,2,1,2,4,50.0,2,7,3,4,7,11,4,0,0,2020-2021,1.5555555555555556,0.8888888888888888
913,Daam Foulon,BEL,DF,Benevento,Serie A,21,1999,11.3,26,15,21,5,0,16,28,57.1,12,12,3,9,14,40,34,0,0,2020-2021,1.238938053097345,2.3008849557522124
914,Dimitri Foulquier,FRA,DF,Granada,La Liga,27,1993,29.6,35,21,20,12,3,15,26,57.7,11,24,7,17,26,61,60,0,0,2020-2021,0.8783783783783783,1.1824324324324325
915,Juan Foyth,ARG,"DF,MF",Villarreal,La Liga,22,1998,13.0,40,22,22,14,4,12,29,41.4,17,21,6,15,19,59,24,1,0,2020-2021,1.4615384615384615,3.076923076923077
916,Gianluca Frabotta,ITA,"DF,MF",Juventus,Serie A,21,1999,7.7,7,4,5,0,2,5,12,41.7,7,9,1,8,14,21,15,0,0,2020-2021,1.8181818181818181,0.9090909090909091
917,Raphael Framberger,GER,DF,Augsburg,Bundesliga,24,1995,17.1,42,23,26,11,5,19,25,76.0,6,24,2,22,36,78,62,1,0,2020-2021,2.1052631578947367,2.4561403508771926
918,Tyrese Francois,AUS,DF,Fulham,Premier League,20,2000,0.2,0,0,0,0,0,0,0,0.0,0,0,0,0,0,0,0,0,0,2020-2021,0.0,0.0
919,Ryan Fraser,SCO,"FW,MF",Newcastle Utd,Premier League,26,1994,10.3,4,1,3,1,0,2,5,40.0,3,1,0,1,6,10,7,0,0,2020-2021,0.5825242718446602,0.3883495145631068
920,Fred,BRA,MF,Manchester Utd,Premier League,27,1993,26.6,81,39,39,38,4,29,89,32.6,60,49,9,40,45,126,26,1,0,2020-2021,1.6917293233082706,3.045112781954887
921,Ryan Fredericks,ENG,"DF,FW",West Ham,Premier League,27,1992,6.3,9,5,5,4,0,3,7,42.9,4,6,2,4,11,20,20,0,0,2020-2021,1.746031746031746,1.4285714285714286
922,Remo Freuler,SUI,MF,Atalanta,Serie A,28,1992,30.1,63,39,17,38,8,32,76,42.1,44,52,4,48,39,102,27,2,0,2020-2021,1.2956810631229236,2.093023255813953
923,Marco Friedl,AUT,DF,Werder Bremen,Bundesliga,22,1998,30.9,50,34,31,17,2,30,62,48.4,32,38,17,21,55,105,118,1,0,2020-2021,1.7799352750809063,1.6181229773462784
924,Marvin Friedrich,GER,DF,Union Berlin,Bundesliga,24,1995,34.0,47,29,35,11,1,18,32,56.3,14,38,18,20,52,99,109,0,0,2020-2021,1.5294117647058822,1.3823529411764706
925,Jeremie Frimpong,NED,"DF,FW",Leverkusen,Bundesliga,19,2000,4.8,7,4,4,3,0,4,8,50.0,4,4,0,4,1,8,7,0,0,2020-2021,0.20833333333333334,1.4583333333333335
Rk,Player,Nation,Pos,Squad,Comp,0,0,90.0,0,0,3,3,3,Tkl,0,0.0,0,0,0,0,0,0,0,0,0,2020-2021,0.0,0.0
926,Jorge de Frutos,ESP,MF,Levante,La Liga,23,1997,24.3,48,24,21,21,6,11,41,26.8,30,25,2,23,16,64,18,0,0,2020-2021,0.6584362139917695,1.9753086419753085
927,Christian Fuchs,AUT,DF,Leicester City,Premier League,34,1986,7.8,18,7,15,2,1,8,15,53.3,7,6,4,2,16,34,34,1,0,2020-2021,2.0512820512820515,2.307692307692308
928,Angelo Fulgini,FRA,MF,Angers,Ligue 1,23,1996,30.3,22,13,4,12,6,12,34,35.3,22,17,0,17,15,37,9,0,0,2020-2021,0.49504950495049505,0.7260726072607261
929,Niclas Füllkrug,GER,FW,Werder Bremen,Bundesliga,27,1993,9.7,7,3,2,4,1,1,13,7.7,12,10,4,6,3,10,13,0,0,2020-2021,0.30927835051546393,0.7216494845360826
930,Ramiro Funes Mori,ARG,DF,Villarreal,La Liga,29,1991,8.1,12,8,7,5,0,7,11,63.6,4,7,5,2,8,20,42,1,0,2020-2021,0.9876543209876544,1.4814814814814816
931,Darnell Furlong,ENG,DF,West Brom,Premier League,24,1995,32.6,45,27,27,12,6,21,44,47.7,23,39,16,23,49,94,90,0,0,2020-2021,1.5030674846625767,1.3803680981595092
932,Daniel Fuzato,BRA,GK,Roma,Serie A,23,1997,5.0,0,0,0,0,0,0,0,0.0,0,1,0,1,0,0,1,1,0,2020-2021,0.0,0.0
933,Baptiste Gabard,FRA,MF,Saint-Étienne,Ligue 1,20,2000,1.5,4,3,1,3,0,1,5,20.0,4,4,0,4,1,5,0,0,0,2020-2021,0.6666666666666666,2.6666666666666665
934,Matteo Gabbia,ITA,DF,Milan,Serie A,20,1999,6.2,9,5,3,6,0,2,2,100.0,0,8,6,2,3,12,21,0,0,2020-2021,0.48387096774193544,1.4516129032258065
935,Manolo Gabbiadini,ITA,FW,Sampdoria,Serie A,28,1991,9.7,2,2,0,2,0,0,1,0.0,1,3,1,2,3,5,5,0,0,2020-2021,0.30927835051546393,0.2061855670103093
936,Mijat Gaćinović,SRB,"DF,MF",Hoffenheim,Bundesliga,25,1995,9.1,18,10,6,11,1,9,24,37.5,15,13,0,13,18,36,15,0,0,2020-2021,1.978021978021978,1.978021978021978
937,Roberto Gagliardini,ITA,MF,Inter,Serie A,26,1994,13.7,30,17,17,8,5,5,28,17.9,23,15,3,12,19,49,16,0,0,2020-2021,1.3868613138686132,2.18978102189781
938,Riccardo Gagliolo,SWE,DF,Parma,Serie A,30,1990,21.7,45,18,35,8,2,28,45,62.2,17,34,7,27,36,81,64,1,0,2020-2021,1.6589861751152075,2.0737327188940093
939,Adolfo Gaich,ARG,FW,Benevento,Serie A,21,1999,8.5,9,4,1,7,1,1,13,7.7,12,4,0,4,2,11,4,0,0,2020-2021,0.23529411764705882,1.0588235294117647
940,Andrey Galabinov,BUL,FW,Spezia,Serie A,31,1988,4.8,2,1,1,1,0,1,3,33.3,2,2,0,2,0,2,5,0,0,2020-2021,0.0,0.4166666666666667
941,Javi Galán,ESP,DF,Huesca,La Liga,25,1994,34.1,88,54,47,35,6,46,72,63.9,26,30,4,26,39,127,61,0,0,2020-2021,1.1436950146627565,2.5806451612903225
942,Conor Gallagher,ENG,MF,West Brom,Premier League,20,2000,28.1,81,41,30,39,12,29,97,29.9,68,47,8,39,27,108,31,0,0,2020-2021,0.9608540925266903,2.882562277580071
943,Enric Gallego,ESP,FW,Osasuna,La Liga,33,1986,9.0,6,3,2,2,2,2,14,14.3,12,5,1,4,1,7,9,0,0,2020-2021,0.1111111111111111,0.6666666666666666
944,Kévin Gameiro,FRA,FW,Valencia,La Liga,33,1987,12.0,7,4,3,2,2,3,11,27.3,8,10,0,10,0,7,3,0,0,2020-2021,0.0,0.5833333333333334
945,Idrissa Gana Gueye,SEN,MF,Paris S-G,Ligue 1,30,1989,17.6,63,35,20,34,9,26,50,52.0,24,26,7,19,20,83,9,3,0,2020-2021,1.1363636363636362,3.579545454545454
946,Ignatius Ganago,CMR,FW,Lens,Ligue 1,21,1999,14.5,4,3,0,2,2,3,12,25.0,9,7,1,6,6,10,3,0,0,2020-2021,0.41379310344827586,0.27586206896551724
947,Aleix García,ESP,MF,Eibar,La Liga,23,1997,4.9,5,4,2,2,1,1,10,10.0,9,5,0,5,8,13,2,0,0,2020-2021,1.6326530612244896,1.0204081632653061
948,Borja García,ESP,"MF,FW",Huesca,La Liga,29,1990,12.4,13,7,4,6,3,6,12,50.0,6,12,0,12,10,23,4,1,0,2020-2021,0.8064516129032258,1.0483870967741935
949,Dani García,ESP,MF,Athletic Club,La Liga,30,1990,21.3,39,19,10,23,6,15,46,32.6,31,20,7,13,33,72,34,0,0,2020-2021,1.5492957746478873,1.8309859154929577
950,David García,ESP,DF,Osasuna,La Liga,26,1994,35.0,26,17,13,13,0,13,24,54.2,11,36,19,17,59,85,171,0,0,2020-2021,1.6857142857142857,0.7428571428571429
Rk,Player,Nation,Pos,Squad,Comp,0,0,90.0,0,0,3,3,3,Tkl,0,0.0,0,0,0,0,0,0,0,0,0,2020-2021,0.0,0.0
951,Eric García,ESP,DF,Manchester City,Premier League,19,2001,4.3,8,7,5,3,0,5,7,71.4,2,4,1,3,4,12,10,0,0,2020-2021,0.9302325581395349,1.8604651162790697
952,Manu García,ESP,MF,Alavés,La Liga,34,1986,12.5,24,13,10,13,1,8,35,22.9,27,16,1,15,12,36,21,0,0,2020-2021,0.96,1.92
953,Raúl García,ESP,"DF,MF",Valladolid,La Liga,31,1989,5.6,10,8,5,5,0,6,20,30.0,14,5,1,4,9,19,10,0,0,2020-2021,1.6071428571428572,1.7857142857142858
954,Raúl García,ESP,"FW,MF",Athletic Club,La Liga,34,1986,19.4,34,19,9,19,6,7,22,31.8,15,30,1,29,15,49,20,0,0,2020-2021,0.7731958762886598,1.752577319587629
955,Rubén García,ESP,"MF,FW",Osasuna,La Liga,27,1993,30.2,50,29,21,22,7,14,45,31.1,31,28,2,26,29,79,20,0,0,2020-2021,0.9602649006622517,1.6556291390728477
956,Sergi García,ESP,MF,Alavés,La Liga,21,1999,0.2,1,1,0,1,0,0,1,0.0,1,0,0,0,0,1,0,0,0,2020-2021,0.0,5.0
957,Unai García,ESP,DF,Osasuna,La Liga,28,1992,13.8,19,9,14,4,1,9,15,60.0,6,16,8,8,14,33,40,0,0,2020-2021,1.0144927536231882,1.3768115942028984
958,Mario Gaspar,ESP,DF,Villarreal,La Liga,29,1990,20.6,55,34,22,24,9,21,40,52.5,19,26,4,22,30,85,47,1,0,2020-2021,1.4563106796116503,2.669902912621359
959,Manuel Gasparini,ITA,GK,Udinese,Serie A,18,2002,0.0,0,0,0,0,0,0,0,0.0,0,0,0,0,0,0,0,0,0,2020-2021,,
960,Dwight Gayle,ENG,"FW,MF",Newcastle Utd,Premier League,29,1990,5.7,2,0,1,1,0,0,7,0.0,7,3,1,2,1,3,2,0,0,2020-2021,0.17543859649122806,0.3508771929824561
961,Paulo Gazzaniga,ARG,GK,Elche,La Liga,28,1992,8.0,1,1,1,0,0,0,0,0.0,0,0,0,0,1,2,4,0,0,2020-2021,0.125,0.125
962,Jean-Philippe Gbamin,CIV,MF,Everton,Premier League,24,1995,0.1,1,0,0,1,0,0,0,0.0,0,1,0,1,0,1,1,0,0,2020-2021,0.0,10.0
963,Yann Gboho,FRA,"MF,FW",Rennes,Ligue 1,19,2001,3.4,6,3,3,1,2,3,8,37.5,5,1,0,1,1,7,3,1,0,2020-2021,0.29411764705882354,1.7647058823529411
964,David de Gea,ESP,GK,Manchester Utd,Premier League,29,1990,25.5,0,0,0,0,0,0,0,0.0,0,0,0,0,0,0,8,3,0,2020-2021,0.0,0.0
965,Christian Gebauer,AUT,"MF,FW",Arminia,Bundesliga,26,1993,7.6,9,4,2,5,2,4,11,36.4,7,4,1,3,6,15,14,0,0,2020-2021,0.7894736842105263,1.1842105263157896
966,Theodor Gebre Selassie,CZE,DF,Werder Bremen,Bundesliga,33,1986,33.7,61,35,39,17,5,28,64,43.8,36,33,11,22,58,119,98,1,0,2020-2021,1.7210682492581602,1.8100890207715132
967,Emrehan Gedikli,GER,FW,Leverkusen,Bundesliga,17,2003,0.3,0,0,0,0,0,0,0,0.0,0,0,0,0,0,0,0,0,0,2020-2021,0.0,0.0
968,Dennis Geiger,GER,MF,Hoffenheim,Bundesliga,22,1998,7.3,13,10,3,8,2,5,8,62.5,3,10,0,10,3,16,0,0,0,2020-2021,0.4109589041095891,1.7808219178082192
969,Christian Gentner,GER,MF,Union Berlin,Bundesliga,34,1985,11.5,17,8,9,5,3,5,18,27.8,13,13,1,12,17,34,16,0,0,2020-2021,1.4782608695652173,1.4782608695652173
970,Yannick Gerhardt,GER,"MF,FW",Wolfsburg,Bundesliga,26,1994,21.5,52,32,14,32,6,21,52,40.4,31,34,4,30,21,73,30,0,0,2020-2021,0.9767441860465116,2.4186046511627906
971,Valère Germain,FRA,"FW,MF",Marseille,Ligue 1,30,1990,9.5,8,6,2,4,2,3,11,27.3,8,7,2,5,11,19,22,0,0,2020-2021,1.1578947368421053,0.8421052631578947
972,Gervinho,CIV,FW,Parma,Serie A,33,1987,22.5,5,1,2,2,1,1,14,7.1,13,11,1,10,10,15,3,0,0,2020-2021,0.4444444444444444,0.2222222222222222
973,Willem Geubbels,FRA,"MF,FW",Monaco,Ligue 1,18,2001,3.3,12,8,5,7,0,5,13,38.5,8,9,0,9,3,15,5,0,0,2020-2021,0.9090909090909092,3.6363636363636367
974,Hamadi Al Ghaddioui,MAR,FW,Stuttgart,Bundesliga,29,1990,0.5,0,0,0,0,0,0,1,0.0,1,0,0,0,0,0,0,0,0,2020-2021,0.0,0.0
975,Anwar El Ghazi,NED,FW,Aston Villa,Premier League,25,1995,17.9,16,13,6,7,3,7,23,30.4,16,11,0,11,6,22,11,0,0,2020-2021,0.335195530726257,0.893854748603352
Rk,Player,Nation,Pos,Squad,Comp,0,0,90.0,0,0,3,3,3,Tkl,0,0.0,0,0,0,0,0,0,0,0,0,2020-2021,0.0,0.0
976,Paolo Ghiglione,ITA,"DF,MF",Genoa,Serie A,23,1997,15.1,27,15,17,8,2,13,28,46.4,15,14,2,12,13,40,25,0,0,2020-2021,0.8609271523178809,1.7880794701986755
977,Faouzi Ghoulam,ALG,"DF,FW",Napoli,Serie A,29,1991,3.2,6,5,3,2,1,0,1,0.0,1,4,2,2,3,9,1,0,0,2020-2021,0.9375,1.875
978,Kieran Gibbs,ENG,DF,West Brom,Premier League,30,1989,9.0,15,11,11,3,1,8,10,80.0,2,8,6,2,16,31,30,1,0,2020-2021,1.7777777777777777,1.6666666666666667
979,Morgan Gibbs-White,ENG,"MF,FW",Wolves,Premier League,20,2000,4.6,9,7,3,4,2,5,12,41.7,7,6,0,6,3,12,1,0,0,2020-2021,0.6521739130434783,1.956521739130435
980,Niko Gießelmann,GER,DF,Union Berlin,Bundesliga,28,1991,4.8,12,9,7,4,1,5,8,62.5,3,9,3,6,8,20,13,1,0,2020-2021,1.6666666666666667,2.5
981,Rafał Gikiewicz,POL,GK,Augsburg,Bundesliga,32,1987,34.0,0,0,0,0,0,0,3,0.0,3,0,0,0,3,3,9,1,0,2020-2021,0.08823529411764706,0.0
982,Bryan Gil,ESP,FW,Sevilla,La Liga,19,2001,0.1,1,1,0,1,0,0,0,0.0,0,0,0,0,0,1,0,0,0,2020-2021,0.0,10.0
983,Bryan Gil,ESP,"MF,FW",Eibar,La Liga,19,2001,25.2,28,18,12,11,5,6,23,26.1,17,20,0,20,17,45,6,0,0,2020-2021,0.6746031746031746,1.1111111111111112
984,David Gil,ESP,GK,Cádiz,La Liga,26,1994,4.0,0,0,0,0,0,0,1,0.0,1,0,0,0,0,0,2,0,0,2020-2021,0.0,0.0
985,Billy Gilmour,SCO,MF,Chelsea,Premier League,19,2001,2.9,4,2,1,2,1,2,7,28.6,5,3,2,1,3,7,1,0,0,2020-2021,1.0344827586206897,1.3793103448275863
986,Álvaro Giménez,ESP,FW,Cádiz,La Liga,29,1991,4.5,4,2,2,2,0,0,3,0.0,3,2,0,2,2,6,3,0,0,2020-2021,0.4444444444444444,0.8888888888888888
987,Daniel Ginczek,GER,"FW,MF",Wolfsburg,Bundesliga,29,1991,2.4,2,2,1,1,0,2,8,25.0,6,2,0,2,1,3,2,0,0,2020-2021,0.4166666666666667,0.8333333333333334
988,Matthias Ginter,GER,DF,Gladbach,Bundesliga,26,1994,34.0,26,16,15,10,1,14,24,58.3,10,43,32,11,51,77,121,0,0,2020-2021,1.5,0.7647058823529411
989,Andrei Girotto,BRA,"DF,MF",Nantes,Ligue 1,28,1992,29.6,65,41,50,15,0,39,70,55.7,31,34,15,19,59,124,103,0,0,2020-2021,1.9932432432432432,2.195945945945946
990,Olivier Giroud,FRA,FW,Chelsea,Premier League,33,1986,8.3,4,2,0,1,3,1,7,14.3,6,4,1,3,5,9,10,0,0,2020-2021,0.6024096385542168,0.48192771084337344
991,Robert Glatzel,GER,FW,Mainz 05,Bundesliga,26,1994,4.0,1,0,1,0,0,0,2,0.0,2,2,0,2,0,1,2,0,0,2020-2021,0.0,0.25
992,Kamil Glik,POL,DF,Benevento,Serie A,32,1988,35.6,44,24,33,10,1,25,53,47.2,28,37,31,6,62,106,153,0,0,2020-2021,1.7415730337078652,1.2359550561797752
993,Serge Gnabry,GER,"FW,MF",Bayern Munich,Bundesliga,25,1995,18.3,39,19,7,19,13,12,32,37.5,20,17,0,17,26,65,3,0,0,2020-2021,1.4207650273224044,2.1311475409836063
994,Ben Godfrey,ENG,DF,Everton,Premier League,22,1998,29.8,55,33,37,15,3,27,41,65.9,14,56,37,19,33,88,120,0,0,2020-2021,1.1073825503355705,1.8456375838926173
995,Diego Godín,URU,DF,Cagliari,Serie A,34,1986,27.9,60,32,51,9,0,24,39,61.5,15,41,24,17,56,116,117,0,0,2020-2021,2.0071684587813623,2.1505376344086025
996,Akaki Gogia,GER,"FW,MF",Union Berlin,Bundesliga,28,1992,1.6,1,0,0,1,0,0,2,0.0,2,0,0,0,1,2,0,0,0,2020-2021,0.625,0.625
997,Amer Gojak,BIH,"MF,FW",Torino,Serie A,23,1997,5.3,1,0,1,0,0,1,7,14.3,6,5,0,5,3,4,1,0,0,2020-2021,0.5660377358490566,0.18867924528301888
998,Edoardo Goldaniga,ITA,DF,Genoa,Serie A,26,1993,20.6,28,18,21,7,0,14,23,60.9,9,17,7,10,38,66,62,1,0,2020-2021,1.8446601941747571,1.3592233009708736
999,Vladimir Golemić,SVN,DF,Crotone,Serie A,29,1991,26.0,33,16,17,13,3,14,19,73.7,5,38,26,12,40,73,97,2,0,2020-2021,1.5384615384615385,1.2692307692307692
1000,Pierluigi Gollini,ITA,GK,Atalanta,Serie A,25,1995,24.0,1,0,1,0,0,1,2,50.0,1,1,0,1,1,2,11,0,0,2020-2021,0.041666666666666664,0.041666666666666664
Rk,Player,Nation,Pos,Squad,Comp,0,0,90.0,0,0,3,3,3,Tkl,0,0.0,0,0,0,0,0,0,0,0,0,2020-2021,0.0,0.0
1001,Aleksandr Golovin,RUS,"MF,FW",Monaco,Ligue 1,24,1996,11.9,28,16,6,18,4,8,39,20.5,31,21,0,21,11,39,3,0,0,2020-2021,0.9243697478991596,2.3529411764705883
1002,Tomislav Gomelt,CRO,MF,Crotone,Serie A,25,1995,0.2,1,1,0,1,0,0,0,0.0,0,0,0,0,1,2,0,0,0,2020-2021,5.0,5.0
1003,André Gomes,POR,MF,Everton,Premier League,27,1993,17.4,35,23,16,16,3,17,58,29.3,41,19,1,18,10,45,12,1,0,2020-2021,0.574712643678161,2.0114942528735633
1004,Dani Gómez,ESP,FW,Levante,La Liga,22,1998,18.5,4,3,2,1,1,0,11,0.0,11,3,0,3,2,6,4,0,0,2020-2021,0.10810810810810811,0.21621621621621623
1005,Ibai Gómez,ESP,MF,Athletic Club,La Liga,30,1989,4.7,6,4,2,3,1,4,7,57.1,3,3,0,3,2,8,4,0,0,2020-2021,0.425531914893617,1.276595744680851
1006,Joe Gomez,ENG,DF,Liverpool,Premier League,23,1997,6.6,3,2,1,1,1,0,4,0.0,4,3,2,1,4,7,29,0,0,2020-2021,0.6060606060606061,0.4545454545454546
1007,Maxi Gómez,URU,FW,Valencia,La Liga,23,1996,29.9,11,9,3,7,1,3,14,21.4,11,13,3,10,2,13,34,0,0,2020-2021,0.06688963210702341,0.3678929765886288
1008,Moi Gómez,ESP,"MF,FW",Villarreal,La Liga,26,1994,28.5,21,12,6,8,7,14,35,40.0,21,20,3,17,11,32,16,0,0,2020-2021,0.38596491228070173,0.7368421052631579
1009,Papu Gómez,ARG,"MF,FW",Atalanta,Serie A,32,1988,7.4,3,2,2,1,0,2,8,25.0,6,8,1,7,1,4,1,0,0,2020-2021,0.13513513513513511,0.4054054054054054
1010,Papu Gómez,ARG,"MF,FW",Sevilla,La Liga,32,1988,10.2,9,6,2,4,3,2,12,16.7,10,13,2,11,7,16,6,0,0,2020-2021,0.6862745098039216,0.8823529411764707
1011,Sergi Gómez,ESP,DF,Sevilla,La Liga,28,1992,8.0,4,3,2,2,0,1,1,100.0,0,5,4,1,6,10,34,0,0,2020-2021,0.75,0.5
1012,Sergio Gómez,ESP,"MF,FW",Huesca,La Liga,19,2000,8.8,29,10,17,9,3,11,22,50.0,11,15,0,15,14,43,9,0,0,2020-2021,1.5909090909090908,3.295454545454545
1013,Alfred Gomis,SEN,GK,Dijon,Ligue 1,26,1993,5.0,1,0,1,0,0,1,2,50.0,1,0,0,0,1,2,7,0,0,2020-2021,0.2,0.2
1014,Alfred Gomis,SEN,GK,Rennes,Ligue 1,26,1993,22.0,1,1,1,0,0,1,1,100.0,0,0,0,0,3,4,10,1,0,2020-2021,0.13636363636363635,0.045454545454545456
1015,Maxime Gonalons,FRA,MF,Granada,La Liga,31,1989,16.4,53,37,18,33,2,15,37,40.5,22,17,0,17,25,78,21,1,0,2020-2021,1.524390243902439,3.231707317073171
1016,Vagner Gonçalves,CPV,"FW,MF",Metz,Ligue 1,24,1996,10.7,16,9,5,5,6,2,15,13.3,13,6,0,6,4,20,1,1,0,2020-2021,0.3738317757009346,1.4953271028037385
1017,Álvaro González,ESP,DF,Marseille,Ligue 1,30,1990,31.5,26,17,20,6,0,19,31,61.3,12,30,18,12,33,59,119,1,0,2020-2021,1.0476190476190477,0.8253968253968254
1018,Bruno González,ESP,DF,Valladolid,La Liga,30,1990,25.1,26,17,18,8,0,17,31,54.8,14,22,14,8,37,63,112,1,0,2020-2021,1.4741035856573705,1.0358565737051793
1019,Diego González,ESP,DF,Elche,La Liga,25,1995,14.2,11,7,7,3,1,5,11,45.5,6,16,9,7,20,31,49,1,0,2020-2021,1.4084507042253522,0.7746478873239437
1020,Nicolás González,ARG,"FW,MF",Stuttgart,Bundesliga,22,1998,10.4,5,5,1,2,2,0,6,0.0,6,10,3,7,4,9,6,0,0,2020-2021,0.3846153846153846,0.4807692307692307
1021,Sergio González,ESP,"MF,DF",Cádiz,La Liga,23,1997,1.0,1,0,0,1,0,1,2,50.0,1,0,0,0,2,3,0,0,0,2020-2021,2.0,1.0
1022,Urko González,ESP,MF,Real Sociedad,La Liga,19,2001,0.5,0,0,0,0,0,0,1,0.0,1,1,1,0,0,0,1,0,0,2020-2021,0.0,0.0
1023,Anthony Gordon,ENG,"FW,MF",Everton,Premier League,19,2001,1.0,3,3,3,0,0,0,2,0.0,2,1,0,1,1,4,3,0,0,2020-2021,1.0,3.0
1024,Leon Goretzka,GER,MF,Bayern Munich,Bundesliga,25,1995,18.9,37,23,12,21,4,16,39,41.0,23,30,2,28,44,81,11,0,0,2020-2021,2.3280423280423284,1.957671957671958
1025,Andoni Gorosabel,ESP,DF,Real Sociedad,La Liga,23,1996,26.5,76,43,45,20,11,27,64,42.2,37,25,4,21,23,99,42,0,0,2020-2021,0.8679245283018868,2.8679245283018866
Rk,Player,Nation,Pos,Squad,Comp,0,0,90.0,0,0,3,3,3,Tkl,0,0.0,0,0,0,0,0,0,0,0,0,2020-2021,0.0,0.0
1026,Robin Gosens,GER,DF,Atalanta,Serie A,26,1994,28.0,46,35,20,15,11,17,41,41.5,24,50,7,43,41,87,34,0,0,2020-2021,1.4642857142857142,1.6428571428571428
1027,Amine Gouiri,ALG,"FW,MF",Nice,Ligue 1,20,2000,30.5,31,18,7,16,8,10,41,24.4,31,22,6,16,17,48,23,0,0,2020-2021,0.5573770491803278,1.0163934426229508
1028,Lucas Gourna-Douath,FRA,MF,Saint-Étienne,Ligue 1,16,2003,14.7,32,22,18,11,3,15,28,53.6,13,10,0,10,24,56,18,0,0,2020-2021,1.6326530612244898,2.17687074829932
1029,Jeffrey Gouweleeuw,NED,DF,Augsburg,Bundesliga,29,1991,31.5,36,20,24,11,1,16,33,48.5,17,37,18,19,69,105,149,2,0,2020-2021,2.1904761904761907,1.1428571428571428
1030,Jonathan Gradit,FRA,DF,Lens,Ligue 1,27,1992,31.4,60,39,26,28,6,22,38,57.9,16,37,19,18,56,116,81,1,0,2020-2021,1.78343949044586,1.910828025477707
1031,Karlan Grant,ENG,"FW,MF",West Brom,Premier League,22,1997,12.5,5,3,3,2,0,2,4,50.0,2,7,0,7,5,10,17,0,0,2020-2021,0.4,0.4
1032,Alberto Grassi,ITA,"MF,DF",Parma,Serie A,25,1995,13.1,30,11,14,13,3,8,29,27.6,21,22,9,13,26,56,32,0,0,2020-2021,1.984732824427481,2.290076335877863
1033,Andrew Gravillon,GLP,DF,Lorient,Ligue 1,22,1998,25.2,26,17,17,9,0,13,28,46.4,15,44,31,13,59,85,118,4,0,2020-2021,2.3412698412698414,1.0317460317460319
1034,Demarai Gray,JAM,FW,Leicester City,Premier League,24,1996,0.2,1,1,1,0,0,0,0,0.0,0,0,0,0,0,1,0,0,0,2020-2021,0.0,5.0
1035,Demarai Gray,JAM,FW,Leverkusen,Bundesliga,24,1996,4.9,3,2,1,2,0,1,1,100.0,0,3,0,3,4,7,3,0,0,2020-2021,0.8163265306122448,0.6122448979591836
1036,Adrian Grbić,AUT,FW,Lorient,Ligue 1,23,1996,10.7,6,4,2,2,2,1,7,14.3,6,6,0,6,5,11,7,0,0,2020-2021,0.4672897196261683,0.5607476635514019
1037,Jack Grealish,ENG,"FW,MF",Aston Villa,Premier League,24,1995,24.3,31,14,8,16,7,15,24,62.5,9,20,3,17,12,43,5,3,0,2020-2021,0.49382716049382713,1.2757201646090535
1038,Etienne Green,ENG,GK,Saint-Étienne,Ligue 1,20,2000,8.0,0,0,0,0,0,0,0,0.0,0,0,0,0,0,0,3,0,0,2020-2021,0.0,0.0
1039,Mason Greenwood,ENG,FW,Manchester Utd,Premier League,18,2001,20.2,13,10,6,4,3,5,22,22.7,17,9,0,9,5,18,1,0,0,2020-2021,0.24752475247524752,0.6435643564356436
1040,Michael Gregoritsch,AUT,"FW,MF",Augsburg,Bundesliga,26,1994,9.3,13,10,6,7,0,3,10,30.0,7,2,0,2,3,16,17,0,0,2020-2021,0.3225806451612903,1.3978494623655913
1041,Clément Grenier,FRA,"MF,FW",Rennes,Ligue 1,29,1991,12.0,20,8,9,8,3,7,31,22.6,24,7,0,7,5,25,3,0,0,2020-2021,0.4166666666666667,1.6666666666666667
1042,Sebastian Griesbeck,GER,MF,Union Berlin,Bundesliga,29,1990,9.9,20,9,8,11,1,8,19,42.1,11,13,3,10,5,25,8,0,0,2020-2021,0.5050505050505051,2.0202020202020203
1043,Antoine Griezmann,FRA,"FW,MF",Barcelona,La Liga,29,1991,28.9,37,22,10,18,9,12,40,30.0,28,20,1,19,12,49,11,0,0,2020-2021,0.4152249134948097,1.2802768166089966
1044,Vincenzo Grifo,ITA,"MF,FW",Freiburg,Bundesliga,27,1993,25.7,18,7,6,7,5,14,34,41.2,20,13,0,13,27,45,18,1,0,2020-2021,1.0505836575875487,0.7003891050583658
1045,Lennart Grill,GER,GK,Leverkusen,Bundesliga,21,1999,4.0,0,0,0,0,0,0,0,0.0,0,0,0,0,0,0,2,0,0,2020-2021,0.0,0.0
1046,Florian Grillitsch,AUT,"MF,DF",Hoffenheim,Bundesliga,24,1995,20.9,37,21,21,13,3,19,52,36.5,33,38,7,31,51,88,47,1,0,2020-2021,2.4401913875598087,1.7703349282296652
1047,Christian Groß,GER,"MF,DF",Werder Bremen,Bundesliga,31,1989,16.3,44,28,17,25,2,15,37,40.5,22,12,2,10,24,68,37,0,0,2020-2021,1.4723926380368098,2.6993865030674846
1048,Pascal Groß,GER,"MF,DF",Brighton,Premier League,29,1991,27.6,45,24,24,15,6,24,53,45.3,29,25,4,21,23,68,18,1,0,2020-2021,0.8333333333333333,1.6304347826086956
1049,Kamil Grosicki,POL,"MF,FW",West Brom,Premier League,32,1988,1.6,2,1,2,0,0,2,8,25.0,6,1,0,1,2,4,1,0,0,2020-2021,1.25,1.25
1050,Ilia Gruev,BUL,FW,Werder Bremen,Bundesliga,20,2000,0.0,0,0,0,0,0,0,0,0.0,0,0,0,0,0,0,0,0,0,2020-2021,,
Rk,Player,Nation,Pos,Squad,Comp,0,0,90.0,0,0,3,3,3,Tkl,0,0.0,0,0,0,0,0,0,0,0,0,2020-2021,0.0,0.0
1051,Carlos Gruezo,ECU,MF,Augsburg,Bundesliga,25,1995,23.2,57,32,20,32,5,20,52,38.5,32,32,5,27,35,92,29,1,0,2020-2021,1.5086206896551724,2.456896551724138
1052,Vicente Guaita,ESP,GK,Crystal Palace,Premier League,33,1987,37.0,1,1,1,0,0,1,1,100.0,0,0,0,0,1,2,11,1,0,2020-2021,0.02702702702702703,0.02702702702702703
1053,Andrés Guardado,MEX,MF,Betis,La Liga,33,1986,14.6,25,12,10,11,4,10,25,40.0,15,13,3,10,18,43,19,0,0,2020-2021,1.2328767123287672,1.7123287671232876
1054,Sergi Guardiola,ESP,FW,Valladolid,La Liga,29,1991,19.9,11,5,1,5,5,2,27,7.4,25,12,1,11,7,18,16,3,0,2020-2021,0.35175879396984927,0.5527638190954774
1055,Nemanja Gudelj,SRB,"MF,DF",Sevilla,La Liga,28,1991,11.6,23,12,16,5,2,4,10,40.0,6,10,6,4,24,47,24,2,0,2020-2021,2.0689655172413794,1.9827586206896552
1056,Gonçalo Guedes,POR,"MF,FW",Valencia,La Liga,23,1996,25.4,18,12,8,7,3,10,45,22.2,35,24,1,23,8,26,7,0,0,2020-2021,0.31496062992125984,0.7086614173228347
1057,Mattéo Guendouzi,FRA,MF,Hertha BSC,Bundesliga,21,1999,20.2,24,13,10,12,2,9,25,36.0,16,15,4,11,21,45,24,1,0,2020-2021,1.0396039603960396,1.188118811881188
1058,Raphaël Guerreiro,POR,DF,Dortmund,Bundesliga,26,1993,24.6,30,13,14,8,8,16,31,51.6,15,21,4,17,28,58,31,1,0,2020-2021,1.1382113821138211,1.2195121951219512
1059,Evann Guessand,CIV,FW,Nice,Ligue 1,19,2001,0.3,0,0,0,0,0,0,1,0.0,1,1,1,0,1,1,1,0,0,2020-2021,3.3333333333333335,0.0
1060,Kelyan Guessoum,FRA,DF,Nîmes,Ligue 1,21,1999,12.5,13,7,11,1,1,11,16,68.8,5,8,6,2,24,37,51,0,0,2020-2021,1.92,1.04
1061,Ander Guevara,ESP,MF,Real Sociedad,La Liga,23,1997,23.1,35,23,15,16,4,15,30,50.0,15,19,5,14,25,60,35,1,0,2020-2021,1.0822510822510822,1.5151515151515151
1062,Lamine Gueye,SEN,"FW,MF",Metz,Ligue 1,22,1998,16.2,18,9,4,11,3,7,24,29.2,17,7,2,5,21,39,5,0,0,2020-2021,1.2962962962962963,1.1111111111111112
1063,Pape Gueye,SEN,MF,Marseille,Ligue 1,21,1999,22.9,49,21,25,19,5,15,45,33.3,30,25,6,19,47,96,34,0,0,2020-2021,2.052401746724891,2.139737991266376
1064,John Guidetti,SWE,FW,Alavés,La Liga,28,1992,2.3,2,2,0,2,0,0,2,0.0,2,0,0,0,1,3,2,0,0,2020-2021,0.4347826086956522,0.8695652173913044
1065,Josuha Guilavogui,FRA,"MF,DF",Wolfsburg,Bundesliga,29,1990,8.3,17,9,9,8,0,5,12,41.7,7,12,5,7,29,46,25,0,0,2020-2021,3.4939759036144573,2.048192771084337
1066,Frederic Guilbert,FRA,DF,Strasbourg,Ligue 1,25,1994,12.4,37,19,23,11,3,21,34,61.8,13,14,1,13,33,70,32,0,0,2020-2021,2.661290322580645,2.9838709677419355
1067,Hugo Guillamón,ESP,DF,Valencia,La Liga,20,2000,22.1,23,13,17,6,0,8,20,40.0,12,19,14,5,27,50,102,3,0,2020-2021,1.2217194570135745,1.0407239819004523
1068,Bruno Guimarães,BRA,MF,Lyon,Ligue 1,22,1997,19.5,76,34,26,41,9,30,64,46.9,34,24,4,20,14,90,13,0,0,2020-2021,0.717948717948718,3.8974358974358974
1069,Serhou Guirassy,GUI,FW,Rennes,Ligue 1,24,1996,19.6,4,1,1,3,0,1,3,33.3,2,10,1,9,5,9,17,0,0,2020-2021,0.25510204081632654,0.2040816326530612
1070,Péter Gulácsi,HUN,GK,RB Leipzig,Bundesliga,30,1990,33.0,1,0,1,0,0,1,2,50.0,1,0,0,0,2,3,7,0,0,2020-2021,0.06060606060606061,0.030303030303030304
1071,Manuel Gulde,GER,DF,Freiburg,Bundesliga,29,1991,21.7,27,15,12,12,3,5,21,23.8,16,25,15,10,37,64,64,0,0,2020-2021,1.7050691244239633,1.2442396313364055
1072,Robert Gumny,POL,DF,Augsburg,Bundesliga,22,1998,15.3,24,15,12,9,3,15,23,65.2,8,12,2,10,18,42,31,0,0,2020-2021,1.1764705882352942,1.5686274509803921
1073,İlkay Gündoğan,GER,MF,Manchester City,Premier League,29,1990,22.5,25,15,8,12,5,10,39,25.6,29,13,4,9,20,45,9,0,0,2020-2021,0.8888888888888888,1.1111111111111112
1074,Christian Günter,GER,"DF,MF",Freiburg,Bundesliga,27,1993,34.0,34,19,18,13,3,15,43,34.9,28,38,9,29,29,63,40,0,0,2020-2021,0.8529411764705882,1.0
1075,Koray Günter,GER,DF,Hellas Verona,Serie A,25,1994,19.6,20,10,10,9,1,4,9,44.4,5,27,21,6,70,90,87,0,0,2020-2021,3.571428571428571,1.0204081632653061
Rk,Player,Nation,Pos,Squad,Comp,0,0,90.0,0,0,3,3,3,Tkl,0,0.0,0,0,0,0,0,0,0,0,0,2020-2021,0.0,0.0
1076,Jon Guridi,ESP,MF,Real Sociedad,La Liga,25,1995,9.2,19,9,10,6,3,8,22,36.4,14,8,1,7,10,29,9,0,0,2020-2021,1.0869565217391306,2.065217391304348
1077,Malo Gusto,FRA,"DF,MF",Lyon,Ligue 1,17,2003,0.0,0,0,0,0,0,0,0,0.0,0,0,0,0,0,0,0,0,0,2020-2021,,
1078,Raúl Guti,ESP,MF,Elche,La Liga,23,1996,31.8,48,28,21,22,5,16,52,30.8,36,25,3,22,49,97,25,0,0,2020-2021,1.540880503144654,1.5094339622641508
1079,Marcos Mauro López Gutiérrez,ARG,DF,Cádiz,La Liga,29,1991,20.3,23,15,15,8,0,15,24,62.5,9,18,12,6,22,45,78,0,0,2020-2021,1.083743842364532,1.1330049261083743
1080,Miguel Gutiérrez,ESP,DF,Real Madrid,La Liga,19,2001,3.5,4,0,0,3,1,1,7,14.3,6,3,0,3,5,9,5,0,0,2020-2021,1.4285714285714286,1.1428571428571428
1081,Manu Gyabuaa,ITA,MF,Atalanta,Serie A,18,2001,0.0,0,0,0,0,0,0,0,0.0,0,0,0,0,0,0,0,0,0,2020-2021,,
1082,Emmanuel Gyasi,GHA,FW,Spezia,Serie A,26,1994,31.7,30,16,16,10,4,9,31,29.0,22,13,2,11,14,44,8,0,0,2020-2021,0.44164037854889593,0.9463722397476341
1083,Erling Haaland,NOR,FW,Dortmund,Bundesliga,20,2000,26.7,7,2,1,3,3,1,4,25.0,3,19,4,15,4,11,16,0,0,2020-2021,0.149812734082397,0.2621722846441948
1084,Janik Haberer,GER,"MF,FW",Freiburg,Bundesliga,26,1994,5.4,7,4,4,3,0,3,15,20.0,12,4,1,3,7,14,9,0,0,2020-2021,1.2962962962962963,1.2962962962962963
1085,Alexander Hack,GER,DF,Mainz 05,Bundesliga,26,1993,15.2,32,21,23,8,1,18,31,58.1,13,26,17,9,41,73,91,2,0,2020-2021,2.697368421052632,2.1052631578947367
1086,Antwoine Hackford,ENG,DF,Sheffield Utd,Premier League,16,2004,0.1,0,0,0,0,0,0,0,0.0,0,0,0,0,0,0,0,0,0,2020-2021,0.0,0.0
1087,Munir El Haddadi,MAR,FW,Sevilla,La Liga,24,1995,9.4,12,8,5,5,2,2,12,16.7,10,6,0,6,5,17,6,0,0,2020-2021,0.5319148936170213,1.276595744680851
1088,André Hahn,GER,"FW,MF",Augsburg,Bundesliga,29,1990,22.6,31,17,14,13,4,9,44,20.5,35,35,3,32,14,45,24,0,0,2020-2021,0.6194690265486725,1.3716814159292035
1089,Amadou Haidara,MLI,"MF,FW",RB Leipzig,Bundesliga,22,1998,21.2,50,28,20,21,9,11,36,30.6,25,33,1,32,30,80,24,0,0,2020-2021,1.4150943396226416,2.358490566037736
1090,Massadio Haïdara,MLI,DF,Lens,Ligue 1,27,1992,23.7,48,32,21,21,6,23,37,62.2,14,29,6,23,35,83,60,0,0,2020-2021,1.4767932489451476,2.0253164556962027
1091,Achraf Hakimi,MAR,DF,Inter,Serie A,21,1998,29.6,53,32,23,19,11,23,48,47.9,25,31,1,30,22,75,23,1,0,2020-2021,0.7432432432432432,1.7905405405405403
1092,Sébastien Haller,CIV,FW,West Ham,Premier League,26,1994,10.4,14,9,1,6,7,4,20,20.0,16,7,1,6,5,19,7,0,0,2020-2021,0.4807692307692307,1.346153846153846
1093,Marcel Halstenberg,GER,DF,RB Leipzig,Bundesliga,28,1991,18.3,29,18,20,8,1,19,41,46.3,22,15,3,12,16,45,35,0,0,2020-2021,0.8743169398907104,1.5846994535519126
1094,Pierre-Yves Hamel,FRA,FW,Lorient,Ligue 1,26,1994,9.4,15,8,3,9,3,1,6,16.7,5,12,1,11,10,25,6,0,0,2020-2021,1.0638297872340425,1.5957446808510638
1095,Romain Hamouma,FRA,"FW,MF",Saint-Étienne,Ligue 1,33,1987,19.7,12,7,5,6,1,4,24,16.7,20,17,1,16,7,19,11,0,0,2020-2021,0.3553299492385787,0.6091370558375635
1096,Samir Handanović,SVN,GK,Inter,Serie A,36,1984,36.0,1,0,1,0,0,1,1,100.0,0,0,0,0,0,1,6,3,0,2020-2021,0.0,0.027777777777777776
1097,Lukáš Haraslín,SVK,"FW,MF",Sassuolo,Serie A,24,1996,3.7,8,4,2,5,1,2,5,40.0,3,1,0,1,0,8,2,0,0,2020-2021,0.0,2.162162162162162
1098,Amine Harit,MAR,"MF,FW",Schalke 04,Bundesliga,23,1997,23.3,22,13,8,11,3,10,23,43.5,13,9,1,8,17,39,7,1,0,2020-2021,0.7296137339055794,0.944206008583691
1099,Rekeem Harper,ENG,MF,West Brom,Premier League,20,2000,0.4,0,0,0,0,0,0,0,0.0,0,2,0,2,1,1,0,0,0,2020-2021,2.5,0.0
1100,Jack Harrison,ENG,"MF,FW",Leeds United,Premier League,23,1996,31.6,63,38,20,30,13,26,59,44.1,33,30,2,28,15,78,21,0,0,2020-2021,0.47468354430379744,1.9936708860759493
Rk,Player,Nation,Pos,Squad,Comp,0,0,90.0,0,0,3,3,3,Tkl,0,0.0,0,0,0,0,0,0,0,0,0,2020-2021,0.0,0.0
1101,Marcel Hartel,GER,MF,Arminia,Bundesliga,24,1996,18.7,35,19,15,18,2,20,40,50.0,20,17,4,13,26,61,16,1,0,2020-2021,1.3903743315508021,1.8716577540106953
1102,Makoto Hasebe,JPN,"DF,MF",Eint Frankfurt,Bundesliga,36,1984,25.4,43,29,21,20,2,25,51,49.0,26,31,12,19,31,74,68,2,0,2020-2021,1.220472440944882,1.6929133858267718
1103,Hans Hateboer,NED,DF,Atalanta,Serie A,26,1994,19.6,28,17,12,14,2,13,23,56.5,10,8,1,7,17,45,9,0,0,2020-2021,0.8673469387755102,1.4285714285714284
1104,Kortney Hause,ENG,DF,Aston Villa,Premier League,25,1995,7.0,4,2,3,1,0,0,3,0.0,3,4,2,2,8,12,53,0,0,2020-2021,1.1428571428571428,0.5714285714285714
1105,Kai Havertz,GER,"MF,FW",Chelsea,Premier League,21,1999,16.9,18,9,6,10,2,6,27,22.2,21,25,0,25,4,22,22,1,0,2020-2021,0.2366863905325444,1.0650887573964498
1106,Isaac Hayden,ENG,"MF,DF",Newcastle Utd,Premier League,25,1995,21.6,52,29,23,22,7,14,35,40.0,21,32,9,23,43,95,47,0,0,2020-2021,1.9907407407407407,2.4074074074074074
1107,Eden Hazard,BEL,"FW,MF",Real Madrid,La Liga,29,1991,5.9,3,2,1,2,0,0,3,0.0,3,3,0,3,3,6,0,0,0,2020-2021,0.5084745762711864,0.5084745762711864
1108,Thorgan Hazard,BEL,"MF,FW",Dortmund,Bundesliga,27,1993,7.3,8,2,6,1,1,3,13,23.1,10,4,0,4,10,18,1,0,0,2020-2021,1.36986301369863,1.095890410958904
1109,Jonas Hector,GER,"MF,FW",Köln,Bundesliga,30,1990,14.3,34,22,8,21,5,15,35,42.9,20,24,5,19,19,53,20,1,0,2020-2021,1.3286713286713285,2.3776223776223775
1110,Michael Hector,JAM,DF,Fulham,Premier League,28,1992,2.9,3,2,1,2,0,1,6,16.7,5,4,2,2,0,3,6,0,0,2020-2021,0.0,1.0344827586206897
1111,Hwang Hee-chan,KOR,"FW,MF",RB Leipzig,Bundesliga,24,1996,5.1,3,2,1,0,2,1,7,14.3,6,4,0,4,1,4,1,0,0,2020-2021,0.19607843137254904,0.5882352941176471
1112,Ahmed Hegazi,EGY,DF,West Brom,Premier League,29,1991,1.0,0,0,0,0,0,0,0,0.0,0,2,0,2,1,1,7,0,0,2020-2021,1.0,0.0
1113,Dominique Heintz,GER,DF,Freiburg,Bundesliga,26,1993,15.2,22,11,19,3,0,10,19,52.6,9,10,8,2,35,57,49,0,0,2020-2021,2.3026315789473686,1.4473684210526316
1114,Dean Henderson,ENG,GK,Manchester Utd,Premier League,23,1997,12.5,1,1,1,0,0,1,2,50.0,1,0,0,0,0,1,3,2,0,2020-2021,0.0,0.08
1115,Jordan Henderson,ENG,"MF,DF",Liverpool,Premier League,30,1990,18.9,24,15,12,9,3,10,26,38.5,16,12,1,11,34,58,30,0,0,2020-2021,1.798941798941799,1.26984126984127
1116,Jeff Hendrick,IRL,MF,Newcastle Utd,Premier League,28,1992,15.8,8,3,5,3,0,1,13,7.7,12,14,9,5,19,27,18,0,0,2020-2021,1.2025316455696202,0.5063291139240506
1117,Benjamin Henrichs,GER,"DF,MF",RB Leipzig,Bundesliga,23,1997,6.0,12,7,4,5,3,2,9,22.2,7,9,1,8,8,20,8,0,0,2020-2021,1.3333333333333333,2.0
1118,Dalbert Henrique,BRA,DF,Rennes,Ligue 1,26,1993,4.1,7,6,4,2,1,6,8,75.0,2,8,2,6,5,12,8,0,0,2020-2021,1.2195121951219514,1.707317073170732
1119,Eduardo Henrique,BRA,MF,Crotone,Serie A,25,1995,10.3,5,2,1,4,0,3,12,25.0,9,6,1,5,7,12,7,1,0,2020-2021,0.6796116504854368,0.48543689320388345
1120,Luis Henrique,BRA,"FW,DF",Marseille,Ligue 1,18,2001,7.5,5,4,3,1,1,4,9,44.4,5,5,1,4,7,12,4,0,0,2020-2021,0.9333333333333333,0.6666666666666666
1121,Christophe Hérelle,MTQ,DF,Brest,Ligue 1,27,1992,15.3,19,13,12,6,1,10,12,83.3,2,13,9,4,31,50,41,2,0,2020-2021,2.026143790849673,1.2418300653594772
1122,Jérôme Hergault,FRA,"DF,MF",Lorient,Ligue 1,34,1986,18.1,38,23,22,10,6,17,31,54.8,14,16,2,14,22,60,34,0,0,2020-2021,1.2154696132596685,2.0994475138121547
1123,Mario Hermoso,ESP,DF,Atlético Madrid,La Liga,25,1995,28.6,55,31,40,11,4,37,61,60.7,24,23,10,13,36,91,73,0,0,2020-2021,1.2587412587412588,1.923076923076923
1124,Aridane Hernández,ESP,DF,Osasuna,La Liga,31,1989,22.5,20,11,13,6,1,7,12,58.3,5,22,19,3,34,54,127,1,0,2020-2021,1.511111111111111,0.8888888888888888
1125,Lucas Hernández,FRA,DF,Bayern Munich,Bundesliga,24,1996,17.7,41,31,16,17,8,17,31,54.8,14,24,6,18,19,60,38,0,0,2020-2021,1.073446327683616,2.3163841807909606
Rk,Player,Nation,Pos,Squad,Comp,0,0,90.0,0,0,3,3,3,Tkl,0,0.0,0,0,0,0,0,0,0,0,0,2020-2021,0.0,0.0
1126,Pablo Hernández,ESP,MF,Leeds United,Premier League,35,1985,4.7,5,3,2,1,2,5,16,31.3,11,2,0,2,0,5,0,1,0,2020-2021,0.0,1.0638297872340425
1127,Theo Hernández,FRA,DF,Milan,Serie A,22,1997,32.6,48,29,22,21,5,19,38,50.0,19,29,6,23,34,82,64,5,0,2020-2021,1.0429447852760736,1.4723926380368098
1128,Hernani,BRA,MF,Parma,Serie A,26,1994,24.3,51,25,21,27,3,29,66,43.9,37,35,4,31,31,82,40,1,0,2020-2021,1.2757201646090535,2.0987654320987654
1129,Ander Herrera,ESP,MF,Paris S-G,Ligue 1,30,1989,20.6,53,35,17,26,10,30,77,39.0,47,31,5,26,31,84,22,1,0,2020-2021,1.5048543689320388,2.5728155339805823
1130,Héctor Herrera,MEX,MF,Atlético Madrid,La Liga,30,1990,7.6,12,7,5,6,1,7,13,53.8,6,7,2,5,14,26,8,0,0,2020-2021,1.842105263157895,1.5789473684210527
1131,Sergio Herrera,ESP,GK,Osasuna,La Liga,27,1993,32.9,0,0,0,0,0,0,2,0.0,2,0,0,0,3,3,29,3,0,2020-2021,0.0911854103343465,0.0
1132,Yangel Herrera,VEN,MF,Granada,La Liga,22,1998,25.7,59,26,19,32,8,11,41,26.8,30,53,17,36,26,85,32,1,0,2020-2021,1.0116731517509727,2.295719844357977
1133,Patrick Herrmann,GER,"FW,MF",Gladbach,Bundesliga,29,1991,9.7,9,6,4,3,2,2,14,14.3,12,16,0,16,10,19,8,0,0,2020-2021,1.0309278350515465,0.9278350515463918
1134,Pablo Hervías,ESP,"DF,MF",Valladolid,La Liga,27,1993,13.4,19,12,7,9,3,9,26,34.6,17,6,0,6,11,30,8,0,0,2020-2021,0.8208955223880596,1.417910447761194
1135,Përparim Hetemaj,FIN,MF,Benevento,Serie A,33,1986,24.6,44,27,21,18,5,26,61,42.6,35,41,5,36,22,66,24,1,0,2020-2021,0.8943089430894309,1.7886178861788617
1136,Son Heung-min,KOR,FW,Tottenham,Premier League,28,1992,34.6,32,18,11,14,7,18,72,25.0,54,28,3,25,14,46,8,0,0,2020-2021,0.40462427745664736,0.9248554913294798
1137,Aaron Hickey,SCO,DF,Bologna,Serie A,18,2002,8.4,12,8,10,2,0,7,17,41.2,10,6,1,5,15,27,15,1,0,2020-2021,1.7857142857142856,1.4285714285714286
1138,Vitorino Hilton,BRA,DF,Montpellier,Ligue 1,42,1977,23.5,15,10,10,4,1,3,14,21.4,11,34,26,8,38,53,104,3,0,2020-2021,1.6170212765957446,0.6382978723404256
1139,Martin Hinteregger,AUT,DF,Eint Frankfurt,Bundesliga,27,1992,28.1,77,49,53,22,2,37,63,58.7,26,31,12,19,44,121,92,0,0,2020-2021,1.5658362989323842,2.7402135231316724
1140,Marwin Hitz,SUI,GK,Dortmund,Bundesliga,32,1987,15.5,1,1,1,0,0,1,1,100.0,0,0,0,0,0,1,7,1,0,2020-2021,0.0,0.06451612903225806
1141,Wesley Hoedt,NED,DF,Lazio,Serie A,26,1994,10.6,22,16,18,4,0,10,17,58.8,7,9,5,4,17,39,48,1,0,2020-2021,1.6037735849056605,2.0754716981132075
1142,Ki-Jana Hoever,NED,"DF,MF",Wolves,Premier League,18,2002,6.4,14,6,11,2,1,10,22,45.5,12,2,0,2,9,23,23,0,0,2020-2021,1.40625,2.1875
1143,Nicolas Höfler,GER,MF,Freiburg,Bundesliga,30,1990,30.3,54,28,16,31,7,23,59,39.0,36,34,10,24,66,120,41,2,0,2020-2021,2.1782178217821784,1.7821782178217822
1144,Jonas Hofmann,GER,"FW,MF",Gladbach,Bundesliga,28,1992,20.2,26,20,12,12,2,10,53,18.9,43,27,2,25,27,53,9,0,0,2020-2021,1.3366336633663367,1.2871287128712872
1145,Marco Höger,GER,"DF,MF",Köln,Bundesliga,30,1989,0.6,1,0,0,1,0,1,2,50.0,1,2,0,2,2,3,1,0,0,2020-2021,3.3333333333333335,1.6666666666666667
1146,Rob Holding,ENG,DF,Arsenal,Premier League,24,1995,28.4,43,20,28,13,2,17,35,48.6,18,37,27,10,24,67,120,0,0,2020-2021,0.8450704225352114,1.5140845070422535
1147,Lucas Höler,GER,"FW,MF",Freiburg,Bundesliga,26,1994,23.2,36,24,13,19,4,12,32,37.5,20,19,2,17,16,52,14,0,0,2020-2021,0.6896551724137931,1.5517241379310345
1148,Mason Holgate,ENG,DF,Everton,Premier League,23,1996,25.4,56,36,31,18,7,20,50,40.0,30,37,13,24,35,91,90,3,0,2020-2021,1.3779527559055118,2.204724409448819
1149,Jordan Holsgrove,SCO,MF,Celta Vigo,La Liga,20,1999,1.6,6,4,4,1,1,5,8,62.5,3,2,0,2,2,8,1,0,0,2020-2021,1.25,3.75
1150,Franck Honorat,FRA,"MF,FW",Brest,Ligue 1,23,1996,27.3,28,13,12,10,6,14,37,37.8,23,15,3,12,11,39,24,0,0,2020-2021,0.40293040293040294,1.0256410256410255
Rk,Player,Nation,Pos,Squad,Comp,0,0,90.0,0,0,3,3,3,Tkl,0,0.0,0,0,0,0,0,0,0,0,0,2020-2021,0.0,0.0
1151,Matthew Hoppe,USA,FW,Schalke 04,Bundesliga,19,2001,14.5,6,6,1,3,2,2,12,16.7,10,8,2,6,4,10,15,0,0,2020-2021,0.27586206896551724,0.41379310344827586
1152,Jannes Horn,GER,DF,Köln,Bundesliga,23,1997,19.6,35,19,23,11,1,23,31,74.2,8,19,2,17,10,45,45,0,0,2020-2021,0.5102040816326531,1.7857142857142856
1153,Timo Horn,GER,GK,Köln,Bundesliga,27,1993,33.4,1,0,1,0,0,1,4,25.0,3,1,0,1,0,1,11,2,0,2020-2021,0.0,0.029940119760479042
1154,Fraser Hornby,SCO,"FW,MF",Reims,Ligue 1,20,1999,0.4,0,0,0,0,0,0,0,0.0,0,0,0,0,1,1,0,0,0,2020-2021,2.5,0.0
1155,Conor Hourihane,IRL,MF,Aston Villa,Premier League,29,1991,2.5,0,0,0,0,0,0,2,0.0,2,3,0,3,0,0,2,0,0,2020-2021,0.0,0.0
1156,Lukáš Hrádecký,FIN,GK,Leverkusen,Bundesliga,30,1989,28.5,0,0,0,0,0,0,1,0.0,1,0,0,0,1,1,11,3,0,2020-2021,0.03508771929824561,0.0
1157,Ajdin Hrustic,AUS,"MF,DF",Eint Frankfurt,Bundesliga,24,1996,3.0,6,5,2,3,1,3,10,30.0,7,2,0,2,4,10,3,0,0,2020-2021,1.3333333333333333,2.0
1158,Florian Hübner,GER,DF,Union Berlin,Bundesliga,29,1991,5.8,10,5,7,3,0,7,15,46.7,8,7,3,4,13,23,21,0,0,2020-2021,2.241379310344828,1.7241379310344829
1159,Callum Hudson-Odoi,ENG,"FW,DF",Chelsea,Premier League,19,2000,11.8,23,15,11,7,5,8,21,38.1,13,15,1,14,6,29,6,0,0,2020-2021,0.5084745762711864,1.9491525423728813
1160,Niall Huggins,WAL,DF,Leeds United,Premier League,19,2000,0.4,0,0,0,0,0,0,1,0.0,1,0,0,0,0,0,1,0,0,2020-2021,0.0,0.0
1161,Mats Hummels,GER,DF,Dortmund,Bundesliga,31,1988,31.3,58,40,34,18,6,26,42,61.9,16,31,22,9,73,131,122,2,0,2020-2021,2.3322683706070286,1.853035143769968
1162,Adrien Hunou,FRA,"FW,MF",Rennes,Ligue 1,26,1994,6.5,6,3,2,2,2,2,8,25.0,6,7,0,7,1,7,2,0,0,2020-2021,0.15384615384615385,0.9230769230769231
1163,Klaas-Jan Huntelaar,NED,FW,Schalke 04,Bundesliga,36,1983,6.5,4,2,0,2,2,0,2,0.0,2,3,1,2,2,6,3,0,0,2020-2021,0.3076923076923077,0.6153846153846154
1164,Elseid Hysaj,ALB,DF,Napoli,Serie A,26,1994,19.6,29,17,16,11,2,17,33,51.5,16,18,4,14,30,59,52,0,0,2020-2021,1.530612244897959,1.4795918367346939
1165,Pierre Højbjerg,DEN,MF,Tottenham,Premier League,24,1995,38.0,98,51,45,42,11,54,129,41.9,75,51,9,42,48,146,66,0,0,2020-2021,1.263157894736842,2.5789473684210527
1166,Simone Iacoponi,ITA,DF,Parma,Serie A,33,1987,13.3,22,12,16,5,1,13,26,50.0,13,9,4,5,11,33,42,1,0,2020-2021,0.8270676691729323,1.6541353383458646
1167,Iago,BRA,DF,Augsburg,Bundesliga,23,1997,17.3,37,27,21,13,3,17,29,58.6,12,17,5,12,22,59,55,0,0,2020-2021,1.2716763005780347,2.138728323699422
1168,Roger Ibanez,BRA,DF,Roma,Serie A,21,1998,26.6,59,37,28,25,6,25,45,55.6,20,38,17,21,68,127,78,3,0,2020-2021,2.556390977443609,2.218045112781955
1169,Vedad Ibišević,BIH,FW,Schalke 04,Bundesliga,35,1984,1.7,0,0,0,0,0,0,0,0.0,0,1,0,1,1,1,1,0,0,2020-2021,0.5882352941176471,0.0
1170,Vicente Iborra,ESP,MF,Villarreal,La Liga,32,1988,10.3,18,8,8,7,3,8,24,33.3,16,14,7,7,14,32,25,1,0,2020-2021,1.3592233009708736,1.7475728155339805
1171,Didier Ibrahim Ndong,GAB,MF,Dijon,Ligue 1,26,1994,29.0,53,32,22,30,1,25,70,35.7,45,35,7,28,37,90,40,0,0,2020-2021,1.2758620689655173,1.8275862068965518
1172,Zlatan Ibrahimović,SWE,FW,Milan,Serie A,38,1981,16.6,5,4,0,4,1,3,6,50.0,3,5,3,2,6,11,27,1,0,2020-2021,0.36144578313253006,0.3012048192771084
1173,Mauro Icardi,ARG,FW,Paris S-G,Ligue 1,27,1993,12.0,6,2,1,2,3,4,13,30.8,9,3,1,2,3,9,7,0,0,2020-2021,0.25,0.5
1174,Oussama Idrissi,MAR,"FW,MF",Sevilla,La Liga,24,1996,0.3,1,1,0,1,0,1,2,50.0,1,2,0,2,1,2,0,0,0,2020-2021,3.3333333333333335,3.3333333333333335
1175,Blendi Idrizi,KVX,MF,Schalke 04,Bundesliga,22,1998,2.6,8,4,1,6,1,1,1,100.0,0,6,2,4,3,11,1,0,0,2020-2021,1.1538461538461537,3.0769230769230766
Rk,Player,Nation,Pos,Squad,Comp,0,0,90.0,0,0,3,3,3,Tkl,0,0.0,0,0,0,0,0,0,0,0,0,2020-2021,0.0,0.0
1176,Odion Ighalo,NGA,FW,Manchester Utd,Premier League,31,1989,0.1,0,0,0,0,0,0,1,0.0,1,0,0,0,0,0,0,0,0,2020-2021,0.0,0.0
1177,Iglesias,ESP,"DF,MF",Getafe,La Liga,22,1998,6.7,27,15,14,10,3,11,19,57.9,8,11,1,10,17,44,19,0,0,2020-2021,2.5373134328358207,4.029850746268656
1178,Borja Iglesias,ESP,FW,Betis,La Liga,27,1993,15.7,1,1,0,0,1,1,8,12.5,7,7,2,5,3,4,9,0,0,2020-2021,0.1910828025477707,0.06369426751592357
1179,Igor,BRA,DF,Fiorentina,Serie A,22,1998,13.0,15,9,9,6,0,7,12,58.3,5,17,9,8,23,38,34,0,0,2020-2021,1.7692307692307692,1.1538461538461537
1180,Kelechi Iheanacho,NGA,FW,Leicester City,Premier League,23,1996,16.2,12,5,2,4,6,4,17,23.5,13,14,0,14,2,14,1,1,0,2020-2021,0.1234567901234568,0.7407407407407408
1181,Jonathan Ikone,FRA,"MF,FW",Lille,Ligue 1,22,1998,24.2,18,12,3,8,7,9,22,40.9,13,16,1,15,7,25,9,0,0,2020-2021,0.2892561983471075,0.7438016528925621
1182,Yun Il-lok,KOR,"MF,FW",Montpellier,Ligue 1,28,1992,3.5,0,0,0,0,0,0,4,0.0,4,0,0,0,5,5,1,0,0,2020-2021,1.4285714285714286,0.0
1183,Ivan Ilić,SRB,MF,Hellas Verona,Serie A,19,2001,20.4,26,14,11,11,4,7,21,33.3,14,17,5,12,27,53,26,0,0,2020-2021,1.323529411764706,1.2745098039215688
1184,Josip Iličić,SVN,"MF,FW",Atalanta,Serie A,32,1988,17.0,9,4,1,5,3,5,21,23.8,16,12,0,12,2,11,0,1,0,2020-2021,0.11764705882352941,0.5294117647058824
1185,Asier Illarramendi,ESP,MF,Real Sociedad,La Liga,30,1990,3.7,5,2,1,4,0,1,5,20.0,4,2,0,2,5,10,7,0,0,2020-2021,1.3513513513513513,1.3513513513513513
1186,Stefan Ilsanker,AUT,"MF,DF",Eint Frankfurt,Bundesliga,31,1989,17.5,33,20,17,15,1,21,42,50.0,21,30,8,22,30,63,51,2,0,2020-2021,1.7142857142857142,1.8857142857142857
1187,Ciro Immobile,ITA,FW,Lazio,Serie A,30,1990,31.7,14,13,4,6,4,7,22,31.8,15,13,1,12,6,20,9,0,0,2020-2021,0.18927444794952683,0.44164037854889593
1188,Riccardo Improta,ITA,"DF,MF",Benevento,Serie A,26,1993,25.9,39,23,25,8,6,21,45,46.7,24,23,4,19,28,67,47,0,0,2020-2021,1.0810810810810811,1.505791505791506
1189,Roberto Inglese,ITA,FW,Parma,Serie A,28,1991,6.4,5,2,1,2,2,2,11,18.2,9,10,0,10,0,5,3,0,0,2020-2021,0.0,0.78125
1190,Danny Ings,ENG,FW,Southampton,Premier League,28,1992,24.1,22,13,3,16,3,12,28,42.9,16,39,2,37,3,25,27,1,0,2020-2021,0.12448132780082986,0.9128630705394191
1191,Marcus Ingvartsen,DEN,"MF,FW",Union Berlin,Bundesliga,24,1996,21.8,17,11,5,6,6,8,26,30.8,18,22,0,22,18,35,10,0,0,2020-2021,0.8256880733944953,0.7798165137614679
1192,Lorenzo Insigne,ITA,FW,Napoli,Serie A,29,1991,31.8,26,18,8,12,6,13,72,18.1,59,30,1,29,37,63,6,1,0,2020-2021,1.1635220125786163,0.8176100628930817
1193,Roberto Insigne,ITA,"MF,FW",Benevento,Serie A,26,1994,17.8,16,10,8,3,5,7,27,25.9,20,10,0,10,7,23,9,0,0,2020-2021,0.3932584269662921,0.898876404494382
1194,Pablo Insua,ESP,DF,Huesca,La Liga,26,1993,17.6,37,18,26,9,2,14,31,45.2,17,14,8,6,24,61,68,0,0,2020-2021,1.3636363636363635,2.102272727272727
1195,Takashi Inui,JPN,"MF,FW",Eibar,La Liga,32,1988,20.2,13,8,6,3,4,3,12,25.0,9,19,0,19,12,25,7,0,0,2020-2021,0.594059405940594,0.6435643564356436
1196,Artur Ioniță,MDA,MF,Benevento,Serie A,29,1990,31.5,47,22,11,31,5,17,63,27.0,46,38,14,24,19,66,28,0,0,2020-2021,0.6031746031746031,1.492063492063492
1197,Alexander Isak,SWE,FW,Real Sociedad,La Liga,20,1999,26.0,9,5,0,3,6,3,8,37.5,5,17,1,16,3,12,7,0,0,2020-2021,0.11538461538461539,0.34615384615384615
1198,Isco,ESP,MF,Real Madrid,La Liga,28,1992,10.1,13,9,5,5,3,2,14,14.3,12,7,1,6,2,15,2,0,0,2020-2021,0.19801980198019803,1.2871287128712872
1199,Ardian Ismajli,ALB,DF,Spezia,Serie A,23,1996,14.4,19,9,10,8,1,8,13,61.5,5,10,7,3,23,42,52,1,0,2020-2021,1.597222222222222,1.3194444444444444
1200,Abass Issah,GHA,"DF,FW",Mainz 05,Bundesliga,21,1998,0.2,0,0,0,0,0,0,0,0.0,0,0,0,0,0,0,0,0,0,2020-2021,0.0,0.0
Rk,Player,Nation,Pos,Squad,Comp,0,0,90.0,0,0,3,3,3,Tkl,0,0.0,0,0,0,0,0,0,0,0,0,2020-2021,0.0,0.0
1201,Branislav Ivanović,SRB,DF,West Brom,Premier League,36,1984,8.5,14,5,11,3,0,7,13,53.8,6,11,5,6,8,22,25,0,0,2020-2021,0.9411764705882353,1.6470588235294117
1202,Alex Iwobi,NGA,"FW,MF",Everton,Premier League,24,1996,17.1,27,10,10,14,3,13,25,52.0,12,20,1,19,16,43,14,0,0,2020-2021,0.935672514619883,1.5789473684210524
1203,Jairo Izquierdo,ESP,"MF,DF",Cádiz,La Liga,26,1993,14.2,21,13,13,8,0,12,31,38.7,19,7,1,6,14,35,12,0,0,2020-2021,0.9859154929577465,1.4788732394366197
1204,José Izquierdo,COL,DF,Brighton,Premier League,28,1992,0.1,0,0,0,0,0,0,0,0.0,0,0,0,0,0,0,0,0,0,2020-2021,0.0,0.0
1205,Armando Izzo,ITA,DF,Torino,Serie A,28,1992,22.3,30,16,13,13,4,13,33,39.4,20,22,9,13,53,83,62,0,0,2020-2021,2.3766816143497755,1.3452914798206277
1206,Phil Jagielka,ENG,DF,Sheffield Utd,Premier League,37,1982,5.8,5,4,4,0,1,2,7,28.6,5,11,5,6,10,15,26,2,0,2020-2021,1.7241379310344829,0.8620689655172414
1207,Alireza Jahanbakhsh,IRN,"FW,MF",Brighton,Premier League,26,1993,5.9,9,7,3,5,1,2,12,16.7,10,8,0,8,8,17,1,0,0,2020-2021,1.3559322033898304,1.5254237288135593
1208,Mato Jajalo,BIH,MF,Udinese,Serie A,32,1988,0.4,1,1,1,0,0,1,1,100.0,0,1,0,1,2,3,0,0,0,2020-2021,5.0,2.5
1209,Ismail Jakobs,SEN,"MF,FW",Köln,Bundesliga,20,1999,19.2,25,10,17,4,4,11,21,52.4,10,18,1,17,16,41,36,0,0,2020-2021,0.8333333333333334,1.3020833333333335
1210,Daniel James,WAL,FW,Manchester Utd,Premier League,22,1997,10.1,15,9,4,7,4,3,18,16.7,15,10,1,9,0,15,6,0,0,2020-2021,0.0,1.4851485148514851
1211,Reece James,ENG,DF,Chelsea,Premier League,20,1999,26.4,55,35,24,22,9,21,44,47.7,23,36,7,29,17,72,52,0,0,2020-2021,0.6439393939393939,2.0833333333333335
1212,Alexandre Jankewitz,SUI,MF,Southampton,Premier League,18,2001,0.0,2,1,2,0,0,1,1,100.0,0,0,0,0,0,2,0,0,0,2020-2021,,inf
1213,Saidy Janko,GAM,DF,Valladolid,La Liga,24,1995,13.6,19,10,12,5,2,8,14,57.1,6,9,1,8,18,37,47,0,0,2020-2021,1.3235294117647058,1.397058823529412
1214,Jakub Jankto,CZE,MF,Sampdoria,Serie A,24,1996,26.8,28,17,14,7,7,11,35,31.4,24,16,1,15,24,52,34,0,0,2020-2021,0.8955223880597015,1.044776119402985
1215,Tony Jantschke,GER,DF,Gladbach,Bundesliga,30,1990,3.0,2,2,1,1,0,1,3,33.3,2,6,4,2,4,6,7,0,0,2020-2021,1.3333333333333333,0.6666666666666666
1216,Adnan Januzaj,BEL,"FW,MF",Real Sociedad,La Liga,25,1995,11.3,9,8,0,6,3,3,8,37.5,5,7,2,5,3,12,4,0,0,2020-2021,0.2654867256637168,0.7964601769911503
1217,Rune Jarstein,NOR,GK,Hertha BSC,Bundesliga,35,1984,8.0,0,0,0,0,0,0,0,0.0,0,0,0,0,0,0,7,1,0,2020-2021,0.0,0.0
1218,Jason,ESP,"MF,DF",Valencia,La Liga,26,1994,4.9,9,3,5,2,2,4,16,25.0,12,6,1,5,10,19,4,0,0,2020-2021,2.0408163265306123,1.8367346938775508
1219,Luis Javier Suárez,COL,"FW,MF",Granada,La Liga,22,1997,18.5,19,11,5,7,7,6,17,35.3,11,10,1,9,8,27,11,0,0,2020-2021,0.43243243243243246,1.027027027027027
1220,Corentin Jean,FRA,"FW,MF",Lens,Ligue 1,25,1995,6.4,4,3,1,1,2,0,5,0.0,5,4,0,4,2,6,2,0,0,2020-2021,0.3125,0.625
1221,Daniel Jebbison,ENG,FW,Sheffield Utd,Premier League,16,2003,3.2,6,2,1,3,2,3,7,42.9,4,6,1,5,1,7,0,0,0,2020-2021,0.3125,1.875
1222,Tin Jedvaj,CRO,DF,Leverkusen,Bundesliga,24,1995,1.7,5,2,2,3,0,1,3,33.3,2,2,1,1,2,7,9,0,0,2020-2021,1.1764705882352942,2.9411764705882355
1223,Fredrik Jensen,FIN,"FW,MF",Augsburg,Bundesliga,22,1997,4.2,3,2,1,2,0,3,6,50.0,3,4,1,3,2,5,6,0,0,2020-2021,0.47619047619047616,0.7142857142857143
1224,Jesé,ESP,FW,Paris S-G,Ligue 1,27,1993,0.3,0,0,0,0,0,0,1,0.0,1,0,0,0,0,0,0,0,0,2020-2021,0.0,0.0
1225,Gabriel Jesus,BRA,FW,Manchester City,Premier League,23,1997,22.9,17,6,5,5,7,11,28,39.3,17,16,0,16,15,32,5,0,0,2020-2021,0.6550218340611355,0.7423580786026202
Rk,Player,Nation,Pos,Squad,Comp,0,0,90.0,0,0,3,3,3,Tkl,0,0.0,0,0,0,0,0,0,0,0,0,2020-2021,0.0,0.0
1226,Juan Jesus,BRA,DF,Roma,Serie A,29,1991,1.7,3,1,2,1,0,2,4,50.0,2,1,0,1,2,5,5,0,0,2020-2021,1.1764705882352942,1.7647058823529411
1227,Raúl Jiménez,MEX,FW,Wolves,Premier League,29,1991,9.1,3,2,1,2,0,0,7,0.0,7,2,0,2,8,11,12,0,0,2020-2021,0.8791208791208791,0.32967032967032966
1228,Joaquín,ESP,"FW,MF",Betis,La Liga,39,1981,14.3,9,3,1,5,3,4,12,33.3,8,8,0,8,17,26,11,0,0,2020-2021,1.1888111888111887,0.6293706293706294
1229,John Joe,IRL,"MF,FW",Getafe,La Liga,16,2003,0.7,2,0,0,2,0,0,0,0.0,0,0,0,0,0,2,0,0,0,2020-2021,0.0,2.857142857142857
1230,Joelinton,BRA,"FW,MF",Newcastle Utd,Premier League,23,1996,22.0,33,21,7,21,5,14,37,37.8,23,30,2,28,9,42,24,0,0,2020-2021,0.4090909090909091,1.5
1231,Marco John,GER,DF,Hoffenheim,Bundesliga,18,2002,11.1,21,15,9,5,7,10,22,45.5,12,18,1,17,16,37,21,0,0,2020-2021,1.4414414414414416,1.8918918918918919
1232,Ben Johnson,ENG,"DF,FW",West Ham,Premier League,20,2000,5.8,11,5,5,3,3,7,9,77.8,2,5,1,4,11,22,9,0,0,2020-2021,1.896551724137931,1.896551724137931
1233,Sam Johnstone,ENG,GK,West Brom,Premier League,27,1993,37.0,0,0,0,0,0,0,0,0.0,0,0,0,0,2,2,15,2,0,2020-2021,0.05405405405405406,0.0
1234,Curtis Jones,ENG,MF,Liverpool,Premier League,19,2001,13.1,16,6,6,7,3,12,25,48.0,13,13,0,13,19,35,11,1,0,2020-2021,1.450381679389313,1.2213740458015268
1235,Frenkie de Jong,NED,"MF,DF",Barcelona,La Liga,23,1997,35.0,44,27,21,19,4,15,35,42.9,20,20,4,16,38,82,29,2,0,2020-2021,1.0857142857142856,1.2571428571428571
1236,Luuk de Jong,NED,FW,Sevilla,La Liga,29,1990,14.1,9,5,3,2,4,1,7,14.3,6,11,3,8,5,14,15,0,0,2020-2021,0.3546099290780142,0.6382978723404256
1237,Jony,ESP,"MF,FW",Osasuna,La Liga,29,1991,9.7,7,3,1,2,4,5,20,25.0,15,5,0,5,14,21,3,0,0,2020-2021,1.4432989690721651,0.7216494845360826
1238,Joan Jordán,ESP,MF,Sevilla,La Liga,26,1994,26.7,52,28,17,29,6,17,76,22.4,59,22,3,19,27,79,25,0,0,2020-2021,1.0112359550561798,1.9475655430711611
1239,Jorginho,ITA,MF,Chelsea,Premier League,28,1991,22.3,57,30,22,31,4,31,76,40.8,45,33,5,28,40,97,21,3,0,2020-2021,1.7937219730941703,2.5560538116591927
1240,Josan,ESP,"MF,DF",Elche,La Liga,30,1989,21.4,34,18,23,11,0,13,39,33.3,26,24,1,23,21,55,26,1,0,2020-2021,0.9813084112149534,1.5887850467289721
1241,Willian José,BRA,FW,Wolves,Premier League,28,1991,12.3,2,1,1,1,0,1,4,25.0,3,6,1,5,1,3,12,0,0,2020-2021,0.08130081300813008,0.16260162601626016
1242,Willian José,BRA,FW,Real Sociedad,La Liga,28,1991,7.7,3,1,0,3,0,1,3,33.3,2,3,1,2,0,3,8,0,0,2020-2021,0.0,0.38961038961038963
1243,Joselu,ESP,FW,Alavés,La Liga,30,1990,33.6,27,14,6,15,6,8,28,28.6,20,26,3,23,15,42,58,1,0,2020-2021,0.4464285714285714,0.8035714285714285
1244,Josema,ESP,DF,Elche,La Liga,24,1996,21.8,43,28,33,10,0,10,18,55.6,8,17,7,10,37,80,92,0,0,2020-2021,1.6972477064220184,1.9724770642201834
1245,Jota,POR,"MF,FW",Valladolid,La Liga,21,1999,7.4,7,3,1,4,2,5,10,50.0,5,4,0,4,6,13,5,1,0,2020-2021,0.8108108108108107,0.9459459459459459
1246,Jota,ESP,MF,Alavés,La Liga,29,1991,15.5,19,14,6,7,6,3,29,10.3,26,12,0,12,9,28,9,0,0,2020-2021,0.5806451612903226,1.2258064516129032
1247,Diogo Jota,POR,FW,Liverpool,Premier League,23,1996,12.4,12,6,4,7,1,2,29,6.9,27,9,0,9,5,17,3,0,0,2020-2021,0.4032258064516129,0.9677419354838709
1248,Stevan Jovetić,MNE,"FW,MF",Monaco,Ligue 1,30,1989,8.9,8,4,2,3,3,3,13,23.1,10,1,0,1,3,11,3,0,0,2020-2021,0.33707865168539325,0.898876404494382
1249,Luka Jović,SRB,FW,Real Madrid,La Liga,22,1997,1.7,0,0,0,0,0,0,0,0.0,0,0,0,0,0,0,0,0,0,2020-2021,0.0,0.0
1250,Luka Jović,SRB,FW,Eint Frankfurt,Bundesliga,22,1997,9.9,2,0,0,2,0,0,4,0.0,4,3,0,3,1,3,7,0,0,2020-2021,0.10101010101010101,0.20202020202020202
Rk,Player,Nation,Pos,Squad,Comp,0,0,90.0,0,0,3,3,3,Tkl,0,0.0,0,0,0,0,0,0,0,0,0,2020-2021,0.0,0.0
1251,Juanmi,ESP,"FW,MF",Betis,La Liga,27,1993,6.7,13,9,3,5,5,4,18,22.2,14,4,0,4,2,15,4,0,0,2020-2021,0.29850746268656714,1.9402985074626866
1252,Hamed Junior Traorè,CIV,"MF,FW",Sassuolo,Serie A,20,2000,19.9,29,17,10,10,9,14,35,40.0,21,27,3,24,18,47,9,0,0,2020-2021,0.9045226130653267,1.4572864321608041
1253,Vinicius Júnior,BRA,FW,Real Madrid,La Liga,20,2000,21.9,32,22,14,10,8,11,43,25.6,32,28,0,28,7,39,4,0,0,2020-2021,0.31963470319634707,1.4611872146118723
1254,James Justin,ENG,DF,Leicester City,Premier League,22,1998,23.0,61,37,38,18,5,20,41,48.8,21,36,10,26,30,91,58,1,0,2020-2021,1.3043478260869565,2.652173913043478
1255,Musa Juwara,GAM,"MF,DF",Bologna,Serie A,18,2001,0.5,2,2,2,0,0,1,3,33.3,2,1,0,1,0,2,0,0,0,2020-2021,0.0,4.0
1256,Jens Jønsson,DEN,MF,Cádiz,La Liga,27,1993,29.1,55,29,25,25,5,22,52,42.3,30,39,7,32,51,106,45,0,0,2020-2021,1.7525773195876289,1.8900343642611683
1257,Ozan Kabak,TUR,DF,Liverpool,Premier League,20,2000,8.9,19,10,11,4,4,6,9,66.7,3,2,2,0,12,31,28,1,0,2020-2021,1.348314606741573,2.134831460674157
1258,Ozan Kabak,TUR,DF,Schalke 04,Bundesliga,20,2000,13.8,17,9,11,5,1,6,13,46.2,7,20,11,9,13,30,57,0,0,2020-2021,0.9420289855072463,1.2318840579710144
1259,Abdoul Kader Bamba,FRA,"FW,MF",Nantes,Ligue 1,26,1994,10.2,18,3,7,8,3,11,18,61.1,7,10,0,10,7,25,4,1,0,2020-2021,0.6862745098039216,1.7647058823529413
1260,Pavel Kadeřábek,CZE,"DF,FW",Hoffenheim,Bundesliga,28,1992,17.6,15,12,7,6,2,6,15,40.0,9,12,3,9,18,33,31,0,0,2020-2021,1.0227272727272727,0.8522727272727272
1261,Tino Kadewere,ZIM,FW,Lyon,Ligue 1,24,1996,22.3,35,22,12,16,7,17,49,34.7,32,16,3,13,21,56,31,0,0,2020-2021,0.9417040358744394,1.569506726457399
1262,Damian Kądzior,POL,"FW,MF",Eibar,La Liga,28,1992,2.2,1,0,0,1,0,1,5,20.0,4,1,0,1,0,1,0,0,0,2020-2021,0.0,0.45454545454545453
1263,Florian Kainz,AUT,"MF,FW",Köln,Bundesliga,27,1992,5.0,4,2,0,4,0,2,8,25.0,6,7,0,7,3,7,3,0,0,2020-2021,0.6,0.8
1264,Gaël Kakuta,COD,"MF,FW",Lens,Ligue 1,29,1991,26.6,38,23,10,18,10,8,44,18.2,36,24,3,21,17,55,4,0,0,2020-2021,0.6390977443609023,1.4285714285714286
1265,Sasa Kalajdzic,AUT,FW,Stuttgart,Bundesliga,23,1997,23.7,16,12,4,5,7,2,17,11.8,15,10,1,9,9,25,21,0,0,2020-2021,0.379746835443038,0.6751054852320675
1266,Arnaud Kalimuendo,FRA,FW,Paris S-G,Ligue 1,18,2002,0.8,0,0,0,0,0,0,0,0.0,0,0,0,0,0,0,0,0,0,2020-2021,0.0,0.0
1267,Arnaud Kalimuendo,FRA,"FW,MF",Lens,Ligue 1,18,2002,13.5,8,2,2,2,4,1,7,14.3,6,11,0,11,2,10,2,0,0,2020-2021,0.14814814814814814,0.5925925925925926
1268,Nikola Kalinić,CRO,FW,Hellas Verona,Serie A,32,1988,11.8,5,1,2,2,1,0,3,0.0,3,6,0,6,1,6,7,0,0,2020-2021,0.0847457627118644,0.423728813559322
1269,Yayah Kallon,SLE,FW,Genoa,Serie A,19,2001,0.5,0,0,0,0,0,0,0,0.0,0,0,0,0,0,0,0,0,0,2020-2021,0.0,0.0
1270,Samuel Kalu,NGA,"FW,MF",Bordeaux,Ligue 1,22,1997,10.7,21,12,11,8,2,4,13,30.8,9,14,0,14,9,30,2,0,0,2020-2021,0.8411214953271029,1.9626168224299068
1271,Pierre Kalulu,FRA,DF,Milan,Serie A,20,2000,8.1,18,14,11,6,1,10,14,71.4,4,9,3,6,19,37,20,0,0,2020-2021,2.345679012345679,2.2222222222222223
1272,Daichi Kamada,JPN,MF,Eint Frankfurt,Bundesliga,23,1996,26.2,48,28,21,16,11,16,49,32.7,33,18,1,17,14,62,22,0,0,2020-2021,0.5343511450381679,1.83206106870229
1273,Aboubakar Kamara,MTN,"FW,MF",Fulham,Premier League,25,1995,3.5,2,2,1,1,0,0,5,0.0,5,6,0,6,1,3,0,0,0,2020-2021,0.2857142857142857,0.5714285714285714
1274,Aboubakar Kamara,MTN,"FW,MF",Dijon,Ligue 1,25,1995,6.2,3,1,0,2,1,1,7,14.3,6,1,0,1,0,3,2,0,0,2020-2021,0.0,0.48387096774193544
1275,Bingourou Kamara,SEN,GK,Strasbourg,Ligue 1,23,1996,8.0,1,1,1,0,0,1,3,33.3,2,0,0,0,1,2,2,1,0,2020-2021,0.125,0.125
Rk,Player,Nation,Pos,Squad,Comp,0,0,90.0,0,0,3,3,3,Tkl,0,0.0,0,0,0,0,0,0,0,0,0,2020-2021,0.0,0.0
1276,Boubacar Kamara,FRA,MF,Marseille,Ligue 1,20,1999,32.2,88,51,31,49,8,40,74,54.1,34,36,13,23,34,122,51,0,0,2020-2021,1.0559006211180124,2.732919254658385
1277,Hassane Kamara,CIV,"DF,FW",Nice,Ligue 1,26,1994,32.9,65,39,40,16,9,27,49,55.1,22,39,12,27,55,120,61,1,0,2020-2021,1.6717325227963526,1.9756838905775076
1278,Marcin Kamiński,POL,DF,Stuttgart,Bundesliga,28,1992,2.4,1,1,0,0,1,0,0,0.0,0,2,1,1,1,2,10,0,0,2020-2021,0.4166666666666667,0.4166666666666667
1279,Kevin Kampl,SVN,MF,RB Leipzig,Bundesliga,29,1990,21.5,38,26,9,24,5,18,35,51.4,17,20,2,18,29,67,14,0,0,2020-2021,1.3488372093023255,1.7674418604651163
1280,Harry Kane,ENG,FW,Tottenham,Premier League,27,1993,34.2,22,12,1,17,4,8,26,30.8,18,28,11,17,11,33,40,0,0,2020-2021,0.3216374269005848,0.6432748538011696
1281,Lee Kang-in,KOR,"FW,MF",Valencia,La Liga,19,2001,14.0,15,11,8,4,3,3,31,9.7,28,12,0,12,2,17,0,0,0,2020-2021,0.14285714285714285,1.0714285714285714
1282,Wilfried Kanga,CIV,FW,Angers,Ligue 1,22,1998,1.5,0,0,0,0,0,0,1,0.0,1,1,0,1,0,0,2,0,0,2020-2021,0.0,0.0
1283,N'Golo Kanté,FRA,MF,Chelsea,Premier League,29,1991,23.8,79,42,39,35,5,27,56,48.2,29,42,4,38,59,138,34,0,0,2020-2021,2.4789915966386555,3.3193277310924367
1284,Jimmy Kaparos,GER,MF,Schalke 04,Bundesliga,18,2001,0.2,0,0,0,0,0,0,1,0.0,1,0,0,0,0,0,0,0,0,2020-2021,0.0,0.0
1285,Yann Karamoh,FRA,"FW,MF",Parma,Serie A,22,1998,14.4,27,17,8,12,7,11,31,35.5,20,6,0,6,4,31,11,0,0,2020-2021,0.2777777777777778,1.875
1286,Isaac Karamoko,FRA,DF,Sassuolo,Serie A,18,2002,0.0,1,0,0,0,1,1,1,100.0,0,0,0,0,0,1,0,0,0,2020-2021,,inf
1287,Atakan Karazor,GER,"DF,MF",Stuttgart,Bundesliga,23,1996,11.5,20,12,12,7,1,13,22,59.1,9,18,8,10,21,41,50,2,0,2020-2021,1.826086956521739,1.7391304347826086
1288,Augustus Kargbo,SLE,FW,Crotone,Serie A,20,1999,0.4,0,0,0,0,0,0,0,0.0,0,0,0,0,0,0,0,0,0,2020-2021,0.0,0.0
1289,Loris Karius,GER,GK,Union Berlin,Bundesliga,27,1993,3.2,0,0,0,0,0,0,0,0.0,0,0,0,0,0,0,2,0,0,2020-2021,0.0,0.0
1290,Rick Karsdorp,NED,DF,Roma,Serie A,25,1995,28.3,36,23,19,12,5,21,48,43.8,27,18,1,17,30,66,32,0,0,2020-2021,1.0600706713780919,1.2720848056537102
1291,Silas Katompa,COD,"DF,FW",Stuttgart,Bundesliga,21,1998,21.3,48,29,19,19,10,21,44,47.7,23,29,1,28,22,70,11,2,0,2020-2021,1.0328638497652582,2.2535211267605635
1292,Noah Katterbach,GER,"DF,MF",Köln,Bundesliga,19,2001,12.3,18,11,11,6,1,13,21,61.9,8,7,3,4,23,41,22,0,0,2020-2021,1.8699186991869918,1.4634146341463414
1293,Eiji Kawashima,JPN,GK,Strasbourg,Ligue 1,37,1983,24.0,1,0,1,0,0,1,1,100.0,0,0,0,0,0,1,4,2,0,2020-2021,0.0,0.041666666666666664
1294,Moise Kean,ITA,"FW,MF",Everton,Premier League,20,2000,0.2,0,0,0,0,0,0,0,0.0,0,0,0,0,0,0,0,0,0,2020-2021,0.0,0.0
1295,Moise Kean,ITA,FW,Paris S-G,Ligue 1,20,2000,18.9,11,8,2,6,3,3,12,25.0,9,7,1,6,8,19,10,0,0,2020-2021,0.4232804232804233,0.5820105820105821
1296,Michael Keane,ENG,DF,Everton,Premier League,27,1993,33.2,28,15,20,8,0,14,31,45.2,17,46,33,13,51,79,161,0,0,2020-2021,1.5361445783132528,0.8433734939759036
1297,Neeskens Kebano,COD,"FW,MF",Fulham,Premier League,28,1992,1.3,0,0,0,0,0,0,1,0.0,1,3,0,3,0,0,0,0,0,2020-2021,0.0,0.0
1298,Thilo Kehrer,GER,DF,Paris S-G,Ligue 1,23,1996,18.0,31,26,17,11,3,10,26,38.5,16,16,4,12,15,46,37,1,0,2020-2021,0.8333333333333334,1.7222222222222223
1299,Habib Keita,MLI,MF,Lyon,Ligue 1,18,2002,0.1,0,0,0,0,0,0,0,0.0,0,0,0,0,0,0,0,0,0,2020-2021,0.0,0.0
1300,Naby Keïta,GUI,MF,Liverpool,Premier League,25,1995,5.8,11,5,1,8,2,7,17,41.2,10,10,0,10,9,20,6,0,0,2020-2021,1.5517241379310345,1.896551724137931
Rk,Player,Nation,Pos,Squad,Comp,0,0,90.0,0,0,3,3,3,Tkl,0,0.0,0,0,0,0,0,0,0,0,0,2020-2021,0.0,0.0
1301,Yannik Keitel,GER,MF,Freiburg,Bundesliga,20,2000,5.5,12,8,7,4,1,7,9,77.8,2,9,3,6,10,22,8,0,0,2020-2021,1.8181818181818181,2.1818181818181817
1302,Caoimhín Kelleher,IRL,GK,Liverpool,Premier League,21,1998,2.0,0,0,0,0,0,0,0,0.0,0,0,0,0,0,0,2,0,0,2020-2021,0.0,0.0
1303,Stephane Keller,CMR,DF,Alavés,La Liga,18,2001,0.2,1,0,1,0,0,1,1,100.0,0,0,0,0,0,1,0,0,0,2020-2021,0.0,5.0
1304,Martin Kelly,ENG,DF,Crystal Palace,Premier League,30,1990,0.0,1,0,1,0,0,1,1,100.0,0,0,0,0,0,1,0,0,0,2020-2021,,inf
1305,Marc-Oliver Kempf,GER,DF,Stuttgart,Bundesliga,25,1995,30.3,49,26,28,18,3,29,49,59.2,20,40,25,15,68,117,103,1,0,2020-2021,2.2442244224422443,1.6171617161716172
1306,Kenedy,BRA,"FW,MF",Granada,La Liga,24,1996,16.3,22,12,10,7,5,5,25,20.0,20,21,4,17,26,48,15,1,0,2020-2021,1.5950920245398772,1.3496932515337423
1307,Jonjoe Kenny,ENG,DF,Everton,Premier League,23,1997,0.9,2,1,1,0,1,2,2,100.0,0,0,0,0,1,3,3,0,0,2020-2021,1.1111111111111112,2.2222222222222223
1308,Franck Kessié,CIV,MF,Milan,Serie A,23,1996,35.8,53,30,28,19,6,20,38,52.6,18,47,15,32,46,99,51,0,0,2020-2021,1.2849162011173185,1.4804469273743017
1309,Reda Khadra,GER,MF,Brighton,Premier League,19,2001,0.1,0,0,0,0,0,0,0,0.0,0,0,0,0,0,0,0,0,0,2020-2021,0.0,0.0
1310,Omar Khailoti,ITA,DF,Bologna,Serie A,18,2001,0.3,0,0,0,0,0,0,0,0.0,0,2,0,2,1,1,0,0,0,2020-2021,3.3333333333333335,0.0
1311,Saîf-Eddine Khaoui,TUN,"FW,DF",Marseille,Ligue 1,25,1995,6.7,19,11,7,6,6,7,16,43.8,9,8,0,8,12,31,1,0,0,2020-2021,1.791044776119403,2.835820895522388
1312,Wahbi Khazri,TUN,FW,Saint-Étienne,Ligue 1,29,1991,13.1,24,15,12,7,5,12,24,50.0,12,10,1,9,4,28,11,0,0,2020-2021,0.3053435114503817,1.83206106870229
1313,Rani Khedira,GER,MF,Augsburg,Bundesliga,26,1994,20.2,29,10,13,15,1,10,20,50.0,10,14,5,9,31,60,47,0,0,2020-2021,1.5346534653465347,1.4356435643564356
1314,Sami Khedira,GER,MF,Hertha BSC,Bundesliga,33,1987,4.4,11,6,3,7,1,6,12,50.0,6,4,0,4,9,20,7,0,0,2020-2021,2.0454545454545454,2.5
1315,Kiké,ESP,FW,Eibar,La Liga,30,1989,34.3,24,18,5,7,12,6,22,27.3,16,24,1,23,7,31,29,0,0,2020-2021,0.20408163265306123,0.6997084548104957
1316,Luca Kilian,GER,DF,Mainz 05,Bundesliga,20,1999,4.2,14,7,10,4,0,9,17,52.9,8,3,1,2,13,27,12,0,0,2020-2021,3.095238095238095,3.333333333333333
1317,Max Kilman,ENG,DF,Wolves,Premier League,23,1997,14.6,21,14,13,4,4,8,14,57.1,6,17,8,9,19,40,46,0,0,2020-2021,1.3013698630136987,1.4383561643835616
1318,Joshua Kimmich,GER,MF,Bayern Munich,Bundesliga,25,1995,24.4,40,28,16,19,5,10,53,18.9,43,25,5,20,36,76,19,0,0,2020-2021,1.4754098360655739,1.639344262295082
1319,Presnel Kimpembe,FRA,DF,Paris S-G,Ligue 1,24,1995,25.6,46,28,23,19,4,24,34,70.6,10,19,11,8,30,76,61,4,0,2020-2021,1.171875,1.796875
1320,Joshua King,NOR,"MF,FW",Everton,Premier League,28,1992,1.6,4,1,2,1,1,0,0,0.0,0,3,0,3,1,5,1,0,0,2020-2021,0.625,2.5
1321,Simon Kjær,DEN,DF,Milan,Serie A,31,1989,26.6,45,26,23,20,2,18,30,60.0,12,42,26,16,42,87,125,0,0,2020-2021,1.5789473684210527,1.6917293233082706
1322,Davy Klaassen,NED,MF,Werder Bremen,Bundesliga,27,1993,2.5,3,1,0,1,2,0,5,0.0,5,5,1,4,3,6,4,0,0,2020-2021,1.2,1.2
1323,Felix Klaus,GER,"DF,MF",Wolfsburg,Bundesliga,27,1992,1.5,7,4,3,4,0,4,5,80.0,1,4,0,4,2,9,4,0,0,2020-2021,1.3333333333333333,4.666666666666667
1324,Klauss,BRA,"MF,FW",Hoffenheim,Bundesliga,23,1997,0.6,1,0,0,0,1,0,1,0.0,1,0,0,0,0,1,0,0,0,2020-2021,0.0,1.6666666666666667
1325,Ragnar Klavan,EST,DF,Cagliari,Serie A,34,1985,8.6,15,9,9,5,1,7,11,63.6,4,9,4,5,8,23,34,0,0,2020-2021,0.9302325581395349,1.744186046511628
Rk,Player,Nation,Pos,Squad,Comp,0,0,90.0,0,0,3,3,3,Tkl,0,0.0,0,0,0,0,0,0,0,0,0,2020-2021,0.0,0.0
1326,Philipp Klement,GER,"MF,FW",Stuttgart,Bundesliga,27,1992,4.7,7,3,6,0,1,3,7,42.9,4,9,2,7,6,13,7,0,0,2020-2021,1.276595744680851,1.4893617021276595
1327,Mateusz Klich,POL,MF,Leeds United,Premier League,30,1990,26.6,38,20,14,20,4,14,61,23.0,47,13,4,9,11,49,16,0,0,2020-2021,0.41353383458646614,1.4285714285714286
1328,Mateo Klimowicz,GER,"MF,FW",Stuttgart,Bundesliga,20,2000,13.3,20,15,6,10,4,5,18,27.8,13,5,1,4,2,22,2,0,0,2020-2021,0.15037593984962405,1.5037593984962405
1329,Fabian Klos,GER,FW,Arminia,Bundesliga,32,1987,30.1,24,13,9,11,4,7,26,26.9,19,20,6,14,4,28,29,0,0,2020-2021,0.13289036544850497,0.7973421926910299
1330,Lukas Klostermann,GER,DF,RB Leipzig,Bundesliga,24,1996,16.1,23,19,8,12,3,11,18,61.1,7,16,6,10,18,41,44,1,0,2020-2021,1.1180124223602483,1.4285714285714284
1331,Justin Kluivert,NED,MF,Roma,Serie A,21,1999,0.2,0,0,0,0,0,0,0,0.0,0,0,0,0,0,0,0,0,0,2020-2021,0.0,0.0
1332,Justin Kluivert,NED,"FW,MF",RB Leipzig,Bundesliga,21,1999,9.0,2,1,1,1,0,0,2,0.0,2,4,0,4,5,7,3,0,0,2020-2021,0.5555555555555556,0.2222222222222222
1333,Lukas Klünter,GER,DF,Hertha BSC,Bundesliga,24,1996,11.0,10,5,6,4,0,5,10,50.0,5,3,1,2,11,21,29,1,0,2020-2021,1.0,0.9090909090909091
1334,Ansgar Knauff,GER,"MF,FW",Dortmund,Bundesliga,18,2002,0.8,0,0,0,0,0,0,1,0.0,1,3,1,2,0,0,0,0,0,2020-2021,0.0,0.0
1335,Robin Knoche,GER,DF,Union Berlin,Bundesliga,28,1992,33.8,44,29,30,12,2,23,39,59.0,16,43,27,16,49,93,118,2,0,2020-2021,1.4497041420118344,1.3017751479289943
1336,Gregor Kobel,SUI,GK,Stuttgart,Bundesliga,22,1997,33.0,2,2,2,0,0,2,2,100.0,0,0,0,0,2,4,8,1,0,2020-2021,0.06060606060606061,0.06060606060606061
1337,Robin Koch,GER,"DF,MF",Leeds United,Premier League,24,1996,12.6,27,16,17,10,0,10,19,52.6,9,18,12,6,27,54,34,2,0,2020-2021,2.142857142857143,2.142857142857143
1338,Giorgi Kochorashvili,GEO,MF,Levante,La Liga,21,1999,0.3,1,0,1,0,0,0,0,0.0,0,0,0,0,0,1,0,0,0,2020-2021,0.0,3.3333333333333335
1339,Kenan Kodro,BIH,"FW,MF",Valladolid,La Liga,26,1993,5.1,0,0,0,0,0,0,2,0.0,2,2,1,1,2,2,6,0,0,2020-2021,0.3921568627450981,0.0
1340,Kenan Kodro,BIH,"FW,MF",Athletic Club,La Liga,26,1993,0.5,0,0,0,0,0,0,1,0.0,1,0,0,0,0,0,0,0,0,2020-2021,0.0,0.0
1341,Dominik Kohr,GER,MF,Mainz 05,Bundesliga,26,1994,14.1,47,31,14,26,7,20,39,51.3,19,18,5,13,27,74,15,0,0,2020-2021,1.9148936170212767,3.3333333333333335
1342,Dominik Kohr,GER,"MF,DF",Eint Frankfurt,Bundesliga,26,1994,2.9,11,7,0,7,4,4,9,44.4,5,5,1,4,9,20,9,0,0,2020-2021,3.103448275862069,3.793103448275862
1343,Koba Koindredi,FRA,MF,Valencia,La Liga,18,2001,0.2,1,1,1,0,0,0,1,0.0,1,0,0,0,0,1,0,0,0,2020-2021,0.0,5.0
1344,Koke,ESP,MF,Atlético Madrid,La Liga,28,1992,33.6,64,42,22,31,11,28,98,28.6,70,35,6,29,36,100,40,0,0,2020-2021,1.0714285714285714,1.9047619047619047
1345,Aleksandr Kokorin,RUS,"FW,MF",Fiorentina,Serie A,29,1991,1.0,1,0,0,1,0,0,1,0.0,1,1,0,1,0,1,0,0,0,2020-2021,0.0,1.0
1346,Aleksandar Kolarov,SRB,DF,Inter,Serie A,34,1985,4.3,4,4,0,4,0,1,2,50.0,1,2,0,2,7,11,8,0,0,2020-2021,1.627906976744186,0.9302325581395349
1347,Sead Kolašinac,BIH,DF,Arsenal,Premier League,27,1993,1.0,0,0,0,0,0,0,0,0.0,0,0,0,0,1,1,0,0,0,2020-2021,1.0,0.0
1348,Sead Kolašinac,BIH,"DF,MF",Schalke 04,Bundesliga,27,1993,15.8,20,17,10,7,3,8,18,44.4,10,17,5,12,20,40,17,0,0,2020-2021,1.2658227848101264,1.2658227848101264
1349,Randal Kolo Muani,FRA,FW,Nantes,Ligue 1,21,1998,33.7,22,14,1,13,8,7,27,25.9,20,15,2,13,8,30,26,0,0,2020-2021,0.2373887240356083,0.6528189910979227
1350,Timothée Kolodziejczak,FRA,DF,Saint-Étienne,Ligue 1,28,1991,22.6,28,15,23,5,0,19,27,70.4,8,24,15,9,36,64,80,1,0,2020-2021,1.5929203539823007,1.238938053097345
Rk,Player,Nation,Pos,Squad,Comp,0,0,90.0,0,0,3,3,3,Tkl,0,0.0,0,0,0,0,0,0,0,0,0,2020-2021,0.0,0.0
1351,Ghislain Konan,CIV,DF,Reims,Ligue 1,24,1995,29.0,57,32,35,17,5,32,56,57.1,24,25,11,14,30,87,67,0,0,2020-2021,1.0344827586206897,1.9655172413793103
1352,Ibrahima Konaté,FRA,DF,RB Leipzig,Bundesliga,21,1999,7.7,6,4,2,3,1,2,8,25.0,6,6,3,3,8,14,24,0,0,2020-2021,1.0389610389610389,0.7792207792207793
1353,Moussa Konaté,SEN,FW,Dijon,Ligue 1,27,1993,13.3,5,3,1,2,2,2,11,18.2,9,4,1,3,5,10,8,0,0,2020-2021,0.37593984962406013,0.37593984962406013
1354,Geoffrey Kondogbia,CTA,MF,Valencia,La Liga,27,1993,4.9,16,9,9,4,3,7,19,36.8,12,6,1,5,8,24,8,0,0,2020-2021,1.6326530612244896,3.265306122448979
1355,Geoffrey Kondogbia,CTA,MF,Atlético Madrid,La Liga,27,1993,6.8,30,20,12,16,2,11,20,55.0,9,11,5,6,11,41,8,1,0,2020-2021,1.6176470588235294,4.411764705882353
1356,Lamine Koné,CIV,DF,Strasbourg,Ligue 1,31,1989,11.6,9,6,5,4,0,5,8,62.5,3,4,3,1,15,24,36,0,0,2020-2021,1.293103448275862,0.7758620689655172
1357,Moussa Koné,SEN,FW,Nîmes,Ligue 1,23,1996,19.5,13,6,1,8,4,2,9,22.2,7,7,1,6,2,15,7,0,0,2020-2021,0.10256410256410256,0.6666666666666666
1358,Youssouf Koné,MLI,"DF,MF",Elche,La Liga,25,1995,0.8,2,0,1,0,1,0,1,0.0,1,0,0,0,0,2,0,0,0,2020-2021,0.0,2.5
1359,Terence Kongolo,NED,DF,Fulham,Premier League,26,1994,1.0,3,2,1,2,0,1,1,100.0,0,0,0,0,2,5,3,0,0,2020-2021,2.0,3.0
1360,Ezri Konsa,ENG,DF,Aston Villa,Premier League,22,1997,35.5,25,13,18,6,1,9,13,69.2,4,53,47,6,29,54,162,1,0,2020-2021,0.8169014084507042,0.704225352112676
1361,Laurent Koscielny,FRA,DF,Bordeaux,Ligue 1,34,1985,24.6,29,17,18,11,0,16,24,66.7,8,44,34,10,54,83,115,1,0,2020-2021,2.195121951219512,1.178861788617886
1362,Filip Kostić,SRB,DF,Eint Frankfurt,Bundesliga,27,1992,28.2,54,31,22,23,9,22,54,40.7,32,43,6,37,26,80,28,2,0,2020-2021,0.9219858156028369,1.9148936170212767
1363,Márk Kosznovszky,HUN,MF,Parma,Serie A,18,2002,1.0,2,2,1,1,0,1,4,25.0,3,2,0,2,1,3,1,0,0,2020-2021,1.0,2.0
1364,Christian Kouamé,CIV,FW,Fiorentina,Serie A,22,1997,11.1,9,4,2,4,3,4,12,33.3,8,9,1,8,5,14,4,0,0,2020-2021,0.45045045045045046,0.8108108108108109
1365,Kalidou Koulibaly,SEN,DF,Napoli,Serie A,29,1991,24.5,36,24,25,7,4,19,32,59.4,13,46,26,20,29,65,64,2,0,2020-2021,1.183673469387755,1.469387755102041
1366,Jules Koundé,FRA,DF,Sevilla,La Liga,21,1998,33.1,27,15,14,11,2,10,24,41.7,14,24,16,8,40,67,104,0,0,2020-2021,1.2084592145015105,0.8157099697885196
1367,Boubakar Kouyaté,MLI,DF,Metz,Ligue 1,23,1997,21.8,60,35,45,15,0,32,58,55.2,26,44,27,17,60,120,132,1,0,2020-2021,2.7522935779816513,2.7522935779816513
1368,Cheikhou Kouyaté,SEN,DF,Crystal Palace,Premier League,30,1989,34.7,58,37,44,12,2,25,43,58.1,18,42,26,16,32,90,125,2,0,2020-2021,0.9221902017291066,1.6714697406340056
1369,Mateo Kovačić,CRO,MF,Chelsea,Premier League,26,1994,20.2,46,28,19,24,3,17,32,53.1,15,18,1,17,15,61,11,2,0,2020-2021,0.7425742574257426,2.2772277227722775
1370,Viktor Kovalenko,UKR,FW,Atalanta,Serie A,24,1996,0.0,0,0,0,0,0,0,0,0.0,0,0,0,0,0,0,1,0,0,2020-2021,,
1371,Emil Krafth,SWE,DF,Newcastle Utd,Premier League,25,1994,14.3,19,8,9,9,1,12,25,48.0,13,15,9,6,15,34,52,2,0,2020-2021,1.048951048951049,1.3286713286713285
1372,Andrej Kramarić,CRO,"FW,MF",Hoffenheim,Bundesliga,29,1991,26.4,7,4,4,0,3,3,8,37.5,5,8,1,7,7,14,5,1,0,2020-2021,0.26515151515151514,0.26515151515151514
1373,Christoph Kramer,GER,MF,Gladbach,Bundesliga,29,1991,22.6,55,37,22,28,5,28,58,48.3,30,32,11,21,34,89,39,0,0,2020-2021,1.5044247787610618,2.433628318584071
1374,Jean-Philippe Krasso,CIV,FW,Saint-Étienne,Ligue 1,23,1997,2.5,5,3,1,4,0,2,4,50.0,2,5,0,5,1,6,3,0,0,2020-2021,0.4,2.0
1375,Toni Kroos,GER,MF,Real Madrid,La Liga,30,1990,23.5,42,22,15,15,12,11,44,25.0,33,26,6,20,15,57,10,3,0,2020-2021,0.6382978723404256,1.7872340425531914
Rk,Player,Nation,Pos,Squad,Comp,0,0,90.0,0,0,3,3,3,Tkl,0,0.0,0,0,0,0,0,0,0,0,0,2020-2021,0.0,0.0
1376,Filip Krovinović,CRO,MF,West Brom,Premier League,24,1995,6.1,13,10,6,5,2,6,18,33.3,12,2,0,2,4,17,2,0,0,2020-2021,0.6557377049180328,2.1311475409836067
1377,Rade Krunić,BIH,"MF,FW",Milan,Serie A,26,1993,8.0,15,12,6,6,3,7,17,41.2,10,12,2,10,10,25,9,0,0,2020-2021,1.25,1.875
1378,Max Kruse,GER,"FW,MF",Union Berlin,Bundesliga,32,1988,18.1,7,3,1,5,1,2,9,22.2,7,11,0,11,3,10,3,0,0,2020-2021,0.16574585635359115,0.38674033149171266
1379,Lukas Kübler,GER,"DF,MF",Freiburg,Bundesliga,27,1992,9.8,15,8,9,5,1,9,14,64.3,5,9,3,6,21,36,31,0,0,2020-2021,2.142857142857143,1.530612244897959
1380,Takefusa Kubo,JPN,"MF,FW",Villarreal,La Liga,19,2001,3.3,1,1,0,0,1,1,5,20.0,4,2,0,2,1,2,2,0,0,2020-2021,0.30303030303030304,0.30303030303030304
1381,Takefusa Kubo,JPN,"MF,FW",Getafe,La Liga,19,2001,8.9,7,4,2,3,2,1,14,7.1,13,14,0,14,14,21,4,0,0,2020-2021,1.5730337078651684,0.7865168539325842
1382,Juraj Kucka,SVK,"MF,FW",Parma,Serie A,33,1987,25.9,67,36,21,37,9,26,74,35.1,48,25,3,22,28,95,25,0,0,2020-2021,1.0810810810810811,2.586872586872587
1383,Kuki,ESP,MF,Valladolid,La Liga,22,1998,0.3,1,1,0,0,1,0,1,0.0,1,0,0,0,0,1,0,0,0,2020-2021,0.0,3.3333333333333335
1384,Dejan Kulusevski,SWE,"MF,FW",Juventus,Serie A,20,2000,21.4,33,19,12,10,11,14,43,32.6,29,22,0,22,9,42,2,1,0,2020-2021,0.42056074766355145,1.5420560747663552
1385,Marash Kumbulla,ALB,DF,Roma,Serie A,20,2000,15.1,16,11,8,7,1,5,17,29.4,12,12,5,7,24,40,38,1,0,2020-2021,1.589403973509934,1.0596026490066226
1386,Pierre Kunde,CMR,MF,Mainz 05,Bundesliga,25,1995,5.7,8,4,1,5,2,2,9,22.2,7,6,0,6,10,18,9,0,0,2020-2021,1.7543859649122806,1.4035087719298245
1387,Fabian Kunze,GER,MF,Arminia,Bundesliga,22,1998,14.1,38,26,19,15,4,19,42,45.2,23,19,3,16,18,56,22,1,0,2020-2021,1.2765957446808511,2.6950354609929077
1388,Jasmin Kurtić,SVN,MF,Parma,Serie A,31,1989,30.4,46,28,22,21,3,21,70,30.0,49,22,2,20,33,79,57,1,0,2020-2021,1.0855263157894737,1.5131578947368423
1389,Layvin Kurzawa,FRA,DF,Paris S-G,Ligue 1,27,1992,14.2,26,19,10,10,6,9,28,32.1,19,20,5,15,28,54,26,1,0,2020-2021,1.971830985915493,1.8309859154929577
1390,Dereck Kutesa,SUI,"MF,FW",Reims,Ligue 1,22,1997,7.6,15,7,7,3,5,5,14,35.7,9,7,1,6,7,22,3,0,0,2020-2021,0.9210526315789475,1.973684210526316
1391,Ahmed Kutucu,TUR,"FW,MF",Schalke 04,Bundesliga,20,2000,1.2,1,0,0,0,1,1,2,50.0,1,1,0,1,0,1,0,0,0,2020-2021,0.0,0.8333333333333334
1392,Enock Kwateng,FRA,DF,Bordeaux,Ligue 1,23,1997,11.5,21,12,15,4,2,14,27,51.9,13,15,3,12,26,47,27,0,0,2020-2021,2.260869565217391,1.826086956521739
1393,Giorgos Kyriakopoulos,GRE,DF,Sassuolo,Serie A,24,1996,16.2,35,18,17,12,6,8,28,28.6,20,16,5,11,15,50,42,0,0,2020-2021,0.9259259259259259,2.160493827160494
1394,Antonino La Gumina,ITA,FW,Sampdoria,Serie A,24,1996,3.8,3,2,0,1,2,0,3,0.0,3,5,1,4,3,6,5,0,0,2020-2021,0.7894736842105263,0.7894736842105263
1395,Gaëtan Laborde,FRA,"FW,MF",Montpellier,Ligue 1,26,1994,36.2,43,22,21,17,5,16,60,26.7,44,29,3,26,16,59,25,1,0,2020-2021,0.4419889502762431,1.1878453038674033
1396,Alexandre Lacazette,FRA,FW,Arsenal,Premier League,29,1991,21.4,18,10,4,11,3,4,22,18.2,18,20,1,19,12,30,13,0,0,2020-2021,0.5607476635514019,0.8411214953271029
1397,Tom Lacoux,FRA,MF,Bordeaux,Ligue 1,18,2002,5.8,22,14,10,11,1,9,21,42.9,12,12,3,9,12,34,7,0,0,2020-2021,2.0689655172413794,3.793103448275862
1398,Maxence Lacroix,FRA,DF,Wolfsburg,Bundesliga,20,2000,28.8,49,29,37,12,0,24,45,53.3,21,51,21,30,65,114,140,1,0,2020-2021,2.256944444444444,1.7013888888888888
1399,Alban Lafont,FRA,GK,Nantes,Ligue 1,21,1999,38.0,1,0,1,0,0,1,1,100.0,0,1,0,1,0,1,14,0,0,2020-2021,0.0,0.02631578947368421
1400,Víctor Laguardia,ESP,DF,Alavés,La Liga,30,1989,29.2,20,12,13,6,1,14,31,45.2,17,25,13,12,37,57,104,0,0,2020-2021,1.2671232876712328,0.684931506849315
Rk,Player,Nation,Pos,Squad,Comp,0,0,90.0,0,0,3,3,3,Tkl,0,0.0,0,0,0,0,0,0,0,0,0,2020-2021,0.0,0.0
1401,Konrad Laimer,AUT,"DF,MF",RB Leipzig,Bundesliga,23,1997,0.9,2,0,0,1,1,0,4,0.0,4,2,0,2,1,3,0,0,0,2020-2021,1.1111111111111112,2.2222222222222223
1402,Stefan Lainer,AUT,DF,Gladbach,Bundesliga,27,1992,30.8,62,37,30,22,10,27,60,45.0,33,34,5,29,35,97,85,1,0,2020-2021,1.1363636363636362,2.012987012987013
1403,Diego Lainez,MEX,"FW,MF",Betis,La Liga,20,2000,9.6,9,4,3,5,1,6,16,37.5,10,15,0,15,11,20,6,0,0,2020-2021,1.1458333333333335,0.9375
1404,Kenny Lala,MAD,DF,Strasbourg,Ligue 1,28,1991,20.4,22,13,13,8,1,11,22,50.0,11,12,6,6,23,45,33,1,0,2020-2021,1.1274509803921569,1.0784313725490198
1405,Adam Lallana,ENG,"MF,FW",Brighton,Premier League,32,1988,17.7,28,13,11,13,4,8,39,20.5,31,18,3,15,15,43,13,0,0,2020-2021,0.8474576271186441,1.5819209039548023
1406,Érik Lamela,ARG,"FW,MF",Tottenham,Premier League,28,1992,8.0,17,9,1,11,5,8,21,38.1,13,11,1,10,6,23,2,0,0,2020-2021,0.75,2.125
1407,Sam Lammers,NED,"FW,MF",Atalanta,Serie A,23,1997,3.2,2,0,0,2,0,0,6,0.0,6,0,0,0,0,2,3,0,0,2020-2021,0.0,0.625
1408,Tariq Lamptey,GHA,"DF,MF",Brighton,Premier League,19,2000,9.8,17,9,7,6,4,6,13,46.2,7,8,1,7,19,36,12,1,0,2020-2021,1.9387755102040816,1.7346938775510203
1409,Loïck Landre,FRA,DF,Nîmes,Ligue 1,28,1992,18.1,14,7,9,5,0,13,28,46.4,15,22,19,3,31,45,52,0,0,2020-2021,1.7127071823204418,0.7734806629834253
1410,Michael Langer,AUT,GK,Schalke 04,Bundesliga,35,1985,2.7,0,0,0,0,0,0,0,0.0,0,0,0,0,0,0,3,0,0,2020-2021,0.0,0.0
1411,Manuel Lanzini,ARG,"MF,FW",West Ham,Premier League,27,1993,6.3,9,2,3,4,2,3,10,30.0,7,9,0,9,7,16,5,0,0,2020-2021,1.1111111111111112,1.4285714285714286
1412,Gianluca Lapadula,PER,FW,Benevento,Serie A,30,1990,28.5,22,12,3,13,6,6,25,24.0,19,18,3,15,5,27,16,0,0,2020-2021,0.17543859649122806,0.7719298245614035
1413,Aymeric Laporte,ESP,DF,Manchester City,Premier League,26,1994,14.9,13,6,10,3,0,7,11,63.6,4,12,7,5,11,24,28,0,0,2020-2021,0.7382550335570469,0.87248322147651
1414,Julien Laporte,FRA,DF,Lorient,Ligue 1,26,1993,29.5,65,39,48,16,1,42,74,56.8,32,34,23,11,65,130,125,0,0,2020-2021,2.2033898305084745,2.2033898305084745
1415,Danilo Larangeira,BRA,DF,Bologna,Serie A,36,1984,34.8,33,24,23,10,0,8,29,27.6,21,58,36,22,51,84,127,2,0,2020-2021,1.4655172413793105,0.9482758620689656
1416,Gautier Larsonneur,FRA,GK,Brest,Ligue 1,23,1997,35.0,1,1,1,0,0,1,1,100.0,0,2,0,2,0,1,16,3,0,2020-2021,0.0,0.02857142857142857
1417,Kevin Lasagna,ITA,FW,Udinese,Serie A,27,1992,12.3,6,1,2,3,1,3,14,21.4,11,11,0,11,6,12,7,0,0,2020-2021,0.4878048780487805,0.4878048780487805
1418,Kevin Lasagna,ITA,FW,Hellas Verona,Serie A,27,1992,14.1,7,3,0,5,2,1,5,20.0,4,12,1,11,1,8,11,0,0,2020-2021,0.07092198581560284,0.49645390070921985
1419,Jamaal Lascelles,ENG,DF,Newcastle Utd,Premier League,26,1993,18.1,14,7,5,9,0,3,6,50.0,3,27,17,10,12,26,86,0,0,2020-2021,0.6629834254143646,0.7734806629834253
1420,Paul Lasne,FRA,MF,Brest,Ligue 1,31,1989,18.7,46,26,25,19,2,17,40,42.5,23,25,5,20,47,93,17,2,0,2020-2021,2.5133689839572195,2.4598930481283423
1421,Toni Lato,ESP,DF,Valencia,La Liga,22,1997,8.1,13,6,7,3,3,6,13,46.2,7,12,1,11,10,23,21,0,0,2020-2021,1.234567901234568,1.6049382716049383
1422,Danny Latza,GER,MF,Mainz 05,Bundesliga,30,1989,20.0,43,26,12,19,12,23,70,32.9,47,39,3,36,27,70,23,0,0,2020-2021,1.35,2.15
1423,Armand Lauriente,FRA,"MF,FW",Lorient,Ligue 1,21,1998,18.0,30,10,10,19,1,7,26,26.9,19,21,0,21,15,45,4,0,0,2020-2021,0.8333333333333334,1.6666666666666667
1424,Vincent Laurini,FRA,DF,Parma,Serie A,31,1989,9.7,16,11,8,6,2,7,9,77.8,2,8,4,4,17,33,22,1,0,2020-2021,1.752577319587629,1.6494845360824744
1425,Lauti,URU,MF,Celta Vigo,La Liga,19,2001,0.2,0,0,0,0,0,0,0,0.0,0,0,0,0,0,0,1,0,0,2020-2021,0.0,0.0
Rk,Player,Nation,Pos,Squad,Comp,0,0,90.0,0,0,3,3,3,Tkl,0,0.0,0,0,0,0,0,0,0,0,0,2020-2021,0.0,0.0
1426,Wesley Lautoa,NCL,"MF,DF",Dijon,Ligue 1,32,1987,17.9,36,20,20,13,3,11,37,29.7,26,17,8,9,29,65,33,1,0,2020-2021,1.6201117318435756,2.011173184357542
1427,Valentino Lazaro,AUT,"DF,FW",Gladbach,Bundesliga,24,1996,13.8,17,11,7,5,5,12,19,63.2,7,18,1,17,15,32,20,0,0,2020-2021,1.0869565217391304,1.2318840579710144
1428,Darko Lazović,SRB,"DF,MF",Hellas Verona,Serie A,29,1990,27.8,29,17,8,17,4,20,42,47.6,22,17,7,10,20,49,29,0,0,2020-2021,0.7194244604316546,1.0431654676258992
1429,Manuel Lazzari,ITA,DF,Lazio,Serie A,26,1993,29.0,24,14,15,4,5,14,39,35.9,25,22,3,19,18,42,28,0,0,2020-2021,0.6206896551724138,0.8275862068965517
1430,Jérémy Le Douaron,FRA,"FW,MF",Brest,Ligue 1,22,1998,9.1,15,10,9,4,2,7,21,33.3,14,14,1,13,8,23,11,0,0,2020-2021,0.8791208791208791,1.6483516483516485
1431,Enzo Le Fée,FRA,MF,Lorient,Ligue 1,20,2000,20.2,51,28,23,23,5,27,73,37.0,46,30,6,24,25,76,10,0,0,2020-2021,1.2376237623762376,2.5247524752475248
1432,Vincent Le Goff,FRA,DF,Lorient,Ligue 1,30,1989,25.6,42,29,16,24,2,18,49,36.7,31,27,5,22,44,86,44,0,0,2020-2021,1.71875,1.640625
1433,Maxime Le Marchand,FRA,DF,Fulham,Premier League,30,1989,1.4,2,2,2,0,0,2,2,100.0,0,0,0,0,0,2,3,0,0,2020-2021,0.0,1.4285714285714286
1434,Robin Le Normand,ESP,DF,Real Sociedad,La Liga,23,1996,30.5,34,20,25,8,1,9,19,47.4,10,35,24,11,36,70,87,1,0,2020-2021,1.180327868852459,1.1147540983606556
1435,Damien Le Tallec,FRA,"MF,DF",Montpellier,Ligue 1,30,1990,13.6,16,10,10,4,2,10,30,33.3,20,15,8,7,25,41,21,2,0,2020-2021,1.8382352941176472,1.1764705882352942
1436,James Lea Siliki,CMR,MF,Rennes,Ligue 1,24,1996,2.8,5,2,1,3,1,2,2,100.0,0,3,0,3,1,6,1,1,0,2020-2021,0.35714285714285715,1.7857142857142858
1437,Rafael Leão,POR,FW,Milan,Serie A,21,1999,21.4,13,6,4,7,2,6,15,40.0,9,17,0,17,4,17,14,1,0,2020-2021,0.1869158878504673,0.6074766355140188
1438,Jean-Louis Leca,FRA,GK,Lens,Ligue 1,34,1985,36.8,3,2,3,0,0,3,5,60.0,2,0,0,0,1,4,14,4,0,2020-2021,0.027173913043478264,0.08152173913043478
1439,Mathew Leckie,AUS,"FW,DF",Hertha BSC,Bundesliga,29,1991,5.6,12,3,5,5,2,4,11,36.4,7,8,0,8,13,25,9,0,0,2020-2021,2.3214285714285716,2.142857142857143
1440,Benjamin Lecomte,FRA,GK,Monaco,Ligue 1,29,1991,28.0,0,0,0,0,0,0,2,0.0,2,1,0,1,2,2,20,1,0,2020-2021,0.07142857142857142,0.0
1441,Jeremías Ledesma,ARG,GK,Cádiz,La Liga,27,1993,32.0,1,0,1,0,0,1,1,100.0,0,1,0,1,0,1,22,6,0,2020-2021,0.0,0.03125
1442,Pierre Lees-Melou,FRA,MF,Nice,Ligue 1,27,1993,22.9,67,39,33,31,3,25,83,30.1,58,50,14,36,29,96,31,1,0,2020-2021,1.2663755458515285,2.9257641921397384
1443,Lucas Leiva,BRA,MF,Lazio,Serie A,33,1987,23.7,68,32,38,28,2,30,86,34.9,56,21,0,21,57,125,21,0,0,2020-2021,2.4050632911392404,2.869198312236287
1444,Florian Lejeune,FRA,DF,Alavés,La Liga,29,1991,33.5,43,32,36,7,0,21,35,60.0,14,38,24,14,51,94,149,1,0,2020-2021,1.5223880597014925,1.2835820895522387
1445,Iñigo Lekue,ESP,DF,Athletic Club,La Liga,27,1993,7.2,9,7,6,3,0,3,8,37.5,5,8,1,7,4,13,24,0,0,2020-2021,0.5555555555555556,1.25
1446,Thomas Lemar,FRA,MF,Atlético Madrid,La Liga,24,1995,15.2,30,17,9,17,4,11,24,45.8,13,22,1,21,11,41,10,0,0,2020-2021,0.7236842105263158,1.973684210526316
1447,Mario Lemina,GAB,MF,Fulham,Premier League,26,1993,18.9,62,35,25,30,7,23,44,52.3,21,26,5,21,30,92,21,0,0,2020-2021,1.5873015873015874,3.2804232804232805
1448,Fabien Lemoine,FRA,MF,Lorient,Ligue 1,33,1987,21.5,74,45,39,33,2,36,89,40.4,53,25,1,24,27,101,35,0,0,2020-2021,1.255813953488372,3.441860465116279
1449,Clément Lenglet,FRA,DF,Barcelona,La Liga,25,1995,27.5,36,21,23,10,3,19,28,67.9,9,26,12,14,33,69,71,1,0,2020-2021,1.2,1.309090909090909
1450,Bernd Leno,GER,GK,Arsenal,Premier League,28,1992,34.8,1,0,1,0,0,1,1,100.0,0,1,0,1,0,1,11,2,0,2020-2021,0.0,0.02873563218390805
Rk,Player,Nation,Pos,Squad,Comp,0,0,90.0,0,0,3,3,3,Tkl,0,0.0,0,0,0,0,0,0,0,0,0,2020-2021,0.0,0.0
1451,Christopher Lenz,GER,"DF,FW",Union Berlin,Bundesliga,25,1994,25.0,74,41,39,30,5,35,71,49.3,36,34,5,29,35,109,50,0,0,2020-2021,1.4,2.96
1452,Pedro León,ESP,"MF,FW",Eibar,La Liga,33,1986,10.4,9,8,3,3,3,3,17,17.6,14,11,0,11,7,16,2,0,0,2020-2021,0.673076923076923,0.8653846153846153
1453,Sergio León,ESP,FW,Levante,La Liga,31,1989,8.3,6,2,0,4,2,2,8,25.0,6,4,0,4,3,9,2,0,0,2020-2021,0.36144578313253006,0.7228915662650601
1454,Lukas Lerager,DEN,MF,Genoa,Serie A,27,1993,12.9,24,13,14,9,1,11,30,36.7,19,13,3,10,14,38,25,1,0,2020-2021,1.0852713178294573,1.8604651162790697
1455,Mehdi Léris,ALG,"DF,MF",Sampdoria,Serie A,22,1998,4.3,11,5,6,4,1,6,16,37.5,10,12,2,10,12,23,15,0,0,2020-2021,2.7906976744186047,2.558139534883721
1456,Khanya Leshabela,RSA,MF,Leicester City,Premier League,20,1999,0.1,0,0,0,0,0,0,0,0.0,0,0,0,0,0,0,0,0,0,2020-2021,0.0,0.0
1457,Karlo Letica,CRO,GK,Sampdoria,Serie A,23,1997,1.0,0,0,0,0,0,0,0,0.0,0,0,0,0,0,0,2,0,0,2020-2021,0.0,0.0
1458,Gaetano Letizia,ITA,DF,Benevento,Serie A,30,1990,17.4,36,25,19,13,4,17,36,47.2,19,15,3,12,20,56,42,1,0,2020-2021,1.149425287356322,2.0689655172413794
1459,Robert Lewandowski,POL,FW,Bayern Munich,Bundesliga,31,1988,27.3,15,9,0,7,8,2,13,15.4,11,9,1,8,3,18,11,0,0,2020-2021,0.10989010989010989,0.5494505494505494
1460,Jamal Lewis,NIR,DF,Newcastle Utd,Premier League,22,1998,20.4,37,20,23,13,1,16,38,42.1,22,21,7,14,11,48,44,1,0,2020-2021,0.5392156862745099,1.8137254901960786
1461,Aaron Leya Iseka,BEL,FW,Metz,Ligue 1,22,1997,11.2,6,4,2,3,1,0,4,0.0,4,4,2,2,0,6,6,0,0,2020-2021,0.0,0.5357142857142857
1462,Yanis Lhery,FRA,MF,Saint-Étienne,Ligue 1,17,2003,0.3,0,0,0,0,0,0,0,0.0,0,0,0,0,0,0,0,0,0,2020-2021,0.0,0.0
1463,Dimitri Liénard,FRA,MF,Strasbourg,Ligue 1,32,1988,20.3,39,27,17,19,3,24,55,43.6,31,23,1,22,18,57,10,0,0,2020-2021,0.8866995073891625,1.921182266009852
1464,Philipp Lienhart,AUT,DF,Freiburg,Bundesliga,24,1996,33.3,21,13,12,7,2,9,20,45.0,11,30,21,9,42,63,100,0,0,2020-2021,1.2612612612612615,0.6306306306306307
1465,Matthijs de Ligt,NED,DF,Juventus,Serie A,20,1999,24.7,37,19,20,16,1,18,28,64.3,10,42,21,21,31,68,64,0,0,2020-2021,1.2550607287449393,1.4979757085020244
1466,Isaac Lihadji,FRA,"MF,FW",Lille,Ligue 1,18,2002,2.2,11,4,2,6,3,4,5,80.0,1,5,1,4,1,12,0,1,0,2020-2021,0.45454545454545453,5.0
1467,Dimitris Limnios,GRE,"MF,FW",Köln,Bundesliga,22,1998,4.2,9,6,3,5,1,5,6,83.3,1,5,0,5,2,11,1,0,0,2020-2021,0.47619047619047616,2.142857142857143
1468,Victor Lindelöf,SWE,DF,Manchester Utd,Premier League,26,1994,28.7,22,10,12,10,0,12,24,50.0,12,22,14,8,30,52,95,1,0,2020-2021,1.0452961672473868,0.7665505226480837
1469,Karol Linetty,POL,MF,Torino,Serie A,25,1995,20.4,38,28,13,19,6,16,45,35.6,29,19,5,14,15,53,7,0,0,2020-2021,0.7352941176470589,1.8627450980392157
1470,Jesse Lingard,ENG,"MF,FW",West Ham,Premier League,27,1992,15.8,12,6,4,8,0,5,14,35.7,9,7,1,6,4,16,0,0,0,2020-2021,0.2531645569620253,0.7594936708860759
1471,Pol Lirola,ESP,"DF,FW",Fiorentina,Serie A,22,1997,5.5,13,8,8,2,3,6,12,50.0,6,6,3,3,6,19,9,0,0,2020-2021,1.0909090909090908,2.3636363636363638
1472,Pol Lirola,ESP,"DF,FW",Marseille,Ligue 1,22,1997,17.3,28,16,11,15,2,16,28,57.1,12,18,5,13,25,53,26,0,0,2020-2021,1.445086705202312,1.6184971098265895
1473,Jake Livermore,ENG,MF,West Brom,Premier League,30,1989,13.8,33,18,14,16,3,14,31,45.2,17,21,6,15,16,49,26,0,0,2020-2021,1.1594202898550725,2.391304347826087
1474,Diego Llorente,ESP,DF,Leeds United,Premier League,26,1993,13.4,34,21,21,13,0,19,32,59.4,13,18,13,5,20,54,40,2,0,2020-2021,1.4925373134328357,2.5373134328358207
1475,Diego Llorente,ESP,DF,Real Sociedad,La Liga,26,1993,1.0,1,0,1,0,0,1,2,50.0,1,1,1,0,2,3,5,0,0,2020-2021,2.0,1.0
Rk,Player,Nation,Pos,Squad,Comp,0,0,90.0,0,0,3,3,3,Tkl,0,0.0,0,0,0,0,0,0,0,0,0,2020-2021,0.0,0.0
1476,Fernando Llorente,ESP,FW,Udinese,Serie A,35,1985,7.9,4,1,2,2,0,2,5,40.0,3,3,0,3,2,6,17,0,0,2020-2021,0.2531645569620253,0.5063291139240506
1477,Fernando Llorente,ESP,"FW,MF",Napoli,Serie A,35,1985,0.6,0,0,0,0,0,0,0,0.0,0,0,0,0,0,0,0,0,0,2020-2021,0.0,0.0
1478,Marcos Llorente,ESP,"MF,FW",Atlético Madrid,La Liga,25,1995,32.8,71,42,21,40,10,26,62,41.9,36,40,3,37,29,100,28,0,0,2020-2021,0.8841463414634148,2.164634146341464
1479,Hugo Lloris,FRA,GK,Tottenham,Premier League,33,1986,38.0,0,0,0,0,0,0,1,0.0,1,0,0,0,0,0,10,1,0,2020-2021,0.0,0.0
1480,Giovani Lo Celso,ARG,MF,Tottenham,Premier League,24,1996,10.5,28,22,12,11,5,10,29,34.5,19,12,1,11,7,35,5,0,0,2020-2021,0.6666666666666666,2.6666666666666665
1481,Stanislav Lobotka,SVK,MF,Napoli,Serie A,25,1994,1.7,1,1,0,1,0,0,1,0.0,1,1,1,0,0,1,1,1,0,2020-2021,0.0,0.5882352941176471
1482,Manuel Locatelli,ITA,MF,Sassuolo,Serie A,22,1998,32.0,81,47,43,28,10,29,56,51.8,27,35,15,20,51,132,65,1,0,2020-2021,1.59375,2.53125
1483,Renan Lodi,BRA,"DF,FW",Atlético Madrid,La Liga,22,1998,12.5,30,17,13,12,5,17,26,65.4,9,15,0,15,16,46,18,0,0,2020-2021,1.28,2.4
1484,Ruben Loftus-Cheek,ENG,FW,Chelsea,Premier League,24,1996,0.7,0,0,0,0,0,0,0,0.0,0,0,0,0,0,0,0,0,0,2020-2021,0.0,0.0
1485,Ruben Loftus-Cheek,ENG,"MF,FW",Fulham,Premier League,24,1996,21.2,25,14,7,15,3,7,23,30.4,16,20,2,18,7,32,18,0,0,2020-2021,0.33018867924528306,1.179245283018868
1486,Niklas Lomb,GER,GK,Leverkusen,Bundesliga,27,1993,1.5,0,0,0,0,0,0,0,0.0,0,0,0,0,0,0,0,2,0,2020-2021,0.0,0.0
1487,Kevin Long,IRL,DF,Burnley,Premier League,29,1990,7.1,11,6,9,2,0,7,9,77.8,2,11,7,4,6,17,24,0,0,2020-2021,0.8450704225352114,1.5492957746478875
1488,Shane Long,IRL,FW,Southampton,Premier League,33,1987,2.3,2,1,0,0,2,2,3,66.7,1,0,0,0,3,5,1,0,0,2020-2021,1.3043478260869565,0.8695652173913044
1489,Matthew Longstaff,ENG,MF,Newcastle Utd,Premier League,20,2000,4.2,3,2,2,1,0,2,8,25.0,6,7,0,7,7,10,2,0,0,2020-2021,1.6666666666666665,0.7142857142857143
1490,Sean Longstaff,ENG,MF,Newcastle Utd,Premier League,22,1997,15.7,31,14,13,15,3,18,42,42.9,24,26,5,21,19,50,14,2,0,2020-2021,1.2101910828025477,1.9745222929936306
1491,Ademola Lookman,NGA,"FW,MF",Fulham,Premier League,22,1997,30.5,35,11,18,9,8,13,44,29.5,31,31,1,30,20,55,9,0,0,2020-2021,0.6557377049180327,1.1475409836065573
1492,Anthony Lopes,POR,GK,Lyon,Ligue 1,29,1990,38.0,1,1,1,0,0,1,2,50.0,1,1,0,1,1,2,20,1,0,2020-2021,0.02631578947368421,0.02631578947368421
1493,Rony Lopes,POR,"FW,MF",Nice,Ligue 1,24,1995,19.8,20,14,4,13,3,6,27,22.2,21,14,3,11,8,28,6,0,0,2020-2021,0.40404040404040403,1.0101010101010102
1494,Adrián López,ESP,"FW,MF",Osasuna,La Liga,32,1988,5.3,3,3,0,1,2,1,5,20.0,4,3,0,3,0,3,3,0,0,2020-2021,0.0,0.5660377358490566
1495,Javi López,ESP,"DF,MF",Alavés,La Liga,18,2002,2.8,5,5,3,2,0,2,3,66.7,1,2,0,2,3,8,3,1,0,2020-2021,1.0714285714285714,1.7857142857142858
1496,Maxime Lopez,FRA,MF,Sassuolo,Serie A,22,1997,20.7,24,13,15,6,3,14,41,34.1,27,9,0,9,16,40,10,1,0,2020-2021,0.7729468599033816,1.1594202898550725
1497,Maxime Lopez,FRA,"FW,MF",Marseille,Ligue 1,22,1997,1.5,1,1,1,0,0,0,2,0.0,2,0,0,0,2,3,2,0,0,2020-2021,1.3333333333333333,0.6666666666666666
1498,Pedro López Muñoz,ESP,DF,Huesca,La Liga,36,1983,11.9,23,15,10,8,5,15,22,68.2,7,10,4,6,16,39,23,1,0,2020-2021,1.3445378151260503,1.9327731092436975
1499,Pau López,ESP,GK,Roma,Serie A,25,1994,20.2,2,0,2,0,0,2,2,100.0,0,1,0,1,0,2,7,4,0,2020-2021,0.0,0.09900990099009901
1500,Roberto López,ESP,"MF,FW",Real Sociedad,La Liga,20,2000,5.6,5,1,1,2,2,2,5,40.0,3,2,0,2,4,9,6,0,0,2020-2021,0.7142857142857143,0.8928571428571429
Rk,Player,Nation,Pos,Squad,Comp,0,0,90.0,0,0,3,3,3,Tkl,0,0.0,0,0,0,0,0,0,0,0,0,2020-2021,0.0,0.0
1501,Unai López,ESP,MF,Athletic Club,La Liga,24,1995,15.8,27,17,13,13,1,10,29,34.5,19,20,5,15,18,45,9,1,0,2020-2021,1.1392405063291138,1.7088607594936709
1502,Dion Lopy,SEN,MF,Reims,Ligue 1,18,2002,2.8,1,1,0,1,0,0,0,0.0,0,0,0,0,2,3,1,0,0,2020-2021,0.7142857142857143,0.35714285714285715
1503,Jordan Lotomba,SUI,"DF,MF",Nice,Ligue 1,21,1998,23.6,35,25,19,11,5,20,34,58.8,14,19,7,12,33,68,52,1,0,2020-2021,1.3983050847457625,1.483050847457627
1504,Adrien Louveau,FRA,MF,Lens,Ligue 1,20,2000,0.1,0,0,0,0,0,0,0,0.0,0,0,0,0,0,0,1,0,0,2020-2021,0.0,0.0
1505,Imran Louza,MAR,MF,Nantes,Ligue 1,21,1999,26.4,55,28,25,26,4,21,69,30.4,48,20,4,16,33,88,15,2,0,2020-2021,1.25,2.0833333333333335
1506,Matteo Lovato,ITA,DF,Hellas Verona,Serie A,20,2000,15.4,21,12,14,5,2,10,21,47.6,11,20,10,10,37,58,48,1,0,2020-2021,2.4025974025974026,1.3636363636363635
1507,Max Lowe,ENG,DF,Sheffield Utd,Premier League,23,1997,6.1,26,11,18,6,2,9,21,42.9,12,12,4,8,5,31,11,0,0,2020-2021,0.819672131147541,4.262295081967213
1508,Eduard Löwen,GER,"MF,DF",Hertha BSC,Bundesliga,23,1997,0.9,5,1,3,1,1,2,5,40.0,3,1,0,1,1,6,1,0,0,2020-2021,1.1111111111111112,5.555555555555555
1509,Matthew Lowton,ENG,DF,Burnley,Premier League,31,1989,34.0,54,32,31,22,1,32,73,43.8,41,36,13,23,56,110,91,1,0,2020-2021,1.6470588235294117,1.588235294117647
1510,Anthony Lozano,HON,FW,Cádiz,La Liga,27,1993,16.9,12,4,1,5,6,2,13,15.4,11,3,1,2,3,15,8,0,0,2020-2021,0.1775147928994083,0.7100591715976332
1511,Hirving Lozano,MEX,FW,Napoli,Serie A,25,1995,21.8,29,18,10,13,6,10,36,27.8,26,37,1,36,18,47,14,0,0,2020-2021,0.8256880733944953,1.3302752293577982
1512,Jan Luca Schuler,GER,FW,Schalke 04,Bundesliga,21,1999,0.4,2,2,1,1,0,0,1,0.0,1,1,0,1,0,2,0,0,0,2020-2021,0.0,5.0
1513,Jean Lucas,BRA,MF,Lyon,Ligue 1,22,1998,1.9,3,2,2,1,0,1,4,25.0,3,3,1,2,2,5,1,0,0,2020-2021,1.0526315789473684,1.5789473684210527
1514,Jean Lucas,BRA,"MF,FW",Brest,Ligue 1,22,1998,11.2,19,13,10,9,0,8,29,27.6,21,7,0,7,8,27,10,1,0,2020-2021,0.7142857142857143,1.6964285714285716
1515,Anderson Lucoqui,ANG,DF,Arminia,Bundesliga,23,1997,17.8,40,25,23,17,0,20,40,50.0,20,30,7,23,27,67,53,0,0,2020-2021,1.5168539325842696,2.2471910112359548
1516,Jeison Lucumí,COL,MF,Elche,La Liga,25,1995,0.5,1,1,0,1,0,0,0,0.0,0,1,0,1,0,1,0,0,0,2020-2021,0.0,2.0
1517,Kilian Ludewig,GER,"DF,FW",Schalke 04,Bundesliga,20,2000,5.8,16,6,10,5,1,8,25,32.0,17,7,0,7,3,19,14,0,0,2020-2021,0.5172413793103449,2.7586206896551726
1518,Florentino Luís,POR,MF,Monaco,Ligue 1,20,1999,2.7,7,2,4,2,1,6,10,60.0,4,1,0,1,6,13,2,1,0,2020-2021,2.222222222222222,2.5925925925925926
1519,José Luis Gayà,ESP,DF,Valencia,La Liga,25,1995,31.6,59,33,40,13,6,33,68,48.5,35,22,3,19,38,97,62,1,0,2020-2021,1.2025316455696202,1.8670886075949367
1520,José Luis Morales,ESP,"MF,FW",Levante,La Liga,33,1987,27.1,18,10,7,9,2,8,36,22.2,28,17,0,17,11,29,11,0,0,2020-2021,0.4059040590405904,0.6642066420664207
1521,José Luis Palomino,ARG,DF,Atalanta,Serie A,30,1990,27.0,67,33,41,19,7,24,48,50.0,24,30,16,14,79,146,60,2,0,2020-2021,2.925925925925926,2.4814814814814814
1522,Luisinho,POR,DF,Huesca,La Liga,35,1985,2.0,3,3,2,1,0,1,3,33.3,2,3,0,3,4,7,7,0,0,2020-2021,2.0,1.5
1523,Luismi,ESP,"MF,DF",Elche,La Liga,28,1992,1.9,4,2,1,3,0,1,2,50.0,1,2,0,2,4,8,0,0,0,2020-2021,2.1052631578947367,2.1052631578947367
1524,David Luiz,BRA,DF,Arsenal,Premier League,33,1987,15.5,12,9,5,7,0,4,4,100.0,0,16,9,7,16,28,50,2,0,2020-2021,1.032258064516129,0.7741935483870968
1525,Douglas Luiz,BRA,MF,Aston Villa,Premier League,22,1998,30.9,49,18,22,26,1,20,58,34.5,38,52,17,35,43,92,44,2,0,2020-2021,1.3915857605177995,1.5857605177993528
Rk,Player,Nation,Pos,Squad,Comp,0,0,90.0,0,0,3,3,3,Tkl,0,0.0,0,0,0,0,0,0,0,0,0,2020-2021,0.0,0.0
1526,Romelu Lukaku,BEL,FW,Inter,Serie A,27,1993,32.0,11,1,1,6,4,6,14,42.9,8,11,1,10,3,14,34,0,0,2020-2021,0.09375,0.34375
1527,Dodi Lukebakio,BEL,"FW,MF",Hertha BSC,Bundesliga,22,1997,20.6,21,14,13,5,3,9,20,45.0,11,14,1,13,12,33,8,0,0,2020-2021,0.5825242718446602,1.0194174757281553
1528,Saša Lukić,SRB,MF,Torino,Serie A,23,1996,23.4,32,13,11,18,3,15,50,30.0,35,23,5,18,17,49,17,0,0,2020-2021,0.7264957264957266,1.3675213675213675
1529,Senad Lulić,BIH,DF,Lazio,Serie A,34,1986,8.0,14,7,6,5,3,7,15,46.7,8,10,1,9,4,18,13,0,0,2020-2021,0.5,1.75
1530,John Lundstram,ENG,MF,Sheffield Utd,Premier League,26,1994,22.6,25,16,12,11,2,13,47,27.7,34,26,8,18,14,39,29,1,0,2020-2021,0.6194690265486725,1.1061946902654867
1531,Sebastiano Luperto,ITA,DF,Crotone,Serie A,23,1996,20.9,38,20,28,8,2,16,27,59.3,11,17,7,10,27,65,74,1,0,2020-2021,1.291866028708134,1.8181818181818183
1532,Andreas Luthe,GER,GK,Union Berlin,Bundesliga,33,1987,30.8,1,1,1,0,0,1,3,33.3,2,1,0,1,0,1,8,3,0,2020-2021,0.0,0.032467532467532464
1533,Lyanco,BRA,DF,Torino,Serie A,23,1997,21.8,21,14,13,6,2,8,14,57.1,6,36,26,10,46,67,76,0,0,2020-2021,2.110091743119266,0.963302752293578
1534,Charalambos Lykogiannis,GRE,DF,Cagliari,Serie A,26,1993,26.9,34,21,22,9,3,22,38,57.9,16,34,13,21,32,66,94,0,0,2020-2021,1.1895910780669146,1.2639405204460967
1535,Yann M'Vila,FRA,MF,Saint-Étienne,Ligue 1,30,1990,0.2,0,0,0,0,0,0,2,0.0,2,0,0,0,1,1,0,0,0,2020-2021,5.0,0.0
1536,Alexis Mac Allister,ARG,"MF,FW",Brighton,Premier League,21,1998,12.4,26,12,6,16,4,11,38,28.9,27,25,4,21,9,35,4,0,0,2020-2021,0.7258064516129032,2.096774193548387
1537,Darwin Machís,VEN,"FW,MF",Granada,La Liga,27,1993,22.5,30,17,12,10,8,6,19,31.6,13,21,2,19,22,52,13,0,0,2020-2021,0.9777777777777777,1.3333333333333333
1538,Tim Maciejewski,GER,FW,Union Berlin,Bundesliga,19,2001,0.1,0,0,0,0,0,0,0,0.0,0,0,0,0,0,0,0,0,0,2020-2021,0.0,0.0
1539,Luca Mack,GER,MF,Stuttgart,Bundesliga,20,2000,0.1,0,0,0,0,0,0,0,0.0,0,0,0,0,0,0,1,0,0,2020-2021,0.0,0.0
1540,Yvann Macon,FRA,DF,Saint-Étienne,Ligue 1,21,1998,6.0,30,20,20,8,2,7,19,36.8,12,6,2,4,9,39,13,0,0,2020-2021,1.5,5.0
1541,James Maddison,ENG,MF,Leicester City,Premier League,23,1996,23.3,32,16,5,16,11,14,41,34.1,27,14,1,13,9,41,5,0,0,2020-2021,0.38626609442060084,1.3733905579399142
1542,Mikail Maden,NOR,FW,Schalke 04,Bundesliga,18,2002,0.1,0,0,0,0,0,0,0,0.0,0,0,0,0,0,0,0,0,0,2020-2021,0.0,0.0
1543,Pablo Maffeo,ESP,DF,Huesca,La Liga,23,1997,21.8,26,17,21,4,1,12,26,46.2,14,18,6,12,35,61,27,0,0,2020-2021,1.6055045871559632,1.1926605504587156
1544,Gabriel Magalhães,BRA,DF,Arsenal,Premier League,22,1997,22.2,25,15,19,5,1,13,19,68.4,6,27,19,8,26,51,74,2,0,2020-2021,1.1711711711711712,1.1261261261261262
1545,Lisandro Magallán,ARG,DF,Crotone,Serie A,26,1993,24.2,54,31,28,24,2,17,42,40.5,25,29,15,14,44,98,78,1,0,2020-2021,1.8181818181818183,2.231404958677686
1546,Christian Maggio,ITA,DF,Benevento,Serie A,38,1982,3.3,9,4,2,7,0,3,9,33.3,6,4,1,3,2,11,6,0,0,2020-2021,0.6060606060606061,2.7272727272727275
1547,Giulio Maggiore,ITA,MF,Spezia,Serie A,22,1998,24.6,61,36,26,28,7,21,53,39.6,32,33,6,27,19,80,25,1,0,2020-2021,0.7723577235772358,2.4796747967479673
1548,Francesco Magnanelli,ITA,MF,Sassuolo,Serie A,35,1984,4.9,7,5,2,5,0,3,10,30.0,7,6,2,4,13,20,10,0,0,2020-2021,2.6530612244897958,1.4285714285714284
1549,Giangiacomo Magnani,ITA,DF,Hellas Verona,Serie A,24,1995,16.8,26,15,14,9,3,9,16,56.3,7,25,16,9,44,70,105,1,0,2020-2021,2.619047619047619,1.5476190476190474
1550,Hugo Magnetti,FRA,MF,Brest,Ligue 1,22,1998,6.7,24,12,10,13,1,20,40,50.0,20,6,1,5,14,38,8,0,0,2020-2021,2.08955223880597,3.582089552238806
Rk,Player,Nation,Pos,Squad,Comp,0,0,90.0,0,0,3,3,3,Tkl,0,0.0,0,0,0,0,0,0,0,0,0,2020-2021,0.0,0.0
1551,Harry Maguire,ENG,DF,Manchester Utd,Premier League,27,1993,33.9,29,17,19,10,0,18,29,62.1,11,28,23,5,60,89,122,4,0,2020-2021,1.7699115044247788,0.8554572271386431
1552,Abdallahi Mahmoud,MTN,MF,Alavés,La Liga,20,2000,0.7,2,2,1,1,0,0,1,0.0,1,0,0,0,1,3,0,0,0,2020-2021,1.4285714285714286,2.857142857142857
1553,Hicham Mahou,FRA,FW,Nice,Ligue 1,21,1999,0.4,1,1,1,0,0,1,2,50.0,1,2,0,2,1,2,0,0,0,2020-2021,2.5,2.5
1554,Riyad Mahrez,ALG,FW,Manchester City,Premier League,29,1991,21.7,20,5,2,10,8,6,30,20.0,24,19,0,19,8,28,4,0,0,2020-2021,0.3686635944700461,0.9216589861751152
1555,Arne Maier,GER,MF,Arminia,Bundesliga,21,1999,11.5,13,9,5,7,1,4,11,36.4,7,10,3,7,8,21,11,1,0,2020-2021,0.6956521739130435,1.1304347826086956
1556,Arne Maier,GER,MF,Hertha BSC,Bundesliga,21,1999,0.3,1,1,0,1,0,0,1,0.0,1,0,0,0,0,1,0,0,0,2020-2021,0.0,3.3333333333333335
1557,Habib Maïga,CIV,MF,Metz,Ligue 1,24,1996,29.9,81,52,36,40,5,42,85,49.4,43,37,6,31,49,130,36,0,0,2020-2021,1.6387959866220736,2.709030100334448
1558,Mike Maignan,FRA,GK,Lille,Ligue 1,25,1995,38.0,0,0,0,0,0,0,0,0.0,0,0,0,0,0,0,7,2,0,2020-2021,0.0,0.0
1559,Ainsley Maitland-Niles,ENG,"MF,DF",Arsenal,Premier League,22,1997,5.4,11,7,6,5,0,8,12,66.7,4,12,2,10,14,25,7,1,0,2020-2021,2.5925925925925926,2.0370370370370368
1560,Ainsley Maitland-Niles,ENG,MF,West Brom,Premier League,22,1997,13.7,22,10,7,8,7,9,28,32.1,19,12,1,11,17,39,24,0,0,2020-2021,1.2408759124087592,1.6058394160583942
1561,Josh Maja,NGA,FW,Fulham,Premier League,21,1998,9.0,7,4,0,3,4,4,10,40.0,6,3,1,2,4,11,1,0,0,2020-2021,0.4444444444444444,0.7777777777777778
1562,Josh Maja,NGA,FW,Bordeaux,Ligue 1,21,1998,8.9,8,2,3,3,2,3,14,21.4,11,3,0,3,6,14,9,0,0,2020-2021,0.6741573033707865,0.898876404494382
1563,Radosław Majecki,POL,GK,Monaco,Ligue 1,20,1999,1.0,0,0,0,0,0,0,0,0.0,0,0,0,0,0,0,1,0,0,2020-2021,0.0,0.0
1564,Abdul Majeed Waris,GHA,"FW,MF",Strasbourg,Ligue 1,28,1991,6.1,1,1,1,0,0,1,6,16.7,5,0,0,0,2,3,2,0,0,2020-2021,0.3278688524590164,0.1639344262295082
1565,Marco Majouga,CTA,"FW,MF",Nîmes,Ligue 1,19,2001,1.4,1,1,1,0,0,1,3,33.3,2,0,0,0,0,1,0,0,0,2020-2021,0.0,0.7142857142857143
1566,Jean-Victor Makengo,FRA,MF,Udinese,Serie A,22,1998,5.8,8,7,5,3,0,3,13,23.1,10,7,1,6,5,13,7,0,0,2020-2021,0.8620689655172414,1.3793103448275863
1567,Nemanja Maksimović,SRB,MF,Getafe,La Liga,25,1995,30.3,50,28,22,24,4,19,46,41.3,27,40,9,31,57,107,46,1,0,2020-2021,1.881188118811881,1.6501650165016502
1568,Nikola Maksimović,SRB,DF,Napoli,Serie A,28,1991,13.4,18,9,11,6,1,9,18,50.0,9,15,6,9,21,39,49,3,0,2020-2021,1.5671641791044775,1.3432835820895521
1569,Filip Malbašić,SRB,"FW,MF",Cádiz,La Liga,27,1992,9.6,12,7,4,5,3,6,18,33.3,12,10,0,10,4,16,2,0,0,2020-2021,0.4166666666666667,1.25
1570,Kévin Malcuit,MAR,DF,Fiorentina,Serie A,29,1991,2.3,5,3,2,2,1,0,1,0.0,1,5,0,5,3,8,6,0,0,2020-2021,1.3043478260869565,2.173913043478261
1571,Kévin Malcuit,MAR,"FW,MF",Napoli,Serie A,29,1991,0.4,2,1,2,0,0,0,1,0.0,1,0,0,0,2,4,2,0,0,2020-2021,5.0,5.0
1572,Daniel Maldini,ITA,"FW,DF",Milan,Serie A,18,2001,0.3,1,0,0,1,0,0,2,0.0,2,0,0,0,0,1,0,0,0,2020-2021,0.0,3.3333333333333335
1573,Ruslan Malinovskyi,UKR,"MF,FW",Atalanta,Serie A,27,1993,20.8,19,8,2,13,4,8,23,34.8,15,16,1,15,2,21,4,0,0,2020-2021,0.09615384615384615,0.9134615384615384
1574,Yunus Mallı,TUR,MF,Wolfsburg,Bundesliga,28,1992,0.6,1,0,0,1,0,1,1,100.0,0,0,0,0,0,1,0,0,0,2020-2021,0.0,1.6666666666666667
1575,Hugo Mallo,ESP,DF,Celta Vigo,La Liga,29,1991,28.9,58,40,34,23,1,24,52,46.2,28,42,11,31,37,95,77,0,0,2020-2021,1.2802768166089966,2.0069204152249136
Rk,Player,Nation,Pos,Squad,Comp,0,0,90.0,0,0,3,3,3,Tkl,0,0.0,0,0,0,0,0,0,0,0,0,2020-2021,0.0,0.0
1576,Mickael Malsa,MTQ,MF,Levante,La Liga,24,1995,26.0,55,26,28,24,3,23,51,45.1,28,38,9,29,43,98,36,2,0,2020-2021,1.6538461538461537,2.1153846153846154
1577,Dennis Man,ROU,"FW,MF",Parma,Serie A,21,1998,7.8,12,6,6,4,2,6,21,28.6,15,5,0,5,2,14,6,0,0,2020-2021,0.25641025641025644,1.5384615384615385
1578,Hianga Mananga Mbock,FRA,"MF,FW",Brest,Ligue 1,20,1999,5.1,4,3,2,2,0,2,9,22.2,7,2,0,2,3,7,6,0,0,2020-2021,0.5882352941176471,0.7843137254901962
1579,Vincent Manceau,FRA,DF,Angers,Ligue 1,31,1989,25.7,42,27,23,17,2,30,63,47.6,33,23,2,21,35,77,61,0,0,2020-2021,1.3618677042801557,1.6342412451361867
1580,Gianluca Mancini,ITA,DF,Roma,Serie A,24,1996,31.7,50,29,29,19,2,18,31,58.1,13,38,18,20,72,122,77,3,0,2020-2021,2.271293375394322,1.5772870662460567
1581,Steve Mandanda,FRA,GK,Marseille,Ligue 1,35,1985,37.0,0,0,0,0,0,0,1,0.0,1,0,0,0,2,2,8,6,0,2020-2021,0.05405405405405406,0.0
1582,Reinildo Mandava,MOZ,DF,Lille,Ligue 1,26,1994,24.2,79,43,39,32,8,35,58,60.3,23,26,3,23,45,124,53,0,0,2020-2021,1.859504132231405,3.2644628099173554
1583,Aïssa Mandi,ALG,DF,Betis,La Liga,28,1991,26.6,30,17,20,10,0,10,16,62.5,6,21,13,8,39,69,90,0,0,2020-2021,1.4661654135338344,1.1278195488721805
1584,Rolando Mandragora,ITA,MF,Udinese,Serie A,23,1997,4.4,8,5,3,4,1,3,10,30.0,7,10,3,7,6,14,5,0,0,2020-2021,1.3636363636363635,1.8181818181818181
1585,Rolando Mandragora,ITA,MF,Torino,Serie A,23,1997,16.9,19,4,4,9,6,7,30,23.3,23,19,6,13,20,39,19,0,0,2020-2021,1.183431952662722,1.124260355029586
1586,Mario Mandžukić,CRO,FW,Milan,Serie A,34,1986,2.4,7,6,2,4,1,2,3,66.7,1,0,0,0,2,9,3,0,0,2020-2021,0.8333333333333334,2.916666666666667
1587,Sadio Mané,SEN,FW,Liverpool,Premier League,28,1992,31.2,48,30,6,22,20,12,33,36.4,21,30,0,30,15,63,11,0,0,2020-2021,0.4807692307692308,1.5384615384615385
1588,Niccolò Manfredini,ITA,GK,Benevento,Serie A,32,1988,1.0,0,0,0,0,0,0,0,0.0,0,0,0,0,0,0,2,1,0,2020-2021,0.0,0.0
1589,Eliaquim Mangala,FRA,DF,Valencia,La Liga,29,1991,3.6,0,0,0,0,0,0,1,0.0,1,8,6,2,6,6,12,0,0,2020-2021,1.6666666666666665,0.0
1590,Orel Mangala,BEL,MF,Stuttgart,Bundesliga,22,1998,23.4,27,15,13,11,3,17,28,60.7,11,27,10,17,26,53,30,0,0,2020-2021,1.1111111111111112,1.153846153846154
1591,Thomas Mangani,FRA,MF,Angers,Ligue 1,33,1987,29.9,54,37,25,26,3,30,90,33.3,60,31,8,23,38,92,39,0,0,2020-2021,1.2709030100334449,1.8060200668896322
1592,Vito Mannone,ITA,GK,Monaco,Ligue 1,32,1988,9.0,0,0,0,0,0,0,0,0.0,0,0,0,0,0,0,3,1,0,2020-2021,0.0,0.0
1593,Kostas Manolas,GRE,DF,Napoli,Serie A,29,1991,25.5,31,18,24,7,0,17,24,70.8,7,22,13,9,23,54,82,2,0,2020-2021,0.9019607843137255,1.2156862745098038
1594,Javier Manquillo,ESP,DF,Newcastle Utd,Premier League,26,1994,9.2,24,14,8,14,2,11,17,64.7,6,8,1,7,9,33,15,1,0,2020-2021,0.9782608695652175,2.608695652173913
1595,Juan Manuel Ramos,URU,DF,Spezia,Serie A,23,1996,3.3,5,0,3,0,2,4,7,57.1,3,1,0,1,2,7,6,0,0,2020-2021,0.6060606060606061,1.5151515151515151
1596,Myziane Maolida,COM,"FW,MF",Nice,Ligue 1,21,1999,12.0,13,8,4,4,5,4,11,36.4,7,6,1,5,6,19,4,0,0,2020-2021,0.5,1.0833333333333333
1597,Faitout Maouassa,FRA,DF,Rennes,Ligue 1,22,1998,13.0,20,11,10,8,2,11,19,57.9,8,9,1,8,17,37,36,0,0,2020-2021,1.3076923076923077,1.5384615384615385
1598,Sekou Mara,FRA,"FW,MF",Bordeaux,Ligue 1,18,2002,2.5,5,3,1,3,1,2,10,20.0,8,0,0,0,1,6,1,0,0,2020-2021,0.4,2.0
1599,Fernando Marçal,BRA,"DF,MF",Wolves,Premier League,31,1989,6.9,13,5,6,7,0,6,11,54.5,5,11,2,9,12,25,25,0,0,2020-2021,1.7391304347826086,1.8840579710144927
1600,Fernando Marçal,BRA,DF,Lyon,Ligue 1,31,1989,0.9,1,0,0,1,0,0,0,0.0,0,0,0,0,2,3,0,0,0,2020-2021,2.2222222222222223,1.1111111111111112
Rk,Player,Nation,Pos,Squad,Comp,0,0,90.0,0,0,3,3,3,Tkl,0,0.0,0,0,0,0,0,0,0,0,0,2020-2021,0.0,0.0
1601,Marcelo,BRA,"DF,MF",Real Madrid,La Liga,32,1988,11.7,25,21,11,6,8,11,24,45.8,13,13,1,12,10,35,15,0,0,2020-2021,0.8547008547008548,2.1367521367521367
1602,Marcelo,BRA,DF,Lyon,Ligue 1,33,1987,32.3,44,29,30,12,2,26,37,70.3,11,35,25,10,49,93,122,2,0,2020-2021,1.51702786377709,1.3622291021671828
1603,Solly March,ENG,"DF,MF",Brighton,Premier League,26,1994,18.6,49,23,24,15,10,18,34,52.9,16,30,5,25,22,71,30,0,0,2020-2021,1.182795698924731,2.6344086021505375
1604,Federico Marchetti,ITA,GK,Genoa,Serie A,37,1983,3.7,1,0,1,0,0,1,1,100.0,0,0,0,0,0,1,2,1,0,2020-2021,0.0,0.27027027027027023
1605,Riccardo Marchizza,ITA,DF,Spezia,Serie A,22,1998,17.3,20,11,12,5,3,12,21,57.1,9,13,4,9,11,31,27,0,0,2020-2021,0.6358381502890174,1.1560693641618496
1606,Gian Marco Ferrari,ITA,DF,Sassuolo,Serie A,28,1992,33.5,32,20,15,14,3,10,23,43.5,13,46,37,9,50,82,100,1,0,2020-2021,1.492537313432836,0.9552238805970149
1607,Iván Marcone,ARG,MF,Elche,La Liga,30,1990,29.4,64,41,42,17,5,35,84,41.7,49,27,8,19,36,100,33,3,0,2020-2021,1.2244897959183674,2.17687074829932
1608,Óscar de Marcos,ESP,"DF,MF",Athletic Club,La Liga,31,1989,16.9,28,17,12,10,6,10,25,40.0,15,12,1,11,12,40,38,0,0,2020-2021,0.7100591715976332,1.656804733727811
1609,Dario Maresic,AUT,DF,Reims,Ligue 1,20,1999,5.7,12,7,8,4,0,8,14,57.1,6,7,2,5,10,22,17,1,0,2020-2021,1.7543859649122806,2.1052631578947367
1610,José Mari,ESP,MF,Cádiz,La Liga,32,1987,16.1,32,17,13,18,1,14,31,45.2,17,16,7,9,27,59,33,1,0,2020-2021,1.6770186335403725,1.9875776397515525
1611,Pablo Marí,ESP,DF,Arsenal,Premier League,26,1993,10.0,15,9,12,3,0,5,10,50.0,5,8,7,1,9,24,30,2,0,2020-2021,0.9,1.5
1612,José María Giménez,URU,DF,Atlético Madrid,La Liga,25,1995,19.6,20,7,14,5,1,12,17,70.6,5,17,11,6,21,41,65,0,0,2020-2021,1.0714285714285714,1.0204081632653061
1613,Mariano,DOM,FW,Real Madrid,La Liga,26,1993,5.7,4,2,2,1,1,0,9,0.0,9,3,1,2,0,4,3,0,0,2020-2021,0.0,0.7017543859649122
1614,Jordan Marié,FRA,MF,Dijon,Ligue 1,28,1991,15.9,34,17,9,23,2,23,56,41.1,33,14,5,9,23,57,12,2,0,2020-2021,1.4465408805031446,2.138364779874214
1615,Adrián Marín,ESP,"DF,MF",Alavés,La Liga,23,1997,1.0,1,1,0,1,0,0,2,0.0,2,1,0,1,2,3,2,0,0,2020-2021,2.0,1.0
1616,Adrián Marín,ESP,"DF,MF",Granada,La Liga,23,1997,3.0,5,2,1,3,1,2,3,66.7,1,5,2,3,4,9,9,0,0,2020-2021,1.3333333333333333,1.6666666666666667
1617,Răzvan Marin,ROU,MF,Cagliari,Serie A,24,1996,32.9,54,33,26,22,6,27,53,50.9,26,29,10,19,29,83,15,0,0,2020-2021,0.8814589665653496,1.6413373860182372
1618,Guillermo Maripán,CHI,DF,Monaco,Ligue 1,26,1994,23.2,26,11,17,9,0,15,27,55.6,12,18,11,7,27,53,66,1,0,2020-2021,1.1637931034482758,1.120689655172414
1619,Marlon,BRA,DF,Sassuolo,Serie A,24,1995,19.4,19,13,13,6,0,13,18,72.2,5,23,17,6,27,46,44,2,0,2020-2021,1.3917525773195878,0.9793814432989691
1620,Omar Marmoush,EGY,FW,Wolfsburg,Bundesliga,21,1999,0.0,0,0,0,0,0,0,0,0.0,0,0,0,0,0,0,0,0,0,2020-2021,,
1621,Marquinhos,BRA,DF,Paris S-G,Ligue 1,26,1994,23.6,27,21,14,10,3,15,26,57.7,11,21,9,12,27,54,75,2,0,2020-2021,1.1440677966101693,1.1440677966101693
1622,Luca Marrone,ITA,DF,Crotone,Serie A,30,1990,17.6,25,18,16,9,0,13,21,61.9,8,22,11,11,26,51,56,1,0,2020-2021,1.477272727272727,1.4204545454545454
1623,Roger Martí,ESP,FW,Levante,La Liga,29,1991,24.4,11,7,5,4,2,6,23,26.1,17,10,3,7,4,15,6,0,0,2020-2021,0.1639344262295082,0.45081967213114754
1624,Anthony Martial,FRA,FW,Manchester Utd,Premier League,24,1995,16.4,2,1,1,1,0,0,10,0.0,10,17,3,14,1,3,8,0,0,2020-2021,0.06097560975609757,0.12195121951219513
1625,Aarón Martín,ESP,DF,Celta Vigo,La Liga,23,1997,17.1,34,20,15,16,3,10,33,30.3,23,15,4,11,13,47,37,0,0,2020-2021,0.7602339181286549,1.9883040935672514
Rk,Player,Nation,Pos,Squad,Comp,0,0,90.0,0,0,3,3,3,Tkl,0,0.0,0,0,0,0,0,0,0,0,0,2020-2021,0.0,0.0
1626,Aarón Martín,ESP,"DF,FW",Mainz 05,Bundesliga,23,1997,2.9,3,2,2,1,0,2,4,50.0,2,1,0,1,2,5,2,0,0,2020-2021,0.6896551724137931,1.0344827586206897
1627,Álex Martín,ESP,DF,Cádiz,La Liga,22,1998,1.1,2,0,1,1,0,2,4,50.0,2,1,1,0,0,2,6,0,0,2020-2021,0.0,1.8181818181818181
1628,Jonas Martin,FRA,MF,Rennes,Ligue 1,30,1990,5.4,11,9,5,4,2,5,14,35.7,9,11,2,9,13,24,2,1,0,2020-2021,2.4074074074074074,2.0370370370370368
1629,Gabriel Martinelli,BRA,FW,Arsenal,Premier League,19,2001,6.5,7,1,2,3,2,4,10,40.0,6,6,0,6,8,15,4,0,0,2020-2021,1.2307692307692308,1.0769230769230769
1630,Emiliano Martínez,ARG,GK,Aston Villa,Premier League,27,1992,38.0,3,3,3,0,0,3,4,75.0,1,0,0,0,2,5,10,2,0,2020-2021,0.05263157894736842,0.07894736842105263
1631,Iñigo Martínez,ESP,DF,Athletic Club,La Liga,29,1991,28.0,22,15,16,6,0,9,27,33.3,18,17,7,10,28,50,96,0,0,2020-2021,1.0,0.7857142857142857
1632,Javi Martínez,ESP,"MF,FW",Osasuna,La Liga,20,1999,5.1,9,4,1,6,2,5,12,41.7,7,9,0,9,5,14,4,0,0,2020-2021,0.9803921568627452,1.7647058823529413
1633,Javi Martínez,ESP,"DF,MF",Bayern Munich,Bundesliga,31,1988,5.2,10,5,4,4,2,7,9,77.8,2,8,4,4,13,23,19,0,0,2020-2021,2.5,1.923076923076923
1634,Josep Martinez,ESP,GK,RB Leipzig,Bundesliga,22,1998,1.0,0,0,0,0,0,0,0,0.0,0,0,0,0,0,0,0,0,0,2020-2021,0.0,0.0
1635,Lautaro Martínez,ARG,FW,Inter,Serie A,22,1997,28.5,25,12,5,11,9,7,24,29.2,17,31,1,30,27,52,16,0,0,2020-2021,0.9473684210526315,0.8771929824561403
1636,Pablo Martinez,FRA,DF,Nîmes,Ligue 1,31,1989,6.0,10,7,7,3,0,7,7,100.0,0,6,4,2,11,21,28,0,0,2020-2021,1.8333333333333333,1.6666666666666667
1637,Lucas Martínez Quarta,ARG,DF,Fiorentina,Serie A,24,1996,16.5,32,20,17,11,4,18,41,43.9,23,27,9,18,39,71,48,0,0,2020-2021,2.3636363636363638,1.9393939393939394
1638,Gelson Martins,POR,"MF,FW",Monaco,Ligue 1,25,1995,17.2,41,26,12,16,13,15,37,40.5,22,20,0,20,13,54,8,0,0,2020-2021,0.7558139534883721,2.3837209302325584
1639,Adam Marušić,MNE,DF,Lazio,Serie A,27,1992,33.0,38,22,22,15,1,20,40,50.0,20,38,6,32,40,78,54,0,0,2020-2021,1.2121212121212122,1.1515151515151516
1640,Sylvain Marveaux,FRA,"MF,FW",Lorient,Ligue 1,34,1986,2.2,6,3,1,4,1,3,3,100.0,0,2,0,2,1,7,2,0,0,2020-2021,0.45454545454545453,2.727272727272727
1641,Marvin,ESP,"DF,MF",Real Madrid,La Liga,20,2000,1.5,3,2,0,3,0,1,2,50.0,1,1,0,1,2,5,3,0,0,2020-2021,1.3333333333333333,2.0
1642,Omar Mascarell,EQG,MF,Schalke 04,Bundesliga,27,1993,19.6,41,24,15,19,7,21,54,38.9,33,40,14,26,37,78,32,1,0,2020-2021,1.887755102040816,2.0918367346938775
1643,Andrea Masiello,ITA,DF,Genoa,Serie A,34,1986,28.5,38,22,29,6,3,23,48,47.9,25,32,13,19,53,91,107,3,0,2020-2021,1.8596491228070176,1.3333333333333333
1644,Jordi Masip,ESP,GK,Valladolid,La Liga,31,1989,25.0,0,0,0,0,0,0,2,0.0,2,2,0,2,2,2,8,1,0,2020-2021,0.08,0.0
1645,Roberto Massimo,GER,"DF,FW",Stuttgart,Bundesliga,19,2000,8.4,21,11,13,5,3,11,24,45.8,13,5,1,4,11,32,13,0,0,2020-2021,1.3095238095238095,2.5
1646,Giuseppe Mastinu,ITA,FW,Spezia,Serie A,28,1991,0.4,1,1,0,0,1,1,1,100.0,0,1,0,1,0,1,0,0,0,2020-2021,0.0,2.5
1647,Arthur Masuaku,COD,"DF,MF",West Ham,Premier League,26,1993,11.2,20,12,14,6,0,11,34,32.4,23,12,0,12,8,28,28,2,0,2020-2021,0.7142857142857143,1.7857142857142858
1648,Jaime Mata,ESP,FW,Getafe,La Liga,31,1988,22.6,12,7,1,3,8,3,18,16.7,15,13,2,11,6,18,16,0,0,2020-2021,0.2654867256637168,0.5309734513274336
1649,Juan Mata,ESP,"FW,MF",Manchester Utd,Premier League,32,1988,5.7,1,0,1,0,0,0,7,0.0,7,3,0,3,3,4,3,0,0,2020-2021,0.5263157894736842,0.17543859649122806
1650,Pape Matar Sarr,SEN,MF,Metz,Ligue 1,17,2002,17.7,45,29,19,21,5,20,38,52.6,18,24,4,20,27,72,16,0,0,2020-2021,1.5254237288135595,2.542372881355932
Rk,Player,Nation,Pos,Squad,Comp,0,0,90.0,0,0,3,3,3,Tkl,0,0.0,0,0,0,0,0,0,0,0,0,2020-2021,0.0,0.0
1651,Eliot Matazo,BEL,MF,Monaco,Ligue 1,18,2002,3.5,11,5,6,5,0,3,7,42.9,4,1,0,1,1,12,2,0,0,2020-2021,0.2857142857142857,3.142857142857143
1652,Jean-Philippe Mateta,FRA,FW,Crystal Palace,Premier League,23,1997,2.5,1,1,0,1,0,1,3,33.3,2,1,0,1,0,1,2,0,0,2020-2021,0.0,0.4
1653,Jean-Philippe Mateta,FRA,FW,Mainz 05,Bundesliga,23,1997,11.1,6,3,1,3,2,0,3,0.0,3,3,1,2,4,10,6,0,0,2020-2021,0.3603603603603604,0.5405405405405406
1654,Nemanja Matić,SRB,MF,Manchester Utd,Premier League,31,1988,12.3,25,11,13,12,0,13,31,41.9,18,19,5,14,22,47,10,3,0,2020-2021,1.7886178861788617,2.0325203252032518
1655,Joël Matip,CMR,DF,Liverpool,Premier League,28,1991,7.7,14,9,7,7,0,7,8,87.5,1,6,0,6,7,21,22,0,0,2020-2021,0.9090909090909091,1.8181818181818181
1656,Rabbi Matondo,WAL,"FW,MF",Schalke 04,Bundesliga,19,2000,2.4,3,2,0,3,0,2,3,66.7,1,1,0,1,1,4,1,0,0,2020-2021,0.4166666666666667,1.25
1657,Ryder Matos,BRA,MF,Udinese,Serie A,27,1993,0.1,0,0,0,0,0,0,0,0.0,0,0,0,0,0,0,0,0,0,2020-2021,0.0,0.0
1658,Henning Matriciani,GER,DF,Schalke 04,Bundesliga,20,2000,0.3,1,1,1,0,0,1,1,100.0,0,1,0,1,0,1,1,0,0,2020-2021,0.0,3.3333333333333335
1659,Chrislain Matsima,FRA,"DF,FW",Monaco,Ligue 1,18,2002,3.9,5,4,3,2,0,4,7,57.1,3,3,0,3,4,9,12,0,0,2020-2021,1.0256410256410258,1.2820512820512822
1660,Federico Mattiello,ITA,DF,Spezia,Serie A,25,1995,0.4,0,0,0,0,0,0,0,0.0,0,0,0,0,0,0,0,0,0,2020-2021,0.0,0.0
1661,Neal Maupay,FRA,"FW,MF",Brighton,Premier League,23,1996,27.9,20,8,9,7,4,4,24,16.7,20,20,0,20,13,33,6,0,0,2020-2021,0.4659498207885305,0.7168458781362007
1662,Tony Mauricio,FRA,MF,Lens,Ligue 1,26,1994,5.6,19,12,7,8,4,11,17,64.7,6,8,1,7,3,22,4,0,0,2020-2021,0.5357142857142857,3.3928571428571432
1663,Stephy Mavididi,ENG,"FW,MF",Montpellier,Ligue 1,22,1998,22.6,18,5,7,10,1,8,23,34.8,15,12,0,12,14,32,6,0,0,2020-2021,0.6194690265486725,0.7964601769911503
1664,Konstantinos Mavropanos,GRE,DF,Stuttgart,Bundesliga,22,1997,16.3,42,29,29,12,1,27,46,58.7,19,25,10,15,59,101,66,1,0,2020-2021,3.6196319018404908,2.576687116564417
1665,Eric Maxim Choupo-Moting,CMR,"FW,MF",Bayern Munich,Bundesliga,31,1989,9.1,8,2,0,5,3,1,4,25.0,3,6,0,6,2,10,7,0,0,2020-2021,0.21978021978021978,0.8791208791208791
1666,Borja Mayoral,ESP,FW,Roma,Serie A,23,1997,17.2,3,2,0,0,3,1,10,10.0,9,5,0,5,0,3,5,2,0,2020-2021,0.0,0.1744186046511628
1667,Borja Mayoral,ESP,FW,Real Madrid,La Liga,23,1997,0.3,0,0,0,0,0,0,1,0.0,1,0,0,0,0,0,0,0,0,2020-2021,0.0,0.0
1668,Youssef Maziz,FRA,"MF,FW",Metz,Ligue 1,22,1998,2.9,2,0,1,1,0,1,5,20.0,4,1,0,1,6,8,1,0,0,2020-2021,2.0689655172413794,0.6896551724137931
1669,Antonio Mazzotta,ITA,DF,Crotone,Serie A,30,1989,0.6,1,1,0,1,0,0,0,0.0,0,0,0,0,0,1,1,0,0,2020-2021,0.0,1.6666666666666667
1670,Kevin Mbabu,SUI,DF,Wolfsburg,Bundesliga,25,1995,18.2,51,33,27,17,7,24,35,68.6,11,28,7,21,22,73,59,1,0,2020-2021,1.208791208791209,2.8021978021978025
1671,Kylian Mbappé,FRA,FW,Paris S-G,Ligue 1,21,1998,26.4,4,2,0,1,3,2,9,22.2,7,7,1,6,3,7,4,1,0,2020-2021,0.11363636363636365,0.15151515151515152
1672,Ibrahima Mbaye,SEN,DF,Bologna,Serie A,25,1994,4.8,6,5,5,1,0,3,5,60.0,2,5,3,2,1,7,10,0,0,2020-2021,0.20833333333333334,1.25
1673,Jean-Manuel Mbom,GER,"MF,DF",Werder Bremen,Bundesliga,20,2000,12.9,19,13,14,3,2,8,27,29.6,19,17,6,11,13,32,27,0,0,2020-2021,1.0077519379844961,1.4728682170542635
1674,Nathanael Mbuku,FRA,"MF,FW",Reims,Ligue 1,18,2002,24.6,33,19,9,13,11,8,28,28.6,20,17,0,17,14,47,10,0,0,2020-2021,0.5691056910569106,1.3414634146341462
1675,James McArthur,SCO,MF,Crystal Palace,Premier League,32,1987,16.3,57,32,25,27,5,15,39,38.5,24,28,3,25,23,80,31,0,0,2020-2021,1.411042944785276,3.496932515337423
Rk,Player,Nation,Pos,Squad,Comp,0,0,90.0,0,0,3,3,3,Tkl,0,0.0,0,0,0,0,0,0,0,0,0,2020-2021,0.0,0.0
1676,Oliver McBurnie,SCO,FW,Sheffield Utd,Premier League,24,1996,14.7,15,7,7,7,1,5,17,29.4,12,10,3,7,6,21,30,0,0,2020-2021,0.40816326530612246,1.0204081632653061
1677,Alex McCarthy,ENG,GK,Southampton,Premier League,30,1989,30.0,1,0,1,0,0,1,4,25.0,3,0,0,0,0,1,11,1,0,2020-2021,0.0,0.03333333333333333
1678,James McCarthy,IRL,MF,Crystal Palace,Premier League,29,1990,9.1,16,12,9,7,0,8,21,38.1,13,15,7,8,8,24,12,0,0,2020-2021,0.8791208791208791,1.7582417582417582
1679,John McGinn,SCO,MF,Aston Villa,Premier League,25,1994,37.0,61,37,23,31,7,27,84,32.1,57,38,6,32,43,104,23,2,0,2020-2021,1.162162162162162,1.6486486486486487
1680,David McGoldrick,IRL,"FW,MF",Sheffield Utd,Premier League,32,1987,26.6,33,21,8,15,10,13,31,41.9,18,19,3,16,2,35,25,0,0,2020-2021,0.07518796992481203,1.2406015037593985
1681,Weston McKennie,USA,MF,Juventus,Serie A,21,1998,18.9,34,19,9,20,5,12,33,36.4,21,21,3,18,28,62,26,0,0,2020-2021,1.4814814814814816,1.798941798941799
1682,Dwight McNeil,ENG,MF,Burnley,Premier League,20,1999,34.1,47,24,24,18,5,18,56,32.1,38,44,6,38,32,79,32,1,0,2020-2021,0.93841642228739,1.378299120234604
1683,Scott McTominay,SCO,MF,Manchester Utd,Premier League,23,1996,23.7,51,24,23,25,3,23,36,63.9,13,35,10,25,29,80,46,0,0,2020-2021,1.2236286919831223,2.151898734177215
1684,Gary Medel,CHI,"DF,MF",Bologna,Serie A,32,1987,5.7,12,9,6,5,1,4,10,40.0,6,8,6,2,7,19,10,0,0,2020-2021,1.2280701754385965,2.1052631578947367
1685,Facundo Medina,ARG,DF,Lens,Ligue 1,21,1999,22.3,39,22,22,15,2,24,38,63.2,14,25,9,16,39,78,51,3,0,2020-2021,1.748878923766816,1.748878923766816
1686,Nathan de Medina,BEL,DF,Arminia,Bundesliga,22,1997,7.1,16,10,9,6,1,3,10,30.0,7,12,2,10,11,27,22,0,0,2020-2021,1.5492957746478875,2.2535211267605635
1687,Ben Mee,ENG,DF,Burnley,Premier League,30,1989,29.9,32,15,16,14,2,14,29,48.3,15,54,45,9,43,75,148,2,0,2020-2021,1.4381270903010035,1.0702341137123745
1688,Joshua Mees,GER,FW,Union Berlin,Bundesliga,24,1996,0.1,0,0,0,0,0,0,0,0.0,0,0,0,0,0,0,0,0,0,2020-2021,0.0,0.0
1689,Admir Mehmedi,SUI,"MF,FW",Wolfsburg,Bundesliga,29,1991,9.1,17,9,6,7,4,6,16,37.5,10,7,0,7,5,22,1,0,0,2020-2021,0.5494505494505495,1.8681318681318682
1690,Soualiho Meïté,FRA,MF,Torino,Serie A,26,1994,10.2,11,7,6,4,1,5,16,31.3,11,18,1,17,10,21,9,1,0,2020-2021,0.9803921568627452,1.0784313725490198
1691,Soualiho Meïté,FRA,MF,Milan,Serie A,26,1994,6.5,18,10,10,6,2,8,17,47.1,9,9,2,7,8,26,16,0,0,2020-2021,1.2307692307692308,2.769230769230769
1692,Hannibal Mejbri,TUN,MF,Manchester Utd,Premier League,17,2003,0.1,0,0,0,0,0,0,0,0.0,0,0,0,0,0,0,0,0,0,2020-2021,0.0,0.0
1693,Farid El Melali,ALG,"FW,MF",Angers,Ligue 1,23,1997,4.6,9,5,5,4,0,2,13,15.4,11,12,0,12,6,15,2,0,0,2020-2021,1.3043478260869565,1.956521739130435
1694,Filippo Melegoni,ITA,"MF,DF",Genoa,Serie A,21,1999,4.3,7,6,2,5,0,3,6,50.0,3,5,0,5,5,12,8,0,0,2020-2021,1.1627906976744187,1.627906976744186
1695,Gonzalo Melero,ESP,"MF,FW",Levante,La Liga,26,1994,20.6,24,15,11,6,7,10,39,25.6,29,14,5,9,18,42,22,1,0,2020-2021,0.8737864077669902,1.1650485436893203
1696,Birger Meling,NOR,DF,Nîmes,Ligue 1,25,1994,25.9,49,31,27,15,7,33,50,66.0,17,43,9,34,36,85,70,0,0,2020-2021,1.38996138996139,1.8918918918918919
1697,Arthur Melo,BRA,MF,Juventus,Serie A,23,1996,12.9,17,9,7,10,0,12,31,38.7,19,6,1,5,18,35,9,1,0,2020-2021,1.3953488372093024,1.317829457364341
1698,Memphis,NED,FW,Lyon,Ligue 1,26,1994,32.5,4,3,0,3,1,1,20,5.0,19,11,1,10,5,9,3,0,0,2020-2021,0.15384615384615385,0.12307692307692308
1699,Houboulang Mendes,GNB,DF,Lorient,Ligue 1,22,1998,14.4,28,19,19,5,4,16,28,57.1,12,14,2,12,14,42,35,0,0,2020-2021,0.9722222222222222,1.9444444444444444
1700,Pedro Mendes,POR,DF,Montpellier,Ligue 1,29,1990,18.1,21,19,16,5,0,14,21,66.7,7,23,13,10,34,55,58,0,0,2020-2021,1.878453038674033,1.160220994475138
Rk,Player,Nation,Pos,Squad,Comp,0,0,90.0,0,0,3,3,3,Tkl,0,0.0,0,0,0,0,0,0,0,0,0,2020-2021,0.0,0.0
1701,Thiago Mendes,BRA,MF,Lyon,Ligue 1,28,1992,24.9,37,22,13,20,4,18,38,47.4,20,33,7,26,39,76,21,2,0,2020-2021,1.566265060240964,1.4859437751004017
1702,Brais Méndez,ESP,"MF,FW",Celta Vigo,La Liga,23,1997,29.7,59,31,23,27,9,16,65,24.6,49,27,2,25,32,91,34,0,0,2020-2021,1.0774410774410774,1.9865319865319866
1703,Édgar Méndez,ESP,"MF,FW",Alavés,La Liga,30,1990,23.2,39,29,18,13,8,15,48,31.3,33,20,3,17,19,58,14,0,0,2020-2021,0.8189655172413793,1.6810344827586208
1704,Eñaut Mendía,ESP,FW,Eibar,La Liga,21,1999,0.7,2,1,2,0,0,1,2,50.0,1,1,1,0,0,2,0,0,0,2020-2021,0.0,2.857142857142857
1705,Batista Mendy,FRA,MF,Nantes,Ligue 1,20,2000,0.8,1,1,0,1,0,0,1,0.0,1,3,1,2,1,2,1,0,0,2020-2021,1.25,1.25
1706,Benjamin Mendy,FRA,DF,Manchester City,Premier League,26,1994,10.6,13,9,1,8,4,5,21,23.8,16,12,5,7,5,18,14,1,0,2020-2021,0.4716981132075472,1.2264150943396226
1707,Edouard Mendy,SEN,GK,Chelsea,Premier League,28,1992,30.5,0,0,0,0,0,0,1,0.0,1,0,0,0,1,1,9,3,0,2020-2021,0.03278688524590164,0.0
1708,Edouard Mendy,SEN,GK,Rennes,Ligue 1,28,1992,1.0,0,0,0,0,0,0,0,0.0,0,0,0,0,0,0,0,0,0,2020-2021,0.0,0.0
1709,Ferland Mendy,FRA,DF,Real Madrid,La Liga,25,1995,24.5,26,16,17,6,3,12,24,50.0,12,16,4,12,26,52,32,1,0,2020-2021,1.0612244897959184,1.0612244897959184
1710,Nampalys Mendy,SEN,MF,Leicester City,Premier League,28,1992,16.2,26,17,18,6,2,7,20,35.0,13,12,1,11,14,40,8,0,0,2020-2021,0.8641975308641976,1.6049382716049383
1711,Hamza Mendyl,MAR,"FW,DF",Schalke 04,Bundesliga,22,1997,1.1,2,2,2,0,0,0,2,0.0,2,2,0,2,0,2,2,0,0,2020-2021,0.0,1.8181818181818181
1712,Levent Mercan,GER,FW,Schalke 04,Bundesliga,19,2000,0.1,0,0,0,0,0,0,0,0.0,0,0,0,0,0,0,0,0,0,2020-2021,0.0,0.0
1713,Jorge Meré,ESP,DF,Köln,Bundesliga,23,1997,14.4,13,6,9,3,1,6,13,46.2,7,14,11,3,15,28,63,0,0,2020-2021,1.0416666666666667,0.9027777777777778
1714,Alex Meret,ITA,GK,Napoli,Serie A,23,1997,22.0,0,0,0,0,0,0,1,0.0,1,0,0,0,0,0,5,0,0,2020-2021,0.0,0.0
1715,Mikel Merino,ESP,MF,Real Sociedad,La Liga,24,1996,23.9,61,36,14,36,11,18,45,40.0,27,36,8,28,32,93,26,0,0,2020-2021,1.3389121338912136,2.552301255230126
1716,Martín Merquelanz,ESP,"MF,FW",Real Sociedad,La Liga,25,1995,6.1,9,3,3,2,4,2,7,28.6,5,7,1,6,3,12,4,0,0,2020-2021,0.49180327868852464,1.4754098360655739
1717,Yıldırım Mert Çetin,TUR,DF,Hellas Verona,Serie A,23,1997,4.6,8,4,3,5,0,2,6,33.3,4,7,5,2,14,22,11,1,0,2020-2021,3.0434782608695654,1.7391304347826089
1718,Dries Mertens,BEL,"FW,MF",Napoli,Serie A,33,1987,16.2,16,14,4,7,5,5,25,20.0,20,7,1,6,9,25,3,1,0,2020-2021,0.5555555555555556,0.9876543209876544
1719,Roque Mesa,ESP,MF,Valladolid,La Liga,31,1989,19.6,46,29,18,24,4,20,47,42.6,27,11,2,9,14,60,23,1,0,2020-2021,0.7142857142857142,2.346938775510204
1720,Illan Meslier,FRA,GK,Leeds United,Premier League,20,2000,35.0,0,0,0,0,0,0,1,0.0,1,0,0,0,0,0,17,8,0,2020-2021,0.0,0.0
1721,Lionel Messi,ARG,"FW,MF",Barcelona,La Liga,33,1987,33.6,18,10,3,9,6,6,17,35.3,11,12,0,12,6,24,0,2,0,2020-2021,0.17857142857142858,0.5357142857142857
1722,Junior Messias,BRA,"MF,FW",Crotone,Serie A,29,1991,35.7,60,35,26,24,10,22,70,31.4,48,32,12,20,35,95,40,0,0,2020-2021,0.9803921568627451,1.6806722689075628
1723,Thomas Meunier,BEL,DF,Dortmund,Bundesliga,28,1991,16.4,30,21,19,6,5,20,29,69.0,9,16,6,10,18,48,29,2,0,2020-2021,1.0975609756097562,1.829268292682927
1724,Mexer,MOZ,DF,Bordeaux,Ligue 1,31,1988,7.9,9,6,8,0,1,5,10,50.0,5,8,5,3,17,26,22,0,0,2020-2021,2.151898734177215,1.1392405063291138
1725,Max Meyer,GER,MF,Köln,Bundesliga,24,1995,3.9,7,4,3,3,1,4,8,50.0,4,4,1,3,3,10,1,0,0,2020-2021,0.7692307692307693,1.794871794871795
Rk,Player,Nation,Pos,Squad,Comp,0,0,90.0,0,0,3,3,3,Tkl,0,0.0,0,0,0,0,0,0,0,0,0,2020-2021,0.0,0.0
1726,Omenuke Mfulu,COD,MF,Elche,La Liga,26,1994,8.8,18,12,10,8,0,5,15,33.3,10,7,1,6,11,29,18,0,0,2020-2021,1.25,2.0454545454545454
1727,Míchel,ESP,MF,Valladolid,La Liga,32,1988,10.5,18,11,10,3,5,5,22,22.7,17,10,1,9,9,27,12,1,0,2020-2021,0.8571428571428571,1.7142857142857142
1728,Jonas Michelbrink,GER,MF,Hertha BSC,Bundesliga,19,2001,0.4,0,0,0,0,0,0,0,0.0,0,0,0,0,0,0,0,0,0,2020-2021,0.0,0.0
1729,Clément Michelin,FRA,DF,Lens,Ligue 1,23,1997,12.8,25,19,13,9,3,9,16,56.3,7,13,4,9,25,50,32,0,0,2020-2021,1.953125,1.953125
1730,Edouard Michut,FRA,MF,Paris S-G,Ligue 1,17,2003,0.0,0,0,0,0,0,0,0,0.0,0,0,0,0,0,0,0,0,0,2020-2021,,
1731,Petar Mićin,SRB,MF,Udinese,Serie A,21,1998,0.2,0,0,0,0,0,0,0,0.0,0,0,0,0,0,0,0,0,0,2020-2021,0.0,0.0
1732,Florian Miguel,FRA,DF,Nîmes,Ligue 1,23,1996,17.1,14,13,12,2,0,9,17,52.9,8,21,13,8,45,59,66,1,0,2020-2021,2.631578947368421,0.8187134502923976
1733,Valentin Mihaila,ROU,"FW,MF",Parma,Serie A,20,2000,7.8,2,1,1,1,0,0,10,0.0,10,8,1,7,5,7,8,0,0,2020-2021,0.6410256410256411,0.25641025641025644
1734,Nikola Milenković,SRB,DF,Fiorentina,Serie A,22,1997,33.7,49,29,33,14,2,21,33,63.6,12,42,33,9,44,93,122,1,0,2020-2021,1.3056379821958455,1.4540059347181007
1735,Arkadiusz Milik,POL,FW,Marseille,Ligue 1,26,1994,13.6,14,9,0,7,7,2,12,16.7,10,5,1,4,2,16,9,0,0,2020-2021,0.14705882352941177,1.0294117647058825
1736,Sergej Milinković-Savić,SRB,MF,Lazio,Serie A,25,1995,30.5,59,40,20,30,9,27,84,32.1,57,52,12,40,33,92,47,0,0,2020-2021,1.0819672131147542,1.9344262295081966
1737,Vanja Milinković-Savić,SRB,GK,Torino,Serie A,23,1997,5.0,1,1,1,0,0,1,1,100.0,0,0,0,0,0,1,1,3,0,2020-2021,0.0,0.2
1738,Éder Militão,BRA,DF,Real Madrid,La Liga,22,1998,12.6,20,8,13,6,1,8,14,57.1,6,19,6,13,19,39,42,0,0,2020-2021,1.507936507936508,1.5873015873015874
1739,Luka Milivojević,SRB,MF,Crystal Palace,Premier League,29,1991,26.2,65,34,25,31,9,42,77,54.5,35,29,6,23,35,100,47,2,0,2020-2021,1.33587786259542,2.480916030534351
1740,Luis Milla,ESP,MF,Granada,La Liga,25,1994,13.9,22,11,11,10,1,6,28,21.4,22,10,0,10,24,46,16,1,0,2020-2021,1.7266187050359711,1.5827338129496402
1741,Pere Milla,ESP,"FW,MF",Elche,La Liga,27,1992,22.0,24,17,12,10,2,8,37,21.6,29,17,5,12,13,37,17,1,0,2020-2021,0.5909090909090909,1.0909090909090908
1742,Álex Millán,ESP,FW,Villarreal,La Liga,20,1999,0.0,0,0,0,0,0,0,0,0.0,0,0,0,0,0,0,0,0,0,2020-2021,,
1743,Vincenzo Millico,ITA,"FW,MF",Torino,Serie A,19,2000,0.2,0,0,0,0,0,0,0,0.0,0,0,0,0,0,0,0,0,0,2020-2021,0.0,0.0
1744,Enzo Millot,FRA,MF,Monaco,Ligue 1,18,2002,0.5,2,0,0,1,1,1,1,100.0,0,0,0,0,2,4,0,0,0,2020-2021,4.0,4.0
1745,James Milner,ENG,"MF,DF",Liverpool,Premier League,34,1986,11.9,26,19,9,14,3,11,33,33.3,22,30,3,27,14,40,16,1,0,2020-2021,1.1764705882352942,2.1848739495798317
1746,Santi Mina,ESP,FW,Celta Vigo,La Liga,24,1995,26.8,31,13,9,12,10,6,37,16.2,31,15,3,12,6,37,17,0,0,2020-2021,0.22388059701492538,1.1567164179104477
1747,Yerry Mina,COL,DF,Everton,Premier League,25,1994,21.5,21,14,17,4,0,8,12,66.7,4,30,23,7,24,45,110,1,0,2020-2021,1.1162790697674418,0.9767441860465116
1748,Takumi Minamino,JPN,MF,Southampton,Premier League,25,1995,7.9,7,3,2,5,0,2,19,10.5,17,13,1,12,4,11,9,0,0,2020-2021,0.5063291139240506,0.8860759493670886
1749,Takumi Minamino,JPN,"MF,FW",Liverpool,Premier League,25,1995,3.3,4,3,1,2,1,0,12,0.0,12,1,0,1,2,6,3,0,0,2020-2021,0.6060606060606061,1.2121212121212122
1750,Tyrone Mings,ENG,DF,Aston Villa,Premier League,27,1993,35.5,32,16,23,7,2,16,24,66.7,8,59,40,19,41,73,172,3,0,2020-2021,1.1549295774647887,0.9014084507042254
Rk,Player,Nation,Pos,Squad,Comp,0,0,90.0,0,0,3,3,3,Tkl,0,0.0,0,0,0,0,0,0,0,0,0,2020-2021,0.0,0.0
1751,Óscar Mingueza,ESP,DF,Barcelona,La Liga,21,1999,21.1,52,33,28,17,7,30,53,56.6,23,19,6,13,20,72,48,2,0,2020-2021,0.947867298578199,2.4644549763033172
1752,Rafa Mir,ESP,FW,Huesca,La Liga,23,1997,32.0,15,9,4,4,7,7,22,31.8,15,14,2,12,15,30,25,0,0,2020-2021,0.46875,0.46875
1753,Jorge Miramón,ESP,DF,Levante,La Liga,31,1989,19.2,32,22,26,6,0,21,35,60.0,14,22,2,20,27,59,54,0,0,2020-2021,1.40625,1.6666666666666667
1754,Aleksei Miranchuk,RUS,"MF,FW",Atalanta,Serie A,24,1995,7.5,24,13,8,9,7,6,9,66.7,3,1,0,1,3,27,1,0,0,2020-2021,0.4,3.2
1755,Juan Miranda,ESP,DF,Betis,La Liga,20,2000,18.4,27,11,16,9,2,16,32,50.0,16,18,2,16,29,56,58,1,0,2020-2021,1.5760869565217392,1.4673913043478262
1756,Antonio Mirante,ITA,GK,Roma,Serie A,37,1983,12.8,0,0,0,0,0,0,1,0.0,1,1,0,1,0,0,7,2,0,2020-2021,0.0,0.0
1757,Tyrick Mitchell,ENG,DF,Crystal Palace,Premier League,20,1999,19.0,64,35,48,9,7,23,40,57.5,17,29,10,19,21,85,62,1,0,2020-2021,1.105263157894737,3.3684210526315788
1758,Aleksandar Mitrović,SRB,FW,Fulham,Premier League,25,1994,15.6,7,4,0,3,4,2,8,25.0,6,12,3,9,3,10,8,0,0,2020-2021,0.19230769230769232,0.44871794871794873
1759,Stefan Mitrović,SRB,DF,Strasbourg,Ligue 1,30,1990,30.9,36,27,29,7,0,24,37,64.9,13,23,13,10,31,67,108,5,0,2020-2021,1.0032362459546926,1.1650485436893205
1760,Maximilian Mittelstädt,GER,"DF,FW",Hertha BSC,Bundesliga,23,1997,20.0,66,39,42,21,3,35,72,48.6,37,34,5,29,55,121,61,1,0,2020-2021,2.75,3.3
1761,Henrikh Mkhitaryan,ARM,"MF,FW",Roma,Serie A,31,1989,30.5,58,24,13,27,18,13,62,21.0,49,34,0,34,39,97,10,0,0,2020-2021,1.278688524590164,1.901639344262295
1762,Jakub Moder,POL,"DF,MF",Brighton,Premier League,21,1999,7.2,15,7,5,7,3,7,20,35.0,13,12,1,11,3,18,9,0,0,2020-2021,0.41666666666666663,2.0833333333333335
1763,Anthony Modeste,FRA,"FW,MF",Saint-Étienne,Ligue 1,32,1988,3.3,2,1,0,2,0,1,4,25.0,3,3,1,2,0,2,3,0,0,2020-2021,0.0,0.6060606060606061
1764,Anthony Modeste,FRA,FW,Köln,Bundesliga,32,1988,2.5,2,0,0,2,0,0,1,0.0,1,0,0,0,0,2,2,0,0,2020-2021,0.0,0.8
1765,Luka Modrić,CRO,MF,Real Madrid,La Liga,34,1985,30.4,37,23,18,16,3,13,36,36.1,23,14,2,12,48,85,14,1,0,2020-2021,1.5789473684210527,1.2171052631578947
1766,Terem Moffi,NGA,FW,Lorient,Ligue 1,21,1999,23.0,13,8,0,8,5,4,19,21.1,15,5,2,3,4,17,8,0,0,2020-2021,0.17391304347826086,0.5652173913043478
1767,Kevin Möhwald,GER,MF,Werder Bremen,Bundesliga,27,1993,17.3,15,9,9,5,1,4,18,22.2,14,10,3,7,32,47,19,2,0,2020-2021,1.8497109826589595,0.8670520231213873
1768,Niklas Moisander,FIN,DF,Werder Bremen,Bundesliga,34,1985,13.6,14,11,11,3,0,8,14,57.1,6,15,8,7,22,36,61,0,0,2020-2021,1.6176470588235294,1.0294117647058825
1769,Dion Moise Sahi,CIV,"FW,MF",Strasbourg,Ligue 1,18,2001,1.0,1,0,0,1,0,1,1,100.0,0,1,0,1,0,1,0,0,0,2020-2021,0.0,1.0
1770,Johan Mojica,COL,DF,Atalanta,Serie A,27,1992,3.3,4,4,3,1,0,2,3,66.7,1,3,0,3,7,11,6,0,0,2020-2021,2.121212121212121,1.2121212121212122
1771,Johan Mojica,COL,DF,Elche,La Liga,27,1992,13.4,21,10,15,5,1,8,18,44.4,10,15,4,11,15,36,27,0,0,2020-2021,1.1194029850746268,1.5671641791044775
1772,Guillem Molina,ESP,DF,Valencia,La Liga,20,2000,1.7,1,0,1,0,0,0,5,0.0,5,1,1,0,4,5,5,0,0,2020-2021,2.3529411764705883,0.5882352941176471
1773,Jorge Molina,ESP,FW,Granada,La Liga,38,1982,17.9,11,4,3,5,3,8,22,36.4,14,5,1,4,3,14,19,0,0,2020-2021,0.1675977653631285,0.6145251396648045
1774,Nahuel Molina,ARG,DF,Udinese,Serie A,22,1998,20.3,27,18,13,10,4,16,42,38.1,26,26,4,22,21,48,49,1,0,2020-2021,1.0344827586206897,1.3300492610837438
1775,Salvatore Molina,ITA,"MF,DF",Crotone,Serie A,28,1992,25.7,39,22,18,14,7,29,45,64.4,16,30,8,22,17,56,41,0,0,2020-2021,0.6614785992217899,1.517509727626459
Rk,Player,Nation,Pos,Squad,Comp,0,0,90.0,0,0,3,3,3,Tkl,0,0.0,0,0,0,0,0,0,0,0,0,2020-2021,0.0,0.0
1776,Victor Mollejo,ESP,"MF,DF",Getafe,La Liga,19,2001,0.8,2,1,1,0,1,0,1,0.0,1,0,0,0,0,2,0,0,0,2020-2021,0.0,2.5
1777,Florent Mollet,FRA,MF,Montpellier,Ligue 1,28,1991,26.2,20,15,7,11,2,12,47,25.5,35,18,4,14,32,52,9,1,0,2020-2021,1.2213740458015268,0.7633587786259542
1778,Jayson Molumby,IRL,MF,Brighton,Premier League,20,1999,0.0,0,0,0,0,0,0,0,0.0,0,0,0,0,0,0,0,0,0,2020-2021,,
1779,Alkhaly Momo Cissé,GUI,"FW,DF",Stuttgart,Bundesliga,17,2002,0.4,1,1,1,0,0,0,0,0.0,0,1,0,1,0,1,0,0,0,2020-2021,0.0,2.5
1780,Jon Moncayola,ESP,MF,Osasuna,La Liga,22,1998,29.6,61,36,27,23,11,24,67,35.8,43,27,9,18,23,84,38,0,0,2020-2021,0.777027027027027,2.0608108108108105
1781,Gabriele Moncini,ITA,"FW,MF",Benevento,Serie A,24,1996,4.0,2,1,2,0,0,0,1,0.0,1,2,0,2,2,4,4,0,0,2020-2021,0.5,0.5
1782,Thomas Monconduit,FRA,MF,Lorient,Ligue 1,29,1991,12.8,28,15,9,16,3,15,41,36.6,26,10,3,7,13,41,21,1,0,2020-2021,1.015625,2.1875
1783,Kévin Monnet-Paquet,FRA,"MF,FW",Saint-Étienne,Ligue 1,31,1988,6.3,11,7,7,2,2,5,10,50.0,5,5,0,5,6,17,7,0,0,2020-2021,0.9523809523809524,1.746031746031746
1784,Nacho Monreal,ESP,DF,Real Sociedad,La Liga,34,1986,23.1,31,19,17,11,3,7,20,35.0,13,14,3,11,31,62,43,0,0,2020-2021,1.3419913419913418,1.3419913419913418
1785,Cristóbal Montiel,ESP,"MF,FW",Fiorentina,Serie A,20,2000,0.0,0,0,0,0,0,0,1,0.0,1,0,0,0,0,0,0,0,0,2020-2021,,
1786,Lorenzo Montipò,ITA,GK,Benevento,Serie A,24,1996,37.0,0,0,0,0,0,0,0,0.0,0,1,0,1,0,0,16,3,0,2020-2021,0.0,0.0
1787,Ángel Montoro,ESP,MF,Granada,La Liga,32,1988,15.1,15,9,7,7,1,4,16,25.0,12,13,3,10,22,37,21,0,0,2020-2021,1.456953642384106,0.9933774834437087
1788,Martín Montoya,ESP,DF,Betis,La Liga,29,1991,2.7,6,3,2,2,2,1,3,33.3,2,1,1,0,2,8,6,0,0,2020-2021,0.7407407407407407,2.222222222222222
1789,Emre Mor,TUR,"FW,MF",Celta Vigo,La Liga,23,1997,5.6,8,4,1,3,4,0,3,0.0,3,5,0,5,5,13,0,0,0,2020-2021,0.8928571428571429,1.4285714285714286
1790,Luca Mora,ITA,MF,Spezia,Serie A,32,1988,1.3,3,1,1,2,0,2,4,50.0,2,2,1,1,0,3,2,0,0,2020-2021,0.0,2.3076923076923075
1791,Wesley Moraes,BRA,FW,Aston Villa,Premier League,23,1996,0.2,0,0,0,0,0,0,1,0.0,1,0,0,0,0,0,0,0,0,2020-2021,0.0,0.0
1792,Álvaro Morata,ESP,FW,Juventus,Serie A,27,1992,22.4,17,12,2,10,5,4,28,14.3,24,22,2,20,5,22,21,0,0,2020-2021,0.22321428571428573,0.7589285714285715
1793,Jan Morávek,CZE,MF,Augsburg,Bundesliga,30,1989,3.0,5,3,4,1,0,1,8,12.5,7,3,0,3,7,12,2,0,0,2020-2021,2.3333333333333335,1.6666666666666667
1794,Jon Morcillo,ESP,"MF,FW",Athletic Club,La Liga,21,1998,15.1,16,9,3,6,7,7,30,23.3,23,9,0,9,15,31,11,0,0,2020-2021,0.9933774834437087,1.0596026490066226
1795,Jérémy Morel,MAD,DF,Lorient,Ligue 1,36,1984,27.7,31,19,21,10,0,20,39,51.3,19,26,11,15,44,75,81,1,0,2020-2021,1.588447653429603,1.1191335740072204
1796,Alberto Moreno,ESP,DF,Villarreal,La Liga,28,1992,2.1,7,4,7,0,0,2,5,40.0,3,2,1,1,3,10,2,0,0,2020-2021,1.4285714285714286,3.333333333333333
1797,Álex Moreno,ESP,DF,Betis,La Liga,27,1993,19.8,42,26,25,12,5,20,43,46.5,23,18,4,14,35,77,48,0,0,2020-2021,1.7676767676767675,2.121212121212121
1798,Gerard Moreno,ESP,FW,Villarreal,La Liga,28,1992,29.7,24,15,8,10,6,7,34,20.6,27,17,4,13,15,39,26,0,0,2020-2021,0.5050505050505051,0.8080808080808081
1799,Tete Morente,ESP,"MF,FW",Elche,La Liga,23,1996,22.4,31,17,17,9,5,9,39,23.1,30,20,0,20,13,44,28,0,0,2020-2021,0.5803571428571429,1.3839285714285716
1800,Mateu Morey,ESP,DF,Dortmund,Bundesliga,20,2000,9.2,13,7,4,7,2,9,12,75.0,3,6,1,5,18,31,7,1,0,2020-2021,1.956521739130435,1.4130434782608696
Rk,Player,Nation,Pos,Squad,Comp,0,0,90.0,0,0,3,3,3,Tkl,0,0.0,0,0,0,0,0,0,0,0,0,2020-2021,0.0,0.0
1801,Wes Morgan,JAM,DF,Leicester City,Premier League,36,1984,0.2,0,0,0,0,0,0,0,0.0,0,0,0,0,0,0,1,0,0,2020-2021,0.0,0.0
1802,Ilaix Moriba,GUI,MF,Barcelona,La Liga,17,2003,6.0,14,6,5,7,2,5,10,50.0,5,16,1,15,5,19,4,1,0,2020-2021,0.8333333333333334,2.3333333333333335
1803,Raúl Moro,ESP,FW,Lazio,Serie A,17,2002,0.1,0,0,0,0,0,0,1,0.0,1,0,0,0,0,0,0,0,0,2020-2021,0.0,0.0
1804,Loren Morón,ESP,FW,Betis,La Liga,26,1993,11.0,11,7,2,6,3,1,16,6.3,15,11,0,11,3,14,14,0,0,2020-2021,0.2727272727272727,1.0
1805,Pedro Mosquera,ESP,MF,Huesca,La Liga,32,1988,22.8,38,18,19,18,1,13,53,24.5,40,23,6,17,31,69,38,1,0,2020-2021,1.3596491228070176,1.6666666666666665
1806,Aimen Moueffek,FRA,"DF,MF",Saint-Étienne,Ligue 1,19,2001,8.3,25,15,16,6,3,13,32,40.6,19,17,2,15,9,34,18,0,0,2020-2021,1.0843373493975903,3.012048192771084
1807,Youssoufa Moukoko,GER,"FW,MF",Dortmund,Bundesliga,15,2004,4.7,3,2,1,1,1,0,0,0.0,0,3,0,3,0,3,2,0,0,2020-2021,0.0,0.6382978723404255
1808,Harold Moukoudi,CMR,DF,Saint-Étienne,Ligue 1,22,1997,25.3,46,27,37,8,1,28,38,73.7,10,24,10,14,42,88,78,1,0,2020-2021,1.6600790513833992,1.8181818181818181
1809,Jessy Moulin,FRA,GK,Saint-Étienne,Ligue 1,34,1986,29.0,2,1,2,0,0,2,3,66.7,1,0,0,0,2,4,9,2,0,2020-2021,0.06896551724137931,0.06896551724137931
1810,Steve Mounié,BEN,FW,Brest,Ligue 1,25,1994,29.8,15,11,3,11,1,3,28,10.7,25,18,3,15,12,27,40,0,0,2020-2021,0.40268456375838924,0.5033557046979865
1811,Mason Mount,ENG,MF,Chelsea,Premier League,21,1999,32.1,75,35,22,38,15,25,69,36.2,44,40,2,38,31,106,14,0,0,2020-2021,0.9657320872274143,2.336448598130841
1812,Lucas Moura,BRA,"FW,MF",Tottenham,Premier League,27,1992,15.7,32,16,12,16,4,8,29,27.6,21,12,0,12,18,50,10,0,0,2020-2021,1.1464968152866242,2.038216560509554
1813,Lys Mousset,FRA,"FW,MF",Sheffield Utd,Premier League,24,1996,3.3,1,0,0,0,1,0,2,0.0,2,1,0,1,0,1,1,1,0,2020-2021,0.0,0.30303030303030304
1814,João Moutinho,POR,MF,Wolves,Premier League,33,1986,28.1,75,40,34,35,6,35,91,38.5,56,18,3,15,47,122,28,0,0,2020-2021,1.6725978647686832,2.6690391459074734
1815,Samuel Moutoussamy,COD,FW,Nantes,Ligue 1,23,1996,0.9,0,0,0,0,0,0,1,0.0,1,1,0,1,0,0,0,0,0,2020-2021,0.0,0.0
1816,Loris Mouyokolo,FRA,DF,Lorient,Ligue 1,19,2001,0.2,1,1,1,0,0,1,1,100.0,0,1,1,0,0,1,1,0,0,2020-2021,0.0,5.0
1817,Javi Moyano,ESP,DF,Valladolid,La Liga,34,1986,1.1,0,0,0,0,0,0,0,0.0,0,2,0,2,0,0,2,0,0,2020-2021,0.0,0.0
1818,Nordi Mukiele,FRA,DF,RB Leipzig,Bundesliga,22,1997,18.6,44,30,14,28,2,21,37,56.8,16,33,1,32,23,67,33,2,0,2020-2021,1.2365591397849462,2.365591397849462
1819,Mert Müldür,TUR,DF,Sassuolo,Serie A,21,1999,18.6,43,20,26,9,8,27,53,50.9,26,17,1,16,36,79,41,0,0,2020-2021,1.9354838709677418,2.311827956989247
1820,Florian Müller,GER,GK,Freiburg,Bundesliga,22,1997,31.0,0,0,0,0,0,0,3,0.0,3,1,0,1,2,2,10,1,0,2020-2021,0.06451612903225806,0.0
1821,Sebastian Müller,GER,"MF,DF",Arminia,Bundesliga,19,2001,0.0,0,0,0,0,0,0,0,0.0,0,0,0,0,0,0,0,0,0,2020-2021,,
1822,Thomas Müller,GER,MF,Bayern Munich,Bundesliga,30,1989,29.7,49,22,11,23,15,24,73,32.9,49,43,3,40,21,70,18,1,0,2020-2021,0.7070707070707071,1.6498316498316499
1823,Joel Mumbongo,SWE,FW,Burnley,Premier League,21,1999,0.4,0,0,0,0,0,0,0,0.0,0,1,0,1,0,0,0,0,0,2020-2021,0.0,0.0
1824,Marshall Munetsi,ZIM,"MF,DF",Reims,Ligue 1,24,1996,21.4,35,19,19,14,2,21,41,51.2,20,33,25,8,57,92,85,3,0,2020-2021,2.663551401869159,1.6355140186915889
1825,Iker Muniain,ESP,"MF,FW",Athletic Club,La Liga,27,1992,21.6,20,7,4,10,6,6,24,25.0,18,15,0,15,11,31,4,0,0,2020-2021,0.5092592592592592,0.9259259259259258
Rk,Player,Nation,Pos,Squad,Comp,0,0,90.0,0,0,3,3,3,Tkl,0,0.0,0,0,0,0,0,0,0,0,0,2020-2021,0.0,0.0
1826,Aihen Muñoz,ESP,DF,Real Sociedad,La Liga,22,1997,13.4,23,16,15,5,3,11,19,57.9,8,12,2,10,10,33,31,0,0,2020-2021,0.7462686567164178,1.716417910447761
1827,Joaquín Muñoz,ESP,FW,Huesca,La Liga,21,1999,0.5,0,0,0,0,0,0,2,0.0,2,0,0,0,1,1,0,0,0,2020-2021,2.0,0.0
1828,Luis Muriel,COL,FW,Atalanta,Serie A,29,1991,16.0,20,9,4,8,8,9,26,34.6,17,17,0,17,7,27,4,0,0,2020-2021,0.4375,1.25
1829,Jeison Murillo,COL,DF,Celta Vigo,La Liga,28,1992,30.0,45,21,35,9,1,24,44,54.5,20,29,17,12,36,81,100,2,0,2020-2021,1.2,1.5
1830,Vedat Muriqi,KVX,FW,Lazio,Serie A,26,1994,9.2,3,1,0,2,1,0,8,0.0,8,9,2,7,3,6,20,0,0,2020-2021,0.32608695652173914,0.32608695652173914
1831,Jacob Murphy,ENG,"DF,MF",Newcastle Utd,Premier League,25,1995,18.1,39,24,25,12,2,24,49,49.0,25,27,3,24,14,53,29,0,0,2020-2021,0.7734806629834253,2.154696132596685
1832,Nicola Murru,ITA,DF,Torino,Serie A,25,1994,6.3,9,6,1,5,3,3,5,60.0,2,11,1,10,12,21,24,0,0,2020-2021,1.9047619047619049,1.4285714285714286
1833,Petar Musa,CRO,FW,Union Berlin,Bundesliga,22,1998,7.9,12,8,3,6,3,4,8,50.0,4,10,0,10,4,16,5,0,0,2020-2021,0.5063291139240506,1.5189873417721518
1834,Mateo Musacchio,ARG,DF,Lazio,Serie A,29,1990,2.5,1,1,1,0,0,0,0,0.0,0,5,2,3,2,3,5,0,0,2020-2021,0.8,0.4
1835,Mateo Musacchio,ARG,DF,Milan,Serie A,29,1990,0.4,2,1,2,0,0,2,3,66.7,1,1,0,1,3,5,0,0,0,2020-2021,7.5,5.0
1836,Yunus Musah,USA,MF,Valencia,La Liga,17,2002,17.0,21,18,12,3,6,8,24,33.3,16,20,0,20,15,36,12,1,0,2020-2021,0.8823529411764706,1.2352941176470589
1837,Jamal Musiala,GER,"FW,MF",Bayern Munich,Bundesliga,17,2003,9.8,20,12,5,7,8,7,22,31.8,15,17,2,15,14,34,3,0,0,2020-2021,1.4285714285714284,2.0408163265306123
1838,Juan Musso,ARG,GK,Udinese,Serie A,26,1994,35.0,1,1,1,0,0,1,1,100.0,0,0,0,0,1,2,8,1,0,2020-2021,0.02857142857142857,0.02857142857142857
1839,Shkodran Mustafi,GER,DF,Arsenal,Premier League,28,1992,0.5,1,1,1,0,0,1,1,100.0,0,1,0,1,0,1,3,0,0,2020-2021,0.0,2.0
1840,Shkodran Mustafi,GER,DF,Schalke 04,Bundesliga,28,1992,11.5,16,5,15,1,0,3,12,25.0,9,20,15,5,32,48,76,1,0,2020-2021,2.782608695652174,1.391304347826087
1841,Yoshinori Mutō,JPN,"FW,MF",Eibar,La Liga,28,1992,12.5,12,7,1,4,7,3,8,37.5,5,5,0,5,3,15,2,0,0,2020-2021,0.24,0.96
1842,Phillipp Mwene,AUT,"DF,MF",Mainz 05,Bundesliga,26,1994,18.6,36,23,21,11,4,19,38,50.0,19,26,3,23,24,60,33,0,0,2020-2021,1.2903225806451613,1.9354838709677418
1843,Joakim Mæhle,DEN,DF,Atalanta,Serie A,23,1997,13.5,18,10,7,5,6,8,19,42.1,11,17,2,15,11,29,5,0,0,2020-2021,0.8148148148148148,1.3333333333333333
1844,Obite N'Dicka,CIV,DF,Eint Frankfurt,Bundesliga,20,1999,22.7,31,23,16,15,0,16,28,57.1,12,27,6,21,47,78,85,0,0,2020-2021,2.0704845814977975,1.3656387665198237
1845,Kévin N'Doram,FRA,MF,Metz,Ligue 1,24,1996,3.4,3,2,0,3,0,1,3,33.3,2,0,0,0,6,9,2,0,0,2020-2021,1.7647058823529411,0.8823529411764706
1846,Stanley N'Soki,FRA,DF,Nice,Ligue 1,21,1999,13.8,27,19,15,9,3,13,22,59.1,9,17,4,13,26,53,38,2,0,2020-2021,1.8840579710144927,1.9565217391304346
1847,Nacho,ESP,DF,Valladolid,La Liga,31,1989,20.1,43,21,29,10,4,24,52,46.2,28,21,1,20,29,72,47,0,0,2020-2021,1.4427860696517412,2.1393034825870645
1848,Nacho,ESP,DF,Real Madrid,La Liga,30,1990,22.2,27,14,13,11,3,12,35,34.3,23,19,9,10,40,67,58,0,0,2020-2021,1.8018018018018018,1.2162162162162162
1849,Yuto Nagatomo,JPN,DF,Marseille,Ligue 1,33,1986,17.7,23,16,12,8,3,9,18,50.0,9,14,3,11,29,52,43,0,0,2020-2021,1.6384180790960452,1.2994350282485876
1850,Kenny Nagera,FRA,FW,Paris S-G,Ligue 1,18,2002,0.0,0,0,0,0,0,0,0,0.0,0,0,0,0,0,0,0,0,0,2020-2021,,
Rk,Player,Nation,Pos,Squad,Comp,0,0,90.0,0,0,3,3,3,Tkl,0,0.0,0,0,0,0,0,0,0,0,0,2020-2021,0.0,0.0
1851,Radja Nainggolan,BEL,MF,Cagliari,Serie A,32,1988,20.5,41,26,22,14,5,19,34,55.9,15,18,0,18,15,56,15,1,0,2020-2021,0.7317073170731707,2.0
1852,Radja Nainggolan,BEL,MF,Inter,Serie A,32,1988,0.5,0,0,0,0,0,0,0,0.0,0,0,0,0,1,1,0,0,0,2020-2021,2.0,0.0
1853,Marvelous Nakamba,ZIM,MF,Aston Villa,Premier League,26,1994,8.3,22,14,10,11,1,7,12,58.3,5,16,5,11,17,39,9,1,0,2020-2021,2.048192771084337,2.650602409638554
1854,Nahitan Nández,URU,"MF,DF",Cagliari,Serie A,24,1995,30.4,56,28,23,23,10,25,68,36.8,43,26,4,22,23,79,49,0,0,2020-2021,0.7565789473684211,1.842105263157895
1855,Nano,ESP,FW,Cádiz,La Liga,25,1995,0.1,0,0,0,0,0,0,0,0.0,0,0,0,0,0,0,0,0,0,2020-2021,0.0,0.0
1856,Paul Nardi,FRA,GK,Lorient,Ligue 1,26,1994,23.0,0,0,0,0,0,0,1,0.0,1,1,0,1,0,0,15,2,0,2020-2021,0.0,0.0
1857,Matija Nastasić,SRB,DF,Schalke 04,Bundesliga,27,1993,13.6,11,7,9,2,0,9,16,56.3,7,22,18,4,26,37,51,1,0,2020-2021,1.911764705882353,0.8088235294117647
1858,Roberto Navarro,ESP,MF,Real Sociedad,La Liga,18,2002,0.4,1,1,1,0,0,0,2,0.0,2,0,0,0,1,2,0,0,0,2020-2021,2.5,2.5
1859,Ximo Navarro,ESP,DF,Alavés,La Liga,30,1990,26.4,54,30,36,17,1,14,30,46.7,16,14,4,10,47,101,75,3,0,2020-2021,1.7803030303030305,2.0454545454545454
1860,Jesús Navas,ESP,DF,Sevilla,La Liga,34,1985,31.4,27,21,15,11,1,15,22,68.2,7,10,3,7,37,64,62,1,0,2020-2021,1.178343949044586,0.8598726114649682
1861,Keylor Navas,CRC,GK,Paris S-G,Ligue 1,33,1986,28.0,0,0,0,0,0,0,0,0.0,0,0,0,0,0,0,10,0,0,2020-2021,0.0,0.0
1862,Raúl Navas,ESP,DF,Osasuna,La Liga,32,1988,1.9,6,3,5,1,0,4,6,66.7,2,0,0,0,3,9,13,0,0,2020-2021,1.5789473684210527,3.1578947368421053
1863,Papa Ndiaga Yade,MTN,"FW,MF",Metz,Ligue 1,20,2000,11.1,15,8,9,2,4,7,20,35.0,13,9,0,9,4,19,6,0,0,2020-2021,0.3603603603603604,1.3513513513513513
1864,Iliman Ndiaye,SEN,MF,Sheffield Utd,Premier League,20,2000,0.1,1,1,0,1,0,1,1,100.0,0,0,0,0,0,1,0,0,0,2020-2021,0.0,10.0
1865,Wilfred Ndidi,NGA,"MF,DF",Leicester City,Premier League,23,1996,24.2,96,63,45,44,7,26,66,39.4,40,38,11,27,61,157,55,0,0,2020-2021,2.5206611570247937,3.9669421487603307
1866,Bridge Ndilu,FRA,"FW,MF",Nantes,Ligue 1,20,2000,0.5,0,0,0,0,0,0,2,0.0,2,2,0,2,0,0,0,0,0,2020-2021,0.0,0.0
1867,Tanguy Ndombele,FRA,MF,Tottenham,Premier League,23,1996,23.2,41,20,11,21,9,18,44,40.9,26,28,4,24,19,60,15,0,0,2020-2021,0.8189655172413793,1.767241379310345
1868,Dan Ndoye,SUI,"FW,MF",Nice,Ligue 1,19,2000,6.1,7,6,3,4,0,1,8,12.5,7,4,0,4,7,14,4,0,0,2020-2021,1.1475409836065575,1.1475409836065575
1869,Paul Nebel,GER,"MF,FW",Mainz 05,Bundesliga,17,2002,0.6,1,1,0,1,0,0,1,0.0,1,0,0,0,2,3,0,0,0,2020-2021,3.3333333333333335,1.6666666666666667
1870,Álvaro Negredo,ESP,FW,Cádiz,La Liga,34,1985,24.4,11,5,3,4,4,5,11,45.5,6,7,2,5,3,14,19,0,0,2020-2021,0.12295081967213116,0.45081967213114754
1871,Reiss Nelson,ENG,"FW,MF",Arsenal,Premier League,20,1999,0.8,1,0,0,0,1,0,0,0.0,0,0,0,0,1,2,1,0,0,2020-2021,1.25,1.25
1872,Ilija Nestorovski,MKD,"FW,MF",Udinese,Serie A,30,1990,7.8,6,4,2,3,1,2,13,15.4,11,5,0,5,1,7,7,0,0,2020-2021,0.12820512820512822,0.7692307692307693
1873,Neto,BRA,GK,Barcelona,La Liga,31,1989,7.0,0,0,0,0,0,0,1,0.0,1,0,0,0,0,0,3,1,0,2020-2021,0.0,0.0
1874,Pedro Neto,POR,"FW,MF",Wolves,Premier League,20,2000,28.3,16,9,4,6,6,6,28,21.4,22,18,2,16,31,47,8,0,0,2020-2021,1.0954063604240283,0.5653710247349824
1875,Luca Netz,GER,"DF,FW",Hertha BSC,Bundesliga,17,2003,3.4,14,8,12,2,0,6,17,35.3,11,3,0,3,6,20,8,0,0,2020-2021,1.7647058823529411,4.11764705882353
Rk,Player,Nation,Pos,Squad,Comp,0,0,90.0,0,0,3,3,3,Tkl,0,0.0,0,0,0,0,0,0,0,0,0,2020-2021,0.0,0.0
1876,Manuel Neuer,GER,GK,Bayern Munich,Bundesliga,34,1986,33.0,0,0,0,0,0,0,1,0.0,1,0,0,0,2,2,12,3,0,2020-2021,0.06060606060606061,0.0
1877,Florian Neuhaus,GER,MF,Gladbach,Bundesliga,23,1997,29.1,48,28,19,26,3,19,63,30.2,44,35,7,28,50,98,20,1,0,2020-2021,1.7182130584192439,1.6494845360824741
1878,Carlos Neva,ESP,DF,Granada,La Liga,24,1996,20.0,12,6,6,6,0,6,11,54.5,5,16,4,12,27,39,58,0,0,2020-2021,1.35,0.6
1879,Rúben Neves,POR,MF,Wolves,Premier League,23,1997,29.7,86,46,42,38,6,36,88,40.9,52,55,11,44,65,151,46,2,0,2020-2021,2.1885521885521886,2.8956228956228958
1880,Neymar,BRA,"MF,FW",Paris S-G,Ligue 1,28,1992,15.7,14,11,1,6,7,8,37,21.6,29,8,0,8,9,23,0,0,0,2020-2021,0.5732484076433121,0.89171974522293
1881,Yvan Neyou,CMR,MF,Saint-Étienne,Ligue 1,23,1997,27.1,58,31,24,33,1,25,60,41.7,35,34,5,29,31,89,13,1,0,2020-2021,1.1439114391143912,2.140221402214022
1882,Jessic Ngankam,GER,FW,Hertha BSC,Bundesliga,20,2000,3.3,5,2,1,2,2,1,3,33.3,2,6,1,5,0,5,1,0,0,2020-2021,0.0,1.5151515151515151
1883,Muzinga Ngonda,COD,DF,Dijon,Ligue 1,25,1994,25.6,59,40,37,21,1,30,50,60.0,20,28,3,25,72,131,58,0,0,2020-2021,2.8125,2.3046875
1884,Ahmad Ngouyamsa,CMR,DF,Dijon,Ligue 1,19,2000,1.7,6,4,5,1,0,4,8,50.0,4,2,1,1,2,8,8,0,0,2020-2021,1.1764705882352942,3.5294117647058822
1885,Opa Nguette,SEN,"FW,MF",Metz,Ligue 1,26,1994,12.6,15,8,2,8,5,3,10,30.0,7,14,2,12,1,16,1,0,0,2020-2021,0.07936507936507936,1.1904761904761905
1886,Moussa Niakhate,SEN,DF,Mainz 05,Bundesliga,24,1996,31.8,42,22,28,13,1,14,29,48.3,15,31,15,16,49,91,79,0,0,2020-2021,1.540880503144654,1.320754716981132
1887,Ibrahima Niane,SEN,FW,Metz,Ligue 1,21,1999,7.4,1,1,0,0,1,1,2,50.0,1,3,0,3,0,1,8,0,0,2020-2021,0.0,0.13513513513513511
1888,M'Baye Niang,SEN,FW,Rennes,Ligue 1,25,1994,4.7,3,2,2,1,0,0,0,0.0,0,2,0,2,1,4,2,0,0,2020-2021,0.2127659574468085,0.6382978723404255
1889,Mamor Niang,SEN,"MF,FW",Getafe,La Liga,18,2002,0.2,1,1,0,1,0,0,0,0.0,0,1,0,1,0,1,0,0,0,2020-2021,0.0,5.0
1890,Tanguy Nianzou,FRA,"DF,FW",Bayern Munich,Bundesliga,18,2002,1.3,3,1,3,0,0,1,1,100.0,0,0,0,0,3,6,1,0,0,2020-2021,2.3076923076923075,2.3076923076923075
1891,Florian Niederlechner,GER,FW,Augsburg,Bundesliga,29,1990,19.3,7,5,1,4,2,0,10,0.0,10,8,3,5,10,17,18,0,0,2020-2021,0.5181347150259067,0.3626943005181347
1892,Nieto,ESP,"FW,DF",Cádiz,La Liga,22,1998,0.2,1,1,0,1,0,0,0,0.0,0,0,0,0,0,1,1,0,0,2020-2021,0.0,5.0
1893,Saúl Ñíguez,ESP,"MF,DF",Atlético Madrid,La Liga,25,1994,22.6,57,34,27,23,7,30,59,50.8,29,35,2,33,19,76,43,0,0,2020-2021,0.8407079646017699,2.5221238938053094
1894,Joakim Nilsson,SWE,DF,Arminia,Bundesliga,26,1994,24.0,36,24,23,12,1,14,23,60.9,9,29,22,7,39,75,111,0,0,2020-2021,1.625,1.5
1895,Casimir Ninga,CHA,FW,Angers,Ligue 1,27,1993,0.3,0,0,0,0,0,0,0,0.0,0,0,0,0,0,0,1,0,0,2020-2021,0.0,0.0
1896,Nino,ESP,"FW,MF",Elche,La Liga,40,1980,3.2,0,0,0,0,0,0,1,0.0,1,1,0,1,0,0,0,0,0,2020-2021,0.0,0.0
1897,Fernando Niño,ESP,FW,Villarreal,La Liga,19,2000,6.6,8,3,0,4,4,2,9,22.2,7,1,0,1,2,10,2,0,0,2020-2021,0.30303030303030304,1.2121212121212122
1898,Eddie Nketiah,ENG,FW,Arsenal,Premier League,21,1999,4.7,3,1,0,2,1,0,2,0.0,2,6,0,6,0,3,5,0,0,2020-2021,0.0,0.6382978723404255
1899,Nicolas Nkoulou,CMR,DF,Torino,Serie A,30,1990,15.1,14,9,11,3,0,7,12,58.3,5,28,14,14,33,47,71,1,0,2020-2021,2.185430463576159,0.9271523178807948
1900,Niels Nkounkou,FRA,"DF,FW",Everton,Premier League,19,2000,0.9,4,3,1,2,1,3,8,37.5,5,4,0,4,0,4,4,0,0,2020-2021,0.0,4.444444444444445
Rk,Player,Nation,Pos,Squad,Comp,0,0,90.0,0,0,3,3,3,Tkl,0,0.0,0,0,0,0,0,0,0,0,0,2020-2021,0.0,0.0
1901,Christopher Nkunku,FRA,"FW,MF",RB Leipzig,Bundesliga,22,1997,21.0,16,11,3,7,6,8,18,44.4,10,27,1,26,9,25,14,0,0,2020-2021,0.42857142857142855,0.7619047619047619
1902,Dan Nlundulu,ENG,"FW,MF",Southampton,Premier League,21,1999,1.2,0,0,0,0,0,0,1,0.0,1,2,0,2,0,0,2,0,0,2020-2021,0.0,0.0
1903,Mark Noble,ENG,MF,West Ham,Premier League,33,1987,7.9,8,4,2,5,1,4,14,28.6,10,7,3,4,13,21,3,0,0,2020-2021,1.6455696202531644,1.0126582278481011
1904,Nolito,ESP,"MF,FW",Celta Vigo,La Liga,33,1986,28.9,70,36,30,30,10,32,92,34.8,60,46,2,44,22,92,19,0,0,2020-2021,0.7612456747404844,2.4221453287197234
1905,Arnaud Nordin,FRA,"MF,FW",Saint-Étienne,Ligue 1,22,1998,19.7,14,8,5,5,4,6,21,28.6,15,13,2,11,9,23,10,0,0,2020-2021,0.4568527918781726,0.7106598984771574
1906,Håvard Nordtveit,NOR,DF,Hoffenheim,Bundesliga,30,1990,7.8,6,2,5,1,0,6,8,75.0,2,4,2,2,13,19,42,0,0,2020-2021,1.6666666666666667,0.7692307692307693
1907,Will Norris,ENG,GK,Burnley,Premier League,26,1993,2.0,0,0,0,0,0,0,0,0.0,0,0,0,0,0,0,0,0,0,2020-2021,0.0,0.0
1908,Oliver Norwood,NIR,MF,Sheffield Utd,Premier League,29,1991,24.7,49,22,16,28,5,21,72,29.2,51,29,12,17,36,85,51,1,0,2020-2021,1.45748987854251,1.9838056680161944
1909,Olivier Ntcham,CMR,MF,Marseille,Ligue 1,24,1996,1.3,1,0,0,1,0,1,3,33.3,2,3,1,2,2,3,3,0,0,2020-2021,1.5384615384615383,0.7692307692307692
1910,Alexander Nübel,GER,GK,Bayern Munich,Bundesliga,23,1996,1.0,0,0,0,0,0,0,0,0.0,0,0,0,0,0,0,1,0,0,2020-2021,0.0,0.0
1911,Kasim Nuhu,GHA,DF,Hoffenheim,Bundesliga,25,1995,11.0,13,7,9,4,0,6,10,60.0,4,8,3,5,15,28,38,0,0,2020-2021,1.3636363636363635,1.1818181818181819
1912,Unai Núñez,ESP,DF,Athletic Club,La Liga,23,1997,23.4,23,12,16,7,0,10,15,66.7,5,19,14,5,32,55,110,0,0,2020-2021,1.3675213675213675,0.982905982905983
1913,Bram Nuytinck,NED,DF,Udinese,Serie A,30,1990,18.2,21,15,10,9,2,13,20,65.0,7,30,17,13,25,46,77,0,0,2020-2021,1.3736263736263736,1.153846153846154
1914,Kelechi Nwakali,NGA,"MF,FW",Huesca,La Liga,22,1998,1.6,4,3,1,2,1,0,4,0.0,4,1,0,1,1,5,1,0,0,2020-2021,0.625,2.5
1915,Simeon Nwankwo,NGA,FW,Crotone,Serie A,28,1992,32.7,9,2,2,6,1,3,22,13.6,19,21,5,16,6,15,51,0,0,2020-2021,0.18348623853211007,0.2752293577981651
1916,Gerzino Nyamsi,FRA,DF,Rennes,Ligue 1,23,1997,9.7,12,10,2,8,2,4,6,66.7,2,8,5,3,10,22,32,1,0,2020-2021,1.0309278350515465,1.2371134020618557
1917,Allan Nyom,CMR,"MF,DF",Getafe,La Liga,32,1988,25.8,38,23,14,19,5,15,30,50.0,15,16,2,14,22,60,42,0,0,2020-2021,0.8527131782945736,1.4728682170542635
1918,M'Bala Nzola,ANG,FW,Spezia,Serie A,23,1996,21.1,12,5,2,6,4,4,7,57.1,3,15,1,14,3,15,20,0,0,2020-2021,0.14218009478672985,0.5687203791469194
1919,Steven Nzonzi,FRA,MF,Rennes,Ligue 1,31,1988,32.3,34,16,15,16,3,12,31,38.7,19,24,10,14,16,50,26,0,0,2020-2021,0.49535603715170284,1.0526315789473686
1920,Jack O'Connell,ENG,DF,Sheffield Utd,Premier League,26,1994,2.0,3,1,1,1,1,0,1,0.0,1,4,3,1,2,5,7,0,0,2020-2021,1.0,1.5
1921,Dara O'Shea,IRL,DF,West Brom,Premier League,21,1999,23.4,45,25,30,13,2,21,45,46.7,24,32,17,15,45,90,108,0,0,2020-2021,1.9230769230769231,1.9230769230769231
1922,Michael Obafemi,IRL,FW,Southampton,Premier League,20,2000,0.7,1,0,0,1,0,0,1,0.0,1,1,0,1,0,1,0,0,0,2020-2021,0.0,1.4285714285714286
1923,Pedro Obiang,EQG,MF,Sassuolo,Serie A,28,1992,16.3,35,22,17,15,3,12,35,34.3,23,26,7,19,22,57,27,0,0,2020-2021,1.3496932515337423,2.147239263803681
1924,Jan Oblak,SVN,GK,Atlético Madrid,La Liga,27,1993,38.0,0,0,0,0,0,0,0,0.0,0,0,0,0,0,0,6,2,0,2020-2021,0.0,0.0
1925,Lucas Ocampos,ARG,FW,Sevilla,La Liga,26,1994,29.2,36,24,12,16,8,13,37,35.1,24,33,1,32,19,55,30,1,0,2020-2021,0.6506849315068494,1.2328767123287672
Rk,Player,Nation,Pos,Squad,Comp,0,0,90.0,0,0,3,3,3,Tkl,0,0.0,0,0,0,0,0,0,0,0,0,2020-2021,0.0,0.0
1926,Bastian Oczipka,GER,"DF,FW",Schalke 04,Bundesliga,31,1989,21.4,33,20,22,10,1,7,21,33.3,14,22,4,18,24,57,41,0,0,2020-2021,1.1214953271028039,1.5420560747663552
1927,Brian Oddei,ITA,"FW,MF",Sassuolo,Serie A,17,2002,0.5,2,1,1,1,0,2,3,66.7,1,1,0,1,0,2,1,0,0,2020-2021,0.0,4.0
1928,Denis Odoi,GHA,DF,Fulham,Premier League,32,1988,3.0,3,3,2,1,0,1,4,25.0,3,3,1,2,5,8,5,0,0,2020-2021,1.6666666666666667,1.0
1929,Álvaro Odriozola,ESP,DF,Real Madrid,La Liga,24,1995,9.2,14,7,5,8,1,3,5,60.0,2,6,3,3,6,20,12,1,0,2020-2021,0.6521739130434783,1.5217391304347827
1930,Angelo Ogbonna,ITA,DF,West Ham,Premier League,32,1988,27.7,26,13,20,5,1,9,17,52.9,8,25,11,14,30,56,119,0,0,2020-2021,1.0830324909747293,0.9386281588447654
1931,Stefano Okaka,ITA,FW,Udinese,Serie A,30,1989,16.5,10,7,2,5,3,2,10,20.0,8,7,1,6,2,12,19,0,0,2020-2021,0.12121212121212122,0.6060606060606061
1932,Shinji Okazaki,JPN,"FW,MF",Huesca,La Liga,34,1986,12.5,7,5,5,0,2,0,5,0.0,5,5,0,5,4,11,6,0,0,2020-2021,0.32,0.56
1933,Masaya Okugawa,JPN,MF,Arminia,Bundesliga,24,1996,10.2,17,8,5,11,1,6,14,42.9,8,17,2,15,8,25,5,0,0,2020-2021,0.7843137254901962,1.6666666666666667
1934,Lucas Olaza,URU,DF,Valladolid,La Liga,26,1994,14.0,20,9,11,7,2,9,17,52.9,8,15,7,8,15,35,38,0,0,2020-2021,1.0714285714285714,1.4285714285714286
1935,Lucas Olaza,URU,DF,Celta Vigo,La Liga,26,1994,17.9,25,16,12,12,1,10,18,55.6,8,15,1,14,24,49,34,0,0,2020-2021,1.340782122905028,1.3966480446927376
1936,Christian Oliva,URU,MF,Cagliari,Serie A,24,1996,4.3,10,4,6,3,1,6,17,35.3,11,11,1,10,8,18,7,0,0,2020-2021,1.8604651162790697,2.3255813953488373
1937,Christian Oliva,URU,MF,Valencia,La Liga,24,1996,2.2,2,0,1,1,0,1,6,16.7,5,1,0,1,6,8,0,0,0,2020-2021,2.727272727272727,0.9090909090909091
1938,Kiko Olivas,ESP,DF,Valladolid,La Liga,31,1988,2.0,3,2,2,1,0,3,5,60.0,2,2,2,0,7,10,3,0,0,2020-2021,3.5,1.5
1939,Paulo Oliveira,POR,DF,Eibar,La Liga,28,1992,29.3,42,21,32,8,2,19,36,52.8,17,39,14,25,59,101,112,0,0,2020-2021,2.0136518771331056,1.4334470989761092
1940,Mathías Olivera,URU,DF,Getafe,La Liga,22,1997,29.0,61,33,31,21,9,32,56,57.1,24,33,3,30,31,92,55,0,0,2020-2021,1.0689655172413792,2.103448275862069
1941,Maximiliano Olivera,URU,DF,Fiorentina,Serie A,28,1992,1.0,2,0,1,1,0,1,1,100.0,0,3,1,2,0,2,8,0,0,2020-2021,0.0,2.0
1942,Dani Olmo,ESP,MF,RB Leipzig,Bundesliga,22,1998,24.4,23,14,6,13,4,4,23,17.4,19,15,0,15,13,36,21,0,0,2020-2021,0.5327868852459017,0.9426229508196722
1943,Robin Olsen,SWE,GK,Everton,Premier League,30,1990,7.0,0,0,0,0,0,0,0,0.0,0,0,0,0,0,0,4,1,0,2020-2021,0.0,0.0
1944,Jonas Omlin,SUI,GK,Montpellier,Ligue 1,26,1994,29.7,1,1,1,0,0,1,4,25.0,3,0,0,0,0,1,9,1,0,2020-2021,0.0,0.03367003367003367
1945,Jérôme Onguéné,CMR,DF,Genoa,Serie A,22,1997,2.0,2,1,2,0,0,2,7,28.6,5,2,0,2,2,4,8,0,0,2020-2021,1.0,1.0
1946,Karim Onisiwo,AUT,"FW,MF",Mainz 05,Bundesliga,28,1992,20.5,31,20,7,15,9,14,23,60.9,9,20,1,19,5,36,12,0,0,2020-2021,0.24390243902439024,1.5121951219512195
1947,Josh Onomah,ENG,MF,Fulham,Premier League,23,1997,4.2,11,8,1,6,4,0,5,0.0,5,4,2,2,2,13,1,0,0,2020-2021,0.47619047619047616,2.619047619047619
1948,Javier Ontiveros,ESP,"FW,MF",Huesca,La Liga,22,1997,10.2,21,14,10,10,1,9,26,34.6,17,12,0,12,9,30,6,0,0,2020-2021,0.8823529411764707,2.058823529411765
1949,Henry Onyekuru,NGA,FW,Monaco,Ligue 1,23,1997,1.6,1,0,1,0,0,1,4,25.0,3,1,0,1,0,1,0,0,0,2020-2021,0.0,0.625
1950,Willi Orban,HUN,DF,RB Leipzig,Bundesliga,27,1992,26.3,40,26,19,15,6,23,37,62.2,14,29,20,9,40,80,74,0,0,2020-2021,1.520912547528517,1.520912547528517
Rk,Player,Nation,Pos,Squad,Comp,0,0,90.0,0,0,3,3,3,Tkl,0,0.0,0,0,0,0,0,0,0,0,0,2020-2021,0.0,0.0
1951,Fabián Orellana,CHI,"MF,FW",Valladolid,La Liga,34,1986,23.8,33,19,12,14,7,12,55,21.8,43,18,0,18,15,48,9,0,0,2020-2021,0.6302521008403361,1.3865546218487395
1952,Divock Origi,BEL,FW,Liverpool,Premier League,25,1995,2.1,3,2,0,2,1,1,3,33.3,2,5,1,4,1,4,2,0,0,2020-2021,0.47619047619047616,1.4285714285714286
1953,Riccardo Orsolini,ITA,"FW,MF",Bologna,Serie A,23,1997,19.5,37,18,13,12,12,16,39,41.0,23,22,3,19,10,47,22,0,0,2020-2021,0.5128205128205128,1.8974358974358974
1954,Stefan Ortega,GER,GK,Arminia,Bundesliga,27,1992,34.0,2,1,2,0,0,2,6,33.3,4,0,0,0,0,2,12,3,0,2020-2021,0.0,0.058823529411764705
1955,Yuya Osako,JPN,"MF,FW",Werder Bremen,Bundesliga,30,1990,8.5,12,8,2,5,5,2,9,22.2,7,6,1,5,5,17,7,0,0,2020-2021,0.5882352941176471,1.411764705882353
1956,Ben Osborn,ENG,"MF,DF",Sheffield Utd,Premier League,25,1994,17.8,33,18,15,10,8,13,40,32.5,27,20,3,17,12,45,17,0,0,2020-2021,0.6741573033707865,1.8539325842696628
1957,Victor Osimhen,NGA,FW,Napoli,Serie A,21,1998,17.5,22,15,2,6,14,3,15,20.0,12,6,0,6,7,29,10,0,0,2020-2021,0.4,1.2571428571428571
1958,Yordan Osorio,VEN,DF,Parma,Serie A,26,1994,20.1,22,14,13,9,0,9,24,37.5,15,30,18,12,53,75,77,1,0,2020-2021,2.6368159203980097,1.0945273631840795
1959,David Ospina,COL,GK,Napoli,Serie A,31,1988,16.0,0,0,0,0,0,0,0,0.0,0,0,0,0,0,0,4,0,0,2020-2021,0.0,0.0
1960,Owen Otasowie,USA,"MF,FW",Wolves,Premier League,19,2001,2.1,5,5,3,2,0,1,2,50.0,1,1,1,0,3,8,4,0,0,2020-2021,1.4285714285714286,2.380952380952381
1961,Otávio,BRA,MF,Bordeaux,Ligue 1,26,1994,17.3,54,31,33,19,2,26,55,47.3,29,20,5,15,26,80,36,0,0,2020-2021,1.5028901734104045,3.121387283236994
1962,Paulo Otávio,BRA,DF,Wolfsburg,Bundesliga,25,1994,19.3,60,40,32,22,6,34,62,54.8,28,51,7,44,42,102,59,0,0,2020-2021,2.176165803108808,3.1088082901554404
1963,Remi Oudin,FRA,"FW,MF",Bordeaux,Ligue 1,23,1996,26.9,34,16,22,7,5,15,36,41.7,21,22,2,20,51,85,40,1,0,2020-2021,1.895910780669145,1.2639405204460967
1964,Alexandre Oukidja,ALG,GK,Metz,Ligue 1,32,1988,34.0,0,0,0,0,0,0,1,0.0,1,1,0,1,0,0,17,3,0,2020-2021,0.0,0.0
1965,Zinédine Ould Khaled,FRA,MF,Angers,Ligue 1,20,2000,0.4,0,0,0,0,0,0,0,0.0,0,0,0,0,1,1,0,0,0,2020-2021,2.5,0.0
1966,Adam Ounas,ALG,"FW,MF",Crotone,Serie A,23,1996,13.3,9,4,4,4,1,0,7,0.0,7,12,1,11,3,12,4,0,0,2020-2021,0.22556390977443608,0.6766917293233082
1967,Adam Ounas,ALG,"MF,FW",Cagliari,Serie A,23,1996,3.4,3,2,3,0,0,0,11,0.0,11,5,0,5,3,6,0,0,0,2020-2021,0.8823529411764706,0.8823529411764706
1968,Thomas Ouwejan,NED,DF,Udinese,Serie A,23,1996,4.6,4,1,0,3,1,2,9,22.2,7,4,0,4,5,9,6,0,0,2020-2021,1.0869565217391306,0.8695652173913044
1969,Reece Oxford,ENG,DF,Augsburg,Bundesliga,21,1998,15.1,26,18,15,11,0,10,17,58.8,7,28,22,6,29,55,89,0,0,2020-2021,1.9205298013245033,1.7218543046357617
1970,Alex Oxlade-Chamberlain,ENG,"MF,FW",Liverpool,Premier League,26,1993,2.8,4,0,0,3,1,0,2,0.0,2,1,0,1,2,6,0,0,0,2020-2021,0.7142857142857143,1.4285714285714286
1971,Mikel Oyarzabal,ESP,"FW,MF",Real Sociedad,La Liga,23,1997,26.8,30,17,14,12,4,10,31,32.3,21,30,5,25,15,45,17,0,0,2020-2021,0.5597014925373134,1.1194029850746268
1972,Ambroise Oyongo,CMR,DF,Montpellier,Ligue 1,29,1991,6.2,13,6,10,3,0,9,15,60.0,6,3,2,1,8,21,26,1,0,2020-2021,1.2903225806451613,2.096774193548387
1973,Salih Özcan,TUR,MF,Köln,Bundesliga,22,1998,15.2,21,13,11,10,0,12,33,36.4,21,11,2,9,20,41,14,1,0,2020-2021,1.3157894736842106,1.381578947368421
1974,Levin Öztunalı,GER,"DF,FW",Mainz 05,Bundesliga,24,1996,8.4,24,18,14,8,2,8,17,47.1,9,15,0,15,15,39,16,0,0,2020-2021,1.7857142857142856,2.857142857142857
1975,Pablo,BRA,DF,Bordeaux,Ligue 1,29,1991,12.0,17,11,13,4,0,8,14,57.1,6,17,12,5,25,42,46,1,0,2020-2021,2.0833333333333335,1.4166666666666667
Rk,Player,Nation,Pos,Squad,Comp,0,0,90.0,0,0,3,3,3,Tkl,0,0.0,0,0,0,0,0,0,0,0,0,2020-2021,0.0,0.0
1976,Fernando Pacheco,ESP,GK,Alavés,La Liga,28,1992,37.2,2,0,2,0,0,2,4,50.0,2,0,0,0,2,4,19,0,0,2020-2021,0.05376344086021505,0.05376344086021505
1977,Jon Pacheco,ESP,DF,Real Sociedad,La Liga,19,2001,0.4,0,0,0,0,0,0,0,0.0,0,0,0,0,1,1,0,0,0,2020-2021,2.5,0.0
1978,Gonçalo Paciência,POR,FW,Schalke 04,Bundesliga,25,1994,8.3,8,3,4,1,3,4,16,25.0,12,4,1,3,1,9,3,0,0,2020-2021,0.12048192771084336,0.9638554216867469
1979,Daniele Padelli,ITA,GK,Inter,Serie A,34,1985,0.5,0,0,0,0,0,0,0,0.0,0,0,0,0,0,0,0,0,0,2020-2021,0.0,0.0
1980,Mattia Pagliuca,ITA,MF,Bologna,Serie A,18,2002,0.1,0,0,0,0,0,0,0,0.0,0,0,0,0,1,1,0,0,0,2020-2021,10.0,0.0
1981,Vincent Pajot,FRA,MF,Metz,Ligue 1,29,1990,10.2,35,20,19,11,5,10,18,55.6,8,9,2,7,42,77,11,0,0,2020-2021,4.11764705882353,3.431372549019608
1982,Rodrigo Palacio,ARG,FW,Bologna,Serie A,38,1982,27.8,13,6,2,3,8,1,15,6.7,14,18,0,18,7,20,29,0,0,2020-2021,0.2517985611510791,0.4676258992805755
1983,Exequiel Palacios,ARG,MF,Leverkusen,Bundesliga,21,1998,6.4,31,17,12,16,3,17,30,56.7,13,13,0,13,12,43,7,0,0,2020-2021,1.875,4.84375
1984,Helibelton Palacios,COL,DF,Elche,La Liga,27,1993,8.3,20,10,16,3,1,8,13,61.5,5,9,1,8,5,25,21,0,0,2020-2021,0.6024096385542168,2.4096385542168672
1985,Ante Palaversa,CRO,MF,Getafe,La Liga,20,2000,0.1,0,0,0,0,0,0,1,0.0,1,0,0,0,0,0,0,0,0,2020-2021,0.0,0.0
1986,Alberto Paleari,ITA,GK,Genoa,Serie A,27,1992,2.3,0,0,0,0,0,0,0,0.0,0,0,0,0,0,0,1,0,0,2020-2021,0.0,0.0
1987,Nicolas Pallois,FRA,DF,Nantes,Ligue 1,32,1987,30.8,58,36,42,14,2,38,72,52.8,34,44,20,24,37,95,155,1,0,2020-2021,1.2012987012987013,1.883116883116883
1988,Emerson Palmieri,ITA,DF,Chelsea,Premier League,25,1994,1.0,3,3,2,0,1,1,3,33.3,2,0,0,0,1,4,6,0,0,2020-2021,1.0,3.0
1989,Antonio Palumbo,ITA,MF,Sampdoria,Serie A,23,1996,0.1,0,0,0,0,0,0,1,0.0,1,0,0,0,0,0,0,0,0,2020-2021,0.0,0.0
1990,Martin Palumbo,NOR,MF,Udinese,Serie A,18,2002,0.7,0,0,0,0,0,0,0,0.0,0,5,0,5,1,1,0,0,0,2020-2021,1.4285714285714286,0.0
1991,Goran Pandev,MKD,"FW,MF",Genoa,Serie A,37,1983,15.6,9,5,1,6,2,4,10,40.0,6,6,0,6,2,11,7,1,0,2020-2021,0.12820512820512822,0.576923076923077
1992,Ivor Pandur,CRO,GK,Hellas Verona,Serie A,20,2000,3.7,0,0,0,0,0,0,0,0.0,0,0,0,0,0,0,0,0,0,2020-2021,0.0,0.0
1993,Jonathan Panzo,ENG,DF,Dijon,Ligue 1,19,2000,20.0,17,12,13,4,0,8,11,72.7,3,27,13,14,59,76,91,2,0,2020-2021,2.95,0.85
1994,Merveille Papela,GER,DF,Mainz 05,Bundesliga,19,2001,0.0,0,0,0,0,0,0,1,0.0,1,0,0,0,0,0,0,0,0,2020-2021,,
1995,Lucas Paquetá,BRA,MF,Lyon,Ligue 1,22,1997,25.3,70,36,30,28,12,23,66,34.8,43,28,3,25,20,90,16,1,0,2020-2021,0.7905138339920948,2.766798418972332
1996,Gaëtan Paquiez,FRA,DF,Nîmes,Ligue 1,26,1994,11.6,21,12,12,7,2,12,29,41.4,17,10,3,7,16,37,28,0,0,2020-2021,1.3793103448275863,1.8103448275862069
1997,Rubén Pardo,ESP,MF,Bordeaux,Ligue 1,27,1992,0.3,0,0,0,0,0,0,0,0.0,0,0,0,0,1,1,0,0,0,2020-2021,3.3333333333333335,0.0
1998,Leandro Paredes,ARG,MF,Paris S-G,Ligue 1,26,1994,14.5,30,18,12,15,3,19,39,48.7,20,17,5,12,17,47,13,1,0,2020-2021,1.1724137931034482,2.0689655172413794
1999,Daniel Parejo,ESP,MF,Villarreal,La Liga,31,1989,34.6,65,40,32,23,10,33,81,40.7,48,35,8,27,45,110,21,3,0,2020-2021,1.3005780346820808,1.8786127167630058
2000,Vittorio Parigini,ITA,"MF,DF",Genoa,Serie A,24,1996,0.6,5,2,4,0,1,0,1,0.0,1,0,0,0,0,5,0,0,0,2020-2021,0.0,8.333333333333334
Rk,Player,Nation,Pos,Squad,Comp,0,0,90.0,0,0,3,3,3,Tkl,0,0.0,0,0,0,0,0,0,0,0,0,2020-2021,0.0,0.0
2001,Marco Parolo,ITA,"DF,MF",Lazio,Serie A,35,1985,7.3,21,8,8,11,2,8,20,40.0,12,20,6,14,14,35,31,0,0,2020-2021,1.9178082191780823,2.8767123287671232
2002,Thomas Partey,GHA,MF,Arsenal,Premier League,27,1993,17.0,44,21,16,24,4,24,56,42.9,32,17,5,12,23,67,18,0,0,2020-2021,1.3529411764705883,2.588235294117647
2003,Thomas Partey,GHA,MF,Atlético Madrid,La Liga,27,1993,2.2,7,4,4,3,0,5,8,62.5,3,4,1,3,2,9,1,0,0,2020-2021,0.9090909090909091,3.1818181818181817
2004,Mario Pašalić,CRO,MF,Atalanta,Serie A,25,1995,12.5,26,15,5,17,4,12,19,63.2,7,12,1,11,8,34,6,0,0,2020-2021,0.64,2.08
2005,Felix Passlack,GER,DF,Dortmund,Bundesliga,22,1998,4.0,9,6,4,2,3,4,8,50.0,4,11,1,10,3,12,2,0,0,2020-2021,0.75,2.25
2006,Christian Pastina,ITA,DF,Benevento,Serie A,19,2001,1.3,0,0,0,0,0,0,1,0.0,1,1,0,1,1,1,8,0,0,2020-2021,0.7692307692307692,0.0
2007,Javier Pastore,ARG,"MF,FW",Roma,Serie A,31,1989,0.9,2,2,2,0,0,2,2,100.0,0,0,0,0,0,2,0,0,0,2020-2021,0.0,2.2222222222222223
2008,Patric,ESP,DF,Lazio,Serie A,27,1993,17.7,30,16,15,11,4,13,24,54.2,11,13,3,10,18,48,51,1,0,2020-2021,1.0169491525423728,1.6949152542372883
2009,Rui Patrício,POR,GK,Wolves,Premier League,32,1988,37.0,0,0,0,0,0,0,1,0.0,1,0,0,0,1,1,3,3,0,2020-2021,0.02702702702702703,0.0
2010,Paulinho,BRA,FW,Leverkusen,Bundesliga,20,2000,0.7,0,0,0,0,0,0,0,0.0,0,0,0,0,0,0,0,0,0,2020-2021,0.0,0.0
2011,Gabriel Paulista,BRA,DF,Valencia,La Liga,29,1990,30.2,17,11,9,5,3,6,17,35.3,11,32,27,5,59,76,132,3,0,2020-2021,1.9536423841059603,0.5629139072847682
2012,Benjamin Pavard,FRA,DF,Bayern Munich,Bundesliga,24,1996,21.6,44,27,20,16,8,23,40,57.5,17,29,5,24,48,92,31,1,0,2020-2021,2.222222222222222,2.0370370370370368
2013,Jiří Pavlenka,CZE,GK,Werder Bremen,Bundesliga,28,1992,34.0,2,0,2,0,0,2,2,100.0,0,0,0,0,1,3,17,4,0,2020-2021,0.029411764705882353,0.058823529411764705
2014,Vasileios Pavlidis,GRE,FW,Schalke 04,Bundesliga,17,2002,0.0,0,0,0,0,0,0,0,0.0,0,0,0,0,0,0,0,0,0,2020-2021,,
2015,Mateo Pavlović,BIH,DF,Angers,Ligue 1,30,1990,12.3,11,6,8,3,0,8,23,34.8,15,13,11,2,21,32,40,0,0,2020-2021,1.7073170731707317,0.8943089430894309
2016,Strahinja Pavlović,SRB,DF,Monaco,Ligue 1,19,2001,0.0,0,0,0,0,0,0,0,0.0,0,0,0,0,0,0,0,0,0,2020-2021,,
2017,Leonardo Pavoletti,ITA,FW,Cagliari,Serie A,31,1988,17.6,7,3,2,5,0,1,20,5.0,19,4,2,2,4,11,32,0,0,2020-2021,0.22727272727272727,0.3977272727272727
2018,Dimitri Payet,FRA,"FW,MF",Marseille,Ligue 1,33,1987,26.9,27,17,4,16,7,17,40,42.5,23,19,2,17,8,35,10,0,0,2020-2021,0.29739776951672864,1.0037174721189592
2019,Nehuén Paz,ARG,DF,Bologna,Serie A,27,1993,4.0,9,4,4,5,0,6,7,85.7,1,4,2,2,11,20,16,0,0,2020-2021,2.75,2.25
2020,Bailey Peacock-Farrell,NIR,GK,Burnley,Premier League,23,1996,4.0,0,0,0,0,0,0,0,0.0,0,0,0,0,0,0,0,0,0,2020-2021,0.0,0.0
2021,Mads Pedersen,DEN,DF,Augsburg,Bundesliga,23,1996,9.9,25,16,20,3,2,10,22,45.5,12,13,3,10,15,40,32,0,0,2020-2021,1.5151515151515151,2.525252525252525
2022,Alfonso Pedraza,ESP,DF,Villarreal,La Liga,24,1996,23.3,35,19,16,11,8,11,31,35.5,20,21,5,16,34,69,47,1,0,2020-2021,1.4592274678111588,1.502145922746781
2023,Pedri,ESP,MF,Barcelona,La Liga,17,2002,26.8,44,27,16,16,12,17,71,23.9,54,46,1,45,33,77,7,0,0,2020-2021,1.2313432835820894,1.6417910447761193
2024,Pedro,ESP,"MF,FW",Roma,Serie A,33,1987,17.7,22,14,6,11,5,7,35,20.0,28,10,0,10,9,31,2,1,0,2020-2021,0.5084745762711864,1.2429378531073447
2025,João Pedro,ITA,"FW,MF",Cagliari,Serie A,28,1992,36.1,13,6,2,6,5,2,27,7.4,25,32,6,26,13,26,28,0,0,2020-2021,0.3601108033240997,0.3601108033240997
Rk,Player,Nation,Pos,Squad,Comp,0,0,90.0,0,0,3,3,3,Tkl,0,0.0,0,0,0,0,0,0,0,0,0,2020-2021,0.0,0.0
2026,Gianluca Pegolo,ITA,GK,Sassuolo,Serie A,39,1981,1.0,0,0,0,0,0,0,0,0.0,0,0,0,0,0,0,1,0,0,2020-2021,0.0,0.0
2027,Peter Pekarík,SVK,DF,Hertha BSC,Bundesliga,33,1986,18.8,24,18,17,7,0,17,31,54.8,14,19,8,11,27,51,41,0,0,2020-2021,1.4361702127659575,1.276595744680851
2028,Yohann Pelé,FRA,GK,Marseille,Ligue 1,37,1982,1.0,0,0,0,0,0,0,0,0.0,0,0,0,0,0,0,0,0,0,2020-2021,0.0,0.0
2029,Graziano Pellè,ITA,FW,Parma,Serie A,35,1985,6.8,2,2,0,1,1,1,8,12.5,7,3,0,3,2,4,8,0,0,2020-2021,0.29411764705882354,0.29411764705882354
2030,Pietro Pellegri,ITA,"FW,MF",Monaco,Ligue 1,19,2001,2.6,2,1,0,2,0,0,0,0.0,0,1,0,1,0,2,0,0,0,2020-2021,0.0,0.7692307692307692
2031,Lorenzo Pellegrini,ITA,MF,Roma,Serie A,24,1996,28.9,40,24,13,20,7,21,60,35.0,39,37,2,35,42,82,23,1,0,2020-2021,1.453287197231834,1.384083044982699
2032,Luca Pellegrini,ITA,"DF,MF",Genoa,Serie A,21,1999,7.1,9,6,6,2,1,4,10,40.0,6,11,2,9,8,17,13,1,0,2020-2021,1.1267605633802817,1.267605633802817
2033,Facundo Pellistri,URU,"MF,FW",Alavés,La Liga,18,2001,6.0,8,5,2,4,2,3,13,23.1,10,0,0,0,4,12,3,0,0,2020-2021,0.6666666666666666,1.3333333333333333
2034,Andy Pelmard,FRA,DF,Nice,Ligue 1,20,2000,13.4,18,12,12,5,1,9,12,75.0,3,11,3,8,20,38,35,0,0,2020-2021,1.4925373134328357,1.3432835820895521
2035,Lee Peltier,ENG,DF,West Brom,Premier League,33,1986,2.5,9,4,8,1,0,4,4,100.0,0,1,1,0,1,10,11,0,0,2020-2021,0.4,3.6
2036,Federico Peluso,ITA,DF,Sassuolo,Serie A,36,1984,2.3,1,1,1,0,0,1,2,50.0,1,2,2,0,3,4,12,0,0,2020-2021,1.3043478260869565,0.4347826086956522
2037,Timothee Pembele,FRA,DF,Paris S-G,Ligue 1,17,2002,4.3,8,7,4,4,0,5,14,35.7,9,4,0,4,5,13,8,1,0,2020-2021,1.1627906976744187,1.8604651162790697
2038,Rubén Peña,ESP,DF,Villarreal,La Liga,29,1991,12.4,25,14,8,15,2,19,33,57.6,14,20,1,19,13,38,19,0,0,2020-2021,1.0483870967741935,2.0161290322580645
2039,Philipp Pentke,GER,GK,Hoffenheim,Bundesliga,35,1985,3.0,0,0,0,0,0,0,0,0.0,0,0,0,0,0,0,0,0,0,2020-2021,0.0,0.0
2040,Nicolas Pépé,CIV,FW,Arsenal,Premier League,25,1995,18.0,20,15,8,6,6,8,23,34.8,15,16,1,15,12,32,19,0,0,2020-2021,0.6666666666666666,1.1111111111111112
2041,Alberto Perea,ESP,MF,Cádiz,La Liga,29,1990,17.2,28,17,12,10,6,9,35,25.7,26,26,1,25,21,49,9,0,0,2020-2021,1.2209302325581395,1.627906976744186
2042,Andreas Pereira,BRA,"FW,MF",Lazio,Serie A,24,1996,6.0,5,0,1,3,1,2,12,16.7,10,6,0,6,1,6,4,0,0,2020-2021,0.16666666666666666,0.8333333333333334
2043,Danilo Pereira,POR,"MF,DF",Paris S-G,Ligue 1,28,1991,15.9,21,11,6,11,4,6,14,42.9,8,14,6,8,29,50,33,4,0,2020-2021,1.8238993710691824,1.320754716981132
2044,Mathias Pereira Lage,POR,"FW,MF",Angers,Ligue 1,23,1996,16.3,29,17,12,15,2,10,40,25.0,30,21,4,17,15,44,16,0,0,2020-2021,0.920245398773006,1.7791411042944785
2045,Matheus Pereira,POR,"MF,FW",West Brom,Premier League,24,1996,28.6,26,15,14,10,2,12,54,22.2,42,18,0,18,29,55,16,0,0,2020-2021,1.013986013986014,0.9090909090909091
2046,Pedro Pereira,POR,DF,Crotone,Serie A,22,1998,28.3,50,32,29,17,4,21,40,52.5,19,33,11,22,19,69,61,0,0,2020-2021,0.6713780918727915,1.7667844522968197
2047,Ricardo Pereira,POR,"DF,FW",Leicester City,Premier League,26,1993,10.7,31,22,16,8,7,14,35,40.0,21,24,1,23,15,46,23,0,0,2020-2021,1.4018691588785048,2.897196261682243
2048,Gastón Pereiro,URU,"MF,DF",Cagliari,Serie A,25,1995,3.0,3,1,2,1,0,1,2,50.0,1,2,0,2,1,4,2,1,0,2020-2021,0.3333333333333333,1.0
2049,Bruno Peres,BRA,DF,Roma,Serie A,30,1990,15.9,21,11,11,7,3,13,24,54.2,11,18,4,14,27,48,11,0,0,2020-2021,1.6981132075471699,1.320754716981132
2050,Roberto Pereyra,ARG,"MF,FW",Udinese,Serie A,29,1991,32.5,18,11,7,8,3,7,23,30.4,16,24,5,19,27,45,24,0,0,2020-2021,0.8307692307692308,0.5538461538461539
Rk,Player,Nation,Pos,Squad,Comp,0,0,90.0,0,0,3,3,3,Tkl,0,0.0,0,0,0,0,0,0,0,0,0,2020-2021,0.0,0.0
2051,Ayoze Pérez,ESP,"MF,FW",Leicester City,Premier League,27,1993,14.8,32,15,6,20,6,13,48,27.1,35,28,0,28,10,42,7,0,0,2020-2021,0.6756756756756757,2.162162162162162
2052,Carles Pérez,ESP,"MF,FW",Roma,Serie A,22,1998,8.6,9,4,3,6,0,6,31,19.4,25,9,0,9,6,15,1,0,0,2020-2021,0.6976744186046512,1.0465116279069768
2053,Iñigo Pérez,ESP,"MF,DF",Osasuna,La Liga,32,1988,15.0,20,10,9,6,5,10,16,62.5,6,12,0,12,15,35,8,1,0,2020-2021,1.0,1.3333333333333333
2054,Juan Pérez,ESP,GK,Osasuna,La Liga,24,1996,3.0,0,0,0,0,0,0,0,0.0,0,0,0,0,0,0,1,0,0,2020-2021,0.0,0.0
2055,Kike Pérez,ESP,MF,Valladolid,La Liga,23,1997,12.9,26,19,8,14,4,7,33,21.2,26,10,1,9,17,43,18,0,0,2020-2021,1.317829457364341,2.0155038759689923
2056,Lucas Pérez,ESP,FW,Alavés,La Liga,31,1988,19.5,6,2,3,3,0,2,10,20.0,8,6,1,5,2,8,5,0,0,2020-2021,0.10256410256410256,0.3076923076923077
2057,Luis Pérez,ESP,DF,Valladolid,La Liga,25,1995,14.4,33,17,16,17,0,18,30,60.0,12,26,8,18,14,47,54,1,0,2020-2021,0.9722222222222222,2.2916666666666665
2058,Manuel Perez,FRA,"MF,FW",Lens,Ligue 1,29,1991,1.4,1,0,1,0,0,0,8,0.0,8,2,0,2,2,3,2,0,0,2020-2021,1.4285714285714286,0.7142857142857143
2059,Nehuén Pérez,ARG,DF,Granada,La Liga,20,2000,8.2,6,3,6,0,0,4,6,66.7,2,5,4,1,12,18,33,0,0,2020-2021,1.4634146341463417,0.7317073170731708
2060,Mattia Perin,ITA,GK,Genoa,Serie A,27,1992,32.0,0,0,0,0,0,0,0,0.0,0,0,0,0,1,1,6,0,0,2020-2021,0.03125,0.0
2061,Ivan Perišić,CRO,"DF,FW",Inter,Serie A,31,1989,19.9,22,13,11,6,5,12,33,36.4,21,33,4,29,19,41,36,1,0,2020-2021,0.9547738693467337,1.105527638190955
2062,Romain Perraud,FRA,DF,Brest,Ligue 1,22,1997,34.9,60,34,42,16,2,24,45,53.3,21,36,3,33,45,105,76,0,0,2020-2021,1.2893982808022924,1.7191977077363898
2063,Lucas Perrin,FRA,DF,Marseille,Ligue 1,21,1998,3.4,7,4,4,3,0,5,12,41.7,7,5,4,1,8,15,16,0,0,2020-2021,2.3529411764705883,2.058823529411765
2064,Pavao Pervan,AUT,GK,Wolfsburg,Bundesliga,32,1987,2.0,0,0,0,0,0,0,0,0.0,0,0,0,0,0,0,1,0,0,2020-2021,0.0,0.0
2065,Matteo Pessina,ITA,MF,Atalanta,Serie A,23,1997,18.3,14,7,4,6,4,7,24,29.2,17,17,2,15,17,31,7,1,0,2020-2021,0.9289617486338797,0.7650273224043715
2066,Andrea Petagna,ITA,FW,Napoli,Serie A,25,1995,10.7,2,0,0,2,0,2,7,28.6,5,4,0,4,1,3,7,0,0,2020-2021,0.09345794392523366,0.1869158878504673
2067,Nils Petersen,GER,FW,Freiburg,Bundesliga,31,1988,14.5,11,7,2,6,3,3,21,14.3,18,25,1,24,9,20,28,0,0,2020-2021,0.6206896551724138,0.7586206896551724
2068,Lukas Petkov,BUL,MF,Augsburg,Bundesliga,19,2000,0.0,0,0,0,0,0,0,0,0.0,0,0,0,0,0,0,0,0,0,2020-2021,,
2069,Jacopo Petriccione,ITA,MF,Crotone,Serie A,25,1995,10.6,14,8,6,7,1,9,24,37.5,15,11,2,9,8,22,11,0,0,2020-2021,0.7547169811320755,1.3207547169811322
2070,Jens Petter Hauge,NOR,FW,Milan,Serie A,20,1999,5.9,7,4,3,3,1,6,10,60.0,4,4,0,4,1,8,3,0,0,2020-2021,0.1694915254237288,1.1864406779661016
2071,Germán Pezzella,ARG,DF,Fiorentina,Serie A,29,1991,30.5,34,20,22,12,0,18,32,56.3,14,26,14,12,36,70,109,1,0,2020-2021,1.180327868852459,1.1147540983606556
2072,Giuseppe Pezzella,ITA,DF,Parma,Serie A,22,1997,20.3,34,19,23,9,2,22,41,53.7,19,22,9,13,12,46,52,3,0,2020-2021,0.5911330049261083,1.6748768472906403
2073,Maximilian Philipp,GER,MF,Wolfsburg,Bundesliga,26,1994,12.3,15,6,3,6,6,5,21,23.8,16,17,0,17,6,21,3,0,0,2020-2021,0.4878048780487805,1.2195121951219512
2074,Rayan Philippe,FRA,FW,Dijon,Ligue 1,19,2000,1.0,3,1,1,1,1,2,2,100.0,0,0,0,0,0,3,0,0,0,2020-2021,0.0,3.0
2075,Romain Philippoteaux,FRA,"FW,MF",Nîmes,Ligue 1,32,1988,2.4,1,1,1,0,0,1,5,20.0,4,2,0,2,2,3,1,0,0,2020-2021,0.8333333333333334,0.4166666666666667
Rk,Player,Nation,Pos,Squad,Comp,0,0,90.0,0,0,3,3,3,Tkl,0,0.0,0,0,0,0,0,0,0,0,0,2020-2021,0.0,0.0
2076,Romain Philippoteaux,FRA,"MF,FW",Brest,Ligue 1,32,1988,6.5,11,6,6,3,2,6,9,66.7,3,4,0,4,10,21,2,0,0,2020-2021,1.5384615384615385,1.6923076923076923
2077,Kalvin Phillips,ENG,MF,Leeds United,Premier League,24,1995,27.0,74,38,38,29,7,26,62,41.9,36,49,14,35,45,119,53,3,0,2020-2021,1.6666666666666667,2.740740740740741
2078,Matt Phillips,SCO,MF,West Brom,Premier League,29,1991,20.3,15,8,4,11,0,7,23,30.4,16,32,4,28,10,25,32,1,0,2020-2021,0.49261083743842365,0.7389162561576355
2079,Nathaniel Phillips,ENG,DF,Liverpool,Premier League,23,1997,16.2,22,14,15,7,0,11,24,45.8,13,17,14,3,20,42,81,0,0,2020-2021,1.234567901234568,1.3580246913580247
2080,Jaden Philogene Bidace,ENG,FW,Aston Villa,Premier League,18,2002,0.0,0,0,0,0,0,0,0,0.0,0,0,0,0,0,0,0,0,0,2020-2021,,
2081,Krzysztof Piątek,POL,FW,Hertha BSC,Bundesliga,25,1995,18.1,9,4,1,7,1,3,22,13.6,19,11,0,11,6,15,14,0,0,2020-2021,0.3314917127071823,0.49723756906077343
2082,Pablo Piatti,ARG,"MF,FW",Elche,La Liga,31,1989,4.0,8,6,3,3,2,3,12,25.0,9,5,0,5,2,10,1,0,0,2020-2021,0.5,2.0
2083,Cristiano Piccini,ITA,DF,Atalanta,Serie A,27,1992,0.7,1,1,1,0,0,0,1,0.0,1,1,0,1,0,1,0,0,0,2020-2021,0.0,1.4285714285714286
2084,Cristiano Piccini,ITA,DF,Valencia,La Liga,27,1992,0.7,1,1,1,0,0,1,2,50.0,1,0,0,0,0,1,3,0,0,2020-2021,0.0,1.4285714285714286
2085,Roberto Piccoli,ITA,FW,Spezia,Serie A,19,2001,7.8,7,3,0,4,3,2,4,50.0,2,4,0,4,2,9,5,0,0,2020-2021,0.25641025641025644,0.8974358974358975
2086,Jordan Pickford,ENG,GK,Everton,Premier League,26,1994,30.5,0,0,0,0,0,0,2,0.0,2,2,0,2,3,3,16,4,0,2020-2021,0.09836065573770492,0.0
2087,Jérémy Pied,FRA,DF,Lille,Ligue 1,31,1989,3.5,7,0,3,3,1,4,9,44.4,5,3,1,2,6,13,8,0,0,2020-2021,1.7142857142857142,2.0
2088,Amos Pieper,GER,DF,Arminia,Bundesliga,22,1998,29.8,58,32,39,17,2,20,33,60.6,13,48,35,13,66,124,160,3,0,2020-2021,2.214765100671141,1.9463087248322146
2089,Ronaël Pierre-Gabriel,FRA,DF,Brest,Ligue 1,22,1998,25.6,60,40,42,16,2,35,52,67.3,17,17,7,10,30,90,57,0,0,2020-2021,1.171875,2.34375
2090,Erik Pieters,NED,"DF,MF",Burnley,Premier League,31,1988,14.1,30,21,18,9,3,19,39,48.7,20,30,9,21,12,42,34,0,0,2020-2021,0.851063829787234,2.127659574468085
2091,Tomás Pina Isla,ESP,MF,Alavés,La Liga,32,1987,28.6,39,18,18,16,5,16,42,38.1,26,28,8,20,37,76,42,0,0,2020-2021,1.2937062937062938,1.3636363636363635
2092,Andrea Pinamonti,ITA,FW,Inter,Serie A,21,1999,1.9,0,0,0,0,0,0,0,0.0,0,1,0,1,1,1,2,0,0,2020-2021,0.5263157894736842,0.0
2093,Yeremi Pino,ESP,"FW,MF",Villarreal,La Liga,17,2002,8.9,19,11,10,7,2,8,28,28.6,20,20,1,19,9,28,8,0,0,2020-2021,1.0112359550561798,2.134831460674157
2094,Carlo Pinsoglio,ITA,GK,Juventus,Serie A,30,1990,0.3,0,0,0,0,0,0,0,0.0,0,0,0,0,0,0,0,0,0,2020-2021,0.0,0.0
2095,Gerard Piqué,ESP,DF,Barcelona,La Liga,33,1987,16.5,16,11,11,5,0,9,12,75.0,3,9,4,5,26,42,46,0,0,2020-2021,1.5757575757575757,0.9696969696969697
2096,Fabio Pisacane,ITA,DF,Cagliari,Serie A,34,1986,2.5,3,2,2,1,0,3,7,42.9,4,8,5,3,1,4,9,1,0,2020-2021,0.4,1.2
2097,Łukasz Piszczek,POL,DF,Dortmund,Bundesliga,35,1985,5.1,10,7,6,4,0,5,12,41.7,7,5,1,4,5,15,12,0,0,2020-2021,0.9803921568627452,1.9607843137254903
2098,Marko Pjaca,CRO,"FW,MF",Genoa,Serie A,25,1995,15.8,13,6,6,3,4,4,16,25.0,12,7,2,5,7,20,12,0,0,2020-2021,0.4430379746835443,0.8227848101265822
2099,Miralem Pjanić,BIH,MF,Barcelona,La Liga,30,1990,7.0,13,8,7,4,2,7,13,53.8,6,5,1,4,11,24,5,0,0,2020-2021,1.5714285714285714,1.8571428571428572
2100,Óscar Plano,ESP,"MF,FW",Valladolid,La Liga,29,1991,28.0,42,24,24,12,6,14,46,30.4,32,35,6,29,34,76,43,0,0,2020-2021,1.2142857142857142,1.5
Rk,Player,Nation,Pos,Squad,Comp,0,0,90.0,0,0,3,3,3,Tkl,0,0.0,0,0,0,0,0,0,0,0,0,2020-2021,0.0,0.0
2101,Marvin Plattenhardt,GER,DF,Hertha BSC,Bundesliga,28,1992,11.9,15,10,6,7,2,5,9,55.6,4,9,1,8,1,16,19,1,0,2020-2021,0.08403361344537814,1.2605042016806722
2102,Alassane Pléa,FRA,FW,Gladbach,Bundesliga,27,1993,20.0,19,9,4,10,5,5,20,25.0,15,1,0,1,5,24,7,0,0,2020-2021,0.25,0.95
2103,Dani Plomer,ESP,FW,Granada,La Liga,21,1998,0.5,0,0,0,0,0,0,1,0.0,1,0,0,0,0,0,1,0,0,2020-2021,0.0,0.0
2104,Tommaso Pobega,ITA,MF,Spezia,Serie A,21,1999,13.7,24,13,7,13,4,11,31,35.5,20,10,2,8,9,33,22,0,0,2020-2021,0.6569343065693432,1.7518248175182483
2105,Daniel Podence,POR,"MF,FW",Wolves,Premier League,24,1995,18.5,12,6,5,5,2,2,19,10.5,17,5,1,4,13,25,2,0,0,2020-2021,0.7027027027027027,0.6486486486486487
2106,Paul Pogba,FRA,"MF,FW",Manchester Utd,Premier League,27,1993,21.1,36,26,15,16,5,11,33,33.3,22,24,2,22,26,62,37,0,0,2020-2021,1.2322274881516586,1.7061611374407581
2107,Joel Pohjanpalo,FIN,FW,Union Berlin,Bundesliga,25,1994,9.5,5,1,0,3,2,1,6,16.7,5,1,0,1,1,6,12,0,0,2020-2021,0.10526315789473684,0.5263157894736842
2108,Joel Pohjanpalo,FIN,MF,Leverkusen,Bundesliga,25,1994,0.1,0,0,0,0,0,0,0,0.0,0,0,0,0,0,0,0,0,0,2020-2021,0.0,0.0
2109,Andrea Poli,ITA,MF,Bologna,Serie A,30,1989,4.3,9,7,4,2,3,6,12,50.0,6,7,1,6,7,16,7,0,0,2020-2021,1.627906976744186,2.0930232558139537
2110,Matteo Politano,ITA,"FW,MF",Napoli,Serie A,26,1993,21.2,24,16,13,9,2,11,47,23.4,36,14,1,13,14,38,18,0,0,2020-2021,0.6603773584905661,1.1320754716981132
2111,Jorge Pombo,ESP,"FW,MF",Cádiz,La Liga,26,1994,5.8,7,3,3,2,2,1,8,12.5,7,2,0,2,2,9,3,0,0,2020-2021,0.3448275862068966,1.206896551724138
2112,Marin Pongračić,CRO,DF,Wolfsburg,Bundesliga,22,1997,6.4,13,9,9,3,1,6,8,75.0,2,12,5,7,11,24,27,0,0,2020-2021,1.71875,2.03125
2113,Pere Pons,ESP,MF,Alavés,La Liga,27,1993,13.2,20,10,8,8,4,5,16,31.3,11,15,2,13,7,27,10,0,0,2020-2021,0.5303030303030303,1.5151515151515151
2114,Nick Pope,ENG,GK,Burnley,Premier League,28,1992,32.0,1,1,1,0,0,0,1,0.0,1,0,0,0,2,3,29,2,0,2020-2021,0.0625,0.03125
2115,Manolo Portanova,ITA,"MF,FW",Genoa,Serie A,20,2000,0.7,3,3,1,1,1,0,2,0.0,2,3,1,2,1,4,2,0,0,2020-2021,1.4285714285714286,4.285714285714286
2116,Manolo Portanova,ITA,MF,Juventus,Serie A,20,2000,0.8,2,0,2,0,0,0,2,0.0,2,4,1,3,0,2,1,0,0,2020-2021,0.0,2.5
2117,Francisco Portillo,ESP,"MF,FW",Getafe,La Liga,30,1990,4.6,5,3,1,4,0,2,14,14.3,12,3,0,3,5,10,1,0,0,2020-2021,1.0869565217391306,1.0869565217391306
2118,Portu,ESP,"FW,MF",Real Sociedad,La Liga,28,1992,24.3,18,8,4,10,4,7,36,19.4,29,24,2,22,8,26,5,0,0,2020-2021,0.3292181069958848,0.7407407407407407
2119,Stefan Posch,AUT,DF,Hoffenheim,Bundesliga,23,1997,23.5,52,24,29,17,6,27,47,57.4,20,27,8,19,37,89,73,1,0,2020-2021,1.574468085106383,2.2127659574468086
2120,Sergio Postigo,ESP,DF,Levante,La Liga,31,1988,18.0,16,12,12,3,1,7,18,38.9,11,21,10,11,33,49,84,1,0,2020-2021,1.8333333333333333,0.8888888888888888
2121,Yussuf Poulsen,DEN,FW,RB Leipzig,Bundesliga,26,1994,15.0,10,6,1,6,3,1,17,5.9,16,16,0,16,6,16,13,0,0,2020-2021,0.4,0.6666666666666666
2122,Maxime Poundjé,FRA,DF,Bordeaux,Ligue 1,27,1992,5.5,10,7,9,1,0,2,6,33.3,4,7,3,4,11,21,5,0,0,2020-2021,2.0,1.8181818181818181
2123,Darío Poveda,ESP,FW,Getafe,La Liga,23,1997,0.1,0,0,0,0,0,0,0,0.0,0,1,0,1,0,0,0,0,0,2020-2021,0.0,0.0
2124,Ian Poveda,ENG,MF,Leeds United,Premier League,20,2000,3.9,5,4,3,0,2,1,7,14.3,6,5,1,4,1,6,2,0,0,2020-2021,0.25641025641025644,1.2820512820512822
2125,Alejandro Pozo Pozo,ESP,"DF,MF",Eibar,La Liga,21,1999,24.3,38,22,17,15,6,17,38,44.7,21,35,2,33,27,65,40,1,0,2020-2021,1.1111111111111112,1.5637860082304527
Rk,Player,Nation,Pos,Squad,Comp,0,0,90.0,0,0,3,3,3,Tkl,0,0.0,0,0,0,0,0,0,0,0,0,2020-2021,0.0,0.0
2126,Dennis Praet,BEL,MF,Leicester City,Premier League,26,1994,8.0,14,7,4,7,3,6,15,40.0,9,12,2,10,7,21,3,0,0,2020-2021,0.875,1.75
2127,Sanjin Prcić,BIH,MF,Strasbourg,Ligue 1,26,1993,3.9,3,2,0,3,0,2,5,40.0,3,4,3,1,4,7,2,1,0,2020-2021,1.0256410256410258,0.7692307692307693
2128,Nicolas de Préville,FRA,"FW,MF",Bordeaux,Ligue 1,29,1991,17.9,19,14,7,6,6,9,42,21.4,33,15,0,15,13,32,7,0,0,2020-2021,0.7262569832402235,1.0614525139664805
2129,Manuel Prietl,AUT,MF,Arminia,Bundesliga,28,1991,28.0,65,44,33,28,4,12,73,16.4,61,34,7,27,45,110,24,0,0,2020-2021,1.6071428571428572,2.3214285714285716
2130,Grischa Prömel,GER,MF,Union Berlin,Bundesliga,25,1995,20.2,39,23,14,23,2,18,34,52.9,16,20,2,18,24,63,22,0,0,2020-2021,1.188118811881188,1.9306930693069309
2131,Davy Pröpper,NED,MF,Brighton,Premier League,28,1991,2.4,6,5,0,6,0,2,5,40.0,3,3,0,3,1,7,0,0,0,2020-2021,0.4166666666666667,2.5
2132,Ivan Provedel,ITA,GK,Spezia,Serie A,26,1994,29.0,2,0,2,0,0,2,6,33.3,4,0,0,0,2,4,20,1,0,2020-2021,0.06896551724137931,0.06896551724137931
2133,Antonio Puertas,ESP,"FW,MF",Granada,La Liga,28,1992,24.1,27,13,9,12,6,10,32,31.3,22,24,5,19,12,39,25,0,0,2020-2021,0.49792531120331945,1.120331950207469
2134,Riqui Puig,ESP,"MF,FW",Barcelona,La Liga,20,1999,3.2,5,3,1,3,1,4,8,50.0,4,0,0,0,1,6,0,0,0,2020-2021,0.3125,1.5625
2135,Erick Pulgar,CHI,MF,Fiorentina,Serie A,26,1994,22.2,41,18,17,23,1,22,49,44.9,27,24,10,14,41,82,45,1,0,2020-2021,1.8468468468468469,1.8468468468468469
2136,Jorge Pulido,ESP,DF,Huesca,La Liga,29,1991,32.1,39,24,31,8,0,17,29,58.6,12,32,18,14,52,91,98,0,0,2020-2021,1.6199376947040498,1.2149532710280373
2137,Christian Pulisic,USA,"FW,MF",Chelsea,Premier League,21,1998,19.3,19,11,8,10,1,8,21,38.1,13,25,2,23,12,31,9,0,0,2020-2021,0.6217616580310881,0.9844559585492227
2138,Ignacio Pussetto,ARG,FW,Udinese,Serie A,24,1995,8.4,16,8,5,6,5,6,17,35.3,11,14,0,14,13,29,6,0,0,2020-2021,1.5476190476190474,1.9047619047619047
2139,Fabio Quagliarella,ITA,FW,Sampdoria,Serie A,37,1983,24.5,12,8,4,4,4,2,19,10.5,17,14,1,13,7,19,10,0,0,2020-2021,0.2857142857142857,0.4897959183673469
2140,Robin Quaison,SWE,"FW,MF",Mainz 05,Bundesliga,26,1993,16.4,14,6,3,6,5,7,14,50.0,7,10,0,10,13,27,10,0,0,2020-2021,0.7926829268292683,0.853658536585366
2141,Domingos Quina,POR,MF,Granada,La Liga,20,1999,3.8,5,5,1,3,1,3,6,50.0,3,8,0,8,2,7,0,0,0,2020-2021,0.5263157894736842,1.3157894736842106
2142,Quini,ESP,DF,Granada,La Liga,30,1989,13.2,33,22,23,7,3,19,36,52.8,17,15,6,9,15,48,39,0,0,2020-2021,1.1363636363636365,2.5
2143,Quique,ESP,"FW,MF",Eibar,La Liga,30,1990,1.9,0,0,0,0,0,0,1,0.0,1,2,0,2,0,0,0,0,0,2020-2021,0.0,0.0
2144,Dani Raba,ESP,"MF,FW",Villarreal,La Liga,24,1995,1.7,2,1,0,1,1,2,8,25.0,6,1,0,1,0,2,0,0,0,2020-2021,0.0,1.1764705882352942
2145,Simone Rabbi,ITA,"FW,DF",Bologna,Serie A,18,2001,0.4,0,0,0,0,0,0,1,0.0,1,0,0,0,0,0,0,0,0,2020-2021,0.0,0.0
2146,Adrien Rabiot,FRA,MF,Juventus,Serie A,25,1995,25.7,72,42,24,41,7,28,60,46.7,32,32,11,21,43,115,29,1,0,2020-2021,1.6731517509727627,2.8015564202334633
2147,Uroš Račić,SRB,MF,Valencia,La Liga,22,1998,24.3,38,22,16,16,6,16,54,29.6,38,33,11,22,26,64,54,0,0,2020-2021,1.0699588477366255,1.5637860082304527
2148,Anthony Racioppi,SUI,GK,Dijon,Ligue 1,21,1998,21.0,0,0,0,0,0,0,2,0.0,2,0,0,0,2,2,12,4,0,2020-2021,0.09523809523809523,0.0
2149,Nemanja Radoja,SRB,MF,Levante,La Liga,27,1993,12.5,23,15,12,10,1,5,19,26.3,14,9,3,6,19,42,12,1,0,2020-2021,1.52,1.84
2150,Nemanja Radonjić,SRB,FW,Marseille,Ligue 1,24,1996,4.4,6,5,1,2,3,2,12,16.7,10,8,0,8,3,9,1,0,0,2020-2021,0.6818181818181818,1.3636363636363635
Rk,Player,Nation,Pos,Squad,Comp,0,0,90.0,0,0,3,3,3,Tkl,0,0.0,0,0,0,0,0,0,0,0,0,2020-2021,0.0,0.0
2151,Nemanja Radonjić,SRB,"FW,MF",Hertha BSC,Bundesliga,24,1996,6.8,5,3,2,2,1,1,5,20.0,4,1,0,1,2,7,1,0,0,2020-2021,0.29411764705882354,0.7352941176470589
2152,Aleksandar Radovanović,SRB,DF,Lens,Ligue 1,26,1993,1.0,1,1,0,1,0,0,0,0.0,0,2,1,1,0,1,2,0,0,2020-2021,0.0,1.0
2153,Ivan Radovanović,SRB,"DF,MF",Genoa,Serie A,31,1988,24.8,18,15,13,5,0,12,31,38.7,19,39,21,18,37,55,114,2,0,2020-2021,1.4919354838709677,0.7258064516129032
2154,Ionuț Radu,ROU,GK,Inter,Serie A,23,1997,1.5,0,0,0,0,0,0,0,0.0,0,0,0,0,0,0,1,0,0,2020-2021,0.0,0.0
2155,Ștefan Radu,ROU,DF,Lazio,Serie A,33,1986,27.3,43,24,20,19,4,25,40,62.5,15,27,14,13,45,88,73,1,0,2020-2021,1.6483516483516483,1.575091575091575
2156,Rafael,BRA,GK,Spezia,Serie A,38,1982,2.3,0,0,0,0,0,0,0,0.0,0,0,0,0,0,0,0,0,0,2020-2021,0.0,0.0
2157,Rafinha,BRA,"MF,FW",Paris S-G,Ligue 1,27,1993,15.1,54,26,18,28,8,28,49,57.1,21,18,3,15,13,67,6,0,0,2020-2021,0.8609271523178809,3.576158940397351
2158,Antonio Raimondo,ITA,FW,Bologna,Serie A,16,2004,0.0,0,0,0,0,0,0,0,0.0,0,0,0,0,0,0,0,0,0,2020-2021,,
2159,Predrag Rajković,SRB,GK,Reims,Ligue 1,24,1995,36.5,2,1,2,0,0,2,5,40.0,3,1,0,1,2,4,17,3,0,2020-2021,0.0547945205479452,0.0547945205479452
2160,Ivan Rakitić,CRO,MF,Sevilla,La Liga,32,1988,24.8,32,18,18,10,4,12,41,29.3,29,19,4,15,26,58,29,1,0,2020-2021,1.0483870967741935,1.2903225806451613
2161,Jonás Ramalho,ESP,DF,Osasuna,La Liga,27,1993,3.4,5,4,4,0,1,1,3,33.3,2,3,0,3,2,7,7,0,0,2020-2021,0.5882352941176471,1.4705882352941178
2162,Benito Raman,BEL,"FW,MF",Schalke 04,Bundesliga,25,1994,13.8,19,13,11,6,2,6,29,20.7,23,11,0,11,5,24,5,0,0,2020-2021,0.36231884057971014,1.3768115942028984
2163,Gastón Ramírez,URU,"FW,MF",Sampdoria,Serie A,29,1990,10.8,31,15,10,17,4,8,27,29.6,19,19,3,16,4,35,13,0,0,2020-2021,0.37037037037037035,2.8703703703703702
2164,Sandro Ramírez,ESP,FW,Huesca,La Liga,25,1995,14.3,13,9,3,8,2,4,11,36.4,7,11,1,10,10,23,2,0,0,2020-2021,0.6993006993006993,0.9090909090909091
2165,Sergio Ramos,ESP,DF,Real Madrid,La Liga,34,1986,14.2,15,12,8,6,1,6,10,60.0,4,9,5,4,19,34,39,1,0,2020-2021,1.3380281690140845,1.0563380281690142
2166,Aaron Ramsdale,ENG,GK,Sheffield Utd,Premier League,22,1998,38.0,1,1,1,0,0,1,1,100.0,0,0,0,0,2,3,22,6,0,2020-2021,0.05263157894736842,0.02631578947368421
2167,Aaron Ramsey,WAL,MF,Juventus,Serie A,29,1990,12.1,22,14,8,13,1,8,25,32.0,17,13,2,11,7,29,8,2,0,2020-2021,0.578512396694215,1.8181818181818183
2168,Jacob Ramsey,ENG,MF,Aston Villa,Premier League,19,2001,7.0,10,5,3,4,3,2,12,16.7,10,13,6,7,4,14,5,0,0,2020-2021,0.5714285714285714,1.4285714285714286
2169,Kayne Ramsey,ENG,DF,Southampton,Premier League,19,2000,1.0,5,2,4,1,0,3,3,100.0,0,0,0,0,0,5,3,0,0,2020-2021,0.0,5.0
2170,Darren Randolph,IRL,GK,West Ham,Premier League,33,1987,3.0,0,0,0,0,0,0,0,0.0,0,0,0,0,0,0,1,0,0,2020-2021,0.0,0.0
2171,Andrea Ranocchia,ITA,DF,Inter,Serie A,32,1988,7.8,13,10,6,6,1,7,8,87.5,1,5,3,2,12,25,19,0,0,2020-2021,1.5384615384615385,1.6666666666666667
2172,Raphinha,BRA,"MF,FW",Leeds United,Premier League,23,1996,26.2,34,17,13,16,5,12,58,20.7,46,31,1,30,29,63,27,0,0,2020-2021,1.1068702290076335,1.297709923664122
2173,Raphinha,BRA,"FW,MF",Rennes,Ligue 1,23,1996,4.5,5,2,1,3,1,1,4,25.0,3,5,0,5,3,8,4,0,0,2020-2021,0.6666666666666666,1.1111111111111112
2174,Marcus Rashford,ENG,FW,Manchester Utd,Premier League,22,1997,32.4,18,9,2,8,8,7,27,25.9,20,22,2,20,8,26,10,0,0,2020-2021,0.2469135802469136,0.5555555555555556
2175,Milot Rashica,KVX,"FW,MF",Werder Bremen,Bundesliga,24,1996,16.2,24,12,11,11,2,12,23,52.2,11,7,0,7,4,28,6,0,0,2020-2021,0.2469135802469136,1.4814814814814816
Rk,Player,Nation,Pos,Squad,Comp,0,0,90.0,0,0,3,3,3,Tkl,0,0.0,0,0,0,0,0,0,0,0,0,2020-2021,0.0,0.0
2176,Giacomo Raspadori,ITA,"FW,MF",Sassuolo,Serie A,20,2000,13.7,5,3,1,1,3,0,4,0.0,4,13,5,8,2,7,9,0,0,2020-2021,0.14598540145985403,0.36496350364963503
2177,Federico Ravaglia,ITA,GK,Bologna,Serie A,20,1999,4.0,0,0,0,0,0,0,1,0.0,1,0,0,0,0,0,2,0,0,2020-2021,0.0,0.0
2178,Tim Ream,USA,DF,Fulham,Premier League,32,1987,7.0,12,5,9,3,0,8,11,72.7,3,8,5,3,6,18,26,1,0,2020-2021,0.8571428571428571,1.7142857142857142
2179,Ante Rebić,CRO,FW,Milan,Serie A,26,1993,19.7,26,9,4,8,14,8,37,21.6,29,21,1,20,7,33,17,0,0,2020-2021,0.3553299492385787,1.3197969543147208
2180,Arkadiusz Reca,POL,DF,Crotone,Serie A,25,1995,25.7,34,16,15,11,8,10,45,22.2,35,30,3,27,50,84,64,0,0,2020-2021,1.9455252918287937,1.3229571984435797
2181,Recio,ESP,MF,Eibar,La Liga,29,1991,8.2,17,5,4,8,5,8,18,44.4,10,6,0,6,4,21,1,0,0,2020-2021,0.48780487804878053,2.073170731707317
2182,Daishawn Redan,NED,"FW,MF",Hertha BSC,Bundesliga,19,2001,1.1,0,0,0,0,0,0,0,0.0,0,1,0,1,0,0,0,0,0,2020-2021,0.0,0.0
2183,Nathan Redmond,ENG,"MF,FW",Southampton,Premier League,26,1994,19.3,30,17,14,12,4,8,24,33.3,16,24,2,22,11,41,9,0,0,2020-2021,0.5699481865284974,1.5544041450777202
2184,Harrison Reed,ENG,MF,Fulham,Premier League,25,1995,25.0,63,38,28,28,7,29,73,39.7,44,34,11,23,50,113,31,1,0,2020-2021,2.0,2.52
2185,Vasco Regini,ITA,DF,Sampdoria,Serie A,29,1990,1.0,2,2,2,0,0,2,2,100.0,0,1,1,0,1,3,5,0,0,2020-2021,1.0,2.0
2186,Sergio Reguilón,ESP,DF,Tottenham,Premier League,23,1996,24.9,47,25,30,13,4,23,48,47.9,25,39,7,32,32,79,50,1,0,2020-2021,1.285140562248996,1.887550200803213
2187,Bobby Reid,JAM,"MF,FW",Fulham,Premier League,27,1993,26.4,31,15,17,10,4,18,39,46.2,21,19,5,14,21,52,39,0,0,2020-2021,0.7954545454545455,1.1742424242424243
2188,Pepe Reina,ESP,GK,Lazio,Serie A,37,1982,29.0,0,0,0,0,0,0,1,0.0,1,0,0,0,1,1,6,0,0,2020-2021,0.034482758620689655,0.0
2189,Jeff Reine-Adélaïde,FRA,"MF,FW",Nice,Ligue 1,22,1998,11.8,7,4,1,4,2,2,9,22.2,7,10,1,9,4,11,6,0,0,2020-2021,0.3389830508474576,0.5932203389830508
2190,Jeff Reine-Adélaïde,FRA,FW,Lyon,Ligue 1,22,1998,0.3,0,0,0,0,0,0,0,0.0,0,0,0,0,0,0,0,0,0,2020-2021,0.0,0.0
2191,Reinier,BRA,"MF,FW",Dortmund,Bundesliga,18,2002,2.9,9,4,6,1,2,2,4,50.0,2,4,1,3,2,11,0,0,0,2020-2021,0.6896551724137931,3.103448275862069
2192,Francisco Reis Ferreira,POR,DF,Valencia,La Liga,23,1997,2.0,1,1,1,0,0,0,3,0.0,3,0,0,0,0,1,6,0,0,2020-2021,0.0,0.5
2193,Rocco Reitz,GER,MF,Gladbach,Bundesliga,18,2002,0.7,3,2,0,3,0,2,2,100.0,0,3,1,2,1,4,1,0,0,2020-2021,1.4285714285714286,4.285714285714286
2194,Karim Rekik,NED,DF,Sevilla,La Liga,25,1994,7.3,7,5,2,5,0,1,4,25.0,3,8,3,5,6,13,17,0,0,2020-2021,0.8219178082191781,0.9589041095890412
2195,Álex Remiro,ESP,GK,Real Sociedad,La Liga,25,1995,38.0,0,0,0,0,0,0,1,0.0,1,0,0,0,3,3,14,0,0,2020-2021,0.07894736842105263,0.0
2196,Panagiotis Retsos,GRE,DF,Saint-Étienne,Ligue 1,21,1998,3.0,5,3,5,0,0,3,7,42.9,4,1,1,0,3,8,12,0,0,2020-2021,1.0,1.6666666666666667
2197,Marco Reus,GER,"MF,FW",Dortmund,Bundesliga,31,1989,25.3,33,16,9,16,8,9,33,27.3,24,22,2,20,14,47,13,0,0,2020-2021,0.5533596837944664,1.3043478260869565
2198,Elvis Rexhbeçaj,GER,"MF,FW",Köln,Bundesliga,22,1997,20.4,53,32,17,27,9,19,53,35.8,34,32,7,25,26,79,18,0,0,2020-2021,1.2745098039215688,2.5980392156862746
2199,Oriol Rey,ESP,MF,Valladolid,La Liga,22,1998,0.2,0,0,0,0,0,0,0,0.0,0,0,0,0,1,1,0,0,0,2020-2021,5.0,0.0
2200,Gio Reyna,USA,"MF,FW",Dortmund,Bundesliga,17,2002,22.0,24,13,9,8,7,9,25,36.0,16,14,1,13,10,34,11,0,0,2020-2021,0.45454545454545453,1.0909090909090908
Rk,Player,Nation,Pos,Squad,Comp,0,0,90.0,0,0,3,3,3,Tkl,0,0.0,0,0,0,0,0,0,0,0,0,2020-2021,0.0,0.0
2201,Baptiste Reynet,FRA,GK,Nîmes,Ligue 1,29,1990,38.0,2,1,2,0,0,2,4,50.0,2,1,0,1,1,3,9,2,0,2020-2021,0.02631578947368421,0.05263157894736842
2202,Bryan Reynolds,USA,DF,Roma,Serie A,19,2001,3.1,4,2,1,1,2,1,5,20.0,4,4,0,4,6,10,4,0,0,2020-2021,1.9354838709677418,1.2903225806451613
2203,Franck Ribéry,FRA,FW,Fiorentina,Serie A,37,1983,23.9,24,11,4,9,11,5,29,17.2,24,11,2,9,3,27,1,0,0,2020-2021,0.12552301255230125,1.00418410041841
2204,Federico Ricci,ITA,FW,Sassuolo,Serie A,26,1994,0.0,0,0,0,0,0,0,0,0.0,0,0,0,0,0,0,0,0,0,2020-2021,,
2205,Giacomo Ricci,ITA,DF,Parma,Serie A,23,1996,0.7,3,1,1,2,0,0,0,0.0,0,2,2,0,1,4,4,0,0,2020-2021,1.4285714285714286,4.285714285714286
2206,Matteo Ricci,ITA,MF,Spezia,Serie A,26,1994,24.8,40,23,14,24,2,27,52,51.9,25,24,4,20,34,74,13,0,0,2020-2021,1.3709677419354838,1.6129032258064515
2207,Declan Rice,ENG,MF,West Ham,Premier League,21,1999,32.0,59,35,33,25,1,21,51,41.2,30,39,11,28,59,118,41,0,0,2020-2021,1.84375,1.84375
2208,Chris Richards,USA,DF,Hoffenheim,Bundesliga,20,2000,10.5,19,8,12,6,1,10,16,62.5,6,13,4,9,21,40,40,1,0,2020-2021,2.0,1.8095238095238095
2209,Chris Richards,USA,DF,Bayern Munich,Bundesliga,20,2000,1.0,0,0,0,0,0,0,0,0.0,0,0,0,0,1,1,1,0,0,2020-2021,1.0,0.0
2210,Lewis Richardson,ENG,"FW,MF",Burnley,Premier League,17,2003,0.0,0,0,0,0,0,0,0,0.0,0,0,0,0,0,0,0,0,0,2020-2021,,
2211,Richarlison,BRA,FW,Everton,Premier League,23,1997,31.8,50,32,21,22,7,16,51,31.4,35,28,3,25,14,64,36,1,0,2020-2021,0.44025157232704404,1.572327044025157
2212,Marco Richter,GER,"FW,MF",Augsburg,Bundesliga,22,1997,15.7,17,9,3,12,2,7,23,30.4,16,10,0,10,6,23,9,0,0,2020-2021,0.3821656050955414,1.0828025477707006
2213,Mikel Rico,ESP,MF,Huesca,La Liga,35,1984,24.3,24,12,14,8,2,11,34,32.4,23,20,3,17,23,47,22,0,0,2020-2021,0.9465020576131687,0.9876543209876543
2214,Sergio Rico,ESP,GK,Paris S-G,Ligue 1,26,1993,9.0,0,0,0,0,0,0,0,0.0,0,0,0,0,0,0,1,0,0,2020-2021,0.0,0.0
2215,Jaïro Riedewald,NED,MF,Crystal Palace,Premier League,23,1996,20.2,34,15,13,17,4,16,36,44.4,20,39,7,32,29,63,25,0,0,2020-2021,1.4356435643564356,1.6831683168316833
2216,Emiliano Rigoni,ARG,MF,Elche,La Liga,27,1993,12.7,12,7,3,8,1,3,15,20.0,12,16,1,15,6,18,9,0,0,2020-2021,0.4724409448818898,0.9448818897637796
2217,Tomás Rincón,VEN,MF,Torino,Serie A,32,1988,31.6,68,38,27,33,8,36,71,50.7,35,32,7,25,31,99,44,0,0,2020-2021,0.9810126582278481,2.151898734177215
2218,Luis Rioja,ESP,"MF,FW",Alavés,La Liga,26,1993,23.2,21,14,11,7,3,7,39,17.9,32,23,1,22,20,41,30,0,0,2020-2021,0.8620689655172414,0.9051724137931034
2219,Renaud Ripart,FRA,"MF,FW",Nîmes,Ligue 1,27,1993,33.9,52,30,25,19,8,26,84,31.0,58,58,12,46,36,88,53,0,0,2020-2021,1.0619469026548674,1.5339233038348083
2220,Andrea Rispoli,ITA,DF,Crotone,Serie A,31,1988,7.2,6,3,2,3,1,2,7,28.6,5,12,3,9,5,11,15,1,0,2020-2021,0.6944444444444444,0.8333333333333333
2221,Mihailo Ristić,SRB,DF,Montpellier,Ligue 1,24,1995,24.8,45,22,25,13,7,28,44,63.6,16,30,9,21,26,71,57,0,0,2020-2021,1.0483870967741935,1.814516129032258
2222,Matt Ritchie,SCO,"DF,MF",Newcastle Utd,Premier League,30,1989,15.0,10,3,5,3,2,3,17,17.6,14,17,2,15,12,22,47,0,0,2020-2021,0.8,0.6666666666666666
2223,Maxence Rivera,FRA,"MF,FW",Saint-Étienne,Ligue 1,18,2002,2.7,12,10,6,4,2,4,10,40.0,6,5,0,5,1,13,0,0,0,2020-2021,0.37037037037037035,4.444444444444444
2224,Emmanuel Rivière,FRA,FW,Crotone,Serie A,30,1990,7.1,2,1,2,0,0,0,3,0.0,3,5,1,4,1,3,0,0,0,2020-2021,0.14084507042253522,0.28169014084507044
2225,Rober,ESP,"DF,MF",Levante,La Liga,25,1995,15.8,14,7,8,3,3,8,18,44.4,10,24,16,8,35,49,52,1,0,2020-2021,2.2151898734177213,0.8860759493670886
Rk,Player,Nation,Pos,Squad,Comp,0,0,90.0,0,0,3,3,3,Tkl,0,0.0,0,0,0,0,0,0,0,0,0,2020-2021,0.0,0.0
2226,Roberto,ESP,GK,Valladolid,La Liga,34,1986,13.0,0,0,0,0,0,0,1,0.0,1,0,0,0,0,0,7,0,0,2020-2021,0.0,0.0
2227,Sergi Roberto,ESP,"DF,FW",Barcelona,La Liga,28,1992,10.5,9,6,5,2,2,7,13,53.8,6,12,6,6,10,19,20,0,0,2020-2021,0.9523809523809523,0.8571428571428571
2228,Tyler Roberts,WAL,"MF,FW",Leeds United,Premier League,21,1999,14.9,15,13,1,11,3,5,22,22.7,17,17,2,15,9,24,12,0,0,2020-2021,0.6040268456375839,1.006711409395973
2229,Andrew Robertson,SCO,DF,Liverpool,Premier League,26,1994,37.6,46,34,23,18,5,28,57,49.1,29,39,9,30,21,67,79,1,0,2020-2021,0.5585106382978723,1.2234042553191489
2230,Antonee Robinson,USA,DF,Fulham,Premier League,22,1997,24.0,45,28,24,16,5,27,44,61.4,17,21,4,17,37,82,68,0,0,2020-2021,1.5416666666666667,1.875
2231,Callum Robinson,IRL,"FW,MF",West Brom,Premier League,25,1995,17.3,7,5,5,1,1,3,19,15.8,16,9,0,9,7,14,8,0,0,2020-2021,0.40462427745664736,0.40462427745664736
2232,Jack Robinson,ENG,DF,Sheffield Utd,Premier League,26,1993,9.7,14,6,8,5,1,6,11,54.5,5,10,4,6,9,23,42,0,0,2020-2021,0.9278350515463918,1.4432989690721651
2233,Joel Robles,ESP,GK,Betis,La Liga,30,1990,18.0,0,0,0,0,0,0,1,0.0,1,1,0,1,0,0,11,2,0,2020-2021,0.0,0.0
2234,Hal Robson-Kanu,WAL,FW,West Brom,Premier League,31,1989,6.2,2,1,1,0,1,0,1,0.0,1,2,0,2,2,4,7,0,0,2020-2021,0.3225806451612903,0.3225806451612903
2235,Marc Roca,ESP,MF,Bayern Munich,Bundesliga,23,1996,2.0,2,2,0,0,2,0,4,0.0,4,4,1,3,2,4,1,0,0,2020-2021,1.0,1.0
2236,Christopher Rocchia,FRA,"DF,FW",Marseille,Ligue 1,22,1998,0.2,1,0,1,0,0,0,2,0.0,2,0,0,0,0,1,1,0,0,2020-2021,0.0,5.0
2237,Rubén Rochina,ESP,MF,Levante,La Liga,29,1991,15.6,38,28,12,23,3,12,35,34.3,23,22,2,20,22,60,7,0,0,2020-2021,1.4102564102564104,2.435897435897436
2238,Marek Rodák,SVK,GK,Fulham,Premier League,23,1996,2.0,0,0,0,0,0,0,0,0.0,0,0,0,0,0,0,0,0,0,2020-2021,0.0,0.0
2239,Sebastian Rode,GER,MF,Eint Frankfurt,Bundesliga,29,1990,18.1,44,25,21,16,7,14,46,30.4,32,30,3,27,47,91,18,0,0,2020-2021,2.596685082872928,2.430939226519337
2240,Joe Rodon,WAL,DF,Tottenham,Premier League,22,1997,8.1,14,9,11,2,1,3,4,75.0,1,10,8,2,21,35,36,2,0,2020-2021,2.5925925925925926,1.7283950617283952
2241,Rodri,ESP,MF,Manchester City,Premier League,24,1996,30.5,72,40,24,40,8,33,66,50.0,33,23,9,14,36,108,54,3,0,2020-2021,1.180327868852459,2.360655737704918
2242,Rodri,ESP,"FW,MF",Betis,La Liga,20,2000,6.0,3,3,1,2,0,1,6,16.7,5,7,0,7,2,5,0,0,0,2020-2021,0.3333333333333333,0.5
2243,Rodrigo,ESP,"MF,FW",Leeds United,Premier League,29,1991,14.3,14,7,8,3,3,4,22,18.2,18,7,0,7,5,19,16,0,0,2020-2021,0.34965034965034963,0.979020979020979
2244,Kévin Rodrigues,POR,"DF,MF",Eibar,La Liga,26,1994,12.2,16,8,8,5,3,7,23,30.4,16,10,1,9,20,36,15,1,0,2020-2021,1.639344262295082,1.3114754098360657
2245,Ángel Rodríguez,ESP,"FW,MF",Getafe,La Liga,33,1987,15.3,7,4,1,4,2,1,16,6.3,15,7,0,7,2,9,8,0,0,2020-2021,0.13071895424836602,0.45751633986928103
2246,Óscar Rodríguez Arnaiz,ESP,"MF,FW",Sevilla,La Liga,22,1998,5.7,15,9,3,8,4,6,13,46.2,7,2,0,2,10,25,1,0,0,2020-2021,1.7543859649122806,2.631578947368421
2247,Guido Rodríguez,ARG,MF,Betis,La Liga,26,1994,31.8,98,56,52,40,6,40,85,47.1,45,52,14,38,68,166,58,2,0,2020-2021,2.138364779874214,3.081761006289308
2248,James Rodríguez,COL,"FW,MF",Everton,Premier League,29,1991,19.6,28,17,8,15,5,11,46,23.9,35,17,0,17,15,43,3,0,0,2020-2021,0.7653061224489796,1.4285714285714284
2249,Jay Rodriguez,ENG,FW,Burnley,Premier League,31,1989,14.1,25,16,5,15,5,13,28,46.4,15,25,4,21,2,27,7,0,0,2020-2021,0.14184397163120568,1.773049645390071
2250,Miguel Rodríguez,ESP,"FW,DF",Celta Vigo,La Liga,17,2003,0.3,1,1,0,1,0,0,0,0.0,0,0,0,0,0,1,0,0,0,2020-2021,0.0,3.3333333333333335
Rk,Player,Nation,Pos,Squad,Comp,0,0,90.0,0,0,3,3,3,Tkl,0,0.0,0,0,0,0,0,0,0,0,0,2020-2021,0.0,0.0
2251,Ricardo Rodríguez,SUI,DF,Torino,Serie A,27,1992,13.8,21,14,11,8,2,13,22,59.1,9,16,5,11,20,41,43,0,0,2020-2021,1.4492753623188406,1.5217391304347825
2252,Víctor Rodríguez,ESP,MF,Elche,La Liga,31,1989,4.7,4,3,3,1,0,0,9,0.0,9,5,1,4,5,9,4,0,0,2020-2021,1.0638297872340425,0.851063829787234
2253,Rodrygo,BRA,FW,Real Madrid,La Liga,19,2001,10.9,15,6,10,4,1,2,17,11.8,15,15,0,15,7,22,4,0,0,2020-2021,0.6422018348623852,1.3761467889908257
2254,Marko Rog,CRO,MF,Cagliari,Serie A,25,1995,12.9,40,24,15,22,3,16,37,43.2,21,17,6,11,19,59,15,0,0,2020-2021,1.4728682170542635,3.1007751937984493
2255,Rogério,BRA,DF,Sassuolo,Serie A,22,1998,20.9,26,13,19,5,2,19,27,70.4,8,26,5,21,31,57,53,0,0,2020-2021,1.4832535885167466,1.244019138755981
2256,Luis Rojas,CHI,"MF,FW",Crotone,Serie A,18,2002,1.2,1,0,0,1,0,1,2,50.0,1,2,0,2,1,2,0,0,0,2020-2021,0.8333333333333334,0.8333333333333334
2257,Alessio Romagnoli,ITA,DF,Milan,Serie A,25,1995,21.2,17,7,8,7,2,8,19,42.1,11,29,22,7,24,41,80,0,0,2020-2021,1.1320754716981132,0.8018867924528302
2258,Cristian Romero,ARG,DF,Atalanta,Serie A,22,1998,28.3,63,32,41,19,3,27,49,55.1,22,31,13,18,96,159,71,2,0,2020-2021,3.392226148409894,2.2261484098939928
2259,Oriol Romeu,ESP,MF,Southampton,Premier League,28,1991,19.6,69,35,25,39,5,26,68,38.2,42,28,7,21,30,99,18,0,0,2020-2021,1.530612244897959,3.520408163265306
2260,Cristiano Ronaldo,POR,FW,Juventus,Serie A,35,1985,31.1,6,3,1,3,2,3,15,20.0,12,11,3,8,5,11,15,1,0,2020-2021,0.1607717041800643,0.19292604501607716
2261,Facundo Roncaglia,ARG,DF,Osasuna,La Liga,33,1987,13.7,25,14,14,11,0,11,20,55.0,9,11,6,5,25,50,26,0,0,2020-2021,1.8248175182481752,1.8248175182481752
2262,Valentin Rongier,FRA,MF,Marseille,Ligue 1,25,1994,21.0,93,59,31,55,7,43,85,50.6,42,32,2,30,28,121,21,1,0,2020-2021,1.3333333333333333,4.428571428571429
2263,Marten de Roon,NED,MF,Atalanta,Serie A,29,1991,33.6,80,48,30,36,14,36,84,42.9,48,44,9,35,69,149,40,0,0,2020-2021,2.0535714285714284,2.380952380952381
2264,Jérôme Roussillon,FRA,DF,Wolfsburg,Bundesliga,27,1993,13.7,24,12,14,8,2,11,20,55.0,9,10,1,9,19,43,28,0,0,2020-2021,1.3868613138686132,1.7518248175182483
2265,Nolan Roux,FRA,FW,Nîmes,Ligue 1,32,1988,7.2,7,3,1,4,2,3,8,37.5,5,6,0,6,5,12,4,0,0,2020-2021,0.6944444444444444,0.9722222222222222
2266,Nicolò Rovella,ITA,MF,Genoa,Serie A,18,2001,13.2,29,16,15,11,3,9,32,28.1,23,11,0,11,20,49,19,1,0,2020-2021,1.5151515151515151,2.1969696969696972
2267,Amir Rrahmani,KVX,DF,Napoli,Serie A,26,1994,12.2,13,8,7,6,0,6,9,66.7,3,17,14,3,8,21,39,1,0,2020-2021,0.6557377049180328,1.0655737704918034
2268,Rubén,ESP,GK,Osasuna,La Liga,36,1984,2.1,0,0,0,0,0,0,0,0.0,0,0,0,0,0,0,1,0,0,2020-2021,0.0,0.0
2269,Waldo Rubio,ESP,"FW,MF",Valladolid,La Liga,24,1995,4.2,6,4,2,2,2,1,14,7.1,13,6,0,6,3,9,3,0,0,2020-2021,0.7142857142857143,1.4285714285714286
2270,John Ruddy,ENG,GK,Wolves,Premier League,33,1986,1.0,0,0,0,0,0,0,0,0.0,0,0,0,0,0,0,0,0,0,2020-2021,0.0,0.0
2271,Antonio Rüdiger,GER,DF,Chelsea,Premier League,27,1993,19.0,31,23,16,14,1,12,15,80.0,3,17,10,7,18,49,51,0,0,2020-2021,0.9473684210526315,1.631578947368421
2272,Sebastian Rudy,GER,"MF,FW",Hoffenheim,Bundesliga,30,1990,18.6,35,26,15,15,5,16,45,35.6,29,24,4,20,13,48,21,1,0,2020-2021,0.6989247311827956,1.8817204301075268
2273,Sebastian Rudy,GER,DF,Schalke 04,Bundesliga,30,1990,2.0,4,2,2,0,2,4,7,57.1,3,6,4,2,1,5,4,0,0,2020-2021,0.5,2.0
2274,Kevin Rüegg,SUI,"DF,MF",Hellas Verona,Serie A,21,1998,2.3,0,0,0,0,0,0,0,0.0,0,3,0,3,2,2,3,0,0,2020-2021,0.8695652173913044,0.0
2275,Daniele Rugani,ITA,DF,Cagliari,Serie A,26,1994,11.1,24,11,10,12,2,10,20,50.0,10,15,10,5,15,39,46,0,0,2020-2021,1.3513513513513513,2.1621621621621623
Rk,Player,Nation,Pos,Squad,Comp,0,0,90.0,0,0,3,3,3,Tkl,0,0.0,0,0,0,0,0,0,0,0,0,2020-2021,0.0,0.0
2276,Daniele Rugani,ITA,DF,Rennes,Ligue 1,26,1994,1.0,0,0,0,0,0,0,1,0.0,1,1,1,0,1,1,1,0,0,2020-2021,1.0,0.0
2277,Matteo Ruggeri,ITA,DF,Atalanta,Serie A,18,2002,2.3,3,0,1,2,0,2,3,66.7,1,2,0,2,4,7,2,0,0,2020-2021,1.7391304347826089,1.3043478260869565
2278,Mário Rui,POR,DF,Napoli,Serie A,29,1991,18.5,24,13,17,6,1,17,33,51.5,16,17,4,13,28,52,29,1,0,2020-2021,1.5135135135135136,1.2972972972972974
2279,Aitor Ruibal,ESP,"FW,MF",Betis,La Liga,24,1996,17.7,32,18,14,14,4,10,35,28.6,25,26,0,26,11,43,8,0,0,2020-2021,0.6214689265536724,1.807909604519774
2280,Kays Ruiz Atil,FRA,"FW,MF",Paris S-G,Ligue 1,17,2002,2.1,1,1,0,1,0,0,4,0.0,4,1,0,1,3,4,2,0,0,2020-2021,1.4285714285714286,0.47619047619047616
2281,Isma Ruiz,ESP,MF,Granada,La Liga,19,2001,0.7,1,0,0,1,0,0,1,0.0,1,0,0,0,0,1,3,0,0,2020-2021,0.0,1.4285714285714286
2282,Fabián Ruiz Peña,ESP,MF,Napoli,Serie A,24,1996,28.5,58,31,26,21,11,25,70,35.7,45,33,3,30,36,94,32,1,0,2020-2021,1.263157894736842,2.0350877192982457
2283,Víctor Ruiz,ESP,DF,Betis,La Liga,31,1989,24.0,11,7,7,4,0,4,13,30.8,9,17,13,4,44,55,85,0,0,2020-2021,1.8333333333333333,0.4583333333333333
2284,Gerónimo Rulli,ARG,GK,Villarreal,La Liga,28,1992,2.0,0,0,0,0,0,0,0,0.0,0,0,0,0,0,0,0,1,0,2020-2021,0.0,0.0
2285,Georginio Rutter,FRA,"FW,MF",Rennes,Ligue 1,18,2002,0.5,2,2,0,1,1,1,3,33.3,2,2,0,2,0,2,0,0,0,2020-2021,0.0,4.0
2286,Georginio Rutter,FRA,FW,Hoffenheim,Bundesliga,18,2002,2.7,4,4,2,2,0,1,2,50.0,1,2,0,2,0,4,2,0,0,2020-2021,0.0,1.4814814814814814
2287,Mathew Ryan,AUS,GK,Arsenal,Premier League,28,1992,3.0,0,0,0,0,0,0,0,0.0,0,0,0,0,0,0,1,0,0,2020-2021,0.0,0.0
2288,Mathew Ryan,AUS,GK,Brighton,Premier League,28,1992,11.0,1,0,1,0,0,0,0,0.0,0,0,0,0,0,1,4,0,0,2020-2021,0.0,0.09090909090909091
2289,Julian Ryerson,NOR,"DF,MF",Union Berlin,Bundesliga,22,1997,11.9,22,15,4,14,4,12,15,80.0,3,13,0,13,11,33,17,0,0,2020-2021,0.9243697478991596,1.8487394957983192
2290,Frederik Rønnow,DEN,GK,Schalke 04,Bundesliga,27,1992,10.5,0,0,0,0,0,0,0,0.0,0,0,0,0,1,1,9,1,0,2020-2021,0.09523809523809523,0.0
2291,João Victor Santos Sá,BRA,FW,Wolfsburg,Bundesliga,26,1994,5.2,9,6,2,6,1,6,11,54.5,5,11,0,11,8,17,2,0,0,2020-2021,1.5384615384615383,1.7307692307692306
2292,Roli Pereira de Sa,FRA,"FW,MF",Nantes,Ligue 1,23,1996,0.6,4,3,1,3,0,3,4,75.0,1,2,0,2,0,4,0,0,0,2020-2021,0.0,6.666666666666667
2293,Idriss Saadi,ALG,"MF,FW",Strasbourg,Ligue 1,28,1992,1.4,0,0,0,0,0,0,2,0.0,2,0,0,0,0,0,0,0,0,2020-2021,0.0,0.0
2294,Youssouf Sabaly,SEN,DF,Bordeaux,Ligue 1,27,1993,32.3,47,33,24,17,6,27,45,60.0,18,31,8,23,49,96,57,2,0,2020-2021,1.51702786377709,1.455108359133127
2295,Mathys Saban,FRA,FW,Saint-Étienne,Ligue 1,18,2002,0.1,0,0,0,0,0,0,0,0.0,0,0,0,0,0,0,0,0,0,2020-2021,0.0,0.0
2296,Marcel Sabitzer,AUT,MF,RB Leipzig,Bundesliga,26,1994,22.5,29,21,12,16,1,12,37,32.4,25,7,2,5,35,64,27,0,0,2020-2021,1.5555555555555556,1.288888888888889
2297,Alexis Saelemaekers,BEL,FW,Milan,Serie A,21,1999,22.4,43,26,20,18,5,19,60,31.7,41,29,1,28,25,68,6,0,0,2020-2021,1.1160714285714286,1.9196428571428572
2298,Modibo Sagnan,MLI,DF,Real Sociedad,La Liga,21,1999,6.9,12,7,6,6,0,4,6,66.7,2,7,2,5,6,18,25,1,0,2020-2021,0.8695652173913043,1.7391304347826086
2299,Allan Saint-Maximin,FRA,"FW,MF",Newcastle Utd,Premier League,23,1997,17.3,16,9,6,9,1,4,9,44.4,5,10,0,10,4,20,2,0,0,2020-2021,0.23121387283236994,0.9248554913294798
2300,Borja Sainz,ESP,"MF,FW",Alavés,La Liga,19,2001,5.0,7,3,3,2,2,4,16,25.0,12,4,0,4,6,13,1,0,0,2020-2021,1.2,1.4
Rk,Player,Nation,Pos,Squad,Comp,0,0,90.0,0,0,3,3,3,Tkl,0,0.0,0,0,0,0,0,0,0,0,0,2020-2021,0.0,0.0
2301,Romain Saïss,MAR,DF,Wolves,Premier League,30,1990,26.7,35,24,23,12,0,19,33,57.6,14,28,13,15,52,87,115,1,0,2020-2021,1.9475655430711611,1.3108614232209739
2302,Bukayo Saka,ENG,"FW,MF",Arsenal,Premier League,18,2001,28.4,25,16,10,13,2,11,40,27.5,29,21,2,19,25,50,24,0,0,2020-2021,0.8802816901408451,0.8802816901408451
2303,Hiroki Sakai,JPN,DF,Marseille,Ligue 1,30,1990,26.5,81,48,34,35,12,39,51,76.5,12,21,5,16,54,135,65,0,0,2020-2021,2.0377358490566038,3.056603773584906
2304,Moïse Sakava,CMR,MF,Reims,Ligue 1,19,2000,0.1,0,0,0,0,0,0,0,0.0,0,0,0,0,0,0,0,0,0,2020-2021,0.0,0.0
2305,Mamadou Sakho,FRA,DF,Crystal Palace,Premier League,30,1990,3.1,3,2,1,2,0,3,3,100.0,0,3,2,1,3,6,11,0,0,2020-2021,0.9677419354838709,0.9677419354838709
2306,Jacopo Sala,ITA,DF,Spezia,Serie A,28,1991,4.2,17,9,14,1,2,8,22,36.4,14,5,2,3,5,22,6,0,0,2020-2021,1.1904761904761905,4.0476190476190474
2307,Mohamed Salah,EGY,FW,Liverpool,Premier League,28,1992,34.2,18,9,4,4,10,7,16,43.8,9,10,0,10,1,19,10,1,0,2020-2021,0.029239766081871343,0.5263157894736842
2308,Eddie Salcedo,ITA,"MF,FW",Hellas Verona,Serie A,18,2001,8.4,6,2,3,2,1,3,3,100.0,0,6,0,6,6,12,6,0,0,2020-2021,0.7142857142857143,0.7142857142857143
2309,William Saliba,FRA,DF,Nice,Ligue 1,19,2001,20.0,15,9,8,5,2,5,6,83.3,1,17,16,1,26,41,80,2,0,2020-2021,1.3,0.75
2310,Romain Salin,FRA,GK,Rennes,Ligue 1,36,1984,15.0,0,0,0,0,0,0,1,0.0,1,0,0,0,1,1,6,3,0,2020-2021,0.06666666666666667,0.0
2311,Mohammed Salisu,GHA,DF,Southampton,Premier League,21,1999,9.4,38,21,20,16,2,25,34,73.5,9,22,5,17,17,55,30,0,0,2020-2021,1.8085106382978722,4.042553191489362
2312,Roland Sallai,HUN,"MF,FW",Freiburg,Bundesliga,23,1997,18.5,18,14,7,9,2,5,13,38.5,8,11,1,10,11,29,8,0,0,2020-2021,0.5945945945945946,0.972972972972973
2313,Salvi,ESP,"MF,FW",Cádiz,La Liga,29,1991,21.5,18,10,14,3,1,8,26,30.8,18,14,1,13,20,38,24,0,0,2020-2021,0.9302325581395349,0.8372093023255814
2314,Lazar Samardzic,SRB,MF,RB Leipzig,Bundesliga,18,2002,2.2,10,7,4,6,0,5,13,38.5,8,6,0,6,2,12,1,0,0,2020-2021,0.9090909090909091,4.545454545454545
2315,Diadie Samassékou,MLI,MF,Hoffenheim,Bundesliga,24,1996,28.5,71,41,22,42,7,33,90,36.7,57,41,12,29,78,149,50,0,0,2020-2021,2.736842105263158,2.491228070175439
2316,Mama Samba Baldé,GNB,FW,Dijon,Ligue 1,24,1995,24.0,23,9,4,13,6,9,22,40.9,13,16,1,15,4,27,26,0,0,2020-2021,0.16666666666666666,0.9583333333333334
2317,Junior Sambia,FRA,"DF,MF",Montpellier,Ligue 1,23,1996,27.2,41,29,20,14,7,26,38,68.4,12,27,14,13,39,80,46,0,0,2020-2021,1.4338235294117647,1.5073529411764706
2318,Frédéric Sammaritano,FRA,"FW,MF",Dijon,Ligue 1,34,1986,12.6,15,10,9,5,1,9,26,34.6,17,6,0,6,9,24,3,0,0,2020-2021,0.7142857142857143,1.1904761904761905
2319,Fede San Emeterio,ESP,MF,Valladolid,La Liga,23,1997,16.2,25,14,15,7,3,11,31,35.5,20,23,8,15,28,53,33,0,0,2020-2021,1.7283950617283952,1.5432098765432098
2320,Antonio Sanabria,PAR,FW,Torino,Serie A,24,1996,10.9,8,3,0,4,4,2,9,22.2,7,5,0,5,5,13,8,0,0,2020-2021,0.4587155963302752,0.7339449541284403
2321,Antonio Sanabria,PAR,FW,Betis,La Liga,24,1996,10.4,5,5,0,4,1,0,2,0.0,2,8,1,7,3,8,9,0,0,2020-2021,0.28846153846153844,0.4807692307692307
2322,Oihan Sancet,ESP,"FW,MF",Athletic Club,La Liga,20,2000,11.5,8,2,3,4,1,2,7,28.6,5,4,0,4,5,13,7,0,0,2020-2021,0.43478260869565216,0.6956521739130435
2323,Renato Sanches,POR,MF,Lille,Ligue 1,22,1997,14.1,13,7,4,8,1,5,25,20.0,20,13,2,11,13,26,8,0,0,2020-2021,0.9219858156028369,0.9219858156028369
2324,Ricard Sánchez,ESP,DF,Atlético Madrid,La Liga,20,2000,0.3,1,1,0,0,1,0,0,0.0,0,1,0,1,0,1,1,0,0,2020-2021,0.0,3.3333333333333335
2325,Alexis Sánchez,CHI,FW,Inter,Serie A,31,1988,12.7,14,8,4,4,6,5,18,27.8,13,11,0,11,7,21,1,1,0,2020-2021,0.5511811023622047,1.1023622047244095
Rk,Player,Nation,Pos,Squad,Comp,0,0,90.0,0,0,3,3,3,Tkl,0,0.0,0,0,0,0,0,0,0,0,0,2020-2021,0.0,0.0
2326,Davinson Sánchez,COL,DF,Tottenham,Premier League,24,1996,16.5,40,20,31,9,0,21,32,65.6,11,18,13,5,14,54,85,2,0,2020-2021,0.8484848484848485,2.4242424242424243
2327,Germán Sánchez,ESP,DF,Granada,La Liga,33,1986,29.3,24,11,13,9,2,11,23,47.8,12,28,26,2,38,62,130,1,0,2020-2021,1.2969283276450512,0.8191126279863481
2328,Javi Sánchez,ESP,DF,Valladolid,La Liga,23,1997,10.2,15,10,10,4,1,9,10,90.0,1,15,7,8,15,30,37,0,0,2020-2021,1.4705882352941178,1.4705882352941178
2329,Manu Sánchez,ESP,DF,Osasuna,La Liga,19,2000,10.8,27,15,10,10,7,11,25,44.0,14,8,0,8,8,35,14,0,0,2020-2021,0.7407407407407407,2.5
2330,Manu Sánchez,ESP,DF,Atlético Madrid,La Liga,19,2000,0.5,0,0,0,0,0,0,1,0.0,1,1,0,1,0,0,1,0,0,2020-2021,0.0,0.0
2331,Juan Sánchez Miño,ARG,"DF,MF",Elche,La Liga,30,1990,5.5,8,5,5,3,0,6,14,42.9,8,4,0,4,4,12,7,0,0,2020-2021,0.7272727272727273,1.4545454545454546
2332,Pepe Sánchez,ESP,DF,Granada,La Liga,20,2000,2.8,4,2,2,2,0,3,4,75.0,1,5,2,3,4,8,9,0,0,2020-2021,1.4285714285714286,1.4285714285714286
2333,Robert Sánchez,ESP,GK,Brighton,Premier League,22,1997,27.0,1,0,1,0,0,1,1,100.0,0,1,0,1,1,2,11,2,0,2020-2021,0.037037037037037035,0.037037037037037035
2334,Jadon Sancho,ENG,"FW,MF",Dortmund,Bundesliga,20,2000,22.9,18,11,4,10,4,7,16,43.8,9,20,1,19,16,34,9,0,0,2020-2021,0.6986899563318778,0.7860262008733625
2335,Alex Sandro,BRA,DF,Juventus,Serie A,29,1991,20.6,37,23,19,13,5,13,25,52.0,12,20,4,16,31,68,57,0,0,2020-2021,1.5048543689320388,1.7961165048543688
2336,Leroy Sané,GER,"FW,MF",Bayern Munich,Bundesliga,24,1996,20.1,18,10,2,10,6,13,30,43.3,17,23,1,22,9,27,8,1,0,2020-2021,0.4477611940298507,0.8955223880597014
2337,Salif Sané,SEN,DF,Schalke 04,Bundesliga,29,1990,11.9,17,9,9,7,1,13,23,56.5,10,25,13,12,25,42,66,0,0,2020-2021,2.100840336134454,1.4285714285714286
2338,Oier Sanjurjo,ESP,MF,Osasuna,La Liga,34,1986,23.2,39,16,8,27,4,17,60,28.3,43,24,6,18,29,68,41,0,0,2020-2021,1.25,1.6810344827586208
2339,Mohamed Sankoh,NED,MF,Stuttgart,Bundesliga,16,2003,0.2,0,0,0,0,0,0,0,0.0,0,1,0,1,0,0,0,0,0,2020-2021,0.0,0.0
2340,Siriki Sanogo,CIV,MF,Benevento,Serie A,18,2001,0.1,0,0,0,0,0,0,0,0.0,0,0,0,0,0,0,0,0,0,2020-2021,0.0,0.0
2341,Morgan Sanson,FRA,MF,Aston Villa,Premier League,25,1994,3.3,7,4,4,2,1,1,4,25.0,3,5,0,5,4,11,1,0,0,2020-2021,1.2121212121212122,2.121212121212121
2342,Morgan Sanson,FRA,MF,Marseille,Ligue 1,25,1994,9.2,21,12,6,12,3,9,28,32.1,19,12,0,12,9,30,5,0,0,2020-2021,0.9782608695652175,2.2826086956521743
2343,Nicola Sansone,ITA,"FW,MF",Bologna,Serie A,28,1991,13.0,22,11,7,12,3,10,31,32.3,21,15,0,15,9,31,7,0,0,2020-2021,0.6923076923076923,1.6923076923076923
2344,Baptiste Santamaria,FRA,MF,Angers,Ligue 1,25,1995,3.0,9,6,3,5,1,2,7,28.6,5,4,0,4,7,16,8,0,0,2020-2021,2.3333333333333335,3.0
2345,Baptiste Santamaria,FRA,MF,Freiburg,Bundesliga,25,1995,24.5,51,38,19,24,8,20,54,37.0,34,36,7,29,52,103,34,1,0,2020-2021,2.122448979591837,2.0816326530612246
2346,Federico Santander,PAR,FW,Bologna,Serie A,29,1991,0.4,0,0,0,0,0,0,0,0.0,0,0,0,0,0,0,0,0,0,2020-2021,0.0,0.0
2347,Davide Santon,ITA,DF,Roma,Serie A,29,1991,6.5,4,3,2,2,0,3,7,42.9,4,10,1,9,4,8,12,0,0,2020-2021,0.6153846153846154,0.6153846153846154
2348,Samir Santos,BRA,DF,Udinese,Serie A,25,1994,24.6,40,23,26,12,2,13,29,44.8,16,33,17,16,58,98,60,1,0,2020-2021,2.357723577235772,1.6260162601626016
2349,Riccardo Saponara,ITA,MF,Fiorentina,Serie A,28,1991,0.6,2,1,0,2,0,1,3,33.3,2,0,0,0,1,3,0,0,0,2020-2021,1.6666666666666667,3.3333333333333335
2350,Riccardo Saponara,ITA,"FW,MF",Spezia,Serie A,28,1991,4.3,4,1,1,0,3,1,3,33.3,2,1,0,1,1,5,4,0,0,2020-2021,0.23255813953488372,0.9302325581395349
Rk,Player,Nation,Pos,Squad,Comp,0,0,90.0,0,0,3,3,3,Tkl,0,0.0,0,0,0,0,0,0,0,0,0,2020-2021,0.0,0.0
2351,Ivan Šaponjić,SRB,FW,Cádiz,La Liga,22,1997,4.3,1,0,0,1,0,0,2,0.0,2,2,0,2,1,2,4,0,0,2020-2021,0.23255813953488372,0.23255813953488372
2352,Pablo Sarabia,ESP,"FW,MF",Paris S-G,Ligue 1,28,1992,14.7,15,11,6,6,3,10,38,26.3,28,9,1,8,5,20,8,0,0,2020-2021,0.3401360544217687,1.0204081632653061
2353,Josh Sargent,USA,"FW,MF",Werder Bremen,Bundesliga,20,2000,27.8,32,19,13,13,6,13,27,48.1,14,39,4,35,17,49,36,0,0,2020-2021,0.6115107913669064,1.1510791366906474
2354,Bouna Sarr,SEN,DF,Marseille,Ligue 1,28,1992,0.8,1,1,0,0,1,1,1,100.0,0,1,1,0,1,2,1,0,0,2020-2021,1.25,1.25
2355,Bouna Sarr,SEN,DF,Bayern Munich,Bundesliga,28,1992,5.0,9,8,4,3,2,3,6,50.0,3,7,0,7,10,19,7,1,0,2020-2021,2.0,1.8
2356,Sidy Sarr,SEN,MF,Nîmes,Ligue 1,24,1996,5.1,10,6,4,6,0,2,5,40.0,3,1,1,0,7,17,4,0,0,2020-2021,1.3725490196078431,1.9607843137254903
2357,Marco Sau,ITA,"MF,FW",Benevento,Serie A,32,1987,8.7,6,2,0,6,0,1,16,6.3,15,7,0,7,5,11,3,0,0,2020-2021,0.574712643678161,0.6896551724137931
2358,Téji Savanier,FRA,MF,Montpellier,Ligue 1,28,1991,24.1,49,33,16,25,8,22,73,30.1,51,28,6,22,38,87,15,0,0,2020-2021,1.5767634854771784,2.033195020746888
2359,Stefan Savić,MNE,DF,Atlético Madrid,La Liga,29,1991,32.8,40,25,32,7,1,21,34,61.8,13,33,19,14,42,82,110,0,0,2020-2021,1.2804878048780488,1.2195121951219514
2360,Romaine Sawyers,SKN,MF,West Brom,Premier League,28,1991,16.5,30,18,16,12,2,14,43,32.6,29,20,4,16,18,48,12,3,0,2020-2021,1.0909090909090908,1.8181818181818181
2361,Gianluca Scamacca,ITA,FW,Genoa,Serie A,21,1999,15.0,19,10,6,7,6,7,19,36.8,12,21,4,17,9,28,12,0,0,2020-2021,0.6,1.2666666666666666
2362,Dane Scarlett,ENG,FW,Tottenham,Premier League,16,2004,0.0,0,0,0,0,0,0,0,0.0,0,0,0,0,0,0,0,0,0,2020-2021,,
2363,Fabian Schär,SUI,DF,Newcastle Utd,Premier League,28,1991,13.8,13,4,8,5,0,7,19,36.8,12,19,12,7,27,40,52,1,0,2020-2021,1.9565217391304346,0.9420289855072463
2364,Aurélien Scheidler,FRA,FW,Dijon,Ligue 1,22,1998,3.8,2,0,0,2,0,0,2,0.0,2,0,0,0,1,3,5,0,0,2020-2021,0.2631578947368421,0.5263157894736842
2365,Nicolás Schiappacasse,URU,MF,Sassuolo,Serie A,21,1999,0.2,0,0,0,0,0,0,0,0.0,0,0,0,0,0,0,0,0,0,2020-2021,0.0,0.0
2366,Pasquale Schiattarella,ITA,MF,Benevento,Serie A,33,1987,25.0,37,22,25,12,0,19,47,40.4,28,19,5,14,32,69,29,2,0,2020-2021,1.28,1.48
2367,Patrik Schick,CZE,FW,Leverkusen,Bundesliga,24,1996,20.7,7,2,0,5,2,1,4,25.0,3,5,2,3,3,10,20,0,0,2020-2021,0.14492753623188406,0.33816425120772947
2368,Sven Schipplock,GER,"FW,MF",Arminia,Bundesliga,31,1988,8.3,15,8,7,6,2,6,27,22.2,21,13,2,11,6,21,8,0,0,2020-2021,0.7228915662650601,1.8072289156626504
2369,Xaver Schlager,AUT,MF,Wolfsburg,Bundesliga,22,1997,29.2,66,40,20,38,8,22,68,32.4,46,50,6,44,54,120,38,0,0,2020-2021,1.8493150684931507,2.26027397260274
2370,Keven Schlotterbeck,GER,DF,Freiburg,Bundesliga,23,1997,18.4,31,10,16,15,0,10,23,43.5,13,26,18,8,36,67,89,2,0,2020-2021,1.956521739130435,1.6847826086956523
2371,Nico Schlotterbeck,GER,DF,Union Berlin,Bundesliga,20,1999,14.3,34,19,14,19,1,18,28,64.3,10,13,6,7,31,65,29,1,0,2020-2021,2.167832167832168,2.3776223776223775
2372,Jeffrey Schlupp,GHA,MF,Crystal Palace,Premier League,27,1992,15.9,29,16,14,12,3,6,23,26.1,17,24,8,16,22,51,16,0,0,2020-2021,1.3836477987421383,1.8238993710691824
2373,Kasper Schmeichel,DEN,GK,Leicester City,Premier League,33,1986,38.0,0,0,0,0,0,0,0,0.0,0,0,0,0,0,0,10,0,0,2020-2021,0.0,0.0
2374,Jonathan Schmid,FRA,"MF,DF",Freiburg,Bundesliga,30,1990,26.6,37,19,17,13,7,16,30,53.3,14,26,10,16,28,65,38,0,0,2020-2021,1.0526315789473684,1.3909774436090225
2375,Romano Schmid,AUT,"MF,FW",Werder Bremen,Bundesliga,20,2000,13.1,22,16,8,10,4,8,35,22.9,27,21,0,21,8,30,6,0,0,2020-2021,0.6106870229007634,1.6793893129770994
Rk,Player,Nation,Pos,Squad,Comp,0,0,90.0,0,0,3,3,3,Tkl,0,0.0,0,0,0,0,0,0,0,0,0,2020-2021,0.0,0.0
2376,Benno Schmitz,GER,DF,Köln,Bundesliga,25,1994,4.6,14,7,6,7,1,7,13,53.8,6,8,2,6,6,20,7,0,0,2020-2021,1.3043478260869565,3.0434782608695654
2377,Morgan Schneiderlin,FRA,MF,Nice,Ligue 1,30,1989,24.4,51,31,21,24,6,20,54,37.0,34,21,11,10,53,104,46,0,0,2020-2021,2.1721311475409837,2.0901639344262297
2378,Alessandro Schöpf,AUT,"FW,MF",Schalke 04,Bundesliga,26,1994,10.5,11,9,3,7,1,1,6,16.7,5,15,1,14,6,17,6,0,0,2020-2021,0.5714285714285714,1.0476190476190477
2379,Jerdy Schouten,NED,MF,Bologna,Serie A,23,1997,27.9,50,25,23,25,2,16,37,43.2,21,36,13,23,79,129,37,6,0,2020-2021,2.831541218637993,1.7921146953405018
2380,Nico Schulz,GER,DF,Dortmund,Bundesliga,27,1993,6.8,9,6,4,3,2,2,11,18.2,9,12,4,8,6,15,10,0,0,2020-2021,0.8823529411764706,1.3235294117647058
2381,Alexander Schwolow,GER,GK,Hertha BSC,Bundesliga,28,1992,26.0,0,0,0,0,0,0,0,0.0,0,1,0,1,0,0,6,0,0,2020-2021,0.0,0.0
2382,Christopher Scott,GER,"MF,FW",Bayern Munich,Bundesliga,18,2002,0.4,2,1,0,1,1,2,2,100.0,0,0,0,0,0,2,1,0,0,2020-2021,0.0,5.0
2383,Matteo Scozzarella,ITA,MF,Parma,Serie A,32,1988,1.7,4,0,3,1,0,2,3,66.7,1,3,1,2,6,10,0,0,0,2020-2021,3.5294117647058822,2.3529411764705883
2384,Simone Scuffet,ITA,GK,Udinese,Serie A,24,1996,1.0,0,0,0,0,0,0,0,0.0,0,0,0,0,0,0,0,0,0,2020-2021,0.0,0.0
2385,Jacopo Segre,ITA,MF,Torino,Serie A,23,1997,2.1,5,2,2,1,2,2,5,40.0,3,0,0,0,0,5,1,0,0,2020-2021,0.0,2.380952380952381
2386,Davie Selke,GER,FW,Werder Bremen,Bundesliga,25,1995,9.0,3,2,1,1,1,0,6,0.0,6,3,2,1,1,4,7,0,0,2020-2021,0.1111111111111111,0.3333333333333333
2387,Malik Sellouki,FRA,"FW,MF",Nice,Ligue 1,20,2000,0.7,0,0,0,0,0,0,1,0.0,1,2,0,2,2,2,0,0,0,2020-2021,2.857142857142857,0.0
2388,Matz Sels,BEL,GK,Strasbourg,Ligue 1,28,1992,6.0,0,0,0,0,0,0,0,0.0,0,0,0,0,0,0,4,0,0,2020-2021,0.0,0.0
2389,Nélson Semedo,POR,"DF,MF",Wolves,Premier League,26,1993,33.1,85,48,53,23,9,42,72,58.3,30,30,10,20,41,126,78,2,0,2020-2021,1.2386706948640482,2.5679758308157097
2390,Léo Sena,BRA,MF,Spezia,Serie A,24,1995,9.8,22,12,7,10,5,12,26,46.2,14,19,4,15,11,33,5,0,0,2020-2021,1.1224489795918366,2.2448979591836733
2391,Stefano Sensi,ITA,MF,Inter,Serie A,24,1995,6.7,9,6,3,5,1,4,11,36.4,7,6,1,5,7,16,1,0,0,2020-2021,1.044776119402985,1.3432835820895521
2392,Jaime Seoane,ESP,MF,Huesca,La Liga,23,1997,22.9,50,30,20,23,7,24,65,36.9,41,27,6,21,17,67,14,0,0,2020-2021,0.7423580786026202,2.183406113537118
2393,Luigi Sepe,ITA,GK,Parma,Serie A,29,1991,36.0,0,0,0,0,0,0,2,0.0,2,0,0,0,2,2,13,2,0,2020-2021,0.05555555555555555,0.0
2394,Suat Serdar,GER,MF,Schalke 04,Bundesliga,23,1997,21.7,55,35,18,33,4,17,52,32.7,35,29,4,25,23,78,21,0,0,2020-2021,1.0599078341013826,2.5345622119815667
2395,Jean Seri,CIV,MF,Bordeaux,Ligue 1,29,1991,7.9,17,9,3,12,2,4,15,26.7,11,8,2,6,12,29,7,0,0,2020-2021,1.5189873417721518,2.151898734177215
2396,Femi Seriki,ENG,MF,Sheffield Utd,Premier League,18,2002,0.0,0,0,0,0,0,0,0,0.0,0,0,0,0,0,0,0,0,0,2020-2021,,
2397,Ryan Sessegnon,ENG,"DF,FW",Hoffenheim,Bundesliga,20,2000,17.5,47,25,26,13,8,15,34,44.1,19,26,3,23,30,77,46,0,0,2020-2021,1.7142857142857142,2.6857142857142855
2398,Nils Seufert,GER,"MF,FW",Arminia,Bundesliga,23,1997,3.8,12,9,2,5,5,2,8,25.0,6,3,1,2,5,17,6,0,0,2020-2021,1.3157894736842106,3.1578947368421053
2399,Edgar Sevikyan,ARM,MF,Levante,La Liga,18,2001,0.1,0,0,0,0,0,0,0,0.0,0,0,0,0,0,0,0,0,0,2020-2021,0.0,0.0
2400,Stephan El Shaarawy,ITA,"MF,FW",Roma,Serie A,27,1992,6.4,4,3,0,3,1,2,9,22.2,7,3,1,2,3,7,2,0,0,2020-2021,0.46875,0.625
Rk,Player,Nation,Pos,Squad,Comp,0,0,90.0,0,0,3,3,3,Tkl,0,0.0,0,0,0,0,0,0,0,0,0,2020-2021,0.0,0.0
2401,Jamie Shackleton,ENG,"MF,DF",Leeds United,Premier League,20,1999,5.1,10,6,6,4,0,4,11,36.4,7,3,1,2,9,19,3,0,0,2020-2021,1.7647058823529413,1.9607843137254903
2402,Xherdan Shaqiri,SUI,"MF,FW",Liverpool,Premier League,28,1991,6.2,7,4,3,1,3,2,7,28.6,5,4,0,4,2,9,0,0,0,2020-2021,0.3225806451612903,1.129032258064516
2403,Billy Sharp,ENG,FW,Sheffield Utd,Premier League,34,1986,8.2,5,1,0,3,2,2,9,22.2,7,2,0,2,0,5,2,0,0,2020-2021,0.0,0.6097560975609757
2404,Luke Shaw,ENG,DF,Manchester Utd,Premier League,25,1995,29.5,44,28,21,16,7,21,36,58.3,15,34,9,25,20,64,44,2,0,2020-2021,0.6779661016949152,1.4915254237288136
2405,Jonjo Shelvey,ENG,MF,Newcastle Utd,Premier League,28,1992,29.1,39,14,18,19,2,10,37,27.0,27,26,14,12,36,75,42,0,0,2020-2021,1.2371134020618557,1.3402061855670102
2406,Eldor Shomurodov,UZB,FW,Genoa,Serie A,25,1995,18.6,28,14,7,13,8,9,37,24.3,28,17,2,15,6,34,11,0,0,2020-2021,0.3225806451612903,1.5053763440860215
2407,Shola Shoretire,ENG,FW,Manchester Utd,Premier League,16,2004,0.1,0,0,0,0,0,0,0,0.0,0,0,0,0,0,0,0,0,0,2020-2021,0.0,0.0
2408,Mahame Siby,MLI,MF,Strasbourg,Ligue 1,24,1996,0.2,0,0,0,0,0,0,1,0.0,1,0,0,0,0,0,1,0,0,2020-2021,0.0,0.0
2409,Abdoulaye Sidibé,FRA,MF,Saint-Étienne,Ligue 1,18,2002,0.1,1,1,1,0,0,1,2,50.0,1,0,0,0,0,1,0,0,0,2020-2021,0.0,10.0
2410,Djibril Sidibé,FRA,DF,Monaco,Ligue 1,28,1992,22.0,58,34,26,29,3,37,52,71.2,15,20,5,15,50,108,37,2,0,2020-2021,2.272727272727273,2.6363636363636362
2411,Sidnei,BRA,DF,Betis,La Liga,30,1989,7.7,9,3,6,3,0,4,9,44.4,5,6,4,2,16,25,28,0,0,2020-2021,2.0779220779220777,1.1688311688311688
2412,Kaj Sierhuis,NED,"FW,MF",Reims,Ligue 1,22,1998,7.2,7,2,1,2,4,2,9,22.2,7,2,1,1,2,9,5,0,0,2020-2021,0.2777777777777778,0.9722222222222222
2413,Tim Siersleben,GER,DF,Wolfsburg,Bundesliga,20,2000,0.4,2,2,2,0,0,1,1,100.0,0,1,0,1,0,2,0,0,0,2020-2021,0.0,5.0
2414,Gylfi Sigurðsson,ISL,"MF,FW",Everton,Premier League,30,1989,25.0,30,20,9,14,7,13,44,29.5,31,31,2,29,34,64,21,1,0,2020-2021,1.36,1.2
2415,Luca Siligardi,ITA,"MF,FW",Crotone,Serie A,32,1988,0.5,4,2,0,3,1,1,5,20.0,4,0,0,0,0,4,0,0,0,2020-2021,0.0,8.0
2416,Luca Siligardi,ITA,"FW,MF",Parma,Serie A,32,1988,0.4,0,0,0,0,0,0,2,0.0,2,0,0,0,0,0,0,0,0,2020-2021,0.0,0.0
2417,Adrien Silva,POR,MF,Sampdoria,Serie A,31,1989,17.8,49,22,21,22,6,18,54,33.3,36,34,1,33,30,79,10,1,0,2020-2021,1.6853932584269662,2.752808988764045
2418,André Silva,POR,FW,Eint Frankfurt,Bundesliga,24,1995,30.7,11,2,0,7,4,6,13,46.2,7,11,1,10,3,14,15,0,0,2020-2021,0.09771986970684039,0.3583061889250814
2419,Bernardo Silva,POR,"MF,FW",Manchester City,Premier League,25,1994,22.9,26,14,7,12,7,11,52,21.2,41,17,1,16,17,43,8,0,0,2020-2021,0.7423580786026202,1.1353711790393013
2420,Caio Henrique Oliveira Silva,BRA,DF,Monaco,Ligue 1,23,1997,26.3,50,34,25,20,5,31,51,60.8,20,20,3,17,16,66,37,0,0,2020-2021,0.6083650190114068,1.9011406844106464
2421,David Silva,ESP,MF,Real Sociedad,La Liga,34,1986,15.5,19,12,2,14,3,8,21,38.1,13,14,1,13,13,32,8,2,0,2020-2021,0.8387096774193549,1.2258064516129032
2422,Fábio Silva,POR,FW,Wolves,Premier League,18,2002,15.2,6,4,1,4,1,4,12,33.3,8,12,1,11,4,10,5,1,0,2020-2021,0.2631578947368421,0.39473684210526316
2423,Florent da Silva,FRA,FW,Lyon,Ligue 1,17,2003,0.0,0,0,0,0,0,0,0,0.0,0,0,0,0,0,0,0,0,0,2020-2021,,
2424,Gabriel Silva,BRA,DF,Saint-Étienne,Ligue 1,29,1991,3.9,7,6,7,0,0,1,2,50.0,1,4,1,3,6,13,8,0,0,2020-2021,1.5384615384615385,1.794871794871795
2425,Gastón Silva,URU,DF,Huesca,La Liga,26,1994,6.7,16,12,11,5,0,8,14,57.1,6,10,4,6,11,27,16,0,0,2020-2021,1.6417910447761193,2.388059701492537
Rk,Player,Nation,Pos,Squad,Comp,0,0,90.0,0,0,3,3,3,Tkl,0,0.0,0,0,0,0,0,0,0,0,0,2020-2021,0.0,0.0
2426,Rui Silva,POR,GK,Granada,La Liga,26,1994,32.0,1,0,1,0,0,1,3,33.3,2,0,0,0,2,3,14,0,0,2020-2021,0.0625,0.03125
2427,Thiago Silva,BRA,DF,Chelsea,Premier League,35,1984,21.5,20,12,11,8,1,14,21,66.7,7,21,13,8,33,53,86,1,0,2020-2021,1.5348837209302326,0.9302325581395349
2428,Marco Silvestri,ITA,GK,Hellas Verona,Serie A,29,1991,34.0,0,0,0,0,0,0,0,0.0,0,0,0,0,0,0,14,1,0,2020-2021,0.0,0.0
2429,Mohamed Simakan,FRA,DF,Strasbourg,Ligue 1,20,2000,17.9,32,22,21,6,5,9,18,50.0,9,17,11,6,31,63,41,0,0,2020-2021,1.7318435754189945,1.787709497206704
2430,Giovanni Simeone,ARG,FW,Cagliari,Serie A,25,1995,19.3,24,11,2,15,7,7,31,22.6,24,23,1,22,10,34,18,0,0,2020-2021,0.5181347150259067,1.2435233160621761
2431,Moses Simon,NGA,"FW,MF",Nantes,Ligue 1,25,1995,25.8,27,14,11,9,7,17,36,47.2,19,24,1,23,15,42,15,1,0,2020-2021,0.5813953488372093,1.0465116279069766
2432,Unai Simón,ESP,GK,Athletic Club,La Liga,23,1997,37.0,1,0,1,0,0,1,2,50.0,1,0,0,0,0,1,7,7,0,2020-2021,0.0,0.02702702702702703
2433,Xavi Simons,NED,MF,Paris S-G,Ligue 1,17,2003,0.0,0,0,0,0,0,0,0,0.0,0,0,0,0,0,0,0,0,0,2020-2021,,
2434,Jóan Símun Edmundsson,FRO,"FW,MF",Arminia,Bundesliga,29,1991,0.6,0,0,0,0,0,0,0,0.0,0,1,0,1,1,1,0,0,0,2020-2021,1.6666666666666667,0.0
2435,Wilfried Singo,CIV,DF,Torino,Serie A,19,2000,20.6,29,14,16,6,7,17,33,51.5,16,13,3,10,29,58,40,0,0,2020-2021,1.407766990291262,1.407766990291262
2436,Daley Sinkgraven,NED,DF,Leverkusen,Bundesliga,25,1995,17.4,32,17,13,16,3,18,35,51.4,17,22,5,17,23,55,23,0,0,2020-2021,1.3218390804597702,1.8390804597701151
2437,Dimitris Siovas,GRE,DF,Huesca,La Liga,31,1988,34.1,46,24,34,10,2,20,30,66.7,10,38,17,21,62,108,125,2,0,2020-2021,1.8181818181818181,1.348973607038123
2438,Tobias Sippel,GER,GK,Gladbach,Bundesliga,32,1988,3.8,0,0,0,0,0,0,0,0.0,0,0,0,0,1,1,4,0,0,2020-2021,0.2631578947368421,0.0
2439,Salvatore Sirigu,ITA,GK,Torino,Serie A,33,1987,32.0,1,0,1,0,0,1,2,50.0,1,0,0,0,0,1,6,2,0,2020-2021,0.0,0.03125
2440,Issouf Sissokho,MLI,"MF,DF",Bordeaux,Ligue 1,18,2002,0.9,6,4,4,2,0,3,6,50.0,3,2,0,2,1,7,0,0,0,2020-2021,1.1111111111111112,6.666666666666666
2441,Ibrahima Sissoko,MLI,MF,Strasbourg,Ligue 1,22,1997,28.7,68,48,25,35,8,28,68,41.2,40,22,5,17,48,116,44,0,0,2020-2021,1.6724738675958188,2.3693379790940767
2442,Moussa Sissoko,FRA,MF,Tottenham,Premier League,30,1989,17.6,22,16,19,3,0,8,20,40.0,12,11,4,7,23,45,25,0,0,2020-2021,1.3068181818181817,1.25
2443,Nelson Sissoko,FRA,DF,Saint-Étienne,Ligue 1,23,1997,5.3,12,6,6,3,3,7,12,58.3,5,2,1,1,12,24,16,1,0,2020-2021,2.2641509433962264,2.2641509433962264
2444,Antonio Sivera,ESP,GK,Alavés,La Liga,23,1996,0.8,0,0,0,0,0,0,0,0.0,0,0,0,0,0,0,0,0,0,2020-2021,0.0,0.0
2445,Jacques Siwe,FRA,FW,Dijon,Ligue 1,19,2001,1.9,4,1,1,1,2,0,1,0.0,1,1,0,1,1,5,1,0,0,2020-2021,0.5263157894736842,2.1052631578947367
2446,Ellyes Skhiri,TUN,MF,Köln,Bundesliga,25,1995,30.9,83,48,44,31,8,33,65,50.8,32,49,13,36,82,165,38,2,0,2020-2021,2.6537216828478964,2.6860841423948223
2447,Łukasz Skorupski,POL,GK,Bologna,Serie A,29,1991,28.0,1,1,1,0,0,1,4,25.0,3,0,0,0,0,1,23,5,0,2020-2021,0.0,0.03571428571428571
2448,Andreas Skov Olsen,DEN,"FW,DF",Bologna,Serie A,20,1999,13.1,19,10,11,4,4,11,21,52.4,10,15,0,15,3,22,25,0,0,2020-2021,0.22900763358778625,1.450381679389313
2449,Robert Skov,DEN,"FW,MF",Hoffenheim,Bundesliga,24,1996,12.9,19,10,9,7,3,7,16,43.8,9,9,2,7,15,34,10,1,0,2020-2021,1.1627906976744187,1.4728682170542635
2450,Milan Škriniar,SVK,DF,Inter,Serie A,25,1995,30.9,48,32,29,16,3,23,34,67.6,11,30,19,11,30,78,89,1,0,2020-2021,0.970873786407767,1.5533980582524272
Rk,Player,Nation,Pos,Squad,Comp,0,0,90.0,0,0,3,3,3,Tkl,0,0.0,0,0,0,0,0,0,0,0,0,2020-2021,0.0,0.0
2451,Steven Skrzybski,GER,"FW,DF",Schalke 04,Bundesliga,27,1992,4.7,5,4,0,5,0,1,7,14.3,6,13,1,12,5,10,1,1,0,2020-2021,1.0638297872340425,1.0638297872340425
2452,Petar Škuletić,SRB,"FW,MF",Montpellier,Ligue 1,30,1990,2.6,3,2,1,2,0,0,5,0.0,5,4,2,2,0,3,4,0,0,2020-2021,0.0,1.1538461538461537
2453,Islam Slimani,ALG,FW,Leicester City,Premier League,32,1988,0.2,0,0,0,0,0,0,0,0.0,0,0,0,0,0,0,0,0,0,2020-2021,0.0,0.0
2454,Islam Slimani,ALG,FW,Lyon,Ligue 1,32,1988,6.4,7,5,3,1,3,3,12,25.0,9,4,1,3,1,8,6,0,0,2020-2021,0.15625,1.09375
2455,William Smallbone,IRL,MF,Southampton,Premier League,20,2000,1.9,6,3,2,4,0,1,3,33.3,2,5,0,5,2,8,1,0,0,2020-2021,1.0526315789473684,3.1578947368421053
2456,Chris Smalling,ENG,DF,Roma,Serie A,30,1989,12.3,14,8,5,7,2,6,10,60.0,4,17,11,6,28,42,46,1,0,2020-2021,2.2764227642276422,1.1382113821138211
2457,Emile Smith Rowe,ENG,"MF,FW",Arsenal,Premier League,20,2000,16.0,14,7,5,5,4,6,17,35.3,11,15,1,14,10,24,12,0,0,2020-2021,0.625,0.875
2458,Robert Snodgrass,SCO,"MF,FW",West Brom,Premier League,32,1987,5.8,17,12,12,4,1,10,16,62.5,6,11,2,9,1,18,12,0,0,2020-2021,0.1724137931034483,2.931034482758621
2459,Robert Snodgrass,SCO,"FW,MF",West Ham,Premier League,32,1987,0.1,0,0,0,0,0,0,0,0.0,0,0,0,0,0,0,0,0,0,2020-2021,0.0,0.0
2460,Cédric Soares,POR,DF,Arsenal,Premier League,28,1991,8.3,12,8,6,4,2,6,21,28.6,15,6,1,5,8,20,16,1,0,2020-2021,0.9638554216867469,1.4457831325301203
2461,Rafa Soares,POR,DF,Eibar,La Liga,25,1995,12.6,28,17,16,8,4,15,21,71.4,6,14,4,10,20,48,32,0,0,2020-2021,1.5873015873015874,2.2222222222222223
2462,Rubén Sobrino,ESP,"MF,FW",Valencia,La Liga,28,1992,0.5,1,1,1,0,0,0,1,0.0,1,0,0,0,0,1,1,0,0,2020-2021,0.0,2.0
2463,Rubén Sobrino,ESP,"FW,MF",Cádiz,La Liga,28,1992,12.4,29,13,8,16,5,8,18,44.4,10,19,0,19,15,44,11,0,0,2020-2021,1.2096774193548387,2.338709677419355
2464,Simon Sohm,SUI,MF,Parma,Serie A,19,2001,10.0,18,12,11,6,1,11,26,42.3,15,8,0,8,5,23,7,0,0,2020-2021,0.5,1.8
2465,Augusto Solari,ARG,MF,Celta Vigo,La Liga,28,1992,5.4,18,13,9,8,1,6,26,23.1,20,13,1,12,6,24,5,0,0,2020-2021,1.111111111111111,3.333333333333333
2466,Roberto Soldado,ESP,FW,Granada,La Liga,35,1985,16.0,7,4,1,4,2,2,11,18.2,9,8,0,8,4,11,13,1,0,2020-2021,0.25,0.4375
2467,Carlos Soler,ESP,MF,Valencia,La Liga,23,1997,30.4,41,24,14,24,3,19,52,36.5,33,35,11,24,23,64,41,0,0,2020-2021,0.7565789473684211,1.348684210526316
2468,Yann Sommer,SUI,GK,Gladbach,Bundesliga,31,1988,30.1,1,1,1,0,0,1,1,100.0,0,0,0,0,2,3,9,2,0,2020-2021,0.06644518272425248,0.03322259136212624
2469,Son,ESP,"DF,MF",Levante,La Liga,26,1994,12.3,18,10,11,6,1,9,19,47.4,10,11,2,9,12,30,20,0,0,2020-2021,0.975609756097561,1.4634146341463414
2470,Brandon Soppy,FRA,DF,Rennes,Ligue 1,18,2002,6.2,21,15,16,5,0,10,16,62.5,6,3,0,3,6,27,12,0,0,2020-2021,0.9677419354838709,3.3870967741935485
2471,David Soria,ESP,GK,Getafe,La Liga,27,1993,28.0,2,2,2,0,0,1,3,33.3,2,0,0,0,1,3,12,0,0,2020-2021,0.03571428571428571,0.07142857142857142
2472,Roberto Soriano,ITA,MF,Bologna,Serie A,29,1991,36.1,48,26,15,20,13,15,64,23.4,49,31,8,23,18,66,43,0,0,2020-2021,0.4986149584487534,1.3296398891966759
2473,Alberto Soro,ESP,"FW,MF",Granada,La Liga,21,1999,4.4,7,2,2,4,1,4,10,40.0,6,7,0,7,1,8,2,0,0,2020-2021,0.22727272727272727,1.5909090909090908
2474,Borna Sosa,CRO,"DF,FW",Stuttgart,Bundesliga,22,1998,22.7,14,10,6,6,2,8,25,32.0,17,23,4,19,31,45,74,0,0,2020-2021,1.3656387665198237,0.6167400881057269
2475,Hugo Sotelo,ESP,MF,Celta Vigo,La Liga,16,2003,0.0,0,0,0,0,0,0,0,0.0,0,0,0,0,0,0,0,0,0,2020-2021,,
Rk,Player,Nation,Pos,Squad,Comp,0,0,90.0,0,0,3,3,3,Tkl,0,0.0,0,0,0,0,0,0,0,0,0,2020-2021,0.0,0.0
2476,Florian Sotoca,FRA,FW,Lens,Ligue 1,29,1990,26.8,31,20,3,20,8,6,22,27.3,16,27,0,27,9,40,24,0,0,2020-2021,0.33582089552238803,1.1567164179104477
2477,Riccardo Sottil,ITA,"FW,MF",Cagliari,Serie A,21,1999,13.2,7,3,2,3,2,0,7,0.0,7,4,0,4,5,12,3,0,0,2020-2021,0.3787878787878788,0.5303030303030303
2478,Cheick Souaré,FRA,MF,Marseille,Ligue 1,17,2002,0.1,0,0,0,0,0,0,0,0.0,0,1,1,0,1,1,0,0,0,2020-2021,10.0,0.0
2479,Tomáš Souček,CZE,MF,West Ham,Premier League,25,1995,38.0,78,41,37,36,5,28,77,36.4,49,43,18,25,62,140,107,0,0,2020-2021,1.631578947368421,2.0526315789473686
2480,Rayan Souici,FRA,DF,Saint-Étienne,Ligue 1,22,1998,0.1,0,0,0,0,0,0,0,0.0,0,0,0,0,0,0,0,0,0,2020-2021,0.0,0.0
2481,Cebio Soukou,BEN,"FW,MF",Arminia,Bundesliga,27,1992,5.1,12,8,5,5,2,6,11,54.5,5,3,0,3,3,15,4,0,0,2020-2021,0.5882352941176471,2.3529411764705883
2482,Adama Soumaoro,FRA,DF,Bologna,Serie A,28,1992,19.5,24,14,17,7,0,6,12,50.0,6,28,23,5,20,44,72,0,0,2020-2021,1.0256410256410255,1.2307692307692308
2483,Adama Soumaoro,FRA,DF,Lille,Ligue 1,28,1992,1.6,1,0,0,0,1,0,0,0.0,0,1,1,0,2,3,2,0,0,2020-2021,1.25,0.625
2484,Boubakary Soumaré,FRA,MF,Lille,Ligue 1,21,1999,21.3,44,29,16,25,3,14,29,48.3,15,14,6,8,39,83,21,0,0,2020-2021,1.8309859154929577,2.0657276995305165
2485,Yaya Soumaré,MLI,FW,Lyon,Ligue 1,20,2000,0.0,1,1,1,0,0,1,2,50.0,1,0,0,0,2,3,0,0,0,2020-2021,inf,inf
2486,Arnaud Souquet,FRA,DF,Montpellier,Ligue 1,28,1992,13.6,50,33,35,13,2,27,48,56.3,21,15,6,9,17,67,34,0,0,2020-2021,1.25,3.6764705882352944
2487,Ansou Sow,SEN,MF,Lens,Ligue 1,20,2000,0.1,0,0,0,0,0,0,0,0.0,0,1,0,1,0,0,0,0,0,2020-2021,0.0,0.0
2488,Djibril Sow,SUI,MF,Eint Frankfurt,Bundesliga,23,1997,24.2,58,33,19,32,7,18,41,43.9,23,31,8,23,51,109,17,0,0,2020-2021,2.1074380165289255,2.396694214876033
2489,Saidou Sow,GUI,DF,Saint-Étienne,Ligue 1,18,2002,11.1,23,12,17,6,0,13,19,68.4,6,12,8,4,14,37,39,1,0,2020-2021,1.2612612612612613,2.0720720720720722
2490,Çağlar Söyüncü,TUR,DF,Leicester City,Premier League,24,1996,20.2,27,17,13,14,0,17,30,56.7,13,12,9,3,28,55,80,1,0,2020-2021,1.3861386138613863,1.3366336633663367
2491,Leonardo Spinazzola,ITA,DF,Roma,Serie A,27,1993,23.6,12,6,3,9,0,8,20,40.0,12,16,1,15,25,37,31,0,0,2020-2021,1.059322033898305,0.5084745762711864
2492,Marco Sportiello,ITA,GK,Atalanta,Serie A,28,1992,14.0,2,2,2,0,0,1,3,33.3,2,0,0,0,2,4,5,1,0,2020-2021,0.14285714285714285,0.14285714285714285
2493,Mattia Sprocati,ITA,"MF,FW",Parma,Serie A,27,1993,0.2,1,0,0,1,0,1,1,100.0,0,0,0,0,1,2,0,0,0,2020-2021,5.0,5.0
2494,Jerry St. Juste,NED,DF,Mainz 05,Bundesliga,23,1996,32.0,65,38,37,26,2,20,36,55.6,16,46,27,19,64,129,82,1,0,2020-2021,2.0,2.03125
2495,Benjamin Stambouli,FRA,"DF,MF",Schalke 04,Bundesliga,29,1990,21.7,45,29,24,18,3,15,37,40.5,22,42,14,28,49,94,45,1,0,2020-2021,2.2580645161290325,2.0737327188940093
2496,Josip Stanišić,CRO,DF,Bayern Munich,Bundesliga,20,2000,1.0,2,2,1,1,0,1,1,100.0,0,3,0,3,2,4,2,0,0,2020-2021,2.0,2.0
2497,Niklas Stark,GER,"DF,MF",Hertha BSC,Bundesliga,25,1995,31.0,49,28,20,27,2,13,31,41.9,18,43,16,27,42,91,101,0,0,2020-2021,1.3548387096774193,1.5806451612903225
2498,Renato Steffen,SUI,"FW,MF",Wolfsburg,Bundesliga,28,1991,17.4,24,15,6,12,6,13,24,54.2,11,21,2,19,22,46,15,0,0,2020-2021,1.264367816091954,1.3793103448275863
2499,Zack Steffen,USA,GK,Manchester City,Premier League,25,1995,1.0,0,0,0,0,0,0,0,0.0,0,0,0,0,0,0,0,0,0,2020-2021,0.0,0.0
2500,Pascal Stenzel,GER,DF,Stuttgart,Bundesliga,24,1996,14.2,33,14,15,17,1,22,50,44.0,28,19,4,15,26,59,39,1,0,2020-2021,1.8309859154929577,2.323943661971831
Rk,Player,Nation,Pos,Squad,Comp,0,0,90.0,0,0,3,3,3,Tkl,0,0.0,0,0,0,0,0,0,0,0,0,2020-2021,0.0,0.0
2501,Dale Stephens,ENG,MF,Burnley,Premier League,31,1989,2.9,11,6,2,7,2,3,6,50.0,3,3,0,3,8,19,2,0,0,2020-2021,2.7586206896551726,3.793103448275862
2502,Jack Stephens,ENG,DF,Southampton,Premier League,26,1994,17.1,34,19,19,15,0,17,38,44.7,21,25,14,11,28,62,64,2,0,2020-2021,1.6374269005847952,1.9883040935672514
2503,Raheem Sterling,ENG,FW,Manchester City,Premier League,25,1994,28.2,21,10,5,12,4,5,12,41.7,7,15,0,15,15,36,4,0,0,2020-2021,0.5319148936170213,0.7446808510638298
2504,Enda Stevens,IRL,DF,Sheffield Utd,Premier League,30,1990,30.0,59,26,32,19,8,33,58,56.9,25,41,12,29,22,81,81,1,0,2020-2021,0.7333333333333333,1.9666666666666666
2505,Lars Stindl,GER,"MF,FW",Gladbach,Bundesliga,31,1988,21.8,24,17,3,16,5,7,32,21.9,25,26,3,23,13,37,14,0,0,2020-2021,0.5963302752293578,1.1009174311926606
2506,Kevin Stöger,AUT,"MF,FW",Mainz 05,Bundesliga,26,1993,6.0,12,6,2,9,1,5,16,31.3,11,5,0,5,6,18,4,0,0,2020-2021,1.0,2.0
2507,John Stones,ENG,DF,Manchester City,Premier League,26,1994,21.5,21,10,13,5,3,9,14,64.3,5,23,15,8,18,39,56,1,0,2020-2021,0.8372093023255814,0.9767441860465116
2508,Thomas Strakosha,ALB,GK,Lazio,Serie A,25,1995,9.0,1,1,1,0,0,0,0,0.0,0,0,0,0,1,2,4,0,0,2020-2021,0.1111111111111111,0.1111111111111111
2509,Tobias Strobl,GER,MF,Augsburg,Bundesliga,30,1990,20.5,21,10,12,9,0,10,30,33.3,20,21,8,13,28,49,27,0,0,2020-2021,1.3658536585365855,1.024390243902439
2510,Kevin Strootman,NED,MF,Genoa,Serie A,30,1990,14.6,30,18,13,15,2,14,32,43.8,18,35,3,32,25,55,18,0,0,2020-2021,1.7123287671232876,2.0547945205479454
2511,Kevin Strootman,NED,"MF,FW",Marseille,Ligue 1,30,1990,2.6,9,6,5,4,0,4,8,50.0,4,5,2,3,5,14,7,0,0,2020-2021,1.923076923076923,3.4615384615384612
2512,Pascal Struijk,NED,"DF,MF",Leeds United,Premier League,20,1999,23.1,49,30,28,19,2,17,28,60.7,11,35,21,14,47,96,92,0,0,2020-2021,2.0346320346320343,2.121212121212121
2513,Jens Stryger Larsen,DEN,DF,Udinese,Serie A,29,1991,29.3,17,11,14,3,0,8,25,32.0,17,26,11,15,24,41,65,0,0,2020-2021,0.8191126279863481,0.5802047781569966
2514,Stefano Sturaro,ITA,MF,Hellas Verona,Serie A,27,1993,4.7,4,3,3,0,1,2,8,25.0,6,5,1,4,5,9,10,0,0,2020-2021,1.0638297872340425,0.851063829787234
2515,Stefano Sturaro,ITA,MF,Genoa,Serie A,27,1993,4.9,11,5,3,6,2,3,15,20.0,12,5,0,5,7,18,2,0,0,2020-2021,1.4285714285714284,2.2448979591836733
2516,Damián Suárez,URU,DF,Getafe,La Liga,32,1988,27.0,59,39,29,23,7,30,81,37.0,51,43,2,41,31,90,42,0,0,2020-2021,1.1481481481481481,2.185185185185185
2517,Denis Suárez,ESP,MF,Celta Vigo,La Liga,26,1994,31.7,64,32,22,30,12,21,94,22.3,73,30,2,28,22,86,15,2,0,2020-2021,0.694006309148265,2.0189274447949526
2518,Luis Suárez,URU,FW,Atlético Madrid,La Liga,33,1987,27.9,11,7,0,4,7,3,12,25.0,9,7,0,7,5,16,13,0,0,2020-2021,0.17921146953405018,0.3942652329749104
2519,Marek Suchý,CZE,DF,Augsburg,Bundesliga,32,1988,3.4,4,2,1,3,0,1,2,50.0,1,3,3,0,4,8,9,0,0,2020-2021,1.1764705882352942,1.1764705882352942
2520,Niklas Süle,GER,DF,Bayern Munich,Bundesliga,24,1995,16.7,32,21,15,14,3,13,21,61.9,8,24,12,12,21,53,36,1,0,2020-2021,1.25748502994012,1.9161676646706587
2521,Suso,ESP,FW,Sevilla,La Liga,26,1993,24.6,20,10,8,6,6,10,41,24.4,31,12,0,12,8,28,8,0,0,2020-2021,0.3252032520325203,0.8130081300813008
2522,Bosko Sutalo,CRO,DF,Atalanta,Serie A,20,2000,2.6,5,5,0,3,2,4,5,80.0,1,2,1,1,2,7,7,1,0,2020-2021,0.7692307692307692,1.923076923076923
2523,Mattias Svanberg,SWE,MF,Bologna,Serie A,21,1999,20.6,38,17,21,9,8,16,45,35.6,29,25,4,21,30,68,25,1,0,2020-2021,1.4563106796116503,1.8446601941747571
2524,Abdoulaye Sylla,GUI,DF,Nantes,Ligue 1,20,2000,0.1,2,1,2,0,0,1,1,100.0,0,1,0,1,0,2,1,0,0,2020-2021,0.0,20.0
2525,Issiaga Sylla,GUI,"DF,MF",Lens,Ligue 1,26,1994,12.4,28,20,11,17,0,11,21,52.4,10,13,3,10,16,44,21,0,0,2020-2021,1.2903225806451613,2.258064516129032
Rk,Player,Nation,Pos,Squad,Comp,0,0,90.0,0,0,3,3,3,Tkl,0,0.0,0,0,0,0,0,0,0,0,0,2020-2021,0.0,0.0
2526,Eddy Sylvestre,FRA,"FW,MF",Nice,Ligue 1,20,1999,1.1,1,1,1,0,0,0,1,0.0,1,1,0,1,1,2,0,0,0,2020-2021,0.9090909090909091,0.9090909090909091
2527,Ádám Szalai,HUN,FW,Mainz 05,Bundesliga,32,1987,8.1,7,6,3,2,2,2,8,25.0,6,4,1,3,2,9,4,0,0,2020-2021,0.2469135802469136,0.8641975308641976
2528,Wojciech Szczęsny,POL,GK,Juventus,Serie A,30,1990,29.7,0,0,0,0,0,0,0,0.0,0,2,0,2,3,3,5,1,0,2020-2021,0.10101010101010101,0.0
2529,Frederik Sørensen,DEN,DF,Köln,Bundesliga,28,1992,1.1,2,1,0,2,0,1,1,100.0,0,2,0,2,0,2,0,0,0,2020-2021,0.0,1.8181818181818181
2530,Alexander Sørloth,NOR,FW,RB Leipzig,Bundesliga,24,1995,16.0,7,5,0,5,2,2,14,14.3,12,13,2,11,3,10,13,0,0,2020-2021,0.1875,0.4375
2531,Tachi,ESP,DF,Alavés,La Liga,22,1997,9.4,11,9,9,2,0,6,14,42.9,8,9,6,3,11,22,32,0,0,2020-2021,1.1702127659574468,1.1702127659574468
2532,Jonathan Tah,GER,DF,Leverkusen,Bundesliga,24,1996,24.7,30,17,19,9,2,11,21,52.4,10,19,12,7,33,63,89,1,0,2020-2021,1.3360323886639676,1.2145748987854252
2533,Waniss Taibi,FRA,MF,Angers,Ligue 1,18,2002,0.4,0,0,0,0,0,0,2,0.0,2,1,0,1,0,0,0,0,0,2020-2021,0.0,0.0
2534,Flavien Tait,FRA,"MF,FW",Rennes,Ligue 1,27,1993,15.2,26,11,11,12,3,10,32,31.3,22,17,3,14,13,39,2,0,0,2020-2021,0.8552631578947368,1.7105263157894737
2535,Adrien Tameze,CMR,MF,Hellas Verona,Serie A,26,1994,25.6,39,25,23,15,1,11,27,40.7,16,31,8,23,32,71,46,2,0,2020-2021,1.25,1.5234375
2536,Japhet Tanganga,ENG,DF,Tottenham,Premier League,21,1999,5.4,5,4,3,2,0,1,3,33.3,2,6,5,1,3,8,15,0,0,2020-2021,0.5555555555555555,0.9259259259259258
2537,Renato Tapia,PER,MF,Celta Vigo,La Liga,25,1995,30.0,93,44,50,34,9,32,83,38.6,51,56,13,43,53,146,75,2,0,2020-2021,1.7666666666666666,3.1
2538,Edmond Tapsoba,BFA,DF,Leverkusen,Bundesliga,21,1999,29.5,54,28,35,18,1,21,45,46.7,24,55,29,26,48,102,96,0,0,2020-2021,1.6271186440677967,1.8305084745762712
2539,Matt Targett,ENG,DF,Aston Villa,Premier League,24,1995,37.8,83,39,52,20,11,56,88,63.6,32,40,14,26,55,138,102,1,0,2020-2021,1.4550264550264551,2.195767195767196
2540,James Tarkowski,ENG,DF,Burnley,Premier League,27,1992,36.0,66,39,52,11,3,25,49,51.0,24,54,42,12,44,110,163,1,0,2020-2021,1.2222222222222223,1.8333333333333333
2541,Ciprian Tătărușanu,ROU,GK,Milan,Serie A,34,1986,1.0,0,0,0,0,0,0,0,0.0,0,0,0,0,0,0,0,1,0,2020-2021,0.0,0.0
2542,Percy Tau,RSA,FW,Brighton,Premier League,26,1994,1.1,1,1,1,0,0,0,2,0.0,2,1,0,1,0,1,1,0,0,2020-2021,0.0,0.9090909090909091
2543,Niklas Tauer,GER,"MF,DF",Mainz 05,Bundesliga,19,2001,0.8,1,1,0,1,0,1,2,50.0,1,3,1,2,3,4,1,0,0,2020-2021,3.75,1.25
2544,Heriberto Tavares,POR,"FW,MF",Brest,Ligue 1,23,1997,0.5,2,0,0,0,2,1,3,33.3,2,0,0,0,1,3,1,0,0,2020-2021,2.0,4.0
2545,Sidnei Tavares,POR,MF,Leicester City,Premier League,18,2001,0.9,1,1,0,1,0,0,0,0.0,0,1,1,0,0,1,0,0,0,2020-2021,0.0,1.1111111111111112
2546,Tomás Tavares,POR,"MF,DF",Alavés,La Liga,19,2001,0.7,2,1,2,0,0,2,2,100.0,0,1,0,1,0,2,1,0,0,2020-2021,0.0,2.857142857142857
2547,Charlie Taylor,ENG,DF,Burnley,Premier League,26,1993,27.0,48,28,30,15,3,25,46,54.3,21,36,19,17,29,77,87,2,0,2020-2021,1.0740740740740742,1.7777777777777777
2548,Neil Taylor,WAL,DF,Aston Villa,Premier League,31,1989,0.2,1,1,1,0,0,0,0,0.0,0,1,0,1,0,1,0,0,0,2020-2021,0.0,5.0
2549,Allan Tchaptchet,FRA,DF,Southampton,Premier League,18,2001,0.1,0,0,0,0,0,0,0,0.0,0,0,0,0,0,0,0,0,0,2020-2021,0.0,0.0
2550,Warren Tchimbembé,CGO,"MF,FW",Metz,Ligue 1,22,1998,5.5,7,4,4,3,0,3,9,33.3,6,6,1,5,2,9,3,0,0,2020-2021,0.36363636363636365,1.2727272727272727
Rk,Player,Nation,Pos,Squad,Comp,0,0,90.0,0,0,3,3,3,Tkl,0,0.0,0,0,0,0,0,0,0,0,0,2020-2021,0.0,0.0
2551,Aurélien Tchouaméni,FRA,MF,Monaco,Ligue 1,20,2000,34.0,127,68,47,62,18,48,92,52.2,44,39,11,28,60,187,47,0,0,2020-2021,1.7647058823529411,3.735294117647059
2552,Álvaro Tejero,ESP,DF,Eibar,La Liga,24,1996,1.2,1,1,0,0,1,1,3,33.3,2,1,0,1,3,4,6,0,0,2020-2021,2.5,0.8333333333333334
2553,Nathan Tella,NGA,"FW,MF",Southampton,Premier League,21,1999,8.3,8,5,1,4,3,6,15,40.0,9,13,0,13,3,11,2,0,0,2020-2021,0.36144578313253006,0.9638554216867469
2554,Alex Telles,BRA,DF,Manchester Utd,Premier League,27,1992,7.7,14,7,10,3,1,8,17,47.1,9,7,2,5,16,30,20,0,0,2020-2021,2.0779220779220777,1.8181818181818181
2555,Andrés Tello,COL,"DF,MF",Benevento,Serie A,23,1996,4.6,9,6,8,0,1,5,20,25.0,15,8,1,7,6,15,6,0,0,2020-2021,1.3043478260869565,1.956521739130435
2556,Cristian Tello,ESP,"FW,MF",Betis,La Liga,28,1991,14.3,16,10,5,9,2,4,22,18.2,18,14,0,14,11,27,8,0,0,2020-2021,0.7692307692307692,1.1188811188811187
2557,Lino Tempelmann,GER,MF,Freiburg,Bundesliga,21,1999,3.0,5,3,2,2,1,0,4,0.0,4,6,1,5,2,7,6,0,0,2020-2021,0.6666666666666666,1.6666666666666667
2558,Hidde ter Avest,NED,DF,Udinese,Serie A,23,1997,3.9,5,2,3,2,0,2,5,40.0,3,3,1,2,2,7,5,0,0,2020-2021,0.5128205128205129,1.2820512820512822
2559,Marc-André ter Stegen,GER,GK,Barcelona,La Liga,28,1992,31.0,0,0,0,0,0,0,2,0.0,2,0,0,0,0,0,12,2,0,2020-2021,0.0,0.0
2560,Pietro Terracciano,ITA,GK,Fiorentina,Serie A,30,1990,3.0,0,0,0,0,0,0,0,0.0,0,0,0,0,0,0,1,0,0,2020-2021,0.0,0.0
2561,Martin Terrier,FRA,"FW,MF",Rennes,Ligue 1,23,1997,27.1,33,15,5,15,13,10,36,27.8,26,23,0,23,16,49,7,0,0,2020-2021,0.5904059040590406,1.2177121771217712
2562,Claudio Terzi,ITA,DF,Spezia,Serie A,36,1984,20.8,34,21,19,14,1,19,28,67.9,9,23,12,11,35,69,55,1,0,2020-2021,1.6826923076923077,1.6346153846153846
2563,Kenny Tete,NED,"DF,MF",Fulham,Premier League,24,1995,16.5,48,30,27,16,5,10,18,55.6,8,14,5,9,27,75,49,0,0,2020-2021,1.6363636363636365,2.909090909090909
2564,Kenny Tete,NED,DF,Lyon,Ligue 1,24,1995,0.2,2,0,1,1,0,0,0,0.0,0,0,0,0,2,4,0,0,0,2020-2021,10.0,10.0
2565,Cedric Teuchert,GER,"FW,MF",Union Berlin,Bundesliga,23,1997,8.4,7,5,2,4,1,3,16,18.8,13,12,0,12,5,12,6,0,0,2020-2021,0.5952380952380952,0.8333333333333333
2566,Florian Thauvin,FRA,"FW,MF",Marseille,Ligue 1,27,1993,30.4,40,22,14,21,5,20,54,37.0,34,26,2,24,14,54,11,0,0,2020-2021,0.46052631578947373,1.3157894736842106
2567,Malick Thiaw,GER,DF,Schalke 04,Bundesliga,18,2001,16.1,42,27,24,17,1,15,26,57.7,11,17,12,5,33,75,70,0,0,2020-2021,2.0496894409937885,2.6086956521739126
2568,Jan Thielmann,GER,"FW,MF",Köln,Bundesliga,18,2002,11.4,11,6,1,8,2,5,9,55.6,4,10,1,9,9,20,2,0,0,2020-2021,0.7894736842105263,0.9649122807017544
2569,Sada Thioub,SEN,"FW,MF",Angers,Ligue 1,25,1995,14.0,17,14,7,6,4,7,23,30.4,16,10,0,10,9,26,3,0,0,2020-2021,0.6428571428571429,1.2142857142857142
2570,Luke Thomas,ENG,DF,Leicester City,Premier League,19,2001,10.8,23,14,11,5,7,14,21,66.7,7,15,2,13,17,40,21,0,0,2020-2021,1.574074074074074,2.1296296296296293
2571,Romain Thomas,FRA,DF,Angers,Ligue 1,32,1988,33.6,47,25,34,11,2,20,35,57.1,15,35,20,15,50,97,138,0,0,2020-2021,1.4880952380952381,1.3988095238095237
2572,Adrien Thomasson,FRA,"MF,FW",Strasbourg,Ligue 1,26,1993,29.2,36,17,8,16,12,12,58,20.7,46,44,5,39,22,58,2,0,0,2020-2021,0.7534246575342466,1.2328767123287672
2573,Erik Thommy,GER,"MF,DF",Stuttgart,Bundesliga,25,1994,3.5,3,1,0,3,0,0,3,0.0,3,3,0,3,3,6,4,0,0,2020-2021,0.8571428571428571,0.8571428571428571
2574,Morten Thorsby,NOR,MF,Sampdoria,Serie A,24,1996,29.4,76,42,32,36,8,20,60,33.3,40,51,16,35,25,101,30,0,0,2020-2021,0.8503401360544218,2.5850340136054424
2575,Khéphren Thuram,FRA,MF,Nice,Ligue 1,19,2001,16.6,32,16,5,21,6,9,27,33.3,18,21,9,12,18,50,22,1,0,2020-2021,1.0843373493975903,1.9277108433734937
Rk,Player,Nation,Pos,Squad,Comp,0,0,90.0,0,0,3,3,3,Tkl,0,0.0,0,0,0,0,0,0,0,0,0,2020-2021,0.0,0.0
2576,Marcus Thuram,FRA,"FW,MF",Gladbach,Bundesliga,22,1997,19.2,24,14,9,10,5,10,23,43.5,13,27,4,23,15,39,13,1,0,2020-2021,0.78125,1.25
2577,Cheikh Tidiane Sabaly,SEN,FW,Metz,Ligue 1,21,1999,0.1,0,0,0,0,0,0,0,0.0,0,0,0,0,0,0,0,0,0,2020-2021,0.0,0.0
2578,Youri Tielemans,BEL,MF,Leicester City,Premier League,23,1997,37.3,86,45,32,38,16,45,108,41.7,63,35,8,27,46,132,20,1,0,2020-2021,1.2332439678284184,2.3056300268096517
2579,Kieran Tierney,SCO,DF,Arsenal,Premier League,23,1997,25.5,27,15,5,14,8,11,31,35.5,20,31,10,21,16,43,63,0,0,2020-2021,0.6274509803921569,1.0588235294117647
2580,Steffen Tigges,GER,"FW,DF",Dortmund,Bundesliga,22,1998,0.6,4,4,0,1,3,2,3,66.7,1,1,0,1,0,4,1,0,0,2020-2021,0.0,6.666666666666667
2581,Guus Til,NED,FW,Freiburg,Bundesliga,22,1997,1.4,4,3,2,1,1,2,3,66.7,1,2,0,2,2,6,2,0,0,2020-2021,1.4285714285714286,2.857142857142857
2582,David Timor,ESP,"MF,DF",Getafe,La Liga,30,1989,15.5,13,9,5,6,2,9,21,42.9,12,5,1,4,19,32,32,1,0,2020-2021,1.2258064516129032,0.8387096774193549
2583,Jean-Clair Todibo,FRA,DF,Nice,Ligue 1,20,1999,14.8,25,15,16,9,0,16,31,51.6,15,13,7,6,19,44,48,1,0,2020-2021,1.2837837837837838,1.689189189189189
2584,Karl Toko Ekambi,CMR,FW,Lyon,Ligue 1,27,1992,31.2,16,10,5,3,8,8,32,25.0,24,20,1,19,26,42,8,0,0,2020-2021,0.8333333333333334,0.5128205128205129
2585,Corentin Tolisso,FRA,MF,Bayern Munich,Bundesliga,25,1994,8.7,19,19,4,11,4,9,29,31.0,20,15,2,13,6,25,8,0,0,2020-2021,0.6896551724137931,2.1839080459770117
2586,Jeremy Toljan,GER,DF,Sassuolo,Serie A,25,1994,16.6,21,12,16,3,2,12,27,44.4,15,15,7,8,13,34,28,0,0,2020-2021,0.7831325301204819,1.2650602409638554
2587,Rafael Tolói,ITA,DF,Atalanta,Serie A,29,1990,28.2,51,23,21,26,4,26,48,54.2,22,37,7,30,33,84,66,0,0,2020-2021,1.1702127659574468,1.8085106382978724
2588,Takehiro Tomiyasu,JPN,DF,Bologna,Serie A,21,1998,30.2,47,31,27,14,6,21,34,61.8,13,37,19,18,54,101,106,0,0,2020-2021,1.7880794701986755,1.5562913907284768
2589,James Tomkins,ENG,DF,Crystal Palace,Premier League,31,1989,6.1,4,2,4,0,0,3,4,75.0,1,4,3,1,4,8,45,0,0,2020-2021,0.6557377049180328,0.6557377049180328
2590,Fikayo Tomori,ENG,DF,Chelsea,Premier League,22,1997,0.5,2,1,2,0,0,0,0,0.0,0,1,1,0,2,4,8,0,0,2020-2021,4.0,4.0
2591,Fikayo Tomori,ENG,DF,Milan,Serie A,22,1997,16.3,28,18,17,9,2,8,14,57.1,6,32,20,12,18,46,61,1,0,2020-2021,1.1042944785276072,1.7177914110429446
2592,Sandro Tonali,ITA,MF,Milan,Serie A,20,2000,14.8,28,19,14,13,1,13,28,46.4,15,18,5,13,22,50,18,0,0,2020-2021,1.4864864864864864,1.8918918918918919
2593,Lorenzo Tonelli,ITA,DF,Sampdoria,Serie A,30,1990,19.8,33,18,20,11,2,10,21,47.6,11,21,14,7,25,58,94,1,0,2020-2021,1.2626262626262625,1.6666666666666665
2594,Toño,ESP,"DF,FW",Levante,La Liga,30,1989,8.1,4,0,4,0,0,0,2,0.0,2,10,1,9,7,11,12,0,0,2020-2021,0.8641975308641976,0.4938271604938272
2595,Ömer Toprak,TUR,DF,Werder Bremen,Bundesliga,31,1989,21.6,23,16,15,6,2,12,24,50.0,12,27,16,11,36,59,115,1,0,2020-2021,1.6666666666666665,1.0648148148148147
2596,Tyron Tormin,FRA,"FW,MF",Saint-Étienne,Ligue 1,19,2001,0.2,0,0,0,0,0,0,0,0.0,0,0,0,0,0,0,0,0,0,2020-2021,0.0,0.0
2597,Ernesto Torregrossa,VEN,FW,Sampdoria,Serie A,28,1992,1.9,1,1,0,0,1,0,2,0.0,2,4,0,4,1,2,1,0,0,2020-2021,0.5263157894736842,0.5263157894736842
2598,Lucas Torreira,URU,MF,Atlético Madrid,La Liga,24,1996,5.8,8,4,2,3,3,0,3,0.0,3,5,3,2,12,20,8,0,0,2020-2021,2.0689655172413794,1.3793103448275863
2599,Ferrán Torres,ESP,"FW,MF",Manchester City,Premier League,20,2000,14.5,12,5,4,6,2,5,16,31.3,11,16,0,16,3,15,8,0,0,2020-2021,0.20689655172413793,0.8275862068965517
2600,Óliver Torres,ESP,"MF,FW",Sevilla,La Liga,25,1994,15.6,34,22,13,15,6,19,53,35.8,34,15,0,15,15,49,9,0,0,2020-2021,0.9615384615384616,2.1794871794871797
Rk,Player,Nation,Pos,Squad,Comp,0,0,90.0,0,0,3,3,3,Tkl,0,0.0,0,0,0,0,0,0,0,0,0,2020-2021,0.0,0.0
2601,Pau Torres,ESP,DF,Villarreal,La Liga,23,1997,33.0,17,11,10,5,2,11,18,61.1,7,33,25,8,23,40,111,1,0,2020-2021,0.696969696969697,0.5151515151515151
2602,Roberto Torres,ESP,"MF,FW",Osasuna,La Liga,31,1989,21.0,15,8,6,5,4,8,29,27.6,21,12,0,12,16,31,13,0,0,2020-2021,0.7619047619047619,0.7142857142857143
2603,Lucas Torró,ESP,MF,Osasuna,La Liga,26,1994,17.2,32,15,11,19,2,21,34,61.8,13,16,7,9,27,59,43,0,0,2020-2021,1.5697674418604652,1.8604651162790697
2604,Jordan Torunarigha,GER,DF,Hertha BSC,Bundesliga,22,1997,10.8,7,4,7,0,0,5,8,62.5,3,8,2,6,15,22,54,1,0,2020-2021,1.3888888888888888,0.6481481481481481
2605,Cenk Tosun,TUR,FW,Everton,Premier League,29,1991,0.5,0,0,0,0,0,0,1,0.0,1,0,0,0,0,0,0,0,0,2020-2021,0.0,0.0
2606,Abdoulaye Touré,GUI,MF,Nantes,Ligue 1,26,1994,18.7,28,12,10,16,2,14,31,45.2,17,17,2,15,22,50,19,0,0,2020-2021,1.1764705882352942,1.4973262032085561
2607,Almamy Touré,MLI,DF,Eint Frankfurt,Bundesliga,24,1996,7.8,18,12,8,7,3,10,14,71.4,4,5,1,4,8,26,22,0,0,2020-2021,1.0256410256410258,2.307692307692308
2608,Lucas Tousart,FRA,MF,Hertha BSC,Bundesliga,23,1997,23.2,33,18,16,15,2,13,27,48.1,14,33,6,27,40,73,52,0,0,2020-2021,1.7241379310344829,1.4224137931034484
2609,Andros Townsend,ENG,"MF,FW",Crystal Palace,Premier League,29,1991,25.1,78,41,45,20,13,30,79,38.0,49,48,2,46,41,119,19,0,0,2020-2021,1.6334661354581672,3.1075697211155378
2610,Conor Townsend,ENG,DF,West Brom,Premier League,27,1993,24.8,44,28,32,9,3,30,49,61.2,19,38,15,23,36,80,55,2,0,2020-2021,1.4516129032258065,1.7741935483870968
2611,Mattéo Tramoni,FRA,"MF,FW",Cagliari,Serie A,20,2000,0.8,4,2,2,1,1,1,2,50.0,1,5,0,5,1,5,2,0,0,2020-2021,1.25,5.0
2612,Adama Traoré,ESP,"FW,MF",Wolves,Premier League,24,1996,29.4,28,16,11,13,4,13,21,61.9,8,23,1,22,7,35,12,1,0,2020-2021,0.2380952380952381,0.9523809523809524
2613,Amadou Traore,FRA,"FW,MF",Bordeaux,Ligue 1,18,2002,3.4,6,1,2,2,2,2,9,22.2,7,9,0,9,1,7,2,0,0,2020-2021,0.29411764705882354,1.7647058823529411
2614,Bertrand Traoré,BFA,FW,Aston Villa,Premier League,24,1995,25.7,26,10,8,10,8,10,34,29.4,24,23,1,22,15,41,14,1,0,2020-2021,0.5836575875486382,1.0116731517509727
2615,Boubacar Traoré,MLI,MF,Metz,Ligue 1,18,2001,0.6,3,2,1,2,0,1,1,100.0,0,1,0,1,0,3,0,0,0,2020-2021,0.0,5.0
2616,Chaka Traorè,CIV,"FW,DF",Parma,Serie A,15,2004,0.2,0,0,0,0,0,0,0,0.0,0,0,0,0,0,0,1,1,0,2020-2021,0.0,0.0
2617,Charles Traore,MLI,DF,Nantes,Ligue 1,28,1992,18.9,53,34,30,17,6,27,54,50.0,27,26,5,21,36,89,65,0,0,2020-2021,1.9047619047619049,2.8042328042328046
2618,Cheick Traoré,MLI,DF,Lens,Ligue 1,25,1995,0.4,2,2,1,1,0,2,4,50.0,2,1,0,1,2,4,1,0,0,2020-2021,5.0,5.0
2619,Hamari Traoré,MLI,DF,Rennes,Ligue 1,28,1992,33.3,56,38,23,27,6,22,59,37.3,37,31,5,26,76,132,50,0,0,2020-2021,2.2822822822822824,1.6816816816816818
2620,Ibrahima Traoré,GUI,"FW,DF",Gladbach,Bundesliga,32,1988,1.1,4,1,1,2,1,0,0,0.0,0,2,0,2,0,4,0,0,0,2020-2021,0.0,3.6363636363636362
2621,Ismaël Traoré,CIV,DF,Angers,Ligue 1,33,1986,33.3,32,14,23,9,0,20,37,54.1,17,27,13,14,40,72,107,0,0,2020-2021,1.2012012012012012,0.9609609609609611
2622,Kevin Trapp,GER,GK,Eint Frankfurt,Bundesliga,30,1990,33.0,0,0,0,0,0,0,1,0.0,1,1,0,1,3,3,11,3,0,2020-2021,0.09090909090909091,0.0
2623,Miguel Trauco,PER,DF,Saint-Étienne,Ligue 1,27,1992,22.6,47,29,25,14,8,23,43,53.5,20,19,4,15,30,77,34,1,0,2020-2021,1.327433628318584,2.079646017699115
2624,Trézéguet,EGY,FW,Aston Villa,Premier League,25,1994,13.0,33,18,14,15,4,13,45,28.9,32,13,1,12,19,52,17,0,0,2020-2021,1.4615384615384615,2.5384615384615383
2625,Manu Trigueros,ESP,MF,Villarreal,La Liga,28,1991,28.1,51,30,25,21,5,21,77,27.3,56,32,2,30,17,68,19,0,0,2020-2021,0.6049822064056939,1.8149466192170818
Rk,Player,Nation,Pos,Squad,Comp,0,0,90.0,0,0,3,3,3,Tkl,0,0.0,0,0,0,0,0,0,0,0,0,2020-2021,0.0,0.0
2626,Christopher Trimmel,AUT,"DF,FW",Union Berlin,Bundesliga,33,1987,28.6,50,25,28,18,4,28,54,51.9,26,32,7,25,50,100,99,0,0,2020-2021,1.7482517482517481,1.7482517482517481
2627,Francisco Trincão,POR,"FW,MF",Barcelona,La Liga,20,1999,7.8,4,2,0,3,1,2,5,40.0,3,4,0,4,1,5,2,0,0,2020-2021,0.12820512820512822,0.5128205128205129
2628,Alessandro Tripaldelli,ITA,DF,Cagliari,Serie A,21,1999,3.3,13,6,5,6,2,5,6,83.3,1,6,1,5,3,16,15,0,0,2020-2021,0.9090909090909092,3.9393939393939394
2629,Kieran Trippier,ENG,DF,Atlético Madrid,La Liga,29,1990,27.5,61,39,30,25,6,26,52,50.0,26,22,4,18,40,101,58,1,0,2020-2021,1.4545454545454546,2.2181818181818183
2630,Leandro Trossard,BEL,"MF,FW",Brighton,Premier League,25,1994,29.0,33,14,11,16,6,10,36,27.8,26,34,2,32,26,59,7,1,0,2020-2021,0.896551724137931,1.1379310344827587
2631,Alexis Trouillet,FRA,"MF,FW",Nice,Ligue 1,19,2000,1.2,5,4,1,4,0,4,5,80.0,1,0,0,0,3,8,0,0,0,2020-2021,2.5,4.166666666666667
2632,Adrien Truffert,FRA,"DF,MF",Rennes,Ligue 1,18,2001,21.7,38,18,18,12,8,13,24,54.2,11,26,5,21,18,56,38,1,0,2020-2021,0.8294930875576038,1.7511520737327189
2633,Marvin Tshibuabua,FRA,DF,Saint-Étienne,Ligue 1,18,2002,0.5,1,0,1,0,0,0,0,0.0,0,0,0,0,1,2,1,0,0,2020-2021,2.0,2.0
2634,Kostas Tsimikas,GRE,"DF,FW",Liverpool,Premier League,24,1996,0.1,0,0,0,0,0,0,0,0.0,0,0,0,0,0,0,0,0,0,2020-2021,0.0,0.0
2635,Axel Tuanzebe,COD,DF,Manchester Utd,Premier League,22,1997,4.5,13,7,5,7,1,8,9,88.9,1,7,5,2,3,16,18,0,0,2020-2021,0.6666666666666666,2.888888888888889
2636,Alessandro Tuia,ITA,DF,Benevento,Serie A,30,1990,19.6,39,17,34,4,1,15,25,60.0,10,22,10,12,36,75,91,1,0,2020-2021,1.8367346938775508,1.9897959183673468
2637,Ľubomír Tupta,SVK,FW,Hellas Verona,Serie A,22,1998,0.6,0,0,0,0,0,0,0,0.0,0,0,0,0,0,0,0,0,0,2020-2021,0.0,0.0
2638,Tuta,BRA,DF,Eint Frankfurt,Bundesliga,21,1999,16.2,35,20,22,13,0,24,43,55.8,19,19,2,17,29,64,53,0,0,2020-2021,1.7901234567901236,2.160493827160494
2639,Destiny Udogie,ITA,"DF,MF",Hellas Verona,Serie A,17,2002,1.9,6,4,2,2,2,2,2,100.0,0,3,0,3,2,8,4,0,0,2020-2021,1.0526315789473684,3.1578947368421053
2640,Matthieu Udol,FRA,DF,Metz,Ligue 1,24,1996,19.2,34,21,18,12,4,17,39,43.6,22,25,5,20,39,73,30,0,0,2020-2021,2.03125,1.7708333333333335
2641,Naomichi Ueda,JPN,DF,Nîmes,Ligue 1,25,1994,7.9,4,2,3,1,0,4,6,66.7,2,5,4,1,6,10,30,1,0,2020-2021,0.7594936708860759,0.5063291139240506
2642,Lesley Ugochukwu,FRA,MF,Rennes,Ligue 1,16,2004,0.7,3,1,0,3,0,2,3,66.7,1,1,0,1,0,3,0,0,0,2020-2021,0.0,4.285714285714286
2643,Hwang Ui-jo,KOR,"FW,MF",Bordeaux,Ligue 1,27,1992,27.8,14,6,5,8,1,6,25,24.0,19,17,2,15,8,22,14,0,0,2020-2021,0.28776978417266186,0.5035971223021583
2644,Samir Ujkani,KVX,GK,Torino,Serie A,32,1988,1.0,0,0,0,0,0,0,0,0.0,0,0,0,0,0,0,1,0,0,2020-2021,0.0,0.0
2645,Samuel Umtiti,FRA,DF,Barcelona,La Liga,26,1993,7.2,5,1,3,2,0,1,2,50.0,1,11,6,5,9,14,15,0,0,2020-2021,1.25,0.6944444444444444
2646,Enes Ünal,TUR,FW,Getafe,La Liga,23,1997,14.6,11,3,0,8,3,4,15,26.7,11,11,0,11,2,13,14,0,0,2020-2021,0.136986301369863,0.7534246575342466
2647,Cengiz Ünder,TUR,"FW,MF",Leicester City,Premier League,23,1997,3.1,4,1,0,3,1,3,5,60.0,2,3,0,3,2,6,0,0,0,2020-2021,0.6451612903225806,1.2903225806451613
2648,Dayot Upamecano,FRA,DF,RB Leipzig,Bundesliga,21,1998,25.9,37,30,18,19,0,14,20,70.0,6,25,14,11,33,70,74,2,0,2020-2021,1.2741312741312742,1.4285714285714286
2649,Kacper Urbanski,POL,FW,Bologna,Serie A,15,2004,0.0,0,0,0,0,0,0,0,0.0,0,0,0,0,0,0,0,0,0,2020-2021,,
2650,Mark Uth,GER,"FW,MF",Schalke 04,Bundesliga,28,1991,16.6,25,13,13,10,2,5,23,21.7,18,21,0,21,5,30,10,0,0,2020-2021,0.3012048192771084,1.506024096385542
Rk,Player,Nation,Pos,Squad,Comp,0,0,90.0,0,0,3,3,3,Tkl,0,0.0,0,0,0,0,0,0,0,0,0,2020-2021,0.0,0.0
2651,Tomáš Vaclík,CZE,GK,Sevilla,La Liga,31,1989,5.0,0,0,0,0,0,0,1,0.0,1,0,0,0,0,0,0,1,0,2020-2021,0.0,0.0
2652,Eugeni Valderrama,ESP,"MF,FW",Huesca,La Liga,26,1994,1.3,2,2,1,0,1,0,1,0.0,1,0,0,0,5,7,3,0,0,2020-2021,3.846153846153846,1.5384615384615383
2653,Lautaro Valenti,ARG,DF,Parma,Serie A,21,1999,5.5,10,4,7,2,1,6,15,40.0,9,11,3,8,11,21,30,0,0,2020-2021,2.0,1.8181818181818181
2654,Antoine Valerio,FRA,MF,Nîmes,Ligue 1,20,1999,0.8,0,0,0,0,0,0,1,0.0,1,1,0,1,2,2,0,0,0,2020-2021,2.5,0.0
2655,Borja Valero,ESP,"MF,FW",Fiorentina,Serie A,35,1985,5.5,13,9,7,4,2,3,15,20.0,12,6,1,5,6,19,2,0,0,2020-2021,1.0909090909090908,2.3636363636363638
2656,Yan Valery,TUN,"DF,MF",Southampton,Premier League,21,1999,1.1,5,3,2,3,0,1,5,20.0,4,2,0,2,2,7,5,0,0,2020-2021,1.8181818181818181,4.545454545454545
2657,Jesús Vallejo,ESP,DF,Granada,La Liga,23,1997,15.0,11,6,7,3,1,7,18,38.9,11,21,11,10,13,24,55,0,0,2020-2021,0.8666666666666667,0.7333333333333333
2658,Manu Vallejo,ESP,"FW,MF",Valencia,La Liga,23,1997,10.6,18,8,5,8,5,5,26,19.2,21,8,0,8,3,21,3,0,0,2020-2021,0.2830188679245283,1.6981132075471699
2659,Federico Valverde,URU,MF,Real Madrid,La Liga,22,1998,14.8,25,16,9,8,8,10,26,38.5,16,16,2,14,22,47,4,0,0,2020-2021,1.4864864864864864,1.689189189189189
2660,Virgil van Dijk,NED,DF,Liverpool,Premier League,29,1991,4.1,3,2,1,2,0,0,0,0.0,0,1,1,0,5,8,8,1,0,2020-2021,1.2195121951219514,0.7317073170731708
2661,Raphaël Varane,FRA,DF,Real Madrid,La Liga,27,1993,30.2,22,14,16,5,1,10,19,52.6,9,26,18,8,36,58,114,2,0,2020-2021,1.1920529801324504,0.728476821192053
2662,Jamie Vardy,ENG,FW,Leicester City,Premier League,33,1987,31.6,18,12,1,8,9,2,15,13.3,13,14,5,9,4,22,32,0,0,2020-2021,0.12658227848101264,0.5696202531645569
2663,Ruben Vargas,SUI,"MF,FW",Augsburg,Bundesliga,21,1998,17.9,18,12,6,9,3,1,16,6.3,15,26,2,24,18,36,27,0,0,2020-2021,1.005586592178771,1.005586592178771
2664,Denis Vavro,SVK,DF,Lazio,Serie A,24,1996,0.4,0,0,0,0,0,0,1,0.0,1,0,0,0,1,1,3,0,0,2020-2021,2.5,0.0
2665,Denis Vavro,SVK,DF,Huesca,La Liga,24,1996,6.8,7,4,2,4,1,2,5,40.0,3,2,0,2,11,18,21,0,0,2020-2021,1.6176470588235294,1.0294117647058825
2666,Franco Vázquez,ARG,"FW,MF",Sevilla,La Liga,31,1989,1.8,5,1,0,3,2,1,5,20.0,4,2,1,1,1,6,1,0,0,2020-2021,0.5555555555555556,2.7777777777777777
2667,Kevin Vázquez,ESP,DF,Celta Vigo,La Liga,27,1993,6.2,11,5,9,2,0,3,9,33.3,6,8,0,8,9,20,18,0,0,2020-2021,1.4516129032258065,1.7741935483870968
2668,Lucas Vázquez,ESP,"DF,FW",Real Madrid,La Liga,29,1991,20.5,61,37,30,22,9,22,52,42.3,30,14,1,13,19,80,31,1,0,2020-2021,0.926829268292683,2.975609756097561
2669,Matías Vecino,URU,MF,Inter,Serie A,28,1991,3.1,1,1,0,0,1,0,5,0.0,5,7,1,6,4,5,3,0,0,2020-2021,1.2903225806451613,0.3225806451612903
2670,Koke Vegas,ESP,GK,Levante,La Liga,24,1995,1.0,0,0,0,0,0,0,0,0.0,0,0,0,0,0,0,1,1,0,2020-2021,0.0,0.0
2671,Gabriel Veiga,ESP,"MF,DF",Celta Vigo,La Liga,18,2002,1.3,3,0,3,0,0,1,4,25.0,3,3,0,3,3,6,0,0,0,2020-2021,2.3076923076923075,2.3076923076923075
2672,Miloš Veljković,SRB,DF,Werder Bremen,Bundesliga,24,1995,19.1,24,14,17,6,1,15,31,48.4,16,22,9,13,29,53,94,1,0,2020-2021,1.5183246073298429,1.256544502617801
2673,Miguel Veloso,POR,MF,Hellas Verona,Serie A,34,1986,14.6,24,17,10,10,4,12,34,35.3,22,12,1,11,12,36,25,0,0,2020-2021,0.8219178082191781,1.6438356164383563
2674,Joël Veltman,NED,DF,Brighton,Premier League,28,1992,25.3,67,33,34,25,8,29,57,50.9,28,24,5,19,33,100,64,0,0,2020-2021,1.3043478260869565,2.6482213438735176
2675,Unai Vencedor Paris,ESP,MF,Athletic Club,La Liga,19,2000,18.9,31,21,10,15,6,11,42,26.2,31,17,6,11,18,49,14,0,0,2020-2021,0.9523809523809524,1.6402116402116402
Rk,Player,Nation,Pos,Squad,Comp,0,0,90.0,0,0,3,3,3,Tkl,0,0.0,0,0,0,0,0,0,0,0,0,2020-2021,0.0,0.0
2676,Lorenzo Venuti,ITA,DF,Fiorentina,Serie A,25,1995,19.5,24,11,14,7,3,14,28,50.0,14,18,3,15,17,41,24,0,0,2020-2021,0.8717948717948718,1.2307692307692308
2677,Daniele Verde,ITA,FW,Spezia,Serie A,24,1996,10.9,5,4,2,2,1,4,10,40.0,6,5,0,5,9,14,7,0,0,2020-2021,0.8256880733944953,0.4587155963302752
2678,Simone Verdi,ITA,"MF,FW",Torino,Serie A,28,1992,18.0,19,12,10,6,3,6,19,31.6,13,8,0,8,8,27,2,2,0,2020-2021,0.4444444444444444,1.0555555555555556
2679,Gonzalo Verdú,ESP,DF,Elche,La Liga,31,1988,32.7,34,19,26,8,0,16,28,57.1,12,40,30,10,52,86,113,0,0,2020-2021,1.5902140672782874,1.039755351681957
2680,Jordan Veretout,FRA,MF,Roma,Serie A,27,1993,22.8,20,12,8,12,0,9,33,27.3,24,14,3,11,14,34,21,3,0,2020-2021,0.6140350877192983,0.8771929824561403
2681,Edoardo Vergani,ITA,FW,Bologna,Serie A,19,2001,0.1,0,0,0,0,0,0,0,0.0,0,0,0,0,0,0,0,0,0,2020-2021,0.0,0.0
2682,Marco Verratti,ITA,MF,Paris S-G,Ligue 1,27,1992,16.6,53,30,17,25,11,24,72,33.3,48,22,5,17,26,79,4,1,0,2020-2021,1.5662650602409638,3.192771084337349
2683,Valerio Verre,ITA,"FW,MF",Sampdoria,Serie A,26,1994,11.1,11,7,2,7,2,4,19,21.1,15,14,2,12,9,20,3,0,0,2020-2021,0.8108108108108109,0.990990990990991
2684,Mikel Vesga,ESP,MF,Athletic Club,La Liga,27,1993,19.1,28,14,8,16,4,12,50,24.0,38,28,8,20,27,55,35,1,0,2020-2021,1.413612565445026,1.4659685863874345
2685,Jannik Vestergaard,DEN,DF,Southampton,Premier League,27,1992,28.6,50,31,31,15,4,35,52,67.3,17,29,16,13,42,92,122,0,0,2020-2021,1.4685314685314685,1.7482517482517481
2686,Rúben Vezo,POR,DF,Levante,La Liga,26,1994,25.7,34,19,26,7,1,12,29,41.4,17,22,11,11,46,80,106,3,0,2020-2021,1.7898832684824904,1.3229571984435797
2687,Guglielmo Vicario,ITA,GK,Cagliari,Serie A,23,1996,4.0,0,0,0,0,0,0,0,0.0,0,0,0,0,0,0,1,0,0,2020-2021,0.0,0.0
2688,Iñigo Vicente,ESP,"FW,MF",Athletic Club,La Liga,22,1998,0.6,1,1,1,0,0,1,1,100.0,0,0,0,0,0,1,0,0,0,2020-2021,0.0,1.6666666666666667
2689,Fede Vico,ESP,"MF,FW",Granada,La Liga,26,1994,8.5,10,6,5,5,0,3,10,30.0,7,15,1,14,12,22,5,0,0,2020-2021,1.411764705882353,1.1764705882352942
2690,Aleix Vidal,ESP,DF,Sevilla,La Liga,30,1989,6.6,9,5,5,3,1,5,12,41.7,7,10,1,9,12,21,9,0,0,2020-2021,1.8181818181818183,1.3636363636363638
2691,Arturo Vidal,CHI,MF,Inter,Serie A,33,1987,12.6,27,14,8,13,6,12,41,29.3,29,23,3,20,29,56,11,0,0,2020-2021,2.301587301587302,2.142857142857143
2692,Clément Vidal,FRA,DF,Montpellier,Ligue 1,20,2000,1.0,2,1,1,1,0,2,4,50.0,2,4,4,0,1,3,6,1,0,2020-2021,1.0,2.0
2693,Nacho Vidal,ESP,DF,Osasuna,La Liga,25,1995,26.1,56,28,27,22,7,22,31,71.0,9,39,10,29,43,99,68,0,0,2020-2021,1.6475095785440612,2.1455938697318007
2694,Ronaldo Vieira,ENG,"MF,DF",Hellas Verona,Serie A,22,1998,2.5,5,3,1,3,1,0,2,0.0,2,4,3,1,0,5,2,0,0,2020-2021,0.0,2.0
2695,Luca Vignali,ITA,DF,Spezia,Serie A,24,1996,17.7,19,9,10,6,3,7,25,28.0,18,13,5,8,22,41,25,0,0,2020-2021,1.2429378531073447,1.073446327683616
2696,Emanuel Vignato,ITA,"FW,MF",Bologna,Serie A,19,2000,13.4,18,9,9,6,3,3,15,20.0,12,6,1,5,10,28,7,0,0,2020-2021,0.7462686567164178,1.3432835820895521
2697,Toni Villa,ESP,"MF,FW",Valladolid,La Liga,25,1995,10.8,31,16,11,14,6,15,42,35.7,27,15,1,14,5,36,3,0,0,2020-2021,0.4629629629629629,2.8703703703703702
2698,Asier Villalibre,ESP,FW,Athletic Club,La Liga,22,1997,17.7,3,2,0,2,1,2,8,25.0,6,4,0,4,2,5,16,0,0,2020-2021,0.11299435028248588,0.16949152542372883
2699,Gonzalo Villar,ESP,MF,Roma,Serie A,22,1998,20.7,44,18,14,24,6,18,61,29.5,43,25,3,22,22,66,14,1,0,2020-2021,1.0628019323671498,2.1256038647342996
2700,Iván Villar,ESP,GK,Celta Vigo,La Liga,23,1997,19.8,0,0,0,0,0,0,1,0.0,1,0,0,0,0,0,18,0,0,2020-2021,0.0,0.0
Rk,Player,Nation,Pos,Squad,Comp,0,0,90.0,0,0,3,3,3,Tkl,0,0.0,0,0,0,0,0,0,0,0,0,2020-2021,0.0,0.0
2701,Rúben Vinagre,POR,"MF,DF",Wolves,Premier League,21,1999,1.9,7,5,5,2,0,3,4,75.0,1,3,0,3,2,9,4,0,0,2020-2021,1.0526315789473684,3.68421052631579
2702,Carlos Vinícius,BRA,FW,Tottenham,Premier League,25,1995,3.4,3,1,2,1,0,1,1,100.0,0,0,0,0,2,5,5,0,0,2020-2021,0.5882352941176471,0.8823529411764706
2703,Nicolas Viola,ITA,MF,Benevento,Serie A,30,1989,11.5,16,9,2,11,3,6,28,21.4,22,10,3,7,9,25,7,0,0,2020-2021,0.782608695652174,1.391304347826087
2704,João Virgínia,POR,GK,Everton,Premier League,20,1999,0.5,0,0,0,0,0,0,0,0.0,0,0,0,0,0,0,0,0,0,2020-2021,0.0,0.0
2705,Vitinha,POR,MF,Wolves,Premier League,20,2000,5.8,7,3,2,5,0,3,8,37.5,5,3,0,3,3,10,1,0,0,2020-2021,0.5172413793103449,1.206896551724138
2706,Vitolo,ESP,"MF,FW",Atlético Madrid,La Liga,30,1989,3.3,4,1,2,0,2,1,6,16.7,5,3,0,3,3,7,2,0,0,2020-2021,0.9090909090909092,1.2121212121212122
2707,Dušan Vlahović,SRB,FW,Fiorentina,Serie A,20,2000,32.5,13,4,3,4,6,5,16,31.3,11,16,2,14,4,17,15,0,0,2020-2021,0.12307692307692308,0.4
2708,Michel Vlap,NED,"MF,FW",Arminia,Bundesliga,23,1997,4.1,1,1,0,1,0,0,8,0.0,8,4,0,4,5,6,3,0,0,2020-2021,1.2195121951219514,0.24390243902439027
2709,Andreas Voglsammer,GER,"FW,MF",Arminia,Bundesliga,28,1992,11.1,12,8,6,6,0,8,17,47.1,9,11,0,11,3,15,11,0,0,2020-2021,0.2702702702702703,1.0810810810810811
2710,Kevin Vogt,GER,DF,Hoffenheim,Bundesliga,28,1991,20.5,18,12,11,6,1,12,21,57.1,9,21,12,9,16,34,71,0,0,2020-2021,0.7804878048780488,0.8780487804878049
2711,Mërgim Vojvoda,KVX,"DF,FW",Torino,Serie A,25,1995,15.1,24,14,18,5,1,12,22,54.5,10,19,4,15,18,42,35,1,0,2020-2021,1.1920529801324504,1.589403973509934
2712,Jake Vokins,ENG,DF,Southampton,Premier League,20,2000,0.7,0,0,0,0,0,0,1,0.0,1,0,0,0,0,0,0,0,0,2020-2021,0.0,0.0
2713,Kevin Volland,GER,"FW,MF",Monaco,Ligue 1,28,1992,30.8,33,16,11,19,3,8,34,23.5,26,23,0,23,4,37,4,0,0,2020-2021,0.12987012987012986,1.0714285714285714
2714,Stefan de Vrij,NED,DF,Inter,Serie A,28,1992,30.4,28,16,15,12,1,15,24,62.5,9,24,18,6,41,69,95,0,0,2020-2021,1.348684210526316,0.9210526315789475
2715,Giacomo Vrioni,ALB,FW,Juventus,Serie A,21,1998,0.0,0,0,0,0,0,0,0,0.0,0,0,0,0,0,0,0,0,0,2020-2021,,
2716,Šime Vrsaljko,CRO,"FW,DF",Atlético Madrid,La Liga,28,1992,5.8,18,12,13,5,0,8,12,66.7,4,5,0,5,8,26,14,0,0,2020-2021,1.3793103448275863,3.103448275862069
2717,Nikola Vukčević,MNE,MF,Levante,La Liga,28,1991,9.0,14,7,5,8,1,9,18,50.0,9,8,5,3,8,22,12,1,0,2020-2021,0.8888888888888888,1.5555555555555556
2718,Miloš Vulić,SRB,MF,Crotone,Serie A,23,1996,14.5,15,8,9,1,5,8,21,38.1,13,10,1,9,8,23,8,0,0,2020-2021,0.5517241379310345,1.0344827586206897
2719,Matěj Vydra,CZE,FW,Burnley,Premier League,28,1992,15.2,9,5,2,4,3,1,8,12.5,7,8,1,7,6,15,5,0,0,2020-2021,0.39473684210526316,0.5921052631578948
2720,Franklin Wadja,CMR,"MF,FW",Lorient,Ligue 1,25,1995,0.4,4,2,0,2,2,2,2,100.0,0,0,0,0,2,6,1,0,0,2020-2021,5.0,10.0
2721,Elye Wahi,FRA,FW,Montpellier,Ligue 1,17,2003,6.2,4,3,2,1,1,1,6,16.7,5,4,0,4,2,6,5,0,0,2020-2021,0.3225806451612903,0.6451612903225806
2722,Walace,BRA,MF,Udinese,Serie A,25,1995,22.8,50,23,28,19,3,21,60,35.0,39,36,3,33,34,84,23,0,0,2020-2021,1.4912280701754386,2.1929824561403506
2723,Theo Walcott,ENG,"MF,FW",Southampton,Premier League,31,1989,18.0,23,11,8,9,6,11,32,34.4,21,16,0,16,14,37,5,0,0,2020-2021,0.7777777777777778,1.2777777777777777
2724,Theo Walcott,ENG,FW,Everton,Premier League,31,1989,0.1,0,0,0,0,0,0,0,0.0,0,0,0,0,0,0,0,0,0,2020-2021,0.0,0.0
2725,Kyle Walker,ENG,DF,Manchester City,Premier League,30,1990,21.6,29,19,15,12,2,16,24,66.7,8,19,7,12,14,43,28,0,0,2020-2021,0.6481481481481481,1.3425925925925926
Rk,Player,Nation,Pos,Squad,Comp,0,0,90.0,0,0,3,3,3,Tkl,0,0.0,0,0,0,0,0,0,0,0,0,2020-2021,0.0,0.0
2726,Kyle Walker-Peters,ENG,DF,Southampton,Premier League,23,1997,29.4,83,53,56,25,2,34,57,59.6,23,41,10,31,38,121,66,2,0,2020-2021,1.2925170068027212,2.8231292517006805
2727,Sebastian Walukiewicz,POL,DF,Cagliari,Serie A,20,2000,18.0,27,19,11,13,3,12,30,40.0,18,22,14,8,36,63,60,0,0,2020-2021,2.0,1.5
2728,Aaron Wan-Bissaka,ENG,DF,Manchester Utd,Premier League,22,1997,34.0,88,54,53,29,6,32,45,71.1,13,65,17,48,62,150,84,2,0,2020-2021,1.8235294117647058,2.588235294117647
2729,Joel Ward,ENG,DF,Crystal Palace,Premier League,30,1989,25.1,43,25,29,14,0,24,42,57.1,18,27,8,19,41,84,87,2,0,2020-2021,1.6334661354581672,1.7131474103585655
2730,James Ward-Prowse,ENG,MF,Southampton,Premier League,25,1994,38.0,75,49,30,41,4,29,70,41.4,41,36,4,32,42,117,60,0,0,2020-2021,1.105263157894737,1.9736842105263157
2731,Daniel Wass,DEN,"MF,DF",Valencia,La Liga,31,1989,33.1,52,31,21,29,2,22,55,40.0,33,33,13,20,47,99,69,0,0,2020-2021,1.4199395770392749,1.5709969788519638
2732,Ollie Watkins,ENG,FW,Aston Villa,Premier League,24,1995,37.0,29,17,5,16,8,10,33,30.3,23,21,2,19,7,36,24,0,0,2020-2021,0.1891891891891892,0.7837837837837838
2733,Caleb Watts,AUS,MF,Southampton,Premier League,18,2002,0.4,2,1,2,0,0,1,2,50.0,1,0,0,0,0,2,0,0,0,2020-2021,0.0,5.0
2734,Timothy Weah,USA,"FW,MF",Lille,Ligue 1,20,2000,9.8,15,7,3,9,3,7,14,50.0,7,7,0,7,4,19,5,0,0,2020-2021,0.4081632653061224,1.530612244897959
2735,Adam Webster,ENG,DF,Brighton,Premier League,25,1995,28.8,29,16,15,10,4,12,25,48.0,13,29,16,13,47,76,92,3,0,2020-2021,1.6319444444444444,1.0069444444444444
2736,Wout Weghorst,NED,FW,Wolfsburg,Bundesliga,27,1992,32.7,13,8,2,8,3,4,20,20.0,16,17,3,14,4,17,26,0,0,2020-2021,0.12232415902140671,0.39755351681957185
2737,Mitchell Weiser,GER,DF,Leverkusen,Bundesliga,26,1994,2.5,4,1,1,2,1,2,4,50.0,2,1,0,1,3,7,4,0,0,2020-2021,1.2,1.6
2738,Shon Weissman,ISR,FW,Valladolid,La Liga,24,1996,23.7,12,9,4,5,3,2,23,8.7,21,17,3,14,8,20,7,0,0,2020-2021,0.33755274261603374,0.5063291139240507
2739,Danny Welbeck,ENG,FW,Brighton,Premier League,29,1990,17.2,12,6,2,6,4,7,19,36.8,12,17,0,17,7,19,13,0,0,2020-2021,0.4069767441860465,0.6976744186046512
2740,Wendell,BRA,DF,Leverkusen,Bundesliga,27,1993,16.2,53,35,27,18,8,23,49,46.9,26,26,3,23,25,78,39,1,0,2020-2021,1.5432098765432098,3.2716049382716053
2741,Oscar Wendt,SWE,DF,Gladbach,Bundesliga,34,1985,13.9,12,6,2,9,1,4,12,33.3,8,18,4,14,14,26,23,0,0,2020-2021,1.0071942446043165,0.8633093525179856
2742,Timo Werner,GER,"FW,MF",Chelsea,Premier League,24,1996,28.9,20,9,6,11,3,7,43,16.3,36,23,1,22,8,28,8,0,0,2020-2021,0.2768166089965398,0.6920415224913495
2743,Ashley Westwood,ENG,MF,Burnley,Premier League,30,1990,37.9,23,15,6,12,5,10,42,23.8,32,26,9,17,44,67,33,0,0,2020-2021,1.1609498680738786,0.6068601583113457
2744,Ben White,ENG,"DF,MF",Brighton,Premier League,22,1997,35.5,49,26,21,24,4,24,57,42.1,33,46,22,24,62,111,56,0,0,2020-2021,1.7464788732394365,1.380281690140845
2745,Georginio Wijnaldum,NED,MF,Liverpool,Premier League,29,1990,32.7,23,7,6,14,3,7,31,22.6,24,18,3,15,26,49,18,1,0,2020-2021,0.7951070336391437,0.7033639143730887
2746,William,BRA,"MF,FW",Wolfsburg,Bundesliga,25,1995,0.0,0,0,0,0,0,0,0,0.0,0,0,0,0,0,0,0,0,0,2020-2021,,
2747,William,BRA,"DF,FW",Schalke 04,Bundesliga,25,1995,5.3,14,10,10,4,0,5,15,33.3,10,16,5,11,11,25,15,1,0,2020-2021,2.0754716981132075,2.6415094339622645
2748,Brandon Williams,ENG,DF,Manchester Utd,Premier League,19,2000,2.1,0,0,0,0,0,0,1,0.0,1,1,0,1,1,1,7,0,0,2020-2021,0.47619047619047616,0.0
2749,Iñaki Williams,GHA,FW,Athletic Club,La Liga,26,1994,26.5,11,7,0,4,7,2,14,14.3,12,13,1,12,5,16,22,0,0,2020-2021,0.18867924528301888,0.41509433962264153
2750,Neco Williams,WAL,DF,Liverpool,Premier League,19,2001,2.8,6,5,4,2,0,5,9,55.6,4,3,1,2,6,12,6,0,0,2020-2021,2.142857142857143,2.142857142857143
Rk,Player,Nation,Pos,Squad,Comp,0,0,90.0,0,0,3,3,3,Tkl,0,0.0,0,0,0,0,0,0,0,0,0,2020-2021,0.0,0.0
2751,Nico Williams,ESP,MF,Athletic Club,La Liga,18,2002,0.6,1,0,1,0,0,0,2,0.0,2,0,0,0,1,2,0,0,0,2020-2021,1.6666666666666667,1.6666666666666667
2752,Rhys Williams,ENG,DF,Liverpool,Premier League,19,2001,7.3,6,4,3,3,0,3,3,100.0,0,4,3,1,6,12,27,1,0,2020-2021,0.8219178082191781,0.8219178082191781
2753,Willian,BRA,FW,Arsenal,Premier League,31,1988,15.6,13,7,6,6,1,6,16,37.5,10,13,0,13,8,21,8,0,0,2020-2021,0.5128205128205129,0.8333333333333334
2754,Joe Willock,ENG,MF,Arsenal,Premier League,20,1999,2.6,6,3,1,4,1,3,7,42.9,4,6,1,5,3,9,0,0,0,2020-2021,1.1538461538461537,2.3076923076923075
2755,Joe Willock,ENG,MF,Newcastle Utd,Premier League,20,1999,10.9,26,13,16,7,3,9,42,21.4,33,21,3,18,17,43,15,1,0,2020-2021,1.5596330275229358,2.385321100917431
2756,Callum Wilson,ENG,FW,Newcastle Utd,Premier League,28,1992,23.2,12,5,1,6,5,2,12,16.7,10,10,3,7,7,19,14,0,0,2020-2021,0.3017241379310345,0.5172413793103449
2757,Marten Winkler,GER,FW,Hertha BSC,Bundesliga,17,2002,0.0,0,0,0,0,0,0,0,0.0,0,0,0,0,0,0,0,0,0,2020-2021,,
2758,Harry Winks,ENG,MF,Tottenham,Premier League,24,1996,9.6,16,9,11,5,0,5,20,25.0,15,16,4,12,11,27,12,1,0,2020-2021,1.1458333333333335,1.6666666666666667
2759,Florian Wirtz,GER,MF,Leverkusen,Bundesliga,17,2003,24.7,35,18,8,22,5,11,37,29.7,26,27,1,26,9,44,8,0,0,2020-2021,0.3643724696356275,1.417004048582996
2760,Yoane Wissa,COD,"MF,FW",Lorient,Ligue 1,23,1996,29.7,35,20,12,14,9,11,34,32.4,23,25,3,22,20,55,14,0,0,2020-2021,0.6734006734006734,1.1784511784511784
2761,Axel Witsel,BEL,MF,Dortmund,Bundesliga,31,1989,12.6,18,12,6,11,1,8,16,50.0,8,13,3,10,22,40,13,0,0,2020-2021,1.746031746031746,1.4285714285714286
2762,Hannes Wolf,AUT,"MF,FW",Gladbach,Bundesliga,21,1999,15.3,26,13,8,10,8,8,36,22.2,28,18,1,17,9,35,4,0,0,2020-2021,0.5882352941176471,1.6993464052287581
2763,Marius Wolf,GER,"MF,DF",Köln,Bundesliga,25,1995,28.3,35,19,19,13,3,13,38,34.2,25,29,3,26,28,63,47,1,0,2020-2021,0.989399293286219,1.2367491166077738
2764,Nick Woltemade,GER,"MF,FW",Werder Bremen,Bundesliga,18,2002,1.6,3,2,1,1,1,2,4,50.0,2,1,0,1,0,3,0,0,0,2020-2021,0.0,1.875
2765,Jeong Woo-yeong,KOR,"FW,MF",Freiburg,Bundesliga,20,1999,9.1,9,5,1,6,2,2,11,18.2,9,8,1,7,11,20,11,0,0,2020-2021,1.208791208791209,0.989010989010989
2766,Chris Wood,NZL,FW,Burnley,Premier League,28,1991,30.5,12,7,2,4,6,5,18,27.8,13,14,3,11,1,13,21,0,0,2020-2021,0.03278688524590164,0.39344262295081966
2767,Joscha Wosz,GER,DF,RB Leipzig,Bundesliga,18,2002,0.4,1,1,1,0,0,0,0,0.0,0,1,0,1,1,2,0,0,0,2020-2021,2.5,2.5
2768,Xeka,POR,MF,Lille,Ligue 1,25,1994,13.3,33,17,14,15,4,16,43,37.2,27,14,2,12,20,53,18,0,0,2020-2021,1.5037593984962405,2.481203007518797
2769,Granit Xhaka,SUI,"MF,DF",Arsenal,Premier League,27,1992,28.0,50,26,18,17,15,30,58,51.7,28,23,7,16,24,74,38,3,0,2020-2021,0.8571428571428571,1.7857142857142858
2770,Reinhold Yabo,GER,"MF,FW",Arminia,Bundesliga,28,1992,7.2,5,2,2,2,1,2,9,22.2,7,6,1,5,4,9,1,0,0,2020-2021,0.5555555555555556,0.6944444444444444
2771,Jawad El Yamiq,MAR,DF,Valladolid,La Liga,28,1992,15.3,21,14,14,7,0,8,11,72.7,3,15,10,5,46,67,100,0,0,2020-2021,3.0065359477124183,1.3725490196078431
2772,Rubén Yáñez,ESP,GK,Getafe,La Liga,26,1993,10.0,0,0,0,0,0,0,1,0.0,1,0,0,0,2,2,2,0,0,2020-2021,0.2,0.0
2773,Andriy Yarmolenko,UKR,"FW,MF",West Ham,Premier League,30,1989,4.2,5,4,2,2,1,2,8,25.0,6,1,0,1,1,6,2,0,0,2020-2021,0.23809523809523808,1.1904761904761905
2774,Yusuf Yazıcı,TUR,"FW,MF",Lille,Ligue 1,23,1997,12.1,12,5,6,2,4,1,24,4.2,23,5,1,4,2,14,2,0,0,2020-2021,0.1652892561983471,0.9917355371900827
2775,DeAndre Yedlin,USA,DF,Newcastle Utd,Premier League,27,1993,4.8,9,4,8,1,0,4,10,40.0,6,5,1,4,7,16,17,0,0,2020-2021,1.4583333333333335,1.875
Rk,Player,Nation,Pos,Squad,Comp,0,0,90.0,0,0,3,3,3,Tkl,0,0.0,0,0,0,0,0,0,0,0,0,2020-2021,0.0,0.0
2776,Burak Yılmaz,TUR,FW,Lille,Ligue 1,35,1985,22.8,13,6,3,7,3,4,30,13.3,26,7,0,7,5,18,22,0,0,2020-2021,0.21929824561403508,0.5701754385964912
2777,Yoel,ESP,GK,Eibar,La Liga,31,1988,3.3,0,0,0,0,0,0,0,0.0,0,0,0,0,0,0,2,0,0,2020-2021,0.0,0.0
2778,Okay Yokuşlu,TUR,MF,West Brom,Premier League,26,1994,14.6,38,25,21,13,4,17,35,48.6,18,15,3,12,35,73,33,1,0,2020-2021,2.397260273972603,2.6027397260273974
2779,Okay Yokuşlu,TUR,MF,Celta Vigo,La Liga,26,1994,5.1,14,8,8,4,2,5,9,55.6,4,5,2,3,10,24,9,0,0,2020-2021,1.9607843137254903,2.7450980392156863
2780,Maya Yoshida,JPN,DF,Sampdoria,Serie A,31,1988,25.3,17,4,10,7,0,7,13,53.8,6,45,34,11,57,74,93,1,0,2020-2021,2.2529644268774702,0.6719367588932806
2781,Amin Younes,GER,MF,Eint Frankfurt,Bundesliga,26,1993,15.5,25,14,8,10,7,6,32,18.8,26,19,1,18,13,38,4,0,0,2020-2021,0.8387096774193549,1.6129032258064515
2782,Ashley Young,ENG,DF,Inter,Serie A,35,1985,15.8,15,7,8,4,3,3,13,23.1,10,13,0,13,6,21,31,0,0,2020-2021,0.37974683544303794,0.9493670886075949
2783,Wilitty Younoussa,CMR,MF,Dijon,Ligue 1,18,2001,0.9,6,3,3,3,0,3,7,42.9,4,3,0,3,2,8,0,0,0,2020-2021,2.2222222222222223,6.666666666666666
2784,Zaydou Youssouf,FRA,MF,Saint-Étienne,Ligue 1,21,1999,13.7,30,15,19,10,1,16,40,40.0,24,15,0,15,25,55,12,1,0,2020-2021,1.8248175182481752,2.18978102189781
2785,Mattia Zaccagni,ITA,MF,Hellas Verona,Serie A,25,1995,29.0,27,13,8,11,8,8,25,32.0,17,28,4,24,27,54,13,1,0,2020-2021,0.9310344827586207,0.9310344827586207
2786,Dan-Axel Zagadou,FRA,DF,Dortmund,Bundesliga,21,1999,3.1,2,2,2,0,0,0,0,0.0,0,3,2,1,6,8,13,0,0,2020-2021,1.9354838709677418,0.6451612903225806
2787,Vasilios Zagaritis,GRE,DF,Parma,Serie A,19,2001,0.7,0,0,0,0,0,0,0,0.0,0,1,0,1,0,0,0,0,0,2020-2021,0.0,0.0
2788,Arthur Zagre,FRA,"DF,MF",Dijon,Ligue 1,18,2001,1.4,3,1,2,1,0,2,2,100.0,0,1,1,0,3,6,1,0,0,2020-2021,2.142857142857143,2.142857142857143
2789,Wilfried Zaha,CIV,FW,Crystal Palace,Premier League,27,1992,29.0,26,18,8,15,3,11,30,36.7,19,21,0,21,9,35,4,0,0,2020-2021,0.3103448275862069,0.896551724137931
2790,Miha Zajc,SVN,MF,Genoa,Serie A,26,1994,20.7,22,14,9,10,3,13,39,33.3,26,30,4,26,27,49,19,0,0,2020-2021,1.3043478260869565,1.0628019323671498
2791,Denis Zakaria,SUI,"MF,DF",Gladbach,Bundesliga,23,1996,15.8,30,15,12,15,3,11,20,55.0,9,20,7,13,23,53,29,1,0,2020-2021,1.4556962025316456,1.8987341772151898
2792,Joseba Zaldúa,ESP,DF,Real Sociedad,La Liga,28,1992,7.1,15,12,7,5,3,6,18,33.3,12,6,2,4,6,21,13,0,0,2020-2021,0.8450704225352114,2.1126760563380285
2793,Nicola Zalewski,POL,MF,Roma,Serie A,18,2002,0.1,1,1,0,1,0,1,1,100.0,0,0,0,0,0,1,0,0,0,2020-2021,0.0,10.0
2794,Andre-Frank Zambo Anguissa,CMR,MF,Fulham,Premier League,24,1995,28.7,78,37,27,38,13,27,68,39.7,41,35,6,29,56,134,17,2,0,2020-2021,1.951219512195122,2.7177700348432055
2795,Niccolò Zanellato,ITA,MF,Crotone,Serie A,22,1998,18.2,24,14,16,6,2,13,36,36.1,23,19,5,14,16,40,12,2,0,2020-2021,0.8791208791208791,1.3186813186813187
2796,Cristián Zapata,COL,DF,Genoa,Serie A,33,1986,10.8,18,12,11,7,0,10,14,71.4,4,15,11,4,15,33,56,0,0,2020-2021,1.3888888888888888,1.6666666666666665
2797,Duván Zapata,COL,FW,Atalanta,Serie A,29,1991,26.4,12,5,2,3,7,4,13,30.8,9,19,5,14,6,18,19,0,0,2020-2021,0.2272727272727273,0.4545454545454546
2798,Gabriele Zappa,ITA,DF,Cagliari,Serie A,20,1999,26.6,34,17,16,15,3,22,49,44.9,27,36,4,32,24,58,50,0,0,2020-2021,0.9022556390977443,1.2781954887218046
2799,Davide Zappacosta,ITA,DF,Genoa,Serie A,28,1992,22.7,33,16,15,13,5,15,30,50.0,15,17,1,16,18,51,41,0,0,2020-2021,0.7929515418502203,1.4537444933920705
2800,Oier Zarraga,ESP,MF,Athletic Club,La Liga,21,1999,1.1,1,1,0,1,0,1,2,50.0,1,1,0,1,0,1,0,0,0,2020-2021,0.0,0.9090909090909091
Rk,Player,Nation,Pos,Squad,Comp,0,0,90.0,0,0,3,3,3,Tkl,0,0.0,0,0,0,0,0,0,0,0,0,2020-2021,0.0,0.0
2801,Simone Zaza,ITA,FW,Torino,Serie A,29,1991,16.6,15,9,4,6,5,6,20,30.0,14,14,0,14,3,18,5,1,0,2020-2021,0.18072289156626503,0.9036144578313252
2802,Deyovaisio Zeefuik,NED,"DF,FW",Hertha BSC,Bundesliga,22,1998,10.1,13,9,8,3,2,8,19,42.1,11,15,3,12,12,25,36,0,0,2020-2021,1.188118811881188,1.2871287128712872
2803,Marvin Zeegelaar,NED,DF,Udinese,Serie A,29,1990,19.3,40,18,23,16,1,20,39,51.3,19,21,9,12,24,64,43,0,0,2020-2021,1.2435233160621761,2.0725388601036268
2804,Arber Zeneli,KVX,"MF,FW",Reims,Ligue 1,25,1995,14.3,20,10,11,1,8,8,22,36.4,14,12,1,11,3,23,8,0,0,2020-2021,0.2097902097902098,1.3986013986013985
2805,Robin Zentner,GER,GK,Mainz 05,Bundesliga,25,1994,31.0,1,1,1,0,0,1,3,33.3,2,0,0,0,3,4,9,2,0,2020-2021,0.0967741935483871,0.03225806451612903
2806,Andi Zeqiri,SUI,"FW,DF",Brighton,Premier League,21,1999,1.9,3,2,0,2,1,1,2,50.0,1,1,0,1,0,3,2,0,0,2020-2021,0.0,1.5789473684210527
2807,Mehdi Zerkane,ALG,"MF,FW",Bordeaux,Ligue 1,21,1999,13.2,23,15,7,10,6,5,18,27.8,13,15,2,13,9,32,5,0,0,2020-2021,0.6818181818181819,1.7424242424242424
2808,Ron-Robert Zieler,GER,GK,Köln,Bundesliga,31,1989,0.6,0,0,0,0,0,0,0,0.0,0,0,0,0,0,0,0,0,0,2020-2021,0.0,0.0
2809,Piotr Zieliński,POL,MF,Napoli,Serie A,26,1994,28.0,18,10,8,7,3,7,20,35.0,13,23,4,19,18,36,12,0,0,2020-2021,0.6428571428571429,0.6428571428571429
2810,Oleksandr Zinchenko,UKR,DF,Manchester City,Premier League,23,1996,16.4,25,15,12,9,4,14,24,58.3,10,17,4,13,23,48,28,0,0,2020-2021,1.402439024390244,1.524390243902439
2811,Joshua Zirkzee,NED,"FW,MF",Parma,Serie A,19,2001,1.3,2,2,1,1,0,1,3,33.3,2,1,1,0,0,2,1,0,0,2020-2021,0.0,1.5384615384615383
2812,Joshua Zirkzee,NED,FW,Bayern Munich,Bundesliga,19,2001,1.0,1,0,0,1,0,1,2,50.0,1,0,0,0,0,1,0,0,0,2020-2021,0.0,1.0
2813,Hakim Ziyech,MAR,"MF,FW",Chelsea,Premier League,27,1993,13.0,14,10,5,7,2,5,19,26.3,14,9,1,8,10,24,2,0,0,2020-2021,0.7692307692307693,1.0769230769230769
2814,Jeroen Zoet,NED,GK,Spezia,Serie A,29,1991,6.7,0,0,0,0,0,0,1,0.0,1,0,0,0,0,0,4,2,0,2020-2021,0.0,0.0
2815,Kévin Zohi,MLI,"FW,MF",Strasbourg,Ligue 1,23,1996,4.8,9,5,3,4,2,2,6,33.3,4,6,0,6,6,15,3,0,0,2020-2021,1.25,1.875
2816,Kurt Zouma,FRA,DF,Chelsea,Premier League,25,1994,22.5,16,10,8,6,2,4,8,50.0,4,13,9,4,28,44,93,0,0,2020-2021,1.2444444444444445,0.7111111111111111
2817,Igor Zubeldia,ESP,DF,Real Sociedad,La Liga,23,1997,21.8,23,16,15,8,0,8,14,57.1,6,20,13,7,12,35,46,0,0,2020-2021,0.5504587155963303,1.055045871559633
2818,Steven Zuber,SUI,"DF,MF",Eint Frankfurt,Bundesliga,28,1991,6.5,24,12,8,13,3,8,16,50.0,8,4,1,3,4,28,1,0,0,2020-2021,0.6153846153846154,3.6923076923076925
2819,Martín Zubimendi,ESP,MF,Real Sociedad,La Liga,21,1999,20.9,41,22,18,20,3,20,34,58.8,14,22,10,12,40,81,39,0,0,2020-2021,1.9138755980861246,1.9617224880382778
2820,Martin Ødegaard,NOR,MF,Arsenal,Premier League,21,1998,9.6,9,3,2,6,1,4,14,28.6,10,2,0,2,2,11,5,0,0,2020-2021,0.20833333333333334,0.9375
2821,Martin Ødegaard,NOR,MF,Real Madrid,La Liga,21,1998,2.6,1,0,0,1,0,1,2,50.0,1,1,0,1,1,2,0,0,0,2020-2021,0.3846153846153846,0.3846153846153846
2822,Filip Đuričić,SRB,"MF,FW",Sassuolo,Serie A,28,1992,23.1,32,23,6,16,10,12,30,40.0,18,20,2,18,9,41,12,0,0,2020-2021,0.3896103896103896,1.3852813852813852
1,Max Aarons,ENG,DF,Norwich City,Premier League,21,2000,32.0,64,44,49,15,0,37,55,67.3,18,39,19,20,28,92,96,1,0,2021-2022,0.875,2.0
2,Yunis Abdelhamid,MAR,DF,Reims,Ligue 1,33,1987,33.1,48,27,34,14,0,16,32,50.0,16,50,25,25,68,116,104,0,0,2021-2022,2.0543806646525677,1.4501510574018126
3,Salis Abdul Samed,GHA,MF,Clermont Foot,Ligue 1,21,2000,27.4,43,23,25,16,2,20,57,35.1,37,18,1,17,42,85,15,0,0,2021-2022,1.5328467153284673,1.5693430656934306
4,Laurent Abergel,FRA,MF,Lorient,Ligue 1,28,1993,32.8,110,60,44,53,13,71,166,42.8,95,58,1,57,55,165,13,0,0,2021-2022,1.676829268292683,3.353658536585366
5,Charles Abi,FRA,FW,Saint-Étienne,Ligue 1,21,2000,0.5,0,0,0,0,0,0,1,0.0,1,2,0,2,0,0,0,0,0,2021-2022,0.0,0.0
6,Dickson Abiama,NGA,FW,Greuther Fürth,Bundesliga,22,1998,8.1,11,7,4,5,2,2,10,20.0,8,12,1,11,4,15,8,0,0,2021-2022,0.4938271604938272,1.3580246913580247
7,Matthis Abline,FRA,FW,Rennes,Ligue 1,18,2003,1.1,0,0,0,0,0,0,0,0.0,0,2,0,2,0,0,1,0,0,2021-2022,0.0,0.0
8,Tammy Abraham,ENG,FW,Roma,Serie A,23,1997,34.3,27,13,7,14,6,9,22,40.9,13,17,3,14,5,32,27,0,0,2021-2022,0.1457725947521866,0.7871720116618076
9,Luis Abram,PER,DF,Granada,La Liga,25,1996,6.2,6,3,3,3,0,2,4,50.0,2,6,5,1,5,11,37,1,0,2021-2022,0.8064516129032258,0.9677419354838709
10,Francesco Acerbi,ITA,DF,Lazio,Serie A,33,1988,28.2,25,12,15,9,1,12,19,63.2,7,37,28,9,34,59,92,0,0,2021-2022,1.2056737588652482,0.8865248226950355
11,Ragnar Ache,GER,"MF,FW",Eint Frankfurt,Bundesliga,23,1998,2.9,2,0,0,1,1,1,4,25.0,3,3,0,3,0,2,1,0,0,2021-2022,0.0,0.6896551724137931
12,Mohamed Achi,FRA,MF,Nantes,Ligue 1,19,2002,0.1,0,0,0,0,0,0,0,0.0,0,0,0,0,0,0,0,0,0,2021-2022,0.0,0.0
13,Marcos Acuña,ARG,DF,Sevilla,La Liga,29,1991,25.1,50,29,27,14,9,30,46,65.2,16,22,5,17,14,64,25,1,0,2021-2022,0.5577689243027888,1.99203187250996
14,Che Adams,SCO,FW,Southampton,Premier League,25,1996,22.7,13,6,5,5,3,2,16,12.5,14,18,2,16,8,21,18,0,0,2021-2022,0.3524229074889868,0.5726872246696035
15,Tyler Adams,USA,MF,RB Leipzig,Bundesliga,22,1999,15.0,23,7,5,16,2,7,25,28.0,18,24,1,23,16,39,19,2,0,2021-2022,1.0666666666666667,1.5333333333333334
16,Sargis Adamyan,ARM,"FW,MF",Hoffenheim,Bundesliga,28,1993,3.7,8,6,3,4,1,3,11,27.3,8,4,0,4,1,9,2,0,0,2021-2022,0.27027027027027023,2.162162162162162
17,Martin Adeline,FRA,"MF,FW",Reims,Ligue 1,17,2003,3.9,15,11,5,8,2,8,16,50.0,8,0,0,0,11,26,6,0,0,2021-2022,2.8205128205128207,3.8461538461538463
18,Amine Adli,MAR,"FW,MF",Leverkusen,Bundesliga,21,2000,14.0,27,14,10,14,3,8,15,53.3,7,26,2,24,11,38,12,0,0,2021-2022,0.7857142857142857,1.9285714285714286
19,Yacine Adli,FRA,"MF,FW",Bordeaux,Ligue 1,21,2000,25.1,43,27,22,14,7,19,68,27.9,49,33,3,30,37,80,11,2,0,2021-2022,1.4741035856573705,1.7131474103585655
20,Michel Aebischer,SUI,MF,Bologna,Serie A,24,1997,4.9,14,5,5,8,1,6,11,54.5,5,4,1,3,6,20,3,0,0,2021-2022,1.2244897959183672,2.8571428571428568
21,Felix Afena-Gyan,GHA,"FW,MF",Roma,Serie A,18,2003,7.4,10,3,1,6,3,4,7,57.1,3,4,0,4,3,13,0,0,0,2021-2022,0.4054054054054054,1.3513513513513513
22,Martin Agirregabiria,ESP,DF,Alavés,La Liga,25,1996,18.0,34,22,17,11,6,18,37,48.6,19,20,3,17,25,59,38,0,0,2021-2022,1.3888888888888888,1.8888888888888888
23,Julen Agirrezabala,ESP,GK,Athletic Club,La Liga,20,2000,4.0,0,0,0,0,0,0,0,0.0,0,0,0,0,0,0,2,0,0,2021-2022,0.0,0.0
24,Lucien Agoume,FRA,MF,Brest,Ligue 1,19,2002,20.8,51,31,24,20,7,23,45,51.1,22,30,9,21,52,103,27,1,0,2021-2022,2.5,2.4519230769230766
25,Kevin Agudelo,COL,"MF,FW",Spezia,Serie A,22,1998,13.7,44,26,13,26,5,7,20,35.0,13,22,0,22,8,52,6,0,0,2021-2022,0.5839416058394161,3.2116788321167884
Rk,Player,Nation,Pos,Squad,Comp,0,0,90.0,0,0,3,3,3,Tkl,0,0.0,0,0,0,0,0,0,0,0,0,2021-2022,0.0,0.0
26,Nayef Aguerd,MAR,DF,Rennes,Ligue 1,25,1996,30.4,27,18,16,11,0,14,24,58.3,10,24,14,10,24,51,127,1,0,2021-2022,0.7894736842105263,0.8881578947368421
27,Sergio Agüero,ARG,FW,Barcelona,La Liga,33,1988,1.7,1,1,0,0,1,0,2,0.0,2,0,0,0,0,1,0,0,0,2021-2022,0.0,0.5882352941176471
28,Ruben Aguilar,FRA,DF,Monaco,Ligue 1,28,1993,23.8,78,53,39,32,7,43,68,63.2,25,19,4,15,44,122,57,0,0,2021-2022,1.8487394957983192,3.277310924369748
29,Álvaro Aguirre,ESP,FW,Rayo Vallecano,La Liga,21,2000,0.1,0,0,0,0,0,0,0,0.0,0,0,0,0,0,0,0,0,0,2021-2022,0.0,0.0
30,Naouirou Ahamada,FRA,"MF,DF",Stuttgart,Bundesliga,19,2002,0.7,1,0,1,0,0,1,3,33.3,2,0,0,0,0,1,0,0,0,2021-2022,0.0,1.4285714285714286
31,Anel Ahmedhodžić,BIH,DF,Bordeaux,Ligue 1,22,1999,15.0,38,26,27,9,2,20,31,64.5,11,16,8,8,22,60,44,0,0,2021-2022,1.4666666666666666,2.533333333333333
32,Jean-Eudes Aholou,CIV,MF,Strasbourg,Ligue 1,27,1994,11.2,16,9,4,9,3,5,19,26.3,14,8,1,7,19,35,7,0,0,2021-2022,1.6964285714285716,1.4285714285714286
33,Joseph Aidoo,GHA,DF,Celta Vigo,La Liga,25,1995,29.3,39,26,28,10,1,17,31,54.8,14,23,13,10,38,77,96,3,0,2021-2022,1.2969283276450512,1.3310580204778157
34,Ola Aina,NGA,DF,Torino,Serie A,24,1996,16.0,27,19,11,10,6,15,23,65.2,8,17,3,14,28,55,30,0,0,2021-2022,1.75,1.6875
35,Rayan Aït-Nouri,ALG,"DF,MF",Wolves,Premier League,20,2001,20.3,64,36,46,15,3,22,44,50.0,22,24,2,22,22,86,39,1,0,2021-2022,1.083743842364532,3.152709359605911
36,Kristoffer Ajer,NOR,DF,Brentford,Premier League,23,1998,22.2,29,18,21,6,2,13,21,61.9,8,19,11,8,26,55,74,0,0,2021-2022,1.1711711711711712,1.3063063063063063
37,Ludovic Ajorque,FRA,FW,Strasbourg,Ligue 1,27,1994,30.4,36,25,5,19,12,7,40,17.5,33,28,3,25,8,44,31,1,0,2021-2022,0.2631578947368421,1.1842105263157896
38,Manuel Akanji,SUI,DF,Dortmund,Bundesliga,26,1995,25.1,33,23,20,11,2,22,32,68.8,10,26,15,11,35,68,58,0,0,2021-2022,1.394422310756972,1.3147410358565736
39,Carlos Akapo,EQG,DF,Cádiz,La Liga,28,1993,20.5,43,31,26,15,2,21,37,56.8,16,26,7,19,51,94,61,0,0,2021-2022,2.4878048780487805,2.097560975609756
40,Marley Aké,FRA,"FW,MF",Juventus,Serie A,20,2001,0.9,0,0,0,0,0,0,2,0.0,2,0,0,0,1,1,0,0,0,2021-2022,1.1111111111111112,0.0
41,Nathan Aké,NED,DF,Manchester City,Premier League,26,1995,10.3,16,9,7,8,1,6,8,75.0,2,7,5,2,8,24,23,0,0,2021-2022,0.7766990291262136,1.5533980582524272
42,Ilias Akhomach,MAR,FW,Barcelona,La Liga,17,2004,1.4,2,0,0,1,1,0,0,0.0,0,0,0,0,0,2,0,0,0,2021-2022,0.0,1.4285714285714286
43,Maghnes Akliouche,FRA,"MF,FW",Monaco,Ligue 1,19,2002,0.6,2,0,0,2,0,0,1,0.0,1,2,0,2,0,2,0,0,0,2021-2022,0.0,3.3333333333333335
44,Paul Akouokou,CIV,MF,Betis,La Liga,23,1997,5.7,14,9,5,7,2,8,12,66.7,4,6,0,6,11,25,6,0,0,2021-2022,1.9298245614035088,2.456140350877193
45,Jean-Daniel Akpa-Akpro,CIV,MF,Lazio,Serie A,28,1992,3.5,17,10,7,9,1,7,12,58.3,5,4,2,2,2,19,6,0,0,2021-2022,0.5714285714285714,4.857142857142857
46,Kevin Akpoguma,NGA,"DF,FW",Hoffenheim,Bundesliga,26,1995,17.0,33,19,16,11,6,16,28,57.1,12,32,2,30,20,53,29,2,0,2021-2022,1.1764705882352942,1.9411764705882353
47,David Alaba,AUT,DF,Real Madrid,La Liga,29,1992,29.4,23,13,15,6,2,9,19,47.4,10,26,15,11,22,45,70,1,0,2021-2022,0.7482993197278912,0.7823129251700681
48,Sofiane Alakouch,MAR,"DF,MF",Metz,Ligue 1,23,1998,1.8,7,4,3,4,0,2,5,40.0,3,4,0,4,1,8,4,0,0,2021-2022,0.5555555555555556,3.888888888888889
49,Tomás Alarcón,CHI,MF,Cádiz,La Liga,22,1999,15.8,31,20,17,10,4,10,31,32.3,21,19,7,12,30,61,31,0,0,2021-2022,1.8987341772151898,1.9620253164556962
50,Lucas Alario,ARG,FW,Leverkusen,Bundesliga,28,1992,7.3,6,5,0,2,4,2,5,40.0,3,5,0,5,1,7,6,0,0,2021-2022,0.136986301369863,0.8219178082191781
Rk,Player,Nation,Pos,Squad,Comp,0,0,90.0,0,0,3,3,3,Tkl,0,0.0,0,0,0,0,0,0,0,0,0,2021-2022,0.0,0.0
51,Jordi Alba,ESP,DF,Barcelona,La Liga,32,1989,29.4,47,34,12,26,9,27,47,57.4,20,26,6,20,33,80,41,1,0,2021-2022,1.1224489795918369,1.598639455782313
52,Josué Albert,GUF,DF,Clermont Foot,Ligue 1,29,1992,0.2,0,0,0,0,0,0,0,0.0,0,0,0,0,1,1,2,0,0,2021-2022,5.0,0.0
53,Luis Alberto,ESP,MF,Lazio,Serie A,28,1992,26.1,29,17,8,11,10,8,52,15.4,44,32,4,28,13,42,7,0,0,2021-2022,0.49808429118773945,1.1111111111111112
54,Raúl Albiol,ESP,DF,Villarreal,La Liga,35,1985,27.4,26,15,20,5,1,14,18,77.8,4,24,15,9,21,47,126,1,0,2021-2022,0.7664233576642336,0.9489051094890512
55,Marc Albrighton,ENG,"FW,DF",Leicester City,Premier League,31,1989,12.6,31,19,16,9,6,10,47,21.3,37,15,3,12,14,45,20,0,0,2021-2022,1.1111111111111112,2.4603174603174605
56,Paco Alcácer,ESP,FW,Villarreal,La Liga,27,1993,8.7,9,3,2,4,3,1,5,20.0,4,7,0,7,6,15,1,0,0,2021-2022,0.6896551724137931,1.0344827586206897
57,Thiago Alcántara,ESP,MF,Liverpool,Premier League,30,1991,17.0,48,29,14,24,10,10,42,23.8,32,22,2,20,26,74,13,2,0,2021-2022,1.5294117647058822,2.823529411764706
58,Rubén Alcaraz,ESP,MF,Cádiz,La Liga,30,1991,12.3,41,20,14,24,3,22,45,48.9,23,10,2,8,13,54,14,0,0,2021-2022,1.056910569105691,3.333333333333333
59,Omar Alderete,PAR,DF,Valencia,La Liga,24,1996,26.7,53,34,34,17,2,34,53,64.2,19,30,18,12,35,88,153,0,0,2021-2022,1.3108614232209739,1.9850187265917603
60,Iván Alejo,ESP,"MF,FW",Cádiz,La Liga,26,1995,11.8,33,15,21,10,2,15,44,34.1,29,12,0,12,8,41,17,0,0,2021-2022,0.6779661016949152,2.796610169491525
61,Doğan Alemdar,TUR,GK,Rennes,Ligue 1,18,2002,12.0,0,0,0,0,0,0,0,0.0,0,0,0,0,0,0,9,1,0,2021-2022,0.0,0.0
62,Carles Aleñá,ESP,MF,Getafe,La Liga,23,1998,25.8,27,19,11,13,3,9,48,18.8,39,21,2,19,15,42,16,0,0,2021-2022,0.5813953488372093,1.0465116279069766
63,Trent Alexander-Arnold,ENG,DF,Liverpool,Premier League,22,1998,31.7,40,23,19,13,8,27,60,45.0,33,22,4,18,43,83,40,0,0,2021-2022,1.3564668769716088,1.2618296529968454
64,Mohamed Ali Cho,FRA,FW,Angers,Ligue 1,17,2004,20.4,10,5,1,4,5,5,17,29.4,12,17,1,16,8,18,0,1,0,2021-2022,0.3921568627450981,0.4901960784313726
65,Alisson,BRA,GK,Liverpool,Premier League,28,1992,36.0,3,1,3,0,0,3,5,60.0,2,1,0,1,0,3,28,1,0,2021-2022,0.0,0.08333333333333333
66,Allan,BRA,MF,Everton,Premier League,30,1991,24.3,74,44,28,39,7,34,105,32.4,71,40,9,31,23,97,39,1,0,2021-2022,0.9465020576131687,3.045267489711934
67,Jim Allevinah,GAB,FW,Clermont Foot,Ligue 1,26,1995,16.5,18,13,8,8,2,5,18,27.8,13,11,0,11,6,24,4,0,0,2021-2022,0.36363636363636365,1.0909090909090908
68,Dele Alli,ENG,MF,Tottenham,Premier League,25,1996,7.3,14,8,10,3,1,5,17,29.4,12,22,5,17,6,20,16,0,0,2021-2022,0.8219178082191781,1.9178082191780823
69,Dele Alli,ENG,"MF,FW",Everton,Premier League,25,1996,3.8,7,2,3,4,0,0,4,0.0,4,7,2,5,6,13,10,0,0,2021-2022,1.5789473684210527,1.842105263157895
70,Miguel Almirón,PAR,"MF,FW",Newcastle Utd,Premier League,27,1994,19.1,47,29,23,17,7,11,44,25.0,33,14,1,13,20,67,13,0,0,2021-2022,1.0471204188481675,2.4607329842931933
71,Marcos Alonso,ESP,DF,Chelsea,Premier League,30,1990,24.1,41,29,20,12,9,17,36,47.2,19,29,5,24,43,84,53,0,0,2021-2022,1.784232365145228,1.7012448132780082
72,Giorgio Altare,ITA,DF,Cagliari,Serie A,22,1998,16.3,39,28,18,18,3,21,26,80.8,5,17,5,12,30,69,70,0,0,2021-2022,1.840490797546012,2.392638036809816
73,Hugo Álvarez,ESP,FW,Celta Vigo,La Liga,18,2003,0.1,1,0,1,0,0,0,0,0.0,0,0,0,0,0,1,1,0,0,2021-2022,0.0,10.0
74,Yeray Álvarez,ESP,DF,Athletic Club,La Liga,26,1995,20.7,24,14,15,8,1,10,18,55.6,8,21,16,5,45,69,97,0,0,2021-2022,2.1739130434782608,1.1594202898550725
75,Dani Alves,BRA,DF,Barcelona,La Liga,38,1983,12.2,30,19,13,13,4,14,26,53.8,12,10,3,7,11,41,10,2,0,2021-2022,0.9016393442622951,2.459016393442623
Rk,Player,Nation,Pos,Squad,Comp,0,0,90.0,0,0,3,3,3,Tkl,0,0.0,0,0,0,0,0,0,0,0,0,2021-2022,0.0,0.0
76,Steven Alzate,COL,MF,Brighton,Premier League,22,1998,4.5,10,4,4,5,1,4,7,57.1,3,2,1,1,10,20,10,0,0,2021-2022,2.2222222222222223,2.2222222222222223
77,Ibrahim Amadou,FRA,"DF,MF",Metz,Ligue 1,28,1993,9.0,16,8,10,6,0,8,15,53.3,7,4,2,2,14,30,26,0,0,2021-2022,1.5555555555555556,1.7777777777777777
78,Emmanuel Amankwaa Akurugu,GHA,DF,Getafe,La Liga,19,2001,0.9,0,0,0,0,0,0,2,0.0,2,1,0,1,0,0,0,0,0,2021-2022,0.0,0.0
79,Daniel Amartey,GHA,DF,Leicester City,Premier League,26,1994,23.6,26,13,19,7,0,19,29,65.5,10,30,22,8,21,47,93,4,0,2021-2022,0.8898305084745762,1.1016949152542372
80,Amath,SEN,"FW,MF",Mallorca,La Liga,25,1996,9.8,21,11,11,6,4,7,17,41.2,10,12,0,12,7,28,7,0,0,2021-2022,0.7142857142857142,2.142857142857143
81,Jordan Amavi,FRA,DF,Nice,Ligue 1,27,1994,4.6,16,10,8,7,1,10,17,58.8,7,3,1,2,15,31,7,0,0,2021-2022,3.2608695652173916,3.4782608695652177
82,Jordan Amavi,FRA,"DF,FW",Marseille,Ligue 1,27,1994,1.4,6,5,3,1,2,5,10,50.0,5,1,0,1,1,7,3,0,0,2021-2022,0.7142857142857143,4.285714285714286
83,Wisdom Amey,ITA,DF,Bologna,Serie A,15,2005,0.8,3,2,1,1,1,2,3,66.7,1,2,0,2,3,6,1,0,0,2021-2022,3.75,3.75
84,Kelvin Amian,FRA,DF,Spezia,Serie A,23,1998,29.4,66,42,43,18,5,30,41,73.2,11,39,21,18,32,98,75,0,0,2021-2022,1.08843537414966,2.2448979591836737
85,Nadiem Amiri,GER,"MF,FW",Genoa,Serie A,24,1996,7.6,6,4,2,2,2,2,9,22.2,7,7,0,7,0,6,0,0,0,2021-2022,0.0,0.7894736842105263
86,Nadiem Amiri,GER,"MF,FW",Leverkusen,Bundesliga,24,1996,4.1,8,4,3,2,3,4,8,50.0,4,4,2,2,5,13,0,0,0,2021-2022,1.2195121951219514,1.9512195121951221
87,Ethan Ampadu,WAL,"MF,DF",Venezia,Serie A,20,2000,25.4,67,43,37,27,3,24,58,41.4,34,49,19,30,51,118,76,0,0,2021-2022,2.0078740157480315,2.6377952755905514
88,Sofyan Amrabat,MAR,MF,Fiorentina,Serie A,24,1996,10.5,24,13,9,13,2,11,19,57.9,8,25,8,17,5,29,6,1,0,2021-2022,0.47619047619047616,2.2857142857142856
89,Joachim Andersen,DEN,DF,Crystal Palace,Premier League,25,1996,32.4,30,23,21,9,0,16,27,59.3,11,29,19,10,37,67,125,3,0,2021-2022,1.1419753086419753,0.9259259259259259
90,Felipe Anderson,BRA,FW,Lazio,Serie A,28,1993,32.1,71,45,30,33,8,27,99,27.3,72,65,6,59,20,91,16,0,0,2021-2022,0.6230529595015576,2.2118380062305296
91,Sebastian Andersson,SWE,FW,Köln,Bundesliga,30,1991,14.0,11,7,0,3,8,3,9,33.3,6,8,0,8,3,14,14,0,0,2021-2022,0.21428571428571427,0.7857142857142857
92,Florin Andone,ROU,FW,Cádiz,La Liga,28,1993,2.0,1,1,1,0,0,0,1,0.0,1,2,0,2,0,1,1,0,0,2021-2022,0.0,0.5
93,Andrés Andrade Cedeño,PAN,DF,Arminia,Bundesliga,22,1998,11.6,27,16,18,8,1,17,35,48.6,18,16,7,9,19,46,44,0,0,2021-2022,1.6379310344827587,2.3275862068965516
94,Benjamin André,FRA,MF,Lille,Ligue 1,30,1990,30.6,123,69,49,65,9,51,113,45.1,62,49,11,38,50,173,56,0,0,2021-2022,1.6339869281045751,4.019607843137255
95,Fredrik André Bjørkan,NOR,DF,Hertha BSC,Bundesliga,22,1998,3.9,12,10,7,4,1,7,9,77.8,2,6,2,4,6,18,8,0,0,2021-2022,1.5384615384615385,3.076923076923077
96,Marcos André,BRA,"FW,MF",Valencia,La Liga,24,1996,10.8,15,11,4,6,5,5,16,31.3,11,15,0,15,7,22,13,0,0,2021-2022,0.6481481481481481,1.3888888888888888
97,Robert Andrich,GER,MF,Leverkusen,Bundesliga,26,1994,20.2,33,17,18,14,1,14,28,50.0,14,19,7,12,31,64,46,0,0,2021-2022,1.5346534653465347,1.6336633663366338
98,José Ángel,ESP,DF,Osasuna,La Liga,31,1989,12.0,20,13,9,9,2,9,14,64.3,5,6,1,5,10,30,21,0,0,2021-2022,0.8333333333333334,1.6666666666666667
99,Angeliño,ESP,DF,RB Leipzig,Bundesliga,24,1997,25.5,28,21,14,13,1,14,30,46.7,16,24,3,21,29,57,40,0,0,2021-2022,1.1372549019607843,1.0980392156862746
100,Ebenezer Annan,GHA,DF,Bologna,Serie A,18,2002,0.3,1,1,1,0,0,0,0,0.0,0,0,0,0,1,2,1,0,0,2021-2022,3.3333333333333335,3.3333333333333335
Rk,Player,Nation,Pos,Squad,Comp,0,0,90.0,0,0,3,3,3,Tkl,0,0.0,0,0,0,0,0,0,0,0,0,2021-2022,0.0,0.0
101,Cristian Ansaldi,ARG,DF,Torino,Serie A,34,1986,7.7,20,9,11,7,2,10,13,76.9,3,9,1,8,6,26,10,0,0,2021-2022,0.7792207792207793,2.5974025974025974
102,Janis Antiste,FRA,FW,Spezia,Serie A,18,2002,8.8,18,11,6,6,6,5,13,38.5,8,7,1,6,4,22,6,0,0,2021-2022,0.45454545454545453,2.0454545454545454
103,Waldemar Anton,GER,DF,Stuttgart,Bundesliga,25,1996,28.8,40,26,22,15,3,19,32,59.4,13,27,16,11,32,72,116,1,0,2021-2022,1.1111111111111112,1.3888888888888888
104,Josep Antoni Gayá,ESP,DF,Mallorca,La Liga,21,2000,0.6,0,0,0,0,0,0,0,0.0,0,1,0,1,1,1,3,1,0,2021-2022,1.6666666666666667,0.0
105,Michail Antonio,JAM,FW,West Ham,Premier League,31,1990,33.0,23,17,5,9,9,7,18,38.9,11,19,1,18,3,26,13,0,0,2021-2022,0.09090909090909091,0.696969696969697
106,Christopher Antwi-Adjei,GHA,"FW,MF",Bochum,Bundesliga,27,1994,12.6,21,18,7,8,6,6,26,23.1,20,12,0,12,1,22,8,0,0,2021-2022,0.07936507936507936,1.6666666666666667
107,Houssem Aouar,ALG,"MF,FW",Lyon,Ligue 1,23,1998,27.8,46,30,9,25,12,27,54,50.0,27,26,1,25,20,66,5,0,0,2021-2022,0.7194244604316546,1.6546762589928057
108,Adil Aouchiche,FRA,"MF,FW",Saint-Étienne,Ligue 1,19,2002,12.0,13,6,5,5,3,5,33,15.2,28,18,1,17,17,30,4,0,0,2021-2022,1.4166666666666667,1.0833333333333333
109,Dennis Appiah,FRA,DF,Nantes,Ligue 1,29,1992,23.3,55,34,35,18,2,28,48,58.3,20,30,13,17,27,82,74,0,0,2021-2022,1.1587982832618025,2.360515021459227
110,Mauro Arambarri,URU,MF,Getafe,La Liga,25,1995,29.6,62,37,19,32,11,20,68,29.4,48,35,5,30,32,94,18,0,0,2021-2022,1.081081081081081,2.0945945945945943
111,Mattia Aramu,ITA,"MF,FW",Venezia,Serie A,26,1995,23.3,20,15,5,9,6,8,33,24.2,25,20,2,18,8,28,19,0,0,2021-2022,0.34334763948497854,0.8583690987124464
112,Charles Aránguiz,CHI,MF,Leverkusen,Bundesliga,32,1989,17.5,45,25,18,21,6,22,52,42.3,30,24,4,20,33,78,21,0,0,2021-2022,1.8857142857142857,2.5714285714285716
113,Néstor Araujo,MEX,DF,Celta Vigo,La Liga,29,1991,29.1,22,14,17,5,0,9,21,42.9,12,17,10,7,27,49,105,2,0,2021-2022,0.9278350515463917,0.7560137457044673
114,Ronald Araújo,URU,DF,Barcelona,La Liga,22,1999,25.2,41,23,29,12,0,21,25,84.0,4,37,20,17,23,64,66,1,0,2021-2022,0.9126984126984127,1.626984126984127
115,Cameron Archer,ENG,"FW,MF",Aston Villa,Premier League,20,2001,0.3,0,0,0,0,0,0,0,0.0,0,0,0,0,0,0,0,0,0,2021-2022,0.0,0.0
116,Alphonse Areola,FRA,GK,West Ham,Premier League,28,1993,1.0,0,0,0,0,0,0,0,0.0,0,0,0,0,0,0,1,0,0,2021-2022,0.0,0.0
117,Jesús Areso,ESP,DF,Osasuna,La Liga,22,1999,2.1,3,3,2,1,0,0,2,0.0,2,0,0,0,0,3,2,1,0,2021-2022,0.0,1.4285714285714286
118,Matias Arezo,URU,"FW,MF",Granada,La Liga,18,2002,1.8,5,3,2,1,2,4,9,44.4,5,1,0,1,1,6,1,0,0,2021-2022,0.5555555555555556,2.7777777777777777
119,Santiago Arias,COL,DF,Granada,La Liga,29,1992,4.9,12,5,8,3,1,4,9,44.4,5,8,4,4,5,17,10,0,0,2021-2022,1.0204081632653061,2.4489795918367343
120,Adam Armstrong,ENG,FW,Southampton,Premier League,24,1997,15.7,10,4,2,2,6,0,6,0.0,6,13,1,12,3,13,6,0,0,2021-2022,0.1910828025477707,0.6369426751592357
121,Stuart Armstrong,SCO,MF,Southampton,Premier League,29,1992,16.4,27,19,15,6,6,9,23,39.1,14,10,1,9,8,35,15,0,0,2021-2022,0.48780487804878053,1.6463414634146343
122,Marko Arnautović,AUT,FW,Bologna,Serie A,32,1989,29.9,17,9,1,11,5,7,30,23.3,23,13,2,11,7,24,17,0,0,2021-2022,0.23411371237458195,0.5685618729096991
123,Maximilian Arnold,GER,MF,Wolfsburg,Bundesliga,27,1994,33.3,37,20,19,16,2,20,50,40.0,30,43,15,28,37,74,55,0,0,2021-2022,1.1111111111111112,1.1111111111111112
124,Kepa Arrizabalaga,ESP,GK,Chelsea,Premier League,26,1994,4.0,0,0,0,0,0,0,0,0.0,0,0,0,0,0,0,4,0,0,2021-2022,0.0,0.0
125,Tolgay Arslan,GER,MF,Udinese,Serie A,30,1990,18.4,35,20,15,16,4,19,50,38.0,31,17,4,13,13,48,23,1,0,2021-2022,0.7065217391304348,1.9021739130434785
Rk,Player,Nation,Pos,Squad,Comp,0,0,90.0,0,0,3,3,3,Tkl,0,0.0,0,0,0,0,0,0,0,0,0,2021-2022,0.0,0.0
126,Santiago Arzamendia,PAR,MF,Cádiz,La Liga,23,1998,5.2,14,6,6,5,3,6,13,46.2,7,6,0,6,4,18,7,0,0,2021-2022,0.7692307692307692,2.692307692307692
127,Takuma Asano,JPN,"FW,MF",Bochum,Bundesliga,26,1994,17.9,11,6,3,6,2,5,19,26.3,14,14,1,13,7,18,7,0,0,2021-2022,0.3910614525139665,0.6145251396648045
128,Santiago Ascacíbar,ARG,MF,Hertha BSC,Bundesliga,24,1997,26.4,93,54,50,37,6,38,89,42.7,51,31,6,25,41,134,42,0,0,2021-2022,1.5530303030303032,3.522727272727273
129,Sergio Asenjo,ESP,GK,Villarreal,La Liga,32,1989,6.0,0,0,0,0,0,0,1,0.0,1,0,0,0,1,1,6,0,0,2021-2022,0.16666666666666666,0.0
130,Alejandro Asensio,ESP,FW,Rayo Vallecano,La Liga,20,2000,0.1,0,0,0,0,0,0,0,0.0,0,0,0,0,0,0,0,0,0,2021-2022,0.0,0.0
131,Marco Asensio,ESP,"FW,MF",Real Madrid,La Liga,25,1996,19.2,12,8,6,4,2,4,18,22.2,14,8,1,7,12,24,6,1,0,2021-2022,0.625,0.625
132,Harrison Ashby,SCO,DF,West Ham,Premier League,19,2001,0.1,0,0,0,0,0,0,0,0.0,0,1,0,1,1,1,1,0,0,2021-2022,10.0,0.0
133,Kristoffer Askildsen,NOR,MF,Sampdoria,Serie A,20,2001,8.4,18,6,7,11,0,9,19,47.4,10,14,7,7,15,33,15,0,0,2021-2022,1.7857142857142856,2.142857142857143
134,Fisnik Asllani,KVX,"MF,FW",Hoffenheim,Bundesliga,18,2002,0.1,0,0,0,0,0,0,1,0.0,1,0,0,0,0,0,0,0,0,2021-2022,0.0,0.0
135,Kristjan Asllani,ALB,MF,Empoli,Serie A,19,2002,15.0,18,9,9,8,1,11,29,37.9,18,16,7,9,19,37,15,1,0,2021-2022,1.2666666666666666,1.2
136,Iago Aspas,ESP,FW,Celta Vigo,La Liga,33,1987,34.3,14,7,1,5,8,4,24,16.7,20,23,2,21,11,25,19,0,0,2021-2022,0.3206997084548105,0.40816326530612246
137,Lorenz Assignon,TOG,DF,Rennes,Ligue 1,21,2000,6.8,15,10,11,3,1,5,9,55.6,4,3,1,2,11,26,19,0,0,2021-2022,1.6176470588235294,2.2058823529411766
138,Simon Asta,GER,DF,Greuther Fürth,Bundesliga,20,2001,8.7,13,6,4,5,4,4,8,50.0,4,14,2,12,8,21,16,0,0,2021-2022,0.9195402298850576,1.4942528735632186
139,Youcef Atal,ALG,DF,Nice,Ligue 1,25,1996,12.7,29,19,17,10,2,14,25,56.0,11,13,2,11,32,61,21,0,0,2021-2022,2.5196850393700787,2.283464566929134
140,Pierre-Emerick Aubameyang,GAB,FW,Arsenal,Premier League,32,1989,11.5,11,5,6,4,1,3,10,30.0,7,12,1,11,0,11,4,0,0,2021-2022,0.0,0.9565217391304348
141,Pierre-Emerick Aubameyang,GAB,FW,Barcelona,La Liga,32,1989,12.0,2,2,0,1,1,0,5,0.0,5,9,1,8,2,4,4,0,0,2021-2022,0.16666666666666666,0.16666666666666666
142,Emil Audero,ITA,GK,Sampdoria,Serie A,24,1997,28.4,3,1,3,0,0,3,5,60.0,2,0,0,0,2,5,17,2,0,2021-2022,0.07042253521126761,0.10563380281690142
143,Tommaso Augello,ITA,DF,Sampdoria,Serie A,26,1994,26.6,36,20,22,8,6,17,29,58.6,12,19,4,15,29,65,68,1,0,2021-2022,1.0902255639097744,1.3533834586466165
144,Jean-Kévin Augustin,FRA,"FW,MF",Nantes,Ligue 1,24,1997,0.9,1,0,0,0,1,0,3,0.0,3,1,0,1,0,1,0,0,0,2021-2022,0.0,1.1111111111111112
145,Ludwig Augustinsson,SWE,"DF,FW",Sevilla,La Liga,27,1994,8.8,18,14,11,3,4,8,13,61.5,5,10,3,7,5,23,21,0,0,2021-2022,0.5681818181818181,2.0454545454545454
146,Serge Aurier,CIV,DF,Villarreal,La Liga,28,1992,11.2,14,9,11,2,1,4,7,57.1,3,14,7,7,11,25,25,0,0,2021-2022,0.9821428571428572,1.25
147,Ezequiel Ávila,ARG,"FW,MF",Osasuna,La Liga,27,1994,20.8,17,7,6,7,4,7,21,33.3,14,14,2,12,13,30,15,1,0,2021-2022,0.625,0.8173076923076923
148,Taiwo Awoniyi,NGA,FW,Union Berlin,Bundesliga,23,1997,24.2,11,7,3,6,2,1,9,11.1,8,11,2,9,2,13,29,0,0,2021-2022,0.08264462809917356,0.4545454545454546
149,Ramzi Aya,ITA,DF,Salernitana,Serie A,30,1990,1.5,1,1,1,0,0,1,1,100.0,0,0,0,0,0,1,4,0,0,2021-2022,0.0,0.6666666666666666
150,Jordan Ayew,GHA,FW,Crystal Palace,Premier League,29,1991,22.4,47,30,20,20,7,17,31,54.8,14,33,3,30,15,62,15,0,0,2021-2022,0.6696428571428572,2.098214285714286
Rk,Player,Nation,Pos,Squad,Comp,0,0,90.0,0,0,3,3,3,Tkl,0,0.0,0,0,0,0,0,0,0,0,0,2021-2022,0.0,0.0
151,Kaan Ayhan,TUR,DF,Sassuolo,Serie A,26,1994,15.0,20,12,14,6,0,7,15,46.7,8,20,14,6,13,33,57,0,0,2021-2022,0.8666666666666667,1.3333333333333333
152,Luke Ayling,ENG,DF,Leeds United,Premier League,29,1991,25.2,74,42,46,23,5,51,97,52.6,46,46,25,21,28,102,52,1,0,2021-2022,1.1111111111111112,2.9365079365079367
153,Karim Azamoum,FRA,DF,Troyes,Ligue 1,31,1990,4.3,6,5,4,2,0,3,5,60.0,2,4,2,2,1,7,10,0,0,2021-2022,0.23255813953488372,1.3953488372093024
154,Sardar Azmoun,IRN,"FW,MF",Leverkusen,Bundesliga,26,1995,4.0,3,1,0,2,1,0,5,0.0,5,2,0,2,0,3,8,0,0,2021-2022,0.0,0.75
155,César Azpilicueta,ESP,DF,Chelsea,Premier League,31,1989,23.0,51,28,18,27,6,16,35,45.7,19,32,9,23,23,74,65,1,0,2021-2022,1.0,2.217391304347826
156,Iddrisu Baba,GHA,MF,Mallorca,La Liga,25,1996,21.5,57,30,31,23,3,25,43,58.1,18,19,5,14,24,81,34,1,0,2021-2022,1.1162790697674418,2.6511627906976742
157,Carlos Bacca,COL,FW,Granada,La Liga,34,1986,5.7,4,4,2,0,2,0,3,0.0,3,5,0,5,1,5,5,0,0,2021-2022,0.17543859649122806,0.7017543859649122
158,Daniel Bachmann,AUT,GK,Watford,Premier League,27,1994,12.0,0,0,0,0,0,0,0,0.0,0,0,0,0,1,1,5,0,0,2021-2022,0.08333333333333333,0.0
159,Loïc Bade,FRA,DF,Rennes,Ligue 1,21,2000,10.9,6,5,4,2,0,3,5,60.0,2,12,10,2,12,18,48,0,0,2021-2022,1.1009174311926606,0.5504587155963303
160,Milan Badelj,CRO,MF,Genoa,Serie A,32,1989,31.6,64,37,25,30,9,34,80,42.5,46,39,7,32,85,149,43,0,0,2021-2022,2.6898734177215187,2.0253164556962022
161,Édgar Badía,ESP,GK,Elche,La Liga,29,1992,24.0,0,0,0,0,0,0,0,0.0,0,0,0,0,0,0,16,2,0,2021-2022,0.0,0.0
162,Benoît Badiashile,FRA,DF,Monaco,Ligue 1,20,2001,20.4,36,19,21,15,0,14,23,60.9,9,18,12,6,28,64,68,1,0,2021-2022,1.3725490196078431,1.7647058823529413
163,Youssouph Badji,SEN,"FW,MF",Brest,Ligue 1,19,2001,1.5,1,0,0,1,0,0,1,0.0,1,0,0,0,0,1,0,0,0,2021-2022,0.0,0.6666666666666666
164,Miguel Baeza,ESP,DF,Celta Vigo,La Liga,21,2000,0.0,0,0,0,0,0,0,0,0.0,0,0,0,0,0,0,0,0,0,2021-2022,,
165,Nicola Bagnolini,ITA,GK,Bologna,Serie A,17,2004,0.0,0,0,0,0,0,0,0,0.0,0,0,0,0,0,0,0,0,0,2021-2022,,
166,Issa Bah,LUX,FW,Venezia,Serie A,19,2002,0.1,0,0,0,0,0,0,0,0.0,0,0,0,0,0,0,0,0,0,2021-2022,0.0,0.0
167,Stéphane Bahoken,CMR,FW,Angers,Ligue 1,29,1992,12.2,13,8,2,7,4,1,9,11.1,8,15,0,15,3,16,3,0,0,2021-2022,0.24590163934426232,1.0655737704918034
168,Leon Bailey,JAM,"FW,MF",Aston Villa,Premier League,23,1997,8.5,17,11,6,8,3,6,13,46.2,7,10,1,9,1,18,2,0,0,2021-2022,0.11764705882352941,2.0
169,Eric Bailly,CIV,DF,Manchester Utd,Premier League,27,1994,2.4,5,4,4,0,1,3,4,75.0,1,4,2,2,3,8,11,0,0,2021-2022,1.25,2.0833333333333335
170,Dénys Bain,FRA,DF,Brest,Ligue 1,28,1993,2.0,3,3,1,2,0,1,1,100.0,0,3,1,2,3,6,5,0,0,2021-2022,1.5,1.5
171,Stefan Bajic,FRA,GK,Saint-Étienne,Ligue 1,19,2001,5.7,0,0,0,0,0,0,0,0.0,0,0,0,0,0,0,4,0,0,2021-2022,0.0,0.0
172,Nedim Bajrami,ALB,"MF,FW",Empoli,Serie A,22,1999,22.8,21,14,5,13,3,4,14,28.6,10,11,0,11,3,24,8,0,0,2021-2022,0.13157894736842105,0.9210526315789473
173,Cédric Bakambu,COD,FW,Marseille,Ligue 1,30,1991,4.0,2,0,1,0,1,0,3,0.0,3,2,0,2,0,2,1,0,0,2021-2022,0.0,0.5
174,Abdoulaye Bakayoko,FRA,DF,Saint-Étienne,Ligue 1,18,2002,3.4,15,9,13,2,0,8,12,66.7,4,5,4,1,12,27,15,0,0,2021-2022,3.5294117647058822,4.411764705882353
175,Tiemoué Bakayoko,FRA,MF,Milan,Serie A,26,1994,5.6,19,13,9,7,3,5,16,31.3,11,8,1,7,9,28,10,2,0,2021-2022,1.6071428571428572,3.3928571428571432
Rk,Player,Nation,Pos,Squad,Comp,0,0,90.0,0,0,3,3,3,Tkl,0,0.0,0,0,0,0,0,0,0,0,0,2021-2022,0.0,0.0
176,Mitchel Bakker,NED,DF,Leverkusen,Bundesliga,21,2000,20.2,33,22,16,12,5,20,34,58.8,14,13,2,11,23,56,42,3,0,2021-2022,1.1386138613861387,1.6336633663366338
177,Ridle Baku,GER,"DF,FW",Wolfsburg,Bundesliga,23,1998,27.2,62,37,30,24,8,25,65,38.5,40,43,1,42,21,83,52,1,0,2021-2022,0.7720588235294118,2.2794117647058822
178,Dilane Bakwa,FRA,"FW,MF",Bordeaux,Ligue 1,18,2002,0.5,1,1,0,1,0,1,2,50.0,1,0,0,0,0,1,1,0,0,2021-2022,0.0,2.0
179,Tommaso Baldanzi,ITA,FW,Empoli,Serie A,18,2003,0.2,0,0,0,0,0,0,0,0.0,0,1,0,1,0,0,0,0,0,2021-2022,0.0,0.0
180,Alejandro Balde,ESP,"DF,FW",Barcelona,La Liga,17,2003,2.1,2,1,1,0,1,0,0,0.0,0,2,2,0,1,3,1,0,0,2021-2022,0.47619047619047616,0.9523809523809523
181,Ibrahima Baldé,FRA,"FW,MF",Lens,Ligue 1,18,2003,0.6,0,0,0,0,0,0,0,0.0,0,0,0,0,0,0,0,0,0,2021-2022,0.0,0.0
182,Keita Baldé,SEN,FW,Cagliari,Serie A,26,1995,13.7,8,4,1,5,2,1,10,10.0,9,6,0,6,4,12,6,0,0,2021-2022,0.29197080291970806,0.5839416058394161
183,Gareth Bale,WAL,FW,Real Madrid,La Liga,32,1989,3.1,2,1,1,0,1,1,4,25.0,3,2,0,2,2,4,1,0,0,2021-2022,0.6451612903225806,0.6451612903225806
184,Mikel Balenziaga,ESP,DF,Athletic Club,La Liga,33,1988,22.5,33,24,15,15,3,25,43,58.1,18,27,4,23,21,54,79,0,0,2021-2022,0.9333333333333333,1.4666666666666666
185,Leonardo Balerdi,ARG,DF,Marseille,Ligue 1,22,1999,10.6,9,6,9,0,0,5,14,35.7,9,11,4,7,19,28,30,0,0,2021-2022,1.7924528301886793,0.8490566037735849
186,Iván Balliu,ALB,DF,Rayo Vallecano,La Liga,29,1992,35.0,45,22,25,11,9,19,31,61.3,12,24,5,19,39,84,64,0,0,2021-2022,1.1142857142857143,1.2857142857142858
187,Fodé Ballo-Touré,SEN,DF,Milan,Serie A,24,1997,5.0,18,14,5,13,0,4,9,44.4,5,6,2,4,3,21,5,0,0,2021-2022,0.6,3.6
188,Folarin Balogun,USA,FW,Arsenal,Premier League,20,2001,0.8,1,1,0,0,1,0,0,0.0,0,1,0,1,0,1,1,0,0,2021-2022,0.0,1.25
189,Abdoulaye Bamba,CIV,"DF,FW",Angers,Ligue 1,31,1990,5.1,6,5,6,0,0,4,11,36.4,7,5,1,4,9,15,13,0,0,2021-2022,1.7647058823529413,1.1764705882352942
190,Jonathan Bamba,CIV,"MF,FW",Lille,Ligue 1,25,1996,27.0,30,12,13,9,8,13,36,36.1,23,24,1,23,21,51,10,0,0,2021-2022,0.7777777777777778,1.1111111111111112
191,Patrick Bamford,ENG,FW,Leeds United,Premier League,27,1993,6.2,1,0,0,1,0,0,3,0.0,3,8,2,6,2,3,8,0,0,2021-2022,0.3225806451612903,0.16129032258064516
192,Filippo Bandinelli,ITA,MF,Empoli,Serie A,26,1995,21.7,33,20,10,17,6,15,31,48.4,16,22,5,17,10,43,37,2,0,2021-2022,0.4608294930875576,1.5207373271889402
193,Mattia Bani,ITA,DF,Genoa,Serie A,27,1993,13.5,23,13,17,6,0,14,18,77.8,4,19,11,8,20,43,76,0,0,2021-2022,1.4814814814814814,1.7037037037037037
194,Simon Banza,COD,FW,Lens,Ligue 1,24,1996,1.4,2,1,0,0,2,0,2,0.0,2,1,0,1,1,3,2,0,0,2021-2022,0.7142857142857143,1.4285714285714286
195,Shandon Baptiste,GRN,MF,Brentford,Premier League,23,1998,10.1,14,4,9,4,1,6,15,40.0,9,10,0,10,11,25,12,0,0,2021-2022,1.0891089108910892,1.3861386138613863
196,Antonín Barák,CZE,"MF,FW",Hellas Verona,Serie A,26,1994,26.0,18,8,9,8,1,5,17,29.4,12,32,5,27,6,24,26,0,0,2021-2022,0.23076923076923078,0.6923076923076923
197,Barbero,ESP,"FW,MF",Osasuna,La Liga,22,1998,0.2,0,0,0,0,0,0,0,0.0,0,0,0,0,0,0,1,0,0,2021-2022,0.0,0.0
198,Danilo Barbosa,BRA,DF,Nice,Ligue 1,25,1996,1.0,0,0,0,0,0,0,0,0.0,0,1,1,0,2,2,10,0,0,2021-2022,2.0,0.0
199,Barcia,ESP,DF,Granada,La Liga,20,2000,0.8,0,0,0,0,0,0,0,0.0,0,1,1,0,1,1,0,1,0,2021-2022,1.25,0.0
200,Bradley Barcola,FRA,"FW,MF",Lyon,Ligue 1,18,2002,2.9,7,4,2,3,2,1,8,12.5,7,7,1,6,2,9,1,0,0,2021-2022,0.6896551724137931,2.413793103448276
Rk,Player,Nation,Pos,Squad,Comp,0,0,90.0,0,0,3,3,3,Tkl,0,0.0,0,0,0,0,0,0,0,0,0,2021-2022,0.0,0.0
201,Melvin Bard,FRA,DF,Nice,Ligue 1,20,2000,28.8,59,37,38,17,4,41,63,65.1,22,33,10,23,51,110,56,0,0,2021-2022,1.7708333333333333,2.048611111111111
202,Enis Bardhi,MKD,"MF,FW",Levante,La Liga,26,1995,18.9,29,12,12,14,3,12,35,34.3,23,13,2,11,10,39,7,0,0,2021-2022,0.5291005291005292,1.5343915343915344
203,Francesco Bardi,ITA,GK,Bologna,Serie A,29,1992,2.0,0,0,0,0,0,0,0,0.0,0,0,0,0,0,0,0,0,0,2021-2022,0.0,0.0
204,Keidi Bare,ALB,MF,Espanyol,La Liga,23,1997,16.5,27,17,14,12,1,11,31,35.5,20,20,10,10,15,42,26,1,0,2021-2022,0.9090909090909091,1.6363636363636365
205,Nicolò Barella,ITA,MF,Inter,Serie A,24,1997,32.4,63,42,17,35,11,29,55,52.7,26,26,2,24,21,84,8,2,0,2021-2022,0.6481481481481481,1.9444444444444444
206,Kike Barja,ESP,"MF,FW",Osasuna,La Liga,24,1997,9.6,15,11,4,7,4,8,22,36.4,14,10,1,9,9,24,4,0,0,2021-2022,0.9375,1.5625
207,Ross Barkley,ENG,"MF,FW",Chelsea,Premier League,27,1993,2.0,0,0,0,0,0,0,1,0.0,1,1,0,1,1,1,0,0,0,2021-2022,0.5,0.0
208,Aymen Barkok,MAR,"MF,DF",Eint Frankfurt,Bundesliga,23,1998,1.8,6,2,2,3,1,2,7,28.6,5,4,1,3,5,11,6,0,0,2021-2022,2.7777777777777777,3.333333333333333
209,Ashley Barnes,ENG,FW,Burnley,Premier League,31,1989,9.0,11,2,2,7,2,2,9,22.2,7,8,1,7,2,13,5,0,0,2021-2022,0.2222222222222222,1.2222222222222223
210,Harvey Barnes,ENG,"FW,MF",Leicester City,Premier League,23,1997,23.3,31,16,9,11,11,7,23,30.4,16,24,1,23,5,36,7,0,0,2021-2022,0.2145922746781116,1.3304721030042919
211,Antonio Barragán,ESP,DF,Elche,La Liga,34,1987,11.3,21,14,13,7,1,11,17,64.7,6,5,3,2,17,38,34,0,0,2021-2022,1.5044247787610618,1.8584070796460175
212,Leandro Barreiro Martins,LUX,MF,Mainz 05,Bundesliga,21,2000,19.9,63,32,23,27,13,29,50,58.0,21,23,6,17,32,95,23,0,0,2021-2022,1.6080402010050252,3.1658291457286434
213,Ander Barrenetxea,ESP,"FW,MF",Real Sociedad,La Liga,19,2001,6.1,15,10,9,6,0,8,18,44.4,10,7,0,7,2,17,2,0,0,2021-2022,0.3278688524590164,2.459016393442623
214,Jacob Barrett Laursen,DEN,DF,Arminia,Bundesliga,26,1994,18.1,16,12,10,6,0,8,21,38.1,13,19,7,12,28,44,43,0,0,2021-2022,1.5469613259668507,0.8839779005524862
215,Musa Barrow,GAM,"FW,MF",Bologna,Serie A,22,1998,23.7,12,4,4,4,4,6,20,30.0,14,20,1,19,6,18,8,0,0,2021-2022,0.25316455696202533,0.5063291139240507
216,Abdourahmane Barry,GUI,DF,Greuther Fürth,Bundesliga,21,2000,2.3,6,4,3,3,0,5,7,71.4,2,5,2,3,4,10,1,0,0,2021-2022,1.7391304347826089,2.608695652173913
217,Marc Bartra,ESP,DF,Betis,La Liga,30,1991,22.1,39,14,18,17,4,19,35,54.3,16,39,22,17,33,72,105,1,0,2021-2022,1.4932126696832577,1.7647058823529411
218,Daniele Baselli,ITA,"MF,FW",Torino,Serie A,29,1992,1.7,3,3,2,0,1,2,6,33.3,4,0,0,0,1,4,2,0,0,2021-2022,0.5882352941176471,1.7647058823529411
219,Daniele Baselli,ITA,MF,Cagliari,Serie A,29,1992,3.2,6,5,3,1,2,1,5,20.0,4,2,0,2,2,8,5,0,0,2021-2022,0.625,1.875
220,Toma Bašić,CRO,MF,Lazio,Serie A,24,1996,10.9,12,8,3,9,0,5,17,29.4,12,13,4,9,4,16,21,0,0,2021-2022,0.36697247706422015,1.1009174311926606
221,Toma Bašić,CRO,MF,Bordeaux,Ligue 1,24,1996,2.3,2,2,1,0,1,0,4,0.0,4,4,1,3,2,4,0,0,0,2021-2022,0.8695652173913044,0.8695652173913044
222,Amine Bassi,FRA,"MF,FW",Metz,Ligue 1,23,1997,2.0,6,3,2,3,1,1,3,33.3,2,5,0,5,0,6,0,0,0,2021-2022,0.0,3.0
223,Álvaro Bastida,ESP,MF,Cádiz,La Liga,17,2004,2.2,7,4,2,4,1,4,5,80.0,1,1,0,1,3,10,1,0,0,2021-2022,1.3636363636363635,3.1818181818181817
224,Alessandro Bastoni,ITA,DF,Inter,Serie A,22,1999,25.7,44,25,28,13,3,17,34,50.0,17,22,12,10,35,79,59,1,0,2021-2022,1.3618677042801557,1.7120622568093387
225,Simone Bastoni,ITA,"MF,DF",Spezia,Serie A,24,1996,25.4,52,34,28,17,7,21,65,32.3,44,38,11,27,30,82,31,0,0,2021-2022,1.1811023622047245,2.047244094488189
Rk,Player,Nation,Pos,Squad,Comp,0,0,90.0,0,0,3,3,3,Tkl,0,0.0,0,0,0,0,0,0,0,0,0,2021-2022,0.0,0.0
226,Lewis Bate,ENG,MF,Leeds United,Premier League,18,2002,1.6,1,0,0,0,1,0,8,0.0,8,1,0,1,1,2,1,0,0,2021-2022,0.625,0.625
227,Rodrigo Battaglia,ARG,MF,Mallorca,La Liga,30,1991,13.1,32,16,13,19,0,15,30,50.0,15,21,10,11,10,42,36,0,0,2021-2022,0.7633587786259542,2.4427480916030535
228,Maximilian Bauer,GER,DF,Greuther Fürth,Bundesliga,21,2000,18.8,28,15,17,10,1,11,28,39.3,17,24,14,10,29,57,99,0,0,2021-2022,1.5425531914893615,1.4893617021276595
229,Oliver Baumann,GER,GK,Hoffenheim,Bundesliga,31,1990,33.0,0,0,0,0,0,0,3,0.0,3,0,0,0,0,0,19,1,0,2021-2022,0.0,0.0
230,Timo Baumgartl,GER,DF,Union Berlin,Bundesliga,25,1996,24.1,59,28,34,21,4,31,47,66.0,16,27,11,16,37,96,58,0,0,2021-2022,1.5352697095435683,2.4481327800829873
231,Julian Baumgartlinger,AUT,"MF,FW",Leverkusen,Bundesliga,33,1988,1.0,3,1,2,1,0,1,2,50.0,1,1,0,1,2,5,0,0,0,2021-2022,2.0,3.0
232,Christoph Baumgartner,AUT,"MF,FW",Hoffenheim,Bundesliga,21,1999,21.0,28,15,14,7,7,13,32,40.6,19,24,3,21,8,36,16,0,0,2021-2022,0.38095238095238093,1.3333333333333333
233,Jon Bautista,ESP,MF,Real Sociedad,La Liga,26,1995,0.5,3,0,0,3,0,0,1,0.0,1,1,0,1,1,4,1,0,0,2021-2022,2.0,6.0
234,Paul Baysse,FRA,"MF,DF",Bordeaux,Ligue 1,33,1988,0.1,1,1,0,1,0,0,0,0.0,0,0,0,0,0,1,1,0,0,2021-2022,0.0,10.0
235,Noah Joel Sarenren Bazee,NGA,"MF,FW",Augsburg,Bundesliga,24,1996,2.7,5,2,2,2,1,3,4,75.0,1,8,2,6,1,6,4,0,0,2021-2022,0.37037037037037035,1.8518518518518516
236,Bebé,CPV,FW,Rayo Vallecano,La Liga,31,1990,9.6,6,5,1,3,2,4,16,25.0,12,18,0,18,3,9,6,0,0,2021-2022,0.3125,0.625
237,Ihlas Bebou,TOG,"FW,DF",Hoffenheim,Bundesliga,27,1994,23.2,22,14,5,12,5,7,21,33.3,14,20,3,17,12,34,25,0,0,2021-2022,0.5172413793103449,0.9482758620689655
238,Rodrigo Becão,BRA,DF,Udinese,Serie A,25,1996,34.8,81,46,49,30,2,34,60,56.7,26,45,20,25,42,123,89,3,0,2021-2022,1.2068965517241381,2.327586206896552
239,Mads Bech Sørensen,DEN,DF,Brentford,Premier League,22,1999,9.3,8,7,6,2,0,6,7,85.7,1,9,6,3,6,14,25,0,0,2021-2022,0.6451612903225806,0.8602150537634408
240,Sheraldo Becker,SUR,"FW,MF",Union Berlin,Bundesliga,26,1995,19.5,9,6,3,4,2,6,18,33.3,12,11,0,11,2,11,4,0,0,2021-2022,0.10256410256410256,0.46153846153846156
241,Jan Bednarek,POL,DF,Southampton,Premier League,25,1996,29.2,32,15,18,13,1,19,33,57.6,14,48,27,21,72,104,141,0,0,2021-2022,2.4657534246575343,1.095890410958904
242,Donny van de Beek,NED,MF,Manchester Utd,Premier League,24,1997,0.8,6,4,4,1,1,1,2,50.0,1,5,1,4,2,8,1,0,0,2021-2022,2.5,7.5
243,Donny van de Beek,NED,MF,Everton,Premier League,24,1997,5.4,15,7,8,6,1,6,13,46.2,7,6,2,4,6,21,4,0,0,2021-2022,1.111111111111111,2.7777777777777777
244,Asmir Begović,BIH,GK,Everton,Premier League,34,1987,3.0,0,0,0,0,0,0,0,0.0,0,0,0,0,0,0,3,0,0,2021-2022,0.0,0.0
245,Valon Behrami,SUI,"MF,FW",Genoa,Serie A,36,1985,3.5,3,1,0,2,1,0,7,0.0,7,4,1,3,1,4,4,0,0,2021-2022,0.2857142857142857,0.8571428571428571
246,Kevin Behrens,GER,FW,Union Berlin,Bundesliga,30,1991,5.5,3,2,1,1,1,0,4,0.0,4,3,0,3,3,6,7,0,0,2021-2022,0.5454545454545454,0.5454545454545454
247,Youcef Belaïli,ALG,"MF,FW",Brest,Ligue 1,29,1992,9.2,2,1,0,0,2,2,9,22.2,7,5,1,4,7,9,4,0,0,2021-2022,0.7608695652173914,0.2173913043478261
248,Vid Belec,SVN,GK,Salernitana,Serie A,31,1990,21.5,0,0,0,0,0,0,0,0.0,0,0,0,0,0,0,9,1,0,2021-2022,0.0,0.0
249,Ishak Belfodil,ALG,FW,Hertha BSC,Bundesliga,29,1992,18.2,9,6,4,4,1,4,8,50.0,4,9,1,8,5,14,16,0,0,2021-2022,0.27472527472527475,0.4945054945054945
250,Haris Belkebla,ALG,MF,Brest,Ligue 1,27,1994,25.7,46,23,21,21,4,18,39,46.2,21,26,6,20,48,94,30,1,0,2021-2022,1.867704280155642,1.7898832684824904
Rk,Player,Nation,Pos,Squad,Comp,0,0,90.0,0,0,3,3,3,Tkl,0,0.0,0,0,0,0,0,0,0,0,0,2021-2022,0.0,0.0
251,Stefan Bell,GER,DF,Mainz 05,Bundesliga,29,1991,31.8,54,23,37,16,1,30,63,47.6,33,26,15,11,41,95,112,1,0,2021-2022,1.2893081761006289,1.6981132075471699
252,Armel Bella Kotchap,GER,DF,Bochum,Bundesliga,19,2001,19.6,34,20,25,9,0,18,28,64.3,10,21,16,5,42,76,84,2,0,2021-2022,2.142857142857143,1.7346938775510203
253,Raoul Bellanova,ITA,"DF,FW",Cagliari,Serie A,21,2000,27.7,29,15,14,12,3,6,27,22.2,21,39,8,31,21,50,51,0,0,2021-2022,0.7581227436823105,1.0469314079422383
254,Karim Bellarabi,GER,"FW,MF",Leverkusen,Bundesliga,31,1990,7.6,9,4,4,4,1,3,13,23.1,10,5,0,5,9,18,4,0,0,2021-2022,1.1842105263157896,1.1842105263157896
255,Jean-Ricner Bellegarde,FRA,MF,Strasbourg,Ligue 1,23,1998,25.9,51,32,21,21,9,17,41,41.5,24,29,4,25,27,78,19,0,0,2021-2022,1.0424710424710426,1.9691119691119692
256,Héctor Bellerín,ESP,DF,Betis,La Liga,26,1995,22.0,52,32,29,20,3,31,44,70.5,13,11,2,9,23,75,57,1,0,2021-2022,1.0454545454545454,2.3636363636363638
257,Jude Bellingham,ENG,MF,Dortmund,Bundesliga,18,2003,31.0,52,34,15,31,6,21,53,39.6,32,50,4,46,42,94,32,0,0,2021-2022,1.3548387096774193,1.6774193548387097
258,George Bello,USA,DF,Arminia,Bundesliga,19,2002,4.8,7,7,7,0,0,4,4,100.0,0,5,4,1,6,13,11,0,0,2021-2022,1.25,1.4583333333333335
259,Jeanuël Belocian,FRA,DF,Rennes,Ligue 1,16,2005,0.1,0,0,0,0,0,0,0,0.0,0,0,0,0,0,0,0,0,0,2021-2022,0.0,0.0
260,Andrea Belotti,ITA,FW,Torino,Serie A,27,1993,15.2,7,3,2,2,3,3,12,25.0,9,12,4,8,2,9,9,0,0,2021-2022,0.13157894736842105,0.46052631578947373
261,Fran Beltrán,ESP,MF,Celta Vigo,La Liga,22,1999,28.9,56,41,27,23,6,28,68,41.2,40,29,5,24,32,88,39,0,0,2021-2022,1.1072664359861593,1.9377162629757787
262,Hatem Ben Arfa,FRA,"FW,MF",Lille,Ligue 1,34,1987,3.5,4,2,2,1,1,2,4,50.0,2,3,0,3,0,4,1,0,0,2021-2022,0.0,1.1428571428571428
263,Salim Ben Seghir,FRA,MF,Marseille,Ligue 1,18,2003,0.0,0,0,0,0,0,0,0,0.0,0,0,0,0,0,0,0,0,0,2021-2022,,
264,Wissam Ben Yedder,FRA,FW,Monaco,Ligue 1,30,1990,28.1,18,8,1,11,6,6,15,40.0,9,12,1,11,0,18,1,0,0,2021-2022,0.0,0.6405693950177935
265,Marco Benassi,ITA,"DF,MF",Fiorentina,Serie A,26,1994,1.8,1,0,1,0,0,1,2,50.0,1,3,0,3,3,4,3,0,0,2021-2022,1.6666666666666665,0.5555555555555556
266,Marco Benassi,ITA,MF,Empoli,Serie A,26,1994,4.2,6,3,3,2,1,1,10,10.0,9,4,0,4,3,9,6,0,0,2021-2022,0.7142857142857143,1.4285714285714286
267,Darío Benedetto,ARG,"FW,MF",Elche,La Liga,31,1990,6.6,5,1,2,2,1,3,6,50.0,3,4,0,4,1,6,1,0,0,2021-2022,0.15151515151515152,0.7575757575757576
268,Darío Benedetto,ARG,"FW,MF",Marseille,Ligue 1,31,1990,0.6,0,0,0,0,0,0,0,0.0,0,2,0,2,0,0,0,0,0,2021-2022,0.0,0.0
269,László Bénes,SVK,MF,Gladbach,Bundesliga,23,1997,2.7,5,3,1,3,1,1,6,16.7,5,5,2,3,2,7,5,0,0,2021-2022,0.7407407407407407,1.8518518518518516
270,Walter Benítez,ARG,GK,Nice,Ligue 1,28,1993,37.0,0,0,0,0,0,0,2,0.0,2,1,0,1,0,0,12,2,0,2021-2022,0.0,0.0
271,Iker Benito,ESP,"FW,MF",Osasuna,La Liga,18,2002,1.3,2,1,1,0,1,0,1,0.0,1,2,0,2,0,2,2,0,0,2021-2022,0.0,1.5384615384615383
272,Loris Benito,SUI,DF,Bordeaux,Ligue 1,29,1992,0.7,0,0,0,0,0,0,0,0.0,0,0,0,0,1,1,3,1,0,2021-2022,1.4285714285714286,0.0
273,Pedro Benito,ESP,FW,Cádiz,La Liga,21,2000,0.3,0,0,0,0,0,0,1,0.0,1,0,0,0,0,0,0,0,0,2021-2022,0.0,0.0
274,Filip Benković,CRO,"DF,FW",Udinese,Serie A,24,1997,0.1,0,0,0,0,0,0,0,0.0,0,0,0,0,0,0,0,0,0,2021-2022,0.0,0.0
275,Ismaël Bennacer,ALG,MF,Milan,Serie A,23,1997,16.9,44,30,22,15,7,21,50,42.0,29,20,4,16,25,69,15,0,0,2021-2022,1.4792899408284026,2.6035502958579886
Rk,Player,Nation,Pos,Squad,Comp,0,0,90.0,0,0,3,3,3,Tkl,0,0.0,0,0,0,0,0,0,0,0,0,2021-2022,0.0,0.0
276,Keanan Bennetts,ENG,"FW,DF",Gladbach,Bundesliga,22,1999,0.6,2,0,1,1,0,1,1,100.0,0,1,0,1,0,2,0,0,0,2021-2022,0.0,3.3333333333333335
277,Saïd Benrahma,ALG,"FW,MF",West Ham,Premier League,25,1995,24.1,28,17,16,9,3,15,38,39.5,23,17,1,16,9,37,8,0,0,2021-2022,0.37344398340248963,1.1618257261410787
278,Ramy Bensebaini,ALG,DF,Gladbach,Bundesliga,26,1995,22.4,42,30,24,15,3,27,44,61.4,17,33,7,26,39,81,77,1,0,2021-2022,1.7410714285714286,1.8750000000000002
279,Nabil Bentaleb,ALG,MF,Angers,Ligue 1,26,1994,16.8,42,24,15,20,7,16,29,55.2,13,24,9,15,28,70,13,0,0,2021-2022,1.6666666666666665,2.5
280,Rodrigo Bentancur,URU,MF,Tottenham,Premier League,24,1997,15.1,36,18,14,14,8,16,32,50.0,16,24,9,15,20,56,35,0,0,2021-2022,1.3245033112582782,2.384105960264901
281,Rodrigo Bentancur,URU,MF,Juventus,Serie A,24,1997,12.8,32,18,11,18,3,7,20,35.0,13,15,2,13,26,58,15,1,0,2021-2022,2.03125,2.5
282,Christian Benteke,BEL,FW,Crystal Palace,Premier League,30,1990,12.7,3,2,1,2,0,2,6,33.3,4,7,3,4,2,5,33,0,0,2021-2022,0.15748031496062992,0.2362204724409449
283,Karim Benzema,FRA,FW,Real Madrid,La Liga,33,1987,28.8,11,9,5,3,3,2,9,22.2,7,10,0,10,4,15,13,0,0,2021-2022,0.1388888888888889,0.3819444444444444
284,Alessandro Berardi,ITA,GK,Hellas Verona,Serie A,30,1991,1.0,0,0,0,0,0,0,0,0.0,0,0,0,0,0,0,0,0,0,2021-2022,0.0,0.0
285,Domenico Berardi,ITA,FW,Sassuolo,Serie A,26,1994,31.3,32,19,9,16,7,15,57,26.3,42,39,2,37,31,63,23,0,0,2021-2022,0.9904153354632588,1.0223642172523961
286,Yuri Berchiche,ESP,DF,Athletic Club,La Liga,31,1990,11.3,25,11,10,11,4,7,14,50.0,7,19,6,13,13,38,25,0,0,2021-2022,1.1504424778761062,2.2123893805309733
287,Álex Berenguer,ESP,MF,Athletic Club,La Liga,26,1995,24.1,45,26,23,14,8,11,51,21.6,40,40,2,38,16,61,20,0,0,2021-2022,0.6639004149377593,1.867219917012448
288,Bartosz Bereszyński,POL,DF,Sampdoria,Serie A,29,1992,32.7,64,38,34,25,5,37,80,46.3,43,38,12,26,42,106,73,1,0,2021-2022,1.2844036697247705,1.9571865443425074
289,Jóhann Berg Guðmundsson,ISL,MF,Burnley,Premier League,30,1990,12.2,16,6,7,7,2,5,20,25.0,15,11,2,9,12,28,22,0,0,2021-2022,0.9836065573770493,1.3114754098360657
290,Patrick Berg,NOR,MF,Lens,Ligue 1,23,1997,3.4,14,6,6,8,0,0,4,0.0,4,2,1,1,4,18,3,0,0,2021-2022,1.1764705882352942,4.11764705882353
291,Mitchell van Bergen,NED,"FW,MF",Reims,Ligue 1,21,1999,10.9,8,5,7,0,1,6,15,40.0,9,9,0,9,4,12,7,0,0,2021-2022,0.36697247706422015,0.7339449541284403
292,Steven Bergwijn,NED,"FW,MF",Tottenham,Premier League,23,1997,6.3,3,2,2,1,0,1,10,10.0,9,3,0,3,1,4,8,0,0,2021-2022,0.15873015873015872,0.4761904761904762
293,Etrit Berisha,ALB,GK,Torino,Serie A,32,1989,10.0,0,0,0,0,0,0,0,0.0,0,0,0,0,0,0,4,0,0,2021-2022,0.0,0.0
294,Valon Berisha,KVX,"MF,FW",Reims,Ligue 1,28,1993,5.1,10,7,2,5,3,2,10,20.0,8,9,0,9,4,14,3,0,0,2021-2022,0.7843137254901962,1.9607843137254903
295,Federico Bernardeschi,ITA,"MF,FW",Juventus,Serie A,27,1994,16.4,16,10,7,4,5,6,13,46.2,7,12,4,8,5,21,15,0,0,2021-2022,0.30487804878048785,0.9756097560975611
296,Paul Bernardoni,FRA,GK,Angers,Ligue 1,24,1997,13.0,3,2,3,0,0,3,4,75.0,1,0,0,0,0,3,8,1,0,2021-2022,0.0,0.23076923076923078
297,Paul Bernardoni,FRA,GK,Saint-Étienne,Ligue 1,24,1997,19.0,0,0,0,0,0,0,0,0.0,0,0,0,0,0,0,14,2,0,2021-2022,0.0,0.0
298,Juan Bernat,ESP,"DF,MF",Paris S-G,Ligue 1,28,1993,10.6,24,14,10,10,4,13,18,72.2,5,8,0,8,8,32,16,0,0,2021-2022,0.7547169811320755,2.2641509433962264
299,Dimitry Bertaud,COD,GK,Montpellier,Ligue 1,23,1998,9.3,0,0,0,0,0,0,1,0.0,1,0,0,0,0,0,5,1,0,2021-2022,0.0,0.0
300,Jason Berthomier,FRA,MF,Clermont Foot,Ligue 1,31,1990,19.2,29,14,5,17,7,12,34,35.3,22,14,2,12,8,37,4,1,0,2021-2022,0.4166666666666667,1.5104166666666667
Rk,Player,Nation,Pos,Squad,Comp,0,0,90.0,0,0,3,3,3,Tkl,0,0.0,0,0,0,0,0,0,0,0,0,2021-2022,0.0,0.0
301,Nicolò Bertola,ITA,"MF,DF",Spezia,Serie A,18,2003,0.4,3,2,3,0,0,3,4,75.0,1,0,0,0,3,6,1,0,0,2021-2022,7.5,7.5
302,Ryan Bertrand,ENG,DF,Leicester City,Premier League,31,1989,3.7,8,5,3,4,1,2,5,40.0,3,8,3,5,1,9,7,0,0,2021-2022,0.27027027027027023,2.162162162162162
303,Daniel Bessa,ITA,MF,Hellas Verona,Serie A,28,1993,8.5,7,2,3,3,1,4,15,26.7,11,13,3,10,5,12,11,0,0,2021-2022,0.5882352941176471,0.8235294117647058
304,Beto,GNB,FW,Udinese,Serie A,23,1998,24.1,21,6,2,14,5,9,19,47.4,10,16,1,15,5,26,25,1,0,2021-2022,0.20746887966804978,0.871369294605809
305,Jordan Beyer,GER,DF,Gladbach,Bundesliga,21,2000,15.4,46,27,32,13,1,23,39,59.0,16,18,5,13,15,61,52,2,0,2021-2022,0.974025974025974,2.987012987012987
306,Giulian Biancone,FRA,"DF,MF",Troyes,Ligue 1,21,2000,25.5,70,42,44,22,4,40,69,58.0,29,23,8,15,53,123,71,1,0,2021-2022,2.0784313725490198,2.7450980392156863
307,Bartosz Białek,POL,"FW,DF",Wolfsburg,Bundesliga,19,2001,2.0,0,0,0,0,0,0,1,0.0,1,1,0,1,0,0,2,0,0,2021-2022,0.0,0.0
308,Ermin Bičakčić,BIH,DF,Hoffenheim,Bundesliga,31,1990,0.1,0,0,0,0,0,0,0,0.0,0,0,0,0,0,0,0,0,0,2021-2022,0.0,0.0
309,Mads Bidstrup,DEN,MF,Brentford,Premier League,20,2001,0.5,1,0,0,1,0,0,3,0.0,3,0,0,0,1,2,2,0,0,2021-2022,2.0,2.0
310,Pedro Bigas,ESP,DF,Elche,La Liga,30,1990,17.2,24,10,16,8,0,9,20,45.0,11,21,16,5,18,42,77,1,0,2021-2022,1.0465116279069768,1.3953488372093024
311,El Bilal Touré,MLI,FW,Reims,Ligue 1,19,2001,13.3,13,6,4,6,3,2,7,28.6,5,10,3,7,6,19,19,0,0,2021-2022,0.45112781954887216,0.9774436090225563
312,Jean-Claude Billong,CMR,DF,Clermont Foot,Ligue 1,27,1993,10.9,17,8,14,1,2,8,11,72.7,3,9,1,8,10,27,35,0,0,2021-2022,0.9174311926605504,1.5596330275229358
313,Luis Binks,ENG,DF,Bologna,Serie A,19,2001,7.2,8,4,7,1,0,4,6,66.7,2,6,5,1,17,25,33,1,0,2021-2022,2.361111111111111,1.1111111111111112
314,Cristiano Biraghi,ITA,DF,Fiorentina,Serie A,28,1992,35.0,37,24,17,15,5,22,53,41.5,31,28,10,18,19,56,31,1,0,2021-2022,0.5428571428571428,1.0571428571428572
315,Davide Biraschi,ITA,DF,Genoa,Serie A,27,1994,10.3,31,16,19,9,3,17,24,70.8,7,16,9,7,16,47,26,0,0,2021-2022,1.5533980582524272,3.0097087378640777
316,Tom Bischof,GER,MF,Hoffenheim,Bundesliga,16,2005,0.2,0,0,0,0,0,0,0,0.0,0,1,0,1,0,0,1,0,0,2021-2022,0.0,0.0
317,Yves Bissouma,MLI,MF,Brighton,Premier League,24,1996,23.5,76,49,35,37,4,21,37,56.8,16,33,3,30,50,126,49,0,0,2021-2022,2.127659574468085,3.234042553191489
318,Nathan Bitu Mazala,FRA,DF,Paris S-G,Ligue 1,18,2002,0.1,0,0,0,0,0,0,0,0.0,0,1,0,1,0,0,0,0,0,2021-2022,0.0,0.0
319,Marco Bizot,NED,GK,Brest,Ligue 1,30,1991,38.0,3,1,3,0,0,3,5,60.0,2,1,0,1,0,3,24,1,0,2021-2022,0.0,0.07894736842105263
320,Bjarki Bjarkason,ISL,MF,Venezia,Serie A,21,2000,0.0,0,0,0,0,0,0,0,0.0,0,0,0,0,0,0,0,0,0,2021-2022,,
321,Antonio Blanco,ESP,MF,Real Madrid,La Liga,21,2000,0.3,2,0,1,1,0,0,0,0.0,0,1,1,0,1,3,0,0,0,2021-2022,3.3333333333333335,6.666666666666667
322,Ludovic Blas,FRA,"MF,FW",Nantes,Ligue 1,23,1997,32.9,33,18,7,20,6,15,44,34.1,29,33,3,30,31,64,6,1,0,2021-2022,0.9422492401215806,1.0030395136778116
323,Danny Blum,GER,FW,Bochum,Bundesliga,30,1991,3.8,2,1,0,0,2,0,2,0.0,2,4,0,4,2,4,1,0,0,2021-2022,0.5263157894736842,0.5263157894736842
324,Myron Boadu,NED,FW,Monaco,Ligue 1,20,2001,10.7,9,7,2,3,4,1,5,20.0,4,6,0,6,2,11,1,0,0,2021-2022,0.1869158878504673,0.8411214953271029
325,Jérôme Boateng,GER,DF,Lyon,Ligue 1,32,1988,18.0,20,15,11,9,0,9,17,52.9,8,20,10,10,20,40,73,0,0,2021-2022,1.1111111111111112,1.1111111111111112
Rk,Player,Nation,Pos,Squad,Comp,0,0,90.0,0,0,3,3,3,Tkl,0,0.0,0,0,0,0,0,0,0,0,0,2021-2022,0.0,0.0
326,Kevin-Prince Boateng,GHA,"MF,FW",Hertha BSC,Bundesliga,34,1987,7.7,6,5,1,4,1,3,9,33.3,6,7,2,5,6,12,11,0,0,2021-2022,0.7792207792207793,0.7792207792207793
327,Antonin Bobichon,FRA,"MF,FW",Angers,Ligue 1,25,1995,0.4,1,0,0,1,0,0,0,0.0,0,0,0,0,1,2,0,0,0,2021-2022,2.5,2.5
328,Herbert Bockhorn,GER,DF,Bochum,Bundesliga,26,1995,9.4,20,14,13,4,3,12,20,60.0,8,10,1,9,14,34,18,0,0,2021-2022,1.4893617021276595,2.127659574468085
329,Jean-Paul Boëtius,NED,MF,Mainz 05,Bundesliga,27,1994,20.0,40,23,18,17,5,22,53,41.5,31,41,3,38,25,65,11,0,0,2021-2022,1.25,2.0
330,Jeremie Boga,CIV,"FW,MF",Atalanta,Serie A,24,1997,8.5,7,3,0,4,3,4,6,66.7,2,6,0,6,1,8,3,1,0,2021-2022,0.11764705882352941,0.8235294117647058
331,Jeremie Boga,CIV,"FW,MF",Sassuolo,Serie A,24,1997,7.4,7,4,1,2,4,2,3,66.7,1,3,0,3,2,9,1,1,0,2021-2022,0.27027027027027023,0.9459459459459459
332,Luka Bogdan,CRO,DF,Salernitana,Serie A,25,1996,4.4,6,3,6,0,0,4,8,50.0,4,3,2,1,6,12,21,0,0,2021-2022,1.3636363636363635,1.3636363636363635
333,Emil Bohinen,NOR,MF,Salernitana,Serie A,22,1999,7.8,15,9,4,9,2,10,20,50.0,10,17,3,14,12,27,14,0,0,2021-2022,1.5384615384615385,1.9230769230769231
334,Quentin Boisgard,FRA,"MF,FW",Lorient,Ligue 1,24,1997,10.6,19,11,6,10,3,8,17,47.1,9,15,0,15,6,25,5,0,0,2021-2022,0.5660377358490566,1.7924528301886793
335,Charles Boli,FRA,"MF,DF",Lens,Ligue 1,22,1998,0.4,2,1,0,2,0,0,0,0.0,0,0,0,0,0,2,0,0,0,2021-2022,0.0,5.0
336,Willy Boly,CIV,DF,Wolves,Premier League,30,1991,10.0,25,19,18,7,0,8,15,53.3,7,14,6,8,14,39,35,0,0,2021-2022,1.4,2.5
337,Giacomo Bonaventura,ITA,MF,Fiorentina,Serie A,31,1989,25.2,33,17,12,16,5,21,46,45.7,25,20,2,18,14,47,9,1,0,2021-2022,0.5555555555555556,1.3095238095238095
338,Federico Bonazzoli,ITA,"FW,MF",Salernitana,Serie A,24,1997,20.7,24,12,9,8,7,6,25,24.0,19,17,1,16,6,30,7,0,0,2021-2022,0.2898550724637681,1.1594202898550725
339,Tarsis Bonga,GER,"MF,FW",Bochum,Bundesliga,24,1997,0.2,0,0,0,0,0,0,0,0.0,0,0,0,0,0,0,0,0,0,2021-2022,0.0,0.0
340,Kevin Bonifazi,ITA,DF,Bologna,Serie A,25,1996,13.4,25,16,16,7,2,13,14,92.9,1,22,7,15,16,41,35,0,0,2021-2022,1.1940298507462686,1.8656716417910448
341,Solomon Bonnah,NED,DF,RB Leipzig,Bundesliga,17,2003,0.1,0,0,0,0,0,0,0,0.0,0,1,0,1,1,1,0,0,0,2021-2022,10.0,0.0
342,Leonardo Bonucci,ITA,DF,Juventus,Serie A,34,1987,22.3,14,5,4,10,0,8,13,61.5,5,22,17,5,26,40,82,0,0,2021-2022,1.1659192825112108,0.6278026905829596
343,Sebastiaan Bornauw,BEL,DF,Wolfsburg,Bundesliga,22,1999,22.3,30,19,23,5,2,16,25,64.0,9,29,8,21,42,72,97,1,0,2021-2022,1.8834080717488788,1.3452914798206277
344,Rafael Borré,COL,FW,Eint Frankfurt,Bundesliga,25,1995,26.4,31,22,4,13,14,7,33,21.2,26,24,4,20,5,36,9,0,0,2021-2022,0.1893939393939394,1.1742424242424243
345,Sven Botman,NED,DF,Lille,Ligue 1,21,2000,25.0,24,11,13,11,0,12,18,66.7,6,32,21,11,26,50,116,0,0,2021-2022,1.04,0.96
346,Denis Bouanga,GAB,"FW,MF",Saint-Étienne,Ligue 1,26,1994,27.1,46,25,14,13,19,22,63,34.9,41,30,0,30,8,54,34,1,0,2021-2022,0.2952029520295203,1.6974169741697416
347,Hicham Boudaoui,ALG,MF,Nice,Ligue 1,21,1999,18.0,31,18,15,10,6,13,36,36.1,23,17,4,13,18,49,15,0,0,2021-2022,1.0,1.7222222222222223
348,Ryad Boudebouz,ALG,"MF,FW",Saint-Étienne,Ligue 1,31,1990,25.0,27,15,11,12,4,12,29,41.4,17,17,2,15,10,37,5,0,0,2021-2022,0.4,1.08
349,Sofiane Boufal,MAR,"FW,MF",Angers,Ligue 1,27,1993,25.9,44,29,19,16,9,18,38,47.4,20,19,2,17,7,51,1,0,0,2021-2022,0.2702702702702703,1.698841698841699
350,Farid Boulaya,ALG,"MF,FW",Metz,Ligue 1,28,1993,17.0,18,10,7,9,2,14,38,36.8,24,8,2,6,12,30,5,0,0,2021-2022,0.7058823529411765,1.0588235294117647
Rk,Player,Nation,Pos,Squad,Comp,0,0,90.0,0,0,3,3,3,Tkl,0,0.0,0,0,0,0,0,0,0,0,0,2021-2022,0.0,0.0
351,Yassine Bounou,MAR,GK,Sevilla,La Liga,30,1991,31.0,0,0,0,0,0,0,0,0.0,0,0,0,0,0,0,11,1,0,2021-2022,0.0,0.0
352,Ismaëlben Boura,COM,DF,Lens,Ligue 1,20,2000,1.1,2,2,1,1,0,0,0,0.0,0,1,1,0,2,4,5,0,0,2021-2022,1.8181818181818181,1.8181818181818181
353,Mehdi Bourabia,MAR,MF,Spezia,Serie A,29,1991,3.1,5,1,2,3,0,3,11,27.3,8,7,6,1,3,8,10,0,0,2021-2022,0.9677419354838709,1.6129032258064515
354,Benjamin Bourigeaud,FRA,"FW,MF",Rennes,Ligue 1,27,1994,35.5,46,24,16,18,12,24,67,35.8,43,33,3,30,30,76,44,0,0,2021-2022,0.8450704225352113,1.295774647887324
355,Redwan Bourles,FRA,"MF,FW",Lorient,Ligue 1,18,2003,0.2,0,0,0,0,0,0,0,0.0,0,0,0,0,0,0,0,0,0,2021-2022,0.0,0.0
356,Edoardo Bove,ITA,"MF,DF",Roma,Serie A,19,2002,0.8,1,1,1,0,0,0,2,0.0,2,1,0,1,1,2,0,0,0,2021-2022,1.25,1.25
357,Jarrod Bowen,ENG,FW,West Ham,Premier League,24,1996,33.1,36,20,20,11,5,17,44,38.6,27,29,2,27,21,57,14,0,0,2021-2022,0.634441087613293,1.0876132930513596
358,Dedryck Boyata,BEL,DF,Hertha BSC,Bundesliga,30,1990,21.1,15,13,11,3,1,8,11,72.7,3,17,13,4,17,32,134,1,0,2021-2022,0.8056872037914692,0.7109004739336492
359,Lucas Boyé,ARG,FW,Elche,La Liga,25,1996,19.0,27,13,5,15,7,9,24,37.5,15,24,1,23,2,29,23,0,0,2021-2022,0.10526315789473684,1.4210526315789473
360,Domagoj Bradarić,CRO,DF,Lille,Ligue 1,21,1999,4.6,11,9,8,2,1,7,12,58.3,5,5,2,3,10,21,7,1,0,2021-2022,2.173913043478261,2.3913043478260874
361,Bilal Brahimi,ALG,MF,Nice,Ligue 1,21,2000,4.2,1,1,0,1,0,0,2,0.0,2,1,0,1,2,3,1,0,0,2021-2022,0.47619047619047616,0.23809523809523808
362,Bilal Brahimi,ALG,FW,Angers,Ligue 1,21,2000,3.8,1,1,0,1,0,0,3,0.0,3,0,0,0,1,2,1,0,0,2021-2022,0.2631578947368421,0.2631578947368421
363,Martin Braithwaite,DEN,FW,Barcelona,La Liga,30,1991,2.6,1,1,0,0,1,0,0,0.0,0,2,0,2,1,2,1,0,0,2021-2022,0.3846153846153846,0.3846153846153846
364,Julian Brandt,GER,"MF,FW",Dortmund,Bundesliga,25,1996,23.1,37,19,13,20,4,17,54,31.5,37,19,2,17,24,61,14,1,0,2021-2022,1.0389610389610389,1.6017316017316017
365,Jarrad Branthwaite,ENG,DF,Everton,Premier League,19,2002,4.3,4,1,3,1,0,3,8,37.5,5,3,2,1,1,5,20,0,0,2021-2022,0.23255813953488372,0.9302325581395349
366,Darko Brašanac,SRB,MF,Osasuna,La Liga,29,1992,26.7,35,22,19,14,2,14,40,35.0,26,25,8,17,25,60,15,0,0,2021-2022,0.9363295880149813,1.3108614232209739
367,Lilian Brassier,FRA,DF,Brest,Ligue 1,21,1999,25.1,40,24,23,13,4,10,21,47.6,11,31,21,10,32,72,86,0,0,2021-2022,1.2749003984063745,1.593625498007968
368,Claudio Bravo,CHI,GK,Betis,La Liga,38,1983,16.2,0,0,0,0,0,0,0,0.0,0,0,0,0,0,0,6,2,0,2021-2022,0.0,0.0
369,Iker Bravo,ESP,FW,Leverkusen,Bundesliga,16,2005,0.1,1,1,0,1,0,0,0,0.0,0,0,0,0,0,1,0,0,0,2021-2022,0.0,10.0
370,Fabian Bredlow,GER,GK,Stuttgart,Bundesliga,26,1995,4.0,0,0,0,0,0,0,0,0.0,0,0,0,0,0,0,1,0,0,2021-2022,0.0,0.0
371,Josip Brekalo,CRO,MF,Torino,Serie A,23,1998,25.4,9,5,5,1,3,3,21,14.3,18,16,1,15,4,13,7,1,0,2021-2022,0.15748031496062992,0.35433070866141736
372,Josip Brekalo,CRO,FW,Wolfsburg,Bundesliga,23,1998,0.2,0,0,0,0,0,0,0,0.0,0,0,0,0,0,0,0,0,0,2021-2022,0.0,0.0
373,Gleison Bremer,BRA,DF,Torino,Serie A,24,1997,32.1,49,24,27,22,0,18,28,64.3,10,54,23,31,105,154,137,0,0,2021-2022,3.2710280373831773,1.5264797507788161
374,Jimmy Briand,FRA,"FW,MF",Bordeaux,Ligue 1,35,1985,2.5,2,0,2,0,0,0,2,0.0,2,0,0,0,1,3,2,0,0,2021-2022,0.4,0.8
375,Yan Brice Eteki,CMR,MF,Granada,La Liga,23,1997,3.8,6,3,3,2,1,3,7,42.9,4,7,3,4,4,10,6,1,0,2021-2022,1.0526315789473684,1.5789473684210527
Rk,Player,Nation,Pos,Squad,Comp,0,0,90.0,0,0,3,3,3,Tkl,0,0.0,0,0,0,0,0,0,0,0,0,2021-2022,0.0,0.0
376,Brian Brobbey,NED,"FW,MF",RB Leipzig,Bundesliga,19,2002,1.5,1,0,0,1,0,1,1,100.0,0,1,0,1,0,1,0,0,0,2021-2022,0.0,0.6666666666666666
377,Armando Broja,ALB,FW,Southampton,Premier League,19,2001,21.9,12,5,2,7,3,2,9,22.2,7,17,1,16,3,15,11,0,0,2021-2022,0.13698630136986303,0.5479452054794521
378,Dylan Bronn,TUN,DF,Metz,Ligue 1,26,1995,28.3,47,29,33,13,1,20,31,64.5,11,32,19,13,40,87,78,1,0,2021-2022,1.4134275618374559,1.6607773851590106
379,John Brooks,USA,DF,Wolfsburg,Bundesliga,28,1993,29.1,47,25,25,18,4,36,60,60.0,24,33,19,14,41,88,125,1,0,2021-2022,1.40893470790378,1.6151202749140892
380,Daniel Brosinski,GER,DF,Mainz 05,Bundesliga,33,1988,4.3,2,1,1,1,0,1,1,100.0,0,6,0,6,3,5,9,0,0,2021-2022,0.6976744186046512,0.46511627906976744
381,Josh Brownhill,ENG,MF,Burnley,Premier League,25,1995,32.8,73,37,25,42,6,21,53,39.6,32,37,12,25,68,141,42,1,0,2021-2022,2.073170731707317,2.225609756097561
382,Marcelo Brozović,CRO,MF,Inter,Serie A,28,1992,32.6,77,45,34,35,8,34,68,50.0,34,28,10,18,37,114,36,2,0,2021-2022,1.1349693251533741,2.3619631901840488
383,Cédric Brunner,SUI,DF,Arminia,Bundesliga,27,1994,24.3,51,35,29,20,2,25,49,51.0,24,27,10,17,43,94,84,0,0,2021-2022,1.7695473251028806,2.0987654320987654
384,Lewis Brunt,ENG,MF,Leicester City,Premier League,20,2000,0.3,0,0,0,0,0,0,0,0.0,0,1,0,1,0,0,0,0,0,2021-2022,0.0,0.0
385,Jacob Bruun Larsen,DEN,"FW,MF",Hoffenheim,Bundesliga,22,1998,9.0,2,1,1,1,0,0,5,0.0,5,14,3,11,5,7,5,2,0,2021-2022,0.5555555555555556,0.2222222222222222
386,Ante Budimir,CRO,FW,Osasuna,La Liga,30,1991,19.3,24,10,3,15,6,6,19,31.6,13,22,4,18,3,27,16,0,0,2021-2022,0.15544041450777202,1.2435233160621761
387,Emi Buendía,ARG,"MF,FW",Aston Villa,Premier League,24,1996,21.1,38,18,16,13,9,21,51,41.2,30,21,3,18,9,47,11,0,0,2021-2022,0.42654028436018954,1.8009478672985781
388,Osman Bukari,GHA,"FW,MF",Nantes,Ligue 1,22,1998,11.2,18,8,7,6,5,8,22,36.4,14,8,0,8,8,26,1,0,0,2021-2022,0.7142857142857143,1.6071428571428572
389,Aleksander Buksa,POL,FW,Genoa,Serie A,18,2003,0.7,0,0,0,0,0,0,1,0.0,1,0,0,0,0,0,1,0,0,2021-2022,0.0,0.0
390,Alessandro Buongiorno,ITA,DF,Torino,Serie A,22,1999,13.1,20,9,9,8,3,9,13,69.2,4,12,6,6,31,51,44,0,0,2021-2022,2.366412213740458,1.5267175572519085
391,Sascha Burchert,GER,GK,Greuther Fürth,Bundesliga,31,1989,14.0,1,1,1,0,0,1,2,50.0,1,0,0,0,0,1,11,1,0,2021-2022,0.0,0.07142857142857142
392,Delano Burgzorg,NED,MF,Mainz 05,Bundesliga,22,1998,0.3,1,1,1,0,0,0,1,0.0,1,0,0,0,0,1,0,0,0,2021-2022,0.0,3.3333333333333335
393,Jonathan Burkardt,GER,"FW,MF",Mainz 05,Bundesliga,21,2000,29.0,17,8,0,10,7,6,25,24.0,19,31,5,26,8,25,16,0,0,2021-2022,0.27586206896551724,0.5862068965517241
394,Roman Bürki,SUI,GK,Dortmund,Bundesliga,30,1990,1.0,0,0,0,0,0,0,0,0.0,0,0,0,0,0,0,0,0,0,2021-2022,0.0,0.0
395,Dan Burn,ENG,DF,Newcastle Utd,Premier League,29,1992,16.0,16,11,11,4,1,7,11,63.6,4,22,14,8,20,36,101,0,0,2021-2022,1.25,1.0
396,Dan Burn,ENG,DF,Brighton,Premier League,29,1992,11.4,22,12,13,8,1,6,15,40.0,9,14,10,4,24,46,51,0,0,2021-2022,2.1052631578947367,1.9298245614035088
397,Maxime Busi,BEL,DF,Reims,Ligue 1,21,1999,14.4,26,15,20,5,1,19,36,52.8,17,19,5,14,17,43,28,0,0,2021-2022,1.1805555555555556,1.8055555555555556
398,Gianluca Busio,USA,MF,Venezia,Serie A,19,2002,21.7,53,28,27,20,6,28,63,44.4,35,45,13,32,21,74,30,1,0,2021-2022,0.967741935483871,2.442396313364055
399,Oriol Busquets,ESP,MF,Clermont Foot,Ligue 1,22,1999,2.2,3,3,0,3,0,2,6,33.3,4,7,4,3,1,4,2,0,0,2021-2022,0.45454545454545453,1.3636363636363635
400,Sergio Busquets,ESP,MF,Barcelona,La Liga,33,1988,35.5,93,49,31,48,14,46,83,55.4,37,44,8,36,45,138,31,0,0,2021-2022,1.267605633802817,2.619718309859155
Rk,Player,Nation,Pos,Squad,Comp,0,0,90.0,0,0,3,3,3,Tkl,0,0.0,0,0,0,0,0,0,0,0,0,2021-2022,0.0,0.0
401,Jack Butland,ENG,GK,Crystal Palace,Premier League,28,1993,8.5,0,0,0,0,0,0,0,0.0,0,0,0,0,0,0,1,0,0,2021-2022,0.0,0.0
402,Adrián Butzke,ESP,FW,Granada,La Liga,22,1999,0.0,0,0,0,0,0,0,0,0.0,0,0,0,0,0,0,0,0,0,2021-2022,,
403,Marcin Bułka,POL,GK,Nice,Ligue 1,21,1999,1.0,0,0,0,0,0,0,0,0.0,0,0,0,0,0,0,0,0,0,2021-2022,0.0,0.0
404,Sam Byram,ENG,DF,Norwich City,Premier League,27,1993,11.4,24,15,17,6,1,19,27,70.4,8,21,11,10,22,46,48,0,0,2021-2022,1.9298245614035088,2.1052631578947367
405,Erick Cabaco,URU,DF,Getafe,La Liga,26,1995,4.5,2,1,1,1,0,2,5,40.0,3,5,2,3,4,6,10,0,0,2021-2022,0.8888888888888888,0.4444444444444444
406,Willy Caballero,ARG,GK,Southampton,Premier League,39,1981,2.0,0,0,0,0,0,0,0,0.0,0,0,0,0,0,0,2,1,0,2021-2022,0.0,0.0
407,Rémy Cabella,FRA,"MF,FW",Montpellier,Ligue 1,31,1990,3.5,15,7,4,8,3,5,15,33.3,10,7,0,7,5,20,1,0,0,2021-2022,1.4285714285714286,4.285714285714286
408,Jimmy Cabot,FRA,DF,Angers,Ligue 1,27,1994,22.3,81,44,59,15,7,47,83,56.6,36,29,0,29,32,113,30,0,0,2021-2022,1.4349775784753362,3.632286995515695
409,Arthur Cabral,BRA,FW,Fiorentina,Serie A,23,1998,8.3,9,5,2,5,2,4,7,57.1,3,4,1,3,1,10,8,0,0,2021-2022,0.12048192771084336,1.0843373493975903
410,Jovane Cabral,CPV,FW,Lazio,Serie A,23,1998,2.1,2,1,1,0,1,0,0,0.0,0,1,1,0,1,3,1,0,0,2021-2022,0.47619047619047616,0.9523809523809523
411,Leandro Cabrera,URU,DF,Espanyol,La Liga,30,1991,37.0,37,24,27,10,0,21,34,61.8,13,32,23,9,44,81,222,2,0,2021-2022,1.1891891891891893,1.0
412,Liberato Cacace,NZL,DF,Empoli,Serie A,20,2000,5.2,15,6,8,4,3,8,8,100.0,0,7,2,5,8,23,9,0,0,2021-2022,1.5384615384615383,2.8846153846153846
413,Martín Cáceres,URU,DF,Cagliari,Serie A,34,1987,9.2,13,7,5,5,3,4,12,33.3,8,12,3,9,14,27,21,0,0,2021-2022,1.5217391304347827,1.4130434782608696
414,Martín Cáceres,URU,DF,Levante,La Liga,34,1987,7.4,2,2,2,0,0,1,5,20.0,4,2,2,0,11,13,16,1,0,2021-2022,1.4864864864864864,0.27027027027027023
415,Anthony Caci,FRA,DF,Strasbourg,Ligue 1,24,1997,26.6,65,34,35,24,6,33,55,60.0,22,22,3,19,33,98,49,1,0,2021-2022,1.2406015037593985,2.443609022556391
416,Mathieu Cafaro,FRA,"MF,FW",Reims,Ligue 1,24,1997,2.1,4,2,3,1,0,0,7,0.0,7,2,0,2,3,7,1,0,0,2021-2022,1.4285714285714286,1.9047619047619047
417,Yannick Cahuzac,FRA,MF,Lens,Ligue 1,36,1985,6.9,5,2,2,3,0,0,5,0.0,5,8,2,6,9,14,12,0,0,2021-2022,1.3043478260869565,0.7246376811594203
418,Felipe Caicedo,ECU,FW,Genoa,Serie A,32,1988,3.2,3,3,0,2,1,0,1,0.0,1,1,0,1,0,3,4,0,0,2021-2022,0.0,0.9375
419,Felipe Caicedo,ECU,"FW,DF",Inter,Serie A,32,1988,0.3,0,0,0,0,0,0,0,0.0,0,1,0,1,0,0,0,0,0,2021-2022,0.0,0.0
420,Moisés Caicedo,ECU,MF,Brighton,Premier League,19,2001,7.3,16,10,7,7,2,5,12,41.7,7,18,4,14,10,26,7,0,0,2021-2022,1.36986301369863,2.191780821917808
421,Marc-Aurèle Caillard,FRA,GK,Metz,Ligue 1,27,1994,17.1,0,0,0,0,0,0,2,0.0,2,0,0,0,2,2,9,1,0,2021-2022,0.11695906432748537,0.0
422,Jens Cajuste,SWE,"MF,FW",Reims,Ligue 1,21,1999,4.0,10,6,6,2,2,6,17,35.3,11,7,2,5,5,15,6,0,0,2021-2022,1.25,2.5
423,Cala,ESP,DF,Cádiz,La Liga,31,1989,10.5,9,4,9,0,0,8,17,47.1,9,12,6,6,12,21,56,0,0,2021-2022,1.1428571428571428,0.8571428571428571
424,Davide Calabria,ITA,DF,Milan,Serie A,24,1996,23.5,62,37,31,23,8,37,72,51.4,35,25,5,20,23,85,40,1,0,2021-2022,0.9787234042553191,2.6382978723404253
425,Riccardo Calafiori,ITA,DF,Genoa,Serie A,19,2002,0.9,1,0,0,0,1,1,2,50.0,1,2,1,1,2,3,4,0,0,2021-2022,2.2222222222222223,1.1111111111111112
Rk,Player,Nation,Pos,Squad,Comp,0,0,90.0,0,0,3,3,3,Tkl,0,0.0,0,0,0,0,0,0,0,0,0,2021-2022,0.0,0.0
426,Riccardo Calafiori,ITA,DF,Roma,Serie A,19,2002,1.9,5,4,2,2,1,1,5,20.0,4,3,0,3,3,8,1,0,0,2021-2022,1.5789473684210527,2.6315789473684212
427,Mattia Caldara,ITA,DF,Venezia,Serie A,27,1994,30.0,48,28,30,15,3,20,34,58.8,14,49,37,12,62,110,147,1,0,2021-2022,2.066666666666667,1.6
428,Calderón,ESP,DF,Betis,La Liga,21,2000,0.7,2,0,1,0,1,1,3,33.3,2,0,0,0,0,2,2,0,0,2021-2022,0.0,2.857142857142857
429,Fernando Calero,ESP,DF,Espanyol,La Liga,25,1995,12.1,17,10,12,5,0,8,13,61.5,5,7,2,5,16,33,63,1,0,2021-2022,1.322314049586777,1.4049586776859504
430,Duje Ćaleta-Car,CRO,DF,Marseille,Ligue 1,24,1996,22.9,21,8,15,6,0,11,14,78.6,3,11,7,4,24,45,55,2,0,2021-2022,1.0480349344978166,0.9170305676855895
431,Hakan Çalhanoğlu,TUR,MF,Inter,Serie A,27,1994,27.6,41,23,16,19,6,11,40,27.5,29,29,5,24,25,66,12,0,0,2021-2022,0.9057971014492753,1.4855072463768115
432,Daniel Caligiuri,ITA,"DF,MF",Augsburg,Bundesliga,33,1988,22.3,46,30,17,26,3,27,72,37.5,45,36,5,31,18,64,33,0,0,2021-2022,0.8071748878923767,2.0627802690582957
433,José Callejón,ESP,FW,Fiorentina,Serie A,34,1987,14.4,15,6,6,6,3,13,31,41.9,18,6,0,6,3,18,1,1,0,2021-2022,0.20833333333333331,1.0416666666666667
434,Lucas Calodat,FRA,DF,Saint-Étienne,Ligue 1,19,2002,0.0,0,0,0,0,0,0,0,0.0,0,0,0,0,0,0,0,0,0,2021-2022,,
435,Dominic Calvert-Lewin,ENG,FW,Everton,Premier League,24,1997,14.3,11,8,1,6,4,3,8,37.5,5,5,2,3,3,14,12,0,0,2021-2022,0.2097902097902098,0.7692307692307692
436,Mahdi Camara,FRA,"MF,DF",Saint-Étienne,Ligue 1,23,1998,34.1,101,57,39,50,12,39,70,55.7,31,44,8,36,57,158,35,1,0,2021-2022,1.6715542521994133,2.961876832844575
437,Mamadou Camara,MLI,FW,Troyes,Ligue 1,20,2001,0.4,1,1,1,0,0,0,0,0.0,0,0,0,0,0,1,0,0,0,2021-2022,0.0,2.5
438,Víctor Camarasa,ESP,"MF,FW",Betis,La Liga,27,1994,1.2,2,1,1,1,0,0,1,0.0,1,2,1,1,2,4,2,0,0,2021-2022,1.6666666666666667,1.6666666666666667
439,Eduardo Camavinga,FRA,MF,Real Madrid,La Liga,18,2002,13.7,52,35,22,20,10,20,38,52.6,18,20,2,18,17,69,14,1,0,2021-2022,1.2408759124087592,3.7956204379562046
440,Eduardo Camavinga,FRA,MF,Rennes,Ligue 1,18,2002,1.6,4,1,2,1,1,2,5,40.0,3,1,1,0,1,5,3,0,0,2021-2022,0.625,2.5
441,Andrea Cambiaso,ITA,DF,Genoa,Serie A,21,2000,19.9,46,20,28,14,4,18,32,56.3,14,33,8,25,23,69,37,1,0,2021-2022,1.155778894472362,2.311557788944724
442,José Campaña,ESP,MF,Levante,La Liga,28,1993,15.8,27,16,13,10,4,12,32,37.5,20,13,2,11,21,48,19,1,0,2021-2022,1.3291139240506329,1.7088607594936709
443,Chem Campbell,WAL,MF,Wolves,Premier League,18,2002,0.1,1,1,0,1,0,0,0,0.0,0,0,0,0,0,1,0,0,0,2021-2022,0.0,10.0
444,Emre Can,GER,"DF,MF",Dortmund,Bundesliga,27,1994,18.8,36,22,20,16,0,15,30,50.0,15,26,10,16,36,72,40,2,0,2021-2022,1.9148936170212765,1.9148936170212765
445,Sergio Canales,ESP,"FW,MF",Betis,La Liga,30,1991,31.0,24,14,8,12,4,10,35,28.6,25,16,1,15,10,34,12,0,0,2021-2022,0.3225806451612903,0.7741935483870968
446,Matteo Cancellieri,ITA,"MF,DF",Hellas Verona,Serie A,19,2002,2.5,4,4,2,2,0,0,5,0.0,5,2,0,2,1,5,0,0,0,2021-2022,0.4,1.6
447,João Cancelo,POR,DF,Manchester City,Premier League,27,1994,35.9,83,54,33,35,15,46,91,50.5,45,25,3,22,59,142,45,1,0,2021-2022,1.6434540389972145,2.3119777158774375
448,Fali Candé,GNB,DF,Metz,Ligue 1,23,1998,10.8,30,18,13,15,2,13,31,41.9,18,11,2,9,6,36,21,0,0,2021-2022,0.5555555555555555,2.7777777777777777
449,Antonio Candreva,ITA,"MF,FW",Sampdoria,Serie A,34,1987,34.7,27,16,9,11,7,19,55,34.5,36,23,2,21,33,60,19,0,0,2021-2022,0.9510086455331411,0.7780979827089336
450,Sergi Canós,ESP,"DF,FW",Brentford,Premier League,24,1997,23.1,56,25,32,15,9,33,60,55.0,27,32,3,29,22,78,38,0,0,2021-2022,0.9523809523809523,2.4242424242424243
Rk,Player,Nation,Pos,Squad,Comp,0,0,90.0,0,0,3,3,3,Tkl,0,0.0,0,0,0,0,0,0,0,0,0,2021-2022,0.0,0.0
451,Álex Cantero,ESP,"FW,MF",Levante,La Liga,21,2000,6.8,6,4,2,3,1,1,8,12.5,7,2,0,2,1,7,0,0,0,2021-2022,0.14705882352941177,0.8823529411764706
452,Todd Cantwell,ENG,"FW,MF",Norwich City,Premier League,23,1998,4.9,15,13,8,6,1,6,17,35.3,11,2,0,2,3,18,2,0,0,2021-2022,0.6122448979591836,3.061224489795918
453,Ander Capa,ESP,DF,Athletic Club,La Liga,29,1992,0.0,0,0,0,0,0,0,0,0.0,0,0,0,0,0,0,0,0,0,2021-2022,,
454,Pierrick Capelle,FRA,"MF,DF",Angers,Ligue 1,34,1987,13.3,36,24,16,17,3,18,52,34.6,34,12,1,11,16,52,20,0,0,2021-2022,1.2030075187969924,2.706766917293233
455,Leonardo Capezzi,ITA,MF,Salernitana,Serie A,26,1995,1.9,3,1,0,3,0,1,4,25.0,3,8,4,4,0,3,2,0,0,2021-2022,0.0,1.5789473684210527
456,Étienne Capoue,FRA,MF,Villarreal,La Liga,33,1988,25.4,44,26,18,23,3,15,28,53.6,13,17,5,12,35,79,51,0,0,2021-2022,1.3779527559055118,1.7322834645669292
457,Gianluca Caprari,ITA,"MF,FW",Hellas Verona,Serie A,28,1993,30.4,43,25,10,22,11,17,51,33.3,34,32,0,32,4,47,7,0,0,2021-2022,0.13157894736842105,1.4144736842105263
458,Francesco Caputo,ITA,FW,Sampdoria,Serie A,33,1987,31.0,5,2,1,3,1,1,6,16.7,5,5,0,5,2,7,10,0,0,2021-2022,0.06451612903225806,0.16129032258064516
459,Francesco Caputo,ITA,FW,Sassuolo,Serie A,33,1987,1.7,0,0,0,0,0,0,0,0.0,0,0,0,0,0,0,0,0,0,2021-2022,0.0,0.0
460,Maxence Caqueret,FRA,MF,Lyon,Ligue 1,21,2000,25.9,73,40,29,36,8,30,80,37.5,50,38,10,28,43,116,26,2,0,2021-2022,1.6602316602316602,2.8185328185328187
461,Andrea Carboni,ITA,DF,Cagliari,Serie A,20,2001,24.6,53,24,33,16,4,19,42,45.2,23,42,15,27,27,80,87,0,0,2021-2022,1.097560975609756,2.154471544715447
462,Isaac Carcelen,ESP,"DF,MF",Cádiz,La Liga,28,1993,17.2,43,29,29,12,2,28,56,50.0,28,25,6,19,34,77,42,0,0,2021-2022,1.9767441860465118,2.5
463,Cárdenas,ESP,GK,Levante,La Liga,24,1997,24.0,1,1,1,0,0,0,3,0.0,3,0,0,0,1,2,19,0,0,2021-2022,0.041666666666666664,0.041666666666666664
464,Irvin Cardona,FRA,"FW,MF",Brest,Ligue 1,23,1997,14.8,13,7,5,4,4,3,16,18.8,13,10,0,10,5,18,17,0,0,2021-2022,0.33783783783783783,0.8783783783783783
465,Igor Carioca,BRA,DF,Lorient,Ligue 1,24,1996,17.5,27,16,16,8,3,15,43,34.9,28,17,2,15,25,52,28,0,0,2021-2022,1.4285714285714286,1.542857142857143
466,Carlo,ESP,MF,Villarreal,La Liga,20,2001,0.1,0,0,0,0,0,0,0,0.0,0,0,0,0,0,0,0,0,0,2021-2022,0.0,0.0
467,Diego Carlos,BRA,DF,Sevilla,La Liga,28,1993,32.9,35,24,20,13,2,16,24,66.7,8,48,33,15,24,59,120,5,0,2021-2022,0.729483282674772,1.0638297872340425
468,Carmona,ESP,DF,Sevilla,La Liga,19,2002,0.3,0,0,0,0,0,0,0,0.0,0,0,0,0,1,1,0,0,0,2021-2022,3.3333333333333335,0.0
469,Yannick Carrasco,BEL,"FW,MF",Atlético Madrid,La Liga,27,1993,28.7,34,19,16,12,6,19,44,43.2,25,26,5,21,19,53,12,2,0,2021-2022,0.662020905923345,1.1846689895470384
470,Guido Carrillo,ARG,FW,Elche,La Liga,30,1991,13.0,7,4,2,4,1,3,13,23.1,10,9,2,7,1,8,27,0,0,2021-2022,0.07692307692307693,0.5384615384615384
471,Dani Carvajal,ESP,DF,Real Madrid,La Liga,29,1992,17.2,43,28,21,15,7,15,26,57.7,11,22,8,14,20,63,38,2,0,2021-2022,1.1627906976744187,2.5
472,William Carvalho,POR,MF,Betis,La Liga,29,1992,20.1,49,33,20,25,4,15,40,37.5,25,18,7,11,16,65,20,0,0,2021-2022,0.7960199004975124,2.4378109452736316
473,Nicolò Casale,ITA,DF,Hellas Verona,Serie A,23,1998,28.7,46,30,25,19,2,21,37,56.8,16,31,12,19,49,95,95,0,0,2021-2022,1.7073170731707317,1.602787456445993
474,Casemiro,BRA,MF,Real Madrid,La Liga,29,1992,28.5,79,51,45,30,4,30,67,44.8,37,65,19,46,38,117,65,3,0,2021-2022,1.3333333333333333,2.7719298245614037
475,Matty Cash,POL,DF,Aston Villa,Premier League,23,1997,37.5,89,50,52,34,3,47,78,60.3,31,54,16,38,49,138,100,2,0,2021-2022,1.3066666666666666,2.3733333333333335
Rk,Player,Nation,Pos,Squad,Comp,0,0,90.0,0,0,3,3,3,Tkl,0,0.0,0,0,0,0,0,0,0,0,0,2021-2022,0.0,0.0
476,Kiko Casilla,ESP,GK,Elche,La Liga,34,1986,14.0,0,0,0,0,0,0,1,0.0,1,0,0,0,1,1,2,2,0,2021-2022,0.07142857142857142,0.0
477,Moreto Cassamã,GNB,MF,Reims,Ligue 1,23,1998,8.9,12,6,7,4,1,3,19,15.8,16,10,5,5,9,21,5,0,0,2021-2022,1.0112359550561798,1.348314606741573
478,Francesco Cassata,ITA,MF,Genoa,Serie A,24,1997,0.1,0,0,0,0,0,0,0,0.0,0,0,0,0,0,0,0,0,0,2021-2022,0.0,0.0
479,Timothy Castagne,BEL,DF,Leicester City,Premier League,25,1995,23.6,67,31,38,22,7,27,43,62.8,16,28,9,19,29,96,54,1,0,2021-2022,1.2288135593220337,2.8389830508474576
480,Koen Casteels,BEL,GK,Wolfsburg,Bundesliga,29,1992,28.0,0,0,0,0,0,0,1,0.0,1,0,0,0,0,0,9,2,0,2021-2022,0.0,0.0
481,Jean-Charles Castelletto,CMR,DF,Nantes,Ligue 1,26,1995,27.9,45,24,27,17,1,25,35,71.4,10,38,27,11,30,75,73,0,0,2021-2022,1.0752688172043012,1.6129032258064517
482,Samu Castillejo,ESP,"FW,MF",Milan,Serie A,26,1995,1.4,4,2,0,2,2,1,8,12.5,7,4,1,3,2,6,1,0,0,2021-2022,1.4285714285714286,2.857142857142857
483,Gonzalo Castro,GER,"MF,FW",Arminia,Bundesliga,34,1987,4.8,8,3,4,4,0,1,5,20.0,4,3,0,3,3,11,3,0,0,2021-2022,0.625,1.6666666666666667
484,Jonny Castro,ESP,DF,Wolves,Premier League,27,1994,11.4,25,15,13,11,1,11,20,55.0,9,14,3,11,13,38,11,0,0,2021-2022,1.1403508771929824,2.1929824561403506
485,Gaetano Castrovilli,ITA,MF,Fiorentina,Serie A,24,1997,15.5,25,17,15,6,4,12,23,52.2,11,18,4,14,11,36,6,0,0,2021-2022,0.7096774193548387,1.6129032258064515
486,Danilo Cataldi,ITA,MF,Lazio,Serie A,26,1994,19.0,36,17,15,17,4,12,38,31.6,26,24,12,12,17,53,19,1,0,2021-2022,0.8947368421052632,1.894736842105263
487,Catena,ESP,DF,Rayo Vallecano,La Liga,26,1994,36.0,39,23,24,15,0,25,42,59.5,17,26,19,7,30,69,168,3,0,2021-2022,0.8333333333333334,1.0833333333333333
488,Craig Cathcart,NIR,DF,Watford,Premier League,32,1989,26.6,32,15,25,6,1,16,30,53.3,14,39,29,10,28,60,132,3,0,2021-2022,1.0526315789473684,1.2030075187969924
489,Edinson Cavani,URU,FW,Manchester Utd,Premier League,34,1987,8.5,4,1,0,3,1,2,8,25.0,6,6,0,6,2,6,8,0,0,2021-2022,0.23529411764705882,0.47058823529411764
490,Dani Ceballos,ESP,MF,Real Madrid,La Liga,24,1996,3.1,7,5,4,3,0,1,5,20.0,4,8,2,6,4,11,2,0,0,2021-2022,1.2903225806451613,2.258064516129032
491,Pietro Ceccaroni,ITA,DF,Venezia,Serie A,25,1995,34.7,55,31,33,18,4,25,36,69.4,11,45,32,13,30,85,143,0,0,2021-2022,0.8645533141210374,1.5850144092219018
492,Federico Ceccherini,ITA,DF,Hellas Verona,Serie A,29,1992,26.2,32,16,19,10,3,19,33,57.6,14,13,8,5,50,82,76,1,0,2021-2022,1.9083969465648856,1.2213740458015268
493,Emil Ceide,NOR,"FW,MF",Sassuolo,Serie A,19,2001,0.6,1,1,0,1,0,1,2,50.0,1,1,0,1,0,1,0,0,0,2021-2022,0.0,1.6666666666666667
494,Zeki Çelik,TUR,DF,Lille,Ligue 1,24,1997,30.0,64,37,43,17,4,36,63,57.1,27,32,9,23,43,107,62,2,0,2021-2022,1.4333333333333333,2.1333333333333333
495,Fabien Centonze,FRA,DF,Metz,Ligue 1,25,1996,17.6,33,21,22,9,2,13,32,40.6,19,37,8,29,32,65,51,0,0,2021-2022,1.8181818181818181,1.8749999999999998
496,Luca Ceppitelli,ITA,DF,Cagliari,Serie A,31,1989,16.1,23,12,13,10,0,16,27,59.3,11,21,14,7,25,48,54,0,0,2021-2022,1.5527950310559004,1.4285714285714284
497,Franco Cervi,ARG,MF,Celta Vigo,La Liga,27,1994,20.0,73,41,35,22,16,33,77,42.9,44,38,2,36,21,94,19,0,0,2021-2022,1.05,3.65
498,Damir Ceter,COL,FW,Cagliari,Serie A,23,1997,0.1,0,0,0,0,0,0,0,0.0,0,0,0,0,0,0,0,0,0,2021-2022,0.0,0.0
499,Julian Chabot,GER,DF,Sampdoria,Serie A,23,1998,5.4,12,10,8,4,0,8,10,80.0,2,7,4,3,9,21,28,1,0,2021-2022,1.6666666666666665,2.222222222222222
500,Julian Chabot,GER,DF,Köln,Bundesliga,23,1998,2.3,8,3,4,4,0,2,5,40.0,3,4,2,2,3,11,5,1,0,2021-2022,1.3043478260869565,3.4782608695652177
Rk,Player,Nation,Pos,Squad,Comp,0,0,90.0,0,0,3,3,3,Tkl,0,0.0,0,0,0,0,0,0,0,0,0,2021-2022,0.0,0.0
501,El Chadaille Bitshiabu,FRA,DF,Paris S-G,Ligue 1,16,2005,0.1,0,0,0,0,0,0,0,0.0,0,0,0,0,0,0,2,0,0,2021-2022,0.0,0.0
502,Nassim Chadli,FRA,"MF,DF",Troyes,Ligue 1,20,2001,1.1,5,3,3,0,2,2,4,50.0,2,1,0,1,0,5,0,0,0,2021-2022,0.0,4.545454545454545
503,Kayky Chagas,BRA,FW,Manchester City,Premier League,18,2003,0.1,0,0,0,0,0,0,0,0.0,0,0,0,0,0,0,0,0,0,2021-2022,0.0,0.0
504,Mehdi Chahiri,MAR,DF,Strasbourg,Ligue 1,25,1996,0.2,1,1,1,0,0,1,1,100.0,0,0,0,0,0,1,0,0,0,2021-2022,0.0,5.0
505,Trevoh Chalobah,ENG,DF,Chelsea,Premier League,22,1999,16.1,40,27,22,18,0,24,31,77.4,7,16,6,10,19,59,43,2,0,2021-2022,1.1801242236024843,2.484472049689441
506,Calum Chambers,ENG,DF,Arsenal,Premier League,26,1995,1.9,5,3,3,1,1,3,4,75.0,1,6,3,3,0,5,10,0,0,2021-2022,0.0,2.6315789473684212
507,Calum Chambers,ENG,DF,Aston Villa,Premier League,26,1995,9.2,16,8,10,6,0,4,6,66.7,2,14,8,6,5,21,42,0,0,2021-2022,0.5434782608695653,1.7391304347826089
508,Dylan Chambost,FRA,"MF,FW",Troyes,Ligue 1,23,1997,8.4,16,11,6,9,1,4,25,16.0,21,9,2,7,8,24,4,0,0,2021-2022,0.9523809523809523,1.9047619047619047
509,Timothy Chandler,USA,DF,Eint Frankfurt,Bundesliga,31,1990,13.5,18,12,10,8,0,11,24,45.8,13,10,3,7,19,37,28,1,0,2021-2022,1.4074074074074074,1.3333333333333333
510,Chapela,ESP,"MF,FW",Cádiz,La Liga,22,1999,4.4,4,2,1,0,3,2,4,50.0,2,6,1,5,4,8,5,0,0,2021-2022,0.9090909090909091,0.9090909090909091
511,Brendan Chardonnet,FRA,DF,Brest,Ligue 1,26,1994,29.8,44,25,32,11,1,29,40,72.5,11,42,29,13,55,99,141,0,0,2021-2022,1.8456375838926173,1.4765100671140938
512,Xavier Chavalerin,FRA,MF,Troyes,Ligue 1,30,1991,30.2,49,26,19,25,5,12,55,21.8,43,32,5,27,39,88,36,0,0,2021-2022,1.2913907284768211,1.6225165562913908
513,Xavier Chavalerin,FRA,MF,Reims,Ligue 1,30,1991,2.4,4,4,2,1,1,1,3,33.3,2,2,0,2,5,9,2,1,0,2021-2022,2.0833333333333335,1.6666666666666667
514,Justin Che,USA,"FW,DF",Hoffenheim,Bundesliga,17,2003,0.5,2,0,1,0,1,1,2,50.0,1,0,0,0,1,3,0,0,0,2021-2022,2.0,4.0
515,Chema,ESP,MF,Getafe,La Liga,29,1992,0.5,0,0,0,0,0,0,1,0.0,1,0,0,0,0,0,0,0,0,2021-2022,0.0,0.0
516,Rayan Cherki,FRA,"FW,MF",Lyon,Ligue 1,17,2003,4.9,6,2,1,3,2,4,9,44.4,5,2,0,2,1,7,0,0,0,2021-2022,0.2040816326530612,1.2244897959183672
517,Denis Cheryshev,RUS,"MF,FW",Valencia,La Liga,30,1990,6.3,14,5,6,1,7,6,15,40.0,9,9,1,8,9,23,9,0,0,2021-2022,1.4285714285714286,2.2222222222222223
518,Daniel Chesters,ENG,MF,West Ham,Premier League,19,2002,0.0,0,0,0,0,0,0,0,0.0,0,0,0,0,0,0,0,0,0,2021-2022,,
519,Giorgio Chiellini,ITA,DF,Juventus,Serie A,36,1984,15.0,22,13,17,4,1,7,13,53.8,6,24,18,6,22,44,59,0,0,2021-2022,1.4666666666666666,1.4666666666666666
520,Federico Chiesa,ITA,"MF,FW",Juventus,Serie A,23,1997,9.6,26,19,9,9,8,12,26,46.2,14,7,0,7,4,30,3,0,0,2021-2022,0.4166666666666667,2.7083333333333335
521,Ben Chilwell,ENG,DF,Chelsea,Premier League,24,1996,6.0,8,3,2,6,0,2,5,40.0,3,7,0,7,4,12,14,1,0,2021-2022,0.6666666666666666,1.3333333333333333
522,Chiquinho,POR,"DF,FW",Wolves,Premier League,21,2000,2.3,9,6,4,5,0,4,5,80.0,1,5,0,5,2,11,1,0,0,2021-2022,0.8695652173913044,3.91304347826087
523,Vlad Chiricheș,ROU,DF,Sassuolo,Serie A,31,1989,25.6,28,15,19,9,0,10,21,47.6,11,34,21,13,41,69,71,4,0,2021-2022,1.6015625,1.09375
524,Pedro Chirivella,ESP,MF,Nantes,Ligue 1,24,1997,29.3,49,31,14,26,9,25,70,35.7,45,23,2,21,37,86,11,0,0,2021-2022,1.2627986348122866,1.6723549488054608
525,Joris Chotard,FRA,MF,Montpellier,Ligue 1,19,2001,32.6,59,30,33,23,3,36,78,46.2,42,27,15,12,42,101,56,0,0,2021-2022,1.2883435582822085,1.8098159509202454
Rk,Player,Nation,Pos,Squad,Comp,0,0,90.0,0,0,3,3,3,Tkl,0,0.0,0,0,0,0,0,0,0,0,0,2021-2022,0.0,0.0
526,Hamza Choudhury,ENG,"DF,MF",Leicester City,Premier League,23,1997,3.2,9,3,4,4,1,3,5,60.0,2,0,0,0,12,21,10,0,0,2021-2022,3.75,2.8125
527,Andreas Christensen,DEN,DF,Chelsea,Premier League,25,1996,16.6,14,8,9,4,1,4,7,57.1,3,14,6,8,29,43,57,1,0,2021-2022,1.7469879518072287,0.8433734939759036
528,Max Christiansen,GER,MF,Greuther Fürth,Bundesliga,24,1996,22.8,46,25,19,22,5,18,43,41.9,25,52,16,36,68,114,56,0,0,2021-2022,2.982456140350877,2.017543859649123
529,Carney Chukwuemeka,ENG,"MF,FW",Aston Villa,Premier League,17,2003,3.3,7,1,2,5,0,3,5,60.0,2,3,0,3,1,8,2,1,0,2021-2022,0.30303030303030304,2.121212121212121
530,Samuel Chukwueze,NGA,"MF,FW",Villarreal,La Liga,22,1999,14.8,13,9,6,5,2,3,6,50.0,3,7,0,7,5,18,4,0,0,2021-2022,0.33783783783783783,0.8783783783783783
531,Víctor Chust,ESP,DF,Cádiz,La Liga,21,2000,20.3,19,10,14,4,1,11,17,64.7,6,20,8,12,16,35,87,0,0,2021-2022,0.7881773399014778,0.9359605911330049
532,Riccardo Ciervo,ITA,"MF,DF",Sampdoria,Serie A,19,2002,2.5,8,3,4,3,1,2,6,33.3,4,1,0,1,2,10,2,0,0,2021-2022,0.8,3.2
533,Jasper Cillessen,NED,GK,Valencia,La Liga,32,1989,16.2,0,0,0,0,0,0,1,0.0,1,0,0,0,1,1,6,0,0,2021-2022,0.0617283950617284,0.0
534,Pathé Ciss,SEN,MF,Rayo Vallecano,La Liga,27,1994,12.2,31,15,20,8,3,12,26,46.2,14,16,6,10,30,61,27,0,0,2021-2022,2.459016393442623,2.540983606557377
535,Moustapha Cissé,GUI,FW,Atalanta,Serie A,17,2003,0.4,1,0,0,1,0,0,3,0.0,3,0,0,0,0,1,0,0,0,2021-2022,0.0,2.5
536,Giorgio Cittadini,ITA,DF,Atalanta,Serie A,19,2002,0.0,0,0,0,0,0,0,0,0.0,0,0,0,0,1,1,0,0,0,2021-2022,inf,
537,Ciaran Clark,IRL,DF,Newcastle Utd,Premier League,31,1989,11.3,13,10,4,7,2,9,14,64.3,5,14,11,3,13,26,43,1,0,2021-2022,1.1504424778761062,1.1504424778761062
538,Alexis Claude-Maurice,FRA,MF,Nice,Ligue 1,23,1998,2.3,2,0,1,0,1,1,4,25.0,3,7,0,7,3,5,1,0,0,2021-2022,1.3043478260869565,0.8695652173913044
539,Jonathan Clauss,FRA,DF,Lens,Ligue 1,28,1992,33.8,63,34,33,20,10,22,55,40.0,33,43,1,42,73,136,51,0,0,2021-2022,2.1597633136094676,1.8639053254437872
540,Carlos Clerc,ESP,DF,Levante,La Liga,29,1992,16.8,35,17,21,10,4,7,19,36.8,12,8,3,5,26,61,32,1,0,2021-2022,1.5476190476190474,2.083333333333333
541,Tom Cleverley,ENG,MF,Watford,Premier League,31,1989,18.0,37,20,19,17,1,18,33,54.5,15,23,6,17,18,55,19,3,0,2021-2022,1.0,2.0555555555555554
542,Nathaniel Clyne,ENG,DF,Crystal Palace,Premier League,30,1991,15.0,21,10,11,9,1,10,20,50.0,10,7,2,5,15,36,32,0,0,2021-2022,1.0,1.4
543,Conor Coady,ENG,DF,Wolves,Premier League,28,1993,37.3,31,14,23,7,1,16,28,57.1,12,46,40,6,28,59,140,0,0,2021-2022,0.7506702412868633,0.8310991957104559
544,Marcus Coco,FRA,"MF,FW",Nantes,Ligue 1,25,1996,10.3,34,14,17,11,6,8,18,44.4,10,11,1,10,10,44,15,0,0,2021-2022,0.9708737864077669,3.3009708737864076
545,Coke,ESP,DF,Levante,La Liga,34,1987,1.3,3,2,1,1,1,3,4,75.0,1,1,0,1,2,5,7,0,0,2021-2022,1.5384615384615383,2.3076923076923075
546,Séamus Coleman,IRL,DF,Everton,Premier League,32,1988,29.5,61,36,35,16,10,33,51,64.7,18,30,11,19,32,93,80,2,0,2021-2022,1.0847457627118644,2.0677966101694913
547,Álex Collado,ESP,"MF,FW",Granada,La Liga,22,1999,11.3,27,12,6,16,5,12,31,38.7,19,28,2,26,6,33,11,0,0,2021-2022,0.5309734513274336,2.389380530973451
548,Ebrima Colley,GAM,"FW,MF",Spezia,Serie A,21,2000,4.4,6,1,3,2,1,1,7,14.3,6,8,0,8,3,9,2,0,0,2021-2022,0.6818181818181818,1.3636363636363635
549,Omar Colley,GAM,DF,Sampdoria,Serie A,28,1992,30.5,47,36,32,14,1,22,32,68.8,10,31,19,12,80,127,135,2,0,2021-2022,2.622950819672131,1.540983606557377
550,Nathan Collins,IRL,DF,Burnley,Premier League,20,2001,18.6,37,15,27,8,2,17,27,63.0,10,38,25,13,24,61,83,2,0,2021-2022,1.2903225806451613,1.9892473118279568
Rk,Player,Nation,Pos,Squad,Comp,0,0,90.0,0,0,3,3,3,Tkl,0,0.0,0,0,0,0,0,0,0,0,0,2021-2022,0.0,0.0
551,Kingsley Coman,FRA,"FW,DF",Bayern Munich,Bundesliga,25,1996,15.1,14,8,1,9,4,5,16,31.3,11,14,0,14,8,22,5,0,0,2021-2022,0.5298013245033113,0.9271523178807948
552,Eray Cömert,SUI,DF,Valencia,La Liga,23,1998,4.5,5,3,4,1,0,3,6,50.0,3,3,2,1,2,7,6,0,0,2021-2022,0.4444444444444444,1.1111111111111112
553,Santi Comesaña,ESP,MF,Rayo Vallecano,La Liga,24,1996,29.8,87,56,45,33,9,40,104,38.5,64,46,6,40,33,120,30,0,0,2021-2022,1.1073825503355705,2.9194630872483223
554,Diego Conde,ESP,GK,Getafe,La Liga,22,1998,0.1,0,0,0,0,0,0,0,0.0,0,0,0,0,0,0,0,0,0,2021-2022,0.0,0.0
555,Aaron Connolly,IRL,"FW,MF",Brighton,Premier League,21,2000,1.7,0,0,0,0,0,0,1,0.0,1,2,0,2,0,0,0,0,0,2021-2022,0.0,0.0
556,Andrea Consigli,ITA,GK,Sassuolo,Serie A,34,1987,36.9,0,0,0,0,0,0,2,0.0,2,0,0,0,0,0,23,3,0,2021-2022,0.0,0.0
557,Abdu Conté,POR,DF,Troyes,Ligue 1,23,1998,15.0,22,12,16,5,1,12,24,50.0,12,12,2,10,4,26,10,0,0,2021-2022,0.26666666666666666,1.4666666666666666
558,Andrea Conti,ITA,"DF,MF",Sampdoria,Serie A,27,1994,2.6,4,2,2,1,1,3,6,50.0,3,4,0,4,7,11,4,0,0,2021-2022,2.692307692307692,1.5384615384615383
559,Andrea Conti,ITA,DF,Milan,Serie A,27,1994,0.1,0,0,0,0,0,0,0,0.0,0,0,0,0,0,0,0,0,0,2021-2022,0.0,0.0
560,Liam Cooper,SCO,DF,Leeds United,Premier League,29,1991,20.2,41,23,27,13,1,23,33,69.7,10,29,18,11,43,84,72,2,0,2021-2022,2.128712871287129,2.0297029702970297
561,Lucas Copado,GER,FW,Bayern Munich,Bundesliga,17,2004,0.2,1,0,1,0,0,1,1,100.0,0,0,0,0,0,1,0,0,0,2021-2022,0.0,5.0
562,Diego Coppola,ITA,DF,Hellas Verona,Serie A,17,2003,2.8,8,4,4,4,0,3,3,100.0,0,5,1,4,4,12,5,0,0,2021-2022,1.4285714285714286,2.857142857142857
563,Francis Coquelin,FRA,MF,Villarreal,La Liga,30,1991,9.2,26,17,9,11,6,11,20,55.0,9,15,5,10,19,45,11,0,0,2021-2022,2.065217391304348,2.8260869565217392
564,Sébastien Corchia,FRA,DF,Nantes,Ligue 1,30,1990,14.7,33,20,17,11,5,24,42,57.1,18,24,3,21,13,46,36,0,0,2021-2022,0.8843537414965987,2.2448979591836737
565,Sergio Córdova,VEN,"FW,MF",Augsburg,Bundesliga,23,1997,3.6,4,3,2,2,0,1,2,50.0,1,4,0,4,0,4,4,0,0,2021-2022,0.0,1.1111111111111112
566,Jack Cork,ENG,MF,Burnley,Premier League,32,1989,18.6,20,6,6,11,3,7,20,35.0,13,17,4,13,17,37,29,1,0,2021-2022,0.9139784946236559,1.075268817204301
567,Maxwel Cornet,CIV,"FW,MF",Burnley,Premier League,24,1996,19.6,16,9,7,5,4,7,15,46.7,8,13,4,9,10,26,14,0,0,2021-2022,0.5102040816326531,0.8163265306122448
568,Maxwel Cornet,CIV,DF,Lyon,Ligue 1,24,1996,0.7,3,1,1,0,2,3,4,75.0,1,0,0,0,1,4,1,0,0,2021-2022,1.4285714285714286,4.285714285714286
569,Jesús Corona,MEX,"FW,DF",Sevilla,La Liga,28,1993,12.9,12,7,7,5,0,3,6,50.0,3,4,0,4,8,20,6,0,0,2021-2022,0.6201550387596899,0.9302325581395349
570,Ángel Correa,ARG,"FW,MF",Atlético Madrid,La Liga,26,1995,20.6,16,8,5,10,1,7,29,24.1,22,25,2,23,10,26,4,0,0,2021-2022,0.48543689320388345,0.7766990291262136
571,Joaquín Correa,ARG,FW,Inter,Serie A,26,1994,11.4,11,5,2,6,3,1,13,7.7,12,8,1,7,3,14,2,0,0,2021-2022,0.2631578947368421,0.9649122807017544
572,Thierry Correia,POR,DF,Valencia,La Liga,22,1999,15.7,35,23,26,6,3,14,29,48.3,15,20,5,15,19,54,27,0,0,2021-2022,1.2101910828025477,2.229299363057325
573,Danny da Costa,GER,"DF,MF",Eint Frankfurt,Bundesliga,28,1993,8.1,15,4,6,7,2,6,18,33.3,12,14,1,13,11,26,18,1,0,2021-2022,1.3580246913580247,1.8518518518518519
574,David Pereira da Costa,POR,"MF,FW",Lens,Ligue 1,20,2001,16.3,22,12,9,6,7,11,26,42.3,15,12,0,12,13,35,5,0,0,2021-2022,0.7975460122699386,1.3496932515337423
575,Hélder Costa,ANG,MF,Leeds United,Premier League,27,1994,0.2,0,0,0,0,0,0,0,0.0,0,1,0,1,0,0,0,0,0,2021-2022,0.0,0.0
Rk,Player,Nation,Pos,Squad,Comp,0,0,90.0,0,0,3,3,3,Tkl,0,0.0,0,0,0,0,0,0,0,0,0,2021-2022,0.0,0.0
576,Hélder Costa,ANG,"MF,FW",Valencia,La Liga,27,1994,12.4,27,16,11,9,7,14,41,34.1,27,12,1,11,3,30,9,0,0,2021-2022,0.24193548387096772,2.1774193548387095
577,Jaume Costa,ESP,DF,Mallorca,La Liga,33,1988,20.3,35,26,23,7,5,23,31,74.2,8,22,7,15,23,58,55,0,0,2021-2022,1.1330049261083743,1.7241379310344827
578,Benoît Costil,FRA,GK,Bordeaux,Ligue 1,34,1987,25.0,1,0,1,0,0,1,2,50.0,1,0,0,0,0,1,6,3,0,2021-2022,0.0,0.04
579,Vladimír Coufal,CZE,DF,West Ham,Premier League,28,1992,24.5,45,25,24,14,7,18,36,50.0,18,31,9,22,22,67,64,1,0,2021-2022,0.8979591836734694,1.836734693877551
580,Kalifa Coulibaly,MLI,FW,Nantes,Ligue 1,29,1991,9.4,5,1,1,1,3,0,4,0.0,4,2,2,0,0,5,11,0,0,2021-2022,0.0,0.5319148936170213
581,Lassana Coulibaly,MLI,MF,Salernitana,Serie A,25,1996,25.9,58,32,29,26,3,24,62,38.7,38,40,13,27,22,80,27,0,0,2021-2022,0.8494208494208495,2.2393822393822393
582,Mamadou Coulibaly,SEN,MF,Salernitana,Serie A,22,1999,9.0,15,12,8,5,2,7,20,35.0,13,9,0,9,11,26,9,0,0,2021-2022,1.2222222222222223,1.6666666666666667
583,Tanguy Coulibaly,FRA,"FW,MF",Stuttgart,Bundesliga,20,2001,12.0,27,15,14,11,2,9,19,47.4,10,14,2,12,4,31,10,0,0,2021-2022,0.3333333333333333,2.25
584,Thibaut Courtois,BEL,GK,Real Madrid,La Liga,29,1992,36.0,1,0,1,0,0,1,2,50.0,1,0,0,0,0,1,9,1,0,2021-2022,0.0,0.027777777777777776
585,Philippe Coutinho,BRA,"MF,FW",Aston Villa,Premier League,29,1992,14.8,17,12,4,11,2,6,21,28.6,15,11,1,10,7,24,4,0,0,2021-2022,0.47297297297297297,1.1486486486486487
586,Philippe Coutinho,BRA,"MF,FW",Barcelona,La Liga,29,1992,5.6,6,3,3,3,0,3,11,27.3,8,3,0,3,4,10,3,0,0,2021-2022,0.7142857142857143,1.0714285714285714
587,Nicolas Cozza,FRA,DF,Montpellier,Ligue 1,22,1999,30.8,80,47,50,23,7,35,65,53.8,30,35,19,16,38,118,82,1,0,2021-2022,1.2337662337662338,2.5974025974025974
588,Alessio Cragno,ITA,GK,Cagliari,Serie A,27,1994,35.0,3,3,2,1,0,3,3,100.0,0,0,0,0,1,4,14,1,0,2021-2022,0.02857142857142857,0.08571428571428572
589,Aaron Cresswell,ENG,DF,West Ham,Premier League,31,1989,30.3,28,18,18,6,4,13,25,52.0,12,31,18,13,35,63,66,0,0,2021-2022,1.155115511551155,0.9240924092409241
590,Charlie Cresswell,ENG,DF,Leeds United,Premier League,18,2002,1.6,5,2,1,4,0,3,3,100.0,0,1,1,0,2,7,6,0,0,2021-2022,1.25,3.125
591,Domenico Criscito,ITA,DF,Genoa,Serie A,34,1986,18.0,37,21,19,14,4,16,25,64.0,9,22,12,10,39,76,57,0,0,2021-2022,2.1666666666666665,2.0555555555555554
592,Bryan Cristante,ITA,MF,Roma,Serie A,26,1995,29.8,79,39,31,39,9,37,69,53.6,32,31,5,26,40,119,45,0,0,2021-2022,1.342281879194631,2.651006711409396
593,Cristo,ESP,DF,Real Sociedad,La Liga,21,2000,0.2,0,0,0,0,0,0,0,0.0,0,0,0,0,0,0,0,0,0,2021-2022,0.0,0.0
594,Enzo Crivelli,FRA,"FW,MF",Saint-Étienne,Ligue 1,26,1995,1.1,1,0,0,0,1,0,0,0.0,0,0,0,0,0,1,1,0,0,2021-2022,0.0,0.9090909090909091
595,Domen Črnigoj,SVN,MF,Venezia,Serie A,25,1995,20.9,21,13,7,11,3,11,29,37.9,18,27,8,19,24,45,42,0,0,2021-2022,1.1483253588516746,1.0047846889952154
596,Giovanni Crociata,ITA,FW,Empoli,Serie A,23,1997,0.2,0,0,0,0,0,0,1,0.0,1,0,0,0,0,0,0,0,0,2021-2022,0.0,0.0
597,Juan Cruz Armada,ESP,DF,Osasuna,La Liga,29,1992,21.5,28,21,15,12,1,8,16,50.0,8,15,12,3,16,44,58,1,0,2021-2022,0.7441860465116279,1.302325581395349
598,Juan Cuadrado,COL,"DF,MF",Juventus,Serie A,33,1988,27.6,48,23,30,13,5,30,55,54.5,25,23,5,18,29,77,34,0,0,2021-2022,1.0507246376811594,1.7391304347826086
599,Cucho,COL,"FW,MF",Watford,Premier League,22,1999,12.7,13,5,5,5,3,5,27,18.5,22,13,1,12,5,18,9,0,0,2021-2022,0.3937007874015748,1.0236220472440944
600,Marc Cucurella,ESP,DF,Brighton,Premier League,23,1998,34.3,93,62,43,32,18,44,71,62.0,27,42,14,28,30,123,74,0,0,2021-2022,0.8746355685131196,2.7113702623906706
Rk,Player,Nation,Pos,Squad,Comp,0,0,90.0,0,0,3,3,3,Tkl,0,0.0,0,0,0,0,0,0,0,0,0,2021-2022,0.0,0.0
601,Marc Cucurella,ESP,"MF,DF",Getafe,La Liga,23,1998,0.3,0,0,0,0,0,0,0,0.0,0,0,0,0,0,0,0,0,0,2021-2022,0.0,0.0
602,Jorge Cuenca,ESP,DF,Getafe,La Liga,21,1999,29.8,46,32,30,15,1,21,28,75.0,7,29,14,15,39,85,155,0,0,2021-2022,1.308724832214765,1.5436241610738255
603,Mickaël Cuisance,FRA,MF,Venezia,Serie A,21,1999,10.2,23,9,7,12,4,10,28,35.7,18,14,0,14,12,35,5,0,0,2021-2022,1.1764705882352942,2.2549019607843137
604,Mickaël Cuisance,FRA,MF,Bayern Munich,Bundesliga,21,1999,0.1,1,1,0,1,0,0,0,0.0,0,0,0,0,0,1,0,0,0,2021-2022,0.0,10.0
605,Luke Cundle,ENG,MF,Wolves,Premier League,19,2002,2.0,4,3,0,4,0,1,1,100.0,0,0,0,0,1,5,1,0,0,2021-2022,0.5,2.0
606,Matheus Cunha,BRA,FW,Atlético Madrid,La Liga,22,1999,11.8,19,12,3,11,5,5,20,25.0,15,18,2,16,6,25,9,0,0,2021-2022,0.5084745762711864,1.6101694915254237
607,Matheus Cunha,BRA,FW,Hertha BSC,Bundesliga,22,1999,0.7,0,0,0,0,0,0,0,0.0,0,0,0,0,0,0,0,0,0,2021-2022,0.0,0.0
608,Patrick Cutrone,ITA,FW,Empoli,Serie A,23,1998,15.6,5,2,0,3,2,1,9,11.1,8,11,1,10,5,10,1,0,0,2021-2022,0.32051282051282054,0.32051282051282054
609,Wylan Cyprien,FRA,MF,Nantes,Ligue 1,26,1995,16.6,33,17,12,18,3,13,32,40.6,19,16,6,10,10,43,14,2,0,2021-2022,0.6024096385542168,1.9879518072289155
610,Rafael Czichos,GER,DF,Köln,Bundesliga,31,1990,15.6,29,18,18,9,2,14,28,50.0,14,23,13,10,19,48,53,2,0,2021-2022,1.217948717948718,1.858974358974359
611,Lennart-Marten Czyborra,GER,DF,Arminia,Bundesliga,22,1999,1.5,0,0,0,0,0,0,2,0.0,2,0,0,0,3,3,3,1,0,2021-2022,2.0,0.0
612,Danilo D'Ambrosio,ITA,DF,Inter,Serie A,32,1988,11.1,30,15,21,8,1,11,22,50.0,11,21,10,11,8,38,20,0,0,2021-2022,0.7207207207207208,2.7027027027027026
613,Lucas Da Cunha,FRA,MF,Nice,Ligue 1,20,2001,4.4,13,7,2,7,4,6,11,54.5,5,2,0,2,1,14,2,0,0,2021-2022,0.22727272727272727,2.954545454545454
614,Lucas Da Cunha,FRA,"FW,MF",Clermont Foot,Ligue 1,20,2001,9.3,17,11,5,8,4,9,18,50.0,9,13,0,13,1,18,3,0,0,2021-2022,0.1075268817204301,1.8279569892473118
615,Damien Da Silva,FRA,DF,Lyon,Ligue 1,33,1988,12.5,13,9,7,5,1,5,9,55.6,4,15,10,5,22,35,53,1,0,2021-2022,1.76,1.04
616,Moanes Dabbur,ISR,"FW,MF",Hoffenheim,Bundesliga,29,1992,14.6,18,10,3,5,10,4,17,23.5,13,10,0,10,5,23,4,0,0,2021-2022,0.3424657534246575,1.2328767123287672
617,Colin Dagba,FRA,DF,Paris S-G,Ligue 1,22,1998,1.8,4,2,2,2,0,3,6,50.0,3,4,2,2,2,6,1,0,0,2021-2022,1.1111111111111112,2.2222222222222223
618,Finn Dahmen,GER,GK,Mainz 05,Bundesliga,23,1998,2.0,0,0,0,0,0,0,0,0.0,0,0,0,0,0,0,2,0,0,2021-2022,0.0,0.0
619,Mahmoud Dahoud,GER,MF,Dortmund,Bundesliga,25,1996,18.4,42,19,10,24,8,20,46,43.5,26,18,3,15,17,59,16,0,0,2021-2022,0.923913043478261,2.2826086956521743
620,Patson Daka,ZAM,FW,Leicester City,Premier League,22,1998,12.9,15,10,2,8,5,2,19,10.5,17,7,0,7,2,17,8,0,0,2021-2022,0.15503875968992248,1.1627906976744187
621,Stuart Dallas,NIR,"DF,MF",Leeds United,Premier League,30,1991,32.4,93,55,58,31,4,56,105,53.3,49,45,14,31,57,150,63,2,0,2021-2022,1.7592592592592593,2.8703703703703707
622,Diogo Dalot,POR,DF,Manchester Utd,Premier League,22,1999,20.0,55,41,35,12,8,31,57,54.4,26,24,13,11,29,84,59,0,0,2021-2022,1.45,2.75
623,Mikkel Damsgaard,DEN,"MF,FW",Sampdoria,Serie A,21,2000,6.4,27,13,12,11,4,20,36,55.6,16,16,1,15,7,34,7,0,0,2021-2022,1.09375,4.21875
624,Flavius Daniliuc,AUT,DF,Nice,Ligue 1,20,2001,14.4,46,31,26,17,3,34,43,79.1,9,13,7,6,14,60,34,1,0,2021-2022,0.9722222222222222,3.194444444444444
625,Danilo,BRA,"DF,MF",Juventus,Serie A,30,1991,21.0,37,26,20,13,4,18,28,64.3,10,21,12,9,32,69,53,1,0,2021-2022,1.5238095238095237,1.7619047619047619
Rk,Player,Nation,Pos,Squad,Comp,0,0,90.0,0,0,3,3,3,Tkl,0,0.0,0,0,0,0,0,0,0,0,0,2021-2022,0.0,0.0
626,Arnaut Danjuma,NED,FW,Villarreal,La Liga,24,1997,16.4,7,6,3,0,4,2,4,50.0,2,5,0,5,2,9,3,0,0,2021-2022,0.12195121951219513,0.426829268292683
627,Kevin Danso,AUT,DF,Lens,Ligue 1,22,1998,31.0,41,29,29,12,0,23,34,67.6,11,38,25,13,40,81,111,0,0,2021-2022,1.2903225806451613,1.3225806451612903
628,Dante,BRA,DF,Nice,Ligue 1,37,1983,31.9,42,29,30,12,0,23,33,69.7,10,43,27,16,49,91,96,1,0,2021-2022,1.536050156739812,1.316614420062696
629,Ebrima Darboe,GAM,MF,Roma,Serie A,20,2001,0.7,1,1,0,1,0,0,0,0.0,0,0,0,0,1,2,0,1,0,2021-2022,1.4285714285714286,1.4285714285714286
630,Márton Dárdai,HUN,DF,Hertha BSC,Bundesliga,19,2002,8.4,10,4,8,2,0,8,18,44.4,10,16,6,10,20,30,33,2,0,2021-2022,2.380952380952381,1.1904761904761905
631,Sergi Darder,ESP,MF,Espanyol,La Liga,27,1993,34.7,45,22,16,19,10,18,54,33.3,36,16,1,15,26,71,32,1,0,2021-2022,0.7492795389048991,1.296829971181556
632,Vladimír Darida,CZE,MF,Hertha BSC,Bundesliga,30,1990,19.8,32,18,15,13,4,13,32,40.6,19,22,3,19,20,52,17,2,0,2021-2022,1.0101010101010102,1.6161616161616161
633,Karl Darlow,ENG,GK,Newcastle Utd,Premier League,30,1990,8.0,0,0,0,0,0,0,0,0.0,0,0,0,0,0,0,5,1,0,2021-2022,0.0,0.0
634,Matteo Darmian,ITA,DF,Inter,Serie A,31,1989,16.7,32,16,17,9,6,16,41,39.0,25,16,1,15,19,51,25,0,0,2021-2022,1.1377245508982037,1.9161676646706587
635,Josh Dasilva,ENG,"MF,FW",Brentford,Premier League,22,1998,2.9,2,1,0,1,1,1,2,50.0,1,3,0,3,1,3,7,0,0,2021-2022,0.3448275862068966,0.6896551724137931
636,Jonathan David,CAN,FW,Lille,Ligue 1,21,2000,31.2,24,9,7,11,6,9,30,30.0,21,14,4,10,5,29,15,0,0,2021-2022,0.16025641025641027,0.7692307692307693
637,Alphonso Davies,CAN,DF,Bayern Munich,Bundesliga,20,2000,19.3,34,17,17,8,9,13,31,41.9,18,27,1,26,23,57,26,1,0,2021-2022,1.1917098445595855,1.761658031088083
638,Ben Davies,WAL,DF,Tottenham,Premier League,28,1993,28.2,36,21,20,12,4,13,26,50.0,13,32,19,13,30,66,75,1,0,2021-2022,1.0638297872340425,1.2765957446808511
639,Tom Davies,ENG,MF,Everton,Premier League,23,1998,2.6,3,1,1,1,1,2,5,40.0,3,2,1,1,2,5,9,0,0,2021-2022,0.7692307692307692,1.1538461538461537
640,Keinan Davis,ENG,FW,Aston Villa,Premier League,23,1998,0.1,0,0,0,0,0,0,0,0.0,0,0,0,0,0,0,0,0,0,2021-2022,0.0,0.0
641,Paweł Dawidowicz,POL,DF,Hellas Verona,Serie A,26,1995,13.3,30,18,16,10,4,16,25,64.0,9,14,11,3,21,51,53,0,0,2021-2022,1.5789473684210527,2.255639097744361
642,Craig Dawson,ENG,DF,West Ham,Premier League,31,1990,30.6,29,17,20,8,1,14,25,56.0,11,59,52,7,29,58,139,0,0,2021-2022,0.9477124183006536,0.9477124183006536
643,Kevin De Bruyne,BEL,MF,Manchester City,Premier League,30,1991,24.5,32,16,4,15,13,12,37,32.4,25,32,2,30,6,38,16,0,0,2021-2022,0.24489795918367346,1.3061224489795917
644,Konrad De La Fuente,USA,"FW,MF",Marseille,Ligue 1,20,2001,8.7,11,7,8,2,1,7,11,63.6,4,5,0,5,2,13,4,0,0,2021-2022,0.2298850574712644,1.264367816091954
645,Sebastien De Maio,FRA,DF,Udinese,Serie A,34,1987,2.0,5,1,4,1,0,1,9,11.1,8,6,5,1,1,6,9,0,0,2021-2022,0.5,2.5
646,Tommaso De Nipoti,ITA,FW,Atalanta,Serie A,18,2003,0.1,0,0,0,0,0,0,0,0.0,0,0,0,0,0,0,0,0,0,2021-2022,0.0,0.0
647,Rodrigo De Paul,ARG,MF,Atlético Madrid,La Liga,27,1994,23.9,55,30,22,25,8,30,60,50.0,30,24,3,21,21,76,17,2,0,2021-2022,0.8786610878661089,2.3012552301255234
648,Mattia De Sciglio,ITA,DF,Juventus,Serie A,28,1992,13.0,24,12,7,9,8,11,24,45.8,13,10,0,10,10,34,30,0,0,2021-2022,0.7692307692307693,1.8461538461538463
649,Lorenzo De Silvestri,ITA,DF,Bologna,Serie A,33,1988,25.5,23,14,13,8,2,9,31,29.0,22,25,7,18,26,49,52,0,0,2021-2022,1.0196078431372548,0.9019607843137255
650,Saulo Decarli,SUI,DF,Bochum,Bundesliga,29,1992,0.1,0,0,0,0,0,0,0,0.0,0,0,0,0,0,0,0,0,0,2021-2022,0.0,0.0
Rk,Player,Nation,Pos,Squad,Comp,0,0,90.0,0,0,3,3,3,Tkl,0,0.0,0,0,0,0,0,0,0,0,0,2021-2022,0.0,0.0
651,Troy Deeney,ENG,FW,Watford,Premier League,33,1988,0.3,0,0,0,0,0,0,1,0.0,1,0,0,0,0,0,2,0,0,2021-2022,0.0,0.0
652,Grégoire Defrel,MTQ,FW,Sassuolo,Serie A,30,1991,15.1,15,9,4,8,3,6,16,37.5,10,11,1,10,4,19,11,0,0,2021-2022,0.26490066225165565,0.9933774834437087
653,Alessandro Deiola,ITA,MF,Cagliari,Serie A,25,1995,23.7,47,22,15,25,7,23,58,39.7,35,28,10,18,26,73,45,0,0,2021-2022,1.0970464135021096,1.9831223628691983
654,Romain Del Castillo,FRA,"MF,FW",Rennes,Ligue 1,25,1996,0.3,2,1,0,1,1,2,2,100.0,0,0,0,0,1,3,0,0,0,2021-2022,3.3333333333333335,6.666666666666667
655,Romain Del Castillo,FRA,"MF,FW",Brest,Ligue 1,25,1996,10.8,27,16,3,17,7,12,31,38.7,19,12,0,12,7,34,3,0,0,2021-2022,0.6481481481481481,2.5
656,Thomas Delaine,FRA,DF,Metz,Ligue 1,29,1992,25.7,48,35,34,12,2,22,42,52.4,20,20,7,13,27,75,31,0,0,2021-2022,1.0505836575875487,1.867704280155642
657,Thomas Delaney,DEN,MF,Sevilla,La Liga,29,1991,17.2,41,24,17,21,3,16,30,53.3,14,19,10,9,13,54,35,0,0,2021-2022,0.7558139534883721,2.3837209302325584
658,Thomas Delaney,DEN,MF,Dortmund,Bundesliga,29,1991,0.2,0,0,0,0,0,0,0,0.0,0,0,0,0,0,0,0,0,0,2021-2022,0.0,0.0
659,Liam Delap,ENG,FW,Manchester City,Premier League,18,2003,0.1,0,0,0,0,0,0,0,0.0,0,0,0,0,0,0,0,0,0,2021-2022,0.0,0.0
660,Sacha Delaye,FRA,"MF,FW",Montpellier,Ligue 1,19,2002,2.9,8,6,3,2,3,2,8,25.0,6,1,0,1,1,9,1,1,0,2021-2022,0.3448275862068966,2.7586206896551726
661,Filippo Delli Carri,ITA,DF,Salernitana,Serie A,22,1999,3.7,6,4,4,2,0,5,14,35.7,9,6,2,4,4,10,14,0,0,2021-2022,1.081081081081081,1.6216216216216215
662,Andy Delort,ALG,FW,Nice,Ligue 1,29,1991,27.2,15,9,3,5,7,7,12,58.3,5,13,4,9,9,24,14,0,0,2021-2022,0.33088235294117646,0.5514705882352942
663,Andy Delort,ALG,FW,Montpellier,Ligue 1,29,1991,3.0,2,0,0,1,1,0,1,0.0,1,1,0,1,0,2,4,0,0,2021-2022,0.0,0.6666666666666666
664,Fabian Delph,ENG,MF,Everton,Premier League,31,1989,7.4,18,15,10,7,1,8,21,38.1,13,12,5,7,14,32,10,0,0,2021-2022,1.8918918918918919,2.4324324324324325
665,Moussa Dembélé,FRA,FW,Lyon,Ligue 1,25,1996,24.5,18,9,5,5,8,6,15,40.0,9,13,0,13,8,26,30,1,0,2021-2022,0.32653061224489793,0.7346938775510204
666,Ousmane Dembélé,FRA,FW,Barcelona,La Liga,24,1997,15.7,24,16,6,10,8,7,23,30.4,16,8,0,8,8,32,3,0,0,2021-2022,0.5095541401273885,1.5286624203821657
667,Yusuf Demir,AUT,FW,Barcelona,La Liga,18,2003,2.1,3,1,1,1,1,2,5,40.0,3,1,0,1,2,5,1,0,0,2021-2022,0.9523809523809523,1.4285714285714286
668,Merih Demiral,TUR,DF,Atalanta,Serie A,23,1998,21.3,31,17,18,12,1,15,28,53.6,13,26,14,12,58,89,68,1,0,2021-2022,2.7230046948356805,1.4553990610328638
669,Kerem Demirbay,GER,MF,Leverkusen,Bundesliga,28,1993,22.8,52,31,19,30,3,16,41,39.0,25,32,9,23,33,85,21,0,0,2021-2022,1.4473684210526316,2.280701754385965
670,Ermedin Demirović,BIH,FW,Freiburg,Bundesliga,23,1998,9.7,12,6,4,4,4,1,10,10.0,9,14,1,13,1,13,7,0,0,2021-2022,0.10309278350515465,1.2371134020618557
671,Diego Demme,GER,MF,Napoli,Serie A,29,1991,7.7,21,12,4,13,4,10,21,47.6,11,11,2,9,9,30,2,0,0,2021-2022,1.1688311688311688,2.727272727272727
672,Jason Denayer,BEL,DF,Lyon,Ligue 1,26,1995,11.1,11,4,8,3,0,6,7,85.7,1,8,7,1,16,27,52,0,0,2021-2022,1.4414414414414416,0.990990990990991
673,Leander Dendoncker,BEL,MF,Wolves,Premier League,26,1995,21.7,42,17,25,14,3,22,50,44.0,28,37,10,27,9,51,38,1,0,2021-2022,0.4147465437788019,1.935483870967742
674,Emmanuel Dennis,NGA,"FW,MF",Watford,Premier League,23,1997,28.7,51,35,20,22,9,17,52,32.7,35,36,2,34,15,66,13,0,0,2021-2022,0.5226480836236934,1.7770034843205575
675,Fabio Depaoli,ITA,DF,Hellas Verona,Serie A,24,1997,7.8,12,7,6,4,2,1,7,14.3,6,9,2,7,8,20,14,0,0,2021-2022,1.0256410256410258,1.5384615384615385
Rk,Player,Nation,Pos,Squad,Comp,0,0,90.0,0,0,3,3,3,Tkl,0,0.0,0,0,0,0,0,0,0,0,0,2021-2022,0.0,0.0
676,Fabio Depaoli,ITA,"MF,DF",Sampdoria,Serie A,24,1997,1.2,3,1,1,2,0,0,2,0.0,2,2,1,1,1,4,2,0,0,2021-2022,0.8333333333333334,2.5
677,Mike van der Hoorn,NED,DF,Arminia,Bundesliga,28,1992,0.2,1,0,1,0,0,0,0,0.0,0,0,0,0,1,2,2,0,0,2021-2022,5.0,5.0
678,Arthur Desmas,FRA,GK,Clermont Foot,Ligue 1,27,1994,14.5,0,0,0,0,0,0,3,0.0,3,0,0,0,0,0,1,3,0,2021-2022,0.0,0.0
679,Sergiño Dest,USA,"DF,FW",Barcelona,La Liga,20,2000,16.8,32,15,21,10,1,13,18,72.2,5,22,4,18,2,34,18,0,0,2021-2022,0.11904761904761904,1.9047619047619047
680,Mattia Destro,ITA,FW,Genoa,Serie A,30,1991,19.4,9,4,1,4,4,1,6,16.7,5,14,1,13,2,11,16,0,0,2021-2022,0.10309278350515465,0.4639175257731959
681,Gerard Deulofeu,ESP,"FW,MF",Udinese,Serie A,27,1994,29.1,11,6,2,3,6,7,29,24.1,22,14,0,14,9,20,4,0,0,2021-2022,0.30927835051546393,0.37800687285223367
682,Kiernan Dewsbury-Hall,ENG,MF,Leicester City,Premier League,22,1998,23.4,39,24,20,14,5,19,40,47.5,21,37,8,29,21,60,26,1,0,2021-2022,0.8974358974358975,1.6666666666666667
683,Jacopo Dezi,ITA,MF,Venezia,Serie A,29,1992,0.2,0,0,0,0,0,0,1,0.0,1,0,0,0,1,1,0,0,0,2021-2022,5.0,0.0
684,Samuel Di Carmine,ITA,FW,Hellas Verona,Serie A,32,1988,0.4,0,0,0,0,0,0,0,0.0,0,0,0,0,0,0,0,0,0,2021-2022,0.0,0.0
685,Federico Di Francesco,ITA,"FW,MF",Empoli,Serie A,27,1994,15.2,16,5,2,8,6,9,23,39.1,14,17,1,16,9,25,11,0,0,2021-2022,0.5921052631578948,1.0526315789473684
686,Giovanni Di Lorenzo,ITA,DF,Napoli,Serie A,27,1993,31.9,58,36,30,20,8,33,58,56.9,25,28,10,18,38,96,46,1,0,2021-2022,1.1912225705329154,1.8181818181818183
687,Ángel Di María,ARG,FW,Paris S-G,Ligue 1,33,1988,18.3,29,18,6,13,10,14,37,37.8,23,17,0,17,6,35,3,0,0,2021-2022,0.32786885245901637,1.5846994535519126
688,Francesco Di Mariano,ITA,FW,Venezia,Serie A,25,1996,0.7,1,1,0,1,0,0,0,0.0,0,2,1,1,0,1,0,0,0,2021-2022,0.0,1.4285714285714286
689,Francesco Di Tacchio,ITA,MF,Salernitana,Serie A,31,1990,13.9,17,7,5,10,2,9,25,36.0,16,16,8,8,22,39,25,0,0,2021-2022,1.5827338129496402,1.223021582733813
690,Boulaye Dia,SEN,FW,Villarreal,La Liga,24,1996,14.1,8,6,3,4,1,2,5,40.0,3,6,1,5,5,13,4,0,0,2021-2022,0.3546099290780142,0.5673758865248227
691,Moussa Diaby,FRA,"FW,MF",Leverkusen,Bundesliga,22,1999,30.7,20,11,8,9,3,5,38,13.2,33,11,0,11,8,28,2,0,0,2021-2022,0.26058631921824105,0.6514657980456027
692,Yadaly Diaby,GUI,"FW,MF",Clermont Foot,Ligue 1,20,2000,0.7,0,0,0,0,0,0,1,0.0,1,0,0,0,2,2,2,0,0,2021-2022,2.857142857142857,0.0
693,Mouctar Diakhaby,GUI,DF,Valencia,La Liga,24,1996,21.6,35,24,18,15,2,13,23,56.5,10,29,17,12,30,65,87,3,0,2021-2022,1.3888888888888888,1.6203703703703702
694,Ibrahim Diakité,GUI,MF,Reims,Ligue 1,17,2003,0.0,0,0,0,0,0,0,1,0.0,1,0,0,0,0,0,0,0,0,2021-2022,,
695,Abdou Diallo,SEN,DF,Paris S-G,Ligue 1,25,1996,9.7,22,14,10,9,3,8,14,57.1,6,6,2,4,10,32,19,1,0,2021-2022,1.0309278350515465,2.2680412371134024
696,Habib Diallo,SEN,FW,Strasbourg,Ligue 1,26,1995,17.1,9,5,0,8,1,0,8,0.0,8,13,4,9,4,13,11,0,0,2021-2022,0.23391812865497075,0.5263157894736842
697,Ibrahima Diallo,FRA,MF,Southampton,Premier League,22,1999,11.4,22,11,10,9,3,10,24,41.7,14,7,0,7,9,31,10,0,0,2021-2022,0.7894736842105263,1.9298245614035088
698,Habib Diarra,SEN,MF,Strasbourg,Ligue 1,17,2004,1.2,2,1,1,1,0,1,1,100.0,0,0,0,0,0,2,0,0,0,2021-2022,0.0,1.6666666666666667
699,Stéphane Diarra,FRA,"MF,FW",Lorient,Ligue 1,22,1998,5.8,11,9,7,3,1,5,10,50.0,5,4,0,4,7,18,1,0,0,2021-2022,1.206896551724138,1.896551724137931
700,Rúben Dias,POR,DF,Manchester City,Premier League,24,1997,26.7,26,19,11,12,3,8,15,53.3,7,19,13,6,23,49,66,0,0,2021-2022,0.8614232209737828,0.9737827715355806
Rk,Player,Nation,Pos,Squad,Comp,0,0,90.0,0,0,3,3,3,Tkl,0,0.0,0,0,0,0,0,0,0,0,0,2021-2022,0.0,0.0
701,Krépin Diatta,SEN,"MF,DF",Monaco,Ligue 1,22,1999,3.2,3,2,1,0,2,1,3,33.3,2,2,0,2,1,4,0,0,0,2021-2022,0.3125,0.9375
702,Amadou Diawara,GUI,MF,Roma,Serie A,24,1997,1.9,7,2,5,2,0,1,3,33.3,2,2,0,2,0,7,1,0,0,2021-2022,0.0,3.68421052631579
703,Brahim Díaz,MAR,MF,Milan,Serie A,21,1999,20.6,23,17,3,11,9,8,22,36.4,14,11,0,11,8,31,4,0,0,2021-2022,0.3883495145631068,1.116504854368932
704,Javier Díaz,ESP,GK,Sevilla,La Liga,24,1997,1.0,0,0,0,0,0,0,0,0.0,0,0,0,0,0,0,0,0,0,2021-2022,0.0,0.0
705,Luis Díaz,COL,FW,Liverpool,Premier League,24,1997,10.6,9,7,3,5,1,2,8,25.0,6,7,0,7,4,13,2,0,0,2021-2022,0.37735849056603776,0.8490566037735849
706,Víctor Díaz,ESP,DF,Granada,La Liga,33,1988,16.7,23,15,14,9,0,12,25,48.0,13,19,11,8,17,40,71,1,0,2021-2022,1.0179640718562875,1.377245508982036
707,Daniel Didavi,GER,"MF,FW",Stuttgart,Bundesliga,31,1990,3.1,6,2,0,4,2,4,7,57.1,3,4,1,3,1,7,1,0,0,2021-2022,0.3225806451612903,1.9354838709677418
708,Bamba Dieng,SEN,FW,Marseille,Ligue 1,21,2000,10.8,17,11,5,5,7,4,14,28.6,10,7,0,7,5,22,8,0,0,2021-2022,0.4629629629629629,1.574074074074074
709,Eric Dier,ENG,DF,Tottenham,Premier League,27,1994,34.1,15,9,6,8,1,7,14,50.0,7,37,32,5,27,42,142,1,0,2021-2022,0.7917888563049853,0.4398826979472141
710,Elhadji Dieye,SEN,"FW,MF",Saint-Étienne,Ligue 1,19,2002,0.4,3,2,2,1,0,0,1,0.0,1,2,0,2,1,4,0,0,0,2021-2022,2.5,7.5
711,Lucas Digne,FRA,DF,Aston Villa,Premier League,28,1993,14.1,13,10,8,3,2,9,19,47.4,10,15,8,7,23,36,40,0,0,2021-2022,1.6312056737588654,0.9219858156028369
712,Lucas Digne,FRA,DF,Everton,Premier League,28,1993,13.0,33,19,26,4,3,21,28,75.0,7,16,5,11,14,47,30,0,0,2021-2022,1.0769230769230769,2.5384615384615383
713,Mitchell Dijks,NED,"DF,FW",Bologna,Serie A,28,1993,7.7,15,6,6,6,3,5,12,41.7,7,11,2,9,3,18,10,1,0,2021-2022,0.38961038961038963,1.948051948051948
714,Javairô Dilrosun,NED,"MF,FW",Bordeaux,Ligue 1,23,1998,19.2,13,4,2,8,3,7,24,29.2,17,14,1,13,11,24,5,0,0,2021-2022,0.5729166666666667,0.6770833333333334
715,Javairô Dilrosun,NED,FW,Hertha BSC,Bundesliga,23,1998,1.5,3,1,1,2,0,1,1,100.0,0,1,0,1,0,3,0,0,0,2021-2022,0.0,2.0
716,Federico Dimarco,ITA,DF,Inter,Serie A,23,1997,15.9,28,15,10,15,3,13,24,54.2,11,6,1,5,19,47,19,0,0,2021-2022,1.1949685534591195,1.7610062893081762
717,Landry Dimata,BEL,"FW,MF",Espanyol,La Liga,23,1997,6.0,2,2,1,1,0,1,4,25.0,3,0,0,0,1,3,7,0,0,2021-2022,0.16666666666666666,0.3333333333333333
718,Stole Dimitrievski,MKD,GK,Rayo Vallecano,La Liga,27,1993,30.8,0,0,0,0,0,0,0,0.0,0,0,0,0,1,1,14,3,0,2021-2022,0.032467532467532464,0.0
719,Junior Dina Ebimbe,FRA,MF,Paris S-G,Ligue 1,20,2000,3.5,9,4,3,4,2,2,3,66.7,1,5,3,2,2,11,1,0,0,2021-2022,0.5714285714285714,2.5714285714285716
720,Tristan Dingomé,CMR,"MF,FW",Troyes,Ligue 1,30,1991,12.0,23,11,10,12,1,10,18,55.6,8,7,1,6,9,32,3,0,0,2021-2022,0.75,1.9166666666666667
721,Sinaly Diomande,CIV,DF,Lyon,Ligue 1,20,2001,6.4,6,3,4,2,0,5,6,83.3,1,6,6,0,12,18,26,0,0,2021-2022,1.875,0.9375
722,Issa Diop,FRA,DF,West Ham,Premier League,24,1997,10.7,10,8,5,5,0,4,11,36.4,7,14,13,1,7,17,44,0,0,2021-2022,0.6542056074766356,0.9345794392523366
723,Sofiane Diop,FRA,"MF,FW",Monaco,Ligue 1,21,2000,21.6,38,20,12,19,7,15,47,31.9,32,10,0,10,23,61,4,0,0,2021-2022,1.0648148148148147,1.759259259259259
724,Andy Diouf,FRA,MF,Rennes,Ligue 1,18,2003,0.2,1,1,1,0,0,1,1,100.0,0,1,0,1,0,1,0,0,0,2021-2022,0.0,5.0
725,Assane Dioussé,SEN,MF,Saint-Étienne,Ligue 1,23,1997,0.3,1,1,1,0,0,1,1,100.0,0,0,0,0,0,1,0,0,0,2021-2022,0.0,3.3333333333333335
Rk,Player,Nation,Pos,Squad,Comp,0,0,90.0,0,0,3,3,3,Tkl,0,0.0,0,0,0,0,0,0,0,0,0,2021-2022,0.0,0.0
726,Axel Disasi,FRA,DF,Monaco,Ligue 1,23,1998,30.2,42,27,20,21,1,23,39,59.0,16,40,30,10,26,68,75,0,0,2021-2022,0.8609271523178809,1.390728476821192
727,Filippo Distefano,ITA,FW,Fiorentina,Serie A,17,2003,0.0,0,0,0,0,0,0,0,0.0,0,0,0,0,0,0,0,0,0,2021-2022,,
728,Matías Dituro,ARG,GK,Celta Vigo,La Liga,34,1987,38.0,0,0,0,0,0,0,0,0.0,0,0,0,0,0,0,10,5,0,2021-2022,0.0,0.0
729,Tiago Djaló,POR,DF,Lille,Ligue 1,21,2000,25.9,60,39,39,19,2,26,39,66.7,13,26,10,16,24,84,71,0,0,2021-2022,0.9266409266409267,2.316602316602317
730,Djené,TOG,DF,Getafe,La Liga,29,1991,34.6,44,26,24,16,4,23,34,67.6,11,24,5,19,59,103,109,2,0,2021-2022,1.7052023121387283,1.2716763005780347
731,Moussa Djenepo,MLI,MF,Southampton,Premier League,23,1998,5.1,9,3,3,5,1,3,11,27.3,8,6,1,5,2,11,6,1,0,2021-2022,0.3921568627450981,1.7647058823529413
732,Koffi Djidji,CIV,DF,Torino,Serie A,28,1992,19.3,48,29,21,23,4,14,18,77.8,4,20,9,11,34,82,60,0,0,2021-2022,1.761658031088083,2.4870466321243523
733,Alexander Djiku,GHA,DF,Strasbourg,Ligue 1,26,1994,29.9,50,37,33,13,4,18,35,51.4,17,30,13,17,61,111,90,2,0,2021-2022,2.040133779264214,1.6722408026755853
734,Bryan Djile Nokoué,CMR,"DF,MF",Saint-Étienne,Ligue 1,19,2002,0.6,3,3,1,2,0,2,2,100.0,0,1,0,1,1,4,2,0,0,2021-2022,1.6666666666666667,5.0
735,Berat Djimsiti,ALB,DF,Atalanta,Serie A,28,1993,25.1,43,24,21,20,2,29,46,63.0,17,21,11,10,31,74,56,0,0,2021-2022,1.2350597609561753,1.7131474103585655
736,Ouparine Djoco,GNB,GK,Clermont Foot,Ligue 1,23,1998,23.5,0,0,0,0,0,0,0,0.0,0,0,0,0,1,1,14,2,0,2021-2022,0.0425531914893617,0.0
737,Naïs Djouahra,FRA,"FW,MF",Real Sociedad,La Liga,21,1999,2.4,7,3,2,2,3,4,8,50.0,4,3,0,3,2,9,2,0,0,2021-2022,0.8333333333333334,2.916666666666667
738,Marko Dmitrović,SRB,GK,Sevilla,La Liga,29,1992,6.0,0,0,0,0,0,0,0,0.0,0,0,0,0,0,0,3,1,0,2021-2022,0.0,0.0
739,Lewis Dobbin,ENG,"FW,MF",Everton,Premier League,18,2003,0.4,2,1,0,1,1,1,2,50.0,1,0,0,0,0,2,0,0,0,2021-2022,0.0,5.0
740,Matt Doherty,IRL,DF,Tottenham,Premier League,29,1992,9.7,18,12,5,11,2,8,14,57.1,6,11,2,9,13,31,20,0,0,2021-2022,1.3402061855670104,1.8556701030927836
741,Jeremy Doku,BEL,"FW,MF",Rennes,Ligue 1,19,2002,5.2,10,5,3,5,2,3,6,50.0,3,4,0,4,3,13,0,0,0,2021-2022,0.5769230769230769,1.923076923076923
742,Kasper Dolberg,DEN,FW,Nice,Ligue 1,23,1997,16.6,9,4,4,3,2,3,9,33.3,6,15,1,14,6,15,17,0,0,2021-2022,0.36144578313253006,0.5421686746987951
743,Jaume Doménech,ESP,GK,Valencia,La Liga,30,1990,3.8,0,0,0,0,0,0,0,0.0,0,0,0,0,0,0,3,1,0,2021-2022,0.0,0.0
744,Brandon Domingues,FRA,"MF,FW",Troyes,Ligue 1,21,2000,2.6,6,2,2,4,0,2,3,66.7,1,3,0,3,3,9,0,0,0,2021-2022,1.1538461538461537,2.3076923076923075
745,Carlos Dominguez,ESP,DF,Celta Vigo,La Liga,20,2001,3.8,4,1,4,0,0,4,6,66.7,2,2,1,1,4,8,21,0,0,2021-2022,1.0526315789473684,1.0526315789473684
746,Mario Dominguez,ESP,FW,Valencia,La Liga,17,2004,0.3,0,0,0,0,0,0,0,0.0,0,0,0,0,0,0,1,0,0,2021-2022,0.0,0.0
747,Nicolás Domínguez,ARG,MF,Bologna,Serie A,23,1998,22.4,76,45,36,32,8,32,76,42.1,44,38,9,29,32,108,34,1,0,2021-2022,1.4285714285714286,3.3928571428571432
748,John Donald,ESP,DF,Elche,La Liga,20,2000,2.0,7,4,4,2,1,5,8,62.5,3,5,3,2,3,10,3,0,0,2021-2022,1.5,3.5
749,Lee Dongjun,KOR,"MF,FW",Hertha BSC,Bundesliga,24,1997,1.3,2,1,0,2,0,1,3,33.3,2,2,0,2,2,4,1,0,0,2021-2022,1.5384615384615383,1.5384615384615383
750,Anastasios Donis,GRE,"FW,MF",Reims,Ligue 1,24,1996,4.1,8,7,4,2,2,2,6,33.3,4,3,0,3,0,8,1,0,0,2021-2022,0.0,1.9512195121951221
Rk,Player,Nation,Pos,Squad,Comp,0,0,90.0,0,0,3,3,3,Tkl,0,0.0,0,0,0,0,0,0,0,0,0,2021-2022,0.0,0.0
751,Gianluigi Donnarumma,ITA,GK,Paris S-G,Ligue 1,22,1999,17.0,0,0,0,0,0,0,0,0.0,0,0,0,0,0,0,9,2,0,2021-2022,0.0,0.0
752,Niklas Dorsch,GER,MF,Augsburg,Bundesliga,23,1998,25.8,76,47,47,23,6,30,60,50.0,30,34,12,22,35,111,36,3,0,2021-2022,1.3565891472868217,2.945736434108527
753,Jodel Dossou,BEN,FW,Clermont Foot,Ligue 1,29,1992,22.3,36,17,15,14,7,15,43,34.9,28,14,0,14,5,41,7,0,0,2021-2022,0.22421524663677128,1.6143497757847534
754,Lohann Doucet,FRA,"MF,DF",Nantes,Ligue 1,18,2002,0.1,0,0,0,0,0,0,0,0.0,0,0,0,0,1,1,0,0,0,2021-2022,10.0,0.0
755,Abdoulaye Doucouré,MLI,MF,Everton,Premier League,28,1993,28.2,75,43,30,37,8,32,71,45.1,39,33,8,25,28,103,32,0,0,2021-2022,0.9929078014184397,2.6595744680851063
756,Cheick Doucouré,MLI,MF,Lens,Ligue 1,21,2000,32.7,75,43,34,34,7,35,79,44.3,44,30,7,23,68,143,24,0,0,2021-2022,2.079510703363914,2.293577981651376
757,Fodé Doucouré,MLI,"DF,FW",Reims,Ligue 1,20,2001,1.7,12,9,9,3,0,9,11,81.8,2,1,0,1,4,16,6,0,0,2021-2022,2.3529411764705883,7.0588235294117645
758,Ismaël Doukouré,FRA,DF,Strasbourg,Ligue 1,18,2003,0.2,0,0,0,0,0,0,0,0.0,0,0,0,0,0,0,1,0,0,2021-2022,0.0,0.0
759,Kamory Doumbia,MLI,"MF,FW",Reims,Ligue 1,18,2003,3.9,8,2,2,5,1,5,13,38.5,8,9,3,6,3,11,3,0,0,2021-2022,0.7692307692307693,2.0512820512820515
760,Moussa Doumbia,MLI,FW,Reims,Ligue 1,26,1994,1.0,0,0,0,0,0,0,1,0.0,1,0,0,0,0,0,0,0,0,2021-2022,0.0,0.0
761,Souleyman Doumbia,CIV,"DF,FW",Angers,Ligue 1,24,1996,24.7,30,20,16,9,5,13,27,48.1,14,25,4,21,39,69,51,0,0,2021-2022,1.5789473684210527,1.2145748987854252
762,Kieran Dowell,ENG,"FW,MF",Norwich City,Premier League,23,1997,10.1,18,7,8,7,3,9,32,28.1,23,10,1,9,7,25,4,0,0,2021-2022,0.6930693069306931,1.7821782178217822
763,Bartłomiej Drągowski,POL,GK,Fiorentina,Serie A,23,1997,6.2,0,0,0,0,0,0,0,0.0,0,0,0,0,1,1,5,2,0,2021-2022,0.16129032258064516,0.0
764,Radu Drăgușin,ROU,DF,Sampdoria,Serie A,19,2002,6.9,4,3,2,2,0,2,6,33.3,4,8,4,4,10,14,33,0,0,2021-2022,1.4492753623188406,0.5797101449275363
765,Radu Drăgușin,ROU,DF,Salernitana,Serie A,19,2002,5.4,5,4,2,3,0,4,10,40.0,6,7,3,4,13,18,17,0,0,2021-2022,2.4074074074074074,0.9259259259259258
766,Cody Drameh,ENG,"DF,MF",Leeds United,Premier League,19,2001,1.4,4,2,3,1,0,1,3,33.3,2,0,0,0,1,5,4,0,0,2021-2022,0.7142857142857143,2.857142857142857
767,Julian Draxler,GER,"FW,MF",Paris S-G,Ligue 1,27,1993,6.1,3,2,0,3,0,0,4,0.0,4,3,0,3,5,8,3,0,0,2021-2022,0.819672131147541,0.49180327868852464
768,Matthieu Dreyer,FRA,GK,Lorient,Ligue 1,32,1989,16.0,1,1,1,0,0,1,1,100.0,0,0,0,0,0,1,9,0,0,2021-2022,0.0,0.0625
769,Domingos Duarte,POR,DF,Granada,La Liga,26,1995,18.7,18,14,9,9,0,6,11,54.5,5,27,20,7,22,40,82,0,0,2021-2022,1.1764705882352942,0.9625668449197862
770,Óscar Duarte,CRC,DF,Levante,La Liga,32,1989,19.7,18,8,12,6,0,8,23,34.8,15,18,9,9,24,42,102,0,0,2021-2022,1.218274111675127,0.9137055837563453
771,Rubén Duarte,ESP,DF,Alavés,La Liga,25,1995,29.1,76,47,43,27,6,43,85,50.6,42,40,6,34,57,133,82,0,0,2021-2022,1.958762886597938,2.611683848797251
772,Leo Dubois,FRA,DF,Lyon,Ligue 1,26,1994,19.4,43,27,22,14,7,27,46,58.7,19,27,3,24,22,65,35,1,0,2021-2022,1.1340206185567012,2.216494845360825
773,Martin Dúbravka,SVK,GK,Newcastle Utd,Premier League,32,1989,26.0,1,1,1,0,0,0,1,0.0,1,0,0,0,0,1,8,2,0,2021-2022,0.0,0.038461538461538464
774,Ondrej Duda,SVK,"MF,FW",Köln,Bundesliga,26,1994,17.9,23,16,4,12,7,6,23,26.1,17,14,2,12,17,40,9,0,0,2021-2022,0.9497206703910616,1.2849162011173185
775,Jeremy Dudziak,TUN,"MF,FW",Greuther Fürth,Bundesliga,25,1995,12.6,17,6,5,8,4,3,14,21.4,11,8,0,8,10,27,4,0,0,2021-2022,0.7936507936507937,1.3492063492063493
Rk,Player,Nation,Pos,Squad,Comp,0,0,90.0,0,0,3,3,3,Tkl,0,0.0,0,0,0,0,0,0,0,0,0,2021-2022,0.0,0.0
776,Shane Duffy,IRL,DF,Brighton,Premier League,29,1992,16.0,15,12,12,3,0,8,14,57.1,6,24,18,6,16,31,76,1,0,2021-2022,1.0,0.9375
777,Unai Dufur,ESP,DF,Osasuna,La Liga,22,1999,1.0,0,0,0,0,0,0,0,0.0,0,1,0,1,4,4,4,0,0,2021-2022,4.0,0.0
778,Denzel Dumfries,NED,DF,Inter,Serie A,25,1996,22.5,32,12,9,14,9,16,32,50.0,16,15,6,9,9,41,26,0,0,2021-2022,0.4,1.4222222222222223
779,Paul Dummett,WAL,DF,Newcastle Utd,Premier League,29,1991,2.2,7,3,3,4,0,5,8,62.5,3,5,0,5,3,10,5,0,0,2021-2022,1.3636363636363635,3.1818181818181817
780,Alfred Duncan,GHA,MF,Fiorentina,Serie A,28,1993,21.5,34,19,13,16,5,11,32,34.4,21,32,3,29,10,44,7,0,0,2021-2022,0.46511627906976744,1.5813953488372092
781,Lewis Dunk,ENG,DF,Brighton,Premier League,29,1991,28.6,10,8,5,5,0,5,11,45.5,6,32,28,4,27,37,113,3,0,2021-2022,0.9440559440559441,0.34965034965034963
782,Erik Durm,GER,DF,Eint Frankfurt,Bundesliga,29,1992,5.3,13,7,6,5,2,10,13,76.9,3,8,1,7,10,23,7,0,0,2021-2022,1.8867924528301887,2.452830188679245
783,Hugo Duro,ESP,"DF,MF",Getafe,La Liga,21,1999,0.1,0,0,0,0,0,0,0,0.0,0,0,0,0,0,0,0,0,0,2021-2022,0.0,0.0
784,Hugo Duro,ESP,"FW,MF",Valencia,La Liga,21,1999,20.4,25,19,11,13,1,15,38,39.5,23,24,2,22,4,29,20,1,0,2021-2022,0.19607843137254904,1.2254901960784315
785,Jean-Kevin Duverne,HAI,DF,Brest,Ligue 1,24,1997,33.4,71,44,43,21,7,42,90,46.7,48,40,5,35,53,124,92,0,0,2021-2022,1.5868263473053892,2.125748502994012
786,Paulo Dybala,ARG,"FW,MF",Juventus,Serie A,27,1993,22.9,30,13,7,14,9,8,35,22.9,27,19,0,19,9,39,4,3,0,2021-2022,0.39301310043668125,1.310043668122271
787,Edin Džeko,BIH,FW,Inter,Serie A,35,1986,27.4,14,8,7,4,3,8,25,32.0,17,22,5,17,4,18,35,0,0,2021-2022,0.14598540145985403,0.5109489051094891
788,Enzo Ebosse,CMR,DF,Angers,Ligue 1,22,1999,21.0,25,14,19,6,0,11,19,57.9,8,19,9,10,15,40,42,0,0,2021-2022,0.7142857142857143,1.1904761904761905
789,Tyronne Ebuehi,NGA,DF,Venezia,Serie A,25,1995,12.6,28,12,16,8,4,10,18,55.6,8,13,3,10,16,44,38,1,0,2021-2022,1.2698412698412698,2.2222222222222223
790,Ederson,BRA,GK,Manchester City,Premier League,27,1993,37.0,2,1,2,0,0,0,2,0.0,2,0,0,0,0,2,12,0,0,2021-2022,0.0,0.05405405405405406
791,Éderson,BRA,MF,Salernitana,Serie A,22,1999,12.7,29,18,11,14,4,14,26,53.8,12,11,2,9,19,48,8,0,0,2021-2022,1.4960629921259843,2.283464566929134
792,Odsonne Édouard,FRA,FW,Crystal Palace,Premier League,23,1998,17.4,16,10,2,7,7,7,21,33.3,14,20,5,15,0,16,18,0,0,2021-2022,0.0,0.9195402298850576
793,CJ Egan-Riley,ENG,DF,Manchester City,Premier League,18,2003,0.0,1,1,1,0,0,1,1,100.0,0,0,0,0,0,1,0,0,0,2021-2022,,inf
794,Maximilian Eggestein,GER,MF,Freiburg,Bundesliga,24,1996,24.4,48,28,17,25,6,22,50,44.0,28,35,11,24,30,78,32,1,0,2021-2022,1.2295081967213115,1.9672131147540985
795,Lilian Egloff,GER,"MF,DF",Stuttgart,Bundesliga,18,2002,0.3,1,0,0,1,0,0,0,0.0,0,1,0,1,0,1,0,0,0,2021-2022,0.0,3.3333333333333335
796,Kingsley Ehizibue,NED,DF,Köln,Bundesliga,26,1995,7.6,32,18,27,5,0,15,24,62.5,9,13,4,9,9,41,26,0,0,2021-2022,1.1842105263157896,4.2105263157894735
797,Julian Eitschberger,GER,DF,Hertha BSC,Bundesliga,17,2004,0.5,0,0,0,0,0,0,1,0.0,1,1,1,0,2,2,2,0,0,2021-2022,4.0,0.0
798,Albin Ekdal,SWE,MF,Sampdoria,Serie A,32,1989,18.2,43,28,17,21,5,26,56,46.4,30,27,7,20,29,72,25,0,0,2021-2022,1.5934065934065935,2.3626373626373627
799,Hugo Ekitike,FRA,FW,Reims,Ligue 1,19,2002,14.1,18,10,8,6,4,4,11,36.4,7,9,2,7,6,24,15,0,0,2021-2022,0.425531914893617,1.2765957446808511
800,Jurgen Ekkelenkamp,NED,"MF,FW",Hertha BSC,Bundesliga,21,2000,8.0,8,3,2,6,0,2,7,28.6,5,9,2,7,4,12,5,0,0,2021-2022,0.5,1.0
Rk,Player,Nation,Pos,Squad,Comp,0,0,90.0,0,0,3,3,3,Tkl,0,0.0,0,0,0,0,0,0,0,0,0,2021-2022,0.0,0.0
801,Caleb Ekuban,GHA,"FW,MF",Genoa,Serie A,27,1994,19.1,19,12,2,12,5,7,23,30.4,16,19,5,14,9,28,6,0,0,2021-2022,0.47120418848167533,0.9947643979057591
802,Anthony Elanga,SWE,FW,Manchester Utd,Premier League,19,2002,13.5,26,20,12,12,2,15,29,51.7,14,17,1,16,9,35,7,0,0,2021-2022,0.6666666666666666,1.9259259259259258
803,Alberth Elis,HON,"FW,MF",Bordeaux,Ligue 1,25,1996,15.7,19,10,5,5,9,11,25,44.0,14,9,0,9,7,26,10,0,0,2021-2022,0.445859872611465,1.2101910828025477
804,Harvey Elliott,ENG,MF,Liverpool,Premier League,18,2003,3.8,3,0,1,1,1,0,6,0.0,6,8,1,7,4,7,2,0,0,2021-2022,1.0526315789473684,0.7894736842105263
805,Elif Elmas,MKD,"FW,MF",Napoli,Serie A,21,1999,18.0,25,15,10,10,5,12,28,42.9,16,13,2,11,8,33,17,0,0,2021-2022,0.4444444444444444,1.3888888888888888
806,Mohamed Elneny,EGY,MF,Arsenal,Premier League,29,1992,9.0,16,8,10,5,1,7,12,58.3,5,7,1,6,14,30,13,0,0,2021-2022,1.5555555555555556,1.7777777777777777
807,Aritz Elustondo,ESP,DF,Real Sociedad,La Liga,27,1994,23.4,21,14,16,5,0,10,20,50.0,10,19,13,6,29,50,86,0,0,2021-2022,1.2393162393162394,0.8974358974358975
808,Nico Elvedi,SUI,DF,Gladbach,Bundesliga,24,1996,27.0,40,24,23,17,0,22,36,61.1,14,33,22,11,34,74,83,1,0,2021-2022,1.2592592592592593,1.4814814814814814
809,Mohamed Elyounoussi,NOR,"MF,FW",Southampton,Premier League,26,1994,22.7,36,17,14,15,7,11,39,28.2,28,23,2,21,12,48,28,0,0,2021-2022,0.5286343612334802,1.5859030837004406
810,Adri Embarba,ESP,"FW,MF",Espanyol,La Liga,29,1992,22.1,44,29,22,15,7,26,69,37.7,43,35,3,32,19,63,30,0,0,2021-2022,0.8597285067873303,1.9909502262443437
811,Breel Embolo,SUI,FW,Gladbach,Bundesliga,24,1997,24.1,16,11,1,12,3,3,8,37.5,5,14,2,12,6,22,7,0,0,2021-2022,0.24896265560165973,0.6639004149377593
812,Emerson,BRA,"DF,MF",Tottenham,Premier League,22,1999,25.4,72,47,50,16,6,36,67,53.7,31,25,2,23,22,94,92,1,0,2021-2022,0.8661417322834646,2.834645669291339
813,Emerson,BRA,DF,Barcelona,La Liga,22,1999,1.0,3,3,2,1,0,1,2,50.0,1,1,0,1,2,5,1,0,0,2021-2022,2.0,3.0
814,Renaud Emond,BEL,"FW,MF",Nantes,Ligue 1,29,1991,2.1,1,0,0,1,0,0,4,0.0,4,2,1,1,0,1,1,0,0,2021-2022,0.0,0.47619047619047616
815,Youssef En-Nesyri,MAR,FW,Sevilla,La Liga,24,1997,14.2,10,5,5,2,3,4,11,36.4,7,9,1,8,4,14,18,0,0,2021-2022,0.28169014084507044,0.7042253521126761
816,Keita Endo,JPN,MF,Union Berlin,Bundesliga,23,1997,0.6,1,1,1,0,0,0,0,0.0,0,1,0,1,0,1,0,0,0,2021-2022,0.0,1.6666666666666667
817,Wataru Endo,JPN,MF,Stuttgart,Bundesliga,28,1993,32.2,73,41,34,34,5,31,72,43.1,41,43,12,31,30,103,64,0,0,2021-2022,0.9316770186335402,2.2670807453416146
818,Christian Eriksen,DEN,MF,Brentford,Premier League,29,1992,10.4,13,6,4,5,4,8,17,47.1,9,9,1,8,9,22,14,0,0,2021-2022,0.8653846153846153,1.25
819,Martin Erlic,CRO,DF,Spezia,Serie A,23,1998,28.6,28,16,18,10,0,10,18,55.6,8,54,39,15,28,56,122,1,0,2021-2022,0.979020979020979,0.979020979020979
820,Gonzalo Escalante,ARG,MF,Lazio,Serie A,28,1993,0.1,1,0,1,0,0,1,1,100.0,0,2,1,1,1,2,0,0,0,2021-2022,10.0,10.0
821,Gonzalo Escalante,ARG,MF,Alavés,La Liga,28,1993,14.4,30,14,9,20,1,13,34,38.2,21,27,2,25,21,51,28,0,0,2021-2022,1.4583333333333333,2.0833333333333335
822,Aarón Escandell,ESP,GK,Granada,La Liga,25,1995,3.2,0,0,0,0,0,0,1,0.0,1,0,0,0,0,0,4,0,0,2021-2022,0.0,0.0
823,Sergio Escudero,ESP,"DF,MF",Granada,La Liga,31,1989,15.9,46,24,25,17,4,26,54,48.1,28,18,3,15,26,72,35,0,0,2021-2022,1.6352201257861634,2.893081761006289
824,Alfonso Espino,URU,DF,Cádiz,La Liga,29,1992,37.0,107,63,58,39,10,44,112,39.3,68,45,10,35,54,161,87,1,0,2021-2022,1.4594594594594594,2.891891891891892
825,Michael Esser,GER,GK,Bochum,Bundesliga,33,1987,3.0,0,0,0,0,0,0,1,0.0,1,0,0,0,0,0,2,0,0,2021-2022,0.0,0.0
Rk,Player,Nation,Pos,Squad,Comp,0,0,90.0,0,0,3,3,3,Tkl,0,0.0,0,0,0,0,0,0,0,0,0,2021-2022,0.0,0.0
826,Estanis,ESP,FW,Barcelona,La Liga,17,2003,0.1,1,1,0,1,0,1,1,100.0,0,0,0,0,0,1,0,0,0,2021-2022,0.0,10.0
827,Maxime Estève,FRA,DF,Montpellier,Ligue 1,19,2002,20.6,27,18,22,4,1,15,27,55.6,12,31,24,7,22,49,69,1,0,2021-2022,1.0679611650485437,1.3106796116504853
828,Pervis Estupiñán,ECU,DF,Villarreal,La Liga,23,1998,17.5,36,22,20,11,5,17,24,70.8,7,13,5,8,25,61,29,2,0,2021-2022,1.4285714285714286,2.057142857142857
829,Oghenekaro Etebo,NGA,MF,Watford,Premier League,25,1995,4.5,11,8,7,4,0,3,8,37.5,5,3,1,2,5,16,5,0,0,2021-2022,1.1111111111111112,2.4444444444444446
830,Jonny Evans,NIR,DF,Leicester City,Premier League,33,1988,15.0,24,14,14,8,2,14,22,63.6,8,17,13,4,20,44,59,0,0,2021-2022,1.3333333333333333,1.6
831,Eberechi Eze,ENG,"MF,FW",Crystal Palace,Premier League,23,1998,6.7,10,6,5,2,3,6,11,54.5,5,4,1,3,5,15,1,0,0,2021-2022,0.7462686567164178,1.4925373134328357
832,Abde Ezzalzouli,MAR,FW,Barcelona,La Liga,19,2001,6.4,17,9,9,5,3,5,8,62.5,3,3,0,3,9,26,0,0,0,2021-2022,1.40625,2.65625
833,Łukasz Fabiański,POL,GK,West Ham,Premier League,36,1985,37.0,0,0,0,0,0,0,0,0.0,0,0,0,0,0,0,11,0,0,2021-2022,0.0,0.0
834,Fabinho,BRA,MF,Liverpool,Premier League,27,1993,25.7,46,25,17,23,6,24,70,34.3,46,33,10,23,39,85,25,1,0,2021-2022,1.517509727626459,1.7898832684824904
835,Fábio,BRA,DF,Nantes,Ligue 1,31,1990,18.5,61,40,31,23,7,36,74,48.6,38,29,7,22,35,96,31,1,0,2021-2022,1.8918918918918919,3.2972972972972974
836,Cesc Fàbregas,ESP,MF,Monaco,Ligue 1,34,1987,0.4,1,0,0,1,0,1,1,100.0,0,0,0,0,1,2,0,0,0,2021-2022,2.5,2.5
837,Wout Faes,BEL,DF,Reims,Ligue 1,23,1998,37.0,40,24,30,9,1,25,33,75.8,8,47,37,10,53,93,169,2,0,2021-2022,1.4324324324324325,1.0810810810810811
838,Wahid Faghir,DEN,FW,Stuttgart,Bundesliga,18,2003,1.4,0,0,0,0,0,0,1,0.0,1,2,0,2,0,0,0,0,0,2021-2022,0.0,0.0
839,Romain Faivre,FRA,"FW,MF",Lyon,Ligue 1,23,1998,9.9,10,4,2,6,2,4,13,30.8,9,4,0,4,3,13,2,0,0,2021-2022,0.30303030303030304,1.0101010101010102
840,Romain Faivre,FRA,MF,Brest,Ligue 1,23,1998,19.9,30,18,12,13,5,12,30,40.0,18,11,0,11,13,43,10,0,0,2021-2022,0.6532663316582915,1.5075376884422111
841,Radamel Falcao,COL,FW,Rayo Vallecano,La Liga,35,1986,9.3,2,1,0,1,1,1,4,25.0,3,4,1,3,2,4,11,0,0,2021-2022,0.2150537634408602,0.2150537634408602
842,Diego Falcinelli,ITA,FW,Bologna,Serie A,30,1991,0.7,2,2,2,0,0,0,0,0.0,0,0,0,0,1,3,1,0,0,2021-2022,1.4285714285714286,2.857142857142857
843,Wladimiro Falcone,ITA,GK,Sampdoria,Serie A,26,1995,9.5,0,0,0,0,0,0,0,0.0,0,0,0,0,1,1,5,0,0,2021-2022,0.10526315789473684,0.0
844,Fali,ESP,"DF,MF",Cádiz,La Liga,27,1993,20.0,32,19,24,8,0,17,32,53.1,15,26,16,10,24,56,82,0,0,2021-2022,1.2,1.6
845,Paolo Faragò,ITA,MF,Cagliari,Serie A,28,1993,0.2,1,1,1,0,0,0,0,0.0,0,2,0,2,0,1,0,0,0,2021-2022,0.0,5.0
846,Omar Faraj,PLE,FW,Levante,La Liga,19,2002,0.0,1,0,1,0,0,1,1,100.0,0,0,0,0,0,1,0,0,0,2021-2022,,inf
847,Davide Faraoni,ITA,DF,Hellas Verona,Serie A,29,1991,28.6,62,40,38,21,3,29,62,46.8,33,38,5,33,23,85,62,1,0,2021-2022,0.8041958041958042,2.167832167832168
848,Mohamed Fares,ALG,"DF,FW",Genoa,Serie A,25,1996,6.5,4,2,1,3,0,0,4,0.0,4,8,3,5,8,12,11,0,0,2021-2022,1.2307692307692308,0.6153846153846154
849,Diego Farias,BRA,"MF,FW",Cagliari,Serie A,31,1990,0.7,1,1,0,1,0,1,3,33.3,2,0,0,0,0,1,0,0,0,2021-2022,0.0,1.4285714285714286
850,Wuilker Faríñez,VEN,GK,Lens,Ligue 1,23,1998,12.3,0,0,0,0,0,0,0,0.0,0,0,0,0,0,0,4,0,0,2021-2022,0.0,0.0
Rk,Player,Nation,Pos,Squad,Comp,0,0,90.0,0,0,3,3,3,Tkl,0,0.0,0,0,0,0,0,0,0,0,0,2021-2022,0.0,0.0
851,Ömer Faruk Beyaz,TUR,"DF,MF",Stuttgart,Bundesliga,17,2003,0.8,4,3,1,3,0,1,5,20.0,4,0,0,0,2,6,0,0,0,2021-2022,2.5,5.0
852,Noah Fatar,FRA,"DF,MF",Angers,Ligue 1,19,2002,0.1,1,0,0,0,1,0,1,0.0,1,0,0,0,1,2,0,0,0,2021-2022,10.0,10.0
853,Ansu Fati,ESP,FW,Barcelona,La Liga,18,2002,3.7,3,2,0,2,1,1,1,100.0,0,4,0,4,1,4,0,0,0,2021-2022,0.27027027027027023,0.8108108108108107
854,Julien Faussurier,FRA,"MF,DF",Brest,Ligue 1,34,1987,5.4,10,6,3,3,4,6,13,46.2,7,12,1,11,5,15,6,0,0,2021-2022,0.9259259259259258,1.8518518518518516
855,Andrea Favilli,ITA,FW,Genoa,Serie A,24,1997,0.4,1,1,0,0,1,0,0,0.0,0,0,0,0,0,1,2,0,0,2021-2022,0.0,2.5
856,Federico Fazio,ARG,DF,Salernitana,Serie A,34,1987,15.9,17,11,10,6,1,9,12,75.0,3,21,16,5,27,44,67,1,0,2021-2022,1.6981132075471699,1.069182389937107
857,Aleix Febas,ESP,MF,Mallorca,La Liga,25,1996,1.3,4,1,0,4,0,2,4,50.0,2,0,0,0,0,4,0,0,0,2021-2022,0.0,3.0769230769230766
858,Peter Federico,DOM,"MF,DF",Real Madrid,La Liga,19,2002,0.3,0,0,0,0,0,0,0,0.0,0,0,0,0,1,1,0,0,0,2021-2022,3.3333333333333335,0.0
859,Adrian Fein,GER,MF,Greuther Fürth,Bundesliga,22,1999,0.4,0,0,0,0,0,0,1,0.0,1,0,0,0,2,2,0,0,0,2021-2022,5.0,0.0
860,Nabil Fekir,FRA,MF,Betis,La Liga,28,1993,31.0,43,29,5,25,13,7,36,19.4,29,14,0,14,7,50,7,0,0,2021-2022,0.22580645161290322,1.3870967741935485
861,Felipe,BRA,DF,Atlético Madrid,La Liga,32,1989,16.7,20,15,11,8,1,8,18,44.4,10,17,11,6,28,48,77,0,0,2021-2022,1.6766467065868265,1.1976047904191618
862,Luiz Felipe,ITA,DF,Lazio,Serie A,24,1997,27.7,41,23,21,16,4,20,34,58.8,14,40,33,7,33,74,102,1,0,2021-2022,1.1913357400722022,1.48014440433213
863,João Félix,POR,"FW,MF",Atlético Madrid,La Liga,21,1999,14.0,5,2,1,4,0,1,5,20.0,4,4,1,3,7,12,8,0,0,2021-2022,0.5,0.35714285714285715
864,Ohis Felix Uduokhai,GER,DF,Augsburg,Bundesliga,23,1997,8.7,9,6,6,3,0,6,11,54.5,5,13,8,5,9,18,33,0,0,2021-2022,1.0344827586206897,1.0344827586206897
865,Kiko Femenía,ESP,DF,Watford,Premier League,30,1991,23.8,35,22,23,10,2,21,37,56.8,16,24,8,16,37,72,51,0,0,2021-2022,1.5546218487394958,1.4705882352941175
866,Evan Ferguson,IRL,MF,Brighton,Premier League,16,2004,0.3,0,0,0,0,0,0,0,0.0,0,0,0,0,0,0,0,0,0,2021-2022,0.0,0.0
867,Nathan Ferguson,ENG,DF,Crystal Palace,Premier League,20,2000,0.1,0,0,0,0,0,0,0,0.0,0,0,0,0,0,0,0,0,0,2021-2022,0.0,0.0
868,Bruno Fernandes,POR,MF,Manchester Utd,Premier League,26,1994,34.6,54,28,26,22,6,26,91,28.6,65,36,0,36,17,71,42,2,0,2021-2022,0.4913294797687861,1.560693641618497
869,Edimilson Fernandes,SUI,"MF,FW",Arminia,Bundesliga,25,1996,3.1,2,0,1,1,0,1,4,25.0,3,2,2,0,2,4,6,0,0,2021-2022,0.6451612903225806,0.6451612903225806
870,Aitor Fernández,ESP,GK,Levante,La Liga,30,1991,13.0,2,1,2,0,0,2,2,100.0,0,0,0,0,0,2,7,0,0,2021-2022,0.0,0.15384615384615385
871,Álex Fernández,ESP,MF,Cádiz,La Liga,28,1992,22.8,47,31,22,17,8,21,61,34.4,40,30,7,23,30,77,31,0,0,2021-2022,1.3157894736842104,2.06140350877193
872,Álvaro Fernández,ESP,GK,Brentford,Premier League,23,1998,12.0,0,0,0,0,0,0,0,0.0,0,0,0,0,0,0,5,2,0,2021-2022,0.0,0.0
873,Federico Fernández,ARG,DF,Newcastle Utd,Premier League,32,1989,5.8,3,0,3,0,0,2,5,40.0,3,10,10,0,4,7,28,0,0,2021-2022,0.6896551724137931,0.5172413793103449
874,Fernandinho,BRA,"MF,DF",Manchester City,Premier League,36,1985,10.7,21,10,7,10,4,9,27,33.3,18,8,2,6,8,29,13,1,0,2021-2022,0.7476635514018692,1.9626168224299068
875,Fernando,BRA,"MF,DF",Sevilla,La Liga,34,1987,20.6,24,17,14,9,1,12,33,36.4,21,21,13,8,29,53,32,2,0,2021-2022,1.407766990291262,1.1650485436893203
Rk,Player,Nation,Pos,Squad,Comp,0,0,90.0,0,0,3,3,3,Tkl,0,0.0,0,0,0,0,0,0,0,0,0,2021-2022,0.0,0.0
876,Alex Ferrari,ITA,DF,Sampdoria,Serie A,27,1994,18.3,40,22,28,9,3,19,33,57.6,14,31,22,9,39,79,63,1,0,2021-2022,2.1311475409836063,2.1857923497267757
877,Salvador Ferrer,ESP,"DF,MF",Spezia,Serie A,23,1998,16.6,32,18,15,9,8,12,25,48.0,13,24,12,12,18,50,46,0,0,2021-2022,1.0843373493975903,1.9277108433734937
878,Jordan Ferri,FRA,MF,Montpellier,Ligue 1,29,1992,32.3,55,35,28,23,4,29,87,33.3,58,21,5,16,30,85,35,0,0,2021-2022,0.9287925696594428,1.7027863777089784
879,Riccardo Fiamozzi,ITA,DF,Empoli,Serie A,28,1993,6.9,7,5,2,2,3,2,4,50.0,2,6,5,1,7,14,12,0,0,2021-2022,1.0144927536231882,1.0144927536231882
880,Fidel,ESP,MF,Elche,La Liga,31,1989,25.1,44,23,18,17,9,14,57,24.6,43,9,1,8,7,51,20,0,0,2021-2022,0.2788844621513944,1.752988047808765
881,Karol Fila,POL,DF,Strasbourg,Ligue 1,23,1998,6.2,10,8,5,4,1,4,8,50.0,4,7,2,5,4,14,6,0,0,2021-2022,0.6451612903225806,1.6129032258064515
882,Alfreð Finnbogason,ISL,FW,Augsburg,Bundesliga,32,1989,3.2,3,1,0,2,1,2,4,50.0,2,5,1,4,2,5,8,0,0,2021-2022,0.625,0.9375
883,Luca Fiordilino,ITA,MF,Venezia,Serie A,25,1996,7.3,21,13,11,6,4,13,27,48.1,14,14,4,10,11,32,12,0,0,2021-2022,1.5068493150684932,2.8767123287671232
884,Vincenzo Fiorillo,ITA,GK,Salernitana,Serie A,31,1990,1.0,0,0,0,0,0,0,0,0.0,0,0,0,0,0,0,1,0,0,2021-2022,0.0,0.0
885,Roberto Firmino,BRA,FW,Liverpool,Premier League,29,1991,11.0,23,14,5,8,10,3,16,18.8,13,20,0,20,4,27,3,0,0,2021-2022,0.36363636363636365,2.090909090909091
886,Junior Firpo,DOM,"DF,MF",Leeds United,Premier League,24,1996,19.0,61,29,30,26,5,31,59,52.5,28,22,6,16,24,85,37,0,0,2021-2022,1.263157894736842,3.210526315789474
887,Mark Flekken,NED,GK,Freiburg,Bundesliga,28,1993,32.0,0,0,0,0,0,0,2,0.0,2,1,0,1,2,2,10,1,0,2021-2022,0.0625,0.0
888,Ashley Fletcher,ENG,FW,Watford,Premier League,25,1995,0.3,2,1,1,1,0,1,1,100.0,0,1,1,0,0,2,0,0,0,2021-2022,0.0,6.666666666666667
889,Alexis Flips,FRA,"MF,DF",Reims,Ligue 1,21,2000,11.7,37,21,21,9,7,22,45,48.9,23,21,0,21,24,61,17,0,0,2021-2022,2.0512820512820515,3.1623931623931627
890,Alessandro Florenzi,ITA,"DF,FW",Milan,Serie A,30,1991,12.8,28,14,14,7,7,14,32,43.8,18,9,2,7,27,55,10,1,0,2021-2022,2.109375,2.1875
891,Phil Foden,ENG,FW,Manchester City,Premier League,21,2000,23.6,16,8,10,4,2,7,17,41.2,10,9,0,9,11,27,5,0,0,2021-2022,0.4661016949152542,0.6779661016949152
892,Mamadou Fofana,MLI,DF,Metz,Ligue 1,23,1998,0.4,1,1,0,1,0,1,2,50.0,1,2,1,1,1,2,2,0,0,2021-2022,2.5,2.5
893,Seko Fofana,CIV,MF,Lens,Ligue 1,26,1995,37.3,27,19,11,13,3,12,58,20.7,46,24,2,22,26,53,17,1,0,2021-2022,0.6970509383378016,0.7238605898123325
894,Wesley Fofana,FRA,DF,Leicester City,Premier League,20,2000,7.0,12,8,11,1,0,7,11,63.6,4,5,2,3,12,24,26,1,0,2021-2022,1.7142857142857142,1.7142857142857142
895,Youssouf Fofana,FRA,MF,Monaco,Ligue 1,22,1999,24.3,69,43,19,41,9,29,56,51.8,27,29,7,22,32,101,22,2,0,2021-2022,1.316872427983539,2.839506172839506
896,Thomas Foket,BEL,"DF,FW",Reims,Ligue 1,26,1994,24.8,28,19,12,13,3,18,40,45.0,22,26,4,22,33,61,35,0,0,2021-2022,1.3306451612903225,1.129032258064516
897,Thomas Fontaine,MAD,DF,Lorient,Ligue 1,30,1991,1.9,2,0,1,0,1,0,1,0.0,1,3,3,0,2,4,4,0,0,2021-2022,1.0526315789473684,1.0526315789473684
898,José Fontán,ESP,DF,Celta Vigo,La Liga,21,2000,3.1,5,3,3,2,0,1,5,20.0,4,3,1,2,10,15,10,0,0,2021-2022,3.225806451612903,1.6129032258064515
899,José Fonte,POR,DF,Lille,Ligue 1,37,1983,38.0,23,12,14,7,2,11,25,44.0,14,39,32,7,44,67,159,1,0,2021-2022,1.1578947368421053,0.6052631578947368
900,Fernando Forestieri,ITA,"FW,MF",Udinese,Serie A,31,1990,0.6,0,0,0,0,0,0,1,0.0,1,1,0,1,0,0,1,0,0,2021-2022,0.0,0.0
Rk,Player,Nation,Pos,Squad,Comp,0,0,90.0,0,0,3,3,3,Tkl,0,0.0,0,0,0,0,0,0,0,0,0,2021-2022,0.0,0.0
901,Pablo Fornals,ESP,"FW,MF",West Ham,Premier League,25,1996,31.1,54,28,21,21,12,22,84,26.2,62,49,2,47,27,81,16,1,0,2021-2022,0.8681672025723473,1.7363344051446945
902,Emil Forsberg,SWE,MF,RB Leipzig,Bundesliga,29,1991,19.0,21,12,2,11,8,7,22,31.8,15,18,0,18,2,23,2,1,0,2021-2022,0.10526315789473684,1.105263157894737
903,Adam Forshaw,ENG,MF,Leeds United,Premier League,29,1991,17.0,53,23,21,27,5,21,54,38.9,33,17,1,16,19,72,12,2,0,2021-2022,1.1176470588235294,3.1176470588235294
904,Marcus Forss,FIN,"FW,MF",Brentford,Premier League,22,1999,2.3,3,3,0,2,1,2,4,50.0,2,5,0,5,1,4,0,0,0,2021-2022,0.4347826086956522,1.3043478260869565
905,Fraser Forster,ENG,GK,Southampton,Premier League,33,1988,19.0,1,0,1,0,0,0,1,0.0,1,0,0,0,0,1,23,2,0,2021-2022,0.0,0.05263157894736842
906,Philipp Förster,GER,"MF,FW",Stuttgart,Bundesliga,26,1995,10.7,20,13,4,12,4,11,26,42.3,15,12,1,11,3,23,2,0,0,2021-2022,0.28037383177570097,1.869158878504673
907,Francesco Forte,ITA,FW,Venezia,Serie A,28,1993,4.7,3,2,0,2,1,2,5,40.0,3,1,0,1,0,3,2,0,0,2021-2022,0.0,0.6382978723404255
908,Steven Fortes,CPV,DF,Lens,Ligue 1,29,1992,1.0,2,0,2,0,0,1,2,50.0,1,2,1,1,0,2,4,0,0,2021-2022,0.0,2.0
909,Ben Foster,ENG,GK,Watford,Premier League,38,1983,26.0,0,0,0,0,0,0,3,0.0,3,0,0,0,0,0,9,4,0,2021-2022,0.0,0.0
910,Tariqe Fosu,GHA,DF,Brentford,Premier League,25,1995,0.2,0,0,0,0,0,0,0,0.0,0,1,0,1,0,0,0,0,0,2021-2022,0.0,0.0
911,Timothy Fosu-Mensah,NED,DF,Leverkusen,Bundesliga,23,1998,1.6,5,3,3,1,1,4,4,100.0,0,1,0,1,2,7,2,0,0,2021-2022,1.25,3.125
912,Dimitri Foulquier,FRA,DF,Granada,La Liga,28,1993,2.0,0,0,0,0,0,0,1,0.0,1,2,1,1,1,1,2,0,0,2021-2022,0.5,0.0
913,Dimitri Foulquier,FRA,DF,Valencia,La Liga,28,1993,26.0,36,17,17,15,4,21,34,61.8,13,19,3,16,29,65,49,0,0,2021-2022,1.1153846153846154,1.3846153846153846
914,Juan Foyth,ARG,DF,Villarreal,La Liga,23,1998,21.4,69,49,35,28,6,35,47,74.5,12,29,7,22,20,89,50,0,0,2021-2022,0.9345794392523366,3.2242990654205608
915,Gianluca Frabotta,ITA,"DF,MF",Hellas Verona,Serie A,22,1999,0.2,0,0,0,0,0,0,1,0.0,1,1,0,1,1,1,0,0,0,2021-2022,5.0,0.0
916,Raphael Framberger,GER,DF,Augsburg,Bundesliga,25,1995,9.4,26,19,12,10,4,13,27,48.1,14,8,2,6,9,35,25,0,0,2021-2022,0.9574468085106382,2.7659574468085104
917,Przemysław Frankowski,POL,DF,Lens,Ligue 1,26,1995,27.2,57,39,22,27,8,36,74,48.6,38,27,0,27,28,85,52,0,0,2021-2022,1.0294117647058825,2.0955882352941178
918,Enric Franquesa,ESP,"DF,FW",Levante,La Liga,24,1997,6.9,5,3,4,0,1,0,1,0.0,1,4,0,4,7,12,11,0,0,2021-2022,1.0144927536231882,0.7246376811594203
919,Fransérgio,BRA,MF,Bordeaux,Ligue 1,30,1990,14.0,24,10,8,12,4,12,43,27.9,31,18,6,12,23,47,23,0,0,2021-2022,1.6428571428571428,1.7142857142857142
920,Ryan Fraser,SCO,"FW,MF",Newcastle Utd,Premier League,27,1994,16.3,10,3,5,3,2,5,13,38.5,8,11,1,10,11,21,11,0,0,2021-2022,0.6748466257668712,0.6134969325153374
921,Davide Frattesi,ITA,MF,Sassuolo,Serie A,21,1999,31.7,46,16,26,18,2,26,52,50.0,26,44,12,32,29,75,62,1,0,2021-2022,0.9148264984227129,1.4511041009463723
922,Fred,BRA,MF,Manchester Utd,Premier League,28,1993,22.5,63,27,32,24,7,22,79,27.8,57,38,11,27,32,95,24,0,0,2021-2022,1.4222222222222223,2.8
923,Ryan Fredericks,ENG,DF,West Ham,Premier League,28,1992,3.4,2,2,2,0,0,0,1,0.0,1,2,1,1,4,6,6,0,0,2021-2022,1.1764705882352942,0.5882352941176471
924,Morten Frendrup,DEN,"DF,MF",Genoa,Serie A,20,2001,7.7,40,24,19,13,8,13,29,44.8,16,19,2,17,17,57,7,1,0,2021-2022,2.207792207792208,5.194805194805195
925,Remo Freuler,SUI,MF,Atalanta,Serie A,29,1992,26.3,69,39,22,33,14,30,70,42.9,40,48,8,40,35,104,26,1,0,2021-2022,1.3307984790874525,2.623574144486692
Rk,Player,Nation,Pos,Squad,Comp,0,0,90.0,0,0,3,3,3,Tkl,0,0.0,0,0,0,0,0,0,0,0,0,2021-2022,0.0,0.0
926,Marvin Friedrich,GER,DF,Gladbach,Bundesliga,25,1995,6.7,14,8,10,4,0,9,11,81.8,2,5,3,2,5,19,26,0,0,2021-2022,0.7462686567164178,2.08955223880597
927,Marvin Friedrich,GER,DF,Union Berlin,Bundesliga,25,1995,13.0,17,5,14,3,0,10,16,62.5,6,13,7,6,23,40,47,0,0,2021-2022,1.7692307692307692,1.3076923076923077
928,Jeremie Frimpong,NED,DF,Leverkusen,Bundesliga,20,2000,22.8,32,18,19,12,1,12,23,52.2,11,24,6,18,17,49,40,2,0,2021-2022,0.7456140350877193,1.4035087719298245
929,Christian Früchtl,GER,GK,Bayern Munich,Bundesliga,21,2000,0.1,0,0,0,0,0,0,0,0.0,0,0,0,0,0,0,0,0,0,2021-2022,0.0,0.0
930,Jorge de Frutos,ESP,"MF,FW",Levante,La Liga,24,1997,19.6,33,15,14,11,8,10,51,19.6,41,11,1,10,12,45,13,0,0,2021-2022,0.6122448979591836,1.683673469387755
931,Leo Fuhr Hjelde,NOR,"MF,DF",Leeds United,Premier League,17,2003,1.7,5,4,3,2,0,3,3,100.0,0,3,3,0,4,9,7,0,0,2021-2022,2.3529411764705883,2.9411764705882355
932,Chris Führich,GER,"FW,MF",Stuttgart,Bundesliga,23,1998,19.0,28,16,10,10,8,18,39,46.2,21,31,2,29,8,36,9,0,0,2021-2022,0.42105263157894735,1.4736842105263157
933,Angelo Fulgini,FRA,"MF,FW",Angers,Ligue 1,24,1996,32.5,35,25,8,18,9,14,44,31.8,30,21,5,16,22,57,5,1,0,2021-2022,0.676923076923077,1.0769230769230769
934,Marius Funk,GER,GK,Greuther Fürth,Bundesliga,25,1996,8.0,0,0,0,0,0,0,0,0.0,0,0,0,0,0,0,8,1,0,2021-2022,0.0,0.0
935,Stephan Fürstner,GER,MF,Mainz 05,Bundesliga,33,1987,0.1,0,0,0,0,0,0,2,0.0,2,0,0,0,0,0,1,0,0,2021-2022,0.0,0.0
936,Matteo Gabbia,ITA,DF,Milan,Serie A,21,1999,6.0,4,3,1,3,0,0,4,0.0,4,2,2,0,8,12,12,0,0,2021-2022,1.3333333333333333,0.6666666666666666
937,Manolo Gabbiadini,ITA,"FW,MF",Sampdoria,Serie A,29,1991,12.7,6,4,3,2,1,1,7,14.3,6,5,2,3,3,9,10,0,0,2021-2022,0.2362204724409449,0.4724409448818898
938,Mijat Gaćinović,SRB,"FW,MF",Hoffenheim,Bundesliga,26,1995,1.2,3,3,1,1,1,3,3,100.0,0,1,0,1,1,4,2,0,0,2021-2022,0.8333333333333334,2.5
939,Gianluca Gaetano,ITA,MF,Napoli,Serie A,21,2000,0.2,1,1,1,0,0,1,2,50.0,1,0,0,0,2,3,0,0,0,2021-2022,10.0,5.0
940,Luca Gagliano,ITA,"FW,DF",Cagliari,Serie A,21,2000,0.1,0,0,0,0,0,0,0,0.0,0,1,0,1,0,0,1,0,0,2021-2022,0.0,0.0
941,Roberto Gagliardini,ITA,MF,Inter,Serie A,27,1994,7.2,12,6,7,4,1,1,13,7.7,12,14,5,9,9,21,7,0,0,2021-2022,1.25,1.6666666666666665
942,Riccardo Gagliolo,SWE,DF,Salernitana,Serie A,31,1990,12.6,23,12,16,4,3,16,27,59.3,11,15,8,7,28,51,52,0,0,2021-2022,2.2222222222222223,1.8253968253968254
943,Javi Galán,ESP,DF,Celta Vigo,La Liga,26,1994,36.6,108,66,60,37,11,42,99,42.4,57,48,8,40,45,153,52,0,0,2021-2022,1.2295081967213115,2.9508196721311473
944,Iñigo Ruiz de Galarreta,ESP,MF,Mallorca,La Liga,27,1993,15.3,40,21,14,21,5,14,30,46.7,16,16,2,14,20,60,21,0,0,2021-2022,1.3071895424836601,2.6143790849673203
945,Nicolas Galazzi,ITA,MF,Venezia,Serie A,20,2000,0.2,2,1,1,0,1,0,1,0.0,1,0,0,0,0,2,0,0,0,2021-2022,0.0,10.0
946,Pablo Galdames Millán,CHI,MF,Genoa,Serie A,24,1996,11.4,28,12,6,16,6,12,35,34.3,23,16,2,14,8,36,9,1,0,2021-2022,0.7017543859649122,2.456140350877193
947,Thiago Galhardo,BRA,"FW,MF",Celta Vigo,La Liga,32,1989,12.8,12,6,3,3,6,2,12,16.7,10,15,2,13,6,18,9,0,0,2021-2022,0.46875,0.9375
948,Conor Gallagher,ENG,MF,Crystal Palace,Premier League,21,2000,31.6,69,38,35,20,14,21,69,30.4,48,58,9,49,29,98,26,0,0,2021-2022,0.9177215189873418,2.1835443037974684
949,Gauthier Gallon,FRA,GK,Troyes,Ligue 1,28,1993,31.0,3,0,3,0,0,1,1,100.0,0,0,0,0,2,5,12,1,0,2021-2022,0.06451612903225806,0.0967741935483871
950,Cristian Gamboa,CRC,DF,Bochum,Bundesliga,31,1989,19.1,59,36,40,16,3,30,61,49.2,31,22,7,15,32,91,35,1,0,2021-2022,1.6753926701570678,3.089005235602094
Rk,Player,Nation,Pos,Squad,Comp,0,0,90.0,0,0,3,3,3,Tkl,0,0.0,0,0,0,0,0,0,0,0,0,2021-2022,0.0,0.0
951,Kévin Gameiro,FRA,FW,Strasbourg,Ligue 1,34,1987,26.5,19,10,5,9,5,6,18,33.3,12,22,1,21,6,25,1,0,0,2021-2022,0.22641509433962265,0.7169811320754716
952,Idrissa Gana Gueye,SEN,MF,Paris S-G,Ligue 1,31,1989,18.2,60,36,24,24,12,18,44,40.9,26,23,4,19,24,84,13,0,0,2021-2022,1.3186813186813187,3.296703296703297
953,Ignatius Ganago,CMR,FW,Lens,Ligue 1,22,1999,11.4,3,2,1,2,0,2,6,33.3,4,4,0,4,2,5,3,0,0,2021-2022,0.17543859649122806,0.2631578947368421
954,Silvère Ganvoula M'Boussy,CGO,FW,Bochum,Bundesliga,25,1996,1.7,0,0,0,0,0,0,1,0.0,1,0,0,0,0,0,1,0,0,2021-2022,0.0,0.0
955,Álvaro García,ESP,"FW,MF",Rayo Vallecano,La Liga,28,1992,33.3,42,23,15,18,9,8,35,22.9,27,27,3,24,42,84,24,0,0,2021-2022,1.2612612612612615,1.2612612612612615
956,Dani García,ESP,MF,Athletic Club,La Liga,31,1990,24.2,36,22,15,17,4,14,47,29.8,33,27,10,17,24,60,41,1,0,2021-2022,0.9917355371900827,1.4876033057851241
957,David García,ESP,DF,Osasuna,La Liga,27,1994,34.5,28,14,15,11,2,12,22,54.5,10,27,21,6,52,80,168,0,0,2021-2022,1.5072463768115942,0.8115942028985508
958,Eric García,ESP,DF,Barcelona,La Liga,20,2001,22.7,27,18,13,13,1,11,26,42.3,15,22,12,10,44,71,53,3,0,2021-2022,1.9383259911894273,1.1894273127753305
959,Fran Garcia,ESP,DF,Rayo Vallecano,La Liga,21,1999,33.6,60,35,44,12,4,39,73,53.4,34,34,8,26,45,105,53,0,0,2021-2022,1.3392857142857142,1.7857142857142856
960,Joan García,ESP,GK,Espanyol,La Liga,20,2001,1.2,0,0,0,0,0,0,0,0.0,0,0,0,0,1,1,1,2,0,2021-2022,0.8333333333333334,0.0
961,Manu García,ESP,MF,Alavés,La Liga,23,1998,12.0,18,9,6,9,3,9,27,33.3,18,8,2,6,13,31,4,0,0,2021-2022,1.0833333333333333,1.5
962,Raúl García,ESP,FW,Athletic Club,La Liga,35,1986,20.0,27,17,6,11,10,8,36,22.2,28,30,4,26,9,36,21,0,0,2021-2022,0.45,1.35
963,Rubén García,ESP,"MF,FW",Osasuna,La Liga,28,1993,26.4,43,26,12,23,8,16,49,32.7,33,31,4,27,24,67,16,0,0,2021-2022,0.9090909090909092,1.628787878787879
964,Saúl García,ESP,MF,Alavés,La Liga,26,1994,0.0,1,1,1,0,0,0,0,0.0,0,0,0,0,0,1,0,0,0,2021-2022,,inf
965,Unai García,ESP,DF,Osasuna,La Liga,29,1992,15.6,21,12,14,6,1,14,17,82.4,3,19,11,8,22,43,78,0,0,2021-2022,1.4102564102564104,1.3461538461538463
966,Alejandro Garnacho,ARG,"FW,MF",Manchester Utd,Premier League,17,2004,0.1,0,0,0,0,0,0,1,0.0,1,0,0,0,0,0,0,0,0,2021-2022,0.0,0.0
967,Mario Gaspar,ESP,DF,Villarreal,La Liga,30,1990,6.9,10,4,2,5,3,6,10,60.0,4,6,3,3,6,16,15,0,0,2021-2022,0.8695652173913043,1.4492753623188406
968,Djeidi Gassama,FRA,FW,Paris S-G,Ligue 1,17,2003,0.0,0,0,0,0,0,0,0,0.0,0,1,1,0,0,0,0,0,0,2021-2022,,
969,Johan Gastien,FRA,MF,Clermont Foot,Ligue 1,33,1988,30.5,56,34,26,25,5,27,74,36.5,47,45,11,34,53,109,49,1,0,2021-2022,1.7377049180327868,1.8360655737704918
970,Gavi,ESP,"MF,FW",Barcelona,La Liga,16,2004,25.7,38,18,13,18,7,9,33,27.3,24,36,0,36,25,63,13,0,0,2021-2022,0.9727626459143969,1.4785992217898833
971,Dwight Gayle,ENG,"FW,DF",Newcastle Utd,Premier League,30,1990,0.4,1,0,0,1,0,0,1,0.0,1,0,0,0,1,2,0,0,0,2021-2022,2.5,2.5
972,Jean-Philippe Gbamin,CIV,MF,Everton,Premier League,25,1995,0.7,1,1,1,0,0,0,2,0.0,2,0,0,0,1,2,1,0,0,2021-2022,1.4285714285714286,1.4285714285714286
973,David de Gea,ESP,GK,Manchester Utd,Premier League,30,1990,38.0,0,0,0,0,0,0,0,0.0,0,0,0,0,0,0,11,2,0,2021-2022,0.0,0.0
974,Linus Gechter,GER,DF,Hertha BSC,Bundesliga,17,2004,8.0,15,8,13,2,0,7,14,50.0,7,12,7,5,11,26,29,0,0,2021-2022,1.375,1.875
975,Dennis Geiger,GER,MF,Hoffenheim,Bundesliga,23,1998,15.3,34,23,9,20,5,17,30,56.7,13,15,1,14,14,48,7,1,0,2021-2022,0.9150326797385621,2.2222222222222223
Rk,Player,Nation,Pos,Squad,Comp,0,0,90.0,0,0,3,3,3,Tkl,0,0.0,0,0,0,0,0,0,0,0,0,2021-2022,0.0,0.0
976,Joe Gelhardt,ENG,"FW,MF",Leeds United,Premier League,19,2002,8.3,4,3,1,0,3,2,10,20.0,8,9,0,9,0,4,3,0,0,2021-2022,0.0,0.48192771084337344
977,Luca Gemello,ITA,GK,Torino,Serie A,21,2000,1.0,0,0,0,0,0,0,0,0.0,0,0,0,0,0,0,0,0,0,2021-2022,0.0,0.0
978,Yannick Gerhardt,GER,"MF,DF",Wolfsburg,Bundesliga,27,1994,17.5,42,20,18,17,7,22,36,61.1,14,24,1,23,25,67,25,1,0,2021-2022,1.4285714285714286,2.4
979,Valère Germain,FRA,FW,Montpellier,Ligue 1,31,1990,21.9,23,14,6,11,6,8,31,25.8,23,13,1,12,9,32,27,0,0,2021-2022,0.4109589041095891,1.0502283105022832
980,Gerson,BRA,"MF,FW",Marseille,Ligue 1,24,1997,28.3,42,17,16,20,6,8,35,22.9,27,26,4,22,16,58,16,2,0,2021-2022,0.5653710247349824,1.4840989399293285
981,Willem Geubbels,FRA,"FW,MF",Nantes,Ligue 1,19,2001,6.0,8,5,4,2,2,5,12,41.7,7,5,0,5,6,14,5,0,0,2021-2022,1.0,1.3333333333333333
982,Hamadi Al Ghaddioui,MAR,FW,Stuttgart,Bundesliga,30,1990,5.5,5,4,2,1,2,0,4,0.0,4,3,1,2,0,5,4,0,0,2021-2022,0.0,0.9090909090909091
983,Ismaël Gharbi,ESP,FW,Paris S-G,Ligue 1,17,2004,0.0,0,0,0,0,0,0,0,0.0,0,0,0,0,0,0,0,0,0,2021-2022,,
984,Anwar El Ghazi,NED,"FW,MF",Aston Villa,Premier League,26,1995,4.3,4,4,2,2,0,2,7,28.6,5,6,0,6,1,5,2,0,0,2021-2022,0.23255813953488372,0.9302325581395349
985,Anwar El Ghazi,NED,"FW,MF",Everton,Premier League,26,1995,0.1,1,1,1,0,0,1,1,100.0,0,3,0,3,0,1,0,0,0,2021-2022,0.0,10.0
986,Lamine Ghezali,FRA,DF,Saint-Étienne,Ligue 1,22,1999,0.0,0,0,0,0,0,0,0,0.0,0,1,0,1,0,0,0,0,0,2021-2022,,
987,Paolo Ghiglione,ITA,DF,Genoa,Serie A,24,1997,6.7,17,12,8,6,3,9,14,64.3,5,11,5,6,10,27,12,1,0,2021-2022,1.4925373134328357,2.5373134328358207
988,Saman Ghoddos,IRN,"MF,DF",Brentford,Premier League,27,1993,6.0,17,10,8,6,3,9,15,60.0,6,2,0,2,3,20,16,0,0,2021-2022,0.5,2.8333333333333335
989,Faouzi Ghoulam,ALG,DF,Napoli,Serie A,30,1991,3.7,3,1,1,2,0,0,3,0.0,3,2,1,1,3,6,10,0,0,2021-2022,0.8108108108108107,0.8108108108108107
990,Dimitris Giannoulis,GRE,DF,Norwich City,Premier League,25,1995,13.0,36,21,17,17,2,24,36,66.7,12,22,6,16,19,55,41,1,0,2021-2022,1.4615384615384615,2.769230769230769
991,Morgan Gibbs-White,ENG,"DF,FW",Wolves,Premier League,21,2000,0.1,0,0,0,0,0,0,0,0.0,0,1,0,1,0,0,0,0,0,2021-2022,0.0,0.0
992,Ben Gibson,ENG,DF,Norwich City,Premier League,28,1993,27.7,23,16,17,6,0,7,12,58.3,5,36,30,6,27,50,139,2,0,2021-2022,0.9747292418772563,0.8303249097472925
993,Niko Gießelmann,GER,"DF,FW",Union Berlin,Bundesliga,29,1991,23.1,24,17,10,11,3,15,38,39.5,23,26,4,22,18,42,29,1,0,2021-2022,0.7792207792207791,1.0389610389610389
994,Rafał Gikiewicz,POL,GK,Augsburg,Bundesliga,33,1987,34.0,2,0,2,0,0,2,7,28.6,5,0,0,0,3,5,11,5,0,2021-2022,0.08823529411764706,0.058823529411764705
995,Bryan Gil,ESP,"FW,MF",Tottenham,Premier League,20,2001,1.0,3,0,1,0,2,1,2,50.0,1,2,0,2,0,3,0,0,0,2021-2022,0.0,3.0
996,Bryan Gil,ESP,"MF,FW",Valencia,La Liga,20,2001,8.4,13,8,6,3,4,2,13,15.4,11,13,0,13,1,14,4,0,0,2021-2022,0.11904761904761904,1.5476190476190474
997,Óscar Gil,ESP,DF,Espanyol,La Liga,24,1997,18.8,52,35,27,20,5,25,46,54.3,21,33,9,24,19,71,33,2,0,2021-2022,1.0106382978723405,2.7659574468085104
998,Mario Gila,ESP,DF,Real Madrid,La Liga,20,2000,0.3,1,0,1,0,0,0,1,0.0,1,0,0,0,1,2,1,0,0,2021-2022,3.3333333333333335,3.3333333333333335
999,Billy Gilmour,SCO,MF,Norwich City,Premier League,20,2001,20.6,41,21,16,21,4,14,52,26.9,38,21,4,17,17,58,29,0,0,2021-2022,0.8252427184466019,1.9902912621359221
1000,Daniel Ginczek,GER,"MF,FW",Wolfsburg,Bundesliga,30,1991,0.1,0,0,0,0,0,0,0,0.0,0,0,0,0,0,0,0,0,0,2021-2022,0.0,0.0
Rk,Player,Nation,Pos,Squad,Comp,0,0,90.0,0,0,3,3,3,Tkl,0,0.0,0,0,0,0,0,0,0,0,0,2021-2022,0.0,0.0
1001,Matthias Ginter,GER,DF,Gladbach,Bundesliga,27,1994,26.2,36,22,20,13,3,27,40,67.5,13,21,10,11,33,69,76,0,0,2021-2022,1.2595419847328244,1.3740458015267176
1002,Nicholas Gioacchini,USA,"FW,MF",Montpellier,Ligue 1,21,2000,5.5,7,5,3,2,2,4,10,40.0,6,8,0,8,4,11,5,0,0,2021-2022,0.7272727272727273,1.2727272727272727
1003,Sebastian Giovinco,ITA,MF,Sampdoria,Serie A,34,1987,0.4,0,0,0,0,0,0,1,0.0,1,0,0,0,0,0,0,0,0,2021-2022,0.0,0.0
1004,Jimmy Giraudon,FRA,DF,Troyes,Ligue 1,29,1992,18.0,14,6,10,4,0,7,22,31.8,15,24,14,10,37,51,68,1,0,2021-2022,2.0555555555555554,0.7777777777777778
1005,Andrei Girotto,BRA,"DF,MF",Nantes,Ligue 1,29,1992,35.0,85,52,49,32,4,52,103,50.5,51,67,33,34,69,154,143,0,0,2021-2022,1.9714285714285715,2.4285714285714284
1006,Olivier Giroud,FRA,FW,Milan,Serie A,34,1986,21.0,15,11,4,6,5,3,17,17.6,14,13,4,9,3,18,19,0,0,2021-2022,0.14285714285714285,0.7142857142857143
1007,Jamie Gittens,ENG,FW,Dortmund,Bundesliga,16,2004,1.5,3,2,0,2,1,2,5,40.0,3,4,1,3,1,4,1,0,0,2021-2022,0.6666666666666666,2.0
1008,Serge Gnabry,GER,"FW,DF",Bayern Munich,Bundesliga,26,1995,24.3,47,31,16,20,11,22,57,38.6,35,26,0,26,14,61,3,0,0,2021-2022,0.5761316872427983,1.934156378600823
1009,Ben Godfrey,ENG,DF,Everton,Premier League,23,1998,22.5,47,32,29,14,4,24,39,61.5,15,41,19,22,15,62,100,2,0,2021-2022,0.6666666666666666,2.088888888888889
1010,Diego Godín,URU,DF,Cagliari,Serie A,35,1986,9.1,18,7,13,3,2,10,15,66.7,5,7,5,2,13,31,46,0,0,2021-2022,1.4285714285714286,1.978021978021978
1011,Edoardo Goldaniga,ITA,DF,Cagliari,Serie A,27,1993,10.4,12,5,7,5,0,4,11,36.4,7,8,5,3,22,34,23,0,0,2021-2022,2.1153846153846154,1.1538461538461537
1012,Edoardo Goldaniga,ITA,"DF,MF",Sassuolo,Serie A,27,1993,0.0,0,0,0,0,0,0,0,0.0,0,0,0,0,0,0,0,0,0,2021-2022,,
1013,Aleksandr Golovin,RUS,"FW,MF",Monaco,Ligue 1,25,1996,16.7,40,22,10,18,12,18,41,43.9,23,26,1,25,12,52,8,0,0,2021-2022,0.718562874251497,2.3952095808383236
1014,André Gomes,POR,MF,Everton,Premier League,28,1993,6.9,16,4,6,6,4,8,32,25.0,24,8,2,6,1,17,7,1,0,2021-2022,0.14492753623188406,2.318840579710145
1015,Angel Gomes,ENG,"MF,FW",Lille,Ligue 1,20,2000,10.6,23,13,6,12,5,10,15,66.7,5,4,0,4,3,26,4,0,0,2021-2022,0.2830188679245283,2.169811320754717
1016,Toti Gomes,POR,DF,Wolves,Premier League,22,1999,4.0,11,7,10,1,0,7,9,77.8,2,6,3,3,8,19,15,0,0,2021-2022,2.0,2.75
1017,Dani Gómez,ESP,FW,Levante,La Liga,23,1998,11.8,7,4,3,2,2,4,12,33.3,8,3,0,3,3,10,5,0,0,2021-2022,0.2542372881355932,0.5932203389830508
1018,Joe Gomez,ENG,DF,Liverpool,Premier League,24,1997,3.7,10,6,5,2,3,5,9,55.6,4,4,1,3,5,15,6,0,0,2021-2022,1.3513513513513513,2.7027027027027026
1019,Maxi Gómez,URU,FW,Valencia,La Liga,24,1996,21.7,5,3,1,2,2,5,8,62.5,3,5,1,4,3,8,22,0,0,2021-2022,0.1382488479262673,0.2304147465437788
1020,Moi Gómez,ESP,"MF,FW",Villarreal,La Liga,27,1994,14.3,15,7,8,3,4,5,17,29.4,12,5,0,5,6,21,6,0,0,2021-2022,0.4195804195804196,1.048951048951049
1021,Papu Gómez,ARG,"FW,MF",Sevilla,La Liga,33,1988,19.8,19,11,9,5,5,9,35,25.7,26,15,2,13,7,26,12,2,0,2021-2022,0.35353535353535354,0.9595959595959596
1022,Sergi Gómez,ESP,DF,Espanyol,La Liga,29,1992,30.2,33,24,29,3,1,18,27,66.7,9,33,23,10,40,73,125,2,0,2021-2022,1.3245033112582782,1.0927152317880795
1023,Victor Gomez,ESP,DF,Espanyol,La Liga,21,2000,0.0,0,0,0,0,0,0,0,0.0,0,0,0,0,0,0,0,0,0,2021-2022,,
1024,Alfred Gomis,SEN,GK,Rennes,Ligue 1,27,1993,25.0,1,0,1,0,0,1,2,50.0,1,0,0,0,1,2,8,2,0,2021-2022,0.04,0.04
1025,Maxime Gonalons,FRA,MF,Granada,La Liga,32,1989,17.2,43,28,17,22,4,14,39,35.9,25,33,10,23,18,61,29,0,0,2021-2022,1.0465116279069768,2.5
Rk,Player,Nation,Pos,Squad,Comp,0,0,90.0,0,0,3,3,3,Tkl,0,0.0,0,0,0,0,0,0,0,0,0,2021-2022,0.0,0.0
1026,Vagner Gonçalves,CPV,FW,Metz,Ligue 1,25,1996,1.0,2,1,0,2,0,1,1,100.0,0,0,0,0,1,3,0,0,0,2021-2022,1.0,2.0
1027,Cedric Gondo,CIV,FW,Salernitana,Serie A,24,1996,7.8,5,2,2,2,1,2,5,40.0,3,2,0,2,3,8,2,0,0,2021-2022,0.38461538461538464,0.6410256410256411
1028,Álvaro González,ESP,DF,Marseille,Ligue 1,31,1990,5.0,1,1,1,0,0,1,1,100.0,0,0,0,0,1,2,9,0,0,2021-2022,0.2,0.2
1029,Diego González,ESP,DF,Elche,La Liga,26,1995,19.9,25,16,18,7,0,9,16,56.3,7,21,13,8,19,44,87,0,0,2021-2022,0.9547738693467337,1.256281407035176
1030,Édgar González,ESP,DF,Betis,La Liga,24,1997,16.3,25,19,15,8,2,17,24,70.8,7,17,11,6,23,48,82,0,0,2021-2022,1.411042944785276,1.5337423312883436
1031,Giovanni González,URU,DF,Mallorca,La Liga,26,1994,4.1,9,3,4,4,1,3,5,60.0,2,7,2,5,4,13,14,0,0,2021-2022,0.9756097560975611,2.1951219512195124
1032,Nicolás González,ARG,FW,Fiorentina,Serie A,23,1998,26.2,21,16,6,8,7,9,28,32.1,19,26,2,24,21,42,4,1,0,2021-2022,0.8015267175572519,0.8015267175572519
1033,Nicolás González,ESP,MF,Barcelona,La Liga,19,2002,12.4,31,20,5,23,3,11,27,40.7,16,12,0,12,6,37,12,0,0,2021-2022,0.48387096774193544,2.5
1034,Roberto González,ESP,"FW,MF",Betis,La Liga,20,2001,1.5,5,4,3,2,0,4,6,66.7,2,5,0,5,1,6,1,0,0,2021-2022,0.6666666666666666,3.3333333333333335
1035,Charlie Goode,ENG,DF,Brentford,Premier League,25,1995,5.0,7,5,5,2,0,4,4,100.0,0,4,2,2,2,9,8,0,0,2021-2022,0.4,1.4
1036,Anthony Gordon,ENG,"MF,FW",Everton,Premier League,20,2001,25.4,54,32,20,30,4,21,59,35.6,38,49,3,46,22,76,17,0,0,2021-2022,0.8661417322834646,2.125984251968504
1037,Kaide Gordon,ENG,FW,Liverpool,Premier League,16,2004,0.1,1,0,0,0,1,0,0,0.0,0,0,0,0,0,1,0,0,0,2021-2022,0.0,10.0
1038,Leon Goretzka,GER,MF,Bayern Munich,Bundesliga,26,1995,15.5,25,15,12,9,4,11,26,42.3,15,11,1,10,17,42,23,2,0,2021-2022,1.096774193548387,1.6129032258064515
1039,Gori,ESP,MF,Espanyol,La Liga,19,2002,0.1,0,0,0,0,0,0,0,0.0,0,2,0,2,0,0,0,0,0,2021-2022,0.0,0.0
1040,Andoni Gorosabel,ESP,DF,Real Sociedad,La Liga,24,1996,25.4,47,31,32,9,6,25,47,53.2,22,16,3,13,18,65,49,0,0,2021-2022,0.7086614173228347,1.8503937007874016
1041,Robin Gosens,GER,DF,Atalanta,Serie A,27,1994,5.1,7,3,3,4,0,4,8,50.0,4,4,0,4,9,16,1,0,0,2021-2022,1.7647058823529413,1.3725490196078431
1042,Robin Gosens,GER,DF,Inter,Serie A,27,1994,1.9,3,1,1,2,0,0,0,0.0,0,5,2,3,3,6,3,0,0,2021-2022,1.5789473684210527,1.5789473684210527
1043,Dan Gosling,ENG,MF,Watford,Premier League,31,1990,1.8,2,1,1,1,0,2,6,33.3,4,2,0,2,0,2,3,0,0,2021-2022,0.0,1.1111111111111112
1044,Amine Gouiri,ALG,"FW,MF",Nice,Ligue 1,21,2000,30.6,22,13,2,13,7,10,32,31.3,22,22,5,17,11,33,17,1,0,2021-2022,0.35947712418300654,0.7189542483660131
1045,Lucas Gourna-Douath,FRA,MF,Saint-Étienne,Ligue 1,17,2003,20.0,45,26,22,18,5,21,36,58.3,15,22,3,19,13,58,9,2,0,2021-2022,0.65,2.25
1046,Jeffrey Gouweleeuw,NED,DF,Augsburg,Bundesliga,30,1991,28.6,50,27,33,17,0,22,36,61.1,14,35,18,17,49,99,116,0,0,2021-2022,1.7132867132867131,1.7482517482517481
1047,Jonathan Gradit,FRA,DF,Lens,Ligue 1,28,1992,34.1,60,28,24,28,8,25,45,55.6,20,39,27,12,65,125,106,0,0,2021-2022,1.9061583577712609,1.7595307917888563
1048,Jens Grahl,GER,GK,Eint Frankfurt,Bundesliga,32,1988,1.0,0,0,0,0,0,0,0,0.0,0,0,0,0,0,0,1,0,0,2021-2022,0.0,0.0
1049,Alberto Grassi,ITA,MF,Cagliari,Serie A,26,1995,24.2,47,26,13,30,4,16,38,42.1,22,27,9,18,63,110,33,1,0,2021-2022,2.603305785123967,1.9421487603305785
1050,Jaume Grau,ESP,MF,Osasuna,La Liga,24,1997,0.0,1,1,1,0,0,0,1,0.0,1,0,0,0,0,1,0,0,0,2021-2022,,inf
Rk,Player,Nation,Pos,Squad,Comp,0,0,90.0,0,0,3,3,3,Tkl,0,0.0,0,0,0,0,0,0,0,0,0,2021-2022,0.0,0.0
1051,Andrew Gravillon,GLP,DF,Reims,Ligue 1,23,1998,23.7,32,24,19,13,0,17,27,63.0,10,25,15,10,33,65,83,1,0,2021-2022,1.3924050632911393,1.350210970464135
1052,Demarai Gray,JAM,"MF,FW",Everton,Premier League,25,1996,26.0,30,19,13,10,7,10,22,45.5,12,30,2,28,15,45,21,1,0,2021-2022,0.5769230769230769,1.1538461538461537
1053,Adrian Grbić,AUT,"FW,MF",Lorient,Ligue 1,24,1996,5.8,2,1,0,2,0,2,6,33.3,4,3,1,2,0,2,7,0,0,2021-2022,0.0,0.3448275862068966
1054,Ivo Grbić,CRO,GK,Lille,Ligue 1,25,1996,21.0,0,0,0,0,0,0,0,0.0,0,0,0,0,0,0,14,1,0,2021-2022,0.0,0.0
1055,Jack Grealish,ENG,FW,Manchester City,Premier League,25,1995,21.3,18,17,4,10,4,5,13,38.5,8,11,1,10,8,26,7,0,0,2021-2022,0.3755868544600939,0.8450704225352113
1056,Etienne Green,ENG,GK,Saint-Étienne,Ligue 1,21,2000,13.3,1,1,1,0,0,0,0,0.0,0,0,0,0,1,2,9,0,0,2021-2022,0.07518796992481203,0.07518796992481203
1057,Julian Green,USA,MF,Greuther Fürth,Bundesliga,26,1995,11.7,9,5,0,8,1,2,8,25.0,6,10,2,8,7,16,10,0,0,2021-2022,0.5982905982905983,0.7692307692307693
1058,Mason Greenwood,ENG,"FW,MF",Manchester Utd,Premier League,19,2001,14.1,15,9,9,1,5,3,9,33.3,6,5,0,5,1,16,6,0,0,2021-2022,0.07092198581560284,1.0638297872340425
1059,Sam Greenwood,ENG,"MF,FW",Leeds United,Premier League,19,2002,2.6,8,5,0,5,3,4,7,57.1,3,3,0,3,2,10,1,0,0,2021-2022,0.7692307692307692,3.0769230769230766
1060,Michael Gregoritsch,AUT,"FW,MF",Augsburg,Bundesliga,27,1994,15.5,19,8,4,10,5,2,15,13.3,13,18,2,16,6,25,29,0,0,2021-2022,0.3870967741935484,1.2258064516129032
1061,Dominik Greif,SVK,GK,Mallorca,La Liga,24,1997,1.0,0,0,0,0,0,0,0,0.0,0,0,0,0,0,0,0,0,0,2021-2022,0.0,0.0
1062,Clément Grenier,FRA,MF,Mallorca,La Liga,30,1991,0.7,0,0,0,0,0,0,0,0.0,0,1,1,0,0,0,1,0,0,2021-2022,0.0,0.0
1063,Sebastian Griesbeck,GER,"DF,MF",Greuther Fürth,Bundesliga,30,1990,27.1,60,31,38,19,3,39,62,62.9,23,38,13,25,43,103,100,1,0,2021-2022,1.5867158671586714,2.214022140221402
1064,Sebastian Griesbeck,GER,MF,Union Berlin,Bundesliga,30,1990,0.1,1,1,0,1,0,1,1,100.0,0,0,0,0,0,1,0,0,0,2021-2022,0.0,10.0
1065,Antoine Griezmann,FRA,FW,Barcelona,La Liga,30,1991,2.9,13,5,3,10,0,2,6,33.3,4,4,0,4,3,16,5,0,0,2021-2022,1.0344827586206897,4.482758620689656
1066,Antoine Griezmann,FRA,"FW,MF",Atlético Madrid,La Liga,30,1991,18.8,30,14,11,15,4,12,32,37.5,20,18,1,17,7,37,18,0,0,2021-2022,0.3723404255319149,1.5957446808510638
1067,Vincenzo Grifo,ITA,"MF,FW",Freiburg,Bundesliga,28,1993,30.8,27,15,9,13,5,9,26,34.6,17,12,2,10,13,40,28,0,0,2021-2022,0.42207792207792205,0.8766233766233766
1068,Lennart Grill,GER,GK,Leverkusen,Bundesliga,22,1999,1.0,0,0,0,0,0,0,0,0.0,0,0,0,0,0,0,0,0,0,2021-2022,0.0,0.0
1069,Florian Grillitsch,AUT,"DF,MF",Hoffenheim,Bundesliga,25,1995,16.6,37,19,15,21,1,17,31,54.8,14,18,7,11,29,66,36,1,0,2021-2022,1.7469879518072287,2.228915662650602
1070,Pascal Groß,GER,"MF,DF",Brighton,Premier League,30,1991,22.6,28,15,15,11,2,12,33,36.4,21,34,8,26,18,46,23,0,0,2021-2022,0.7964601769911503,1.238938053097345
1071,Carlos Gruezo,ECU,MF,Augsburg,Bundesliga,26,1995,10.8,22,11,10,10,2,8,21,38.1,13,11,2,9,9,31,15,0,0,2021-2022,0.8333333333333333,2.0370370370370368
1072,Vicente Guaita,ESP,GK,Crystal Palace,Premier League,34,1987,29.5,1,0,1,0,0,1,1,100.0,0,0,0,0,1,2,8,1,0,2021-2022,0.03389830508474576,0.03389830508474576
1073,Andrés Guardado,MEX,MF,Betis,La Liga,34,1986,15.5,30,13,12,17,1,13,34,38.2,21,18,4,14,21,51,29,1,0,2021-2022,1.3548387096774193,1.935483870967742
1074,Sergi Guardiola,ESP,FW,Rayo Vallecano,La Liga,30,1991,19.0,10,9,3,5,2,1,21,4.8,20,14,2,12,4,14,17,0,0,2021-2022,0.21052631578947367,0.5263157894736842
1075,Nemanja Gudelj,SRB,"DF,MF",Sevilla,La Liga,29,1991,11.6,16,7,10,4,2,5,8,62.5,3,14,9,5,22,38,37,0,0,2021-2022,1.896551724137931,1.3793103448275863
Rk,Player,Nation,Pos,Squad,Comp,0,0,90.0,0,0,3,3,3,Tkl,0,0.0,0,0,0,0,0,0,0,0,0,2021-2022,0.0,0.0
1076,Gabriel Gudmundsson,SWE,"DF,MF",Lille,Ligue 1,22,1999,14.9,43,31,24,16,3,17,35,48.6,18,15,3,12,20,63,13,0,0,2021-2022,1.342281879194631,2.8859060402684564
1077,Noah Guede-Nadje,FRA,MF,Angers,Ligue 1,17,2003,0.0,0,0,0,0,0,0,0,0.0,0,0,0,0,0,0,0,0,0,2021-2022,,
1078,Gonçalo Guedes,POR,"FW,MF",Valencia,La Liga,24,1996,29.0,21,14,6,7,8,2,22,9.1,20,14,0,14,9,30,1,0,0,2021-2022,0.3103448275862069,0.7241379310344828
1079,Marc Guéhi,ENG,DF,Crystal Palace,Premier League,21,2000,35.8,35,17,24,10,1,15,16,93.8,1,34,26,8,30,65,127,0,0,2021-2022,0.8379888268156426,0.9776536312849162
1080,Mattéo Guendouzi,FRA,MF,Marseille,Ligue 1,22,1999,35.0,45,30,10,26,9,13,47,27.7,34,15,1,14,16,61,18,0,0,2021-2022,0.45714285714285713,1.2857142857142858
1081,Yanis Guermouche,FRA,"MF,FW",Montpellier,Ligue 1,20,2001,0.1,2,1,0,1,1,1,1,100.0,0,0,0,0,0,2,0,0,0,2021-2022,0.0,20.0
1082,Raphaël Guerreiro,POR,DF,Dortmund,Bundesliga,27,1993,19.9,35,19,19,12,4,16,31,51.6,15,18,2,16,25,60,14,1,0,2021-2022,1.256281407035176,1.7587939698492463
1083,Evann Guessand,CIV,FW,Nice,Ligue 1,20,2001,4.9,9,8,2,5,2,3,8,37.5,5,4,0,4,0,9,1,0,0,2021-2022,0.0,1.8367346938775508
1084,Ander Guevara,ESP,MF,Real Sociedad,La Liga,24,1997,9.6,18,13,6,10,2,10,17,58.8,7,12,6,6,12,30,8,0,0,2021-2022,1.25,1.875
1085,Lamine Gueye,SEN,"FW,MF",Metz,Ligue 1,23,1998,6.2,5,5,1,1,3,3,7,42.9,4,4,0,4,6,11,1,0,0,2021-2022,0.9677419354838709,0.8064516129032258
1086,Pape Gueye,SEN,MF,Marseille,Ligue 1,22,1999,17.0,38,19,15,22,1,16,31,51.6,15,15,3,12,24,62,16,0,0,2021-2022,1.411764705882353,2.235294117647059
1087,John Guidetti,SWE,"FW,MF",Alavés,La Liga,29,1992,3.1,2,1,0,0,2,0,1,0.0,1,1,0,1,0,2,0,0,0,2021-2022,0.0,0.6451612903225806
1088,Josuha Guilavogui,FRA,"MF,DF",Bordeaux,Ligue 1,30,1990,14.8,39,16,18,17,4,14,29,48.3,15,16,8,8,36,75,23,0,0,2021-2022,2.4324324324324325,2.635135135135135
1089,Josuha Guilavogui,FRA,"MF,DF",Wolfsburg,Bundesliga,30,1990,10.5,23,14,13,9,1,7,18,38.9,11,11,6,5,25,48,42,0,0,2021-2022,2.380952380952381,2.1904761904761907
1090,Frederic Guilbert,FRA,DF,Strasbourg,Ligue 1,26,1994,28.0,69,39,33,24,12,32,62,51.6,30,37,11,26,55,124,39,0,0,2021-2022,1.9642857142857142,2.4642857142857144
1091,Hugo Guillamón,ESP,"MF,DF",Valencia,La Liga,21,2000,26.2,43,27,20,16,7,18,44,40.9,26,26,10,16,30,73,53,1,0,2021-2022,1.1450381679389314,1.6412213740458015
1092,Bruno Guimarães,BRA,MF,Newcastle Utd,Premier League,23,1997,11.5,44,23,18,22,4,21,38,55.3,17,25,6,19,9,53,13,0,0,2021-2022,0.782608695652174,3.8260869565217392
1093,Bruno Guimarães,BRA,MF,Lyon,Ligue 1,23,1997,18.2,50,31,20,25,5,23,59,39.0,36,21,4,17,21,71,11,1,0,2021-2022,1.153846153846154,2.7472527472527473
1094,Serhou Guirassy,GUI,FW,Rennes,Ligue 1,25,1996,11.3,4,2,1,2,1,1,7,14.3,6,4,0,4,1,5,8,0,0,2021-2022,0.08849557522123894,0.35398230088495575
1095,Péter Gulácsi,HUN,GK,RB Leipzig,Bundesliga,31,1990,33.0,0,0,0,0,0,0,0,0.0,0,0,0,0,1,1,15,1,0,2021-2022,0.030303030303030304,0.0
1096,Manuel Gulde,GER,DF,Freiburg,Bundesliga,30,1991,13.6,18,10,14,3,1,8,11,72.7,3,16,8,8,17,35,37,0,0,2021-2022,1.25,1.3235294117647058
1097,Gerard Gumbau,ESP,MF,Elche,La Liga,26,1994,21.0,46,19,22,19,5,22,51,43.1,29,18,4,14,23,69,25,0,0,2021-2022,1.0952380952380953,2.1904761904761907
1098,Robert Gumny,POL,DF,Augsburg,Bundesliga,23,1998,25.2,48,29,25,20,3,25,43,58.1,18,24,7,17,28,76,57,3,0,2021-2022,1.1111111111111112,1.9047619047619049
1099,İlkay Gündoğan,GER,MF,Manchester City,Premier League,30,1990,20.6,23,9,10,12,1,12,31,38.7,19,11,1,10,15,38,10,0,0,2021-2022,0.7281553398058251,1.116504854368932
1100,Angus Gunn,SCO,GK,Norwich City,Premier League,25,1996,9.0,0,0,0,0,0,0,0,0.0,0,0,0,0,0,0,11,0,0,2021-2022,0.0,0.0
Rk,Player,Nation,Pos,Squad,Comp,0,0,90.0,0,0,3,3,3,Tkl,0,0.0,0,0,0,0,0,0,0,0,0,2021-2022,0.0,0.0
1101,Christian Günter,GER,"DF,MF",Freiburg,Bundesliga,28,1993,34.0,34,20,16,15,3,18,50,36.0,32,23,6,17,17,51,49,2,0,2021-2022,0.5,1.0
1102,Koray Günter,GER,DF,Hellas Verona,Serie A,26,1994,26.8,32,18,19,11,2,16,32,50.0,16,27,21,6,69,101,110,1,0,2021-2022,2.574626865671642,1.1940298507462686
1103,Lasse Günther,GER,DF,Augsburg,Bundesliga,18,2003,1.8,8,5,4,3,1,5,9,55.6,4,0,0,0,2,10,2,0,0,2021-2022,1.1111111111111112,4.444444444444445
1104,Jon Guridi,ESP,MF,Real Sociedad,La Liga,26,1995,2.3,5,3,2,3,0,1,4,25.0,3,3,1,2,3,8,4,0,0,2021-2022,1.3043478260869565,2.173913043478261
1105,Malo Gusto,FRA,DF,Lyon,Ligue 1,18,2003,20.9,55,35,29,21,5,24,40,60.0,16,21,6,15,33,88,41,1,0,2021-2022,1.5789473684210527,2.6315789473684212
1106,Raúl Guti,ESP,MF,Elche,La Liga,24,1996,18.1,25,15,7,14,4,10,30,33.3,20,9,3,6,25,50,7,0,0,2021-2022,1.3812154696132595,1.3812154696132595
1107,Marcos Mauro López Gutiérrez,ARG,DF,Cádiz,La Liga,30,1991,1.5,1,0,0,1,0,0,2,0.0,2,2,1,1,1,2,9,0,0,2021-2022,0.6666666666666666,0.6666666666666666
1108,Miguel Gutiérrez,ESP,DF,Real Madrid,La Liga,20,2001,2.9,7,5,5,0,2,3,5,60.0,2,0,0,0,2,9,2,0,0,2021-2022,0.6896551724137931,2.413793103448276
1109,Albert Guðmundsson,ISL,"FW,MF",Genoa,Serie A,24,1997,6.7,5,3,2,1,2,3,8,37.5,5,2,0,2,5,10,4,0,0,2021-2022,0.7462686567164178,0.7462686567164178
1110,Joško Gvardiol,CRO,DF,RB Leipzig,Bundesliga,19,2002,26.8,47,31,28,17,2,22,39,56.4,17,30,11,19,51,98,62,2,0,2021-2022,1.9029850746268657,1.753731343283582
1111,Emmanuel Gyasi,GHA,"FW,MF",Spezia,Serie A,27,1994,33.7,47,30,31,9,7,21,41,51.2,20,22,4,18,16,63,43,1,0,2021-2022,0.4747774480712166,1.3946587537091988
1112,Norbert Gyömbér,SVK,DF,Salernitana,Serie A,29,1992,28.5,53,32,40,11,2,33,50,66.0,17,38,24,14,44,97,126,1,0,2021-2022,1.543859649122807,1.8596491228070176
1113,Erling Haaland,NOR,FW,Dortmund,Bundesliga,21,2000,21.2,2,1,0,1,1,0,1,0.0,1,8,1,7,1,3,31,0,0,2021-2022,0.04716981132075472,0.09433962264150944
1114,Nicolas Haas,SUI,MF,Empoli,Serie A,25,1996,11.1,35,22,15,10,10,17,39,43.6,22,24,4,20,9,44,17,1,0,2021-2022,0.8108108108108109,3.1531531531531534
1115,Janik Haberer,GER,MF,Freiburg,Bundesliga,27,1994,9.1,14,8,5,6,3,7,19,36.8,12,11,4,7,16,30,11,0,0,2021-2022,1.7582417582417582,1.5384615384615385
1116,Alexander Hack,GER,DF,Mainz 05,Bundesliga,27,1993,23.0,52,26,35,17,0,29,46,63.0,17,31,14,17,51,103,95,1,0,2021-2022,2.217391304347826,2.260869565217391
1117,Robin Hack,GER,"FW,MF",Arminia,Bundesliga,22,1998,15.2,14,8,6,5,3,3,21,14.3,18,18,1,17,5,19,4,0,0,2021-2022,0.32894736842105265,0.9210526315789475
1118,Munir El Haddadi,MAR,"FW,MF",Sevilla,La Liga,25,1995,5.3,8,4,1,6,1,2,8,25.0,6,7,1,6,5,13,2,0,0,2021-2022,0.9433962264150944,1.509433962264151
1119,André Hahn,GER,"MF,FW",Augsburg,Bundesliga,30,1990,23.3,36,20,9,15,12,17,50,34.0,33,38,5,33,15,51,43,0,0,2021-2022,0.6437768240343348,1.5450643776824033
1120,Amadou Haidara,MLI,MF,RB Leipzig,Bundesliga,23,1998,14.7,30,14,11,19,0,17,37,45.9,20,22,6,16,16,46,8,1,0,2021-2022,1.08843537414966,2.0408163265306123
1121,Massadio Haïdara,MLI,DF,Lens,Ligue 1,28,1992,12.0,28,21,18,7,3,15,24,62.5,9,18,4,14,22,50,31,0,0,2021-2022,1.8333333333333333,2.3333333333333335
1122,Oualid El Hajjam,MAR,DF,Troyes,Ligue 1,30,1991,11.9,22,11,12,6,4,15,23,65.2,8,12,6,6,22,44,28,0,0,2021-2022,1.8487394957983192,1.8487394957983192
1123,Achraf Hakimi,MAR,DF,Paris S-G,Ligue 1,22,1998,27.5,74,51,38,27,9,40,72,55.6,32,26,5,21,28,102,23,2,0,2021-2022,1.018181818181818,2.690909090909091
1124,Marcel Halstenberg,GER,DF,RB Leipzig,Bundesliga,29,1991,5.6,10,7,6,4,0,6,11,54.5,5,6,0,6,7,17,11,0,0,2021-2022,1.25,1.7857142857142858
1125,Pierre-Yves Hamel,FRA,"FW,MF",Lorient,Ligue 1,27,1994,0.3,0,0,0,0,0,0,1,0.0,1,0,0,0,2,2,0,0,0,2021-2022,6.666666666666667,0.0
Rk,Player,Nation,Pos,Squad,Comp,0,0,90.0,0,0,3,3,3,Tkl,0,0.0,0,0,0,0,0,0,0,0,0,2021-2022,0.0,0.0
1126,Pierre-Yves Hamel,FRA,FW,Clermont Foot,Ligue 1,27,1994,5.8,11,6,0,5,6,5,6,83.3,1,2,1,1,0,11,0,0,0,2021-2022,0.0,1.896551724137931
1127,Romain Hamouma,FRA,"FW,MF",Saint-Étienne,Ligue 1,34,1987,9.8,10,7,1,5,4,2,13,15.4,11,8,0,8,4,14,1,0,0,2021-2022,0.4081632653061224,1.0204081632653061
1128,Samir Handanović,SVN,GK,Inter,Serie A,37,1984,37.0,1,0,1,0,0,1,2,50.0,1,1,0,1,0,1,6,3,0,2021-2022,0.0,0.02702702702702703
1129,Grant Hanley,SCO,DF,Norwich City,Premier League,29,1991,32.2,44,25,28,14,2,18,35,51.4,17,56,45,11,56,100,176,2,0,2021-2022,1.7391304347826086,1.3664596273291925
1130,Ridgeciano Haps,SUR,DF,Venezia,Serie A,28,1993,22.8,36,20,26,4,6,11,21,52.4,10,34,12,22,29,65,57,1,0,2021-2022,1.2719298245614035,1.5789473684210527
1131,Genki Haraguchi,JPN,MF,Union Berlin,Bundesliga,30,1991,19.5,37,20,12,22,3,15,48,31.3,33,25,3,22,26,63,15,0,0,2021-2022,1.3333333333333333,1.8974358974358974
1132,Amine Harit,MAR,"FW,MF",Marseille,Ligue 1,24,1997,12.9,18,11,9,9,0,9,17,52.9,8,10,0,10,4,22,2,0,0,2021-2022,0.31007751937984496,1.3953488372093024
1133,Varazdat Haroyan,ARM,DF,Cádiz,La Liga,28,1992,16.0,31,21,20,10,1,19,29,65.5,10,22,12,10,15,46,62,0,0,2021-2022,0.9375,1.9375
1134,Jack Harrison,ENG,"FW,MF",Leeds United,Premier League,24,1996,29.3,57,37,22,22,13,31,76,40.8,45,35,1,34,21,78,19,0,0,2021-2022,0.7167235494880546,1.9453924914675766
1135,Abdou Harroui,NED,MF,Sassuolo,Serie A,23,1998,5.0,11,4,4,7,0,8,11,72.7,3,14,0,14,4,15,5,0,0,2021-2022,0.8,2.2
1136,Luis Hartwig,GER,FW,Bochum,Bundesliga,18,2002,0.0,0,0,0,0,0,0,0,0.0,0,0,0,0,0,0,0,0,0,2021-2022,,
1137,Makoto Hasebe,JPN,DF,Eint Frankfurt,Bundesliga,37,1984,13.2,27,12,15,11,1,13,29,44.8,16,24,8,16,22,49,36,0,0,2021-2022,1.6666666666666667,2.0454545454545454
1138,Hans Hateboer,NED,"DF,MF",Atalanta,Serie A,27,1994,15.4,22,14,10,8,4,11,26,42.3,15,11,1,10,7,29,20,0,0,2021-2022,0.45454545454545453,1.4285714285714286
1139,Kortney Hause,ENG,DF,Aston Villa,Premier League,26,1995,4.4,3,3,2,0,1,3,4,75.0,1,8,5,3,6,9,13,0,0,2021-2022,1.3636363636363635,0.6818181818181818
1140,Kai Havertz,GER,"FW,MF",Chelsea,Premier League,22,1999,20.1,17,8,5,7,5,4,14,28.6,10,28,1,27,4,21,32,1,0,2021-2022,0.1990049751243781,0.8457711442786069
1141,Isaac Hayden,ENG,"MF,DF",Newcastle Utd,Premier League,26,1995,11.1,28,14,11,14,3,12,29,41.4,17,17,8,9,14,42,24,0,0,2021-2022,1.2612612612612613,2.5225225225225225
1142,Eden Hazard,BEL,"FW,MF",Real Madrid,La Liga,30,1991,8.0,6,3,3,2,1,3,7,42.9,4,3,0,3,2,8,0,0,0,2021-2022,0.25,0.75
1143,Thorgan Hazard,BEL,"FW,DF",Dortmund,Bundesliga,28,1993,14.9,23,13,8,10,5,15,40,37.5,25,23,1,22,6,29,4,0,0,2021-2022,0.40268456375838924,1.5436241610738255
1144,Jonas Hector,GER,DF,Köln,Bundesliga,31,1990,28.4,76,39,36,26,14,29,74,39.2,45,59,8,51,50,126,68,1,0,2021-2022,1.7605633802816902,2.676056338028169
1145,Hwang Hee-chan,KOR,"FW,MF",Wolves,Premier League,25,1996,20.2,27,13,9,16,2,14,44,31.8,30,10,0,10,13,40,7,1,0,2021-2022,0.6435643564356436,1.3366336633663367
1146,Hwang Hee-chan,KOR,FW,RB Leipzig,Bundesliga,25,1996,0.5,0,0,0,0,0,0,0,0.0,0,0,0,0,1,1,0,0,0,2021-2022,2.0,0.0
1147,Silvan Hefti,SUI,DF,Genoa,Serie A,23,1997,14.3,50,30,23,22,5,32,58,55.2,26,20,4,16,20,70,34,1,0,2021-2022,1.3986013986013985,3.4965034965034962
1148,Dominique Heintz,GER,DF,Union Berlin,Bundesliga,27,1993,5.2,8,5,5,3,0,3,6,50.0,3,7,4,3,7,15,14,0,0,2021-2022,1.346153846153846,1.5384615384615383
1149,Dominique Heintz,GER,DF,Freiburg,Bundesliga,27,1993,0.3,0,0,0,0,0,0,0,0.0,0,0,0,0,1,1,0,0,0,2021-2022,3.3333333333333335,0.0
1150,Jordan Henderson,ENG,MF,Liverpool,Premier League,31,1990,28.9,36,20,9,25,2,17,44,38.6,27,25,1,24,23,59,14,0,0,2021-2022,0.795847750865052,1.245674740484429
Rk,Player,Nation,Pos,Squad,Comp,0,0,90.0,0,0,3,3,3,Tkl,0,0.0,0,0,0,0,0,0,0,0,0,2021-2022,0.0,0.0
1151,Liam Henderson,SCO,MF,Empoli,Serie A,25,1996,22.4,22,13,7,8,7,9,31,29.0,22,14,4,10,9,31,13,0,0,2021-2022,0.4017857142857143,0.9821428571428572
1152,Jeff Hendrick,IRL,MF,Newcastle Utd,Premier League,29,1992,0.8,1,1,0,1,0,1,1,100.0,0,0,0,0,0,1,1,0,0,2021-2022,0.0,1.25
1153,Wayne Hennessey,WAL,GK,Burnley,Premier League,34,1987,2.0,0,0,0,0,0,0,0,0.0,0,0,0,0,1,1,0,1,0,2021-2022,0.5,0.0
1154,Benjamin Henrichs,GER,DF,RB Leipzig,Bundesliga,24,1997,12.7,30,21,18,6,6,12,22,54.5,10,16,1,15,19,49,14,0,0,2021-2022,1.4960629921259843,2.362204724409449
1155,Henrique,BRA,DF,Lyon,Ligue 1,27,1994,12.3,13,7,10,1,2,5,16,31.3,11,13,1,12,22,35,14,0,0,2021-2022,1.7886178861788617,1.056910569105691
1156,Dalbert Henrique,BRA,"DF,MF",Cagliari,Serie A,27,1993,23.1,43,23,23,16,4,11,35,31.4,24,28,5,23,24,67,34,0,0,2021-2022,1.0389610389610389,1.8614718614718613
1157,Luis Henrique,BRA,"FW,MF",Marseille,Ligue 1,19,2001,7.8,4,3,2,1,1,2,5,40.0,3,2,0,2,5,9,1,0,0,2021-2022,0.6410256410256411,0.5128205128205129
1158,Matheus Henrique,BRA,MF,Sassuolo,Serie A,23,1997,12.0,10,3,6,3,1,6,24,25.0,18,14,2,12,7,17,12,1,0,2021-2022,0.5833333333333334,0.8333333333333334
1159,Rico Henry,ENG,DF,Brentford,Premier League,24,1997,30.8,28,20,18,8,2,12,34,35.3,22,31,10,21,26,54,76,1,0,2021-2022,0.8441558441558441,0.9090909090909091
1160,Thomas Henry,FRA,FW,Venezia,Serie A,26,1994,23.5,9,4,2,3,4,5,13,38.5,8,11,5,6,2,11,25,0,0,2021-2022,0.0851063829787234,0.3829787234042553
1161,Christophe Hérelle,MTQ,DF,Brest,Ligue 1,28,1992,21.5,48,28,30,16,2,17,26,65.4,9,20,15,5,44,92,84,1,0,2021-2022,2.046511627906977,2.2325581395348837
1162,Jérôme Hergault,FRA,DF,Lorient,Ligue 1,35,1986,3.9,3,1,1,2,0,2,5,40.0,3,4,1,3,4,7,7,0,0,2021-2022,1.0256410256410258,0.7692307692307693
1163,Kike Hermoso,ESP,DF,Betis,La Liga,21,1999,1.0,2,1,2,0,0,2,2,100.0,0,2,1,1,0,2,5,1,0,2021-2022,0.0,2.0
1164,Mario Hermoso,ESP,DF,Atlético Madrid,La Liga,26,1995,20.7,30,15,23,4,3,20,38,52.6,18,18,3,15,29,59,49,2,0,2021-2022,1.4009661835748792,1.4492753623188406
1165,Aridane Hernández,ESP,DF,Osasuna,La Liga,32,1989,12.9,12,9,10,2,0,3,13,23.1,10,11,9,2,20,32,71,0,0,2021-2022,1.5503875968992247,0.9302325581395349
1166,Lucas Hernández,FRA,DF,Bayern Munich,Bundesliga,25,1996,22.6,50,31,20,24,6,26,42,61.9,16,22,11,11,28,78,54,1,0,2021-2022,1.238938053097345,2.2123893805309733
1167,Luis Hernández,ESP,DF,Cádiz,La Liga,32,1989,15.2,9,5,9,0,0,5,8,62.5,3,5,3,2,16,25,34,0,0,2021-2022,1.0526315789473684,0.5921052631578948
1168,Mario Hernández,ESP,"DF,FW",Rayo Vallecano,La Liga,22,1999,4.4,10,4,7,3,0,5,9,55.6,4,1,0,1,4,14,7,0,0,2021-2022,0.9090909090909091,2.2727272727272725
1169,Theo Hernández,FRA,DF,Milan,Serie A,23,1997,30.1,53,35,34,14,5,29,40,72.5,11,16,3,13,23,76,29,3,0,2021-2022,0.7641196013289037,1.760797342192691
1170,Hernani,BRA,"MF,FW",Genoa,Serie A,27,1994,7.6,20,10,8,9,3,13,32,40.6,19,17,4,13,13,33,5,1,0,2021-2022,1.7105263157894737,2.6315789473684212
1171,Ander Herrera,ESP,MF,Paris S-G,Ligue 1,31,1989,12.1,29,17,7,16,6,14,39,35.9,25,22,8,14,14,43,8,0,0,2021-2022,1.15702479338843,2.396694214876033
1172,Héctor Herrera,MEX,MF,Atlético Madrid,La Liga,31,1990,9.5,16,8,11,4,1,7,20,35.0,13,13,2,11,12,28,16,0,0,2021-2022,1.263157894736842,1.6842105263157894
1173,Sergio Herrera,ESP,GK,Osasuna,La Liga,28,1993,36.0,3,2,3,0,0,3,6,50.0,3,1,0,1,1,4,18,0,0,2021-2022,0.027777777777777776,0.08333333333333333
1174,Yangel Herrera,VEN,MF,Espanyol,La Liga,23,1998,18.3,41,31,19,19,3,18,39,46.2,21,27,5,22,19,60,33,1,0,2021-2022,1.0382513661202186,2.240437158469945
1175,Patrick Herrmann,GER,"DF,FW",Gladbach,Bundesliga,30,1991,8.4,15,7,5,6,4,9,24,37.5,15,10,1,9,6,21,8,0,0,2021-2022,0.7142857142857143,1.7857142857142856
Rk,Player,Nation,Pos,Squad,Comp,0,0,90.0,0,0,3,3,3,Tkl,0,0.0,0,0,0,0,0,0,0,0,0,2021-2022,0.0,0.0
1176,Son Heung-min,KOR,"MF,FW",Tottenham,Premier League,29,1992,33.4,15,6,5,7,3,5,23,21.7,18,27,6,21,13,28,8,0,0,2021-2022,0.38922155688622756,0.44910179640718567
1177,Daan Heymans,BEL,"MF,FW",Venezia,Serie A,22,1999,2.8,3,1,1,2,0,1,5,20.0,4,7,3,4,4,7,3,0,0,2021-2022,1.4285714285714286,1.0714285714285714
1178,Aaron Hickey,SCO,DF,Bologna,Serie A,19,2002,31.3,46,29,24,15,7,20,30,66.7,10,36,13,23,29,75,44,0,0,2021-2022,0.926517571884984,1.4696485623003195
1179,Piero Hincapié,ECU,DF,Leverkusen,Bundesliga,19,2002,19.5,33,23,23,8,2,19,25,76.0,6,34,15,19,33,66,56,2,0,2021-2022,1.6923076923076923,1.6923076923076923
1180,Martin Hinteregger,AUT,DF,Eint Frankfurt,Bundesliga,28,1992,24.7,45,28,28,16,1,28,43,65.1,15,36,16,20,42,87,78,3,0,2021-2022,1.7004048582995952,1.8218623481781377
1181,Marwin Hitz,SUI,GK,Dortmund,Bundesliga,33,1987,4.5,0,0,0,0,0,0,0,0.0,0,0,0,0,0,0,2,0,0,2021-2022,0.0,0.0
1182,Ki-Jana Hoever,NED,"DF,MF",Wolves,Premier League,19,2002,3.4,10,6,5,5,0,7,12,58.3,5,6,0,6,6,16,8,0,0,2021-2022,1.7647058823529411,2.9411764705882355
1183,Nicolas Höfler,GER,MF,Freiburg,Bundesliga,31,1990,28.9,73,42,37,29,7,28,62,45.2,34,50,21,29,46,119,42,0,0,2021-2022,1.591695501730104,2.5259515570934257
1184,Jonas Hofmann,GER,"MF,FW",Gladbach,Bundesliga,29,1992,23.1,30,20,6,17,7,17,42,40.5,25,23,0,23,12,42,10,0,0,2021-2022,0.5194805194805194,1.2987012987012987
1185,Rob Holding,ENG,DF,Arsenal,Premier League,25,1995,9.4,13,9,11,1,1,5,6,83.3,1,23,18,5,10,23,42,1,0,2021-2022,1.0638297872340425,1.3829787234042552
1186,Lucas Höler,GER,FW,Freiburg,Bundesliga,27,1994,28.7,41,25,10,17,14,13,28,46.4,15,25,4,21,17,58,39,2,0,2021-2022,0.5923344947735192,1.4285714285714286
1187,Mason Holgate,ENG,DF,Everton,Premier League,24,1996,23.7,35,18,26,9,0,11,26,42.3,15,25,17,8,26,61,95,1,0,2021-2022,1.0970464135021096,1.4767932489451476
1188,Gerrit Holtmann,PHI,"FW,MF",Bochum,Bundesliga,26,1995,20.4,15,9,5,3,7,6,22,27.3,16,26,2,24,8,23,6,0,0,2021-2022,0.3921568627450981,0.7352941176470589
1189,Martin Hongla,CMR,MF,Hellas Verona,Serie A,23,1998,7.2,14,8,5,6,3,4,8,50.0,4,6,2,4,4,18,16,1,0,2021-2022,0.5555555555555556,1.9444444444444444
1190,Franck Honorat,FRA,"FW,MF",Brest,Ligue 1,24,1996,32.2,54,38,25,13,16,27,47,57.4,20,24,2,22,15,69,25,0,0,2021-2022,0.4658385093167701,1.6770186335403725
1191,Justin Hoogma,NED,DF,Greuther Fürth,Bundesliga,23,1998,3.0,6,5,4,2,0,4,6,66.7,2,5,5,0,4,10,4,0,0,2021-2022,1.3333333333333333,2.0
1192,Sydney van Hooijdonk,NED,"FW,MF",Bologna,Serie A,21,2000,0.4,0,0,0,0,0,0,1,0.0,1,1,0,1,0,0,0,0,0,2021-2022,0.0,0.0
1193,Matthew Hoppe,USA,"FW,MF",Mallorca,La Liga,20,2001,1.5,1,0,0,0,1,0,3,0.0,3,0,0,0,0,1,0,0,0,2021-2022,0.0,0.6666666666666666
1194,Jannes Horn,GER,DF,Köln,Bundesliga,24,1997,5.3,6,4,4,2,0,4,8,50.0,4,1,1,0,3,9,9,0,0,2021-2022,0.5660377358490566,1.1320754716981132
1195,Timo Horn,GER,GK,Köln,Bundesliga,28,1993,13.0,0,0,0,0,0,0,1,0.0,1,0,0,0,0,0,5,0,0,2021-2022,0.0,0.0
1196,Fraser Hornby,SCO,"FW,MF",Reims,Ligue 1,21,1999,3.9,3,1,1,2,0,0,2,0.0,2,3,0,3,4,7,5,0,0,2021-2022,1.0256410256410258,0.7692307692307693
1197,Cédric Hountondji,BEN,DF,Clermont Foot,Ligue 1,27,1994,22.6,33,17,20,12,1,16,24,66.7,8,23,12,11,34,67,76,0,0,2021-2022,1.5044247787610618,1.4601769911504423
1198,Lukáš Hrádecký,FIN,GK,Leverkusen,Bundesliga,31,1989,32.0,1,1,1,0,0,1,1,100.0,0,0,0,0,0,1,10,1,0,2021-2022,0.0,0.03125
1199,Branimir Hrgota,SWE,FW,Greuther Fürth,Bundesliga,28,1993,30.9,46,29,10,31,5,21,72,29.2,51,27,1,26,11,57,3,1,0,2021-2022,0.3559870550161812,1.4886731391585761
1200,Petko Hristov,BUL,DF,Spezia,Serie A,22,1999,13.9,17,10,11,6,0,10,16,62.5,6,29,23,6,19,36,47,0,0,2021-2022,1.3669064748201438,1.223021582733813
Rk,Player,Nation,Pos,Squad,Comp,0,0,90.0,0,0,3,3,3,Tkl,0,0.0,0,0,0,0,0,0,0,0,0,2021-2022,0.0,0.0
1201,Ajdin Hrustic,AUS,MF,Eint Frankfurt,Bundesliga,25,1996,10.7,16,11,5,7,4,11,32,34.4,21,18,1,17,10,26,7,0,0,2021-2022,0.9345794392523366,1.4953271028037385
1202,Timo Hübers,GER,DF,Köln,Bundesliga,25,1996,19.3,45,27,28,17,0,27,45,60.0,18,31,19,12,52,97,95,0,0,2021-2022,2.694300518134715,2.33160621761658
1203,Benjamin Hübner,GER,DF,Hoffenheim,Bundesliga,32,1989,4.2,9,5,0,7,2,3,5,60.0,2,2,2,0,9,18,7,0,0,2021-2022,2.142857142857143,2.142857142857143
1204,Callum Hudson-Odoi,ENG,"MF,FW",Chelsea,Premier League,20,2000,10.7,14,10,5,6,3,8,23,34.8,15,8,0,8,2,16,6,1,0,2021-2022,0.1869158878504673,1.3084112149532712
1205,Will Hughes,ENG,MF,Crystal Palace,Premier League,26,1995,11.7,29,14,10,16,3,7,16,43.8,9,13,7,6,8,37,10,0,0,2021-2022,0.6837606837606838,2.4786324786324787
1206,Mats Hummels,GER,DF,Dortmund,Bundesliga,32,1988,19.6,34,22,20,13,1,20,36,55.6,16,18,13,5,32,66,66,1,0,2021-2022,1.6326530612244896,1.7346938775510203
1207,Elseid Hysaj,ALB,DF,Lazio,Serie A,27,1994,22.5,46,30,25,17,4,29,45,64.4,16,18,6,12,24,70,34,1,0,2021-2022,1.0666666666666667,2.0444444444444443
1208,Suk Hyun-jun,KOR,"FW,MF",Troyes,Ligue 1,30,1991,1.7,0,0,0,0,0,0,0,0.0,0,2,0,2,0,0,2,0,0,2021-2022,0.0,0.0
1209,Pierre Højbjerg,DEN,MF,Tottenham,Premier League,25,1995,35.5,78,45,31,38,9,38,85,44.7,47,61,13,48,48,126,54,0,0,2021-2022,1.352112676056338,2.1971830985915495
1210,Iago,BRA,DF,Augsburg,Bundesliga,24,1997,24.2,49,29,25,19,5,15,34,44.1,19,28,6,22,27,76,62,0,0,2021-2022,1.115702479338843,2.024793388429752
1211,Robert Ibáñez,ESP,"MF,FW",Osasuna,La Liga,28,1993,1.0,3,3,2,0,1,1,2,50.0,1,1,0,1,1,4,1,0,0,2021-2022,1.0,3.0
1212,Roger Ibanez,BRA,DF,Roma,Serie A,22,1998,32.1,54,32,31,19,4,26,43,60.5,17,26,7,19,62,116,104,2,0,2021-2022,1.9314641744548287,1.6822429906542056
1213,Vicente Iborra,ESP,MF,Villarreal,La Liga,33,1988,11.5,19,10,9,7,3,12,24,50.0,12,11,5,6,11,30,27,1,0,2021-2022,0.9565217391304348,1.6521739130434783
1214,Zlatan Ibrahimović,SWE,FW,Milan,Serie A,39,1981,11.3,0,0,0,0,0,0,2,0.0,2,2,1,1,3,3,9,0,0,2021-2022,0.2654867256637168,0.0
1215,Mauro Icardi,ARG,FW,Paris S-G,Ligue 1,28,1993,11.4,5,3,1,3,1,3,7,42.9,4,3,0,3,5,10,12,0,0,2021-2022,0.43859649122807015,0.43859649122807015
1216,Adam Idah,IRL,"FW,MF",Norwich City,Premier League,20,2001,6.9,9,6,2,5,2,2,3,66.7,1,4,2,2,3,12,7,0,0,2021-2022,0.43478260869565216,1.3043478260869565
1217,Oussama Idrissi,MAR,"MF,FW",Sevilla,La Liga,25,1996,1.4,1,0,0,1,0,0,1,0.0,1,1,0,1,1,2,1,0,0,2021-2022,0.7142857142857143,0.7142857142857143
1218,Oussama Idrissi,MAR,MF,Cádiz,La Liga,25,1996,10.0,8,4,3,4,1,4,15,26.7,11,8,0,8,3,11,5,0,0,2021-2022,0.3,0.8
1219,Iglesias,ESP,DF,Getafe,La Liga,23,1998,8.0,19,10,11,8,0,7,17,41.2,10,8,2,6,10,29,28,0,0,2021-2022,1.25,2.375
1220,Borja Iglesias,ESP,FW,Betis,La Liga,28,1993,17.5,6,4,1,2,3,0,8,0.0,8,11,1,10,4,10,7,0,0,2021-2022,0.22857142857142856,0.34285714285714286
1221,Jonathan Iglesias,URU,MF,Clermont Foot,Ligue 1,32,1988,6.4,18,11,6,10,2,10,18,55.6,8,8,2,6,5,23,2,1,0,2021-2022,0.78125,2.8125
1222,Juan Ignacio Ramírez,URU,FW,Saint-Étienne,Ligue 1,24,1997,1.4,2,1,0,1,1,0,0,0.0,0,0,0,0,0,2,0,0,0,2021-2022,0.0,1.4285714285714286
1223,Igor,BRA,DF,Fiorentina,Serie A,23,1998,24.9,53,31,34,16,3,30,40,75.0,10,37,19,18,31,84,46,4,0,2021-2022,1.244979919678715,2.1285140562249
1224,Kelechi Iheanacho,NGA,FW,Leicester City,Premier League,24,1996,14.0,10,7,2,5,3,3,14,21.4,11,19,0,19,4,14,10,0,0,2021-2022,0.2857142857142857,0.7142857142857143
1225,Danylo Ihnatenko,UKR,MF,Bordeaux,Ligue 1,24,1997,7.7,17,9,8,7,2,10,24,41.7,14,9,2,7,6,23,17,1,0,2021-2022,0.7792207792207793,2.207792207792208
Rk,Player,Nation,Pos,Squad,Comp,0,0,90.0,0,0,3,3,3,Tkl,0,0.0,0,0,0,0,0,0,0,0,0,2021-2022,0.0,0.0
1226,Jonathan Ikone,FRA,FW,Fiorentina,Serie A,23,1998,7.2,7,3,2,3,2,3,10,30.0,7,10,2,8,1,8,2,0,0,2021-2022,0.1388888888888889,0.9722222222222222
1227,Jonathan Ikone,FRA,"MF,FW",Lille,Ligue 1,23,1998,11.8,11,3,6,4,1,4,11,36.4,7,13,1,12,5,16,4,0,0,2021-2022,0.423728813559322,0.9322033898305084
1228,Ivan Ilić,SRB,MF,Hellas Verona,Serie A,20,2001,28.1,39,18,16,19,4,20,54,37.0,34,34,12,22,22,61,55,0,0,2021-2022,0.7829181494661921,1.387900355871886
1229,Josip Iličić,SVN,"MF,FW",Atalanta,Serie A,33,1988,9.3,7,7,3,2,2,4,17,23.5,13,6,1,5,3,10,1,0,0,2021-2022,0.3225806451612903,0.7526881720430108
1230,Asier Illarramendi,ESP,MF,Real Sociedad,La Liga,31,1990,4.2,9,5,5,3,1,1,10,10.0,9,5,1,4,4,13,12,0,0,2021-2022,0.9523809523809523,2.142857142857143
1231,Stefan Ilsanker,AUT,"DF,MF",Eint Frankfurt,Bundesliga,32,1989,3.0,14,8,7,6,1,5,10,50.0,5,6,2,4,6,20,15,1,0,2021-2022,2.0,4.666666666666667
1232,Ciro Immobile,ITA,FW,Lazio,Serie A,31,1990,30.1,10,5,4,4,2,1,15,6.7,14,7,1,6,3,13,16,0,0,2021-2022,0.09966777408637874,0.33222591362126247
1233,Burak İnce,TUR,FW,Arminia,Bundesliga,17,2004,1.5,1,1,1,0,0,1,2,50.0,1,1,0,1,0,1,0,0,0,2021-2022,0.0,0.6666666666666666
1234,Danny Ings,ENG,FW,Aston Villa,Premier League,29,1992,21.1,23,16,2,16,5,13,37,35.1,24,31,2,29,6,29,22,0,0,2021-2022,0.2843601895734597,1.0900473933649288
1235,Marcus Ingvartsen,DEN,MF,Union Berlin,Bundesliga,25,1996,1.4,0,0,0,0,0,0,2,0.0,2,0,0,0,2,2,1,0,0,2021-2022,1.4285714285714286,0.0
1236,Marcus Ingvartsen,DEN,"FW,MF",Mainz 05,Bundesliga,25,1996,7.6,3,2,2,0,1,3,9,33.3,6,6,0,6,6,9,7,1,0,2021-2022,0.7894736842105263,0.39473684210526316
1237,Bonke Innocent,NGA,MF,Lorient,Ligue 1,25,1996,9.7,27,16,10,16,1,11,26,42.3,15,11,3,8,16,43,14,0,0,2021-2022,1.6494845360824744,2.7835051546391756
1238,Lorenzo Insigne,ITA,FW,Napoli,Serie A,30,1991,25.4,23,14,8,12,3,8,44,18.2,36,30,1,29,20,43,3,1,0,2021-2022,0.7874015748031497,0.9055118110236221
1239,Nikita Iosifov,RUS,MF,Villarreal,La Liga,20,2001,0.0,0,0,0,0,0,0,0,0.0,0,0,0,0,0,0,0,0,0,2021-2022,,
1240,Tim Iroegbunam,ENG,MF,Aston Villa,Premier League,18,2003,1.0,5,4,2,3,0,1,1,100.0,0,0,0,0,2,7,1,0,0,2021-2022,2.0,5.0
1241,Alexander Isak,SWE,FW,Real Sociedad,La Liga,21,1999,23.8,7,4,1,3,3,2,12,16.7,10,14,2,12,3,10,10,0,0,2021-2022,0.12605042016806722,0.29411764705882354
1242,Isco,ESP,"MF,FW",Real Madrid,La Liga,29,1992,3.7,9,5,4,4,1,5,12,41.7,7,1,0,1,2,11,1,0,0,2021-2022,0.5405405405405405,2.4324324324324325
1243,Wilson Isidor,FRA,"FW,MF",Monaco,Ligue 1,20,2000,0.6,0,0,0,0,0,0,4,0.0,4,1,0,1,0,0,0,0,0,2021-2022,0.0,0.0
1244,Ardian Ismajli,ALB,DF,Empoli,Serie A,24,1996,14.1,13,9,8,4,1,5,14,35.7,9,21,11,10,24,37,80,0,0,2021-2022,1.702127659574468,0.9219858156028369
1245,Hiroki Ito,JPN,DF,Stuttgart,Bundesliga,22,1999,26.1,43,31,21,19,3,25,43,58.1,18,40,19,21,53,96,95,0,0,2021-2022,2.0306513409961684,1.6475095785440612
1246,Cedric Itten,SUI,FW,Greuther Fürth,Bundesliga,24,1996,7.1,5,2,1,2,2,1,6,16.7,5,3,0,3,2,7,4,0,0,2021-2022,0.28169014084507044,0.7042253521126761
1247,Gian-Luca Itter,GER,DF,Greuther Fürth,Bundesliga,22,1999,16.2,44,26,30,11,3,21,38,55.3,17,24,9,15,13,57,51,0,0,2021-2022,0.8024691358024691,2.7160493827160495
1248,Alex Iwobi,NGA,"MF,DF",Everton,Premier League,25,1996,22.6,40,19,23,12,5,21,52,40.4,31,39,3,36,20,60,25,2,0,2021-2022,0.8849557522123893,1.7699115044247786
1249,Armando Izzo,ITA,DF,Torino,Serie A,29,1992,5.8,16,9,14,2,0,9,11,81.8,2,5,4,1,17,33,21,0,0,2021-2022,2.931034482758621,2.7586206896551726
1250,Nicolas Jackson,SEN,"FW,MF",Villarreal,La Liga,20,2001,1.8,2,0,1,0,1,0,0,0.0,0,0,0,0,1,3,1,0,0,2021-2022,0.5555555555555556,1.1111111111111112
Rk,Player,Nation,Pos,Squad,Comp,0,0,90.0,0,0,3,3,3,Tkl,0,0.0,0,0,0,0,0,0,0,0,0,2021-2022,0.0,0.0
1251,Lee Jae-sung,KOR,"MF,FW",Mainz 05,Bundesliga,28,1992,16.0,30,12,8,14,8,6,27,22.2,21,20,2,18,18,48,18,0,0,2021-2022,1.125,1.875
1252,Paul Jaeckel,GER,DF,Union Berlin,Bundesliga,23,1998,22.7,51,29,27,24,0,29,51,56.9,22,34,10,24,57,108,81,0,0,2021-2022,2.511013215859031,2.246696035242291
1253,Mato Jajalo,BIH,MF,Udinese,Serie A,33,1988,7.0,24,14,14,7,3,11,23,47.8,12,7,0,7,11,35,5,0,0,2021-2022,1.5714285714285714,3.4285714285714284
1254,Kristijan Jakić,CRO,MF,Eint Frankfurt,Bundesliga,24,1997,20.9,37,22,10,21,6,15,62,24.2,47,33,3,30,21,58,25,1,0,2021-2022,1.0047846889952154,1.7703349282296652
1255,Ismail Jakobs,SEN,"DF,FW",Monaco,Ligue 1,21,1999,13.4,32,16,14,15,3,16,35,45.7,19,16,1,15,17,49,31,0,0,2021-2022,1.2686567164179103,2.388059701492537
1256,Marin Jakoliš,CRO,FW,Angers,Ligue 1,24,1996,2.5,2,1,0,1,1,0,6,0.0,6,0,0,0,1,3,0,0,0,2021-2022,0.4,0.8
1257,Abdel Jalil Medioub,ALG,DF,Bordeaux,Ligue 1,23,1997,6.9,9,5,5,3,1,3,4,75.0,1,8,4,4,12,21,34,0,0,2021-2022,1.7391304347826086,1.3043478260869565
1258,Daniel James,WAL,FW,Manchester Utd,Premier League,23,1997,1.4,2,1,0,2,0,0,0,0.0,0,2,0,2,0,2,1,0,0,2021-2022,0.0,1.4285714285714286
1259,Daniel James,WAL,"FW,MF",Leeds United,Premier League,23,1997,26.3,24,14,8,8,8,10,23,43.5,13,18,1,17,8,32,12,0,0,2021-2022,0.3041825095057034,0.9125475285171103
1260,Reece James,ENG,DF,Chelsea,Premier League,21,1999,20.7,33,25,14,18,1,9,22,40.9,13,20,2,18,17,50,22,0,0,2021-2022,0.821256038647343,1.5942028985507246
1261,Vitaly Janelt,GER,MF,Brentford,Premier League,23,1998,25.5,61,32,26,27,8,27,53,50.9,26,23,7,16,28,89,35,0,0,2021-2022,1.0980392156862746,2.392156862745098
1262,Jakub Jankto,CZE,"DF,MF",Getafe,La Liga,25,1996,6.5,11,7,5,5,1,10,17,58.8,7,4,0,4,4,15,7,0,0,2021-2022,0.6153846153846154,1.6923076923076923
1263,Pontus Jansson,SWE,DF,Brentford,Premier League,30,1991,36.9,40,21,32,8,0,22,34,64.7,12,37,27,10,52,92,187,0,0,2021-2022,1.4092140921409215,1.0840108401084012
1264,Tony Jantschke,GER,DF,Gladbach,Bundesliga,31,1990,2.5,6,5,2,4,0,3,6,50.0,3,3,2,1,5,11,8,0,0,2021-2022,2.0,2.4
1265,Adnan Januzaj,BEL,"FW,MF",Real Sociedad,La Liga,26,1995,18.1,17,11,5,8,4,9,24,37.5,15,15,3,12,12,29,15,0,0,2021-2022,0.6629834254143646,0.9392265193370165
1266,Léo Jardim,BRA,GK,Lille,Ligue 1,26,1995,17.0,0,0,0,0,0,0,0,0.0,0,0,0,0,1,1,10,0,0,2021-2022,0.058823529411764705,0.0
1267,Paweł Jaroszyński,POL,DF,Salernitana,Serie A,26,1994,5.7,10,5,7,3,0,5,7,71.4,2,4,0,4,10,20,19,0,0,2021-2022,1.7543859649122806,1.7543859649122806
1268,Jason,ESP,"MF,FW",Alavés,La Liga,27,1994,7.5,11,7,6,4,1,7,20,35.0,13,7,0,7,7,18,5,0,0,2021-2022,0.9333333333333333,1.4666666666666666
1269,Jason,ESP,"MF,DF",Valencia,La Liga,27,1994,0.8,4,1,2,1,1,0,1,0.0,1,2,0,2,1,5,1,0,0,2021-2022,1.25,5.0
1270,Dennis Jastrzembski,POL,"DF,FW",Hertha BSC,Bundesliga,21,2000,2.5,2,1,1,1,0,2,8,25.0,6,1,0,1,5,7,3,0,0,2021-2022,2.0,0.8
1271,Luis Javier Suárez,COL,FW,Granada,La Liga,23,1997,31.6,26,14,9,9,8,8,27,29.6,19,25,3,22,6,32,23,0,0,2021-2022,0.18987341772151897,0.8227848101265822
1272,Corentin Jean,FRA,"FW,MF",Lens,Ligue 1,26,1995,2.8,9,6,4,4,1,3,6,50.0,3,5,0,5,1,10,0,0,0,2021-2022,0.35714285714285715,3.2142857142857144
1273,Jemerson,BRA,DF,Metz,Ligue 1,28,1992,13.4,37,25,30,7,0,18,26,69.2,8,23,8,15,25,62,33,1,0,2021-2022,1.8656716417910448,2.761194029850746
1274,Fredrik Jensen,FIN,"MF,FW",Augsburg,Bundesliga,23,1997,4.6,5,4,1,3,1,4,7,57.1,3,5,1,4,2,7,4,0,0,2021-2022,0.4347826086956522,1.0869565217391306
1275,Mathias Jensen,DEN,MF,Brentford,Premier League,25,1996,17.8,33,18,12,16,5,22,63,34.9,41,32,3,29,22,55,13,0,0,2021-2022,1.2359550561797752,1.8539325842696628
Rk,Player,Nation,Pos,Squad,Comp,0,0,90.0,0,0,3,3,3,Tkl,0,0.0,0,0,0,0,0,0,0,0,0,2021-2022,0.0,0.0
1276,Moritz Jenz,GER,DF,Lorient,Ligue 1,22,1999,15.3,26,12,18,6,2,11,24,45.8,13,19,11,8,28,54,55,0,0,2021-2022,1.8300653594771241,1.6993464052287581
1277,Gabriel Jesus,BRA,FW,Manchester City,Premier League,24,1997,20.9,18,12,2,4,12,6,26,23.1,20,18,0,18,15,33,8,0,0,2021-2022,0.7177033492822967,0.861244019138756
1278,Juan Jesus,BRA,DF,Napoli,Serie A,30,1991,14.2,25,17,14,11,0,12,18,66.7,6,21,16,5,9,34,34,0,0,2021-2022,0.6338028169014085,1.7605633802816902
1279,Álvaro Jiménez,ESP,"MF,FW",Cádiz,La Liga,26,1995,2.6,6,3,3,2,1,4,7,57.1,3,3,0,3,3,9,0,0,0,2021-2022,1.1538461538461537,2.3076923076923075
1280,Raúl Jiménez,MEX,FW,Wolves,Premier League,30,1991,29.2,29,14,6,16,7,6,30,20.0,24,31,5,26,13,42,26,0,0,2021-2022,0.4452054794520548,0.9931506849315068
1281,João Pedro,BRA,"FW,MF",Watford,Premier League,19,2001,18.3,20,14,7,8,5,6,23,26.1,17,23,3,20,15,35,17,0,0,2021-2022,0.819672131147541,1.0928961748633879
1282,Joaquín,ESP,"FW,MF",Betis,La Liga,40,1981,5.2,6,2,4,2,0,3,8,37.5,5,5,2,3,3,9,10,0,0,2021-2022,0.5769230769230769,1.1538461538461537
1283,Joelinton,BRA,"MF,FW",Newcastle Utd,Premier League,24,1996,28.4,72,38,30,33,9,26,61,42.6,35,46,11,35,34,106,50,2,0,2021-2022,1.1971830985915493,2.535211267605634
1284,Jofre,ESP,"MF,DF",Espanyol,La Liga,20,2001,0.2,1,1,0,0,1,1,1,100.0,0,0,0,0,0,1,0,0,0,2021-2022,0.0,5.0
1285,Marco John,GER,DF,Hoffenheim,Bundesliga,19,2002,0.5,0,0,0,0,0,0,1,0.0,1,1,0,1,1,1,1,0,0,2021-2022,2.0,0.0
1286,Dennis Johnsen,NOR,"FW,MF",Venezia,Serie A,23,1998,16.1,14,10,8,4,2,6,18,33.3,12,14,1,13,5,19,3,0,0,2021-2022,0.3105590062111801,0.8695652173913043
1287,Ben Johnson,ENG,DF,West Ham,Premier League,21,2000,15.5,33,16,15,15,3,21,28,75.0,7,16,8,8,22,55,55,0,0,2021-2022,1.4193548387096775,2.129032258064516
1288,Curtis Jones,ENG,MF,Liverpool,Premier League,20,2001,9.5,11,9,3,6,2,1,10,10.0,9,4,0,4,6,17,4,0,0,2021-2022,0.631578947368421,1.1578947368421053
1289,Phil Jones,ENG,DF,Manchester Utd,Premier League,29,1992,1.8,5,5,3,1,1,2,3,66.7,1,4,4,0,3,8,8,0,0,2021-2022,1.6666666666666665,2.7777777777777777
1290,Frenkie de Jong,NED,MF,Barcelona,La Liga,24,1997,27.5,35,19,12,18,5,12,23,52.2,11,19,5,14,20,55,16,0,0,2021-2022,0.7272727272727273,1.2727272727272727
1291,Luuk de Jong,NED,FW,Barcelona,La Liga,30,1990,7.3,9,7,1,5,3,1,2,50.0,1,4,0,4,0,9,12,0,0,2021-2022,0.0,1.2328767123287672
1292,Joan Jordán,ESP,MF,Sevilla,La Liga,27,1994,27.9,61,30,22,31,8,28,65,43.1,37,27,6,21,30,91,18,1,0,2021-2022,1.0752688172043012,2.186379928315412
1293,Kaio Jorge,BRA,"MF,FW",Juventus,Serie A,19,2002,1.3,2,1,0,2,0,1,3,33.3,2,1,0,1,0,2,2,0,0,2021-2022,0.0,1.5384615384615383
1294,Jorginho,ITA,MF,Chelsea,Premier League,29,1991,25.3,64,33,27,31,6,29,83,34.9,54,27,4,23,36,100,21,1,0,2021-2022,1.4229249011857708,2.5296442687747036
1295,Josan,ESP,"DF,MF",Elche,La Liga,31,1989,13.5,36,22,23,9,4,26,44,59.1,18,11,4,7,10,46,21,0,0,2021-2022,0.7407407407407407,2.6666666666666665
1296,Willian José,BRA,FW,Betis,La Liga,29,1991,17.8,15,13,2,10,3,2,8,25.0,6,10,2,8,3,18,16,0,0,2021-2022,0.16853932584269662,0.8426966292134831
1297,Joselu,ESP,FW,Alavés,La Liga,31,1990,34.7,16,11,1,9,6,7,25,28.0,18,21,4,17,7,23,45,0,0,2021-2022,0.20172910662824206,0.4610951008645533
1298,Josema,ESP,DF,Elche,La Liga,25,1996,2.0,3,2,1,1,1,0,2,0.0,2,1,1,0,0,3,11,0,0,2021-2022,0.0,1.5
1299,Lenny Joseph,FRA,"FW,MF",Metz,Ligue 1,20,2000,1.7,2,1,1,1,0,0,0,0.0,0,3,0,3,0,2,0,0,0,2021-2022,0.0,1.1764705882352942
1300,Diogo Jota,POR,FW,Liverpool,Premier League,24,1996,26.3,39,18,12,18,9,13,55,23.6,42,19,2,17,6,45,6,0,0,2021-2022,0.22813688212927757,1.4828897338403042
Rk,Player,Nation,Pos,Squad,Comp,0,0,90.0,0,0,3,3,3,Tkl,0,0.0,0,0,0,0,0,0,0,0,0,2021-2022,0.0,0.0
1301,Stevan Jovetić,MNE,"FW,MF",Hertha BSC,Bundesliga,31,1989,11.3,5,2,0,2,3,1,6,16.7,5,3,0,3,1,6,6,0,0,2021-2022,0.08849557522123894,0.44247787610619466
1302,Luka Jović,SRB,FW,Real Madrid,La Liga,23,1997,4.1,1,1,0,1,0,0,1,0.0,1,3,0,3,1,2,4,0,0,2021-2022,0.24390243902439027,0.24390243902439027
1303,Miguel Juan Llambrich,ESP,DF,Espanyol,La Liga,25,1996,0.8,2,2,1,1,0,0,0,0.0,0,1,0,1,0,2,5,0,0,2021-2022,0.0,2.5
1304,José Juan Macías,MEX,"FW,MF",Getafe,La Liga,21,1999,2.2,1,0,0,0,1,0,1,0.0,1,1,0,1,1,2,0,0,0,2021-2022,0.45454545454545453,0.45454545454545453
1305,Juanmi,ESP,FW,Betis,La Liga,28,1993,23.7,39,25,11,19,9,19,49,38.8,30,24,1,23,9,48,10,1,0,2021-2022,0.379746835443038,1.6455696202531647
1306,Gideon Jung,GER,DF,Greuther Fürth,Bundesliga,26,1994,1.6,3,1,1,2,0,2,4,50.0,2,1,1,0,2,5,5,0,0,2021-2022,1.25,1.875
1307,Flavio Junior Bianchi,ITA,"FW,MF",Genoa,Serie A,21,2000,3.5,2,2,1,0,1,0,2,0.0,2,0,0,0,0,2,0,0,0,2021-2022,0.0,0.5714285714285714
1308,Lago Junior,CIV,"FW,MF",Mallorca,La Liga,30,1990,2.0,3,2,3,0,0,3,5,60.0,2,0,0,0,2,5,2,0,0,2021-2022,1.0,1.5
1309,Hamed Junior Traorè,CIV,"FW,MF",Sassuolo,Serie A,21,2000,19.7,32,18,8,14,10,10,46,21.7,36,22,2,20,12,44,6,1,0,2021-2022,0.6091370558375635,1.6243654822335025
1310,Vinicius Júnior,BRA,FW,Real Madrid,La Liga,21,2000,29.9,46,24,23,19,4,15,50,30.0,35,25,0,25,6,52,6,0,0,2021-2022,0.20066889632107024,1.5384615384615385
1311,James Justin,ENG,DF,Leicester City,Premier League,23,1998,11.1,22,13,11,8,3,7,15,46.7,8,16,4,12,17,39,34,0,0,2021-2022,1.5315315315315317,1.981981981981982
1312,Ferran Jutglà,ESP,FW,Barcelona,La Liga,22,1999,3.3,2,1,0,1,1,0,1,0.0,1,2,0,2,1,3,1,0,0,2021-2022,0.30303030303030304,0.6060606060606061
1313,Jens Jønsson,DEN,MF,Cádiz,La Liga,28,1993,14.5,40,29,22,17,1,17,35,48.6,18,17,7,10,34,74,32,0,0,2021-2022,2.3448275862068964,2.7586206896551726
1314,Mathias Jørgensen,DEN,DF,Brentford,Premier League,31,1990,5.8,10,4,3,5,2,7,10,70.0,3,6,1,5,10,20,13,0,0,2021-2022,1.7241379310344829,1.7241379310344829
1315,Ozan Kabak,TUR,DF,Norwich City,Premier League,21,2000,10.2,10,5,4,6,0,5,9,55.6,4,19,11,8,16,26,26,0,0,2021-2022,1.5686274509803924,0.9803921568627452
1316,Christian Kabasele,BEL,DF,Watford,Premier League,30,1991,13.3,11,5,10,1,0,7,10,70.0,3,20,16,4,14,25,67,1,0,2021-2022,1.0526315789473684,0.8270676691729323
1317,Issa Kaboré,BFA,"DF,MF",Troyes,Ligue 1,20,2001,25.0,45,22,22,14,9,20,38,52.6,18,27,2,25,20,65,38,1,0,2021-2022,0.8,1.8
1318,Anton Kade,GER,"FW,MF",Hertha BSC,Bundesliga,17,2004,0.9,4,2,3,1,0,2,8,25.0,6,3,0,3,3,7,1,0,0,2021-2022,3.333333333333333,4.444444444444445
1319,Pavel Kadeřábek,CZE,"DF,MF",Hoffenheim,Bundesliga,29,1992,13.3,11,10,6,3,2,5,16,31.3,11,18,6,12,13,24,22,0,0,2021-2022,0.9774436090225563,0.8270676691729323
1320,Tino Kadewere,ZIM,FW,Lyon,Ligue 1,25,1996,5.6,7,5,2,2,3,4,13,30.8,9,7,0,7,4,11,1,1,0,2021-2022,0.7142857142857143,1.25
1321,Florian Kainz,AUT,"MF,FW",Köln,Bundesliga,28,1992,25.8,41,26,9,25,7,23,51,45.1,28,27,3,24,32,73,24,0,0,2021-2022,1.2403100775193798,1.5891472868217054
1322,Gaël Kakuta,COD,"MF,FW",Lens,Ligue 1,30,1991,18.6,22,14,2,13,7,4,20,20.0,16,10,0,10,4,26,3,0,0,2021-2022,0.2150537634408602,1.182795698924731
1323,Sasa Kalajdzic,AUT,FW,Stuttgart,Bundesliga,24,1997,13.6,10,6,2,5,3,3,11,27.3,8,5,0,5,2,12,14,0,0,2021-2022,0.14705882352941177,0.7352941176470589
1324,Arnaud Kalimuendo,FRA,FW,Lens,Ligue 1,19,2002,23.9,9,8,1,3,5,2,7,28.6,5,6,1,5,8,17,0,0,0,2021-2022,0.3347280334728034,0.3765690376569038
1325,Arnaud Kalimuendo,FRA,FW,Paris S-G,Ligue 1,19,2002,0.1,0,0,0,0,0,0,0,0.0,0,0,0,0,0,0,0,0,0,2021-2022,0.0,0.0
Rk,Player,Nation,Pos,Squad,Comp,0,0,90.0,0,0,3,3,3,Tkl,0,0.0,0,0,0,0,0,0,0,0,0,2021-2022,0.0,0.0
1326,Nikola Kalinić,CRO,FW,Hellas Verona,Serie A,33,1988,4.5,2,0,0,1,1,1,2,50.0,1,2,0,2,0,2,2,0,0,2021-2022,0.0,0.4444444444444444
1327,Yayah Kallon,SLE,"FW,MF",Genoa,Serie A,20,2001,7.1,15,11,5,6,4,3,11,27.3,8,7,1,6,1,16,5,0,0,2021-2022,0.14084507042253522,2.1126760563380285
1328,Samuel Kalu,NGA,FW,Watford,Premier League,23,1997,2.5,2,2,0,2,0,1,1,100.0,0,2,0,2,3,5,3,0,0,2021-2022,1.2,0.8
1329,Samuel Kalu,NGA,"FW,MF",Bordeaux,Ligue 1,23,1997,3.6,8,5,3,4,1,2,5,40.0,3,2,0,2,3,11,1,0,0,2021-2022,0.8333333333333333,2.2222222222222223
1330,Pierre Kalulu,FRA,DF,Milan,Serie A,21,2000,21.6,61,36,36,21,4,17,22,77.3,5,36,15,21,26,87,54,0,0,2021-2022,1.2037037037037037,2.824074074074074
1331,Daichi Kamada,JPN,MF,Eint Frankfurt,Bundesliga,24,1996,23.8,40,21,7,26,7,11,40,27.5,29,18,0,18,8,48,10,0,0,2021-2022,0.3361344537815126,1.680672268907563
1332,Boubacar Kamara,FRA,"MF,DF",Marseille,Ligue 1,21,1999,30.9,68,38,27,36,5,26,47,55.3,21,29,10,19,46,114,44,1,0,2021-2022,1.4886731391585761,2.2006472491909386
1333,Hassane Kamara,CIV,DF,Watford,Premier League,27,1994,18.0,53,34,31,16,6,27,43,62.8,16,20,4,16,69,122,67,0,0,2021-2022,3.8333333333333335,2.9444444444444446
1334,Hassane Kamara,CIV,"MF,DF",Nice,Ligue 1,27,1994,6.0,13,10,4,6,3,5,8,62.5,3,10,2,8,9,22,4,0,0,2021-2022,1.5,2.1666666666666665
1335,Dimitrije Kamenović,SRB,DF,Lazio,Serie A,21,2000,0.5,1,1,1,0,0,1,1,100.0,0,0,0,0,2,3,1,0,0,2021-2022,4.0,2.0
1336,Kevin Kampl,SVN,MF,RB Leipzig,Bundesliga,30,1990,21.1,41,19,16,20,5,10,42,23.8,32,24,5,19,24,65,17,0,0,2021-2022,1.1374407582938388,1.943127962085308
1337,Jean-Armel Kana-Biyik,CMR,DF,Metz,Ligue 1,32,1989,7.4,10,6,8,2,0,4,9,44.4,5,11,4,7,16,26,22,1,0,2021-2022,2.162162162162162,1.3513513513513513
1338,Nordine Kandil,FRA,"MF,FW",Strasbourg,Ligue 1,19,2001,1.0,2,1,2,0,0,1,1,100.0,0,1,1,0,0,2,0,0,0,2021-2022,0.0,2.0
1339,Harry Kane,ENG,FW,Tottenham,Premier League,28,1993,35.9,15,5,2,10,3,7,18,38.9,11,26,8,18,3,18,39,0,0,2021-2022,0.08356545961002786,0.4178272980501393
1340,Lee Kang-in,KOR,"MF,FW",Mallorca,La Liga,20,2001,15.7,13,6,2,9,2,5,29,17.2,24,11,1,10,5,18,7,0,0,2021-2022,0.3184713375796179,0.8280254777070064
1341,N'Golo Kanté,FRA,MF,Chelsea,Premier League,30,1991,19.7,59,31,20,27,12,25,40,62.5,15,37,2,35,31,90,8,0,0,2021-2022,1.5736040609137056,2.9949238578680206
1342,Stefanos Kapino,GRE,GK,Arminia,Bundesliga,27,1994,1.0,0,0,0,0,0,0,0,0.0,0,0,0,0,0,0,0,0,0,2021-2022,0.0,0.0
1343,Atakan Karazor,GER,MF,Stuttgart,Bundesliga,24,1996,21.1,48,24,18,27,3,18,36,50.0,18,37,14,23,34,82,47,0,0,2021-2022,1.6113744075829384,2.2748815165876777
1344,Rick Karsdorp,NED,"DF,FW",Roma,Serie A,26,1995,32.0,53,38,33,13,7,28,50,56.0,22,22,5,17,34,87,26,1,0,2021-2022,1.0625,1.65625
1345,Denso Kasius,NED,"DF,FW",Bologna,Serie A,18,2002,2.0,9,7,5,3,1,2,5,40.0,3,4,0,4,3,12,4,0,0,2021-2022,1.5,4.5
1346,Grigoris Kastanos,CYP,"MF,FW",Salernitana,Serie A,23,1998,15.0,30,19,9,19,2,7,23,30.4,16,21,5,16,22,52,8,0,0,2021-2022,1.4666666666666666,2.0
1347,Silas Katompa,COD,"FW,MF",Stuttgart,Bundesliga,22,1998,3.1,5,4,4,0,1,3,7,42.9,4,5,0,5,2,7,1,0,0,2021-2022,0.6451612903225806,1.6129032258064515
1348,Noah Katterbach,GER,DF,Köln,Bundesliga,20,2001,0.2,1,1,1,0,0,1,1,100.0,0,0,0,0,0,1,1,0,0,2021-2022,0.0,5.0
1349,Eiji Kawashima,JPN,GK,Strasbourg,Ligue 1,38,1983,1.0,0,0,0,0,0,0,0,0.0,0,0,0,0,0,0,0,0,0,2021-2022,0.0,0.0
1350,Edo Kayembe,COD,MF,Watford,Premier League,23,1998,8.9,21,13,11,9,1,8,16,50.0,8,6,1,5,9,30,13,0,0,2021-2022,1.0112359550561798,2.359550561797753
Rk,Player,Nation,Pos,Squad,Comp,0,0,90.0,0,0,3,3,3,Tkl,0,0.0,0,0,0,0,0,0,0,0,0,2021-2022,0.0,0.0
1351,Moise Kean,ITA,FW,Everton,Premier League,21,2000,0.0,0,0,0,0,0,0,0,0.0,0,0,0,0,0,0,0,0,0,2021-2022,,
1352,Moise Kean,ITA,FW,Juventus,Serie A,21,2000,12.2,9,4,2,5,2,6,16,37.5,10,5,0,5,3,12,8,1,0,2021-2022,0.24590163934426232,0.7377049180327869
1353,Michael Keane,ENG,DF,Everton,Premier League,28,1993,31.0,46,25,32,13,1,28,45,62.2,17,33,28,5,62,108,128,2,0,2021-2022,2.0,1.4838709677419355
1354,Ilan Kebbal,ALG,"MF,FW",Reims,Ligue 1,23,1998,19.7,31,15,13,10,8,12,44,27.3,32,16,0,16,13,44,3,0,0,2021-2022,0.6598984771573604,1.5736040609137056
1355,Wajdi Kechrida,TUN,"DF,MF",Salernitana,Serie A,25,1995,10.6,9,6,6,3,0,8,13,61.5,5,10,2,8,8,17,15,0,0,2021-2022,0.7547169811320755,0.8490566037735849
1356,Thilo Kehrer,GER,DF,Paris S-G,Ligue 1,24,1996,16.8,21,14,9,11,1,9,21,42.9,12,19,11,8,24,45,29,0,0,2021-2022,1.4285714285714286,1.25
1357,Habib Keita,MLI,"MF,FW",Lyon,Ligue 1,19,2002,0.1,0,0,0,0,0,0,0,0.0,0,0,0,0,0,0,0,0,0,2021-2022,0.0,0.0
1358,Naby Keïta,GUI,MF,Liverpool,Premier League,26,1995,13.0,46,23,17,19,10,26,42,61.9,16,33,2,31,14,60,8,0,0,2021-2022,1.0769230769230769,3.5384615384615383
1359,Yannik Keitel,GER,MF,Freiburg,Bundesliga,21,2000,5.6,11,4,5,4,2,5,15,33.3,10,7,1,6,1,12,8,0,0,2021-2022,0.17857142857142858,1.9642857142857144
1360,Caoimhín Kelleher,IRL,GK,Liverpool,Premier League,22,1998,2.0,1,1,1,0,0,1,1,100.0,0,0,0,0,0,1,1,0,0,2021-2022,0.0,0.5
1361,Marc-Oliver Kempf,GER,DF,Hertha BSC,Bundesliga,26,1995,11.7,10,9,9,1,0,5,14,35.7,9,14,7,7,25,35,49,1,0,2021-2022,2.1367521367521367,0.8547008547008548
1362,Marc-Oliver Kempf,GER,DF,Stuttgart,Bundesliga,26,1995,9.3,13,8,7,4,2,3,10,30.0,7,16,14,2,16,29,26,2,0,2021-2022,1.7204301075268815,1.3978494623655913
1363,Kenedy,BRA,DF,Chelsea,Premier League,25,1996,0.6,5,2,1,2,2,2,3,66.7,1,0,0,0,0,5,0,0,0,2021-2022,0.0,8.333333333333334
1364,Jonjoe Kenny,ENG,DF,Everton,Premier League,24,1997,11.3,17,7,11,6,0,13,21,61.9,8,8,1,7,20,37,31,0,0,2021-2022,1.7699115044247786,1.5044247787610618
1365,Dimitrios Keramitsis,GRE,MF,Roma,Serie A,17,2004,0.0,0,0,0,0,0,0,0,0.0,0,0,0,0,0,0,0,0,0,2021-2022,,
1366,Franck Kessié,CIV,MF,Milan,Serie A,24,1996,25.6,41,23,12,24,5,17,26,65.4,9,39,10,29,23,64,22,0,0,2021-2022,0.8984375,1.6015625
1367,Saîf-Eddine Khaoui,TUN,"MF,FW",Clermont Foot,Ligue 1,26,1995,10.3,19,10,5,10,4,9,18,50.0,9,9,0,9,14,33,5,0,0,2021-2022,1.3592233009708736,1.8446601941747571
1368,Wahbi Khazri,TUN,"FW,MF",Saint-Étienne,Ligue 1,30,1991,24.7,33,18,7,17,9,9,34,26.5,25,21,0,21,12,45,7,0,0,2021-2022,0.4858299595141701,1.3360323886639676
1369,Rani Khedira,GER,MF,Union Berlin,Bundesliga,27,1994,30.6,75,38,25,42,8,32,66,48.5,34,21,8,13,50,125,27,1,0,2021-2022,1.6339869281045751,2.4509803921568625
1370,Kiké,ESP,FW,Osasuna,La Liga,31,1989,20.7,11,7,3,4,4,3,23,13.0,20,10,1,9,3,14,12,0,0,2021-2022,0.14492753623188406,0.5314009661835749
1371,Luca Kilian,GER,FW,Mainz 05,Bundesliga,21,1999,0.0,0,0,0,0,0,0,0,0.0,0,0,0,0,0,0,0,0,0,2021-2022,,
1372,Luca Kilian,GER,DF,Köln,Bundesliga,21,1999,25.3,42,24,30,9,3,21,41,51.2,20,31,13,18,46,88,109,3,0,2021-2022,1.8181818181818181,1.6600790513833992
1373,Max Kilman,ENG,DF,Wolves,Premier League,24,1997,29.9,50,26,38,10,2,24,37,64.9,13,36,21,15,45,95,113,3,0,2021-2022,1.5050167224080269,1.6722408026755853
1374,Joshua Kimmich,GER,MF,Bayern Munich,Bundesliga,26,1995,27.5,39,20,14,17,8,18,58,31.0,40,34,8,26,52,91,29,1,0,2021-2022,1.8909090909090909,1.4181818181818182
1375,Presnel Kimpembe,FRA,DF,Paris S-G,Ligue 1,25,1995,28.6,34,19,18,15,1,14,23,60.9,9,20,14,6,38,72,73,1,0,2021-2022,1.3286713286713285,1.1888111888111887
Rk,Player,Nation,Pos,Squad,Comp,0,0,90.0,0,0,3,3,3,Tkl,0,0.0,0,0,0,0,0,0,0,0,0,2021-2022,0.0,0.0
1376,Joshua King,NOR,FW,Watford,Premier League,29,1992,25.0,19,15,7,6,6,4,17,23.5,13,15,4,11,8,27,31,0,0,2021-2022,0.32,0.76
1377,Jakub Kiwior,POL,MF,Spezia,Serie A,21,2000,21.8,50,27,25,19,6,26,57,45.6,31,38,15,23,40,90,53,0,0,2021-2022,1.8348623853211008,2.293577981651376
1378,Sofian Kiyine,MAR,"MF,FW",Venezia,Serie A,23,1997,13.8,24,14,9,11,4,12,32,37.5,20,15,1,14,10,34,9,0,0,2021-2022,0.7246376811594203,1.7391304347826086
1379,Simon Kjær,DEN,DF,Milan,Serie A,32,1989,8.9,20,12,9,8,3,6,12,50.0,6,17,13,4,9,29,39,0,0,2021-2022,1.0112359550561798,2.2471910112359548
1380,Kristoffer Klaesson,NOR,GK,Leeds United,Premier League,20,2000,0.4,0,0,0,0,0,0,0,0.0,0,0,0,0,0,0,0,0,0,2021-2022,0.0,0.0
1381,Philipp Klement,GER,MF,Stuttgart,Bundesliga,28,1992,3.8,7,3,1,4,2,3,3,100.0,0,6,1,5,1,8,0,0,0,2021-2022,0.2631578947368421,1.842105263157895
1382,Mateusz Klich,POL,MF,Leeds United,Premier League,31,1990,23.0,47,25,18,23,6,25,66,37.9,41,22,4,18,11,58,20,0,0,2021-2022,0.4782608695652174,2.0434782608695654
1383,Thibault Klidje,TOG,"MF,FW",Bordeaux,Ligue 1,20,2001,1.0,0,0,0,0,0,0,1,0.0,1,1,1,0,2,2,0,0,0,2021-2022,2.0,0.0
1384,Mateo Klimowicz,GER,"MF,FW",Stuttgart,Bundesliga,21,2000,6.7,13,6,6,7,0,5,16,31.3,11,2,0,2,4,17,3,0,0,2021-2022,0.5970149253731343,1.9402985074626866
1385,Fabian Klos,GER,FW,Arminia,Bundesliga,33,1987,15.8,7,5,0,5,2,2,10,20.0,8,17,4,13,0,7,31,0,0,2021-2022,0.0,0.4430379746835443
1386,Lukas Klostermann,GER,DF,RB Leipzig,Bundesliga,25,1996,18.3,29,16,11,15,3,13,19,68.4,6,16,3,13,26,55,58,0,0,2021-2022,1.4207650273224044,1.5846994535519126
1387,Justin Kluivert,NED,MF,Nice,Ligue 1,22,1999,20.8,19,9,6,12,1,5,21,23.8,16,13,1,12,14,33,6,0,0,2021-2022,0.673076923076923,0.9134615384615384
1388,Lukas Klünter,GER,DF,Hertha BSC,Bundesliga,25,1996,2.2,1,1,1,0,0,1,5,20.0,4,1,0,1,2,3,2,0,0,2021-2022,0.9090909090909091,0.45454545454545453
1389,Ansgar Knauff,GER,"FW,MF",Dortmund,Bundesliga,19,2002,1.3,3,1,1,1,1,0,4,0.0,4,2,0,2,0,3,4,0,0,2021-2022,0.0,2.3076923076923075
1390,Ansgar Knauff,GER,"DF,MF",Eint Frankfurt,Bundesliga,19,2002,8.4,18,14,8,5,5,8,15,53.3,7,11,1,10,8,26,6,0,0,2021-2022,0.9523809523809523,2.142857142857143
1391,Robin Knoche,GER,DF,Union Berlin,Bundesliga,29,1992,33.0,50,24,38,12,0,30,53,56.6,23,45,26,19,49,99,151,1,0,2021-2022,1.4848484848484849,1.5151515151515151
1392,Gregor Kobel,SUI,GK,Dortmund,Bundesliga,23,1997,28.5,0,0,0,0,0,0,2,0.0,2,0,0,0,1,1,20,0,0,2021-2022,0.03508771929824561,0.0
1393,Robin Koch,GER,"MF,DF",Leeds United,Premier League,25,1996,17.5,21,13,9,10,2,9,34,26.5,25,26,10,16,20,41,44,0,0,2021-2022,1.1428571428571428,1.2
1394,Samuel Koeberlé,FRA,FW,Reims,Ligue 1,16,2004,0.0,0,0,0,0,0,0,0,0.0,0,0,0,0,0,0,0,0,0,2021-2022,,
1395,Philippe Koffi,CIV,FW,Reims,Ligue 1,19,2002,4.2,4,0,0,3,1,0,2,0.0,2,2,1,1,3,7,3,0,0,2021-2022,0.7142857142857143,0.9523809523809523
1396,Dominik Kohr,GER,MF,Mainz 05,Bundesliga,27,1994,17.9,40,20,18,19,3,16,42,38.1,26,21,2,19,35,75,22,0,0,2021-2022,1.9553072625698324,2.23463687150838
1397,Koba Koindredi,FRA,MF,Valencia,La Liga,19,2001,2.0,4,3,2,1,1,2,6,33.3,4,3,0,3,4,8,5,0,0,2021-2022,2.0,2.0
1398,Koke,ESP,MF,Atlético Madrid,La Liga,29,1992,27.9,55,30,19,29,7,26,63,41.3,37,21,5,16,24,79,31,1,0,2021-2022,0.8602150537634409,1.9713261648745521
1399,Aleksandr Kokorin,RUS,"FW,MF",Fiorentina,Serie A,30,1991,0.6,1,1,1,0,0,0,0,0.0,0,1,0,1,0,1,0,0,0,2021-2022,0.0,1.6666666666666667
1400,Aleksandar Kolarov,SRB,DF,Inter,Serie A,35,1985,0.5,1,1,1,0,0,1,1,100.0,0,0,0,0,1,2,2,0,0,2021-2022,2.0,2.0
Rk,Player,Nation,Pos,Squad,Comp,0,0,90.0,0,0,3,3,3,Tkl,0,0.0,0,0,0,0,0,0,0,0,0,2021-2022,0.0,0.0
1401,Sead Kolašinac,BIH,DF,Arsenal,Premier League,28,1993,1.0,0,0,0,0,0,0,0,0.0,0,0,0,0,4,4,1,0,0,2021-2022,4.0,0.0
1402,Sead Kolašinac,BIH,DF,Marseille,Ligue 1,28,1993,4.9,7,6,2,3,2,5,8,62.5,3,4,0,4,0,7,7,1,0,2021-2022,0.0,1.4285714285714284
1403,Luca Koleosho,ITA,FW,Espanyol,La Liga,16,2004,0.0,0,0,0,0,0,0,0,0.0,0,0,0,0,0,0,0,0,0,2021-2022,,
1404,Randal Kolo Muani,FRA,"FW,MF",Nantes,Ligue 1,22,1998,32.8,28,14,7,10,11,10,25,40.0,15,14,3,11,6,34,31,0,0,2021-2022,0.1829268292682927,0.853658536585366
1405,Timothée Kolodziejczak,FRA,DF,Saint-Étienne,Ligue 1,29,1991,28.5,43,24,22,14,7,20,36,55.6,16,29,7,22,60,103,72,1,0,2021-2022,2.1052631578947367,1.5087719298245614
1406,Ghislain Konan,CIV,DF,Reims,Ligue 1,25,1995,26.9,35,19,19,15,1,16,30,53.3,14,35,8,27,28,63,45,0,0,2021-2022,1.0408921933085502,1.3011152416356877
1407,Ibrahima Konaté,FRA,DF,Liverpool,Premier League,22,1999,11.0,16,10,9,6,1,7,10,70.0,3,13,9,4,16,32,37,1,0,2021-2022,1.4545454545454546,1.4545454545454546
1408,Geoffrey Kondogbia,CTA,"MF,DF",Atlético Madrid,La Liga,28,1993,20.9,74,44,25,40,9,21,49,42.9,28,16,5,11,44,118,24,0,0,2021-2022,2.105263157894737,3.5406698564593304
1409,Ibrahima Koné,MLI,FW,Lorient,Ligue 1,22,1999,8.1,7,4,0,3,4,2,3,66.7,1,8,3,5,1,8,3,0,0,2021-2022,0.1234567901234568,0.8641975308641976
1410,Manu Koné,FRA,MF,Gladbach,Bundesliga,20,2001,24.3,60,37,29,28,3,25,42,59.5,17,27,4,23,34,94,12,0,0,2021-2022,1.3991769547325101,2.4691358024691357
1411,Youssouf Koné,MLI,DF,Troyes,Ligue 1,26,1995,10.9,30,18,21,8,1,19,30,63.3,11,8,3,5,10,40,25,0,0,2021-2022,0.9174311926605504,2.7522935779816513
1412,Ezri Konsa,ENG,DF,Aston Villa,Premier League,23,1997,27.5,25,15,13,11,1,10,13,76.9,3,31,22,9,15,40,86,2,0,2021-2022,0.5454545454545454,0.9090909090909091
1413,Teun Koopmeiners,NED,MF,Atalanta,Serie A,23,1998,23.6,40,24,10,19,11,22,54,40.7,32,31,2,29,15,55,19,0,0,2021-2022,0.635593220338983,1.694915254237288
1414,Laurent Koscielny,FRA,DF,Bordeaux,Ligue 1,35,1985,10.4,14,9,10,3,1,8,13,61.5,5,17,12,5,12,26,39,0,0,2021-2022,1.1538461538461537,1.346153846153846
1415,Odilon Kossonou,CIV,DF,Leverkusen,Bundesliga,20,2001,19.9,23,17,16,6,1,15,25,60.0,10,36,14,22,26,49,66,0,0,2021-2022,1.306532663316583,1.155778894472362
1416,Filip Kostić,SRB,"DF,FW",Eint Frankfurt,Bundesliga,28,1992,28.0,44,17,26,9,9,20,53,37.7,33,24,1,23,15,59,24,0,0,2021-2022,0.5357142857142857,1.5714285714285714
1417,Rominigue Kouamé,MLI,MF,Troyes,Ligue 1,24,1996,33.0,47,22,24,20,3,19,58,32.8,39,33,5,28,46,93,22,2,0,2021-2022,1.393939393939394,1.4242424242424243
1418,Kalidou Koulibaly,SEN,DF,Napoli,Serie A,30,1991,26.7,39,23,31,6,2,25,38,65.8,13,41,25,16,29,68,90,1,0,2021-2022,1.0861423220973783,1.4606741573033708
1419,Jules Koundé,FRA,DF,Sevilla,La Liga,22,1998,30.4,40,17,27,10,3,18,28,64.3,10,33,18,15,21,61,101,2,0,2021-2022,0.6907894736842105,1.3157894736842106
1420,Christos Kourfalidis,GRE,"MF,FW",Cagliari,Serie A,18,2002,0.2,0,0,0,0,0,0,1,0.0,1,1,0,1,0,0,0,0,0,2021-2022,0.0,0.0
1421,Boubakar Kouyaté,MLI,DF,Metz,Ligue 1,24,1997,29.6,84,50,56,28,0,48,77,62.3,29,63,33,30,79,163,217,3,0,2021-2022,2.668918918918919,2.8378378378378377
1422,Cheikhou Kouyaté,SEN,MF,Crystal Palace,Premier League,31,1989,21.9,52,38,28,22,2,18,39,46.2,21,40,14,26,38,90,39,0,0,2021-2022,1.7351598173515983,2.3744292237442925
1423,Mateo Kovačić,CRO,MF,Chelsea,Premier League,27,1994,17.3,51,31,14,26,11,17,35,48.6,18,19,4,15,7,58,9,1,0,2021-2022,0.40462427745664736,2.9479768786127165
1424,Viktor Kovalenko,UKR,MF,Spezia,Serie A,25,1996,14.7,16,10,7,8,1,9,21,42.9,12,16,3,13,13,29,8,0,0,2021-2022,0.8843537414965987,1.08843537414966
1425,Emil Krafth,SWE,DF,Newcastle Utd,Premier League,26,1994,18.2,37,16,25,11,1,27,36,75.0,9,16,10,6,25,62,56,0,0,2021-2022,1.3736263736263736,2.032967032967033
Rk,Player,Nation,Pos,Squad,Comp,0,0,90.0,0,0,3,3,3,Tkl,0,0.0,0,0,0,0,0,0,0,0,0,2021-2022,0.0,0.0
1426,Alex Král,CZE,MF,West Ham,Premier League,23,1998,0.0,0,0,0,0,0,0,0,0.0,0,0,0,0,0,0,0,0,0,2021-2022,,
1427,Andrej Kramarić,CRO,"FW,MF",Hoffenheim,Bundesliga,30,1991,30.1,8,4,1,5,2,7,17,41.2,10,10,0,10,9,17,7,1,0,2021-2022,0.2990033222591362,0.26578073089700993
1428,Christoph Kramer,GER,MF,Gladbach,Bundesliga,30,1991,8.3,28,11,15,10,3,12,28,42.9,16,18,5,13,12,40,9,0,0,2021-2022,1.4457831325301203,3.373493975903614
1429,Jean-Philippe Krasso,CIV,FW,Saint-Étienne,Ligue 1,24,1997,5.0,7,5,0,5,2,2,10,20.0,8,7,1,6,0,7,1,0,0,2021-2022,0.0,1.4
1430,Julian Kristoffersen,NOR,FW,Salernitana,Serie A,24,1997,0.1,0,0,0,0,0,0,0,0.0,0,0,0,0,0,0,0,0,0,2021-2022,0.0,0.0
1431,Toni Kroos,GER,MF,Real Madrid,La Liga,31,1990,23.4,34,26,13,17,4,14,36,38.9,22,16,3,13,12,46,13,1,0,2021-2022,0.5128205128205129,1.4529914529914532
1432,Florian Krüger,GER,"FW,MF",Arminia,Bundesliga,22,1999,12.5,3,1,0,3,0,2,10,20.0,8,12,1,11,2,5,13,0,0,2021-2022,0.16,0.24
1433,Tim Krul,NED,GK,Norwich City,Premier League,33,1988,29.0,1,1,1,0,0,1,4,25.0,3,0,0,0,0,1,10,4,0,2021-2022,0.0,0.034482758620689655
1434,Rade Krunić,BIH,"MF,FW",Milan,Serie A,27,1993,15.7,33,18,16,14,3,15,31,48.4,16,19,2,17,16,49,17,0,0,2021-2022,1.019108280254777,2.1019108280254777
1435,Max Kruse,GER,"MF,FW",Wolfsburg,Bundesliga,33,1988,12.5,9,3,4,4,1,5,12,41.7,7,2,0,2,3,12,4,0,0,2021-2022,0.24,0.72
1436,Max Kruse,GER,"FW,MF",Union Berlin,Bundesliga,33,1988,14.1,4,1,0,3,1,2,16,12.5,14,12,0,12,3,7,2,0,0,2021-2022,0.2127659574468085,0.28368794326241137
1437,Lukas Kübler,GER,"DF,MF",Freiburg,Bundesliga,28,1992,25.9,62,35,38,16,8,28,49,57.1,21,24,8,16,44,106,70,0,0,2021-2022,1.698841698841699,2.393822393822394
1438,Takefusa Kubo,JPN,"FW,MF",Mallorca,La Liga,20,2001,17.8,31,19,12,14,5,10,24,41.7,14,24,3,21,8,39,4,0,0,2021-2022,0.449438202247191,1.7415730337078652
1439,Juraj Kucka,SVK,MF,Watford,Premier League,34,1987,21.3,59,39,32,25,2,27,73,37.0,46,30,9,21,27,86,46,2,0,2021-2022,1.2676056338028168,2.7699530516431925
1440,Mykola Kukharevych,UKR,FW,Troyes,Ligue 1,20,2001,0.2,0,0,0,0,0,0,0,0.0,0,0,0,0,0,0,0,0,0,2021-2022,0.0,0.0
1441,Dejan Kulusevski,SWE,"MF,FW",Tottenham,Premier League,21,2000,14.0,19,13,7,10,2,5,23,21.7,18,14,0,14,13,32,3,0,0,2021-2022,0.9285714285714286,1.3571428571428572
1442,Dejan Kulusevski,SWE,"FW,MF",Juventus,Serie A,21,2000,8.6,15,12,9,6,0,8,21,38.1,13,14,0,14,5,20,5,0,0,2021-2022,0.5813953488372093,1.744186046511628
1443,Marash Kumbulla,ALB,DF,Roma,Serie A,21,2000,11.4,21,13,13,7,1,8,15,53.3,7,17,8,9,16,37,26,0,0,2021-2022,1.4035087719298245,1.8421052631578947
1444,Fabian Kunze,GER,MF,Arminia,Bundesliga,23,1998,14.0,35,21,14,20,1,15,32,46.9,17,17,2,15,19,54,27,1,0,2021-2022,1.3571428571428572,2.5
1445,Enock Kwateng,FRA,DF,Bordeaux,Ligue 1,24,1997,22.2,54,35,31,19,4,33,72,45.8,39,17,4,13,43,97,48,1,0,2021-2022,1.936936936936937,2.4324324324324325
1446,Grejohn Kyei,FRA,FW,Clermont Foot,Ligue 1,25,1995,4.4,3,2,1,1,1,0,6,0.0,6,6,0,6,0,3,1,0,0,2021-2022,0.0,0.6818181818181818
1447,Giorgos Kyriakopoulos,GRE,"DF,FW",Sassuolo,Serie A,25,1996,21.9,30,14,19,7,4,19,38,50.0,19,32,9,23,11,41,52,0,0,2021-2022,0.5022831050228311,1.3698630136986303
1448,Andrea La Mantia,ITA,"FW,MF",Empoli,Serie A,30,1991,5.4,2,0,0,0,2,1,2,50.0,1,3,1,2,1,3,6,0,0,2021-2022,0.18518518518518517,0.37037037037037035
1449,Gaëtan Laborde,FRA,FW,Montpellier,Ligue 1,27,1994,3.8,2,2,1,1,0,2,4,50.0,2,3,0,3,5,7,5,0,0,2021-2022,1.3157894736842106,0.5263157894736842
1450,Gaëtan Laborde,FRA,FW,Rennes,Ligue 1,27,1994,30.3,19,7,5,8,6,3,22,13.6,19,29,3,26,8,27,16,0,0,2021-2022,0.264026402640264,0.6270627062706271
Rk,Player,Nation,Pos,Squad,Comp,0,0,90.0,0,0,3,3,3,Tkl,0,0.0,0,0,0,0,0,0,0,0,0,2021-2022,0.0,0.0
1451,Alexandre Lacazette,FRA,FW,Arsenal,Premier League,30,1991,19.8,27,10,8,13,6,7,21,33.3,14,12,1,11,5,32,6,0,0,2021-2022,0.25252525252525254,1.3636363636363635
1452,Tom Lacoux,FRA,"DF,MF",Bordeaux,Ligue 1,19,2002,10.1,18,13,11,5,2,9,24,37.5,15,14,4,10,9,27,20,1,0,2021-2022,0.8910891089108911,1.7821782178217822
1453,Lenny Lacroix,FRA,DF,Metz,Ligue 1,18,2003,2.2,9,7,8,1,0,5,8,62.5,3,5,1,4,10,19,5,0,0,2021-2022,4.545454545454545,4.090909090909091
1454,Maxence Lacroix,FRA,DF,Wolfsburg,Bundesliga,21,2000,27.7,59,33,41,16,2,29,40,72.5,11,35,16,19,60,119,144,0,0,2021-2022,2.1660649819494586,2.1299638989169676
1455,Alban Lafont,FRA,GK,Nantes,Ligue 1,22,1999,38.0,3,3,3,0,0,3,8,37.5,5,1,0,1,1,4,25,2,0,2021-2022,0.02631578947368421,0.07894736842105263
1456,Víctor Laguardia,ESP,DF,Alavés,La Liga,31,1989,33.8,29,16,21,8,0,19,30,63.3,11,36,24,12,27,56,151,1,0,2021-2022,0.7988165680473374,0.8579881656804734
1457,Konrad Laimer,AUT,MF,RB Leipzig,Bundesliga,24,1997,13.8,38,24,11,22,5,24,53,45.3,29,29,3,26,4,42,9,0,0,2021-2022,0.2898550724637681,2.753623188405797
1458,Stefan Lainer,AUT,DF,Gladbach,Bundesliga,28,1992,16.3,19,11,9,7,3,12,28,42.9,16,24,5,19,14,33,31,0,0,2021-2022,0.8588957055214723,1.165644171779141
1459,Diego Lainez,MEX,FW,Betis,La Liga,21,2000,1.6,1,1,0,1,0,0,3,0.0,3,3,0,3,1,2,0,0,0,2021-2022,0.625,0.625
1460,Adam Lallana,ENG,MF,Brighton,Premier League,33,1988,17.3,34,17,14,14,6,12,41,29.3,29,16,6,10,16,50,13,1,0,2021-2022,0.9248554913294798,1.9653179190751444
1461,Vassilis Lambropoulos,GRE,DF,Bochum,Bundesliga,31,1990,13.0,18,12,13,3,2,11,25,44.0,14,21,10,11,17,35,56,0,0,2021-2022,1.3076923076923077,1.3846153846153846
1462,Érik Lamela,ARG,"FW,MF",Sevilla,La Liga,29,1992,11.3,31,18,12,14,5,10,29,34.5,19,11,0,11,5,36,3,0,0,2021-2022,0.44247787610619466,2.743362831858407
1463,Mohamed Lamine Bayo,GUI,FW,Clermont Foot,Ligue 1,23,1998,26.8,12,5,4,3,5,3,24,12.5,21,7,1,6,7,19,14,0,0,2021-2022,0.26119402985074625,0.44776119402985076
1464,Didier Lamkel Zé,CMR,FW,Metz,Ligue 1,24,1996,6.7,3,1,1,0,2,1,3,33.3,2,3,1,2,1,4,7,0,0,2021-2022,0.14925373134328357,0.44776119402985076
1465,Sam Lammers,NED,"FW,MF",Atalanta,Serie A,24,1997,0.4,1,0,0,0,1,0,0,0.0,0,0,0,0,0,1,0,0,0,2021-2022,0.0,2.5
1466,Sam Lammers,NED,"FW,MF",Eint Frankfurt,Bundesliga,24,1997,5.7,4,4,0,2,2,2,6,33.3,4,9,2,7,2,6,4,0,0,2021-2022,0.3508771929824561,0.7017543859649122
1467,Tariq Lamptey,GHA,"DF,FW",Brighton,Premier League,20,2000,17.3,36,25,14,17,5,15,25,60.0,10,13,3,10,21,57,23,0,0,2021-2022,1.2138728323699421,2.0809248554913293
1468,Manuel Lanzini,ARG,"MF,FW",West Ham,Premier League,28,1993,19.8,28,15,10,11,7,10,35,28.6,25,16,0,16,19,47,10,0,0,2021-2022,0.9595959595959596,1.4141414141414141
1469,Aymeric Laporte,ESP,DF,Manchester City,Premier League,27,1994,31.4,33,15,22,10,1,14,20,70.0,6,15,10,5,20,53,64,2,0,2021-2022,0.6369426751592357,1.0509554140127388
1470,Julien Laporte,FRA,DF,Lorient,Ligue 1,27,1993,32.1,63,45,35,26,2,32,64,50.0,32,37,22,15,54,117,174,0,0,2021-2022,1.6822429906542056,1.9626168224299065
1471,Yasser Larouci,ALG,DF,Troyes,Ligue 1,20,2001,3.8,6,5,2,4,0,3,3,100.0,0,1,0,1,7,13,5,0,0,2021-2022,1.842105263157895,1.5789473684210527
1472,Kevin Lasagna,ITA,"MF,FW",Hellas Verona,Serie A,28,1992,13.2,13,7,4,5,4,4,15,26.7,11,16,0,16,3,16,7,0,0,2021-2022,0.2272727272727273,0.9848484848484849
1473,Jamaal Lascelles,ENG,DF,Newcastle Utd,Premier League,27,1993,22.9,15,7,9,5,1,4,12,33.3,8,38,28,10,22,37,121,1,0,2021-2022,0.9606986899563319,0.6550218340611355
1474,Bryan Lasme,FRA,FW,Arminia,Bundesliga,22,1998,9.7,6,6,1,2,3,0,3,0.0,3,7,0,7,1,7,9,0,0,2021-2022,0.10309278350515465,0.6185567010309279
1475,Paul Lasne,FRA,MF,Brest,Ligue 1,32,1989,9.4,26,12,6,16,4,8,18,44.4,10,11,2,9,24,50,10,0,0,2021-2022,2.553191489361702,2.7659574468085104
Rk,Player,Nation,Pos,Squad,Comp,0,0,90.0,0,0,3,3,3,Tkl,0,0.0,0,0,0,0,0,0,0,0,0,2021-2022,0.0,0.0
1476,Juanmi Latasa,ESP,FW,Real Madrid,La Liga,20,2001,0.1,0,0,0,0,0,0,0,0.0,0,0,0,0,0,0,0,0,0,2021-2022,0.0,0.0
1477,Toni Lato,ESP,DF,Valencia,La Liga,23,1997,6.6,17,12,12,3,2,9,16,56.3,7,6,0,6,8,25,14,0,0,2021-2022,1.2121212121212122,2.5757575757575757
1478,Armand Lauriente,FRA,"FW,MF",Lorient,Ligue 1,22,1998,27.5,33,18,9,16,8,11,30,36.7,19,27,2,25,15,48,3,0,0,2021-2022,0.5454545454545454,1.2
1479,Darko Lazović,SRB,DF,Hellas Verona,Serie A,30,1990,30.7,36,23,20,8,8,21,39,53.8,18,28,4,24,19,55,49,1,0,2021-2022,0.6188925081433225,1.1726384364820848
1480,Manuel Lazzari,ITA,DF,Lazio,Serie A,27,1993,18.5,28,14,13,15,0,16,26,61.5,10,10,2,8,12,40,16,1,0,2021-2022,0.6486486486486487,1.5135135135135136
1481,Théo Le Bris,FRA,MF,Lorient,Ligue 1,18,2002,0.7,2,1,1,1,0,1,2,50.0,1,2,0,2,0,2,1,0,0,2021-2022,0.0,2.857142857142857
1482,Jérémy Le Douaron,FRA,"FW,MF",Brest,Ligue 1,23,1998,16.1,11,5,4,4,3,1,17,5.9,16,15,0,15,4,15,14,0,0,2021-2022,0.24844720496894407,0.6832298136645962
1483,Enzo Le Fée,FRA,"MF,FW",Lorient,Ligue 1,21,2000,24.4,70,44,25,36,9,41,90,45.6,49,25,1,24,29,99,18,0,0,2021-2022,1.1885245901639345,2.8688524590163937
1484,Vincent Le Goff,FRA,DF,Lorient,Ligue 1,31,1989,34.0,61,38,38,19,4,37,62,59.7,25,18,3,15,37,98,50,0,0,2021-2022,1.088235294117647,1.7941176470588236
1485,Maxime Le Marchand,FRA,DF,Strasbourg,Ligue 1,31,1989,9.6,17,8,16,1,0,8,10,80.0,2,9,5,4,14,31,32,0,0,2021-2022,1.4583333333333335,1.7708333333333335
1486,Robin Le Normand,ESP,DF,Real Sociedad,La Liga,24,1996,37.0,49,32,36,8,5,28,36,77.8,8,34,22,12,48,97,125,0,0,2021-2022,1.2972972972972974,1.3243243243243243
1487,Patrick Leal,USA,FW,Venezia,Serie A,18,2003,0.0,0,0,0,0,0,0,1,0.0,1,0,0,0,0,0,0,0,0,2021-2022,,
1488,Rafael Leão,POR,FW,Milan,Serie A,22,1999,28.9,17,7,3,9,5,10,20,50.0,10,12,1,11,12,29,8,0,0,2021-2022,0.4152249134948097,0.5882352941176471
1489,Jean-Louis Leca,FRA,GK,Lens,Ligue 1,35,1985,25.7,0,0,0,0,0,0,0,0.0,0,1,0,1,1,1,11,1,0,2021-2022,0.038910505836575876,0.0
1490,Jeremías Ledesma,ARG,GK,Cádiz,La Liga,28,1993,38.0,3,1,3,0,0,3,4,75.0,1,0,0,0,1,4,21,4,0,2021-2022,0.02631578947368421,0.07894736842105263
1491,Pierre Lees-Melou,FRA,MF,Norwich City,Premier League,28,1993,25.2,58,36,23,29,6,25,92,27.2,67,37,11,26,25,83,23,0,0,2021-2022,0.9920634920634921,2.301587301587302
1492,Wu Lei,CHN,"FW,MF",Espanyol,La Liga,29,1991,5.3,3,2,1,2,0,3,8,37.5,5,4,0,4,4,7,3,0,0,2021-2022,0.7547169811320755,0.5660377358490566
1493,Maxim Leitsch,GER,DF,Bochum,Bundesliga,23,1998,17.1,18,10,9,7,2,10,15,66.7,5,31,19,12,31,49,74,1,0,2021-2022,1.8128654970760232,1.0526315789473684
1494,Lucas Leiva,BRA,MF,Lazio,Serie A,34,1987,18.9,55,30,26,25,4,15,53,28.3,38,27,10,17,28,83,37,0,0,2021-2022,1.4814814814814816,2.9100529100529102
1495,Florian Lejeune,FRA,DF,Alavés,La Liga,30,1991,30.0,33,24,22,10,1,12,20,60.0,8,30,19,11,31,64,158,0,0,2021-2022,1.0333333333333334,1.1
1496,Iñigo Lekue,ESP,DF,Athletic Club,La Liga,28,1993,21.4,32,23,16,12,4,22,44,50.0,22,37,12,25,23,55,63,0,0,2021-2022,1.074766355140187,1.4953271028037385
1497,Thomas Lemar,FRA,MF,Atlético Madrid,La Liga,25,1995,16.0,24,14,9,12,3,8,23,34.8,15,18,0,18,8,32,11,0,0,2021-2022,0.5,1.5
1498,Félix Lemaréchal,FRA,MF,Monaco,Ligue 1,17,2003,0.1,0,0,0,0,0,0,1,0.0,1,0,0,0,0,0,0,0,0,2021-2022,0.0,0.0
1499,Mario Lemina,GAB,MF,Nice,Ligue 1,27,1993,21.9,62,35,25,33,4,28,38,73.7,10,32,9,23,48,110,37,0,0,2021-2022,2.1917808219178085,2.8310502283105023
1500,Fabien Lemoine,FRA,MF,Lorient,Ligue 1,34,1987,12.4,35,22,20,14,1,17,41,41.5,24,21,4,17,14,49,24,1,0,2021-2022,1.129032258064516,2.82258064516129
Rk,Player,Nation,Pos,Squad,Comp,0,0,90.0,0,0,3,3,3,Tkl,0,0.0,0,0,0,0,0,0,0,0,0,2021-2022,0.0,0.0
1501,Tim Lemperle,GER,"FW,MF",Köln,Bundesliga,19,2002,1.7,4,1,2,1,1,1,3,33.3,2,1,0,1,2,6,2,0,0,2021-2022,1.1764705882352942,2.3529411764705883
1502,Ruben Lendinez,ESP,DF,Valencia,La Liga,18,2003,1.5,3,3,1,2,0,3,8,37.5,5,4,0,4,2,5,6,0,0,2021-2022,1.3333333333333333,2.0
1503,Clément Lenglet,FRA,DF,Barcelona,La Liga,26,1995,9.2,20,11,11,7,2,8,13,61.5,5,7,3,4,13,33,21,0,0,2021-2022,1.4130434782608696,2.173913043478261
1504,Aaron Lennon,ENG,"MF,FW",Burnley,Premier League,34,1987,17.2,33,17,10,13,10,10,34,29.4,24,26,4,22,9,42,14,0,0,2021-2022,0.5232558139534884,1.9186046511627908
1505,Bernd Leno,GER,GK,Arsenal,Premier League,29,1992,4.0,1,1,1,0,0,1,1,100.0,0,0,0,0,0,1,1,0,0,2021-2022,0.0,0.25
1506,Christopher Lenz,GER,DF,Eint Frankfurt,Bundesliga,26,1994,7.4,29,15,22,6,1,12,21,57.1,9,9,4,5,7,36,21,0,0,2021-2022,0.9459459459459459,3.918918918918919
1507,Léo Leroy,FRA,MF,Montpellier,Ligue 1,21,2000,7.0,31,21,17,11,3,12,34,35.3,22,20,4,16,8,39,8,0,0,2021-2022,1.1428571428571428,4.428571428571429
1508,Alexandre Letellier,FRA,GK,Paris S-G,Ligue 1,30,1990,0.1,0,0,0,0,0,0,0,0.0,0,0,0,0,0,0,0,0,0,2021-2022,0.0,0.0
1509,Robert Lewandowski,POL,FW,Bayern Munich,Bundesliga,32,1988,32.7,10,3,0,6,4,5,17,29.4,12,17,2,15,6,16,8,0,0,2021-2022,0.18348623853211007,0.3058103975535168
1510,Jamie Leweling,GER,"FW,MF",Greuther Fürth,Bundesliga,20,2001,21.8,13,8,3,7,3,3,16,18.8,13,9,0,9,13,26,5,0,0,2021-2022,0.5963302752293578,0.5963302752293578
1511,Jamal Lewis,NIR,DF,Newcastle Utd,Premier League,23,1998,2.9,8,6,6,1,1,3,4,75.0,1,3,2,1,3,11,8,0,0,2021-2022,1.0344827586206897,2.7586206896551726
1512,Luca Lezzerini,ITA,GK,Venezia,Serie A,26,1995,5.5,0,0,0,0,0,0,0,0.0,0,1,0,1,0,0,0,0,0,2021-2022,0.0,0.0
1513,Ben Lhassine Kone,CIV,MF,Torino,Serie A,21,2000,0.9,3,3,1,2,0,1,2,50.0,1,0,0,0,1,4,1,0,0,2021-2022,1.1111111111111112,3.333333333333333
1514,Yanis Lhery,FRA,"FW,MF",Saint-Étienne,Ligue 1,18,2003,0.8,0,0,0,0,0,0,0,0.0,0,4,0,4,0,0,0,0,0,2021-2022,0.0,0.0
1515,Dimitri Liénard,FRA,"DF,MF",Strasbourg,Ligue 1,33,1988,22.7,71,43,40,21,10,46,77,59.7,31,12,0,12,21,92,28,0,0,2021-2022,0.9251101321585904,3.1277533039647576
1516,Philipp Lienhart,AUT,DF,Freiburg,Bundesliga,25,1996,31.9,24,13,17,6,1,13,24,54.2,11,33,23,10,50,74,158,1,0,2021-2022,1.567398119122257,0.7523510971786834
1517,Matthijs de Ligt,NED,DF,Juventus,Serie A,21,1999,29.7,34,19,21,13,0,15,18,83.3,3,31,21,10,26,60,103,0,0,2021-2022,0.8754208754208754,1.144781144781145
1518,Isaac Lihadji,FRA,"MF,FW",Lille,Ligue 1,19,2002,2.6,3,3,1,1,1,1,5,20.0,4,1,0,1,2,5,0,0,0,2021-2022,0.7692307692307692,1.1538461538461537
1519,Anderson Lima,BRA,MF,Lazio,Serie A,21,1999,0.7,2,0,1,1,0,0,2,0.0,2,1,0,1,2,4,1,0,0,2021-2022,2.857142857142857,2.857142857142857
1520,Andreas Linde,SWE,GK,Greuther Fürth,Bundesliga,28,1993,12.0,0,0,0,0,0,0,0,0.0,0,0,0,0,1,1,1,1,0,2021-2022,0.08333333333333333,0.0
1521,Victor Lindelöf,SWE,DF,Manchester Utd,Premier League,27,1994,26.2,16,11,9,7,0,9,14,64.3,5,26,17,9,25,41,96,0,0,2021-2022,0.9541984732824428,0.6106870229007634
1522,Jesper Lindstrøm,DEN,"MF,FW",Eint Frankfurt,Bundesliga,21,2000,22.0,28,13,6,13,9,12,36,33.3,24,30,0,30,24,52,11,1,0,2021-2022,1.0909090909090908,1.2727272727272727
1523,Karol Linetty,POL,"MF,FW",Torino,Serie A,26,1995,10.0,14,8,3,4,7,6,18,33.3,12,8,0,8,3,17,2,0,0,2021-2022,0.3,1.4
1524,Jesse Lingard,ENG,"FW,MF",Manchester Utd,Premier League,28,1992,4.1,9,7,4,3,2,2,6,33.3,4,4,0,4,0,9,1,0,0,2021-2022,0.0,2.1951219512195124
1525,Pol Lirola,ESP,"DF,FW",Marseille,Ligue 1,23,1997,19.7,28,16,15,9,4,13,28,46.4,15,15,0,15,13,41,22,0,0,2021-2022,0.6598984771573604,1.4213197969543148
Rk,Player,Nation,Pos,Squad,Comp,0,0,90.0,0,0,3,3,3,Tkl,0,0.0,0,0,0,0,0,0,0,0,0,2021-2022,0.0,0.0
1526,Valentino Livramento,ENG,DF,Southampton,Premier League,18,2002,24.5,54,28,30,18,6,27,45,60.0,18,23,9,14,47,101,50,1,0,2021-2022,1.9183673469387754,2.204081632653061
1527,Dejan Ljubicic,AUT,"MF,FW",Köln,Bundesliga,23,1997,21.9,33,19,12,13,8,13,49,26.5,36,19,1,18,15,48,11,0,0,2021-2022,0.6849315068493151,1.5068493150684932
1528,Javier Llabrés,ESP,"FW,MF",Mallorca,La Liga,18,2002,1.5,2,1,0,1,1,1,2,50.0,1,1,0,1,0,2,0,0,0,2021-2022,0.0,1.3333333333333333
1529,Diego Llorente,ESP,DF,Leeds United,Premier League,27,1993,26.0,53,31,32,19,2,33,47,70.2,14,35,17,18,40,93,77,2,0,2021-2022,1.5384615384615385,2.0384615384615383
1530,Marcos Llorente,ESP,"MF,DF",Atlético Madrid,La Liga,26,1995,27.2,51,23,25,22,4,28,43,65.1,15,33,10,23,27,78,44,0,0,2021-2022,0.9926470588235294,1.875
1531,Hugo Lloris,FRA,GK,Tottenham,Premier League,34,1986,38.0,1,1,1,0,0,1,2,50.0,1,0,0,0,1,2,24,3,0,2021-2022,0.02631578947368421,0.02631578947368421
1532,Giovani Lo Celso,ARG,"MF,FW",Tottenham,Premier League,25,1996,2.6,8,4,4,2,2,4,10,40.0,6,6,1,5,1,9,0,1,0,2021-2022,0.3846153846153846,3.0769230769230766
1533,Giovani Lo Celso,ARG,"FW,MF",Villarreal,La Liga,25,1996,11.0,22,12,8,10,4,9,22,40.9,13,4,0,4,5,27,3,0,0,2021-2022,0.45454545454545453,2.0
1534,Julen Lobete,ESP,"FW,MF",Real Sociedad,La Liga,20,2000,3.2,4,3,3,0,1,1,2,50.0,1,6,1,5,1,5,1,0,0,2021-2022,0.3125,1.25
1535,Stanislav Lobotka,SVK,MF,Napoli,Serie A,26,1994,18.7,39,24,16,20,3,14,36,38.9,22,9,1,8,12,51,13,1,0,2021-2022,0.6417112299465241,2.085561497326203
1536,Jürgen Locadia,CUW,"MF,FW",Brighton,Premier League,27,1993,0.3,0,0,0,0,0,0,0,0.0,0,0,0,0,0,0,0,0,0,2021-2022,0.0,0.0
1537,Jürgen Locadia,CUW,"FW,MF",Bochum,Bundesliga,27,1993,4.9,4,2,1,0,3,1,1,100.0,0,1,0,1,1,5,2,0,0,2021-2022,0.2040816326530612,0.8163265306122448
1538,Manuel Locatelli,ITA,MF,Juventus,Serie A,23,1998,24.0,44,25,21,16,7,21,47,44.7,26,43,21,22,22,66,33,0,0,2021-2022,0.9166666666666666,1.8333333333333333
1539,Bradley Locko,FRA,"MF,DF",Reims,Ligue 1,19,2002,11.2,28,19,13,11,4,14,24,58.3,10,20,8,12,14,42,15,0,0,2021-2022,1.25,2.5
1540,Renan Lodi,BRA,DF,Atlético Madrid,La Liga,23,1998,13.1,31,18,14,13,4,11,27,40.7,16,22,4,18,13,44,19,1,0,2021-2022,0.9923664122137404,2.366412213740458
1541,Ruben Loftus-Cheek,ENG,"MF,DF",Chelsea,Premier League,25,1996,15.5,29,10,16,11,2,10,19,52.6,9,15,6,9,11,40,17,0,0,2021-2022,0.7096774193548387,1.8709677419354838
1542,Kevin Long,IRL,DF,Burnley,Premier League,30,1990,4.6,3,2,1,2,0,1,2,50.0,1,4,1,3,1,4,20,0,0,2021-2022,0.2173913043478261,0.6521739130434783
1543,Shane Long,IRL,FW,Southampton,Premier League,34,1987,3.4,9,5,2,4,3,1,1,100.0,0,4,0,4,0,9,2,0,0,2021-2022,0.0,2.6470588235294117
1544,Sean Longstaff,ENG,MF,Newcastle Utd,Premier League,23,1997,16.3,54,34,18,31,5,24,65,36.9,41,18,6,12,9,63,18,0,0,2021-2022,0.5521472392638036,3.312883435582822
1545,Ademola Lookman,NGA,"FW,MF",Leicester City,Premier League,23,1997,16.1,32,14,10,13,9,10,28,35.7,18,19,1,18,10,42,4,0,0,2021-2022,0.6211180124223602,1.9875776397515525
1546,Anthony Lopes,POR,GK,Lyon,Ligue 1,30,1990,33.1,0,0,0,0,0,0,0,0.0,0,0,0,0,3,3,12,3,0,2021-2022,0.09063444108761329,0.0
1547,David López,ESP,"MF,DF",Espanyol,La Liga,31,1989,8.3,18,13,9,8,1,9,16,56.3,7,10,8,2,10,28,25,2,0,2021-2022,1.2048192771084336,2.1686746987951806
1548,Diego López,ESP,GK,Espanyol,La Liga,39,1981,35.3,0,0,0,0,0,0,2,0.0,2,0,0,0,1,1,21,1,0,2021-2022,0.028328611898017,0.0
1549,Javi López,ESP,DF,Alavés,La Liga,19,2002,5.1,8,6,6,2,0,4,6,66.7,2,7,1,6,4,12,15,0,0,2021-2022,0.7843137254901962,1.5686274509803924
1550,Maxime Lopez,FRA,MF,Sassuolo,Serie A,23,1997,32.6,69,36,40,27,2,35,87,40.2,52,33,7,26,42,111,38,1,0,2021-2022,1.2883435582822085,2.116564417177914
Rk,Player,Nation,Pos,Squad,Comp,0,0,90.0,0,0,3,3,3,Tkl,0,0.0,0,0,0,0,0,0,0,0,0,2021-2022,0.0,0.0
1551,Pau López,ESP,GK,Marseille,Ligue 1,26,1994,29.0,0,0,0,0,0,0,1,0.0,1,0,0,0,0,0,12,1,0,2021-2022,0.0,0.0
1552,Unai López,ESP,MF,Rayo Vallecano,La Liga,25,1995,12.9,19,9,6,10,3,10,33,30.3,23,7,0,7,10,29,8,1,0,2021-2022,0.7751937984496123,1.4728682170542635
1553,Dion Lopy,SEN,MF,Reims,Ligue 1,19,2002,18.2,53,29,22,24,7,21,53,39.6,32,20,4,16,22,75,17,0,0,2021-2022,1.208791208791209,2.9120879120879124
1554,Samuel Loric,FRA,DF,Lorient,Ligue 1,21,2000,3.0,7,5,2,3,2,5,8,62.5,3,2,0,2,5,12,9,0,0,2021-2022,1.6666666666666667,2.3333333333333335
1555,Anthony Losilla,FRA,MF,Bochum,Bundesliga,35,1986,32.6,65,39,29,30,6,34,69,49.3,35,32,9,23,70,135,53,1,0,2021-2022,2.147239263803681,1.9938650306748464
1556,Jonas Lössl,DEN,GK,Brentford,Premier League,32,1989,2.0,0,0,0,0,0,0,0,0.0,0,0,0,0,0,0,1,0,0,2021-2022,0.0,0.0
1557,Marcel Lotka,POL,GK,Hertha BSC,Bundesliga,20,2001,9.8,1,0,1,0,0,1,1,100.0,0,0,0,0,1,2,3,3,0,2021-2022,0.1020408163265306,0.1020408163265306
1558,Jordan Lotomba,SUI,DF,Nice,Ligue 1,22,1998,19.8,33,17,21,9,3,16,30,53.3,14,17,4,13,12,45,28,0,0,2021-2022,0.6060606060606061,1.6666666666666665
1559,Johaneko Louisjean,FRA,DF,Bordeaux,Ligue 1,17,2004,0.1,0,0,0,0,0,0,0,0.0,0,0,0,0,0,0,0,0,0,2021-2022,0.0,0.0
1560,Mamadou Loum,SEN,MF,Alavés,La Liga,24,1996,25.7,49,22,26,22,1,17,45,37.8,28,30,11,19,37,86,68,1,0,2021-2022,1.4396887159533074,1.906614785992218
1561,Imran Louza,MAR,MF,Watford,Premier League,22,1999,15.7,41,21,18,20,3,16,38,42.1,22,28,6,22,42,83,20,1,0,2021-2022,2.67515923566879,2.6114649681528666
1562,Matteo Lovato,ITA,DF,Atalanta,Serie A,21,2000,3.4,5,4,4,1,0,0,1,0.0,1,4,2,2,7,12,8,0,0,2021-2022,2.058823529411765,1.4705882352941178
1563,Matteo Lovato,ITA,DF,Cagliari,Serie A,21,2000,13.8,23,15,13,10,0,8,20,40.0,12,21,10,11,28,51,43,0,0,2021-2022,2.0289855072463765,1.6666666666666665
1564,Eduard Löwen,GER,MF,Bochum,Bundesliga,24,1997,15.7,28,22,12,11,5,10,43,23.3,33,17,2,15,9,37,15,1,0,2021-2022,0.5732484076433121,1.78343949044586
1565,Matthew Lowton,ENG,DF,Burnley,Premier League,32,1989,19.7,38,24,20,10,8,20,37,54.1,17,25,11,14,26,64,68,0,0,2021-2022,1.3197969543147208,1.9289340101522843
1566,Anthony Lozano,HON,"FW,MF",Cádiz,La Liga,28,1993,18.6,8,4,2,3,3,5,18,27.8,13,16,2,14,2,10,7,0,0,2021-2022,0.1075268817204301,0.4301075268817204
1567,Hirving Lozano,MEX,FW,Napoli,Serie A,26,1995,17.9,28,20,12,11,5,8,30,26.7,22,24,0,24,9,37,9,0,0,2021-2022,0.5027932960893855,1.564245810055866
1568,Jean Lucas,BRA,MF,Monaco,Ligue 1,23,1998,16.1,43,25,14,24,5,17,40,42.5,23,15,5,10,13,56,4,1,0,2021-2022,0.8074534161490683,2.670807453416149
1569,Anderson Lucoqui,ANG,DF,Mainz 05,Bundesliga,24,1997,8.3,22,10,11,6,5,11,22,50.0,11,15,3,12,11,33,10,0,0,2021-2022,1.325301204819277,2.650602409638554
1570,Florentino Luís,POR,MF,Getafe,La Liga,21,1999,11.0,42,25,22,17,3,17,35,48.6,18,21,2,19,21,63,11,1,0,2021-2022,1.9090909090909092,3.8181818181818183
1571,José Luis Gayà,ESP,DF,Valencia,La Liga,26,1995,20.8,35,21,24,10,1,16,34,47.1,18,17,3,14,19,54,37,0,0,2021-2022,0.9134615384615384,1.6826923076923077
1572,José Luis Morales,ESP,"FW,MF",Levante,La Liga,34,1987,30.2,27,17,6,9,12,12,42,28.6,30,29,0,29,4,31,7,0,0,2021-2022,0.13245033112582782,0.8940397350993378
1573,José Luis Palomino,ARG,DF,Atalanta,Serie A,31,1990,29.7,78,40,42,33,3,32,50,64.0,18,43,21,22,100,178,80,2,0,2021-2022,3.367003367003367,2.6262626262626263
1574,Luismi,ESP,"FW,MF",Sevilla,La Liga,20,2001,0.1,0,0,0,0,0,0,0,0.0,0,0,0,0,0,0,0,0,0,2021-2022,0.0,0.0
1575,Douglas Luiz,BRA,MF,Aston Villa,Premier League,23,1998,30.2,59,39,30,24,5,21,72,29.2,51,30,7,23,34,93,28,1,0,2021-2022,1.1258278145695364,1.9536423841059603
Rk,Player,Nation,Pos,Squad,Comp,0,0,90.0,0,0,3,3,3,Tkl,0,0.0,0,0,0,0,0,0,0,0,0,2021-2022,0.0,0.0
1576,Romelu Lukaku,BEL,FW,Chelsea,Premier League,28,1993,17.7,2,1,0,1,1,1,5,20.0,4,11,1,10,0,2,20,0,0,2021-2022,0.0,0.11299435028248588
1577,Castello Lukeba,FRA,DF,Lyon,Ligue 1,18,2002,23.3,34,19,27,7,0,15,23,65.2,8,18,9,9,38,72,64,2,0,2021-2022,1.630901287553648,1.4592274678111588
1578,Dodi Lukebakio,BEL,FW,Hertha BSC,Bundesliga,23,1997,2.0,2,1,2,0,0,1,3,33.3,2,2,0,2,2,4,0,0,0,2021-2022,1.0,1.0
1579,Dodi Lukebakio,BEL,"FW,MF",Wolfsburg,Bundesliga,23,1997,9.8,7,4,3,2,2,1,10,10.0,9,5,0,5,13,20,4,0,0,2021-2022,1.3265306122448979,0.7142857142857142
1580,Saša Lukić,SRB,MF,Torino,Serie A,24,1996,33.1,51,34,17,27,7,19,43,44.2,24,34,6,28,24,75,41,0,0,2021-2022,0.7250755287009063,1.5407854984894258
1581,Levi Lumeka,ENG,"DF,FW",Troyes,Ligue 1,22,1998,0.7,0,0,0,0,0,0,2,0.0,2,0,0,0,0,0,2,0,0,2021-2022,0.0,0.0
1582,Andriy Lunin,UKR,GK,Real Madrid,La Liga,22,1999,2.0,0,0,0,0,0,0,0,0.0,0,0,0,0,0,0,2,0,0,2021-2022,0.0,0.0
1583,Andrey Lunyov,RUS,GK,Leverkusen,Bundesliga,29,1991,1.0,0,0,0,0,0,0,0,0.0,0,0,0,0,0,0,0,0,0,2021-2022,0.0,0.0
1584,Sebastiano Luperto,ITA,DF,Empoli,Serie A,24,1996,21.8,29,17,17,10,2,10,20,50.0,10,32,26,6,45,74,132,0,0,2021-2022,2.0642201834862384,1.3302752293577982
1585,Andreas Luthe,GER,GK,Union Berlin,Bundesliga,34,1987,27.0,0,0,0,0,0,0,1,0.0,1,0,0,0,0,0,11,4,0,2021-2022,0.0,0.0
1586,Lyanco,BRA,DF,Southampton,Premier League,24,1997,10.1,18,15,11,7,0,10,18,55.6,8,18,13,5,13,31,50,1,0,2021-2022,1.2871287128712872,1.7821782178217822
1587,Charalambos Lykogiannis,GRE,"DF,FW",Cagliari,Serie A,27,1993,20.2,19,12,16,1,2,11,20,55.0,9,18,8,10,31,50,73,0,0,2021-2022,1.5346534653465347,0.9405940594059407
1588,Yannis M'Bemba,GAB,"DF,FW",Nantes,Ligue 1,20,2001,0.1,0,0,0,0,0,0,0,0.0,0,0,0,0,0,0,1,0,0,2021-2022,0.0,0.0
1589,Alexis Mac Allister,ARG,"MF,FW",Brighton,Premier League,22,1998,23.6,65,40,23,30,12,29,68,42.6,39,37,7,30,13,78,22,0,0,2021-2022,0.5508474576271186,2.754237288135593
1590,Deiver Machado,COL,"DF,MF",Lens,Ligue 1,27,1993,5.8,16,14,11,1,4,12,14,85.7,2,9,1,8,3,19,12,1,0,2021-2022,0.5172413793103449,2.7586206896551726
1591,Darwin Machís,VEN,"MF,FW",Granada,La Liga,28,1993,15.3,23,13,11,8,4,9,23,39.1,14,10,0,10,15,38,17,0,0,2021-2022,0.9803921568627451,1.5032679738562091
1592,Yvann Macon,FRA,DF,Saint-Étienne,Ligue 1,22,1998,17.0,41,22,24,14,3,16,42,38.1,26,18,4,14,18,59,27,0,0,2021-2022,1.0588235294117647,2.411764705882353
1593,James Maddison,ENG,"MF,FW",Leicester City,Premier League,24,1996,27.3,40,20,8,24,8,14,46,30.4,32,18,3,15,11,51,12,0,0,2021-2022,0.40293040293040294,1.465201465201465
1594,Niki Mäenpää,FIN,GK,Venezia,Serie A,36,1985,16.5,0,0,0,0,0,0,0,0.0,0,0,0,0,0,0,8,2,0,2021-2022,0.0,0.0
1595,Pablo Maffeo,ESP,DF,Mallorca,La Liga,24,1997,32.7,84,47,48,28,8,38,69,55.1,31,30,13,17,46,130,74,0,0,2021-2022,1.4067278287461773,2.568807339449541
1596,Louis Mafouta,CTA,FW,Metz,Ligue 1,27,1994,5.8,0,0,0,0,0,0,5,0.0,5,1,0,1,0,0,4,0,0,2021-2022,0.0,0.0
1597,Gabriel Magalhães,BRA,DF,Arsenal,Premier League,23,1997,34.0,50,30,36,12,2,30,41,73.2,11,34,26,8,13,63,112,4,0,2021-2022,0.38235294117647056,1.4705882352941178
1598,Giulio Maggiore,ITA,MF,Spezia,Serie A,23,1998,31.3,58,32,20,32,6,31,77,40.3,46,30,5,25,29,87,33,0,0,2021-2022,0.926517571884984,1.853035143769968
1599,Matej Maglica,CRO,MF,Stuttgart,Bundesliga,22,1998,0.1,0,0,0,0,0,0,1,0.0,1,0,0,0,0,0,0,0,0,2021-2022,0.0,0.0
1600,Francesco Magnanelli,ITA,MF,Sassuolo,Serie A,36,1984,3.0,5,4,4,1,0,1,9,11.1,8,3,1,2,1,6,3,0,0,2021-2022,0.3333333333333333,1.6666666666666667
Rk,Player,Nation,Pos,Squad,Comp,0,0,90.0,0,0,3,3,3,Tkl,0,0.0,0,0,0,0,0,0,0,0,0,2021-2022,0.0,0.0
1601,Giangiacomo Magnani,ITA,DF,Hellas Verona,Serie A,25,1995,5.9,10,7,5,5,0,8,16,50.0,8,5,3,2,10,20,46,0,0,2021-2022,1.694915254237288,1.694915254237288
1602,Giangiacomo Magnani,ITA,DF,Sampdoria,Serie A,25,1995,2.7,4,2,4,0,0,1,1,100.0,0,2,2,0,7,11,12,0,0,2021-2022,2.5925925925925926,1.4814814814814814
1603,Hugo Magnetti,FRA,MF,Brest,Ligue 1,23,1998,16.3,50,34,27,20,3,22,50,44.0,28,14,3,11,25,75,13,0,0,2021-2022,1.5337423312883436,3.067484662576687
1604,Yohann Magnin,FRA,"MF,DF",Clermont Foot,Ligue 1,24,1997,19.1,53,31,22,26,5,24,42,57.1,18,17,7,10,20,73,36,0,0,2021-2022,1.0471204188481675,2.7748691099476437
1605,Harry Maguire,ENG,DF,Manchester Utd,Premier League,28,1993,27.9,34,21,22,8,4,19,31,61.3,12,36,29,7,32,66,101,3,0,2021-2022,1.1469534050179213,1.2186379928315412
1606,Riyad Mahrez,ALG,FW,Manchester City,Premier League,30,1991,16.6,11,3,5,4,2,5,19,26.3,14,15,1,14,6,17,6,0,0,2021-2022,0.36144578313253006,0.6626506024096385
1607,Arne Maier,GER,MF,Augsburg,Bundesliga,22,1999,20.7,20,13,6,10,4,8,26,30.8,18,18,1,17,15,35,13,0,0,2021-2022,0.7246376811594203,0.9661835748792271
1608,Habib Maïga,CIV,MF,Metz,Ligue 1,25,1996,14.1,47,28,29,13,5,24,48,50.0,24,20,7,13,14,61,18,0,0,2021-2022,0.9929078014184397,3.3333333333333335
1609,Mike Maignan,FRA,GK,Milan,Serie A,26,1995,32.0,2,1,2,0,0,2,2,100.0,0,0,0,0,1,3,4,2,0,2021-2022,0.03125,0.0625
1610,Ainsley Maitland-Niles,ENG,MF,Arsenal,Premier League,23,1997,3.0,8,4,5,3,0,2,4,50.0,2,2,0,2,4,12,4,0,0,2021-2022,1.3333333333333333,2.6666666666666665
1611,Ainsley Maitland-Niles,ENG,DF,Roma,Serie A,23,1997,5.4,8,6,5,0,3,5,14,35.7,9,7,0,7,6,14,7,0,0,2021-2022,1.111111111111111,1.4814814814814814
1612,Josh Maja,NGA,FW,Bordeaux,Ligue 1,22,1998,0.1,0,0,0,0,0,0,0,0.0,0,1,0,1,0,0,0,0,0,2021-2022,0.0,0.0
1613,Abdul Majeed Waris,GHA,"FW,MF",Strasbourg,Ligue 1,29,1991,3.6,5,3,2,3,0,5,10,50.0,5,2,0,2,0,5,1,0,0,2021-2022,0.0,1.3888888888888888
1614,Lovro Majer,CRO,"MF,FW",Rennes,Ligue 1,23,1998,20.4,32,21,9,14,9,11,42,26.2,31,26,2,24,11,43,9,0,0,2021-2022,0.5392156862745099,1.5686274509803924
1615,Jean-Victor Makengo,FRA,MF,Udinese,Serie A,23,1998,26.1,30,21,7,17,6,15,29,51.7,14,26,6,20,19,49,17,0,0,2021-2022,0.7279693486590038,1.1494252873563218
1616,Béni Makouana,CGO,"FW,MF",Montpellier,Ligue 1,18,2002,3.6,2,2,0,0,2,0,1,0.0,1,1,0,1,3,5,2,0,0,2021-2022,0.8333333333333333,0.5555555555555556
1617,Nemanja Maksimović,SRB,MF,Getafe,La Liga,26,1995,32.6,56,32,24,26,6,18,49,36.7,31,42,13,29,71,127,41,0,0,2021-2022,2.1779141104294477,1.7177914110429446
1618,Nikola Maksimović,SRB,DF,Genoa,Serie A,29,1991,12.4,14,6,10,4,0,7,9,77.8,2,17,11,6,12,26,61,1,0,2021-2022,0.9677419354838709,1.129032258064516
1619,Kévin Malcuit,MAR,"DF,MF",Napoli,Serie A,30,1991,3.2,4,2,4,0,0,2,2,100.0,0,3,0,3,8,12,6,0,0,2021-2022,2.5,1.25
1620,Daniel Maldini,ITA,MF,Milan,Serie A,19,2001,1.6,8,3,4,3,1,2,6,33.3,4,4,0,4,1,9,0,0,0,2021-2022,0.625,5.0
1621,Youssef Maleh,MAR,MF,Fiorentina,Serie A,22,1998,11.3,27,16,8,13,6,12,25,48.0,13,14,1,13,6,33,2,0,0,2021-2022,0.5309734513274336,2.389380530973451
1622,Donyell Malen,NED,FW,Dortmund,Bundesliga,22,1999,18.7,13,10,4,5,4,7,13,53.8,6,10,0,10,10,23,11,0,0,2021-2022,0.5347593582887701,0.6951871657754011
1623,Ruslan Malinovskyi,UKR,"MF,FW",Atalanta,Serie A,28,1993,17.7,18,10,3,10,5,5,19,26.3,14,27,3,24,5,23,1,0,0,2021-2022,0.2824858757062147,1.0169491525423728
1624,Hugo Mallo,ESP,DF,Celta Vigo,La Liga,30,1991,20.3,45,25,24,19,2,16,31,51.6,15,23,9,14,20,65,53,0,0,2021-2022,0.9852216748768473,2.216748768472906
1625,Lennard Maloney,USA,DF,Dortmund,Bundesliga,21,1999,0.1,1,0,1,0,0,1,1,100.0,0,0,0,0,0,1,0,0,0,2021-2022,0.0,10.0
Rk,Player,Nation,Pos,Squad,Comp,0,0,90.0,0,0,3,3,3,Tkl,0,0.0,0,0,0,0,0,0,0,0,0,2021-2022,0.0,0.0
1626,Mickael Malsa,MTQ,MF,Levante,La Liga,25,1995,12.7,37,17,16,18,3,15,42,35.7,27,20,8,12,18,55,15,0,0,2021-2022,1.4173228346456694,2.9133858267716537
1627,Giorgi Mamardashvili,GEO,GK,Valencia,La Liga,20,2000,18.0,0,0,0,0,0,0,0,0.0,0,0,0,0,0,0,6,1,0,2021-2022,0.0,0.0
1628,Rey Manaj,ALB,FW,Spezia,Serie A,24,1997,19.6,19,12,3,11,5,6,26,23.1,20,16,0,16,4,23,13,0,0,2021-2022,0.2040816326530612,0.9693877551020408
1629,Hianga Mananga Mbock,FRA,MF,Brest,Ligue 1,21,1999,8.9,18,12,8,7,3,9,21,42.9,12,5,2,3,5,23,6,0,0,2021-2022,0.5617977528089887,2.0224719101123596
1630,Vincent Manceau,FRA,DF,Angers,Ligue 1,32,1989,26.2,32,19,18,13,1,14,37,37.8,23,23,6,17,32,64,72,0,0,2021-2022,1.2213740458015268,1.2213740458015268
1631,Gianluca Mancini,ITA,DF,Roma,Serie A,25,1996,32.0,41,25,22,18,1,18,33,54.5,15,38,19,19,39,80,69,0,0,2021-2022,1.21875,1.28125
1632,Leonardo Mancuso,ITA,FW,Empoli,Serie A,29,1992,4.7,1,1,0,1,0,0,6,0.0,6,2,0,2,1,2,2,0,0,2021-2022,0.2127659574468085,0.2127659574468085
1633,Steve Mandanda,FRA,GK,Marseille,Ligue 1,36,1985,9.0,0,0,0,0,0,0,1,0.0,1,1,0,1,1,1,4,1,0,2021-2022,0.1111111111111111,0.0
1634,Reinildo Mandava,MOZ,DF,Atlético Madrid,La Liga,27,1994,14.4,45,25,30,14,1,22,30,73.3,8,18,9,9,21,66,38,0,0,2021-2022,1.4583333333333333,3.125
1635,Reinildo Mandava,MOZ,DF,Lille,Ligue 1,27,1994,16.9,43,23,29,11,3,32,51,62.7,19,13,4,9,37,80,55,0,0,2021-2022,2.1893491124260356,2.544378698224852
1636,Aïssa Mandi,ALG,DF,Villarreal,La Liga,29,1991,15.3,11,5,2,8,1,3,6,50.0,3,17,14,3,13,24,49,3,0,2021-2022,0.8496732026143791,0.7189542483660131
1637,Rolando Mandragora,ITA,MF,Torino,Serie A,24,1997,14.7,21,10,3,16,2,12,21,57.1,9,18,4,14,10,31,13,0,0,2021-2022,0.6802721088435374,1.4285714285714286
1638,Anthony Mandrea,ALG,GK,Angers,Ligue 1,24,1996,10.0,0,0,0,0,0,0,0,0.0,0,0,0,0,0,0,9,0,0,2021-2022,0.0,0.0
1639,Sadio Mané,SEN,FW,Liverpool,Premier League,29,1992,31.3,33,20,7,14,12,8,26,30.8,18,30,1,29,8,41,15,0,0,2021-2022,0.25559105431309903,1.0543130990415335
1640,Eliaquim Mangala,FRA,DF,Saint-Étienne,Ligue 1,30,1991,13.1,17,12,12,5,0,8,12,66.7,4,11,8,3,17,34,61,1,0,2021-2022,1.297709923664122,1.297709923664122
1641,Orel Mangala,BEL,MF,Stuttgart,Bundesliga,23,1998,20.6,17,10,5,7,5,11,22,50.0,11,11,4,7,12,29,19,1,0,2021-2022,0.5825242718446602,0.8252427184466019
1642,Thomas Mangani,FRA,MF,Angers,Ligue 1,34,1987,24.4,58,30,23,34,1,31,68,45.6,37,38,11,27,36,94,29,0,0,2021-2022,1.4754098360655739,2.377049180327869
1643,Ricardo Mangas,POR,DF,Bordeaux,Ligue 1,23,1998,26.1,35,22,22,8,5,26,41,63.4,15,18,4,14,25,60,47,3,0,2021-2022,0.9578544061302682,1.3409961685823755
1644,Kostas Manolas,GRE,DF,Napoli,Serie A,30,1991,3.5,2,2,1,1,0,2,3,66.7,1,2,1,1,4,6,10,1,0,2021-2022,1.1428571428571428,0.5714285714285714
1645,Javier Manquillo,ESP,DF,Newcastle Utd,Premier League,27,1994,14.0,39,29,28,10,1,21,36,58.3,15,15,6,9,10,49,32,0,0,2021-2022,0.7142857142857143,2.7857142857142856
1646,Myziane Maolida,COM,MF,Nice,Ligue 1,22,1999,0.4,1,0,0,1,0,0,0,0.0,0,1,0,1,0,1,0,0,0,2021-2022,0.0,2.5
1647,Myziane Maolida,COM,"FW,MF",Hertha BSC,Bundesliga,22,1999,8.6,7,4,5,1,1,3,9,33.3,6,5,0,5,1,8,6,0,0,2021-2022,0.11627906976744186,0.813953488372093
1648,Sekou Mara,FRA,"FW,MF",Bordeaux,Ligue 1,19,2002,10.1,8,4,1,1,6,1,8,12.5,7,7,0,7,2,10,6,0,0,2021-2022,0.19801980198019803,0.7920792079207921
1649,Nikola Maraš,SRB,DF,Rayo Vallecano,La Liga,25,1995,11.6,13,9,12,1,0,9,15,60.0,6,17,13,4,15,28,51,0,0,2021-2022,1.293103448275862,1.120689655172414
1650,Fernando Marçal,BRA,"MF,DF",Wolves,Premier League,32,1989,16.1,42,22,27,14,1,21,37,56.8,16,25,4,21,28,70,52,0,0,2021-2022,1.7391304347826086,2.6086956521739126
Rk,Player,Nation,Pos,Squad,Comp,0,0,90.0,0,0,3,3,3,Tkl,0,0.0,0,0,0,0,0,0,0,0,0,2021-2022,0.0,0.0
1651,Marcelo,BRA,DF,Real Madrid,La Liga,33,1988,5.8,8,4,2,3,3,5,10,50.0,5,7,2,5,1,9,11,0,0,2021-2022,0.1724137931034483,1.3793103448275863
1652,Marcelo,BRA,DF,Bordeaux,Ligue 1,34,1987,10.0,9,5,7,2,0,4,6,66.7,2,4,3,1,13,22,46,1,0,2021-2022,1.3,0.9
1653,Marcelo,BRA,DF,Lyon,Ligue 1,34,1987,2.0,4,3,0,4,0,4,6,66.7,2,3,2,1,4,8,10,0,0,2021-2022,2.0,2.0
1654,Solly March,ENG,"DF,FW",Brighton,Premier League,27,1994,19.4,30,17,11,9,10,7,22,31.8,15,22,3,19,17,47,25,0,0,2021-2022,0.8762886597938145,1.5463917525773196
1655,Riccardo Marchizza,ITA,DF,Empoli,Serie A,23,1998,15.0,21,15,11,8,2,11,16,68.8,5,15,6,9,10,31,24,0,0,2021-2022,0.6666666666666666,1.4
1656,Gian Marco Ferrari,ITA,DF,Sassuolo,Serie A,29,1992,34.7,16,11,10,6,0,10,23,43.5,13,37,27,10,43,59,114,2,0,2021-2022,1.239193083573487,0.4610951008645533
1657,Iván Marcone,ARG,MF,Elche,La Liga,31,1990,9.0,24,14,17,6,1,12,24,50.0,12,8,3,5,12,36,13,0,0,2021-2022,1.3333333333333333,2.6666666666666665
1658,Óscar de Marcos,ESP,DF,Athletic Club,La Liga,32,1989,18.7,50,37,24,19,7,28,43,65.1,15,20,3,17,19,69,27,0,0,2021-2022,1.0160427807486632,2.6737967914438503
1659,Davide Marfella,ITA,GK,Napoli,Serie A,21,1999,0.1,0,0,0,0,0,0,0,0.0,0,0,0,0,0,0,0,0,0,2021-2022,0.0,0.0
1660,José Mari,ESP,MF,Cádiz,La Liga,33,1987,4.3,14,7,3,10,1,7,8,87.5,1,4,1,3,7,21,2,0,0,2021-2022,1.627906976744186,3.255813953488372
1661,Pablo Marí,ESP,DF,Arsenal,Premier League,27,1993,2.0,5,3,1,3,1,3,6,50.0,3,5,4,1,3,8,10,0,0,2021-2022,1.5,2.5
1662,Pablo Marí,ESP,DF,Udinese,Serie A,27,1993,14.9,16,8,8,6,2,8,16,50.0,8,18,12,6,21,37,72,0,0,2021-2022,1.4093959731543624,1.0738255033557047
1663,José María Giménez,URU,DF,Atlético Madrid,La Liga,26,1995,22.7,18,12,12,6,0,8,16,50.0,8,25,19,6,25,43,96,1,0,2021-2022,1.1013215859030838,0.7929515418502203
1664,Mariano,DOM,FW,Real Madrid,La Liga,27,1993,3.8,2,0,2,0,0,0,0,0.0,0,2,0,2,1,3,3,0,0,2021-2022,0.2631578947368421,0.5263157894736842
1665,Răzvan Marin,ROU,MF,Cagliari,Serie A,25,1996,31.3,42,21,16,22,4,24,54,44.4,30,23,5,18,10,52,17,1,0,2021-2022,0.3194888178913738,1.3418530351437699
1666,Guillermo Maripán,CHI,DF,Monaco,Ligue 1,27,1994,20.4,36,24,27,9,0,20,40,50.0,20,21,14,7,25,61,66,1,0,2021-2022,1.2254901960784315,1.7647058823529413
1667,Mika Màrmol,ESP,DF,Barcelona,La Liga,19,2002,0.0,0,0,0,0,0,0,0,0.0,0,0,0,0,0,0,0,0,0,2021-2022,,
1668,Omar Marmoush,EGY,FW,Wolfsburg,Bundesliga,22,1999,0.3,0,0,0,0,0,0,0,0.0,0,0,0,0,0,0,0,0,0,2021-2022,0.0,0.0
1669,Omar Marmoush,EGY,FW,Stuttgart,Bundesliga,22,1999,17.5,26,17,6,14,6,4,20,20.0,16,9,1,8,7,33,6,0,0,2021-2022,0.4,1.4857142857142858
1670,Marquinhos,BRA,DF,Paris S-G,Ligue 1,27,1994,31.8,37,14,25,11,1,20,35,57.1,15,35,19,16,16,53,102,0,0,2021-2022,0.5031446540880503,1.1635220125786163
1671,Roger Martí,ESP,FW,Levante,La Liga,30,1991,23.5,23,14,3,13,7,8,30,26.7,22,14,0,14,2,25,8,0,0,2021-2022,0.0851063829787234,0.9787234042553191
1672,Anthony Martial,FRA,FW,Manchester Utd,Premier League,25,1995,2.4,0,0,0,0,0,0,1,0.0,1,1,0,1,0,0,1,0,0,2021-2022,0.0,0.0
1673,Anthony Martial,FRA,"FW,MF",Sevilla,La Liga,25,1995,5.4,2,1,0,0,2,2,6,33.3,4,4,0,4,0,2,3,0,0,2021-2022,0.0,0.37037037037037035
1674,Martín,ESP,MF,Cádiz,La Liga,22,1999,1.3,2,2,0,2,0,0,0,0.0,0,1,0,1,1,3,3,0,0,2021-2022,0.7692307692307692,1.5384615384615383
1675,Aarón Martín,ESP,DF,Mainz 05,Bundesliga,24,1997,25.5,54,33,32,18,4,24,55,43.6,31,24,4,20,20,74,35,0,0,2021-2022,0.7843137254901961,2.1176470588235294
Rk,Player,Nation,Pos,Squad,Comp,0,0,90.0,0,0,3,3,3,Tkl,0,0.0,0,0,0,0,0,0,0,0,0,2021-2022,0.0,0.0
1676,Ander Martin,ESP,"FW,MF",Real Sociedad,La Liga,20,2000,1.0,1,0,0,1,0,1,1,100.0,0,0,0,0,3,4,1,0,0,2021-2022,3.0,1.0
1677,Andrés Martín,ESP,"FW,MF",Rayo Vallecano,La Liga,22,1999,2.1,0,0,0,0,0,0,1,0.0,1,1,0,1,0,0,0,0,0,2021-2022,0.0,0.0
1678,Carlos Martín,ESP,DF,Atlético Madrid,La Liga,19,2002,0.1,0,0,0,0,0,0,0,0.0,0,0,0,0,0,0,1,0,0,2021-2022,0.0,0.0
1679,Iván Martín,ESP,"MF,FW",Alavés,La Liga,22,1999,1.8,1,1,1,0,0,0,1,0.0,1,2,0,2,1,2,1,0,0,2021-2022,0.5555555555555556,0.5555555555555556
1680,Jonas Martin,FRA,MF,Rennes,Ligue 1,31,1990,23.4,35,20,12,21,2,19,53,35.8,34,17,3,14,22,57,28,1,0,2021-2022,0.9401709401709403,1.4957264957264957
1681,Gabriel Martinelli,BRA,"FW,MF",Arsenal,Premier League,20,2001,20.7,27,19,7,14,6,10,29,34.5,19,26,1,25,20,47,15,0,0,2021-2022,0.9661835748792271,1.3043478260869565
1682,Emiliano Martínez,ARG,GK,Aston Villa,Premier League,28,1992,36.0,1,1,1,0,0,1,3,33.3,2,0,0,0,0,1,6,1,0,2021-2022,0.0,0.027777777777777776
1683,Iñigo Martínez,ESP,DF,Athletic Club,La Liga,30,1991,26.0,28,13,18,7,3,14,23,60.9,9,22,10,12,39,67,143,0,0,2021-2022,1.5,1.0769230769230769
1684,Javi Martínez,ESP,"MF,FW",Osasuna,La Liga,21,1999,9.8,21,14,8,11,2,10,29,34.5,19,6,0,6,9,30,10,0,0,2021-2022,0.9183673469387754,2.142857142857143
1685,Josep Martinez,ESP,GK,RB Leipzig,Bundesliga,23,1998,1.0,0,0,0,0,0,0,0,0.0,0,0,0,0,0,0,0,0,0,2021-2022,0.0,0.0
1686,Lautaro Martínez,ARG,FW,Inter,Serie A,23,1997,25.4,20,10,3,10,7,6,11,54.5,5,21,1,20,18,38,6,0,0,2021-2022,0.7086614173228347,0.7874015748031497
1687,Pablo Martínez,ESP,MF,Levante,La Liga,23,1998,7.3,15,8,7,8,0,4,13,30.8,9,6,3,3,15,30,5,0,0,2021-2022,2.0547945205479454,2.0547945205479454
1688,Lucas Martínez Quarta,ARG,DF,Fiorentina,Serie A,25,1996,15.9,36,25,23,11,2,21,34,61.8,13,22,9,13,19,55,46,0,0,2021-2022,1.1949685534591195,2.2641509433962264
1689,Gelson Martins,POR,"MF,FW",Monaco,Ligue 1,26,1995,21.2,42,27,10,26,6,21,59,35.6,38,26,1,25,17,59,4,0,0,2021-2022,0.8018867924528302,1.9811320754716981
1690,Adam Marušić,MNE,DF,Lazio,Serie A,28,1992,30.2,30,18,16,12,2,13,32,40.6,19,19,8,11,41,71,71,0,0,2021-2022,1.3576158940397351,0.9933774834437087
1691,Omar Mascarell,EQG,MF,Elche,La Liga,28,1993,27.7,46,26,16,23,7,24,60,40.0,36,42,14,28,48,94,52,2,0,2021-2022,1.7328519855595668,1.660649819494585
1692,Andrea Masiello,ITA,DF,Genoa,Serie A,35,1986,5.7,5,3,4,1,0,4,7,57.1,3,8,4,4,11,16,20,1,0,2021-2022,1.9298245614035088,0.8771929824561403
1693,Adam Masina,MAR,DF,Watford,Premier League,27,1994,12.0,24,13,11,10,3,12,29,41.4,17,18,6,12,18,42,45,0,0,2021-2022,1.5,2.0
1694,Erhan Mašović,SRB,DF,Bochum,Bundesliga,22,1998,17.2,35,20,21,13,1,21,33,63.6,12,28,19,9,34,69,64,1,0,2021-2022,1.9767441860465118,2.0348837209302326
1695,Roberto Massimo,GER,"DF,FW",Stuttgart,Bundesliga,20,2000,9.7,14,5,6,7,1,4,16,25.0,12,9,0,9,3,17,6,0,0,2021-2022,0.30927835051546393,1.4432989690721651
1696,Arthur Masuaku,COD,"DF,FW",West Ham,Premier League,27,1993,7.2,31,23,19,11,1,14,23,60.9,9,9,1,8,9,40,17,0,0,2021-2022,1.25,4.305555555555555
1697,Jaime Mata,ESP,FW,Getafe,La Liga,32,1988,7.5,7,5,3,1,3,1,9,11.1,8,4,1,3,1,8,5,0,0,2021-2022,0.13333333333333333,0.9333333333333333
1698,Juan Mata,ESP,MF,Manchester Utd,Premier League,33,1988,2.6,6,4,2,3,1,3,5,60.0,2,1,0,1,1,7,1,0,0,2021-2022,0.3846153846153846,2.3076923076923075
1699,Pape Matar Sarr,SEN,MF,Metz,Ligue 1,18,2002,23.7,45,26,21,23,1,18,39,46.2,21,33,3,30,29,74,22,0,0,2021-2022,1.2236286919831223,1.89873417721519
1700,Eliot Matazo,BEL,MF,Monaco,Ligue 1,19,2002,8.8,8,7,4,4,0,2,11,18.2,9,11,3,8,13,21,9,0,0,2021-2022,1.477272727272727,0.9090909090909091
Rk,Player,Nation,Pos,Squad,Comp,0,0,90.0,0,0,3,3,3,Tkl,0,0.0,0,0,0,0,0,0,0,0,0,2021-2022,0.0,0.0
1701,Aleš Matějů,CZE,DF,Venezia,Serie A,25,1996,8.1,16,12,10,5,1,13,29,44.8,16,10,6,4,9,25,15,0,0,2021-2022,1.1111111111111112,1.9753086419753088
1702,Jean-Philippe Mateta,FRA,FW,Crystal Palace,Premier League,24,1997,12.7,8,4,2,5,1,3,18,16.7,15,11,3,8,4,12,13,0,0,2021-2022,0.31496062992125984,0.6299212598425197
1703,Nemanja Matić,SRB,MF,Manchester Utd,Premier League,32,1988,15.4,31,18,19,11,1,15,31,48.4,16,21,6,15,31,62,21,3,0,2021-2022,2.012987012987013,2.012987012987013
1704,Joël Matip,CMR,DF,Liverpool,Premier League,29,1991,31.0,47,34,23,19,5,20,31,64.5,11,26,14,12,44,91,93,1,0,2021-2022,1.4193548387096775,1.5161290322580645
1705,Chrislain Matsima,FRA,DF,Monaco,Ligue 1,19,2002,1.5,3,2,1,2,0,2,7,28.6,5,3,3,0,1,4,6,1,0,2021-2022,0.6666666666666666,2.0
1706,Azor Matusiwa,NED,MF,Reims,Ligue 1,23,1998,27.4,58,32,28,26,4,26,55,47.3,29,49,19,30,62,120,43,0,0,2021-2022,2.2627737226277373,2.1167883211678835
1707,Neal Maupay,FRA,FW,Brighton,Premier League,24,1996,25.3,17,10,2,6,9,4,18,22.2,14,21,2,19,2,19,2,0,0,2021-2022,0.07905138339920949,0.6719367588932806
1708,Stephy Mavididi,ENG,"FW,MF",Montpellier,Ligue 1,23,1998,25.5,24,13,11,7,6,14,39,35.9,25,23,2,21,8,32,11,0,0,2021-2022,0.3137254901960784,0.9411764705882353
1709,Konstantinos Mavropanos,GRE,DF,Stuttgart,Bundesliga,23,1997,30.1,57,39,35,21,1,30,51,58.8,21,46,23,23,69,126,174,2,0,2021-2022,2.2923588039867107,1.893687707641196
1710,Eric Maxim Choupo-Moting,CMR,"FW,MF",Bayern Munich,Bundesliga,32,1989,4.2,10,9,3,6,1,3,10,30.0,7,1,0,1,5,15,2,0,0,2021-2022,1.1904761904761905,2.380952380952381
1711,Luís Maximiano,POR,GK,Granada,La Liga,22,1999,34.8,3,1,3,0,0,3,6,50.0,3,0,0,0,1,4,16,2,0,2021-2022,0.02873563218390805,0.08620689655172414
1712,Borja Mayoral,ESP,"FW,DF",Roma,Serie A,24,1997,1.1,0,0,0,0,0,0,0,0.0,0,0,0,0,0,0,0,0,0,2021-2022,0.0,0.0
1713,Borja Mayoral,ESP,FW,Getafe,La Liga,24,1997,11.6,7,5,2,3,2,1,2,50.0,1,10,4,6,4,11,3,0,0,2021-2022,0.3448275862068966,0.603448275862069
1714,Derek Mazou-Sacko,FRA,"FW,DF",Troyes,Ligue 1,16,2004,0.0,1,0,0,0,1,1,1,100.0,0,0,0,0,0,1,1,0,0,2021-2022,,inf
1715,Pasquale Mazzocchi,ITA,DF,Venezia,Serie A,26,1995,13.8,18,8,11,4,3,10,26,38.5,16,11,8,3,21,39,31,1,0,2021-2022,1.5217391304347825,1.3043478260869565
1716,Pasquale Mazzocchi,ITA,DF,Salernitana,Serie A,26,1995,14.1,28,19,15,11,2,14,34,41.2,20,5,0,5,11,39,31,0,0,2021-2022,0.7801418439716312,1.9858156028368794
1717,Kevin Mbabu,SUI,DF,Wolfsburg,Bundesliga,26,1995,15.5,31,20,21,5,5,12,23,52.2,11,25,8,17,35,66,35,0,0,2021-2022,2.2580645161290325,2.0
1718,Kylian Mbappé,FRA,FW,Paris S-G,Ligue 1,22,1998,33.6,11,8,1,4,6,7,13,53.8,6,6,0,6,5,16,13,0,0,2021-2022,0.1488095238095238,0.3273809523809524
1719,Ibrahima Mbaye,SEN,DF,Bologna,Serie A,26,1994,1.2,1,1,1,0,0,1,2,50.0,1,1,1,0,1,2,6,0,0,2021-2022,0.8333333333333334,0.8333333333333334
1720,Amadou Mbengue,SEN,"DF,MF",Metz,Ligue 1,19,2002,6.8,19,10,10,9,0,11,22,50.0,11,7,2,5,10,29,19,0,0,2021-2022,1.4705882352941178,2.794117647058824
1721,Bryan Mbeumo,CMR,FW,Brentford,Premier League,21,1999,32.3,28,16,1,12,15,6,20,30.0,14,21,6,15,11,39,20,0,0,2021-2022,0.3405572755417957,0.86687306501548
1722,Jason Mbock,FRA,FW,Angers,Ligue 1,21,1999,0.2,0,0,0,0,0,0,0,0.0,0,0,0,0,0,0,0,0,0,2021-2022,0.0,0.0
1723,Jordi Mboula,ESP,FW,Mallorca,La Liga,22,1999,4.8,8,2,3,3,2,5,9,55.6,4,7,1,6,3,11,3,0,0,2021-2022,0.625,1.6666666666666667
1724,Moustapha Mbow,SEN,DF,Reims,Ligue 1,21,2000,1.0,6,6,3,2,1,3,3,100.0,0,0,0,0,1,7,6,0,0,2021-2022,1.0,6.0
1725,Nathanael Mbuku,FRA,"FW,MF",Reims,Ligue 1,19,2002,15.8,14,13,4,7,3,2,8,25.0,6,14,0,14,11,25,4,0,0,2021-2022,0.6962025316455696,0.8860759493670886
Rk,Player,Nation,Pos,Squad,Comp,0,0,90.0,0,0,3,3,3,Tkl,0,0.0,0,0,0,0,0,0,0,0,0,2021-2022,0.0,0.0
1726,James McArthur,SCO,MF,Crystal Palace,Premier League,33,1987,16.0,33,23,13,19,1,16,44,36.4,28,23,9,14,30,63,27,0,0,2021-2022,1.875,2.0625
1727,James Mcatee,ENG,"MF,FW",Manchester City,Premier League,18,2002,0.2,0,0,0,0,0,0,2,0.0,2,0,0,0,0,0,0,0,0,2021-2022,0.0,0.0
1728,Kasey McAteer,ENG,FW,Leicester City,Premier League,19,2001,0.0,0,0,0,0,0,0,0,0.0,0,0,0,0,0,0,0,0,0,2021-2022,,
1729,Liam McCarron,SCO,FW,Leeds United,Premier League,20,2001,0.1,0,0,0,0,0,0,0,0.0,0,1,0,1,0,0,0,0,0,2021-2022,0.0,0.0
1730,Alex McCarthy,ENG,GK,Southampton,Premier League,31,1989,17.0,0,0,0,0,0,0,0,0.0,0,0,0,0,0,0,4,0,0,2021-2022,0.0,0.0
1731,John McGinn,SCO,MF,Aston Villa,Premier League,26,1994,34.3,106,64,35,55,16,54,104,51.9,50,53,6,47,35,141,34,0,0,2021-2022,1.0204081632653061,3.090379008746356
1732,Weston McKennie,USA,MF,Juventus,Serie A,22,1998,15.2,20,11,11,7,2,8,26,30.8,18,17,8,9,23,43,20,0,0,2021-2022,1.5131578947368423,1.3157894736842106
1733,Stuart McKinstry,SCO,MF,Leeds United,Premier League,18,2002,0.0,0,0,0,0,0,0,0,0.0,0,0,0,0,0,0,0,0,0,2021-2022,,
1734,Kenny McLean,SCO,MF,Norwich City,Premier League,29,1992,30.1,42,22,18,20,4,17,59,28.8,42,29,7,22,34,76,54,0,0,2021-2022,1.1295681063122922,1.3953488372093024
1735,Dwight McNeil,ENG,MF,Burnley,Premier League,21,1999,34.5,78,49,27,38,13,33,73,45.2,40,64,11,53,35,113,31,1,0,2021-2022,1.0144927536231885,2.260869565217391
1736,Scott McTominay,SCO,MF,Manchester Utd,Premier League,24,1996,26.5,65,33,32,24,9,30,61,49.2,31,45,10,35,31,96,60,1,0,2021-2022,1.169811320754717,2.452830188679245
1737,Gary Medel,CHI,DF,Bologna,Serie A,33,1987,31.4,39,23,27,11,1,16,36,44.4,20,30,21,9,44,83,112,0,0,2021-2022,1.4012738853503186,1.2420382165605095
1738,Facundo Medina,ARG,DF,Lens,Ligue 1,22,1999,28.8,61,42,34,23,4,38,62,61.3,24,24,8,16,37,98,78,3,0,2021-2022,1.284722222222222,2.1180555555555554
1739,Nathan de Medina,BEL,DF,Arminia,Bundesliga,23,1997,8.6,17,10,11,6,0,6,10,60.0,4,14,3,11,10,27,28,0,0,2021-2022,1.1627906976744187,1.9767441860465118
1740,Ben Mee,ENG,DF,Burnley,Premier League,31,1989,20.4,26,12,16,7,3,12,19,63.2,7,28,22,6,24,50,94,1,0,2021-2022,1.1764705882352942,1.2745098039215688
1741,Admir Mehmedi,SUI,DF,Wolfsburg,Bundesliga,30,1991,0.0,0,0,0,0,0,0,0,0.0,0,0,0,0,0,0,0,0,0,2021-2022,,
1742,Hannibal Mejbri,TUN,FW,Manchester Utd,Premier League,18,2003,0.8,2,1,1,1,0,1,1,100.0,0,0,0,0,0,2,0,0,0,2021-2022,0.0,2.5
1743,Farid El Melali,ALG,FW,Angers,Ligue 1,24,1997,0.2,0,0,0,0,0,0,1,0.0,1,1,0,1,0,0,1,0,0,2021-2022,0.0,0.0
1744,Filippo Melegoni,ITA,"MF,FW",Genoa,Serie A,22,1999,10.9,20,12,5,8,7,8,16,50.0,8,10,1,9,11,31,8,1,0,2021-2022,1.0091743119266054,1.8348623853211008
1745,Óscar Melendo,ESP,"MF,FW",Espanyol,La Liga,23,1997,11.0,11,5,4,4,3,3,13,23.1,10,4,1,3,1,12,10,0,0,2021-2022,0.09090909090909091,1.0
1746,Gonzalo Melero,ESP,MF,Levante,La Liga,27,1994,18.8,29,16,10,15,4,16,36,44.4,20,21,8,13,7,36,22,0,0,2021-2022,0.3723404255319149,1.5425531914893615
1747,Birger Meling,NOR,DF,Rennes,Ligue 1,26,1994,20.3,43,27,25,11,7,23,31,74.2,8,23,7,16,22,65,40,0,0,2021-2022,1.083743842364532,2.1182266009852215
1748,Arthur Melo,BRA,MF,Juventus,Serie A,24,1996,10.7,25,12,10,14,1,13,24,54.2,11,11,2,9,7,32,8,1,0,2021-2022,0.6542056074766356,2.336448598130841
1749,Memphis,NED,FW,Barcelona,La Liga,27,1994,20.6,10,4,2,4,4,3,13,23.1,10,9,1,8,3,13,4,0,0,2021-2022,0.14563106796116504,0.48543689320388345
1750,Houboulang Mendes,GNB,DF,Lorient,Ligue 1,23,1998,35.8,58,28,37,18,3,40,57,70.2,17,41,21,20,41,99,128,4,0,2021-2022,1.1452513966480449,1.6201117318435756
Rk,Player,Nation,Pos,Squad,Comp,0,0,90.0,0,0,3,3,3,Tkl,0,0.0,0,0,0,0,0,0,0,0,0,2021-2022,0.0,0.0
1751,Nuno Mendes,POR,DF,Paris S-G,Ligue 1,19,2002,18.4,48,29,23,18,7,25,47,53.2,22,27,5,22,21,69,17,1,0,2021-2022,1.1413043478260871,2.608695652173913
1752,Pedro Mendes,POR,DF,Montpellier,Ligue 1,30,1990,0.2,1,1,1,0,0,0,0,0.0,0,1,1,0,0,1,2,0,0,2021-2022,0.0,5.0
1753,Thiago Mendes,BRA,"MF,DF",Lyon,Ligue 1,29,1992,20.7,36,22,18,16,2,12,30,40.0,18,24,5,19,34,70,56,1,0,2021-2022,1.642512077294686,1.7391304347826086
1754,Tomás Mendes,ESP,MF,Alavés,La Liga,16,2004,0.1,0,0,0,0,0,0,0,0.0,0,0,0,0,0,0,1,0,0,2021-2022,0.0,0.0
1755,Brais Méndez,ESP,MF,Celta Vigo,La Liga,24,1997,33.6,68,35,24,35,9,26,87,29.9,61,52,6,46,37,105,30,0,0,2021-2022,1.101190476190476,2.0238095238095237
1756,Édgar Méndez,ESP,"FW,MF",Alavés,La Liga,31,1990,17.9,25,14,11,10,4,11,34,32.4,23,16,0,16,4,29,17,0,0,2021-2022,0.223463687150838,1.3966480446927376
1757,Arial Mendy,SEN,"DF,FW",Clermont Foot,Ligue 1,26,1994,8.8,6,4,4,2,0,2,11,18.2,9,6,1,5,7,13,17,0,0,2021-2022,0.7954545454545454,0.6818181818181818
1758,Batista Mendy,FRA,"MF,DF",Angers,Ligue 1,21,2000,26.8,49,28,21,22,6,23,45,51.1,22,37,6,31,34,83,40,0,0,2021-2022,1.2686567164179103,1.828358208955224
1759,Benjamin Mendy,FRA,DF,Manchester City,Premier League,27,1994,0.9,2,2,1,1,0,2,6,33.3,4,0,0,0,0,2,0,0,0,2021-2022,0.0,2.2222222222222223
1760,Edouard Mendy,SEN,GK,Chelsea,Premier League,29,1992,34.0,1,0,1,0,0,1,3,33.3,2,0,0,0,0,1,13,4,0,2021-2022,0.0,0.029411764705882353
1761,Ferland Mendy,FRA,DF,Real Madrid,La Liga,26,1995,19.3,24,14,11,10,3,8,14,57.1,6,8,2,6,18,42,27,3,0,2021-2022,0.9326424870466321,1.2435233160621761
1762,Nampalys Mendy,SEN,MF,Leicester City,Premier League,29,1992,11.5,12,6,8,4,0,6,17,35.3,11,7,4,3,11,23,11,1,0,2021-2022,0.9565217391304348,1.0434782608695652
1763,Gideon Mensah,GHA,DF,Bordeaux,Ligue 1,23,1998,13.4,37,24,19,12,6,18,38,47.4,20,11,2,9,16,53,21,0,0,2021-2022,1.1940298507462686,2.761194029850746
1764,Jorge Meré,ESP,DF,Köln,Bundesliga,24,1997,5.4,9,6,3,6,0,4,7,57.1,3,6,4,2,10,19,19,0,0,2021-2022,1.8518518518518516,1.6666666666666665
1765,Alex Meret,ITA,GK,Napoli,Serie A,24,1997,6.9,0,0,0,0,0,0,0,0.0,0,0,0,0,0,0,3,1,0,2021-2022,0.0,0.0
1766,Fran Mérida,ESP,MF,Espanyol,La Liga,31,1990,3.0,7,3,5,2,0,4,10,40.0,6,1,0,1,6,13,1,0,0,2021-2022,2.0,2.3333333333333335
1767,Mikel Merino,ESP,MF,Real Sociedad,La Liga,25,1996,32.1,71,38,21,40,10,26,67,38.8,41,50,10,40,21,92,56,2,0,2021-2022,0.6542056074766355,2.2118380062305296
1768,Quentin Merlin,FRA,"DF,MF",Nantes,Ligue 1,19,2002,21.4,45,28,19,20,6,26,49,53.1,23,25,4,21,27,72,29,2,0,2021-2022,1.2616822429906542,2.1028037383177574
1769,Martín Merquelanz,ESP,"FW,MF",Rayo Vallecano,La Liga,26,1995,1.9,2,1,2,0,0,2,6,33.3,4,2,0,2,0,2,1,0,0,2021-2022,0.0,1.0526315789473684
1770,Yıldırım Mert Çetin,TUR,MF,Hellas Verona,Serie A,24,1997,0.5,1,0,1,0,0,1,1,100.0,0,0,0,0,0,1,2,0,0,2021-2022,0.0,2.0
1771,Dries Mertens,BEL,"FW,MF",Napoli,Serie A,34,1987,15.4,16,7,1,11,4,3,16,18.8,13,8,2,6,9,25,2,0,0,2021-2022,0.5844155844155844,1.0389610389610389
1772,Illan Meslier,FRA,GK,Leeds United,Premier League,21,2000,37.6,1,1,1,0,0,1,1,100.0,0,0,0,0,0,1,27,1,0,2021-2022,0.0,0.026595744680851064
1773,Lionel Messi,ARG,"FW,MF",Paris S-G,Ligue 1,34,1987,23.9,10,3,1,5,4,3,13,23.1,10,5,0,5,4,14,0,0,0,2021-2022,0.1673640167364017,0.4184100418410042
1774,Junior Messias,BRA,"FW,MF",Milan,Serie A,30,1991,15.9,34,18,11,14,9,15,34,44.1,19,11,1,10,17,51,17,0,0,2021-2022,1.069182389937107,2.138364779874214
1775,Thomas Meunier,BEL,DF,Dortmund,Bundesliga,29,1991,15.6,29,19,13,12,4,16,33,48.5,17,10,2,8,12,41,25,1,0,2021-2022,0.7692307692307693,1.858974358974359
Rk,Player,Nation,Pos,Squad,Comp,0,0,90.0,0,0,3,3,3,Tkl,0,0.0,0,0,0,0,0,0,0,0,0,2021-2022,0.0,0.0
1776,Mexer,MOZ,DF,Bordeaux,Ligue 1,32,1988,13.6,14,10,11,3,0,11,17,64.7,6,12,7,5,21,35,60,2,0,2021-2022,1.5441176470588236,1.0294117647058825
1777,Marco Meyerhöfer,GER,DF,Greuther Fürth,Bundesliga,25,1995,25.3,53,35,22,22,9,24,37,64.9,13,38,19,19,47,100,64,1,0,2021-2022,1.8577075098814229,2.0948616600790513
1778,Matt Miazga,USA,DF,Alavés,La Liga,26,1995,9.3,7,7,3,4,0,2,7,28.6,5,14,12,2,11,18,55,1,0,2021-2022,1.182795698924731,0.7526881720430108
1779,Kingsley Michael,NGA,MF,Bologna,Serie A,21,1999,0.8,4,1,2,2,0,1,2,50.0,1,2,1,1,1,5,1,1,0,2021-2022,1.25,5.0
1780,Sven Michel,GER,FW,Union Berlin,Bundesliga,31,1990,3.8,10,6,5,3,2,2,8,25.0,6,3,0,3,1,11,1,0,0,2021-2022,0.2631578947368421,2.6315789473684212
1781,Edouard Michut,FRA,MF,Paris S-G,Ligue 1,18,2003,0.8,0,0,0,0,0,0,2,0.0,2,2,0,2,1,1,2,0,0,2021-2022,1.25,0.0
1782,Miguel,ESP,"FW,MF",Alavés,La Liga,21,1999,9.2,7,3,1,5,1,2,15,13.3,13,6,0,6,1,8,7,0,0,2021-2022,0.10869565217391305,0.7608695652173914
1783,Valentin Mihaila,ROU,"MF,FW",Atalanta,Serie A,21,2000,0.8,1,1,0,1,0,0,1,0.0,1,2,0,2,0,1,0,0,0,2021-2022,0.0,1.25
1784,Mikael,BRA,"FW,MF",Salernitana,Serie A,22,1999,1.0,1,1,0,1,0,0,0,0.0,0,0,0,0,0,1,1,0,0,2021-2022,0.0,1.0
1785,Hilmir Mikaelsson,ISL,FW,Venezia,Serie A,17,2004,0.2,2,0,0,1,1,0,0,0.0,0,0,0,0,0,2,0,0,0,2021-2022,0.0,10.0
1786,Georges Mikautadze,GEO,FW,Metz,Ligue 1,20,2000,0.0,0,0,0,0,0,0,0,0.0,0,0,0,0,0,0,0,0,0,2021-2022,,
1787,William Mikelbrencis,FRA,DF,Metz,Ligue 1,17,2004,6.8,11,5,6,4,1,6,9,66.7,3,6,3,3,5,16,9,0,0,2021-2022,0.7352941176470589,1.6176470588235294
1788,Nikola Milenković,SRB,DF,Fiorentina,Serie A,23,1997,32.5,54,32,31,20,3,29,34,85.3,5,30,15,15,39,93,94,0,0,2021-2022,1.2,1.6615384615384616
1789,Arkadiusz Milik,POL,FW,Marseille,Ligue 1,27,1994,15.7,9,2,0,5,4,4,18,22.2,14,9,1,8,3,12,10,1,0,2021-2022,0.1910828025477707,0.5732484076433121
1790,Sergej Milinković-Savić,SRB,MF,Lazio,Serie A,26,1995,34.4,67,44,20,32,15,29,67,43.3,38,50,9,41,34,101,43,1,0,2021-2022,0.9883720930232559,1.9476744186046513
1791,Vanja Milinković-Savić,SRB,GK,Torino,Serie A,24,1997,27.0,0,0,0,0,0,0,1,0.0,1,0,0,0,0,0,7,2,0,2021-2022,0.0,0.0
1792,Éder Militão,BRA,DF,Real Madrid,La Liga,23,1998,33.7,50,32,30,12,8,20,39,51.3,19,42,20,22,52,102,107,3,0,2021-2022,1.5430267062314538,1.4836795252225519
1793,Luka Milivojević,SRB,MF,Crystal Palace,Premier League,30,1991,8.6,18,9,9,6,3,10,16,62.5,6,6,1,5,11,29,15,0,0,2021-2022,1.2790697674418605,2.0930232558139537
1794,Luis Milla,ESP,MF,Granada,La Liga,26,1994,30.8,59,29,25,30,4,25,64,39.1,39,28,4,24,25,84,34,0,0,2021-2022,0.8116883116883117,1.9155844155844155
1795,Pere Milla,ESP,"MF,FW",Elche,La Liga,28,1992,18.3,20,15,14,5,1,8,44,18.2,36,21,1,20,5,25,21,0,0,2021-2022,0.27322404371584696,1.0928961748633879
1796,Enzo Millot,FRA,MF,Stuttgart,Bundesliga,19,2002,0.6,2,0,0,2,0,0,1,0.0,1,0,0,0,1,3,1,0,0,2021-2022,1.6666666666666667,3.3333333333333335
1797,James Milner,ENG,"MF,DF",Liverpool,Premier League,35,1986,9.5,28,16,12,11,5,12,29,41.4,17,19,5,14,17,45,20,0,0,2021-2022,1.7894736842105263,2.9473684210526314
1798,Santi Mina,ESP,FW,Celta Vigo,La Liga,25,1995,26.3,27,17,8,15,4,5,32,15.6,27,28,2,26,6,33,22,0,0,2021-2022,0.22813688212927757,1.026615969581749
1799,Yerry Mina,COL,DF,Everton,Premier League,26,1994,9.4,12,10,12,0,0,10,13,76.9,3,13,9,4,11,23,38,1,0,2021-2022,1.1702127659574468,1.276595744680851
1800,Takumi Minamino,JPN,"FW,MF",Liverpool,Premier League,26,1995,2.1,3,2,1,1,1,2,8,25.0,6,2,0,2,1,4,2,0,0,2021-2022,0.47619047619047616,1.4285714285714286
Rk,Player,Nation,Pos,Squad,Comp,0,0,90.0,0,0,3,3,3,Tkl,0,0.0,0,0,0,0,0,0,0,0,0,2021-2022,0.0,0.0
1801,Tyrone Mings,ENG,DF,Aston Villa,Premier League,28,1993,35.4,23,12,17,3,3,14,22,63.6,8,47,30,17,46,69,153,2,0,2021-2022,1.2994350282485876,0.6497175141242938
1802,Óscar Mingueza,ESP,DF,Barcelona,La Liga,22,1999,9.9,25,11,12,11,2,16,23,69.6,7,5,0,5,9,34,22,1,0,2021-2022,0.9090909090909091,2.525252525252525
1803,Rafa Mir,ESP,FW,Sevilla,La Liga,24,1997,20.1,4,3,1,1,2,0,11,0.0,11,4,3,1,0,4,17,0,0,2021-2022,0.0,0.1990049751243781
1804,Jorge Miramón,ESP,DF,Levante,La Liga,32,1989,22.0,36,19,16,12,8,15,44,34.1,29,15,3,12,35,71,58,0,0,2021-2022,1.5909090909090908,1.6363636363636365
1805,Aleksei Miranchuk,RUS,"MF,FW",Atalanta,Serie A,25,1995,8.6,11,7,3,7,1,4,12,33.3,8,3,0,3,1,12,7,0,0,2021-2022,0.11627906976744186,1.2790697674418605
1806,Juan Miranda,ESP,DF,Betis,La Liga,21,2000,8.7,21,11,16,4,1,12,22,54.5,10,10,4,6,15,36,22,0,0,2021-2022,1.7241379310344829,2.4137931034482762
1807,Fabio Miretti,ITA,MF,Juventus,Serie A,17,2003,3.6,4,2,2,2,0,2,9,22.2,7,3,1,2,2,6,3,0,0,2021-2022,0.5555555555555556,1.1111111111111112
1808,Tyrick Mitchell,ENG,DF,Crystal Palace,Premier League,21,1999,34.5,104,57,67,26,11,46,67,68.7,21,47,5,42,41,145,101,0,0,2021-2022,1.1884057971014492,3.0144927536231885
1809,Stefan Mitrović,SRB,DF,Getafe,La Liga,31,1990,29.6,16,8,12,4,0,8,13,61.5,5,28,18,10,22,38,114,1,0,2021-2022,0.7432432432432432,0.5405405405405405
1810,Maximilian Mittelstädt,GER,"DF,FW",Hertha BSC,Bundesliga,24,1997,16.6,52,33,30,12,10,26,50,52.0,24,28,5,23,46,98,37,0,0,2021-2022,2.7710843373493974,3.1325301204819276
1811,Henrikh Mkhitaryan,ARM,"MF,FW",Roma,Serie A,32,1989,27.7,45,29,11,27,7,17,52,32.7,35,33,2,31,22,67,33,0,0,2021-2022,0.7942238267148015,1.6245487364620939
1812,Jakub Moder,POL,MF,Brighton,Premier League,22,1999,18.9,42,25,18,17,7,23,42,54.8,19,25,2,23,10,52,22,1,0,2021-2022,0.5291005291005292,2.2222222222222223
1813,Anthony Modeste,FRA,FW,Köln,Bundesliga,33,1988,29.0,10,6,4,5,1,3,18,16.7,15,11,2,9,4,14,29,0,0,2021-2022,0.13793103448275862,0.3448275862068966
1814,Marco Modolo,ITA,DF,Venezia,Serie A,32,1989,4.4,6,3,4,2,0,2,5,40.0,3,6,6,0,4,10,26,0,0,2021-2022,0.9090909090909091,1.3636363636363635
1815,Luka Modrić,CRO,MF,Real Madrid,La Liga,35,1985,22.6,18,10,8,7,3,6,27,22.2,21,10,4,6,20,38,9,0,0,2021-2022,0.8849557522123893,0.7964601769911503
1816,Terem Moffi,NGA,FW,Lorient,Ligue 1,22,1999,30.1,17,10,3,12,2,9,32,28.1,23,11,2,9,4,21,22,0,0,2021-2022,0.13289036544850497,0.5647840531561461
1817,Kevin Möhwald,GER,MF,Union Berlin,Bundesliga,28,1993,3.9,7,1,3,3,1,1,7,14.3,6,3,0,3,3,10,6,0,0,2021-2022,0.7692307692307693,1.794871794871795
1818,Dion Moise Sahi,CIV,"FW,MF",Strasbourg,Ligue 1,19,2001,1.4,0,0,0,0,0,0,0,0.0,0,1,0,1,1,1,1,0,0,2021-2022,0.7142857142857143,0.0
1819,Johan Mojica,COL,DF,Elche,La Liga,28,1992,31.7,46,25,34,7,5,23,31,74.2,8,22,3,19,25,71,61,3,0,2021-2022,0.7886435331230284,1.4511041009463723
1820,Clinton Mola,ENG,DF,Stuttgart,Bundesliga,20,2001,1.3,3,1,2,1,0,2,4,50.0,2,5,5,0,3,6,2,0,0,2021-2022,2.3076923076923075,2.3076923076923075
1821,Jorge Molina,ESP,FW,Granada,La Liga,39,1982,21.8,4,2,2,1,1,2,18,11.1,16,13,2,11,6,10,11,0,0,2021-2022,0.27522935779816515,0.18348623853211007
1822,Nahuel Molina,ARG,DF,Udinese,Serie A,23,1998,29.3,41,24,17,21,3,16,48,33.3,32,24,3,21,22,63,44,2,0,2021-2022,0.7508532423208191,1.3993174061433447
1823,Cristian Molinaro,ITA,DF,Venezia,Serie A,38,1983,6.1,12,9,10,2,0,5,7,71.4,2,7,2,5,6,18,20,0,0,2021-2022,0.9836065573770493,1.9672131147540985
1824,Florent Mollet,FRA,"FW,MF",Montpellier,Ligue 1,29,1991,29.2,31,22,14,12,5,14,57,24.6,43,27,4,23,24,55,13,0,0,2021-2022,0.8219178082191781,1.0616438356164384
1825,Jon Moncayola,ESP,MF,Osasuna,La Liga,23,1998,32.4,40,20,18,18,4,17,44,38.6,27,26,9,17,20,60,43,0,0,2021-2022,0.617283950617284,1.234567901234568
Rk,Player,Nation,Pos,Squad,Comp,0,0,90.0,0,0,3,3,3,Tkl,0,0.0,0,0,0,0,0,0,0,0,0,2021-2022,0.0,0.0
1826,Monchu,ESP,MF,Granada,La Liga,21,1999,7.4,15,6,5,9,1,5,10,50.0,5,8,3,5,4,19,4,0,0,2021-2022,0.5405405405405405,2.0270270270270268
1827,Thomas Monconduit,FRA,MF,Lorient,Ligue 1,30,1991,25.0,41,25,19,17,5,20,57,35.1,37,21,10,11,22,63,51,1,0,2021-2022,0.88,1.64
1828,Gonzalo Montiel,ARG,DF,Sevilla,La Liga,24,1997,11.8,15,4,8,5,2,12,24,50.0,12,8,2,6,10,25,22,0,0,2021-2022,0.847457627118644,1.271186440677966
1829,Lorenzo Montipò,ITA,GK,Hellas Verona,Serie A,25,1996,34.0,0,0,0,0,0,0,0,0.0,0,0,0,0,1,1,16,3,0,2021-2022,0.029411764705882353,0.0
1830,Ángel Montoro,ESP,MF,Granada,La Liga,33,1988,14.8,26,13,16,7,3,17,27,63.0,10,11,1,10,11,37,29,1,0,2021-2022,0.7432432432432432,1.7567567567567566
1831,Martín Montoya,ESP,DF,Betis,La Liga,30,1991,5.8,20,12,11,7,2,15,26,57.7,11,6,0,6,11,31,20,0,0,2021-2022,1.896551724137931,3.4482758620689657
1832,Wesley Moraes,BRA,FW,Aston Villa,Premier League,24,1996,0.0,0,0,0,0,0,0,0,0.0,0,0,0,0,0,0,0,0,0,2021-2022,,
1833,Álvaro Morata,ESP,FW,Juventus,Serie A,28,1992,25.6,18,9,4,9,5,8,31,25.8,23,26,1,25,5,23,24,0,0,2021-2022,0.1953125,0.703125
1834,Jan Morávek,CZE,MF,Augsburg,Bundesliga,31,1989,5.2,11,6,3,7,1,6,18,33.3,12,11,2,9,6,17,8,0,0,2021-2022,1.1538461538461537,2.1153846153846154
1835,Jon Morcillo,ESP,"MF,FW",Athletic Club,La Liga,22,1998,0.6,3,0,1,2,0,3,4,75.0,1,1,0,1,0,3,0,0,0,2021-2022,0.0,5.0
1836,Jérémy Morel,MAD,DF,Lorient,Ligue 1,37,1984,6.7,13,9,8,4,1,6,6,100.0,0,9,7,2,7,20,31,0,0,2021-2022,1.044776119402985,1.9402985074626866
1837,Alberto Moreno,ESP,"MF,DF",Villarreal,La Liga,29,1992,13.6,13,7,5,7,1,5,18,27.8,13,13,1,12,27,40,15,0,0,2021-2022,1.9852941176470589,0.9558823529411765
1838,Álex Moreno,ESP,DF,Betis,La Liga,28,1993,26.7,76,40,53,15,8,33,60,55.0,27,28,6,22,34,110,82,1,0,2021-2022,1.2734082397003745,2.8464419475655434
1839,Gerard Moreno,ESP,FW,Villarreal,La Liga,29,1992,13.2,5,2,2,2,1,1,7,14.3,6,6,1,5,6,11,14,0,0,2021-2022,0.4545454545454546,0.3787878787878788
1840,Tete Morente,ESP,MF,Elche,La Liga,24,1996,18.1,21,14,13,7,1,7,28,25.0,21,30,1,29,12,33,12,0,0,2021-2022,0.6629834254143646,1.160220994475138
1841,Ilaix Moriba,GUI,MF,Valencia,La Liga,18,2003,9.1,26,18,10,13,3,14,35,40.0,21,15,0,15,12,38,14,0,0,2021-2022,1.3186813186813187,2.857142857142857
1842,Ilaix Moriba,GUI,MF,RB Leipzig,Bundesliga,18,2003,0.4,0,0,0,0,0,0,4,0.0,4,2,0,2,1,1,0,0,0,2021-2022,2.5,0.0
1843,Manu Morlanes,ESP,MF,Espanyol,La Liga,22,1999,12.7,36,15,16,17,3,18,43,41.9,25,24,5,19,13,49,17,0,0,2021-2022,1.0236220472440944,2.834645669291339
1844,Raúl Moro,ESP,FW,Lazio,Serie A,18,2002,2.2,3,3,0,2,1,1,5,20.0,4,2,0,2,0,3,0,0,0,2021-2022,0.0,1.3636363636363635
1845,Loren Morón,ESP,"FW,MF",Espanyol,La Liga,27,1993,6.3,6,4,1,3,2,0,12,0.0,12,11,1,10,2,8,9,0,0,2021-2022,0.31746031746031744,0.9523809523809524
1846,Loren Morón,ESP,FW,Betis,La Liga,27,1993,0.0,1,1,1,0,0,1,1,100.0,0,0,0,0,0,1,0,0,0,2021-2022,,inf
1847,Tyler Morton,ENG,MF,Liverpool,Premier League,18,2002,0.7,0,0,0,0,0,0,2,0.0,2,0,0,0,3,3,0,0,0,2021-2022,4.285714285714286,0.0
1848,Cristhian Mosquera,ESP,DF,Valencia,La Liga,17,2004,2.4,4,2,3,0,1,3,6,50.0,3,1,0,1,3,7,1,1,0,2021-2022,1.25,1.6666666666666667
1849,Lebo Mothiba,RSA,"FW,MF",Troyes,Ligue 1,25,1996,5.8,8,4,4,3,1,2,5,40.0,3,3,0,3,2,10,0,0,0,2021-2022,0.3448275862068966,1.3793103448275863
1850,Lebo Mothiba,RSA,FW,Strasbourg,Ligue 1,25,1996,0.0,0,0,0,0,0,0,0,0.0,0,0,0,0,0,0,0,0,0,2021-2022,,
Rk,Player,Nation,Pos,Squad,Comp,0,0,90.0,0,0,3,3,3,Tkl,0,0.0,0,0,0,0,0,0,0,0,0,2021-2022,0.0,0.0
1851,Andrei Motoc,ROU,DF,Salernitana,Serie A,19,2002,1.0,1,1,0,1,0,0,0,0.0,0,2,2,0,2,3,1,0,0,2021-2022,2.0,1.0
1852,Baptiste Mouazan,FRA,MF,Lorient,Ligue 1,19,2001,1.1,4,3,2,2,0,1,3,33.3,2,3,0,3,1,5,1,0,0,2021-2022,0.9090909090909091,3.6363636363636362
1853,Aimen Moueffek,FRA,MF,Saint-Étienne,Ligue 1,20,2001,4.8,7,4,2,3,2,2,8,25.0,6,3,0,3,2,9,4,0,0,2021-2022,0.4166666666666667,1.4583333333333335
1854,Youssoufa Moukoko,GER,"FW,MF",Dortmund,Bundesliga,16,2004,2.5,1,0,0,1,0,0,1,0.0,1,5,0,5,3,4,0,0,0,2021-2022,1.2,0.4
1855,Harold Moukoudi,CMR,DF,Saint-Étienne,Ligue 1,23,1997,18.5,25,12,17,8,0,14,25,56.0,11,27,14,13,35,60,48,0,0,2021-2022,1.8918918918918919,1.3513513513513513
1856,Jessy Moulin,FRA,GK,Troyes,Ligue 1,35,1986,7.0,0,0,0,0,0,0,0,0.0,0,0,0,0,1,1,7,0,0,2021-2022,0.14285714285714285,0.0
1857,Steve Mounié,BEN,FW,Brest,Ligue 1,26,1994,25.7,17,6,3,12,2,4,27,14.8,23,13,1,12,6,23,12,0,0,2021-2022,0.23346303501945526,0.6614785992217899
1858,Mason Mount,ENG,MF,Chelsea,Premier League,22,1999,26.3,41,16,10,17,14,10,34,29.4,24,18,1,17,13,54,12,0,0,2021-2022,0.49429657794676807,1.55893536121673
1859,Lucas Moura,BRA,"FW,MF",Tottenham,Premier League,28,1992,19.7,25,10,7,14,4,8,35,22.9,27,19,0,19,18,43,19,0,0,2021-2022,0.9137055837563453,1.2690355329949239
1860,Lys Mousset,FRA,"MF,FW",Salernitana,Serie A,25,1996,1.8,1,0,0,1,0,0,0,0.0,0,2,0,2,0,1,0,0,0,2021-2022,0.0,0.5555555555555556
1861,João Moutinho,POR,MF,Wolves,Premier League,34,1986,33.0,74,39,34,27,13,30,106,28.3,76,48,8,40,34,108,36,2,0,2021-2022,1.0303030303030303,2.242424242424242
1862,Samuel Moutoussamy,COD,MF,Nantes,Ligue 1,24,1996,16.8,48,32,20,20,8,23,62,37.1,39,14,2,12,17,65,16,0,0,2021-2022,1.0119047619047619,2.857142857142857
1863,Toni Moya,ESP,MF,Alavés,La Liga,23,1998,15.4,23,10,7,13,3,13,43,30.2,30,18,5,13,20,43,18,0,0,2021-2022,1.2987012987012987,1.4935064935064934
1864,Samuel Mráz,SVK,FW,Spezia,Serie A,24,1997,0.6,0,0,0,0,0,0,0,0.0,0,1,0,1,0,0,0,0,0,2021-2022,0.0,0.0
1865,Nordi Mukiele,FRA,"DF,FW",RB Leipzig,Bundesliga,23,1997,20.5,35,22,23,9,3,14,27,51.9,13,31,5,26,31,66,44,2,0,2021-2022,1.5121951219512195,1.7073170731707317
1866,Mert Müldür,TUR,DF,Sassuolo,Serie A,22,1999,22.7,52,35,43,7,2,27,49,55.1,22,25,6,19,24,76,44,1,0,2021-2022,1.0572687224669604,2.290748898678414
1867,Florian Müller,GER,GK,Stuttgart,Bundesliga,23,1997,30.0,0,0,0,0,0,0,1,0.0,1,1,0,1,0,0,13,2,0,2021-2022,0.0,0.0
1868,Thomas Müller,GER,MF,Bayern Munich,Bundesliga,31,1989,28.4,35,20,7,16,12,16,54,29.6,38,32,1,31,15,50,12,0,0,2021-2022,0.5281690140845071,1.2323943661971832
1869,Bali Mumba,ENG,DF,Norwich City,Premier League,19,2001,0.5,1,1,1,0,0,0,0,0.0,0,0,0,0,0,1,5,0,0,2021-2022,0.0,2.0
1870,Marshall Munetsi,ZIM,"MF,DF",Reims,Ligue 1,25,1996,20.9,34,17,21,11,2,17,39,43.6,22,39,13,26,43,77,72,2,0,2021-2022,2.057416267942584,1.6267942583732058
1871,Iker Muniain,ESP,MF,Athletic Club,La Liga,28,1992,30.9,32,10,8,19,5,12,40,30.0,28,20,1,19,17,49,8,1,0,2021-2022,0.5501618122977346,1.0355987055016183
1872,Aihen Muñoz,ESP,DF,Real Sociedad,La Liga,23,1997,14.9,28,17,14,13,1,18,29,62.1,11,11,1,10,17,45,34,0,0,2021-2022,1.1409395973154361,1.8791946308724832
1873,Luis Muriel,COL,"FW,MF",Atalanta,Serie A,30,1991,17.1,15,4,2,7,6,3,19,15.8,16,12,0,12,4,19,5,0,0,2021-2022,0.23391812865497075,0.8771929824561403
1874,Jeison Murillo,COL,DF,Celta Vigo,La Liga,29,1992,12.4,15,10,13,2,0,9,13,69.2,4,11,8,3,17,32,37,0,0,2021-2022,1.3709677419354838,1.2096774193548387
1875,Vedat Muriqi,KVX,FW,Lazio,Serie A,27,1994,2.4,1,0,1,0,0,0,5,0.0,5,0,0,0,0,1,2,0,0,2021-2022,0.0,0.4166666666666667
Rk,Player,Nation,Pos,Squad,Comp,0,0,90.0,0,0,3,3,3,Tkl,0,0.0,0,0,0,0,0,0,0,0,0,2021-2022,0.0,0.0
1876,Vedat Muriqi,KVX,FW,Mallorca,La Liga,27,1994,16.0,6,3,1,3,2,1,7,14.3,6,12,0,12,6,12,29,0,0,2021-2022,0.375,0.375
1877,Jacob Murphy,ENG,"FW,DF",Newcastle Utd,Premier League,26,1995,16.4,49,26,34,11,4,26,41,63.4,15,20,2,18,23,72,17,0,0,2021-2022,1.402439024390244,2.987804878048781
1878,Nicola Murru,ITA,DF,Sampdoria,Serie A,26,1994,10.9,22,17,10,11,1,8,13,61.5,5,17,3,14,7,29,20,1,0,2021-2022,0.6422018348623852,2.018348623853211
1879,Yunus Musah,USA,"MF,FW",Valencia,La Liga,18,2002,14.0,23,13,8,8,7,6,20,30.0,14,19,1,18,14,37,11,0,0,2021-2022,1.0,1.6428571428571428
1880,Torben Müsel,GER,MF,Gladbach,Bundesliga,22,1999,0.1,0,0,0,0,0,0,0,0.0,0,0,0,0,0,0,0,0,0,2021-2022,0.0,0.0
1881,Jamal Musiala,GER,"MF,FW",Bayern Munich,Bundesliga,18,2003,16.3,40,26,11,16,13,15,36,41.7,21,25,0,25,19,59,2,1,0,2021-2022,1.165644171779141,2.4539877300613497
1882,Juan Musso,ARG,GK,Atalanta,Serie A,27,1994,32.6,1,1,1,0,0,0,0,0.0,0,0,0,0,0,1,17,1,0,2021-2022,0.0,0.03067484662576687
1883,Shkodran Mustafi,GER,DF,Levante,La Liga,29,1992,7.3,9,6,6,3,0,5,9,55.6,4,6,3,3,15,24,40,0,0,2021-2022,2.0547945205479454,1.2328767123287672
1884,Junior Mwanga,FRA,DF,Bordeaux,Ligue 1,18,2003,1.0,5,2,4,1,0,3,3,100.0,0,1,0,1,0,5,1,0,0,2021-2022,0.0,5.0
1885,Enock Mwepu,ZAM,MF,Brighton,Premier League,23,1998,11.1,22,12,10,10,2,5,27,18.5,22,20,2,18,12,34,19,0,0,2021-2022,1.0810810810810811,1.981981981981982
1886,Vitaliy Mykolenko,UKR,DF,Everton,Premier League,22,1999,11.7,25,15,15,7,3,12,21,57.1,9,15,2,13,16,41,37,0,0,2021-2022,1.3675213675213675,2.1367521367521367
1887,Joakim Mæhle,DEN,"DF,MF",Atalanta,Serie A,24,1997,16.3,21,11,6,9,6,12,27,44.4,15,18,2,16,14,35,13,0,0,2021-2022,0.8588957055214723,1.2883435582822085
1888,Obite N'Dicka,CIV,DF,Eint Frankfurt,Bundesliga,21,1999,31.7,60,34,29,27,4,44,59,74.6,15,46,20,26,48,108,137,0,0,2021-2022,1.5141955835962146,1.8927444794952681
1889,Kévin N'Doram,FRA,MF,Metz,Ligue 1,25,1996,13.7,10,8,3,5,2,3,20,15.0,17,24,5,19,19,29,21,0,0,2021-2022,1.3868613138686132,0.7299270072992701
1890,Eric N'Jo,FRA,DF,Troyes,Ligue 1,17,2004,1.1,0,0,0,0,0,0,1,0.0,1,1,1,0,2,2,1,0,0,2021-2022,1.8181818181818181,0.0
1891,Vital N'Simba,COD,DF,Clermont Foot,Ligue 1,28,1993,31.0,66,45,38,23,5,36,63,57.1,27,28,7,21,29,95,30,0,0,2021-2022,0.9354838709677419,2.129032258064516
1892,Nacho,ESP,DF,Real Madrid,La Liga,31,1990,17.3,18,14,9,9,0,12,22,54.5,10,22,15,7,34,52,50,0,0,2021-2022,1.9653179190751444,1.0404624277456647
1893,Mickael Nade,FRA,DF,Saint-Étienne,Ligue 1,22,1999,28.5,57,35,37,18,2,23,38,60.5,15,29,15,14,60,117,84,0,0,2021-2022,2.1052631578947367,2.0
1894,Marvelous Nakamba,ZIM,MF,Aston Villa,Premier League,27,1994,10.0,32,19,18,14,0,12,34,35.3,22,14,4,10,12,44,17,1,0,2021-2022,1.2,3.2
1895,Nahitan Nández,URU,"MF,DF",Cagliari,Serie A,25,1995,16.9,39,21,16,15,8,18,33,54.5,15,16,1,15,9,48,15,1,0,2021-2022,0.5325443786982249,2.307692307692308
1896,Nani,POR,"MF,FW",Venezia,Serie A,34,1986,3.2,2,1,1,1,0,0,1,0.0,1,1,0,1,2,4,0,1,0,2021-2022,0.625,0.625
1897,Paul Nardi,FRA,GK,Lorient,Ligue 1,27,1994,22.0,1,0,1,0,0,1,2,50.0,1,0,0,0,0,1,10,2,0,2021-2022,0.0,0.045454545454545456
1898,Nikolas Nartey,DEN,"MF,DF",Stuttgart,Bundesliga,21,2000,4.5,6,3,0,5,1,3,9,33.3,6,4,2,2,7,13,5,0,0,2021-2022,1.5555555555555556,1.3333333333333333
1899,Matija Nastasić,SRB,DF,Fiorentina,Serie A,28,1993,2.4,1,1,1,0,0,1,1,100.0,0,1,1,0,5,6,11,0,0,2021-2022,2.0833333333333335,0.4166666666666667
1900,Roberto Navarro,ESP,"MF,FW",Real Sociedad,La Liga,19,2002,2.2,5,3,1,1,3,3,5,60.0,2,2,0,2,2,7,2,0,0,2021-2022,0.9090909090909091,2.2727272727272725
Rk,Player,Nation,Pos,Squad,Comp,0,0,90.0,0,0,3,3,3,Tkl,0,0.0,0,0,0,0,0,0,0,0,0,2021-2022,0.0,0.0
1901,Ximo Navarro,ESP,DF,Alavés,La Liga,31,1990,15.0,28,19,21,6,1,13,27,48.1,14,11,5,6,22,50,56,2,0,2021-2022,1.4666666666666666,1.8666666666666667
1902,Jesús Navas,ESP,DF,Sevilla,La Liga,35,1985,19.8,18,13,11,5,2,9,17,52.9,8,15,2,13,17,35,26,1,0,2021-2022,0.8585858585858586,0.9090909090909091
1903,Keylor Navas,CRC,GK,Paris S-G,Ligue 1,34,1986,20.6,0,0,0,0,0,0,0,0.0,0,0,0,0,0,0,5,1,0,2021-2022,0.0,0.0
1904,Papa Ndiaga Yade,MTN,"DF,FW",Metz,Ligue 1,21,2000,7.7,15,10,8,7,0,8,18,44.4,10,4,1,3,10,25,9,0,0,2021-2022,1.2987012987012987,1.948051948051948
1905,Wilfred Ndidi,NGA,"MF,DF",Leicester City,Premier League,24,1996,18.0,60,32,32,27,1,22,55,40.0,33,36,8,28,42,102,54,1,0,2021-2022,2.3333333333333335,3.3333333333333335
1906,Tanguy Ndombele,FRA,MF,Tottenham,Premier League,24,1996,5.4,10,7,3,5,2,1,8,12.5,7,5,0,5,1,11,1,0,0,2021-2022,0.18518518518518517,1.8518518518518516
1907,Tanguy Ndombele,FRA,MF,Lyon,Ligue 1,24,1996,7.8,25,14,5,17,3,12,19,63.2,7,8,3,5,3,28,6,2,0,2021-2022,0.38461538461538464,3.2051282051282053
1908,Dan Ndoye,SUI,"FW,MF",Nice,Ligue 1,20,2000,2.3,0,0,0,0,0,0,2,0.0,2,4,0,4,0,0,0,0,0,2021-2022,0.0,0.0
1909,Paul Nebel,GER,"MF,FW",Mainz 05,Bundesliga,18,2002,2.5,5,3,3,1,1,2,3,66.7,1,0,0,0,0,5,1,0,0,2021-2022,0.0,2.0
1910,Álvaro Negredo,ESP,FW,Cádiz,La Liga,35,1985,24.0,5,3,1,4,0,3,6,50.0,3,11,5,6,2,7,23,0,0,2021-2022,0.08333333333333333,0.20833333333333334
1911,Reiss Nelson,ENG,FW,Arsenal,Premier League,21,1999,0.2,1,0,0,0,1,0,1,0.0,1,1,0,1,0,1,0,0,0,2021-2022,0.0,5.0
1912,David Nemeth,AUT,DF,Mainz 05,Bundesliga,20,2001,3.5,3,2,2,1,0,1,3,33.3,2,5,1,4,6,9,11,1,0,2021-2022,1.7142857142857142,0.8571428571428571
1913,Ilija Nestorovski,MKD,FW,Udinese,Serie A,31,1990,2.1,0,0,0,0,0,0,3,0.0,3,0,0,0,0,0,4,0,0,2021-2022,0.0,0.0
1914,Neto,BRA,GK,Barcelona,La Liga,32,1989,3.0,0,0,0,0,0,0,0,0.0,0,0,0,0,0,0,2,1,0,2021-2022,0.0,0.0
1915,Pedro Neto,POR,"FW,MF",Wolves,Premier League,21,2000,5.2,4,4,2,0,2,0,9,0.0,9,0,0,0,6,10,1,0,0,2021-2022,1.1538461538461537,0.7692307692307692
1916,Luca Netz,GER,"DF,FW",Gladbach,Bundesliga,18,2003,15.5,24,11,12,10,2,11,40,27.5,29,24,4,20,13,37,33,1,0,2021-2022,0.8387096774193549,1.5483870967741935
1917,Manuel Neuer,GER,GK,Bayern Munich,Bundesliga,35,1986,27.9,2,1,2,0,0,1,2,50.0,1,0,0,0,0,2,7,1,0,2021-2022,0.0,0.07168458781362008
1918,Florian Neuhaus,GER,MF,Gladbach,Bundesliga,24,1997,23.6,55,28,24,26,5,27,64,42.2,37,38,6,32,31,86,19,4,0,2021-2022,1.3135593220338981,2.330508474576271
1919,Carlos Neva,ESP,DF,Granada,La Liga,25,1996,23.4,31,19,24,7,0,16,28,57.1,12,27,9,18,32,63,81,0,0,2021-2022,1.3675213675213675,1.324786324786325
1920,Rúben Neves,POR,MF,Wolves,Premier League,24,1997,29.6,68,37,23,41,4,24,87,27.6,63,39,5,34,41,109,49,3,0,2021-2022,1.385135135135135,2.2972972972972974
1921,Neymar,BRA,"FW,MF",Paris S-G,Ligue 1,29,1992,20.6,29,19,5,12,12,12,36,33.3,24,9,1,8,4,33,2,1,0,2021-2022,0.1941747572815534,1.407766990291262
1922,Yvan Neyou,CMR,MF,Saint-Étienne,Ligue 1,24,1997,10.4,29,13,14,12,3,9,27,33.3,18,8,3,5,23,52,13,0,0,2021-2022,2.2115384615384617,2.7884615384615383
1923,Jeremy Ngakia,ENG,DF,Watford,Premier League,20,2000,10.0,31,18,23,5,3,11,26,42.3,15,11,4,7,12,43,32,0,0,2021-2022,1.2,3.1
1924,Jessic Ngankam,GER,FW,Greuther Fürth,Bundesliga,21,2000,3.8,3,1,1,1,1,1,2,50.0,1,3,0,3,0,3,1,0,0,2021-2022,0.0,0.7894736842105263
1925,Opa Nguette,SEN,"FW,MF",Metz,Ligue 1,27,1994,11.6,21,14,9,6,6,5,14,35.7,9,13,3,10,2,23,9,0,0,2021-2022,0.1724137931034483,1.8103448275862069
Rk,Player,Nation,Pos,Squad,Comp,0,0,90.0,0,0,3,3,3,Tkl,0,0.0,0,0,0,0,0,0,0,0,0,2021-2022,0.0,0.0
1926,Aurélien Nguiamba,FRA,MF,Spezia,Serie A,22,1999,0.6,3,2,1,2,0,2,3,66.7,1,2,1,1,0,3,1,0,0,2021-2022,0.0,5.0
1927,Sikou Niakaté,MLI,DF,Metz,Ligue 1,22,1999,7.3,8,7,8,0,0,4,11,36.4,7,5,3,2,27,35,34,0,0,2021-2022,3.6986301369863015,1.095890410958904
1928,Moussa Niakhate,SEN,DF,Mainz 05,Bundesliga,25,1996,28.5,40,23,25,13,2,20,33,60.6,13,37,11,26,50,90,69,1,0,2021-2022,1.7543859649122806,1.4035087719298245
1929,Ibrahima Niane,SEN,FW,Metz,Ligue 1,22,1999,17.6,1,1,0,1,0,0,5,0.0,5,6,1,5,3,4,16,0,0,2021-2022,0.17045454545454544,0.056818181818181816
1930,M'Baye Niang,SEN,FW,Bordeaux,Ligue 1,26,1994,8.6,4,0,0,2,2,0,4,0.0,4,9,1,8,1,5,4,0,0,2021-2022,0.11627906976744186,0.46511627906976744
1931,Tanguy Nianzou,FRA,DF,Bayern Munich,Bundesliga,19,2002,6.5,11,7,7,3,1,7,11,63.6,4,7,2,5,7,18,17,0,0,2021-2022,1.0769230769230769,1.6923076923076923
1932,Cheikh Niasse,SEN,"FW,MF",Lille,Ligue 1,21,2000,0.5,2,2,0,2,0,2,3,66.7,1,1,1,0,1,3,2,0,0,2021-2022,2.0,4.0
1933,Florian Niederlechner,GER,FW,Augsburg,Bundesliga,30,1990,12.9,6,5,1,3,2,4,13,30.8,9,9,0,9,4,10,7,0,0,2021-2022,0.31007751937984496,0.46511627906976744
1934,Håvard Nielsen,NOR,"MF,FW",Greuther Fürth,Bundesliga,28,1993,15.2,17,12,5,11,1,8,21,38.1,13,18,1,17,7,24,22,0,0,2021-2022,0.46052631578947373,1.118421052631579
1935,Saúl Ñíguez,ESP,"DF,MF",Chelsea,Premier League,26,1994,5.3,20,9,11,9,0,9,16,56.3,7,14,3,11,7,27,10,1,0,2021-2022,1.3207547169811322,3.7735849056603774
1936,Saúl Ñíguez,ESP,"FW,MF",Atlético Madrid,La Liga,26,1994,2.2,7,2,0,6,1,3,4,75.0,1,7,1,6,0,7,3,0,0,2021-2022,0.0,3.1818181818181817
1937,Dimitris Nikolaou,GRE,DF,Spezia,Serie A,22,1998,36.0,39,26,29,7,3,22,34,64.7,12,48,24,24,49,88,132,1,0,2021-2022,1.3611111111111112,1.0833333333333333
1938,Joakim Nilsson,SWE,DF,Arminia,Bundesliga,27,1994,30.4,37,19,24,13,0,20,26,76.9,6,36,23,13,56,93,143,1,0,2021-2022,1.842105263157895,1.2171052631578947
1939,Casimir Ninga,CHA,FW,Angers,Ligue 1,28,1993,4.5,5,1,1,4,0,2,5,40.0,3,2,0,2,1,6,0,0,0,2021-2022,0.2222222222222222,1.1111111111111112
1940,Fernando Niño,ESP,FW,Mallorca,La Liga,20,2000,9.8,10,4,3,2,5,2,12,16.7,10,9,2,7,3,13,15,0,0,2021-2022,0.3061224489795918,1.0204081632653061
1941,Eddie Nketiah,ENG,FW,Arsenal,Premier League,22,1999,9.3,9,4,1,4,4,1,4,25.0,3,9,2,7,4,13,5,0,0,2021-2022,0.4301075268817204,0.9677419354838709
1942,Nicolas Nkoulou,CMR,DF,Watford,Premier League,31,1990,1.9,1,0,0,1,0,0,0,0.0,0,2,1,1,2,3,8,0,0,2021-2022,1.0526315789473684,0.5263157894736842
1943,Christopher Nkunku,FRA,"FW,MF",RB Leipzig,Bundesliga,23,1997,30.3,23,10,10,11,2,9,35,25.7,26,23,2,21,15,38,15,0,0,2021-2022,0.49504950495049505,0.759075907590759
1944,Felix Nmecha,GER,"MF,FW",Wolfsburg,Bundesliga,20,2000,3.6,3,1,1,1,1,0,2,0.0,2,2,0,2,7,10,6,0,0,2021-2022,1.9444444444444444,0.8333333333333333
1945,Lukas Nmecha,GER,"FW,MF",Wolfsburg,Bundesliga,22,1998,18.1,12,5,5,5,2,5,19,26.3,14,9,1,8,4,16,10,0,0,2021-2022,0.22099447513812154,0.6629834254143646
1946,Mark Noble,ENG,MF,West Ham,Premier League,34,1987,3.7,8,2,7,1,0,5,11,45.5,6,4,1,3,4,12,2,1,0,2021-2022,1.081081081081081,2.162162162162162
1947,Peru Nolaskoain,ESP,DF,Athletic Club,La Liga,22,1998,0.0,0,0,0,0,0,0,0,0.0,0,0,0,0,0,0,0,0,0,2021-2022,,
1948,Nolito,ESP,MF,Celta Vigo,La Liga,34,1986,15.4,25,15,14,7,4,13,47,27.7,34,20,1,19,9,34,5,0,0,2021-2022,0.5844155844155844,1.6233766233766234
1949,Arnaud Nordin,FRA,"FW,MF",Saint-Étienne,Ligue 1,23,1998,20.8,21,11,8,8,5,8,22,36.4,14,19,0,19,6,27,8,0,0,2021-2022,0.28846153846153844,1.0096153846153846
1950,Håvard Nordtveit,NOR,DF,Hoffenheim,Bundesliga,31,1990,3.4,7,6,2,4,1,4,4,100.0,0,2,1,1,10,17,11,0,0,2021-2022,2.9411764705882355,2.058823529411765
Rk,Player,Nation,Pos,Squad,Comp,0,0,90.0,0,0,3,3,3,Tkl,0,0.0,0,0,0,0,0,0,0,0,0,2021-2022,0.0,0.0
1951,Mathias Normann,NOR,MF,Norwich City,Premier League,25,1996,18.3,34,21,19,14,1,17,46,37.0,29,17,8,9,19,53,43,1,0,2021-2022,1.0382513661202186,1.8579234972677594
1952,Connor Noß,IRL,MF,Gladbach,Bundesliga,20,2001,0.6,1,0,0,1,0,0,1,0.0,1,1,1,0,0,1,0,0,0,2021-2022,0.0,1.6666666666666667
1953,Hugo Novoa,ESP,"MF,FW",RB Leipzig,Bundesliga,18,2003,1.5,4,4,2,0,2,2,7,28.6,5,2,0,2,1,5,0,0,0,2021-2022,0.6666666666666666,2.6666666666666665
1954,Soma Novothny,HUN,"FW,MF",Bochum,Bundesliga,27,1994,0.9,1,1,1,0,0,0,1,0.0,1,1,0,1,0,1,2,0,0,2021-2022,0.0,1.1111111111111112
1955,Jean-Pierre Nsame,CMR,FW,Venezia,Serie A,28,1993,2.7,1,1,0,0,1,0,0,0.0,0,0,0,0,0,1,1,0,0,2021-2022,0.0,0.37037037037037035
1956,Randy Nteka,ANG,"FW,MF",Rayo Vallecano,La Liga,23,1997,16.2,24,13,9,11,4,8,19,42.1,11,21,1,20,8,32,12,0,0,2021-2022,0.4938271604938272,1.4814814814814816
1957,Alexander Nübel,GER,GK,Monaco,Ligue 1,24,1996,38.0,0,0,0,0,0,0,1,0.0,1,0,0,0,0,0,11,1,0,2021-2022,0.0,0.0
1958,Kasim Nuhu,GHA,DF,Hoffenheim,Bundesliga,26,1995,0.1,0,0,0,0,0,0,1,0.0,1,0,0,0,0,0,1,0,0,2021-2022,0.0,0.0
1959,Unai Núñez,ESP,DF,Athletic Club,La Liga,24,1997,6.9,4,4,2,2,0,3,6,50.0,3,9,8,1,8,12,26,2,0,2021-2022,1.1594202898550725,0.5797101449275363
1960,Hans Nunoo Sarpei,GHA,"DF,MF",Greuther Fürth,Bundesliga,22,1998,7.1,16,11,9,7,0,10,14,71.4,4,8,5,3,14,30,21,0,0,2021-2022,1.971830985915493,2.2535211267605635
1961,Bram Nuytinck,NED,DF,Udinese,Serie A,31,1990,22.6,38,24,24,13,1,15,34,44.1,19,42,31,11,22,60,101,0,0,2021-2022,0.9734513274336283,1.6814159292035398
1962,Simeon Nwankwo,NGA,FW,Salernitana,Serie A,29,1992,9.4,5,5,0,4,1,4,10,40.0,6,8,3,5,3,8,10,0,0,2021-2022,0.3191489361702127,0.5319148936170213
1963,Gerzino Nyamsi,FRA,DF,Strasbourg,Ligue 1,24,1997,33.2,35,21,24,9,2,20,27,74.1,7,25,16,9,25,60,90,1,0,2021-2022,0.753012048192771,1.0542168674698795
1964,Allan Nyom,CMR,DF,Getafe,La Liga,33,1988,2.7,3,1,2,1,0,2,2,100.0,0,2,1,1,2,5,7,0,0,2021-2022,0.7407407407407407,1.111111111111111
1965,M'Bala Nzola,ANG,FW,Spezia,Serie A,24,1996,11.9,2,2,0,0,2,1,6,16.7,5,8,0,8,0,2,13,0,0,2021-2022,0.0,0.1680672268907563
1966,Christian Nørgaard,DEN,MF,Brentford,Premier League,27,1994,33.9,109,60,42,58,9,52,101,51.5,49,48,9,39,64,173,58,1,0,2021-2022,1.887905604719764,3.2153392330383483
1967,Adam Obert,SVK,"DF,MF",Cagliari,Serie A,18,2002,3.0,8,5,6,2,0,5,6,83.3,1,6,4,2,4,12,11,0,0,2021-2022,1.3333333333333333,2.6666666666666665
1968,Joel Obi,NGA,"MF,DF",Salernitana,Serie A,30,1991,12.7,23,14,5,14,4,5,12,41.7,7,17,6,11,10,33,7,0,0,2021-2022,0.7874015748031497,1.8110236220472442
1969,Jan Oblak,SVN,GK,Atlético Madrid,La Liga,28,1993,38.0,0,0,0,0,0,0,0,0.0,0,0,0,0,1,1,10,4,0,2021-2022,0.02631578947368421,0.0
1970,Lucas Ocampos,ARG,FW,Sevilla,La Liga,27,1994,23.6,45,24,23,18,4,23,55,41.8,32,35,1,34,9,54,24,1,0,2021-2022,0.3813559322033898,1.906779661016949
1971,Bastian Oczipka,GER,DF,Union Berlin,Bundesliga,32,1989,10.4,24,15,15,7,2,10,13,76.9,3,10,2,8,12,36,21,0,0,2021-2022,1.1538461538461537,2.3076923076923075
1972,Brian Oddei,ITA,FW,Sassuolo,Serie A,18,2002,0.1,0,0,0,0,0,0,0,0.0,0,0,0,0,0,0,0,0,0,2021-2022,0.0,0.0
1973,Álvaro Odriozola,ESP,DF,Fiorentina,Serie A,25,1995,19.3,25,15,12,6,7,15,32,46.9,17,17,6,11,8,33,25,2,0,2021-2022,0.41450777202072536,1.2953367875647668
1974,Angelo Ogbonna,ITA,DF,West Ham,Premier League,33,1988,10.2,7,4,5,2,0,3,7,42.9,4,5,4,1,11,18,29,0,0,2021-2022,1.0784313725490198,0.6862745098039216
1975,Florent Ogier,FRA,DF,Clermont Foot,Ligue 1,32,1989,27.0,31,17,18,12,1,17,31,54.8,14,41,27,14,37,68,89,0,0,2021-2022,1.3703703703703705,1.1481481481481481
Rk,Player,Nation,Pos,Squad,Comp,0,0,90.0,0,0,3,3,3,Tkl,0,0.0,0,0,0,0,0,0,0,0,0,2021-2022,0.0,0.0
1976,Stefano Okaka,ITA,FW,Udinese,Serie A,31,1989,0.2,0,0,0,0,0,0,0,0.0,0,2,0,2,0,0,1,0,0,2021-2022,0.0,0.0
1977,David Okereke,NGA,"FW,MF",Venezia,Serie A,23,1997,22.8,16,10,4,9,3,3,20,15.0,17,19,3,16,10,26,20,0,0,2021-2022,0.43859649122807015,0.7017543859649122
1978,Masaya Okugawa,JPN,"MF,FW",Arminia,Bundesliga,25,1996,28.1,46,25,18,22,6,12,37,32.4,25,29,1,28,20,66,13,0,0,2021-2022,0.7117437722419928,1.6370106761565835
1979,Lucas Olaza,URU,DF,Elche,La Liga,27,1994,3.3,5,3,3,1,1,1,1,100.0,0,5,1,4,4,9,6,0,0,2021-2022,1.2121212121212122,1.5151515151515151
1980,Oier Olazábal,ESP,GK,Espanyol,La Liga,31,1989,1.5,0,0,0,0,0,0,0,0.0,0,0,0,0,0,0,0,0,0,2021-2022,0.0,0.0
1981,Mathias Olesen,LUX,"MF,FW",Köln,Bundesliga,20,2001,0.2,0,0,0,0,0,0,0,0.0,0,0,0,0,1,1,0,0,0,2021-2022,5.0,0.0
1982,Michael Olise,FRA,"FW,MF",Crystal Palace,Premier League,19,2001,12.7,22,18,8,11,3,7,24,29.2,17,17,0,17,6,28,6,0,0,2021-2022,0.4724409448818898,1.7322834645669292
1983,Christian Oliva,URU,MF,Cagliari,Serie A,25,1996,0.5,2,2,2,0,0,1,4,25.0,3,0,0,0,0,2,0,0,0,2021-2022,0.0,4.0
1984,Brian Oliván,ESP,DF,Mallorca,La Liga,27,1994,24.3,33,20,22,9,2,12,23,52.2,11,17,7,10,28,61,63,0,0,2021-2022,1.1522633744855966,1.3580246913580247
1985,Sérgio Oliveira,POR,MF,Roma,Serie A,29,1992,9.9,27,14,11,14,2,15,30,50.0,15,13,0,13,10,37,7,0,0,2021-2022,1.0101010101010102,2.727272727272727
1986,Mathías Olivera,URU,DF,Getafe,La Liga,23,1997,31.1,79,47,39,34,6,40,69,58.0,29,45,4,41,55,134,67,1,0,2021-2022,1.7684887459807073,2.540192926045016
1987,Dani Olmo,ESP,"MF,FW",RB Leipzig,Bundesliga,23,1998,8.3,14,6,5,7,2,5,18,27.8,13,5,1,4,4,18,1,0,0,2021-2022,0.48192771084337344,1.686746987951807
1988,Robin Olsen,SWE,GK,Aston Villa,Premier League,31,1990,1.0,0,0,0,0,0,0,0,0.0,0,0,0,0,0,0,0,0,0,2021-2022,0.0,0.0
1989,Warmed Omari,FRA,DF,Rennes,Ligue 1,21,2000,31.1,33,17,22,10,1,15,23,65.2,8,20,13,7,31,64,94,5,0,2021-2022,0.9967845659163986,1.0610932475884245
1990,Jonas Omlin,SUI,GK,Montpellier,Ligue 1,27,1994,28.7,2,1,2,0,0,2,3,66.7,1,0,0,0,0,2,12,3,0,2021-2022,0.0,0.06968641114982578
1991,Andrew Omobamidele,IRL,DF,Norwich City,Premier League,19,2002,4.2,8,6,5,3,0,5,11,45.5,6,8,8,0,5,13,13,0,0,2021-2022,1.1904761904761905,1.9047619047619047
1992,Amadou Onana,BEL,MF,Lille,Ligue 1,19,2001,15.1,48,31,17,27,4,18,25,72.0,7,10,3,7,30,78,19,0,0,2021-2022,1.9867549668874174,3.178807947019868
1993,Jean Onana,CMR,MF,Bordeaux,Ligue 1,21,2000,20.4,70,49,33,33,4,35,86,40.7,51,37,5,32,36,106,23,1,0,2021-2022,1.7647058823529413,3.431372549019608
1994,Karim Onisiwo,AUT,FW,Mainz 05,Bundesliga,29,1992,26.2,18,10,4,6,8,7,22,31.8,15,27,2,25,7,25,8,0,0,2021-2022,0.26717557251908397,0.6870229007633588
1995,Javier Ontiveros,ESP,"FW,MF",Osasuna,La Liga,23,1997,0.4,0,0,0,0,0,0,2,0.0,2,0,0,0,1,1,0,1,0,2021-2022,2.5,0.0
1996,Tyler Onyango,ENG,MF,Everton,Premier League,18,2003,0.3,0,0,0,0,0,0,0,0.0,0,0,0,0,0,0,1,0,0,2021-2022,0.0,0.0
1997,Frank Onyeka,NGA,MF,Brentford,Premier League,23,1998,11.6,25,17,13,9,3,8,27,29.6,19,16,2,14,14,39,13,0,0,2021-2022,1.206896551724138,2.1551724137931036
1998,Willi Orban,HUN,DF,RB Leipzig,Bundesliga,28,1992,29.4,32,22,20,11,1,13,25,52.0,12,40,24,16,44,76,123,2,0,2021-2022,1.4965986394557824,1.08843537414966
1999,Divock Origi,BEL,FW,Liverpool,Premier League,26,1995,1.5,0,0,0,0,0,0,2,0.0,2,1,0,1,1,1,2,0,0,2021-2022,0.6666666666666666,0.0
2000,Riccardo Orsolini,ITA,"FW,MF",Bologna,Serie A,24,1997,19.8,21,13,9,11,1,13,29,44.8,16,9,4,5,5,26,14,0,0,2021-2022,0.25252525252525254,1.0606060606060606
Rk,Player,Nation,Pos,Squad,Comp,0,0,90.0,0,0,3,3,3,Tkl,0,0.0,0,0,0,0,0,0,0,0,0,2021-2022,0.0,0.0
2001,Stefan Ortega,GER,GK,Arminia,Bundesliga,28,1992,33.0,1,0,1,0,0,1,2,50.0,1,2,0,2,0,1,5,1,0,2021-2022,0.0,0.030303030303030304
2002,Pedro Ortiz,ESP,MF,Sevilla,La Liga,20,2000,0.1,0,0,0,0,0,0,0,0.0,0,0,0,0,0,0,1,0,0,2021-2022,0.0,0.0
2003,Victor Osimhen,NGA,FW,Napoli,Serie A,22,1998,22.0,10,5,1,2,7,2,6,33.3,4,16,3,13,3,13,17,0,0,2021-2022,0.13636363636363635,0.45454545454545453
2004,Milutin Osmajić,MNE,"FW,MF",Cádiz,La Liga,22,1999,2.9,1,1,0,1,0,0,0,0.0,0,0,0,0,1,2,3,0,0,2021-2022,0.3448275862068966,0.3448275862068966
2005,David Ospina,COL,GK,Napoli,Serie A,32,1988,31.0,0,0,0,0,0,0,0,0.0,0,0,0,0,1,1,11,1,0,2021-2022,0.03225806451612903,0.0
2006,Patrick Osterhage,GER,MF,Bochum,Bundesliga,21,2000,6.7,9,6,3,5,1,3,7,42.9,4,7,1,6,11,20,8,0,0,2021-2022,1.6417910447761193,1.3432835820895521
2007,Tomáš Ostrák,CZE,"MF,FW",Köln,Bundesliga,21,2000,0.3,1,0,0,0,1,1,3,33.3,2,0,0,0,1,2,0,0,0,2021-2022,3.3333333333333335,3.3333333333333335
2008,Otávio,BRA,MF,Bordeaux,Ligue 1,27,1994,12.7,36,23,13,21,2,16,39,41.0,23,9,3,6,18,54,11,0,0,2021-2022,1.4173228346456694,2.834645669291339
2009,Paulo Otávio,BRA,"DF,MF",Wolfsburg,Bundesliga,26,1994,4.0,14,10,7,4,3,8,15,53.3,7,11,6,5,4,18,9,0,0,2021-2022,1.0,3.5
2010,Dango Ouattara,BFA,"MF,FW",Lorient,Ligue 1,19,2002,9.0,21,15,9,11,1,11,23,47.8,12,10,1,9,14,35,15,1,0,2021-2022,1.5555555555555556,2.3333333333333335
2011,Remi Oudin,FRA,"MF,FW",Bordeaux,Ligue 1,24,1996,19.3,34,18,19,13,2,18,32,56.3,14,14,3,11,27,61,21,0,0,2021-2022,1.398963730569948,1.761658031088083
2012,Alexandre Oukidja,ALG,GK,Metz,Ligue 1,33,1988,20.8,0,0,0,0,0,0,1,0.0,1,1,0,1,1,1,17,2,0,2021-2022,0.04807692307692307,0.0
2013,Azzedine Ounahi,MAR,MF,Angers,Ligue 1,21,2000,18.1,39,22,16,22,1,11,40,27.5,29,19,1,18,26,65,13,0,0,2021-2022,1.43646408839779,2.154696132596685
2014,Adam Ounas,ALG,"MF,FW",Napoli,Serie A,24,1996,3.6,6,1,0,3,3,3,7,42.9,4,3,0,3,2,8,3,0,0,2021-2022,0.5555555555555556,1.6666666666666665
2015,Jesús Owono,EQG,GK,Alavés,La Liga,20,2001,1.0,0,0,0,0,0,0,0,0.0,0,0,0,0,0,0,1,0,0,2021-2022,0.0,0.0
2016,Reece Oxford,ENG,DF,Augsburg,Bundesliga,22,1998,29.9,27,14,16,9,2,15,31,48.4,16,42,33,9,72,99,172,1,0,2021-2022,2.408026755852843,0.9030100334448161
2017,Alex Oxlade-Chamberlain,ENG,"MF,FW",Liverpool,Premier League,27,1993,8.7,15,11,2,8,5,3,14,21.4,11,12,2,10,6,21,5,0,0,2021-2022,0.6896551724137931,1.7241379310344829
2018,Mikel Oyarzabal,ESP,"FW,MF",Real Sociedad,La Liga,24,1997,18.6,18,10,7,7,4,7,21,33.3,14,18,2,16,10,28,16,1,0,2021-2022,0.5376344086021505,0.9677419354838709
2019,Ambroise Oyongo,CMR,DF,Montpellier,Ligue 1,30,1991,7.3,13,4,7,4,2,9,15,60.0,6,5,1,4,6,19,17,0,0,2021-2022,0.8219178082191781,1.7808219178082192
2020,Salih Özcan,TUR,MF,Köln,Bundesliga,23,1998,25.7,42,30,14,23,5,22,51,43.1,29,37,5,32,51,93,35,1,0,2021-2022,1.9844357976653697,1.6342412451361867
2021,Levin Öztunalı,GER,MF,Union Berlin,Bundesliga,25,1996,6.4,14,11,6,5,3,7,17,41.2,10,3,0,3,4,18,12,0,0,2021-2022,0.625,2.1875
2022,Fernando Pacheco,ESP,GK,Alavés,La Liga,29,1992,33.9,2,1,2,0,0,2,2,100.0,0,0,0,0,0,2,18,1,0,2021-2022,0.0,0.058997050147492625
2023,Jon Pacheco,ESP,DF,Real Sociedad,La Liga,20,2001,4.2,6,4,4,2,0,3,3,100.0,0,6,4,2,6,12,18,0,0,2021-2022,1.4285714285714286,1.4285714285714286
2024,Gonçalo Paciência,POR,FW,Eint Frankfurt,Bundesliga,26,1994,5.7,4,2,2,1,1,1,3,33.3,2,2,0,2,1,5,4,0,0,2021-2022,0.17543859649122806,0.7017543859649122
2025,Daniele Padelli,ITA,GK,Udinese,Serie A,35,1985,3.0,0,0,0,0,0,0,0,0.0,0,0,0,0,0,0,2,1,0,2021-2022,0.0,0.0
Rk,Player,Nation,Pos,Squad,Comp,0,0,90.0,0,0,3,3,3,Tkl,0,0.0,0,0,0,0,0,0,0,0,0,2021-2022,0.0,0.0
2026,Simone Pafundi,ITA,FW,Udinese,Serie A,15,2006,0.3,0,0,0,0,0,0,1,0.0,1,0,0,0,0,0,0,0,0,2021-2022,0.0,0.0
2027,Vincent Pajot,FRA,MF,Metz,Ligue 1,30,1990,25.7,86,56,35,47,4,20,46,43.5,26,33,6,27,51,137,38,0,0,2021-2022,1.9844357976653697,3.3463035019455254
2028,Exequiel Palacios,ARG,MF,Leverkusen,Bundesliga,22,1998,12.2,30,19,12,14,4,15,38,39.5,23,20,1,19,28,58,11,2,0,2021-2022,2.295081967213115,2.459016393442623
2029,Helibelton Palacios,COL,DF,Elche,La Liga,28,1993,21.5,69,38,56,10,3,37,55,67.3,18,21,8,13,18,87,61,0,0,2021-2022,0.8372093023255814,3.2093023255813953
2030,Isaac Palazón Camacho,ESP,"FW,MF",Rayo Vallecano,La Liga,26,1994,25.4,42,28,20,19,3,18,59,30.5,41,31,3,28,13,55,22,0,0,2021-2022,0.5118110236220472,1.6535433070866143
2031,Nicolas Pallois,FRA,DF,Nantes,Ligue 1,33,1987,27.2,51,33,40,11,0,34,59,57.6,25,40,19,21,53,104,116,1,0,2021-2022,1.9485294117647058,1.875
2032,Cole Palmer,ENG,"FW,MF",Manchester City,Premier League,19,2002,1.4,2,1,1,1,0,0,2,0.0,2,3,0,3,1,3,0,0,0,2021-2022,0.7142857142857143,1.4285714285714286
2033,Erik Palmer-Brown,USA,DF,Troyes,Ligue 1,24,1997,19.3,37,22,29,8,0,20,26,76.9,6,26,18,8,34,71,87,1,0,2021-2022,1.761658031088083,1.9170984455958548
2034,Emerson Palmieri,ITA,DF,Chelsea,Premier League,26,1994,0.1,0,0,0,0,0,0,0,0.0,0,0,0,0,0,0,0,0,0,2021-2022,0.0,0.0
2035,Emerson Palmieri,ITA,DF,Lyon,Ligue 1,26,1994,25.2,46,25,16,22,8,22,34,64.7,12,23,8,15,27,73,66,0,0,2021-2022,1.0714285714285714,1.8253968253968254
2036,Martin Palumbo,NOR,FW,Juventus,Serie A,19,2002,0.1,0,0,0,0,0,0,1,0.0,1,0,0,0,0,0,0,0,0,2021-2022,0.0,0.0
2037,Goran Pandev,MKD,"FW,MF",Genoa,Serie A,38,1983,9.4,2,0,1,0,1,0,9,0.0,9,3,1,2,2,4,0,0,0,2021-2022,0.2127659574468085,0.2127659574468085
2038,Ivor Pandur,CRO,GK,Hellas Verona,Serie A,21,2000,3.0,0,0,0,0,0,0,0,0.0,0,0,0,0,0,0,2,0,0,2021-2022,0.0,0.0
2039,Miloš Pantović,SRB,"MF,FW",Bochum,Bundesliga,25,1996,17.0,19,10,8,7,4,6,25,24.0,19,26,4,22,18,37,14,0,0,2021-2022,1.0588235294117647,1.1176470588235294
2040,Antonios Papadopoulos,GER,"DF,MF",Dortmund,Bundesliga,21,1999,0.2,0,0,0,0,0,0,0,0.0,0,1,0,1,0,0,0,0,0,2021-2022,0.0,0.0
2041,Merveille Papela,GER,MF,Mainz 05,Bundesliga,20,2001,0.9,3,2,2,1,0,2,3,66.7,1,2,0,2,2,5,0,0,0,2021-2022,2.2222222222222223,3.333333333333333
2042,Lucas Paquetá,BRA,"MF,FW",Lyon,Ligue 1,23,1997,30.0,68,38,24,26,18,17,51,33.3,34,43,5,38,9,77,22,0,0,2021-2022,0.3,2.2666666666666666
2043,Rubén Pardo,ESP,MF,Bordeaux,Ligue 1,28,1992,0.1,0,0,0,0,0,0,0,0.0,0,0,0,0,0,0,0,0,0,2021-2022,0.0,0.0
2044,Kevin Paredes,USA,"FW,DF",Wolfsburg,Bundesliga,18,2003,0.2,1,0,0,0,1,0,0,0.0,0,1,0,1,0,1,0,0,0,2021-2022,0.0,5.0
2045,Leandro Paredes,ARG,MF,Paris S-G,Ligue 1,27,1994,9.3,23,13,9,11,3,12,24,50.0,12,10,6,4,10,33,5,2,0,2021-2022,1.075268817204301,2.4731182795698925
2046,Daniel Parejo,ESP,MF,Villarreal,La Liga,32,1989,30.0,43,29,15,15,13,20,52,38.5,32,32,7,25,29,72,19,1,0,2021-2022,0.9666666666666667,1.4333333333333333
2047,Fabiano Parisi,ITA,DF,Empoli,Serie A,20,2000,16.4,35,19,25,5,5,13,31,41.9,18,30,10,20,22,57,42,0,0,2021-2022,1.3414634146341464,2.1341463414634148
2048,Raúl Parra,ESP,DF,Cádiz,La Liga,21,1999,1.0,2,1,2,0,0,1,3,33.3,2,0,0,0,0,2,5,0,0,2021-2022,0.0,2.0
2049,Thomas Partey,GHA,MF,Arsenal,Premier League,28,1993,22.5,43,29,22,17,4,18,44,40.9,26,22,4,18,23,66,35,2,0,2021-2022,1.0222222222222221,1.9111111111111112
2050,Mario Pašalić,CRO,"MF,FW",Atalanta,Serie A,26,1995,22.2,27,12,8,13,6,12,30,40.0,18,27,6,21,20,47,14,0,0,2021-2022,0.9009009009009009,1.2162162162162162
Rk,Player,Nation,Pos,Squad,Comp,0,0,90.0,0,0,3,3,3,Tkl,0,0.0,0,0,0,0,0,0,0,0,0,2021-2022,0.0,0.0
2051,Felix Passlack,GER,DF,Dortmund,Bundesliga,23,1998,5.2,13,9,8,4,1,6,12,50.0,6,5,1,4,4,17,7,0,0,2021-2022,0.7692307692307692,2.5
2052,Javier Pastore,ARG,"MF,FW",Elche,La Liga,32,1989,5.8,7,3,3,2,2,3,12,25.0,9,5,1,4,4,11,2,0,0,2021-2022,0.6896551724137931,1.206896551724138
2053,Patric,ESP,DF,Lazio,Serie A,28,1993,18.3,21,15,17,4,0,9,20,45.0,11,22,11,11,12,33,44,2,0,2021-2022,0.6557377049180327,1.1475409836065573
2054,Rui Patrício,POR,GK,Roma,Serie A,33,1988,38.0,0,0,0,0,0,0,0,0.0,0,1,0,1,0,0,10,3,0,2021-2022,0.0,0.0
2055,Paulinho,BRA,"FW,MF",Leverkusen,Bundesliga,21,2000,13.5,22,13,6,13,3,13,27,48.1,14,14,1,13,6,28,7,0,0,2021-2022,0.4444444444444444,1.6296296296296295
2056,Gabriel Paulista,BRA,DF,Valencia,La Liga,30,1990,17.7,21,12,16,5,0,14,20,70.0,6,18,12,6,39,60,88,0,0,2021-2022,2.2033898305084745,1.1864406779661016
2057,Benjamin Pavard,FRA,DF,Bayern Munich,Bundesliga,25,1996,23.1,35,20,21,13,1,19,29,65.5,10,28,16,12,36,71,50,1,0,2021-2022,1.5584415584415583,1.5151515151515151
2058,Strahinja Pavlović,SRB,DF,Monaco,Ligue 1,20,2001,5.0,23,16,8,13,2,8,12,66.7,4,5,3,2,9,32,15,0,0,2021-2022,1.8,4.6
2059,Leonardo Pavoletti,ITA,FW,Cagliari,Serie A,32,1988,16.9,10,6,2,5,3,3,9,33.3,6,9,5,4,2,12,12,0,0,2021-2022,0.1183431952662722,0.591715976331361
2060,Dimitri Payet,FRA,"FW,MF",Marseille,Ligue 1,34,1987,28.8,16,8,4,10,2,7,31,22.6,24,9,0,9,9,25,3,0,0,2021-2022,0.3125,0.5555555555555556
2061,Mads Pedersen,DEN,"MF,DF",Augsburg,Bundesliga,24,1996,15.5,28,21,8,15,5,12,27,44.4,15,13,4,9,15,43,30,0,0,2021-2022,0.967741935483871,1.8064516129032258
2062,Alfonso Pedraza,ESP,DF,Villarreal,La Liga,25,1996,18.9,34,16,17,12,5,10,28,35.7,18,12,3,9,31,65,32,0,0,2021-2022,1.6402116402116402,1.798941798941799
2063,Pedri,ESP,MF,Barcelona,La Liga,18,2002,9.8,20,12,9,8,3,7,20,35.0,13,13,0,13,5,25,7,1,0,2021-2022,0.5102040816326531,2.0408163265306123
2064,Pedro,ESP,FW,Lazio,Serie A,34,1987,22.6,36,23,8,19,9,16,47,34.0,31,18,2,16,6,42,8,0,0,2021-2022,0.2654867256637168,1.5929203539823007
2065,João Pedro,ITA,FW,Cagliari,Serie A,29,1992,36.9,15,12,2,8,5,4,18,22.2,14,23,5,18,8,23,18,1,0,2021-2022,0.21680216802168023,0.4065040650406504
2066,Adrià Pedrosa,ESP,DF,Espanyol,La Liga,23,1998,30.2,58,30,38,14,6,26,57,45.6,31,25,7,18,25,83,92,2,0,2021-2022,0.8278145695364238,1.9205298013245033
2067,Gianluca Pegolo,ITA,GK,Sassuolo,Serie A,40,1981,1.0,0,0,0,0,0,0,0,0.0,0,0,0,0,0,0,0,1,0,2021-2022,0.0,0.0
2068,Peter Pekarík,SVK,DF,Hertha BSC,Bundesliga,34,1986,24.8,45,29,33,11,1,32,46,69.6,14,28,10,18,29,74,58,0,0,2021-2022,1.1693548387096775,1.814516129032258
2069,Pietro Pellegri,ITA,FW,Torino,Serie A,20,2001,2.4,1,1,0,1,0,0,4,0.0,4,0,0,0,0,1,5,0,0,2021-2022,0.0,0.4166666666666667
2070,Pietro Pellegri,ITA,FW,Milan,Serie A,20,2001,1.5,2,2,0,1,1,0,1,0.0,1,0,0,0,0,2,1,0,0,2021-2022,0.0,1.3333333333333333
2071,Lorenzo Pellegrini,ITA,MF,Roma,Serie A,25,1996,25.4,35,14,10,17,8,16,60,26.7,44,29,1,28,27,62,20,0,0,2021-2022,1.062992125984252,1.3779527559055118
2072,Luca Pellegrini,ITA,DF,Juventus,Serie A,22,1999,12.3,23,10,13,5,5,12,19,63.2,7,9,1,8,5,28,23,0,0,2021-2022,0.4065040650406504,1.8699186991869918
2073,Facundo Pellistri,URU,"MF,FW",Alavés,La Liga,19,2001,7.5,9,5,4,3,2,1,10,10.0,9,13,2,11,6,15,7,0,0,2021-2022,0.8,1.2
2074,Federico Peluso,ITA,DF,Sassuolo,Serie A,37,1984,0.1,1,1,0,1,0,1,1,100.0,0,0,0,0,0,1,0,0,0,2021-2022,0.0,10.0
2075,Timothee Pembele,FRA,DF,Bordeaux,Ligue 1,18,2002,15.7,20,8,8,10,2,10,29,34.5,19,12,3,9,16,36,24,0,0,2021-2022,1.019108280254777,1.2738853503184715
Rk,Player,Nation,Pos,Squad,Comp,0,0,90.0,0,0,3,3,3,Tkl,0,0.0,0,0,0,0,0,0,0,0,0,2021-2022,0.0,0.0
2076,Rubén Peña,ESP,"MF,FW",Villarreal,La Liga,30,1991,1.5,2,0,1,1,0,2,6,33.3,4,1,0,1,5,7,2,0,0,2021-2022,3.3333333333333335,1.3333333333333333
2077,Philipp Pentke,GER,GK,Hoffenheim,Bundesliga,36,1985,1.0,0,0,0,0,0,0,0,0.0,0,0,0,0,0,0,0,0,0,2021-2022,0.0,0.0
2078,Nicolas Pépé,CIV,"FW,MF",Arsenal,Premier League,26,1995,7.7,8,5,3,5,0,3,9,33.3,6,9,1,8,8,16,2,0,0,2021-2022,1.0389610389610389,1.0389610389610389
2079,Ricardo Pepi,USA,"FW,MF",Augsburg,Bundesliga,18,2003,5.3,4,2,1,3,0,1,8,12.5,7,7,0,7,3,7,8,0,0,2021-2022,0.5660377358490566,0.7547169811320755
2080,Alberto Perea,ESP,MF,Cádiz,La Liga,30,1990,8.6,19,9,7,9,3,6,20,30.0,14,15,1,14,9,28,4,0,0,2021-2022,1.0465116279069768,2.2093023255813953
2081,Brayann Pereira,FRA,"DF,MF",Lens,Ligue 1,18,2003,0.2,1,1,1,0,0,1,1,100.0,0,0,0,0,0,1,1,0,0,2021-2022,0.0,5.0
2082,Danilo Pereira,POR,MF,Paris S-G,Ligue 1,29,1991,22.6,33,17,10,20,3,14,28,50.0,14,19,10,9,37,70,29,1,0,2021-2022,1.6371681415929202,1.4601769911504423
2083,Mathias Pereira Lage,POR,DF,Angers,Ligue 1,24,1996,11.6,21,7,10,7,4,8,30,26.7,22,18,7,11,21,42,22,0,0,2021-2022,1.8103448275862069,1.8103448275862069
2084,Ricardo Pereira,POR,DF,Leicester City,Premier League,27,1993,11.0,37,20,19,13,5,21,40,52.5,19,13,1,12,17,54,39,0,0,2021-2022,1.5454545454545454,3.3636363636363638
2085,Gastón Pereiro,URU,"FW,MF",Cagliari,Serie A,26,1995,10.8,13,5,7,4,2,5,18,27.8,13,12,1,11,1,14,8,0,0,2021-2022,0.09259259259259259,1.2037037037037037
2086,Luan Peres Petroni,BRA,DF,Marseille,Ligue 1,27,1994,29.8,65,35,33,25,7,36,52,69.2,16,26,12,14,43,108,64,1,0,2021-2022,1.4429530201342282,2.1812080536912752
2087,Dor Peretz,ISR,MF,Venezia,Serie A,26,1995,6.5,27,18,8,16,3,13,25,52.0,12,8,4,4,8,35,11,0,0,2021-2022,1.2307692307692308,4.153846153846154
2088,Roberto Pereyra,ARG,"MF,FW",Udinese,Serie A,30,1991,19.9,18,12,7,6,5,7,23,30.4,16,26,5,21,12,30,11,0,0,2021-2022,0.6030150753768845,0.9045226130653267
2089,Ayoze Pérez,ESP,"MF,FW",Leicester City,Premier League,28,1993,4.9,4,2,0,3,1,0,13,0.0,13,11,1,10,2,6,5,0,0,2021-2022,0.4081632653061224,0.8163265306122448
2090,Carles Pérez,ESP,"MF,FW",Roma,Serie A,23,1998,6.2,8,3,3,1,4,3,12,25.0,9,10,0,10,2,10,2,0,0,2021-2022,0.3225806451612903,1.2903225806451613
2091,Iñigo Pérez,ESP,MF,Osasuna,La Liga,33,1988,3.8,3,2,2,1,0,2,4,50.0,2,1,0,1,0,3,3,0,0,2021-2022,0.0,0.7894736842105263
2092,Juan Pérez,ESP,GK,Osasuna,La Liga,25,1996,2.0,0,0,0,0,0,0,1,0.0,1,0,0,0,0,0,1,1,0,2021-2022,0.0,0.0
2093,Kike Pérez,ESP,"MF,FW",Elche,La Liga,24,1997,5.8,8,6,1,3,4,0,10,0.0,10,6,1,5,3,11,4,0,0,2021-2022,0.5172413793103449,1.3793103448275863
2094,Lucas Pérez,ESP,FW,Elche,La Liga,32,1988,14.1,4,1,2,1,1,3,10,30.0,7,2,0,2,3,7,4,0,0,2021-2022,0.2127659574468085,0.28368794326241137
2095,Lucas Pérez,ESP,"FW,MF",Cádiz,La Liga,32,1988,11.8,3,3,2,1,0,0,10,0.0,10,3,1,2,0,3,1,0,0,2021-2022,0.0,0.2542372881355932
2096,Nehuén Pérez,ARG,DF,Udinese,Serie A,21,2000,18.8,44,21,21,21,2,16,25,64.0,9,27,9,18,21,65,47,0,0,2021-2022,1.1170212765957446,2.3404255319148937
2097,Mattia Perin,ITA,GK,Juventus,Serie A,28,1992,4.5,0,0,0,0,0,0,0,0.0,0,0,0,0,0,0,3,0,0,2021-2022,0.0,0.0
2098,Ivan Perišić,CRO,DF,Inter,Serie A,32,1989,31.3,38,22,18,11,9,28,50,56.0,22,39,7,32,47,85,42,0,0,2021-2022,1.5015974440894568,1.2140575079872205
2099,Sonny Perkins,ENG,MF,West Ham,Premier League,17,2004,0.0,0,0,0,0,0,0,0,0.0,0,0,0,0,0,0,0,0,0,2021-2022,,
2100,Diego Perotti,ARG,"MF,FW",Salernitana,Serie A,33,1988,3.2,11,5,7,1,3,4,13,30.8,9,1,0,1,2,13,6,0,0,2021-2022,0.625,3.4375
Rk,Player,Nation,Pos,Squad,Comp,0,0,90.0,0,0,3,3,3,Tkl,0,0.0,0,0,0,0,0,0,0,0,0,2021-2022,0.0,0.0
2101,Romain Perraud,FRA,DF,Southampton,Premier League,23,1997,18.0,34,22,18,14,2,16,29,55.2,13,24,6,18,17,51,42,0,0,2021-2022,0.9444444444444444,1.8888888888888888
2102,Lucas Perrin,FRA,DF,Strasbourg,Ligue 1,22,1998,27.8,43,32,24,17,2,26,45,57.8,19,28,11,17,42,85,67,0,0,2021-2022,1.5107913669064748,1.5467625899280575
2103,Mario Perrone,ITA,DF,Salernitana,Serie A,18,2003,0.2,0,0,0,0,0,0,0,0.0,0,0,0,0,0,0,0,0,0,2021-2022,0.0,0.0
2104,Pavao Pervan,AUT,GK,Wolfsburg,Bundesliga,33,1987,6.0,0,0,0,0,0,0,0,0.0,0,0,0,0,0,0,3,0,0,2021-2022,0.0,0.0
2105,Matteo Pessina,ITA,"MF,FW",Atalanta,Serie A,24,1997,16.0,27,14,10,11,6,14,33,42.4,19,22,3,19,13,40,7,0,0,2021-2022,0.8125,1.6875
2106,Andrea Petagna,ITA,FW,Napoli,Serie A,26,1995,6.5,3,3,0,3,0,1,4,25.0,3,1,0,1,0,3,5,0,0,2021-2022,0.0,0.46153846153846156
2107,Nils Petersen,GER,FW,Freiburg,Bundesliga,32,1988,6.4,5,3,2,3,0,1,13,7.7,12,7,0,7,2,7,17,0,0,2021-2022,0.3125,0.78125
2108,Danijel Petković,MNE,GK,Angers,Ligue 1,28,1993,15.0,0,0,0,0,0,0,1,0.0,1,0,0,0,1,1,9,5,0,2021-2022,0.06666666666666667,0.0
2109,Léo Pétrot,FRA,DF,Lorient,Ligue 1,24,1997,20.2,31,17,23,8,0,21,29,72.4,8,33,17,16,22,53,86,0,0,2021-2022,1.0891089108910892,1.5346534653465347
2110,Njegoš Petrović,SRB,MF,Granada,La Liga,22,1999,10.2,24,11,4,19,1,8,14,57.1,6,16,4,12,9,33,11,0,0,2021-2022,0.8823529411764707,2.3529411764705883
2111,Jens Petter Hauge,NOR,"MF,FW",Eint Frankfurt,Bundesliga,21,1999,11.6,14,5,6,7,1,7,23,30.4,16,7,0,7,3,17,5,0,0,2021-2022,0.25862068965517243,1.206896551724138
2112,Alex Petxa,ESP,"DF,MF",Athletic Club,La Liga,24,1997,4.6,12,9,4,7,1,4,8,50.0,4,8,2,6,4,16,6,0,0,2021-2022,0.8695652173913044,2.608695652173913
2113,Germán Pezzella,ARG,DF,Betis,La Liga,30,1991,22.1,21,9,16,5,0,16,29,55.2,13,29,18,11,39,60,106,0,0,2021-2022,1.7647058823529411,0.9502262443438914
2114,Giuseppe Pezzella,ITA,"DF,MF",Atalanta,Serie A,23,1997,11.9,28,13,15,7,6,8,18,44.4,10,13,5,8,9,37,16,0,0,2021-2022,0.7563025210084033,2.3529411764705883
2115,Immanuel Pherai,SUR,MF,Dortmund,Bundesliga,20,2001,0.0,0,0,0,0,0,0,0,0.0,0,0,0,0,0,0,0,0,0,2021-2022,,
2116,Maximilian Philipp,GER,MF,Wolfsburg,Bundesliga,27,1994,10.7,15,11,6,7,2,5,21,23.8,16,12,1,11,4,19,5,0,0,2021-2022,0.3738317757009346,1.4018691588785048
2117,Romain Philippoteaux,FRA,MF,Brest,Ligue 1,33,1988,0.3,1,1,0,1,0,0,0,0.0,0,0,0,0,0,1,0,0,0,2021-2022,0.0,3.3333333333333335
2118,Kalvin Phillips,ENG,MF,Leeds United,Premier League,25,1995,17.7,54,25,24,25,5,24,57,42.1,33,37,9,28,24,78,18,0,0,2021-2022,1.3559322033898307,3.050847457627119
2119,Jaden Philogene Bidace,ENG,FW,Aston Villa,Premier League,19,2002,0.1,0,0,0,0,0,0,0,0.0,0,0,0,0,0,0,0,0,0,2021-2022,0.0,0.0
2120,Jérôme Phojo,FRA,DF,Clermont Foot,Ligue 1,28,1993,0.1,0,0,0,0,0,0,0,0.0,0,0,0,0,0,0,1,0,0,2021-2022,0.0,0.0
2121,Krzysztof Piątek,POL,FW,Fiorentina,Serie A,26,1995,8.1,5,4,1,1,3,2,3,66.7,1,6,0,6,2,7,8,0,0,2021-2022,0.2469135802469136,0.617283950617284
2122,Krzysztof Piątek,POL,FW,Hertha BSC,Bundesliga,26,1995,3.9,2,2,0,1,1,0,1,0.0,1,0,0,0,0,2,6,0,0,2021-2022,0.0,0.5128205128205129
2123,Pablo Piatti,ARG,"MF,FW",Elche,La Liga,32,1989,3.5,9,4,5,3,1,3,8,37.5,5,5,1,4,2,11,3,0,0,2021-2022,0.5714285714285714,2.5714285714285716
2124,Cristiano Piccini,ITA,DF,Valencia,La Liga,28,1992,3.6,14,8,9,5,0,5,7,71.4,2,3,2,1,1,15,11,0,0,2021-2022,0.2777777777777778,3.888888888888889
2125,Roberto Piccoli,ITA,FW,Genoa,Serie A,20,2001,2.4,1,1,0,1,0,0,0,0.0,0,0,0,0,1,2,1,1,0,2021-2022,0.4166666666666667,0.4166666666666667
Rk,Player,Nation,Pos,Squad,Comp,0,0,90.0,0,0,3,3,3,Tkl,0,0.0,0,0,0,0,0,0,0,0,0,2021-2022,0.0,0.0
2126,Roberto Piccoli,ITA,FW,Atalanta,Serie A,20,2001,2.2,2,0,0,0,2,0,2,0.0,2,1,0,1,0,2,0,0,0,2021-2022,0.0,0.9090909090909091
2127,Jordan Pickford,ENG,GK,Everton,Premier League,27,1994,35.0,1,1,1,0,0,0,1,0.0,1,1,0,1,1,2,14,1,0,2021-2022,0.02857142857142857,0.02857142857142857
2128,Jérémy Pied,FRA,"DF,FW",Lille,Ligue 1,32,1989,0.1,0,0,0,0,0,0,0,0.0,0,0,0,0,1,1,0,0,0,2021-2022,10.0,0.0
2129,Amos Pieper,GER,DF,Arminia,Bundesliga,23,1998,26.4,58,29,38,19,1,32,51,62.7,19,37,23,14,50,108,132,1,0,2021-2022,1.893939393939394,2.1969696969696972
2130,Ronaël Pierre-Gabriel,FRA,DF,Brest,Ligue 1,23,1998,28.3,79,45,52,21,6,42,73,57.5,31,22,7,15,48,127,74,0,0,2021-2022,1.696113074204947,2.791519434628975
2131,Erik Pieters,NED,DF,Burnley,Premier League,32,1988,8.1,28,15,15,11,2,17,28,60.7,11,18,7,11,10,38,38,0,0,2021-2022,1.234567901234568,3.4567901234567904
2132,Tomás Pina Isla,ESP,MF,Alavés,La Liga,33,1987,16.0,28,16,13,11,4,14,29,48.3,15,12,3,9,22,50,23,0,0,2021-2022,1.375,1.75
2133,Andrea Pinamonti,ITA,FW,Empoli,Serie A,22,1999,31.9,11,6,0,7,4,2,18,11.1,16,24,3,21,7,18,23,0,0,2021-2022,0.219435736677116,0.3448275862068966
2134,Orbelín Pineda,MEX,"MF,FW",Celta Vigo,La Liga,25,1996,1.1,4,1,4,0,0,1,2,50.0,1,0,0,0,0,4,1,0,0,2021-2022,0.0,3.6363636363636362
2135,Ethan Pinnock,JAM,DF,Brentford,Premier League,28,1993,29.9,51,35,37,12,2,25,38,65.8,13,30,11,19,44,95,154,1,0,2021-2022,1.4715719063545152,1.705685618729097
2136,Yeremi Pino,ESP,"MF,FW",Villarreal,La Liga,18,2002,18.6,32,14,14,8,10,10,24,41.7,14,33,4,29,6,38,12,1,0,2021-2022,0.3225806451612903,1.7204301075268815
2137,Carlo Pinsoglio,ITA,GK,Juventus,Serie A,31,1990,0.5,0,0,0,0,0,0,0,0.0,0,0,0,0,0,0,0,0,0,2021-2022,0.0,0.0
2138,Riccardo Pinzi,ITA,FW,Udinese,Serie A,17,2003,0.0,0,0,0,0,0,0,0,0.0,0,0,0,0,0,0,0,0,0,2021-2022,,
2139,Gerard Piqué,ESP,DF,Barcelona,La Liga,34,1987,23.2,22,12,18,4,0,11,14,78.6,3,19,16,3,34,56,86,1,0,2021-2022,1.4655172413793105,0.9482758620689655
2140,Marko Pjaca,CRO,MF,Torino,Serie A,26,1995,12.8,7,4,1,4,2,3,8,37.5,5,10,2,8,4,11,2,0,0,2021-2022,0.3125,0.546875
2141,Marvin Plattenhardt,GER,DF,Hertha BSC,Bundesliga,29,1992,18.2,25,11,18,6,1,15,27,55.6,12,18,3,15,17,42,52,0,0,2021-2022,0.9340659340659341,1.3736263736263736
2142,Alassane Pléa,FRA,"MF,FW",Gladbach,Bundesliga,28,1993,23.0,18,14,6,9,3,7,20,35.0,13,9,1,8,4,22,9,0,0,2021-2022,0.17391304347826086,0.782608695652174
2143,Tommaso Pobega,ITA,MF,Torino,Serie A,22,1999,24.9,48,30,17,20,11,21,40,52.5,19,32,3,29,25,73,38,0,0,2021-2022,1.0040160642570282,1.9277108433734942
2144,Daniel Podence,POR,"FW,MF",Wolves,Premier League,25,1995,16.5,18,11,10,5,3,4,17,23.5,13,8,1,7,10,28,1,0,0,2021-2022,0.6060606060606061,1.0909090909090908
2145,Suf Podgoreanu,ISR,FW,Spezia,Serie A,19,2002,1.3,2,0,1,1,0,1,4,25.0,3,2,0,2,1,3,3,0,0,2021-2022,0.7692307692307692,1.5384615384615383
2146,Paul Pogba,FRA,"MF,FW",Manchester Utd,Premier League,28,1993,15.0,13,9,5,7,1,6,28,21.4,22,11,0,11,13,26,16,0,0,2021-2022,0.8666666666666667,0.8666666666666667
2147,Joel Pohjanpalo,FIN,FW,Leverkusen,Bundesliga,26,1994,0.1,0,0,0,0,0,0,0,0.0,0,0,0,0,0,0,0,0,0,2021-2022,0.0,0.0
2148,Matteo Politano,ITA,FW,Napoli,Serie A,27,1993,18.3,24,12,8,11,5,15,54,27.8,39,11,2,9,13,37,5,0,0,2021-2022,0.7103825136612022,1.3114754098360655
2149,Julian Pollersbeck,GER,GK,Lyon,Ligue 1,26,1994,4.8,0,0,0,0,0,0,0,0.0,0,0,0,0,1,1,1,0,0,2021-2022,0.20833333333333334,0.0
2150,Sebastian Polter,GER,FW,Bochum,Bundesliga,30,1991,26.0,9,3,1,4,4,2,11,18.2,9,15,5,10,2,11,24,0,0,2021-2022,0.07692307692307693,0.34615384615384615
Rk,Player,Nation,Pos,Squad,Comp,0,0,90.0,0,0,3,3,3,Tkl,0,0.0,0,0,0,0,0,0,0,0,0,2021-2022,0.0,0.0
2151,Ezequiel Ponce,ARG,FW,Elche,La Liga,24,1997,7.4,5,4,1,3,1,3,10,30.0,7,5,0,5,1,6,7,0,0,2021-2022,0.13513513513513511,0.6756756756756757
2152,Marin Pongračić,CRO,DF,Dortmund,Bundesliga,23,1997,9.2,17,10,13,4,0,6,10,60.0,4,11,5,6,17,34,32,2,0,2021-2022,1.847826086956522,1.847826086956522
2153,Pere Pons,ESP,MF,Alavés,La Liga,28,1993,15.2,26,18,4,20,2,7,21,33.3,14,10,1,9,6,32,11,0,0,2021-2022,0.39473684210526316,1.7105263157894737
2154,Nick Pope,ENG,GK,Burnley,Premier League,29,1992,36.0,0,0,0,0,0,0,2,0.0,2,0,0,0,2,2,30,3,0,2021-2022,0.05555555555555555,0.0
2155,Manolo Portanova,ITA,"FW,MF",Genoa,Serie A,21,2000,14.7,46,28,9,26,11,14,34,41.2,20,26,2,24,17,63,22,0,0,2021-2022,1.1564625850340136,3.1292517006802725
2156,Portu,ESP,"FW,MF",Real Sociedad,La Liga,29,1992,17.7,16,7,2,6,8,3,19,15.8,16,21,3,18,7,23,8,0,0,2021-2022,0.3954802259887006,0.903954802259887
2157,Stefan Posch,AUT,DF,Hoffenheim,Bundesliga,24,1997,24.4,48,30,20,26,2,22,39,56.4,17,43,18,25,28,76,71,2,0,2021-2022,1.1475409836065575,1.9672131147540985
2158,Sergio Postigo,ESP,DF,Levante,La Liga,32,1988,9.4,11,7,8,2,1,4,8,50.0,4,7,5,2,7,18,45,1,0,2021-2022,0.7446808510638298,1.1702127659574468
2159,Yussuf Poulsen,DEN,"FW,MF",RB Leipzig,Bundesliga,27,1994,12.0,13,4,3,6,4,3,13,23.1,10,13,0,13,3,16,9,0,0,2021-2022,0.25,1.0833333333333333
2160,Gaëtan Poussin,FRA,GK,Bordeaux,Ligue 1,22,1999,13.0,1,1,1,0,0,1,1,100.0,0,0,0,0,0,1,15,1,0,2021-2022,0.0,0.07692307692307693
2161,Darío Poveda,ESP,"FW,MF",Getafe,La Liga,24,1997,4.2,2,0,1,0,1,0,5,0.0,5,7,1,6,1,3,1,0,0,2021-2022,0.23809523809523808,0.47619047619047616
2162,José Pozo,ESP,"MF,DF",Rayo Vallecano,La Liga,25,1996,0.8,2,2,0,2,0,2,3,66.7,1,1,0,1,0,2,1,0,0,2021-2022,0.0,2.5
2163,Dennis Praet,BEL,MF,Torino,Serie A,27,1994,17.1,19,10,6,8,5,8,22,36.4,14,12,1,11,3,22,4,0,0,2021-2022,0.17543859649122806,1.111111111111111
2164,Mateusz Praszelik,POL,MF,Hellas Verona,Serie A,20,2000,0.3,0,0,0,0,0,0,0,0.0,0,0,0,0,0,0,0,0,0,2021-2022,0.0,0.0
2165,Abdón Prats,ESP,FW,Mallorca,La Liga,28,1992,7.1,2,2,1,0,1,1,5,20.0,4,5,0,5,1,3,6,0,0,2021-2022,0.14084507042253522,0.28169014084507044
2166,Sanjin Prcić,BIH,MF,Strasbourg,Ligue 1,27,1993,24.3,47,28,14,27,6,14,29,48.3,15,18,3,15,47,94,19,0,0,2021-2022,1.934156378600823,1.934156378600823
2167,Nicolas de Préville,FRA,"FW,MF",Metz,Ligue 1,30,1991,21.9,17,8,7,8,2,3,19,15.8,16,12,4,8,5,22,11,0,0,2021-2022,0.22831050228310504,0.7762557077625571
2168,Isaac Price,NIR,MF,Everton,Premier League,17,2003,0.2,0,0,0,0,0,0,0,0.0,0,1,0,1,0,0,0,0,0,2021-2022,0.0,0.0
2169,Manuel Prietl,AUT,MF,Arminia,Bundesliga,29,1991,23.6,59,26,23,31,5,23,60,38.3,37,28,3,25,39,98,33,0,0,2021-2022,1.6525423728813557,2.5
2170,Alejandro Primo,ESP,GK,Levante,La Liga,17,2004,1.0,0,0,0,0,0,0,0,0.0,0,0,0,0,0,0,0,0,0,2021-2022,0.0,0.0
2171,Grischa Prömel,GER,MF,Union Berlin,Bundesliga,26,1995,26.9,36,22,14,17,5,22,52,42.3,30,18,3,15,23,59,22,0,0,2021-2022,0.8550185873605949,1.338289962825279
2172,Nick Proschwitz,GER,FW,Hoffenheim,Bundesliga,34,1986,0.3,0,0,0,0,0,0,0,0.0,0,0,0,0,0,0,0,0,0,2021-2022,0.0,0.0
2173,Ivan Provedel,ITA,GK,Spezia,Serie A,27,1994,30.7,0,0,0,0,0,0,1,0.0,1,0,0,0,2,2,10,2,0,2021-2022,0.06514657980456026,0.0
2174,Javi Puado,ESP,"MF,FW",Espanyol,La Liga,23,1998,24.9,24,14,18,5,1,12,37,32.4,25,18,2,16,11,35,24,0,0,2021-2022,0.44176706827309237,0.9638554216867471
2175,Marc Pubill,ESP,"DF,MF",Levante,La Liga,18,2003,5.7,12,6,10,2,0,4,8,50.0,4,7,2,5,4,16,8,2,0,2021-2022,0.7017543859649122,2.1052631578947367
Rk,Player,Nation,Pos,Squad,Comp,0,0,90.0,0,0,3,3,3,Tkl,0,0.0,0,0,0,0,0,0,0,0,0,2021-2022,0.0,0.0
2176,Antonio Puertas,ESP,"MF,FW",Granada,La Liga,29,1992,25.1,34,20,18,12,4,17,44,38.6,27,33,3,30,11,45,36,0,0,2021-2022,0.43824701195219123,1.3545816733067728
2177,Riqui Puig,ESP,MF,Barcelona,La Liga,21,1999,5.4,6,3,2,4,0,2,14,14.3,12,5,0,5,3,9,0,0,0,2021-2022,0.5555555555555555,1.111111111111111
2178,Teemu Pukki,FIN,FW,Norwich City,Premier League,31,1990,36.1,23,11,2,14,7,6,29,20.7,23,21,1,20,4,27,3,0,0,2021-2022,0.11080332409972299,0.6371191135734072
2179,Erick Pulgar,CHI,MF,Fiorentina,Serie A,27,1994,3.8,6,6,4,2,0,4,9,44.4,5,5,1,4,5,11,2,1,0,2021-2022,1.3157894736842106,1.5789473684210527
2180,Christian Pulisic,USA,"MF,FW",Chelsea,Premier League,22,1998,14.3,10,7,6,3,1,3,17,17.6,14,12,0,12,5,15,10,0,0,2021-2022,0.34965034965034963,0.6993006993006993
2181,Afimico Pululu,FRA,"FW,MF",Greuther Fürth,Bundesliga,22,1999,0.8,1,0,1,0,0,1,2,50.0,1,1,0,1,0,1,0,0,0,2021-2022,0.0,1.25
2182,Ignacio Pussetto,ARG,"FW,MF",Udinese,Serie A,25,1995,13.4,17,9,2,9,6,2,10,20.0,8,18,2,16,4,21,13,0,0,2021-2022,0.29850746268656714,1.2686567164179103
2183,Niklas Pyyhtiä,FIN,MF,Bologna,Serie A,17,2003,0.2,0,0,0,0,0,0,1,0.0,1,0,0,0,0,0,0,0,0,2021-2022,0.0,0.0
2184,Przemysław Płacheta,POL,"FW,MF",Norwich City,Premier League,23,1998,5.6,4,3,3,1,0,2,7,28.6,5,3,1,2,2,6,5,1,0,2021-2022,0.35714285714285715,0.7142857142857143
2185,Yacine Qasmi,MAR,FW,Rayo Vallecano,La Liga,30,1991,0.0,0,0,0,0,0,0,0,0.0,0,0,0,0,0,0,0,0,0,2021-2022,,
2186,Fabio Quagliarella,ITA,FW,Sampdoria,Serie A,38,1983,18.5,6,2,2,2,2,2,15,13.3,13,14,1,13,3,9,12,0,0,2021-2022,0.16216216216216217,0.32432432432432434
2187,Quini,ESP,DF,Granada,La Liga,31,1989,25.6,73,34,48,21,4,42,79,53.2,37,28,10,18,36,109,62,0,0,2021-2022,1.40625,2.8515625
2188,Dani Raba,ESP,"MF,FW",Villarreal,La Liga,25,1995,1.0,1,0,0,1,0,1,2,50.0,1,2,0,2,0,1,2,0,0,2021-2022,0.0,1.0
2189,Dani Raba,ESP,"MF,FW",Granada,La Liga,25,1995,0.3,2,2,1,0,1,2,3,66.7,1,0,0,0,1,3,0,0,0,2021-2022,3.3333333333333335,6.666666666666667
2190,Adrien Rabiot,FRA,MF,Juventus,Serie A,26,1995,25.4,64,43,32,24,8,15,34,44.1,19,34,8,26,20,84,41,1,0,2021-2022,0.7874015748031497,2.5196850393700787
2191,Uroš Račić,SRB,MF,Valencia,La Liga,23,1998,13.4,32,18,9,19,4,12,33,36.4,21,16,6,10,16,48,21,0,0,2021-2022,1.1940298507462686,2.388059701492537
2192,Nemanja Radoja,SRB,MF,Levante,La Liga,28,1993,13.5,25,8,9,13,3,8,20,40.0,12,16,9,7,22,47,16,2,0,2021-2022,1.6296296296296295,1.8518518518518519
2193,Nemanja Radonjić,SRB,FW,Marseille,Ligue 1,25,1996,0.2,0,0,0,0,0,0,0,0.0,0,0,0,0,0,0,0,0,0,2021-2022,0.0,0.0
2194,Ivan Radovanović,SRB,"DF,MF",Salernitana,Serie A,32,1988,11.7,11,7,8,3,0,7,19,36.8,12,14,7,7,7,18,29,0,0,2021-2022,0.5982905982905983,0.9401709401709403
2195,Ionuț Radu,ROU,GK,Inter,Serie A,24,1997,1.0,0,0,0,0,0,0,0,0.0,0,0,0,0,0,0,0,1,0,2021-2022,0.0,0.0
2196,Ștefan Radu,ROU,DF,Lazio,Serie A,34,1986,6.2,9,6,3,6,0,5,9,55.6,4,7,2,5,5,14,15,0,0,2021-2022,0.8064516129032258,1.4516129032258065
2197,Boris Radunović,SRB,GK,Cagliari,Serie A,25,1996,3.0,0,0,0,0,0,0,0,0.0,0,0,0,0,0,0,0,0,0,2021-2022,0.0,0.0
2198,Sidney Raebiger,GER,MF,RB Leipzig,Bundesliga,16,2005,0.0,0,0,0,0,0,0,0,0.0,0,0,0,0,0,0,0,0,0,2021-2022,,
2199,Rafinha,BRA,MF,Real Sociedad,La Liga,28,1993,11.7,43,27,17,20,6,16,28,57.1,12,21,2,19,12,55,4,0,0,2021-2022,1.0256410256410258,3.6752136752136755
2200,Rafinha,BRA,"FW,MF",Paris S-G,Ligue 1,28,1993,2.4,14,8,3,9,2,7,11,63.6,4,3,0,3,4,18,0,0,0,2021-2022,1.6666666666666667,5.833333333333334
Rk,Player,Nation,Pos,Squad,Comp,0,0,90.0,0,0,3,3,3,Tkl,0,0.0,0,0,0,0,0,0,0,0,0,2021-2022,0.0,0.0
2201,Antonio Raillo,ESP,DF,Mallorca,La Liga,29,1991,17.0,16,7,10,4,2,5,6,83.3,1,17,14,3,18,34,81,0,0,2021-2022,1.0588235294117647,0.9411764705882353
2202,Antonio Raimondo,ITA,FW,Bologna,Serie A,17,2004,0.8,0,0,0,0,0,0,1,0.0,1,1,0,1,0,0,1,0,0,2021-2022,0.0,0.0
2203,Predrag Rajković,SRB,GK,Reims,Ligue 1,25,1995,38.0,2,2,2,0,0,2,3,66.7,1,1,0,1,1,3,21,1,0,2021-2022,0.02631578947368421,0.05263157894736842
2204,Jesurun Rak Sakyi,ENG,"FW,MF",Crystal Palace,Premier League,18,2002,0.9,0,0,0,0,0,0,1,0.0,1,3,0,3,1,1,0,0,0,2021-2022,1.1111111111111112,0.0
2205,Ivan Rakitić,CRO,MF,Sevilla,La Liga,33,1988,24.2,40,22,12,23,5,13,40,32.5,27,31,8,23,23,63,35,0,0,2021-2022,0.9504132231404959,1.6528925619834711
2206,Diant Ramaj,GER,GK,Eint Frankfurt,Bundesliga,19,2001,1.0,0,0,0,0,0,0,0,0.0,0,0,0,0,0,0,3,0,0,2021-2022,0.0,0.0
2207,Jonás Ramalho,ESP,DF,Osasuna,La Liga,28,1993,2.7,4,2,2,2,0,2,3,66.7,1,4,1,3,3,7,9,0,0,2021-2022,1.111111111111111,1.4814814814814814
2208,Adil Rami,FRA,DF,Troyes,Ligue 1,35,1985,13.0,10,9,6,4,0,7,8,87.5,1,17,9,8,16,26,43,0,0,2021-2022,1.2307692307692308,0.7692307692307693
2209,Sandro Ramírez,ESP,FW,Getafe,La Liga,26,1995,16.2,7,3,1,3,3,1,12,8.3,11,14,3,11,2,9,3,0,0,2021-2022,0.1234567901234568,0.4320987654320988
2210,Guilherme Ramos,POR,DF,Arminia,Bundesliga,23,1997,10.1,25,15,17,8,0,12,19,63.2,7,21,8,13,27,52,52,0,0,2021-2022,2.6732673267326734,2.4752475247524752
2211,Sergio Ramos,ESP,DF,Paris S-G,Ligue 1,35,1986,8.9,12,5,6,6,0,8,15,53.3,7,4,2,2,8,20,27,0,0,2021-2022,0.898876404494382,1.348314606741573
2212,Aaron Ramsdale,ENG,GK,Arsenal,Premier League,23,1998,34.0,2,1,2,0,0,1,2,50.0,1,0,0,0,0,2,26,3,0,2021-2022,0.0,0.058823529411764705
2213,Aaron Ramsey,WAL,MF,Juventus,Serie A,30,1990,1.1,0,0,0,0,0,0,0,0.0,0,0,0,0,1,1,0,0,0,2021-2022,0.9090909090909091,0.0
2214,Jacob Ramsey,ENG,MF,Aston Villa,Premier League,20,2001,27.4,67,44,31,28,8,30,69,43.5,39,36,7,29,24,91,28,0,0,2021-2022,0.8759124087591241,2.445255474452555
2215,Luca Ranieri,ITA,DF,Salernitana,Serie A,22,1999,23.4,38,21,23,11,4,19,33,57.6,14,18,8,10,22,60,67,0,0,2021-2022,0.9401709401709403,1.623931623931624
2216,Andrea Ranocchia,ITA,DF,Inter,Serie A,33,1988,3.8,8,4,5,1,2,1,3,33.3,2,4,3,1,4,12,16,0,0,2021-2022,1.0526315789473684,2.1052631578947367
2217,Raphinha,BRA,"FW,MF",Leeds United,Premier League,24,1996,32.4,51,29,25,14,12,22,71,31.0,49,43,0,43,29,80,28,1,0,2021-2022,0.8950617283950618,1.5740740740740742
2218,Tobias Raschl,GER,MF,Greuther Fürth,Bundesliga,21,2000,6.6,12,9,4,8,0,5,7,71.4,2,10,1,9,3,15,1,0,0,2021-2022,0.4545454545454546,1.8181818181818183
2219,Elba Rashani,KVX,"FW,MF",Clermont Foot,Ligue 1,28,1993,19.5,40,21,15,21,4,17,55,30.9,38,34,3,31,11,51,20,0,0,2021-2022,0.5641025641025641,2.051282051282051
2220,Marcus Rashford,ENG,"FW,MF",Manchester Utd,Premier League,23,1997,13.7,6,5,1,4,1,2,13,15.4,11,10,1,9,5,11,5,1,0,2021-2022,0.36496350364963503,0.43795620437956206
2221,Milot Rashica,KVX,"FW,MF",Norwich City,Premier League,25,1996,24.8,31,19,12,12,7,11,30,36.7,19,22,3,19,15,46,23,0,0,2021-2022,0.6048387096774194,1.25
2222,Giacomo Raspadori,ITA,"MF,FW",Sassuolo,Serie A,21,2000,30.4,29,18,5,15,9,11,38,28.9,27,29,3,26,9,38,11,0,0,2021-2022,0.2960526315789474,0.9539473684210527
2223,Raúl,ESP,"FW,DF",Betis,La Liga,20,2000,0.0,0,0,0,0,0,0,0,0.0,0,0,0,0,0,0,0,0,0,2021-2022,,
2224,David Raum,GER,"DF,FW",Hoffenheim,Bundesliga,23,1998,30.6,52,29,30,10,12,30,64,46.9,34,38,5,33,27,79,39,1,0,2021-2022,0.8823529411764706,1.6993464052287581
2225,Nicola Ravaglia,ITA,GK,Sampdoria,Serie A,32,1988,0.1,0,0,0,0,0,0,0,0.0,0,0,0,0,0,0,0,0,0,2021-2022,0.0,0.0
Rk,Player,Nation,Pos,Squad,Comp,0,0,90.0,0,0,3,3,3,Tkl,0,0.0,0,0,0,0,0,0,0,0,0,2021-2022,0.0,0.0
2226,David Raya,ESP,GK,Brentford,Premier League,25,1995,24.0,0,0,0,0,0,0,0,0.0,0,1,0,1,0,0,10,1,0,2021-2022,0.0,0.0
2227,Ante Rebić,CRO,FW,Milan,Serie A,27,1993,9.9,14,8,3,6,5,7,20,35.0,13,14,0,14,3,17,3,1,0,2021-2022,0.30303030303030304,1.4141414141414141
2228,Arkadiusz Reca,POL,DF,Spezia,Serie A,26,1995,19.7,31,19,21,3,7,20,30,66.7,10,20,7,13,32,63,47,2,0,2021-2022,1.6243654822335025,1.5736040609137056
2229,Lluís Recasens,ESP,DF,Espanyol,La Liga,19,2002,0.5,2,0,2,0,0,1,1,100.0,0,0,0,0,2,4,2,0,0,2021-2022,4.0,4.0
2230,Nathan Redmond,ENG,"MF,FW",Southampton,Premier League,27,1994,20.4,22,14,9,9,4,7,30,23.3,23,21,2,19,8,30,16,0,0,2021-2022,0.3921568627450981,1.0784313725490198
2231,Sergio Reguilón,ESP,"DF,MF",Tottenham,Premier League,24,1996,21.3,40,24,15,18,7,22,43,51.2,21,20,8,12,31,71,45,1,0,2021-2022,1.4553990610328638,1.8779342723004695
2232,Manolo Reina,ESP,GK,Mallorca,La Liga,36,1985,21.0,0,0,0,0,0,0,0,0.0,0,0,0,0,1,1,6,2,0,2021-2022,0.047619047619047616,0.0
2233,Pepe Reina,ESP,GK,Lazio,Serie A,38,1982,15.0,0,0,0,0,0,0,1,0.0,1,0,0,0,0,0,1,1,0,2021-2022,0.0,0.0
2234,Jeff Reine-Adélaïde,FRA,"MF,DF",Lyon,Ligue 1,23,1998,2.2,5,3,4,1,0,4,5,80.0,1,2,0,2,0,5,0,1,0,2021-2022,0.0,2.2727272727272725
2235,Reinier,BRA,"FW,MF",Dortmund,Bundesliga,19,2002,1.8,5,3,4,0,1,1,1,100.0,0,3,0,3,0,5,0,0,0,2021-2022,0.0,2.7777777777777777
2236,Karim Rekik,NED,DF,Sevilla,La Liga,26,1994,12.2,11,8,4,6,1,2,9,22.2,7,11,6,5,9,20,19,0,0,2021-2022,0.7377049180327869,0.9016393442622951
2237,Álex Remiro,ESP,GK,Real Sociedad,La Liga,26,1995,35.0,0,0,0,0,0,0,0,0.0,0,0,0,0,1,1,24,2,0,2021-2022,0.02857142857142857,0.0
2238,Panagiotis Retsos,GRE,DF,Hellas Verona,Serie A,22,1998,0.6,0,0,0,0,0,0,2,0.0,2,0,0,0,2,2,3,0,0,2021-2022,3.3333333333333335,0.0
2239,Panagiotis Retsos,GRE,"DF,FW",Leverkusen,Bundesliga,22,1998,0.4,0,0,0,0,0,0,0,0.0,0,0,0,0,1,1,0,1,0,2021-2022,2.5,0.0
2240,Marco Reus,GER,"MF,FW",Dortmund,Bundesliga,32,1989,27.8,45,30,13,21,11,16,42,38.1,26,23,6,17,12,57,41,1,0,2021-2022,0.4316546762589928,1.618705035971223
2241,Elvis Rexhbeçaj,GER,MF,Bochum,Bundesliga,23,1997,28.2,41,20,17,19,5,19,40,47.5,21,41,6,35,27,68,15,0,0,2021-2022,0.9574468085106383,1.4539007092198581
2242,Gio Reyna,USA,MF,Dortmund,Bundesliga,18,2002,4.9,7,4,2,4,1,3,9,33.3,6,6,0,6,1,8,3,0,0,2021-2022,0.2040816326530612,1.4285714285714284
2243,Bryan Reynolds,USA,DF,Roma,Serie A,20,2001,0.0,0,0,0,0,0,0,1,0.0,1,0,0,0,0,0,1,0,0,2021-2022,,
2244,Nico Ribaudo,ESP,"MF,FW",Espanyol,La Liga,20,2001,12.4,15,6,9,5,1,11,34,32.4,23,14,2,12,7,22,3,0,0,2021-2022,0.564516129032258,1.2096774193548387
2245,Tiago Ribeiro,POR,FW,Monaco,Ligue 1,19,2002,0.0,0,0,0,0,0,0,0,0.0,0,0,0,0,0,0,0,0,0,2021-2022,,
2246,Franck Ribéry,FRA,"MF,FW",Salernitana,Serie A,38,1983,15.8,17,10,6,6,5,8,13,61.5,5,12,0,12,3,20,1,0,0,2021-2022,0.18987341772151897,1.0759493670886076
2247,Samuele Ricci,ITA,MF,Torino,Serie A,19,2001,8.0,8,4,4,2,2,2,5,40.0,3,7,1,6,14,22,9,0,0,2021-2022,1.75,1.0
2248,Samuele Ricci,ITA,MF,Empoli,Serie A,19,2001,17.0,33,19,17,13,3,20,34,58.8,14,24,5,19,31,64,18,0,0,2021-2022,1.8235294117647058,1.9411764705882353
2249,Declan Rice,ENG,MF,West Ham,Premier League,22,1999,35.3,80,42,45,32,3,38,71,53.5,33,45,21,24,63,143,52,1,0,2021-2022,1.784702549575071,2.26628895184136
2250,Chris Richards,USA,DF,Hoffenheim,Bundesliga,21,2000,14.5,26,15,10,15,1,11,18,61.1,7,21,9,12,22,48,50,1,0,2021-2022,1.5172413793103448,1.793103448275862
Rk,Player,Nation,Pos,Squad,Comp,0,0,90.0,0,0,3,3,3,Tkl,0,0.0,0,0,0,0,0,0,0,0,0,2021-2022,0.0,0.0
2251,Chris Richards,USA,DF,Bayern Munich,Bundesliga,21,2000,0.0,0,0,0,0,0,0,0,0.0,0,1,0,1,0,0,0,0,0,2021-2022,,
2252,Omar Richards,ENG,DF,Bayern Munich,Bundesliga,23,1998,4.9,19,12,11,5,3,11,16,68.8,5,7,1,6,4,23,7,0,0,2021-2022,0.8163265306122448,3.877551020408163
2253,Taylor Richards,ENG,MF,Brighton,Premier League,20,2000,0.3,1,0,0,1,0,1,2,50.0,1,0,0,0,0,1,0,0,0,2021-2022,0.0,3.3333333333333335
2254,Richarlison,BRA,FW,Everton,Premier League,24,1997,28.0,40,23,18,15,7,15,31,48.4,16,42,4,38,12,52,34,0,0,2021-2022,0.42857142857142855,1.4285714285714286
2255,Marco Richter,GER,"FW,MF",Hertha BSC,Bundesliga,23,1997,18.9,30,16,14,10,6,13,36,36.1,23,30,4,26,16,46,24,0,0,2021-2022,0.8465608465608466,1.5873015873015874
2256,Diego Rico,ESP,DF,Real Sociedad,La Liga,28,1993,18.3,41,20,19,17,5,22,45,48.9,23,29,4,25,30,71,54,0,0,2021-2022,1.639344262295082,2.240437158469945
2257,Sergio Rico,ESP,GK,Mallorca,La Liga,27,1993,14.0,0,0,0,0,0,0,0,0.0,0,0,0,0,0,0,5,2,0,2021-2022,0.0,0.0
2258,Sergio Rico,ESP,GK,Paris S-G,Ligue 1,27,1993,0.3,0,0,0,0,0,0,0,0.0,0,0,0,0,0,0,1,0,0,2021-2022,0.0,0.0
2259,Jaïro Riedewald,NED,MF,Crystal Palace,Premier League,24,1996,1.3,1,1,0,1,0,1,2,50.0,1,1,0,1,1,2,2,0,0,2021-2022,0.7692307692307692,0.7692307692307692
2260,Manuel Riemann,GER,GK,Bochum,Bundesliga,32,1988,31.0,1,0,1,0,0,1,4,25.0,3,0,0,0,1,2,12,3,0,2021-2022,0.03225806451612903,0.03225806451612903
2261,Tomás Rincón,VEN,MF,Torino,Serie A,33,1988,1.8,2,2,2,0,0,0,3,0.0,3,3,1,2,2,4,4,0,0,2021-2022,1.1111111111111112,1.1111111111111112
2262,Tomás Rincón,VEN,MF,Sampdoria,Serie A,33,1988,13.0,22,13,9,10,3,13,34,38.2,21,15,2,13,18,40,11,0,0,2021-2022,1.3846153846153846,1.6923076923076923
2263,Luis Rioja,ESP,"MF,FW",Alavés,La Liga,27,1993,34.6,28,15,11,10,7,14,58,24.1,44,22,1,21,25,53,20,0,0,2021-2022,0.722543352601156,0.8092485549132947
2264,Renaud Ripart,FRA,"MF,FW",Troyes,Ligue 1,28,1993,21.0,38,21,18,15,5,18,50,36.0,32,21,1,20,19,57,21,1,0,2021-2022,0.9047619047619048,1.8095238095238095
2265,Mihailo Ristić,SRB,DF,Montpellier,Ligue 1,25,1995,20.0,44,32,26,16,2,25,43,58.1,18,16,6,10,17,61,48,0,0,2021-2022,0.85,2.2
2266,Matt Ritchie,SCO,DF,Newcastle Utd,Premier League,31,1989,14.9,22,15,10,10,2,10,27,37.0,17,10,2,8,13,35,26,0,0,2021-2022,0.87248322147651,1.4765100671140938
2267,Maxence Rivera,FRA,FW,Saint-Étienne,Ligue 1,19,2002,0.1,0,0,0,0,0,0,0,0.0,0,0,0,0,0,0,0,0,0,2021-2022,0.0,0.0
2268,Rober,ESP,DF,Levante,La Liga,26,1995,22.3,36,20,27,7,2,23,39,59.0,16,25,15,10,30,66,90,1,0,2021-2022,1.3452914798206277,1.6143497757847534
2269,Sergi Roberto,ESP,"MF,DF",Barcelona,La Liga,29,1992,4.4,5,1,2,3,0,3,5,60.0,2,2,0,2,4,9,6,0,0,2021-2022,0.9090909090909091,1.1363636363636362
2270,Connor Roberts,WAL,DF,Burnley,Premier League,25,1995,18.8,20,13,10,7,3,10,15,66.7,5,25,5,20,22,42,62,1,0,2021-2022,1.1702127659574468,1.0638297872340425
2271,Patrick Roberts,ENG,MF,Troyes,Ligue 1,24,1997,0.2,0,0,0,0,0,0,0,0.0,0,0,0,0,0,0,0,0,0,2021-2022,0.0,0.0
2272,Tyler Roberts,WAL,"MF,FW",Leeds United,Premier League,22,1999,11.0,16,7,6,7,3,9,16,56.3,7,11,1,10,5,21,11,0,0,2021-2022,0.45454545454545453,1.4545454545454546
2273,Andrew Robertson,SCO,DF,Liverpool,Premier League,27,1994,28.2,36,21,16,15,5,20,35,57.1,15,24,3,21,23,59,61,0,0,2021-2022,0.8156028368794327,1.2765957446808511
2274,Marc Roca,ESP,MF,Bayern Munich,Bundesliga,24,1996,4.2,9,7,2,4,3,2,8,25.0,6,6,0,6,6,15,4,0,0,2021-2022,1.4285714285714286,2.142857142857143
2275,Rubén Rochina,ESP,"MF,FW",Granada,La Liga,30,1991,8.3,21,13,7,8,6,8,28,28.6,20,11,1,10,6,27,5,1,0,2021-2022,0.7228915662650601,2.5301204819277108
Rk,Player,Nation,Pos,Squad,Comp,0,0,90.0,0,0,3,3,3,Tkl,0,0.0,0,0,0,0,0,0,0,0,0,2021-2022,0.0,0.0
2276,Cimo Röcker,GER,DF,Hertha BSC,Bundesliga,27,1994,0.2,0,0,0,0,0,0,0,0.0,0,0,0,0,2,2,0,0,0,2021-2022,10.0,0.0
2277,Enzo Roco,CHI,DF,Elche,La Liga,28,1992,28.4,36,20,24,11,1,15,24,62.5,9,38,27,11,28,64,110,3,0,2021-2022,0.9859154929577465,1.267605633802817
2278,Stian Rode Gregersen,NOR,DF,Bordeaux,Ligue 1,26,1995,21.7,39,26,23,12,4,18,33,54.5,15,26,16,10,38,77,103,2,0,2021-2022,1.7511520737327189,1.7972350230414746
2279,Sebastian Rode,GER,MF,Eint Frankfurt,Bundesliga,30,1990,8.4,15,7,5,8,2,5,17,29.4,12,11,1,10,13,28,8,0,0,2021-2022,1.5476190476190474,1.7857142857142856
2280,Joe Rodon,WAL,DF,Tottenham,Premier League,23,1997,1.0,0,0,0,0,0,0,0,0.0,0,2,1,1,0,0,7,0,0,2021-2022,0.0,0.0
2281,Rodri,ESP,MF,Manchester City,Premier League,25,1996,32.0,72,43,24,38,10,32,59,54.2,27,28,5,23,28,100,45,0,0,2021-2022,0.875,2.25
2282,Rodri,ESP,FW,Betis,La Liga,21,2000,9.8,10,7,4,5,1,5,22,22.7,17,11,0,11,3,13,4,0,0,2021-2022,0.3061224489795918,1.0204081632653061
2283,Rodrigo,ESP,"MF,FW",Leeds United,Premier League,30,1991,25.2,20,9,7,6,7,4,32,12.5,28,12,0,12,11,31,27,1,0,2021-2022,0.4365079365079365,0.7936507936507937
2284,Gerson Rodrigues,LUX,"FW,MF",Troyes,Ligue 1,26,1995,9.4,12,9,2,6,4,1,17,5.9,16,8,1,7,0,12,2,0,0,2021-2022,0.0,1.276595744680851
2285,Kévin Rodrigues,POR,"DF,FW",Rayo Vallecano,La Liga,27,1994,4.8,15,11,8,7,0,6,10,60.0,4,10,1,9,7,22,6,0,0,2021-2022,1.4583333333333335,3.125
2286,Ángel Rodríguez,ESP,"FW,MF",Mallorca,La Liga,34,1987,17.2,15,9,6,7,2,4,21,19.0,17,15,1,14,3,18,13,0,0,2021-2022,0.1744186046511628,0.872093023255814
2287,Óscar Rodríguez Arnaiz,ESP,"MF,FW",Getafe,La Liga,23,1998,10.5,16,11,6,8,2,4,12,33.3,8,7,1,6,11,27,6,0,0,2021-2022,1.0476190476190477,1.5238095238095237
2288,Óscar Rodríguez Arnaiz,ESP,"FW,MF",Sevilla,La Liga,23,1998,4.6,4,3,1,3,0,2,3,66.7,1,2,0,2,5,9,7,1,0,2021-2022,1.0869565217391306,0.8695652173913044
2289,Dani Rodríguez,ESP,"MF,FW",Mallorca,La Liga,33,1988,31.5,53,31,20,24,9,15,46,32.6,31,28,3,25,20,73,27,0,0,2021-2022,0.6349206349206349,1.6825396825396826
2290,Guido Rodríguez,ARG,MF,Betis,La Liga,27,1994,28.1,97,53,46,45,6,54,98,55.1,44,55,12,43,31,128,56,0,0,2021-2022,1.103202846975089,3.4519572953736652
2291,Jay Rodriguez,ENG,FW,Burnley,Premier League,32,1989,15.4,20,12,8,8,4,4,14,28.6,10,19,1,18,4,24,12,0,0,2021-2022,0.2597402597402597,1.2987012987012987
2292,Ricardo Rodríguez,SUI,DF,Torino,Serie A,28,1992,27.5,36,21,11,23,2,18,33,54.5,15,22,8,14,41,77,48,1,0,2021-2022,1.490909090909091,1.309090909090909
2293,Rodrygo,BRA,FW,Real Madrid,La Liga,20,2001,16.9,18,14,7,4,7,3,18,16.7,15,21,0,21,11,29,3,0,0,2021-2022,0.6508875739644971,1.0650887573964498
2294,Mads Roerslev,DEN,DF,Brentford,Premier League,22,1999,13.8,23,12,19,2,2,14,32,43.8,18,14,5,9,16,39,29,0,0,2021-2022,1.1594202898550725,1.6666666666666665
2295,Marko Rog,CRO,MF,Cagliari,Serie A,26,1995,3.5,5,3,1,2,2,1,8,12.5,7,6,1,5,1,6,3,0,0,2021-2022,0.2857142857142857,1.4285714285714286
2296,Rogério,BRA,DF,Sassuolo,Serie A,23,1998,19.2,21,13,12,5,4,15,22,68.2,7,20,8,12,18,39,42,1,0,2021-2022,0.9375,1.09375
2297,Alessio Romagnoli,ITA,DF,Milan,Serie A,26,1995,15.7,24,14,14,10,0,14,18,77.8,4,21,12,9,19,43,45,0,0,2021-2022,1.2101910828025477,1.5286624203821657
2298,Simone Romagnoli,ITA,DF,Empoli,Serie A,31,1990,16.6,28,12,14,12,2,15,20,75.0,5,34,28,6,9,37,86,0,0,2021-2022,0.5421686746987951,1.686746987951807
2299,Leo Román,ESP,GK,Mallorca,La Liga,21,2000,2.0,0,0,0,0,0,0,0,0.0,0,0,0,0,0,0,2,0,0,2021-2022,0.0,0.0
2300,Cristian Romero,ARG,DF,Tottenham,Premier League,23,1998,20.5,62,39,39,21,2,22,34,64.7,12,46,21,25,33,95,74,1,0,2021-2022,1.6097560975609757,3.024390243902439
Rk,Player,Nation,Pos,Squad,Comp,0,0,90.0,0,0,3,3,3,Tkl,0,0.0,0,0,0,0,0,0,0,0,0,2021-2022,0.0,0.0
2301,Iván Romero,ESP,FW,Sevilla,La Liga,20,2001,2.0,2,2,0,2,0,0,0,0.0,0,1,0,1,2,4,0,0,0,2021-2022,1.0,1.0
2302,Luka Romero,ARG,FW,Lazio,Serie A,16,2004,0.9,2,1,0,1,1,0,2,0.0,2,0,0,0,1,3,0,0,0,2021-2022,1.1111111111111112,2.2222222222222223
2303,Sergio Romero,ARG,GK,Venezia,Serie A,34,1987,16.0,2,2,2,0,0,2,2,100.0,0,0,0,0,1,3,10,0,0,2021-2022,0.0625,0.125
2304,Oriol Romeu,ESP,MF,Southampton,Premier League,29,1991,32.1,77,39,25,45,7,28,73,38.4,45,39,8,31,51,128,43,0,0,2021-2022,1.588785046728972,2.398753894080997
2305,Cristiano Ronaldo,POR,FW,Manchester Utd,Premier League,36,1985,27.3,8,6,1,5,2,2,6,33.3,4,8,0,8,2,10,29,0,0,2021-2022,0.07326007326007326,0.29304029304029305
2306,Cristiano Ronaldo,POR,FW,Juventus,Serie A,36,1985,0.3,1,0,0,1,0,1,1,100.0,0,0,0,0,0,1,0,0,0,2021-2022,0.0,3.3333333333333335
2307,Salomón Rondón,VEN,FW,Everton,Premier League,31,1989,8.8,6,1,1,2,3,4,14,28.6,10,5,0,5,0,6,10,0,0,2021-2022,0.0,0.6818181818181818
2308,Valentin Rongier,FRA,"MF,DF",Marseille,Ligue 1,26,1994,24.4,77,51,36,36,5,28,60,46.7,32,26,5,21,33,110,14,0,0,2021-2022,1.3524590163934427,3.155737704918033
2309,Marten de Roon,NED,"MF,DF",Atalanta,Serie A,30,1991,28.3,69,42,33,29,7,34,62,54.8,28,36,2,34,45,114,41,0,0,2021-2022,1.5901060070671378,2.4381625441696113
2310,Unai Ropero,ESP,MF,Alavés,La Liga,19,2001,0.1,0,0,0,0,0,0,0,0.0,0,0,0,0,1,1,0,0,0,2021-2022,10.0,0.0
2311,Pablo Rosario,NED,MF,Nice,Ligue 1,24,1997,30.3,59,37,18,32,9,26,66,39.4,40,33,7,26,38,97,43,0,0,2021-2022,1.2541254125412542,1.9471947194719472
2312,Romario Rösch,GER,MF,Mainz 05,Bundesliga,22,1999,0.0,0,0,0,0,0,0,0,0.0,0,0,0,0,0,0,0,0,0,2021-2022,,
2313,Danny Rose,ENG,DF,Watford,Premier League,31,1990,7.7,16,10,11,4,1,10,24,41.7,14,8,5,3,14,30,11,1,0,2021-2022,1.8181818181818181,2.0779220779220777
2314,Francesco Rossi,ITA,GK,Atalanta,Serie A,30,1991,0.4,0,0,0,0,0,0,0,0.0,0,0,0,0,0,0,0,0,0,2021-2022,0.0,0.0
2315,Tom Rothe,GER,DF,Dortmund,Bundesliga,16,2004,1.0,4,3,2,2,0,3,6,50.0,3,2,0,2,2,6,3,0,0,2021-2022,2.0,4.0
2316,Jérôme Roussillon,FRA,DF,Wolfsburg,Bundesliga,28,1993,19.7,14,9,8,6,0,10,16,62.5,6,24,5,19,14,28,34,2,0,2021-2022,0.7106598984771574,0.7106598984771574
2317,Nicolò Rovella,ITA,MF,Genoa,Serie A,19,2001,16.3,37,26,16,14,7,15,40,37.5,25,21,1,20,20,57,20,0,0,2021-2022,1.2269938650306749,2.2699386503067482
2318,Jon Rowe,ENG,"FW,MF",Norwich City,Premier League,18,2003,2.5,3,2,2,1,0,2,3,66.7,1,7,0,7,3,6,1,0,0,2021-2022,1.2,1.2
2319,Amir Rrahmani,KVX,DF,Napoli,Serie A,27,1994,32.5,21,11,15,5,1,15,19,78.9,4,36,25,11,19,40,89,0,0,2021-2022,0.5846153846153846,0.6461538461538462
2320,Ruan,BRA,DF,Sassuolo,Serie A,22,1999,2.4,7,4,7,0,0,3,4,75.0,1,6,5,1,2,9,24,1,0,2021-2022,0.8333333333333334,2.916666666666667
2321,Rubén,ESP,DF,Espanyol,La Liga,20,2001,1.7,6,1,4,2,0,4,7,57.1,3,0,0,0,2,8,4,0,0,2021-2022,1.1764705882352942,3.5294117647058822
2322,John Ruddy,ENG,GK,Wolves,Premier League,34,1986,1.5,0,0,0,0,0,0,0,0.0,0,0,0,0,0,0,3,0,0,2021-2022,0.0,0.0
2323,Antonio Rüdiger,GER,DF,Chelsea,Premier League,28,1993,33.7,48,28,29,15,4,36,48,75.0,12,20,11,9,28,76,91,1,0,2021-2022,0.830860534124629,1.4243323442136497
2324,Sebastian Rudy,GER,MF,Hoffenheim,Bundesliga,31,1990,8.6,22,12,9,13,0,11,21,52.4,10,8,3,5,11,33,8,1,0,2021-2022,1.2790697674418605,2.558139534883721
2325,Daniele Rugani,ITA,DF,Juventus,Serie A,27,1994,9.8,8,5,4,4,0,4,7,57.1,3,9,4,5,11,19,47,0,0,2021-2022,1.1224489795918366,0.8163265306122448
Rk,Player,Nation,Pos,Squad,Comp,0,0,90.0,0,0,3,3,3,Tkl,0,0.0,0,0,0,0,0,0,0,0,0,2021-2022,0.0,0.0
2326,Matteo Ruggeri,ITA,DF,Salernitana,Serie A,19,2002,7.5,8,4,5,2,1,7,10,70.0,3,6,1,5,2,10,25,0,0,2021-2022,0.26666666666666666,1.0666666666666667
2327,Mário Rui,POR,DF,Napoli,Serie A,30,1991,33.2,68,43,32,28,8,39,84,46.4,45,31,7,24,40,108,50,0,0,2021-2022,1.2048192771084336,2.048192771084337
2328,Aitor Ruibal,ESP,"FW,DF",Betis,La Liga,25,1996,9.5,21,15,13,3,5,10,34,29.4,24,8,0,8,8,29,6,0,0,2021-2022,0.8421052631578947,2.210526315789474
2329,Isma Ruiz,ESP,MF,Granada,La Liga,20,2001,3.1,3,1,3,0,0,1,9,11.1,8,5,2,3,3,6,2,0,0,2021-2022,0.9677419354838709,0.9677419354838709
2330,Fabián Ruiz Peña,ESP,MF,Napoli,Serie A,25,1996,26.5,55,33,22,29,4,29,67,43.3,38,34,1,33,22,77,32,0,0,2021-2022,0.8301886792452831,2.0754716981132075
2331,Víctor Ruiz,ESP,DF,Betis,La Liga,32,1989,15.8,11,9,7,2,2,6,9,66.7,3,18,13,5,29,40,71,1,0,2021-2022,1.8354430379746836,0.6962025316455696
2332,Gerónimo Rulli,ARG,GK,Villarreal,La Liga,29,1992,32.0,0,0,0,0,0,0,4,0.0,4,0,0,0,1,1,15,5,0,2021-2022,0.03125,0.0
2333,Lukas Rupp,GER,MF,Norwich City,Premier League,30,1991,8.5,9,4,5,3,1,4,15,26.7,11,11,1,10,9,18,7,0,0,2021-2022,1.0588235294117647,1.0588235294117647
2334,Alessandro Russo,ITA,MF,Salernitana,Serie A,17,2003,0.3,1,0,1,0,0,0,1,0.0,1,0,0,0,0,1,1,0,0,2021-2022,0.0,3.3333333333333335
2335,Franco Russo,ARG,DF,Mallorca,La Liga,26,1994,16.3,19,10,10,9,0,13,31,41.9,18,14,9,5,27,46,73,1,0,2021-2022,1.656441717791411,1.165644171779141
2336,Georginio Rutter,FRA,"FW,MF",Hoffenheim,Bundesliga,19,2002,17.9,18,13,4,8,6,6,17,35.3,11,29,1,28,6,24,11,1,0,2021-2022,0.335195530726257,1.005586592178771
2337,Mathew Ryan,AUS,GK,Real Sociedad,La Liga,29,1992,3.0,0,0,0,0,0,0,0,0.0,0,0,0,0,0,0,2,0,0,2021-2022,0.0,0.0
2338,Julian Ryerson,NOR,DF,Union Berlin,Bundesliga,23,1997,15.9,27,15,11,12,4,17,25,68.0,8,12,4,8,16,43,32,0,0,2021-2022,1.0062893081761006,1.6981132075471699
2339,Frederik Rønnow,DEN,GK,Union Berlin,Bundesliga,28,1992,7.0,0,0,0,0,0,0,0,0.0,0,0,0,0,0,0,1,0,0,2021-2022,0.0,0.0
2340,José Sá,POR,GK,Wolves,Premier League,28,1993,36.5,2,1,2,0,0,2,4,50.0,2,0,0,0,2,4,19,5,0,2021-2022,0.0547945205479452,0.0547945205479452
2341,Roli Pereira de Sa,FRA,MF,Nantes,Ligue 1,24,1996,6.4,12,4,3,5,4,3,20,15.0,17,6,0,6,6,18,3,0,0,2021-2022,0.9375,1.875
2342,Youssouf Sabaly,SEN,DF,Betis,La Liga,28,1993,8.8,12,10,11,0,1,7,13,53.8,6,11,4,7,13,25,16,1,0,2021-2022,1.477272727272727,1.3636363636363635
2343,Mathys Saban,FRA,"FW,MF",Saint-Étienne,Ligue 1,19,2002,0.8,4,2,2,2,0,1,1,100.0,0,1,0,1,0,4,0,0,0,2021-2022,0.0,5.0
2344,Stefano Sabelli,ITA,DF,Genoa,Serie A,28,1993,3.9,6,3,3,2,1,3,9,33.3,6,5,1,4,3,9,12,0,0,2021-2022,0.7692307692307693,1.5384615384615385
2345,Abdelhamid Sabiri,MAR,"MF,FW",Sampdoria,Serie A,24,1996,9.9,34,18,10,15,9,7,25,28.0,18,10,2,8,7,41,3,0,0,2021-2022,0.7070707070707071,3.4343434343434343
2346,Marcel Sabitzer,AUT,"MF,FW",RB Leipzig,Bundesliga,27,1994,0.5,2,1,1,1,0,1,1,100.0,0,0,0,0,1,3,0,0,0,2021-2022,2.0,4.0
2347,Marcel Sabitzer,AUT,"MF,DF",Bayern Munich,Bundesliga,27,1994,10.1,18,7,8,8,2,9,19,47.4,10,7,0,7,9,27,10,1,0,2021-2022,0.8910891089108911,1.7821782178217822
2348,Falaye Sacko,MLI,DF,Saint-Étienne,Ligue 1,26,1995,7.4,15,10,14,1,0,13,16,81.3,3,11,7,4,4,19,18,2,0,2021-2022,0.5405405405405405,2.0270270270270268
2349,Alexis Saelemaekers,BEL,FW,Milan,Serie A,22,1999,20.7,43,22,12,17,14,15,51,29.4,36,19,0,19,15,58,8,0,0,2021-2022,0.7246376811594203,2.077294685990338
2350,Rafiki Said,COM,"MF,FW",Brest,Ligue 1,21,2000,1.4,4,3,1,2,1,3,4,75.0,1,2,0,2,0,4,0,0,0,2021-2022,0.0,2.857142857142857
Rk,Player,Nation,Pos,Squad,Comp,0,0,90.0,0,0,3,3,3,Tkl,0,0.0,0,0,0,0,0,0,0,0,0,2021-2022,0.0,0.0
2351,Wesley Saïd,FRA,"FW,MF",Lens,Ligue 1,26,1995,7.3,10,5,1,8,1,1,9,11.1,8,4,0,4,2,12,0,0,0,2021-2022,0.273972602739726,1.36986301369863
2352,Allan Saint-Maximin,FRA,"FW,MF",Newcastle Utd,Premier League,24,1997,31.2,13,8,6,4,3,3,17,17.6,14,13,2,11,11,24,3,0,0,2021-2022,0.3525641025641026,0.4166666666666667
2353,Romain Saïss,MAR,DF,Wolves,Premier League,31,1990,30.1,40,27,28,11,1,19,33,57.6,14,41,21,20,58,98,158,2,0,2021-2022,1.9269102990033222,1.3289036544850499
2354,Bukayo Saka,ENG,"FW,MF",Arsenal,Premier League,19,2001,33.1,40,21,12,17,11,13,39,33.3,26,28,2,26,22,62,23,0,0,2021-2022,0.6646525679758308,1.2084592145015105
2355,Mamadou Sakho,FRA,DF,Montpellier,Ligue 1,31,1990,28.6,34,22,26,8,0,16,26,61.5,10,41,34,7,41,75,134,4,0,2021-2022,1.4335664335664335,1.1888111888111887
2356,Bakary Sako,MLI,"FW,MF",Saint-Étienne,Ligue 1,33,1988,1.7,0,0,0,0,0,0,1,0.0,1,3,1,2,0,0,0,0,0,2021-2022,0.0,0.0
2357,Jacopo Sala,ITA,MF,Spezia,Serie A,29,1991,9.8,22,11,10,10,2,13,30,43.3,17,6,0,6,14,36,11,0,0,2021-2022,1.4285714285714284,2.2448979591836733
2358,Mohamed Salah,EGY,FW,Liverpool,Premier League,29,1992,30.7,17,8,5,9,3,6,19,31.6,13,7,1,6,6,23,5,0,0,2021-2022,0.19543973941368079,0.5537459283387622
2359,Eddie Salcedo,ITA,"MF,FW",Spezia,Serie A,19,2001,4.8,1,1,0,0,1,0,1,0.0,1,2,1,1,0,1,7,1,0,2021-2022,0.0,0.20833333333333334
2360,William Saliba,FRA,DF,Marseille,Ligue 1,20,2001,36.0,54,32,36,16,2,27,35,77.1,8,24,16,8,48,102,85,0,0,2021-2022,1.3333333333333333,1.5
2361,Romain Salin,FRA,GK,Rennes,Ligue 1,37,1984,1.0,0,0,0,0,0,0,0,0.0,0,0,0,0,0,0,0,0,0,2021-2022,0.0,0.0
2362,Mohammed Salisu,GHA,DF,Southampton,Premier League,22,1999,33.0,80,47,54,22,4,40,65,61.5,25,49,26,23,78,158,158,4,0,2021-2022,2.3636363636363638,2.4242424242424243
2363,Roland Sallai,HUN,"MF,FW",Freiburg,Bundesliga,24,1997,17.2,22,16,8,11,3,7,23,30.4,16,12,0,12,11,33,12,0,0,2021-2022,0.6395348837209303,1.2790697674418605
2364,Yoann Salmier,GUF,DF,Troyes,Ligue 1,28,1992,29.6,58,33,44,11,3,26,34,76.5,8,30,14,16,40,98,94,0,0,2021-2022,1.3513513513513513,1.9594594594594594
2365,Salvi,ESP,"MF,FW",Cádiz,La Liga,30,1991,15.5,20,10,9,8,3,8,20,40.0,12,17,2,15,6,26,11,0,0,2021-2022,0.3870967741935484,1.2903225806451613
2366,Lazar Samardzic,SRB,"MF,FW",Udinese,Serie A,19,2002,5.4,13,9,4,7,2,7,26,26.9,19,6,0,6,2,15,2,0,0,2021-2022,0.37037037037037035,2.4074074074074074
2367,Diadie Samassékou,MLI,MF,Hoffenheim,Bundesliga,25,1996,18.4,41,26,14,21,6,21,44,47.7,23,27,11,16,28,69,26,0,0,2021-2022,1.5217391304347827,2.2282608695652177
2368,Mama Samba Baldé,GNB,"MF,FW",Troyes,Ligue 1,25,1995,19.1,40,28,16,14,10,8,26,30.8,18,32,1,31,5,45,9,0,0,2021-2022,0.2617801047120419,2.094240837696335
2369,Albert Sambi Lokonga,BEL,MF,Arsenal,Premier League,21,1999,12.6,22,18,11,9,2,12,14,85.7,2,12,7,5,13,35,12,4,0,2021-2022,1.0317460317460319,1.746031746031746
2370,Junior Sambia,FRA,"DF,FW",Montpellier,Ligue 1,24,1996,17.0,22,13,12,7,3,13,22,59.1,9,22,3,19,21,43,31,0,0,2021-2022,1.2352941176470589,1.2941176470588236
2371,Luigi Samele,ITA,FW,Sassuolo,Serie A,19,2002,0.1,0,0,0,0,0,0,0,0.0,0,0,0,0,0,0,1,0,0,2021-2022,0.0,0.0
2372,Fede San Emeterio,ESP,MF,Cádiz,La Liga,24,1997,9.2,16,5,5,8,3,5,15,33.3,10,5,0,5,8,24,6,0,0,2021-2022,0.8695652173913044,1.7391304347826089
2373,Antonio Sanabria,PAR,FW,Torino,Serie A,25,1996,20.0,3,2,0,1,2,1,4,25.0,3,11,4,7,2,5,10,0,0,2021-2022,0.1,0.15
2374,Oihan Sancet,ESP,FW,Athletic Club,La Liga,21,2000,15.8,12,7,2,8,2,5,20,25.0,15,2,0,2,5,17,13,0,0,2021-2022,0.3164556962025316,0.7594936708860759
2375,Renato Sanches,POR,"MF,FW",Lille,Ligue 1,23,1997,18.3,19,7,8,10,1,9,26,34.6,17,14,3,11,14,33,7,0,0,2021-2022,0.7650273224043715,1.0382513661202186
Rk,Player,Nation,Pos,Squad,Comp,0,0,90.0,0,0,3,3,3,Tkl,0,0.0,0,0,0,0,0,0,0,0,0,2021-2022,0.0,0.0
2376,Alexis Sánchez,CHI,FW,Inter,Serie A,32,1988,9.8,9,8,0,6,3,2,11,18.2,9,4,0,4,2,11,3,0,0,2021-2022,0.2040816326530612,0.9183673469387754
2377,Antonio Sánchez,ESP,"MF,FW",Mallorca,La Liga,24,1997,18.0,53,24,29,17,7,19,49,38.8,30,32,2,30,32,85,32,1,0,2021-2022,1.7777777777777777,2.9444444444444446
2378,Davinson Sánchez,COL,DF,Tottenham,Premier League,25,1996,18.1,41,22,25,14,2,19,28,67.9,9,24,16,8,30,71,54,3,0,2021-2022,1.6574585635359114,2.2651933701657456
2379,Germán Sánchez,ESP,DF,Granada,La Liga,34,1986,25.5,27,19,18,9,0,11,20,55.0,9,19,16,3,28,55,137,0,0,2021-2022,1.0980392156862746,1.0588235294117647
2380,Manu Sánchez,ESP,DF,Osasuna,La Liga,20,2000,25.1,72,34,41,22,9,43,79,54.4,36,28,3,25,18,90,43,0,0,2021-2022,0.7171314741035856,2.8685258964143423
2381,Robert Sánchez,ESP,GK,Brighton,Premier League,23,1997,37.0,2,1,2,0,0,1,1,100.0,0,1,0,1,0,2,11,4,0,2021-2022,0.0,0.05405405405405406
2382,Jadon Sancho,ENG,"FW,MF",Manchester Utd,Premier League,21,2000,21.1,14,8,9,4,1,8,22,36.4,14,19,0,19,15,29,5,3,0,2021-2022,0.7109004739336492,0.6635071090047393
2383,Philippe Sandler,NED,DF,Troyes,Ligue 1,24,1997,0.8,0,0,0,0,0,0,0,0.0,0,1,1,0,3,3,6,0,0,2021-2022,3.75,0.0
2384,Alex Sandro,BRA,DF,Juventus,Serie A,30,1991,19.8,27,16,15,9,3,11,25,44.0,14,17,6,11,27,54,40,0,0,2021-2022,1.3636363636363635,1.3636363636363635
2385,Leroy Sané,GER,"FW,MF",Bayern Munich,Bundesliga,25,1996,22.0,28,16,5,19,4,9,24,37.5,15,18,0,18,12,40,2,1,0,2021-2022,0.5454545454545454,1.2727272727272727
2386,Oier Sanjurjo,ESP,MF,Osasuna,La Liga,35,1986,8.4,10,6,3,7,0,2,19,10.5,17,8,3,5,1,11,9,0,0,2021-2022,0.11904761904761904,1.1904761904761905
2387,Mohamed Sankoh,NED,FW,Stuttgart,Bundesliga,17,2003,0.0,0,0,0,0,0,0,0,0.0,0,0,0,0,0,0,0,0,0,2021-2022,,
2388,Morgan Sanson,FRA,MF,Aston Villa,Premier League,26,1994,4.0,12,8,7,2,3,3,7,42.9,4,13,0,13,10,22,2,1,0,2021-2022,2.5,3.0
2389,Nicola Sansone,ITA,"FW,MF",Bologna,Serie A,29,1991,10.0,13,7,5,6,2,3,15,20.0,12,1,0,1,4,17,2,0,0,2021-2022,0.4,1.3
2390,Baptiste Santamaria,FRA,"MF,DF",Rennes,Ligue 1,26,1995,28.0,52,27,15,31,6,24,44,54.5,20,33,12,21,33,85,42,0,0,2021-2022,1.1785714285714286,1.8571428571428572
2391,Baptiste Santamaria,FRA,MF,Freiburg,Bundesliga,26,1995,0.2,0,0,0,0,0,0,1,0.0,1,0,0,0,1,1,1,0,0,2021-2022,5.0,0.0
2392,Federico Santander,PAR,"FW,DF",Bologna,Serie A,30,1991,0.7,2,1,1,1,0,1,1,100.0,0,0,0,0,0,2,0,0,0,2021-2022,0.0,2.857142857142857
2393,Jesús Santiago,ESP,MF,Valencia,La Liga,17,2004,0.9,2,2,1,1,0,0,2,0.0,2,1,0,1,0,2,1,0,0,2021-2022,0.0,2.2222222222222223
2394,Samir Santos,BRA,DF,Watford,Premier League,26,1994,18.6,24,11,18,6,0,8,19,42.1,11,21,11,10,43,67,85,3,0,2021-2022,2.311827956989247,1.2903225806451613
2395,Samir Santos,BRA,DF,Udinese,Serie A,26,1994,15.8,36,16,22,13,1,15,25,60.0,10,21,7,14,42,78,62,0,0,2021-2022,2.6582278481012658,2.2784810126582276
2396,Sergio Santos,ESP,DF,Real Madrid,La Liga,20,2001,0.1,0,0,0,0,0,0,0,0.0,0,0,0,0,0,0,0,0,0,2021-2022,0.0,0.0
2397,Alvaro Sanz,ESP,MF,Barcelona,La Liga,20,2001,0.3,0,0,0,0,0,0,1,0.0,1,0,0,0,0,0,0,0,0,2021-2022,0.0,0.0
2398,Riccardo Saponara,ITA,FW,Fiorentina,Serie A,29,1991,14.3,10,2,1,6,3,6,16,37.5,10,5,0,5,1,11,3,0,0,2021-2022,0.06993006993006992,0.6993006993006993
2399,Pablo Sarabia,ESP,FW,Paris S-G,Ligue 1,29,1992,0.2,0,0,0,0,0,0,1,0.0,1,0,0,0,0,0,0,0,0,2021-2022,0.0,0.0
2400,Marcelo Saracchi,URU,DF,Levante,La Liga,23,1998,2.1,8,5,6,1,1,2,4,50.0,2,3,0,3,4,12,7,1,0,2021-2022,1.9047619047619047,3.8095238095238093
Rk,Player,Nation,Pos,Squad,Comp,0,0,90.0,0,0,3,3,3,Tkl,0,0.0,0,0,0,0,0,0,0,0,0,2021-2022,0.0,0.0
2401,Josh Sargent,USA,"FW,MF",Norwich City,Premier League,21,2000,17.5,26,14,15,7,4,14,39,35.9,25,29,2,27,11,37,18,2,0,2021-2022,0.6285714285714286,1.4857142857142858
2402,Jeremy Sarmiento,ECU,"FW,MF",Brighton,Premier League,19,2002,0.5,1,1,0,0,1,0,2,0.0,2,2,0,2,0,1,0,0,0,2021-2022,0.0,2.0
2403,Bouna Sarr,SEN,DF,Bayern Munich,Bundesliga,29,1992,0.7,4,4,2,1,1,4,5,80.0,1,2,1,1,6,10,1,0,0,2021-2022,8.571428571428571,5.714285714285714
2404,Ismaila Sarr,SEN,"FW,MF",Watford,Premier League,23,1998,20.7,12,7,4,3,5,5,19,26.3,14,10,1,9,9,21,10,0,0,2021-2022,0.43478260869565216,0.5797101449275363
2405,Malang Sarr,FRA,DF,Chelsea,Premier League,22,1999,6.1,14,7,10,2,2,7,12,58.3,5,6,3,3,11,25,20,0,0,2021-2022,1.8032786885245902,2.295081967213115
2406,Joan Sastre Vanrell,ESP,DF,Mallorca,La Liga,24,1997,2.9,6,3,5,0,1,3,4,75.0,1,3,0,3,2,8,10,0,0,2021-2022,0.6896551724137931,2.0689655172413794
2407,Giacomo Satalino,ITA,GK,Sassuolo,Serie A,22,1999,0.1,0,0,0,0,0,0,0,0.0,0,0,0,0,0,0,0,0,0,2021-2022,0.0,0.0
2408,Martin Satriano,URU,"FW,MF",Inter,Serie A,20,2001,0.4,1,0,0,0,1,1,1,100.0,0,0,0,0,0,1,0,0,0,2021-2022,0.0,2.5
2409,Martin Satriano,URU,FW,Brest,Ligue 1,20,2001,10.4,5,2,1,1,3,2,7,28.6,5,8,0,8,2,7,3,0,0,2021-2022,0.1923076923076923,0.4807692307692307
2410,Téji Savanier,FRA,MF,Montpellier,Ligue 1,29,1991,26.8,46,27,18,19,9,21,59,35.6,38,23,1,22,25,71,12,1,0,2021-2022,0.9328358208955224,1.716417910447761
2411,Esteban Saveljich,MNE,DF,Rayo Vallecano,La Liga,30,1991,18.9,18,11,11,7,0,9,15,60.0,6,20,12,8,16,34,69,0,0,2021-2022,0.8465608465608466,0.9523809523809524
2412,Stefan Savić,MNE,DF,Atlético Madrid,La Liga,30,1991,27.1,46,20,25,20,1,29,43,67.4,14,19,12,7,37,83,102,1,0,2021-2022,1.3653136531365313,1.6974169741697416
2413,Joe Scally,USA,DF,Gladbach,Bundesliga,18,2002,21.2,40,30,21,14,5,17,41,41.5,24,27,4,23,22,62,38,0,0,2021-2022,1.0377358490566038,1.8867924528301887
2414,Giorgio Scalvini,ITA,"DF,MF",Atalanta,Serie A,17,2003,8.5,22,11,13,8,1,9,19,47.4,10,12,1,11,22,44,16,0,0,2021-2022,2.588235294117647,2.588235294117647
2415,Gianluca Scamacca,ITA,FW,Sassuolo,Serie A,22,1999,23.8,19,14,2,5,12,5,21,23.8,16,16,1,15,5,24,22,1,0,2021-2022,0.21008403361344538,0.7983193277310924
2416,Dane Scarlett,ENG,MF,Tottenham,Premier League,17,2004,0.0,0,0,0,0,0,0,0,0.0,0,0,0,0,0,0,0,0,0,2021-2022,,
2417,Kevin Schade,GER,"MF,FW",Freiburg,Bundesliga,19,2001,9.2,9,7,6,2,1,3,10,30.0,7,15,3,12,3,12,16,0,0,2021-2022,0.32608695652173914,0.9782608695652175
2418,András Schäfer,HUN,MF,Union Berlin,Bundesliga,22,1999,2.7,4,1,3,1,0,0,5,0.0,5,7,1,6,2,6,4,0,0,2021-2022,0.7407407407407407,1.4814814814814814
2419,Fabian Schär,SUI,DF,Newcastle Utd,Premier League,29,1991,24.0,16,11,11,3,2,8,16,50.0,8,27,18,9,32,48,95,2,0,2021-2022,1.3333333333333333,0.6666666666666666
2420,Louis Schaub,AUT,"MF,FW",Köln,Bundesliga,26,1994,7.3,16,10,7,7,2,11,20,55.0,9,17,3,14,3,19,3,0,0,2021-2022,0.4109589041095891,2.191780821917808
2421,Andrea Schiavone,ITA,MF,Salernitana,Serie A,28,1993,6.3,14,8,5,9,0,10,23,43.5,13,13,3,10,8,22,12,0,0,2021-2022,1.2698412698412698,2.2222222222222223
2422,Patrik Schick,CZE,FW,Leverkusen,Bundesliga,25,1996,23.1,5,2,2,2,1,1,9,11.1,8,6,1,5,3,8,28,0,0,2021-2022,0.12987012987012986,0.21645021645021645
2423,Kingsley Schindler,GHA,"DF,FW",Köln,Bundesliga,28,1993,3.9,1,0,0,0,1,1,5,20.0,4,5,1,4,5,6,5,0,0,2021-2022,1.2820512820512822,0.25641025641025644
2424,Xaver Schlager,AUT,MF,Wolfsburg,Bundesliga,23,1997,11.6,43,20,20,20,3,20,49,40.8,29,25,2,23,9,52,14,0,0,2021-2022,0.7758620689655172,3.706896551724138
2425,Keven Schlotterbeck,GER,"DF,FW",Freiburg,Bundesliga,24,1997,3.5,11,5,6,5,0,5,6,83.3,1,7,4,3,11,22,24,1,0,2021-2022,3.142857142857143,3.142857142857143
Rk,Player,Nation,Pos,Squad,Comp,0,0,90.0,0,0,3,3,3,Tkl,0,0.0,0,0,0,0,0,0,0,0,0,2021-2022,0.0,0.0
2426,Nico Schlotterbeck,GER,DF,Freiburg,Bundesliga,21,1999,30.9,72,43,36,34,2,33,48,68.8,15,41,32,9,56,128,154,1,0,2021-2022,1.8122977346278317,2.330097087378641
2427,Jeffrey Schlupp,GHA,"MF,FW",Crystal Palace,Premier League,28,1992,20.6,46,25,16,23,7,24,50,48.0,26,39,9,30,18,64,32,0,0,2021-2022,0.8737864077669902,2.233009708737864
2428,Kasper Schmeichel,DEN,GK,Leicester City,Premier League,34,1986,37.0,0,0,0,0,0,0,2,0.0,2,0,0,0,1,1,15,2,0,2021-2022,0.02702702702702703,0.0
2429,Jonathan Schmid,FRA,DF,Freiburg,Bundesliga,31,1990,6.5,12,6,6,3,3,5,7,71.4,2,7,1,6,6,18,15,0,0,2021-2022,0.9230769230769231,1.8461538461538463
2430,Benno Schmitz,GER,DF,Köln,Bundesliga,26,1994,26.9,57,37,21,27,9,42,86,48.8,44,44,8,36,39,96,39,0,0,2021-2022,1.449814126394052,2.1189591078066914
2431,David Schnegg,AUT,DF,Venezia,Serie A,22,1998,1.6,2,0,1,1,0,1,3,33.3,2,4,0,4,3,5,6,0,0,2021-2022,1.875,1.25
2432,Morgan Schneiderlin,FRA,MF,Nice,Ligue 1,31,1989,7.2,21,12,9,11,1,6,13,46.2,7,8,2,6,20,41,18,0,0,2021-2022,2.7777777777777777,2.9166666666666665
2433,Alessandro Schöpf,AUT,MF,Arminia,Bundesliga,27,1994,26.6,40,22,19,16,5,14,30,46.7,16,31,5,26,30,70,21,1,0,2021-2022,1.1278195488721805,1.5037593984962405
2434,Jerdy Schouten,NED,MF,Bologna,Serie A,24,1997,15.5,25,17,10,12,3,9,22,40.9,13,22,5,17,33,58,29,1,0,2021-2022,2.129032258064516,1.6129032258064515
2435,Nico Schulz,GER,DF,Dortmund,Bundesliga,28,1993,9.3,21,12,9,7,5,9,21,42.9,12,8,1,7,11,32,8,0,0,2021-2022,1.182795698924731,2.258064516129032
2436,Marvin Schwäbe,GER,GK,Köln,Bundesliga,26,1995,21.0,0,0,0,0,0,0,0,0.0,0,0,0,0,0,0,8,1,0,2021-2022,0.0,0.0
2437,Alexander Schwolow,GER,GK,Hertha BSC,Bundesliga,29,1992,24.2,0,0,0,0,0,0,1,0.0,1,0,0,0,2,2,18,3,0,2021-2022,0.08264462809917356,0.0
2438,Valentino Scotta,ESP,DF,Sevilla,La Liga,19,2001,0.0,0,0,0,0,0,0,0,0.0,0,0,0,0,0,0,0,0,0,2021-2022,,
2439,Demba Seck,SEN,"MF,FW",Torino,Serie A,20,2001,1.6,2,1,0,2,0,0,0,0.0,0,0,0,0,0,2,0,0,0,2021-2022,0.0,1.25
2440,Aleksandar Sedlar,SRB,"DF,MF",Mallorca,La Liga,29,1991,4.5,5,3,4,1,0,3,5,60.0,2,4,4,0,5,10,19,0,0,2021-2022,1.1111111111111112,1.1111111111111112
2441,Paul Seguin,GER,MF,Greuther Fürth,Bundesliga,26,1995,23.4,50,31,15,32,3,26,56,46.4,30,27,3,24,19,69,30,1,0,2021-2022,0.811965811965812,2.1367521367521367
2442,Alidu Seidu,GHA,DF,Clermont Foot,Ligue 1,21,2000,15.7,34,20,20,13,1,16,27,59.3,11,25,11,14,34,68,49,1,0,2021-2022,2.1656050955414012,2.1656050955414012
2443,Davie Selke,GER,FW,Hertha BSC,Bundesliga,26,1995,11.2,5,4,1,3,1,1,3,33.3,2,6,1,5,1,6,11,0,0,2021-2022,0.08928571428571429,0.44642857142857145
2444,Matz Sels,BEL,GK,Strasbourg,Ligue 1,29,1992,37.0,1,1,1,0,0,0,0,0.0,0,0,0,0,1,2,22,0,0,2021-2022,0.02702702702702703,0.02702702702702703
2445,Ken Sema,SWE,"MF,FW",Watford,Premier League,27,1993,9.5,16,6,11,4,1,9,20,45.0,11,10,0,10,5,21,11,0,0,2021-2022,0.5263157894736842,1.6842105263157894
2446,Nélson Semedo,POR,"MF,DF",Wolves,Premier League,27,1993,23.7,58,39,39,17,2,25,49,51.0,24,23,4,19,21,79,64,1,0,2021-2022,0.8860759493670887,2.4472573839662446
2447,Lion Semić,GER,DF,Dortmund,Bundesliga,17,2003,0.0,0,0,0,0,0,0,0,0.0,0,0,0,0,0,0,0,0,0,2021-2022,,
2448,Adrian Šemper,CRO,GK,Genoa,Serie A,23,1998,1.0,0,0,0,0,0,0,0,0.0,0,0,0,0,0,0,0,0,0,2021-2022,0.0,0.0
2449,Stefano Sensi,ITA,"MF,FW",Sampdoria,Serie A,25,1995,8.4,18,9,10,6,2,10,23,43.5,13,2,0,2,6,24,4,0,0,2021-2022,0.7142857142857143,2.142857142857143
2450,Stefano Sensi,ITA,"MF,FW",Inter,Serie A,25,1995,1.9,4,3,1,3,0,2,4,50.0,2,2,0,2,0,4,2,0,0,2021-2022,0.0,2.1052631578947367
Rk,Player,Nation,Pos,Squad,Comp,0,0,90.0,0,0,3,3,3,Tkl,0,0.0,0,0,0,0,0,0,0,0,0,2021-2022,0.0,0.0
2451,Luigi Sepe,ITA,GK,Salernitana,Serie A,30,1991,15.5,0,0,0,0,0,0,0,0.0,0,0,0,0,1,1,3,0,0,2021-2022,0.06451612903225806,0.0
2452,Suat Serdar,GER,"MF,FW",Hertha BSC,Bundesliga,24,1997,24.6,64,30,24,29,11,25,55,45.5,30,32,3,29,20,84,14,0,0,2021-2022,0.8130081300813008,2.6016260162601625
2453,Laurens Serpe,ITA,DF,Genoa,Serie A,20,2001,0.5,1,0,1,0,0,1,2,50.0,1,0,0,0,0,1,1,0,0,2021-2022,0.0,2.0
2454,Janni Serra,GER,FW,Arminia,Bundesliga,23,1998,12.4,4,2,2,0,2,2,7,28.6,5,8,3,5,5,9,19,0,0,2021-2022,0.4032258064516129,0.3225806451612903
2455,Javier Serrano,ESP,MF,Atlético Madrid,La Liga,18,2003,0.8,3,1,0,3,0,2,4,50.0,2,0,0,0,3,6,2,0,0,2021-2022,3.75,3.75
2456,Nicolás Serrano,ESP,"MF,FW",Athletic Club,La Liga,18,2003,3.5,9,6,3,5,1,3,10,30.0,7,5,1,4,2,11,3,0,0,2021-2022,0.5714285714285714,2.5714285714285716
2457,Zidan Sertdemir,DEN,"MF,FW",Leverkusen,Bundesliga,16,2005,0.2,2,2,2,0,0,0,0,0.0,0,0,0,0,0,2,0,0,0,2021-2022,0.0,10.0
2458,Ryan Sessegnon,ENG,"DF,MF",Tottenham,Premier League,21,2000,11.6,25,19,14,7,4,11,22,50.0,11,18,3,15,7,32,26,0,0,2021-2022,0.603448275862069,2.1551724137931036
2459,Nils Seufert,GER,MF,Greuther Fürth,Bundesliga,24,1997,1.1,3,2,1,1,1,0,1,0.0,1,0,0,0,0,3,0,0,0,2021-2022,0.0,2.727272727272727
2460,Salva Sevilla,ESP,MF,Mallorca,La Liga,37,1984,16.7,18,12,8,8,2,6,17,35.3,11,12,6,6,14,32,11,0,0,2021-2022,0.8383233532934132,1.0778443113772456
2461,Stephan El Shaarawy,ITA,"FW,DF",Roma,Serie A,28,1992,11.7,13,8,4,9,0,4,6,66.7,2,10,2,8,11,24,8,0,0,2021-2022,0.9401709401709403,1.1111111111111112
2462,Jamie Shackleton,ENG,"DF,MF",Leeds United,Premier League,21,1999,7.9,27,16,19,7,1,13,25,52.0,12,11,7,4,8,35,12,1,0,2021-2022,1.0126582278481011,3.4177215189873418
2463,Xherdan Shaqiri,SUI,"FW,MF",Lyon,Ligue 1,29,1991,7.5,7,3,0,5,2,2,10,20.0,8,2,0,2,2,9,2,0,0,2021-2022,0.26666666666666666,0.9333333333333333
2464,Luke Shaw,ENG,DF,Manchester Utd,Premier League,26,1995,17.8,21,13,9,9,3,12,21,57.1,9,22,11,11,9,30,22,2,0,2021-2022,0.5056179775280899,1.1797752808988764
2465,Jonjo Shelvey,ENG,MF,Newcastle Utd,Premier League,29,1992,22.0,30,17,12,18,0,14,34,41.2,20,22,7,15,22,52,20,2,0,2021-2022,1.0,1.3636363636363635
2466,Aimar Sher,SWE,MF,Spezia,Serie A,18,2002,0.5,2,1,1,1,0,0,1,0.0,1,1,0,1,3,5,1,0,0,2021-2022,6.0,4.0
2467,Eldor Shomurodov,UZB,"FW,MF",Roma,Serie A,26,1995,8.7,5,4,0,4,1,1,10,10.0,9,8,0,8,2,7,5,0,0,2021-2022,0.2298850574712644,0.574712643678161
2468,Shola Shoretire,ENG,MF,Manchester Utd,Premier League,17,2004,0.2,0,0,0,0,0,0,0,0.0,0,0,0,0,0,0,0,0,0,2021-2022,0.0,0.0
2469,Mahame Siby,MLI,DF,Strasbourg,Ligue 1,25,1996,0.2,0,0,0,0,0,0,0,0.0,0,0,0,0,1,1,2,0,0,2021-2022,5.0,0.0
2470,Aboubakar Sidibé,FRA,DF,Clermont Foot,Ligue 1,25,1996,0.1,0,0,0,0,0,0,0,0.0,0,0,0,0,0,0,0,0,0,2021-2022,0.0,0.0
2471,Alassane Sidibe,CIV,MF,Atalanta,Serie A,19,2002,0.1,1,1,1,0,0,0,0,0.0,0,0,0,0,0,1,0,0,0,2021-2022,0.0,10.0
2472,Djibril Sidibé,FRA,DF,Monaco,Ligue 1,29,1992,10.5,24,13,13,8,3,9,24,37.5,15,10,1,9,16,40,13,0,0,2021-2022,1.5238095238095237,2.2857142857142856
2473,Kaj Sierhuis,NED,FW,Reims,Ligue 1,23,1998,0.9,1,1,1,0,0,1,3,33.3,2,0,0,0,0,1,1,0,0,2021-2022,0.0,1.1111111111111112
2474,Francisco Sierralta,CHI,DF,Watford,Premier League,24,1997,4.7,7,3,7,0,0,5,8,62.5,3,7,2,5,6,13,35,0,0,2021-2022,1.276595744680851,1.4893617021276595
2475,Arnór Sigurðsson,ISL,"FW,MF",Venezia,Serie A,22,1999,2.0,1,1,0,1,0,1,2,50.0,1,2,0,2,1,2,0,0,0,2021-2022,0.5,0.5
Rk,Player,Nation,Pos,Squad,Comp,0,0,90.0,0,0,3,3,3,Tkl,0,0.0,0,0,0,0,0,0,0,0,0,2021-2022,0.0,0.0
2476,Kiliann Sildillia,FRA,"DF,MF",Freiburg,Bundesliga,19,2002,1.9,7,3,3,4,0,3,6,50.0,3,1,0,1,2,9,7,1,0,2021-2022,1.0526315789473684,3.68421052631579
2477,Adrien Silva,POR,MF,Sampdoria,Serie A,32,1989,12.0,24,12,14,5,5,9,33,27.3,24,15,5,10,23,47,23,0,0,2021-2022,1.9166666666666667,2.0
2478,André Silva,POR,FW,RB Leipzig,Bundesliga,25,1995,23.1,13,9,2,3,8,4,13,30.8,9,20,2,18,2,15,15,0,0,2021-2022,0.08658008658008658,0.5627705627705627
2479,Bernardo Silva,POR,"MF,FW",Manchester City,Premier League,26,1994,31.7,57,29,19,19,19,31,67,46.3,36,24,2,22,20,77,19,0,0,2021-2022,0.6309148264984227,1.7981072555205049
2480,Caio Henrique Oliveira Silva,BRA,DF,Monaco,Ligue 1,24,1997,29.6,53,30,31,18,4,28,59,47.5,31,30,6,24,27,80,37,3,0,2021-2022,0.9121621621621622,1.7905405405405403
2481,David Silva,ESP,MF,Real Sociedad,La Liga,35,1986,19.1,28,17,10,11,7,3,20,15.0,17,13,3,10,7,35,12,0,0,2021-2022,0.36649214659685864,1.4659685863874345
2482,Fábio Silva,POR,FW,Wolves,Premier League,19,2002,6.4,3,2,0,2,1,0,8,0.0,8,2,0,2,1,4,1,0,0,2021-2022,0.15625,0.46875
2483,Gabriel Silva,BRA,"DF,MF",Saint-Étienne,Ligue 1,30,1991,7.9,12,7,7,2,3,9,13,69.2,4,9,3,6,18,30,13,0,0,2021-2022,2.2784810126582276,1.5189873417721518
2484,Jonathan Silva,ARG,"DF,FW",Getafe,La Liga,27,1994,2.5,10,8,4,4,2,7,12,58.3,5,4,0,4,3,13,7,0,0,2021-2022,1.2,4.0
2485,Rui Silva,POR,GK,Betis,La Liga,27,1994,21.8,1,0,1,0,0,1,2,50.0,1,0,0,0,1,2,11,1,0,2021-2022,0.04587155963302752,0.04587155963302752
2486,Thiago Silva,BRA,DF,Chelsea,Premier League,36,1984,29.4,32,21,19,12,1,11,22,50.0,11,54,31,23,44,76,100,0,0,2021-2022,1.4965986394557824,1.08843537414966
2487,Marco Silvestri,ITA,GK,Udinese,Serie A,30,1991,35.0,0,0,0,0,0,0,1,0.0,1,0,0,0,1,1,11,1,0,2021-2022,0.02857142857142857,0.0
2488,Mohamed Simakan,FRA,DF,RB Leipzig,Bundesliga,21,2000,22.3,48,27,25,21,2,27,41,65.9,14,22,11,11,40,88,46,1,0,2021-2022,1.7937219730941703,2.1524663677130045
2489,Giovanni Simeone,ARG,FW,Hellas Verona,Serie A,26,1995,29.5,27,15,6,12,9,9,39,23.1,30,37,3,34,6,33,23,0,0,2021-2022,0.2033898305084746,0.9152542372881356
2490,Giovanni Simeone,ARG,FW,Cagliari,Serie A,26,1995,0.1,0,0,0,0,0,0,0,0.0,0,0,0,0,0,0,0,0,0,2021-2022,0.0,0.0
2491,Giuliano Simeone,ARG,MF,Atlético Madrid,La Liga,18,2002,0.0,0,0,0,0,0,0,0,0.0,0,0,0,0,0,0,0,0,0,2021-2022,,
2492,Ellis Simms,ENG,FW,Everton,Premier League,20,2001,0.7,0,0,0,0,0,0,0,0.0,0,1,1,0,0,0,1,0,0,2021-2022,0.0,0.0
2493,Moses Simon,NGA,"FW,MF",Nantes,Ligue 1,26,1995,25.9,17,11,6,5,6,11,23,47.8,12,14,3,11,12,29,5,0,0,2021-2022,0.46332046332046334,0.6563706563706564
2494,Unai Simón,ESP,GK,Athletic Club,La Liga,24,1997,34.0,0,0,0,0,0,0,0,0.0,0,0,0,0,1,1,5,1,0,2021-2022,0.029411764705882353,0.0
2495,Xavi Simons,NED,"MF,FW",Paris S-G,Ligue 1,18,2003,1.5,1,1,0,1,0,1,2,50.0,1,3,0,3,0,1,0,0,0,2021-2022,0.0,0.6666666666666666
2496,Wilfried Singo,CIV,DF,Torino,Serie A,20,2000,29.0,55,35,24,24,7,24,34,70.6,10,26,6,20,23,78,47,0,0,2021-2022,0.7931034482758621,1.896551724137931
2497,Daley Sinkgraven,NED,DF,Leverkusen,Bundesliga,26,1995,3.9,6,2,4,0,2,3,7,42.9,4,3,1,2,3,9,6,0,0,2021-2022,0.7692307692307693,1.5384615384615385
2498,Tobias Sippel,GER,GK,Gladbach,Bundesliga,33,1988,1.0,0,0,0,0,0,0,0,0.0,0,0,0,0,0,0,0,0,0,2021-2022,0.0,0.0
2499,Hugo Siquet,BEL,DF,Freiburg,Bundesliga,19,2002,0.2,0,0,0,0,0,0,0,0.0,0,0,0,0,0,0,0,0,0,2021-2022,0.0,0.0
2500,Salvatore Sirigu,ITA,GK,Genoa,Serie A,34,1987,37.0,1,1,1,0,0,1,2,50.0,1,0,0,0,0,1,19,2,0,2021-2022,0.0,0.02702702702702703
Rk,Player,Nation,Pos,Squad,Comp,0,0,90.0,0,0,3,3,3,Tkl,0,0.0,0,0,0,0,0,0,0,0,0,2021-2022,0.0,0.0
2501,Issouf Sissokho,MLI,MF,Bordeaux,Ligue 1,19,2002,4.8,17,8,2,13,2,8,17,47.1,9,8,1,7,7,24,0,0,0,2021-2022,1.4583333333333335,3.541666666666667
2502,Ibrahima Sissoko,MLI,"MF,DF",Strasbourg,Ligue 1,23,1997,25.6,47,23,18,20,9,19,46,41.3,27,32,11,21,35,82,31,0,0,2021-2022,1.3671875,1.8359375
2503,Moussa Sissoko,FRA,MF,Watford,Premier League,31,1989,35.8,53,27,27,20,6,28,42,66.7,14,42,13,29,30,83,64,0,0,2021-2022,0.8379888268156426,1.4804469273743017
2504,Nelson Sissoko,FRA,DF,Saint-Étienne,Ligue 1,24,1997,0.5,2,0,2,0,0,1,1,100.0,0,0,0,0,0,2,2,0,0,2021-2022,0.0,4.0
2505,Sambou Sissoko,FRA,"MF,DF",Reims,Ligue 1,22,1999,2.0,12,6,6,4,2,6,8,75.0,2,2,0,2,2,14,7,0,0,2021-2022,1.0,6.0
2506,Antonio Sivera,ESP,GK,Alavés,La Liga,24,1996,3.1,0,0,0,0,0,0,1,0.0,1,0,0,0,0,0,0,0,0,2021-2022,0.0,0.0
2507,Ellyes Skhiri,TUN,MF,Köln,Bundesliga,26,1995,20.2,55,33,25,26,4,22,41,53.7,19,41,7,34,37,92,35,1,0,2021-2022,1.8316831683168318,2.722772277227723
2508,Oliver Skipp,ENG,MF,Tottenham,Premier League,20,2000,15.0,33,19,14,18,1,15,31,48.4,16,19,7,12,12,45,10,1,0,2021-2022,0.8,2.2
2509,Leo Skiri Østigård,NOR,DF,Genoa,Serie A,21,1999,13.0,16,9,8,7,1,9,11,81.8,2,17,10,7,8,24,55,1,0,2021-2022,0.6153846153846154,1.2307692307692308
2510,Łukasz Skorupski,POL,GK,Bologna,Serie A,30,1991,36.0,0,0,0,0,0,0,1,0.0,1,0,0,0,0,0,17,0,0,2021-2022,0.0,0.0
2511,Andreas Skov Olsen,DEN,"FW,DF",Bologna,Serie A,21,1999,8.3,12,10,4,4,4,5,11,45.5,6,9,1,8,3,15,11,0,0,2021-2022,0.36144578313253006,1.4457831325301203
2512,Robert Skov,DEN,"FW,DF",Hoffenheim,Bundesliga,25,1996,4.1,3,2,1,1,1,2,9,22.2,7,2,0,2,3,6,3,0,0,2021-2022,0.7317073170731708,0.7317073170731708
2513,Milan Škriniar,SVK,DF,Inter,Serie A,26,1995,35.0,47,27,26,17,4,24,42,57.1,18,36,25,11,25,72,90,1,0,2021-2022,0.7142857142857143,1.3428571428571427
2514,Islam Slimani,ALG,FW,Lyon,Ligue 1,33,1988,6.4,3,2,0,1,2,1,6,16.7,5,4,0,4,2,5,5,0,0,2021-2022,0.3125,0.46875
2515,William Smallbone,IRL,"MF,FW",Southampton,Premier League,21,2000,1.5,4,4,2,2,0,1,3,33.3,2,4,0,4,2,6,0,0,0,2021-2022,1.3333333333333333,2.6666666666666665
2516,Chris Smalling,ENG,DF,Roma,Serie A,31,1989,23.2,36,23,28,8,0,18,25,72.0,7,32,24,8,26,62,92,1,0,2021-2022,1.120689655172414,1.5517241379310345
2517,Emile Smith Rowe,ENG,"MF,FW",Arsenal,Premier League,21,2000,21.3,14,7,7,7,0,4,20,20.0,16,18,1,17,15,29,10,1,0,2021-2022,0.704225352112676,0.6572769953051643
2518,Cédric Soares,POR,DF,Arsenal,Premier League,29,1991,16.5,38,26,23,9,6,16,25,64.0,9,18,7,11,16,54,31,1,0,2021-2022,0.9696969696969697,2.303030303030303
2519,Danilo Soares,BRA,DF,Bochum,Bundesliga,29,1991,28.5,109,71,61,39,9,56,84,66.7,28,63,9,54,62,171,65,2,0,2021-2022,2.175438596491228,3.824561403508772
2520,Rubén Sobrino,ESP,MF,Valencia,La Liga,29,1992,0.2,1,1,1,0,0,1,1,100.0,0,1,0,1,2,3,0,0,0,2021-2022,10.0,5.0
2521,Rubén Sobrino,ESP,"FW,MF",Cádiz,La Liga,29,1992,20.7,28,17,11,10,7,5,35,14.3,30,21,1,20,21,49,18,0,0,2021-2022,1.0144927536231885,1.3526570048309179
2522,Alex Sola,ESP,"DF,FW",Real Sociedad,La Liga,22,1999,0.5,1,1,1,0,0,1,3,33.3,2,1,0,1,2,3,3,0,0,2021-2022,4.0,2.0
2523,Augusto Solari,ARG,"MF,DF",Celta Vigo,La Liga,29,1992,7.9,24,12,9,12,3,12,32,37.5,20,14,4,10,7,31,10,1,0,2021-2022,0.8860759493670886,3.0379746835443036
2524,Roberto Soldado,ESP,FW,Levante,La Liga,36,1985,7.4,3,1,0,1,2,1,3,33.3,2,4,0,4,1,4,7,0,0,2021-2022,0.13513513513513511,0.4054054054054054
2525,Carlos Soler,ESP,MF,Valencia,La Liga,24,1997,27.5,29,19,10,15,4,11,37,29.7,26,19,4,15,14,43,28,0,0,2021-2022,0.509090909090909,1.0545454545454545
Rk,Player,Nation,Pos,Squad,Comp,0,0,90.0,0,0,3,3,3,Tkl,0,0.0,0,0,0,0,0,0,0,0,0,2021-2022,0.0,0.0
2526,Yann Sommer,SUI,GK,Gladbach,Bundesliga,32,1988,33.0,0,0,0,0,0,0,2,0.0,2,0,0,0,3,3,8,3,0,2021-2022,0.09090909090909091,0.0
2527,Son,ESP,DF,Levante,La Liga,27,1994,21.9,28,18,16,7,5,17,34,50.0,17,11,5,6,19,47,33,1,0,2021-2022,0.8675799086757991,1.2785388127853883
2528,Brandon Soppy,FRA,"DF,MF",Udinese,Serie A,19,2002,8.6,20,9,8,10,2,11,16,68.8,5,10,2,8,5,25,9,1,0,2021-2022,0.5813953488372093,2.3255813953488373
2529,David Soria,ESP,GK,Getafe,La Liga,28,1993,37.9,1,0,1,0,0,1,2,50.0,1,0,0,0,0,1,22,2,0,2021-2022,0.0,0.026385224274406333
2530,Roberto Soriano,ITA,MF,Bologna,Serie A,30,1991,29.1,57,30,27,22,8,17,56,30.4,39,37,3,34,22,79,32,0,0,2021-2022,0.7560137457044673,1.958762886597938
2531,Alberto Soro,ESP,"MF,FW",Granada,La Liga,22,1999,6.4,12,10,3,6,3,1,7,14.3,6,21,2,19,3,15,4,0,0,2021-2022,0.46875,1.875
2532,Borna Sosa,CRO,"DF,FW",Stuttgart,Bundesliga,23,1998,27.8,22,12,14,5,3,12,26,46.2,14,30,3,27,26,48,61,0,0,2021-2022,0.935251798561151,0.7913669064748201
2533,Hugo Sotelo,ESP,FW,Celta Vigo,La Liga,17,2003,0.0,0,0,0,0,0,0,0,0.0,0,0,0,0,0,0,0,0,0,2021-2022,,
2534,Florian Sotoca,FRA,"FW,MF",Lens,Ligue 1,30,1990,27.6,31,19,7,20,4,12,51,23.5,39,31,4,27,25,56,41,0,0,2021-2022,0.9057971014492753,1.1231884057971013
2535,Riccardo Sottil,ITA,FW,Fiorentina,Serie A,22,1999,13.8,9,4,4,4,1,3,9,33.3,6,3,0,3,1,10,2,0,0,2021-2022,0.07246376811594203,0.6521739130434783
2536,Tomáš Souček,CZE,MF,West Ham,Premier League,26,1995,34.0,66,32,27,33,6,28,65,43.1,37,34,13,21,52,118,98,1,0,2021-2022,1.5294117647058822,1.9411764705882353
2537,Matìas Soulé,ARG,FW,Juventus,Serie A,18,2003,0.1,0,0,0,0,0,0,1,0.0,1,0,0,0,0,0,0,0,0,2021-2022,0.0,0.0
2538,Sambou Soumano,SEN,"FW,MF",Lorient,Ligue 1,20,2001,5.0,4,1,1,2,1,2,2,100.0,0,3,0,3,1,5,7,0,0,2021-2022,0.2,0.8
2539,Adama Soumaoro,FRA,DF,Bologna,Serie A,29,1992,25.2,15,5,5,8,2,4,9,44.4,5,22,16,6,34,49,95,0,0,2021-2022,1.3492063492063493,0.5952380952380952
2540,Boubakary Soumaré,FRA,MF,Leicester City,Premier League,22,1999,12.2,19,13,10,8,1,8,17,47.1,9,13,1,12,14,33,18,0,0,2021-2022,1.1475409836065575,1.557377049180328
2541,Arnaud Souquet,FRA,DF,Montpellier,Ligue 1,29,1992,25.9,56,35,30,17,9,32,65,49.2,33,21,7,14,34,90,60,1,0,2021-2022,1.3127413127413128,2.1621621621621623
2542,Djibril Sow,SUI,MF,Eint Frankfurt,Bundesliga,24,1997,26.8,57,33,28,25,4,22,60,36.7,38,35,8,27,50,107,20,1,0,2021-2022,1.8656716417910448,2.126865671641791
2543,Saidou Sow,GUI,DF,Saint-Étienne,Ligue 1,19,2002,11.0,28,17,21,6,1,16,21,76.2,5,15,5,10,23,51,34,0,0,2021-2022,2.090909090909091,2.5454545454545454
2544,Çağlar Söyüncü,TUR,DF,Leicester City,Premier League,25,1996,27.7,47,30,32,12,3,26,42,61.9,16,44,27,17,32,79,115,1,0,2021-2022,1.1552346570397112,1.696750902527076
2545,Leonardo Spinazzola,ITA,DF,Roma,Serie A,28,1993,1.4,0,0,0,0,0,0,1,0.0,1,4,1,3,0,0,3,0,0,2021-2022,0.0,0.0
2546,Marco Sportiello,ITA,GK,Atalanta,Serie A,29,1992,5.0,0,0,0,0,0,0,0,0.0,0,0,0,0,0,0,2,0,0,2021-2022,0.0,0.0
2547,Tony Springett,IRL,"MF,FW",Norwich City,Premier League,18,2002,1.6,2,1,1,1,0,1,4,25.0,3,0,0,0,0,2,2,0,0,2021-2022,0.0,1.25
2548,Jerry St. Juste,NED,DF,Mainz 05,Bundesliga,24,1996,6.7,13,9,7,6,0,7,8,87.5,1,7,3,4,14,27,14,0,0,2021-2022,2.08955223880597,1.9402985074626866
2549,Anton Stach,GER,MF,Mainz 05,Bundesliga,22,1998,20.7,28,19,14,13,1,15,38,39.5,23,24,5,19,51,79,25,0,0,2021-2022,2.4637681159420293,1.3526570048309179
2550,Kostas Stafylidis,GRE,"DF,MF",Bochum,Bundesliga,27,1993,15.4,37,27,22,13,2,20,26,76.9,6,19,6,13,31,68,43,0,0,2021-2022,2.012987012987013,2.4025974025974026
Rk,Player,Nation,Pos,Squad,Comp,0,0,90.0,0,0,3,3,3,Tkl,0,0.0,0,0,0,0,0,0,0,0,0,2021-2022,0.0,0.0
2551,Luca Stanga,ITA,DF,Milan,Serie A,19,2002,0.0,1,0,0,1,0,0,0,0.0,0,0,0,0,0,1,0,0,0,2021-2022,,inf
2552,Josip Stanišić,CRO,DF,Bayern Munich,Bundesliga,21,2000,7.2,21,10,7,12,2,12,18,66.7,6,7,0,7,11,32,10,2,0,2021-2022,1.5277777777777777,2.9166666666666665
2553,Niklas Stark,GER,DF,Hertha BSC,Bundesliga,26,1995,22.6,28,16,18,10,0,12,17,70.6,5,27,17,10,36,64,122,2,0,2021-2022,1.5929203539823007,1.238938053097345
2554,Jason Steele,ENG,GK,Brighton,Premier League,30,1990,1.0,0,0,0,0,0,0,0,0.0,0,0,0,0,0,0,0,0,0,2021-2022,0.0,0.0
2555,Jed Steer,ENG,GK,Aston Villa,Premier League,28,1992,1.0,0,0,0,0,0,0,0,0.0,0,0,0,0,0,0,0,0,0,2021-2022,0.0,0.0
2556,Renato Steffen,SUI,"FW,MF",Wolfsburg,Bundesliga,29,1991,10.7,20,16,10,10,0,9,16,56.3,7,7,0,7,13,33,14,0,0,2021-2022,1.2149532710280375,1.869158878504673
2557,Zack Steffen,USA,GK,Manchester City,Premier League,26,1995,1.0,0,0,0,0,0,0,0,0.0,0,0,0,0,0,0,2,0,0,2021-2022,0.0,0.0
2558,Calvin Stengs,NED,MF,Nice,Ligue 1,22,1998,11.9,16,7,6,9,1,7,20,35.0,13,10,0,10,8,24,6,0,0,2021-2022,0.6722689075630252,1.3445378151260503
2559,Pascal Stenzel,GER,DF,Stuttgart,Bundesliga,25,1996,10.0,24,11,15,5,4,17,33,51.5,16,13,3,10,11,35,25,0,0,2021-2022,1.1,2.4
2560,Dale Stephens,ENG,MF,Burnley,Premier League,32,1989,1.4,4,1,0,3,1,3,8,37.5,5,4,1,3,1,5,1,0,0,2021-2022,0.7142857142857143,2.857142857142857
2561,Jack Stephens,ENG,DF,Southampton,Premier League,27,1994,9.0,19,12,13,5,1,6,16,37.5,10,12,7,5,19,38,42,0,0,2021-2022,2.111111111111111,2.111111111111111
2562,Raheem Sterling,ENG,FW,Manchester City,Premier League,26,1994,23.6,23,10,3,11,9,10,23,43.5,13,12,0,12,12,35,3,0,0,2021-2022,0.5084745762711864,0.9745762711864406
2563,Finley Stevens,WAL,DF,Brentford,Premier League,18,2003,0.2,3,1,0,3,0,1,1,100.0,0,0,0,0,0,3,0,0,0,2021-2022,0.0,15.0
2564,Angelo Stiller,GER,MF,Hoffenheim,Bundesliga,20,2001,18.8,30,17,11,15,4,9,23,39.1,14,32,6,26,9,39,16,2,0,2021-2022,0.4787234042553191,1.5957446808510638
2565,Lars Stindl,GER,"MF,FW",Gladbach,Bundesliga,32,1988,18.1,23,15,6,14,3,9,33,27.3,24,28,2,26,10,33,14,0,0,2021-2022,0.5524861878453038,1.2707182320441988
2566,Riccardo Stivanello,ITA,DF,Bologna,Serie A,17,2004,0.5,1,1,1,0,0,1,1,100.0,0,2,2,0,0,1,6,0,0,2021-2022,0.0,2.0
2567,Kevin Stöger,AUT,MF,Mainz 05,Bundesliga,27,1993,4.7,10,5,5,5,0,4,10,40.0,6,6,0,6,5,15,1,1,0,2021-2022,1.0638297872340425,2.127659574468085
2568,Petar Stojanović,SVN,DF,Empoli,Serie A,25,1995,30.4,96,63,55,32,9,59,114,51.8,55,39,13,26,27,123,65,1,0,2021-2022,0.8881578947368421,3.1578947368421053
2569,John Stones,ENG,DF,Manchester City,Premier League,27,1994,12.4,5,3,3,2,0,2,3,66.7,1,3,3,0,11,16,27,1,0,2021-2022,0.8870967741935484,0.4032258064516129
2570,Thomas Strakosha,ALB,GK,Lazio,Serie A,26,1995,23.0,0,0,0,0,0,0,0,0.0,0,0,0,0,0,0,7,2,0,2021-2022,0.0,0.0
2571,Stefan Strandberg,NOR,DF,Salernitana,Serie A,31,1990,10.4,13,8,10,3,0,8,11,72.7,3,15,13,2,9,22,49,0,0,2021-2022,0.8653846153846153,1.25
2572,Dávid Strelec,SVK,"FW,MF",Spezia,Serie A,20,2001,5.6,4,4,1,2,1,2,9,22.2,7,8,1,7,2,6,1,0,0,2021-2022,0.35714285714285715,0.7142857142857143
2573,Tobias Strobl,GER,"MF,DF",Augsburg,Bundesliga,31,1990,3.6,8,3,3,5,0,3,11,27.3,8,7,2,5,7,15,3,0,0,2021-2022,1.9444444444444444,2.2222222222222223
2574,Kevin Strootman,NED,MF,Cagliari,Serie A,31,1990,7.1,8,4,2,4,2,5,12,41.7,7,11,2,9,10,18,15,0,0,2021-2022,1.4084507042253522,1.1267605633802817
2575,Pascal Struijk,NED,"DF,MF",Leeds United,Premier League,21,1999,22.8,61,39,34,23,4,30,50,60.0,20,35,23,12,33,94,60,2,0,2021-2022,1.4473684210526316,2.675438596491228
Rk,Player,Nation,Pos,Squad,Comp,0,0,90.0,0,0,3,3,3,Tkl,0,0.0,0,0,0,0,0,0,0,0,0,2021-2022,0.0,0.0
2576,Jens Stryger Larsen,DEN,DF,Udinese,Serie A,30,1991,7.6,5,2,3,1,1,2,3,66.7,1,2,0,2,4,9,17,0,0,2021-2022,0.5263157894736842,0.6578947368421053
2577,Leo Štulac,SVN,MF,Empoli,Serie A,26,1994,9.3,13,6,5,6,2,7,19,36.8,12,6,2,4,8,21,15,0,0,2021-2022,0.8602150537634408,1.3978494623655913
2578,Stefano Sturaro,ITA,MF,Genoa,Serie A,28,1993,19.6,43,26,16,16,11,22,48,45.8,26,25,1,24,15,58,29,2,0,2021-2022,0.7653061224489796,2.193877551020408
2579,Damián Suárez,URU,DF,Getafe,La Liga,33,1988,30.1,74,47,34,30,10,42,91,46.2,49,46,5,41,31,105,30,0,0,2021-2022,1.0299003322259135,2.458471760797342
2580,Denis Suárez,ESP,MF,Celta Vigo,La Liga,27,1994,31.3,61,29,20,33,8,25,82,30.5,57,32,4,28,16,77,11,0,0,2021-2022,0.5111821086261981,1.9488817891373802
2581,Luis Suárez,URU,FW,Atlético Madrid,La Liga,34,1987,20.4,8,5,2,4,2,2,10,20.0,8,8,1,7,1,9,14,0,0,2021-2022,0.04901960784313726,0.3921568627450981
2582,Mario Suárez,ESP,DF,Rayo Vallecano,La Liga,34,1987,7.9,9,4,7,2,0,3,9,33.3,6,6,4,2,7,16,37,1,0,2021-2022,0.8860759493670886,1.1392405063291138
2583,Isaac Success,NGA,"FW,MF",Udinese,Serie A,25,1996,10.1,5,2,0,3,2,1,5,20.0,4,2,0,2,2,7,6,0,0,2021-2022,0.19801980198019803,0.49504950495049505
2584,Niklas Süle,GER,DF,Bayern Munich,Bundesliga,25,1995,20.4,29,23,21,7,1,18,24,75.0,6,16,12,4,28,57,49,0,0,2021-2022,1.3725490196078431,1.4215686274509804
2585,Kamaldeen Sulemana,GHA,"MF,FW",Rennes,Ligue 1,19,2002,11.3,23,12,7,9,7,10,17,58.8,7,10,1,9,4,27,5,0,0,2021-2022,0.35398230088495575,2.0353982300884956
2586,Crysencio Summerville,NED,"MF,FW",Leeds United,Premier League,19,2001,1.4,5,3,1,1,3,2,3,66.7,1,2,0,2,2,7,0,0,0,2021-2022,1.4285714285714286,3.5714285714285716
2587,Vladyslav Supriaha,UKR,FW,Sampdoria,Serie A,21,2000,0.2,0,0,0,0,0,0,1,0.0,1,0,0,0,0,0,0,0,0,2021-2022,0.0,0.0
2588,Suso,ESP,FW,Sevilla,La Liga,27,1993,4.3,4,3,1,3,0,3,13,23.1,10,4,0,4,0,4,0,0,0,2021-2022,0.0,0.9302325581395349
2589,Bosko Sutalo,CRO,DF,Hellas Verona,Serie A,21,2000,10.2,20,13,11,6,3,8,16,50.0,8,10,5,5,17,37,39,0,0,2021-2022,1.6666666666666667,1.9607843137254903
2590,Mattias Svanberg,SWE,MF,Bologna,Serie A,22,1999,28.5,39,15,15,16,8,16,54,29.6,38,31,9,22,28,67,34,0,0,2021-2022,0.9824561403508771,1.368421052631579
2591,Michael Svoboda,AUT,DF,Venezia,Serie A,22,1998,13.7,33,17,26,6,1,18,32,56.3,14,27,15,12,10,43,61,5,0,2021-2022,0.7299270072992701,2.408759124087591
2592,Abdoulaye Sylla,GUI,DF,Nantes,Ligue 1,21,2000,1.7,4,4,2,1,1,2,4,50.0,2,5,3,2,1,5,3,0,0,2021-2022,0.5882352941176471,2.3529411764705883
2593,Mamadou Sylla,SEN,"FW,MF",Alavés,La Liga,27,1994,4.4,2,2,0,1,1,0,1,0.0,1,0,0,0,1,3,5,0,0,2021-2022,0.22727272727272727,0.45454545454545453
2594,Mamadou Sylla,SEN,FW,Rayo Vallecano,La Liga,27,1994,2.8,1,1,1,0,0,0,1,0.0,1,2,0,2,4,5,3,0,0,2021-2022,1.4285714285714286,0.35714285714285715
2595,Ádám Szalai,HUN,FW,Mainz 05,Bundesliga,33,1987,2.9,3,2,0,2,1,0,2,0.0,2,2,0,2,0,3,0,0,0,2021-2022,0.0,1.0344827586206897
2596,Wojciech Szczęsny,POL,GK,Juventus,Serie A,31,1990,33.0,1,1,1,0,0,1,2,50.0,1,0,0,0,0,1,8,1,0,2021-2022,0.0,0.030303030303030304
2597,Dominik Szoboszlai,HUN,"MF,FW",RB Leipzig,Bundesliga,20,2000,17.1,17,12,5,9,3,8,27,29.6,19,30,3,27,10,27,15,0,0,2021-2022,0.5847953216374269,0.9941520467836257
2598,Jakob Sørensen,DEN,"MF,DF",Norwich City,Premier League,23,1998,6.7,22,11,6,14,2,10,20,50.0,10,7,3,4,10,32,19,0,0,2021-2022,1.4925373134328357,3.2835820895522385
2599,Alexander Sørloth,NOR,FW,Real Sociedad,La Liga,25,1995,19.6,20,7,4,10,6,7,17,41.2,10,14,1,13,4,24,15,0,0,2021-2022,0.2040816326530612,1.0204081632653061
2600,Tachi,ESP,DF,Alavés,La Liga,23,1997,2.7,6,3,3,3,0,5,7,71.4,2,4,3,1,1,7,9,0,0,2021-2022,0.37037037037037035,2.222222222222222
Rk,Player,Nation,Pos,Squad,Comp,0,0,90.0,0,0,3,3,3,Tkl,0,0.0,0,0,0,0,0,0,0,0,0,2021-2022,0.0,0.0
2601,Jonathan Tah,GER,DF,Leverkusen,Bundesliga,25,1996,32.0,25,18,19,5,1,17,33,51.5,16,31,20,11,43,68,156,0,0,2021-2022,1.34375,0.78125
2602,Waniss Taibi,FRA,"MF,FW",Angers,Ligue 1,19,2002,1.5,8,7,4,4,0,2,4,50.0,2,0,0,0,1,9,1,0,0,2021-2022,0.6666666666666666,5.333333333333333
2603,Flavien Tait,FRA,MF,Rennes,Ligue 1,28,1993,23.6,28,19,13,9,6,13,40,32.5,27,15,4,11,19,47,13,1,0,2021-2022,0.8050847457627118,1.1864406779661016
2604,Adrien Tameze,CMR,"MF,DF",Hellas Verona,Serie A,27,1994,28.6,52,29,24,21,7,20,59,33.9,39,40,5,35,52,104,41,0,0,2021-2022,1.8181818181818181,1.8181818181818181
2605,Japhet Tanganga,ENG,DF,Tottenham,Premier League,22,1999,8.2,14,8,7,6,1,9,19,47.4,10,13,5,8,9,23,31,0,0,2021-2022,1.0975609756097562,1.707317073170732
2606,Renato Tapia,PER,MF,Celta Vigo,La Liga,26,1995,15.7,50,31,15,31,4,20,50,40.0,30,21,5,16,28,78,43,0,0,2021-2022,1.78343949044586,3.1847133757961785
2607,Edmond Tapsoba,BFA,DF,Leverkusen,Bundesliga,22,1999,20.2,35,17,24,10,1,20,32,62.5,12,27,15,12,29,64,72,1,0,2021-2022,1.4356435643564356,1.7326732673267327
2608,Florian Tardieu,FRA,MF,Troyes,Ligue 1,29,1992,29.2,58,25,31,21,6,31,71,43.7,40,31,9,22,42,100,38,0,0,2021-2022,1.4383561643835616,1.9863013698630136
2609,Matt Targett,ENG,DF,Aston Villa,Premier League,25,1995,15.9,34,18,28,5,1,24,45,53.3,21,16,9,7,23,57,35,0,0,2021-2022,1.4465408805031446,2.138364779874214
2610,Matt Targett,ENG,DF,Newcastle Utd,Premier League,25,1995,16.0,41,26,26,14,1,24,37,64.9,13,15,4,11,25,66,39,1,0,2021-2022,1.5625,2.5625
2611,Oussama Targhalline,MAR,FW,Marseille,Ligue 1,19,2002,0.1,0,0,0,0,0,0,0,0.0,0,0,0,0,0,0,0,0,0,2021-2022,0.0,0.0
2612,James Tarkowski,ENG,DF,Burnley,Premier League,28,1992,34.5,65,45,47,17,1,33,47,70.2,14,75,61,14,48,113,186,4,0,2021-2022,1.391304347826087,1.8840579710144927
2613,Ciprian Tătărușanu,ROU,GK,Milan,Serie A,35,1986,6.0,0,0,0,0,0,0,1,0.0,1,0,0,0,0,0,2,1,0,2021-2022,0.0,0.0
2614,Niklas Tauer,GER,"DF,MF",Mainz 05,Bundesliga,20,2001,5.4,16,9,9,7,0,9,14,64.3,5,6,2,4,9,25,14,0,0,2021-2022,1.6666666666666665,2.962962962962963
2615,Nuno Tavares,POR,DF,Arsenal,Premier League,21,2000,13.1,21,14,10,7,4,8,18,44.4,10,15,5,10,9,30,33,1,0,2021-2022,0.6870229007633588,1.6030534351145038
2616,Charlie Taylor,ENG,DF,Burnley,Premier League,27,1993,30.3,45,26,31,11,3,26,44,59.1,18,42,20,22,58,103,95,2,0,2021-2022,1.914191419141914,1.4851485148514851
2617,Loum Tchaouna,FRA,"FW,MF",Rennes,Ligue 1,17,2003,1.0,3,1,1,2,0,1,5,20.0,4,0,0,0,2,5,0,0,0,2021-2022,2.0,3.0
2618,Warren Tchimbembé,CGO,MF,Metz,Ligue 1,23,1998,2.3,1,1,0,1,0,0,1,0.0,1,2,1,1,2,3,2,0,0,2021-2022,0.8695652173913044,0.4347826086956522
2619,Aurélien Tchouaméni,FRA,MF,Monaco,Ligue 1,21,2000,32.5,86,45,33,49,4,29,55,52.7,26,39,7,32,101,187,34,0,0,2021-2022,3.1076923076923078,2.646153846153846
2620,Mathys Tel,FRA,"FW,MF",Rennes,Ligue 1,16,2005,0.6,2,1,1,1,0,0,0,0.0,0,0,0,0,1,3,2,0,0,2021-2022,1.6666666666666667,3.3333333333333335
2621,Jordan Tell,GLP,FW,Clermont Foot,Ligue 1,24,1997,3.2,5,5,0,3,2,1,4,25.0,3,3,0,3,0,5,1,0,0,2021-2022,0.0,1.5625
2622,Nathan Tella,NGA,"MF,FW",Southampton,Premier League,22,1999,8.9,13,9,5,7,1,6,17,35.3,11,13,0,13,6,19,9,0,0,2021-2022,0.6741573033707865,1.4606741573033708
2623,Alex Telles,BRA,DF,Manchester Utd,Premier League,28,1992,18.4,48,27,35,9,4,27,43,62.8,16,17,4,13,26,74,45,0,0,2021-2022,1.4130434782608696,2.608695652173913
2624,Cristian Tello,ESP,FW,Betis,La Liga,29,1991,9.1,17,11,6,7,4,13,31,41.9,18,9,0,9,10,27,6,0,0,2021-2022,1.098901098901099,1.8681318681318682
2625,Nahuel Tenaglia,ARG,DF,Alavés,La Liga,25,1996,11.9,42,27,30,9,3,24,37,64.9,13,10,2,8,26,68,42,0,0,2021-2022,2.1848739495798317,3.5294117647058822
Rk,Player,Nation,Pos,Squad,Comp,0,0,90.0,0,0,3,3,3,Tkl,0,0.0,0,0,0,0,0,0,0,0,0,2021-2022,0.0,0.0
2626,Marc Tenas,ESP,"FW,MF",Alavés,La Liga,20,2001,0.6,1,1,1,0,0,1,1,100.0,0,1,0,1,0,1,0,1,0,2021-2022,0.0,1.6666666666666667
2627,Marc-André ter Stegen,GER,GK,Barcelona,La Liga,29,1992,35.0,0,0,0,0,0,0,1,0.0,1,0,0,0,1,1,13,5,0,2021-2022,0.02857142857142857,0.0
2628,Filippo Terracciano,ITA,DF,Hellas Verona,Serie A,18,2003,0.1,0,0,0,0,0,0,0,0.0,0,0,0,0,0,0,1,0,0,2021-2022,0.0,0.0
2629,Pietro Terracciano,ITA,GK,Fiorentina,Serie A,31,1990,31.8,0,0,0,0,0,0,4,0.0,4,0,0,0,2,2,20,1,0,2021-2022,0.06289308176100629,0.0
2630,Martin Terrier,FRA,"FW,MF",Rennes,Ligue 1,24,1997,30.9,55,33,22,16,17,25,43,58.1,18,29,3,26,18,73,17,0,0,2021-2022,0.5825242718446603,1.7799352750809063
2631,Aleksa Terzić,SRB,DF,Fiorentina,Serie A,21,1999,3.0,8,5,3,3,2,4,7,57.1,3,7,0,7,4,12,5,0,0,2021-2022,1.3333333333333333,2.6666666666666665
2632,Robert Tesche,GER,MF,Bochum,Bundesliga,34,1987,3.9,6,4,4,1,1,5,7,71.4,2,6,2,4,5,11,5,1,0,2021-2022,1.2820512820512822,1.5384615384615385
2633,Tanner Tessmann,USA,MF,Venezia,Serie A,19,2001,7.6,11,5,4,6,1,5,14,35.7,9,19,9,10,5,16,22,0,0,2021-2022,0.6578947368421053,1.4473684210526316
2634,Tetê,BRA,"FW,MF",Lyon,Ligue 1,21,2000,6.5,10,5,4,5,1,3,13,23.1,10,4,0,4,3,13,1,0,0,2021-2022,0.46153846153846156,1.5384615384615385
2635,Cedric Teuchert,GER,"MF,FW",Union Berlin,Bundesliga,24,1997,1.2,3,2,3,0,0,2,6,33.3,4,1,0,1,0,3,0,0,0,2021-2022,0.0,2.5
2636,Arthur Theate,BEL,DF,Bologna,Serie A,21,2000,26.9,33,19,26,3,4,14,31,45.2,17,29,16,13,42,75,69,0,0,2021-2022,1.5613382899628254,1.2267657992565058
2637,Jan Thielmann,GER,"MF,FW",Köln,Bundesliga,19,2002,13.2,24,16,6,12,6,8,23,34.8,15,23,2,21,10,34,11,0,0,2021-2022,0.7575757575757576,1.8181818181818183
2638,Sada Thioub,SEN,FW,Angers,Ligue 1,26,1995,0.0,0,0,0,0,0,0,0,0.0,0,0,0,0,0,0,0,0,0,2021-2022,,
2639,Sada Thioub,SEN,"DF,MF",Saint-Étienne,Ligue 1,26,1995,10.6,13,8,5,8,0,6,14,42.9,8,9,0,9,10,23,8,0,0,2021-2022,0.9433962264150944,1.2264150943396226
2640,Luke Thomas,ENG,DF,Leicester City,Premier League,20,2001,21.2,50,31,33,13,4,28,65,43.1,37,35,14,21,40,90,55,0,0,2021-2022,1.8867924528301887,2.358490566037736
2641,Romain Thomas,FRA,DF,Angers,Ligue 1,33,1988,28.5,49,37,28,21,0,30,57,52.6,27,35,19,16,44,93,126,0,0,2021-2022,1.543859649122807,1.719298245614035
2642,Adrien Thomasson,FRA,MF,Strasbourg,Ligue 1,27,1993,26.5,64,31,18,27,19,30,93,32.3,63,56,4,52,29,93,16,1,0,2021-2022,1.0943396226415094,2.4150943396226414
2643,Erik Thommy,GER,"FW,MF",Stuttgart,Bundesliga,26,1994,3.0,2,0,0,2,0,1,2,50.0,1,3,0,3,4,6,0,0,0,2021-2022,1.3333333333333333,0.6666666666666666
2644,Dominic Thompson,ENG,DF,Brentford,Premier League,21,2000,1.6,1,0,1,0,0,0,1,0.0,1,2,2,0,2,3,3,0,0,2021-2022,1.25,0.625
2645,Morten Thorsby,NOR,MF,Sampdoria,Serie A,25,1996,32.7,46,26,15,23,8,28,56,50.0,28,37,12,25,25,71,39,0,0,2021-2022,0.7645259938837919,1.4067278287461773
2646,Thuler,BRA,DF,Montpellier,Ligue 1,22,1999,9.5,21,12,17,4,0,8,15,53.3,7,9,7,2,9,30,30,0,0,2021-2022,0.9473684210526315,2.210526315789474
2647,Khéphren Thuram,FRA,MF,Nice,Ligue 1,20,2001,21.1,33,19,11,18,4,17,35,48.6,18,31,11,20,28,61,19,0,0,2021-2022,1.3270142180094786,1.5639810426540284
2648,Marcus Thuram,FRA,FW,Gladbach,Bundesliga,23,1997,10.9,6,5,0,5,1,1,4,25.0,3,5,0,5,5,11,5,0,0,2021-2022,0.4587155963302752,0.5504587155963303
2649,Alexis Tibidi,FRA,"MF,FW",Stuttgart,Bundesliga,17,2003,4.3,7,3,1,3,3,3,4,75.0,1,4,0,4,3,10,2,0,0,2021-2022,0.6976744186046512,1.627906976744186
2650,Cheikh Tidiane Sabaly,SEN,"FW,MF",Metz,Ligue 1,22,1999,1.7,6,3,1,4,1,2,2,100.0,0,1,0,1,0,6,1,0,0,2021-2022,0.0,3.5294117647058822
Rk,Player,Nation,Pos,Squad,Comp,0,0,90.0,0,0,3,3,3,Tkl,0,0.0,0,0,0,0,0,0,0,0,0,2021-2022,0.0,0.0
2651,Youri Tielemans,BEL,MF,Leicester City,Premier League,24,1997,29.2,74,38,23,45,6,42,100,42.0,58,47,13,34,21,95,41,3,0,2021-2022,0.7191780821917808,2.5342465753424657
2652,Kieran Tierney,SCO,DF,Arsenal,Premier League,24,1997,21.3,18,14,11,7,0,10,11,90.9,1,23,5,18,15,33,54,0,0,2021-2022,0.704225352112676,0.8450704225352113
2653,Steffen Tigges,GER,"FW,MF",Dortmund,Bundesliga,23,1998,1.2,4,3,1,2,1,2,3,66.7,1,3,1,2,0,4,3,0,0,2021-2022,0.0,3.3333333333333335
2654,Malik Tillman,USA,"FW,MF",Bayern Munich,Bundesliga,19,2002,1.2,2,1,0,1,1,0,1,0.0,1,5,1,4,2,4,1,0,0,2021-2022,1.6666666666666667,1.6666666666666667
2655,Timmy Tillman,GER,MF,Greuther Fürth,Bundesliga,22,1999,22.3,43,26,17,18,8,19,42,45.2,23,33,4,29,12,55,26,0,0,2021-2022,0.5381165919282511,1.9282511210762332
2656,David Timor,ESP,MF,Getafe,La Liga,31,1989,3.8,1,1,1,0,0,0,3,0.0,3,3,2,1,1,2,4,1,0,2021-2022,0.2631578947368421,0.2631578947368421
2657,Mircea Ţîrlea,ROU,DF,Alavés,La Liga,21,2000,0.2,0,0,0,0,0,0,0,0.0,0,0,0,0,0,0,1,0,0,2021-2022,0.0,0.0
2658,Jean-Clair Todibo,FRA,DF,Nice,Ligue 1,21,1999,34.6,59,37,43,15,1,39,60,65.0,21,45,21,24,51,110,130,2,0,2021-2022,1.4739884393063583,1.7052023121387283
2659,Umut Tohumcu,GER,MF,Hoffenheim,Bundesliga,16,2004,0.1,0,0,0,0,0,0,0,0.0,0,0,0,0,0,0,0,0,0,2021-2022,0.0,0.0
2660,Karl Toko Ekambi,CMR,FW,Lyon,Ligue 1,28,1992,25.5,13,7,4,6,3,4,21,19.0,17,26,0,26,20,33,5,0,0,2021-2022,0.7843137254901961,0.5098039215686274
2661,Corentin Tolisso,FRA,MF,Bayern Munich,Bundesliga,26,1994,7.8,11,5,1,9,1,7,17,41.2,10,5,1,4,9,20,10,0,0,2021-2022,1.153846153846154,1.4102564102564104
2662,Jeremy Toljan,GER,DF,Sassuolo,Serie A,26,1994,15.5,18,10,12,4,2,13,20,65.0,7,12,5,7,12,30,41,0,0,2021-2022,0.7741935483870968,1.1612903225806452
2663,Rafael Tolói,ITA,DF,Atalanta,Serie A,30,1990,16.0,38,15,12,15,11,24,39,61.5,15,23,11,12,26,64,35,0,0,2021-2022,1.625,2.375
2664,Raúl de Tomás,ESP,FW,Espanyol,La Liga,26,1994,32.4,15,11,6,7,2,6,17,35.3,11,12,3,9,6,21,42,1,0,2021-2022,0.1851851851851852,0.46296296296296297
2665,Tiago Tomás,POR,FW,Stuttgart,Bundesliga,19,2002,11.9,8,4,0,7,1,0,6,0.0,6,3,0,3,4,12,1,0,0,2021-2022,0.3361344537815126,0.6722689075630252
2666,Takehiro Tomiyasu,JPN,DF,Arsenal,Premier League,22,1998,18.7,35,17,19,13,3,21,32,65.6,11,22,3,19,24,59,64,2,0,2021-2022,1.2834224598930482,1.8716577540106953
2667,Takehiro Tomiyasu,JPN,DF,Bologna,Serie A,22,1998,0.1,0,0,0,0,0,0,0,0.0,0,1,0,1,1,1,0,0,0,2021-2022,10.0,0.0
2668,James Tomkins,ENG,DF,Crystal Palace,Premier League,32,1989,6.1,8,3,6,2,0,6,8,75.0,2,8,8,0,4,12,18,0,0,2021-2022,0.6557377049180328,1.3114754098360657
2669,Fikayo Tomori,ENG,DF,Milan,Serie A,23,1997,30.2,73,44,36,34,3,18,26,69.2,8,37,23,14,45,118,84,1,0,2021-2022,1.490066225165563,2.4172185430463577
2670,Sandro Tonali,ITA,MF,Milan,Serie A,21,2000,28.9,54,37,23,25,6,21,41,51.2,20,26,8,18,34,88,19,0,0,2021-2022,1.1764705882352942,1.8685121107266436
2671,Lorenzo Tonelli,ITA,DF,Empoli,Serie A,31,1990,9.7,17,9,11,4,2,6,13,46.2,7,14,8,6,19,36,28,2,0,2021-2022,1.9587628865979383,1.752577319587629
2672,Ivan Toney,ENG,FW,Brentford,Premier League,25,1996,32.3,33,21,5,20,8,12,38,31.6,26,16,2,14,14,47,44,1,0,2021-2022,0.43343653250774,1.021671826625387
2673,Ernesto Torregrossa,VEN,FW,Sampdoria,Serie A,29,1992,1.3,2,1,1,0,1,1,2,50.0,1,0,0,0,0,2,1,0,0,2021-2022,0.0,1.5384615384615383
2674,Lucas Torreira,URU,MF,Fiorentina,Serie A,25,1996,24.4,37,29,13,21,3,18,40,45.0,22,18,1,17,26,63,18,0,0,2021-2022,1.0655737704918034,1.5163934426229508
2675,Raúl Torrente,ESP,DF,Granada,La Liga,19,2001,14.2,31,21,18,11,2,16,29,55.2,13,14,9,5,12,43,69,0,0,2021-2022,0.8450704225352114,2.183098591549296
Rk,Player,Nation,Pos,Squad,Comp,0,0,90.0,0,0,3,3,3,Tkl,0,0.0,0,0,0,0,0,0,0,0,0,2021-2022,0.0,0.0
2676,Ferrán Torres,ESP,FW,Manchester City,Premier League,21,2000,3.4,2,2,0,1,1,0,3,0.0,3,2,0,2,0,2,1,0,0,2021-2022,0.0,0.5882352941176471
2677,Ferrán Torres,ESP,FW,Barcelona,La Liga,21,2000,15.7,10,5,3,4,3,3,7,42.9,4,12,3,9,6,16,7,0,0,2021-2022,0.3821656050955414,0.6369426751592357
2678,Óliver Torres,ESP,"MF,FW",Sevilla,La Liga,26,1994,11.2,22,12,8,7,7,8,25,32.0,17,10,1,9,6,28,4,0,0,2021-2022,0.5357142857142857,1.9642857142857144
2679,Pau Torres,ESP,DF,Villarreal,La Liga,24,1997,31.7,32,19,23,7,2,18,25,72.0,7,32,23,9,19,51,105,2,0,2021-2022,0.5993690851735016,1.0094637223974763
2680,Roberto Torres,ESP,"MF,FW",Osasuna,La Liga,32,1989,9.0,7,4,3,1,3,3,15,20.0,12,8,0,8,8,15,4,0,0,2021-2022,0.8888888888888888,0.7777777777777778
2681,Lucas Torró,ESP,MF,Osasuna,La Liga,27,1994,30.3,71,40,25,38,8,29,57,50.9,28,32,11,21,47,118,55,0,0,2021-2022,1.551155115511551,2.3432343234323434
2682,Jordan Torunarigha,GER,DF,Hertha BSC,Bundesliga,23,1997,5.4,4,1,1,3,0,4,5,80.0,1,4,2,2,17,21,30,0,0,2021-2022,3.148148148148148,0.7407407407407407
2683,Cenk Tosun,TUR,MF,Everton,Premier League,30,1991,0.1,0,0,0,0,0,0,0,0.0,0,0,0,0,0,0,0,0,0,2021-2022,0.0,0.0
2684,Abdoulaye Touré,GUI,MF,Genoa,Serie A,27,1994,4.8,12,4,3,8,1,5,11,45.5,6,6,1,5,4,16,6,0,0,2021-2022,0.8333333333333334,2.5
2685,Almamy Touré,MLI,"DF,MF",Eint Frankfurt,Bundesliga,25,1996,5.6,12,9,8,3,1,4,17,23.5,13,10,3,7,5,17,19,0,0,2021-2022,0.8928571428571429,2.142857142857143
2686,Lucas Tousart,FRA,MF,Hertha BSC,Bundesliga,24,1997,21.8,42,25,15,22,5,10,34,29.4,24,30,6,24,35,77,55,0,0,2021-2022,1.6055045871559632,1.926605504587156
2687,Yoann Touzghar,TUN,FW,Troyes,Ligue 1,34,1986,16.2,5,2,1,3,1,1,3,33.3,2,3,1,2,3,8,8,0,0,2021-2022,0.1851851851851852,0.308641975308642
2688,Andros Townsend,ENG,"MF,FW",Everton,Premier League,30,1991,16.2,31,17,15,6,10,15,40,37.5,25,28,2,26,14,45,6,1,0,2021-2022,0.8641975308641976,1.9135802469135803
2689,Adama Traoré,ESP,"FW,MF",Wolves,Premier League,25,1996,11.9,8,3,6,0,2,3,7,42.9,4,4,1,3,2,10,1,0,0,2021-2022,0.1680672268907563,0.6722689075630252
2690,Adama Traoré,ESP,FW,Barcelona,La Liga,25,1996,4.2,4,2,0,3,1,3,5,60.0,2,2,0,2,4,8,3,1,0,2021-2022,0.9523809523809523,0.9523809523809523
2691,Amadou Traore,FRA,FW,Bordeaux,Ligue 1,19,2002,0.2,0,0,0,0,0,0,0,0.0,0,0,0,0,0,0,0,0,0,2021-2022,0.0,0.0
2692,Bertrand Traoré,BFA,"MF,FW",Aston Villa,Premier League,25,1995,2.4,3,3,0,1,2,1,2,50.0,1,0,0,0,0,3,1,0,0,2021-2022,0.0,1.25
2693,Boubacar Traoré,MLI,MF,Metz,Ligue 1,19,2001,19.2,43,26,18,23,2,10,39,25.6,29,29,5,24,25,68,11,1,0,2021-2022,1.3020833333333335,2.2395833333333335
2694,Charles Traore,MLI,DF,Nantes,Ligue 1,29,1992,8.0,16,12,10,4,2,2,13,15.4,11,11,4,7,15,31,30,0,0,2021-2022,1.875,2.0
2695,Hamari Traoré,MLI,DF,Rennes,Ligue 1,29,1992,32.1,63,36,25,26,12,41,59,69.5,18,29,8,21,37,100,81,1,0,2021-2022,1.1526479750778815,1.9626168224299065
2696,Ismaël Traoré,CIV,DF,Angers,Ligue 1,34,1986,35.7,28,17,16,11,1,13,28,46.4,15,25,17,8,44,72,122,1,0,2021-2022,1.2324929971988794,0.7843137254901961
2697,Kevin Trapp,GER,GK,Eint Frankfurt,Bundesliga,31,1990,32.0,0,0,0,0,0,0,1,0.0,1,0,0,0,1,1,13,2,0,2021-2022,0.03125,0.0
2698,Miguel Trauco,PER,"DF,MF",Saint-Étienne,Ligue 1,28,1992,12.4,25,18,16,8,1,12,22,54.5,10,13,4,9,23,48,17,0,0,2021-2022,1.8548387096774193,2.0161290322580645
2699,Óscar Trejo,ARG,MF,Rayo Vallecano,La Liga,33,1988,22.3,42,24,14,18,10,15,50,30.0,35,26,1,25,13,55,11,0,0,2021-2022,0.5829596412556054,1.8834080717488788
2700,Trézéguet,EGY,FW,Aston Villa,Premier League,26,1994,0.1,0,0,0,0,0,0,0,0.0,0,0,0,0,0,0,0,0,0,2021-2022,0.0,0.0
Rk,Player,Nation,Pos,Squad,Comp,0,0,90.0,0,0,3,3,3,Tkl,0,0.0,0,0,0,0,0,0,0,0,0,2021-2022,0.0,0.0
2701,Manu Trigueros,ESP,"MF,FW",Villarreal,La Liga,29,1991,24.2,45,25,16,18,11,23,66,34.8,43,19,3,16,13,58,17,0,0,2021-2022,0.5371900826446281,1.859504132231405
2702,Simone Trimboli,ITA,MF,Sampdoria,Serie A,19,2002,0.7,2,1,2,0,0,2,2,100.0,0,0,0,0,2,4,0,0,0,2021-2022,2.857142857142857,2.857142857142857
2703,Christopher Trimmel,AUT,"DF,FW",Union Berlin,Bundesliga,34,1987,22.1,49,30,25,19,5,26,45,57.8,19,20,3,17,34,83,75,0,0,2021-2022,1.5384615384615383,2.2171945701357463
2704,Francisco Trincão,POR,"FW,MF",Wolves,Premier League,21,1999,14.8,28,15,9,13,6,3,19,15.8,16,17,1,16,12,40,1,1,0,2021-2022,0.8108108108108107,1.8918918918918919
2705,Kieran Trippier,ENG,DF,Newcastle Utd,Premier League,30,1990,4.8,17,10,8,8,1,10,16,62.5,6,10,3,7,10,27,10,0,0,2021-2022,2.0833333333333335,3.541666666666667
2706,Kieran Trippier,ENG,"DF,FW",Atlético Madrid,La Liga,30,1990,10.8,22,12,12,5,5,12,21,57.1,9,12,1,11,10,32,11,0,0,2021-2022,0.9259259259259258,2.0370370370370368
2707,William Troost-Ekong,NGA,DF,Watford,Premier League,27,1993,15.4,18,9,11,6,1,10,15,66.7,5,24,14,10,7,25,82,1,0,2021-2022,0.45454545454545453,1.1688311688311688
2708,Leandro Trossard,BEL,"FW,MF",Brighton,Premier League,26,1994,31.2,34,20,12,9,13,4,31,12.9,27,33,4,29,15,49,10,0,0,2021-2022,0.4807692307692308,1.0897435897435899
2709,Adrien Truffert,FRA,DF,Rennes,Ligue 1,19,2001,18.2,29,21,17,9,3,11,24,45.8,13,25,5,20,19,48,30,0,0,2021-2022,1.043956043956044,1.5934065934065935
2710,Philipp Tschauner,GER,GK,RB Leipzig,Bundesliga,35,1985,0.0,0,0,0,0,0,0,0,0.0,0,0,0,0,0,0,0,0,0,2021-2022,,
2711,Kostas Tsimikas,GRE,DF,Liverpool,Premier League,25,1996,9.7,27,12,12,8,7,12,16,75.0,4,6,2,4,10,37,22,2,0,2021-2022,1.0309278350515465,2.7835051546391756
2712,Axel Tuanzebe,COD,DF,Aston Villa,Premier League,23,1997,5.6,5,3,3,2,0,2,5,40.0,3,5,4,1,5,10,12,1,0,2021-2022,0.8928571428571429,0.8928571428571429
2713,Axel Tuanzebe,COD,DF,Napoli,Serie A,23,1997,0.1,0,0,0,0,0,0,0,0.0,0,1,1,0,0,0,0,0,0,2021-2022,0.0,0.0
2714,Ozan Tufan,TUR,MF,Watford,Premier League,26,1995,3.7,3,2,1,1,1,1,5,20.0,4,2,0,2,2,5,4,0,0,2021-2022,0.5405405405405405,0.8108108108108107
2715,Beñat Turrientes,ESP,MF,Real Sociedad,La Liga,19,2002,2.3,0,0,0,0,0,0,4,0.0,4,1,0,1,2,2,2,0,0,2021-2022,0.8695652173913044,0.0
2716,Tuta,BRA,DF,Eint Frankfurt,Bundesliga,22,1999,24.3,46,28,20,22,4,26,47,55.3,21,43,15,28,41,87,76,1,0,2021-2022,1.6872427983539093,1.8930041152263375
2717,Christos Tzolis,GRE,"FW,MF",Norwich City,Premier League,19,2002,3.7,5,3,3,1,1,2,9,22.2,7,3,0,3,1,6,1,0,0,2021-2022,0.27027027027027023,1.3513513513513513
2718,Destiny Udogie,ITA,DF,Udinese,Serie A,18,2002,27.5,64,40,30,27,7,33,60,55.0,27,39,6,33,27,91,42,0,0,2021-2022,0.9818181818181818,2.327272727272727
2719,Matthieu Udol,FRA,DF,Metz,Ligue 1,25,1996,11.2,23,14,11,10,2,12,18,66.7,6,20,7,13,31,54,29,1,0,2021-2022,2.7678571428571432,2.053571428571429
2720,Ike Ugbo,CAN,FW,Troyes,Ligue 1,22,1998,9.0,3,1,0,1,2,0,1,0.0,1,4,1,3,2,5,1,0,0,2021-2022,0.2222222222222222,0.3333333333333333
2721,Lesley Ugochukwu,FRA,MF,Rennes,Ligue 1,17,2004,4.5,13,9,5,5,3,9,19,47.4,10,7,2,5,4,17,2,0,0,2021-2022,0.8888888888888888,2.888888888888889
2722,Hwang Ui-jo,KOR,FW,Bordeaux,Ligue 1,28,1992,27.9,10,4,4,4,2,4,13,30.8,9,9,1,8,5,15,18,0,0,2021-2022,0.17921146953405018,0.35842293906810035
2723,Anthony Ujah,NGA,"FW,MF",Union Berlin,Bundesliga,30,1990,0.4,0,0,0,0,0,0,0,0.0,0,0,0,0,0,0,0,0,0,2021-2022,0.0,0.0
2724,Maximilian Ullmann,AUT,DF,Venezia,Serie A,25,1996,2.7,0,0,0,0,0,0,1,0.0,1,4,0,4,2,2,7,0,0,2021-2022,0.7407407407407407,0.0
2725,Sven Ulreich,GER,GK,Bayern Munich,Bundesliga,32,1988,6.0,0,0,0,0,0,0,0,0.0,0,0,0,0,0,0,1,0,0,2021-2022,0.0,0.0
Rk,Player,Nation,Pos,Squad,Comp,0,0,90.0,0,0,3,3,3,Tkl,0,0.0,0,0,0,0,0,0,0,0,0,2021-2022,0.0,0.0
2726,Samuel Umtiti,FRA,DF,Barcelona,La Liga,27,1993,1.0,2,2,2,0,0,1,2,50.0,1,1,1,0,0,2,4,0,0,2021-2022,0.0,2.0
2727,Enes Ünal,TUR,FW,Getafe,La Liga,24,1997,31.1,37,22,2,18,17,5,42,11.9,37,25,5,20,5,42,36,0,0,2021-2022,0.1607717041800643,1.1897106109324758
2728,Cengiz Ünder,TUR,"FW,MF",Marseille,Ligue 1,24,1997,24.4,18,13,5,6,7,5,18,27.8,13,13,2,11,14,32,9,0,0,2021-2022,0.5737704918032788,0.7377049180327869
2729,Dayot Upamecano,FRA,DF,Bayern Munich,Bundesliga,22,1998,24.6,66,42,42,21,3,24,36,66.7,12,20,10,10,32,98,71,6,0,2021-2022,1.3008130081300813,2.6829268292682924
2730,Benjamin Uphoff,GER,GK,Freiburg,Bundesliga,27,1993,2.0,0,0,0,0,0,0,0,0.0,0,0,0,0,0,0,2,2,0,2021-2022,0.0,0.0
2731,Kacper Urbanski,POL,MF,Bologna,Serie A,16,2004,0.5,3,2,1,2,0,2,2,100.0,0,2,0,2,0,3,0,0,0,2021-2022,0.0,6.0
2732,Jere Uronen,FIN,DF,Brest,Ligue 1,27,1994,9.8,28,15,15,10,3,14,24,58.3,10,12,3,9,16,44,21,0,0,2021-2022,1.6326530612244896,2.8571428571428568
2733,Mark Uth,GER,"MF,FW",Köln,Bundesliga,29,1991,22.5,32,20,9,14,9,15,49,30.6,34,27,1,26,14,46,13,0,0,2021-2022,0.6222222222222222,1.4222222222222223
2734,Myrto Uzuni,ALB,"FW,MF",Granada,La Liga,26,1995,9.5,7,4,6,1,0,0,2,0.0,2,13,1,12,10,17,7,0,0,2021-2022,1.0526315789473684,0.7368421052631579
2735,Antonio Vacca,ITA,MF,Venezia,Serie A,31,1990,11.8,36,20,24,10,2,14,36,38.9,22,16,8,8,20,56,16,0,0,2021-2022,1.694915254237288,3.0508474576271185
2736,Álvaro Vadillo,ESP,"DF,MF",Espanyol,La Liga,26,1994,0.1,1,1,1,0,0,1,2,50.0,1,0,0,0,0,1,1,0,0,2021-2022,0.0,10.0
2737,Óscar Valentín,ESP,MF,Rayo Vallecano,La Liga,26,1994,28.5,102,53,46,51,5,44,105,41.9,61,56,10,46,39,141,43,0,0,2021-2022,1.368421052631579,3.5789473684210527
2738,Germán Valera,ESP,FW,Real Sociedad,La Liga,19,2002,0.6,3,2,3,0,0,1,1,100.0,0,0,0,0,0,3,1,0,0,2021-2022,0.0,5.0
2739,Yan Valery,TUN,DF,Southampton,Premier League,22,1999,4.1,8,6,4,3,1,4,9,44.4,5,6,3,3,6,14,19,1,0,2021-2022,1.4634146341463417,1.9512195121951221
2740,Martin Valjent,SVK,DF,Mallorca,La Liga,25,1995,35.3,31,19,18,12,1,13,24,54.2,11,34,26,8,31,62,173,1,0,2021-2022,0.878186968838527,0.878186968838527
2741,Jesús Vallejo,ESP,DF,Real Madrid,La Liga,24,1997,3.8,7,5,7,0,0,5,6,83.3,1,9,8,1,6,13,16,0,0,2021-2022,1.5789473684210527,1.842105263157895
2742,Manu Vallejo,ESP,"MF,FW",Alavés,La Liga,24,1997,4.1,8,2,1,4,3,4,13,30.8,9,7,0,7,0,8,4,0,0,2021-2022,0.0,1.9512195121951221
2743,Manu Vallejo,ESP,"FW,MF",Valencia,La Liga,24,1997,1.1,2,1,1,1,0,0,1,0.0,1,0,0,0,0,2,1,0,0,2021-2022,0.0,1.8181818181818181
2744,Federico Valverde,URU,MF,Real Madrid,La Liga,23,1998,20.4,36,16,11,16,9,12,31,38.7,19,23,5,18,24,60,12,0,0,2021-2022,1.1764705882352942,1.7647058823529413
2745,Virgil van Dijk,NED,DF,Liverpool,Premier League,30,1991,34.0,16,10,11,5,0,11,16,68.8,5,21,14,7,31,47,109,0,0,2021-2022,0.9117647058823529,0.47058823529411764
2746,Vanderson,BRA,"FW,DF",Monaco,Ligue 1,20,2001,12.4,35,19,10,19,6,15,23,65.2,8,17,4,13,13,48,12,0,0,2021-2022,1.0483870967741935,2.82258064516129
2747,Zinho Vanheusden,BEL,DF,Genoa,Serie A,22,1999,11.0,18,6,12,5,1,8,14,57.1,6,19,14,5,23,41,42,0,0,2021-2022,2.090909090909091,1.6363636363636365
2748,Jonathan Varane,FRA,MF,Lens,Ligue 1,19,2001,0.0,0,0,0,0,0,0,0,0.0,0,0,0,0,0,0,0,0,0,2021-2022,,
2749,Raphaël Varane,FRA,DF,Manchester Utd,Premier League,28,1993,20.3,28,19,21,6,1,10,22,45.5,12,18,9,9,18,46,82,1,0,2021-2022,0.8866995073891625,1.379310344827586
2750,Jamie Vardy,ENG,FW,Leicester City,Premier League,34,1987,20.1,6,5,0,4,2,1,7,14.3,6,9,0,9,1,7,17,0,0,2021-2022,0.04975124378109452,0.29850746268656714
Rk,Player,Nation,Pos,Squad,Comp,0,0,90.0,0,0,3,3,3,Tkl,0,0.0,0,0,0,0,0,0,0,0,0,2021-2022,0.0,0.0
2751,Ruben Vargas,SUI,"MF,FW",Augsburg,Bundesliga,22,1998,22.0,28,21,7,14,7,11,30,36.7,19,9,1,8,16,44,13,0,0,2021-2022,0.7272727272727273,1.2727272727272727
2752,Sebastian Vasiliadis,GRE,MF,Arminia,Bundesliga,23,1997,13.3,31,17,12,15,4,15,42,35.7,27,15,2,13,25,56,31,1,0,2021-2022,1.8796992481203008,2.3308270676691727
2753,Johan Vásquez,MEX,DF,Genoa,Serie A,22,1998,25.3,79,46,44,32,3,48,75,64.0,27,32,10,22,42,121,85,0,0,2021-2022,1.6600790513833992,3.1225296442687744
2754,Denis Vavro,SVK,DF,Lazio,Serie A,25,1996,0.1,0,0,0,0,0,0,0,0.0,0,0,0,0,0,0,0,0,0,2021-2022,0.0,0.0
2755,José Luis García Vayá,ESP,MF,Levante,La Liga,22,1998,22.4,46,27,10,31,5,16,41,39.0,25,24,5,19,38,84,30,0,0,2021-2022,1.6964285714285716,2.053571428571429
2756,Jesus Vazquez,ESP,DF,Valencia,La Liga,18,2003,9.0,24,13,10,8,6,10,22,45.5,12,16,3,13,9,33,19,0,0,2021-2022,1.0,2.6666666666666665
2757,Kevin Vázquez,ESP,DF,Celta Vigo,La Liga,28,1993,14.8,34,24,12,13,9,14,28,50.0,14,20,7,13,36,70,34,0,0,2021-2022,2.4324324324324325,2.2972972972972974
2758,Lucas Vázquez,ESP,DF,Real Madrid,La Liga,30,1991,20.4,43,22,24,9,10,17,35,48.6,18,25,7,18,20,63,41,1,0,2021-2022,0.9803921568627452,2.107843137254902
2759,Matías Vecino,URU,MF,Inter,Serie A,29,1991,4.2,7,5,2,3,2,3,9,33.3,6,10,1,9,4,11,7,0,0,2021-2022,0.9523809523809523,1.6666666666666665
2760,Gabriel Veiga,ESP,MF,Celta Vigo,La Liga,19,2002,1.2,5,4,0,4,1,3,12,25.0,9,2,0,2,4,9,1,0,0,2021-2022,3.3333333333333335,4.166666666666667
2761,Miguel Veloso,POR,MF,Hellas Verona,Serie A,35,1986,14.9,23,15,4,17,2,10,16,62.5,6,18,5,13,11,34,18,1,0,2021-2022,0.7382550335570469,1.5436241610738255
2762,Joël Veltman,NED,DF,Brighton,Premier League,29,1992,31.9,74,48,47,21,6,21,53,39.6,32,46,16,30,45,119,89,0,0,2021-2022,1.4106583072100314,2.3197492163009406
2763,Micky van de Ven,NED,DF,Wolfsburg,Bundesliga,20,2001,2.1,4,4,3,1,0,0,1,0.0,1,4,1,3,2,6,8,0,0,2021-2022,0.9523809523809523,1.9047619047619047
2764,Unai Vencedor Paris,ESP,MF,Athletic Club,La Liga,20,2000,26.5,26,11,11,9,6,8,42,19.0,34,31,13,18,19,45,22,0,0,2021-2022,0.7169811320754716,0.9811320754716981
2765,Lorenzo Venuti,ITA,DF,Fiorentina,Serie A,26,1995,17.5,25,10,13,10,2,14,24,58.3,10,13,4,9,5,30,27,0,0,2021-2022,0.2857142857142857,1.4285714285714286
2766,Daniele Verde,ITA,"FW,MF",Spezia,Serie A,25,1996,21.7,11,4,8,2,1,9,20,45.0,11,17,2,15,18,29,8,0,0,2021-2022,0.8294930875576038,0.5069124423963134
2767,Simone Verdi,ITA,"MF,FW",Torino,Serie A,29,1992,0.5,1,1,0,1,0,0,0,0.0,0,0,0,0,0,1,0,0,0,2021-2022,0.0,2.0
2768,Simone Verdi,ITA,"FW,MF",Salernitana,Serie A,29,1992,9.2,12,8,5,2,5,9,20,45.0,11,4,0,4,3,15,1,0,0,2021-2022,0.32608695652173914,1.3043478260869565
2769,Gonzalo Verdú,ESP,DF,Elche,La Liga,32,1988,15.5,19,9,15,4,0,8,16,50.0,8,20,14,6,13,32,59,1,0,2021-2022,0.8387096774193549,1.2258064516129032
2770,Jordan Veretout,FRA,MF,Roma,Serie A,28,1993,25.8,34,25,20,12,2,15,39,38.5,24,12,1,11,27,61,22,1,0,2021-2022,1.0465116279069766,1.317829457364341
2771,Edoardo Vergani,ITA,"FW,MF",Salernitana,Serie A,20,2001,1.1,2,2,2,0,0,0,0,0.0,0,2,2,0,0,2,2,0,0,2021-2022,0.0,1.8181818181818181
2772,Vincent Vermeij,NED,MF,Freiburg,Bundesliga,26,1994,0.0,0,0,0,0,0,0,0,0.0,0,1,0,1,0,0,0,0,0,2021-2022,,
2773,Marco Verratti,ITA,MF,Paris S-G,Ligue 1,28,1992,21.5,60,40,16,30,14,32,64,50.0,32,36,10,26,18,78,14,2,0,2021-2022,0.8372093023255814,2.7906976744186047
2774,Valerio Verre,ITA,"MF,FW",Sampdoria,Serie A,27,1994,4.7,7,5,1,4,2,4,9,44.4,5,7,0,7,0,7,5,0,0,2021-2022,0.0,1.4893617021276595
2775,Valerio Verre,ITA,MF,Empoli,Serie A,27,1994,3.4,4,2,3,1,0,2,7,28.6,5,2,0,2,1,5,0,0,0,2021-2022,0.29411764705882354,1.1764705882352942
Rk,Player,Nation,Pos,Squad,Comp,0,0,90.0,0,0,3,3,3,Tkl,0,0.0,0,0,0,0,0,0,0,0,0,2021-2022,0.0,0.0
2776,Freddie Veseli,ALB,DF,Salernitana,Serie A,28,1992,6.6,7,2,4,3,0,5,6,83.3,1,10,5,5,4,11,19,0,0,2021-2022,0.6060606060606061,1.0606060606060606
2777,Mikel Vesga,ESP,MF,Athletic Club,La Liga,28,1993,15.1,27,14,7,18,2,11,31,35.5,20,16,5,11,20,47,34,2,0,2021-2022,1.3245033112582782,1.7880794701986755
2778,Jannik Vestergaard,DEN,DF,Leicester City,Premier League,28,1992,6.3,15,10,12,3,0,8,15,53.3,7,10,8,2,7,22,36,0,0,2021-2022,1.1111111111111112,2.380952380952381
2779,Rúben Vezo,POR,DF,Levante,La Liga,27,1994,26.9,41,29,28,12,1,26,41,63.4,15,41,25,16,36,77,105,1,0,2021-2022,1.338289962825279,1.5241635687732342
2780,Guglielmo Vicario,ITA,GK,Empoli,Serie A,24,1996,38.0,1,1,1,0,0,1,1,100.0,0,1,0,1,1,2,21,1,0,2021-2022,0.02631578947368421,0.02631578947368421
2781,Aleix Vidal,ESP,"DF,MF",Espanyol,La Liga,31,1989,21.1,31,25,17,9,5,19,39,48.7,20,19,6,13,25,56,35,2,0,2021-2022,1.1848341232227488,1.4691943127962084
2782,Arturo Vidal,CHI,MF,Inter,Serie A,34,1987,8.2,26,10,16,9,1,9,26,34.6,17,13,5,8,7,33,7,1,0,2021-2022,0.853658536585366,3.1707317073170733
2783,Nacho Vidal,ESP,DF,Osasuna,La Liga,26,1995,32.2,83,47,49,25,9,39,77,50.6,38,32,14,18,58,141,79,0,0,2021-2022,1.8012422360248446,2.5776397515527947
2784,Gabriel Vidovic,CRO,"FW,MF",Bayern Munich,Bundesliga,17,2003,0.4,0,0,0,0,0,0,0,0.0,0,0,0,0,0,0,0,0,0,2021-2022,0.0,0.0
2785,Ronaldo Vieira,ENG,MF,Sampdoria,Serie A,23,1998,5.5,10,6,6,4,0,5,10,50.0,5,5,2,3,6,16,5,1,0,2021-2022,1.0909090909090908,1.8181818181818181
2786,Nick Viergever,NED,DF,Greuther Fürth,Bundesliga,31,1989,23.7,32,23,25,7,0,24,34,70.6,10,31,22,9,37,69,119,1,0,2021-2022,1.5611814345991561,1.350210970464135
2787,Luca Vignali,ITA,"DF,MF",Spezia,Serie A,25,1996,0.9,1,1,0,1,0,0,3,0.0,3,0,0,0,1,2,1,0,0,2021-2022,1.1111111111111112,1.1111111111111112
2788,Emanuel Vignato,ITA,"MF,DF",Bologna,Serie A,20,2000,6.6,12,7,5,7,0,6,13,46.2,7,2,0,2,2,14,5,0,0,2021-2022,0.30303030303030304,1.8181818181818183
2789,Dídac Vilà,ESP,"DF,MF",Espanyol,La Liga,32,1989,2.3,7,5,2,5,0,4,9,44.4,5,2,1,1,3,10,8,0,0,2021-2022,1.3043478260869565,3.0434782608695654
2790,Tonny Vilhena,NED,"MF,FW",Espanyol,La Liga,26,1995,10.3,16,6,7,8,1,7,21,33.3,14,10,2,8,8,24,17,0,0,2021-2022,0.7766990291262136,1.5533980582524272
2791,Daniel Villahermosa,ESP,MF,Espanyol,La Liga,20,2001,0.3,0,0,0,0,0,0,0,0.0,0,0,0,0,0,0,1,0,0,2021-2022,0.0,0.0
2792,Asier Villalibre,ESP,FW,Athletic Club,La Liga,23,1997,6.1,4,3,2,1,1,1,2,50.0,1,3,1,2,1,5,7,0,0,2021-2022,0.1639344262295082,0.6557377049180328
2793,Gonzalo Villar,ESP,MF,Getafe,La Liga,23,1998,3.3,5,3,4,1,0,2,5,40.0,3,4,1,3,1,6,1,0,0,2021-2022,0.30303030303030304,1.5151515151515151
2794,Matías Viña,URU,"DF,FW",Roma,Serie A,23,1997,17.4,46,30,27,14,5,29,59,49.2,30,26,3,23,25,71,33,0,0,2021-2022,1.4367816091954024,2.6436781609195403
2795,Nicolas Viola,ITA,MF,Bologna,Serie A,31,1989,1.1,2,2,1,1,0,1,2,50.0,1,1,1,0,0,2,1,0,0,2021-2022,0.0,1.8181818181818181
2796,Mattia Viti,ITA,DF,Empoli,Serie A,19,2002,16.6,28,16,16,9,3,15,24,62.5,9,28,25,3,29,57,69,1,0,2021-2022,1.7469879518072287,1.686746987951807
2797,Vitolo,ESP,MF,Getafe,La Liga,31,1989,2.5,3,2,1,1,1,2,5,40.0,3,3,0,3,1,4,1,0,0,2021-2022,0.4,1.2
2798,Daniel Vivian,ESP,DF,Athletic Club,La Liga,22,1999,22.1,32,21,24,7,1,17,24,70.8,7,20,15,5,26,58,107,1,0,2021-2022,1.176470588235294,1.4479638009049773
2799,Dušan Vlahović,SRB,FW,Fiorentina,Serie A,21,2000,20.6,5,0,0,2,3,2,11,18.2,9,6,2,4,1,6,16,0,0,2021-2022,0.04854368932038835,0.24271844660194172
2800,Dušan Vlahović,SRB,FW,Juventus,Serie A,21,2000,12.0,0,0,0,0,0,0,4,0.0,4,3,0,3,0,0,7,0,0,2021-2022,0.0,0.0
Rk,Player,Nation,Pos,Squad,Comp,0,0,90.0,0,0,3,3,3,Tkl,0,0.0,0,0,0,0,0,0,0,0,0,2021-2022,0.0,0.0
2801,Nikola Vlašić,CRO,"FW,MF",West Ham,Premier League,23,1997,6.2,11,7,4,6,1,5,20,25.0,15,4,0,4,2,13,1,0,0,2021-2022,0.3225806451612903,1.7741935483870968
2802,Andreas Voglsammer,GER,"FW,MF",Union Berlin,Bundesliga,29,1992,9.8,14,9,8,3,3,6,14,42.9,8,9,2,7,2,16,7,0,0,2021-2022,0.2040816326530612,1.4285714285714284
2803,Kevin Vogt,GER,DF,Hoffenheim,Bundesliga,29,1991,28.5,21,12,15,6,0,11,21,52.4,10,18,7,11,13,34,101,1,0,2021-2022,0.45614035087719296,0.7368421052631579
2804,Mërgim Vojvoda,KVX,DF,Torino,Serie A,26,1995,22.0,38,23,23,11,4,20,36,55.6,16,27,8,19,20,58,51,0,0,2021-2022,0.9090909090909091,1.7272727272727273
2805,Kevin Volland,GER,"MF,FW",Monaco,Ligue 1,29,1992,27.1,24,10,2,18,4,6,31,19.4,25,20,0,20,3,27,9,0,0,2021-2022,0.11070110701107011,0.8856088560885609
2806,Cristian Volpato,ITA,"FW,MF",Roma,Serie A,17,2003,0.4,1,1,0,0,1,1,1,100.0,0,0,0,0,0,1,0,0,0,2021-2022,0.0,2.5
2807,Aster Vranckx,BEL,MF,Wolfsburg,Bundesliga,18,2002,12.7,34,13,14,16,4,14,26,53.8,12,19,7,12,13,47,16,0,0,2021-2022,1.0236220472440944,2.677165354330709
2808,Stefan de Vrij,NED,DF,Inter,Serie A,29,1992,26.8,38,29,22,16,0,12,17,70.6,5,17,8,9,32,70,52,0,0,2021-2022,1.1940298507462686,1.417910447761194
2809,Šime Vrsaljko,CRO,DF,Atlético Madrid,La Liga,29,1992,10.2,27,17,14,12,1,12,20,60.0,8,10,1,9,12,39,30,0,0,2021-2022,1.1764705882352942,2.647058823529412
2810,Nikola Vukčević,MNE,MF,Levante,La Liga,29,1991,1.3,3,2,2,1,0,0,1,0.0,1,2,0,2,2,5,1,0,0,2021-2022,1.5384615384615383,2.3076923076923075
2811,Matěj Vydra,CZE,FW,Burnley,Premier League,29,1992,7.5,12,7,3,4,5,3,7,42.9,4,5,1,4,0,12,9,0,0,2021-2022,0.0,1.6
2812,Elye Wahi,FRA,FW,Montpellier,Ligue 1,18,2003,19.8,18,10,9,6,3,6,16,37.5,10,7,0,7,4,22,4,0,0,2021-2022,0.20202020202020202,0.9090909090909091
2813,Walace,BRA,MF,Udinese,Serie A,26,1995,33.0,83,49,37,38,8,50,113,44.2,63,51,5,46,54,137,32,1,0,2021-2022,1.6363636363636365,2.515151515151515
2814,Theo Walcott,ENG,"MF,FW",Southampton,Premier League,32,1989,4.2,4,2,2,0,2,1,5,20.0,4,3,0,3,5,9,2,0,0,2021-2022,1.1904761904761905,0.9523809523809523
2815,Luca Waldschmidt,GER,"MF,FW",Wolfsburg,Bundesliga,25,1996,8.0,9,1,3,5,1,5,13,38.5,8,5,0,5,8,17,3,0,0,2021-2022,1.0,1.125
2816,Kyle Walker,ENG,DF,Manchester City,Premier League,31,1990,19.5,15,6,7,7,1,8,17,47.1,9,14,4,10,14,29,16,1,0,2021-2022,0.717948717948718,0.7692307692307693
2817,Kyle Walker-Peters,ENG,DF,Southampton,Premier League,24,1997,29.3,57,33,28,21,8,26,38,68.4,12,29,8,21,37,94,53,1,0,2021-2022,1.2627986348122866,1.9453924914675766
2818,Sebastian Walukiewicz,POL,DF,Cagliari,Serie A,21,2000,3.4,9,5,7,2,0,3,5,60.0,2,5,2,3,7,16,14,0,0,2021-2022,2.058823529411765,2.6470588235294117
2819,Aaron Wan-Bissaka,ENG,DF,Manchester Utd,Premier League,23,1997,19.9,49,36,25,18,6,14,20,70.0,6,24,14,10,34,83,41,2,0,2021-2022,1.7085427135678393,2.462311557788945
2820,Paul Wanner,GER,"FW,MF",Bayern Munich,Bundesliga,15,2005,0.4,2,2,0,2,0,1,1,100.0,0,0,0,0,0,2,0,0,0,2021-2022,0.0,5.0
2821,Danny Ward,WAL,GK,Leicester City,Premier League,28,1993,1.0,0,0,0,0,0,0,0,0.0,0,0,0,0,0,0,1,0,0,2021-2022,0.0,0.0
2822,Joel Ward,ENG,DF,Crystal Palace,Premier League,31,1989,27.6,44,26,30,11,3,30,57,52.6,27,24,11,13,32,76,107,1,0,2021-2022,1.1594202898550725,1.5942028985507246
2823,James Ward-Prowse,ENG,MF,Southampton,Premier League,26,1994,35.7,41,24,12,24,5,19,70,27.1,51,43,15,28,40,81,45,1,0,2021-2022,1.1204481792717087,1.1484593837535013
2824,Magnus Warming,DEN,"MF,FW",Torino,Serie A,21,2000,0.6,1,1,0,1,0,0,0,0.0,0,2,0,2,0,1,0,0,0,2021-2022,0.0,1.6666666666666667
2825,Daniel Wass,DEN,"DF,FW",Atlético Madrid,La Liga,32,1989,0.5,0,0,0,0,0,0,0,0.0,0,0,0,0,0,0,3,0,0,2021-2022,0.0,0.0
Rk,Player,Nation,Pos,Squad,Comp,0,0,90.0,0,0,3,3,3,Tkl,0,0.0,0,0,0,0,0,0,0,0,0,2021-2022,0.0,0.0
2826,Daniel Wass,DEN,MF,Valencia,La Liga,32,1989,17.6,23,13,6,14,3,8,31,25.8,23,13,2,11,13,36,19,0,0,2021-2022,0.7386363636363635,1.3068181818181817
2827,Ollie Watkins,ENG,FW,Aston Villa,Premier League,25,1995,32.8,17,13,2,7,8,2,15,13.3,13,25,3,22,12,29,27,0,0,2021-2022,0.3658536585365854,0.5182926829268293
2828,Timothy Weah,USA,"MF,FW",Lille,Ligue 1,21,2000,18.0,19,7,8,8,3,10,20,50.0,10,16,1,15,10,29,7,0,0,2021-2022,0.5555555555555556,1.0555555555555556
2829,Adam Webster,ENG,DF,Brighton,Premier League,26,1995,15.9,26,8,17,7,2,13,20,65.0,7,25,17,8,17,43,66,2,0,2021-2022,1.069182389937107,1.6352201257861634
2830,Wout Weghorst,NED,FW,Burnley,Premier League,28,1992,16.1,17,9,3,9,5,6,19,31.6,13,16,5,11,6,23,13,0,0,2021-2022,0.37267080745341613,1.0559006211180124
2831,Wout Weghorst,NED,FW,Wolfsburg,Bundesliga,28,1992,17.3,13,7,3,3,7,7,17,41.2,10,10,3,7,2,15,11,1,0,2021-2022,0.11560693641618497,0.7514450867052023
2832,Noah Weißhaupt,GER,"MF,FW",Freiburg,Bundesliga,19,2001,1.1,1,1,1,0,0,1,2,50.0,1,2,0,2,1,2,1,1,0,2021-2022,0.9090909090909091,0.9090909090909091
2833,Danny Welbeck,ENG,"FW,MF",Brighton,Premier League,30,1990,16.4,14,7,2,8,4,3,10,30.0,7,18,2,16,5,19,18,0,0,2021-2022,0.30487804878048785,0.853658536585366
2834,Timo Werner,GER,"FW,MF",Chelsea,Premier League,25,1996,14.3,8,4,3,3,2,2,20,10.0,18,9,0,9,2,10,4,0,0,2021-2022,0.13986013986013984,0.5594405594405594
2835,Ashley Westwood,ENG,MF,Burnley,Premier League,31,1990,25.4,21,12,8,12,1,10,31,32.3,21,21,9,12,30,51,16,1,0,2021-2022,1.1811023622047245,0.8267716535433072
2836,Ben White,ENG,DF,Arsenal,Premier League,23,1997,32.0,44,23,30,8,6,28,45,62.2,17,42,24,18,42,86,102,0,0,2021-2022,1.3125,1.375
2837,Silvan Widmer,SUI,DF,Mainz 05,Bundesliga,28,1993,32.4,60,28,32,20,8,36,61,59.0,25,44,16,28,43,103,59,2,0,2021-2022,1.3271604938271606,1.8518518518518519
2838,Georginio Wijnaldum,NED,MF,Paris S-G,Ligue 1,30,1990,18.4,15,9,2,12,1,11,19,57.9,8,13,3,10,9,24,7,0,0,2021-2022,0.48913043478260876,0.8152173913043479
2839,Jetro Willems,NED,DF,Greuther Fürth,Bundesliga,27,1994,17.8,30,15,18,10,2,15,26,57.7,11,15,3,12,14,44,42,0,0,2021-2022,0.7865168539325842,1.6853932584269662
2840,Brandon Williams,ENG,DF,Norwich City,Premier League,20,2000,23.6,55,37,35,18,2,36,64,56.3,28,26,6,20,44,99,50,0,0,2021-2022,1.8644067796610169,2.330508474576271
2841,Iñaki Williams,GHA,FW,Athletic Club,La Liga,27,1994,30.9,14,5,1,6,7,5,17,29.4,12,18,3,15,3,17,20,0,0,2021-2022,0.0970873786407767,0.45307443365695793
2842,Neco Williams,WAL,DF,Liverpool,Premier League,20,2001,0.1,0,0,0,0,0,0,0,0.0,0,0,0,0,0,0,0,0,0,2021-2022,0.0,0.0
2843,Nico Williams,ESP,MF,Athletic Club,La Liga,19,2002,14.9,20,10,6,11,3,10,31,32.3,21,18,2,16,5,25,9,0,0,2021-2022,0.33557046979865773,1.342281879194631
2844,Joe Willock,ENG,MF,Newcastle Utd,Premier League,21,1999,22.6,64,37,30,28,6,29,68,42.6,39,37,6,31,21,85,10,1,0,2021-2022,0.9292035398230087,2.831858407079646
2845,Callum Wilson,ENG,FW,Newcastle Utd,Premier League,29,1992,15.4,9,8,1,5,3,1,4,25.0,3,7,2,5,3,12,10,0,0,2021-2022,0.19480519480519481,0.5844155844155844
2846,Patrick Wimmer,AUT,"FW,MF",Arminia,Bundesliga,20,2001,22.8,53,31,13,31,9,22,61,36.1,39,30,1,29,27,80,13,0,0,2021-2022,1.1842105263157894,2.324561403508772
2847,Jonas Wind,DEN,"FW,MF",Wolfsburg,Bundesliga,22,1999,13.1,10,6,1,7,2,1,4,25.0,3,8,3,5,6,16,13,0,0,2021-2022,0.4580152671755725,0.7633587786259542
2848,Marten Winkler,GER,MF,Hertha BSC,Bundesliga,18,2002,0.3,0,0,0,0,0,0,0,0.0,0,0,0,0,0,0,0,0,0,2021-2022,0.0,0.0
2849,Harry Winks,ENG,MF,Tottenham,Premier League,25,1996,10.1,15,10,4,9,2,8,21,38.1,13,14,3,11,16,31,10,2,0,2021-2022,1.5841584158415842,1.4851485148514851
2850,Frederik Winther,DEN,DF,Augsburg,Bundesliga,20,2001,3.6,7,2,7,0,0,5,6,83.3,1,4,1,3,8,15,21,0,0,2021-2022,2.2222222222222223,1.9444444444444444
Rk,Player,Nation,Pos,Squad,Comp,0,0,90.0,0,0,3,3,3,Tkl,0,0.0,0,0,0,0,0,0,0,0,0,2021-2022,0.0,0.0
2851,Florian Wirtz,GER,"MF,FW",Leverkusen,Bundesliga,18,2003,20.6,25,10,6,16,3,10,28,35.7,18,12,1,11,13,38,4,0,0,2021-2022,0.6310679611650485,1.2135922330097086
2852,Yoane Wissa,COD,FW,Brentford,Premier League,24,1996,14.3,12,6,5,4,3,1,16,6.3,15,12,5,7,8,20,6,0,0,2021-2022,0.5594405594405594,0.8391608391608392
2853,Axel Witsel,BEL,"MF,DF",Dortmund,Bundesliga,32,1989,21.6,42,27,12,23,7,18,30,60.0,12,24,9,15,27,69,38,0,0,2021-2022,1.25,1.9444444444444444
2854,Hannes Wolf,AUT,"FW,MF",Gladbach,Bundesliga,22,1999,3.4,23,12,4,13,6,10,20,50.0,10,10,0,10,2,25,1,0,0,2021-2022,0.5882352941176471,6.764705882352941
2855,Marius Wolf,GER,"DF,FW",Dortmund,Bundesliga,26,1995,14.7,26,10,13,9,4,12,24,50.0,12,14,1,13,13,39,8,0,0,2021-2022,0.8843537414965987,1.7687074829931975
2856,Luca Wollschläger,GER,"FW,MF",Hertha BSC,Bundesliga,18,2003,0.2,1,1,0,1,0,0,1,0.0,1,0,0,0,0,1,0,0,0,2021-2022,0.0,5.0
2857,Jeong Woo-yeong,KOR,"FW,MF",Freiburg,Bundesliga,21,1999,19.8,15,9,6,7,2,5,15,33.3,10,8,1,7,7,22,11,0,0,2021-2022,0.35353535353535354,0.7575757575757576
2858,Chris Wood,NZL,FW,Burnley,Premier League,29,1991,15.2,7,5,0,3,4,3,10,30.0,7,13,4,9,0,7,3,0,0,2021-2022,0.0,0.46052631578947373
2859,Chris Wood,NZL,FW,Newcastle Utd,Premier League,29,1991,14.7,2,0,1,1,0,1,2,50.0,1,5,2,3,2,4,9,0,0,2021-2022,0.1360544217687075,0.1360544217687075
2860,Freddie Woodman,ENG,GK,Newcastle Utd,Premier League,24,1997,4.0,0,0,0,0,0,0,0,0.0,0,0,0,0,0,0,0,1,0,2021-2022,0.0,0.0
2861,Christopher Wooh,CMR,DF,Lens,Ligue 1,19,2001,11.7,29,11,20,8,1,11,18,61.1,7,21,14,7,21,50,40,1,0,2021-2022,1.794871794871795,2.4786324786324787
2862,Joscha Wosz,GER,DF,RB Leipzig,Bundesliga,19,2002,0.1,0,0,0,0,0,0,0,0.0,0,0,0,0,0,0,0,0,0,2021-2022,0.0,0.0
2863,Xeka,POR,MF,Lille,Ligue 1,26,1994,18.0,47,27,18,24,5,27,56,48.2,29,23,3,20,24,71,26,1,0,2021-2022,1.3333333333333333,2.611111111111111
2864,Granit Xhaka,SUI,"MF,DF",Arsenal,Premier League,28,1992,25.9,32,18,16,12,4,16,41,39.0,25,21,6,15,21,53,31,0,0,2021-2022,0.8108108108108109,1.2355212355212355
2865,Sekou Yansané,GUI,FW,Paris S-G,Ligue 1,18,2003,0.2,0,0,0,0,0,0,1,0.0,1,0,0,0,0,0,1,0,0,2021-2022,0.0,0.0
2866,Andriy Yarmolenko,UKR,"FW,MF",West Ham,Premier League,31,1989,3.5,4,2,2,2,0,2,8,25.0,6,4,2,2,0,4,2,0,0,2021-2022,0.0,1.1428571428571428
2867,Yusuf Yazıcı,TUR,"MF,FW",Lille,Ligue 1,24,1997,5.7,10,5,3,6,1,1,9,11.1,8,4,0,4,2,12,1,0,0,2021-2022,0.3508771929824561,1.7543859649122806
2868,Kelvin Yeboah,ITA,"FW,MF",Genoa,Serie A,21,2000,9.4,14,7,5,7,2,9,19,47.4,10,22,1,21,1,15,7,0,0,2021-2022,0.10638297872340426,1.4893617021276595
2869,Gerard Yepes,ESP,"MF,DF",Sampdoria,Serie A,18,2002,0.2,1,0,0,1,0,1,1,100.0,0,1,0,1,0,1,0,0,0,2021-2022,0.0,5.0
2870,Burak Yılmaz,TUR,FW,Lille,Ligue 1,36,1985,24.6,7,2,0,2,5,2,17,11.8,15,8,1,7,2,9,11,0,0,2021-2022,0.08130081300813008,0.2845528455284553
2871,Okay Yokuşlu,TUR,"DF,MF",Getafe,La Liga,27,1994,5.2,9,8,6,2,1,5,5,100.0,0,7,5,2,5,14,17,0,0,2021-2022,0.9615384615384615,1.7307692307692306
2872,Okay Yokuşlu,TUR,"DF,MF",Celta Vigo,La Liga,27,1994,1.6,4,1,2,1,1,2,3,66.7,1,2,1,1,2,6,6,0,0,2021-2022,1.25,2.5
2873,Leny Yoro,FRA,MF,Lille,Ligue 1,15,2005,0.1,1,0,0,1,0,0,0,0.0,0,1,0,1,0,1,0,0,0,2021-2022,0.0,10.0
2874,Maya Yoshida,JPN,DF,Sampdoria,Serie A,32,1988,20.3,17,10,8,9,0,8,15,53.3,7,27,20,7,28,45,72,1,0,2021-2022,1.379310344827586,0.8374384236453202
2875,Ashley Young,ENG,"DF,FW",Aston Villa,Premier League,36,1985,13.9,18,6,9,6,3,11,16,68.8,5,10,4,6,13,31,25,1,0,2021-2022,0.935251798561151,1.2949640287769784
Rk,Player,Nation,Pos,Squad,Comp,0,0,90.0,0,0,3,3,3,Tkl,0,0.0,0,0,0,0,0,0,0,0,0,2021-2022,0.0,0.0
2876,Nathan Young-Coombes,ENG,MF,Brentford,Premier League,18,2003,0.0,0,0,0,0,0,0,0,0.0,0,0,0,0,0,0,0,0,0,2021-2022,,
2877,Zaydou Youssouf,FRA,MF,Saint-Étienne,Ligue 1,22,1999,17.3,48,26,21,25,2,14,34,41.2,20,11,3,8,17,65,13,0,0,2021-2022,0.9826589595375722,2.7745664739884393
2878,Mattia Zaccagni,ITA,MF,Hellas Verona,Serie A,26,1995,2.0,3,1,1,0,2,1,2,50.0,1,1,0,1,4,7,0,0,0,2021-2022,2.0,1.5
2879,Mattia Zaccagni,ITA,FW,Lazio,Serie A,26,1995,20.8,33,16,10,13,10,11,19,57.9,8,17,2,15,20,53,5,0,0,2021-2022,0.9615384615384615,1.5865384615384615
2880,Dan-Axel Zagadou,FRA,DF,Dortmund,Bundesliga,22,1999,10.6,13,7,11,1,1,7,10,70.0,3,14,4,10,15,28,38,2,0,2021-2022,1.4150943396226416,1.2264150943396226
2881,Wilfried Zaha,CIV,FW,Crystal Palace,Premier League,28,1992,30.7,40,20,14,15,11,10,31,32.3,21,28,0,28,5,45,5,0,0,2021-2022,0.16286644951140067,1.3029315960912053
2882,Denis Zakaria,SUI,MF,Juventus,Serie A,24,1996,6.6,11,7,3,6,2,3,11,27.3,8,16,3,13,11,22,7,0,0,2021-2022,1.6666666666666667,1.6666666666666667
2883,Denis Zakaria,SUI,"MF,DF",Gladbach,Bundesliga,24,1996,15.5,23,14,9,10,4,12,35,34.3,23,25,5,20,19,42,22,1,0,2021-2022,1.2258064516129032,1.4838709677419355
2884,Joseba Zaldúa,ESP,DF,Real Sociedad,La Liga,29,1992,13.0,31,22,20,8,3,16,22,72.7,6,14,4,10,13,44,35,0,0,2021-2022,1.0,2.3846153846153846
2885,Nicola Zalewski,POL,DF,Roma,Serie A,19,2002,8.8,32,19,17,11,4,21,35,60.0,14,18,1,17,16,48,4,0,0,2021-2022,1.8181818181818181,3.6363636363636362
2886,Andre-Frank Zambo Anguissa,CMR,MF,Napoli,Serie A,25,1995,21.4,50,26,24,17,9,25,51,49.0,26,31,5,26,24,74,33,1,0,2021-2022,1.1214953271028039,2.336448598130841
2887,Nicolò Zaniolo,ITA,"FW,MF",Roma,Serie A,22,1999,21.9,24,15,0,15,9,6,28,21.4,22,19,0,19,7,31,6,0,0,2021-2022,0.31963470319634707,1.0958904109589043
2888,Alessandro Zanoli,ITA,DF,Napoli,Serie A,20,2000,5.1,10,7,6,3,1,3,5,60.0,2,2,1,1,4,14,16,0,0,2021-2022,0.7843137254901962,1.9607843137254903
2889,Mattia Zanotti,ITA,DF,Inter,Serie A,18,2003,0.1,1,0,1,0,0,0,1,0.0,1,0,0,0,0,1,0,0,0,2021-2022,0.0,10.0
2890,Duván Zapata,COL,FW,Atalanta,Serie A,30,1991,19.1,6,2,0,4,2,4,8,50.0,4,8,1,7,3,9,5,0,0,2021-2022,0.15706806282722513,0.31413612565445026
2891,Gabriele Zappa,ITA,DF,Cagliari,Serie A,21,1999,12.7,21,9,12,6,3,6,24,25.0,18,15,5,10,14,35,28,0,0,2021-2022,1.1023622047244095,1.6535433070866143
2892,Davide Zappacosta,ITA,DF,Atalanta,Serie A,29,1992,26.1,32,22,12,13,7,19,37,51.4,18,32,2,30,12,44,22,0,0,2021-2022,0.45977011494252873,1.2260536398467432
2893,Oier Zarraga,ESP,MF,Athletic Club,La Liga,22,1999,13.0,13,5,4,7,2,3,28,10.7,25,17,10,7,19,32,10,0,0,2021-2022,1.4615384615384615,1.0
2894,Simone Zaza,ITA,"FW,DF",Torino,Serie A,30,1991,1.4,2,2,1,1,0,1,1,100.0,0,3,0,3,0,2,3,0,0,2021-2022,0.0,1.4285714285714286
2895,Akim Zedadka,ALG,DF,Clermont Foot,Ligue 1,26,1995,37.1,72,44,34,29,9,37,71,52.1,34,32,8,24,58,130,48,0,0,2021-2022,1.5633423180592991,1.9407008086253368
2896,Deyovaisio Zeefuik,NED,DF,Hertha BSC,Bundesliga,23,1998,6.3,11,10,6,4,1,6,12,50.0,6,12,4,8,11,22,21,1,0,2021-2022,1.746031746031746,1.746031746031746
2897,Marvin Zeegelaar,NED,DF,Udinese,Serie A,30,1990,7.1,15,11,6,8,1,5,14,35.7,9,12,4,8,12,27,22,1,0,2021-2022,1.6901408450704227,2.1126760563380285
2898,Arber Zeneli,KVX,FW,Reims,Ligue 1,26,1995,4.5,1,0,0,0,1,1,5,20.0,4,0,0,0,1,2,1,0,0,2021-2022,0.2222222222222222,0.2222222222222222
2899,Robin Zentner,GER,GK,Mainz 05,Bundesliga,26,1994,32.0,2,2,2,0,0,2,2,100.0,0,0,0,0,2,4,21,1,0,2021-2022,0.0625,0.0625
2900,Andi Zeqiri,SUI,"FW,MF",Augsburg,Bundesliga,22,1999,11.3,14,7,3,5,6,3,12,25.0,9,10,1,9,2,16,12,0,0,2021-2022,0.17699115044247787,1.238938053097345
Rk,Player,Nation,Pos,Squad,Comp,0,0,90.0,0,0,3,3,3,Tkl,0,0.0,0,0,0,0,0,0,0,0,0,2021-2022,0.0,0.0
2901,Mehdi Zerkane,ALG,"MF,DF",Bordeaux,Ligue 1,22,1999,0.9,0,0,0,0,0,0,1,0.0,1,1,1,0,2,2,0,0,0,2021-2022,2.2222222222222223,0.0
2902,Edon Zhegrova,KVX,"MF,FW",Lille,Ligue 1,22,1999,5.3,14,5,2,8,4,5,6,83.3,1,4,1,3,2,16,2,0,0,2021-2022,0.37735849056603776,2.6415094339622645
2903,Luca Zidane,FRA,GK,Rayo Vallecano,La Liga,23,1998,7.2,0,0,0,0,0,0,1,0.0,1,0,0,0,0,0,1,1,0,2021-2022,0.0,0.0
2904,Piotr Zieliński,POL,MF,Napoli,Serie A,27,1994,23.2,19,12,5,9,5,6,21,28.6,15,13,2,11,8,27,4,0,0,2021-2022,0.3448275862068966,0.8189655172413793
2905,David Zima,CZE,DF,Torino,Serie A,20,2000,14.6,20,12,8,11,1,9,20,45.0,11,15,13,2,23,43,42,0,0,2021-2022,1.5753424657534247,1.36986301369863
2906,Christoph Zimmermann,GER,DF,Norwich City,Premier League,28,1993,1.7,6,3,5,1,0,3,4,75.0,1,0,0,0,1,7,4,0,0,2021-2022,0.5882352941176471,3.5294117647058822
2907,Oleksandr Zinchenko,UKR,DF,Manchester City,Premier League,24,1996,11.6,20,14,7,10,3,11,20,55.0,9,11,3,8,14,34,15,1,0,2021-2022,1.206896551724138,1.7241379310344829
2908,Hakim Ziyech,MAR,"MF,FW",Chelsea,Premier League,28,1993,14.7,19,10,5,12,2,10,36,27.8,26,11,1,10,10,29,10,0,0,2021-2022,0.6802721088435374,1.2925170068027212
2909,Jeroen Zoet,NED,GK,Spezia,Serie A,30,1991,7.0,1,0,1,0,0,1,1,100.0,0,0,0,0,0,1,4,0,0,2021-2022,0.0,0.14285714285714285
2910,Simon Zoller,GER,FW,Bochum,Bundesliga,30,1991,6.6,4,2,2,1,1,1,3,33.3,2,3,0,3,4,8,2,0,0,2021-2022,0.6060606060606061,0.6060606060606061
2911,Nadir Zortea,ITA,"DF,MF",Salernitana,Serie A,22,1999,15.7,21,15,9,7,5,11,19,57.9,8,14,2,12,7,28,33,0,0,2021-2022,0.445859872611465,1.337579617834395
2912,Tanguy Zoukrou,FRA,DF,Troyes,Ligue 1,18,2003,0.9,1,0,1,0,0,1,2,50.0,1,0,0,0,0,1,2,0,0,2021-2022,0.0,1.1111111111111112
2913,Kurt Zouma,FRA,DF,West Ham,Premier League,26,1994,23.1,11,6,8,3,0,4,7,57.1,3,31,26,5,34,45,132,0,0,2021-2022,1.4718614718614718,0.47619047619047616
2914,Petar Zovko,BIH,GK,Spezia,Serie A,19,2002,0.3,0,0,0,0,0,0,0,0.0,0,0,0,0,0,0,1,0,0,2021-2022,0.0,0.0
2915,Igor Zubeldia,ESP,DF,Real Sociedad,La Liga,24,1997,18.3,20,10,12,8,0,12,18,66.7,6,16,6,10,27,47,53,0,0,2021-2022,1.4754098360655736,1.0928961748633879
2916,Martín Zubimendi,ESP,MF,Real Sociedad,La Liga,22,1999,28.8,52,25,19,30,3,22,44,50.0,22,30,13,17,49,101,48,1,0,2021-2022,1.7013888888888888,1.8055555555555556
2917,Szymon Żurkowski,POL,MF,Empoli,Serie A,23,1997,25.6,58,33,24,21,13,29,68,42.6,39,43,10,33,35,93,32,1,0,2021-2022,1.3671875,2.265625
2918,Martin Ødegaard,NOR,"MF,FW",Arsenal,Premier League,22,1998,30.9,49,21,6,24,19,22,61,36.1,39,18,1,17,11,60,11,1,0,2021-2022,0.3559870550161812,1.5857605177993528
2919,Milan Đurić,BIH,FW,Salernitana,Serie A,31,1990,24.1,1,1,0,1,0,1,3,33.3,2,6,1,5,2,3,32,0,0,2021-2022,0.08298755186721991,0.04149377593360996
2920,Filip Đuričić,SRB,"MF,FW",Sassuolo,Serie A,29,1992,7.5,13,10,7,1,5,5,13,38.5,8,7,1,6,4,17,1,0,0,2021-2022,0.5333333333333333,1.7333333333333334
1,Brenden Aaronson,USA,"MF,FW",Leeds United,Premier League,21,2000,26.4,45,18,16,22,7,15,46,32.6,31,43,3,40,5,50,6,1,0,2022-2023,0.1893939393939394,1.7045454545454546
2,Paxten Aaronson,USA,"MF,DF",Eint Frankfurt,Bundesliga,18,2003,1.9,6,5,2,2,2,2,3,66.7,1,2,1,1,0,6,2,0,0,2022-2023,0.0,3.1578947368421053
3,James Abankwah,IRL,DF,Udinese,Serie A,18,2004,0.7,1,1,0,1,0,0,0,0.0,0,4,2,2,0,1,5,0,0,2022-2023,0.0,1.4285714285714286
4,George Abbott,ENG,MF,Tottenham,Premier League,16,2005,0.0,0,0,0,0,0,0,0,0.0,0,0,0,0,1,1,0,0,0,2022-2023,inf,
5,Yunis Abdelhamid,MAR,DF,Reims,Ligue 1,34,1987,37.0,82,50,47,33,2,39,52,75.0,13,65,27,38,64,146,116,1,0,2022-2023,1.7297297297297298,2.2162162162162162
6,Himad Abdelli,ALG,"MF,FW",Angers,Ligue 1,22,1999,23.7,64,38,22,32,10,31,67,46.3,36,30,1,29,28,92,15,0,0,2022-2023,1.1814345991561181,2.70042194092827
7,Salis Abdul Samed,GHA,MF,Lens,Ligue 1,22,2000,32.2,46,26,18,23,5,29,52,55.8,23,38,9,29,36,82,26,0,0,2022-2023,1.1180124223602483,1.4285714285714284
8,Laurent Abergel,FRA,MF,Lorient,Ligue 1,29,1993,26.0,92,52,59,30,3,39,92,42.4,53,47,8,39,34,126,39,0,0,2022-2023,1.3076923076923077,3.5384615384615383
9,Oliver Abildgaard,DEN,MF,Hellas Verona,Serie A,26,1996,6.6,10,6,6,3,1,7,16,43.8,9,7,1,6,5,15,17,0,0,2022-2023,0.7575757575757576,1.5151515151515151
10,Matthis Abline,FRA,"FW,MF",Auxerre,Ligue 1,19,2003,9.0,4,2,0,3,1,0,5,0.0,5,6,1,5,1,5,1,0,0,2022-2023,0.1111111111111111,0.4444444444444444
11,Matthis Abline,FRA,"FW,MF",Rennes,Ligue 1,19,2003,1.2,1,1,0,0,1,1,1,100.0,0,1,0,1,2,3,1,0,0,2022-2023,1.6666666666666667,0.8333333333333334
12,Abner,BRA,DF,Betis,La Liga,22,2000,6.7,12,9,9,2,1,7,16,43.8,9,8,2,6,8,20,24,0,0,2022-2023,1.1940298507462686,1.791044776119403
13,Zakaria Aboukhlal,MAR,"FW,MF",Toulouse,Ligue 1,22,2000,27.5,33,23,13,9,11,14,45,31.1,31,18,1,17,22,55,23,0,0,2022-2023,0.8,1.2
14,Tammy Abraham,ENG,FW,Roma,Serie A,24,1997,24.3,17,10,4,8,5,3,16,18.8,13,10,4,6,3,20,14,0,0,2022-2023,0.12345679012345678,0.6995884773662551
15,Christian Acella,ITA,MF,Cremonese,Serie A,20,2002,0.2,1,0,1,0,0,0,2,0.0,2,0,0,0,0,1,0,0,0,2022-2023,0.0,5.0
16,Francesco Acerbi,ITA,DF,Inter,Serie A,34,1988,26.9,33,19,22,7,4,20,27,74.1,7,25,18,7,41,74,85,2,0,2022-2023,1.5241635687732342,1.2267657992565058
17,Álvaro Aceves,ESP,GK,Valladolid,La Liga,19,2003,0.1,0,0,0,0,0,0,0,0.0,0,0,0,0,0,0,0,0,0,2022-2023,0.0,0.0
18,Mohamed Achi,FRA,FW,Nantes,Ligue 1,20,2002,0.4,1,1,1,0,0,1,1,100.0,0,0,0,0,0,1,0,0,0,2022-2023,0.0,2.5
19,Marcos Acuña,ARG,DF,Sevilla,La Liga,30,1991,21.2,57,36,34,17,6,30,42,71.4,12,16,5,11,23,80,36,0,0,2022-2023,1.0849056603773586,2.688679245283019
20,Che Adams,SCO,FW,Southampton,Premier League,26,1996,22.1,17,13,7,8,2,7,12,58.3,5,13,4,9,4,21,22,0,0,2022-2023,0.18099547511312217,0.7692307692307692
21,Tyler Adams,USA,MF,Leeds United,Premier League,23,1999,24.0,89,46,44,35,10,50,77,64.9,27,48,8,40,35,124,29,0,0,2022-2023,1.4583333333333333,3.7083333333333335
22,Sargis Adamyan,ARM,"FW,MF",Köln,Bundesliga,29,1993,7.2,14,7,5,3,6,7,17,41.2,10,12,0,12,4,18,5,0,0,2022-2023,0.5555555555555556,1.9444444444444444
23,Tosin Adarabioyo,ENG,DF,Fulham,Premier League,24,1997,23.2,30,13,22,6,2,16,23,69.6,7,20,15,5,26,56,140,1,0,2022-2023,1.120689655172414,1.293103448275862
24,Martin Adeline,FRA,"MF,FW",Reims,Ligue 1,18,2003,1.2,3,3,2,1,0,3,4,75.0,1,3,1,2,3,6,3,0,0,2022-2023,2.5,2.5
25,Karim Adeyemi,GER,"FW,MF",Dortmund,Bundesliga,20,2002,15.4,16,11,6,6,4,8,30,26.7,22,18,1,17,7,23,3,0,0,2022-2023,0.45454545454545453,1.0389610389610389
Rk,Player,Nation,Pos,Squad,Comp,0,0,90.0,0,0,3,3,3,Tkl,0,0.0,0,0,0,0,0,0,0,0,0,2022-2023,0.0,0.0
26,Amine Adli,MAR,"FW,MF",Leverkusen,Bundesliga,22,2000,15.9,18,10,4,6,8,5,17,29.4,12,28,2,26,6,24,7,0,0,2022-2023,0.3773584905660377,1.1320754716981132
27,Yacine Adli,FRA,"MF,FW",Milan,Serie A,22,2000,1.6,6,3,2,4,0,2,2,100.0,0,2,0,2,1,7,1,0,0,2022-2023,0.625,3.75
28,Michel Aebischer,SUI,"FW,MF",Bologna,Serie A,25,1997,17.1,12,6,3,6,3,2,18,11.1,16,14,2,12,7,19,9,0,0,2022-2023,0.4093567251461988,0.7017543859649122
29,Felix Afena-Gyan,GHA,"FW,MF",Cremonese,Serie A,19,2003,9.1,7,3,4,1,2,2,10,20.0,8,5,1,4,1,8,6,0,0,2022-2023,0.10989010989010989,0.7692307692307693
30,Emmanuel Agbadou,CIV,DF,Reims,Ligue 1,25,1997,26.5,71,49,53,16,2,42,65,64.6,23,30,14,16,32,103,107,3,0,2022-2023,1.2075471698113207,2.6792452830188678
31,Julen Agirrezabala,ESP,GK,Athletic Club,La Liga,21,2000,7.5,0,0,0,0,0,0,0,0.0,0,0,0,0,0,0,2,0,0,2022-2023,0.0,0.0
32,Lucien Agoume,FRA,MF,Troyes,Ligue 1,20,2002,12.2,42,25,18,15,9,17,33,51.5,16,14,5,9,27,69,24,0,0,2022-2023,2.2131147540983607,3.4426229508196724
33,Felix Agu,GER,"DF,FW",Werder Bremen,Bundesliga,22,1999,0.5,1,0,0,1,0,0,0,0.0,0,1,1,0,0,1,0,0,0,2022-2023,0.0,2.0
34,Álvaro Aguado,ESP,MF,Valladolid,La Liga,26,1996,21.0,27,15,13,11,3,15,25,60.0,10,16,4,12,13,40,15,0,0,2022-2023,0.6190476190476191,1.2857142857142858
35,Kevin Agudelo,COL,"MF,FW",Spezia,Serie A,23,1998,23.7,71,38,22,30,19,25,59,42.4,34,39,5,34,10,81,6,0,0,2022-2023,0.4219409282700422,2.9957805907173
36,Nayef Aguerd,MAR,DF,West Ham,Premier League,26,1996,17.7,27,18,18,8,1,13,20,65.0,7,26,24,2,18,45,79,2,0,2022-2023,1.0169491525423728,1.5254237288135595
37,Ruben Aguilar,FRA,DF,Monaco,Ligue 1,29,1993,13.0,19,9,7,7,5,8,22,36.4,14,13,1,12,18,37,28,1,0,2022-2023,1.3846153846153846,1.4615384615384615
38,Naouirou Ahamada,FRA,"MF,FW",Crystal Palace,Premier League,20,2002,1.0,3,2,3,0,0,1,3,33.3,2,2,0,2,0,3,0,0,0,2022-2023,0.0,3.0
39,Naouirou Ahamada,FRA,MF,Stuttgart,Bundesliga,20,2002,15.5,17,11,7,7,3,8,20,40.0,12,16,5,11,8,25,7,0,0,2022-2023,0.5161290322580645,1.096774193548387
40,Amar Ahmed,SWE,FW,Troyes,Ligue 1,18,2004,0.2,1,1,0,1,0,0,1,0.0,1,0,0,0,1,2,0,0,0,2022-2023,5.0,5.0
41,Jean-Eudes Aholou,CIV,MF,Strasbourg,Ligue 1,28,1994,14.4,34,20,10,20,4,12,31,38.7,19,25,0,25,24,58,15,0,0,2022-2023,1.6666666666666665,2.361111111111111
42,Joseph Aidoo,GHA,DF,Celta Vigo,La Liga,26,1995,34.7,51,36,33,17,1,16,28,57.1,12,26,14,12,31,82,150,0,0,2022-2023,0.893371757925072,1.4697406340057635
43,Ola Aina,NGA,DF,Torino,Serie A,25,1996,9.7,17,13,5,8,4,9,15,60.0,6,12,2,10,11,28,26,0,0,2022-2023,1.1340206185567012,1.752577319587629
44,Rayan Aït-Nouri,ALG,DF,Wolves,Premier League,21,2001,12.0,33,20,25,7,1,9,16,56.3,7,3,0,3,9,42,28,0,0,2022-2023,0.75,2.75
45,Emanuel Aiwum,AUT,DF,Cremonese,Serie A,21,2000,18.4,55,34,36,17,2,33,47,70.2,14,28,16,12,25,80,52,3,0,2022-2023,1.358695652173913,2.989130434782609
46,Kristoffer Ajer,NOR,DF,Brentford,Premier League,24,1998,8.5,11,8,5,4,2,9,16,56.3,7,6,5,1,7,18,22,0,0,2022-2023,0.8235294117647058,1.2941176470588236
47,Ludovic Ajorque,FRA,FW,Strasbourg,Ligue 1,28,1994,8.6,5,4,1,4,0,3,9,33.3,6,3,1,2,2,7,7,0,0,2022-2023,0.23255813953488372,0.5813953488372093
48,Ludovic Ajorque,FRA,"FW,MF",Mainz 05,Bundesliga,28,1994,13.5,6,5,1,4,1,1,9,11.1,8,8,2,6,1,7,8,0,0,2022-2023,0.07407407407407407,0.4444444444444444
49,Manuel Akanji,SUI,DF,Manchester City,Premier League,27,1995,25.4,36,25,15,18,3,23,36,63.9,13,27,9,18,16,52,33,1,0,2022-2023,0.6299212598425197,1.4173228346456694
50,Nathan Aké,NED,DF,Manchester City,Premier League,27,1995,20.8,26,12,15,9,2,11,15,73.3,4,20,10,10,20,46,48,0,0,2022-2023,0.9615384615384615,1.25
Rk,Player,Nation,Pos,Squad,Comp,0,0,90.0,0,0,3,3,3,Tkl,0,0.0,0,0,0,0,0,0,0,0,0,2022-2023,0.0,0.0
51,Sergio Akieme,ESP,DF,Almería,La Liga,24,1997,25.5,27,16,19,6,2,12,22,54.5,10,22,6,16,14,41,41,0,0,2022-2023,0.5490196078431373,1.0588235294117647
52,Babatunde Akinsola,NGA,FW,Valladolid,La Liga,19,2003,0.1,1,1,0,0,1,0,0,0.0,0,0,0,0,0,1,0,0,0,2022-2023,0.0,10.0
53,Maghnes Akliouche,FRA,"MF,FW",Monaco,Ligue 1,20,2002,4.5,7,4,4,3,0,2,8,25.0,6,2,0,2,3,10,2,0,0,2022-2023,0.6666666666666666,1.5555555555555556
54,Paul Akouokou,CIV,"MF,DF",Betis,La Liga,24,1997,5.0,16,9,13,3,0,13,20,65.0,7,2,2,0,12,28,17,1,0,2022-2023,2.4,3.2
55,Jean-Daniel Akpa-Akpro,CIV,"MF,FW",Empoli,Serie A,29,1992,15.1,53,37,25,19,9,23,42,54.8,19,35,4,31,13,66,27,0,0,2022-2023,0.8609271523178809,3.5099337748344372
56,Kevin Akpoguma,NGA,DF,Hoffenheim,Bundesliga,27,1995,21.7,75,44,45,27,3,32,45,71.1,13,45,16,29,24,99,70,1,0,2022-2023,1.1059907834101383,3.456221198156682
57,David Alaba,AUT,DF,Real Madrid,La Liga,30,1992,20.4,15,11,8,4,3,9,15,60.0,6,18,9,9,14,29,37,1,0,2022-2023,0.6862745098039216,0.7352941176470589
58,Ángel Alarcón,ESP,FW,Barcelona,La Liga,18,2004,0.3,0,0,0,0,0,,0,0.0,0,0,0,0,0,0,0,0,0,2022-2023,0.0,0.0
59,Tomás Alarcón,CHI,MF,Cádiz,La Liga,23,1999,2.5,3,2,0,2,1,1,2,50.0,1,1,0,1,2,5,2,0,0,2022-2023,0.8,1.2
60,Lucas Alario,ARG,"FW,MF",Eint Frankfurt,Bundesliga,29,1992,3.7,3,2,1,0,2,0,1,0.0,1,0,0,0,2,5,13,0,0,2022-2023,0.5405405405405405,0.8108108108108107
61,Jordi Alba,ESP,DF,Barcelona,La Liga,33,1989,15.8,25,18,13,11,1,12,28,42.9,16,12,5,7,11,36,23,0,0,2022-2023,0.6962025316455696,1.5822784810126582
62,Luis Alberto,ESP,MF,Lazio,Serie A,29,1992,27.1,49,29,18,20,11,23,72,31.9,49,35,6,29,9,58,4,0,0,2022-2023,0.33210332103321033,1.8081180811808117
63,Raúl Albiol,ESP,DF,Villarreal,La Liga,36,1985,23.5,25,17,17,6,2,14,18,77.8,4,17,13,4,14,39,111,0,0,2022-2023,0.5957446808510638,1.0638297872340425
64,Marc Albrighton,ENG,"FW,MF",Leicester City,Premier League,32,1989,2.6,4,1,0,2,2,1,8,12.5,7,6,2,4,1,5,5,0,0,2022-2023,0.3846153846153846,1.5384615384615383
65,Thiago Alcántara,ESP,MF,Liverpool,Premier League,31,1991,13.9,43,24,20,21,2,14,23,60.9,9,15,3,12,21,64,13,2,0,2022-2023,1.5107913669064748,3.093525179856115
66,Carlos Alcaraz,ARG,"MF,FW",Southampton,Premier League,19,2002,11.4,10,5,2,7,1,6,22,27.3,16,14,5,9,1,11,11,0,0,2022-2023,0.08771929824561403,0.8771929824561403
67,Rubén Alcaraz,ESP,MF,Cádiz,La Liga,31,1991,22.7,43,31,24,18,1,19,54,35.2,35,23,8,15,19,62,37,0,0,2022-2023,0.8370044052863437,1.894273127753304
68,Omar Alderete,PAR,DF,Getafe,La Liga,25,1996,22.7,35,20,21,14,0,28,40,70.0,12,23,16,7,26,61,85,0,0,2022-2023,1.145374449339207,1.5418502202643172
69,Iván Alejo,ESP,"MF,FW",Cádiz,La Liga,27,1995,14.6,32,21,19,9,4,17,37,45.9,20,18,3,15,5,37,12,1,0,2022-2023,0.3424657534246575,2.191780821917808
70,Doğan Alemdar,TUR,GK,Rennes,Ligue 1,19,2002,4.5,0,0,0,0,0,0,0,0.0,0,0,0,0,0,0,1,1,0,2022-2023,0.0,0.0
71,Carles Aleñá,ESP,"MF,FW",Getafe,La Liga,24,1998,23.5,18,10,7,5,6,5,34,14.7,29,19,1,18,4,22,18,0,0,2022-2023,0.1702127659574468,0.7659574468085106
72,Trent Alexander-Arnold,ENG,DF,Liverpool,Premier League,23,1998,32.5,57,40,32,16,9,42,80,52.5,38,25,7,18,43,100,41,2,0,2022-2023,1.323076923076923,1.7538461538461538
73,Alejandro Alfaro,ESP,MF,Elche,La Liga,20,2002,0.2,0,0,0,0,0,0,0,0.0,0,0,0,0,0,0,0,0,0,2022-2023,0.0,0.0
74,Ángel Algobia,ESP,MF,Getafe,La Liga,23,1999,12.6,27,13,14,13,0,22,48,45.8,26,15,5,10,3,30,11,0,0,2022-2023,0.2380952380952381,2.142857142857143
75,Mohamed Ali Cho,FRA,"FW,MF",Real Sociedad,La Liga,18,2004,6.5,13,10,6,5,2,4,10,40.0,6,9,0,9,2,15,2,0,0,2022-2023,0.3076923076923077,2.0
Rk,Player,Nation,Pos,Squad,Comp,0,0,90.0,0,0,3,3,3,Tkl,0,0.0,0,0,0,0,0,0,0,0,0,2022-2023,0.0,0.0
76,Faride Alidou,GER,"DF,MF",Eint Frankfurt,Bundesliga,21,2001,2.0,8,5,3,4,1,3,9,33.3,6,3,0,3,1,9,3,0,0,2022-2023,0.5,4.0
77,Alisson,BRA,GK,Liverpool,Premier League,29,1992,37.0,0,0,0,0,0,0,3,0.0,3,3,0,3,0,0,20,0,0,2022-2023,0.0,0.0
78,Jim Allevinah,GAB,"DF,FW",Clermont Foot,Ligue 1,27,1995,24.9,39,24,24,11,4,19,62,30.6,43,24,2,22,24,63,26,1,0,2022-2023,0.9638554216867471,1.566265060240964
79,Dele Alli,ENG,MF,Everton,Premier League,26,1996,0.4,0,0,0,0,0,0,0,0.0,0,0,0,0,0,0,0,0,0,2022-2023,0.0,0.0
80,Domingos André Ribeiro Almeida,POR,MF,Valencia,La Liga,22,2000,28.2,66,42,23,32,11,26,57,45.6,31,26,0,26,20,86,16,1,0,2022-2023,0.7092198581560284,2.3404255319148937
81,Miguel Almirón,PAR,FW,Newcastle Utd,Premier League,28,1994,27.7,46,30,16,19,11,18,42,42.9,24,25,2,23,10,56,17,0,0,2022-2023,0.36101083032490977,1.660649819494585
82,Marcos Alonso,ESP,DF,Barcelona,La Liga,31,1990,13.0,15,10,10,5,0,9,12,75.0,3,14,10,4,11,26,32,0,0,2022-2023,0.8461538461538461,1.1538461538461537
83,Mickaël Alphonse,GLP,DF,Ajaccio,Ligue 1,33,1989,15.1,35,23,20,11,4,20,33,60.6,13,17,5,12,35,70,44,1,0,2022-2023,2.3178807947019866,2.3178807947019866
84,Éder Álvarez Balanta,COL,"MF,FW",Schalke 04,Bundesliga,29,1993,2.6,5,4,2,3,0,2,6,33.3,4,0,0,0,3,8,4,0,0,2022-2023,1.1538461538461537,1.923076923076923
85,Carlos Álvarez,ESP,MF,Sevilla,La Liga,18,2003,0.1,1,1,0,1,0,0,0,0.0,0,0,0,0,0,1,0,0,0,2022-2023,0.0,10.0
86,Gastón Álvarez,URU,DF,Getafe,La Liga,22,2000,16.7,38,30,24,9,5,23,42,54.8,19,15,5,10,15,53,35,0,0,2022-2023,0.8982035928143713,2.2754491017964074
87,Julián Álvarez,ARG,"FW,MF",Manchester City,Premier League,22,2000,16.3,26,16,3,13,10,9,30,30.0,21,13,0,13,2,28,6,0,0,2022-2023,0.12269938650306748,1.5950920245398772
88,Agustín Álvarez Martínez,URU,"FW,MF",Sassuolo,Serie A,21,2001,4.1,6,3,0,5,1,1,4,25.0,3,5,1,4,3,9,3,0,0,2022-2023,0.7317073170731708,1.4634146341463417
89,Yeray Álvarez,ESP,DF,Athletic Club,La Liga,27,1995,25.9,34,23,26,7,1,24,31,77.4,7,23,13,10,48,82,101,0,0,2022-2023,1.8532818532818534,1.3127413127413128
90,Ibrahim Amadou,FRA,"DF,MF",Angers,Ligue 1,29,1993,4.7,10,7,6,3,1,7,11,63.6,4,7,3,4,10,20,20,0,0,2022-2023,2.127659574468085,2.127659574468085
91,Selim Amallah,MAR,"MF,FW",Valladolid,La Liga,25,1996,3.0,15,9,7,8,0,5,8,62.5,3,2,0,2,5,20,2,0,0,2022-2023,1.6666666666666667,5.0
92,Daniel Amartey,GHA,DF,Leicester City,Premier League,27,1994,17.9,19,8,13,5,1,12,14,85.7,2,24,17,7,8,27,71,0,0,2022-2023,0.446927374301676,1.0614525139664805
93,Amath,SEN,"MF,FW",Mallorca,La Liga,26,1996,13.6,29,19,14,8,7,14,22,63.6,8,13,1,12,5,34,5,0,0,2022-2023,0.36764705882352944,2.1323529411764706
94,Jordan Amavi,FRA,DF,Getafe,La Liga,28,1994,2.2,3,2,3,0,0,1,3,33.3,2,3,0,3,4,7,7,0,0,2022-2023,1.8181818181818181,1.3636363636363635
95,Lukáš Ambros,CZE,MF,Wolfsburg,Bundesliga,18,2004,0.2,1,0,1,0,0,1,4,25.0,3,1,0,1,0,1,2,1,0,2022-2023,0.0,5.0
96,Kelvin Amian,FRA,DF,Spezia,Serie A,24,1998,26.4,54,32,33,12,9,24,31,77.4,7,34,12,22,22,76,87,1,0,2022-2023,0.8333333333333334,2.0454545454545454
97,Bruno Amione,ARG,DF,Hellas Verona,Serie A,20,2002,0.6,1,1,1,0,0,1,2,50.0,1,1,0,1,0,1,4,0,0,2022-2023,0.0,1.6666666666666667
98,Bruno Amione,ARG,DF,Sampdoria,Serie A,20,2002,23.2,50,33,36,14,0,19,43,44.2,24,26,11,15,25,75,62,1,0,2022-2023,1.0775862068965518,2.1551724137931036
99,Nadiem Amiri,GER,"MF,FW",Leverkusen,Bundesliga,25,1996,10.9,15,6,5,8,2,9,20,45.0,11,12,1,11,6,21,10,2,0,2022-2023,0.5504587155963303,1.3761467889908257
100,Samuel Amo-Ameyaw,ENG,MF,Southampton,Premier League,16,2006,0.0,0,0,0,0,0,0,1,0.0,1,0,0,0,0,0,0,0,0,2022-2023,,
Rk,Player,Nation,Pos,Squad,Comp,0,0,90.0,0,0,3,3,3,Tkl,0,0.0,0,0,0,0,0,0,0,0,0,2022-2023,0.0,0.0
101,Ethan Ampadu,WAL,"DF,MF",Spezia,Serie A,21,2000,29.3,66,37,33,28,5,17,41,41.5,24,48,23,25,36,102,98,0,0,2022-2023,1.2286689419795223,2.252559726962457
102,Sofyan Amrabat,MAR,MF,Fiorentina,Serie A,25,1996,22.2,39,24,15,17,7,16,29,55.2,13,23,5,18,21,60,18,2,0,2022-2023,0.9459459459459459,1.7567567567567568
103,Ayoub Amraoui,MAR,"DF,FW",Nice,Ligue 1,18,2004,3.3,6,5,3,3,0,2,5,40.0,3,1,0,1,4,10,4,0,0,2022-2023,1.2121212121212122,1.8181818181818183
104,Joachim Andersen,DEN,DF,Crystal Palace,Premier League,26,1996,30.9,42,22,30,12,0,16,32,50.0,16,28,13,15,24,66,188,1,0,2022-2023,0.7766990291262136,1.3592233009708738
105,Elliot Anderson,SCO,"MF,FW",Newcastle Utd,Premier League,19,2002,4.6,11,5,5,3,3,6,12,50.0,6,11,2,9,6,17,2,0,0,2022-2023,1.3043478260869565,2.3913043478260874
106,Felipe Anderson,BRA,FW,Lazio,Serie A,29,1993,32.9,80,50,31,41,8,31,88,35.2,57,58,6,52,31,111,27,0,0,2022-2023,0.9422492401215806,2.43161094224924
107,Benjamin André,FRA,MF,Lille,Ligue 1,31,1990,32.4,128,74,51,60,17,65,121,53.7,56,50,8,42,47,175,60,0,0,2022-2023,1.4506172839506173,3.9506172839506175
108,Marcos André,BRA,"FW,MF",Valencia,La Liga,25,1996,5.0,4,1,1,1,2,1,2,50.0,1,4,1,3,0,4,0,0,0,2022-2023,0.0,0.8
109,Komnen Andrić,SRB,FW,Clermont Foot,Ligue 1,27,1995,16.1,13,5,2,7,4,2,15,13.3,13,8,1,7,8,21,13,0,0,2022-2023,0.49689440993788814,0.8074534161490683
110,Robert Andrich,GER,MF,Leverkusen,Bundesliga,27,1994,26.7,61,38,30,27,4,26,45,57.8,19,27,9,18,42,103,55,2,0,2022-2023,1.5730337078651686,2.2846441947565546
111,Angeliño,ESP,DF,Hoffenheim,Bundesliga,25,1997,29.1,40,24,19,18,3,23,37,62.2,14,32,6,26,25,65,67,0,0,2022-2023,0.8591065292096219,1.3745704467353952
112,Fabrizio Angileri,ARG,DF,Getafe,La Liga,28,1994,6.5,12,9,8,3,1,10,17,58.8,7,8,3,5,7,19,10,0,0,2022-2023,1.0769230769230769,1.8461538461538463
113,Jaidon Anthony,ENG,"MF,FW",Bournemouth,Premier League,22,1999,14.0,30,17,15,9,6,8,24,33.3,16,30,3,27,10,40,19,0,0,2022-2023,0.7142857142857143,2.142857142857143
114,Janis Antiste,FRA,FW,Sassuolo,Serie A,19,2002,0.6,1,0,1,0,0,1,1,100.0,0,0,0,0,0,1,0,0,0,2022-2023,0.0,1.6666666666666667
115,Waldemar Anton,GER,DF,Stuttgart,Bundesliga,26,1996,32.6,49,27,27,19,3,27,51,52.9,24,44,16,28,38,87,123,2,0,2022-2023,1.165644171779141,1.5030674846625767
116,Josep Antoni Gayá,ESP,"DF,MF",Mallorca,La Liga,22,2000,1.1,0,0,0,0,0,0,0,0.0,0,4,2,2,1,1,6,0,0,2022-2023,0.9090909090909091,0.0
117,José Antonio,ESP,"MF,DF",Cádiz,La Liga,18,2004,0.5,2,1,0,0,2,0,0,0.0,0,0,0,0,0,2,0,0,0,2022-2023,0.0,4.0
118,Marcos Antônio,BRA,MF,Lazio,Serie A,22,2000,6.6,9,6,4,5,0,9,20,45.0,11,7,2,5,11,20,18,0,0,2022-2023,1.6666666666666667,1.3636363636363638
119,Michail Antonio,JAM,FW,West Ham,Premier League,32,1990,20.3,14,7,1,8,5,3,12,25.0,9,13,5,8,5,19,9,0,0,2022-2023,0.24630541871921183,0.689655172413793
120,Antony,BRA,FW,Manchester Utd,Premier League,22,2000,20.0,22,9,9,9,4,8,28,28.6,20,18,0,18,11,33,6,0,0,2022-2023,0.55,1.1
121,Valentin Antov,BUL,DF,Monza,Serie A,21,2000,3.4,6,5,3,3,0,1,5,20.0,4,5,4,1,4,10,14,1,0,2022-2023,1.1764705882352942,1.7647058823529411
122,Christopher Antwi-Adjei,GHA,"FW,MF",Bochum,Bundesliga,28,1994,22.0,23,15,7,8,8,10,29,34.5,19,17,0,17,5,28,16,0,0,2022-2023,0.22727272727272727,1.0454545454545454
123,Anuar,MAR,"MF,FW",Valladolid,La Liga,27,1995,2.3,4,4,0,1,3,0,0,0.0,0,5,2,3,3,7,3,0,0,2022-2023,1.3043478260869565,1.7391304347826089
124,Houssem Aouar,ALG,MF,Lyon,Ligue 1,24,1998,5.8,12,5,5,5,2,3,9,33.3,6,12,2,10,8,20,3,0,0,2022-2023,1.3793103448275863,2.0689655172413794
125,Adil Aouchiche,FRA,MF,Lorient,Ligue 1,20,2002,2.8,5,2,3,1,1,1,9,11.1,8,1,0,1,4,9,1,0,0,2022-2023,1.4285714285714286,1.7857142857142858
Rk,Player,Nation,Pos,Squad,Comp,0,0,90.0,0,0,3,3,3,Tkl,0,0.0,0,0,0,0,0,0,0,0,0,2022-2023,0.0,0.0
126,Dennis Appiah,FRA,"DF,MF",Nantes,Ligue 1,30,1992,8.8,21,11,14,7,0,10,27,37.0,17,13,5,8,10,31,16,0,0,2022-2023,1.1363636363636362,2.3863636363636362
127,Stredair Appuah,FRA,"DF,MF",Nantes,Ligue 1,18,2004,0.7,2,1,0,2,0,0,0,0.0,0,2,0,2,1,3,0,0,0,2022-2023,1.4285714285714286,2.857142857142857
128,Mauro Arambarri,URU,MF,Getafe,La Liga,26,1995,11.0,14,6,9,4,1,3,17,17.6,14,17,5,12,14,28,19,0,0,2022-2023,1.2727272727272727,1.2727272727272727
129,Charles Aránguiz,CHI,MF,Leverkusen,Bundesliga,33,1989,5.5,17,7,7,10,0,12,20,60.0,8,4,0,4,7,24,4,0,0,2022-2023,1.2727272727272727,3.090909090909091
130,Ronald Araújo,URU,DF,Barcelona,La Liga,23,1999,20.0,26,18,12,13,1,6,9,66.7,3,15,7,8,12,38,41,1,0,2022-2023,0.6,1.3
131,Cameron Archer,ENG,"FW,MF",Aston Villa,Premier League,21,2001,0.5,0,0,0,0,0,0,0,0.0,0,0,0,0,0,0,0,0,0,2022-2023,0.0,0.0
132,Taïryk Arconte,FRA,FW,Brest,Ligue 1,18,2003,1.4,1,1,0,0,1,0,3,0.0,3,1,0,1,0,1,2,0,0,2022-2023,0.0,0.7142857142857143
133,Alphonse Areola,FRA,GK,West Ham,Premier League,29,1993,3.4,0,0,0,0,0,0,0,0.0,0,0,0,0,0,0,0,0,0,2022-2023,0.0,0.0
134,Adu Ares,ESP,"FW,MF",Athletic Club,La Liga,20,2001,0.9,4,2,2,1,1,4,4,100.0,0,1,0,1,2,6,1,0,0,2022-2023,2.2222222222222223,4.444444444444445
135,Joe Aribo,NGA,"MF,FW",Southampton,Premier League,26,1996,13.6,31,20,15,12,4,11,20,55.0,9,14,1,13,10,41,11,0,0,2022-2023,0.7352941176470589,2.2794117647058822
136,Adam Armstrong,ENG,"FW,MF",Southampton,Premier League,25,1997,14.8,14,9,6,5,3,3,10,30.0,7,15,3,12,5,19,6,0,0,2022-2023,0.33783783783783783,0.9459459459459459
137,Stuart Armstrong,SCO,"MF,FW",Southampton,Premier League,30,1992,15.6,32,21,15,13,4,14,39,35.9,25,18,0,18,10,42,9,2,0,2022-2023,0.6410256410256411,2.0512820512820515
138,Marko Arnautović,AUT,FW,Bologna,Serie A,33,1989,17.0,9,6,2,5,2,1,6,16.7,5,11,1,10,2,11,10,0,0,2022-2023,0.11764705882352941,0.5294117647058824
139,Maximilian Arnold,GER,MF,Wolfsburg,Bundesliga,28,1994,30.7,62,31,25,28,9,28,54,51.9,26,34,11,23,26,88,65,2,0,2022-2023,0.8469055374592834,2.019543973941368
140,Mohamed El Arouch,FRA,MF,Lyon,Ligue 1,18,2004,0.0,1,1,1,0,0,0,0,0.0,0,0,0,0,0,1,0,0,0,2022-2023,,inf
141,Sergio Arribas,ESP,"MF,FW",Real Madrid,La Liga,20,2001,0.2,0,0,0,0,0,0,0,0.0,0,1,0,1,0,0,0,0,0,2022-2023,0.0,0.0
142,Kepa Arrizabalaga,ESP,GK,Chelsea,Premier League,27,1994,28.5,2,2,2,0,0,2,3,66.7,1,0,0,0,1,3,16,2,0,2022-2023,0.03508771929824561,0.07017543859649122
143,Roberto Arroyo,ESP,MF,Valladolid,La Liga,18,2003,0.2,1,1,0,1,0,1,1,100.0,0,0,0,0,0,1,0,0,0,2022-2023,0.0,5.0
144,Tolgay Arslan,GER,MF,Udinese,Serie A,31,1990,13.5,29,18,13,15,1,14,39,35.9,25,19,0,19,12,41,9,1,0,2022-2023,0.8888888888888888,2.1481481481481484
145,Ricard Artero,ESP,"MF,FW",Girona,La Liga,19,2003,1.5,3,3,2,1,0,1,1,100.0,0,2,0,2,1,4,3,0,0,2022-2023,0.6666666666666666,2.0
146,Santiago Arzamendia,PAR,"DF,MF",Cádiz,La Liga,24,1998,5.4,9,8,7,1,1,6,21,28.6,15,11,1,10,2,11,15,1,0,2022-2023,0.37037037037037035,1.6666666666666665
147,Takuma Asano,JPN,"FW,MF",Bochum,Bundesliga,27,1994,19.0,14,9,4,4,6,7,16,43.8,9,17,1,16,8,22,8,0,0,2022-2023,0.42105263157894735,0.7368421052631579
148,Santiago Ascacíbar,ARG,MF,Cremonese,Serie A,25,1997,8.1,29,14,17,10,2,14,35,40.0,21,14,2,12,13,42,11,0,0,2022-2023,1.6049382716049383,3.5802469135802473
149,Sergio Asenjo,ESP,GK,Valladolid,La Liga,33,1989,10.0,0,0,0,0,0,0,0,0.0,0,0,0,0,0,0,10,2,0,2022-2023,0.0,0.0
150,Marco Asensio,ESP,"FW,MF",Real Madrid,La Liga,26,1996,16.0,16,10,8,6,2,8,19,42.1,11,8,3,5,5,21,4,0,0,2022-2023,0.3125,1.0
Rk,Player,Nation,Pos,Squad,Comp,0,0,90.0,0,0,3,3,3,Tkl,0,0.0,0,0,0,0,0,0,0,0,0,2022-2023,0.0,0.0
151,Kristoffer Askildsen,NOR,MF,Lecce,Serie A,21,2001,8.1,7,3,2,3,2,4,10,40.0,6,15,4,11,11,18,6,0,0,2022-2023,1.3580246913580247,0.8641975308641976
152,Fisnik Asllani,KVX,FW,Hoffenheim,Bundesliga,19,2002,1.9,0,0,0,0,0,0,4,0.0,4,2,0,2,3,3,3,0,0,2022-2023,1.5789473684210527,0.0
153,Kristjan Asllani,ALB,MF,Inter,Serie A,20,2002,6.6,11,5,1,8,2,7,10,70.0,3,3,1,2,6,17,4,0,0,2022-2023,0.9090909090909092,1.6666666666666667
154,Iago Aspas,ESP,FW,Celta Vigo,La Liga,34,1987,31.9,8,4,0,4,4,3,22,13.6,19,10,1,9,7,15,23,0,0,2022-2023,0.219435736677116,0.25078369905956116
155,Lorenz Assignon,TOG,DF,Rennes,Ligue 1,22,2000,2.9,6,2,4,2,0,2,4,50.0,2,6,0,6,2,8,9,0,0,2022-2023,0.6896551724137931,2.0689655172413794
156,Youcef Atal,ALG,"DF,MF",Nice,Ligue 1,26,1996,8.7,38,22,18,15,5,23,32,71.9,9,9,0,9,14,52,13,0,0,2022-2023,1.6091954022988506,4.367816091954023
157,Valentin Atangana Edoa,FRA,MF,Reims,Ligue 1,16,2005,1.9,8,3,4,2,2,3,6,50.0,3,2,1,1,0,8,1,0,0,2022-2023,0.0,4.2105263157894735
158,Pierre-Emerick Aubameyang,GAB,FW,Chelsea,Premier League,33,1989,6.2,1,0,1,0,0,0,1,0.0,1,2,0,2,2,3,4,2,0,2022-2023,0.3225806451612903,0.16129032258064516
159,Pierre-Emerick Aubameyang,GAB,FW,Barcelona,La Liga,33,1989,0.1,0,0,0,0,0,0,0,0.0,0,0,0,0,0,0,0,0,0,2022-2023,0.0,0.0
160,Emil Audero,ITA,GK,Sampdoria,Serie A,25,1997,25.0,0,0,0,0,0,0,2,0.0,2,0,0,0,0,0,7,1,0,2022-2023,0.0,0.0
161,Tommaso Augello,ITA,DF,Sampdoria,Serie A,27,1994,34.0,17,14,13,2,2,9,20,45.0,11,23,7,16,17,34,61,1,0,2022-2023,0.5,0.5
162,Ludwig Augustinsson,SWE,DF,Aston Villa,Premier League,28,1994,0.9,1,1,1,0,0,0,0,0.0,0,0,0,0,0,1,1,0,0,2022-2023,0.0,1.1111111111111112
163,Ludwig Augustinsson,SWE,DF,Mallorca,La Liga,28,1994,1.5,2,1,2,0,0,1,3,33.3,2,1,0,1,1,3,3,0,0,2022-2023,0.6666666666666666,1.3333333333333333
164,Carlos Augusto,BRA,DF,Monza,Serie A,23,1999,34.3,73,38,42,23,8,33,54,61.1,21,24,6,18,24,97,85,1,0,2022-2023,0.6997084548104957,2.1282798833819245
165,Serge Aurier,CIV,DF,Nott'ham Forest,Premier League,29,1992,21.6,64,41,41,18,5,23,33,69.7,10,34,11,23,29,93,75,0,0,2022-2023,1.3425925925925926,2.962962962962963
166,Mathias Autret,FRA,"MF,FW",Auxerre,Ligue 1,31,1991,14.3,22,10,10,10,2,7,16,43.8,9,14,2,12,12,34,13,0,0,2022-2023,0.8391608391608392,1.5384615384615383
167,Ezequiel Ávila,ARG,"FW,MF",Osasuna,La Liga,28,1994,19.0,8,5,2,4,2,6,23,26.1,17,12,1,11,8,16,16,0,0,2022-2023,0.42105263157894735,0.42105263157894735
168,Cédric Avinel,GLP,DF,Ajaccio,Ligue 1,35,1986,19.9,13,7,8,5,0,8,12,66.7,4,20,13,7,15,28,91,1,0,2022-2023,0.7537688442211056,0.6532663316582915
169,Taiwo Awoniyi,NGA,FW,Nott'ham Forest,Premier League,24,1997,15.6,17,10,2,10,5,6,12,50.0,6,18,4,14,4,21,20,0,0,2022-2023,0.25641025641025644,1.0897435897435899
170,Yasin Ayari,SWE,MF,Brighton,Premier League,18,2003,0.7,2,2,1,1,0,0,4,0.0,4,1,0,1,0,2,0,0,0,2022-2023,0.0,2.857142857142857
171,Mehmet Aydin,GER,"DF,FW",Schalke 04,Bundesliga,20,2002,6.3,25,18,14,9,2,11,24,45.8,13,11,0,11,10,35,15,0,0,2022-2023,1.5873015873015874,3.9682539682539684
172,André Ayew,GHA,"FW,MF",Nott'ham Forest,Premier League,32,1989,3.5,5,3,0,4,1,2,4,50.0,2,6,1,5,0,5,7,0,0,2022-2023,0.0,1.4285714285714286
173,Jordan Ayew,GHA,"FW,MF",Crystal Palace,Premier League,30,1991,30.2,66,41,23,20,23,21,53,39.6,32,35,4,31,15,81,31,0,0,2022-2023,0.49668874172185434,2.185430463576159
174,Kaan Ayhan,TUR,DF,Sassuolo,Serie A,27,1994,6.1,10,4,6,4,0,7,7,100.0,0,5,4,1,5,15,26,1,0,2022-2023,0.819672131147541,1.639344262295082
175,Luke Ayling,ENG,DF,Leeds United,Premier League,30,1991,22.8,66,37,42,15,9,42,85,49.4,43,34,11,23,26,92,52,2,0,2022-2023,1.1403508771929824,2.8947368421052633
Rk,Player,Nation,Pos,Squad,Comp,0,0,90.0,0,0,3,3,3,Tkl,0,0.0,0,0,0,0,0,0,0,0,0,2022-2023,0.0,0.0
176,Ayman Azhil,MAR,MF,Leverkusen,Bundesliga,21,2001,0.0,0,0,0,0,0,0,0,0.0,0,0,0,0,0,0,0,0,0,2022-2023,,
177,Sardar Azmoun,IRN,"FW,MF",Leverkusen,Bundesliga,27,1995,10.3,6,3,1,4,1,1,7,14.3,6,4,0,4,2,8,14,0,0,2022-2023,0.1941747572815534,0.5825242718446602
178,César Azpilicueta,ESP,DF,Chelsea,Premier League,32,1989,17.0,43,25,23,15,5,22,37,59.5,15,26,5,21,19,62,54,1,0,2022-2023,1.1176470588235294,2.5294117647058822
179,Sanoussy Ba,GER,DF,RB Leipzig,Bundesliga,18,2004,0.0,0,0,0,0,0,0,0,0.0,0,0,0,0,0,0,0,0,0,2022-2023,,
180,Iddrisu Baba,GHA,"MF,DF",Mallorca,La Liga,26,1996,18.9,31,17,15,16,0,15,32,46.9,17,18,8,10,11,42,39,0,0,2022-2023,0.5820105820105821,1.6402116402116402
181,Srđan Babić,SRB,DF,Almería,La Liga,26,1996,33.3,28,18,20,8,0,15,32,46.9,17,34,22,12,29,57,124,1,0,2022-2023,0.8708708708708709,0.8408408408408409
182,Loïc Bade,FRA,DF,Sevilla,La Liga,22,2000,16.1,27,20,23,3,1,17,30,56.7,13,21,13,8,23,50,77,0,0,2022-2023,1.4285714285714284,1.6770186335403725
183,Loïc Bade,FRA,DF,Rennes,Ligue 1,22,2000,1.0,1,1,1,0,0,0,0,0.0,0,0,0,0,1,2,3,0,0,2022-2023,1.0,1.0
184,Édgar Badía,ESP,GK,Elche,La Liga,30,1992,36.0,1,0,1,0,0,1,2,50.0,1,0,0,0,0,1,19,3,0,2022-2023,0.0,0.027777777777777776
185,Benoît Badiashile,FRA,DF,Chelsea,Premier League,21,2001,10.1,14,8,10,4,0,9,14,64.3,5,5,2,3,16,30,34,1,0,2022-2023,1.5841584158415842,1.3861386138613863
186,Benoît Badiashile,FRA,DF,Monaco,Ligue 1,21,2001,9.3,10,8,6,4,0,5,10,50.0,5,9,6,3,17,27,40,1,0,2022-2023,1.8279569892473118,1.075268817204301
187,Alex Baena,ESP,"MF,FW",Villarreal,La Liga,21,2001,21.6,30,17,9,15,6,15,45,33.3,30,15,3,12,7,37,16,0,0,2022-2023,0.32407407407407407,1.3888888888888888
188,Jaime Báez,URU,DF,Cremonese,Serie A,27,1995,1.1,4,2,3,0,1,3,6,50.0,3,0,0,0,0,4,2,1,0,2022-2023,0.0,3.6363636363636362
189,Leon Bailey,JAM,"FW,MF",Aston Villa,Premier League,24,1997,21.9,14,6,6,7,1,5,20,25.0,15,13,0,13,6,20,12,0,0,2022-2023,0.27397260273972607,0.6392694063926941
190,Eric Bailly,CIV,DF,Marseille,Ligue 1,28,1994,6.0,13,10,6,6,1,7,7,100.0,0,15,12,3,12,25,18,1,0,2022-2023,2.0,2.1666666666666665
191,Dénys Bain,FRA,DF,Auxerre,Ligue 1,29,1993,1.4,4,3,3,1,0,1,2,50.0,1,2,1,1,2,6,4,0,0,2022-2023,1.4285714285714286,2.857142857142857
192,Brandon Baiye,BEL,MF,Clermont Foot,Ligue 1,21,2000,0.6,3,2,2,1,0,2,3,66.7,1,1,0,1,1,4,3,0,0,2022-2023,1.6666666666666667,5.0
193,Stefan Bajcetic,ESP,MF,Liverpool,Premier League,17,2004,5.8,9,6,5,3,1,8,27,29.6,19,7,0,7,9,18,4,0,0,2022-2023,1.5517241379310345,1.5517241379310345
194,Nedim Bajrami,ALB,"MF,FW",Empoli,Serie A,23,1999,10.4,8,4,3,3,2,4,6,66.7,2,5,0,5,7,15,4,0,0,2022-2023,0.673076923076923,0.7692307692307692
195,Nedim Bajrami,ALB,"FW,MF",Sassuolo,Serie A,23,1999,9.1,12,7,6,2,4,5,11,45.5,6,9,1,8,7,19,6,0,0,2022-2023,0.7692307692307693,1.3186813186813187
196,Cédric Bakambu,COD,MF,Marseille,Ligue 1,31,1991,0.7,2,1,2,0,0,2,2,100.0,0,0,0,0,0,2,0,0,0,2022-2023,0.0,2.857142857142857
197,Tiemoué Bakayoko,FRA,MF,Milan,Serie A,27,1994,0.5,5,5,4,1,0,3,3,100.0,0,0,0,0,0,5,0,1,0,2022-2023,0.0,10.0
198,Mitchel Bakker,NED,"DF,MF",Leverkusen,Bundesliga,22,2000,18.4,16,8,9,7,0,6,15,40.0,9,20,2,18,15,31,20,2,0,2022-2023,0.8152173913043479,0.8695652173913044
199,Ridle Baku,GER,"DF,FW",Wolfsburg,Bundesliga,24,1998,28.7,50,26,29,17,4,32,58,55.2,26,44,6,38,21,71,59,0,0,2022-2023,0.7317073170731707,1.7421602787456447
200,Tommaso Baldanzi,ITA,MF,Empoli,Serie A,19,2003,19.7,25,12,9,13,3,7,32,21.9,25,21,1,20,2,27,5,0,0,2022-2023,0.10152284263959391,1.2690355329949239
Rk,Player,Nation,Pos,Squad,Comp,0,0,90.0,0,0,3,3,3,Tkl,0,0.0,0,0,0,0,0,0,0,0,0,2022-2023,0.0,0.0
201,Alejandro Balde,ESP,DF,Barcelona,La Liga,18,2003,27.5,42,30,22,16,4,24,41,58.5,17,25,3,22,12,54,17,1,0,2022-2023,0.43636363636363634,1.5272727272727273
202,Thierno Balde,FRA,"DF,MF",Troyes,Ligue 1,20,2002,23.9,27,14,19,4,4,18,30,60.0,12,15,3,12,23,50,39,0,0,2022-2023,0.9623430962343097,1.1297071129707115
203,Carlos Baleba,CMR,MF,Lille,Ligue 1,18,2004,5.3,13,11,2,9,2,9,14,64.3,5,13,3,10,1,14,3,2,0,2022-2023,0.18867924528301888,2.452830188679245
204,Mikel Balenziaga,ESP,DF,Athletic Club,La Liga,34,1988,1.3,4,4,1,2,1,4,4,100.0,0,0,0,0,1,5,2,0,0,2022-2023,0.7692307692307692,3.0769230769230766
205,Leonardo Balerdi,ARG,DF,Marseille,Ligue 1,23,1999,29.3,57,37,43,12,2,32,45,71.1,13,48,29,19,63,120,91,1,0,2022-2023,2.150170648464164,1.9453924914675766
206,Dominic Ballard,ENG,"FW,MF",Southampton,Premier League,17,2005,0.3,0,0,0,0,0,0,0,0.0,0,0,0,0,1,1,0,0,0,2022-2023,3.3333333333333335,0.0
207,Iván Balliu,ALB,DF,Rayo Vallecano,La Liga,30,1992,35.9,52,29,26,20,6,18,30,60.0,12,26,3,23,25,77,72,1,0,2022-2023,0.6963788300835655,1.4484679665738163
208,Fodé Ballo-Touré,SEN,DF,Milan,Serie A,25,1997,5.8,14,9,7,6,1,7,10,70.0,3,11,3,8,2,16,3,0,0,2022-2023,0.3448275862068966,2.413793103448276
209,Folarin Balogun,USA,FW,Reims,Ligue 1,21,2001,33.3,9,5,1,5,3,2,20,10.0,18,20,1,19,3,12,15,0,0,2022-2023,0.0900900900900901,0.2702702702702703
210,Abdoulaye Bamba,CIV,DF,Angers,Ligue 1,32,1990,15.2,22,12,15,5,2,16,19,84.2,3,7,3,4,18,40,38,0,0,2022-2023,1.1842105263157896,1.4473684210526316
211,Jonathan Bamba,CIV,FW,Lille,Ligue 1,26,1996,30.9,37,17,12,14,11,14,45,31.1,31,36,1,35,22,59,14,0,0,2022-2023,0.7119741100323624,1.197411003236246
212,Patrick Bamford,ENG,FW,Leeds United,Premier League,28,1993,16.8,9,6,0,6,3,4,20,20.0,16,12,5,7,5,14,13,0,0,2022-2023,0.2976190476190476,0.5357142857142857
213,Lameck Banda,ZAM,"FW,MF",Lecce,Serie A,21,2001,18.2,30,20,13,14,3,15,41,36.6,26,24,2,22,8,38,5,0,0,2022-2023,0.43956043956043955,1.6483516483516485
214,Filippo Bandinelli,ITA,MF,Empoli,Serie A,27,1995,25.1,55,34,19,26,10,17,45,37.8,28,20,7,13,18,73,40,0,0,2022-2023,0.7171314741035856,2.191235059760956
215,Léo Baptistão,BRA,"FW,MF",Almería,La Liga,29,1992,19.2,32,20,13,16,3,13,33,39.4,20,17,2,15,19,51,12,0,0,2022-2023,0.9895833333333334,1.6666666666666667
216,Shandon Baptiste,GRN,MF,Brentford,Premier League,24,1998,6.9,15,9,6,6,3,7,17,41.2,10,10,2,8,7,22,10,0,0,2022-2023,1.0144927536231882,2.1739130434782608
217,Antonín Barák,CZE,MF,Hellas Verona,Serie A,27,1994,0.3,0,0,0,0,0,0,0,0.0,0,0,0,0,0,0,0,0,0,2022-2023,0.0,0.0
218,Antonín Barák,CZE,MF,Fiorentina,Serie A,27,1994,20.0,21,9,5,7,9,6,16,37.5,10,16,2,14,3,24,13,0,0,2022-2023,0.15,1.05
219,Andrea Barberis,ITA,MF,Monza,Serie A,28,1993,3.8,7,2,4,3,0,5,11,45.5,6,0,0,0,8,15,1,0,0,2022-2023,2.1052631578947367,1.842105263157895
220,Tommaso Barbieri,ITA,DF,Juventus,Serie A,19,2002,1.2,3,3,3,0,0,3,8,37.5,5,3,0,3,0,3,2,0,0,2022-2023,0.0,2.5
221,Bradley Barcola,FRA,"FW,MF",Lyon,Ligue 1,19,2002,16.0,25,16,8,10,7,8,39,20.5,31,29,0,29,19,44,10,0,0,2022-2023,1.1875,1.5625
222,Melvin Bard,FRA,DF,Nice,Ligue 1,21,2000,27.3,96,60,61,29,6,59,89,66.3,30,35,4,31,64,160,40,1,0,2022-2023,2.3443223443223444,3.5164835164835164
223,Francesco Bardi,ITA,GK,Bologna,Serie A,30,1992,1.0,0,0,0,0,0,0,0,0.0,0,0,0,0,0,0,0,0,0,2022-2023,0.0,0.0
224,Keidi Bare,ALB,MF,Espanyol,La Liga,24,1997,5.6,15,8,7,5,3,7,13,53.8,6,8,2,6,11,26,8,0,0,2022-2023,1.9642857142857144,2.678571428571429
225,Nicolò Barella,ITA,MF,Inter,Serie A,25,1997,29.0,49,25,17,26,6,28,53,52.8,25,29,5,24,12,61,12,0,0,2022-2023,0.41379310344827586,1.6896551724137931
Rk,Player,Nation,Pos,Squad,Comp,0,0,90.0,0,0,3,3,3,Tkl,0,0.0,0,0,0,0,0,0,0,0,0,2022-2023,0.0,0.0
226,Kike Barja,ESP,"FW,MF",Osasuna,La Liga,25,1997,14.6,15,9,6,5,4,8,24,33.3,16,7,0,7,4,19,3,0,0,2022-2023,0.273972602739726,1.0273972602739727
227,Ross Barkley,ENG,"MF,FW",Nice,Ligue 1,28,1993,10.7,16,9,7,4,5,7,13,53.8,6,7,2,5,8,24,6,0,0,2022-2023,0.7476635514018692,1.4953271028037385
228,Aymen Barkok,MAR,MF,Mainz 05,Bundesliga,24,1998,6.5,18,8,10,5,3,5,10,50.0,5,7,0,7,3,21,9,0,0,2022-2023,0.46153846153846156,2.769230769230769
229,Harvey Barnes,ENG,"FW,MF",Leicester City,Premier League,24,1997,30.1,26,14,8,14,4,14,42,33.3,28,32,1,31,8,34,12,0,0,2022-2023,0.26578073089700993,0.8637873754152824
230,Leandro Barreiro Martins,LUX,MF,Mainz 05,Bundesliga,22,2000,23.8,60,38,19,28,13,22,49,44.9,27,38,13,25,41,101,39,1,0,2022-2023,1.722689075630252,2.5210084033613445
231,Enzo Barrenechea,ARG,MF,Juventus,Serie A,21,2001,1.8,8,3,3,4,1,3,5,60.0,2,3,0,3,2,10,3,0,0,2022-2023,1.1111111111111112,4.444444444444445
232,Ander Barrenetxea,ESP,"FW,DF",Real Sociedad,La Liga,20,2001,9.8,21,15,15,6,0,12,28,42.9,16,15,1,14,5,26,7,0,0,2022-2023,0.5102040816326531,2.142857142857143
233,Mickaël Barreto,FRA,MF,Ajaccio,Ligue 1,31,1991,14.7,32,20,12,17,3,8,45,17.8,37,17,0,17,18,50,11,0,0,2022-2023,1.2244897959183674,2.17687074829932
234,Pablo Barrios,ESP,MF,Atlético Madrid,La Liga,19,2003,8.0,19,10,3,10,6,8,15,53.3,7,12,2,10,9,28,6,1,0,2022-2023,1.125,2.375
235,Musa Barrow,GAM,"FW,MF",Bologna,Serie A,23,1998,21.8,21,4,10,6,5,8,14,57.1,6,25,1,24,1,22,7,0,0,2022-2023,0.04587155963302752,0.963302752293578
236,Federico Baschirotto,ITA,DF,Lecce,Serie A,25,1996,37.0,40,30,35,5,0,22,36,61.1,14,45,29,16,36,76,192,0,0,2022-2023,0.972972972972973,1.0810810810810811
237,Toma Bašić,CRO,MF,Lazio,Serie A,25,1996,5.7,6,4,4,1,1,3,8,37.5,5,9,0,9,7,13,8,0,0,2022-2023,1.2280701754385965,1.0526315789473684
238,Alberto Basso,ITA,MF,Cremonese,Serie A,18,2004,0.2,0,0,0,0,0,0,0,0.0,0,0,0,0,0,0,0,0,0,2022-2023,0.0,0.0
239,Gil Bastião Dias,POR,FW,Stuttgart,Bundesliga,25,1996,4.4,8,6,3,4,1,3,12,25.0,9,7,0,7,2,10,3,0,0,2022-2023,0.45454545454545453,1.8181818181818181
240,Alessandro Bastoni,ITA,DF,Inter,Serie A,23,1999,24.0,41,20,20,14,7,11,27,40.7,16,27,13,14,24,65,45,0,0,2022-2023,1.0,1.7083333333333333
241,Simone Bastoni,ITA,"MF,DF",Spezia,Serie A,25,1996,13.2,47,24,23,19,5,15,33,45.5,18,20,5,15,8,55,14,0,0,2022-2023,0.6060606060606061,3.560606060606061
242,Rodrigo Battaglia,ARG,MF,Mallorca,La Liga,31,1991,7.6,12,5,7,5,0,6,14,42.9,8,16,7,9,5,17,18,0,0,2022-2023,0.6578947368421053,1.5789473684210527
243,Maximilian Bauer,GER,DF,Augsburg,Bundesliga,22,2000,20.5,31,17,18,12,1,17,34,50.0,17,25,9,16,23,54,79,1,0,2022-2023,1.1219512195121952,1.5121951219512195
244,Oliver Baumann,GER,GK,Hoffenheim,Bundesliga,32,1990,34.0,0,0,0,0,0,0,0,0.0,0,0,0,0,0,0,15,1,0,2022-2023,0.0,0.0
245,Timo Baumgartl,GER,DF,Union Berlin,Bundesliga,26,1996,6.2,11,6,5,4,2,5,18,27.8,13,12,4,8,2,13,14,0,0,2022-2023,0.3225806451612903,1.7741935483870968
246,Julian Baumgartlinger,AUT,MF,Augsburg,Bundesliga,34,1988,6.2,15,4,5,6,4,6,19,31.6,13,4,2,2,4,19,15,0,0,2022-2023,0.6451612903225806,2.4193548387096775
247,Christoph Baumgartner,AUT,"MF,FW",Hoffenheim,Bundesliga,22,1999,28.5,36,19,12,17,7,9,52,17.3,43,57,5,52,15,51,19,1,0,2022-2023,0.5263157894736842,1.263157894736842
248,Cyrille Bayala,BFA,MF,Ajaccio,Ligue 1,26,1996,22.3,53,37,16,20,17,23,48,47.9,25,20,3,17,25,78,21,0,0,2022-2023,1.1210762331838564,2.3766816143497755
249,Brian Bayeye,COD,DF,Torino,Serie A,22,2000,0.7,3,0,3,0,0,1,1,100.0,0,1,1,0,1,4,2,0,0,2022-2023,1.4285714285714286,4.285714285714286
250,Noah Joel Sarenren Bazee,NGA,"MF,FW",Augsburg,Bundesliga,25,1996,0.2,0,0,0,0,0,0,1,0.0,1,1,0,1,0,0,0,0,0,2022-2023,0.0,0.0
Rk,Player,Nation,Pos,Squad,Comp,0,0,90.0,0,0,3,3,3,Tkl,0,0.0,0,0,0,0,0,0,0,0,0,2022-2023,0.0,0.0
251,Gavin Bazunu,IRL,GK,Southampton,Premier League,20,2002,32.0,1,0,1,0,0,1,1,100.0,0,0,0,0,1,2,24,2,0,2022-2023,0.03125,0.03125
252,Bebé,CPV,FW,Rayo Vallecano,La Liga,32,1990,0.7,0,0,0,0,0,0,2,0.0,2,1,0,1,0,0,0,0,0,2022-2023,0.0,0.0
253,Ihlas Bebou,TOG,"FW,DF",Hoffenheim,Bundesliga,28,1994,15.7,19,16,8,7,4,11,17,64.7,6,9,2,7,7,26,15,0,0,2022-2023,0.445859872611465,1.2101910828025477
254,Rodrigo Becão,BRA,DF,Udinese,Serie A,26,1996,27.6,70,36,50,17,3,40,53,75.5,13,44,24,20,26,96,68,2,0,2022-2023,0.9420289855072463,2.5362318840579707
255,Mads Bech Sørensen,DEN,"DF,MF",Brentford,Premier League,23,1999,0.2,0,0,0,0,0,0,0,0.0,0,0,0,0,1,1,1,0,0,2022-2023,5.0,0.0
256,Julius Beck,DEN,MF,Spezia,Serie A,17,2005,0.1,2,1,1,1,0,0,0,0.0,0,0,0,0,0,2,0,0,0,2022-2023,0.0,20.0
257,Sheraldo Becker,SUR,FW,Union Berlin,Bundesliga,27,1995,28.4,15,5,1,7,7,2,11,18.2,9,13,1,12,3,18,7,1,0,2022-2023,0.10563380281690142,0.5281690140845071
258,Jan Bednarek,POL,DF,Southampton,Premier League,26,1996,18.6,27,21,20,7,0,12,16,75.0,4,38,27,11,49,76,87,0,0,2022-2023,2.6344086021505375,1.4516129032258063
259,Jan Bednarek,POL,DF,Aston Villa,Premier League,26,1996,1.1,3,3,0,3,0,1,1,100.0,0,3,1,2,2,5,5,0,0,2022-2023,1.8181818181818181,2.727272727272727
260,Donny van de Beek,NED,MF,Manchester Utd,Premier League,25,1997,1.9,0,0,0,0,0,0,1,0.0,1,2,1,1,1,1,1,0,0,2022-2023,0.5263157894736842,0.0
261,Asmir Begović,BIH,GK,Everton,Premier League,35,1987,1.0,0,0,0,0,0,0,0,0.0,0,0,0,0,0,0,1,0,0,2022-2023,0.0,0.0
262,Yanis Begraoui,MAR,"FW,MF",Toulouse,Ligue 1,21,2001,0.7,2,0,1,0,1,1,2,50.0,1,0,0,0,1,3,0,0,0,2022-2023,1.4285714285714286,2.857142857142857
263,Kevin Behrens,GER,FW,Union Berlin,Bundesliga,31,1991,17.1,11,7,4,4,3,4,18,22.2,14,18,3,15,5,16,25,0,0,2022-2023,0.29239766081871343,0.6432748538011696
264,Alexis Beka Beka,FRA,"MF,DF",Nice,Ligue 1,21,2001,6.1,16,5,6,9,1,4,15,26.7,11,9,1,8,12,28,6,0,0,2022-2023,1.9672131147540985,2.6229508196721314
265,Jérémie Bela,ANG,"DF,MF",Clermont Foot,Ligue 1,29,1993,8.3,6,4,2,1,3,3,4,75.0,1,10,1,9,9,15,8,0,0,2022-2023,1.0843373493975903,0.7228915662650601
266,Reda Belahyane,FRA,MF,Nice,Ligue 1,18,2004,2.0,8,6,5,3,0,3,5,60.0,2,5,1,4,2,10,0,0,0,2022-2023,1.0,4.0
267,Youcef Belaïli,ALG,"MF,FW",Ajaccio,Ligue 1,30,1992,12.8,18,10,3,9,6,8,20,40.0,12,10,1,9,5,23,4,0,0,2022-2023,0.390625,1.40625
268,Youcef Belaïli,ALG,"FW,MF",Brest,Ligue 1,30,1992,4.0,5,2,3,2,0,2,7,28.6,5,2,0,2,1,6,1,0,0,2022-2023,0.25,1.25
269,Haris Belkebla,ALG,MF,Brest,Ligue 1,28,1994,29.5,80,48,35,40,5,44,85,51.8,41,32,6,26,52,132,21,3,0,2022-2023,1.7627118644067796,2.711864406779661
270,Stefan Bell,GER,DF,Mainz 05,Bundesliga,30,1991,26.6,43,28,32,10,1,22,44,50.0,22,42,15,27,44,87,133,0,0,2022-2023,1.6541353383458646,1.6165413533834585
271,Armel Bella Kotchap,GER,DF,Southampton,Premier League,20,2001,20.9,37,17,28,9,0,15,20,75.0,5,29,12,17,44,81,110,0,0,2022-2023,2.105263157894737,1.7703349282296652
272,Raoul Bellanova,ITA,DF,Inter,Serie A,22,2000,5.5,14,6,11,2,1,9,14,64.3,5,6,1,5,4,18,14,0,0,2022-2023,0.7272727272727273,2.5454545454545454
273,Karim Bellarabi,GER,"FW,MF",Leverkusen,Bundesliga,32,1990,0.9,2,0,1,1,0,2,3,66.7,1,0,0,0,0,2,0,0,0,2022-2023,0.0,2.2222222222222223
274,Jean-Ricner Bellegarde,FRA,"MF,FW",Strasbourg,Ligue 1,24,1998,26.9,47,25,15,21,11,11,25,44.0,14,26,3,23,26,73,22,0,0,2022-2023,0.966542750929368,1.7472118959107807
275,Héctor Bellerín,ESP,DF,Barcelona,La Liga,27,1995,1.6,2,0,0,2,0,2,3,66.7,1,2,0,2,3,5,2,0,0,2022-2023,1.875,1.25
Rk,Player,Nation,Pos,Squad,Comp,0,0,90.0,0,0,3,3,3,Tkl,0,0.0,0,0,0,0,0,0,0,0,0,2022-2023,0.0,0.0
276,Jude Bellingham,ENG,MF,Dortmund,Bundesliga,19,2003,29.9,76,42,28,34,14,34,51,66.7,17,51,4,47,35,111,30,0,0,2022-2023,1.1705685618729098,2.5418060200668897
277,Jeanuël Belocian,FRA,DF,Rennes,Ligue 1,17,2005,5.6,10,7,3,5,2,5,9,55.6,4,6,3,3,6,16,11,0,0,2022-2023,1.0714285714285714,1.7857142857142858
278,Andrea Belotti,ITA,FW,Roma,Serie A,28,1993,12.7,12,5,3,5,4,5,11,45.5,6,11,1,10,3,15,5,0,0,2022-2023,0.2362204724409449,0.9448818897637796
279,Fran Beltrán,ESP,MF,Celta Vigo,La Liga,23,1999,31.7,34,22,15,14,5,14,55,25.5,41,29,5,24,53,87,35,2,0,2022-2023,1.6719242902208202,1.0725552050473186
280,Eliesse Ben Seghir,MAR,"FW,MF",Monaco,Ligue 1,17,2005,11.7,18,10,4,12,2,4,12,33.3,8,18,1,17,4,22,1,0,0,2022-2023,0.3418803418803419,1.5384615384615385
281,Salim Ben Seghir,FRA,MF,Marseille,Ligue 1,19,2003,0.0,0,0,0,0,0,0,0,0.0,0,1,0,1,0,0,0,0,0,2022-2023,,
282,Wissam Ben Yedder,FRA,FW,Monaco,Ligue 1,31,1990,23.5,16,9,2,5,9,4,13,30.8,9,15,0,15,4,20,0,0,0,2022-2023,0.1702127659574468,0.6808510638297872
283,Marco Benassi,ITA,DF,Fiorentina,Serie A,27,1994,1.0,3,3,2,0,1,3,4,75.0,1,0,0,0,1,4,1,0,0,2022-2023,1.0,3.0
284,Marco Benassi,ITA,MF,Cremonese,Serie A,27,1994,11.1,26,15,9,11,6,15,24,62.5,9,13,1,12,12,38,19,0,0,2022-2023,1.0810810810810811,2.3423423423423424
285,Iker Benito,ESP,"FW,MF",Osasuna,La Liga,19,2002,2.0,4,3,0,3,1,2,4,50.0,2,0,0,0,2,6,4,0,0,2022-2023,1.0,2.0
286,Ismaël Bennacer,ALG,MF,Milan,Serie A,24,1997,22.3,59,33,26,31,2,30,51,58.8,21,25,7,18,26,85,16,1,0,2022-2023,1.1659192825112108,2.6457399103139014
287,Saïd Benrahma,ALG,"FW,MF",West Ham,Premier League,26,1995,23.0,25,15,11,7,7,11,27,40.7,16,23,1,22,9,34,13,0,0,2022-2023,0.391304347826087,1.0869565217391304
288,Ramy Bensebaini,ALG,DF,Gladbach,Bundesliga,27,1995,27.6,34,21,21,10,3,26,39,66.7,13,44,14,30,36,70,98,1,0,2022-2023,1.3043478260869565,1.2318840579710144
289,Nabil Bentaleb,ALG,MF,Angers,Ligue 1,27,1994,27.7,74,40,31,35,8,36,61,59.0,25,33,11,22,44,118,29,3,0,2022-2023,1.588447653429603,2.6714801444043323
290,Rodrigo Bentancur,URU,MF,Tottenham,Premier League,25,1997,16.7,45,28,15,21,9,16,28,57.1,12,28,15,13,20,65,22,0,0,2022-2023,1.1976047904191618,2.694610778443114
291,Daniel Bentley,ENG,GK,Wolves,Premier League,29,1993,2.0,1,1,1,0,0,1,1,100.0,0,0,0,0,0,1,0,1,0,2022-2023,0.0,0.5
292,Karim Benzema,FRA,FW,Real Madrid,La Liga,34,1987,22.6,9,5,2,4,3,2,11,18.2,9,11,0,11,2,11,5,0,0,2022-2023,0.08849557522123894,0.3982300884955752
293,Domenico Berardi,ITA,FW,Sassuolo,Serie A,27,1994,20.7,23,14,8,10,5,9,40,22.5,31,13,0,13,19,42,18,0,0,2022-2023,0.9178743961352658,1.1111111111111112
294,Yuri Berchiche,ESP,DF,Athletic Club,La Liga,32,1990,26.7,56,32,28,20,8,35,59,59.3,24,37,12,25,40,96,59,1,0,2022-2023,1.4981273408239701,2.0973782771535583
295,Álex Berenguer,ESP,FW,Athletic Club,La Liga,27,1995,25.5,58,37,17,25,16,23,60,38.3,37,37,4,33,10,68,6,0,0,2022-2023,0.39215686274509803,2.2745098039215685
296,Bartosz Bereszyński,POL,DF,Sampdoria,Serie A,30,1992,13.3,28,18,15,11,2,17,26,65.4,9,18,4,14,21,49,25,0,0,2022-2023,1.5789473684210527,2.1052631578947367
297,Bartosz Bereszyński,POL,DF,Napoli,Serie A,30,1992,1.8,3,2,1,1,1,2,2,100.0,0,4,0,4,3,6,3,0,0,2022-2023,1.6666666666666665,1.6666666666666665
298,Patrick Berg,NOR,"MF,FW",Lens,Ligue 1,24,1997,0.3,0,0,0,0,0,0,1,0.0,1,0,0,0,1,1,0,0,0,2022-2023,3.3333333333333335,0.0
299,Mitchell van Bergen,NED,"FW,DF",Reims,Ligue 1,22,1999,10.1,18,8,6,7,5,8,20,40.0,12,8,2,6,6,24,11,0,0,2022-2023,0.594059405940594,1.7821782178217822
300,Mergim Berisha,GER,FW,Augsburg,Bundesliga,24,1998,18.7,11,6,4,3,4,4,14,28.6,10,16,1,15,0,11,19,0,0,2022-2023,0.0,0.5882352941176471
Rk,Player,Nation,Pos,Squad,Comp,0,0,90.0,0,0,3,3,3,Tkl,0,0.0,0,0,0,0,0,0,0,0,0,2022-2023,0.0,0.0
301,Quentin Bernard,FRA,DF,Auxerre,Ligue 1,33,1989,7.0,9,7,4,2,3,7,15,46.7,8,9,1,8,15,24,17,0,0,2022-2023,2.142857142857143,1.2857142857142858
302,Paul Bernardoni,FRA,GK,Angers,Ligue 1,25,1997,27.0,2,0,2,0,0,2,3,66.7,1,1,0,1,1,3,12,1,0,2022-2023,0.037037037037037035,0.07407407407407407
303,Juan Bernat,ESP,"DF,MF",Paris S-G,Ligue 1,29,1993,18.3,32,16,18,9,5,21,39,53.8,18,11,2,9,9,41,22,1,0,2022-2023,0.4918032786885246,1.7486338797814207
304,Victor Bernth Kristiansen,DEN,DF,Leicester City,Premier League,19,2002,9.9,38,23,18,16,4,22,30,73.3,8,16,4,12,3,41,26,1,0,2022-2023,0.30303030303030304,3.8383838383838382
305,Jason Berthomier,FRA,MF,Clermont Foot,Ligue 1,32,1990,0.3,0,0,0,0,0,0,0,0.0,0,0,0,0,0,0,0,0,0,2022-2023,0.0,0.0
306,Marco Bertini,ITA,MF,Lazio,Serie A,19,2002,0.0,0,0,0,0,0,0,0,0.0,0,0,0,0,0,0,0,0,0,2022-2023,,
307,Beto,GNB,FW,Udinese,Serie A,24,1998,23.7,16,9,0,9,7,4,17,23.5,13,18,3,15,6,22,30,0,0,2022-2023,0.25316455696202533,0.6751054852320675
308,Owen Bevan,WAL,DF,Bournemouth,Premier League,18,2003,0.1,0,0,0,0,0,0,0,0.0,0,0,0,0,0,0,0,0,0,2022-2023,0.0,0.0
309,Matteo Bianchetti,ITA,DF,Cremonese,Serie A,29,1993,23.7,32,19,21,9,2,20,32,62.5,12,31,17,14,20,52,111,0,0,2022-2023,0.8438818565400844,1.350210970464135
310,Alessandro Bianco,ITA,MF,Fiorentina,Serie A,19,2002,1.7,5,2,2,3,0,2,3,66.7,1,1,0,1,0,5,0,0,0,2022-2023,0.0,2.9411764705882355
311,Giulian Biancone,FRA,DF,Nott'ham Forest,Premier League,22,2000,0.2,2,1,2,0,0,1,1,100.0,0,0,0,0,1,3,0,0,0,2022-2023,5.0,10.0
312,Ermin Bičakčić,BIH,DF,Hoffenheim,Bundesliga,32,1990,2.9,8,4,6,1,1,2,6,33.3,4,4,3,1,5,13,14,0,0,2022-2023,1.7241379310344829,2.7586206896551726
313,Pedro Bigas,ESP,DF,Elche,La Liga,31,1990,22.4,37,20,30,7,0,18,29,62.1,11,25,14,11,33,70,95,0,0,2022-2023,1.4732142857142858,1.6517857142857144
314,Jaka Bijol,SVN,DF,Udinese,Serie A,23,1999,30.3,39,23,32,7,0,16,27,59.3,11,41,25,16,29,68,165,0,0,2022-2023,0.957095709570957,1.2871287128712872
315,El Bilal Touré,MLI,FW,Almería,La Liga,20,2001,14.0,4,3,2,1,1,0,3,0.0,3,6,1,5,1,5,23,0,0,2022-2023,0.07142857142857142,0.2857142857142857
316,El Bilal Touré,MLI,FW,Reims,Ligue 1,20,2001,1.0,0,0,0,0,0,0,0,0.0,0,2,0,2,0,0,1,0,0,2022-2023,0.0,0.0
317,Philip Billing,DEN,"MF,FW",Bournemouth,Premier League,26,1996,30.7,63,36,21,33,9,11,42,26.2,31,48,8,40,31,94,58,1,0,2022-2023,1.009771986970684,2.0521172638436482
318,Jean-Claude Billong,CMR,MF,Clermont Foot,Ligue 1,28,1993,0.3,0,0,0,0,0,0,0,0.0,0,1,1,0,1,1,0,0,0,2022-2023,3.3333333333333335,0.0
319,Cristiano Biraghi,ITA,DF,Fiorentina,Serie A,29,1992,28.3,65,38,29,29,7,32,65,49.2,33,32,7,25,14,79,42,1,0,2022-2023,0.4946996466431095,2.2968197879858656
320,Samuele Birindelli,ITA,DF,Monza,Serie A,23,1999,15.6,35,19,21,10,4,18,29,62.1,11,28,8,20,16,51,30,0,0,2022-2023,1.0256410256410258,2.2435897435897436
321,Veljko Birmančević,SRB,"FW,MF",Toulouse,Ligue 1,24,1998,4.9,13,7,5,4,4,7,21,33.3,14,12,2,10,7,20,1,0,0,2022-2023,1.4285714285714284,2.6530612244897958
322,Tom Bischof,GER,"MF,FW",Hoffenheim,Bundesliga,17,2005,3.5,15,10,8,3,4,7,10,70.0,3,5,1,4,1,16,1,0,0,2022-2023,0.2857142857142857,4.285714285714286
323,Yves Bissouma,MLI,MF,Tottenham,Premier League,25,1996,11.2,16,13,6,6,4,2,7,28.6,5,15,6,9,12,28,10,0,0,2022-2023,1.0714285714285714,1.4285714285714286
324,Kristijan Bistrović,CRO,MF,Lecce,Serie A,24,1998,5.1,3,1,3,0,0,0,5,0.0,5,3,0,3,0,3,4,0,0,2022-2023,0.0,0.5882352941176471
325,Leonardo Bittencourt,GER,"MF,DF",Werder Bremen,Bundesliga,28,1993,18.1,53,28,20,25,8,25,62,40.3,37,13,0,13,10,63,15,0,0,2022-2023,0.5524861878453038,2.9281767955801103
Rk,Player,Nation,Pos,Squad,Comp,0,0,90.0,0,0,3,3,3,Tkl,0,0.0,0,0,0,0,0,0,0,0,0,2022-2023,0.0,0.0
326,Marco Bizot,NED,GK,Brest,Ligue 1,31,1991,37.0,0,0,0,0,0,0,1,0.0,1,1,0,1,0,0,24,4,0,2022-2023,0.0,0.0
327,Antonio Blanco,ESP,MF,Cádiz,La Liga,22,2000,1.8,6,4,5,1,0,4,6,66.7,2,5,0,5,1,7,3,0,0,2022-2023,0.5555555555555556,3.333333333333333
328,Lautaro Blanco,ARG,"DF,MF",Elche,La Liga,23,1999,9.7,16,9,10,4,2,9,26,34.6,17,8,1,7,2,18,10,1,0,2022-2023,0.2061855670103093,1.6494845360824744
329,Rubén Blanco,ESP,GK,Marseille,Ligue 1,27,1995,5.5,0,0,0,0,0,0,0,0.0,0,0,0,0,0,0,1,0,0,2022-2023,0.0,0.0
330,Ludovic Blas,FRA,"MF,FW",Nantes,Ligue 1,24,1997,31.3,47,30,17,19,11,17,49,34.7,32,26,1,25,19,66,8,0,0,2022-2023,0.6070287539936102,1.5015974440894568
331,Janis Blaswich,GER,GK,RB Leipzig,Bundesliga,31,1991,26.0,0,0,0,0,0,0,0,0.0,0,0,0,0,0,0,10,0,0,2022-2023,0.0,0.0
332,Miha Blažič,SVN,DF,Angers,Ligue 1,29,1993,22.0,8,6,8,0,0,7,15,46.7,8,25,19,6,22,30,80,1,0,2022-2023,1.0,0.36363636363636365
333,Joaquín Blázquez,ARG,GK,Brest,Ligue 1,21,2001,1.0,0,0,0,0,0,0,0,0.0,0,0,0,0,0,0,2,0,0,2022-2023,0.0,0.0
334,Alexis Blin,FRA,MF,Lecce,Serie A,25,1996,26.4,69,39,27,33,9,38,73,52.1,35,55,15,40,34,103,74,0,0,2022-2023,1.2878787878787878,2.6136363636363638
335,Daley Blind,NED,"DF,MF",Bayern Munich,Bundesliga,32,1990,1.5,2,0,2,0,0,0,1,0.0,1,4,2,2,2,4,6,0,0,2022-2023,1.3333333333333333,1.3333333333333333
336,Myron Boadu,NED,FW,Monaco,Ligue 1,21,2001,3.3,3,3,0,2,1,1,7,14.3,6,1,0,1,0,3,1,0,0,2022-2023,0.0,0.9090909090909092
337,Jérôme Boateng,GER,DF,Lyon,Ligue 1,33,1988,4.8,3,0,2,1,0,2,6,33.3,4,8,5,3,6,9,16,0,0,2022-2023,1.25,0.625
338,Kevin-Prince Boateng,GHA,MF,Hertha BSC,Bundesliga,35,1987,5.2,8,6,4,2,2,3,9,33.3,6,11,3,8,3,11,5,0,0,2022-2023,0.5769230769230769,1.5384615384615383
339,Antonin Bobichon,FRA,MF,Angers,Ligue 1,26,1995,0.2,0,0,0,0,0,0,0,0.0,0,1,0,1,0,0,0,0,0,2022-2023,0.0,0.0
340,Jean-Paul Boëtius,NED,MF,Hertha BSC,Bundesliga,28,1994,11.7,30,16,19,9,2,8,25,32.0,17,25,5,20,14,44,10,0,0,2022-2023,1.1965811965811965,2.5641025641025643
341,Jeremie Boga,CIV,"MF,FW",Atalanta,Serie A,25,1997,8.7,9,5,3,2,4,2,5,40.0,3,6,0,6,1,10,1,0,0,2022-2023,0.1149425287356322,1.0344827586206897
342,Emil Bohinen,NOR,MF,Salernitana,Serie A,23,1999,9.2,25,13,15,8,2,12,23,52.2,11,25,7,18,17,42,21,0,0,2022-2023,1.847826086956522,2.717391304347826
343,Quentin Boisgard,FRA,MF,Lorient,Ligue 1,25,1997,2.0,6,2,1,4,1,3,4,75.0,1,3,1,2,4,10,2,0,0,2022-2023,2.0,3.0
344,Willy Boly,CIV,DF,Nott'ham Forest,Premier League,31,1991,7.6,13,6,8,3,2,8,13,61.5,5,13,4,9,12,25,45,0,0,2022-2023,1.5789473684210527,1.7105263157894737
345,Giacomo Bonaventura,ITA,MF,Fiorentina,Serie A,32,1989,21.2,35,23,14,15,6,24,37,64.9,13,14,0,14,16,51,5,1,0,2022-2023,0.7547169811320755,1.650943396226415
346,Federico Bonazzoli,ITA,"FW,MF",Salernitana,Serie A,25,1997,12.4,5,3,0,3,2,0,9,0.0,9,9,1,8,3,8,0,0,0,2022-2023,0.24193548387096772,0.4032258064516129
347,Warren Bondo,FRA,MF,Monza,Serie A,18,2003,0.7,1,0,1,0,0,0,0,0.0,0,1,0,1,0,1,0,0,0,2022-2023,0.0,1.4285714285714286
348,Theo Bongonda,COD,"MF,FW",Cádiz,La Liga,26,1995,21.5,28,20,11,14,3,17,40,42.5,23,21,2,19,6,34,14,0,0,2022-2023,0.27906976744186046,1.302325581395349
349,Kevin Bonifazi,ITA,DF,Bologna,Serie A,26,1996,10.0,13,8,7,6,0,6,12,50.0,6,11,8,3,12,25,39,0,0,2022-2023,1.2,1.3
350,Leonardo Bonucci,ITA,DF,Juventus,Serie A,35,1987,9.8,5,4,1,4,0,2,4,50.0,2,12,8,4,13,18,29,0,0,2022-2023,1.3265306122448979,0.5102040816326531
Rk,Player,Nation,Pos,Squad,Comp,0,0,90.0,0,0,3,3,3,Tkl,0,0.0,0,0,0,0,0,0,0,0,0,2022-2023,0.0,0.0
351,Neto Borges,BRA,DF,Clermont Foot,Ligue 1,25,1996,31.5,75,45,45,20,10,46,75,61.3,29,45,11,34,41,116,62,1,0,2022-2023,1.3015873015873016,2.380952380952381
352,Yvandro Borges Sanches,LUX,"FW,MF",Gladbach,Bundesliga,18,2004,0.3,2,2,0,2,0,2,2,100.0,0,0,0,0,0,2,0,0,0,2022-2023,0.0,6.666666666666667
353,Sebastiaan Bornauw,BEL,DF,Wolfsburg,Bundesliga,23,1999,21.4,29,17,17,10,2,16,22,72.7,6,27,12,15,31,60,83,1,0,2022-2023,1.4485981308411215,1.355140186915888
354,Rafael Borré,COL,"MF,FW",Eint Frankfurt,Bundesliga,26,1995,12.0,25,15,4,13,8,4,17,23.5,13,10,2,8,2,27,9,0,0,2022-2023,0.16666666666666666,2.0833333333333335
355,Erik Botheim,NOR,"MF,FW",Salernitana,Serie A,22,2000,9.6,11,7,3,4,4,6,13,46.2,7,3,0,3,0,11,4,0,0,2022-2023,0.0,1.1458333333333335
356,Sven Botman,NED,DF,Newcastle Utd,Premier League,22,2000,34.7,38,24,31,7,0,22,28,78.6,6,44,24,20,34,72,126,2,0,2022-2023,0.9798270893371757,1.095100864553314
357,Kenji-Van Boto,MAD,DF,Auxerre,Ligue 1,26,1996,2.0,3,2,2,0,1,2,4,50.0,2,0,0,0,1,4,3,0,0,2022-2023,0.5,1.5
358,Kouamé Botué,BFA,"FW,MF",Ajaccio,Ligue 1,19,2002,2.5,4,2,2,1,1,0,2,0.0,2,1,0,1,0,4,1,0,0,2022-2023,0.0,1.6
359,Badredine Bouanani,ALG,"FW,MF",Nice,Ligue 1,17,2004,9.6,13,9,2,7,4,7,14,50.0,7,4,0,4,1,14,2,0,0,2022-2023,0.10416666666666667,1.3541666666666667
360,Hicham Boudaoui,ALG,MF,Nice,Ligue 1,22,1999,20.8,67,32,31,30,6,35,53,66.0,18,34,5,29,36,103,16,0,0,2022-2023,1.7307692307692306,3.2211538461538463
361,Franci Bouebari,FRA,DF,Strasbourg,Ligue 1,18,2003,0.8,3,0,1,2,0,3,5,60.0,2,0,0,0,2,5,2,0,0,2022-2023,2.5,3.75
362,Sofiane Boufal,MAR,"FW,MF",Angers,Ligue 1,28,1993,9.3,14,9,7,4,3,3,14,21.4,11,6,0,6,5,19,1,0,0,2022-2023,0.5376344086021505,1.5053763440860215
363,Yassine Bounou,MAR,GK,Sevilla,La Liga,31,1991,23.9,2,1,2,0,0,1,4,25.0,3,0,0,0,2,4,11,1,0,2022-2023,0.08368200836820085,0.08368200836820085
364,Ismaëlben Boura,COM,"DF,FW",Lens,Ligue 1,21,2000,1.0,6,4,4,2,0,5,6,83.3,1,2,1,1,2,8,3,0,0,2022-2023,2.0,6.0
365,Mehdi Bourabia,MAR,MF,Spezia,Serie A,30,1991,30.8,41,20,13,22,6,19,41,46.3,22,39,12,27,32,73,57,0,0,2022-2023,1.0389610389610389,1.3311688311688312
366,Benjamin Bourigeaud,FRA,"MF,FW",Rennes,Ligue 1,28,1994,34.1,45,29,16,23,6,21,65,32.3,44,38,3,35,31,76,32,0,0,2022-2023,0.9090909090909091,1.3196480938416422
367,Edoardo Bove,ITA,MF,Roma,Serie A,20,2002,11.0,35,18,12,15,8,16,39,41.0,23,15,1,14,10,45,11,0,0,2022-2023,0.9090909090909091,3.1818181818181817
368,Jarrod Bowen,ENG,"FW,MF",West Ham,Premier League,25,1996,35.9,39,16,14,11,14,16,58,27.6,42,47,9,38,36,75,25,0,0,2022-2023,1.0027855153203342,1.0863509749303621
369,Lucas Boyé,ARG,FW,Elche,La Liga,26,1996,27.4,36,16,12,16,8,17,35,48.6,18,33,5,28,15,51,46,0,0,2022-2023,0.5474452554744526,1.3138686131386863
370,Jayden Braaf,NED,"MF,FW",Hellas Verona,Serie A,19,2002,3.2,5,3,2,3,0,0,0,0.0,0,1,0,1,2,7,1,0,0,2022-2023,0.625,1.5625
371,Domagoj Bradarić,CRO,DF,Salernitana,Serie A,22,1999,25.0,26,19,14,8,4,7,16,43.8,9,20,5,15,21,47,44,0,0,2022-2023,0.84,1.04
372,Bilal Brahimi,ALG,"FW,MF",Nice,Ligue 1,22,2000,8.9,8,5,2,5,1,1,7,14.3,6,4,0,4,4,12,0,0,0,2022-2023,0.449438202247191,0.898876404494382
373,Martin Braithwaite,DEN,"FW,MF",Espanyol,La Liga,31,1991,27.3,12,2,2,4,6,5,14,35.7,9,10,0,10,5,17,11,0,0,2022-2023,0.18315018315018314,0.43956043956043955
374,Julian Brandt,GER,"MF,FW",Dortmund,Bundesliga,26,1996,26.6,29,20,6,14,9,12,43,27.9,31,23,0,23,15,44,9,1,0,2022-2023,0.5639097744360902,1.0902255639097744
375,Darko Brašanac,SRB,MF,Osasuna,La Liga,30,1992,11.6,29,20,12,10,7,12,23,52.2,11,14,2,12,12,41,9,0,0,2022-2023,1.0344827586206897,2.5
Rk,Player,Nation,Pos,Squad,Comp,0,0,90.0,0,0,3,3,3,Tkl,0,0.0,0,0,0,0,0,0,0,0,0,2022-2023,0.0,0.0
376,Lilian Brassier,FRA,DF,Brest,Ligue 1,22,1999,34.4,42,30,31,8,3,23,32,71.9,9,42,19,23,53,95,132,1,0,2022-2023,1.5406976744186047,1.2209302325581395
377,Claudio Bravo,CHI,GK,Betis,La Liga,39,1983,12.0,0,0,0,0,0,0,0,0.0,0,0,0,0,2,2,1,1,0,2022-2023,0.16666666666666666,0.0
378,Fabian Bredlow,GER,GK,Stuttgart,Bundesliga,27,1995,15.0,1,1,1,0,0,1,1,100.0,0,0,0,0,0,1,4,2,0,2022-2023,0.0,0.06666666666666667
379,James Bree,ENG,DF,Southampton,Premier League,24,1997,4.1,5,3,4,1,0,3,4,75.0,1,3,1,2,6,11,11,0,0,2022-2023,1.4634146341463417,1.2195121951219514
380,Josip Brekalo,CRO,"FW,MF",Fiorentina,Serie A,24,1998,2.5,2,1,0,1,1,1,4,25.0,3,1,0,1,1,3,1,0,0,2022-2023,0.4,0.8
381,Josip Brekalo,CRO,"MF,FW",Wolfsburg,Bundesliga,24,1998,3.0,2,1,2,0,0,0,4,0.0,4,0,0,0,2,4,2,0,0,2022-2023,0.6666666666666666,0.6666666666666666
382,Gleison Bremer,BRA,DF,Juventus,Serie A,25,1997,29.3,29,20,23,5,1,19,26,73.1,7,44,22,22,42,71,120,2,0,2022-2023,1.4334470989761092,0.9897610921501706
383,Armando Broja,ALB,FW,Chelsea,Premier League,20,2001,3.3,4,1,0,3,1,1,1,100.0,0,10,1,9,1,5,1,0,0,2022-2023,0.30303030303030304,1.2121212121212122
384,Dylan Bronn,TUN,DF,Salernitana,Serie A,27,1995,18.7,34,18,17,16,1,20,30,66.7,10,32,20,12,20,54,58,1,0,2022-2023,1.0695187165775402,1.8181818181818183
385,David Brooks,WAL,"FW,MF",Bournemouth,Premier League,25,1997,1.9,1,0,1,0,0,0,1,0.0,1,2,0,2,2,3,5,0,0,2022-2023,1.0526315789473684,0.5263157894736842
386,John Brooks,USA,DF,Hoffenheim,Bundesliga,29,1993,15.0,18,12,10,8,0,13,18,72.2,5,17,12,5,10,28,105,0,0,2022-2023,0.6666666666666666,1.2
387,Moritz Broschinski,GER,"FW,MF",Bochum,Bundesliga,21,2000,2.4,0,0,0,0,0,0,5,0.0,5,1,0,1,0,0,6,0,0,2022-2023,0.0,0.0
388,Marcelo Brozović,CRO,MF,Inter,Serie A,29,1992,19.7,37,22,13,22,2,11,37,29.7,26,23,7,16,22,59,28,0,0,2022-2023,1.116751269035533,1.8781725888324874
389,Cédric Brunner,SUI,DF,Schalke 04,Bundesliga,28,1994,25.7,39,27,26,11,2,30,45,66.7,15,24,7,17,43,82,79,0,0,2022-2023,1.6731517509727627,1.517509727626459
390,Lewis Brunt,ENG,DF,Leicester City,Premier League,21,2000,0.3,0,0,0,0,0,0,0,0.0,0,0,0,0,0,0,2,0,0,2022-2023,0.0,0.0
391,Jacob Bruun Larsen,DEN,FW,Hoffenheim,Bundesliga,23,1998,3.6,4,3,0,1,3,3,4,75.0,1,3,1,2,1,5,0,0,0,2022-2023,0.2777777777777778,1.1111111111111112
392,Andreas Bruus,DEN,"DF,FW",Troyes,Ligue 1,23,1999,18.1,12,6,9,3,0,8,20,40.0,12,13,2,11,17,29,24,0,0,2022-2023,0.9392265193370165,0.6629834254143646
393,Joe Bryan,ENG,"MF,DF",Nice,Ligue 1,28,1993,2.0,5,4,3,2,0,4,4,100.0,0,2,0,2,1,6,1,0,0,2022-2023,0.5,2.5
394,Lee Buchanan,ENG,"DF,FW",Werder Bremen,Bundesliga,21,2001,5.2,14,10,2,11,1,6,12,50.0,6,5,0,5,12,26,21,0,0,2022-2023,2.3076923076923075,2.692307692307692
395,Ante Budimir,CRO,FW,Osasuna,La Liga,31,1991,20.0,19,9,0,12,7,2,10,20.0,8,10,0,10,5,24,19,0,0,2022-2023,0.25,0.95
396,Emi Buendía,ARG,"MF,FW",Aston Villa,Premier League,25,1996,26.8,52,23,20,20,12,21,74,28.4,53,20,2,18,20,72,17,0,0,2022-2023,0.7462686567164178,1.9402985074626866
397,Hugo Bueno,ESP,DF,Wolves,Premier League,19,2002,14.6,33,16,23,6,4,17,33,51.5,16,14,1,13,10,43,36,0,0,2022-2023,0.684931506849315,2.26027397260274
398,Manu Bueno,ESP,MF,Sevilla,La Liga,18,2004,1.7,7,4,3,3,1,5,8,62.5,3,0,0,0,0,7,2,0,0,2022-2023,0.0,4.11764705882353
399,Santiago Bueno,URU,DF,Girona,La Liga,23,1998,33.4,63,38,43,19,1,24,36,66.7,12,34,22,12,31,94,105,2,0,2022-2023,0.9281437125748503,1.8862275449101797
400,Adam Buksa,POL,"FW,MF",Lens,Ligue 1,26,1996,1.1,1,0,0,0,1,0,3,0.0,3,0,0,0,0,1,0,0,0,2022-2023,0.0,0.9090909090909091
Rk,Player,Nation,Pos,Squad,Comp,0,0,90.0,0,0,3,3,3,Tkl,0,0.0,0,0,0,0,0,0,0,0,0,2022-2023,0.0,0.0
401,Marius Bülter,GER,"FW,MF",Schalke 04,Bundesliga,29,1993,28.9,22,11,8,7,7,12,32,37.5,20,34,1,33,10,32,20,0,0,2022-2023,0.34602076124567477,0.7612456747404844
402,Cristian Buonaiuto,ITA,"MF,FW",Cremonese,Serie A,29,1992,10.9,25,16,8,11,6,12,26,46.2,14,11,0,11,14,39,7,0,0,2022-2023,1.2844036697247705,2.293577981651376
403,Facundo Buonanotte,ARG,"FW,MF",Brighton,Premier League,17,2004,6.3,2,1,1,1,0,1,22,4.5,21,5,2,3,4,6,3,0,0,2022-2023,0.6349206349206349,0.31746031746031744
404,Alessandro Buongiorno,ITA,DF,Torino,Serie A,23,1999,30.2,38,25,22,16,0,16,31,51.6,15,38,19,19,60,98,105,2,0,2022-2023,1.9867549668874174,1.2582781456953642
405,Delano Burgzorg,NED,"FW,MF",Mainz 05,Bundesliga,23,1998,2.7,3,3,1,1,1,2,3,66.7,1,2,0,2,0,3,2,0,0,2022-2023,0.0,1.111111111111111
406,Jonathan Burkardt,GER,"MF,FW",Mainz 05,Bundesliga,22,2000,5.9,3,1,0,1,2,1,4,25.0,3,6,1,5,1,4,1,0,0,2022-2023,0.1694915254237288,0.5084745762711864
407,Oliver Burke,SCO,"FW,MF",Werder Bremen,Bundesliga,25,1997,3.0,1,0,0,0,1,0,0,0.0,0,2,0,2,0,1,0,0,0,2022-2023,0.0,0.3333333333333333
408,Dan Burn,ENG,DF,Newcastle Utd,Premier League,30,1992,34.6,60,38,29,23,8,34,67,50.7,33,42,16,26,32,92,120,2,0,2022-2023,0.9248554913294798,1.7341040462427746
409,Maxime Busi,BEL,DF,Reims,Ligue 1,22,1999,11.6,21,16,9,11,1,13,29,44.8,16,14,6,8,14,35,24,0,0,2022-2023,1.206896551724138,1.8103448275862069
410,Sergio Busquets,ESP,MF,Barcelona,La Liga,34,1988,26.0,58,26,24,26,8,29,51,56.9,22,32,6,26,27,85,36,2,0,2022-2023,1.0384615384615385,2.230769230769231
411,Aurélio Buta,POR,DF,Eint Frankfurt,Bundesliga,25,1997,14.6,33,19,15,13,5,15,27,55.6,12,18,1,17,9,42,34,0,0,2022-2023,0.6164383561643836,2.26027397260274
412,Leonardo Buta,POR,DF,Udinese,Serie A,20,2002,0.2,1,1,0,1,0,0,0,0.0,0,0,0,0,0,1,0,0,0,2022-2023,0.0,5.0
413,Marcin Bułka,POL,GK,Nice,Ligue 1,22,1999,2.0,0,0,0,0,0,0,1,0.0,1,0,0,0,1,1,0,0,0,2022-2023,0.5,0.0
414,Rémy Cabella,FRA,"MF,FW",Lille,Ligue 1,32,1990,28.1,64,37,21,28,15,29,64,45.3,35,41,5,36,17,81,7,1,0,2022-2023,0.6049822064056939,2.277580071174377
415,Jimmy Cabot,FRA,"DF,MF",Lens,Ligue 1,28,1994,5.7,20,12,10,8,2,12,26,46.2,14,5,0,5,4,24,12,0,0,2022-2023,0.7017543859649122,3.508771929824561
416,Arthur Cabral,BRA,FW,Fiorentina,Serie A,24,1998,15.9,9,2,1,4,4,4,8,50.0,4,10,1,9,1,10,12,0,0,2022-2023,0.06289308176100629,0.5660377358490566
417,Leandro Cabrera,URU,DF,Espanyol,La Liga,31,1991,29.7,46,24,34,12,0,28,43,65.1,15,37,23,14,43,89,114,2,0,2022-2023,1.4478114478114479,1.5488215488215489
418,Liberato Cacace,NZL,DF,Empoli,Serie A,21,2000,6.5,25,10,12,8,5,9,15,60.0,6,15,7,8,4,29,16,0,0,2022-2023,0.6153846153846154,3.8461538461538463
419,Anthony Caci,FRA,DF,Mainz 05,Bundesliga,25,1997,22.6,58,33,32,20,6,28,42,66.7,14,28,4,24,54,112,40,0,0,2022-2023,2.389380530973451,2.566371681415929
420,Cafú,POR,MF,Nott'ham Forest,Premier League,29,1993,0.1,0,0,0,0,0,0,0,0.0,0,0,0,0,0,0,1,0,0,2022-2023,0.0,0.0
421,Moisés Caicedo,ECU,MF,Brighton,Premier League,20,2001,34.9,100,50,41,47,12,40,68,58.8,28,43,7,36,56,156,31,3,0,2022-2023,1.6045845272206305,2.865329512893983
422,Tom Cairney,SCO,MF,Fulham,Premier League,31,1991,11.0,17,6,4,8,5,7,10,70.0,3,18,3,15,5,22,3,0,0,2022-2023,0.45454545454545453,1.5454545454545454
423,Jens Cajuste,SWE,MF,Reims,Ligue 1,22,1999,17.0,46,25,25,14,7,25,48,52.1,23,30,6,24,18,64,22,0,0,2022-2023,1.0588235294117647,2.7058823529411766
424,Cala,ESP,DF,Cádiz,La Liga,32,1989,1.5,2,1,1,1,0,1,2,50.0,1,2,1,1,1,3,12,0,0,2022-2023,0.6666666666666666,1.3333333333333333
425,Davide Calabria,ITA,DF,Milan,Serie A,25,1996,18.8,71,44,31,32,8,38,61,62.3,23,22,7,15,25,96,34,0,0,2022-2023,1.3297872340425532,3.776595744680851
Rk,Player,Nation,Pos,Squad,Comp,0,0,90.0,0,0,3,3,3,Tkl,0,0.0,0,0,0,0,0,0,0,0,0,2022-2023,0.0,0.0
426,Mattia Caldara,ITA,DF,Spezia,Serie A,28,1994,13.9,23,14,10,11,2,9,20,45.0,11,23,16,7,17,40,88,2,0,2022-2023,1.223021582733813,1.6546762589928057
427,Luca Caldirola,ITA,DF,Monza,Serie A,31,1991,26.1,26,14,19,4,3,13,26,50.0,13,32,18,14,25,51,66,1,0,2022-2023,0.9578544061302682,0.9961685823754789
428,Fernando Calero,ESP,"DF,MF",Espanyol,La Liga,26,1995,17.9,46,29,27,15,4,21,34,61.8,13,31,13,18,13,59,52,0,0,2022-2023,0.7262569832402235,2.569832402234637
429,Duje Ćaleta-Car,CRO,DF,Southampton,Premier League,25,1996,10.5,14,10,9,4,1,6,9,66.7,3,15,11,4,15,29,65,1,0,2022-2023,1.4285714285714286,1.3333333333333333
430,Duje Ćaleta-Car,CRO,DF,Marseille,Ligue 1,25,1996,0.1,0,0,0,0,0,0,0,0.0,0,0,0,0,0,0,1,0,0,2022-2023,0.0,0.0
431,Hakan Çalhanoğlu,TUR,MF,Inter,Serie A,28,1994,26.3,48,27,17,26,5,16,43,37.2,27,30,5,25,25,73,13,1,0,2022-2023,0.9505703422053232,1.8250950570342206
432,Kerim Calhanoglu,GER,DF,Schalke 04,Bundesliga,19,2002,0.7,2,1,2,0,0,2,2,100.0,0,1,0,1,0,2,3,0,0,2022-2023,0.0,2.857142857142857
433,Daniel Caligiuri,ITA,"DF,MF",Augsburg,Bundesliga,34,1988,3.2,8,5,5,3,0,4,5,80.0,1,3,2,1,3,11,2,0,0,2022-2023,0.9375,2.5
434,Alexander Callens,PER,DF,Girona,La Liga,30,1992,1.3,3,3,2,1,0,3,4,75.0,1,3,1,2,1,4,9,0,0,2022-2023,0.7692307692307692,2.3076923076923075
435,Dominic Calvert-Lewin,ENG,FW,Everton,Premier League,25,1997,12.9,4,2,1,0,3,1,5,20.0,4,5,1,4,3,7,18,0,0,2022-2023,0.23255813953488372,0.31007751937984496
436,Mahdi Camara,FRA,MF,Brest,Ligue 1,24,1998,20.2,63,36,18,38,7,25,43,58.1,18,35,4,31,40,103,16,0,0,2022-2023,1.9801980198019802,3.118811881188119
437,Mohamed Camara,GUI,MF,Roma,Serie A,25,1997,7.7,13,10,3,7,3,5,15,33.3,10,5,1,4,10,23,8,0,0,2022-2023,1.2987012987012987,1.6883116883116882
438,Mohamed Camara,MLI,MF,Monaco,Ligue 1,22,2000,24.4,83,45,38,39,6,48,92,52.2,44,45,6,39,27,110,14,1,0,2022-2023,1.1065573770491803,3.4016393442622954
439,Ousmane Camara,GUI,"FW,MF",Auxerre,Ligue 1,20,2001,0.3,1,1,0,0,1,0,0,0.0,0,0,0,0,0,1,0,0,0,2022-2023,0.0,3.3333333333333335
440,Ousmane Camara,FRA,DF,Angers,Ligue 1,19,2003,5.8,10,6,5,5,0,5,12,41.7,7,4,2,2,11,21,15,0,0,2022-2023,1.896551724137931,1.7241379310344829
441,Eduardo Camavinga,FRA,"MF,DF",Real Madrid,La Liga,19,2002,22.3,68,48,32,21,15,24,64,37.5,40,24,5,19,17,85,25,0,0,2022-2023,0.7623318385650224,3.0493273542600896
442,Nicolò Cambiaghi,ITA,"FW,MF",Empoli,Serie A,21,2000,14.3,30,22,11,12,7,8,27,29.6,19,19,1,18,9,39,8,0,0,2022-2023,0.6293706293706294,2.097902097902098
443,Andrea Cambiaso,ITA,DF,Bologna,Serie A,22,2000,24.1,57,34,34,20,3,28,65,43.1,37,26,2,24,26,83,33,1,0,2022-2023,1.0788381742738589,2.3651452282157677
444,Axel Camblan,FRA,"FW,MF",Brest,Ligue 1,18,2003,0.8,2,2,1,1,0,0,1,0.0,1,0,0,0,0,2,0,0,0,2022-2023,0.0,2.5
445,Sergio Camello,ESP,FW,Rayo Vallecano,La Liga,21,2001,26.7,16,10,3,9,4,5,17,29.4,12,9,1,8,2,18,26,0,0,2022-2023,0.0749063670411985,0.599250936329588
446,Chem Campbell,WAL,"FW,MF",Wolves,Premier League,19,2002,0.8,2,1,1,1,0,0,1,0.0,1,2,0,2,1,3,0,0,0,2022-2023,1.25,2.5
447,Emre Can,GER,MF,Dortmund,Bundesliga,28,1994,21.1,57,28,25,27,5,22,43,51.2,21,16,6,10,25,82,39,1,0,2022-2023,1.1848341232227488,2.701421800947867
448,Sergio Canales,ESP,"FW,MF",Betis,La Liga,31,1991,26.7,25,14,10,8,7,14,33,42.4,19,18,0,18,14,39,8,0,0,2022-2023,0.5243445692883896,0.9363295880149813
449,Matteo Cancellieri,ITA,FW,Lazio,Serie A,20,2002,2.8,10,4,5,3,2,5,9,55.6,4,4,0,4,1,11,2,0,0,2022-2023,0.35714285714285715,3.5714285714285716
450,João Cancelo,POR,DF,Manchester City,Premier League,28,1994,14.2,29,21,16,9,4,17,24,70.8,7,7,1,6,19,48,9,1,0,2022-2023,1.3380281690140845,2.0422535211267605
Rk,Player,Nation,Pos,Squad,Comp,0,0,90.0,0,0,3,3,3,Tkl,0,0.0,0,0,0,0,0,0,0,0,0,2022-2023,0.0,0.0
451,João Cancelo,POR,"DF,FW",Bayern Munich,Bundesliga,28,1994,11.2,23,14,9,10,4,10,23,43.5,13,14,2,12,15,38,22,0,0,2022-2023,1.3392857142857144,2.053571428571429
452,Antonio Candreva,ITA,"MF,DF",Salernitana,Serie A,35,1987,30.3,17,7,13,2,2,11,38,28.9,27,7,3,4,17,34,32,0,0,2022-2023,0.5610561056105611,0.5610561056105611
453,Thomas Cannon,IRL,FW,Everton,Premier League,19,2002,0.3,0,0,0,0,0,0,0,0.0,0,0,0,0,0,0,0,0,0,2022-2023,0.0,0.0
454,Sergi Canós,ESP,"FW,DF",Brentford,Premier League,25,1997,0.9,0,0,0,0,0,0,2,0.0,2,3,1,2,0,0,1,0,0,2022-2023,0.0,0.0
455,Ander Capa,ESP,DF,Athletic Club,La Liga,30,1992,1.2,1,1,1,0,0,1,5,20.0,4,5,0,5,0,1,2,0,0,2022-2023,0.0,0.8333333333333334
456,Pierrick Capelle,FRA,"MF,DF",Angers,Ligue 1,35,1987,15.9,36,21,17,15,4,22,55,40.0,33,24,3,21,15,51,24,0,0,2022-2023,0.9433962264150944,2.2641509433962264
457,Étienne Capoue,FRA,MF,Villarreal,La Liga,34,1988,21.7,21,12,6,13,2,10,18,55.6,8,12,5,7,19,40,20,1,0,2022-2023,0.8755760368663594,0.967741935483871
458,Gianluca Caprari,ITA,"MF,FW",Monza,Serie A,29,1993,27.1,16,6,3,11,2,8,26,30.8,18,22,1,21,8,24,3,0,0,2022-2023,0.2952029520295203,0.5904059040590406
459,Francesco Caputo,ITA,FW,Sampdoria,Serie A,34,1987,12.2,3,1,0,0,3,0,3,0.0,3,0,0,0,1,4,3,0,0,2022-2023,0.0819672131147541,0.24590163934426232
460,Francesco Caputo,ITA,FW,Empoli,Serie A,34,1987,19.0,2,2,0,1,1,0,1,0.0,1,7,2,5,2,4,8,0,0,2022-2023,0.10526315789473684,0.10526315789473684
461,Maxence Caqueret,FRA,MF,Lyon,Ligue 1,22,2000,30.7,87,54,27,38,22,43,109,39.4,66,45,3,42,39,126,27,0,0,2022-2023,1.2703583061889252,2.8338762214983713
462,Andrea Carboni,ITA,DF,Monza,Serie A,21,2001,1.9,3,2,2,0,1,2,5,40.0,3,3,2,1,3,6,2,1,0,2022-2023,1.5789473684210527,1.5789473684210527
463,Franco Carboni,ITA,"DF,FW",Monza,Serie A,19,2003,0.7,1,1,1,0,0,0,2,0.0,2,3,0,3,1,2,0,0,0,2022-2023,1.4285714285714286,1.4285714285714286
464,Valentin Carboni,ARG,"MF,DF",Inter,Serie A,17,2005,0.3,1,1,0,1,0,1,3,33.3,2,1,0,1,0,1,0,0,0,2022-2023,0.0,3.3333333333333335
465,Isaac Carcelen,ESP,DF,Cádiz,La Liga,29,1993,24.4,69,51,41,22,6,41,63,65.1,22,35,11,24,19,88,80,1,0,2022-2023,0.778688524590164,2.8278688524590168
466,Irvin Cardona,FRA,"FW,MF",Brest,Ligue 1,24,1997,2.6,2,0,1,1,0,0,3,0.0,3,3,0,3,2,4,2,0,0,2022-2023,0.7692307692307692,0.7692307692307692
467,Irvin Cardona,FRA,"MF,FW",Augsburg,Bundesliga,24,1997,3.5,1,1,1,0,0,1,5,20.0,4,3,0,3,4,5,8,0,0,2022-2023,1.1428571428571428,0.2857142857142857
468,Igor Carioca,BRA,DF,Lorient,Ligue 1,25,1996,5.1,18,11,12,2,4,12,21,57.1,9,7,0,7,5,23,17,0,0,2022-2023,0.9803921568627452,3.5294117647058827
469,Diego Carlos,BRA,DF,Aston Villa,Premier League,29,1993,2.3,1,0,0,1,0,0,1,0.0,1,2,2,0,1,2,2,0,0,2022-2023,0.4347826086956522,0.4347826086956522
470,Juan Carlos,ESP,GK,Girona,La Liga,34,1988,10.0,0,0,0,0,0,0,0,0.0,0,0,0,0,1,1,7,1,0,2022-2023,0.1,0.0
471,José Carlos Lazo,ESP,"MF,FW",Almería,La Liga,26,1996,0.2,0,0,0,0,0,0,0,0.0,0,0,0,0,0,0,0,0,0,2022-2023,0.0,0.0
472,José Carlos Lazo,ESP,"MF,FW",Espanyol,La Liga,26,1996,1.8,5,3,2,2,1,3,3,100.0,0,2,0,2,3,8,5,0,0,2022-2023,1.6666666666666665,2.7777777777777777
473,Carmona,ESP,"MF,DF",Elche,La Liga,20,2002,6.5,16,9,7,6,3,6,16,37.5,10,14,2,12,8,24,9,0,0,2022-2023,1.2307692307692308,2.4615384615384617
474,Carmona,ESP,DF,Sevilla,La Liga,20,2002,5.9,13,11,5,3,5,9,16,56.3,7,10,6,4,7,20,17,1,0,2022-2023,1.1864406779661016,2.2033898305084745
475,Marco Carnesecchi,ITA,GK,Cremonese,Serie A,22,2000,27.0,1,1,1,0,0,1,2,50.0,1,0,0,0,0,1,11,2,0,2022-2023,0.0,0.037037037037037035
Rk,Player,Nation,Pos,Squad,Comp,0,0,90.0,0,0,3,3,3,Tkl,0,0.0,0,0,0,0,0,0,0,0,0,2022-2023,0.0,0.0
476,Yannick Carrasco,BEL,"DF,MF",Atlético Madrid,La Liga,28,1993,25.7,35,14,21,10,4,23,54,42.6,31,23,1,22,12,47,19,0,0,2022-2023,0.4669260700389105,1.3618677042801557
477,Dani Carvajal,ESP,DF,Real Madrid,La Liga,30,1992,19.8,32,18,15,12,5,18,35,51.4,17,24,6,18,15,47,49,0,0,2022-2023,0.7575757575757576,1.6161616161616161
478,Fabio Carvalho,POR,"MF,FW",Liverpool,Premier League,19,2002,3.9,8,8,3,3,2,3,6,50.0,3,6,0,6,6,14,0,0,0,2022-2023,1.5384615384615385,2.0512820512820515
479,Matis Carvalho,POR,GK,Montpellier,Ligue 1,23,1999,1.5,0,0,0,0,0,0,0,0.0,0,0,0,0,1,1,0,0,0,2022-2023,0.6666666666666666,0.0
480,William Carvalho,POR,MF,Betis,La Liga,30,1992,27.1,43,27,18,23,2,17,44,38.6,27,27,6,21,16,59,22,0,0,2022-2023,0.5904059040590406,1.5867158671586714
481,Nicolò Casale,ITA,DF,Lazio,Serie A,24,1998,27.1,42,20,28,14,0,22,34,64.7,12,25,17,8,17,59,73,1,0,2022-2023,0.6273062730627306,1.5498154981549814
482,Casemiro,BRA,MF,Manchester Utd,Premier League,30,1992,23.6,88,46,43,35,10,47,92,51.1,45,49,11,38,34,122,64,0,0,2022-2023,1.4406779661016949,3.7288135593220337
483,Casemiro,BRA,MF,Real Madrid,La Liga,30,1992,0.1,0,0,0,0,0,0,0,0.0,0,0,0,0,0,0,1,0,0,2022-2023,0.0,0.0
484,Matty Cash,POL,DF,Aston Villa,Premier League,24,1997,20.2,55,32,36,15,4,26,37,70.3,11,20,5,15,26,81,43,0,0,2022-2023,1.2871287128712872,2.722772277227723
485,Tommaso Cassandro,ITA,DF,Lecce,Serie A,22,2000,0.1,1,1,0,1,0,0,0,0.0,0,1,1,0,0,1,0,0,0,2022-2023,0.0,10.0
486,Timothy Castagne,BEL,DF,Leicester City,Premier League,26,1995,36.2,87,44,53,27,7,41,84,48.8,43,50,13,37,43,130,110,0,0,2022-2023,1.1878453038674033,2.4033149171270716
487,Michele Castagnetti,ITA,MF,Cremonese,Serie A,32,1989,15.7,46,21,20,24,2,18,54,33.3,36,14,4,10,15,61,22,0,0,2022-2023,0.9554140127388535,2.9299363057324843
488,Koen Casteels,BEL,GK,Wolfsburg,Bundesliga,30,1992,34.0,0,0,0,0,0,0,0,0.0,0,0,0,0,1,1,10,1,0,2022-2023,0.029411764705882353,0.0
489,Valentín Castellanos,ARG,FW,Girona,La Liga,23,1998,28.9,12,5,2,7,3,0,18,0.0,18,22,2,20,6,18,26,0,0,2022-2023,0.20761245674740486,0.4152249134948097
490,Jean-Charles Castelletto,CMR,DF,Nantes,Ligue 1,27,1995,28.5,43,26,29,12,2,22,36,61.1,14,35,22,13,58,101,90,0,0,2022-2023,2.0350877192982457,1.5087719298245614
491,Samu Castillejo,ESP,"FW,MF",Valencia,La Liga,27,1995,15.1,21,12,8,9,4,8,40,20.0,32,21,2,19,9,30,2,0,0,2022-2023,0.5960264900662252,1.390728476821192
492,Jonny Castro,ESP,DF,Wolves,Premier League,28,1994,14.0,33,15,22,10,1,17,38,44.7,21,26,5,21,14,47,28,2,0,2022-2023,1.0,2.357142857142857
493,Gaetano Castrovilli,ITA,MF,Fiorentina,Serie A,25,1997,8.0,10,8,1,7,2,2,9,22.2,7,5,1,4,8,18,5,0,0,2022-2023,1.0,1.25
494,Danilo Cataldi,ITA,MF,Lazio,Serie A,27,1994,21.3,25,16,7,15,3,14,40,35.0,26,23,9,14,24,49,33,0,0,2022-2023,1.1267605633802817,1.1737089201877935
495,Catena,ESP,DF,Rayo Vallecano,La Liga,27,1994,34.5,29,14,23,4,2,13,27,48.1,14,32,25,7,28,57,159,1,0,2022-2023,0.8115942028985508,0.8405797101449275
496,Yoann Cathline,FRA,"FW,MF",Lorient,Ligue 1,20,2002,12.1,19,12,7,6,6,5,12,41.7,7,10,1,9,8,27,16,1,0,2022-2023,0.6611570247933884,1.5702479338842976
497,Maximiliano Caufriez,BEL,DF,Clermont Foot,Ligue 1,25,1997,24.7,40,24,31,8,1,20,28,71.4,8,33,18,15,34,74,70,0,0,2022-2023,1.376518218623482,1.6194331983805668
498,Edinson Cavani,URU,FW,Valencia,La Liga,35,1987,16.1,7,4,3,3,1,3,15,20.0,12,10,3,7,2,9,11,0,0,2022-2023,0.12422360248447203,0.43478260869565216
499,Dani Ceballos,ESP,MF,Real Madrid,La Liga,25,1996,17.4,43,29,13,15,15,25,64,39.1,39,23,2,21,25,68,6,1,0,2022-2023,1.4367816091954024,2.4712643678160924
500,Pietro Ceccaroni,ITA,DF,Lecce,Serie A,26,1995,0.5,0,0,0,0,0,0,0,0.0,0,1,1,0,3,3,2,0,0,2022-2023,6.0,0.0
Rk,Player,Nation,Pos,Squad,Comp,0,0,90.0,0,0,3,3,3,Tkl,0,0.0,0,0,0,0,0,0,0,0,0,2022-2023,0.0,0.0
501,Federico Ceccherini,ITA,DF,Hellas Verona,Serie A,30,1992,15.7,25,19,15,9,1,13,23,56.5,10,17,10,7,19,44,55,0,0,2022-2023,1.2101910828025477,1.5923566878980893
502,Assan Ceesay,GAM,FW,Lecce,Serie A,28,1994,20.1,23,18,7,8,8,9,17,52.9,8,15,2,13,3,26,24,0,0,2022-2023,0.14925373134328357,1.144278606965174
503,Emil Ceide,NOR,FW,Sassuolo,Serie A,20,2001,5.7,5,2,5,0,0,3,5,60.0,2,3,1,2,1,6,0,0,0,2022-2023,0.17543859649122806,0.8771929824561403
504,Zeki Çelik,TUR,DF,Roma,Serie A,25,1997,16.7,42,21,19,21,2,24,41,58.5,17,33,6,27,14,56,36,2,0,2022-2023,0.8383233532934132,2.51497005988024
505,Álex Centelles,ESP,DF,Almería,La Liga,24,1997,12.5,22,14,16,3,3,16,22,72.7,6,13,2,11,11,33,40,0,0,2022-2023,0.88,1.76
506,Fabien Centonze,FRA,DF,Nantes,Ligue 1,26,1996,18.8,58,37,30,22,6,30,42,71.4,12,24,7,17,44,102,55,1,0,2022-2023,2.3404255319148937,3.085106382978723
507,Michele Cerofolini,ITA,GK,Fiorentina,Serie A,23,1999,5.0,0,0,0,0,0,0,0,0.0,0,0,0,0,1,1,2,0,0,2022-2023,0.2,0.0
508,Franco Cervi,ARG,"MF,DF",Celta Vigo,La Liga,28,1994,21.0,76,46,29,36,11,33,66,50.0,33,33,1,32,36,112,16,0,0,2022-2023,1.7142857142857142,3.619047619047619
509,Julian Chabot,GER,DF,Köln,Bundesliga,24,1998,20.0,36,23,19,14,3,20,35,57.1,15,30,18,12,41,77,105,0,0,2022-2023,2.05,1.8
510,Florian Chabrolle,FRA,MF,Ajaccio,Ligue 1,24,1998,3.7,6,4,1,5,0,2,4,50.0,2,3,0,3,7,13,2,0,0,2022-2023,1.8918918918918919,1.6216216216216215
511,El Chadaille Bitshiabu,FRA,DF,Paris S-G,Ligue 1,17,2005,6.5,10,7,7,2,1,3,12,25.0,9,9,7,2,9,19,13,3,0,2022-2023,1.3846153846153846,1.5384615384615385
512,Fares Chaïbi,ALG,"FW,MF",Toulouse,Ligue 1,19,2002,26.0,31,18,8,15,8,17,50,34.0,33,38,5,33,19,50,36,1,0,2022-2023,0.7307692307692307,1.1923076923076923
513,Nathaniel Chalobah,ENG,MF,Fulham,Premier League,27,1994,0.1,1,1,1,0,0,1,1,100.0,0,0,0,0,0,1,2,0,0,2022-2023,0.0,10.0
514,Trevoh Chalobah,ENG,DF,Chelsea,Premier League,23,1999,17.9,31,20,22,6,3,24,35,68.6,11,17,7,10,24,55,56,1,0,2022-2023,1.340782122905028,1.7318435754189945
515,Muhammed Cham,AUT,MF,Clermont Foot,Ligue 1,21,2000,21.9,30,15,15,4,11,13,35,37.1,22,13,0,13,7,37,5,0,0,2022-2023,0.31963470319634707,1.3698630136986303
516,Calum Chambers,ENG,"DF,MF",Aston Villa,Premier League,27,1995,3.9,9,6,7,2,0,6,8,75.0,2,5,4,1,7,16,10,1,0,2022-2023,1.794871794871795,2.307692307692308
517,Timothy Chandler,USA,DF,Eint Frankfurt,Bundesliga,32,1990,1.0,2,2,2,0,0,2,2,100.0,0,1,0,1,0,2,3,0,0,2022-2023,0.0,2.0
518,Gaëtan Charbonnier,FRA,"FW,MF",Auxerre,Ligue 1,33,1988,2.8,2,1,0,2,0,0,4,0.0,4,2,0,2,0,2,5,0,0,2022-2023,0.0,0.7142857142857143
519,Brendan Chardonnet,FRA,DF,Brest,Ligue 1,27,1994,27.7,45,27,27,18,0,20,38,52.6,18,40,19,21,63,108,86,1,0,2022-2023,2.2743682310469313,1.6245487364620939
520,Shea Charles,NIR,DF,Manchester City,Premier League,18,2003,0.3,4,0,4,0,0,1,1,100.0,0,0,0,0,1,5,2,0,0,2022-2023,3.3333333333333335,13.333333333333334
521,Xavier Chavalerin,FRA,MF,Troyes,Ligue 1,31,1991,27.0,82,50,39,30,13,27,71,38.0,44,31,8,23,41,123,24,0,0,2022-2023,1.5185185185185186,3.037037037037037
522,Pep Chavarría,ESP,"FW,MF",Rayo Vallecano,La Liga,24,1998,4.1,6,4,2,1,3,1,5,20.0,4,8,0,8,2,8,8,0,0,2022-2023,0.48780487804878053,1.4634146341463417
523,Ivane Chegra,FRA,"MF,FW",Ajaccio,Ligue 1,18,2004,2.1,8,3,6,1,1,4,11,36.4,7,0,0,0,1,9,0,0,0,2022-2023,0.47619047619047616,3.8095238095238093
524,Pape Cheikh Diop,SEN,MF,Elche,La Liga,24,1997,0.4,0,0,0,0,0,0,1,0.0,1,0,0,0,0,0,0,0,0,2022-2023,0.0,0.0
525,Rayan Cherki,FRA,"MF,FW",Lyon,Ligue 1,18,2003,20.8,14,8,2,5,7,8,23,34.8,15,6,0,6,5,19,1,0,0,2022-2023,0.24038461538461536,0.673076923076923
Rk,Player,Nation,Pos,Squad,Comp,0,0,90.0,0,0,3,3,3,Tkl,0,0.0,0,0,0,0,0,0,0,0,0,2022-2023,0.0,0.0
526,Ilyes Cheti,ALG,DF,Angers,Ligue 1,27,1995,2.3,6,4,4,0,2,5,8,62.5,3,5,1,4,4,10,7,0,0,2022-2023,1.7391304347826089,2.608695652173913
527,Lucas Chevalier,FRA,GK,Lille,Ligue 1,20,2001,32.0,2,1,2,0,0,2,2,100.0,0,1,0,1,2,4,7,2,0,2022-2023,0.0625,0.0625
528,Fabio Chiarodia,ITA,DF,Werder Bremen,Bundesliga,17,2005,0.7,0,0,0,0,0,0,0,0.0,0,1,0,1,2,2,4,0,0,2022-2023,2.857142857142857,0.0
529,Federico Chiesa,ITA,"DF,MF",Juventus,Serie A,24,1997,9.5,22,11,6,6,10,5,14,35.7,9,13,1,12,0,22,1,0,0,2022-2023,0.0,2.3157894736842106
530,Ben Chilwell,ENG,"DF,MF",Chelsea,Premier League,25,1996,15.6,21,17,12,8,1,13,25,52.0,12,21,2,19,18,39,26,0,0,2022-2023,1.153846153846154,1.3461538461538463
531,Vlad Chiricheș,ROU,DF,Cremonese,Serie A,32,1989,10.9,35,20,27,7,1,16,24,66.7,8,36,23,13,22,57,44,0,0,2022-2023,2.018348623853211,3.2110091743119265
532,Pedro Chirivella,ESP,MF,Nantes,Ligue 1,25,1997,22.5,33,22,12,15,6,17,44,38.6,27,24,1,23,20,53,7,0,0,2022-2023,0.8888888888888888,1.4666666666666666
533,Joris Chotard,FRA,MF,Montpellier,Ligue 1,20,2001,27.3,64,34,37,23,4,40,78,51.3,38,40,11,29,40,104,42,1,0,2022-2023,1.465201465201465,2.3443223443223444
534,Andreas Christensen,DEN,DF,Barcelona,La Liga,26,1996,19.6,20,15,9,11,0,10,16,62.5,6,14,12,2,21,41,47,0,0,2022-2023,1.0714285714285714,1.0204081632653061
535,Oliver Christensen,DEN,GK,Hertha BSC,Bundesliga,23,1999,33.0,1,0,1,0,0,0,2,0.0,2,0,0,0,0,1,22,2,0,2022-2023,0.0,0.030303030303030304
536,Ryan Christie,SCO,"MF,FW",Bournemouth,Premier League,27,1995,20.4,34,22,10,23,1,14,50,28.0,36,16,4,12,26,60,20,0,0,2022-2023,1.2745098039215688,1.6666666666666667
537,Carney Chukwuemeka,ENG,"MF,FW",Chelsea,Premier League,18,2003,3.9,13,7,7,6,0,3,5,60.0,2,7,0,7,6,19,1,0,0,2022-2023,1.5384615384615385,3.3333333333333335
538,Samuel Chukwueze,NGA,"FW,MF",Villarreal,La Liga,23,1999,26.0,14,7,7,2,5,7,23,30.4,16,13,0,13,12,26,16,0,0,2022-2023,0.46153846153846156,0.5384615384615384
539,Chumi,ESP,DF,Almería,La Liga,23,1999,16.5,29,16,18,9,2,14,23,60.9,9,20,7,13,15,44,53,0,0,2022-2023,0.9090909090909091,1.7575757575757576
540,Darko Churlinov,MKD,FW,Stuttgart,Bundesliga,22,2000,0.3,3,2,2,1,0,2,3,66.7,1,1,0,1,0,3,0,0,0,2022-2023,0.0,10.0
541,Víctor Chust,ESP,DF,Cádiz,La Liga,22,2000,10.7,9,6,7,2,0,4,7,57.1,3,8,3,5,10,19,53,0,0,2022-2023,0.9345794392523366,0.8411214953271029
542,Tolga Ciğerci,TUR,MF,Hertha BSC,Bundesliga,30,1992,7.5,16,13,6,9,1,10,16,62.5,6,6,2,4,8,24,5,0,0,2022-2023,1.0666666666666667,2.1333333333333333
543,Yanis Cimignani,FRA,"MF,DF",Ajaccio,Ligue 1,20,2002,3.1,11,5,3,7,1,4,5,80.0,1,5,1,4,2,13,2,0,0,2022-2023,0.6451612903225806,3.5483870967741935
544,Daniel Ciofani,ITA,FW,Cremonese,Serie A,37,1985,11.8,6,3,1,2,3,4,7,57.1,3,7,1,6,2,8,10,0,0,2022-2023,0.1694915254237288,0.5084745762711864
545,Tio Cipot,SVN,"FW,MF",Spezia,Serie A,19,2003,1.5,12,7,6,3,3,6,8,75.0,2,0,0,0,0,12,2,0,0,2022-2023,0.0,8.0
546,Pathé Ciss,SEN,"MF,DF",Rayo Vallecano,La Liga,28,1994,14.2,39,29,11,23,5,15,34,44.1,19,23,10,13,22,61,34,0,0,2022-2023,1.5492957746478875,2.746478873239437
547,Souleymane Cissé,FRA,DF,Clermont Foot,Ligue 1,19,2002,0.4,1,1,1,0,0,1,1,100.0,0,1,1,0,1,2,2,0,0,2022-2023,2.5,2.5
548,Patrick Ciurria,ITA,"DF,MF",Monza,Serie A,27,1995,30.6,31,18,20,10,1,17,33,51.5,16,24,2,22,7,38,32,0,0,2022-2023,0.22875816993464052,1.0130718954248366
549,Bobby Clark,ENG,MF,Liverpool,Premier League,17,2005,0.1,0,0,0,0,0,0,0,0.0,0,2,0,2,0,0,0,0,0,2022-2023,0.0,0.0
550,Alexis Claude-Maurice,FRA,FW,Nice,Ligue 1,24,1998,0.7,3,2,2,1,0,3,3,100.0,0,0,0,0,2,5,1,0,0,2022-2023,2.857142857142857,4.285714285714286
Rk,Player,Nation,Pos,Squad,Comp,0,0,90.0,0,0,3,3,3,Tkl,0,0.0,0,0,0,0,0,0,0,0,0,2022-2023,0.0,0.0
551,Alexis Claude-Maurice,FRA,"MF,FW",Lens,Ligue 1,24,1998,6.7,14,9,5,8,1,6,16,37.5,10,6,0,6,2,16,1,0,0,2022-2023,0.29850746268656714,2.08955223880597
552,Jonathan Clauss,FRA,DF,Marseille,Ligue 1,29,1992,28.8,46,28,21,16,9,23,52,44.2,29,29,4,25,31,77,40,2,0,2022-2023,1.0763888888888888,1.597222222222222
553,Carlos Clerc,ESP,"DF,MF",Elche,La Liga,30,1992,29.3,75,51,55,16,4,31,50,62.0,19,29,7,22,28,103,94,1,0,2022-2023,0.9556313993174061,2.5597269624573378
554,Nathaniel Clyne,ENG,DF,Crystal Palace,Premier League,31,1991,18.2,27,16,13,9,5,14,23,60.9,9,22,4,18,19,46,34,0,0,2022-2023,1.043956043956044,1.4835164835164836
555,Conor Coady,ENG,DF,Everton,Premier League,29,1993,23.3,14,9,8,6,0,7,15,46.7,8,21,17,4,14,28,88,3,0,2022-2023,0.6008583690987124,0.6008583690987124
556,Nicolò Cocetta,ITA,DF,Udinese,Serie A,18,2003,0.4,0,0,0,0,0,0,1,0.0,1,1,1,0,1,1,1,0,0,2022-2023,2.5,0.0
557,Marcus Coco,FRA,"FW,MF",Nantes,Ligue 1,26,1996,7.1,24,15,11,9,4,11,23,47.8,12,13,3,10,14,38,7,0,0,2022-2023,1.971830985915493,3.3802816901408455
558,Alexandre Coeff,FRA,DF,Auxerre,Ligue 1,30,1992,6.5,10,5,6,4,0,4,9,44.4,5,9,4,5,8,18,35,1,0,2022-2023,1.2307692307692308,1.5384615384615385
559,Jack Colback,ENG,MF,Nott'ham Forest,Premier League,32,1989,5.5,18,13,12,6,0,5,8,62.5,3,3,0,3,3,21,9,0,0,2022-2023,0.5454545454545454,3.272727272727273
560,Séamus Coleman,IRL,DF,Everton,Premier League,33,1988,18.4,35,26,21,10,4,19,29,65.5,10,14,7,7,22,57,58,2,0,2022-2023,1.1956521739130437,1.9021739130434785
561,David Čolina,CRO,"DF,FW",Augsburg,Bundesliga,22,2000,1.8,4,1,1,1,2,2,2,100.0,0,8,0,8,4,8,3,0,0,2022-2023,2.2222222222222223,2.2222222222222223
562,Álex Collado,ESP,MF,Elche,La Liga,23,1999,8.1,26,14,13,11,2,8,13,61.5,5,12,1,11,2,28,4,0,0,2022-2023,0.2469135802469136,3.2098765432098766
563,Diego Collado,ESP,FW,Villarreal,La Liga,21,2001,0.1,0,0,0,0,0,0,0,0.0,0,0,0,0,0,0,0,0,0,2022-2023,0.0,0.0
564,Omar Colley,GAM,DF,Sampdoria,Serie A,29,1992,15.4,17,10,10,7,0,9,12,75.0,3,9,5,4,22,39,69,1,0,2022-2023,1.4285714285714286,1.103896103896104
565,Nathan Collins,IRL,DF,Wolves,Premier League,21,2001,20.2,27,15,19,8,0,15,24,62.5,9,35,28,7,21,48,84,0,0,2022-2023,1.0396039603960396,1.3366336633663367
566,Lorenzo Colombo,ITA,FW,Lecce,Serie A,20,2002,16.8,17,9,1,9,7,6,14,42.9,8,22,0,22,2,19,7,0,0,2022-2023,0.11904761904761904,1.0119047619047619
567,Andrea Colpani,ITA,MF,Monza,Serie A,23,1999,10.5,14,9,6,5,3,8,12,66.7,4,14,2,12,3,17,6,0,0,2022-2023,0.2857142857142857,1.3333333333333333
568,Levi Colwill,ENG,DF,Brighton,Premier League,19,2003,13.6,8,7,4,4,0,4,9,44.4,5,5,3,2,15,23,37,1,0,2022-2023,1.1029411764705883,0.5882352941176471
569,Kingsley Coman,FRA,"FW,MF",Bayern Munich,Bundesliga,26,1996,15.7,11,8,3,5,3,7,17,41.2,10,19,1,18,2,13,7,0,0,2022-2023,0.12738853503184713,0.7006369426751593
570,Eray Cömert,SUI,DF,Valencia,La Liga,24,1998,18.6,35,23,24,10,1,17,33,51.5,16,23,8,15,29,64,76,1,0,2022-2023,1.5591397849462365,1.8817204301075268
571,Santi Comesaña,ESP,MF,Rayo Vallecano,La Liga,25,1996,27.2,71,44,24,41,6,38,82,46.3,44,39,3,36,32,103,17,0,0,2022-2023,1.1764705882352942,2.610294117647059
572,Andrea Consigli,ITA,GK,Sassuolo,Serie A,35,1987,35.0,1,0,1,0,0,0,1,0.0,1,0,0,0,0,1,13,3,0,2022-2023,0.0,0.02857142857142857
573,Abdu Conté,POR,DF,Troyes,Ligue 1,24,1998,14.6,25,17,14,8,3,12,22,54.5,10,13,6,7,6,31,25,0,0,2022-2023,0.4109589041095891,1.7123287671232876
574,Andrea Conti,ITA,DF,Sampdoria,Serie A,28,1994,0.3,0,0,0,0,0,0,0,0.0,0,0,0,0,0,0,0,0,0,2022-2023,0.0,0.0
575,Lewis Cook,ENG,MF,Bournemouth,Premier League,25,1997,19.1,37,22,10,22,5,18,44,40.9,26,29,10,19,23,60,31,0,0,2022-2023,1.2041884816753925,1.9371727748691099
Rk,Player,Nation,Pos,Squad,Comp,0,0,90.0,0,0,3,3,3,Tkl,0,0.0,0,0,0,0,0,0,0,0,0,2022-2023,0.0,0.0
576,Steve Cook,ENG,DF,Nott'ham Forest,Premier League,31,1991,10.6,8,4,4,4,0,5,7,71.4,2,16,11,5,12,20,51,0,0,2022-2023,1.1320754716981132,0.7547169811320755
577,Liam Cooper,SCO,DF,Leeds United,Premier League,30,1991,15.8,38,23,27,9,2,23,36,63.9,13,16,8,8,34,72,57,3,0,2022-2023,2.151898734177215,2.4050632911392404
578,Copete,ESP,DF,Mallorca,La Liga,22,1999,24.5,53,28,35,16,2,26,36,72.2,10,38,17,21,44,97,111,2,0,2022-2023,1.7959183673469388,2.163265306122449
579,Diego Coppola,ITA,DF,Hellas Verona,Serie A,18,2003,13.1,25,17,15,10,0,11,24,45.8,13,20,6,14,14,39,38,0,0,2022-2023,1.0687022900763359,1.9083969465648856
580,Francis Coquelin,FRA,MF,Villarreal,La Liga,31,1991,8.3,18,13,7,9,2,7,7,100.0,0,8,2,6,9,27,7,0,0,2022-2023,1.0843373493975903,2.1686746987951806
581,Sébastien Corchia,FRA,DF,Nantes,Ligue 1,31,1990,8.7,16,6,10,2,4,11,22,50.0,11,9,3,6,14,30,21,0,0,2022-2023,1.6091954022988506,1.8390804597701151
582,Alex Cordaz,ITA,GK,Inter,Serie A,39,1983,0.3,0,0,0,0,0,0,0,0.0,0,0,0,0,0,0,0,0,0,2022-2023,0.0,0.0
583,Maxwel Cornet,CIV,FW,West Ham,Premier League,25,1996,2.7,7,3,5,0,2,4,6,66.7,2,6,0,6,2,9,3,0,0,2022-2023,0.7407407407407407,2.5925925925925926
584,Jesús Corona,MEX,FW,Sevilla,La Liga,29,1993,1.2,1,0,1,0,0,0,1,0.0,1,0,0,0,1,2,1,0,0,2022-2023,0.8333333333333334,0.8333333333333334
585,Ángel Correa,ARG,"FW,MF",Atlético Madrid,La Liga,27,1995,16.2,12,6,6,3,3,5,16,31.3,11,17,0,17,10,22,6,1,0,2022-2023,0.617283950617284,0.7407407407407408
586,Joaquín Correa,ARG,FW,Inter,Serie A,27,1994,10.6,12,7,3,6,3,4,15,26.7,11,4,1,3,3,15,0,0,0,2022-2023,0.2830188679245283,1.1320754716981132
587,Thierry Correia,POR,DF,Valencia,La Liga,23,1999,22.3,71,52,46,22,3,31,54,57.4,23,25,2,23,24,95,54,2,0,2022-2023,1.0762331838565022,3.1838565022421523
588,Alessandro Cortinovis,ITA,MF,Hellas Verona,Serie A,21,2001,0.1,1,0,1,0,0,0,0,0.0,0,1,0,1,0,1,0,0,0,2022-2023,0.0,10.0
589,Danny da Costa,GER,DF,Mainz 05,Bundesliga,29,1993,13.7,20,16,7,8,5,12,20,60.0,8,22,3,19,9,29,26,0,0,2022-2023,0.6569343065693432,1.4598540145985401
590,David Pereira da Costa,POR,"MF,FW",Lens,Ligue 1,21,2001,15.6,13,7,1,10,2,7,19,36.8,12,19,1,18,11,24,6,0,0,2022-2023,0.7051282051282052,0.8333333333333334
591,Diego Costa,ESP,FW,Wolves,Premier League,33,1988,13.8,3,1,3,0,0,2,9,22.2,7,6,1,5,2,5,17,0,0,2022-2023,0.14492753623188406,0.21739130434782608
592,Jaume Costa,ESP,DF,Mallorca,La Liga,34,1988,28.9,50,34,26,17,7,29,51,56.9,22,13,5,8,22,72,44,1,0,2022-2023,0.7612456747404844,1.7301038062283738
593,Logan Costa,CPV,DF,Toulouse,Ligue 1,21,2001,4.6,9,4,7,1,1,6,9,66.7,3,6,3,3,4,13,12,0,0,2022-2023,0.8695652173913044,1.956521739130435
594,Nuno da Costa,CPV,"FW,MF",Auxerre,Ligue 1,31,1991,22.3,45,23,14,23,8,11,46,23.9,35,21,1,20,20,65,15,0,0,2022-2023,0.8968609865470851,2.0179372197309418
595,Samu Costa,POR,MF,Almería,La Liga,21,2000,22.1,61,31,35,20,6,29,61,47.5,32,29,7,22,37,98,64,4,0,2022-2023,1.67420814479638,2.760180995475113
596,Benoît Costil,FRA,GK,Auxerre,Ligue 1,35,1987,19.0,2,0,2,0,0,2,4,50.0,2,0,0,0,0,2,5,0,0,2022-2023,0.0,0.10526315789473684
597,Vladimír Coufal,CZE,DF,West Ham,Premier League,29,1992,23.7,58,31,37,15,6,36,51,70.6,15,24,6,18,38,96,70,0,0,2022-2023,1.6033755274261603,2.4472573839662446
598,Lassana Coulibaly,MLI,MF,Salernitana,Serie A,26,1996,32.1,84,50,42,35,7,30,73,41.1,43,35,7,28,25,109,33,2,0,2022-2023,0.778816199376947,2.616822429906542
599,Soumaïla Coulibaly,FRA,DF,Dortmund,Bundesliga,18,2003,0.5,0,0,0,0,0,0,0,0.0,0,0,0,0,0,0,0,1,0,2022-2023,0.0,0.0
600,Tanguy Coulibaly,FRA,"FW,DF",Stuttgart,Bundesliga,21,2001,3.6,12,9,9,1,2,5,12,41.7,7,10,0,10,3,15,0,0,0,2022-2023,0.8333333333333333,3.333333333333333
Rk,Player,Nation,Pos,Squad,Comp,0,0,90.0,0,0,3,3,3,Tkl,0,0.0,0,0,0,0,0,0,0,0,0,2022-2023,0.0,0.0
601,Thibaut Courtois,BEL,GK,Real Madrid,La Liga,30,1992,31.0,1,0,1,0,0,1,1,100.0,0,0,0,0,3,4,7,1,0,2022-2023,0.0967741935483871,0.03225806451612903
602,Mathieu Coutadeur,FRA,MF,Ajaccio,Ligue 1,36,1986,21.6,23,13,13,10,0,8,28,28.6,20,19,3,16,19,42,21,0,0,2022-2023,0.8796296296296295,1.0648148148148147
603,Philippe Coutinho,BRA,"MF,FW",Aston Villa,Premier League,30,1992,8.8,19,14,8,8,3,9,15,60.0,6,11,1,10,4,23,2,0,0,2022-2023,0.45454545454545453,2.1590909090909087
604,Yan Couto,BRA,"DF,MF",Girona,La Liga,20,2002,12.9,25,18,11,11,3,12,20,60.0,8,7,2,5,5,30,10,0,0,2022-2023,0.38759689922480617,1.937984496124031
605,Conor Coventry,IRL,"MF,FW",West Ham,Premier League,22,2000,0.0,0,0,0,0,0,0,0,0.0,0,0,0,0,0,0,0,0,0,2022-2023,,
606,Nicolas Cozza,FRA,DF,Montpellier,Ligue 1,23,1999,14.2,38,21,27,9,2,26,38,68.4,12,11,5,6,21,59,35,1,0,2022-2023,1.4788732394366197,2.676056338028169
607,Nicolas Cozza,FRA,DF,Wolfsburg,Bundesliga,23,1999,1.1,3,3,1,2,0,2,3,66.7,1,3,1,2,0,3,0,0,0,2022-2023,0.0,2.727272727272727
608,Alessio Cragno,ITA,GK,Monza,Serie A,28,1994,1.0,0,0,0,0,0,0,1,0.0,1,0,0,0,0,0,0,0,0,2022-2023,0.0,0.0
609,Matthew Craig,SCO,MF,Tottenham,Premier League,19,2003,0.2,4,1,2,2,0,0,0,0.0,0,0,0,0,0,4,0,0,0,2022-2023,0.0,20.0
610,Aaron Cresswell,ENG,DF,West Ham,Premier League,32,1989,24.8,21,11,12,7,2,12,31,38.7,19,21,11,10,27,48,56,0,0,2022-2023,1.0887096774193548,0.8467741935483871
611,Bryan Cristante,ITA,"MF,DF",Roma,Serie A,27,1995,32.6,113,62,55,49,9,55,90,61.1,35,39,10,29,18,131,53,0,0,2022-2023,0.5521472392638036,3.4662576687116564
612,Domen Črnigoj,SVN,MF,Salernitana,Serie A,26,1995,3.3,8,3,0,7,1,1,2,50.0,1,9,1,8,9,17,6,0,0,2022-2023,2.7272727272727275,2.4242424242424243
613,Juan Cruz Armada,ESP,DF,Osasuna,La Liga,30,1992,22.9,24,14,17,4,3,13,23,56.5,10,21,8,13,13,37,58,0,0,2022-2023,0.5676855895196506,1.0480349344978166
614,Juan Cruz,ESP,FW,Betis,La Liga,22,2000,2.0,1,0,0,1,0,1,3,33.3,2,1,0,1,0,1,0,0,0,2022-2023,0.0,0.5
615,Juan Cuadrado,COL,"DF,FW",Juventus,Serie A,34,1988,23.1,50,34,34,13,3,27,65,41.5,38,15,2,13,24,74,32,0,0,2022-2023,1.0389610389610389,2.1645021645021645
616,Marc Cucurella,ESP,DF,Chelsea,Premier League,24,1998,18.6,66,33,40,15,11,30,60,50.0,30,28,8,20,16,82,48,1,0,2022-2023,0.8602150537634408,3.548387096774193
617,Jorge Cuenca,ESP,DF,Villarreal,La Liga,22,1999,5.6,9,7,7,2,0,4,7,57.1,3,10,8,2,6,15,44,0,0,2022-2023,1.0714285714285714,1.6071428571428572
618,Braian Cufré,ARG,DF,Mallorca,La Liga,25,1996,2.4,5,2,2,1,2,2,5,40.0,3,2,1,1,2,7,1,0,0,2022-2023,0.8333333333333334,2.0833333333333335
619,Mickaël Cuisance,FRA,MF,Sampdoria,Serie A,22,1999,6.9,13,10,7,5,1,5,23,21.7,18,10,0,10,5,18,4,0,0,2022-2023,0.7246376811594203,1.8840579710144927
620,Matheus Cunha,BRA,FW,Wolves,Premier League,23,1999,10.7,7,4,0,5,2,2,10,20.0,8,15,3,12,9,16,11,0,0,2022-2023,0.8411214953271029,0.6542056074766356
621,Matheus Cunha,BRA,"FW,MF",Atlético Madrid,La Liga,23,1999,4.2,4,1,1,3,0,0,3,0.0,3,4,1,3,2,6,3,0,0,2022-2023,0.47619047619047616,0.9523809523809523
622,Curro,ESP,MF,Almería,La Liga,26,1996,0.5,2,0,1,1,0,1,2,50.0,1,0,0,0,0,2,0,0,0,2022-2023,0.0,4.0
623,Marco D'Alessandro,ITA,"DF,FW",Monza,Serie A,31,1991,3.2,4,4,3,1,0,2,5,40.0,3,2,0,2,1,5,3,0,0,2022-2023,0.3125,1.25
624,Danilo D'Ambrosio,ITA,DF,Inter,Serie A,33,1988,8.1,25,17,17,7,1,15,27,55.6,12,12,4,8,10,35,17,0,0,2022-2023,1.234567901234568,3.0864197530864197
625,Luca D'Andrea,ITA,FW,Sassuolo,Serie A,17,2004,3.5,4,0,2,1,1,1,4,25.0,3,2,0,2,1,5,1,0,0,2022-2023,0.2857142857142857,1.1428571428571428
Rk,Player,Nation,Pos,Squad,Comp,0,0,90.0,0,0,3,3,3,Tkl,0,0.0,0,0,0,0,0,0,0,0,0,2022-2023,0.0,0.0
626,Damien Da Silva,FRA,DF,Lyon,Ligue 1,34,1988,3.8,8,7,5,3,0,3,3,100.0,0,4,3,1,5,13,12,0,0,2022-2023,1.3157894736842106,2.1052631578947367
627,Moanes Dabbur,ISR,FW,Hoffenheim,Bundesliga,30,1992,10.4,11,8,4,5,2,3,9,33.3,6,8,0,8,5,16,0,0,0,2022-2023,0.4807692307692307,1.0576923076923077
628,Andréa Dacourt,FRA,MF,Nice,Ligue 1,17,2005,0.0,0,0,0,0,0,0,0,0.0,0,0,0,0,0,0,0,0,0,2022-2023,,
629,Colin Dagba,FRA,"DF,MF",Strasbourg,Ligue 1,23,1998,10.6,32,20,17,10,5,19,26,73.1,7,18,2,16,17,49,19,0,0,2022-2023,1.6037735849056605,3.018867924528302
630,Finn Dahmen,GER,GK,Mainz 05,Bundesliga,24,1998,8.0,0,0,0,0,0,0,0,0.0,0,0,0,0,0,0,3,0,0,2022-2023,0.0,0.0
631,Mahmoud Dahoud,GER,MF,Dortmund,Bundesliga,26,1996,3.7,11,9,3,4,4,7,7,100.0,0,6,2,4,7,18,3,0,0,2022-2023,1.8918918918918919,2.972972972972973
632,Patson Daka,ZAM,FW,Leicester City,Premier League,23,1998,13.2,14,8,6,8,0,3,13,23.1,10,14,2,12,7,21,7,0,0,2022-2023,0.5303030303030303,1.0606060606060606
633,Thijs Dallinga,NED,FW,Toulouse,Ligue 1,21,2000,26.1,8,6,2,2,4,1,13,7.7,12,17,3,14,3,11,20,0,0,2022-2023,0.11494252873563218,0.3065134099616858
634,Diogo Dalot,POR,DF,Manchester Utd,Premier League,23,1999,23.9,54,41,40,13,1,33,45,73.3,12,25,7,18,37,91,55,2,0,2022-2023,1.5481171548117156,2.259414225941423
635,Muhammed Damar,GER,MF,Hoffenheim,Bundesliga,18,2004,1.8,6,3,1,2,3,1,2,50.0,1,3,0,3,0,6,0,0,0,2022-2023,0.0,3.333333333333333
636,Mikkel Damsgaard,DEN,"MF,FW",Brentford,Premier League,22,2000,11.0,31,21,13,13,5,15,42,35.7,27,20,2,18,10,41,14,0,0,2022-2023,0.9090909090909091,2.8181818181818183
637,Flavius Daniliuc,AUT,DF,Salernitana,Serie A,21,2001,24.4,57,29,37,17,3,26,47,55.3,21,30,13,17,29,86,76,0,0,2022-2023,1.1885245901639345,2.336065573770492
638,Flavius Daniliuc,AUT,DF,Nice,Ligue 1,21,2001,1.0,2,0,2,0,0,1,1,100.0,0,4,1,3,0,2,1,0,0,2022-2023,0.0,2.0
639,Danilo,BRA,MF,Nott'ham Forest,Premier League,21,2001,10.8,18,7,7,9,2,6,25,24.0,19,26,6,20,9,27,19,0,0,2022-2023,0.8333333333333333,1.6666666666666665
640,Danilo,BRA,DF,Juventus,Serie A,31,1991,35.4,92,62,61,23,8,52,73,71.2,21,39,20,19,47,139,114,1,0,2022-2023,1.3276836158192091,2.598870056497175
641,Arnaut Danjuma,NED,"FW,MF",Tottenham,Premier League,25,1997,1.9,2,0,1,1,0,0,0,0.0,0,1,0,1,0,2,0,0,0,2022-2023,0.0,1.0526315789473684
642,Arnaut Danjuma,NED,FW,Villarreal,La Liga,25,1997,5.3,3,3,1,0,2,1,2,50.0,1,0,0,0,0,3,1,1,0,2022-2023,0.0,0.5660377358490566
643,Kévin Danois,FRA,MF,Auxerre,Ligue 1,18,2004,0.0,1,1,0,1,0,0,0,0.0,0,0,0,0,1,2,0,0,0,2022-2023,inf,inf
644,Kevin Danso,AUT,DF,Lens,Ligue 1,23,1998,35.9,37,19,25,11,1,19,30,63.3,11,48,34,14,33,70,124,0,0,2022-2023,0.9192200557103064,1.0306406685236769
645,Dante,BRA,DF,Nice,Ligue 1,38,1983,36.7,70,40,45,21,4,36,59,61.0,23,52,31,21,47,117,125,2,0,2022-2023,1.2806539509536783,1.9073569482288826
646,Márton Dárdai,HUN,"DF,MF",Hertha BSC,Bundesliga,20,2002,10.5,17,8,9,8,0,9,18,50.0,9,14,9,5,11,28,45,1,0,2022-2023,1.0476190476190477,1.619047619047619
647,Sergi Darder,ESP,MF,Espanyol,La Liga,28,1993,36.9,69,38,12,43,14,29,73,39.7,44,34,2,32,24,93,23,0,0,2022-2023,0.6504065040650406,1.869918699186992
648,Achraf Dari,MAR,DF,Brest,Ligue 1,23,1999,14.6,21,14,15,5,1,14,20,70.0,6,16,10,6,19,40,65,2,0,2022-2023,1.3013698630136987,1.4383561643835616
649,Vladimír Darida,CZE,MF,Hertha BSC,Bundesliga,31,1990,0.3,1,1,0,1,0,0,0,0.0,0,1,0,1,0,1,0,0,0,2022-2023,0.0,3.3333333333333335
650,Matteo Darmian,ITA,DF,Inter,Serie A,32,1989,22.5,56,30,29,15,12,31,47,66.0,16,33,5,28,21,77,36,0,0,2022-2023,0.9333333333333333,2.488888888888889
Rk,Player,Nation,Pos,Squad,Comp,0,0,90.0,0,0,3,3,3,Tkl,0,0.0,0,0,0,0,0,0,0,0,0,2022-2023,0.0,0.0
651,Josh Dasilva,ENG,MF,Brentford,Premier League,23,1998,15.4,18,9,6,6,6,6,16,37.5,10,22,6,16,5,23,7,1,0,2022-2023,0.3246753246753247,1.1688311688311688
652,David Datro Fofana,CIV,FW,Chelsea,Premier League,19,2002,0.8,3,1,1,1,1,1,1,100.0,0,1,0,1,0,3,0,0,0,2022-2023,0.0,3.75
653,Juan David Cabal,COL,DF,Hellas Verona,Serie A,21,2001,4.9,10,6,7,3,0,7,12,58.3,5,8,5,3,13,23,12,0,0,2022-2023,2.6530612244897958,2.0408163265306123
654,Jonathan David,CAN,FW,Lille,Ligue 1,22,2000,35.2,24,17,6,11,7,10,27,37.0,17,20,2,18,8,32,13,0,0,2022-2023,0.22727272727272727,0.6818181818181818
655,Alphonso Davies,CAN,DF,Bayern Munich,Bundesliga,21,2000,22.7,45,28,25,13,7,18,39,46.2,21,28,4,24,24,69,24,4,0,2022-2023,1.0572687224669604,1.9823788546255507
656,Ben Davies,WAL,DF,Tottenham,Premier League,29,1993,25.4,28,11,13,13,2,14,26,53.8,12,17,8,9,18,46,72,0,0,2022-2023,0.7086614173228347,1.1023622047244095
657,Tom Davies,ENG,MF,Everton,Premier League,24,1998,6.0,15,9,5,9,1,7,14,50.0,7,10,1,9,4,19,7,1,0,2022-2023,0.6666666666666666,2.5
658,Paweł Dawidowicz,POL,DF,Hellas Verona,Serie A,27,1995,18.1,48,31,28,17,3,22,31,71.0,9,14,9,5,23,71,71,0,0,2022-2023,1.2707182320441988,2.6519337016574585
659,Craig Dawson,ENG,DF,West Ham,Premier League,32,1990,8.0,11,7,9,2,0,5,7,71.4,2,9,6,3,6,17,26,0,0,2022-2023,0.75,1.375
660,Craig Dawson,ENG,DF,Wolves,Premier League,32,1990,15.7,9,6,6,3,0,4,7,57.1,3,31,23,8,12,21,74,2,0,2022-2023,0.7643312101910829,0.5732484076433121
661,Kevin De Bruyne,BEL,MF,Manchester City,Premier League,31,1991,26.9,28,12,3,12,13,14,39,35.9,25,27,2,25,9,37,10,0,0,2022-2023,0.3345724907063197,1.0408921933085502
662,Charles De Ketelaere,BEL,"MF,FW",Milan,Serie A,21,2001,12.4,26,12,7,14,5,13,30,43.3,17,14,2,12,4,30,9,0,0,2022-2023,0.3225806451612903,2.096774193548387
663,Manuel De Luca,ITA,"FW,MF",Sampdoria,Serie A,24,1998,0.5,0,0,0,0,0,0,0,0.0,0,0,0,0,0,0,0,0,0,2022-2023,0.0,0.0
664,Tommaso De Nipoti,ITA,MF,Atalanta,Serie A,19,2003,0.0,1,0,0,1,0,0,0,0.0,0,0,0,0,0,1,0,0,0,2022-2023,,inf
665,Rodrigo De Paul,ARG,MF,Atlético Madrid,La Liga,28,1994,21.4,35,21,11,18,6,18,35,51.4,17,20,3,17,8,43,7,0,0,2022-2023,0.3738317757009346,1.6355140186915889
666,Mattia De Sciglio,ITA,DF,Juventus,Serie A,29,1992,11.6,14,7,8,3,3,9,14,64.3,5,9,3,6,4,18,20,0,0,2022-2023,0.3448275862068966,1.206896551724138
667,Lorenzo De Silvestri,ITA,DF,Bologna,Serie A,34,1988,7.5,3,2,2,0,1,3,7,42.9,4,6,5,1,3,6,20,0,0,2022-2023,0.4,0.4
668,Thibault De Smet,BEL,DF,Reims,Ligue 1,24,1998,19.5,24,17,10,14,0,11,37,29.7,26,28,5,23,20,44,40,1,0,2022-2023,1.0256410256410255,1.2307692307692308
669,Koni De Winter,BEL,DF,Empoli,Serie A,20,2002,11.4,14,9,11,3,0,5,13,38.5,8,14,12,2,6,20,65,0,0,2022-2023,0.5263157894736842,1.2280701754385965
670,Grégoire Defrel,MTQ,FW,Sassuolo,Serie A,31,1991,13.0,9,7,5,2,2,4,13,30.8,9,11,0,11,2,11,5,0,0,2022-2023,0.15384615384615385,0.6923076923076923
671,Duccio Degl'Innocenti,ITA,MF,Empoli,Serie A,19,2003,0.0,0,0,0,0,0,0,0,0.0,0,0,0,0,1,1,0,0,0,2022-2023,inf,
672,Brecht Dejaegere,BEL,MF,Toulouse,Ligue 1,31,1991,20.1,40,23,10,20,10,15,51,29.4,36,25,5,20,14,54,11,0,0,2022-2023,0.6965174129353233,1.990049751243781
673,Romain Del Castillo,FRA,"MF,FW",Brest,Ligue 1,26,1996,15.8,39,24,13,17,9,16,36,44.4,20,14,1,13,11,50,5,0,0,2022-2023,0.6962025316455696,2.4683544303797467
674,Alberto Del Moral,ESP,MF,Villarreal,La Liga,22,2000,0.1,0,0,0,0,0,0,0,0.0,0,0,0,0,0,0,0,0,0,2022-2023,0.0,0.0
675,Thomas Delaine,FRA,"DF,MF",Strasbourg,Ligue 1,30,1992,11.9,28,14,16,6,6,13,26,50.0,13,8,3,5,16,44,9,0,0,2022-2023,1.3445378151260503,2.3529411764705883
Rk,Player,Nation,Pos,Squad,Comp,0,0,90.0,0,0,3,3,3,Tkl,0,0.0,0,0,0,0,0,0,0,0,0,2022-2023,0.0,0.0
676,Thomas Delaney,DEN,MF,Sevilla,La Liga,30,1991,3.4,4,2,0,4,0,3,5,60.0,2,3,2,1,4,8,3,0,0,2022-2023,1.1764705882352942,1.1764705882352942
677,Thomas Delaney,DEN,MF,Hoffenheim,Bundesliga,30,1991,3.3,6,3,3,2,1,3,8,37.5,5,5,0,5,1,7,4,0,0,2022-2023,0.30303030303030304,1.8181818181818183
678,Sacha Delaye,FRA,"FW,MF",Montpellier,Ligue 1,20,2002,0.2,1,0,0,0,1,1,1,100.0,0,0,0,0,0,1,0,0,0,2022-2023,0.0,5.0
679,Fran Delgado,ESP,DF,Betis,La Liga,21,2001,0.1,0,0,0,0,0,0,0,0.0,0,0,0,0,0,0,0,0,0,2022-2023,0.0,0.0
680,Andy Delort,ALG,FW,Nice,Ligue 1,30,1991,8.7,2,0,1,1,0,1,2,50.0,1,0,0,0,1,3,7,0,0,2022-2023,0.1149425287356322,0.2298850574712644
681,Andy Delort,ALG,FW,Nantes,Ligue 1,30,1991,5.2,5,4,1,2,2,2,6,33.3,4,3,0,3,0,5,2,0,0,2022-2023,0.0,0.9615384615384615
682,Karamoko Dembélé,ENG,"FW,MF",Brest,Ligue 1,19,2003,2.0,2,0,1,1,0,2,2,100.0,0,1,0,1,1,3,0,0,0,2022-2023,0.5,1.0
683,Moussa Dembélé,FRA,"FW,MF",Lyon,Ligue 1,26,1996,9.7,8,4,3,3,2,4,7,57.1,3,5,0,5,2,10,6,0,0,2022-2023,0.2061855670103093,0.8247422680412372
684,Ousmane Dembélé,FRA,FW,Barcelona,La Liga,25,1997,15.7,19,12,4,8,7,4,15,26.7,11,10,1,9,0,19,2,0,0,2022-2023,0.0,1.2101910828025477
685,Siriki Dembélé,CIV,"FW,MF",Bournemouth,Premier League,25,1996,1.2,3,1,2,1,0,0,1,0.0,1,1,0,1,1,4,1,0,0,2022-2023,0.8333333333333334,2.5
686,Siriki Dembélé,CIV,"MF,FW",Auxerre,Ligue 1,25,1996,4.1,10,6,4,3,3,4,12,33.3,8,2,0,2,1,11,2,0,0,2022-2023,0.24390243902439027,2.439024390243903
687,Merih Demiral,TUR,DF,Atalanta,Serie A,24,1998,17.1,41,29,30,11,0,26,36,72.2,10,24,7,17,24,65,57,1,0,2022-2023,1.4035087719298245,2.39766081871345
688,Kerem Demirbay,GER,MF,Leverkusen,Bundesliga,29,1993,17.2,36,18,16,17,3,18,34,52.9,16,26,6,20,16,52,11,0,0,2022-2023,0.9302325581395349,2.0930232558139537
689,Ermedin Demirović,BIH,"FW,MF",Augsburg,Bundesliga,24,1998,26.3,31,14,9,12,10,9,22,40.9,13,31,4,27,14,45,37,0,0,2022-2023,0.532319391634981,1.1787072243346006
690,Diego Demme,GER,MF,Napoli,Serie A,30,1991,1.6,1,0,1,0,0,0,4,0.0,4,2,0,2,0,1,1,0,0,2022-2023,0.0,0.625
691,Sepp van den Berg,NED,DF,Schalke 04,Bundesliga,20,2001,7.7,5,4,2,2,1,1,4,25.0,3,8,5,3,13,18,33,2,0,2022-2023,1.6883116883116882,0.6493506493506493
692,Branco van den Boomen,NED,MF,Toulouse,Ligue 1,27,1995,32.1,71,36,26,32,13,36,89,40.4,53,27,4,23,10,81,27,2,0,2022-2023,0.3115264797507788,2.2118380062305296
693,Leander Dendoncker,BEL,MF,Aston Villa,Premier League,27,1995,7.7,19,9,11,6,2,11,22,50.0,11,19,4,15,10,29,12,0,0,2022-2023,1.2987012987012987,2.4675324675324677
694,Leander Dendoncker,BEL,MF,Wolves,Premier League,27,1995,2.4,4,2,0,3,1,2,3,66.7,1,2,0,2,9,13,4,0,0,2022-2023,3.75,1.6666666666666667
695,Emmanuel Dennis,NGA,"FW,MF",Nott'ham Forest,Premier League,24,1997,8.0,17,11,5,5,7,8,18,44.4,10,13,1,12,2,19,6,0,0,2022-2023,0.25,2.125
696,Fabio Depaoli,ITA,DF,Hellas Verona,Serie A,25,1997,24.1,48,28,25,16,7,25,44,56.8,19,32,6,26,18,66,33,3,0,2022-2023,0.7468879668049793,1.9917012448132778
697,Fabio Depaoli,ITA,"DF,MF",Sampdoria,Serie A,25,1997,1.5,5,3,2,3,0,3,4,75.0,1,1,0,1,1,6,4,0,0,2022-2023,0.6666666666666666,3.3333333333333335
698,Kastriot Dermaku,ALB,DF,Lecce,Serie A,30,1992,0.4,0,0,0,0,0,0,0,0.0,0,0,0,0,0,0,0,0,0,2022-2023,0.0,0.0
699,Halil Dervişoğlu,TUR,MF,Brentford,Premier League,22,1999,0.1,0,0,0,0,0,0,1,0.0,1,0,0,0,0,0,0,0,0,2022-2023,0.0,0.0
700,Rémy Descamps,FRA,GK,Nantes,Ligue 1,26,1996,1.0,0,0,0,0,0,0,0,0.0,0,0,0,0,0,0,0,0,0,2022-2023,0.0,0.0
Rk,Player,Nation,Pos,Squad,Comp,0,0,90.0,0,0,3,3,3,Tkl,0,0.0,0,0,0,0,0,0,0,0,0,2022-2023,0.0,0.0
701,Mikkel Desler,DEN,DF,Toulouse,Ligue 1,27,1995,25.1,71,38,36,27,8,43,67,64.2,24,35,6,29,36,107,48,2,0,2022-2023,1.4342629482071712,2.828685258964143
702,Cyriel Dessers,NGA,FW,Cremonese,Serie A,27,1994,17.6,11,4,4,4,3,2,6,33.3,4,14,2,12,3,14,5,0,0,2022-2023,0.17045454545454544,0.625
703,Sergiño Dest,USA,DF,Milan,Serie A,21,2000,3.7,12,6,3,5,4,3,4,75.0,1,1,0,1,4,16,2,0,0,2022-2023,1.081081081081081,3.243243243243243
704,Mattia Destro,ITA,"FW,MF",Empoli,Serie A,31,1991,6.4,1,1,0,1,0,0,0,0.0,0,2,0,2,1,2,5,0,0,2022-2023,0.15625,0.15625
705,Gerard Deulofeu,ESP,FW,Udinese,Serie A,28,1994,13.5,8,5,5,1,2,5,15,33.3,10,8,1,7,2,10,1,0,0,2022-2023,0.14814814814814814,0.5925925925925926
706,Kiernan Dewsbury-Hall,ENG,MF,Leicester City,Premier League,23,1998,25.6,53,29,14,34,5,19,47,40.4,28,55,13,42,28,81,21,0,0,2022-2023,1.09375,2.0703125
707,Samuel Di Carmine,ITA,"FW,MF",Cremonese,Serie A,33,1988,0.3,0,0,0,0,0,0,0,0.0,0,0,0,0,0,0,0,0,0,2022-2023,0.0,0.0
708,Federico Di Francesco,ITA,"FW,MF",Lecce,Serie A,28,1994,22.6,28,16,7,11,10,9,19,47.4,10,16,0,16,8,36,14,0,0,2022-2023,0.35398230088495575,1.238938053097345
709,Michele Di Gregorio,ITA,GK,Monza,Serie A,25,1997,37.0,0,0,0,0,0,0,3,0.0,3,1,0,1,4,4,18,3,0,2022-2023,0.10810810810810811,0.0
710,Giovanni Di Lorenzo,ITA,DF,Napoli,Serie A,28,1993,36.2,60,29,33,19,8,25,49,51.0,24,30,9,21,30,90,60,0,0,2022-2023,0.8287292817679557,1.6574585635359114
711,Ángel Di María,ARG,"FW,MF",Juventus,Serie A,34,1988,15.1,10,5,3,5,2,3,19,15.8,16,15,0,15,7,17,0,0,0,2022-2023,0.4635761589403974,0.6622516556291391
712,Boulaye Dia,SEN,"FW,MF",Salernitana,Serie A,25,1996,28.0,12,5,3,6,3,2,7,28.6,5,10,0,10,7,19,27,1,0,2022-2023,0.25,0.42857142857142855
713,Moussa Diaby,FRA,"FW,MF",Leverkusen,Bundesliga,23,1999,30.0,14,8,4,8,2,7,14,50.0,7,8,0,8,5,19,3,0,0,2022-2023,0.16666666666666666,0.4666666666666667
714,Mouctar Diakhaby,GUI,DF,Valencia,La Liga,25,1996,27.2,30,16,19,11,0,13,20,65.0,7,30,17,13,20,50,111,2,0,2022-2023,0.7352941176470589,1.1029411764705883
715,Mamadou Diakhon,FRA,FW,Reims,Ligue 1,16,2005,0.2,2,0,2,0,0,0,1,0.0,1,1,0,1,1,3,0,0,0,2022-2023,5.0,10.0
716,Bafodé Diakité,FRA,DF,Lille,Ligue 1,21,2001,29.5,54,35,23,24,7,32,57,56.1,25,37,8,29,17,71,58,0,0,2022-2023,0.576271186440678,1.8305084745762712
717,Ibrahim Diakité,GUI,DF,Reims,Ligue 1,18,2003,1.5,3,3,3,0,0,2,3,66.7,1,0,0,0,5,8,6,0,0,2022-2023,3.3333333333333335,2.0
718,Abdou Diallo,SEN,"DF,MF",RB Leipzig,Bundesliga,26,1996,5.3,6,5,5,1,0,1,3,33.3,2,8,5,3,8,14,22,0,0,2022-2023,1.509433962264151,1.1320754716981132
719,Baila Diallo,FRA,"DF,MF",Clermont Foot,Ligue 1,21,2001,1.0,1,0,1,0,0,0,0,0.0,0,1,1,0,0,1,1,0,0,2022-2023,0.0,1.0
720,Habib Diallo,SEN,FW,Strasbourg,Ligue 1,27,1995,32.0,18,10,8,7,3,6,16,37.5,10,19,4,15,12,30,26,0,0,2022-2023,0.375,0.5625
721,Ibrahima Diallo,FRA,MF,Southampton,Premier League,23,1999,9.1,25,15,14,10,1,8,14,57.1,6,11,1,10,6,31,11,0,0,2022-2023,0.6593406593406593,2.7472527472527473
722,Ismael Diallo,CIV,DF,Ajaccio,Ligue 1,25,1997,24.2,46,33,35,9,2,35,63,55.6,28,26,12,14,30,76,46,1,0,2022-2023,1.2396694214876034,1.9008264462809918
723,Habib Diarra,SEN,"MF,FW",Strasbourg,Ligue 1,18,2004,18.1,24,16,10,11,3,15,29,51.7,14,17,1,16,11,35,13,0,0,2022-2023,0.6077348066298343,1.3259668508287292
724,Mamady Diarra,MLI,"MF,DF",Cádiz,La Liga,22,2000,0.7,2,1,2,0,0,1,2,50.0,1,2,0,2,0,2,0,0,0,2022-2023,0.0,2.857142857142857
725,Moussa Diarra,MLI,DF,Toulouse,Ligue 1,21,2000,13.6,20,9,9,9,2,9,15,60.0,6,25,10,15,19,39,27,1,0,2022-2023,1.397058823529412,1.4705882352941178
Rk,Player,Nation,Pos,Squad,Comp,0,0,90.0,0,0,3,3,3,Tkl,0,0.0,0,0,0,0,0,0,0,0,0,2022-2023,0.0,0.0
726,Stéphane Diarra,FRA,"FW,MF",Lorient,Ligue 1,23,1998,11.8,25,17,14,9,2,11,29,37.9,18,13,1,12,22,47,9,0,0,2022-2023,1.8644067796610169,2.11864406779661
727,Youba Diarra,MLI,MF,Cádiz,La Liga,24,1998,1.1,3,0,2,1,0,1,5,20.0,4,7,1,6,2,5,3,0,0,2022-2023,1.8181818181818181,2.727272727272727
728,Rúben Dias,POR,DF,Manchester City,Premier League,25,1997,22.2,21,13,10,10,1,11,18,61.1,7,21,13,8,18,39,56,1,0,2022-2023,0.8108108108108109,0.9459459459459459
729,Krépin Diatta,SEN,"MF,FW",Monaco,Ligue 1,23,1999,23.0,30,21,4,17,9,13,32,40.6,19,29,1,28,17,47,12,0,0,2022-2023,0.7391304347826086,1.3043478260869565
730,Mory Diaw,SEN,GK,Clermont Foot,Ligue 1,29,1993,37.0,0,0,0,0,0,0,4,0.0,4,0,0,0,2,2,13,5,0,2022-2023,0.05405405405405406,0.0
731,Brahim Díaz,MAR,"MF,FW",Milan,Serie A,22,1999,21.4,32,15,5,22,5,5,15,33.3,10,11,0,11,7,39,6,0,0,2022-2023,0.3271028037383178,1.4953271028037385
732,Luis Díaz,COL,FW,Liverpool,Premier League,25,1997,11.1,17,11,4,8,5,8,15,53.3,7,8,0,8,6,23,2,0,0,2022-2023,0.5405405405405406,1.5315315315315317
733,Justin Diehl,GER,"MF,FW",Köln,Bundesliga,17,2004,0.2,0,0,0,0,0,0,0,0.0,0,0,0,0,0,0,0,0,0,2022-2023,0.0,0.0
734,Bamba Dieng,SEN,"FW,MF",Marseille,Ligue 1,22,2000,2.2,4,4,2,1,1,3,4,75.0,1,5,1,4,0,4,0,0,0,2022-2023,0.0,1.8181818181818181
735,Bamba Dieng,SEN,FW,Lorient,Ligue 1,22,2000,8.3,19,10,5,12,2,3,11,27.3,8,6,0,6,2,21,6,0,0,2022-2023,0.24096385542168672,2.2891566265060237
736,Eric Dier,ENG,DF,Tottenham,Premier League,28,1994,31.3,30,19,16,12,2,9,19,47.4,10,41,24,17,35,65,112,2,0,2022-2023,1.1182108626198082,0.9584664536741214
737,Florian Dietz,GER,FW,Köln,Bundesliga,23,1998,4.4,2,1,0,2,0,1,4,25.0,3,4,1,3,0,2,2,0,0,2022-2023,0.0,0.45454545454545453
738,Lucas Digne,FRA,DF,Aston Villa,Premier League,29,1993,16.7,30,12,20,9,1,20,33,60.6,13,18,5,13,18,48,45,0,0,2022-2023,1.0778443113772456,1.7964071856287427
739,Federico Dimarco,ITA,DF,Inter,Serie A,24,1997,23.0,31,25,6,18,7,9,19,47.4,10,15,4,11,18,49,20,0,0,2022-2023,0.782608695652174,1.3478260869565217
740,Stole Dimitrievski,MKD,GK,Rayo Vallecano,La Liga,28,1993,36.9,1,0,1,0,0,1,2,50.0,1,2,0,2,1,2,17,3,0,2022-2023,0.02710027100271003,0.02710027100271003
741,Junior Dina Ebimbe,FRA,"DF,MF",Eint Frankfurt,Bundesliga,21,2000,11.8,30,19,16,14,0,16,33,48.5,17,18,5,13,11,41,20,0,0,2022-2023,0.9322033898305084,2.542372881355932
742,Tristan Dingomé,CMR,MF,Troyes,Ligue 1,31,1991,1.1,1,1,0,1,0,0,2,0.0,2,0,0,0,0,1,0,0,0,2022-2023,0.0,0.9090909090909091
743,Eren Dinkçi,GER,"FW,MF",Werder Bremen,Bundesliga,20,2001,2.6,5,5,2,1,2,2,6,33.3,4,2,0,2,0,5,2,0,0,2022-2023,0.0,1.923076923076923
744,Sinaly Diomande,CIV,DF,Lyon,Ligue 1,21,2001,21.7,42,24,26,15,1,31,49,63.3,18,26,13,13,49,91,75,1,0,2022-2023,2.2580645161290325,1.935483870967742
745,Lois Diony,FRA,FW,Angers,Ligue 1,29,1992,5.6,1,0,0,1,0,1,3,33.3,2,2,0,2,0,1,1,0,0,2022-2023,0.0,0.17857142857142858
746,Edan Diop,FRA,"DF,FW",Monaco,Ligue 1,17,2004,2.5,13,8,3,3,7,7,15,46.7,8,7,1,6,4,17,1,0,0,2022-2023,1.6,5.2
747,Issa Diop,FRA,DF,Fulham,Premier League,25,1997,22.4,28,19,18,9,1,17,32,53.1,15,24,17,7,35,63,86,0,0,2022-2023,1.5625,1.25
748,Sofiane Diop,FRA,"MF,FW",Nice,Ligue 1,22,2000,13.6,23,11,12,6,5,7,20,35.0,13,14,2,12,16,39,5,0,0,2022-2023,1.1764705882352942,1.6911764705882353
749,Sofiane Diop,FRA,MF,Monaco,Ligue 1,22,2000,0.7,0,0,0,0,0,0,0,0.0,0,0,0,0,1,1,0,0,0,2022-2023,1.4285714285714286,0.0
750,Yehvann Diouf,FRA,GK,Reims,Ligue 1,22,1999,31.0,2,0,2,0,0,1,3,33.3,2,0,0,0,1,3,13,5,0,2022-2023,0.03225806451612903,0.06451612903225806
Rk,Player,Nation,Pos,Squad,Comp,0,0,90.0,0,0,3,3,3,Tkl,0,0.0,0,0,0,0,0,0,0,0,0,2022-2023,0.0,0.0
751,Axel Disasi,FRA,DF,Monaco,Ligue 1,24,1998,37.0,30,20,13,13,4,13,27,48.1,14,51,31,20,56,86,112,2,0,2022-2023,1.5135135135135136,0.8108108108108109
752,Tiago Djaló,POR,DF,Lille,Ligue 1,22,2000,22.4,31,21,23,7,1,13,20,65.0,7,17,11,6,23,54,60,1,0,2022-2023,1.0267857142857144,1.3839285714285716
753,Djené,TOG,DF,Getafe,La Liga,30,1991,31.6,41,28,23,17,1,22,38,57.9,16,25,10,15,42,83,81,1,0,2022-2023,1.3291139240506329,1.2974683544303798
754,Moussa Djenepo,MLI,"DF,FW",Southampton,Premier League,24,1998,7.9,19,11,13,5,1,11,27,40.7,16,19,2,17,11,30,7,0,0,2022-2023,1.3924050632911391,2.4050632911392404
755,Koffi Djidji,CIV,DF,Torino,Serie A,29,1992,26.9,50,25,32,17,1,18,32,56.3,14,29,14,15,34,84,72,0,0,2022-2023,1.2639405204460967,1.858736059479554
756,Alexander Djiku,GHA,DF,Strasbourg,Ligue 1,27,1994,29.7,53,36,37,16,0,26,46,56.5,20,45,19,26,66,119,151,3,0,2022-2023,2.2222222222222223,1.7845117845117846
757,Berat Djimsiti,ALB,DF,Atalanta,Serie A,29,1993,20.0,34,19,21,13,0,17,25,68.0,8,17,7,10,36,70,74,1,0,2022-2023,1.8,1.7
758,Moussa Djitte,SEN,FW,Ajaccio,Ligue 1,22,1999,1.5,1,0,0,0,1,1,2,50.0,1,0,0,0,0,1,1,0,0,2022-2023,0.0,0.6666666666666666
759,Ouparine Djoco,GNB,GK,Clermont Foot,Ligue 1,24,1998,1.0,0,0,0,0,0,0,0,0.0,0,0,0,0,0,0,1,0,0,2022-2023,0.0,0.0
760,Marko Dmitrović,SRB,GK,Sevilla,La Liga,30,1992,14.1,0,0,0,0,0,0,0,0.0,0,0,0,0,0,0,6,0,0,2022-2023,0.0,0.0
761,Alan Do Marcolino,GAB,FW,Rennes,Ligue 1,20,2002,0.2,0,0,0,0,0,0,0,0.0,0,0,0,0,0,0,1,0,0,2022-2023,0.0,0.0
762,Ben Doak,SCO,FW,Liverpool,Premier League,16,2005,0.3,3,2,1,2,0,1,1,100.0,0,1,0,1,0,3,0,0,0,2022-2023,0.0,10.0
763,Ritsu Doan,JPN,"MF,FW",Freiburg,Bundesliga,24,1998,26.9,61,29,19,29,13,25,55,45.5,30,40,1,39,14,75,12,0,0,2022-2023,0.5204460966542751,2.2676579925650557
764,Dodô,BRA,DF,Fiorentina,Serie A,23,1998,25.9,40,22,20,14,6,22,46,47.8,24,26,2,24,25,65,37,0,0,2022-2023,0.9652509652509653,1.5444015444015444
765,Danilho Doekhi,NED,DF,Union Berlin,Bundesliga,24,1998,24.6,38,23,21,17,0,14,26,53.8,12,27,12,15,29,67,93,0,0,2022-2023,1.178861788617886,1.5447154471544715
766,Matt Doherty,IRL,"DF,MF",Tottenham,Premier League,30,1992,7.4,16,10,12,3,1,8,10,80.0,2,11,6,5,8,24,14,1,0,2022-2023,1.081081081081081,2.162162162162162
767,Matt Doherty,IRL,DF,Atlético Madrid,La Liga,30,1992,0.2,0,0,0,0,0,0,0,0.0,0,2,0,2,0,0,0,0,0,2022-2023,0.0,0.0
768,Josh Doig,SCO,DF,Hellas Verona,Serie A,20,2002,15.0,19,8,6,7,6,6,16,37.5,10,25,6,19,11,30,13,1,0,2022-2023,0.7333333333333333,1.2666666666666666
769,Jeremy Doku,BEL,"MF,FW",Rennes,Ligue 1,20,2002,14.3,25,16,6,13,6,12,24,50.0,12,10,0,10,5,30,2,0,0,2022-2023,0.34965034965034963,1.7482517482517481
770,Kasper Dolberg,DEN,FW,Sevilla,La Liga,24,1997,2.2,1,0,0,1,0,1,3,33.3,2,0,0,0,0,1,5,0,0,2022-2023,0.0,0.45454545454545453
771,Kasper Dolberg,DEN,"FW,MF",Hoffenheim,Bundesliga,24,1997,4.5,7,5,1,4,2,4,6,66.7,2,6,2,4,0,7,5,0,0,2022-2023,0.0,1.5555555555555556
772,Carlos Dominguez,ESP,DF,Celta Vigo,La Liga,21,2001,1.2,1,1,0,1,0,1,2,50.0,1,1,1,0,0,1,7,0,0,2022-2023,0.0,0.8333333333333334
773,Nicolás Domínguez,ARG,MF,Bologna,Serie A,24,1998,25.6,79,49,34,33,12,39,76,51.3,37,29,3,26,21,100,29,1,0,2022-2023,0.8203125,3.0859375
774,John Donald,ESP,"MF,DF",Elche,La Liga,21,2000,12.1,20,11,9,9,2,7,14,50.0,7,14,7,7,14,34,23,1,0,2022-2023,1.15702479338843,1.6528925619834711
775,Giulio Donati,ITA,DF,Monza,Serie A,32,1990,4.7,4,1,1,1,2,3,6,50.0,3,3,1,2,4,8,11,0,0,2022-2023,0.851063829787234,0.851063829787234
Rk,Player,Nation,Pos,Squad,Comp,0,0,90.0,0,0,3,3,3,Tkl,0,0.0,0,0,0,0,0,0,0,0,0,2022-2023,0.0,0.0
776,Kyliane Dong,FRA,"MF,FW",Troyes,Ligue 1,17,2004,2.4,3,1,0,2,1,1,2,50.0,1,1,0,1,1,4,0,0,0,2022-2023,0.4166666666666667,1.25
777,Jordan Dongmo,CMR,MF,Troyes,Ligue 1,21,2001,0.2,1,0,0,1,0,1,1,100.0,0,0,0,0,0,1,0,0,0,2022-2023,0.0,5.0
778,Gianluigi Donnarumma,ITA,GK,Paris S-G,Ligue 1,23,1999,37.9,1,0,1,0,0,1,2,50.0,1,0,0,0,0,1,12,4,0,2022-2023,0.0,0.026385224274406333
779,Niklas Dorsch,GER,MF,Augsburg,Bundesliga,24,1998,5.4,21,12,8,11,2,9,16,56.3,7,9,3,6,6,27,9,0,0,2022-2023,1.111111111111111,3.888888888888889
780,Jodel Dossou,BEN,"MF,DF",Clermont Foot,Ligue 1,30,1992,2.9,7,4,3,2,2,4,4,100.0,0,2,1,1,1,8,0,0,0,2022-2023,0.3448275862068966,2.413793103448276
781,Lohann Doucet,FRA,"MF,FW",Nantes,Ligue 1,19,2002,1.0,3,0,2,0,1,3,4,75.0,1,2,0,2,2,5,4,0,0,2022-2023,2.0,3.0
782,Abdoulaye Doucouré,MLI,MF,Everton,Premier League,29,1993,17.0,31,20,9,15,7,12,37,32.4,25,26,3,23,13,44,11,0,0,2022-2023,0.7647058823529411,1.8235294117647058
783,Cheick Doucouré,MLI,MF,Crystal Palace,Premier League,22,2000,30.8,77,46,40,33,4,29,52,55.8,23,47,13,34,56,133,48,0,0,2022-2023,1.8181818181818181,2.5
784,Siriné Doucouré,MLI,"FW,MF",Lorient,Ligue 1,20,2002,1.5,2,2,2,0,0,1,2,50.0,1,0,0,0,1,3,0,0,0,2022-2023,0.6666666666666666,1.3333333333333333
785,Désiré Doué,FRA,"MF,FW",Rennes,Ligue 1,17,2005,12.4,37,18,10,23,4,13,32,40.6,19,17,1,16,13,50,3,0,0,2022-2023,1.0483870967741935,2.9838709677419355
786,Guela Doué,CIV,"FW,MF",Rennes,Ligue 1,19,2002,0.1,0,0,0,0,0,0,0,0.0,0,0,0,0,0,0,0,0,0,2022-2023,0.0,0.0
787,Ismaël Doukouré,FRA,"DF,MF",Strasbourg,Ligue 1,19,2003,25.5,48,24,23,21,4,20,34,58.8,14,26,8,18,27,75,54,0,0,2022-2023,1.0588235294117647,1.8823529411764706
788,Kamory Doumbia,MLI,MF,Reims,Ligue 1,19,2003,12.8,31,16,9,14,8,12,37,32.4,25,17,1,16,13,44,3,0,0,2022-2023,1.015625,2.421875
789,Souleyman Doumbia,CIV,"DF,FW",Angers,Ligue 1,25,1996,19.9,45,31,31,13,1,17,31,54.8,14,20,3,17,27,72,27,1,0,2022-2023,1.35678391959799,2.261306532663317
790,Flynn Downes,ENG,MF,West Ham,Premier League,23,1999,8.5,16,9,4,10,2,6,12,50.0,6,15,2,13,7,23,6,0,0,2022-2023,0.8235294117647058,1.8823529411764706
791,Kami Doyle,ENG,MF,Southampton,Premier League,16,2005,0.1,0,0,0,0,0,0,0,0.0,0,0,0,0,0,0,0,0,0,2022-2023,0.0,0.0
792,Bartłomiej Drągowski,POL,GK,Spezia,Serie A,24,1997,32.7,1,0,1,0,0,1,5,20.0,4,0,0,0,1,2,15,3,0,2022-2023,0.030581039755351678,0.030581039755351678
793,Cody Drameh,ENG,DF,Leeds United,Premier League,20,2001,0.8,5,4,0,4,1,2,3,66.7,1,0,0,0,1,6,1,0,0,2022-2023,1.25,6.25
794,Dion Drena Beljo,CRO,FW,Augsburg,Bundesliga,20,2002,12.5,7,6,3,2,2,2,13,15.4,11,15,2,13,1,8,14,0,0,2022-2023,0.08,0.56
795,Dominick Drexler,GER,"MF,FW",Schalke 04,Bundesliga,32,1990,15.2,25,17,12,10,3,9,22,40.9,13,18,2,16,8,33,12,0,0,2022-2023,0.5263157894736842,1.6447368421052633
796,Domingos Duarte,POR,DF,Getafe,La Liga,27,1995,29.5,26,18,21,5,0,19,26,73.1,7,29,23,6,39,65,145,0,0,2022-2023,1.3220338983050848,0.8813559322033898
797,Martin Dúbravka,SVK,GK,Newcastle Utd,Premier League,33,1989,1.7,0,0,0,0,0,0,1,0.0,1,0,0,0,0,0,1,0,0,2022-2023,0.0,0.0
798,Marvin Ducksch,GER,FW,Werder Bremen,Bundesliga,28,1994,31.7,8,3,2,4,2,3,16,18.8,13,13,2,11,9,17,41,1,0,2022-2023,0.28391167192429023,0.25236593059936907
799,Ondrej Duda,SVK,MF,Hellas Verona,Serie A,27,1994,11.8,22,14,7,12,3,9,16,56.3,7,11,0,11,13,35,8,0,0,2022-2023,1.1016949152542372,1.8644067796610169
800,Ondrej Duda,SVK,MF,Köln,Bundesliga,27,1994,7.7,9,8,2,5,2,4,11,36.4,7,7,1,6,2,11,3,0,0,2022-2023,0.2597402597402597,1.1688311688311688
Rk,Player,Nation,Pos,Squad,Comp,0,0,90.0,0,0,3,3,3,Tkl,0,0.0,0,0,0,0,0,0,0,0,0,2022-2023,0.0,0.0
801,Shane Duffy,IRL,"DF,FW",Fulham,Premier League,30,1992,0.2,0,0,0,0,0,0,0,0.0,0,0,0,0,0,0,0,1,0,2022-2023,0.0,0.0
802,Rémy Dugimont,FRA,"FW,MF",Auxerre,Ligue 1,36,1986,1.3,2,1,0,1,1,1,2,50.0,1,3,0,3,0,2,5,0,0,2022-2023,0.0,1.5384615384615383
803,Denzel Dumfries,NED,DF,Inter,Serie A,26,1996,24.6,35,18,17,13,5,22,34,64.7,12,33,9,24,12,47,26,0,0,2022-2023,0.4878048780487805,1.4227642276422763
804,Alfred Duncan,GHA,MF,Fiorentina,Serie A,29,1993,12.3,18,10,0,17,1,10,21,47.6,11,9,0,9,8,26,6,0,0,2022-2023,0.6504065040650406,1.4634146341463414
805,Lewis Dunk,ENG,DF,Brighton,Premier League,30,1991,36.0,30,19,19,9,2,18,41,43.9,23,37,27,10,34,64,81,1,0,2022-2023,0.9444444444444444,0.8333333333333334
806,Maxime Dupé,FRA,GK,Toulouse,Ligue 1,29,1993,38.0,0,0,0,0,0,0,0,0.0,0,0,0,0,0,0,9,3,0,2022-2023,0.0,0.0
807,Jhon Durán,COL,"FW,MF",Aston Villa,Premier League,18,2003,1.5,2,2,0,1,1,1,4,25.0,3,0,0,0,2,4,2,0,0,2022-2023,1.3333333333333333,1.3333333333333333
808,Pablo Durán,ESP,"MF,DF",Celta Vigo,La Liga,21,2001,0.4,0,0,0,0,0,0,0,0.0,0,2,1,1,1,1,2,0,0,2022-2023,2.5,0.0
809,Julien Duranville,BEL,MF,Dortmund,Bundesliga,16,2006,0.3,1,1,0,1,0,1,1,100.0,0,0,0,0,0,1,0,0,0,2022-2023,0.0,3.3333333333333335
810,Hugo Duro,ESP,FW,Valencia,La Liga,22,1999,15.4,15,12,2,6,7,7,17,41.2,10,11,1,10,2,17,7,1,0,2022-2023,0.12987012987012986,0.974025974025974
811,Jean-Kevin Duverne,HAI,DF,Brest,Ligue 1,25,1997,27.9,72,38,44,24,4,42,73,57.5,31,33,5,28,28,100,65,1,0,2022-2023,1.0035842293906811,2.5806451612903225
812,Paulo Dybala,ARG,"MF,FW",Roma,Serie A,28,1993,19.3,14,4,1,8,5,8,26,30.8,18,12,1,11,8,22,4,0,0,2022-2023,0.41450777202072536,0.7253886010362695
813,Edin Džeko,BIH,FW,Inter,Serie A,36,1986,19.2,3,2,0,3,0,0,4,0.0,4,15,1,14,3,6,25,0,0,2022-2023,0.15625,0.15625
814,Malcolm Ebiowei,ENG,"MF,FW",Crystal Palace,Premier League,18,2003,0.4,1,1,1,0,0,0,1,0.0,1,2,0,2,0,1,0,0,0,2022-2023,0.0,2.5
815,Festy Ebosele,IRL,DF,Udinese,Serie A,19,2002,4.6,15,10,8,7,0,4,10,40.0,6,5,0,5,2,17,5,0,0,2022-2023,0.4347826086956522,3.2608695652173916
816,Enzo Ebosse,CMR,DF,Udinese,Serie A,23,1999,10.3,15,9,11,4,0,9,13,69.2,4,27,6,21,11,26,29,0,0,2022-2023,1.0679611650485437,1.4563106796116503
817,Tyronne Ebuehi,NGA,DF,Empoli,Serie A,26,1995,21.4,22,14,11,7,4,9,13,69.2,4,23,12,11,12,34,79,1,0,2022-2023,0.5607476635514019,1.0280373831775702
818,Ederson,BRA,GK,Manchester City,Premier League,28,1993,35.0,3,1,3,0,0,1,2,50.0,1,0,0,0,1,4,10,2,0,2022-2023,0.02857142857142857,0.08571428571428572
819,Éderson,BRA,MF,Atalanta,Serie A,23,1999,24.6,67,34,18,42,7,29,66,43.9,37,56,7,49,36,103,31,0,0,2022-2023,1.4634146341463414,2.7235772357723578
820,Odsonne Édouard,FRA,FW,Crystal Palace,Premier League,24,1998,20.0,25,13,7,12,6,7,13,53.8,6,17,5,12,3,28,22,0,0,2022-2023,0.15,1.25
821,Samuel Edozie,ENG,"FW,MF",Southampton,Premier League,19,2003,6.3,17,10,6,10,1,3,8,37.5,5,7,0,7,6,23,6,0,0,2022-2023,0.9523809523809524,2.6984126984126986
822,Maximilian Eggestein,GER,MF,Freiburg,Bundesliga,25,1996,27.2,51,29,21,24,6,17,35,48.6,18,37,8,29,36,87,27,0,0,2022-2023,1.3235294117647058,1.875
823,Lilian Egloff,GER,"MF,FW",Stuttgart,Bundesliga,19,2002,2.7,12,10,4,5,3,4,6,66.7,2,2,0,2,1,13,1,0,0,2022-2023,0.37037037037037035,4.444444444444444
824,Íñigo Eguaras,ESP,MF,Almería,La Liga,30,1992,10.7,11,8,4,6,1,5,18,27.8,13,9,3,6,6,17,15,0,0,2022-2023,0.5607476635514019,1.0280373831775702
825,Kingsley Ehizibue,NED,DF,Udinese,Serie A,27,1995,17.1,47,31,28,13,6,29,45,64.4,16,21,3,18,10,57,42,1,0,2022-2023,0.5847953216374269,2.7485380116959064
Rk,Player,Nation,Pos,Squad,Comp,0,0,90.0,0,0,3,3,3,Tkl,0,0.0,0,0,0,0,0,0,0,0,0,2022-2023,0.0,0.0
826,Kingsley Ehizibue,NED,DF,Köln,Bundesliga,27,1995,0.7,0,0,0,0,0,0,0,0.0,0,1,0,1,2,2,1,0,0,2022-2023,2.857142857142857,0.0
827,Julian Eitschberger,GER,FW,Hertha BSC,Bundesliga,18,2004,0.0,0,0,0,0,0,0,0,0.0,0,0,0,0,0,0,0,0,0,2022-2023,,
828,Chidera Ejuke,NGA,"FW,MF",Hertha BSC,Bundesliga,24,1998,9.9,5,4,1,4,0,1,5,20.0,4,4,0,4,4,9,1,0,0,2022-2023,0.40404040404040403,0.5050505050505051
829,Albin Ekdal,SWE,MF,Spezia,Serie A,33,1989,19.3,37,20,14,20,3,19,45,42.2,26,24,2,22,26,63,36,0,0,2022-2023,1.3471502590673574,1.9170984455958548
830,Hugo Ekitike,FRA,FW,Paris S-G,Ligue 1,20,2002,12.8,12,4,1,10,1,4,12,33.3,8,12,0,12,9,21,3,0,0,2022-2023,0.703125,0.9375
831,Emmanuel Ekong,SWE,"FW,MF",Empoli,Serie A,20,2002,0.2,0,0,0,0,0,0,0,0.0,0,0,0,0,0,0,0,0,0,2022-2023,0.0,0.0
832,Anthony Elanga,SWE,FW,Manchester Utd,Premier League,20,2002,4.7,3,0,0,2,1,1,2,50.0,1,4,0,4,2,5,4,0,0,2022-2023,0.425531914893617,0.6382978723404255
833,Alberth Elis,HON,"MF,FW",Brest,Ligue 1,26,1996,2.9,4,3,1,2,1,1,7,14.3,6,1,0,1,1,5,2,0,0,2022-2023,0.3448275862068966,1.3793103448275863
834,Mikael Ellertsson,ISL,"MF,DF",Spezia,Serie A,20,2002,1.9,4,2,1,3,0,0,3,0.0,3,2,1,1,2,6,0,0,0,2022-2023,1.0526315789473684,2.1052631578947367
835,Harvey Elliott,ENG,"MF,FW",Liverpool,Premier League,19,2003,17.9,27,18,6,12,9,9,37,24.3,28,26,1,25,15,42,8,0,0,2022-2023,0.8379888268156426,1.5083798882681565
836,Elif Elmas,MKD,"FW,MF",Napoli,Serie A,22,1999,18.1,24,13,8,12,4,11,23,47.8,12,18,2,16,11,35,5,0,0,2022-2023,0.6077348066298343,1.3259668508287292
837,Mohamed Elneny,EGY,MF,Arsenal,Premier League,30,1992,1.3,1,1,1,0,0,1,1,100.0,0,0,0,0,0,1,0,0,0,2022-2023,0.0,0.7692307692307692
838,Aritz Elustondo,ESP,DF,Real Sociedad,La Liga,28,1994,16.1,26,17,15,10,1,14,26,53.8,12,15,6,9,20,46,43,1,0,2022-2023,1.2422360248447204,1.6149068322981366
839,Nico Elvedi,SUI,DF,Gladbach,Bundesliga,25,1996,31.4,46,24,32,12,2,27,41,65.9,14,31,16,15,35,81,149,3,0,2022-2023,1.1146496815286624,1.4649681528662422
840,Rodrigo Ely,BRA,DF,Almería,La Liga,28,1993,35.1,30,21,26,4,0,18,25,72.0,7,46,33,13,31,61,203,1,0,2022-2023,0.8831908831908831,0.8547008547008547
841,Mohamed Elyounoussi,NOR,"MF,FW",Southampton,Premier League,27,1994,24.1,46,28,22,20,4,19,44,43.2,25,40,3,37,27,73,37,0,0,2022-2023,1.120331950207469,1.908713692946058
842,Adri Embarba,ESP,"FW,MF",Almería,La Liga,30,1992,16.4,50,27,21,26,3,22,46,47.8,24,23,0,23,9,59,9,0,0,2022-2023,0.5487804878048781,3.048780487804878
843,Adri Embarba,ESP,FW,Espanyol,La Liga,30,1992,0.4,1,0,0,1,0,1,1,100.0,0,1,0,1,0,1,0,0,0,2022-2023,0.0,2.5
844,Breel Embolo,SUI,FW,Monaco,Ligue 1,25,1997,20.7,15,9,2,7,6,5,10,50.0,5,14,3,11,5,20,12,0,0,2022-2023,0.24154589371980678,0.7246376811594203
845,Emerson,BRA,DF,Tottenham,Premier League,23,1999,19.3,54,33,38,12,4,27,40,67.5,13,17,3,14,18,72,75,0,0,2022-2023,0.9326424870466321,2.797927461139896
846,Youssef En-Nesyri,MAR,FW,Sevilla,La Liga,25,1997,18.5,16,8,3,7,6,4,14,28.6,10,6,2,4,4,20,16,0,0,2022-2023,0.21621621621621623,0.8648648648648649
847,Julio Enciso,PAR,"FW,MF",Brighton,Premier League,18,2004,9.0,13,4,3,6,4,8,13,61.5,5,9,0,9,4,17,2,0,0,2022-2023,0.4444444444444444,1.4444444444444444
848,Wataru Endo,JPN,MF,Stuttgart,Bundesliga,29,1993,32.5,70,37,30,31,9,38,85,44.7,47,44,6,38,26,96,63,0,0,2022-2023,0.8,2.1538461538461537
849,Arne Engels,BEL,MF,Augsburg,Bundesliga,18,2003,16.0,20,9,9,10,1,8,19,42.1,11,17,5,12,15,35,12,1,0,2022-2023,0.9375,1.25
850,Christian Eriksen,DEN,MF,Manchester Utd,Premier League,30,1992,22.8,22,18,10,7,5,10,33,30.3,23,23,9,14,11,33,20,1,0,2022-2023,0.4824561403508772,0.9649122807017544
Rk,Player,Nation,Pos,Squad,Comp,0,0,90.0,0,0,3,3,3,Tkl,0,0.0,0,0,0,0,0,0,0,0,0,2022-2023,0.0,0.0
851,Martin Erlic,CRO,DF,Sassuolo,Serie A,24,1998,25.9,27,16,18,8,1,10,23,43.5,13,36,23,13,31,58,120,1,0,2022-2023,1.196911196911197,1.0424710424710426
852,Tjark Ernst,GER,GK,Hertha BSC,Bundesliga,19,2003,1.0,0,0,0,0,0,0,0,0.0,0,0,0,0,0,0,1,0,0,2022-2023,0.0,0.0
853,Gonzalo Escalante,ARG,MF,Cremonese,Serie A,29,1993,6.2,16,8,8,8,0,10,13,76.9,3,7,1,6,10,26,4,0,0,2022-2023,1.6129032258064515,2.5806451612903225
854,Gonzalo Escalante,ARG,MF,Cádiz,La Liga,29,1993,12.5,36,24,15,20,1,15,29,51.7,14,18,4,14,17,53,26,1,0,2022-2023,1.36,2.88
855,Sergio Escudero,ESP,DF,Valladolid,La Liga,32,1989,16.0,33,19,21,8,4,15,35,42.9,20,26,6,20,26,59,46,0,0,2022-2023,1.625,2.0625
856,Alfonso Espino,URU,DF,Cádiz,La Liga,30,1992,34.7,87,56,55,20,12,48,96,50.0,48,52,11,41,48,135,99,3,0,2022-2023,1.3832853025936598,2.5072046109510087
857,Bernardo Espinosa,COL,DF,Girona,La Liga,33,1989,13.6,6,2,2,4,0,3,9,33.3,6,17,10,7,12,18,70,2,0,2022-2023,0.8823529411764706,0.4411764705882353
858,Salvatore Esposito,ITA,MF,Spezia,Serie A,21,2000,10.8,15,12,8,5,2,5,21,23.8,16,9,1,8,11,26,18,0,0,2022-2023,1.0185185185185184,1.3888888888888888
859,Maxime Estève,FRA,DF,Montpellier,Ligue 1,20,2002,18.3,24,13,17,5,2,12,17,70.6,5,28,17,11,34,58,90,0,0,2022-2023,1.8579234972677594,1.3114754098360655
860,Pervis Estupiñán,ECU,DF,Brighton,Premier League,24,1998,29.7,61,31,36,19,6,35,60,58.3,25,30,8,22,37,98,37,1,0,2022-2023,1.245791245791246,2.053872053872054
861,Jonny Evans,NIR,DF,Leicester City,Premier League,34,1988,11.7,13,5,12,1,0,7,11,63.6,4,15,11,4,18,31,51,0,0,2022-2023,1.5384615384615385,1.1111111111111112
862,Edu Expósito,ESP,MF,Espanyol,La Liga,25,1996,12.9,34,20,16,15,3,13,23,56.5,10,7,0,7,12,46,20,0,0,2022-2023,0.9302325581395349,2.635658914728682
863,Eberechi Eze,ENG,"MF,FW",Crystal Palace,Premier League,24,1998,29.3,42,24,17,18,7,18,38,47.4,20,22,0,22,13,55,10,0,0,2022-2023,0.44368600682593856,1.4334470989761092
864,Kimberly Ezekwem,GER,DF,Freiburg,Bundesliga,21,2001,0.1,0,0,0,0,0,0,0,0.0,0,1,0,1,0,0,0,0,0,2022-2023,0.0,0.0
865,Nicolás Ezequiel Fernández,ARG,"MF,DF",Elche,La Liga,22,2000,5.7,23,12,10,7,6,9,17,52.9,8,7,0,7,5,28,2,1,0,2022-2023,0.8771929824561403,4.035087719298246
866,Abde Ezzalzouli,MAR,"FW,MF",Osasuna,La Liga,20,2001,16.7,29,19,13,12,4,13,23,56.5,10,20,0,20,4,33,6,0,0,2022-2023,0.23952095808383234,1.7365269461077846
867,Łukasz Fabiański,POL,GK,West Ham,Premier League,37,1985,34.6,2,0,2,0,0,1,2,50.0,1,1,0,1,0,2,10,1,0,2022-2023,0.0,0.057803468208092484
868,Fabinho,BRA,MF,Liverpool,Premier League,28,1993,29.7,65,38,18,40,7,24,62,38.7,38,38,11,27,37,102,40,0,0,2022-2023,1.245791245791246,2.1885521885521886
869,Fábio,BRA,"DF,MF",Nantes,Ligue 1,32,1990,2.5,4,2,1,2,1,4,6,66.7,2,2,0,2,3,7,11,0,0,2022-2023,1.2,1.6
870,Noah Fadiga,SEN,DF,Brest,Ligue 1,22,1999,14.5,30,21,18,9,3,14,26,53.8,12,17,7,10,26,56,18,0,0,2022-2023,1.793103448275862,2.0689655172413794
871,Wout Faes,BEL,DF,Leicester City,Premier League,24,1998,31.0,56,33,28,26,2,28,44,63.6,16,53,37,16,41,97,113,2,0,2022-2023,1.3225806451612903,1.8064516129032258
872,Wout Faes,BEL,DF,Reims,Ligue 1,24,1998,3.0,1,1,1,0,0,1,2,50.0,1,6,3,3,7,8,19,0,0,2022-2023,2.3333333333333335,0.3333333333333333
873,Nicolò Fagioli,ITA,MF,Juventus,Serie A,21,2001,16.9,29,19,12,15,2,8,27,29.6,19,16,2,14,8,37,7,1,0,2022-2023,0.4733727810650888,1.7159763313609468
874,Ralf Fährmann,GER,GK,Schalke 04,Bundesliga,33,1988,11.4,1,0,1,0,0,1,1,100.0,0,0,0,0,0,1,10,2,0,2022-2023,0.0,0.08771929824561403
875,Romain Faivre,FRA,"MF,FW",Lorient,Ligue 1,24,1998,13.8,13,8,5,4,4,5,25,20.0,20,11,0,11,1,14,4,0,0,2022-2023,0.07246376811594203,0.9420289855072463
Rk,Player,Nation,Pos,Squad,Comp,0,0,90.0,0,0,3,3,3,Tkl,0,0.0,0,0,0,0,0,0,0,0,0,2022-2023,0.0,0.0
876,Romain Faivre,FRA,MF,Lyon,Ligue 1,24,1998,3.3,6,3,2,2,2,1,3,33.3,2,3,0,3,0,6,0,0,0,2022-2023,0.0,1.8181818181818183
877,Radamel Falcao,COL,"FW,MF",Rayo Vallecano,La Liga,36,1986,6.8,4,4,1,3,0,1,8,12.5,7,5,1,4,2,6,10,0,0,2022-2023,0.29411764705882354,0.5882352941176471
878,Wladimiro Falcone,ITA,GK,Lecce,Serie A,27,1995,38.0,2,0,2,0,0,2,2,100.0,0,0,0,0,2,4,21,3,0,2022-2023,0.05263157894736842,0.05263157894736842
879,Fali,ESP,"DF,MF",Cádiz,La Liga,28,1993,19.0,27,19,19,8,0,18,29,62.1,11,24,15,9,13,40,70,1,0,2022-2023,0.6842105263157895,1.4210526315789473
880,Fallou Fall,SEN,DF,Reims,Ligue 1,18,2004,0.4,0,0,0,0,0,0,1,0.0,1,3,3,0,0,0,4,0,0,2022-2023,0.0,0.0
881,Mamadou Fall,SEN,DF,Villarreal,La Liga,19,2002,0.3,0,0,0,0,0,0,0,0.0,0,1,0,1,0,0,1,0,0,2022-2023,0.0,0.0
882,Davide Faraoni,ITA,DF,Hellas Verona,Serie A,30,1991,16.5,34,24,19,13,2,16,41,39.0,25,30,11,19,15,49,37,0,0,2022-2023,0.9090909090909091,2.0606060606060606
883,Ansu Fati,ESP,FW,Barcelona,La Liga,19,2002,15.5,16,9,8,4,4,5,18,27.8,13,19,0,19,5,21,6,0,0,2022-2023,0.3225806451612903,1.032258064516129
884,Khalil Fayad,FRA,MF,Montpellier,Ligue 1,18,2004,8.0,30,14,12,16,2,12,21,57.1,9,8,1,7,9,39,4,0,0,2022-2023,1.125,3.75
885,Cheikh Faye,SEN,FW,Montpellier,Ligue 1,23,1999,0.4,0,0,0,0,0,0,0,0.0,0,0,0,0,1,1,0,0,0,2022-2023,2.5,0.0
886,Federico Fazio,ARG,DF,Salernitana,Serie A,35,1987,11.9,15,12,8,7,0,4,11,36.4,7,9,4,5,28,43,61,0,0,2022-2023,2.3529411764705883,1.2605042016806722
887,Jacopo Fazzini,ITA,MF,Empoli,Serie A,19,2003,9.2,31,17,20,8,3,18,34,52.9,16,15,3,12,7,38,19,0,0,2022-2023,0.7608695652173914,3.3695652173913047
888,Zouhair Feddal,MAR,DF,Valladolid,La Liga,33,1989,4.2,4,2,1,3,0,3,4,75.0,1,9,9,0,5,9,27,0,0,2022-2023,1.1904761904761905,0.9523809523809523
889,Nabil Fekir,FRA,MF,Betis,La Liga,29,1993,10.7,11,5,3,3,5,2,9,22.2,7,6,2,4,1,12,0,0,0,2022-2023,0.09345794392523366,1.0280373831775702
890,Felipe,BRA,DF,Nott'ham Forest,Premier League,33,1989,15.8,42,23,29,13,0,24,41,58.5,17,34,13,21,36,78,90,0,0,2022-2023,2.2784810126582276,2.6582278481012658
891,Felipe,BRA,DF,Atlético Madrid,La Liga,33,1989,2.2,3,2,1,2,0,2,4,50.0,2,2,2,0,0,3,7,0,0,2022-2023,0.0,1.3636363636363635
892,Luiz Felipe,ITA,DF,Betis,La Liga,25,1997,19.6,34,23,23,11,0,18,34,52.9,16,43,24,19,28,62,106,0,0,2022-2023,1.4285714285714284,1.7346938775510203
893,João Félix,POR,"FW,MF",Chelsea,Premier League,22,1999,10.5,14,7,5,6,3,4,12,33.3,8,3,0,3,1,15,1,1,0,2022-2023,0.09523809523809523,1.3333333333333333
894,João Félix,POR,"FW,MF",Atlético Madrid,La Liga,22,1999,7.2,10,7,2,3,5,1,6,16.7,5,1,0,1,3,13,2,0,0,2022-2023,0.41666666666666663,1.3888888888888888
895,Ohis Felix Uduokhai,GER,DF,Augsburg,Bundesliga,24,1997,16.1,30,20,14,13,3,15,29,51.7,14,27,14,13,29,59,61,1,0,2022-2023,1.8012422360248446,1.8633540372670805
896,Kiko Femenía,ESP,DF,Villarreal,La Liga,31,1991,12.6,18,9,14,3,1,13,18,72.2,5,15,6,9,20,38,22,0,0,2022-2023,1.5873015873015874,1.4285714285714286
897,Evan Ferguson,IRL,FW,Brighton,Premier League,17,2004,10.6,6,3,1,3,2,1,7,14.3,6,11,1,10,2,8,6,0,0,2022-2023,0.18867924528301888,0.5660377358490566
898,Lewis Ferguson,SCO,"MF,FW",Bologna,Serie A,22,1999,25.7,44,25,16,20,8,20,40,50.0,20,22,7,15,19,63,25,0,0,2022-2023,0.7392996108949417,1.7120622568093387
899,Bruno Fernandes,POR,"MF,FW",Manchester Utd,Premier League,27,1994,36.8,68,42,24,25,19,30,71,42.3,41,37,5,32,25,93,40,1,0,2022-2023,0.6793478260869565,1.847826086956522
900,Edimilson Fernandes,SUI,DF,Mainz 05,Bundesliga,26,1996,27.1,35,25,26,5,4,18,34,52.9,16,37,16,21,54,89,87,2,0,2022-2023,1.9926199261992619,1.2915129151291511
Rk,Player,Nation,Pos,Squad,Comp,0,0,90.0,0,0,3,3,3,Tkl,0,0.0,0,0,0,0,0,0,0,0,0,2022-2023,0.0,0.0
901,Aitor Fernández,ESP,GK,Osasuna,La Liga,31,1991,21.0,1,1,1,0,0,0,1,0.0,1,0,0,0,2,3,17,0,0,2022-2023,0.09523809523809523,0.047619047619047616
902,Álex Fernández,ESP,"MF,FW",Cádiz,La Liga,29,1992,17.5,13,7,6,4,3,4,14,28.6,10,14,1,13,8,21,19,0,0,2022-2023,0.45714285714285713,0.7428571428571429
903,Álvaro Fernández,ESP,GK,Espanyol,La Liga,24,1998,11.0,0,0,0,0,0,0,0,0.0,0,0,0,0,0,0,7,2,0,2022-2023,0.0,0.0
904,Carlos Fernández,ESP,FW,Real Sociedad,La Liga,26,1996,7.0,6,4,1,3,2,1,15,6.7,14,1,0,1,1,7,4,0,0,2022-2023,0.14285714285714285,0.8571428571428571
905,Enzo Fernández,ARG,MF,Chelsea,Premier League,21,2001,17.2,45,27,25,17,3,21,56,37.5,35,32,2,30,16,61,12,1,0,2022-2023,0.9302325581395349,2.616279069767442
906,Federico Fernández,ARG,DF,Elche,La Liga,33,1989,1.0,1,1,1,0,0,1,1,100.0,0,0,0,0,2,3,12,0,0,2022-2023,2.0,1.0
907,Joaquín Fernández,ESP,DF,Valladolid,La Liga,26,1996,24.0,35,28,20,11,4,19,30,63.3,11,31,22,9,27,62,98,1,0,2022-2023,1.125,1.4583333333333333
908,Valery Fernández,ESP,"MF,DF",Girona,La Liga,22,1999,10.7,12,6,4,6,2,5,9,55.6,4,8,1,7,10,22,9,1,0,2022-2023,0.9345794392523366,1.1214953271028039
909,Fernando,ESP,GK,Almería,La Liga,32,1990,36.5,0,0,0,0,0,0,2,0.0,2,2,0,2,1,1,20,3,0,2022-2023,0.0273972602739726,0.0
910,Fernando,BRA,"MF,DF",Sevilla,La Liga,35,1987,17.5,34,23,14,17,3,18,30,60.0,12,21,10,11,24,58,29,0,0,2022-2023,1.3714285714285714,1.9428571428571428
911,Alex Ferrari,ITA,DF,Sampdoria,Serie A,28,1994,9.6,9,5,7,2,0,4,8,50.0,4,21,10,11,19,28,25,0,0,2022-2023,1.9791666666666667,0.9375
912,Alex Ferrari,ITA,DF,Cremonese,Serie A,28,1994,11.2,40,23,32,7,1,28,42,66.7,14,19,4,15,25,65,45,1,0,2022-2023,2.232142857142857,3.5714285714285716
913,Salvador Ferrer,ESP,DF,Spezia,Serie A,24,1998,1.5,4,2,2,2,0,1,3,33.3,2,3,1,2,1,5,4,0,0,2022-2023,0.6666666666666666,2.6666666666666665
914,Jordan Ferri,FRA,MF,Montpellier,Ligue 1,30,1992,30.4,55,35,32,19,4,30,89,33.7,59,22,6,16,26,81,21,0,0,2022-2023,0.8552631578947368,1.8092105263157896
915,Fidel,ESP,"MF,FW",Elche,La Liga,32,1989,19.0,15,10,8,5,2,4,38,10.5,34,9,0,9,5,20,8,0,0,2022-2023,0.2631578947368421,0.7894736842105263
916,Karol Fila,POL,DF,Strasbourg,Ligue 1,24,1998,0.5,0,0,0,0,0,0,0,0.0,0,0,0,0,1,1,1,0,0,2022-2023,2.0,0.0
917,Vincenzo Fiorillo,ITA,GK,Salernitana,Serie A,32,1990,1.0,0,0,0,0,0,0,0,0.0,0,0,0,0,0,0,0,0,0,2022-2023,0.0,0.0
918,Roberto Firmino,BRA,"FW,MF",Liverpool,Premier League,30,1991,13.5,17,12,2,12,3,4,22,18.2,18,16,1,15,7,24,2,0,0,2022-2023,0.5185185185185185,1.2592592592592593
919,Junior Firpo,DOM,DF,Leeds United,Premier League,25,1996,15.2,47,25,27,15,5,24,46,52.2,22,23,7,16,24,71,40,0,0,2022-2023,1.5789473684210527,3.0921052631578947
920,Kilian Fischer,GER,"DF,FW",Wolfsburg,Bundesliga,21,2000,5.6,9,6,3,4,2,6,11,54.5,5,6,0,6,5,14,18,0,0,2022-2023,0.8928571428571429,1.6071428571428572
921,Mark Flekken,NED,GK,Freiburg,Bundesliga,29,1993,34.0,0,0,0,0,0,0,1,0.0,1,1,0,1,0,0,9,5,0,2022-2023,0.0,0.0
922,Florian Flick,GER,MF,Schalke 04,Bundesliga,22,2000,5.7,12,3,7,5,0,4,14,28.6,10,9,3,6,4,16,18,0,0,2022-2023,0.7017543859649122,2.1052631578947367
923,Alexis Flips,FRA,"FW,MF",Reims,Ligue 1,22,2000,22.0,51,30,18,17,16,27,64,42.2,37,35,5,30,24,75,12,0,0,2022-2023,1.0909090909090908,2.3181818181818183
924,Alessandro Florenzi,ITA,DF,Milan,Serie A,31,1991,2.3,6,4,3,2,1,4,7,57.1,3,1,0,1,4,10,2,0,0,2022-2023,1.7391304347826089,2.608695652173913
925,Phil Foden,ENG,FW,Manchester City,Premier League,22,2000,20.5,16,10,9,5,2,8,19,42.1,11,25,2,23,5,21,12,0,0,2022-2023,0.24390243902439024,0.7804878048780488
Rk,Player,Nation,Pos,Squad,Comp,0,0,90.0,0,0,3,3,3,Tkl,0,0.0,0,0,0,0,0,0,0,0,0,2022-2023,0.0,0.0
926,Seko Fofana,CIV,MF,Lens,Ligue 1,27,1995,34.1,28,13,8,18,2,15,39,38.5,24,17,4,13,19,47,14,0,0,2022-2023,0.5571847507331378,0.8211143695014662
927,Wesley Fofana,FRA,DF,Leicester City,Premier League,21,2000,2.0,4,2,1,2,1,1,3,33.3,2,1,1,0,9,13,5,0,0,2022-2023,4.5,2.0
928,Wesley Fofana,FRA,DF,Chelsea,Premier League,21,2000,13.1,30,18,19,7,4,13,26,50.0,13,17,10,7,20,50,33,2,0,2022-2023,1.5267175572519085,2.290076335877863
929,Yahia Fofana,CIV,GK,Angers,Ligue 1,21,2000,11.0,0,0,0,0,0,0,0,0.0,0,0,0,0,1,1,4,1,0,2022-2023,0.09090909090909091,0.0
930,Youssouf Fofana,FRA,MF,Monaco,Ligue 1,23,1999,34.3,81,41,31,42,8,38,74,51.4,36,50,6,44,56,137,32,1,0,2022-2023,1.6326530612244898,2.361516034985423
931,Thomas Foket,BEL,DF,Reims,Ligue 1,27,1994,22.0,35,22,18,11,6,17,46,37.0,29,21,7,14,33,68,29,2,0,2022-2023,1.5,1.5909090909090908
932,José Fonte,POR,DF,Lille,Ligue 1,38,1983,28.8,23,17,18,4,1,10,21,47.6,11,27,14,13,25,48,112,2,0,2022-2023,0.8680555555555556,0.798611111111111
933,Pablo Fornals,ESP,"FW,MF",West Ham,Premier League,26,1996,16.7,30,15,9,12,9,13,34,38.2,21,16,2,14,14,44,9,0,0,2022-2023,0.8383233532934132,1.7964071856287427
934,Emil Forsberg,SWE,"MF,FW",RB Leipzig,Bundesliga,30,1991,16.5,16,11,1,8,7,6,20,30.0,14,25,2,23,3,19,7,0,0,2022-2023,0.18181818181818182,0.9696969696969697
935,Adam Forshaw,ENG,MF,Leeds United,Premier League,30,1991,5.3,12,9,5,7,0,7,17,41.2,10,9,1,8,4,16,2,0,0,2022-2023,0.7547169811320755,2.2641509433962264
936,Fraser Forster,ENG,GK,Tottenham,Premier League,34,1988,13.5,1,0,1,0,0,0,0,0.0,0,1,0,1,0,1,3,1,0,2022-2023,0.0,0.07407407407407407
937,Philipp Förster,GER,MF,Bochum,Bundesliga,27,1995,14.5,31,19,11,15,5,12,40,30.0,28,22,0,22,6,37,6,0,0,2022-2023,0.41379310344827586,2.1379310344827585
938,Steven Fortes,CPV,DF,Lens,Ligue 1,30,1992,0.1,0,0,0,0,0,0,0,0.0,0,0,0,0,0,0,0,0,0,2022-2023,0.0,0.0
939,Timothy Fosu-Mensah,NED,DF,Leverkusen,Bundesliga,24,1998,2.1,7,5,3,3,1,4,4,100.0,0,2,0,2,0,7,1,0,0,2022-2023,0.0,3.333333333333333
940,Dimitri Foulquier,FRA,DF,Valencia,La Liga,29,1993,19.3,31,19,17,8,6,20,28,71.4,8,19,3,16,14,45,40,0,0,2022-2023,0.7253886010362695,1.6062176165803108
941,Juan Foyth,ARG,DF,Villarreal,La Liga,24,1998,21.8,73,48,49,22,2,41,57,71.9,16,32,11,21,20,93,68,0,0,2022-2023,0.9174311926605504,3.348623853211009
942,Raphael Framberger,GER,"DF,FW",Augsburg,Bundesliga,26,1995,2.0,10,6,6,4,0,3,5,60.0,2,2,1,1,2,12,5,0,0,2022-2023,1.0,5.0
943,Tyrese Francois,AUS,FW,Fulham,Premier League,22,2000,0.0,0,0,0,0,0,0,1,0.0,1,0,0,0,0,0,1,0,0,2022-2023,,
944,Bartol Franjić,CRO,MF,Wolfsburg,Bundesliga,22,2000,2.5,4,2,2,2,0,0,2,0.0,2,4,1,3,5,9,4,0,0,2022-2023,2.0,1.6
945,Przemysław Frankowski,POL,"DF,MF",Lens,Ligue 1,27,1995,31.5,77,51,37,31,9,39,80,48.8,41,38,6,32,41,118,42,2,0,2022-2023,1.3015873015873016,2.4444444444444446
946,Ryan Fraser,SCO,FW,Newcastle Utd,Premier League,28,1994,3.5,2,2,0,0,2,2,5,40.0,3,3,1,2,0,2,3,0,0,2022-2023,0.0,0.5714285714285714
947,Davide Frattesi,ITA,MF,Sassuolo,Serie A,22,1999,31.9,63,36,24,29,10,25,44,56.8,19,27,6,21,16,79,42,0,0,2022-2023,0.5015673981191223,1.974921630094044
948,Oscar Fraulo,DEN,"FW,MF",Gladbach,Bundesliga,18,2003,0.1,0,0,0,0,0,0,0,0.0,0,0,0,0,0,0,0,0,0,2022-2023,0.0,0.0
949,Fred,BRA,MF,Manchester Utd,Premier League,29,1993,13.9,47,30,24,20,3,15,38,39.5,23,38,2,36,19,66,19,0,0,2022-2023,1.3669064748201438,3.381294964028777
950,Ryan Fredericks,ENG,DF,Bournemouth,Premier League,29,1992,5.9,3,2,2,0,1,1,4,25.0,3,7,2,5,1,4,27,0,0,2022-2023,0.1694915254237288,0.5084745762711864
Rk,Player,Nation,Pos,Squad,Comp,0,0,90.0,0,0,3,3,3,Tkl,0,0.0,0,0,0,0,0,0,0,0,0,2022-2023,0.0,0.0
951,Iván Fresneda,ESP,DF,Valladolid,La Liga,17,2004,19.4,48,34,31,13,4,29,47,61.7,18,32,8,24,15,63,60,0,0,2022-2023,0.7731958762886598,2.4742268041237114
952,Remo Freuler,SUI,MF,Nott'ham Forest,Premier League,30,1992,24.0,43,23,23,15,5,19,43,44.2,24,36,9,27,29,72,45,0,0,2022-2023,1.2083333333333333,1.7916666666666667
953,Michael Frey,SUI,FW,Schalke 04,Bundesliga,28,1994,9.6,13,5,2,8,3,4,13,30.8,9,6,0,6,2,15,1,0,0,2022-2023,0.20833333333333334,1.3541666666666667
954,Marco Friedl,AUT,DF,Werder Bremen,Bundesliga,24,1998,28.8,62,46,40,22,0,41,68,60.3,27,46,17,29,58,120,127,1,0,2022-2023,2.013888888888889,2.1527777777777777
955,Marvin Friedrich,GER,DF,Gladbach,Bundesliga,26,1995,13.9,17,11,13,3,1,10,13,76.9,3,14,6,8,11,28,52,0,0,2022-2023,0.7913669064748201,1.223021582733813
956,Jeremie Frimpong,NED,"DF,MF",Leverkusen,Bundesliga,21,2000,30.1,53,27,22,26,5,23,44,52.3,21,24,3,21,16,69,40,0,0,2022-2023,0.5315614617940199,1.760797342192691
957,Chris Führich,GER,"FW,MF",Stuttgart,Bundesliga,24,1998,20.9,36,14,15,14,7,24,44,54.5,20,29,2,27,7,43,13,0,0,2022-2023,0.3349282296650718,1.722488038277512
958,Angelo Fulgini,FRA,"MF,FW",Lens,Ligue 1,25,1996,9.5,14,7,2,4,8,5,14,35.7,9,11,0,11,8,22,2,0,0,2022-2023,0.8421052631578947,1.4736842105263157
959,Angelo Fulgini,FRA,MF,Mainz 05,Bundesliga,25,1996,5.8,6,5,2,3,1,5,12,41.7,7,5,0,5,5,11,7,0,0,2022-2023,0.8620689655172414,1.0344827586206897
960,Niclas Füllkrug,GER,FW,Werder Bremen,Bundesliga,29,1993,27.5,9,4,0,6,3,3,13,23.1,10,13,4,9,1,10,24,0,0,2022-2023,0.03636363636363636,0.32727272727272727
961,Matteo Gabbia,ITA,DF,Milan,Serie A,22,1999,6.8,17,10,12,5,0,6,8,75.0,2,8,3,5,5,22,29,0,0,2022-2023,0.7352941176470589,2.5
962,Manolo Gabbiadini,ITA,"FW,MF",Sampdoria,Serie A,30,1991,26.2,23,15,8,9,6,9,23,39.1,14,16,2,14,6,29,25,0,0,2022-2023,0.22900763358778625,0.8778625954198473
963,Gianluca Gaetano,ITA,MF,Napoli,Serie A,22,2000,0.8,5,3,1,3,1,0,0,0.0,0,1,0,1,1,6,0,0,0,2022-2023,1.25,6.25
964,Roberto Gagliardini,ITA,MF,Inter,Serie A,28,1994,8.7,16,6,9,6,1,10,21,47.6,11,14,5,9,4,20,15,0,0,2022-2023,0.4597701149425288,1.8390804597701151
965,Adolfo Gaich,ARG,FW,Hellas Verona,Serie A,23,1999,8.1,5,3,0,3,2,1,6,16.7,5,7,2,5,3,8,7,1,0,2022-2023,0.3703703703703704,0.617283950617284
966,Cody Gakpo,NED,"FW,MF",Liverpool,Premier League,23,1999,16.2,26,15,4,13,9,13,38,34.2,25,13,1,12,4,30,2,0,0,2022-2023,0.2469135802469136,1.6049382716049383
967,Javi Galán,ESP,DF,Celta Vigo,La Liga,27,1994,35.1,104,72,60,40,4,48,98,49.0,50,54,5,49,41,145,63,1,0,2022-2023,1.168091168091168,2.962962962962963
968,Iñigo Ruiz de Galarreta,ESP,MF,Mallorca,La Liga,28,1993,27.2,54,38,27,23,4,20,52,38.5,32,26,9,17,30,84,19,0,0,2022-2023,1.1029411764705883,1.9852941176470589
969,Pablo Galdames Millán,CHI,MF,Cremonese,Serie A,25,1996,8.2,14,10,8,3,3,5,33,15.2,28,13,2,11,10,24,13,0,0,2022-2023,1.2195121951219514,1.707317073170732
970,Conor Gallagher,ENG,MF,Chelsea,Premier League,22,2000,18.0,46,33,17,19,10,10,37,27.0,27,41,10,31,23,69,18,1,0,2022-2023,1.2777777777777777,2.5555555555555554
971,Antonino Gallo,ITA,DF,Lecce,Serie A,22,2000,27.6,56,36,35,12,9,38,57,66.7,19,37,6,31,13,69,71,0,0,2022-2023,0.47101449275362317,2.0289855072463765
972,Gauthier Gallon,FRA,GK,Troyes,Ligue 1,29,1993,29.6,2,2,2,0,0,2,4,50.0,2,0,0,0,2,4,17,0,0,2022-2023,0.06756756756756756,0.06756756756756756
973,Cristian Gamboa,CRC,DF,Bochum,Bundesliga,32,1989,16.4,42,24,27,14,1,21,31,67.7,10,20,7,13,16,58,34,1,0,2022-2023,0.9756097560975611,2.5609756097560976
974,Kévin Gameiro,FRA,FW,Strasbourg,Ligue 1,35,1987,23.3,20,10,6,10,4,8,28,28.6,20,10,1,9,9,29,0,0,0,2022-2023,0.38626609442060084,0.8583690987124464
975,Idrissa Gana Gueye,SEN,MF,Everton,Premier League,32,1989,28.6,97,57,49,35,13,31,62,50.0,31,50,12,38,56,153,34,3,0,2022-2023,1.958041958041958,3.3916083916083912
Rk,Player,Nation,Pos,Squad,Comp,0,0,90.0,0,0,3,3,3,Tkl,0,0.0,0,0,0,0,0,0,0,0,0,2022-2023,0.0,0.0
976,Ignatius Ganago,CMR,"FW,MF",Nantes,Ligue 1,23,1999,16.9,9,7,2,3,4,4,7,57.1,3,13,1,12,2,11,12,0,0,2022-2023,0.1183431952662722,0.5325443786982249
977,Ignatius Ganago,CMR,FW,Lens,Ligue 1,23,1999,0.7,0,0,0,0,0,0,0,0.0,0,0,0,0,0,0,1,0,0,2022-2023,0.0,0.0
978,Silvère Ganvoula M'Boussy,CGO,"FW,MF",Bochum,Bundesliga,26,1996,2.7,2,2,0,1,1,0,0,0.0,0,0,0,0,0,2,3,0,0,2022-2023,0.0,0.7407407407407407
979,Aleix García,ESP,MF,Girona,La Liga,25,1997,26.0,37,20,9,18,10,15,33,45.5,18,24,8,16,31,68,35,1,0,2022-2023,1.1923076923076923,1.4230769230769231
980,Álvaro García,ESP,"FW,MF",Rayo Vallecano,La Liga,29,1992,31.9,49,28,21,13,15,11,33,33.3,22,41,4,37,34,83,24,1,0,2022-2023,1.0658307210031348,1.536050156739812
981,Borja García,ESP,"MF,FW",Girona,La Liga,31,1990,7.5,10,4,7,2,1,2,9,22.2,7,3,1,2,5,15,6,1,0,2022-2023,0.6666666666666666,1.3333333333333333
982,Carlos García,ESP,DF,Cádiz,La Liga,22,2000,0.3,0,0,0,0,0,0,0,0.0,0,0,0,0,0,0,2,0,0,2022-2023,0.0,0.0
983,Dani García,ESP,MF,Athletic Club,La Liga,32,1990,16.5,46,27,17,25,4,29,47,61.7,18,21,6,15,19,65,21,1,0,2022-2023,1.1515151515151516,2.787878787878788
984,David García,ESP,DF,Osasuna,La Liga,28,1994,29.8,34,20,22,12,0,19,22,86.4,3,28,13,15,45,79,151,0,0,2022-2023,1.5100671140939597,1.1409395973154361
985,Eric García,ESP,"DF,MF",Barcelona,La Liga,21,2001,15.7,24,16,16,5,3,9,20,45.0,11,23,10,13,19,43,36,1,0,2022-2023,1.2101910828025477,1.5286624203821657
986,Fran Garcia,ESP,DF,Rayo Vallecano,La Liga,22,1999,37.9,84,54,53,23,8,55,96,57.3,41,49,8,41,44,128,66,0,0,2022-2023,1.1609498680738786,2.216358839050132
987,Joan García,ESP,GK,Espanyol,La Liga,21,2001,1.0,0,0,0,0,0,0,0,0.0,0,0,0,0,0,0,0,0,0,2022-2023,0.0,0.0
988,Raúl García,ESP,"FW,MF",Athletic Club,La Liga,36,1986,10.7,12,8,3,4,5,5,15,33.3,10,13,1,12,6,18,9,0,0,2022-2023,0.5607476635514019,1.1214953271028039
989,Rubén García,ESP,"FW,MF",Osasuna,La Liga,29,1993,12.9,20,11,12,4,4,7,24,29.2,17,14,1,13,12,32,13,0,0,2022-2023,0.9302325581395349,1.5503875968992247
990,Unai García,ESP,DF,Osasuna,La Liga,30,1992,19.0,23,13,13,8,2,12,17,70.6,5,23,14,9,19,42,60,2,0,2022-2023,1.0,1.2105263157894737
991,Alejandro Garnacho,ARG,"FW,MF",Manchester Utd,Premier League,18,2004,6.3,5,2,2,0,3,1,11,9.1,10,5,0,5,5,10,3,0,0,2022-2023,0.7936507936507937,0.7936507936507937
992,James Garner,ENG,"MF,DF",Everton,Premier League,21,2001,8.9,16,13,4,8,4,9,19,47.4,10,9,1,8,12,28,13,0,0,2022-2023,1.348314606741573,1.797752808988764
993,Felix Garreta,ESP,DF,Betis,La Liga,18,2004,1.0,1,0,0,1,0,0,0,0.0,0,1,1,0,1,2,4,0,0,2022-2023,1.0,1.0
994,Aleix Garrido,ESP,FW,Barcelona,La Liga,18,2004,0.1,2,1,1,0,1,1,1,100.0,0,1,0,1,0,2,0,0,0,2022-2023,0.0,20.0
995,Sékou Gassama,SEN,FW,Valladolid,La Liga,27,1995,0.4,0,0,0,0,0,0,0,0.0,0,0,0,0,0,0,0,0,0,2022-2023,0.0,0.0
996,Johan Gastien,FRA,MF,Clermont Foot,Ligue 1,34,1988,28.9,62,34,30,23,9,38,111,34.2,73,37,7,30,36,98,25,1,0,2022-2023,1.245674740484429,2.1453287197231834
997,Federico Gatti,ITA,DF,Juventus,Serie A,24,1998,16.1,15,11,9,4,2,9,15,60.0,6,20,14,6,21,36,54,2,0,2022-2023,1.3043478260869563,0.9316770186335402
998,Gavi,ESP,"MF,FW",Barcelona,La Liga,17,2004,28.1,47,31,7,30,10,21,55,38.2,34,32,5,27,18,65,22,0,0,2022-2023,0.6405693950177935,1.6725978647686832
999,Paulo Gazzaniga,ARG,GK,Girona,La Liga,30,1992,28.0,0,0,0,0,0,0,1,0.0,1,0,0,0,1,1,9,5,0,2022-2023,0.03571428571428571,0.0
1000,David de Gea,ESP,GK,Manchester Utd,Premier League,31,1990,38.0,0,0,0,0,0,0,1,0.0,1,0,0,0,1,1,15,3,0,2022-2023,0.02631578947368421,0.0
Rk,Player,Nation,Pos,Squad,Comp,0,0,90.0,0,0,3,3,3,Tkl,0,0.0,0,0,0,0,0,0,0,0,0,2022-2023,0.0,0.0
1001,Dario Gebuhr,GER,DF,Eint Frankfurt,Bundesliga,19,2003,0.2,0,0,0,0,0,0,1,0.0,1,0,0,0,0,0,0,0,0,2022-2023,0.0,0.0
1002,Dennis Geiger,GER,MF,Hoffenheim,Bundesliga,24,1998,21.7,45,25,15,28,2,22,35,62.9,13,27,3,24,24,69,18,2,0,2022-2023,1.1059907834101383,2.0737327188940093
1003,Joe Gelhardt,ENG,FW,Leeds United,Premier League,20,2002,2.4,6,2,1,3,2,3,5,60.0,2,5,0,5,0,6,4,0,0,2022-2023,0.0,2.5
1004,Valentin Gendrey,FRA,DF,Lecce,Serie A,22,2000,34.5,88,57,54,25,9,40,71,56.3,31,45,4,41,37,125,89,0,0,2022-2023,1.0724637681159421,2.550724637681159
1005,Denis Genreau,AUS,MF,Toulouse,Ligue 1,23,1999,7.3,35,13,16,12,7,13,31,41.9,18,16,1,15,8,43,9,0,0,2022-2023,1.095890410958904,4.794520547945206
1006,Yannick Gerhardt,GER,MF,Wolfsburg,Bundesliga,28,1994,20.7,29,15,10,11,8,12,30,40.0,18,26,5,21,7,36,24,0,0,2022-2023,0.33816425120772947,1.4009661835748792
1007,Valère Germain,FRA,"FW,MF",Montpellier,Ligue 1,32,1990,7.6,13,11,3,5,5,4,12,33.3,8,8,0,8,6,19,12,0,0,2022-2023,0.7894736842105263,1.7105263157894737
1008,Gerson,BRA,MF,Marseille,Ligue 1,25,1997,4.6,6,4,1,4,1,3,5,60.0,2,5,0,5,2,8,4,0,0,2022-2023,0.4347826086956522,1.3043478260869565
1009,Ismaël Gharbi,ESP,"MF,FW",Paris S-G,Ligue 1,18,2004,0.6,0,0,0,0,0,0,2,0.0,2,2,0,2,3,3,0,0,0,2022-2023,5.0,0.0
1010,Paolo Ghiglione,ITA,DF,Cremonese,Serie A,25,1997,7.9,16,11,10,3,3,10,23,43.5,13,9,4,5,4,20,12,0,0,2022-2023,0.5063291139240506,2.0253164556962022
1011,Saman Ghoddos,IRN,"MF,FW",Brentford,Premier League,28,1993,1.5,2,1,0,1,1,1,3,33.3,2,5,1,4,4,6,2,0,0,2022-2023,2.6666666666666665,1.3333333333333333
1012,Faouzi Ghoulam,ALG,DF,Angers,Ligue 1,31,1991,5.3,3,3,1,1,1,3,5,60.0,2,4,2,2,4,7,12,1,0,2022-2023,0.7547169811320755,0.5660377358490566
1013,Morgan Gibbs-White,ENG,"FW,MF",Wolves,Premier League,22,2000,2.0,3,1,3,0,0,2,4,50.0,2,2,0,2,1,4,3,0,0,2022-2023,0.5,1.5
1014,Morgan Gibbs-White,ENG,"MF,FW",Nott'ham Forest,Premier League,22,2000,33.0,26,14,7,7,12,11,33,33.3,22,23,4,19,14,40,15,0,0,2022-2023,0.42424242424242425,0.7878787878787878
1015,Niko Gießelmann,GER,DF,Union Berlin,Bundesliga,30,1991,14.5,21,11,9,9,3,13,31,41.9,18,17,5,12,9,30,28,0,0,2022-2023,0.6206896551724138,1.4482758620689655
1016,Samuel Gigot,FRA,DF,Marseille,Ligue 1,28,1993,20.9,46,24,22,21,3,12,15,80.0,3,24,7,17,45,91,85,1,0,2022-2023,2.1531100478468903,2.200956937799043
1017,Rafał Gikiewicz,POL,GK,Augsburg,Bundesliga,34,1987,23.0,2,2,2,0,0,2,3,66.7,1,0,0,0,0,2,15,5,0,2022-2023,0.0,0.08695652173913043
1018,Bryan Gil,ESP,"MF,FW",Tottenham,Premier League,21,2001,1.6,3,1,3,0,0,0,3,0.0,3,3,0,3,1,4,1,0,0,2022-2023,0.625,1.875
1019,Bryan Gil,ESP,"FW,DF",Sevilla,La Liga,21,2001,10.2,22,11,11,7,4,10,23,43.5,13,10,0,10,8,30,10,0,0,2022-2023,0.7843137254901962,2.1568627450980395
1020,David Gil,ESP,GK,Cádiz,La Liga,28,1994,4.0,0,0,0,0,0,0,0,0.0,0,0,0,0,0,0,3,0,0,2022-2023,0.0,0.0
1021,Óscar Gil,ESP,DF,Espanyol,La Liga,25,1997,28.4,63,37,38,16,9,32,61,52.5,29,51,18,33,31,94,55,1,0,2022-2023,1.091549295774648,2.2183098591549295
1022,Mario Gila,ESP,DF,Lazio,Serie A,21,2000,1.0,3,1,3,0,0,0,1,0.0,1,0,0,0,3,6,3,0,0,2022-2023,3.0,3.0
1023,Billy Gilmour,SCO,MF,Brighton,Premier League,21,2001,5.6,5,2,2,2,1,2,8,25.0,6,5,2,3,6,11,5,0,0,2022-2023,1.0714285714285714,0.8928571428571429
1024,Álvaro Giménez,ESP,FW,Cádiz,La Liga,31,1991,0.2,0,0,0,0,0,0,1,0.0,1,0,0,0,0,0,0,0,0,2022-2023,0.0,0.0
1025,Gvidas Gineitis,LTU,MF,Torino,Serie A,18,2004,1.5,3,1,0,2,1,1,2,50.0,1,0,0,0,0,3,1,0,0,2022-2023,0.0,2.0
Rk,Player,Nation,Pos,Squad,Comp,0,0,90.0,0,0,3,3,3,Tkl,0,0.0,0,0,0,0,0,0,0,0,0,2022-2023,0.0,0.0
1026,Matthias Ginter,GER,DF,Freiburg,Bundesliga,28,1994,34.0,43,20,29,12,2,26,40,65.0,14,40,24,16,35,78,153,3,0,2022-2023,1.0294117647058822,1.2647058823529411
1027,Andrei Girotto,BRA,"DF,MF",Nantes,Ligue 1,30,1992,35.0,122,73,71,45,6,74,132,56.1,58,55,24,31,73,195,176,1,0,2022-2023,2.085714285714286,3.4857142857142858
1028,Olivier Giroud,FRA,FW,Milan,Serie A,35,1986,23.8,8,5,2,4,2,2,10,20.0,8,11,3,8,3,11,23,0,0,2022-2023,0.12605042016806722,0.3361344537815126
1029,Jamie Gittens,ENG,"FW,MF",Dortmund,Bundesliga,17,2004,5.9,8,4,2,5,1,2,7,28.6,5,1,0,1,1,9,2,0,0,2022-2023,0.1694915254237288,1.3559322033898304
1030,Serge Gnabry,GER,"FW,MF",Bayern Munich,Bundesliga,27,1995,21.6,35,23,11,14,10,17,43,39.5,26,24,1,23,11,46,5,1,0,2022-2023,0.5092592592592592,1.6203703703703702
1031,Wilfried Gnonto,ITA,"FW,MF",Leeds United,Premier League,18,2003,15.0,27,17,7,15,5,10,30,33.3,20,24,1,23,5,32,7,0,0,2022-2023,0.3333333333333333,1.8
1032,Ben Godfrey,ENG,DF,Everton,Premier League,24,1998,8.9,20,11,13,5,2,11,29,37.9,18,12,6,6,8,28,33,1,0,2022-2023,0.898876404494382,2.2471910112359548
1033,Pierluigi Gollini,ITA,GK,Fiorentina,Serie A,27,1995,3.0,1,0,1,0,0,1,1,100.0,0,0,0,0,0,1,2,0,0,2022-2023,0.0,0.3333333333333333
1034,Pierluigi Gollini,ITA,GK,Napoli,Serie A,27,1995,4.0,0,0,0,0,0,0,0,0.0,0,0,0,0,0,0,1,0,0,2022-2023,0.0,0.0
1035,Aleksandr Golovin,RUS,"MF,FW",Monaco,Ligue 1,26,1996,27.4,62,36,19,32,11,28,72,38.9,44,28,1,27,37,99,10,0,0,2022-2023,1.3503649635036497,2.2627737226277373
1036,André Gomes,POR,MF,Lille,Ligue 1,29,1993,18.1,37,19,12,17,8,19,52,36.5,33,20,5,15,9,46,16,1,0,2022-2023,0.49723756906077343,2.044198895027624
1037,Angel Gomes,ENG,MF,Lille,Ligue 1,21,2000,31.3,41,19,12,21,8,18,49,36.7,31,22,2,20,13,54,11,1,0,2022-2023,0.41533546325878595,1.3099041533546325
1038,João Gomes,BRA,MF,Wolves,Premier League,21,2001,7.3,29,13,14,14,1,13,23,56.5,10,12,3,9,4,33,11,0,0,2022-2023,0.547945205479452,3.9726027397260273
1039,Toti Gomes,POR,DF,Wolves,Premier League,23,1999,10.9,15,9,11,4,0,9,13,69.2,4,16,8,8,11,26,51,0,0,2022-2023,1.0091743119266054,1.3761467889908257
1040,Dani Gómez,ESP,"MF,FW",Espanyol,La Liga,24,1998,1.0,2,1,1,1,0,1,2,50.0,1,0,0,0,1,3,0,0,0,2022-2023,1.0,2.0
1041,Joe Gomez,ENG,DF,Liverpool,Premier League,25,1997,16.3,28,21,15,11,2,11,19,57.9,8,17,11,6,24,52,51,2,0,2022-2023,1.4723926380368098,1.7177914110429446
1042,Maxi Gómez,URU,FW,Valencia,La Liga,25,1996,1.2,0,0,0,0,0,0,0,0.0,0,0,0,0,0,0,2,0,0,2022-2023,0.0,0.0
1043,Moi Gómez,ESP,"MF,FW",Osasuna,La Liga,28,1994,27.3,26,17,9,14,3,15,32,46.9,17,15,3,12,10,36,5,1,0,2022-2023,0.3663003663003663,0.9523809523809523
1044,Papu Gómez,ARG,"FW,MF",Sevilla,La Liga,34,1988,11.8,6,4,3,3,0,2,10,20.0,8,8,1,7,4,10,5,0,0,2022-2023,0.3389830508474576,0.5084745762711864
1045,Sergi Gómez,ESP,DF,Espanyol,La Liga,30,1992,26.0,29,16,20,9,0,18,22,81.8,4,33,19,14,27,56,125,1,0,2022-2023,1.0384615384615385,1.1153846153846154
1046,Sergio Gómez,ESP,"DF,MF",Manchester City,Premier League,21,2000,3.9,9,4,6,1,2,5,8,62.5,3,5,3,2,2,11,9,1,0,2022-2023,0.5128205128205129,2.307692307692308
1047,Antonio Gomis,ESP,GK,Atlético Madrid,La Liga,19,2003,0.1,0,0,0,0,0,0,0,0.0,0,0,0,0,0,0,0,0,0,2022-2023,0.0,0.0
1048,Maxime Gonalons,FRA,MF,Clermont Foot,Ligue 1,33,1989,16.1,52,32,25,21,6,25,53,47.2,28,21,1,20,20,72,7,1,0,2022-2023,1.2422360248447204,3.229813664596273
1049,Diego González,ESP,DF,Elche,La Liga,27,1995,10.6,12,7,9,3,0,7,11,63.6,4,14,12,2,7,19,50,1,0,2022-2023,0.6603773584905661,1.1320754716981132
1050,Édgar González,ESP,DF,Betis,La Liga,25,1997,19.7,28,19,18,7,3,14,27,51.9,13,12,9,3,21,49,120,0,0,2022-2023,1.0659898477157361,1.4213197969543148
Rk,Player,Nation,Pos,Squad,Comp,0,0,90.0,0,0,3,3,3,Tkl,0,0.0,0,0,0,0,0,0,0,0,0,2022-2023,0.0,0.0
1051,Giovanni González,URU,DF,Mallorca,La Liga,27,1994,10.3,16,8,11,2,3,9,22,40.9,13,8,2,6,7,23,22,0,0,2022-2023,0.6796116504854368,1.5533980582524272
1052,Joan Gonzàlez,ESP,MF,Lecce,Serie A,20,2002,24.4,48,28,20,18,10,17,51,33.3,34,37,8,29,16,64,28,0,0,2022-2023,0.6557377049180328,1.9672131147540985
1053,Nicolás González,ARG,"FW,MF",Fiorentina,Serie A,24,1998,15.0,17,10,3,10,4,5,16,31.3,11,14,0,14,4,21,6,0,0,2022-2023,0.26666666666666666,1.1333333333333333
1054,Nicolás González,ESP,MF,Valencia,La Liga,20,2002,15.6,27,15,11,13,3,9,25,36.0,16,21,7,14,19,46,16,0,0,2022-2023,1.217948717948718,1.7307692307692308
1055,Oumar Gonzalez,CMR,DF,Ajaccio,Ligue 1,24,1998,28.6,51,28,34,13,4,23,37,62.2,14,32,11,21,52,103,82,0,0,2022-2023,1.8181818181818181,1.7832167832167831
1056,Roberto González,ESP,"FW,MF",Betis,La Liga,21,2001,0.6,0,0,0,0,0,0,1,0.0,1,0,0,0,1,1,0,0,0,2022-2023,1.6666666666666667,0.0
1057,Jacek Góralski,POL,MF,Bochum,Bundesliga,29,1992,1.6,6,3,3,3,0,4,6,66.7,2,4,0,4,3,9,5,0,0,2022-2023,1.875,3.75
1058,Anthony Gordon,ENG,"FW,MF",Newcastle Utd,Premier League,21,2001,5.4,14,12,5,7,2,9,20,45.0,11,9,1,8,2,16,1,1,0,2022-2023,0.37037037037037035,2.5925925925925926
1059,Anthony Gordon,ENG,FW,Everton,Premier League,21,2001,12.2,34,22,17,10,7,8,24,33.3,16,19,0,19,4,38,11,0,0,2022-2023,0.3278688524590164,2.7868852459016393
1060,Leon Goretzka,GER,MF,Bayern Munich,Bundesliga,27,1995,19.2,43,24,21,16,6,27,48,56.3,21,40,3,37,30,73,32,0,0,2022-2023,1.5625,2.2395833333333335
1061,Andoni Gorosabel,ESP,DF,Real Sociedad,La Liga,25,1996,19.0,41,25,23,9,9,26,43,60.5,17,21,2,19,17,58,23,0,0,2022-2023,0.8947368421052632,2.1578947368421053
1062,Robin Gosens,GER,DF,Inter,Serie A,28,1994,13.2,34,18,15,10,9,15,25,60.0,10,16,2,14,23,57,15,0,0,2022-2023,1.7424242424242424,2.5757575757575757
1063,Mario Götze,GER,MF,Eint Frankfurt,Bundesliga,30,1992,30.4,42,25,13,22,7,14,47,29.8,33,25,0,25,13,55,12,0,0,2022-2023,0.4276315789473684,1.381578947368421
1064,Amine Gouiri,ALG,"FW,MF",Nice,Ligue 1,22,2000,2.5,1,1,1,0,0,0,1,0.0,1,1,0,1,0,1,3,0,0,2022-2023,0.0,0.4
1065,Amine Gouiri,ALG,"FW,MF",Rennes,Ligue 1,22,2000,28.0,42,25,14,16,12,14,33,42.4,19,21,0,21,12,54,10,0,0,2022-2023,0.42857142857142855,1.5
1066,Jeffrey Gouweleeuw,NED,DF,Augsburg,Bundesliga,31,1991,31.1,42,27,19,17,6,24,49,49.0,25,41,23,18,50,92,141,2,0,2022-2023,1.607717041800643,1.35048231511254
1067,Jonathan Gradit,FRA,DF,Lens,Ligue 1,29,1992,31.4,62,40,30,25,7,31,53,58.5,22,40,26,14,38,100,83,0,0,2022-2023,1.2101910828025477,1.9745222929936306
1068,José Gragera,ESP,"MF,DF",Espanyol,La Liga,21,2000,5.1,19,9,11,6,2,6,11,54.5,5,10,4,6,7,26,18,0,0,2022-2023,1.3725490196078431,3.7254901960784315
1069,Alberto Grassi,ITA,MF,Empoli,Serie A,27,1995,13.3,26,21,13,13,0,15,24,62.5,9,23,12,11,27,53,45,0,0,2022-2023,2.0300751879699246,1.9548872180451127
1070,Ryan Gravenberch,NED,MF,Bayern Munich,Bundesliga,20,2002,6.4,17,8,4,10,3,7,13,53.8,6,9,1,8,9,26,10,0,0,2022-2023,1.40625,2.65625
1071,Andrew Gravillon,GLP,DF,Torino,Serie A,24,1998,3.5,3,3,0,3,0,0,0,0.0,0,4,2,2,9,12,16,0,0,2022-2023,2.5714285714285716,0.8571428571428571
1072,Andrew Gravillon,GLP,DF,Reims,Ligue 1,24,1998,11.5,16,8,9,6,1,8,13,61.5,5,18,9,9,21,37,36,0,0,2022-2023,1.826086956521739,1.391304347826087
1073,Demarai Gray,JAM,"FW,MF",Everton,Premier League,26,1996,27.9,33,24,9,14,10,17,31,54.8,14,23,3,20,13,46,18,0,0,2022-2023,0.4659498207885305,1.1827956989247312
1074,Adrian Grbić,AUT,"MF,FW",Lorient,Ligue 1,25,1996,0.3,0,0,0,0,0,0,1,0.0,1,3,0,3,0,0,0,0,0,2022-2023,0.0,0.0
1075,Ivo Grbić,CRO,GK,Atlético Madrid,La Liga,26,1996,10.2,0,0,0,0,0,0,0,0.0,0,0,0,0,0,0,9,1,0,2022-2023,0.0,0.0
Rk,Player,Nation,Pos,Squad,Comp,0,0,90.0,0,0,3,3,3,Tkl,0,0.0,0,0,0,0,0,0,0,0,0,2022-2023,0.0,0.0
1076,Jack Grealish,ENG,FW,Manchester City,Premier League,26,1995,22.8,25,16,10,12,3,13,23,56.5,10,17,3,14,7,32,9,0,0,2022-2023,0.30701754385964913,1.0964912280701753
1077,Sam Greenwood,ENG,"MF,FW",Leeds United,Premier League,20,2002,4.7,15,7,7,8,0,8,21,38.1,13,10,2,8,1,16,1,0,0,2022-2023,0.2127659574468085,3.1914893617021276
1078,Michael Gregoritsch,AUT,FW,Freiburg,Bundesliga,28,1994,23.9,19,12,6,9,4,3,21,14.3,18,23,4,19,5,24,10,0,0,2022-2023,0.2092050209205021,0.794979079497908
1079,Dominik Greif,SVK,GK,Mallorca,La Liga,25,1997,1.0,0,0,0,0,0,0,0,0.0,0,0,0,0,0,0,0,0,0,2022-2023,0.0,0.0
1080,Leo Greiml,AUT,DF,Schalke 04,Bundesliga,21,2001,4.0,10,5,4,5,1,5,12,41.7,7,7,3,4,3,13,16,0,0,2022-2023,0.75,2.5
1081,Clément Grenier,FRA,MF,Mallorca,La Liga,31,1991,8.0,20,8,6,12,2,10,20,50.0,10,9,1,8,6,26,7,0,0,2022-2023,0.75,2.5
1082,Antoine Griezmann,FRA,"FW,MF",Atlético Madrid,La Liga,31,1991,31.8,49,34,15,23,11,20,66,30.3,46,34,3,31,24,73,31,0,0,2022-2023,0.7547169811320754,1.540880503144654
1083,Vincenzo Grifo,ITA,"MF,FW",Freiburg,Bundesliga,29,1993,26.8,29,16,6,15,8,13,31,41.9,18,18,1,17,19,48,19,0,0,2022-2023,0.708955223880597,1.0820895522388059
1084,Lennart Grill,GER,GK,Union Berlin,Bundesliga,23,1999,5.0,0,0,0,0,0,0,1,0.0,1,0,0,0,0,0,1,1,0,2022-2023,0.0,0.0
1085,Christian Groß,GER,MF,Werder Bremen,Bundesliga,33,1989,21.0,56,25,20,34,2,29,60,48.3,31,20,5,15,23,79,38,1,0,2022-2023,1.0952380952380953,2.6666666666666665
1086,Pascal Groß,GER,"MF,DF",Brighton,Premier League,31,1991,36.0,59,38,23,27,9,25,55,45.5,30,32,10,22,13,72,21,1,0,2022-2023,0.3611111111111111,1.6388888888888888
1087,Brajan Gruda,GER,MF,Mainz 05,Bundesliga,18,2004,0.0,0,0,0,0,0,0,0,0.0,0,0,0,0,0,0,0,0,0,2022-2023,,
1088,Ilia Gruev,BUL,MF,Werder Bremen,Bundesliga,22,2000,17.6,44,27,16,25,3,18,31,58.1,13,23,6,17,22,66,21,1,0,2022-2023,1.25,2.5
1089,Carlos Gruezo,ECU,MF,Augsburg,Bundesliga,27,1995,10.7,21,12,12,9,0,9,16,56.3,7,13,4,9,10,31,15,0,0,2022-2023,0.9345794392523366,1.9626168224299068
1090,Vicente Guaita,ESP,GK,Crystal Palace,Premier League,35,1987,27.0,0,0,0,0,0,0,0,0.0,0,0,0,0,0,0,9,1,0,2022-2023,0.0,0.0
1091,Andrés Guardado,MEX,MF,Betis,La Liga,35,1986,15.3,41,25,17,20,4,18,43,41.9,25,14,5,9,23,64,29,0,0,2022-2023,1.5032679738562091,2.679738562091503
1092,Sergi Guardiola,ESP,FW,Valladolid,La Liga,31,1991,5.6,12,7,6,5,1,2,4,50.0,2,6,0,6,2,14,7,0,0,2022-2023,0.35714285714285715,2.142857142857143
1093,Sergi Guardiola,ESP,FW,Cádiz,La Liga,31,1991,12.9,9,7,0,6,3,3,12,25.0,9,5,0,5,3,12,7,0,0,2022-2023,0.23255813953488372,0.6976744186046512
1094,Nemanja Gudelj,SRB,"DF,MF",Sevilla,La Liga,30,1991,30.9,43,33,22,18,3,20,33,60.6,13,39,29,10,34,77,102,1,0,2022-2023,1.1003236245954693,1.3915857605177995
1095,Gabriel Gudmundsson,SWE,"DF,FW",Lille,Ligue 1,23,1999,9.3,19,11,7,10,2,12,22,54.5,10,11,2,9,10,29,20,0,0,2022-2023,1.075268817204301,2.043010752688172
1096,Gonçalo Guedes,POR,"FW,MF",Wolves,Premier League,25,1996,7.9,8,6,4,3,1,5,8,62.5,3,4,0,4,1,9,2,0,0,2022-2023,0.12658227848101264,1.0126582278481011
1097,Axel Gueguin,FRA,"FW,MF",Montpellier,Ligue 1,17,2005,0.3,0,0,0,0,0,0,0,0.0,0,1,0,1,0,0,0,0,0,2022-2023,0.0,0.0
1098,Marc Guéhi,ENG,DF,Crystal Palace,Premier League,22,2000,37.0,52,27,39,11,2,26,42,61.9,16,45,24,21,45,97,134,3,0,2022-2023,1.2162162162162162,1.4054054054054055
1099,Mattéo Guendouzi,FRA,MF,Marseille,Ligue 1,23,1999,23.4,39,18,9,21,9,14,38,36.8,24,12,5,7,21,60,18,0,0,2022-2023,0.8974358974358975,1.6666666666666667
1100,Javier Guerra,ESP,MF,Valencia,La Liga,19,2003,6.7,16,13,7,4,5,9,20,45.0,11,8,1,7,11,27,9,0,0,2022-2023,1.6417910447761193,2.388059701492537
Rk,Player,Nation,Pos,Squad,Comp,0,0,90.0,0,0,3,3,3,Tkl,0,0.0,0,0,0,0,0,0,0,0,0,2022-2023,0.0,0.0
1101,Raphaël Guerreiro,POR,"DF,MF",Dortmund,Bundesliga,28,1993,25.4,36,20,13,15,8,21,34,61.8,13,21,2,19,36,72,23,0,0,2022-2023,1.4173228346456694,1.4173228346456694
1102,Axel Guessand,FRA,DF,Udinese,Serie A,17,2004,0.9,2,1,2,0,0,1,2,50.0,1,1,0,1,2,4,3,0,0,2022-2023,2.2222222222222223,2.2222222222222223
1103,Evann Guessand,CIV,"FW,MF",Nantes,Ligue 1,21,2001,14.0,24,16,8,13,3,6,12,50.0,6,17,1,16,9,33,6,0,0,2022-2023,0.6428571428571429,1.7142857142857142
1104,Ander Guevara,ESP,MF,Real Sociedad,La Liga,25,1997,2.5,5,2,2,2,1,1,4,25.0,3,6,1,5,2,7,3,0,0,2022-2023,0.8,2.0
1105,Pape Gueye,SEN,MF,Sevilla,La Liga,23,1999,13.0,37,22,13,21,3,16,33,48.5,17,21,5,16,22,59,10,0,0,2022-2023,1.6923076923076923,2.8461538461538463
1106,Pape Gueye,SEN,"MF,DF",Marseille,Ligue 1,23,1999,5.5,18,7,10,7,1,7,15,46.7,8,9,2,7,9,27,2,0,0,2022-2023,1.6363636363636365,3.272727272727273
1107,Josuha Guilavogui,FRA,"DF,MF",Wolfsburg,Bundesliga,31,1990,13.1,18,11,7,10,1,6,17,35.3,11,19,13,6,23,41,52,0,0,2022-2023,1.7557251908396947,1.3740458015267176
1108,Frederic Guilbert,FRA,DF,Strasbourg,Ligue 1,27,1994,16.2,47,29,18,23,6,25,43,58.1,18,24,3,21,43,90,33,1,0,2022-2023,2.6543209876543212,2.9012345679012346
1109,Hugo Guillamón,ESP,MF,Valencia,La Liga,22,2000,18.1,20,12,10,8,2,8,24,33.3,16,14,2,12,19,39,30,2,0,2022-2023,1.0497237569060773,1.1049723756906076
1110,Bruno Guimarães,BRA,MF,Newcastle Utd,Premier League,24,1997,30.3,78,40,27,46,5,38,65,58.5,27,28,4,24,36,114,22,1,0,2022-2023,1.188118811881188,2.5742574257425743
1111,Serhou Guirassy,GUI,MF,Rennes,Ligue 1,26,1996,0.3,0,0,0,0,0,0,0,0.0,0,0,0,0,0,0,0,0,0,2022-2023,0.0,0.0
1112,Serhou Guirassy,GUI,FW,Stuttgart,Bundesliga,26,1996,18.3,4,1,2,2,0,1,2,50.0,1,7,2,5,0,4,14,0,0,2022-2023,0.0,0.2185792349726776
1113,Rafik Guitane,FRA,FW,Reims,Ligue 1,23,1999,0.0,0,0,0,0,0,0,0,0.0,0,0,0,0,0,0,1,0,0,2022-2023,,
1114,Péter Gulácsi,HUN,GK,RB Leipzig,Bundesliga,32,1990,6.0,0,0,0,0,0,0,0,0.0,0,0,0,0,0,0,2,0,0,2022-2023,0.0,0.0
1115,Manuel Gulde,GER,DF,Freiburg,Bundesliga,31,1991,7.1,14,8,10,4,0,2,4,50.0,2,5,1,4,19,33,25,0,0,2022-2023,2.676056338028169,1.971830985915493
1116,Gerard Gumbau,ESP,MF,Elche,La Liga,27,1994,30.4,44,25,17,23,4,18,51,35.3,33,32,8,24,28,72,40,0,0,2022-2023,0.9210526315789475,1.4473684210526316
1117,Robert Gumny,POL,DF,Augsburg,Bundesliga,24,1998,22.4,34,24,13,15,6,11,27,40.7,16,21,7,14,26,60,62,1,0,2022-2023,1.1607142857142858,1.517857142857143
1118,İlkay Gündoğan,GER,MF,Manchester City,Premier League,31,1990,26.1,30,18,7,13,10,12,34,35.3,22,18,3,15,20,50,13,0,0,2022-2023,0.7662835249042145,1.1494252873563218
1119,Christian Günter,GER,"DF,MF",Freiburg,Bundesliga,29,1993,30.5,29,21,18,9,2,13,43,30.2,30,22,4,18,16,45,41,0,0,2022-2023,0.5245901639344263,0.9508196721311475
1120,Koray Günter,GER,DF,Hellas Verona,Serie A,27,1994,11.1,10,6,1,8,1,4,7,57.1,3,24,15,9,30,40,46,0,0,2022-2023,2.7027027027027026,0.9009009009009009
1121,Koray Günter,GER,DF,Sampdoria,Serie A,27,1994,8.6,10,8,6,4,0,6,9,66.7,3,10,5,5,11,21,46,0,0,2022-2023,1.2790697674418605,1.1627906976744187
1122,Gorka Guruzeta,ESP,FW,Athletic Club,La Liga,25,1996,15.8,24,20,6,12,6,11,24,45.8,13,23,2,21,4,28,8,0,0,2022-2023,0.2531645569620253,1.5189873417721518
1123,Malo Gusto,FRA,DF,Lyon,Ligue 1,19,2003,17.7,42,26,23,11,8,21,43,48.8,22,22,5,17,28,70,23,1,0,2022-2023,1.5819209039548023,2.3728813559322033
1124,Raúl Guti,ESP,MF,Elche,La Liga,25,1996,12.4,18,12,8,9,1,8,18,44.4,10,10,3,7,8,26,6,0,0,2022-2023,0.6451612903225806,1.4516129032258065
1125,Miguel Gutiérrez,ESP,DF,Girona,La Liga,21,2001,26.6,41,23,23,13,5,23,37,62.2,14,23,5,18,18,59,42,1,0,2022-2023,0.6766917293233082,1.5413533834586466
Rk,Player,Nation,Pos,Squad,Comp,0,0,90.0,0,0,3,3,3,Tkl,0,0.0,0,0,0,0,0,0,0,0,0,2022-2023,0.0,0.0
1126,Joško Gvardiol,CRO,DF,RB Leipzig,Bundesliga,20,2002,24.1,23,17,15,8,0,9,22,40.9,13,34,17,17,34,57,76,1,0,2022-2023,1.4107883817427385,0.954356846473029
1127,Darko Gyabi,ENG,FW,Leeds United,Premier League,18,2004,0.1,2,2,1,1,0,0,0,0.0,0,2,0,2,0,2,0,0,0,2022-2023,0.0,20.0
1128,Emmanuel Gyasi,GHA,"FW,DF",Spezia,Serie A,28,1994,31.2,24,15,11,10,3,9,36,25.0,27,24,6,18,8,32,26,0,0,2022-2023,0.25641025641025644,0.7692307692307693
1129,Norbert Gyömbér,SVK,DF,Salernitana,Serie A,30,1992,19.3,32,23,25,6,1,16,24,66.7,8,33,22,11,35,67,92,0,0,2022-2023,1.8134715025906736,1.6580310880829014
1130,Christian Gytkjær,DEN,"FW,MF",Monza,Serie A,32,1990,6.2,6,2,1,4,1,2,5,40.0,3,6,1,5,0,6,2,0,0,2022-2023,0.0,0.9677419354838709
1131,Erling Haaland,NOR,FW,Manchester City,Premier League,22,2000,30.8,3,2,0,2,1,1,5,20.0,4,12,4,8,3,6,14,0,0,2022-2023,0.09740259740259741,0.09740259740259741
1132,Nicolas Haas,SUI,MF,Empoli,Serie A,26,1996,12.8,27,13,16,6,5,12,24,50.0,12,16,4,12,8,35,27,0,0,2022-2023,0.625,2.109375
1133,Janik Haberer,GER,MF,Union Berlin,Bundesliga,28,1994,24.3,29,17,8,18,3,17,48,35.4,31,35,2,33,14,43,25,0,0,2022-2023,0.5761316872427983,1.1934156378600822
1134,Alexander Hack,GER,DF,Mainz 05,Bundesliga,28,1993,12.6,30,18,21,9,0,19,33,57.6,14,18,5,13,24,54,45,1,0,2022-2023,1.9047619047619049,2.380952380952381
1135,Munir El Haddadi,MAR,"MF,FW",Getafe,La Liga,26,1995,12.8,12,7,3,7,2,2,10,20.0,8,23,2,21,9,21,7,0,0,2022-2023,0.703125,0.9375
1136,Jaouen Hadjam,ALG,DF,Nantes,Ligue 1,19,2003,8.9,27,21,13,9,5,16,25,64.0,9,10,3,7,12,39,12,0,0,2022-2023,1.348314606741573,3.033707865168539
1137,Dennis Hadzikadunic,BIH,DF,Mallorca,La Liga,24,1998,6.8,9,6,4,5,0,4,4,100.0,0,5,4,1,3,12,27,0,0,2022-2023,0.4411764705882353,1.3235294117647058
1138,André Hahn,GER,"FW,MF",Augsburg,Bundesliga,31,1990,4.3,9,5,4,4,1,8,12,66.7,4,9,2,7,4,13,14,0,0,2022-2023,0.9302325581395349,2.0930232558139537
1139,Amadou Haidara,MLI,MF,RB Leipzig,Bundesliga,24,1998,15.9,25,11,15,10,0,13,34,38.2,21,26,6,20,26,51,20,0,0,2022-2023,1.6352201257861634,1.572327044025157
1140,Massadio Haïdara,MLI,"DF,MF",Lens,Ligue 1,29,1992,18.6,24,16,9,9,6,12,24,50.0,12,26,9,17,36,60,39,1,0,2022-2023,1.9354838709677418,1.2903225806451613
1141,Achraf Hakimi,MAR,"DF,MF",Paris S-G,Ligue 1,23,1998,22.8,54,34,19,20,15,31,59,52.5,28,34,2,32,16,70,19,0,0,2022-2023,0.7017543859649122,2.3684210526315788
1142,Lewis Hall,ENG,DF,Chelsea,Premier League,17,2004,7.3,23,12,19,4,0,15,22,68.2,7,8,0,8,11,34,11,1,0,2022-2023,1.5068493150684932,3.1506849315068495
1143,Sébastien Haller,CIV,FW,Dortmund,Bundesliga,28,1994,13.6,5,4,2,1,2,0,4,0.0,4,8,0,8,1,6,10,0,0,2022-2023,0.07352941176470588,0.36764705882352944
1144,Marcel Halstenberg,GER,DF,RB Leipzig,Bundesliga,30,1991,17.3,40,21,20,15,5,23,41,56.1,18,22,1,21,21,61,29,0,0,2022-2023,1.2138728323699421,2.312138728323699
1145,Mathis Hamdi,FRA,DF,Troyes,Ligue 1,18,2003,0.8,0,0,0,0,0,0,1,0.0,1,0,0,0,1,1,1,0,0,2022-2023,1.25,0.0
1146,Ben Hamed Touré,CIV,FW,Ajaccio,Ligue 1,18,2003,2.3,4,4,2,2,0,1,5,20.0,4,2,0,2,1,5,4,0,0,2022-2023,0.4347826086956522,1.7391304347826089
1147,Romain Hamouma,FRA,"FW,MF",Ajaccio,Ligue 1,35,1987,12.0,8,3,3,3,2,3,6,50.0,3,8,0,8,2,10,2,0,0,2022-2023,0.16666666666666666,0.6666666666666666
1148,Saïd Hamulic,BIH,FW,Toulouse,Ligue 1,21,2000,1.2,0,0,0,0,0,0,0,0.0,0,0,0,0,0,0,0,0,0,2022-2023,0.0,0.0
1149,Andreas Hanche-Olsen,NOR,DF,Mainz 05,Bundesliga,25,1997,16.6,35,23,24,7,4,22,39,56.4,17,16,8,8,33,68,77,2,0,2022-2023,1.9879518072289155,2.108433734939759
1150,Samir Handanović,SVN,GK,Inter,Serie A,38,1984,13.7,0,0,0,0,0,0,0,0.0,0,0,0,0,0,0,5,0,0,2022-2023,0.0,0.0
Rk,Player,Nation,Pos,Squad,Comp,0,0,90.0,0,0,3,3,3,Tkl,0,0.0,0,0,0,0,0,0,0,0,0,2022-2023,0.0,0.0
1151,Genki Haraguchi,JPN,MF,Stuttgart,Bundesliga,31,1991,8.3,16,7,7,7,2,4,16,25.0,12,13,2,11,8,24,6,0,0,2022-2023,0.9638554216867469,1.9277108433734937
1152,Genki Haraguchi,JPN,MF,Union Berlin,Bundesliga,31,1991,5.5,12,8,1,10,1,3,9,33.3,6,7,1,6,3,15,9,0,0,2022-2023,0.5454545454545454,2.1818181818181817
1153,Amine Harit,MAR,"MF,FW",Marseille,Ligue 1,25,1997,5.7,6,4,0,3,3,3,8,37.5,5,4,1,3,4,10,6,0,0,2022-2023,0.7017543859649122,1.0526315789473684
1154,Luke Harris,WAL,"MF,FW",Fulham,Premier League,17,2005,0.1,0,0,0,0,0,0,0,0.0,0,0,0,0,0,0,0,0,0,2022-2023,0.0,0.0
1155,Jack Harrison,ENG,"FW,MF",Leeds United,Premier League,25,1996,30.1,41,17,5,15,21,12,52,23.1,40,47,2,45,22,63,25,0,0,2022-2023,0.7308970099667774,1.3621262458471761
1156,Abdou Harroui,NED,MF,Sassuolo,Serie A,24,1998,7.2,17,6,6,7,4,2,7,28.6,5,6,1,5,2,19,10,0,0,2022-2023,0.2777777777777778,2.361111111111111
1157,Makoto Hasebe,JPN,DF,Eint Frankfurt,Bundesliga,38,1984,14.5,18,12,16,2,0,7,22,31.8,15,22,9,13,17,35,45,0,0,2022-2023,1.1724137931034482,1.2413793103448276
1158,Haissem Hassan,FRA,"FW,MF",Villarreal,La Liga,20,2002,0.6,0,0,0,0,0,0,2,0.0,2,0,0,0,1,1,0,0,0,2022-2023,1.6666666666666667,0.0
1159,Hans Hateboer,NED,DF,Atalanta,Serie A,28,1994,15.5,21,13,11,8,2,11,27,40.7,16,23,4,19,12,33,25,0,0,2022-2023,0.7741935483870968,1.3548387096774193
1160,Kai Havertz,GER,"FW,MF",Chelsea,Premier League,23,1999,28.5,34,16,4,20,10,10,30,33.3,20,28,0,28,7,41,41,0,0,2022-2023,0.24561403508771928,1.1929824561403508
1161,Eden Hazard,BEL,FW,Real Madrid,La Liga,31,1991,2.2,0,0,0,0,0,0,2,0.0,2,1,0,1,1,1,0,0,0,2022-2023,0.45454545454545453,0.0
1162,Thorgan Hazard,BEL,"FW,DF",Dortmund,Bundesliga,29,1993,5.2,17,6,5,11,1,12,17,70.6,5,6,0,6,5,22,5,0,0,2022-2023,0.9615384615384615,3.269230769230769
1163,Rhys Healey,WAL,FW,Toulouse,Ligue 1,27,1994,0.7,0,0,0,0,0,0,0,0.0,0,0,0,0,0,0,0,0,0,2022-2023,0.0,0.0
1164,Jan Paul van Hecke,NED,DF,Brighton,Premier League,22,2000,3.3,8,6,3,4,1,5,5,100.0,0,8,5,3,6,14,9,0,0,2022-2023,1.8181818181818183,2.4242424242424243
1165,Jonas Hector,GER,DF,Köln,Bundesliga,32,1990,31.4,112,66,59,43,10,66,113,58.4,47,61,9,52,39,151,74,1,0,2022-2023,1.2420382165605095,3.56687898089172
1166,Hwang Hee-chan,KOR,"FW,MF",Wolves,Premier League,26,1996,12.6,20,9,7,8,5,6,20,30.0,14,18,2,16,5,25,5,0,0,2022-2023,0.39682539682539686,1.5873015873015874
1167,Gauthier Hein,FRA,"MF,FW",Auxerre,Ligue 1,25,1996,20.8,27,20,13,11,3,18,48,37.5,30,10,0,10,6,33,10,0,0,2022-2023,0.28846153846153844,1.2980769230769231
1168,Dominique Heintz,GER,DF,Bochum,Bundesliga,28,1993,8.8,13,9,5,7,1,6,17,35.3,11,11,7,4,12,25,34,0,0,2022-2023,1.3636363636363635,1.477272727272727
1169,Dean Henderson,ENG,GK,Nott'ham Forest,Premier League,25,1997,18.0,0,0,0,0,0,0,0,0.0,0,0,0,0,0,0,12,1,0,2022-2023,0.0,0.0
1170,Jordan Henderson,ENG,MF,Liverpool,Premier League,32,1990,23.0,32,23,10,18,4,15,36,41.7,21,21,3,18,21,53,16,1,0,2022-2023,0.9130434782608695,1.391304347826087
1171,Liam Henderson,SCO,MF,Empoli,Serie A,26,1996,11.2,13,10,6,5,2,4,21,19.0,17,10,2,8,10,23,10,0,0,2022-2023,0.8928571428571429,1.1607142857142858
1172,Jack Hendry,SCO,DF,Cremonese,Serie A,27,1995,2.4,0,0,0,0,0,0,1,0.0,1,2,1,1,1,1,7,0,0,2022-2023,0.4166666666666667,0.0
1173,Wayne Hennessey,WAL,GK,Nott'ham Forest,Premier League,35,1987,3.0,1,0,1,0,0,1,1,100.0,0,0,0,0,0,1,2,0,0,2022-2023,0.0,0.3333333333333333
1174,Benjamin Henrichs,GER,"DF,MF",RB Leipzig,Bundesliga,25,1997,24.3,73,46,41,29,3,43,66,65.2,23,48,4,44,35,108,46,0,0,2022-2023,1.4403292181069958,3.0041152263374484
1175,Henrique,BRA,"DF,FW",Lyon,Ligue 1,28,1994,4.0,9,4,3,2,4,6,13,46.2,7,3,1,2,5,14,8,0,0,2022-2023,1.25,2.25
Rk,Player,Nation,Pos,Squad,Comp,0,0,90.0,0,0,3,3,3,Tkl,0,0.0,0,0,0,0,0,0,0,0,0,2022-2023,0.0,0.0
1176,Luiz Henrique,BRA,FW,Betis,La Liga,21,2001,20.1,48,34,27,15,6,20,44,45.5,24,22,0,22,14,62,17,0,0,2022-2023,0.6965174129353233,2.388059701492537
1177,Matheus Henrique,BRA,MF,Sassuolo,Serie A,24,1997,21.6,26,12,9,11,6,12,24,50.0,12,15,4,11,12,38,10,0,0,2022-2023,0.5555555555555555,1.2037037037037037
1178,Rico Henry,ENG,DF,Brentford,Premier League,25,1997,36.0,57,31,20,28,9,22,41,53.7,19,29,8,21,30,87,84,1,0,2022-2023,0.8333333333333334,1.5833333333333333
1179,Thomas Henry,FRA,FW,Hellas Verona,Serie A,27,1994,11.4,5,3,1,1,3,1,5,20.0,4,6,2,4,0,5,14,0,0,2022-2023,0.0,0.43859649122807015
1180,Christophe Hérelle,MTQ,DF,Brest,Ligue 1,29,1992,11.8,10,4,7,2,1,4,13,30.8,9,16,11,5,20,30,48,0,0,2022-2023,1.694915254237288,0.847457627118644
1181,Mario Hermoso,ESP,DF,Atlético Madrid,La Liga,27,1995,23.4,22,15,14,6,2,9,30,30.0,21,19,9,10,19,41,85,1,0,2022-2023,0.811965811965812,0.9401709401709403
1182,Javi Hernández,ESP,DF,Girona,La Liga,24,1998,12.4,21,12,12,7,2,13,21,61.9,8,10,5,5,7,28,38,0,0,2022-2023,0.564516129032258,1.6935483870967742
1183,Aridane Hernández,ESP,DF,Osasuna,La Liga,33,1989,19.9,21,15,17,4,0,12,25,48.0,13,34,21,13,28,49,96,1,0,2022-2023,1.407035175879397,1.0552763819095479
1184,Lucas Hernández,FRA,DF,Bayern Munich,Bundesliga,26,1996,5.3,6,4,3,3,0,5,6,83.3,1,2,1,1,5,11,7,0,0,2022-2023,0.9433962264150944,1.1320754716981132
1185,Luis Hernández,ESP,DF,Cádiz,La Liga,33,1989,35.0,33,21,25,7,1,22,36,61.1,14,31,24,7,31,64,145,0,0,2022-2023,0.8857142857142857,0.9428571428571428
1186,Mario Hernández,ESP,DF,Rayo Vallecano,La Liga,23,1999,1.1,3,2,2,1,0,3,7,42.9,4,2,0,2,2,5,0,0,0,2022-2023,1.8181818181818181,2.727272727272727
1187,Theo Hernández,FRA,DF,Milan,Serie A,24,1997,30.8,43,24,27,15,1,22,38,57.9,16,34,7,27,21,64,35,1,0,2022-2023,0.6818181818181818,1.396103896103896
1188,Jorge Herrando,ESP,DF,Osasuna,La Liga,21,2001,0.3,0,0,0,0,0,0,0,0.0,0,1,0,1,0,0,3,0,0,2022-2023,0.0,0.0
1189,Ander Herrera,ESP,MF,Athletic Club,La Liga,32,1989,7.7,18,10,8,7,3,6,18,33.3,12,12,3,9,11,29,12,0,0,2022-2023,1.4285714285714286,2.3376623376623376
1190,Sergio Herrera,ESP,GK,Osasuna,La Liga,29,1993,17.0,2,0,2,0,0,2,2,100.0,0,1,0,1,1,3,6,2,0,2022-2023,0.058823529411764705,0.11764705882352941
1191,Yangel Herrera,VEN,"MF,FW",Girona,La Liga,24,1998,10.7,26,9,9,14,3,6,15,40.0,9,14,1,13,4,30,12,0,0,2022-2023,0.3738317757009346,2.429906542056075
1192,Patrick Herrmann,GER,"FW,MF",Gladbach,Bundesliga,31,1991,1.8,6,2,4,1,1,2,4,50.0,2,2,0,2,2,8,1,0,0,2022-2023,1.1111111111111112,3.333333333333333
1193,Son Heung-min,KOR,"MF,FW",Tottenham,Premier League,30,1992,32.1,24,12,7,8,9,9,30,30.0,21,23,2,21,13,37,6,0,0,2022-2023,0.40498442367601245,0.7476635514018691
1194,Aaron Hickey,SCO,DF,Brentford,Premier League,20,2002,21.3,38,26,27,11,0,18,32,56.3,14,18,7,11,17,55,32,1,0,2022-2023,0.7981220657276995,1.784037558685446
1195,Isak Hien,SWE,DF,Hellas Verona,Serie A,23,1999,29.0,73,36,54,19,0,38,61,62.3,23,40,17,23,31,104,92,1,0,2022-2023,1.0689655172413792,2.5172413793103448
1196,Omar El Hilali,MAR,"DF,MF",Espanyol,La Liga,18,2003,1.0,3,2,3,0,0,1,2,50.0,1,1,0,1,1,4,6,0,0,2022-2023,1.0,3.0
1197,Piero Hincapié,ECU,"DF,MF",Leverkusen,Bundesliga,20,2002,27.3,51,34,28,20,3,25,38,65.8,13,41,20,21,31,82,83,1,0,2022-2023,1.1355311355311355,1.8681318681318682
1198,Jack Hinshelwood,ENG,FW,Brighton,Premier League,17,2005,0.0,1,0,1,0,0,0,0,0.0,0,0,0,0,0,1,0,0,0,2022-2023,,inf
1199,Morten Hjulmand,DEN,MF,Lecce,Serie A,23,1999,32.9,90,52,49,40,1,37,67,55.2,30,43,11,32,72,162,54,0,0,2022-2023,2.1884498480243164,2.7355623100303954
1200,Adam Hložek,CZE,"FW,MF",Leverkusen,Bundesliga,20,2002,14.3,9,4,4,3,2,3,9,33.3,6,9,2,7,6,15,9,0,0,2022-2023,0.4195804195804196,0.6293706293706294
Rk,Player,Nation,Pos,Squad,Comp,0,0,90.0,0,0,3,3,3,Tkl,0,0.0,0,0,0,0,0,0,0,0,0,2022-2023,0.0,0.0
1201,Joseph Hodge,IRL,MF,Wolves,Premier League,19,2002,1.9,5,2,1,3,1,3,4,75.0,1,5,0,5,0,5,2,1,0,2022-2023,0.0,2.6315789473684212
1202,Nicolas Höfler,GER,MF,Freiburg,Bundesliga,32,1990,31.3,66,35,28,35,3,27,61,44.3,34,40,13,27,58,124,49,0,0,2022-2023,1.853035143769968,2.108626198083067
1203,Jonas Hofmann,GER,"FW,MF",Gladbach,Bundesliga,30,1992,29.8,31,16,17,8,6,15,52,28.8,37,36,2,34,16,47,21,0,0,2022-2023,0.5369127516778524,1.0402684563758389
1204,Philipp Hofmann,GER,FW,Bochum,Bundesliga,29,1993,29.2,18,11,0,13,5,5,12,41.7,7,20,8,12,6,24,48,0,0,2022-2023,0.20547945205479454,0.6164383561643836
1205,Rob Holding,ENG,DF,Arsenal,Premier League,26,1995,6.3,8,5,4,4,0,3,6,50.0,3,6,5,1,3,11,27,1,0,2022-2023,0.4761904761904762,1.2698412698412698
1206,Lucas Höler,GER,"FW,MF",Freiburg,Bundesliga,28,1994,16.7,19,14,5,7,7,6,22,27.3,16,22,5,17,10,29,17,0,0,2022-2023,0.5988023952095809,1.1377245508982037
1207,Mason Holgate,ENG,DF,Everton,Premier League,25,1996,5.6,11,7,8,3,0,3,11,27.3,8,7,3,4,7,18,28,0,0,2022-2023,1.25,1.9642857142857144
1208,Emil Holm,SWE,DF,Spezia,Serie A,22,2000,15.5,26,15,13,8,5,16,31,51.6,15,21,6,15,9,35,41,0,0,2022-2023,0.5806451612903226,1.6774193548387097
1209,Noah Holm,NOR,"FW,MF",Reims,Ligue 1,21,2001,2.2,6,4,2,2,2,2,5,40.0,3,0,0,0,0,6,5,0,0,2022-2023,0.0,2.727272727272727
1210,Gerrit Holtmann,PHI,"FW,MF",Bochum,Bundesliga,27,1995,10.5,14,7,6,7,1,12,21,57.1,9,15,1,14,2,16,4,0,0,2022-2023,0.19047619047619047,1.3333333333333333
1211,Martin Hongla,CMR,MF,Hellas Verona,Serie A,24,1998,5.8,8,5,4,4,0,5,5,100.0,0,7,1,6,6,14,9,0,0,2022-2023,1.0344827586206897,1.3793103448275863
1212,Martin Hongla,CMR,"DF,MF",Valladolid,La Liga,24,1998,14.5,18,13,13,5,0,11,21,52.4,10,15,12,3,8,26,46,1,0,2022-2023,0.5517241379310345,1.2413793103448276
1213,Franck Honorat,FRA,"FW,MF",Brest,Ligue 1,25,1996,28.2,41,29,20,8,13,19,34,55.9,15,22,2,20,21,62,18,0,0,2022-2023,0.7446808510638298,1.4539007092198581
1214,Jannes Horn,GER,"DF,FW",Bochum,Bundesliga,25,1997,0.7,2,1,1,1,0,1,1,100.0,0,1,0,1,3,5,2,0,0,2022-2023,4.285714285714286,2.857142857142857
1215,Cédric Hountondji,BEN,DF,Angers,Ligue 1,28,1994,34.4,50,36,31,17,2,19,29,65.5,10,44,22,22,59,109,132,1,0,2022-2023,1.7151162790697676,1.4534883720930234
1216,Ilyes Housni,FRA,FW,Paris S-G,Ligue 1,17,2005,0.1,1,1,1,0,0,1,1,100.0,0,0,0,0,0,1,0,0,0,2022-2023,0.0,10.0
1217,Lukáš Hrádecký,FIN,GK,Leverkusen,Bundesliga,32,1989,33.0,0,0,0,0,0,0,0,0.0,0,0,0,0,0,0,3,3,0,2022-2023,0.0,0.0
1218,Petko Hristov,BUL,DF,Spezia,Serie A,23,1999,4.1,6,4,2,4,0,5,8,62.5,3,4,2,2,4,10,12,0,0,2022-2023,0.9756097560975611,1.4634146341463417
1219,Ajdin Hrustic,AUS,MF,Hellas Verona,Serie A,26,1996,2.5,2,1,1,1,0,1,2,50.0,1,2,0,2,0,2,2,1,0,2022-2023,0.0,0.8
1220,Timo Hübers,GER,DF,Köln,Bundesliga,26,1996,28.4,43,28,35,8,0,24,52,46.2,28,27,13,14,58,101,153,0,0,2022-2023,2.0422535211267605,1.5140845070422535
1221,Callum Hudson-Odoi,ENG,"FW,MF",Leverkusen,Bundesliga,21,2000,6.7,5,3,4,0,1,1,1,100.0,0,0,0,0,2,7,4,0,0,2022-2023,0.29850746268656714,0.7462686567164178
1222,Will Hughes,ENG,MF,Crystal Palace,Premier League,27,1995,9.4,29,16,11,16,2,11,20,55.0,9,16,7,9,16,45,9,0,0,2022-2023,1.702127659574468,3.085106382978723
1223,Mats Hummels,GER,DF,Dortmund,Bundesliga,33,1988,22.4,62,34,38,22,2,32,55,58.2,23,30,16,14,33,95,100,1,0,2022-2023,1.4732142857142858,2.7678571428571432
1224,Adrien Hunou,FRA,"MF,FW",Angers,Ligue 1,28,1994,24.8,39,20,17,16,6,16,45,35.6,29,35,0,35,7,46,7,0,0,2022-2023,0.282258064516129,1.5725806451612903
1225,Denis Huseinbasic,BIH,"MF,FW",Köln,Bundesliga,21,2001,8.8,23,9,8,11,4,10,25,40.0,15,16,2,14,4,27,5,0,0,2022-2023,0.45454545454545453,2.6136363636363633
Rk,Player,Nation,Pos,Squad,Comp,0,0,90.0,0,0,3,3,3,Tkl,0,0.0,0,0,0,0,0,0,0,0,0,2022-2023,0.0,0.0
1226,Omari Hutchinson,ENG,FW,Chelsea,Premier League,18,2003,0.3,0,0,0,0,0,0,0,0.0,0,0,0,0,1,1,0,0,0,2022-2023,3.3333333333333335,0.0
1227,Elseid Hysaj,ALB,DF,Lazio,Serie A,28,1994,22.2,39,23,24,11,4,23,41,56.1,18,31,7,24,20,59,42,0,0,2022-2023,0.9009009009009009,1.7567567567567568
1228,Pierre Højbjerg,DEN,MF,Tottenham,Premier League,26,1995,34.8,56,30,28,22,6,26,67,38.8,41,46,17,29,49,105,64,1,0,2022-2023,1.4080459770114944,1.6091954022988506
1229,Rasmus Højlund,DEN,FW,Atalanta,Serie A,19,2003,20.4,4,3,0,2,2,1,6,16.7,5,9,1,8,1,5,5,0,0,2022-2023,0.04901960784313726,0.19607843137254904
1230,Iago,BRA,"DF,MF",Augsburg,Bundesliga,25,1997,17.8,34,16,20,10,4,11,29,37.9,18,18,5,13,17,51,53,0,0,2022-2023,0.9550561797752809,1.9101123595505618
1231,Pablo Ibáñez,ESP,MF,Osasuna,La Liga,23,1998,11.8,29,13,7,17,5,12,35,34.3,23,19,2,17,8,37,24,0,0,2022-2023,0.6779661016949152,2.4576271186440675
1232,Roger Ibanez,BRA,DF,Roma,Serie A,23,1998,31.1,67,33,38,26,3,32,48,66.7,16,30,11,19,66,133,95,2,0,2022-2023,2.122186495176849,2.1543408360128615
1233,Arijon Ibrahimović,GER,MF,Bayern Munich,Bundesliga,16,2005,0.2,1,1,1,0,0,0,0,0.0,0,0,0,0,0,1,0,0,0,2022-2023,0.0,5.0
1234,Zlatan Ibrahimović,SWE,FW,Milan,Serie A,40,1981,1.6,0,0,0,0,0,0,0,0.0,0,1,1,0,0,0,2,0,0,2022-2023,0.0,0.0
1235,Mounaim El Idrissy,FRA,FW,Ajaccio,Ligue 1,23,1999,27.7,32,19,5,20,7,10,36,27.8,26,22,0,22,13,45,20,0,0,2022-2023,0.4693140794223827,1.1552346570397112
1236,Antonio Iervolino,ITA,MF,Salernitana,Serie A,19,2003,0.1,0,0,0,0,0,0,1,0.0,1,0,0,0,0,0,0,0,0,2022-2023,0.0,0.0
1237,Iglesias,ESP,"DF,MF",Getafe,La Liga,24,1998,23.8,61,35,40,18,3,33,65,50.8,32,40,5,35,21,82,91,1,0,2022-2023,0.8823529411764706,2.5630252100840334
1238,Borja Iglesias,ESP,FW,Betis,La Liga,29,1993,26.3,8,4,3,3,2,2,13,15.4,11,9,1,8,1,9,17,0,0,2022-2023,0.03802281368821293,0.3041825095057034
1239,Igor,BRA,DF,Fiorentina,Serie A,24,1998,22.9,43,29,21,18,4,20,27,74.1,7,33,14,19,25,68,56,2,0,2022-2023,1.091703056768559,1.8777292576419216
1240,Kelechi Iheanacho,NGA,"FW,MF",Leicester City,Premier League,25,1996,12.5,7,2,0,3,4,3,10,30.0,7,9,1,8,0,7,8,0,0,2022-2023,0.0,0.56
1241,Jonathan Ikone,FRA,FW,Fiorentina,Serie A,24,1998,22.3,16,8,5,6,5,5,14,35.7,9,18,1,17,4,20,3,0,0,2022-2023,0.17937219730941703,0.7174887892376681
1242,Ivan Ilić,SRB,MF,Hellas Verona,Serie A,21,2001,9.5,16,10,9,7,0,6,11,54.5,5,10,1,9,8,24,14,0,0,2022-2023,0.8421052631578947,1.6842105263157894
1243,Ivan Ilić,SRB,MF,Torino,Serie A,21,2001,13.1,18,7,6,11,1,10,20,50.0,10,12,3,9,5,23,10,0,0,2022-2023,0.3816793893129771,1.3740458015267176
1244,Rareş Ilie,ROU,"MF,FW",Nice,Ligue 1,19,2003,1.6,3,3,0,1,2,2,4,50.0,2,2,0,2,1,4,1,0,0,2022-2023,0.625,1.875
1245,Samuel Iling-Junior,ENG,"DF,FW",Juventus,Serie A,18,2003,3.5,7,2,3,1,3,4,9,44.4,5,5,1,4,2,9,6,0,0,2022-2023,0.5714285714285714,2.0
1246,Emirhan İlkhan,TUR,MF,Torino,Serie A,18,2004,1.0,1,1,0,1,0,1,1,100.0,0,3,1,2,2,3,2,0,0,2022-2023,2.0,1.0
1247,Emirhan İlkhan,TUR,MF,Sampdoria,Serie A,18,2004,1.3,6,3,2,2,2,2,3,66.7,1,5,1,4,0,6,3,0,0,2022-2023,0.0,4.615384615384615
1248,Asier Illarramendi,ESP,MF,Real Sociedad,La Liga,32,1990,12.0,36,18,10,22,4,16,44,36.4,28,27,8,19,18,54,20,0,0,2022-2023,1.5,3.0
1249,Ciro Immobile,ITA,FW,Lazio,Serie A,32,1990,24.7,11,5,4,4,3,6,9,66.7,3,10,2,8,1,12,14,0,0,2022-2023,0.04048582995951417,0.4453441295546559
1250,Danny Ings,ENG,FW,West Ham,Premier League,30,1992,8.6,9,8,0,4,5,5,14,35.7,9,8,2,6,3,12,5,0,0,2022-2023,0.3488372093023256,1.0465116279069768
Rk,Player,Nation,Pos,Squad,Comp,0,0,90.0,0,0,3,3,3,Tkl,0,0.0,0,0,0,0,0,0,0,0,0,2022-2023,0.0,0.0
1251,Danny Ings,ENG,FW,Aston Villa,Premier League,30,1992,9.2,10,5,1,6,3,1,6,16.7,5,12,1,11,1,11,11,0,0,2022-2023,0.10869565217391305,1.0869565217391306
1252,Marcus Ingvartsen,DEN,"FW,MF",Mainz 05,Bundesliga,26,1996,14.6,4,1,0,2,2,1,10,10.0,9,9,1,8,4,8,10,0,0,2022-2023,0.273972602739726,0.273972602739726
1253,Bonke Innocent,NGA,MF,Lorient,Ligue 1,26,1996,13.1,28,17,13,14,1,11,36,30.6,25,22,5,17,26,54,31,0,0,2022-2023,1.984732824427481,2.1374045801526718
1254,Alexander Isak,SWE,FW,Newcastle Utd,Premier League,22,1999,16.9,18,8,4,7,7,10,28,35.7,18,21,2,19,4,22,8,0,0,2022-2023,0.2366863905325444,1.0650887573964498
1255,Alexander Isak,SWE,FW,Real Sociedad,La Liga,22,1999,1.7,1,1,0,0,1,0,0,0.0,0,0,0,0,0,1,2,0,0,2022-2023,0.0,0.5882352941176471
1256,Isco,ESP,"MF,FW",Sevilla,La Liga,30,1992,8.9,15,9,6,5,4,8,14,57.1,6,3,0,3,10,25,3,0,0,2022-2023,1.1235955056179774,1.6853932584269662
1257,Ismaily,BRA,DF,Lille,Ligue 1,32,1990,19.8,41,18,16,16,9,17,32,53.1,15,25,5,20,21,62,39,0,0,2022-2023,1.0606060606060606,2.0707070707070705
1258,Ardian Ismajli,ALB,DF,Empoli,Serie A,25,1996,23.3,40,32,25,15,0,18,24,75.0,6,47,31,16,27,67,120,0,0,2022-2023,1.1587982832618025,1.7167381974248928
1259,Ko Itakura,JPN,DF,Gladbach,Bundesliga,25,1997,22.0,29,17,18,7,4,16,30,53.3,14,41,25,16,27,56,95,0,0,2022-2023,1.2272727272727273,1.3181818181818181
1260,Hiroki Ito,JPN,DF,Stuttgart,Bundesliga,23,1999,28.5,40,29,24,14,2,18,35,51.4,17,38,17,21,40,80,94,0,0,2022-2023,1.4035087719298245,1.4035087719298245
1261,Junya Ito,JPN,FW,Reims,Ligue 1,29,1993,32.4,40,20,14,15,11,13,53,24.5,40,29,1,28,8,48,4,1,0,2022-2023,0.2469135802469136,1.234567901234568
1262,Diego Iturralde,ESP,DF,Sevilla,La Liga,19,2003,0.5,1,0,1,0,0,0,2,0.0,2,0,0,0,0,1,1,0,0,2022-2023,0.0,2.0
1263,Andreas Ivan,ROU,MF,Schalke 04,Bundesliga,27,1995,0.5,0,0,0,0,0,0,1,0.0,1,0,0,0,0,0,1,0,0,2022-2023,0.0,0.0
1264,Mihailo Ivanović,SRB,FW,Sampdoria,Serie A,17,2004,0.0,0,0,0,0,0,0,0,0.0,0,0,0,0,0,0,0,0,0,2022-2023,,
1265,Daniel Iversen,DEN,GK,Leicester City,Premier League,25,1997,12.0,0,0,0,0,0,0,0,0.0,0,0,0,0,0,0,6,1,0,2022-2023,0.0,0.0
1266,Alex Iwobi,NGA,"MF,FW",Everton,Premier League,26,1996,37.5,69,37,37,28,4,33,65,50.8,32,41,2,39,25,94,29,0,0,2022-2023,0.6666666666666666,1.84
1267,Armando Izzo,ITA,DF,Monza,Serie A,30,1992,27.4,73,50,44,27,2,29,45,64.4,16,29,17,12,50,123,87,1,0,2022-2023,1.8248175182481752,2.664233576642336
1268,Nicolas Jackson,SEN,FW,Villarreal,La Liga,21,2001,17.8,14,11,2,10,2,2,8,25.0,6,18,2,16,2,16,4,0,0,2022-2023,0.11235955056179775,0.7865168539325842
1269,Lee Jae-sung,KOR,MF,Mainz 05,Bundesliga,29,1992,21.0,38,17,9,21,8,16,36,44.4,20,29,5,24,17,55,21,0,0,2022-2023,0.8095238095238095,1.8095238095238095
1270,Paul Jaeckel,GER,DF,Union Berlin,Bundesliga,24,1998,13.3,24,18,11,11,2,17,35,48.6,18,11,5,6,19,43,44,1,0,2022-2023,1.4285714285714286,1.8045112781954886
1271,Mato Jajalo,BIH,MF,Udinese,Serie A,34,1988,0.7,0,0,0,0,0,0,1,0.0,1,0,0,0,0,0,2,0,0,2022-2023,0.0,0.0
1272,Kristijan Jakić,CRO,"DF,MF",Eint Frankfurt,Bundesliga,25,1997,16.2,33,21,19,12,2,22,41,53.7,19,32,10,22,14,47,49,1,0,2022-2023,0.8641975308641976,2.037037037037037
1273,Ismail Jakobs,SEN,"DF,FW",Monaco,Ligue 1,22,1999,12.4,11,5,7,3,1,5,12,41.7,7,9,1,8,9,20,18,0,0,2022-2023,0.7258064516129032,0.8870967741935484
1274,Marin Jakoliš,CRO,FW,Angers,Ligue 1,25,1996,0.3,1,1,0,0,1,0,0,0.0,0,0,0,0,0,1,0,0,0,2022-2023,0.0,3.3333333333333335
1275,Daniel James,WAL,FW,Leeds United,Premier League,24,1997,2.2,6,2,1,3,2,3,6,50.0,3,4,0,4,2,8,2,0,0,2022-2023,0.9090909090909091,2.727272727272727
Rk,Player,Nation,Pos,Squad,Comp,0,0,90.0,0,0,3,3,3,Tkl,0,0.0,0,0,0,0,0,0,0,0,0,2022-2023,0.0,0.0
1276,Daniel James,WAL,FW,Fulham,Premier League,24,1997,6.9,10,6,4,5,1,4,9,44.4,5,5,1,4,1,11,5,0,0,2022-2023,0.14492753623188406,1.4492753623188406
1277,Reece James,ENG,"DF,MF",Chelsea,Premier League,22,1999,13.8,31,20,10,18,3,15,19,78.9,4,17,2,15,12,43,23,0,0,2022-2023,0.8695652173913043,2.2463768115942027
1278,Vitaly Janelt,GER,"MF,DF",Brentford,Premier League,24,1998,24.5,54,27,20,24,10,21,49,42.9,28,29,9,20,29,83,26,0,0,2022-2023,1.183673469387755,2.204081632653061
1279,Saidy Janko,GAM,DF,Bochum,Bundesliga,26,1995,12.6,23,15,13,8,2,12,20,60.0,8,24,10,14,11,34,33,1,0,2022-2023,0.873015873015873,1.8253968253968254
1280,Pontus Jansson,SWE,DF,Brentford,Premier League,31,1991,8.0,5,3,4,1,0,3,5,60.0,2,13,9,4,9,14,38,0,0,2022-2023,1.125,0.625
1281,Tony Jantschke,GER,"DF,MF",Gladbach,Bundesliga,32,1990,1.1,2,1,1,1,0,1,1,100.0,0,5,3,2,0,2,5,0,0,2022-2023,0.0,1.8181818181818181
1282,Adnan Januzaj,BEL,FW,Sevilla,La Liga,27,1995,0.5,0,0,0,0,0,0,1,0.0,1,0,0,0,1,1,0,0,0,2022-2023,2.0,0.0
1283,Léo Jardim,BRA,GK,Lille,Ligue 1,27,1995,6.0,0,0,0,0,0,0,1,0.0,1,0,0,0,0,0,0,1,0,2022-2023,0.0,0.0
1284,Luis Javier Suárez,COL,FW,Almería,La Liga,24,1997,16.6,17,11,5,6,6,6,26,23.1,20,13,3,10,3,20,10,0,0,2022-2023,0.18072289156626503,1.0240963855421685
1285,Luis Javier Suárez,COL,FW,Marseille,Ligue 1,24,1997,3.3,4,1,1,2,1,1,4,25.0,3,1,0,1,3,7,6,0,0,2022-2023,0.9090909090909092,1.2121212121212122
1286,Dany Jean,HAI,"DF,MF",Strasbourg,Ligue 1,19,2002,0.1,0,0,0,0,0,0,1,0.0,1,1,0,1,0,0,0,0,0,2022-2023,0.0,0.0
1287,Julian Jeanvier,GUI,DF,Auxerre,Ligue 1,30,1992,19.6,32,17,24,8,0,13,22,59.1,9,24,17,7,27,59,96,1,0,2022-2023,1.3775510204081631,1.6326530612244896
1288,Jeffinho,BRA,FW,Lyon,Ligue 1,22,1999,5.0,17,4,4,9,4,6,15,40.0,9,6,0,6,1,18,0,0,0,2022-2023,0.2,3.4
1289,Fredrik Jensen,FIN,"FW,MF",Augsburg,Bundesliga,24,1997,10.3,15,10,8,3,4,5,10,50.0,5,12,5,7,4,19,12,0,0,2022-2023,0.3883495145631068,1.4563106796116503
1290,Mathias Jensen,DEN,MF,Brentford,Premier League,26,1996,31.1,71,36,29,30,12,34,97,35.1,63,54,5,49,32,103,24,1,0,2022-2023,1.0289389067524115,2.282958199356913
1291,Moritz Jenz,GER,DF,Schalke 04,Bundesliga,23,1999,10.5,14,11,8,5,1,5,8,62.5,3,16,10,6,8,22,53,1,0,2022-2023,0.7619047619047619,1.3333333333333333
1292,Jesé,ESP,FW,Sampdoria,Serie A,29,1993,2.3,2,0,0,2,0,0,1,0.0,1,3,1,2,1,3,2,0,0,2022-2023,0.4347826086956522,0.8695652173913044
1293,Gabriel Jesus,BRA,FW,Arsenal,Premier League,25,1997,22.9,33,25,16,8,9,15,31,48.4,16,27,3,24,11,44,15,1,0,2022-2023,0.48034934497816595,1.4410480349344978
1294,Juan Jesus,BRA,DF,Napoli,Serie A,31,1991,10.4,16,11,9,6,1,9,12,75.0,3,18,11,7,10,26,29,0,0,2022-2023,0.9615384615384615,1.5384615384615383
1295,Raúl Jiménez,MEX,FW,Wolves,Premier League,31,1991,9.4,9,6,3,5,1,3,6,50.0,3,9,0,9,0,9,8,0,0,2022-2023,0.0,0.9574468085106382
1296,Joaquín,ESP,"MF,FW",Betis,La Liga,41,1981,5.5,3,3,2,1,0,1,3,33.3,2,7,2,5,4,7,5,0,0,2022-2023,0.7272727272727273,0.5454545454545454
1297,Joelinton,BRA,"MF,FW",Newcastle Utd,Premier League,25,1996,29.6,70,49,36,26,8,26,62,41.9,36,52,7,45,48,118,39,0,0,2022-2023,1.6216216216216215,2.364864864864865
1298,Þórir Jóhann Helgason,ISL,MF,Lecce,Serie A,21,2000,2.5,2,2,1,0,1,2,3,66.7,1,3,1,2,3,5,3,0,0,2022-2023,1.2,0.8
1299,Ben Johnson,ENG,DF,West Ham,Premier League,22,2000,9.6,20,14,12,4,4,12,18,66.7,6,12,4,8,9,29,28,1,0,2022-2023,0.9375,2.0833333333333335
1300,Brennan Johnson,WAL,"FW,MF",Nott'ham Forest,Premier League,21,2001,32.6,34,20,18,8,8,8,29,27.6,21,30,1,29,5,39,7,1,0,2022-2023,0.15337423312883436,1.0429447852760736
Rk,Player,Nation,Pos,Squad,Comp,0,0,90.0,0,0,3,3,3,Tkl,0,0.0,0,0,0,0,0,0,0,0,0,2022-2023,0.0,0.0
1301,Sam Johnstone,ENG,GK,Crystal Palace,Premier League,29,1993,9.0,0,0,0,0,0,0,0,0.0,0,0,0,0,0,0,5,0,0,2022-2023,0.0,0.0
1302,Paul Joly,FRA,DF,Auxerre,Ligue 1,22,2000,9.6,33,21,21,10,2,19,35,54.3,16,13,2,11,24,57,29,2,0,2022-2023,2.5,3.4375
1303,Curtis Jones,ENG,MF,Liverpool,Premier League,21,2001,11.5,34,17,8,12,14,18,31,58.1,13,12,2,10,3,37,9,0,0,2022-2023,0.2608695652173913,2.9565217391304346
1304,Frenkie de Jong,NED,MF,Barcelona,La Liga,25,1997,28.2,46,26,16,21,9,17,41,41.5,24,11,1,10,35,81,22,1,0,2022-2023,1.2411347517730498,1.6312056737588654
1305,Joan Jordán,ESP,MF,Sevilla,La Liga,28,1994,17.7,32,17,13,17,2,16,38,42.1,22,14,7,7,16,48,14,2,0,2022-2023,0.903954802259887,1.807909604519774
1306,Jorginho,ITA,MF,Arsenal,Premier League,30,1991,9.5,18,13,6,10,2,5,24,20.8,19,7,2,5,9,27,8,0,0,2022-2023,0.9473684210526315,1.894736842105263
1307,Jorginho,ITA,MF,Chelsea,Premier League,30,1991,14.2,42,23,22,14,6,22,46,47.8,24,18,3,15,21,63,7,0,0,2022-2023,1.4788732394366197,2.9577464788732395
1308,Josan,ESP,"DF,MF",Elche,La Liga,32,1989,12.0,25,20,20,5,0,14,27,51.9,13,8,0,8,7,32,15,1,0,2022-2023,0.5833333333333334,2.0833333333333335
1309,Willian José,BRA,FW,Betis,La Liga,30,1991,8.1,9,6,6,3,0,4,9,44.4,5,4,0,4,1,10,15,0,0,2022-2023,0.1234567901234568,1.1111111111111112
1310,Joselu,ESP,FW,Espanyol,La Liga,32,1990,33.2,13,11,3,4,6,4,17,23.5,13,25,4,21,8,21,43,0,0,2022-2023,0.24096385542168672,0.39156626506024095
1311,Mateo Joseph,ESP,"FW,MF",Leeds United,Premier League,18,2003,0.3,0,0,0,0,0,0,0,0.0,0,1,0,1,0,0,1,0,0,2022-2023,0.0,0.0
1312,Diogo Jota,POR,FW,Liverpool,Premier League,25,1996,12.6,23,15,8,8,7,12,37,32.4,25,5,0,5,3,26,11,0,0,2022-2023,0.2380952380952381,1.8253968253968254
1313,Stevan Jovetić,MNE,"FW,MF",Hertha BSC,Bundesliga,32,1989,9.9,3,2,2,1,0,1,11,9.1,10,2,1,1,2,5,10,0,0,2022-2023,0.20202020202020202,0.30303030303030304
1314,Luka Jović,SRB,"FW,MF",Fiorentina,Serie A,24,1997,17.0,6,3,1,4,1,2,8,25.0,6,7,2,5,2,8,10,0,0,2022-2023,0.11764705882352941,0.35294117647058826
1315,Juanmi,ESP,FW,Betis,La Liga,29,1993,10.3,14,10,4,7,3,7,31,22.6,24,10,0,10,4,18,4,0,0,2022-2023,0.3883495145631068,1.3592233009708736
1316,Juanpe,ESP,DF,Girona,La Liga,31,1991,15.8,19,11,10,9,0,11,17,64.7,6,12,9,3,10,29,60,1,0,2022-2023,0.6329113924050632,1.2025316455696202
1317,Jubal,BRA,DF,Auxerre,Ligue 1,28,1993,35.7,41,26,29,11,1,19,38,50.0,19,57,34,23,53,94,193,0,0,2022-2023,1.4845938375350138,1.1484593837535013
1318,Christopher Jullien,FRA,DF,Montpellier,Ligue 1,29,1993,29.9,46,28,29,14,3,28,51,54.9,23,35,18,17,43,89,114,1,0,2022-2023,1.4381270903010035,1.5384615384615385
1319,Anthony Jung,GER,"DF,FW",Werder Bremen,Bundesliga,30,1991,29.1,46,27,19,20,7,31,58,53.4,27,30,6,24,22,68,63,0,0,2022-2023,0.7560137457044673,1.5807560137457044
1320,Eli Junior Kroupi,FRA,"FW,MF",Lorient,Ligue 1,16,2006,0.1,0,0,0,0,0,0,1,0.0,1,0,0,0,1,1,0,0,0,2022-2023,10.0,0.0
1321,Lago Junior,CIV,"FW,MF",Mallorca,La Liga,31,1990,0.6,1,0,0,1,0,1,1,100.0,0,0,0,0,0,1,0,0,0,2022-2023,0.0,1.6666666666666667
1322,Hamed Junior Traorè,CIV,"FW,MF",Bournemouth,Premier League,22,2000,4.7,17,11,5,9,3,6,18,33.3,12,9,0,9,2,19,1,0,0,2022-2023,0.425531914893617,3.6170212765957444
1323,Hamed Junior Traorè,CIV,"MF,FW",Sassuolo,Serie A,22,2000,6.6,11,6,4,6,1,4,11,36.4,7,4,0,4,2,13,0,1,0,2022-2023,0.30303030303030304,1.6666666666666667
1324,Vinicius Júnior,BRA,FW,Real Madrid,La Liga,22,2000,31.4,30,21,10,12,8,14,39,35.9,25,24,1,23,6,36,1,0,0,2022-2023,0.1910828025477707,0.9554140127388535
1325,Josip Juranović,CRO,DF,Union Berlin,Bundesliga,26,1995,10.4,9,7,5,2,2,7,18,38.9,11,9,3,6,6,15,22,1,0,2022-2023,0.5769230769230769,0.8653846153846153
Rk,Player,Nation,Pos,Squad,Comp,0,0,90.0,0,0,3,3,3,Tkl,0,0.0,0,0,0,0,0,0,0,0,0,2022-2023,0.0,0.0
1326,James Justin,ENG,DF,Leicester City,Premier League,24,1998,13.9,20,18,7,12,1,9,18,50.0,9,24,6,18,15,35,47,0,0,2022-2023,1.079136690647482,1.4388489208633093
1327,Filip Jørgensen,DEN,GK,Villarreal,La Liga,20,2002,2.0,0,0,0,0,0,0,1,0.0,1,0,0,0,0,0,0,0,0,2022-2023,0.0,0.0
1328,Mathias Jørgensen,DEN,DF,Brentford,Premier League,32,1990,12.3,17,8,9,8,0,9,21,42.9,12,19,12,7,16,33,39,1,0,2022-2023,1.3008130081300813,1.3821138211382114
1329,Ozan Kabak,TUR,DF,Hoffenheim,Bundesliga,22,2000,26.5,51,34,27,21,3,17,30,56.7,13,35,23,12,45,96,83,0,0,2022-2023,1.6981132075471699,1.9245283018867925
1330,Issa Kaboré,BFA,DF,Marseille,Ligue 1,21,2001,11.4,33,19,10,18,5,21,32,65.6,11,11,1,10,12,45,21,1,0,2022-2023,1.0526315789473684,2.8947368421052633
1331,Abdoul Kader Bamba,FRA,"FW,MF",Nantes,Ligue 1,28,1994,0.9,0,0,0,0,0,0,2,0.0,2,3,1,2,0,0,1,0,0,2022-2023,0.0,0.0
1332,Pavel Kadeřábek,CZE,DF,Hoffenheim,Bundesliga,30,1992,18.5,26,20,10,9,7,15,23,65.2,8,12,2,10,14,40,37,1,0,2022-2023,0.7567567567567568,1.4054054054054055
1333,Tino Kadewere,ZIM,"FW,MF",Mallorca,La Liga,26,1996,6.0,6,3,3,3,0,4,9,44.4,5,6,2,4,2,8,1,0,0,2022-2023,0.3333333333333333,1.0
1334,Kaiky,BRA,DF,Almería,La Liga,18,2004,6.5,5,5,5,0,0,3,7,42.9,4,18,10,8,11,16,28,0,0,2022-2023,1.6923076923076923,0.7692307692307693
1335,Florian Kainz,AUT,"MF,FW",Köln,Bundesliga,29,1992,26.0,21,10,7,12,2,8,26,30.8,18,27,6,21,32,53,30,1,0,2022-2023,1.2307692307692308,0.8076923076923077
1336,Gaël Kakuta,COD,FW,Lens,Ligue 1,31,1991,0.2,0,0,0,0,0,0,0,0.0,0,0,0,0,0,0,1,0,0,2022-2023,0.0,0.0
1337,Sasa Kalajdzic,AUT,FW,Wolves,Premier League,25,1997,0.5,0,0,0,0,0,0,0,0.0,0,0,0,0,1,1,0,0,0,2022-2023,2.0,0.0
1338,Sasa Kalajdzic,AUT,FW,Stuttgart,Bundesliga,25,1997,2.6,3,2,0,1,2,1,3,33.3,2,1,0,1,0,3,0,0,0,2022-2023,0.0,1.1538461538461537
1339,Arnaud Kalimuendo,FRA,FW,Rennes,Ligue 1,20,2002,20.5,15,8,3,6,6,5,20,25.0,15,15,2,13,2,17,9,0,0,2022-2023,0.0975609756097561,0.7317073170731707
1340,Yayah Kallon,SLE,"MF,FW",Hellas Verona,Serie A,21,2001,9.6,14,10,5,4,5,7,12,58.3,5,10,0,10,8,22,5,0,0,2022-2023,0.8333333333333334,1.4583333333333335
1341,Gedeon Kalulu,COD,DF,Lorient,Ligue 1,24,1997,27.1,64,34,43,14,7,30,48,62.5,18,32,3,29,28,92,79,2,0,2022-2023,1.033210332103321,2.3616236162361623
1342,Pierre Kalulu,FRA,DF,Milan,Serie A,22,2000,28.3,57,39,33,21,3,28,42,66.7,14,41,17,24,41,98,56,1,0,2022-2023,1.448763250883392,2.0141342756183747
1343,Justin-Noël Kalumba,FRA,DF,Angers,Ligue 1,17,2004,6.1,9,5,5,2,2,5,16,31.3,11,4,1,3,4,13,5,0,0,2022-2023,0.6557377049180328,1.4754098360655739
1344,Daichi Kamada,JPN,MF,Eint Frankfurt,Bundesliga,25,1996,25.2,51,31,10,37,4,31,57,54.4,26,31,2,29,16,67,17,1,0,2022-2023,0.6349206349206349,2.0238095238095237
1345,Waren Kamanzi,NOR,DF,Toulouse,Ligue 1,21,2000,7.4,16,9,9,5,2,13,19,68.4,6,8,2,6,8,24,9,0,0,2022-2023,1.081081081081081,2.162162162162162
1346,Bingourou Kamara,SEN,GK,Montpellier,Ligue 1,25,1996,4.5,0,0,0,0,0,0,0,0.0,0,0,0,0,0,0,2,0,0,2022-2023,0.0,0.0
1347,Boubacar Kamara,FRA,MF,Aston Villa,Premier League,22,1999,19.7,58,25,25,23,10,27,56,48.2,29,38,12,26,19,77,24,3,0,2022-2023,0.9644670050761421,2.9441624365482233
1348,Jakub Kamiński,POL,"FW,DF",Wolfsburg,Bundesliga,20,2002,22.9,36,25,15,13,8,20,40,50.0,20,37,2,35,8,44,15,0,0,2022-2023,0.3493449781659389,1.572052401746725
1349,Marcin Kamiński,POL,DF,Schalke 04,Bundesliga,30,1992,7.0,6,4,4,0,2,2,4,50.0,2,8,7,1,9,15,28,0,0,2022-2023,1.2857142857142858,0.8571428571428571
1350,Kevin Kampl,SVN,MF,RB Leipzig,Bundesliga,31,1990,15.2,21,11,6,14,1,6,27,22.2,21,26,9,17,22,43,11,0,0,2022-2023,1.4473684210526316,1.381578947368421
Rk,Player,Nation,Pos,Squad,Comp,0,0,90.0,0,0,3,3,3,Tkl,0,0.0,0,0,0,0,0,0,0,0,0,2022-2023,0.0,0.0
1351,Nordine Kandil,FRA,"MF,FW",Strasbourg,Ligue 1,20,2001,1.1,3,2,1,2,0,0,3,0.0,3,2,0,2,1,4,1,0,0,2022-2023,0.9090909090909091,2.727272727272727
1352,Harry Kane,ENG,FW,Tottenham,Premier League,29,1993,37.8,15,12,1,6,8,7,21,33.3,14,27,7,20,2,17,18,0,0,2022-2023,0.052910052910052914,0.39682539682539686
1353,Lee Kang-in,KOR,"MF,FW",Mallorca,La Liga,21,2001,31.4,42,24,10,22,10,18,61,29.5,43,25,2,23,11,53,7,0,0,2022-2023,0.35031847133757965,1.337579617834395
1354,Wilfried Kanga,CIV,FW,Hertha BSC,Bundesliga,24,1998,15.7,5,4,2,1,2,2,4,50.0,2,14,3,11,2,7,13,0,0,2022-2023,0.12738853503184713,0.3184713375796179
1355,N'Golo Kanté,FRA,MF,Chelsea,Premier League,31,1991,5.8,16,10,4,10,2,4,8,50.0,4,11,0,11,6,22,2,0,0,2022-2023,1.0344827586206897,2.7586206896551726
1356,Kenan Karaman,TUR,FW,Schalke 04,Bundesliga,28,1994,10.8,11,8,3,5,3,3,12,25.0,9,9,1,8,3,14,9,0,0,2022-2023,0.27777777777777773,1.0185185185185184
1357,Yann Karamoh,FRA,"MF,FW",Torino,Serie A,24,1998,8.0,5,2,3,2,0,1,5,20.0,4,5,0,5,0,5,2,1,0,2022-2023,0.0,0.625
1358,Atakan Karazor,GER,MF,Stuttgart,Bundesliga,25,1996,21.8,49,30,18,25,6,24,47,51.1,23,39,11,28,31,80,44,0,0,2022-2023,1.4220183486238531,2.2477064220183487
1359,Ayman Kari,FRA,"MF,DF",Lorient,Ligue 1,17,2004,1.1,0,0,0,0,0,0,0,0.0,0,4,0,4,3,3,0,0,0,2022-2023,2.727272727272727,0.0
1360,Jon Karrikaburu,ESP,FW,Real Sociedad,La Liga,19,2002,1.0,1,0,0,1,0,0,0,0.0,0,2,0,2,0,1,0,0,0,2022-2023,0.0,1.0
1361,Rick Karsdorp,NED,DF,Roma,Serie A,27,1995,7.9,21,13,11,7,3,13,22,59.1,9,0,0,0,7,28,15,1,0,2022-2023,0.8860759493670886,2.6582278481012658
1362,Denso Kasius,NED,DF,Bologna,Serie A,19,2002,3.8,12,6,7,4,1,8,10,80.0,2,6,3,3,3,15,6,0,0,2022-2023,0.7894736842105263,3.1578947368421053
1363,Thomas Kastanaras,GRE,"FW,DF",Stuttgart,Bundesliga,19,2003,0.8,0,0,0,0,0,0,0,0.0,0,1,0,1,0,0,0,0,0,2022-2023,0.0,0.0
1364,Grigoris Kastanos,CYP,"MF,DF",Salernitana,Serie A,24,1998,14.3,39,23,18,19,2,16,40,40.0,24,20,6,14,8,47,8,0,0,2022-2023,0.5594405594405594,2.727272727272727
1365,Silas Katompa,COD,"FW,MF",Stuttgart,Bundesliga,23,1998,22.1,25,17,5,14,6,6,20,30.0,14,17,2,15,8,33,1,0,0,2022-2023,0.36199095022624433,1.1312217194570136
1366,Moise Kean,ITA,FW,Juventus,Serie A,22,2000,11.1,8,6,2,5,1,3,7,42.9,4,4,0,4,5,13,2,0,0,2022-2023,0.45045045045045046,0.7207207207207208
1367,Michael Keane,ENG,DF,Everton,Premier League,29,1993,10.9,7,4,5,2,0,5,8,62.5,3,12,7,5,14,21,55,1,0,2022-2023,1.2844036697247705,0.6422018348623852
1368,Neeskens Kebano,COD,FW,Fulham,Premier League,30,1992,8.5,17,9,8,6,3,9,18,50.0,9,14,0,14,1,18,8,0,0,2022-2023,0.11764705882352941,2.0
1369,Kévin Keben Biakolo,CMR,DF,Toulouse,Ligue 1,18,2004,4.0,3,2,2,0,1,0,4,0.0,4,1,0,1,5,8,9,0,0,2022-2023,1.25,0.75
1370,Thilo Kehrer,GER,DF,West Ham,Premier League,25,1996,24.8,43,24,25,14,4,21,45,46.7,24,16,6,10,34,77,76,1,0,2022-2023,1.3709677419354838,1.7338709677419355
1371,Check Keita,FRA,DF,Reims,Ligue 1,19,2003,7.6,12,9,9,3,0,4,9,44.4,5,6,5,1,5,17,24,1,0,2022-2023,0.6578947368421053,1.5789473684210527
1372,Naby Keïta,GUI,MF,Liverpool,Premier League,27,1995,3.3,5,4,2,3,0,1,4,25.0,3,1,0,1,2,7,3,0,0,2022-2023,0.6060606060606061,1.5151515151515151
1373,Yannik Keitel,GER,MF,Freiburg,Bundesliga,22,2000,7.6,11,7,4,6,1,3,5,60.0,2,6,3,3,13,24,8,0,0,2022-2023,1.7105263157894737,1.4473684210526316
1374,Caoimhín Kelleher,IRL,GK,Liverpool,Premier League,23,1998,1.0,0,0,0,0,0,0,0,0.0,0,0,0,0,0,0,0,0,0,2022-2023,0.0,0.0
1375,Lloyd Kelly,ENG,DF,Bournemouth,Premier League,23,1998,22.7,33,18,23,9,1,13,19,68.4,6,26,15,11,26,59,101,1,0,2022-2023,1.145374449339207,1.4537444933920705
Rk,Player,Nation,Pos,Squad,Comp,0,0,90.0,0,0,3,3,3,Tkl,0,0.0,0,0,0,0,0,0,0,0,0,2022-2023,0.0,0.0
1376,Marc-Oliver Kempf,GER,DF,Hertha BSC,Bundesliga,27,1995,30.1,44,27,29,14,1,16,22,72.7,6,42,32,10,51,95,143,0,0,2022-2023,1.6943521594684385,1.4617940199335548
1377,Kenedy,BRA,"FW,DF",Valladolid,La Liga,26,1996,3.1,6,2,3,3,0,2,4,50.0,2,2,0,2,1,7,0,0,0,2022-2023,0.3225806451612903,1.9354838709677418
1378,Jonjoe Kenny,ENG,DF,Hertha BSC,Bundesliga,25,1997,24.9,46,34,27,16,3,24,42,57.1,18,38,9,29,46,92,74,0,0,2022-2023,1.8473895582329318,1.8473895582329318
1379,Franck Kessié,CIV,MF,Barcelona,La Liga,25,1996,11.0,15,9,6,6,3,8,18,44.4,10,10,2,8,12,27,11,2,0,2022-2023,1.0909090909090908,1.3636363636363635
1380,Saîf-Eddine Khaoui,TUN,MF,Clermont Foot,Ligue 1,27,1995,22.5,47,28,14,25,8,15,47,31.9,32,17,2,15,33,80,8,0,0,2022-2023,1.4666666666666666,2.088888888888889
1381,Wahbi Khazri,TUN,"FW,MF",Montpellier,Ligue 1,31,1991,18.2,26,13,13,7,6,6,25,24.0,19,17,1,16,9,35,20,0,0,2022-2023,0.4945054945054945,1.4285714285714286
1382,Rani Khedira,GER,MF,Union Berlin,Bundesliga,28,1994,32.0,60,33,21,32,7,25,50,50.0,25,33,10,23,40,100,33,0,0,2022-2023,1.25,1.875
1383,Anthony Khelifa,FRA,DF,Ajaccio,Ligue 1,16,2005,0.1,0,0,0,0,0,0,0,0.0,0,0,0,0,0,0,0,0,0,2022-2023,0.0,0.0
1384,Kiké,ESP,FW,Osasuna,La Liga,32,1989,11.3,6,3,0,4,2,2,5,40.0,3,6,1,5,1,7,13,0,0,2022-2023,0.08849557522123894,0.5309734513274336
1385,Luca Kilian,GER,DF,Köln,Bundesliga,22,1999,12.5,22,16,14,7,1,12,21,57.1,9,16,8,8,11,33,48,0,0,2022-2023,0.88,1.76
1386,Max Kilman,ENG,DF,Wolves,Premier League,25,1997,36.7,36,20,26,9,1,16,30,53.3,14,70,42,28,19,55,164,1,0,2022-2023,0.5177111716621253,0.9809264305177111
1387,Joshua Kimmich,GER,MF,Bayern Munich,Bundesliga,27,1995,31.2,78,49,24,46,8,38,72,52.8,34,36,7,29,41,119,39,2,0,2022-2023,1.314102564102564,2.5
1388,Presnel Kimpembe,FRA,DF,Paris S-G,Ligue 1,26,1995,8.1,17,8,9,6,2,9,13,69.2,4,12,7,5,13,30,9,1,0,2022-2023,1.6049382716049383,2.0987654320987654
1389,Jakub Kiwior,POL,DF,Arsenal,Premier League,22,2000,4.7,7,5,6,1,0,5,8,62.5,3,5,3,2,6,13,10,0,0,2022-2023,1.276595744680851,1.4893617021276595
1390,Jakub Kiwior,POL,DF,Spezia,Serie A,22,2000,16.0,22,17,15,7,0,6,24,25.0,18,26,18,8,24,46,71,1,0,2022-2023,1.5,1.375
1391,Simon Kjær,DEN,DF,Milan,Serie A,33,1989,11.2,15,8,9,6,0,7,11,63.6,4,14,11,3,9,24,35,1,0,2022-2023,0.8035714285714286,1.3392857142857144
1392,Pascal Klemens,GER,DF,Hertha BSC,Bundesliga,17,2005,1.0,0,0,0,0,0,0,1,0.0,1,1,0,1,1,1,3,0,0,2022-2023,1.0,0.0
1393,Mateusz Klich,POL,"MF,FW",Leeds United,Premier League,32,1990,3.1,12,8,3,4,5,7,13,53.8,6,4,0,4,0,12,1,0,0,2022-2023,0.0,3.8709677419354835
1394,Lukas Klostermann,GER,DF,RB Leipzig,Bundesliga,26,1996,10.1,16,8,7,9,0,8,15,53.3,7,6,3,3,13,29,31,0,0,2022-2023,1.2871287128712872,1.5841584158415842
1395,Justin Kluivert,NED,"FW,MF",Valencia,La Liga,23,1999,16.1,17,14,7,4,6,6,12,50.0,6,4,0,4,7,24,4,0,0,2022-2023,0.43478260869565216,1.0559006211180124
1396,Ansgar Knauff,GER,DF,Eint Frankfurt,Bundesliga,20,2002,14.3,36,25,22,11,3,15,34,44.1,19,19,1,18,15,51,26,0,0,2022-2023,1.048951048951049,2.5174825174825175
1397,Robin Knoche,GER,DF,Union Berlin,Bundesliga,30,1992,31.9,45,29,29,12,4,24,47,51.1,23,35,18,17,38,83,140,0,0,2022-2023,1.1912225705329154,1.4106583072100314
1398,Gregor Kobel,SUI,GK,Dortmund,Bundesliga,24,1997,27.0,0,0,0,0,0,0,1,0.0,1,1,0,1,0,0,7,2,0,2022-2023,0.0,0.0
1399,Robin Koch,GER,DF,Leeds United,Premier League,26,1996,35.3,53,30,32,16,5,24,56,42.9,32,44,21,23,43,96,152,1,0,2022-2023,1.218130311614731,1.501416430594901
1400,Samuel Koeberlé,FRA,MF,Reims,Ligue 1,17,2004,0.0,0,0,0,0,0,0,0,0.0,0,0,0,0,0,0,0,0,0,2022-2023,,
Rk,Player,Nation,Pos,Squad,Comp,0,0,90.0,0,0,3,3,3,Tkl,0,0.0,0,0,0,0,0,0,0,0,0,2022-2023,0.0,0.0
1401,Rudy Kohon,FRA,DF,Troyes,Ligue 1,18,2004,0.7,4,3,4,0,0,2,2,100.0,0,1,0,1,1,5,2,0,0,2022-2023,1.4285714285714286,5.714285714285714
1402,Dominik Kohr,GER,MF,Mainz 05,Bundesliga,28,1994,25.5,59,33,23,31,5,29,61,47.5,32,46,9,37,34,93,26,1,0,2022-2023,1.3333333333333333,2.3137254901960786
1403,Koke,ESP,MF,Atlético Madrid,La Liga,30,1992,28.3,55,38,23,25,7,28,72,38.9,44,35,13,22,20,75,19,0,0,2022-2023,0.7067137809187279,1.9434628975265018
1404,Sead Kolašinac,BIH,DF,Marseille,Ligue 1,29,1993,24.6,52,36,24,22,6,24,37,64.9,13,19,2,17,43,95,35,1,0,2022-2023,1.7479674796747966,2.113821138211382
1405,Luca Koleosho,ITA,"FW,DF",Espanyol,La Liga,17,2004,0.7,2,2,0,0,2,1,2,50.0,1,1,0,1,0,2,0,0,0,2022-2023,0.0,2.857142857142857
1406,Randal Kolo Muani,FRA,FW,Eint Frankfurt,Bundesliga,23,1998,29.2,14,10,3,3,8,1,9,11.1,8,19,2,17,3,17,13,0,0,2022-2023,0.10273972602739727,0.4794520547945206
1407,Timothée Kolodziejczak,FRA,DF,Schalke 04,Bundesliga,30,1991,0.3,0,0,0,0,0,0,1,0.0,1,0,0,0,1,1,1,0,0,2022-2023,3.3333333333333335,0.0
1408,Cheick Konaté,MLI,DF,Clermont Foot,Ligue 1,18,2004,6.4,19,12,10,7,2,13,22,59.1,9,7,1,6,13,32,8,1,0,2022-2023,2.03125,2.96875
1409,Ibrahima Konaté,FRA,DF,Liverpool,Premier League,23,1999,17.2,38,26,25,13,0,16,27,59.3,11,12,5,7,26,64,61,4,0,2022-2023,1.5116279069767442,2.2093023255813953
1410,Geoffrey Kondogbia,CTA,MF,Atlético Madrid,La Liga,29,1993,11.2,40,23,19,20,1,17,25,68.0,8,9,1,8,26,66,12,1,0,2022-2023,2.3214285714285716,3.5714285714285716
1411,Ibrahima Koné,MLI,FW,Lorient,Ligue 1,23,1999,17.5,24,13,3,13,8,5,11,45.5,6,13,0,13,4,28,18,0,0,2022-2023,0.22857142857142856,1.3714285714285714
1412,Manu Koné,FRA,MF,Gladbach,Bundesliga,21,2001,29.0,74,39,37,33,4,24,47,51.1,23,44,12,32,32,106,21,0,0,2022-2023,1.103448275862069,2.5517241379310347
1413,Youssouf Koné,MLI,DF,Ajaccio,Ligue 1,27,1995,10.2,28,19,24,4,0,18,25,72.0,7,9,2,7,12,40,32,1,0,2022-2023,1.1764705882352942,2.7450980392156863
1414,Ezri Konsa,ENG,DF,Aston Villa,Premier League,24,1997,36.9,42,20,25,15,2,18,26,69.2,8,41,23,18,26,68,120,3,0,2022-2023,0.7046070460704608,1.1382113821138211
1415,Teun Koopmeiners,NED,MF,Atalanta,Serie A,24,1998,31.8,46,26,15,24,7,28,55,50.9,27,41,5,36,19,65,36,2,0,2022-2023,0.5974842767295597,1.4465408805031446
1416,Odilon Kossonou,CIV,DF,Leverkusen,Bundesliga,21,2001,16.9,21,14,12,7,2,8,16,50.0,8,26,11,15,24,45,58,1,0,2022-2023,1.4201183431952664,1.2426035502958581
1417,Filip Kostić,SRB,"DF,FW",Juventus,Serie A,29,1992,28.5,41,26,17,20,4,21,47,44.7,26,30,4,26,16,57,32,0,0,2022-2023,0.5614035087719298,1.4385964912280702
1418,Filip Kostić,SRB,"DF,MF",Eint Frankfurt,Bundesliga,29,1992,0.8,2,0,1,1,0,0,0,0.0,0,0,0,0,1,3,0,0,0,2022-2023,1.25,2.5
1419,Christian Kouamé,CIV,FW,Fiorentina,Serie A,24,1997,20.7,27,18,8,10,9,7,14,50.0,7,15,3,12,12,39,8,0,0,2022-2023,0.5797101449275363,1.3043478260869565
1420,Rominigue Kouamé,MLI,MF,Troyes,Ligue 1,25,1996,29.6,44,27,28,14,2,17,41,41.5,24,32,11,21,49,93,46,1,0,2022-2023,1.6554054054054053,1.4864864864864864
1421,Tomáš Koubek,CZE,GK,Augsburg,Bundesliga,29,1992,11.0,0,0,0,0,0,0,0,0.0,0,0,0,0,0,0,7,0,0,2022-2023,0.0,0.0
1422,Kalidou Koulibaly,SEN,DF,Chelsea,Premier League,31,1991,20.0,45,31,34,8,3,26,40,65.0,14,30,13,17,29,74,77,0,0,2022-2023,1.45,2.25
1423,Jules Koundé,FRA,DF,Barcelona,La Liga,23,1998,27.0,37,23,18,13,6,21,31,67.7,10,24,9,15,19,56,61,3,0,2022-2023,0.7037037037037037,1.3703703703703705
1424,Boubakar Kouyaté,MLI,DF,Montpellier,Ligue 1,25,1997,14.0,31,18,18,11,2,19,35,54.3,16,24,14,10,34,65,73,1,0,2022-2023,2.4285714285714284,2.2142857142857144
1425,Cheikhou Kouyaté,SEN,MF,Nott'ham Forest,Premier League,32,1989,9.8,29,21,18,8,3,9,13,69.2,4,14,2,12,10,39,24,0,0,2022-2023,1.0204081632653061,2.9591836734693877
Rk,Player,Nation,Pos,Squad,Comp,0,0,90.0,0,0,3,3,3,Tkl,0,0.0,0,0,0,0,0,0,0,0,0,2022-2023,0.0,0.0
1426,Mateo Kovačić,CRO,MF,Chelsea,Premier League,28,1994,19.0,36,24,16,14,6,14,36,38.9,22,10,1,9,19,55,16,0,0,2022-2023,1.0,1.894736842105263
1427,Viktor Kovalenko,UKR,MF,Spezia,Serie A,26,1996,6.1,9,5,1,6,2,5,8,62.5,3,11,2,9,4,13,7,0,0,2022-2023,0.6557377049180328,1.4754098360655739
1428,Soichiro Kozuki,JPN,"FW,MF",Schalke 04,Bundesliga,21,2000,4.2,6,4,3,3,0,4,6,66.7,2,5,0,5,3,9,3,0,0,2022-2023,0.7142857142857143,1.4285714285714286
1429,Emil Krafth,SWE,DF,Newcastle Utd,Premier League,27,1994,0.0,0,0,0,0,0,0,0,0.0,0,0,0,0,0,0,0,0,0,2022-2023,,
1430,Alex Král,CZE,MF,Schalke 04,Bundesliga,24,1998,26.2,34,24,10,22,2,17,37,45.9,20,31,6,25,17,51,53,0,0,2022-2023,0.648854961832061,1.297709923664122
1431,Andrej Kramarić,CRO,"MF,FW",Hoffenheim,Bundesliga,31,1991,26.5,5,2,2,1,2,1,11,9.1,10,14,2,12,6,11,13,0,0,2022-2023,0.22641509433962265,0.18867924528301888
1432,Christoph Kramer,GER,MF,Gladbach,Bundesliga,31,1991,24.7,44,33,24,15,5,22,55,40.0,33,34,2,32,17,61,40,0,0,2022-2023,0.688259109311741,1.7813765182186236
1433,Tom Krauß,GER,MF,Schalke 04,Bundesliga,21,2001,27.9,112,68,39,62,11,51,100,51.0,49,39,6,33,36,148,35,0,0,2022-2023,1.2903225806451613,4.014336917562725
1434,Rasmus Kristensen,DEN,DF,Leeds United,Premier League,25,1997,21.8,62,35,35,21,6,42,76,55.3,34,32,14,18,35,97,61,0,0,2022-2023,1.6055045871559632,2.8440366972477062
1435,Julian Kristoffersen,NOR,FW,Salernitana,Serie A,25,1997,0.2,0,0,0,0,0,0,0,0.0,0,1,0,1,0,0,0,0,0,2022-2023,0.0,0.0
1436,Raimonds Krollis,LVA,"FW,DF",Spezia,Serie A,20,2001,0.4,1,1,0,0,1,0,1,0.0,1,0,0,0,0,1,0,0,0,2022-2023,0.0,2.5
1437,Toni Kroos,GER,MF,Real Madrid,La Liga,32,1990,23.9,51,32,16,33,2,23,69,33.3,46,23,4,19,24,75,11,0,0,2022-2023,1.00418410041841,2.1338912133891212
1438,Rade Krunić,BIH,MF,Milan,Serie A,28,1993,18.4,40,28,18,18,4,16,50,32.0,34,31,11,20,16,56,21,0,0,2022-2023,0.8695652173913044,2.173913043478261
1439,Max Kruse,GER,"MF,FW",Wolfsburg,Bundesliga,34,1988,3.0,1,1,0,1,0,0,1,0.0,1,2,1,1,0,1,1,0,0,2022-2023,0.0,0.3333333333333333
1440,Lukas Kübler,GER,DF,Freiburg,Bundesliga,29,1992,18.2,37,25,24,9,4,18,30,60.0,12,25,11,14,29,66,50,0,0,2022-2023,1.5934065934065935,2.032967032967033
1441,Takefusa Kubo,JPN,"FW,MF",Real Sociedad,La Liga,21,2001,27.1,44,26,18,16,10,16,38,42.1,22,29,1,28,9,53,4,0,0,2022-2023,0.33210332103321033,1.6236162361623616
1442,Dejan Kulusevski,SWE,"MF,FW",Tottenham,Premier League,22,2000,23.0,38,15,23,7,8,16,44,36.4,28,19,0,19,13,51,7,0,0,2022-2023,0.5652173913043478,1.6521739130434783
1443,Sael Kumbedi,FRA,DF,Lyon,Ligue 1,17,2005,14.7,47,27,27,13,7,20,38,52.6,18,23,7,16,10,57,16,0,0,2022-2023,0.6802721088435374,3.197278911564626
1444,Marash Kumbulla,ALB,DF,Roma,Serie A,22,2000,2.9,4,4,2,2,0,2,3,66.7,1,2,1,1,4,8,6,0,0,2022-2023,1.3793103448275863,1.3793103448275863
1445,Pierre Kunde,CMR,"MF,FW",Bochum,Bundesliga,27,1995,4.2,12,6,3,8,1,6,14,42.9,8,7,1,6,7,19,9,0,0,2022-2023,1.6666666666666665,2.857142857142857
1446,Alou Kuol,AUS,FW,Stuttgart,Bundesliga,21,2000,0.1,0,0,0,0,0,0,0,0.0,0,0,0,0,0,0,0,0,0,2022-2023,0.0,0.0
1447,Layvin Kurzawa,FRA,DF,Fulham,Premier League,29,1992,1.5,3,2,1,1,1,3,3,100.0,0,1,1,0,2,5,4,0,0,2022-2023,1.3333333333333333,2.0
1448,Khvicha Kvaratskhelia,GEO,FW,Napoli,Serie A,21,2001,28.0,43,23,12,8,23,17,43,39.5,26,20,0,20,5,48,6,1,0,2022-2023,0.17857142857142858,1.5357142857142858
1449,Grejohn Kyei,FRA,FW,Clermont Foot,Ligue 1,26,1995,24.8,16,7,2,9,5,4,13,30.8,9,14,3,11,6,22,22,0,0,2022-2023,0.24193548387096772,0.6451612903225806
1450,Daniel Kyereh,GHA,"MF,FW",Freiburg,Bundesliga,26,1996,6.2,6,4,2,4,0,3,6,50.0,3,4,0,4,2,8,6,0,0,2022-2023,0.3225806451612903,0.9677419354838709
Rk,Player,Nation,Pos,Squad,Comp,0,0,90.0,0,0,3,3,3,Tkl,0,0.0,0,0,0,0,0,0,0,0,0,2022-2023,0.0,0.0
1451,Giorgos Kyriakopoulos,GRE,"DF,FW",Bologna,Serie A,26,1996,7.8,13,6,4,5,4,10,23,43.5,13,14,2,12,4,17,10,0,0,2022-2023,0.5128205128205129,1.6666666666666667
1452,Giorgos Kyriakopoulos,GRE,"FW,DF",Sassuolo,Serie A,26,1996,8.5,21,8,7,9,5,10,14,71.4,4,7,1,6,11,32,12,1,0,2022-2023,1.2941176470588236,2.4705882352941178
1453,César de la Hoz,ESP,MF,Almería,La Liga,30,1992,18.6,37,20,17,18,2,19,37,51.4,18,26,6,20,13,50,37,0,0,2022-2023,0.6989247311827956,1.9892473118279568
1454,Luca de la Torre,USA,MF,Celta Vigo,La Liga,24,1998,16.5,28,19,11,14,3,12,32,37.5,20,22,1,21,9,37,6,0,0,2022-2023,0.5454545454545454,1.696969696969697
1455,Rémy Labeau Lascary,GLP,"FW,MF",Lens,Ligue 1,19,2003,1.4,4,2,4,0,0,0,0,0.0,0,4,0,4,1,5,0,0,0,2022-2023,0.7142857142857143,2.857142857142857
1456,Gaëtan Laborde,FRA,FW,Nice,Ligue 1,28,1994,27.8,45,25,13,17,15,18,40,45.0,22,27,2,25,9,54,13,0,0,2022-2023,0.3237410071942446,1.618705035971223
1457,Gaëtan Laborde,FRA,FW,Rennes,Ligue 1,28,1994,2.8,1,1,1,0,0,0,1,0.0,1,1,0,1,0,1,1,0,0,2022-2023,0.0,0.35714285714285715
1458,Alexandre Lacazette,FRA,FW,Lyon,Ligue 1,31,1991,32.5,43,23,7,17,19,10,29,34.5,19,23,3,20,15,58,4,0,0,2022-2023,0.46153846153846156,1.323076923076923
1459,Qazim Laçi,ALB,MF,Ajaccio,Ligue 1,26,1996,2.4,6,3,2,3,1,4,9,44.4,5,5,0,5,2,8,3,0,0,2022-2023,0.8333333333333334,2.5
1460,Maxence Lacroix,FRA,DF,Wolfsburg,Bundesliga,22,2000,18.1,22,13,15,7,0,8,16,50.0,8,22,11,11,26,48,85,0,0,2022-2023,1.43646408839779,1.2154696132596685
1461,Alban Lafont,FRA,GK,Nantes,Ligue 1,23,1999,37.0,0,0,0,0,0,0,1,0.0,1,0,0,0,0,0,20,4,0,2022-2023,0.0,0.0
1462,Aïssa Laïdouni,TUN,MF,Union Berlin,Bundesliga,25,1996,9.7,14,7,6,8,0,5,17,29.4,12,22,4,18,9,23,3,0,0,2022-2023,0.9278350515463918,1.4432989690721651
1463,Konrad Laimer,AUT,MF,RB Leipzig,Bundesliga,25,1997,16.3,60,31,23,30,7,30,54,55.6,24,31,4,27,18,78,8,0,0,2022-2023,1.1042944785276072,3.680981595092024
1464,Stefan Lainer,AUT,DF,Gladbach,Bundesliga,29,1992,9.1,16,8,10,5,1,10,23,43.5,13,8,1,7,14,30,34,1,0,2022-2023,1.5384615384615385,1.7582417582417582
1465,Kenny Lala,MAD,DF,Brest,Ligue 1,30,1991,15.7,36,19,19,15,2,22,38,57.9,16,15,5,10,21,57,28,0,0,2022-2023,1.337579617834395,2.2929936305732483
1466,Adam Lallana,ENG,"MF,FW",Brighton,Premier League,34,1988,8.0,9,4,6,2,1,0,7,0.0,7,6,0,6,2,11,1,0,0,2022-2023,0.25,1.125
1467,Vassilis Lambropoulos,GRE,DF,Bochum,Bundesliga,32,1990,7.0,10,8,7,3,0,6,9,66.7,3,5,3,2,13,23,41,0,0,2022-2023,1.8571428571428572,1.4285714285714286
1468,Érik Lamela,ARG,"FW,MF",Sevilla,La Liga,30,1992,20.5,46,27,14,16,16,12,34,35.3,22,26,2,24,7,53,3,0,0,2022-2023,0.34146341463414637,2.2439024390243905
1469,Mohamed Lamine Bayo,GUI,"FW,MF",Lille,Ligue 1,24,1998,7.2,3,3,0,2,1,0,12,0.0,12,3,1,2,0,3,1,0,0,2022-2023,0.0,0.41666666666666663
1470,Sam Lammers,NED,FW,Sampdoria,Serie A,25,1997,12.2,12,5,2,7,3,6,15,40.0,9,10,3,7,6,18,11,0,0,2022-2023,0.49180327868852464,0.9836065573770493
1471,Sam Lammers,NED,FW,Empoli,Serie A,25,1997,9.8,20,10,5,9,6,7,11,63.6,4,4,1,3,3,23,8,0,0,2022-2023,0.3061224489795918,2.0408163265306123
1472,Tariq Lamptey,GHA,DF,Brighton,Premier League,21,2000,5.0,11,6,6,4,1,5,7,71.4,2,7,3,4,7,18,2,0,0,2022-2023,1.4,2.2
1473,Manuel Lanzini,ARG,"MF,FW",West Ham,Premier League,29,1993,2.8,2,2,1,1,0,2,6,33.3,4,2,0,2,2,4,0,0,0,2022-2023,0.7142857142857143,0.7142857142857143
1474,Aymeric Laporte,ESP,DF,Manchester City,Premier League,28,1994,11.0,11,8,6,4,1,7,11,63.6,4,10,4,6,3,14,30,1,0,2022-2023,0.2727272727272727,1.0
1475,Julien Laporte,FRA,DF,Lorient,Ligue 1,28,1993,18.4,22,16,18,3,1,16,22,72.7,6,33,27,6,18,40,108,2,0,2022-2023,0.9782608695652175,1.1956521739130437
Rk,Player,Nation,Pos,Squad,Comp,0,0,90.0,0,0,3,3,3,Tkl,0,0.0,0,0,0,0,0,0,0,0,0,2022-2023,0.0,0.0
1476,Cyle Larin,CAN,FW,Valladolid,La Liga,27,1995,16.3,9,3,2,4,3,3,7,42.9,4,6,3,3,0,9,15,0,0,2022-2023,0.0,0.5521472392638036
1477,Juan Larios,ESP,DF,Southampton,Premier League,18,2004,1.7,7,6,6,1,0,5,5,100.0,0,2,0,2,3,10,4,0,0,2022-2023,1.7647058823529411,4.11764705882353
1478,Yasser Larouci,ALG,"DF,MF",Troyes,Ligue 1,21,2001,20.0,23,13,13,8,2,15,24,62.5,9,15,1,14,26,49,46,0,0,2022-2023,1.3,1.15
1479,Jordan Larsson,SWE,"FW,MF",Schalke 04,Bundesliga,25,1997,5.1,8,5,1,7,0,2,9,22.2,7,9,0,9,4,12,3,0,0,2022-2023,0.7843137254901962,1.5686274509803924
1480,Kevin Lasagna,ITA,"FW,MF",Hellas Verona,Serie A,29,1992,17.5,12,6,7,3,2,6,14,42.9,8,17,1,16,5,17,13,0,0,2022-2023,0.2857142857142857,0.6857142857142857
1481,Jamaal Lascelles,ENG,DF,Newcastle Utd,Premier League,28,1993,2.4,1,0,1,0,0,1,1,100.0,0,3,2,1,0,1,17,0,0,2022-2023,0.0,0.4166666666666667
1482,Juanmi Latasa,ESP,FW,Getafe,La Liga,21,2001,5.0,5,4,2,0,3,1,1,100.0,0,3,1,2,1,6,8,0,0,2022-2023,0.2,1.0
1483,Toni Lato,ESP,"DF,MF",Valencia,La Liga,24,1997,10.2,23,11,9,12,2,9,21,42.9,12,10,1,9,6,29,14,0,0,2022-2023,0.5882352941176471,2.2549019607843137
1484,Danny Latza,GER,MF,Schalke 04,Bundesliga,32,1989,9.5,17,13,8,8,1,5,17,29.4,12,16,1,15,5,22,15,0,0,2022-2023,0.5263157894736842,1.7894736842105263
1485,Armand Lauriente,FRA,FW,Sassuolo,Serie A,23,1998,24.2,21,15,5,7,9,8,21,38.1,13,20,0,20,12,33,8,0,0,2022-2023,0.49586776859504134,0.8677685950413223
1486,Armand Lauriente,FRA,FW,Lorient,Ligue 1,23,1998,3.0,8,7,3,4,1,3,7,42.9,4,5,1,4,4,12,1,0,0,2022-2023,1.3333333333333333,2.6666666666666665
1487,Roméo Lavia,BEL,MF,Southampton,Premier League,18,2004,24.7,60,35,27,29,4,21,53,39.6,32,47,11,36,33,93,23,1,0,2022-2023,1.3360323886639676,2.4291497975708505
1488,Lázaro,BRA,"FW,MF",Almería,La Liga,20,2002,8.0,4,3,3,0,1,3,15,20.0,12,16,1,15,2,6,1,0,0,2022-2023,0.25,0.5
1489,Valentino Lazaro,AUT,DF,Torino,Serie A,26,1996,15.3,10,5,6,0,4,6,14,42.9,8,16,3,13,3,13,29,0,0,2022-2023,0.19607843137254902,0.6535947712418301
1490,Marko Lazetić,SRB,FW,Milan,Serie A,18,2004,0.1,0,0,0,0,0,0,0,0.0,0,0,0,0,0,0,0,0,0,2022-2023,0.0,0.0
1491,Darko Lazović,SRB,"MF,DF",Hellas Verona,Serie A,31,1990,24.9,24,13,9,12,3,13,29,44.8,16,14,3,11,16,40,19,0,0,2022-2023,0.642570281124498,0.9638554216867471
1492,Manuel Lazzari,ITA,DF,Lazio,Serie A,28,1993,20.9,33,21,13,14,6,21,36,58.3,15,20,6,14,18,51,36,1,0,2022-2023,0.861244019138756,1.5789473684210527
1493,Théo Le Bris,FRA,"MF,DF",Lorient,Ligue 1,19,2002,16.1,31,19,17,11,3,15,33,45.5,18,21,2,19,18,49,31,0,0,2022-2023,1.1180124223602483,1.9254658385093166
1494,Julien Le Cardinal,FRA,DF,Lens,Ligue 1,24,1997,1.8,6,4,5,0,1,4,6,66.7,2,3,0,3,2,8,5,0,0,2022-2023,1.1111111111111112,3.333333333333333
1495,Jérémy Le Douaron,FRA,"MF,FW",Brest,Ligue 1,24,1998,23.0,15,9,5,9,1,3,27,11.1,24,29,2,27,11,26,30,0,0,2022-2023,0.4782608695652174,0.6521739130434783
1496,Enzo Le Fée,FRA,MF,Lorient,Ligue 1,22,2000,33.6,108,64,52,40,16,43,113,38.1,70,50,5,45,34,142,38,1,0,2022-2023,1.0119047619047619,3.214285714285714
1497,Vincent Le Goff,FRA,DF,Lorient,Ligue 1,32,1989,37.0,75,32,56,16,3,45,62,72.6,17,29,9,20,41,116,105,1,0,2022-2023,1.1081081081081081,2.027027027027027
1498,Maxime Le Marchand,FRA,DF,Strasbourg,Ligue 1,32,1989,22.4,39,24,23,14,2,19,31,61.3,12,22,14,8,37,76,74,0,0,2022-2023,1.6517857142857144,1.7410714285714286
1499,Robin Le Normand,ESP,DF,Real Sociedad,La Liga,25,1996,31.1,36,23,25,9,2,14,27,51.9,13,22,14,8,33,69,93,0,0,2022-2023,1.0610932475884245,1.157556270096463
1500,Rafael Leão,POR,"FW,MF",Milan,Serie A,23,1999,26.9,8,7,2,3,3,6,14,42.9,8,9,2,7,15,23,8,0,0,2022-2023,0.5576208178438662,0.29739776951672864
Rk,Player,Nation,Pos,Squad,Comp,0,0,90.0,0,0,3,3,3,Tkl,0,0.0,0,0,0,0,0,0,0,0,0,2022-2023,0.0,0.0
1501,Paolo Lebas,FRA,MF,Ajaccio,Ligue 1,19,2003,0.6,0,0,0,0,0,0,0,0.0,0,0,0,0,0,0,0,0,0,2022-2023,0.0,0.0
1502,Jean-Louis Leca,FRA,GK,Lens,Ligue 1,36,1985,1.0,0,0,0,0,0,0,0,0.0,0,0,0,0,0,0,0,1,0,2022-2023,0.0,0.0
1503,Benjamin Lecomte,FRA,GK,Espanyol,La Liga,31,1991,10.0,0,0,0,0,0,0,0,0.0,0,0,0,0,0,0,3,2,0,2022-2023,0.0,0.0
1504,Benjamin Lecomte,FRA,GK,Montpellier,Ligue 1,31,1991,19.0,0,0,0,0,0,0,2,0.0,2,0,0,0,0,0,6,0,0,2022-2023,0.0,0.0
1505,Jeremías Ledesma,ARG,GK,Cádiz,La Liga,29,1993,34.0,3,2,3,0,0,3,7,42.9,4,1,0,1,2,5,23,3,0,2022-2023,0.058823529411764705,0.08823529411764706
1506,Pierre Lees-Melou,FRA,MF,Brest,Ligue 1,29,1993,30.7,97,55,55,37,5,57,123,46.3,66,48,13,35,52,149,46,1,0,2022-2023,1.6938110749185669,3.1596091205211727
1507,Diogo Leite,POR,DF,Union Berlin,Bundesliga,23,1999,25.0,35,20,21,14,0,21,34,61.8,13,23,14,9,26,61,99,1,0,2022-2023,1.04,1.4
1508,Maxim Leitsch,GER,DF,Mainz 05,Bundesliga,24,1998,7.4,9,7,6,3,0,4,5,80.0,1,7,4,3,18,27,26,1,0,2022-2023,2.4324324324324325,1.2162162162162162
1509,Florian Lejeune,FRA,DF,Rayo Vallecano,La Liga,31,1991,28.5,28,17,19,8,1,17,25,68.0,8,24,16,8,15,43,123,0,0,2022-2023,0.5263157894736842,0.9824561403508771
1510,Iñigo Lekue,ESP,DF,Athletic Club,La Liga,29,1993,14.7,24,17,20,4,0,12,19,63.2,7,16,2,14,13,37,31,1,0,2022-2023,0.8843537414965987,1.6326530612244898
1511,Thomas Lemar,FRA,MF,Atlético Madrid,La Liga,26,1995,13.9,30,18,10,13,7,10,28,35.7,18,12,3,9,7,37,12,0,0,2022-2023,0.5035971223021583,2.158273381294964
1512,Félix Lemaréchal,FRA,MF,Brest,Ligue 1,18,2003,3.2,5,5,2,1,2,0,3,0.0,3,6,0,6,1,6,2,0,0,2022-2023,0.3125,1.5625
1513,Dexter Lembikisa,JAM,DF,Wolves,Premier League,18,2003,0.3,0,0,0,0,0,0,0,0.0,0,0,0,0,0,0,0,0,0,2022-2023,0.0,0.0
1514,Mario Lemina,GAB,MF,Wolves,Premier League,28,1993,14.4,38,24,22,13,3,20,38,52.6,18,26,8,18,14,52,24,1,0,2022-2023,0.9722222222222222,2.638888888888889
1515,Mario Lemina,GAB,"MF,DF",Nice,Ligue 1,28,1993,9.3,32,21,11,14,7,12,18,66.7,6,13,5,8,11,43,20,0,0,2022-2023,1.182795698924731,3.440860215053763
1516,Tim Lemperle,GER,"FW,MF",Köln,Bundesliga,20,2002,1.5,6,4,3,1,2,3,5,60.0,2,5,0,5,1,7,4,0,0,2022-2023,0.6666666666666666,4.0
1517,Clément Lenglet,FRA,DF,Tottenham,Premier League,27,1995,22.4,38,23,18,15,5,16,34,47.1,18,26,11,15,18,56,68,2,0,2022-2023,0.8035714285714286,1.6964285714285716
1518,Bernd Leno,GER,GK,Fulham,Premier League,30,1992,36.0,0,0,0,0,0,0,3,0.0,3,0,0,0,0,0,18,1,0,2022-2023,0.0,0.0
1519,Christopher Lenz,GER,DF,Eint Frankfurt,Bundesliga,27,1994,14.3,29,21,17,7,5,16,37,43.2,21,16,3,13,21,50,34,0,0,2022-2023,1.4685314685314685,2.027972027972028
1520,Donovan Léon,GUF,GK,Auxerre,Ligue 1,29,1992,2.0,0,0,0,0,0,0,0,0.0,0,0,0,0,0,0,1,0,0,2022-2023,0.0,0.0
1521,Sergio León,ESP,FW,Valladolid,La Liga,33,1989,14.8,6,4,0,4,2,3,6,50.0,3,6,0,6,0,6,4,0,0,2022-2023,0.0,0.4054054054054054
1522,Johann Lepenant,FRA,MF,Lyon,Ligue 1,19,2002,21.5,58,34,24,27,7,32,86,37.2,54,29,5,24,28,86,17,3,0,2022-2023,1.302325581395349,2.697674418604651
1523,Mehdi Léris,ALG,"MF,DF",Sampdoria,Serie A,24,1998,27.3,63,46,30,24,9,23,55,41.8,32,38,6,32,27,90,34,0,0,2022-2023,0.9890109890109889,2.3076923076923075
1524,Jefferson Lerma,COL,MF,Bournemouth,Premier League,27,1994,36.1,50,30,23,23,4,20,45,44.4,25,32,15,17,47,97,91,2,0,2022-2023,1.3019390581717452,1.3850415512465373
1525,Benjamin Leroy,FRA,GK,Ajaccio,Ligue 1,33,1989,31.1,0,0,0,0,0,0,2,0.0,2,0,0,0,1,1,16,2,0,2022-2023,0.03215434083601286,0.0
Rk,Player,Nation,Pos,Squad,Comp,0,0,90.0,0,0,3,3,3,Tkl,0,0.0,0,0,0,0,0,0,0,0,0,2022-2023,0.0,0.0
1526,Léo Leroy,FRA,MF,Montpellier,Ligue 1,22,2000,13.2,53,38,24,26,3,31,57,54.4,26,25,2,23,14,67,8,0,0,2022-2023,1.0606060606060606,4.015151515151516
1527,Alexandre Letellier,FRA,GK,Paris S-G,Ligue 1,31,1990,0.1,0,0,0,0,0,0,0,0.0,0,0,0,0,0,0,0,0,0,2022-2023,0.0,0.0
1528,Ruan Levine,BRA,"MF,FW",Ajaccio,Ligue 1,23,1999,0.3,2,2,1,1,0,0,0,0.0,0,1,0,1,2,4,0,0,0,2022-2023,6.666666666666667,6.666666666666667
1529,Robert Lewandowski,POL,FW,Barcelona,La Liga,33,1988,31.6,17,11,2,5,10,7,14,50.0,7,20,0,20,2,19,14,0,0,2022-2023,0.06329113924050632,0.5379746835443038
1530,Jamie Leweling,GER,"FW,MF",Union Berlin,Bundesliga,21,2001,2.9,5,3,2,2,1,3,5,60.0,2,3,0,3,1,6,0,0,0,2022-2023,0.3448275862068966,1.7241379310344829
1531,Jamal Lewis,NIR,"DF,FW",Newcastle Utd,Premier League,24,1998,0.1,0,0,0,0,0,0,0,0.0,0,0,0,0,0,0,0,0,0,2022-2023,0.0,0.0
1532,Rico Lewis,ENG,"DF,MF",Manchester City,Premier League,17,2004,10.0,16,9,9,5,2,6,11,54.5,5,8,4,4,6,22,13,1,0,2022-2023,0.6,1.6
1533,Keane Lewis-Potter,ENG,"FW,MF",Brentford,Premier League,21,2001,3.6,1,0,0,1,0,0,0,0.0,0,5,1,4,0,1,2,0,0,2022-2023,0.0,0.2777777777777778
1534,Dimitri Liénard,FRA,"DF,MF",Strasbourg,Ligue 1,34,1988,17.1,46,29,20,18,8,34,57,59.6,23,28,4,24,16,62,24,0,0,2022-2023,0.935672514619883,2.6900584795321634
1535,Philipp Lienhart,AUT,DF,Freiburg,Bundesliga,26,1996,27.8,29,18,19,10,0,13,27,48.1,14,29,15,14,35,64,97,0,0,2022-2023,1.2589928057553956,1.0431654676258992
1536,Matthijs de Ligt,NED,DF,Bayern Munich,Bundesliga,22,1999,26.7,32,23,15,16,1,15,24,62.5,9,31,20,11,23,55,85,0,0,2022-2023,0.8614232209737828,1.198501872659176
1537,Dimitris Limnios,GRE,FW,Köln,Bundesliga,24,1998,0.4,0,0,0,0,0,0,0,0.0,0,0,0,0,1,1,0,0,0,2022-2023,2.5,0.0
1538,Victor Lindelöf,SWE,DF,Manchester Utd,Premier League,28,1994,15.2,22,17,10,9,3,9,17,52.9,8,18,9,9,21,43,63,1,0,2022-2023,1.381578947368421,1.4473684210526316
1539,Jesper Lindstrøm,DEN,"MF,FW",Eint Frankfurt,Bundesliga,22,2000,18.7,26,11,15,7,4,7,22,31.8,15,25,3,22,9,35,9,0,0,2022-2023,0.4812834224598931,1.3903743315508021
1540,Karol Linetty,POL,MF,Torino,Serie A,27,1995,21.0,32,17,7,22,3,13,25,52.0,12,28,8,20,19,51,25,0,0,2022-2023,0.9047619047619048,1.5238095238095237
1541,Jesse Lingard,ENG,"FW,MF",Nott'ham Forest,Premier League,29,1992,10.3,4,4,2,2,0,1,7,14.3,6,11,0,11,5,9,4,0,0,2022-2023,0.48543689320388345,0.3883495145631068
1542,Samuel Lino,BRA,"FW,MF",Valencia,La Liga,22,1999,32.1,66,43,17,37,12,26,72,36.1,46,34,0,34,18,84,16,0,0,2022-2023,0.5607476635514018,2.05607476635514
1543,Pol Lirola,ESP,DF,Elche,La Liga,24,1997,7.0,13,6,9,3,1,8,13,61.5,5,3,2,1,7,20,16,0,0,2022-2023,1.0,1.8571428571428572
1544,Mateusz Lis,POL,GK,Troyes,Ligue 1,25,1997,8.3,0,0,0,0,0,0,1,0.0,1,1,0,1,0,0,3,0,0,2022-2023,0.0,0.0
1545,Marcin Listkowski,POL,"MF,FW",Lecce,Serie A,24,1998,0.9,0,0,0,0,0,0,0,0.0,0,0,0,0,3,3,2,0,0,2022-2023,3.333333333333333,0.0
1546,Valentino Livramento,ENG,"DF,FW",Southampton,Premier League,19,2002,0.3,2,1,2,0,0,0,0,0.0,0,0,0,0,2,4,3,0,0,2022-2023,6.666666666666667,6.666666666666667
1547,Dejan Ljubicic,AUT,"MF,FW",Köln,Bundesliga,24,1997,19.0,25,14,7,14,4,13,40,32.5,27,20,1,19,8,33,8,1,0,2022-2023,0.42105263157894735,1.3157894736842106
1548,Javier Llabrés,ESP,FW,Mallorca,La Liga,19,2002,0.2,0,0,0,0,0,0,0,0.0,0,0,0,0,0,0,1,0,0,2022-2023,0.0,0.0
1549,Diego Llorente,ESP,DF,Leeds United,Premier League,28,1993,7.2,13,10,8,5,0,4,8,50.0,4,6,2,4,15,28,24,2,0,2022-2023,2.0833333333333335,1.8055555555555556
1550,Diego Llorente,ESP,DF,Roma,Serie A,28,1993,6.4,10,5,6,4,0,5,12,41.7,7,4,2,2,11,21,20,0,0,2022-2023,1.71875,1.5625
Rk,Player,Nation,Pos,Squad,Comp,0,0,90.0,0,0,3,3,3,Tkl,0,0.0,0,0,0,0,0,0,0,0,0,2022-2023,0.0,0.0
1551,Marcos Llorente,ESP,"MF,DF",Atlético Madrid,La Liga,27,1995,18.9,32,15,16,10,6,17,30,56.7,13,26,2,24,17,49,19,0,0,2022-2023,0.8994708994708995,1.6931216931216932
1552,Hugo Lloris,FRA,GK,Tottenham,Premier League,35,1986,24.5,1,1,1,0,0,1,3,33.3,2,0,0,0,1,2,13,5,0,2022-2023,0.04081632653061224,0.04081632653061224
1553,Giovani Lo Celso,ARG,"MF,FW",Villarreal,La Liga,26,1996,12.5,32,28,7,15,10,12,21,57.1,9,14,2,12,6,38,5,0,0,2022-2023,0.48,2.56
1554,Stanislav Lobotka,SVK,MF,Napoli,Serie A,27,1994,34.5,83,44,35,35,13,43,73,58.9,30,29,7,22,23,106,16,0,0,2022-2023,0.6666666666666666,2.4057971014492754
1555,Manuel Locatelli,ITA,MF,Juventus,Serie A,24,1998,27.2,59,33,26,23,10,30,53,56.6,23,50,22,28,27,86,59,0,0,2022-2023,0.9926470588235294,2.1691176470588234
1556,Luka Lochoshvili,GEO,DF,Cremonese,Serie A,24,1998,20.4,45,19,30,11,4,22,31,71.0,9,31,10,21,22,67,89,0,0,2022-2023,1.0784313725490198,2.2058823529411766
1557,Bradley Locko,FRA,DF,Reims,Ligue 1,20,2002,11.8,31,16,21,4,6,15,27,55.6,12,17,4,13,20,51,21,0,0,2022-2023,1.694915254237288,2.6271186440677963
1558,Bradley Locko,FRA,DF,Brest,Ligue 1,20,2002,3.0,4,3,2,1,1,2,3,66.7,1,4,0,4,2,6,13,0,0,2022-2023,0.6666666666666666,1.3333333333333333
1559,Renan Lodi,BRA,DF,Nott'ham Forest,Premier League,24,1998,24.6,52,39,38,8,6,33,66,50.0,33,25,6,19,33,85,74,0,0,2022-2023,1.3414634146341462,2.113821138211382
1560,Ruben Loftus-Cheek,ENG,"MF,DF",Chelsea,Premier League,26,1996,17.1,25,14,8,14,3,12,22,54.5,10,15,2,13,12,37,23,0,0,2022-2023,0.7017543859649122,1.461988304093567
1561,Sean Longstaff,ENG,MF,Newcastle Utd,Premier League,24,1997,28.0,42,21,16,20,6,20,52,38.5,32,35,8,27,16,58,23,0,0,2022-2023,0.5714285714285714,1.5
1562,Ademola Lookman,NGA,"FW,MF",Atalanta,Serie A,24,1997,19.2,13,5,2,6,5,3,15,20.0,12,18,0,18,4,17,1,0,0,2022-2023,0.20833333333333334,0.6770833333333334
1563,Anthony Lopes,POR,GK,Lyon,Ligue 1,31,1990,31.3,1,0,1,0,0,1,4,25.0,3,0,0,0,3,4,10,0,0,2022-2023,0.09584664536741214,0.03194888178913738
1564,Rony Lopes,POR,"MF,FW",Troyes,Ligue 1,26,1995,26.1,24,12,6,15,3,7,31,22.6,24,14,2,12,9,33,10,0,0,2022-2023,0.3448275862068965,0.9195402298850575
1565,David López,ESP,DF,Girona,La Liga,32,1989,18.4,31,18,17,13,1,19,27,70.4,8,29,19,10,14,45,64,1,0,2022-2023,0.7608695652173914,1.6847826086956523
1566,Diego López,ESP,GK,Rayo Vallecano,La Liga,40,1981,1.1,0,0,0,0,0,0,0,0.0,0,0,0,0,0,0,0,1,0,2022-2023,0.0,0.0
1567,Diego López,ESP,"FW,MF",Valencia,La Liga,20,2002,5.0,2,2,1,1,0,2,15,13.3,13,9,0,9,3,5,5,0,0,2022-2023,0.6,0.4
1568,Maxime Lopez,FRA,MF,Sassuolo,Serie A,24,1997,25.5,42,18,26,12,4,16,56,28.6,40,24,6,18,22,64,21,0,0,2022-2023,0.8627450980392157,1.6470588235294117
1569,Pau López,ESP,GK,Marseille,Ligue 1,27,1994,32.5,0,0,0,0,0,0,1,0.0,1,0,0,0,0,0,5,1,0,2022-2023,0.0,0.0
1570,Unai López,ESP,MF,Rayo Vallecano,La Liga,26,1995,13.9,32,20,10,17,5,13,37,35.1,24,12,1,11,15,47,6,1,0,2022-2023,1.079136690647482,2.302158273381295
1571,Dion Lopy,SEN,MF,Reims,Ligue 1,20,2002,15.3,45,24,22,16,7,23,62,37.1,39,27,3,24,22,67,18,0,0,2022-2023,1.4379084967320261,2.941176470588235
1572,Anthony Losilla,FRA,MF,Bochum,Bundesliga,36,1986,30.2,76,49,32,34,10,38,77,49.4,39,39,12,27,37,113,67,0,0,2022-2023,1.2251655629139073,2.5165562913907285
1573,Jordan Lotomba,SUI,DF,Nice,Ligue 1,23,1998,27.3,65,38,33,24,8,31,48,64.6,17,38,11,27,32,97,53,0,0,2022-2023,1.1721611721611722,2.380952380952381
1574,Matteo Lovato,ITA,DF,Salernitana,Serie A,22,2000,9.0,17,14,14,3,0,10,25,40.0,15,8,5,3,13,30,33,2,0,2022-2023,1.4444444444444444,1.8888888888888888
1575,Dejan Lovren,CRO,DF,Lyon,Ligue 1,33,1989,16.2,25,19,20,5,0,20,29,69.0,9,20,10,10,26,51,70,1,0,2022-2023,1.6049382716049383,1.5432098765432098
Rk,Player,Nation,Pos,Squad,Comp,0,0,90.0,0,0,3,3,3,Tkl,0,0.0,0,0,0,0,0,0,0,0,0,2022-2023,0.0,0.0
1576,Sandi Lovrić,SVN,MF,Udinese,Serie A,24,1998,25.9,40,18,16,16,8,25,43,58.1,18,25,2,23,26,66,21,0,0,2022-2023,1.0038610038610039,1.5444015444015444
1577,Jamal Lowe,JAM,"MF,FW",Bournemouth,Premier League,28,1994,0.1,0,0,0,0,0,0,0,0.0,0,0,0,0,0,0,0,0,0,2022-2023,0.0,0.0
1578,Anthony Lozano,HON,FW,Cádiz,La Liga,29,1993,16.0,6,4,1,4,1,1,7,14.3,6,12,1,11,3,9,17,0,0,2022-2023,0.1875,0.375
1579,Hirving Lozano,MEX,FW,Napoli,Serie A,27,1995,17.8,24,13,10,6,8,9,21,42.9,12,31,0,31,15,39,6,0,0,2022-2023,0.8426966292134831,1.348314606741573
1580,Pol Lozano,ESP,MF,Espanyol,La Liga,22,1999,0.2,0,0,0,0,0,0,0,0.0,0,1,0,1,0,0,1,0,0,2022-2023,0.0,0.0
1581,Jean Lucas,BRA,MF,Monaco,Ligue 1,24,1998,3.2,9,5,3,5,1,6,12,50.0,6,2,1,1,4,13,2,0,0,2022-2023,1.25,2.8125
1582,Jhon Lucumí,COL,DF,Bologna,Serie A,24,1998,32.2,53,37,39,13,1,24,43,55.8,19,43,26,17,35,88,100,1,0,2022-2023,1.0869565217391304,1.6459627329192545
1583,José Luis Gayà,ESP,DF,Valencia,La Liga,27,1995,30.1,80,46,61,16,3,43,74,58.1,31,28,9,19,23,103,48,0,0,2022-2023,0.7641196013289037,2.6578073089700998
1584,José Luis Morales,ESP,"FW,MF",Villarreal,La Liga,35,1987,13.5,7,6,1,2,4,5,17,29.4,12,12,1,11,2,9,2,0,0,2022-2023,0.14814814814814814,0.5185185185185185
1585,José Luis Palomino,ARG,DF,Atalanta,Serie A,32,1990,8.4,23,14,16,7,0,11,19,57.9,8,11,4,7,28,51,20,0,0,2022-2023,3.333333333333333,2.738095238095238
1586,Douglas Luiz,BRA,MF,Aston Villa,Premier League,24,1998,32.5,72,42,31,32,9,29,63,46.0,34,36,7,29,40,112,27,2,0,2022-2023,1.2307692307692308,2.2153846153846155
1587,Romelu Lukaku,BEL,FW,Inter,Serie A,29,1993,18.4,3,1,1,0,2,2,5,40.0,3,3,1,2,0,3,16,0,0,2022-2023,0.0,0.16304347826086957
1588,Castello Lukeba,FRA,DF,Lyon,Ligue 1,19,2002,33.2,39,23,27,8,4,21,31,67.7,10,42,24,18,75,114,105,1,0,2022-2023,2.259036144578313,1.1746987951807228
1589,Dodi Lukebakio,BEL,"FW,MF",Hertha BSC,Bundesliga,24,1997,26.6,18,11,7,8,3,6,27,22.2,21,23,5,18,13,31,17,0,0,2022-2023,0.48872180451127817,0.6766917293233082
1590,Saša Lukić,SRB,MF,Fulham,Premier League,25,1996,4.6,8,3,1,4,3,3,7,42.9,4,6,2,4,5,13,3,0,0,2022-2023,1.0869565217391306,1.7391304347826089
1591,Saša Lukić,SRB,MF,Torino,Serie A,25,1996,13.3,21,14,10,10,1,9,15,60.0,6,17,7,10,13,34,10,0,0,2022-2023,0.9774436090225563,1.5789473684210527
1592,Andriy Lunin,UKR,GK,Real Madrid,La Liga,23,1999,7.0,0,0,0,0,0,0,0,0.0,0,0,0,0,0,0,1,0,0,2022-2023,0.0,0.0
1593,Andrey Lunyov,RUS,GK,Leverkusen,Bundesliga,30,1991,1.0,0,0,0,0,0,0,0,0.0,0,0,0,0,0,0,0,0,0,2022-2023,0.0,0.0
1594,Sebastiano Luperto,ITA,DF,Empoli,Serie A,25,1996,34.8,33,18,24,8,1,9,20,45.0,11,54,42,12,43,76,163,1,0,2022-2023,1.2356321839080462,0.9482758620689656
1595,Lyanco,BRA,DF,Southampton,Premier League,25,1997,13.1,24,16,15,9,0,12,18,66.7,6,30,25,5,20,44,65,2,0,2022-2023,1.5267175572519085,1.83206106870229
1596,Charalambos Lykogiannis,GRE,DF,Bologna,Serie A,28,1993,12.3,16,8,5,6,5,5,13,38.5,8,9,4,5,15,31,30,0,0,2022-2023,1.2195121951219512,1.3008130081300813
1597,Youssouf M'Changama,COM,MF,Auxerre,Ligue 1,31,1990,12.0,22,11,7,12,3,7,13,53.8,6,6,0,6,15,37,6,1,0,2022-2023,1.25,1.8333333333333333
1598,Awer Mabil,AUS,"MF,FW",Cádiz,La Liga,26,1995,1.8,2,0,0,1,1,1,3,33.3,2,1,1,0,0,2,1,0,0,2022-2023,0.0,1.1111111111111112
1599,Alexis Mac Allister,ARG,MF,Brighton,Premier League,23,1998,32.1,70,39,22,40,8,34,71,47.9,37,26,2,24,22,92,10,1,0,2022-2023,0.6853582554517134,2.1806853582554515
1600,Deiver Machado,COL,"DF,MF",Lens,Ligue 1,28,1993,24.3,45,26,18,20,7,21,34,61.8,13,21,4,17,21,66,27,0,0,2022-2023,0.8641975308641975,1.8518518518518519
Rk,Player,Nation,Pos,Squad,Comp,0,0,90.0,0,0,3,3,3,Tkl,0,0.0,0,0,0,0,0,0,0,0,0,2022-2023,0.0,0.0
1601,Darwin Machís,VEN,FW,Valladolid,La Liga,29,1993,6.7,3,2,0,2,1,1,8,12.5,7,5,0,5,3,6,4,0,0,2022-2023,0.44776119402985076,0.44776119402985076
1602,James Maddison,ENG,"MF,FW",Leicester City,Premier League,25,1996,27.6,51,26,25,19,7,19,50,38.0,31,19,1,18,13,64,6,1,0,2022-2023,0.47101449275362317,1.8478260869565217
1603,Noni Madueke,ENG,FW,Chelsea,Premier League,20,2002,7.1,12,8,5,4,3,6,13,46.2,7,13,2,11,4,16,7,0,0,2022-2023,0.5633802816901409,1.6901408450704227
1604,Pablo Maffeo,ESP,DF,Mallorca,La Liga,25,1997,33.1,75,46,54,16,5,45,78,57.7,33,38,11,27,26,101,76,0,0,2022-2023,0.7854984894259819,2.2658610271903323
1605,Gabriel Magalhães,BRA,DF,Arsenal,Premier League,24,1997,37.9,48,30,29,15,4,18,27,66.7,9,49,26,23,32,80,125,3,0,2022-2023,0.8443271767810027,1.266490765171504
1606,Lisandro Magallán,ARG,DF,Elche,La Liga,28,1993,10.0,19,11,11,5,3,10,12,83.3,2,14,5,9,13,32,30,1,0,2022-2023,1.3,1.9
1607,Soungoutou Magassa,FRA,MF,Monaco,Ligue 1,18,2003,0.9,4,1,2,2,0,2,4,50.0,2,3,0,3,1,5,1,0,0,2022-2023,1.1111111111111112,4.444444444444445
1608,Giulio Maggiore,ITA,MF,Salernitana,Serie A,24,1998,9.9,20,8,11,6,3,10,21,47.6,11,19,4,15,8,28,10,0,0,2022-2023,0.8080808080808081,2.0202020202020203
1609,Giangiacomo Magnani,ITA,DF,Hellas Verona,Serie A,26,1995,17.0,33,22,20,11,2,19,25,76.0,6,20,15,5,21,54,76,0,0,2022-2023,1.2352941176470589,1.9411764705882353
1610,Hugo Magnetti,FRA,MF,Brest,Ligue 1,24,1998,18.8,43,27,18,23,2,23,63,36.5,40,21,1,20,25,68,12,0,0,2022-2023,1.3297872340425532,2.2872340425531914
1611,Yohann Magnin,FRA,MF,Clermont Foot,Ligue 1,25,1997,26.7,89,54,37,45,7,54,106,50.9,52,50,12,38,25,114,46,0,0,2022-2023,0.9363295880149813,3.3333333333333335
1612,Harry Maguire,ENG,DF,Manchester Utd,Premier League,29,1993,8.5,8,6,6,1,1,4,5,80.0,1,18,11,7,13,21,41,0,0,2022-2023,1.5294117647058822,0.9411764705882353
1613,Jon Magunacelaya,ESP,"MF,FW",Real Sociedad,La Liga,22,2000,0.7,1,0,0,0,1,0,2,0.0,2,0,0,0,0,1,1,0,0,2022-2023,0.0,1.4285714285714286
1614,Riyad Mahrez,ALG,"FW,MF",Manchester City,Premier League,31,1991,21.3,30,14,8,13,9,13,39,33.3,26,27,1,26,9,39,5,0,0,2022-2023,0.4225352112676056,1.408450704225352
1615,Arne Maier,GER,MF,Augsburg,Bundesliga,23,1999,21.8,31,22,17,11,3,10,18,55.6,8,21,0,21,15,46,22,0,0,2022-2023,0.6880733944954128,1.4220183486238531
1616,Mike Maignan,FRA,GK,Milan,Serie A,27,1995,22.0,1,0,1,0,0,1,1,100.0,0,0,0,0,1,2,10,1,0,2022-2023,0.045454545454545456,0.045454545454545456
1617,Linton Maina,GER,"FW,MF",Köln,Bundesliga,23,1999,24.9,18,12,5,11,2,7,30,23.3,23,19,0,19,5,23,9,0,0,2022-2023,0.20080321285140562,0.7228915662650602
1618,Kobbie Mainoo,ENG,MF,Manchester Utd,Premier League,17,2005,0.1,0,0,0,0,0,0,0,0.0,0,1,1,0,0,0,0,0,0,2022-2023,0.0,0.0
1619,Ainsley Maitland-Niles,ENG,"DF,MF",Southampton,Premier League,24,1997,15.6,45,24,23,18,4,28,44,63.6,16,28,7,21,22,67,45,1,0,2022-2023,1.4102564102564104,2.8846153846153846
1620,Jordan Majchrzak,POL,FW,Roma,Serie A,17,2004,0.2,0,0,0,0,0,0,0,0.0,0,0,0,0,0,0,0,0,0,2022-2023,0.0,0.0
1621,Lovro Majer,CRO,"MF,FW",Rennes,Ligue 1,24,1998,18.5,34,23,16,13,5,8,29,27.6,21,21,1,20,21,55,5,1,0,2022-2023,1.135135135135135,1.837837837837838
1622,Jean-Victor Makengo,FRA,MF,Udinese,Serie A,24,1998,8.9,16,13,7,7,2,5,9,55.6,4,8,2,6,9,25,3,0,0,2022-2023,1.0112359550561798,1.797752808988764
1623,Jean-Victor Makengo,FRA,MF,Lorient,Ligue 1,24,1998,11.8,16,8,5,10,1,6,20,30.0,14,8,5,3,10,26,13,1,0,2022-2023,0.847457627118644,1.3559322033898304
1624,Béni Makouana,CGO,"FW,MF",Montpellier,Ligue 1,19,2002,2.2,1,0,0,1,0,0,2,0.0,2,3,1,2,0,1,1,0,0,2022-2023,0.0,0.45454545454545453
1625,Nemanja Maksimović,SRB,MF,Getafe,La Liga,27,1995,22.8,41,30,17,18,6,19,32,59.4,13,36,14,22,34,75,27,0,0,2022-2023,1.4912280701754386,1.7982456140350878
Rk,Player,Nation,Pos,Squad,Comp,0,0,90.0,0,0,3,3,3,Tkl,0,0.0,0,0,0,0,0,0,0,0,0,2022-2023,0.0,0.0
1626,Tyrell Malacia,NED,DF,Manchester Utd,Premier League,22,1999,15.5,46,33,33,12,1,14,25,56.0,11,13,3,10,25,71,49,0,0,2022-2023,1.6129032258064515,2.967741935483871
1627,Lorenzo Malagrida,ITA,"MF,DF",Sampdoria,Serie A,18,2003,1.2,1,0,0,0,1,1,3,33.3,2,1,0,1,0,1,1,0,0,2022-2023,0.0,0.8333333333333334
1628,Daniel Maldini,ITA,"FW,MF",Spezia,Serie A,20,2001,7.0,12,5,3,4,5,4,11,36.4,7,9,0,9,1,13,8,0,0,2022-2023,0.14285714285714285,1.7142857142857142
1629,Youssef Maleh,MAR,MF,Fiorentina,Serie A,23,1998,3.3,3,1,0,3,0,0,4,0.0,4,5,0,5,1,4,3,0,0,2022-2023,0.30303030303030304,0.9090909090909092
1630,Youssef Maleh,MAR,MF,Lecce,Serie A,23,1998,7.5,17,8,3,7,7,6,14,42.9,8,20,1,19,5,22,10,0,0,2022-2023,0.6666666666666666,2.2666666666666666
1631,Donyell Malen,NED,FW,Dortmund,Bundesliga,23,1999,19.0,13,5,3,4,6,5,12,41.7,7,14,1,13,4,17,11,0,0,2022-2023,0.21052631578947367,0.6842105263157895
1632,Ruslan Malinovskyi,UKR,"MF,FW",Atalanta,Serie A,29,1993,6.1,14,8,5,6,3,6,17,35.3,11,8,1,7,5,19,2,0,0,2022-2023,0.819672131147541,2.295081967213115
1633,Ruslan Malinovskyi,UKR,"MF,FW",Marseille,Ligue 1,29,1993,13.6,21,11,3,12,6,10,26,38.5,16,13,1,12,3,24,9,0,0,2022-2023,0.22058823529411764,1.5441176470588236
1634,Hugo Mallo,ESP,DF,Celta Vigo,La Liga,31,1991,24.0,53,29,34,14,5,28,42,66.7,14,28,7,21,24,77,73,0,0,2022-2023,1.0,2.2083333333333335
1635,Mickael Malsa,MTQ,MF,Valladolid,La Liga,26,1995,0.8,2,2,1,1,0,1,4,25.0,3,1,1,0,2,4,3,0,0,2022-2023,2.5,2.5
1636,Giorgi Mamardashvili,GEO,GK,Valencia,La Liga,21,2000,38.0,0,0,0,0,0,0,0,0.0,0,0,0,0,1,1,11,4,0,2022-2023,0.02631578947368421,0.0
1637,Hianga Mananga Mbock,FRA,MF,Brest,Ligue 1,22,1999,0.2,0,0,0,0,0,0,1,0.0,1,0,0,0,0,0,0,0,0,2022-2023,0.0,0.0
1638,Gianluca Mancini,ITA,DF,Roma,Serie A,26,1996,31.8,37,19,27,9,1,18,34,52.9,16,38,17,21,46,83,67,0,0,2022-2023,1.4465408805031446,1.1635220125786163
1639,Steve Mandanda,FRA,GK,Rennes,Ligue 1,37,1985,33.5,0,0,0,0,0,0,2,0.0,2,0,0,0,0,0,9,3,0,2022-2023,0.0,0.0
1640,Reinildo Mandava,MOZ,DF,Atlético Madrid,La Liga,28,1994,20.6,66,43,46,19,1,38,49,77.6,11,27,12,15,30,96,59,0,0,2022-2023,1.4563106796116503,3.203883495145631
1641,Aïssa Mandi,ALG,DF,Villarreal,La Liga,30,1991,16.2,18,10,14,3,1,6,12,50.0,6,19,14,5,21,39,58,0,0,2022-2023,1.2962962962962963,1.1111111111111112
1642,Rolando Mandragora,ITA,MF,Fiorentina,Serie A,25,1997,21.7,42,24,12,22,8,23,52,44.2,29,25,3,22,16,58,21,0,0,2022-2023,0.7373271889400922,1.935483870967742
1643,Sadio Mané,SEN,"FW,MF",Bayern Munich,Bundesliga,30,1992,15.8,11,5,3,3,5,1,9,11.1,8,15,2,13,0,11,4,0,0,2022-2023,0.0,0.6962025316455696
1644,Orel Mangala,BEL,MF,Nott'ham Forest,Premier League,24,1998,17.2,28,20,16,10,2,12,29,41.4,17,21,7,14,23,51,15,0,0,2022-2023,1.3372093023255816,1.627906976744186
1645,Thomas Mangani,FRA,MF,Ajaccio,Ligue 1,35,1987,14.8,32,17,14,15,3,18,47,38.3,29,22,3,19,24,56,22,1,0,2022-2023,1.6216216216216215,2.162162162162162
1646,Vito Mannone,ITA,GK,Lorient,Ligue 1,34,1988,17.9,0,0,0,0,0,0,0,0.0,0,0,0,0,0,0,4,3,0,2022-2023,0.0,0.0
1647,Javier Manquillo,ESP,DF,Newcastle Utd,Premier League,28,1994,0.4,3,2,2,1,0,2,2,100.0,0,1,0,1,1,4,1,0,0,2022-2023,2.5,7.5
1648,Myziane Maolida,COM,"MF,FW",Reims,Ligue 1,23,1999,2.6,8,3,2,5,1,5,12,41.7,7,1,0,1,2,10,0,0,0,2022-2023,0.7692307692307692,3.0769230769230766
1649,Myziane Maolida,COM,"FW,MF",Hertha BSC,Bundesliga,23,1999,1.1,1,1,1,0,0,1,2,50.0,1,0,0,0,0,1,1,0,0,2022-2023,0.0,0.9090909090909091
1650,Faitout Maouassa,FRA,"FW,DF",Montpellier,Ligue 1,24,1998,21.4,52,32,26,20,6,18,41,43.9,23,31,3,28,20,72,23,0,0,2022-2023,0.9345794392523366,2.429906542056075
Rk,Player,Nation,Pos,Squad,Comp,0,0,90.0,0,0,3,3,3,Tkl,0,0.0,0,0,0,0,0,0,0,0,0,2022-2023,0.0,0.0
1651,Sekou Mara,FRA,"FW,MF",Southampton,Premier League,20,2002,6.2,14,10,5,8,1,3,9,33.3,6,11,0,11,1,15,5,0,0,2022-2023,0.16129032258064516,2.258064516129032
1652,Marcão,BRA,DF,Sevilla,La Liga,26,1996,4.2,2,2,1,1,0,1,1,100.0,0,3,3,0,6,8,14,0,0,2022-2023,1.4285714285714286,0.47619047619047616
1653,Solly March,ENG,"FW,DF",Brighton,Premier League,28,1994,30.2,53,31,16,17,20,8,28,28.6,20,34,3,31,24,77,32,0,0,2022-2023,0.794701986754967,1.7549668874172186
1654,Agustín Marchesín,ARG,GK,Celta Vigo,La Liga,34,1988,19.0,0,0,0,0,0,0,1,0.0,1,0,0,0,0,0,7,0,0,2022-2023,0.0,0.0
1655,Federico Marchetti,ITA,GK,Spezia,Serie A,39,1983,0.7,0,0,0,0,0,0,0,0.0,0,0,0,0,0,0,0,0,0,2022-2023,0.0,0.0
1656,Vincent Marchetti,FRA,MF,Ajaccio,Ligue 1,25,1997,27.2,55,26,29,19,7,25,68,36.8,43,23,3,20,19,74,31,0,0,2022-2023,0.698529411764706,2.0220588235294117
1657,Riccardo Marchizza,ITA,DF,Sassuolo,Serie A,24,1998,3.1,2,2,1,1,0,2,4,50.0,2,2,0,2,2,4,8,0,0,2022-2023,0.6451612903225806,0.6451612903225806
1658,Gian Marco Ferrari,ITA,DF,Sassuolo,Serie A,30,1992,24.7,23,16,11,10,2,10,17,58.8,7,29,20,9,23,46,81,4,0,2022-2023,0.9311740890688259,0.9311740890688259
1659,Emiliano Marcondes,DEN,MF,Bournemouth,Premier League,27,1995,0.1,0,0,0,0,0,0,0,0.0,0,0,0,0,0,0,1,0,0,2022-2023,0.0,0.0
1660,Óscar de Marcos,ESP,DF,Athletic Club,La Liga,33,1989,31.3,67,33,34,22,11,40,76,52.6,36,42,6,36,29,96,59,0,0,2022-2023,0.926517571884984,2.1405750798722045
1661,Alberto Marí,ESP,"FW,MF",Valencia,La Liga,21,2001,1.0,0,0,0,0,0,0,2,0.0,2,0,0,0,0,0,1,0,0,2022-2023,0.0,0.0
1662,José Mari,ESP,MF,Cádiz,La Liga,34,1987,4.4,16,7,12,3,1,10,16,62.5,6,3,1,2,5,21,9,0,0,2022-2023,1.1363636363636362,3.6363636363636362
1663,Pablo Marí,ESP,DF,Monza,Serie A,28,1993,27.6,37,19,29,7,1,17,26,65.4,9,22,14,8,31,68,111,3,0,2022-2023,1.1231884057971013,1.3405797101449275
1664,José María Giménez,URU,DF,Atlético Madrid,La Liga,27,1995,26.9,43,25,28,14,1,24,35,68.6,11,37,17,20,24,67,138,1,0,2022-2023,0.892193308550186,1.5985130111524164
1665,Mariano,DOM,FW,Real Madrid,La Liga,28,1993,1.7,1,0,0,1,0,0,0,0.0,0,1,0,1,0,1,0,0,0,2022-2023,0.0,0.5882352941176471
1666,Pablo Marín,ESP,"MF,FW",Real Sociedad,La Liga,19,2003,4.0,10,5,5,4,1,2,7,28.6,5,1,0,1,4,14,2,0,0,2022-2023,1.0,2.5
1667,Răzvan Marin,ROU,MF,Empoli,Serie A,26,1996,28.2,44,22,22,21,1,19,40,47.5,21,29,11,18,14,58,33,0,0,2022-2023,0.49645390070921985,1.5602836879432624
1668,Diego Mariño,ESP,GK,Almería,La Liga,32,1990,0.5,0,0,0,0,0,0,0,0.0,0,0,0,0,0,0,0,0,0,2022-2023,0.0,0.0
1669,Guillermo Maripán,CHI,DF,Monaco,Ligue 1,28,1994,24.0,46,26,26,20,0,17,33,51.5,16,39,27,12,38,84,87,0,0,2022-2023,1.5833333333333333,1.9166666666666667
1670,Marlon,BRA,DF,Monza,Serie A,26,1995,17.7,35,21,20,14,1,15,29,51.7,14,13,4,9,18,53,50,0,0,2022-2023,1.0169491525423728,1.9774011299435028
1671,Omar Marmoush,EGY,FW,Wolfsburg,Bundesliga,23,1999,16.4,16,10,8,2,6,4,16,25.0,12,21,1,20,7,23,4,0,0,2022-2023,0.426829268292683,0.9756097560975611
1672,Marquinhos,BRA,MF,Arsenal,Premier League,19,2003,0.0,0,0,0,0,0,0,0,0.0,0,0,0,0,0,0,0,0,0,2022-2023,,
1673,Marquinhos,BRA,DF,Paris S-G,Ligue 1,28,1994,30.2,33,25,18,12,3,18,26,69.2,8,43,27,16,23,56,83,2,0,2022-2023,0.7615894039735099,1.0927152317880795
1674,Luca Marrone,ITA,DF,Monza,Serie A,32,1990,1.5,0,0,0,0,0,0,2,0.0,2,2,2,0,0,0,4,1,0,2022-2023,0.0,0.0
1675,Eric Martel,GER,MF,Köln,Bundesliga,20,2002,22.4,66,41,29,30,7,30,60,50.0,30,29,9,20,33,99,49,0,0,2022-2023,1.4732142857142858,2.9464285714285716
Rk,Player,Nation,Pos,Squad,Comp,0,0,90.0,0,0,3,3,3,Tkl,0,0.0,0,0,0,0,0,0,0,0,0,2022-2023,0.0,0.0
1676,Roger Martí,ESP,FW,Elche,La Liga,31,1991,7.3,5,2,3,2,0,1,5,20.0,4,4,0,4,1,6,7,0,0,2022-2023,0.136986301369863,0.684931506849315
1677,Roger Martí,ESP,FW,Cádiz,La Liga,31,1991,7.1,6,4,2,3,1,1,8,12.5,7,7,0,7,2,8,7,0,0,2022-2023,0.28169014084507044,0.8450704225352114
1678,Anthony Martial,FRA,FW,Manchester Utd,Premier League,26,1995,10.9,5,3,0,2,3,1,4,25.0,3,11,2,9,1,6,4,0,0,2022-2023,0.09174311926605504,0.4587155963302752
1679,Aarón Martín,ESP,DF,Mainz 05,Bundesliga,25,1997,20.5,42,27,25,11,6,21,40,52.5,19,22,1,21,15,57,31,0,0,2022-2023,0.7317073170731707,2.048780487804878
1680,Ander Martin,ESP,"MF,FW",Real Sociedad,La Liga,21,2000,0.5,2,2,1,1,0,1,4,25.0,3,0,0,0,0,2,1,0,0,2022-2023,0.0,4.0
1681,Andrés Martín,ESP,"FW,MF",Rayo Vallecano,La Liga,23,1999,2.3,4,2,2,1,1,3,5,60.0,2,2,0,2,1,5,2,0,0,2022-2023,0.4347826086956522,1.7391304347826089
1682,Carlos Martín,ESP,"FW,MF",Atlético Madrid,La Liga,20,2002,0.3,2,2,0,2,0,2,3,66.7,1,0,0,0,1,3,0,0,0,2022-2023,3.3333333333333335,6.666666666666667
1683,Iván Martín,ESP,MF,Girona,La Liga,23,1999,17.6,9,7,4,4,1,8,23,34.8,15,12,0,12,9,18,12,0,0,2022-2023,0.5113636363636364,0.5113636363636364
1684,Jonas Martin,FRA,MF,Lille,Ligue 1,32,1990,3.1,9,7,4,5,0,5,14,35.7,9,3,1,2,7,16,3,0,0,2022-2023,2.258064516129032,2.903225806451613
1685,Gabriel Martinelli,BRA,FW,Arsenal,Premier League,21,2001,31.0,31,18,13,12,6,9,22,40.9,13,24,1,23,9,40,14,0,0,2022-2023,0.2903225806451613,1.0
1686,Arnau Martinez,ESP,DF,Girona,La Liga,19,2003,30.4,69,45,41,19,9,38,85,44.7,47,44,10,34,25,94,54,2,0,2022-2023,0.8223684210526316,2.2697368421052633
1687,Emiliano Martínez,ARG,GK,Aston Villa,Premier League,29,1992,34.9,0,0,0,0,0,0,2,0.0,2,0,0,0,1,1,23,1,0,2022-2023,0.02865329512893983,0.0
1688,Iñigo Martínez,ESP,DF,Athletic Club,La Liga,31,1991,14.9,18,8,11,7,0,6,9,66.7,3,17,11,6,18,36,55,0,0,2022-2023,1.2080536912751678,1.2080536912751678
1689,Lautaro Martínez,ARG,FW,Inter,Serie A,24,1997,28.6,25,14,3,15,7,7,23,30.4,16,31,1,30,13,38,16,1,0,2022-2023,0.45454545454545453,0.8741258741258741
1690,Lisandro Martínez,ARG,DF,Manchester Utd,Premier League,24,1998,23.5,54,28,33,18,3,30,43,69.8,13,51,27,24,33,87,103,0,0,2022-2023,1.4042553191489362,2.297872340425532
1691,Lucas Martínez Quarta,ARG,DF,Fiorentina,Serie A,26,1996,24.1,80,48,44,32,4,42,61,68.9,19,41,19,22,48,128,78,1,0,2022-2023,1.9917012448132778,3.3195020746887964
1692,Roger Martínez,ESP,DF,Espanyol,La Liga,18,2004,0.1,0,0,0,0,0,0,0,0.0,0,0,0,0,0,0,0,0,0,2022-2023,0.0,0.0
1693,Gelson Martins,POR,"MF,FW",Monaco,Ligue 1,27,1995,3.8,15,8,6,4,5,4,13,30.8,9,4,1,3,3,18,2,0,0,2022-2023,0.7894736842105263,3.947368421052632
1694,Adam Marušić,MNE,DF,Lazio,Serie A,29,1992,30.7,41,30,23,14,4,25,39,64.1,14,20,6,14,38,79,63,1,0,2022-2023,1.237785016286645,1.3355048859934853
1695,Omar Mascarell,EQG,"MF,DF",Elche,La Liga,29,1993,27.2,53,26,32,19,2,31,64,48.4,33,51,19,32,45,98,54,1,0,2022-2023,1.6544117647058825,1.9485294117647058
1696,Adam Masina,MAR,DF,Udinese,Serie A,28,1994,8.8,10,7,7,3,0,6,15,40.0,9,11,4,7,10,20,28,1,0,2022-2023,1.1363636363636362,1.1363636363636362
1697,Jordi Masip,ESP,GK,Valladolid,La Liga,33,1989,27.9,0,0,0,0,0,0,2,0.0,2,0,0,0,1,1,3,2,0,2022-2023,0.03584229390681004,0.0
1698,Erhan Mašović,SRB,"DF,MF",Bochum,Bundesliga,23,1998,24.2,50,31,28,21,1,30,51,58.8,21,30,14,16,27,77,79,0,0,2022-2023,1.115702479338843,2.066115702479339
1699,Han-Noah Massengo,FRA,MF,Auxerre,Ligue 1,21,2001,12.4,27,15,10,15,2,7,16,43.8,9,12,3,9,14,41,7,0,0,2022-2023,1.129032258064516,2.1774193548387095
1700,Yanis Massolin,FRA,MF,Clermont Foot,Ligue 1,19,2002,0.7,2,1,1,0,1,0,1,0.0,1,1,0,1,2,4,0,0,0,2022-2023,2.857142857142857,2.857142857142857
Rk,Player,Nation,Pos,Squad,Comp,0,0,90.0,0,0,3,3,3,Tkl,0,0.0,0,0,0,0,0,0,0,0,0,2022-2023,0.0,0.0
1701,Jaime Mata,ESP,"FW,MF",Getafe,La Liga,33,1988,4.9,13,10,4,5,4,7,22,31.8,15,7,2,5,3,16,6,0,0,2022-2023,0.6122448979591836,2.6530612244897958
1702,Pape Matar Sarr,SEN,"MF,FW",Tottenham,Premier League,19,2002,2.4,7,6,4,2,1,4,8,50.0,4,3,2,1,6,13,6,0,0,2022-2023,2.5,2.916666666666667
1703,Eliot Matazo,BEL,MF,Monaco,Ligue 1,20,2002,13.1,26,12,11,13,2,11,26,42.3,15,18,4,14,15,41,11,1,0,2022-2023,1.1450381679389314,1.984732824427481
1704,Jean-Philippe Mateta,FRA,FW,Crystal Palace,Premier League,25,1997,8.6,7,1,2,4,1,1,3,33.3,2,3,1,2,3,10,18,0,0,2022-2023,0.3488372093023256,0.813953488372093
1705,Nemanja Matić,SRB,MF,Roma,Serie A,33,1988,20.6,47,27,24,19,4,19,33,57.6,14,27,7,20,25,72,21,1,0,2022-2023,1.2135922330097086,2.2815533980582523
1706,Joël Matip,CMR,DF,Liverpool,Premier League,30,1991,12.1,14,8,12,2,0,11,23,47.8,12,8,3,5,21,35,45,3,0,2022-2023,1.7355371900826446,1.15702479338843
1707,Henning Matriciani,GER,DF,Schalke 04,Bundesliga,22,2000,20.7,43,23,28,12,3,26,60,43.3,34,28,11,17,23,66,57,1,0,2022-2023,1.1111111111111112,2.077294685990338
1708,Chrislain Matsima,FRA,"DF,MF",Lorient,Ligue 1,20,2002,2.5,0,0,0,0,0,0,0,0.0,0,3,3,0,2,2,7,0,0,2022-2023,0.8,0.0
1709,Chrislain Matsima,FRA,DF,Monaco,Ligue 1,20,2002,5.0,11,6,7,2,2,4,7,57.1,3,5,5,0,9,20,16,0,0,2022-2023,1.8,2.2
1710,Jean Mattéo Bahoya,FRA,"FW,MF",Angers,Ligue 1,17,2005,3.0,7,3,1,3,3,4,7,57.1,3,4,0,4,0,7,0,0,0,2022-2023,0.0,2.3333333333333335
1711,Azor Matusiwa,NED,MF,Reims,Ligue 1,24,1998,27.6,66,41,30,29,7,36,61,59.0,25,37,11,26,46,112,52,0,0,2022-2023,1.6666666666666665,2.391304347826087
1712,Neal Maupay,FRA,FW,Everton,Premier League,25,1996,12.4,11,5,3,4,4,2,4,50.0,2,8,0,8,5,16,0,0,0,2022-2023,0.4032258064516129,0.8870967741935484
1713,Aïman Maurer,MAR,MF,Clermont Foot,Ligue 1,17,2004,5.6,2,1,1,1,0,1,10,10.0,9,1,0,1,3,5,5,0,0,2022-2023,0.5357142857142857,0.35714285714285715
1714,Stephy Mavididi,ENG,FW,Montpellier,Ligue 1,24,1998,14.3,24,19,12,8,4,13,27,48.1,14,21,1,20,4,28,10,0,0,2022-2023,0.2797202797202797,1.6783216783216783
1715,Konstantinos Mavropanos,GRE,DF,Stuttgart,Bundesliga,24,1997,25.4,50,27,32,15,3,28,38,73.7,10,39,18,21,63,113,99,0,0,2022-2023,2.4803149606299213,1.968503937007874
1716,Christian Mawissa,FRA,DF,Toulouse,Ligue 1,17,2005,1.1,2,0,1,1,0,1,3,33.3,2,0,0,0,3,5,1,0,0,2022-2023,2.727272727272727,1.8181818181818181
1717,Philipp Max,GER,DF,Eint Frankfurt,Bundesliga,28,1993,7.7,12,9,4,7,1,5,16,31.3,11,10,2,8,3,15,11,0,0,2022-2023,0.38961038961038963,1.5584415584415585
1718,Eric Maxim Choupo-Moting,CMR,FW,Bayern Munich,Bundesliga,33,1989,12.4,10,7,2,6,2,1,2,50.0,1,8,0,8,0,10,5,0,0,2022-2023,0.0,0.8064516129032258
1719,Luís Maximiano,POR,GK,Lazio,Serie A,23,1999,0.1,0,0,0,0,0,0,0,0.0,0,0,0,0,0,0,0,0,0,2022-2023,0.0,0.0
1720,Keke Maximilian Topp,GER,FW,Schalke 04,Bundesliga,18,2004,0.2,0,0,0,0,0,0,0,0.0,0,0,0,0,1,1,0,0,0,2022-2023,5.0,0.0
1721,Fernand Mayembo,CGO,DF,Ajaccio,Ligue 1,26,1996,7.9,8,5,6,2,0,4,9,44.4,5,2,0,2,11,19,36,0,0,2022-2023,1.3924050632911391,1.0126582278481011
1722,Borja Mayoral,ESP,FW,Getafe,La Liga,25,1997,30.7,9,4,7,2,0,5,31,16.1,26,18,0,18,3,12,10,0,0,2022-2023,0.09771986970684039,0.2931596091205212
1723,Ibrahim Maza,GER,"MF,FW",Hertha BSC,Bundesliga,16,2005,0.8,1,1,1,0,0,0,1,0.0,1,2,0,2,0,1,1,0,0,2022-2023,0.0,1.25
1724,Derek Mazou-Sacko,FRA,MF,Troyes,Ligue 1,17,2004,0.2,0,0,0,0,0,0,1,0.0,1,1,0,1,1,1,1,0,0,2022-2023,5.0,0.0
1725,Noussair Mazraoui,MAR,DF,Bayern Munich,Bundesliga,24,1997,11.9,29,21,9,9,11,15,24,62.5,9,13,2,11,10,39,25,0,0,2022-2023,0.8403361344537815,2.436974789915966
Rk,Player,Nation,Pos,Squad,Comp,0,0,90.0,0,0,3,3,3,Tkl,0,0.0,0,0,0,0,0,0,0,0,0,2022-2023,0.0,0.0
1726,Pasquale Mazzocchi,ITA,DF,Salernitana,Serie A,27,1995,21.8,32,18,21,5,6,17,37,45.9,20,10,2,8,10,42,37,2,0,2022-2023,0.4587155963302752,1.4678899082568806
1727,Kevin Mbabu,SUI,"DF,FW",Fulham,Premier League,27,1995,1.6,3,2,2,1,0,1,3,33.3,2,2,0,2,3,6,3,0,0,2022-2023,1.875,1.875
1728,Noah Mbamba,BEL,MF,Leverkusen,Bundesliga,17,2005,0.0,0,0,0,0,0,0,0,0.0,0,0,0,0,0,0,0,0,0,2022-2023,,
1729,Kylian Mbappé,FRA,FW,Paris S-G,Ligue 1,23,1998,31.3,10,4,0,5,5,5,16,31.3,11,5,0,5,5,15,6,0,0,2022-2023,0.1597444089456869,0.3194888178913738
1730,Mamadou Mbaye,SEN,DF,Cádiz,La Liga,24,1998,8.4,10,7,7,3,0,6,8,75.0,2,10,8,2,7,17,50,1,0,2022-2023,0.8333333333333333,1.1904761904761905
1731,Chancel Mbemba,COD,DF,Marseille,Ligue 1,27,1994,31.7,43,26,24,17,2,22,31,71.0,9,25,12,13,42,85,89,0,0,2022-2023,1.3249211356466877,1.3564668769716088
1732,Bryan Mbeumo,CMR,FW,Brentford,Premier League,22,1999,32.3,26,18,5,13,8,8,42,19.0,34,24,1,23,13,39,21,0,0,2022-2023,0.40247678018575855,0.8049535603715171
1733,Jason Mbock,FRA,"MF,FW",Angers,Ligue 1,22,1999,0.3,0,0,0,0,0,0,0,0.0,0,0,0,0,0,0,0,0,0,2022-2023,0.0,0.0
1734,Jean-Manuel Mbom,GER,MF,Werder Bremen,Bundesliga,22,2000,0.1,0,0,0,0,0,0,1,0.0,1,0,0,0,0,0,0,0,0,2022-2023,0.0,0.0
1735,Nathanael Mbuku,FRA,"FW,MF",Reims,Ligue 1,20,2002,0.7,2,1,2,0,0,2,2,100.0,0,0,0,0,0,2,0,0,0,2022-2023,0.0,2.857142857142857
1736,Nathanael Mbuku,FRA,"MF,FW",Augsburg,Bundesliga,20,2002,0.4,1,0,0,1,0,0,0,0.0,0,0,0,0,0,1,0,0,0,2022-2023,0.0,2.5
1737,James McArthur,SCO,MF,Crystal Palace,Premier League,34,1987,0.6,1,1,1,0,0,1,1,100.0,0,2,1,1,1,2,2,0,0,2022-2023,1.6666666666666667,1.6666666666666667
1738,Alex McCarthy,ENG,GK,Southampton,Premier League,32,1989,6.0,0,0,0,0,0,0,1,0.0,1,0,0,0,1,1,3,1,0,2022-2023,0.16666666666666666,0.0
1739,John McGinn,SCO,"MF,FW",Aston Villa,Premier League,27,1994,29.9,66,36,27,29,10,34,71,47.9,37,43,4,39,24,90,19,0,0,2022-2023,0.802675585284281,2.207357859531773
1740,Scott McKenna,SCO,DF,Nott'ham Forest,Premier League,25,1996,17.5,12,7,7,3,2,6,10,60.0,4,20,14,6,12,24,85,1,0,2022-2023,0.6857142857142857,0.6857142857142857
1741,Weston McKennie,USA,MF,Leeds United,Premier League,23,1998,16.0,30,13,5,18,7,10,29,34.5,19,22,3,19,22,52,26,0,0,2022-2023,1.375,1.875
1742,Weston McKennie,USA,"MF,DF",Juventus,Serie A,23,1998,11.7,14,5,3,9,2,5,8,62.5,3,15,4,11,11,25,15,1,0,2022-2023,0.9401709401709403,1.1965811965811965
1743,Dwight McNeil,ENG,"FW,MF",Everton,Premier League,22,1999,27.8,64,41,35,14,15,27,65,41.5,38,46,7,39,31,95,41,0,0,2022-2023,1.1151079136690647,2.302158273381295
1744,Scott McTominay,SCO,MF,Manchester Utd,Premier League,25,1996,12.9,32,19,16,10,6,13,22,59.1,9,15,6,9,14,46,45,1,0,2022-2023,1.0852713178294573,2.4806201550387597
1745,Gary Medel,CHI,"MF,DF",Bologna,Serie A,34,1987,16.4,25,15,16,7,2,9,16,56.3,7,17,10,7,28,53,34,0,0,2022-2023,1.707317073170732,1.524390243902439
1746,Facundo Medina,ARG,DF,Lens,Ligue 1,23,1999,30.9,31,20,16,15,0,13,35,37.1,22,25,9,16,26,57,62,1,0,2022-2023,0.8414239482200647,1.0032362459546926
1747,Fernando Medrano,ESP,DF,Celta Vigo,La Liga,22,2000,0.1,2,1,2,0,0,1,1,100.0,0,0,0,0,1,3,1,0,0,2022-2023,10.0,20.0
1748,Ben Mee,ENG,DF,Brentford,Premier League,32,1989,36.3,45,24,28,13,4,20,37,54.1,17,54,42,12,48,93,122,2,0,2022-2023,1.322314049586777,1.2396694214876034
1749,Bamo Meïté,CIV,DF,Lorient,Ligue 1,20,2001,16.7,18,8,13,4,1,7,16,43.8,9,33,23,10,16,34,70,0,0,2022-2023,0.9580838323353293,1.0778443113772456
1750,Soualiho Meïté,FRA,MF,Cremonese,Serie A,28,1994,26.3,47,31,25,15,7,22,46,47.8,24,27,6,21,27,74,36,0,0,2022-2023,1.026615969581749,1.7870722433460076
Rk,Player,Nation,Pos,Squad,Comp,0,0,90.0,0,0,3,3,3,Tkl,0,0.0,0,0,0,0,0,0,0,0,0,2022-2023,0.0,0.0
1751,Farid El Melali,ALG,"DF,FW",Angers,Ligue 1,25,1997,9.0,21,12,7,12,2,11,22,50.0,11,16,0,16,8,29,7,0,0,2022-2023,0.8888888888888888,2.3333333333333335
1752,Gonzalo Melero,ESP,MF,Almería,La Liga,28,1994,20.6,32,16,9,18,5,11,39,28.2,28,23,2,21,7,39,19,1,0,2022-2023,0.3398058252427184,1.5533980582524272
1753,Birger Meling,NOR,DF,Rennes,Ligue 1,27,1994,13.4,24,15,9,12,3,12,25,48.0,13,18,2,16,23,47,26,0,0,2022-2023,1.716417910447761,1.791044776119403
1754,Memphis,NED,FW,Atlético Madrid,La Liga,28,1994,3.0,1,0,0,0,1,0,1,0.0,1,0,0,0,0,1,0,0,0,2022-2023,0.0,0.3333333333333333
1755,Memphis,NED,FW,Barcelona,La Liga,28,1994,1.3,1,1,1,0,0,0,1,0.0,1,0,0,0,0,1,0,0,0,2022-2023,0.0,0.7692307692307692
1756,Houboulang Mendes,GNB,DF,Almería,La Liga,24,1998,9.8,19,11,16,3,0,11,27,40.7,16,12,2,10,7,26,23,1,0,2022-2023,0.7142857142857142,1.9387755102040816
1757,Nuno Mendes,POR,DF,Paris S-G,Ligue 1,20,2002,17.2,45,30,29,12,4,30,41,73.2,11,19,3,16,17,62,18,0,0,2022-2023,0.9883720930232559,2.616279069767442
1758,Pedro Mendes,POR,DF,Montpellier,Ligue 1,31,1990,0.1,0,0,0,0,0,0,0,0.0,0,0,0,0,0,0,0,1,0,2022-2023,0.0,0.0
1759,Thiago Mendes,BRA,"MF,DF",Lyon,Ligue 1,30,1992,22.9,48,27,24,21,3,30,40,75.0,10,28,8,20,47,95,51,4,0,2022-2023,2.052401746724891,2.096069868995633
1760,Brais Méndez,ESP,MF,Real Sociedad,La Liga,25,1997,26.7,58,34,18,30,10,24,64,37.5,40,27,3,24,12,70,14,1,0,2022-2023,0.449438202247191,2.1722846441947565
1761,Diego Méndez,ESP,MF,Rayo Vallecano,La Liga,18,2003,0.0,0,0,0,0,0,0,0,0.0,0,0,0,0,1,1,0,0,0,2022-2023,inf,
1762,Antoine Mendy,FRA,DF,Nice,Ligue 1,18,2004,5.8,22,13,16,5,1,9,15,60.0,6,6,1,5,2,24,16,0,0,2022-2023,0.3448275862068966,3.793103448275862
1763,Arial Mendy,SEN,DF,Clermont Foot,Ligue 1,27,1994,2.5,4,2,3,0,1,2,2,100.0,0,2,0,2,4,8,4,0,0,2022-2023,1.6,1.6
1764,Batista Mendy,FRA,"MF,DF",Angers,Ligue 1,22,2000,31.8,70,30,34,28,8,37,53,69.8,16,38,6,32,21,91,29,2,0,2022-2023,0.660377358490566,2.20125786163522
1765,Edouard Mendy,SEN,GK,Chelsea,Premier League,30,1992,9.5,0,0,0,0,0,0,0,0.0,0,0,0,0,0,0,3,3,0,2022-2023,0.0,0.0
1766,Ferland Mendy,FRA,DF,Real Madrid,La Liga,27,1995,15.0,21,12,14,6,1,12,20,60.0,8,7,2,5,14,35,16,0,0,2022-2023,0.9333333333333333,1.4
1767,Nampalys Mendy,SEN,MF,Leicester City,Premier League,30,1992,8.4,13,9,7,6,0,8,15,53.3,7,20,4,16,13,26,2,0,0,2022-2023,1.5476190476190474,1.5476190476190474
1768,Gideon Mensah,GHA,DF,Auxerre,Ligue 1,24,1998,25.1,80,44,43,32,5,44,77,57.1,33,33,10,23,38,118,41,0,0,2022-2023,1.5139442231075697,3.187250996015936
1769,Chris Mepham,WAL,DF,Bournemouth,Premier League,24,1997,24.4,45,22,37,8,0,19,30,63.3,11,40,27,13,30,75,152,0,0,2022-2023,1.2295081967213115,1.8442622950819674
1770,Jorge Meré,ESP,DF,Cádiz,La Liga,25,1997,6.7,11,7,9,2,0,5,8,62.5,3,9,6,3,6,17,32,0,0,2022-2023,0.8955223880597015,1.6417910447761193
1771,Alex Meret,ITA,GK,Napoli,Serie A,25,1997,34.0,0,0,0,0,0,0,0,0.0,0,0,0,0,0,0,6,1,0,2022-2023,0.0,0.0
1772,Mikel Merino,ESP,MF,Real Sociedad,La Liga,26,1996,27.7,77,49,28,33,16,31,62,50.0,31,38,8,30,20,97,51,1,0,2022-2023,0.7220216606498195,2.779783393501805
1773,Quentin Merlin,FRA,DF,Nantes,Ligue 1,20,2002,19.9,31,19,19,8,4,18,38,47.4,20,27,4,23,24,55,30,0,0,2022-2023,1.206030150753769,1.5577889447236182
1774,Yıldırım Mert Çetin,TUR,DF,Lecce,Serie A,25,1997,0.2,1,0,1,0,0,0,0,0.0,0,0,0,0,1,2,1,0,0,2022-2023,5.0,5.0
1775,Roque Mesa,ESP,MF,Valladolid,La Liga,33,1989,18.0,27,15,16,10,1,12,38,31.6,26,16,4,12,13,40,18,0,0,2022-2023,0.7222222222222222,1.5
Rk,Player,Nation,Pos,Squad,Comp,0,0,90.0,0,0,3,3,3,Tkl,0,0.0,0,0,0,0,0,0,0,0,0,2022-2023,0.0,0.0
1776,Illan Meslier,FRA,GK,Leeds United,Premier League,22,2000,34.0,2,1,2,0,0,2,4,50.0,2,0,0,0,1,3,30,3,0,2022-2023,0.029411764705882353,0.058823529411764705
1777,Lionel Messi,ARG,"FW,MF",Paris S-G,Ligue 1,35,1987,31.5,26,18,1,13,12,11,27,40.7,16,11,0,11,2,28,0,0,0,2022-2023,0.06349206349206349,0.8253968253968254
1778,Junior Messias,BRA,"FW,DF",Milan,Serie A,31,1991,16.6,24,18,9,9,6,5,19,26.3,14,20,4,16,7,31,28,0,0,2022-2023,0.4216867469879518,1.4457831325301203
1779,Amine Messoussa,FRA,FW,Lille,Ligue 1,17,2004,0.0,0,0,0,0,0,0,0,0.0,0,0,0,0,0,0,0,0,0,2022-2023,,
1780,Thomas Meunier,BEL,DF,Dortmund,Bundesliga,30,1991,6.5,16,7,8,5,3,10,17,58.8,7,7,2,5,9,25,16,0,0,2022-2023,1.3846153846153846,2.4615384615384617
1781,Alexander Meyer,GER,GK,Dortmund,Bundesliga,31,1991,7.0,0,0,0,0,0,0,1,0.0,1,0,0,0,0,0,1,0,0,2022-2023,0.0,0.0
1782,Sven Michel,GER,"FW,MF",Union Berlin,Bundesliga,32,1990,5.5,9,5,1,5,3,4,8,50.0,4,5,1,4,0,9,4,0,0,2022-2023,0.0,1.6363636363636365
1783,Alex Mighten,ENG,FW,Nott'ham Forest,Premier League,20,2002,0.1,0,0,0,0,0,0,1,0.0,1,0,0,0,0,0,0,0,0,2022-2023,0.0,0.0
1784,Tommaso Milanese,ITA,MF,Cremonese,Serie A,20,2002,0.3,0,0,0,0,0,0,0,0.0,0,1,1,0,0,0,0,0,0,2022-2023,0.0,0.0
1785,Nikola Milenković,SRB,DF,Fiorentina,Serie A,24,1997,23.7,40,25,20,17,3,18,27,66.7,9,27,14,13,22,62,72,0,0,2022-2023,0.9282700421940928,1.6877637130801688
1786,Lewis Miley,ENG,MF,Newcastle Utd,Premier League,16,2006,0.2,0,0,0,0,0,0,0,0.0,0,1,0,1,0,0,0,0,0,2022-2023,0.0,0.0
1787,Arkadiusz Milik,POL,FW,Juventus,Serie A,28,1994,17.6,12,8,2,8,2,2,8,25.0,6,10,1,9,1,13,14,0,0,2022-2023,0.056818181818181816,0.6818181818181818
1788,Arkadiusz Milik,POL,FW,Marseille,Ligue 1,28,1994,1.4,1,1,0,0,1,0,1,0.0,1,0,0,0,0,1,2,0,0,2022-2023,0.0,0.7142857142857143
1789,Sergej Milinković-Savić,SRB,MF,Lazio,Serie A,27,1995,33.6,58,35,22,23,13,24,67,35.8,43,50,12,38,28,86,49,0,0,2022-2023,0.8333333333333333,1.726190476190476
1790,Vanja Milinković-Savić,SRB,GK,Torino,Serie A,25,1997,38.0,2,1,2,0,0,2,2,100.0,0,0,0,0,1,3,19,1,0,2022-2023,0.02631578947368421,0.05263157894736842
1791,Éder Militão,BRA,DF,Real Madrid,La Liga,24,1998,30.0,46,32,25,18,3,26,33,78.8,7,67,39,28,42,88,104,2,0,2022-2023,1.4,1.5333333333333334
1792,Luka Milivojević,SRB,MF,Crystal Palace,Premier League,31,1991,5.7,13,7,7,4,2,7,10,70.0,3,13,4,9,12,25,10,1,0,2022-2023,2.1052631578947367,2.280701754385965
1793,Luis Milla,ESP,MF,Getafe,La Liga,27,1994,20.6,48,30,21,18,9,19,44,43.2,25,13,1,12,32,80,25,1,0,2022-2023,1.5533980582524272,2.3300970873786406
1794,Pere Milla,ESP,"FW,MF",Elche,La Liga,29,1992,20.5,31,20,18,8,5,14,41,34.1,27,18,3,15,9,40,19,1,0,2022-2023,0.43902439024390244,1.5121951219512195
1795,Enzo Millot,FRA,MF,Stuttgart,Bundesliga,20,2002,9.9,23,16,9,10,4,12,19,63.2,7,20,3,17,12,35,7,0,0,2022-2023,1.2121212121212122,2.323232323232323
1796,James Milner,ENG,"MF,DF",Liverpool,Premier League,36,1986,10.1,26,16,11,11,4,15,34,44.1,19,14,2,12,12,38,15,0,0,2022-2023,1.188118811881188,2.5742574257425743
1797,Marko Milovanović,SRB,FW,Almería,La Liga,18,2003,0.2,0,0,0,0,0,0,0,0.0,0,0,0,0,0,0,0,0,0,2022-2023,0.0,0.0
1798,Kim Min-jae,KOR,DF,Napoli,Serie A,25,1996,33.9,55,30,32,22,1,25,29,86.2,4,36,26,10,41,96,123,1,0,2022-2023,1.2094395280235988,1.6224188790560472
1799,Yerry Mina,COL,DF,Everton,Premier League,27,1994,6.6,15,8,9,6,0,9,11,81.8,2,7,4,3,6,21,28,0,0,2022-2023,0.9090909090909092,2.272727272727273
1800,Takumi Minamino,JPN,"MF,FW",Monaco,Ligue 1,27,1995,8.0,15,8,5,7,3,7,35,20.0,28,14,0,14,6,21,4,0,0,2022-2023,0.75,1.875
Rk,Player,Nation,Pos,Squad,Comp,0,0,90.0,0,0,3,3,3,Tkl,0,0.0,0,0,0,0,0,0,0,0,0,2022-2023,0.0,0.0
1801,Tyrone Mings,ENG,DF,Aston Villa,Premier League,29,1993,35.0,15,7,10,5,0,9,20,45.0,11,40,21,19,54,69,163,2,0,2022-2023,1.542857142857143,0.42857142857142855
1802,Óscar Mingueza,ESP,DF,Celta Vigo,La Liga,23,1999,14.3,37,21,27,9,1,25,32,78.1,7,10,4,6,12,49,25,0,0,2022-2023,0.8391608391608392,2.5874125874125875
1803,Rafa Mir,ESP,FW,Sevilla,La Liga,25,1997,14.4,8,2,2,4,2,2,5,40.0,3,5,1,4,4,12,11,0,0,2022-2023,0.2777777777777778,0.5555555555555556
1804,Aleksei Miranchuk,RUS,MF,Torino,Serie A,26,1995,23.2,11,5,3,4,4,3,11,27.3,8,11,0,11,2,13,5,0,0,2022-2023,0.08620689655172414,0.47413793103448276
1805,Juan Miranda,ESP,DF,Betis,La Liga,22,2000,16.4,23,16,16,6,1,14,29,48.3,15,20,7,13,20,43,63,0,0,2022-2023,1.2195121951219514,1.402439024390244
1806,Antonio Mirante,ITA,GK,Milan,Serie A,39,1983,0.0,0,0,0,0,0,0,0,0.0,0,0,0,0,0,0,0,0,0,2022-2023,,
1807,Fabio Miretti,ITA,"MF,FW",Juventus,Serie A,18,2003,13.7,24,11,15,6,3,12,29,41.4,17,20,1,19,4,28,11,0,0,2022-2023,0.29197080291970806,1.7518248175182483
1808,Filippo Missori,ITA,DF,Roma,Serie A,18,2004,2.0,4,3,3,0,1,3,6,50.0,3,0,0,0,3,7,5,0,0,2022-2023,1.5,2.0
1809,Tyrick Mitchell,ENG,DF,Crystal Palace,Premier League,22,1999,32.1,71,49,43,23,5,30,53,56.6,23,48,11,37,42,113,78,0,0,2022-2023,1.308411214953271,2.2118380062305296
1810,Kaoru Mitoma,JPN,"FW,MF",Brighton,Premier League,25,1997,25.8,44,27,15,16,13,20,41,48.8,21,25,0,25,17,61,10,0,0,2022-2023,0.6589147286821705,1.7054263565891472
1811,Aleksandar Mitrović,SRB,FW,Fulham,Premier League,27,1994,22.3,14,7,8,4,2,5,12,41.7,7,22,5,17,3,17,20,1,0,2022-2023,0.13452914798206278,0.6278026905829596
1812,Stefan Mitrović,SRB,DF,Getafe,La Liga,32,1990,18.7,14,6,12,2,0,7,11,63.6,4,12,10,2,17,31,90,2,0,2022-2023,0.9090909090909092,0.7486631016042781
1813,Maximilian Mittelstädt,GER,"DF,MF",Hertha BSC,Bundesliga,25,1997,9.4,39,20,31,6,2,17,39,43.6,22,13,2,11,26,65,27,0,0,2022-2023,2.7659574468085104,4.148936170212766
1814,Henrikh Mkhitaryan,ARM,MF,Inter,Serie A,33,1989,22.1,41,26,13,22,6,14,41,34.1,27,27,4,23,21,62,18,0,0,2022-2023,0.9502262443438914,1.855203619909502
1815,Anthony Modeste,FRA,FW,Dortmund,Bundesliga,34,1988,9.0,4,4,2,0,2,2,5,40.0,3,7,0,7,2,6,22,0,0,2022-2023,0.2222222222222222,0.4444444444444444
1816,Luka Modrić,CRO,MF,Real Madrid,La Liga,36,1985,19.4,19,9,6,6,7,10,25,40.0,15,15,5,10,10,29,7,0,0,2022-2023,0.5154639175257733,0.9793814432989691
1817,Terem Moffi,NGA,FW,Nice,Ligue 1,23,1999,14.8,12,6,0,6,6,2,12,16.7,10,3,0,3,2,14,5,0,0,2022-2023,0.13513513513513511,0.8108108108108107
1818,Terem Moffi,NGA,FW,Lorient,Ligue 1,23,1999,15.4,8,5,1,4,3,3,5,60.0,2,11,3,8,3,11,10,0,0,2022-2023,0.19480519480519481,0.5194805194805194
1819,Mostafa Mohamed,EGY,FW,Nantes,Ligue 1,24,1997,21.5,18,13,5,7,6,9,20,45.0,11,23,1,22,10,28,33,0,0,2022-2023,0.46511627906976744,0.8372093023255814
1820,Tobias Mohr,GER,"DF,MF",Schalke 04,Bundesliga,26,1995,9.3,8,5,3,5,0,2,7,28.6,5,14,5,9,8,16,19,0,0,2022-2023,0.8602150537634408,0.8602150537634408
1821,Johan Mojica,COL,DF,Villarreal,La Liga,29,1992,7.1,13,9,9,3,1,5,9,55.6,4,8,3,5,4,17,14,1,0,2022-2023,0.5633802816901409,1.8309859154929577
1822,Johan Mojica,COL,"DF,MF",Elche,La Liga,29,1992,3.0,6,3,5,1,0,2,3,66.7,1,3,2,1,4,10,5,0,0,2022-2023,1.3333333333333333,2.0
1823,Clinton Mola,ENG,DF,Stuttgart,Bundesliga,21,2001,0.2,3,1,2,1,0,1,1,100.0,0,1,1,0,1,4,2,0,0,2022-2023,5.0,15.0
1824,Nahuel Molina,ARG,DF,Atlético Madrid,La Liga,24,1998,31.9,69,43,38,18,13,39,91,42.9,52,38,7,31,18,87,63,1,0,2022-2023,0.5642633228840126,2.1630094043887147
1825,Salvatore Molina,ITA,DF,Monza,Serie A,30,1992,2.5,6,5,2,4,0,4,5,80.0,1,4,2,2,1,7,2,0,0,2022-2023,0.4,2.4
Rk,Player,Nation,Pos,Squad,Comp,0,0,90.0,0,0,3,3,3,Tkl,0,0.0,0,0,0,0,0,0,0,0,0,2022-2023,0.0,0.0
1826,Florent Mollet,FRA,MF,Nantes,Ligue 1,30,1991,12.1,14,6,5,4,5,7,24,29.2,17,12,1,11,10,24,11,0,0,2022-2023,0.8264462809917356,1.15702479338843
1827,Florent Mollet,FRA,MF,Schalke 04,Bundesliga,30,1991,4.6,4,1,0,4,0,2,7,28.6,5,7,1,6,1,5,1,0,0,2022-2023,0.2173913043478261,0.8695652173913044
1828,Jon Moncayola,ESP,"MF,DF",Osasuna,La Liga,24,1998,27.2,55,39,24,22,9,30,76,39.5,46,37,5,32,17,72,32,2,0,2022-2023,0.625,2.0220588235294117
1829,Monchu,ESP,MF,Valladolid,La Liga,22,1999,22.6,50,29,20,21,9,19,46,41.3,27,28,11,17,18,68,22,1,0,2022-2023,0.7964601769911503,2.2123893805309733
1830,César Montes,MEX,DF,Espanyol,La Liga,25,1997,17.7,17,9,10,7,0,10,18,55.6,8,19,12,7,14,31,101,0,0,2022-2023,0.7909604519774012,0.96045197740113
1831,Daniele Montevago,ITA,FW,Sampdoria,Serie A,19,2003,2.6,1,0,0,0,1,0,1,0.0,1,2,1,1,0,1,1,0,0,2022-2023,0.0,0.3846153846153846
1832,Gonzalo Montiel,ARG,DF,Sevilla,La Liga,25,1997,16.9,26,15,12,14,0,15,29,51.7,14,25,7,18,19,45,38,0,0,2022-2023,1.124260355029586,1.5384615384615385
1833,Lorenzo Montipò,ITA,GK,Hellas Verona,Serie A,26,1996,37.0,1,0,1,0,0,0,3,0.0,3,1,0,1,0,1,26,3,0,2022-2023,0.0,0.02702702702702703
1834,Martín Montoya,ESP,DF,Betis,La Liga,31,1991,5.0,13,8,9,4,0,10,12,83.3,2,6,1,5,9,22,14,1,0,2022-2023,1.8,2.6
1835,Kieffer Moore,WAL,FW,Bournemouth,Premier League,29,1992,14.2,14,11,2,9,3,5,16,31.3,11,12,5,7,1,15,26,0,0,2022-2023,0.07042253521126761,0.9859154929577465
1836,Andrew Moran,IRL,FW,Brighton,Premier League,18,2003,0.1,0,0,0,0,0,0,0,0.0,0,1,0,1,0,0,0,0,0,2022-2023,0.0,0.0
1837,Álvaro Morata,ESP,FW,Atlético Madrid,La Liga,29,1992,21.1,16,11,4,8,4,3,8,37.5,5,11,3,8,0,16,23,0,0,2022-2023,0.0,0.7582938388625592
1838,Jon Morcillo,ESP,"FW,MF",Athletic Club,La Liga,23,1998,0.8,1,0,1,0,0,0,1,0.0,1,0,0,0,1,2,0,0,0,2022-2023,1.25,1.25
1839,Alberto Moreno,ESP,DF,Villarreal,La Liga,30,1992,14.4,23,12,10,10,3,11,24,45.8,13,12,1,11,23,46,26,0,0,2022-2023,1.597222222222222,1.597222222222222
1840,Álex Moreno,ESP,DF,Aston Villa,Premier League,29,1993,14.8,23,14,15,5,3,13,36,36.1,23,18,3,15,7,30,37,2,0,2022-2023,0.47297297297297297,1.554054054054054
1841,Álex Moreno,ESP,DF,Betis,La Liga,29,1993,15.0,29,22,19,10,0,18,36,50.0,18,17,4,13,17,46,39,0,0,2022-2023,1.1333333333333333,1.9333333333333333
1842,Diego Moreno,ESP,DF,Osasuna,La Liga,21,2001,7.1,4,4,2,2,0,3,8,37.5,5,7,4,3,5,9,21,0,0,2022-2023,0.7042253521126761,0.5633802816901409
1843,Gerard Moreno,ESP,FW,Villarreal,La Liga,30,1992,13.7,11,6,0,6,5,3,6,50.0,3,6,2,4,5,16,10,0,0,2022-2023,0.36496350364963503,0.8029197080291971
1844,Marlos Moreno,COL,"MF,DF",Troyes,Ligue 1,25,1996,0.1,2,2,2,0,0,2,3,66.7,1,1,1,0,0,2,0,0,0,2022-2023,0.0,20.0
1845,Tete Morente,ESP,"MF,DF",Elche,La Liga,25,1996,23.0,33,21,18,13,2,15,36,41.7,21,23,3,20,25,58,28,0,0,2022-2023,1.0869565217391304,1.434782608695652
1846,Ilaix Moriba,GUI,MF,Valencia,La Liga,19,2003,11.2,35,16,14,17,4,14,24,58.3,10,11,1,10,4,39,12,0,0,2022-2023,0.35714285714285715,3.125
1847,Manu Morlanes,ESP,MF,Villarreal,La Liga,23,1999,1.8,3,2,2,1,0,3,3,100.0,0,3,2,1,1,4,2,0,0,2022-2023,0.5555555555555556,1.6666666666666665
1848,Manu Morlanes,ESP,MF,Mallorca,La Liga,23,1999,7.8,22,9,12,8,2,13,24,54.2,11,10,5,5,5,27,9,0,0,2022-2023,0.6410256410256411,2.8205128205128207
1849,Nikola Moro,CRO,MF,Bologna,Serie A,24,1998,13.6,32,21,11,15,6,14,36,38.9,22,15,2,13,8,40,18,0,0,2022-2023,0.5882352941176471,2.3529411764705883
1850,Loren Morón,ESP,FW,Betis,La Liga,28,1993,0.2,2,2,0,1,1,0,0,0.0,0,0,0,0,0,2,1,0,0,2022-2023,0.0,10.0
Rk,Player,Nation,Pos,Squad,Comp,0,0,90.0,0,0,3,3,3,Tkl,0,0.0,0,0,0,0,0,0,0,0,0,2022-2023,0.0,0.0
1851,Cristhian Mosquera,ESP,DF,Valencia,La Liga,18,2004,1.6,4,2,3,1,0,4,5,80.0,1,1,0,1,1,5,5,0,0,2022-2023,0.625,2.5
1852,Dany Mota,POR,"FW,MF",Monza,Serie A,24,1998,21.2,8,7,1,3,4,2,10,20.0,8,5,1,4,6,14,25,0,0,2022-2023,0.2830188679245283,0.37735849056603776
1853,Lebo Mothiba,RSA,"FW,MF",Strasbourg,Ligue 1,26,1996,4.8,1,0,1,0,0,0,1,0.0,1,6,1,5,0,1,4,0,0,2022-2023,0.0,0.20833333333333334
1854,Youssoufa Moukoko,GER,FW,Dortmund,Bundesliga,17,2004,12.7,13,7,3,6,4,3,6,50.0,3,9,0,9,2,15,1,0,0,2022-2023,0.15748031496062992,1.0236220472440944
1855,Steve Mounié,BEN,FW,Brest,Ligue 1,27,1994,18.4,13,5,1,7,5,5,14,35.7,9,18,7,11,3,16,20,0,0,2022-2023,0.16304347826086957,0.7065217391304348
1856,Mason Mount,ENG,"MF,FW",Chelsea,Premier League,23,1999,18.3,33,19,6,16,11,14,27,51.9,13,24,6,18,8,41,9,0,0,2022-2023,0.4371584699453552,1.8032786885245902
1857,Lucas Moura,BRA,"MF,DF",Tottenham,Premier League,29,1992,1.7,8,5,1,3,4,1,4,25.0,3,0,0,0,2,10,1,1,0,2022-2023,1.1764705882352942,4.705882352941177
1858,Bevic Moussiti-Oko,CGO,FW,Ajaccio,Ligue 1,27,1995,7.8,3,1,1,1,1,1,2,50.0,1,5,3,2,2,5,8,0,0,2022-2023,0.25641025641025644,0.38461538461538464
1859,João Moutinho,POR,MF,Wolves,Premier League,35,1986,19.8,51,30,24,21,6,19,46,41.3,27,22,6,16,18,69,20,0,0,2022-2023,0.9090909090909091,2.5757575757575757
1860,João Moutinho,POR,"DF,FW",Spezia,Serie A,24,1998,0.6,7,1,5,1,1,3,4,75.0,1,1,1,0,0,7,0,0,0,2022-2023,0.0,11.666666666666668
1861,Samuel Moutoussamy,COD,MF,Nantes,Ligue 1,25,1996,26.7,64,34,27,28,9,26,76,34.2,50,23,2,21,24,88,15,0,0,2022-2023,0.898876404494382,2.397003745318352
1862,Divin Mubama,ENG,FW,West Ham,Premier League,17,2004,0.4,1,1,1,0,0,0,0,0.0,0,0,0,0,0,1,0,0,0,2022-2023,0.0,2.5
1863,Mykhailo Mudryk,UKR,"FW,MF",Chelsea,Premier League,21,2001,7.3,11,9,2,4,5,4,13,30.8,9,7,1,6,0,11,3,0,0,2022-2023,0.0,1.5068493150684932
1864,François Mughe,CMR,MF,Marseille,Ligue 1,18,2004,0.1,0,0,0,0,0,0,0,0.0,0,0,0,0,0,0,0,0,0,2022-2023,0.0,0.0
1865,Nordi Mukiele,FRA,DF,Paris S-G,Ligue 1,24,1997,12.6,31,23,16,6,9,19,29,65.5,10,22,9,13,14,45,16,0,0,2022-2023,1.1111111111111112,2.4603174603174605
1866,Mert Müldür,TUR,"FW,DF",Sassuolo,Serie A,23,1999,0.1,0,0,0,0,0,0,0,0.0,0,0,0,0,0,0,0,0,0,2022-2023,0.0,0.0
1867,Florian Müller,GER,GK,Stuttgart,Bundesliga,24,1997,19.0,0,0,0,0,0,0,0,0.0,0,0,0,0,0,0,7,4,0,2022-2023,0.0,0.0
1868,Thomas Müller,GER,"FW,MF",Bayern Munich,Bundesliga,32,1989,18.5,21,12,5,9,7,6,16,37.5,10,19,3,16,4,25,16,0,0,2022-2023,0.21621621621621623,1.135135135135135
1869,Abdul Mumin,GHA,DF,Rayo Vallecano,La Liga,24,1998,10.2,11,9,5,6,0,3,7,42.9,4,13,5,8,9,20,36,2,0,2022-2023,0.8823529411764707,1.0784313725490198
1870,Marshall Munetsi,ZIM,MF,Reims,Ligue 1,26,1996,30.0,58,27,13,31,14,20,48,41.7,28,37,11,26,26,84,41,1,0,2022-2023,0.8666666666666667,1.9333333333333333
1871,Iker Muniain,ESP,"MF,FW",Athletic Club,La Liga,29,1992,18.8,21,16,7,11,3,6,17,35.3,11,10,1,9,4,25,2,0,0,2022-2023,0.2127659574468085,1.1170212765957446
1872,Aihen Muñoz,ESP,DF,Real Sociedad,La Liga,24,1997,19.5,38,23,17,17,4,22,47,46.8,25,26,5,21,9,47,38,0,0,2022-2023,0.46153846153846156,1.9487179487179487
1873,Álvaro Muñoz,URU,FW,Real Madrid,La Liga,18,2004,0.9,2,1,1,0,1,1,1,100.0,0,0,0,0,0,2,1,0,0,2022-2023,0.0,2.2222222222222223
1874,Iker Muñoz,ESP,MF,Osasuna,La Liga,19,2002,2.8,1,0,0,1,0,0,3,0.0,3,2,1,1,3,4,8,0,0,2022-2023,1.0714285714285714,0.35714285714285715
1875,Pablo Muñoz,ESP,MF,Rayo Vallecano,La Liga,18,2003,0.1,0,0,0,0,0,0,1,0.0,1,0,0,0,0,0,0,0,0,2022-2023,0.0,0.0
Rk,Player,Nation,Pos,Squad,Comp,0,0,90.0,0,0,3,3,3,Tkl,0,0.0,0,0,0,0,0,0,0,0,0,2022-2023,0.0,0.0
1876,Luis Muriel,COL,"FW,MF",Atalanta,Serie A,31,1991,11.9,9,6,2,3,4,5,16,31.3,11,9,0,9,2,11,2,0,0,2022-2023,0.1680672268907563,0.7563025210084033
1877,Jeison Murillo,COL,DF,Sampdoria,Serie A,30,1992,11.7,22,11,16,6,0,17,26,65.4,9,22,14,8,8,30,39,0,0,2022-2023,0.6837606837606838,1.8803418803418805
1878,Vedat Muriqi,KVX,FW,Mallorca,La Liga,28,1994,32.6,12,7,4,7,1,3,13,23.1,10,19,7,12,12,24,73,0,0,2022-2023,0.36809815950920244,0.36809815950920244
1879,Jacob Murphy,ENG,FW,Newcastle Utd,Premier League,27,1995,13.9,15,7,3,8,4,8,20,40.0,12,17,0,17,7,22,3,0,0,2022-2023,0.5035971223021583,1.079136690647482
1880,Nicola Murru,ITA,DF,Sampdoria,Serie A,27,1994,8.7,24,14,15,8,1,7,13,53.8,6,17,7,10,10,34,21,0,0,2022-2023,1.149425287356322,2.7586206896551726
1881,Yunus Musah,USA,MF,Valencia,La Liga,19,2002,23.4,48,35,17,23,8,20,30,66.7,10,20,1,19,11,59,16,2,0,2022-2023,0.47008547008547014,2.0512820512820515
1882,Jamal Musiala,GER,"MF,FW",Bayern Munich,Bundesliga,19,2003,24.4,34,23,9,16,9,13,35,37.1,22,30,3,27,19,53,3,0,0,2022-2023,0.778688524590164,1.3934426229508197
1883,Juan Musso,ARG,GK,Atalanta,Serie A,28,1994,23.1,1,1,1,0,0,1,1,100.0,0,0,0,0,0,1,11,1,0,2022-2023,0.0,0.04329004329004329
1884,Marlon Mustapha,AUT,"FW,MF",Mainz 05,Bundesliga,21,2001,0.8,2,2,0,2,0,0,0,0.0,0,4,0,4,0,2,0,0,0,2022-2023,0.0,2.5
1885,Yvon Mvogo,SUI,GK,Lorient,Ligue 1,28,1994,20.1,0,0,0,0,0,0,0,0.0,0,0,0,0,2,2,6,3,0,2022-2023,0.09950248756218905,0.0
1886,Enock Mwepu,ZAM,"FW,MF",Brighton,Premier League,24,1998,2.4,10,5,1,6,3,3,4,75.0,1,3,1,2,1,11,1,0,0,2022-2023,0.4166666666666667,4.166666666666667
1887,Francisco Mwepu,ZAM,FW,Cádiz,La Liga,22,2000,0.2,1,0,0,1,0,0,0,0.0,0,0,0,0,0,1,0,0,0,2022-2023,0.0,5.0
1888,Vitaliy Mykolenko,UKR,DF,Everton,Premier League,23,1999,29.5,58,34,36,19,3,28,51,54.9,23,50,16,34,46,104,99,0,0,2022-2023,1.5593220338983051,1.9661016949152543
1889,Joakim Mæhle,DEN,"DF,MF",Atalanta,Serie A,25,1997,24.5,32,18,12,7,13,22,39,56.4,17,29,6,23,24,56,26,0,0,2022-2023,0.9795918367346939,1.3061224489795917
1890,Obite N'Dicka,CIV,DF,Eint Frankfurt,Bundesliga,22,1999,29.9,25,18,10,11,4,18,32,56.3,14,47,19,28,31,56,150,0,0,2022-2023,1.0367892976588629,0.8361204013377926
1891,Nathan N'Goumou,FRA,FW,Toulouse,Ligue 1,22,2000,1.0,3,2,2,1,0,1,1,100.0,0,2,0,2,2,5,0,0,0,2022-2023,2.0,3.0
1892,Nathan N'Goumou,FRA,FW,Gladbach,Bundesliga,22,2000,7.7,11,5,5,5,1,7,13,53.8,6,9,0,9,1,12,4,0,0,2022-2023,0.12987012987012986,1.4285714285714286
1893,Stanley N'Soki,FRA,DF,Hoffenheim,Bundesliga,23,1999,14.3,22,13,14,7,1,12,22,54.5,10,22,5,17,24,46,34,0,0,2022-2023,1.6783216783216783,1.5384615384615383
1894,Herculano Nabian,POR,MF,Empoli,Serie A,18,2004,0.0,0,0,0,0,0,0,0,0.0,0,0,0,0,0,0,0,0,0,2022-2023,,
1895,Nacho,ESP,DF,Real Madrid,La Liga,32,1990,18.2,24,16,17,5,2,12,29,41.4,17,11,6,5,18,42,37,0,0,2022-2023,0.989010989010989,1.3186813186813187
1896,Nikolas Nartey,DEN,"DF,MF",Stuttgart,Bundesliga,22,2000,5.3,11,6,7,3,1,5,9,55.6,4,9,0,9,4,15,12,0,0,2022-2023,0.7547169811320755,2.0754716981132075
1897,Juanjo Narváez,COL,"MF,FW",Valladolid,La Liga,27,1995,1.6,1,1,1,0,0,1,1,100.0,0,2,0,2,0,1,0,0,0,2022-2023,0.0,0.625
1898,Matija Nastasić,SRB,DF,Mallorca,La Liga,29,1993,10.1,10,8,7,1,2,3,6,50.0,3,11,4,7,18,28,43,1,0,2022-2023,1.7821782178217822,0.9900990099009901
1899,Roberto Navarro,ESP,"MF,FW",Real Sociedad,La Liga,20,2002,3.9,5,4,4,0,1,1,2,50.0,1,7,0,7,2,7,2,0,0,2022-2023,0.5128205128205129,1.2820512820512822
1900,Jesús Navas,ESP,"DF,FW",Sevilla,La Liga,36,1985,22.0,19,12,8,3,8,11,22,50.0,11,18,7,11,22,41,52,1,0,2022-2023,1.0,0.8636363636363636
Rk,Player,Nation,Pos,Squad,Comp,0,0,90.0,0,0,3,3,3,Tkl,0,0.0,0,0,0,0,0,0,0,0,0,2022-2023,0.0,0.0
1901,Keylor Navas,CRC,GK,Nott'ham Forest,Premier League,35,1986,17.0,0,0,0,0,0,0,0,0.0,0,0,0,0,1,1,11,2,0,2022-2023,0.058823529411764705,0.0
1902,Michel Ndary Adopo,FRA,"MF,DF",Torino,Serie A,22,2000,2.9,7,2,4,2,1,1,3,33.3,2,2,2,0,1,8,4,0,0,2022-2023,0.3448275862068966,2.413793103448276
1903,Youssouf Ndayishimiye,BDI,"MF,DF",Nice,Ligue 1,23,1998,6.3,13,9,8,5,0,6,11,54.5,5,8,5,3,12,25,22,1,0,2022-2023,1.9047619047619049,2.0634920634920637
1904,Papa Ndiaga Yade,MTN,"DF,MF",Troyes,Ligue 1,22,2000,6.3,10,6,6,2,2,7,22,31.8,15,10,2,8,8,18,10,0,0,2022-2023,1.2698412698412698,1.5873015873015874
1905,Wilfred Ndidi,NGA,MF,Leicester City,Premier League,25,1996,18.7,61,42,34,24,3,17,43,39.5,26,32,14,18,38,99,48,3,0,2022-2023,2.0320855614973263,3.2620320855614975
1906,Tanguy Ndombele,FRA,MF,Napoli,Serie A,25,1996,9.0,14,8,4,8,2,4,7,57.1,3,10,1,9,7,21,7,1,0,2022-2023,0.7777777777777778,1.5555555555555556
1907,Álvaro Negredo,ESP,FW,Cádiz,La Liga,36,1985,8.4,5,4,1,2,2,2,2,100.0,0,4,1,3,0,5,8,0,0,2022-2023,0.0,0.5952380952380952
1908,Reiss Nelson,ENG,FW,Arsenal,Premier League,22,1999,2.4,4,1,2,1,1,2,4,50.0,2,3,0,3,0,4,4,0,0,2022-2023,0.0,1.6666666666666667
1909,Ilija Nestorovski,MKD,"FW,MF",Udinese,Serie A,32,1990,7.1,7,3,2,1,4,5,11,45.5,6,6,1,5,2,9,10,0,0,2022-2023,0.28169014084507044,0.9859154929577465
1910,Neto,BRA,GK,Bournemouth,Premier League,33,1989,26.5,3,1,3,0,0,3,3,100.0,0,0,0,0,0,3,10,3,0,2022-2023,0.0,0.11320754716981132
1911,Pedro Neto,POR,"FW,MF",Wolves,Premier League,22,2000,10.7,11,6,4,2,5,7,17,41.2,10,5,1,4,4,15,4,0,0,2022-2023,0.3738317757009346,1.0280373831775702
1912,Luca Netz,GER,DF,Gladbach,Bundesliga,19,2003,7.8,25,13,19,3,3,19,32,59.4,13,5,1,4,6,31,27,0,0,2022-2023,0.7692307692307693,3.2051282051282053
1913,Manuel Neuer,GER,GK,Bayern Munich,Bundesliga,36,1986,12.0,0,0,0,0,0,0,0,0.0,0,0,0,0,0,0,4,1,0,2022-2023,0.0,0.0
1914,Florian Neuhaus,GER,MF,Gladbach,Bundesliga,25,1997,15.6,19,9,9,5,5,8,27,29.6,19,20,3,17,12,31,5,0,0,2022-2023,0.7692307692307693,1.217948717948718
1915,Rúben Neves,POR,MF,Wolves,Premier League,25,1997,33.5,79,43,31,33,15,32,76,42.1,44,59,22,37,50,129,85,1,0,2022-2023,1.492537313432836,2.3582089552238807
1916,Neymar,BRA,"MF,FW",Paris S-G,Ligue 1,30,1992,17.2,22,14,6,9,7,9,19,47.4,10,7,1,6,4,26,1,1,0,2022-2023,0.23255813953488372,1.2790697674418605
1917,Jessic Ngankam,GER,"FW,MF",Hertha BSC,Bundesliga,22,2000,9.2,14,9,7,4,3,6,14,42.9,8,6,1,5,1,15,4,0,0,2022-2023,0.10869565217391305,1.5217391304347827
1918,Cyril Ngonge,BEL,"MF,FW",Hellas Verona,Serie A,22,2000,8.3,7,3,2,2,3,3,11,27.3,8,7,0,7,6,13,4,0,0,2022-2023,0.7228915662650601,0.8433734939759036
1919,Moussa Niakhate,SEN,DF,Nott'ham Forest,Premier League,26,1996,12.9,18,9,15,3,0,11,22,50.0,11,18,8,10,19,37,60,0,0,2022-2023,1.4728682170542635,1.3953488372093024
1920,Ibrahima Niane,SEN,FW,Angers,Ligue 1,23,1999,12.6,6,2,1,4,1,1,6,16.7,5,8,2,6,1,7,9,0,0,2022-2023,0.07936507936507936,0.4761904761904762
1921,M'Baye Niang,SEN,FW,Auxerre,Ligue 1,27,1994,16.5,13,7,1,8,4,3,13,23.1,10,22,1,21,1,14,20,0,0,2022-2023,0.06060606060606061,0.7878787878787878
1922,Tanguy Nianzou,FRA,DF,Sevilla,La Liga,20,2002,15.2,20,15,10,9,1,8,11,72.7,3,8,5,3,16,36,44,3,0,2022-2023,1.0526315789473684,1.3157894736842106
1923,Rasmus Nicolaisen,DEN,DF,Toulouse,Ligue 1,25,1997,33.3,48,21,34,14,0,29,46,63.0,17,58,45,13,50,98,152,0,0,2022-2023,1.5015015015015016,1.4414414414414416
1924,Hans Nicolussi Caviglia,ITA,MF,Salernitana,Serie A,22,2000,6.5,15,6,5,8,2,9,15,60.0,6,9,0,9,7,22,7,1,0,2022-2023,1.0769230769230769,2.3076923076923075
1925,Florian Niederlechner,GER,"FW,MF",Augsburg,Bundesliga,31,1990,10.1,10,5,5,4,1,4,7,57.1,3,16,2,14,1,11,9,0,0,2022-2023,0.09900990099009901,0.9900990099009901
Rk,Player,Nation,Pos,Squad,Comp,0,0,90.0,0,0,3,3,3,Tkl,0,0.0,0,0,0,0,0,0,0,0,0,2022-2023,0.0,0.0
1926,Florian Niederlechner,GER,FW,Hertha BSC,Bundesliga,31,1990,8.7,9,7,2,4,3,2,8,25.0,6,7,0,7,3,12,10,0,0,2022-2023,0.3448275862068966,1.0344827586206897
1927,Saúl Ñíguez,ESP,"MF,DF",Atlético Madrid,La Liga,27,1994,12.2,42,27,18,18,6,22,37,59.5,15,27,5,22,15,57,29,0,0,2022-2023,1.2295081967213115,3.4426229508196724
1928,Dimitris Nikolaou,GRE,DF,Spezia,Serie A,23,1998,32.9,45,32,31,10,4,25,37,67.6,12,41,26,15,27,72,82,0,0,2022-2023,0.8206686930091186,1.3677811550151977
1929,Fernando Niño,ESP,"MF,FW",Villarreal,La Liga,21,2000,0.2,0,0,0,0,0,0,0,0.0,0,0,0,0,0,0,0,0,0,2022-2023,0.0,0.0
1930,Justin Njinmah,GER,FW,Dortmund,Bundesliga,21,2000,0.2,0,0,0,0,0,0,0,0.0,0,0,0,0,0,0,0,0,0,2022-2023,0.0,0.0
1931,Eddie Nketiah,ENG,FW,Arsenal,Premier League,23,1999,12.1,13,9,6,2,5,2,10,20.0,8,7,1,6,1,14,7,0,0,2022-2023,0.08264462809917356,1.0743801652892562
1932,Christopher Nkunku,FRA,"FW,MF",RB Leipzig,Bundesliga,24,1997,21.1,6,4,2,1,3,1,6,16.7,5,8,3,5,8,14,11,0,0,2022-2023,0.3791469194312796,0.2843601895734597
1933,Felix Nmecha,GER,MF,Wolfsburg,Bundesliga,21,2000,20.4,41,24,11,23,7,16,34,47.1,18,26,10,16,25,66,31,0,0,2022-2023,1.2254901960784315,2.0098039215686274
1934,Lukas Nmecha,GER,FW,Wolfsburg,Bundesliga,23,1998,10.0,5,3,0,2,3,3,3,100.0,0,5,1,4,3,8,4,0,0,2022-2023,0.3,0.5
1935,Arnaud Nordin,FRA,FW,Montpellier,Ligue 1,24,1998,26.7,26,14,10,12,4,12,28,42.9,16,19,1,18,14,40,7,0,0,2022-2023,0.5243445692883896,0.9737827715355806
1936,Riad Nouri,FRA,"MF,FW",Ajaccio,Ligue 1,37,1985,18.8,21,12,7,10,4,12,29,41.4,17,8,1,7,15,36,11,0,0,2022-2023,0.7978723404255319,1.1170212765957446
1937,Hugo Novoa,ESP,"DF,FW",RB Leipzig,Bundesliga,19,2003,2.0,8,2,1,3,4,4,7,57.1,3,4,0,4,1,9,0,0,0,2022-2023,0.5,4.0
1938,Samuel Ntanda,BEL,MF,Sampdoria,Serie A,17,2005,0.0,0,0,0,0,0,0,0,0.0,0,0,0,0,0,0,0,0,0,2022-2023,,
1939,Randy Nteka,ANG,"FW,MF",Elche,La Liga,24,1997,8.1,15,10,7,6,2,2,11,18.2,9,15,3,12,4,19,9,0,0,2022-2023,0.4938271604938272,1.8518518518518519
1940,Randy Nteka,ANG,"FW,MF",Rayo Vallecano,La Liga,24,1997,1.3,4,2,2,2,0,1,1,100.0,0,2,0,2,2,6,3,0,0,2022-2023,1.5384615384615383,3.0769230769230766
1941,Alexander Nübel,GER,GK,Monaco,Ligue 1,25,1996,38.0,0,0,0,0,0,0,1,0.0,1,0,0,0,1,1,10,3,0,2022-2023,0.02631578947368421,0.0
1942,Matheus Nunes,POR,MF,Wolves,Premier League,23,1998,27.4,67,43,36,22,9,28,61,45.9,33,35,4,31,16,83,35,2,0,2022-2023,0.5839416058394161,2.445255474452555
1943,Darwin Núñez,URU,FW,Liverpool,Premier League,23,1999,18.8,11,5,2,4,5,4,17,23.5,13,10,0,10,3,14,13,0,0,2022-2023,0.15957446808510636,0.5851063829787234
1944,Unai Núñez,ESP,DF,Celta Vigo,La Liga,25,1997,35.0,47,35,29,15,3,18,34,52.9,16,27,17,10,72,119,135,1,0,2022-2023,2.057142857142857,1.3428571428571427
1945,Bram Nuytinck,NED,DF,Udinese,Serie A,32,1990,4.3,7,4,3,4,0,4,8,50.0,4,6,6,0,5,12,22,0,0,2022-2023,1.1627906976744187,1.627906976744186
1946,Bram Nuytinck,NED,DF,Sampdoria,Serie A,32,1990,16.6,54,38,33,21,0,23,34,67.6,11,36,21,15,23,77,84,0,0,2022-2023,1.3855421686746987,3.2530120481927707
1947,Ethan Nwaneri,ENG,FW,Arsenal,Premier League,15,2007,0.0,0,0,0,0,0,0,0,0.0,0,1,0,1,0,0,0,0,0,2022-2023,,
1948,Gerzino Nyamsi,FRA,DF,Strasbourg,Ligue 1,25,1997,17.5,28,20,14,12,2,10,12,83.3,2,19,11,8,10,38,63,1,0,2022-2023,0.5714285714285714,1.6
1949,Ørjan Nyland,NOR,GK,RB Leipzig,Bundesliga,31,1990,2.0,0,0,0,0,0,0,0,0.0,0,0,0,0,0,0,0,0,0,2022-2023,0.0,0.0
1950,M'Bala Nzola,ANG,FW,Spezia,Serie A,25,1996,29.5,12,5,0,6,6,3,9,33.3,6,20,6,14,7,19,21,0,0,2022-2023,0.23728813559322035,0.4067796610169492
Rk,Player,Nation,Pos,Squad,Comp,0,0,90.0,0,0,3,3,3,Tkl,0,0.0,0,0,0,0,0,0,0,0,0,2022-2023,0.0,0.0
1951,Christian Nørgaard,DEN,MF,Brentford,Premier League,28,1994,19.6,52,30,21,29,2,18,48,37.5,30,32,9,23,34,86,41,2,0,2022-2023,1.7346938775510203,2.6530612244897958
1952,Lewis O'Brien,ENG,MF,Nott'ham Forest,Premier League,23,1998,6.5,16,9,4,11,1,6,12,50.0,6,13,2,11,5,21,9,0,0,2022-2023,0.7692307692307693,2.4615384615384617
1953,Pedro Obiang,EQG,MF,Sassuolo,Serie A,30,1992,9.7,26,17,12,12,2,10,18,55.6,8,12,2,10,8,34,15,0,0,2022-2023,0.8247422680412372,2.680412371134021
1954,Jan Oblak,SVN,GK,Atlético Madrid,La Liga,29,1993,27.7,0,0,0,0,0,0,0,0.0,0,0,0,0,1,1,8,0,0,2022-2023,0.036101083032490974,0.0
1955,Brian Ocampo,URU,"MF,FW",Cádiz,La Liga,23,1999,12.4,18,15,12,5,1,8,21,38.1,13,13,0,13,3,21,3,0,0,2022-2023,0.24193548387096772,1.4516129032258065
1956,Lucas Ocampos,ARG,"FW,MF",Sevilla,La Liga,28,1994,12.9,22,14,9,9,4,8,31,25.8,23,17,2,15,8,30,5,0,0,2022-2023,0.6201550387596899,1.7054263565891472
1957,Guillermo Ochoa,MEX,GK,Salernitana,Serie A,37,1985,20.0,0,0,0,0,0,0,2,0.0,2,0,0,0,0,0,9,1,0,2022-2023,0.0,0.0
1958,Wilson Odobert,FRA,"MF,FW",Troyes,Ligue 1,17,2004,19.6,20,14,10,7,3,9,25,36.0,16,11,0,11,15,35,5,0,0,2022-2023,0.7653061224489796,1.0204081632653061
1959,Álvaro Odriozola,ESP,DF,Real Madrid,La Liga,26,1995,0.4,0,0,0,0,0,0,0,0.0,0,0,0,0,0,0,0,0,0,2022-2023,0.0,0.0
1960,Tim Oermann,GER,DF,Bochum,Bundesliga,18,2003,2.2,2,1,2,0,0,1,1,100.0,0,3,2,1,1,3,8,1,0,2022-2023,0.45454545454545453,0.9090909090909091
1961,Odeluga Offiah,ENG,DF,Brighton,Premier League,19,2002,0.3,1,1,1,0,0,0,2,0.0,2,0,0,0,0,1,1,0,0,2022-2023,0.0,3.3333333333333335
1962,Angelo Ogbonna,ITA,DF,West Ham,Premier League,34,1988,13.7,11,4,7,4,0,5,10,50.0,5,11,7,4,17,28,74,1,0,2022-2023,1.2408759124087592,0.8029197080291971
1963,Florent Ogier,FRA,DF,Clermont Foot,Ligue 1,33,1989,18.9,33,16,20,12,1,22,39,56.4,17,22,13,9,18,51,64,1,0,2022-2023,0.9523809523809524,1.7460317460317463
1964,Marios Oikonomou,GRE,DF,Sampdoria,Serie A,29,1992,2.4,3,2,3,0,0,1,3,33.3,2,5,4,1,4,7,13,0,0,2022-2023,1.6666666666666667,1.25
1965,David Okereke,NGA,"FW,MF",Cremonese,Serie A,24,1997,25.2,12,8,4,5,3,3,16,18.8,13,23,3,20,10,22,12,0,0,2022-2023,0.39682539682539686,0.4761904761904762
1966,Caleb Okoli,ITA,DF,Atalanta,Serie A,21,2001,10.7,21,17,14,6,1,10,25,40.0,15,10,5,5,30,51,44,3,0,2022-2023,2.8037383177570097,1.9626168224299068
1967,Olasagasti,ESP,"MF,DF",Real Sociedad,La Liga,21,2000,0.7,4,4,1,2,1,1,2,50.0,1,2,0,2,0,4,1,0,0,2022-2023,0.0,5.714285714285714
1968,Lucas Olaza,URU,DF,Valladolid,La Liga,28,1994,16.6,24,14,12,10,2,17,26,65.4,9,20,8,12,14,38,34,0,0,2022-2023,0.8433734939759036,1.4457831325301203
1969,Finn Ole Becker,GER,MF,Hoffenheim,Bundesliga,22,2000,5.7,10,2,4,6,0,4,7,57.1,3,4,0,4,5,15,8,0,0,2022-2023,0.8771929824561403,1.7543859649122806
1970,Mathias Olesen,LUX,MF,Köln,Bundesliga,21,2001,5.3,10,5,4,4,2,5,8,62.5,3,6,1,5,2,12,3,0,0,2022-2023,0.37735849056603776,1.8867924528301887
1971,Michael Olise,FRA,"FW,MF",Crystal Palace,Premier League,20,2001,30.5,58,34,28,26,4,25,60,41.7,35,46,1,45,26,84,17,0,0,2022-2023,0.8524590163934426,1.901639344262295
1972,Brian Oliván,ESP,DF,Espanyol,La Liga,28,1994,26.7,47,27,30,12,5,17,26,65.4,9,26,6,20,22,69,67,0,0,2022-2023,0.8239700374531835,1.7602996254681649
1973,Lucas Oliveira Rosa,BRA,DF,Valladolid,La Liga,22,2000,10.3,39,18,23,10,6,12,20,60.0,8,12,2,10,15,54,24,0,0,2022-2023,1.4563106796116503,3.786407766990291
1974,Mathías Olivera,URU,DF,Napoli,Serie A,24,1997,18.3,39,23,16,16,7,22,43,51.2,21,28,2,26,22,61,26,0,0,2022-2023,1.2021857923497268,2.1311475409836063
1975,Dani Olmo,ESP,"MF,FW",RB Leipzig,Bundesliga,24,1998,14.2,15,9,1,10,4,6,14,42.9,8,15,0,15,6,21,6,0,0,2022-2023,0.4225352112676057,1.0563380281690142
Rk,Player,Nation,Pos,Squad,Comp,0,0,90.0,0,0,3,3,3,Tkl,0,0.0,0,0,0,0,0,0,0,0,0,2022-2023,0.0,0.0
1976,Jan Olschowsky,GER,GK,Gladbach,Bundesliga,20,2001,4.0,0,0,0,0,0,0,1,0.0,1,1,0,1,0,0,1,0,0,2022-2023,0.0,0.0
1977,Robin Olsen,SWE,GK,Aston Villa,Premier League,32,1990,3.1,0,0,0,0,0,0,2,0.0,2,0,0,0,0,0,1,0,0,2022-2023,0.0,0.0
1978,Warmed Omari,FRA,DF,Rennes,Ligue 1,22,2000,15.1,20,11,14,6,0,14,28,50.0,14,13,7,6,17,37,43,1,0,2022-2023,1.1258278145695364,1.3245033112582782
1979,Jonas Omlin,SUI,GK,Montpellier,Ligue 1,28,1994,13.0,1,0,1,0,0,0,0,0.0,0,0,0,0,0,1,8,1,0,2022-2023,0.0,0.07692307692307693
1980,Jonas Omlin,SUI,GK,Gladbach,Bundesliga,28,1994,14.3,1,1,1,0,0,1,3,33.3,2,1,0,1,0,1,9,1,0,2022-2023,0.0,0.06993006993006992
1981,Ado Onaiwu,JPN,FW,Toulouse,Ligue 1,26,1995,12.0,11,6,4,4,3,5,13,38.5,8,5,1,4,2,13,5,0,0,2022-2023,0.16666666666666666,0.9166666666666666
1982,Amadou Onana,BEL,MF,Everton,Premier League,20,2001,27.6,72,43,24,42,6,30,42,71.4,12,25,6,19,37,109,39,0,0,2022-2023,1.3405797101449275,2.608695652173913
1983,André Onana,CMR,GK,Inter,Serie A,26,1996,24.0,0,0,0,0,0,0,1,0.0,1,0,0,0,0,0,5,0,0,2022-2023,0.0,0.0
1984,Jean Onana,CMR,"MF,DF",Lens,Ligue 1,22,2000,9.0,28,17,8,17,3,10,22,45.5,12,15,5,10,18,46,20,0,0,2022-2023,2.0,3.111111111111111
1985,Karim Onisiwo,AUT,"FW,MF",Mainz 05,Bundesliga,30,1992,28.2,19,12,3,10,6,4,21,19.0,17,19,0,19,2,21,7,0,0,2022-2023,0.07092198581560284,0.6737588652482269
1986,Josh Onomah,ENG,MF,Fulham,Premier League,25,1997,0.2,1,0,1,0,0,0,0,0.0,0,1,0,1,0,1,0,0,0,2022-2023,0.0,5.0
1987,Paul Onuachu,NGA,FW,Southampton,Premier League,28,1994,4.5,3,2,1,1,1,1,3,33.3,2,4,1,3,0,3,4,0,0,2022-2023,0.0,0.6666666666666666
1988,Frank Onyeka,NGA,MF,Brentford,Premier League,24,1998,9.4,19,14,11,7,1,10,25,40.0,15,16,3,13,10,29,16,0,0,2022-2023,1.0638297872340425,2.021276595744681
1989,Loïs Openda,BEL,FW,Lens,Ligue 1,22,2000,28.0,11,9,2,6,3,2,13,15.4,11,9,0,9,2,13,6,0,0,2022-2023,0.07142857142857142,0.39285714285714285
1990,Willi Orban,HUN,DF,RB Leipzig,Bundesliga,29,1992,32.8,51,30,33,18,0,26,43,60.5,17,42,24,18,39,90,129,1,0,2022-2023,1.1890243902439026,1.5548780487804879
1991,Ivan Ordets,UKR,DF,Bochum,Bundesliga,30,1992,27.2,31,19,21,9,1,16,28,57.1,12,34,17,17,57,88,139,0,0,2022-2023,2.0955882352941178,1.1397058823529411
1992,Divock Origi,BEL,FW,Milan,Serie A,27,1995,11.4,10,5,4,3,3,5,10,50.0,5,6,2,4,0,10,13,0,0,2022-2023,0.0,0.8771929824561403
1993,Aimar Oroz,ESP,"MF,FW",Osasuna,La Liga,20,2001,22.4,26,14,8,10,8,8,30,26.7,22,24,1,23,24,50,6,0,0,2022-2023,1.0714285714285714,1.1607142857142858
1994,Mislav Oršić,CRO,MF,Southampton,Premier League,29,1992,0.1,1,1,1,0,0,0,0,0.0,0,0,0,0,0,1,0,0,0,2022-2023,0.0,10.0
1995,Riccardo Orsolini,ITA,FW,Bologna,Serie A,25,1997,23.6,30,19,15,10,5,17,41,41.5,24,29,3,26,8,38,18,0,0,2022-2023,0.3389830508474576,1.271186440677966
1996,Stefan Ortega,GER,GK,Manchester City,Premier League,29,1992,3.0,0,0,0,0,0,0,0,0.0,0,0,0,0,0,0,0,0,0,2022-2023,0.0,0.0
1997,Pedro Ortiz,ESP,MF,Sevilla,La Liga,21,2000,0.0,0,0,0,0,0,0,0,0.0,0,0,0,0,0,0,0,0,0,2022-2023,,
1998,Jordi Osei-Tutu,ENG,"DF,FW",Bochum,Bundesliga,23,1998,8.3,23,18,13,5,5,12,23,52.2,11,12,5,7,10,33,8,0,0,2022-2023,1.2048192771084336,2.7710843373493974
1999,Victor Osimhen,NGA,FW,Napoli,Serie A,23,1998,28.5,10,6,1,2,7,0,7,0.0,7,6,1,5,6,16,29,0,0,2022-2023,0.21052631578947367,0.3508771929824561
2000,Patrick Osterhage,GER,MF,Bochum,Bundesliga,22,2000,11.4,20,17,8,10,2,11,16,68.8,5,17,6,11,12,32,25,0,0,2022-2023,1.0526315789473684,1.7543859649122806
Rk,Player,Nation,Pos,Squad,Comp,0,0,90.0,0,0,3,3,3,Tkl,0,0.0,0,0,0,0,0,0,0,0,0,2022-2023,0.0,0.0
2001,Paulo Otávio,BRA,DF,Wolfsburg,Bundesliga,27,1994,22.7,72,46,46,17,9,44,66,66.7,22,42,6,36,30,102,70,1,0,2022-2023,1.3215859030837005,3.1718061674008813
2002,Dango Ouattara,BFA,"MF,FW",Bournemouth,Premier League,20,2002,13.8,28,15,20,6,2,13,32,40.6,19,20,3,17,13,41,29,1,0,2022-2023,0.9420289855072463,2.0289855072463765
2003,Dango Ouattara,BFA,"FW,MF",Lorient,Ligue 1,20,2002,17.2,41,26,20,11,10,15,28,53.6,13,24,6,18,19,60,21,0,0,2022-2023,1.1046511627906976,2.3837209302325584
2004,Remi Oudin,FRA,"FW,MF",Lecce,Serie A,25,1996,14.7,25,13,9,12,4,10,23,43.5,13,16,2,14,29,54,23,0,0,2022-2023,1.9727891156462587,1.7006802721088436
2005,Zinédine Ould Khaled,FRA,"MF,FW",Angers,Ligue 1,22,2000,0.6,1,1,0,1,0,0,1,0.0,1,0,0,0,2,3,0,0,0,2022-2023,3.3333333333333335,1.6666666666666667
2006,Azzedine Ounahi,MAR,"MF,FW",Marseille,Ligue 1,22,2000,1.3,2,1,1,1,0,0,2,0.0,2,1,0,1,0,2,0,0,0,2022-2023,0.0,1.5384615384615383
2007,Azzedine Ounahi,MAR,"MF,FW",Angers,Ligue 1,22,2000,12.5,19,8,5,13,1,10,20,50.0,10,8,0,8,15,34,4,1,0,2022-2023,1.2,1.52
2008,Adam Ounas,ALG,FW,Napoli,Serie A,25,1996,0.2,0,0,0,0,0,0,0,0.0,0,0,0,0,1,1,0,0,0,2022-2023,5.0,0.0
2009,Adam Ounas,ALG,"FW,MF",Lille,Ligue 1,25,1996,11.8,20,11,4,10,6,8,13,61.5,5,16,0,16,7,27,5,0,0,2022-2023,0.5932203389830508,1.694915254237288
2010,Thomas Ouwejan,NED,DF,Schalke 04,Bundesliga,25,1996,10.0,20,8,13,5,2,6,10,60.0,4,17,4,13,13,33,27,0,0,2022-2023,1.3,2.0
2011,Reece Oxford,ENG,DF,Augsburg,Bundesliga,23,1998,1.0,1,1,1,0,0,0,0,0.0,0,4,3,1,1,2,5,0,0,2022-2023,1.0,1.0
2012,Alex Oxlade-Chamberlain,ENG,"FW,MF",Liverpool,Premier League,28,1993,3.7,5,4,1,2,2,1,5,20.0,4,5,2,3,1,6,4,0,0,2022-2023,0.27027027027027023,1.3513513513513513
2013,Mikel Oyarzabal,ESP,"FW,MF",Real Sociedad,La Liga,25,1997,13.5,13,7,5,3,5,5,19,26.3,14,14,4,10,3,16,5,0,0,2022-2023,0.2222222222222222,0.9629629629629629
2014,Salih Özcan,TUR,MF,Dortmund,Bundesliga,24,1998,17.5,31,18,10,16,5,16,39,41.0,23,24,2,22,28,59,19,1,0,2022-2023,1.6,1.7714285714285714
2015,Cenk Özkacar,TUR,DF,Valencia,La Liga,21,2000,15.2,27,20,17,10,0,14,19,73.7,5,14,2,12,12,39,47,4,0,2022-2023,0.7894736842105263,1.7763157894736843
2016,David Ozoh,ENG,FW,Crystal Palace,Premier League,17,2005,0.0,0,0,0,0,0,0,0,0.0,0,0,0,0,0,0,0,0,0,2022-2023,,
2017,Levin Öztunalı,GER,MF,Union Berlin,Bundesliga,26,1996,0.1,0,0,0,0,0,0,1,0.0,1,0,0,0,0,0,0,0,0,2022-2023,0.0,0.0
2018,Fernando Pacheco,ESP,GK,Almería,La Liga,30,1992,1.0,0,0,0,0,0,0,0,0.0,0,0,0,0,0,0,1,0,0,2022-2023,0.0,0.0
2019,Fernando Pacheco,ESP,GK,Espanyol,La Liga,30,1992,16.0,0,0,0,0,0,0,1,0.0,1,0,0,0,1,1,11,0,0,2022-2023,0.0625,0.0
2020,Jon Pacheco,ESP,DF,Real Sociedad,La Liga,21,2001,13.3,16,10,10,6,0,6,10,60.0,4,9,6,3,12,28,37,1,0,2022-2023,0.9022556390977443,1.2030075187969924
2021,Gonçalo Paciência,POR,"FW,MF",Celta Vigo,La Liga,27,1994,7.4,8,5,0,5,3,2,7,28.6,5,9,1,8,0,8,4,0,0,2022-2023,0.0,1.081081081081081
2022,Simone Pafundi,ITA,"MF,FW",Udinese,Serie A,16,2006,0.9,8,5,1,5,2,2,4,50.0,2,0,0,0,1,9,0,0,0,2022-2023,1.1111111111111112,8.88888888888889
2023,Exequiel Palacios,ARG,MF,Leverkusen,Bundesliga,23,1998,18.4,59,36,20,33,6,29,48,60.4,19,29,2,27,33,92,28,0,0,2022-2023,1.7934782608695654,3.206521739130435
2024,Helibelton Palacios,COL,DF,Elche,La Liga,29,1993,21.3,38,20,21,15,2,19,26,73.1,7,26,12,14,20,58,55,0,0,2022-2023,0.9389671361502347,1.784037558685446
2025,Ante Palaversa,CRO,MF,Troyes,Ligue 1,22,2000,0.3,1,1,1,0,0,0,0,0.0,0,0,0,0,1,2,0,0,0,2022-2023,3.3333333333333335,3.3333333333333335
Rk,Player,Nation,Pos,Squad,Comp,0,0,90.0,0,0,3,3,3,Tkl,0,0.0,0,0,0,0,0,0,0,0,0,2022-2023,0.0,0.0
2026,Isaac Palazón Camacho,ESP,"FW,MF",Rayo Vallecano,La Liga,27,1994,32.9,45,30,11,23,11,24,66,36.4,42,42,3,39,17,62,30,0,0,2022-2023,0.5167173252279635,1.3677811550151977
2027,João Palhinha,POR,MF,Fulham,Premier League,27,1995,34.5,148,83,59,65,24,71,135,52.6,64,48,5,43,46,194,61,2,0,2022-2023,1.3333333333333333,4.2898550724637685
2028,Nicolas Pallois,FRA,DF,Nantes,Ligue 1,34,1987,24.6,69,44,51,16,2,42,70,60.0,28,35,18,17,30,99,131,2,0,2022-2023,1.2195121951219512,2.8048780487804876
2029,Cole Palmer,ENG,"MF,FW",Manchester City,Premier League,20,2002,4.1,5,1,0,3,2,3,5,60.0,2,2,1,1,1,6,2,0,0,2022-2023,0.24390243902439027,1.2195121951219514
2030,Erik Palmer-Brown,USA,DF,Troyes,Ligue 1,25,1997,35.5,42,27,31,10,1,18,33,54.5,15,56,29,27,26,68,166,1,0,2022-2023,0.7323943661971831,1.1830985915492958
2031,Emerson Palmieri,ITA,DF,West Ham,Premier League,27,1994,14.7,26,14,9,15,2,12,24,50.0,12,17,4,13,15,41,36,0,0,2022-2023,1.0204081632653061,1.7687074829931975
2032,Miloš Pantović,SRB,MF,Union Berlin,Bundesliga,26,1996,2.3,4,2,4,0,0,3,5,60.0,2,3,0,3,0,4,5,0,0,2022-2023,0.0,1.7391304347826089
2033,Flavio Paoletti,ITA,MF,Sampdoria,Serie A,19,2003,3.2,2,2,0,2,0,1,5,20.0,4,1,0,1,5,7,9,0,0,2022-2023,1.5625,0.625
2034,Antonios Papadopoulos,GER,DF,Dortmund,Bundesliga,22,1999,0.1,0,0,0,0,0,0,0,0.0,0,0,0,0,1,1,0,0,0,2022-2023,10.0,0.0
2035,Lucas Paquetá,BRA,MF,West Ham,Premier League,24,1997,23.9,71,53,23,36,12,27,68,39.7,41,41,4,37,16,87,31,0,0,2022-2023,0.6694560669456068,2.97071129707113
2036,Lucas Paquetá,BRA,MF,Lyon,Ligue 1,24,1997,1.8,5,4,0,5,0,1,3,33.3,2,2,0,2,1,6,3,0,0,2022-2023,0.5555555555555556,2.7777777777777777
2037,Aitor Paredes,ESP,DF,Athletic Club,La Liga,22,2000,9.5,7,6,4,2,1,6,11,54.5,5,11,7,4,14,21,26,0,0,2022-2023,1.4736842105263157,0.7368421052631579
2038,Kevin Paredes,USA,"FW,MF",Wolfsburg,Bundesliga,19,2003,5.9,13,9,6,3,4,9,12,75.0,3,7,0,7,6,19,8,0,0,2022-2023,1.0169491525423728,2.2033898305084745
2039,Leandro Paredes,ARG,MF,Juventus,Serie A,28,1994,10.9,19,13,7,11,1,10,22,45.5,12,8,0,8,17,36,22,0,0,2022-2023,1.5596330275229358,1.7431192660550459
2040,Leandro Paredes,ARG,MF,Paris S-G,Ligue 1,28,1994,0.6,1,1,1,0,0,1,1,100.0,0,2,1,1,1,2,0,0,0,2022-2023,1.6666666666666667,1.6666666666666667
2041,Daniel Parejo,ESP,MF,Villarreal,La Liga,33,1989,36.5,71,40,32,23,16,30,75,40.0,45,40,12,28,29,100,31,2,0,2022-2023,0.7945205479452054,1.9452054794520548
2042,Fabiano Parisi,ITA,DF,Empoli,Serie A,21,2000,31.4,65,35,37,21,7,30,72,41.7,42,51,16,35,41,106,91,0,0,2022-2023,1.3057324840764333,2.070063694267516
2043,Moises Parra Gutierrez,ESP,FW,Getafe,La Liga,20,2002,0.1,1,0,0,1,0,0,0,0.0,0,0,0,0,0,1,0,0,0,2022-2023,0.0,10.0
2044,Raúl Parra,ESP,DF,Cádiz,La Liga,22,1999,3.4,4,2,4,0,0,4,9,44.4,5,5,3,2,1,5,9,0,0,2022-2023,0.29411764705882354,1.1764705882352942
2045,Thomas Partey,GHA,MF,Arsenal,Premier League,29,1993,27.6,70,40,20,35,15,25,52,48.1,27,26,5,21,28,98,41,1,0,2022-2023,1.0144927536231882,2.5362318840579707
2046,Marco Pašalić,CRO,MF,Dortmund,Bundesliga,21,2000,0.1,0,0,0,0,0,0,0,0.0,0,0,0,0,0,0,0,0,0,2022-2023,0.0,0.0
2047,Mario Pašalić,CRO,"MF,FW",Atalanta,Serie A,27,1995,19.7,22,10,6,14,2,6,23,26.1,17,22,4,18,21,43,13,0,0,2022-2023,1.0659898477157361,1.116751269035533
2048,Pascu,ESP,"DF,FW",Villarreal,La Liga,19,2003,0.1,0,0,0,0,0,0,0,0.0,0,0,0,0,0,0,0,0,0,2022-2023,0.0,0.0
2049,Felix Passlack,GER,DF,Dortmund,Bundesliga,24,1998,0.7,4,3,0,4,0,1,1,100.0,0,1,1,0,0,4,1,0,0,2022-2023,0.0,5.714285714285714
2050,Javier Pastore,ARG,MF,Elche,La Liga,33,1989,0.1,0,0,0,0,0,0,0,0.0,0,0,0,0,0,0,0,0,0,2022-2023,0.0,0.0
Rk,Player,Nation,Pos,Squad,Comp,0,0,90.0,0,0,3,3,3,Tkl,0,0.0,0,0,0,0,0,0,0,0,0,2022-2023,0.0,0.0
2051,Patric,ESP,DF,Lazio,Serie A,29,1993,15.7,17,11,12,3,2,11,16,68.8,5,17,12,5,11,28,53,1,0,2022-2023,0.7006369426751593,1.0828025477707006
2052,Rui Patrício,POR,GK,Roma,Serie A,34,1988,35.0,1,1,1,0,0,1,1,100.0,0,0,0,0,2,3,6,3,0,2022-2023,0.05714285714285714,0.02857142857142857
2053,Nathan Patterson,SCO,"DF,MF",Everton,Premier League,20,2001,14.2,49,24,32,13,4,29,54,53.7,25,24,4,20,15,64,45,0,0,2022-2023,1.0563380281690142,3.450704225352113
2054,Paulinho,BRA,FW,Leverkusen,Bundesliga,22,2000,0.9,0,0,0,0,0,0,0,0.0,0,1,0,1,0,0,2,0,0,2022-2023,0.0,0.0
2055,Gabriel Paulista,BRA,DF,Valencia,La Liga,31,1990,16.7,17,9,13,4,0,13,19,68.4,6,22,14,8,32,49,79,2,0,2022-2023,1.9161676646706587,1.0179640718562875
2056,Benjamin Pavard,FRA,DF,Bayern Munich,Bundesliga,26,1996,27.0,70,41,36,26,8,36,48,75.0,12,35,16,19,44,114,83,0,0,2022-2023,1.6296296296296295,2.5925925925925926
2057,Jiří Pavlenka,CZE,GK,Werder Bremen,Bundesliga,30,1992,32.3,1,0,1,0,0,1,5,20.0,4,1,0,1,3,4,21,1,0,2022-2023,0.09287925696594428,0.030959752321981428
2058,Dimitri Payet,FRA,"MF,FW",Marseille,Ligue 1,35,1987,9.3,6,4,2,2,2,3,11,27.3,8,4,0,4,0,6,4,0,0,2022-2023,0.0,0.6451612903225806
2059,Ben Pearson,ENG,MF,Bournemouth,Premier League,27,1995,3.2,7,3,3,3,1,1,3,33.3,2,4,0,4,2,9,6,0,0,2022-2023,0.625,2.1875
2060,Kristian Pedersen,DEN,DF,Köln,Bundesliga,27,1994,3.1,5,4,4,1,0,0,2,0.0,2,3,0,3,6,11,17,0,0,2022-2023,1.9354838709677418,1.6129032258064515
2061,Mads Pedersen,DEN,"DF,MF",Augsburg,Bundesliga,25,1996,20.4,44,23,31,11,2,22,33,66.7,11,32,9,23,20,64,41,1,0,2022-2023,0.9803921568627452,2.1568627450980395
2062,Alfonso Pedraza,ESP,DF,Villarreal,La Liga,26,1996,18.1,35,26,20,10,5,19,29,65.5,10,19,1,18,18,53,31,0,0,2022-2023,0.9944751381215469,1.9337016574585635
2063,Pedri,ESP,MF,Barcelona,La Liga,19,2002,22.0,39,22,15,17,7,13,45,28.9,32,27,0,27,13,52,8,1,0,2022-2023,0.5909090909090909,1.7727272727272727
2064,Pedro,ESP,FW,Lazio,Serie A,35,1987,21.1,35,24,14,10,11,11,30,36.7,19,18,2,16,6,41,4,1,0,2022-2023,0.2843601895734597,1.6587677725118481
2065,Adrià Pedrosa,ESP,"DF,MF",Espanyol,La Liga,24,1998,2.5,5,1,5,0,0,4,7,57.1,3,1,1,0,5,10,3,0,0,2022-2023,2.0,2.0
2066,Jordan Pefok,USA,FW,Union Berlin,Bundesliga,26,1996,15.1,15,7,3,4,8,2,17,11.8,15,17,5,12,4,19,15,0,0,2022-2023,0.26490066225165565,0.9933774834437087
2067,Gianluca Pegolo,ITA,GK,Sassuolo,Serie A,41,1981,2.0,0,0,0,0,0,0,1,0.0,1,0,0,0,0,0,1,0,0,2022-2023,0.0,0.0
2068,Dženan Pejčinović,GER,FW,Wolfsburg,Bundesliga,17,2005,0.1,0,0,0,0,0,0,0,0.0,0,0,0,0,0,0,0,0,0,2022-2023,0.0,0.0
2069,Peter Pekarík,SVK,DF,Hertha BSC,Bundesliga,35,1986,2.3,4,3,4,0,0,4,6,66.7,2,6,2,4,4,8,7,0,0,2022-2023,1.7391304347826089,1.7391304347826089
2070,Pietro Pellegri,ITA,FW,Torino,Serie A,21,2001,5.2,6,2,1,3,2,2,3,66.7,1,5,1,4,0,6,4,0,0,2022-2023,0.0,1.1538461538461537
2071,Lorenzo Pellegrini,ITA,MF,Roma,Serie A,26,1996,28.3,52,29,24,24,4,22,48,45.8,26,27,4,23,26,78,22,0,0,2022-2023,0.9187279151943463,1.8374558303886925
2072,Luca Pellegrini,ITA,DF,Lazio,Serie A,23,1999,2.0,1,0,0,1,0,1,4,25.0,3,3,0,3,7,8,4,0,0,2022-2023,3.5,0.5
2073,Luca Pellegrini,ITA,DF,Eint Frankfurt,Bundesliga,23,1999,6.2,13,8,10,3,0,8,8,100.0,0,8,2,6,7,20,11,1,0,2022-2023,1.129032258064516,2.096774193548387
2074,Théo Pellenard,FRA,DF,Auxerre,Ligue 1,28,1994,1.1,1,0,1,0,0,1,1,100.0,0,3,1,2,2,3,2,0,0,2022-2023,1.8181818181818181,0.9090909090909091
2075,Facundo Pellistri,URU,"FW,MF",Manchester Utd,Premier League,20,2001,0.7,1,1,0,1,0,0,0,0.0,0,0,0,0,0,1,3,0,0,2022-2023,0.0,1.4285714285714286
Rk,Player,Nation,Pos,Squad,Comp,0,0,90.0,0,0,3,3,3,Tkl,0,0.0,0,0,0,0,0,0,0,0,0,2022-2023,0.0,0.0
2076,Timothee Pembele,FRA,DF,Paris S-G,Ligue 1,19,2002,2.9,5,5,3,1,1,2,4,50.0,2,2,0,2,4,9,2,0,0,2022-2023,1.3793103448275863,1.7241379310344829
2077,Iñaki Peña,ESP,GK,Barcelona,La Liga,23,1999,0.8,0,0,0,0,0,0,0,0.0,0,0,0,0,0,0,0,1,0,2022-2023,0.0,0.0
2078,Rubén Peña,ESP,"DF,MF",Osasuna,La Liga,31,1991,14.2,32,18,10,18,4,20,41,48.8,21,23,8,15,17,49,31,0,0,2022-2023,1.1971830985915493,2.2535211267605635
2079,Patrick Pentz,AUT,GK,Reims,Ligue 1,25,1997,7.0,0,0,0,0,0,0,0,0.0,0,0,0,0,0,0,1,0,0,2022-2023,0.0,0.0
2080,Nicolas Pépé,CIV,"FW,MF",Nice,Ligue 1,27,1995,16.6,25,13,14,5,6,11,25,44.0,14,17,0,17,3,28,1,0,0,2022-2023,0.18072289156626503,1.506024096385542
2081,Ricardo Pepi,USA,FW,Augsburg,Bundesliga,19,2003,1.1,1,1,1,0,0,1,1,100.0,0,1,0,1,0,1,1,0,0,2022-2023,0.0,0.9090909090909091
2082,Pepín,EQG,MF,Monza,Serie A,25,1996,12.5,28,19,10,11,7,9,27,33.3,18,14,3,11,13,41,17,0,0,2022-2023,1.04,2.24
2083,Alberto Perea,ESP,MF,Cádiz,La Liga,31,1990,0.5,2,0,2,0,0,0,0,0.0,0,2,0,2,0,2,0,0,0,2022-2023,0.0,4.0
2084,Juan Perea,COL,FW,Stuttgart,Bundesliga,22,2000,4.6,5,4,0,2,3,2,4,50.0,2,2,1,1,1,6,3,0,0,2022-2023,0.2173913043478261,1.0869565217391306
2085,Andreas Pereira,BRA,MF,Fulham,Premier League,26,1996,29.9,18,9,3,6,9,8,34,23.5,26,21,3,18,6,24,8,0,0,2022-2023,0.20066889632107024,0.6020066889632107
2086,Brayann Pereira,FRA,DF,Auxerre,Ligue 1,19,2003,2.0,6,5,5,1,0,1,5,20.0,4,2,2,0,2,8,8,1,0,2022-2023,1.0,3.0
2087,Danilo Pereira,POR,"DF,MF",Paris S-G,Ligue 1,30,1991,26.8,32,17,15,14,3,19,26,73.1,7,26,19,7,36,68,59,1,0,2022-2023,1.3432835820895521,1.1940298507462686
2088,Mathias Pereira Lage,POR,"MF,FW",Brest,Ligue 1,25,1996,14.0,20,7,5,14,1,11,29,37.9,18,10,1,9,14,34,12,0,0,2022-2023,1.0,1.4285714285714286
2089,Ricardo Pereira,POR,"DF,MF",Leicester City,Premier League,28,1993,5.0,11,7,8,3,0,7,17,41.2,10,8,2,6,4,15,20,0,0,2022-2023,0.8,2.2
2090,Roberto Pereyra,ARG,"DF,MF",Udinese,Serie A,31,1991,31.3,36,20,21,12,3,16,44,36.4,28,20,5,15,16,52,28,0,0,2022-2023,0.5111821086261981,1.1501597444089458
2091,Ayoze Pérez,ESP,"MF,FW",Leicester City,Premier League,29,1993,4.2,11,8,5,4,2,8,19,42.1,11,6,0,6,2,13,3,0,0,2022-2023,0.47619047619047616,2.619047619047619
2092,Ayoze Pérez,ESP,"FW,MF",Betis,La Liga,29,1993,15.4,31,15,9,16,6,10,40,25.0,30,22,0,22,13,44,5,0,0,2022-2023,0.8441558441558441,2.012987012987013
2093,Carles Pérez,ESP,"MF,FW",Celta Vigo,La Liga,24,1998,23.8,39,23,12,17,10,22,66,33.3,44,29,3,26,6,45,9,0,0,2022-2023,0.25210084033613445,1.638655462184874
2094,Francisco Perez,ESP,"FW,MF",Valencia,La Liga,19,2002,1.6,1,1,1,0,0,0,3,0.0,3,0,0,0,0,1,1,0,0,2022-2023,0.0,0.625
2095,Kike Pérez,ESP,MF,Valladolid,La Liga,25,1997,25.6,67,33,30,32,5,25,68,36.8,43,26,7,19,20,87,28,0,0,2022-2023,0.78125,2.6171875
2096,Lucas Pérez,ESP,FW,Cádiz,La Liga,33,1988,7.0,3,2,2,1,0,1,3,33.3,2,2,0,2,1,4,3,0,0,2022-2023,0.14285714285714285,0.42857142857142855
2097,Luis Pérez,ESP,DF,Valladolid,La Liga,27,1995,13.5,44,24,26,12,6,27,38,71.1,11,13,4,9,16,60,29,0,0,2022-2023,1.1851851851851851,3.259259259259259
2098,Nehuén Pérez,ARG,DF,Udinese,Serie A,22,2000,31.3,77,40,54,20,3,39,55,70.9,16,53,23,30,35,112,106,1,0,2022-2023,1.1182108626198082,2.460063897763578
2099,Simone Perilli,ITA,GK,Hellas Verona,Serie A,27,1995,1.0,0,0,0,0,0,0,0,0.0,0,0,0,0,0,0,0,0,0,2022-2023,0.0,0.0
2100,Mattia Perin,ITA,GK,Juventus,Serie A,29,1992,10.5,0,0,0,0,0,0,0,0.0,0,0,0,0,0,0,0,0,0,2022-2023,0.0,0.0
Rk,Player,Nation,Pos,Squad,Comp,0,0,90.0,0,0,3,3,3,Tkl,0,0.0,0,0,0,0,0,0,0,0,0,2022-2023,0.0,0.0
2101,Samuele Perisan,ITA,GK,Empoli,Serie A,24,1997,7.0,0,0,0,0,0,0,0,0.0,0,0,0,0,0,0,2,0,0,2022-2023,0.0,0.0
2102,Ivan Perišić,CRO,"DF,MF",Tottenham,Premier League,33,1989,23.4,42,24,25,10,7,27,47,57.4,20,29,7,22,22,64,49,1,0,2022-2023,0.9401709401709403,1.794871794871795
2103,Romain Perraud,FRA,DF,Southampton,Premier League,24,1997,20.4,54,33,23,23,8,28,52,53.8,24,24,6,18,20,74,42,0,0,2022-2023,0.9803921568627452,2.647058823529412
2104,Gaëtan Perrin,FRA,"MF,FW",Auxerre,Ligue 1,26,1996,15.5,17,8,5,6,6,8,30,26.7,22,15,0,15,10,27,9,0,0,2022-2023,0.6451612903225806,1.096774193548387
2105,Lucas Perrin,FRA,DF,Strasbourg,Ligue 1,23,1998,19.6,44,27,28,14,2,25,49,51.0,24,13,5,8,36,80,53,0,0,2022-2023,1.8367346938775508,2.2448979591836733
2106,Máximo Perrone,ARG,MF,Manchester City,Premier League,19,2003,0.2,0,0,0,0,0,0,0,0.0,0,1,0,1,0,0,0,0,0,2022-2023,0.0,0.0
2107,Matteo Pessina,ITA,MF,Monza,Serie A,25,1997,32.6,57,36,28,21,8,26,62,41.9,36,50,15,35,37,94,33,1,0,2022-2023,1.1349693251533741,1.7484662576687116
2108,Andrea Petagna,ITA,FW,Monza,Serie A,27,1995,18.5,7,5,2,3,2,3,6,50.0,3,16,4,12,3,10,18,0,0,2022-2023,0.16216216216216217,0.3783783783783784
2109,Nils Petersen,GER,FW,Freiburg,Bundesliga,33,1988,3.1,6,4,0,3,3,2,5,40.0,3,11,2,9,1,7,6,0,0,2022-2023,0.3225806451612903,1.9354838709677418
2110,Lukas Petkov,BUL,"MF,FW",Augsburg,Bundesliga,21,2000,1.6,5,1,4,1,0,2,3,66.7,1,4,1,3,1,6,0,0,0,2022-2023,0.625,3.125
2111,Cameron Peupion,AUS,MF,Brighton,Premier League,19,2002,0.1,0,0,0,0,0,0,0,0.0,0,0,0,0,0,0,0,0,0,2022-2023,0.0,0.0
2112,Germán Pezzella,ARG,DF,Betis,La Liga,31,1991,27.9,41,28,32,9,0,26,38,68.4,12,32,15,17,50,91,129,1,0,2022-2023,1.7921146953405018,1.4695340501792116
2113,Giuseppe Pezzella,ITA,DF,Lecce,Serie A,24,1997,10.2,21,9,16,2,3,9,16,56.3,7,11,3,8,8,29,31,1,0,2022-2023,0.7843137254901962,2.058823529411765
2114,Luca Pfeiffer,GER,FW,Stuttgart,Bundesliga,25,1996,7.8,1,1,1,0,0,0,1,0.0,1,4,0,4,1,2,5,0,0,2022-2023,0.12820512820512822,0.12820512820512822
2115,Maximilian Philipp,GER,FW,Wolfsburg,Bundesliga,28,1994,1.3,2,1,1,1,0,1,1,100.0,0,1,0,1,0,2,0,0,0,2022-2023,0.0,1.5384615384615383
2116,Maximilian Philipp,GER,"FW,MF",Werder Bremen,Bundesliga,28,1994,4.9,6,5,3,2,1,1,9,11.1,8,7,1,6,3,9,4,0,0,2022-2023,0.6122448979591836,1.2244897959183672
2117,Kalvin Phillips,ENG,MF,Manchester City,Premier League,26,1995,3.3,6,4,3,3,0,2,10,20.0,8,7,3,4,5,11,10,0,0,2022-2023,1.5151515151515151,1.8181818181818183
2118,Nathaniel Phillips,ENG,DF,Liverpool,Premier League,25,1997,0.7,2,1,0,2,0,2,2,100.0,0,0,0,0,2,4,1,0,0,2022-2023,2.857142857142857,2.857142857142857
2119,Krzysztof Piątek,POL,FW,Salernitana,Serie A,27,1995,23.8,18,11,3,9,6,5,21,23.8,16,17,4,13,2,20,39,0,0,2022-2023,0.08403361344537814,0.7563025210084033
2120,Roberto Piccoli,ITA,FW,Hellas Verona,Serie A,21,2001,2.1,1,0,1,0,0,0,2,0.0,2,2,0,2,0,1,2,0,0,2022-2023,0.0,0.47619047619047616
2121,Roberto Piccoli,ITA,FW,Empoli,Serie A,21,2001,5.7,1,1,1,0,0,0,3,0.0,3,4,1,3,1,2,9,0,0,2022-2023,0.17543859649122806,0.17543859649122806
2122,Charles Pickel,COD,MF,Cremonese,Serie A,25,1997,27.6,55,23,25,26,4,32,57,56.1,25,37,5,32,24,79,36,1,0,2022-2023,0.8695652173913043,1.9927536231884058
2123,Jordan Pickford,ENG,GK,Everton,Premier League,28,1994,37.0,0,0,0,0,0,0,1,0.0,1,0,0,0,4,4,15,3,0,2022-2023,0.10810810810810811,0.0
2124,Amos Pieper,GER,DF,Werder Bremen,Bundesliga,24,1998,21.7,46,28,25,19,2,24,40,60.0,16,23,11,12,30,76,94,1,0,2022-2023,1.3824884792626728,2.119815668202765
2125,Ronaël Pierre-Gabriel,FRA,DF,Espanyol,La Liga,24,1998,2.6,17,9,12,4,1,5,11,45.5,6,5,2,3,9,26,11,0,0,2022-2023,3.4615384615384612,6.538461538461538
Rk,Player,Nation,Pos,Squad,Comp,0,0,90.0,0,0,3,3,3,Tkl,0,0.0,0,0,0,0,0,0,0,0,0,2022-2023,0.0,0.0
2126,Ronaël Pierre-Gabriel,FRA,DF,Strasbourg,Ligue 1,24,1998,7.3,25,18,11,12,2,15,17,88.2,2,16,3,13,9,34,22,0,0,2022-2023,1.2328767123287672,3.4246575342465753
2127,Andrea Pinamonti,ITA,FW,Sassuolo,Serie A,23,1999,24.0,10,7,0,5,5,3,7,42.9,4,19,2,17,2,12,11,0,0,2022-2023,0.08333333333333333,0.4166666666666667
2128,Ethan Pinnock,JAM,DF,Brentford,Premier League,29,1993,30.0,52,28,33,12,7,18,24,75.0,6,41,31,10,35,87,215,2,0,2022-2023,1.1666666666666667,1.7333333333333334
2129,Yeremi Pino,ESP,"FW,MF",Villarreal,La Liga,19,2002,27.2,62,38,25,20,17,21,56,37.5,35,41,4,37,15,77,36,0,0,2022-2023,0.5514705882352942,2.2794117647058822
2130,Gerard Piqué,ESP,DF,Barcelona,La Liga,35,1987,4.3,5,4,1,4,0,4,4,100.0,0,2,1,1,2,7,19,0,0,2022-2023,0.46511627906976744,1.1627906976744187
2131,Lorenzo Pirola,ITA,DF,Salernitana,Serie A,20,2002,21.6,33,29,18,14,1,19,27,70.4,8,50,35,15,30,63,85,1,0,2022-2023,1.3888888888888888,1.5277777777777777
2132,Niccolò Pisilli,ITA,MF,Roma,Serie A,17,2004,0.0,0,0,0,0,0,0,0,0.0,0,0,0,0,0,0,0,0,0,2022-2023,,
2133,Marko Pjaca,CRO,"MF,FW",Empoli,Serie A,27,1995,5.8,4,3,3,1,0,3,5,60.0,2,3,0,3,3,7,3,0,0,2022-2023,0.5172413793103449,0.6896551724137931
2134,Óscar Plano,ESP,"FW,MF",Valladolid,La Liga,31,1991,22.6,40,25,9,17,14,12,37,32.4,25,26,2,24,29,69,23,0,0,2022-2023,1.2831858407079646,1.7699115044247786
2135,Gonzalo Plata,ECU,FW,Valladolid,La Liga,21,2000,25.6,66,35,31,24,11,23,70,32.9,47,40,0,40,12,78,10,1,0,2022-2023,0.46875,2.578125
2136,Marvin Plattenhardt,GER,DF,Hertha BSC,Bundesliga,30,1992,26.7,43,33,24,15,4,29,47,61.7,18,25,11,14,15,58,82,0,0,2022-2023,0.5617977528089888,1.6104868913857677
2137,Alassane Pléa,FRA,FW,Gladbach,Bundesliga,29,1993,19.7,16,8,5,7,4,8,26,30.8,18,23,3,20,12,28,14,0,0,2022-2023,0.6091370558375635,0.8121827411167513
2138,Tommaso Pobega,ITA,MF,Milan,Serie A,23,1999,9.8,27,16,8,15,4,13,20,65.0,7,12,4,8,9,36,11,0,0,2022-2023,0.9183673469387754,2.7551020408163263
2139,Daniel Podence,POR,"FW,MF",Wolves,Premier League,26,1995,19.7,27,17,13,9,5,6,32,18.8,26,19,0,19,7,34,6,0,0,2022-2023,0.3553299492385787,1.3705583756345179
2140,Paul Pogba,FRA,"MF,FW",Juventus,Serie A,29,1993,1.2,0,0,0,0,0,0,1,0.0,1,0,0,0,0,0,2,0,0,2022-2023,0.0,0.0
2141,Joel Pohjanpalo,FIN,"FW,MF",Leverkusen,Bundesliga,27,1994,0.0,0,0,0,0,0,0,0,0.0,0,0,0,0,0,0,0,0,0,2022-2023,,
2142,Matteo Politano,ITA,FW,Napoli,Serie A,28,1993,13.0,18,9,9,5,4,11,25,44.0,14,6,0,6,7,25,7,0,0,2022-2023,0.5384615384615384,1.3846153846153846
2143,Sebastian Polter,GER,FW,Schalke 04,Bundesliga,31,1991,7.0,4,3,0,4,0,1,4,25.0,3,4,0,4,1,5,6,0,0,2022-2023,0.14285714285714285,0.5714285714285714
2144,Ezequiel Ponce,ARG,"FW,MF",Elche,La Liga,25,1997,12.5,9,7,0,6,3,0,7,0.0,7,6,1,5,1,10,13,0,0,2022-2023,0.08,0.72
2145,Julien Ponceau,FRA,MF,Lorient,Ligue 1,21,2000,18.4,28,19,10,14,4,10,32,31.3,22,27,3,24,14,42,12,0,0,2022-2023,0.7608695652173914,1.5217391304347827
2146,Marin Pongračić,CRO,DF,Lecce,Serie A,24,1997,8.8,16,14,8,7,1,5,7,71.4,2,4,3,1,16,32,31,0,0,2022-2023,1.8181818181818181,1.8181818181818181
2147,Nick Pope,ENG,GK,Newcastle Utd,Premier League,30,1992,36.2,1,0,1,0,0,1,3,33.3,2,0,0,0,0,1,27,2,0,2022-2023,0.0,0.027624309392265192
2148,Łukasz Poręba,POL,MF,Lens,Ligue 1,22,2000,2.9,5,4,2,1,2,2,3,66.7,1,3,0,3,4,9,2,0,0,2022-2023,1.3793103448275863,1.7241379310344829
2149,Jackson Porozo,ECU,DF,Troyes,Ligue 1,21,2000,18.0,32,20,24,7,1,13,31,41.9,18,24,17,7,33,65,75,0,0,2022-2023,1.8333333333333333,1.7777777777777777
2150,Pedro Porro,ESP,"DF,MF",Tottenham,Premier League,22,1999,12.6,25,16,8,15,2,14,39,35.9,25,25,2,23,15,40,24,1,0,2022-2023,1.1904761904761905,1.9841269841269842
Rk,Player,Nation,Pos,Squad,Comp,0,0,90.0,0,0,3,3,3,Tkl,0,0.0,0,0,0,0,0,0,0,0,0,2022-2023,0.0,0.0
2151,Francisco Portillo,ESP,"MF,FW",Almería,La Liga,32,1990,8.0,13,6,4,5,4,3,16,18.8,13,7,1,6,7,20,8,0,0,2022-2023,0.875,1.625
2152,Portu,ESP,"MF,DF",Getafe,La Liga,30,1992,19.7,28,21,14,10,4,18,42,42.9,24,23,3,20,17,45,20,1,0,2022-2023,0.8629441624365483,1.4213197969543148
2153,Stefan Posch,AUT,DF,Bologna,Serie A,25,1997,28.1,81,43,41,29,11,44,75,58.7,31,44,15,29,35,116,69,0,0,2022-2023,1.2455516014234875,2.882562277580071
2154,Stefan Posch,AUT,DF,Hoffenheim,Bundesliga,25,1997,0.2,0,0,0,0,0,0,0,0.0,0,0,0,0,0,0,0,0,0,2022-2023,0.0,0.0
2155,Yussuf Poulsen,DEN,FW,RB Leipzig,Bundesliga,28,1994,4.6,6,4,1,4,1,2,5,40.0,3,3,1,2,0,6,5,0,0,2022-2023,0.0,1.3043478260869565
2156,José Pozo,ESP,"MF,FW",Rayo Vallecano,La Liga,26,1996,1.0,2,2,0,2,0,0,0,0.0,0,0,0,0,1,3,1,0,0,2022-2023,1.0,2.0
2157,Manuel Pozo,ESP,FW,Valladolid,La Liga,20,2001,0.2,0,0,0,0,0,0,0,0.0,0,2,0,2,2,2,0,0,0,2022-2023,10.0,0.0
2158,Alejandro Pozo Pozo,ESP,DF,Almería,La Liga,23,1999,20.9,37,19,17,17,3,27,53,50.9,26,30,5,25,26,63,45,1,0,2022-2023,1.244019138755981,1.7703349282296652
2159,Dennis Praet,BEL,"MF,FW",Leicester City,Premier League,28,1994,7.2,12,9,5,6,1,6,11,54.5,5,12,2,10,5,17,6,0,0,2022-2023,0.6944444444444444,1.6666666666666665
2160,Abdón Prats,ESP,"FW,MF",Mallorca,La Liga,29,1992,4.6,1,0,1,0,0,0,0,0.0,0,5,0,5,0,1,2,0,0,2022-2023,0.0,0.2173913043478261
2161,Sanjin Prcić,BIH,MF,Strasbourg,Ligue 1,28,1993,18.1,27,12,6,16,5,19,31,61.3,12,22,7,15,25,52,22,0,0,2022-2023,1.3812154696132595,1.4917127071823204
2162,Isaac Price,NIR,MF,Everton,Premier League,18,2003,0.4,0,0,0,0,0,0,1,0.0,1,1,1,0,0,0,0,0,0,2022-2023,0.0,0.0
2163,Grischa Prömel,GER,MF,Hoffenheim,Bundesliga,27,1995,16.2,27,19,14,11,2,9,25,36.0,16,22,4,18,8,35,23,0,0,2022-2023,0.4938271604938272,1.6666666666666667
2164,Ivan Provedel,ITA,GK,Lazio,Serie A,28,1994,37.9,1,0,1,0,0,0,0,0.0,0,0,0,0,0,1,15,1,0,2022-2023,0.0,0.026385224274406333
2165,Javi Puado,ESP,"FW,MF",Espanyol,La Liga,24,1998,26.0,20,11,12,5,3,12,28,42.9,16,12,2,10,10,30,14,0,0,2022-2023,0.38461538461538464,0.7692307692307693
2166,Mehdi Puch-Herrantz,FRA,MF,Ajaccio,Ligue 1,18,2004,0.5,2,2,0,1,1,1,2,50.0,1,1,0,1,3,5,0,0,0,2022-2023,6.0,4.0
2167,Tymoteusz Puchacz,POL,DF,Union Berlin,Bundesliga,23,1999,0.6,1,0,1,0,0,0,0,0.0,0,0,0,0,0,1,1,0,0,2022-2023,0.0,1.6666666666666667
2168,Arnau Puigmal,ESP,"MF,FW",Almería,La Liga,21,2001,8.5,22,14,10,7,5,12,17,70.6,5,7,0,7,11,33,6,0,0,2022-2023,1.2941176470588236,2.588235294117647
2169,Christian Pulisic,USA,"FW,DF",Chelsea,Premier League,23,1998,9.1,11,6,3,6,2,3,5,60.0,2,8,1,7,4,15,4,0,0,2022-2023,0.43956043956043955,1.208791208791209
2170,Ignacio Pussetto,ARG,"MF,DF",Sampdoria,Serie A,26,1995,1.7,6,3,2,3,1,3,4,75.0,1,4,0,4,0,6,3,0,0,2022-2023,0.0,3.5294117647058822
2171,Niklas Pyyhtiä,FIN,MF,Bologna,Serie A,18,2003,1.2,1,0,0,1,0,0,1,0.0,1,1,1,0,1,2,4,0,0,2022-2023,0.8333333333333334,0.8333333333333334
2172,Fabio Quagliarella,ITA,FW,Sampdoria,Serie A,39,1983,8.9,2,1,1,1,0,1,7,14.3,6,5,1,4,0,2,9,0,0,2022-2023,0.0,0.2247191011235955
2173,Giacomo Quagliata,ITA,DF,Cremonese,Serie A,22,2000,7.8,10,8,7,1,2,5,11,45.5,6,7,2,5,11,21,8,0,0,2022-2023,1.4102564102564104,1.2820512820512822
2174,Eduardo Quaresma,POR,DF,Hoffenheim,Bundesliga,20,2002,1.0,5,3,3,2,0,1,3,33.3,2,3,2,1,0,5,3,0,0,2022-2023,0.0,5.0
2175,Joshua Quarshie,GER,MF,Hoffenheim,Bundesliga,18,2004,0.0,0,0,0,0,0,0,0,0.0,0,0,0,0,0,0,0,0,0,2022-2023,,
Rk,Player,Nation,Pos,Squad,Comp,0,0,90.0,0,0,3,3,3,Tkl,0,0.0,0,0,0,0,0,0,0,0,0,2022-2023,0.0,0.0
2176,Ghjuvanni Quilichini,FRA,GK,Ajaccio,Ligue 1,19,2002,0.9,0,0,0,0,0,0,0,0.0,0,0,0,0,0,0,1,0,0,2022-2023,0.0,0.0
2177,Domingos Quina,POR,MF,Elche,La Liga,22,1999,3.1,3,2,2,1,0,1,3,33.3,2,5,0,5,3,6,1,0,0,2022-2023,0.9677419354838709,0.9677419354838709
2178,Rubén Quintanilla,ESP,DF,Mallorca,La Liga,20,2002,0.0,0,0,0,0,0,0,0,0.0,0,1,0,1,0,0,0,0,0,2022-2023,,
2179,Adrien Rabiot,FRA,MF,Juventus,Serie A,27,1995,30.5,65,35,31,23,11,30,57,52.6,27,37,7,30,26,91,44,1,0,2022-2023,0.8524590163934426,2.1311475409836067
2180,Nemanja Radonjić,SRB,"MF,FW",Torino,Serie A,26,1996,16.2,2,1,2,0,0,0,4,0.0,4,3,0,3,2,4,4,0,0,2022-2023,0.1234567901234568,0.1234567901234568
2181,Ivan Radovanović,SRB,"MF,DF",Salernitana,Serie A,33,1988,7.5,12,4,8,4,0,4,10,40.0,6,9,3,6,7,19,9,1,0,2022-2023,0.9333333333333333,1.6
2182,Ionuț Radu,ROU,GK,Cremonese,Serie A,25,1997,9.0,0,0,0,0,0,0,0,0.0,0,0,0,0,0,0,1,3,0,2022-2023,0.0,0.0
2183,Ionuț Radu,ROU,GK,Auxerre,Ligue 1,25,1997,17.0,0,0,0,0,0,0,0,0.0,0,0,0,0,0,0,3,3,0,2022-2023,0.0,0.0
2184,Ștefan Radu,ROU,FW,Lazio,Serie A,35,1986,0.0,0,0,0,0,0,0,0,0.0,0,0,0,0,0,0,0,0,0,2022-2023,,
2185,Antonio Raillo,ESP,DF,Mallorca,La Liga,30,1991,30.7,34,21,23,11,0,10,15,66.7,5,38,29,9,31,65,158,1,0,2022-2023,1.009771986970684,1.1074918566775245
2186,Antonio Raimondo,ITA,FW,Bologna,Serie A,18,2004,0.2,0,0,0,0,0,0,0,0.0,0,0,0,0,0,0,1,0,0,2022-2023,0.0,0.0
2187,Predrag Rajković,SRB,GK,Mallorca,La Liga,26,1995,36.0,0,0,0,0,0,0,2,0.0,2,0,0,0,0,0,16,1,0,2022-2023,0.0,0.0
2188,Ivan Rakitić,CRO,MF,Sevilla,La Liga,34,1988,19.9,37,26,10,18,9,19,40,47.5,21,21,1,20,27,64,20,0,0,2022-2023,1.35678391959799,1.8592964824120604
2189,Diant Ramaj,GER,GK,Eint Frankfurt,Bundesliga,20,2001,1.0,0,0,0,0,0,0,0,0.0,0,0,0,0,0,0,1,0,0,2022-2023,0.0,0.0
2190,Largie Ramazani,BEL,"FW,MF",Almería,La Liga,21,2001,15.6,15,9,6,3,6,8,27,29.6,19,11,0,11,15,30,10,0,0,2022-2023,0.9615384615384616,0.9615384615384616
2191,Simon Ramet,FRA,DF,Lille,Ligue 1,19,2003,0.0,0,0,0,0,0,0,0,0.0,0,0,0,0,0,0,0,0,0,2022-2023,,
2192,Adil Rami,FRA,DF,Troyes,Ligue 1,36,1985,17.7,19,14,13,5,1,17,32,53.1,15,23,16,7,25,44,75,3,0,2022-2023,1.4124293785310735,1.073446327683616
2193,Chris Ramos,ESP,FW,Cádiz,La Liga,25,1997,7.9,12,9,2,7,3,4,11,36.4,7,8,3,5,1,13,19,0,0,2022-2023,0.12658227848101264,1.5189873417721518
2194,Sergio Ramos,ESP,DF,Paris S-G,Ligue 1,36,1986,30.0,34,26,14,18,2,23,44,52.3,21,29,13,16,34,68,93,3,0,2022-2023,1.1333333333333333,1.1333333333333333
2195,Aaron Ramsdale,ENG,GK,Arsenal,Premier League,24,1998,38.0,1,1,1,0,0,1,1,100.0,0,0,0,0,0,1,20,6,0,2022-2023,0.0,0.02631578947368421
2196,Aaron Ramsey,WAL,MF,Nice,Ligue 1,31,1990,17.6,47,25,18,19,10,16,39,41.0,23,25,4,21,17,64,18,1,0,2022-2023,0.9659090909090908,2.6704545454545454
2197,Jacob Ramsey,ENG,"MF,FW",Aston Villa,Premier League,21,2001,29.3,69,39,23,35,11,32,69,46.4,37,48,8,40,23,92,34,0,0,2022-2023,0.7849829351535836,2.354948805460751
2198,Luca Ranieri,ITA,DF,Fiorentina,Serie A,23,1999,5.6,9,4,6,3,0,6,9,66.7,3,5,3,2,11,20,15,1,0,2022-2023,1.9642857142857144,1.6071428571428572
2199,Andrea Ranocchia,ITA,DF,Monza,Serie A,34,1988,0.5,3,1,1,2,0,3,4,75.0,1,5,5,0,0,3,7,0,0,2022-2023,0.0,6.0
2200,Filippo Ranocchia,ITA,MF,Monza,Serie A,21,2001,5.9,11,6,5,4,2,4,12,33.3,8,5,1,4,4,15,7,0,0,2022-2023,0.6779661016949152,1.8644067796610169
Rk,Player,Nation,Pos,Squad,Comp,0,0,90.0,0,0,3,3,3,Tkl,0,0.0,0,0,0,0,0,0,0,0,0,2022-2023,0.0,0.0
2201,Lilian Raolisoa,FRA,"DF,MF",Angers,Ligue 1,22,2000,1.9,11,9,6,3,2,7,10,70.0,3,3,1,2,3,14,5,0,0,2022-2023,1.5789473684210527,5.7894736842105265
2202,Raphinha,BRA,FW,Barcelona,La Liga,25,1996,23.0,29,19,10,7,12,11,31,35.5,20,33,1,32,14,43,11,1,0,2022-2023,0.6086956521739131,1.2608695652173914
2203,Nicolai Rapp,GER,"MF,DF",Werder Bremen,Bundesliga,25,1996,0.8,3,1,3,0,0,0,3,0.0,3,0,0,0,0,3,1,0,0,2022-2023,0.0,3.75
2204,Elba Rashani,KVX,"MF,FW",Clermont Foot,Ligue 1,29,1993,24.0,39,26,13,19,7,13,39,33.3,26,27,2,25,21,60,19,0,0,2022-2023,0.875,1.625
2205,Marcus Rashford,ENG,FW,Manchester Utd,Premier League,24,1997,32.0,20,10,7,8,5,9,24,37.5,15,31,4,27,7,27,14,0,0,2022-2023,0.21875,0.625
2206,Giacomo Raspadori,ITA,FW,Sassuolo,Serie A,22,2000,0.5,0,0,0,0,0,0,0,0.0,0,0,0,0,0,0,0,0,0,2022-2023,0.0,0.0
2207,Giacomo Raspadori,ITA,"FW,MF",Napoli,Serie A,22,2000,10.1,10,8,0,6,4,4,10,40.0,6,9,0,9,4,14,4,0,0,2022-2023,0.39603960396039606,0.9900990099009901
2208,Rafael Ratão,BRA,"FW,MF",Toulouse,Ligue 1,26,1995,20.6,52,36,29,16,7,27,73,37.0,46,34,0,34,21,73,7,0,0,2022-2023,1.0194174757281553,2.524271844660194
2209,David Raum,GER,"DF,MF",RB Leipzig,Bundesliga,24,1998,18.7,39,25,23,12,4,17,29,58.6,12,24,6,18,16,55,26,1,0,2022-2023,0.8556149732620321,2.085561497326203
2210,Nicola Ravaglia,ITA,GK,Sampdoria,Serie A,33,1988,9.0,0,0,0,0,0,0,1,0.0,1,0,0,0,0,0,7,0,0,2022-2023,0.0,0.0
2211,Rayan Raveloson,MAD,"DF,MF",Auxerre,Ligue 1,25,1997,27.0,38,23,21,16,1,23,33,69.7,10,43,12,31,39,77,70,0,0,2022-2023,1.4444444444444444,1.4074074074074074
2212,David Raya,ESP,GK,Brentford,Premier League,26,1995,38.0,0,0,0,0,0,0,2,0.0,2,1,0,1,1,1,10,3,0,2022-2023,0.02631578947368421,0.0
2213,Tim Ream,USA,DF,Fulham,Premier League,34,1987,32.2,30,16,15,12,3,13,26,50.0,13,45,24,21,41,71,116,3,0,2022-2023,1.2732919254658384,0.9316770186335402
2214,Ante Rebić,CRO,"FW,MF",Milan,Serie A,28,1993,10.9,10,8,1,3,6,3,11,27.3,8,6,1,5,1,11,5,0,0,2022-2023,0.09174311926605504,0.9174311926605504
2215,Arkadiusz Reca,POL,DF,Spezia,Serie A,27,1995,24.1,44,28,22,12,10,19,32,59.4,13,21,5,16,24,68,54,0,0,2022-2023,0.9958506224066389,1.8257261410788381
2216,Nathan Redmond,ENG,DF,Southampton,Premier League,28,1994,0.0,0,0,0,0,0,0,0,0.0,0,0,0,0,0,0,0,0,0,2022-2023,,
2217,Harrison Reed,ENG,MF,Fulham,Premier League,27,1995,31.8,44,27,17,21,6,16,51,31.4,35,54,12,42,19,63,36,0,0,2022-2023,0.5974842767295597,1.3836477987421383
2218,Sergio Reguilón,ESP,DF,Atlético Madrid,La Liga,25,1996,3.4,7,5,5,2,0,5,7,71.4,2,3,0,3,2,9,4,0,0,2022-2023,0.5882352941176471,2.058823529411765
2219,Bobby Reid,JAM,"FW,DF",Fulham,Premier League,29,1993,27.5,42,24,14,14,14,16,36,44.4,20,25,3,22,20,62,28,1,0,2022-2023,0.7272727272727273,1.5272727272727273
2220,Pepe Reina,ESP,GK,Villarreal,La Liga,39,1982,22.0,0,0,0,0,0,0,1,0.0,1,0,0,0,1,1,4,4,0,2022-2023,0.045454545454545456,0.0
2221,Jeff Reine-Adélaïde,FRA,MF,Troyes,Ligue 1,24,1998,2.6,3,2,2,1,0,1,2,50.0,1,2,0,2,2,5,1,0,0,2022-2023,0.7692307692307692,1.1538461538461537
2222,Jeff Reine-Adélaïde,FRA,MF,Lyon,Ligue 1,24,1998,3.7,8,5,1,5,2,5,9,55.6,4,4,0,4,6,14,0,0,0,2022-2023,1.6216216216216215,2.162162162162162
2223,Reinier,BRA,"MF,FW",Girona,La Liga,20,2002,7.2,12,10,7,3,2,2,8,25.0,6,6,0,6,5,17,4,0,0,2022-2023,0.6944444444444444,1.6666666666666665
2224,Rocco Reitz,GER,MF,Gladbach,Bundesliga,20,2002,0.0,0,0,0,0,0,0,0,0.0,0,0,0,0,0,0,0,0,0,2022-2023,,
2225,Karim Rekik,NED,DF,Sevilla,La Liga,27,1994,13.1,11,5,8,3,0,4,5,80.0,1,12,5,7,10,21,24,0,0,2022-2023,0.7633587786259542,0.8396946564885497
Rk,Player,Nation,Pos,Squad,Comp,0,0,90.0,0,0,3,3,3,Tkl,0,0.0,0,0,0,0,0,0,0,0,0,2022-2023,0.0,0.0
2226,Álex Remiro,ESP,GK,Real Sociedad,La Liga,27,1995,38.0,1,1,1,0,0,1,3,33.3,2,0,0,0,0,1,17,3,0,2022-2023,0.0,0.02631578947368421
2227,Panagiotis Retsos,GRE,DF,Hellas Verona,Serie A,23,1998,1.4,5,4,2,2,1,3,3,100.0,0,4,1,3,2,7,3,0,0,2022-2023,1.4285714285714286,3.5714285714285716
2228,Marco Reus,GER,"MF,FW",Dortmund,Bundesliga,33,1989,15.0,30,17,12,14,4,7,24,29.2,17,12,4,8,8,38,8,0,0,2022-2023,0.5333333333333333,2.0
2229,Alejandro Revuelta Montero,ESP,DF,Getafe,La Liga,22,2000,0.0,0,0,0,0,0,0,0,0.0,0,0,0,0,0,0,1,0,0,2022-2023,,
2230,Elvis Rexhbeçaj,GER,MF,Augsburg,Bundesliga,24,1997,28.0,51,30,18,24,9,29,59,49.2,30,39,12,27,17,68,40,0,0,2022-2023,0.6071428571428571,1.8214285714285714
2231,Gio Reyna,USA,"FW,MF",Dortmund,Bundesliga,19,2002,6.9,14,7,2,5,7,5,10,50.0,5,8,2,6,3,17,5,0,0,2022-2023,0.43478260869565216,2.0289855072463765
2232,Chadi Riad,MAR,MF,Barcelona,La Liga,19,2003,0.0,0,0,0,0,0,0,0,0.0,0,0,0,0,0,0,0,0,0,2022-2023,,
2233,Nico Ribaudo,ESP,"MF,FW",Espanyol,La Liga,21,2001,13.9,18,13,5,9,4,11,30,36.7,19,19,1,18,5,23,1,0,0,2022-2023,0.3597122302158273,1.2949640287769784
2234,Alexsandro Ribeiro,BRA,DF,Lille,Ligue 1,22,1999,17.9,32,18,24,7,1,19,28,67.9,9,11,2,9,25,57,59,1,0,2022-2023,1.3966480446927376,1.787709497206704
2235,Franck Ribéry,FRA,MF,Salernitana,Serie A,39,1983,0.4,0,0,0,0,0,0,0,0.0,0,1,0,1,0,0,0,0,0,2022-2023,0.0,0.0
2236,Samuele Ricci,ITA,MF,Torino,Serie A,20,2001,23.0,32,21,17,10,5,18,23,78.3,5,20,5,15,17,49,29,1,0,2022-2023,0.7391304347826086,1.391304347826087
2237,Declan Rice,ENG,MF,West Ham,Premier League,23,1999,36.4,79,38,44,31,4,31,50,62.0,19,45,15,30,63,142,58,0,0,2022-2023,1.7307692307692308,2.1703296703296706
2238,Chris Richards,USA,DF,Crystal Palace,Premier League,22,2000,5.0,9,6,8,1,0,5,7,71.4,2,10,1,9,8,17,31,0,0,2022-2023,1.6,1.8
2239,Richarlison,BRA,"MF,FW",Tottenham,Premier League,25,1997,11.2,21,16,13,5,3,12,27,44.4,15,14,1,13,5,26,10,0,0,2022-2023,0.44642857142857145,1.8750000000000002
2240,Marco Richter,GER,"MF,FW",Hertha BSC,Bundesliga,24,1997,20.4,43,23,18,17,8,19,48,39.6,29,29,2,27,24,67,25,0,0,2022-2023,1.1764705882352942,2.107843137254902
2241,Diego Rico,ESP,DF,Real Sociedad,La Liga,29,1993,18.3,35,21,17,11,7,12,27,44.4,15,18,5,13,20,55,51,1,0,2022-2023,1.0928961748633879,1.9125683060109289
2242,Jaïro Riedewald,NED,"DF,MF",Crystal Palace,Premier League,25,1996,0.7,2,1,2,0,0,0,1,0.0,1,2,0,2,0,2,4,0,0,2022-2023,0.0,2.857142857142857
2243,Manuel Riemann,GER,GK,Bochum,Bundesliga,33,1988,34.0,3,2,3,0,0,3,5,60.0,2,1,0,1,5,8,23,7,0,2022-2023,0.14705882352941177,0.08823529411764706
2244,Tomás Rincón,VEN,MF,Sampdoria,Serie A,34,1988,28.4,56,27,22,26,8,29,61,47.5,32,37,7,30,30,86,18,0,0,2022-2023,1.0563380281690142,1.971830985915493
2245,Rémy Riou,FRA,GK,Lyon,Ligue 1,34,1987,6.7,1,0,1,0,0,1,1,100.0,0,0,0,0,0,1,3,0,0,2022-2023,0.0,0.14925373134328357
2246,Renaud Ripart,FRA,"FW,MF",Troyes,Ligue 1,29,1993,14.7,40,23,14,20,6,19,52,36.5,33,29,2,27,7,47,5,0,0,2022-2023,0.4761904761904762,2.7210884353741496
2247,Rodrigo Riquelme,ESP,"MF,FW",Girona,La Liga,22,2000,24.2,20,8,8,8,4,9,35,25.7,26,16,0,16,11,31,5,0,0,2022-2023,0.4545454545454546,0.8264462809917356
2248,Matt Ritchie,SCO,"FW,MF",Newcastle Utd,Premier League,32,1989,0.4,1,1,0,1,0,1,3,33.3,2,0,0,0,1,2,0,0,0,2022-2023,2.5,2.5
2249,Sergi Roberto,ESP,"DF,MF",Barcelona,La Liga,30,1992,14.5,22,15,12,6,4,7,18,38.9,11,15,7,8,11,33,16,0,0,2022-2023,0.7586206896551724,1.5172413793103448
2250,Lucas Robertone,ARG,MF,Almería,La Liga,25,1997,31.6,50,28,20,21,9,28,64,43.8,36,45,7,38,46,96,46,1,0,2022-2023,1.4556962025316456,1.5822784810126582
Rk,Player,Nation,Pos,Squad,Comp,0,0,90.0,0,0,3,3,3,Tkl,0,0.0,0,0,0,0,0,0,0,0,0,2022-2023,0.0,0.0
2251,Andrew Robertson,SCO,DF,Liverpool,Premier League,28,1994,28.7,38,21,12,16,10,21,41,51.2,20,32,5,27,18,56,50,3,0,2022-2023,0.6271777003484321,1.32404181184669
2252,Antonee Robinson,USA,DF,Fulham,Premier League,24,1997,34.3,62,38,43,15,4,44,65,67.7,21,49,13,36,53,115,83,3,0,2022-2023,1.545189504373178,1.8075801749271139
2253,Joel Robles,ESP,GK,Leeds United,Premier League,32,1990,4.0,0,0,0,0,0,0,1,0.0,1,0,0,0,0,0,2,1,0,2022-2023,0.0,0.0
2254,Joel Roca,ESP,"MF,FW",Girona,La Liga,17,2005,0.9,2,2,2,0,0,2,5,40.0,3,1,1,0,0,2,1,0,0,2022-2023,0.0,2.2222222222222223
2255,Marc Roca,ESP,MF,Leeds United,Premier League,25,1996,25.7,66,40,27,34,5,20,65,30.8,45,34,10,24,23,89,24,2,0,2022-2023,0.8949416342412452,2.568093385214008
2256,Enzo Roco,CHI,DF,Elche,La Liga,29,1992,18.4,33,13,23,10,0,15,24,62.5,9,22,15,7,17,50,63,1,0,2022-2023,0.923913043478261,1.7934782608695654
2257,Marek Rodák,SVK,GK,Fulham,Premier League,25,1996,2.0,0,0,0,0,0,0,0,0.0,0,0,0,0,0,0,1,1,0,2022-2023,0.0,0.0
2258,Sebastian Rode,GER,MF,Eint Frankfurt,Bundesliga,31,1990,15.7,38,24,7,28,3,14,45,31.1,31,18,2,16,16,54,12,0,0,2022-2023,1.019108280254777,2.4203821656050954
2259,Joe Rodon,WAL,DF,Rennes,Ligue 1,24,1997,15.7,11,7,9,2,0,4,10,40.0,6,16,12,4,9,20,54,1,0,2022-2023,0.5732484076433121,0.7006369426751593
2260,Rodri,ESP,MF,Manchester City,Premier League,26,1996,32.3,67,41,28,28,11,26,53,49.1,27,40,14,26,33,100,43,1,0,2022-2023,1.021671826625387,2.0743034055727554
2261,Rodri,ESP,"FW,MF",Betis,La Liga,22,2000,17.8,16,11,5,9,2,8,17,47.1,9,10,0,10,13,29,2,0,0,2022-2023,0.7303370786516854,0.898876404494382
2262,Rodrigo,ESP,"FW,MF",Leeds United,Premier League,31,1991,21.5,24,10,2,15,7,8,19,42.1,11,16,4,12,6,30,21,1,0,2022-2023,0.27906976744186046,1.1162790697674418
2263,Ángel Rodríguez,ESP,"FW,MF",Mallorca,La Liga,35,1987,4.4,1,1,0,1,0,0,2,0.0,2,3,0,3,1,2,1,0,0,2022-2023,0.22727272727272727,0.22727272727272727
2264,Óscar Rodríguez Arnaiz,ESP,MF,Celta Vigo,La Liga,24,1998,19.7,32,25,12,15,5,13,28,46.4,15,16,2,14,24,56,15,0,0,2022-2023,1.218274111675127,1.6243654822335025
2265,Dani Rodríguez,ESP,MF,Mallorca,La Liga,34,1988,23.3,42,23,18,22,2,21,46,45.7,25,31,8,23,21,63,14,0,0,2022-2023,0.9012875536480687,1.8025751072961373
2266,Guido Rodríguez,ARG,MF,Betis,La Liga,28,1994,31.9,115,75,59,50,6,54,101,53.5,47,58,14,44,42,157,76,1,0,2022-2023,1.316614420062696,3.6050156739811916
2267,Miguel Rodríguez,ESP,"MF,FW",Celta Vigo,La Liga,19,2003,2.8,7,5,4,3,0,4,11,36.4,7,6,0,6,1,8,3,0,0,2022-2023,0.35714285714285715,2.5
2268,Pablo Rodríguez,ESP,"FW,MF",Lecce,Serie A,20,2001,0.6,2,1,2,0,0,0,2,0.0,2,3,0,3,0,2,0,0,0,2022-2023,0.0,3.3333333333333335
2269,Ricardo Rodríguez,SUI,DF,Torino,Serie A,29,1992,29.7,54,33,30,17,7,28,42,66.7,14,30,15,15,38,92,61,0,0,2022-2023,1.2794612794612794,1.8181818181818181
2270,Rodrygo,BRA,"FW,MF",Real Madrid,La Liga,21,2001,26.4,17,10,3,7,7,4,23,17.4,19,23,0,23,8,25,5,0,0,2022-2023,0.30303030303030304,0.6439393939393939
2271,Mads Roerslev,DEN,DF,Brentford,Premier League,23,1999,12.3,22,12,19,3,0,16,33,48.5,17,14,5,9,9,31,38,0,0,2022-2023,0.7317073170731707,1.7886178861788617
2272,Agustín Rogel,URU,DF,Hertha BSC,Bundesliga,24,1997,15.8,18,9,13,5,0,11,17,64.7,6,15,8,7,11,29,74,1,0,2022-2023,0.6962025316455696,1.1392405063291138
2273,Rogério,BRA,DF,Sassuolo,Serie A,24,1998,33.3,37,21,22,8,7,17,35,48.6,18,32,9,23,37,74,70,0,0,2022-2023,1.1111111111111112,1.1111111111111112
2274,Merlin Röhl,GER,"MF,FW",Freiburg,Bundesliga,20,2002,0.6,1,0,1,0,0,0,0,0.0,0,0,0,0,0,1,1,0,0,2022-2023,0.0,1.6666666666666667
2275,Tony Rölke,GER,FW,Hertha BSC,Bundesliga,19,2003,0.2,0,0,0,0,0,0,0,0.0,0,1,0,1,0,0,1,0,0,2022-2023,0.0,0.0
Rk,Player,Nation,Pos,Squad,Comp,0,0,90.0,0,0,3,3,3,Tkl,0,0.0,0,0,0,0,0,0,0,0,0,2022-2023,0.0,0.0
2276,Filippo Romagna,ITA,DF,Sassuolo,Serie A,25,1997,0.5,0,0,0,0,0,0,0,0.0,0,1,1,0,0,0,2,0,0,2022-2023,0.0,0.0
2277,Alessio Romagnoli,ITA,DF,Lazio,Serie A,27,1995,32.5,33,15,19,14,0,11,22,50.0,11,33,26,7,38,71,108,0,0,2022-2023,1.1692307692307693,1.0153846153846153
2278,Simone Romagnoli,ITA,DF,Lecce,Serie A,32,1990,1.9,6,5,3,3,0,2,2,100.0,0,4,1,3,1,7,11,0,0,2022-2023,0.5263157894736842,3.1578947368421053
2279,Leo Román,ESP,GK,Mallorca,La Liga,22,2000,1.0,0,0,0,0,0,0,0,0.0,0,0,0,0,0,0,0,0,0,2022-2023,0.0,0.0
2280,Cristian Romero,ARG,DF,Tottenham,Premier League,24,1998,26.3,68,36,42,24,2,29,46,63.0,17,40,18,22,44,112,102,3,0,2022-2023,1.6730038022813687,2.585551330798479
2281,Iván Romero,ESP,MF,Sevilla,La Liga,21,2001,0.1,0,0,0,0,0,0,0,0.0,0,0,0,0,0,0,0,0,0,2022-2023,0.0,0.0
2282,Luka Romero,ARG,FW,Lazio,Serie A,17,2004,1.7,0,0,0,0,0,0,3,0.0,3,4,0,4,3,3,1,0,0,2022-2023,1.7647058823529411,0.0
2283,Oriol Romeu,ESP,MF,Southampton,Premier League,30,1991,0.8,1,0,0,1,0,0,0,0.0,0,1,0,1,1,2,1,0,0,2022-2023,1.25,1.25
2284,Oriol Romeu,ESP,MF,Girona,La Liga,30,1991,32.8,70,38,36,26,8,26,51,51.0,25,48,10,38,37,107,54,0,0,2022-2023,1.128048780487805,2.1341463414634148
2285,Cristiano Ronaldo,POR,FW,Manchester Utd,Premier League,37,1985,5.8,2,2,1,0,1,1,2,50.0,1,0,0,0,1,3,9,0,0,2022-2023,0.1724137931034483,0.3448275862068966
2286,Connor Ronan,IRL,MF,Wolves,Premier League,24,1998,0.0,0,0,0,0,0,0,0,0.0,0,0,0,0,0,0,0,0,0,2022-2023,,
2287,Salomón Rondón,VEN,FW,Everton,Premier League,32,1989,1.2,0,0,0,0,0,0,0,0.0,0,1,1,0,0,0,0,0,0,2022-2023,0.0,0.0
2288,Valentin Rongier,FRA,MF,Marseille,Ligue 1,27,1994,33.7,93,59,33,47,13,41,77,53.2,36,50,11,39,54,147,38,1,0,2022-2023,1.602373887240356,2.759643916913946
2289,Marten de Roon,NED,MF,Atalanta,Serie A,31,1991,32.9,77,39,37,35,5,37,81,45.7,44,37,4,33,36,113,58,0,0,2022-2023,1.0942249240121582,2.3404255319148937
2290,Pablo Rosario,NED,"MF,DF",Nice,Ligue 1,25,1997,19.6,46,26,22,20,4,18,34,52.9,16,15,5,10,23,69,32,1,0,2022-2023,1.173469387755102,2.346938775510204
2291,Francesco Rossi,ITA,GK,Atalanta,Serie A,31,1991,0.0,0,0,0,0,0,0,0,0.0,0,0,0,0,0,0,0,0,0,2022-2023,,
2292,Tom Rothe,GER,DF,Dortmund,Bundesliga,17,2004,0.3,1,1,0,1,0,1,1,100.0,0,0,0,0,1,2,2,0,0,2022-2023,3.3333333333333335,3.3333333333333335
2293,Joe Rothwell,ENG,MF,Bournemouth,Premier League,27,1995,11.3,20,13,7,12,1,7,21,33.3,14,14,3,11,9,29,7,0,0,2022-2023,0.7964601769911503,1.7699115044247786
2294,Anthony Rouault,FRA,DF,Toulouse,Ligue 1,21,2001,36.8,66,37,54,10,2,30,58,51.7,28,52,26,26,56,122,126,4,0,2022-2023,1.5217391304347827,1.7934782608695654
2295,Jérôme Roussillon,FRA,"MF,DF",Wolfsburg,Bundesliga,29,1993,0.2,0,0,0,0,0,0,0,0.0,0,0,0,0,0,0,0,0,0,2022-2023,0.0,0.0
2296,Jérôme Roussillon,FRA,DF,Union Berlin,Bundesliga,29,1993,10.6,16,9,6,8,2,8,12,66.7,4,7,2,5,4,20,22,0,0,2022-2023,0.37735849056603776,1.509433962264151
2297,Nicolò Rovella,ITA,MF,Monza,Serie A,20,2001,19.3,45,29,22,21,2,13,36,36.1,23,20,1,19,40,85,17,0,0,2022-2023,2.0725388601036268,2.33160621761658
2298,Nicolò Rovella,ITA,MF,Juventus,Serie A,20,2001,0.3,1,1,0,1,0,1,1,100.0,0,0,0,0,0,1,0,0,0,2022-2023,0.0,3.3333333333333335
2299,Amir Rrahmani,KVX,DF,Napoli,Serie A,28,1994,27.2,33,18,20,13,0,17,26,65.4,9,36,20,16,14,47,79,1,0,2022-2023,0.5147058823529412,1.2132352941176472
2300,Ruan,BRA,DF,Sassuolo,Serie A,23,1999,19.0,38,26,25,12,1,19,29,65.5,10,29,17,12,24,62,80,3,0,2022-2023,1.263157894736842,2.0
Rk,Player,Nation,Pos,Squad,Comp,0,0,90.0,0,0,3,3,3,Tkl,0,0.0,0,0,0,0,0,0,0,0,0,2022-2023,0.0,0.0
2301,Rubén,ESP,"DF,MF",Espanyol,La Liga,21,2001,9.9,30,15,18,9,3,20,29,69.0,9,14,4,10,18,48,18,0,0,2022-2023,1.8181818181818181,3.0303030303030303
2302,Antonio Rüdiger,GER,DF,Real Madrid,La Liga,29,1993,26.8,18,16,12,5,1,14,23,60.9,9,23,13,10,19,37,74,0,0,2022-2023,0.708955223880597,0.6716417910447761
2303,Sebastian Rudy,GER,MF,Hoffenheim,Bundesliga,32,1990,8.8,26,12,10,16,0,13,27,48.1,14,27,7,20,11,37,13,0,0,2022-2023,1.25,2.954545454545454
2304,Daniele Rugani,ITA,DF,Juventus,Serie A,28,1994,6.3,7,0,6,1,0,4,4,100.0,0,7,5,2,7,14,32,0,0,2022-2023,1.1111111111111112,1.1111111111111112
2305,Matteo Ruggeri,ITA,"DF,MF",Atalanta,Serie A,20,2002,9.2,17,12,5,9,3,8,16,50.0,8,14,3,11,12,29,16,0,0,2022-2023,1.3043478260869565,1.847826086956522
2306,Mário Rui,POR,DF,Napoli,Serie A,31,1991,19.4,34,22,17,13,4,20,41,48.8,21,17,4,13,15,49,24,1,0,2022-2023,0.7731958762886598,1.752577319587629
2307,Aitor Ruibal,ESP,"DF,FW",Betis,La Liga,26,1996,16.2,47,29,35,9,3,31,58,53.4,27,17,2,15,24,71,41,0,0,2022-2023,1.4814814814814816,2.9012345679012346
2308,Kays Ruiz Atil,FRA,MF,Auxerre,Ligue 1,19,2002,0.7,1,1,1,0,0,0,1,0.0,1,2,1,1,3,4,0,0,0,2022-2023,4.285714285714286,1.4285714285714286
2309,Fabián Ruiz Peña,ESP,MF,Paris S-G,Ligue 1,26,1996,21.0,62,28,25,30,7,43,79,54.4,36,24,1,23,18,80,23,1,0,2022-2023,0.8571428571428571,2.9523809523809526
2310,Víctor Ruiz,ESP,DF,Betis,La Liga,33,1989,6.2,5,3,3,2,0,3,3,100.0,0,10,7,3,6,11,34,0,0,2022-2023,0.9677419354838709,0.8064516129032258
2311,Gerónimo Rulli,ARG,GK,Villarreal,La Liga,30,1992,14.0,0,0,0,0,0,0,0,0.0,0,1,0,1,1,1,6,2,0,2022-2023,0.07142857142857142,0.0
2312,Alessandro Russo,ITA,GK,Sassuolo,Serie A,21,2001,1.0,0,0,0,0,0,0,0,0.0,0,0,0,0,0,0,1,1,0,2022-2023,0.0,0.0
2313,Franco Russo,ARG,DF,Mallorca,La Liga,27,1994,1.6,2,1,2,0,0,0,1,0.0,1,5,0,5,3,5,5,0,0,2022-2023,1.875,1.25
2314,Georginio Rutter,FRA,"FW,MF",Leeds United,Premier League,20,2002,3.0,10,9,5,3,2,5,8,62.5,3,5,0,5,3,13,3,0,0,2022-2023,1.0,3.3333333333333335
2315,Georginio Rutter,FRA,FW,Hoffenheim,Bundesliga,20,2002,11.2,7,4,1,4,2,1,3,33.3,2,10,2,8,5,12,6,0,0,2022-2023,0.44642857142857145,0.625
2316,Julian Ryerson,NOR,DF,Union Berlin,Bundesliga,24,1997,11.5,28,17,17,10,1,15,25,60.0,10,15,3,12,12,40,19,0,0,2022-2023,1.0434782608695652,2.4347826086956523
2317,Julian Ryerson,NOR,DF,Dortmund,Bundesliga,24,1997,15.7,27,15,17,7,3,19,37,51.4,18,13,2,11,8,35,28,0,0,2022-2023,0.5095541401273885,1.7197452229299364
2318,Frederik Rønnow,DEN,GK,Union Berlin,Bundesliga,29,1992,29.0,0,0,0,0,0,0,5,0.0,5,0,0,0,0,0,9,1,0,2022-2023,0.0,0.0
2319,José Sá,POR,GK,Wolves,Premier League,29,1993,36.0,1,0,1,0,0,1,1,100.0,0,0,0,0,0,1,10,6,0,2022-2023,0.0,0.027777777777777776
2320,Youssouf Sabaly,SEN,DF,Betis,La Liga,29,1993,18.7,45,23,29,14,2,22,33,66.7,11,35,8,27,19,64,52,1,0,2022-2023,1.0160427807486632,2.4064171122994655
2321,Halid Šabanović,BIH,DF,Angers,Ligue 1,22,1999,7.1,8,6,7,1,0,6,8,75.0,2,8,2,6,8,16,12,0,0,2022-2023,1.1267605633802817,1.1267605633802817
2322,Abdelhamid Sabiri,MAR,"MF,FW",Sampdoria,Serie A,25,1996,11.9,18,7,5,9,4,4,13,30.8,9,18,4,14,2,20,5,0,0,2022-2023,0.1680672268907563,1.5126050420168067
2323,Marcel Sabitzer,AUT,MF,Manchester Utd,Premier League,28,1994,7.0,12,8,3,8,1,2,11,18.2,9,6,2,4,8,20,11,0,0,2022-2023,1.1428571428571428,1.7142857142857142
2324,Marcel Sabitzer,AUT,MF,Bayern Munich,Bundesliga,28,1994,7.0,27,14,11,10,6,10,17,58.8,7,3,0,3,10,37,9,0,0,2022-2023,1.4285714285714286,3.857142857142857
2325,Falaye Sacko,MLI,DF,Montpellier,Ligue 1,27,1995,28.7,46,25,25,15,6,32,51,62.7,19,43,14,29,33,79,75,1,0,2022-2023,1.1498257839721255,1.602787456445993
Rk,Player,Nation,Pos,Squad,Comp,0,0,90.0,0,0,3,3,3,Tkl,0,0.0,0,0,0,0,0,0,0,0,0,2022-2023,0.0,0.0
2326,Umar Sadiq,NGA,FW,Almería,La Liga,25,1997,2.7,0,0,0,0,0,0,1,0.0,1,2,0,2,0,0,3,0,0,2022-2023,0.0,0.0
2327,Umar Sadiq,NGA,FW,Real Sociedad,La Liga,25,1997,0.9,1,1,0,0,1,0,1,0.0,1,2,0,2,0,1,0,0,0,2022-2023,0.0,1.1111111111111112
2328,Alexis Saelemaekers,BEL,"FW,DF",Milan,Serie A,23,1999,15.6,31,20,12,16,3,19,41,46.3,22,13,1,12,19,50,11,0,0,2022-2023,1.217948717948718,1.9871794871794872
2329,Wesley Saïd,FRA,"FW,MF",Lens,Ligue 1,27,1995,7.2,4,1,1,2,1,2,6,33.3,4,4,0,4,1,5,2,0,0,2022-2023,0.1388888888888889,0.5555555555555556
2330,Allan Saint-Maximin,FRA,FW,Newcastle Utd,Premier League,25,1997,12.4,10,3,3,6,1,2,11,18.2,9,4,0,4,5,15,2,0,0,2022-2023,0.4032258064516129,0.8064516129032258
2331,Théo Sainte-Luce,FRA,DF,Montpellier,Ligue 1,23,1998,5.9,13,11,8,5,0,7,14,50.0,7,7,2,5,10,23,11,0,0,2022-2023,1.694915254237288,2.2033898305084745
2332,Samuel Sáiz,ESP,MF,Girona,La Liga,31,1991,2.7,2,2,0,2,0,1,2,50.0,1,3,0,3,0,2,1,1,0,2022-2023,0.0,0.7407407407407407
2333,Bukayo Saka,ENG,FW,Arsenal,Premier League,20,2001,35.3,63,34,22,15,26,20,44,45.5,24,38,0,38,14,77,19,0,0,2022-2023,0.39660056657223797,1.784702549575071
2334,Hamza Sakhi,FRA,MF,Auxerre,Ligue 1,26,1996,18.4,44,22,22,17,5,22,42,52.4,20,16,1,15,25,69,9,0,0,2022-2023,1.358695652173913,2.3913043478260874
2335,Mamadou Sakho,FRA,DF,Montpellier,Ligue 1,32,1990,8.5,9,5,4,5,0,3,5,60.0,2,17,12,5,8,17,35,1,0,2022-2023,0.9411764705882353,1.0588235294117647
2336,Jacopo Sala,ITA,MF,Spezia,Serie A,30,1991,1.2,1,0,1,0,0,0,2,0.0,2,2,0,2,1,2,2,0,0,2022-2023,0.8333333333333334,0.8333333333333334
2337,Ibrahim Salah,MAR,"FW,MF",Rennes,Ligue 1,20,2001,2.5,8,1,5,3,0,2,15,13.3,13,3,0,3,2,10,0,0,0,2022-2023,0.8,3.2
2338,Mohamed Salah,EGY,FW,Liverpool,Premier League,30,1992,36.6,21,12,4,5,12,10,26,38.5,16,21,0,21,6,27,4,0,0,2022-2023,0.16393442622950818,0.5737704918032787
2339,Amine Salama,FRA,"FW,MF",Angers,Ligue 1,22,2000,13.9,11,9,3,7,1,2,12,16.7,10,8,2,6,10,21,2,0,0,2022-2023,0.7194244604316546,0.7913669064748201
2340,Kike Salas,ESP,DF,Sevilla,La Liga,20,2002,4.1,1,1,1,0,0,0,0,0.0,0,4,3,1,5,6,23,0,0,2022-2023,1.2195121951219514,0.24390243902439027
2341,William Saliba,FRA,DF,Arsenal,Premier League,21,2001,26.8,34,20,23,9,2,15,18,83.3,3,13,10,3,19,53,85,4,0,2022-2023,0.708955223880597,1.2686567164179103
2342,Dikeni-Rafid Salifou,TOG,MF,Werder Bremen,Bundesliga,19,2003,0.0,0,0,0,0,0,0,0,0.0,0,0,0,0,0,0,0,0,0,2022-2023,,
2343,Mohammed Salisu,GHA,DF,Southampton,Premier League,23,1999,21.9,52,29,34,16,2,24,34,70.6,10,56,25,31,30,82,122,1,0,2022-2023,1.3698630136986303,2.3744292237442925
2344,Roland Sallai,HUN,"MF,FW",Freiburg,Bundesliga,25,1997,11.1,11,8,4,3,4,4,10,40.0,6,7,1,6,2,13,11,0,0,2022-2023,0.1801801801801802,0.990990990990991
2345,Yoann Salmier,GUF,DF,Troyes,Ligue 1,29,1992,29.4,51,29,34,12,5,21,35,60.0,14,34,19,15,39,90,124,0,0,2022-2023,1.326530612244898,1.7346938775510206
2346,Salvi,ESP,"FW,MF",Rayo Vallecano,La Liga,31,1991,5.4,13,8,5,5,3,2,8,25.0,6,0,0,0,2,15,2,0,0,2022-2023,0.37037037037037035,2.4074074074074074
2347,Lazar Samardzic,SRB,MF,Udinese,Serie A,20,2002,20.5,33,16,9,20,4,17,43,39.5,26,13,0,13,11,44,16,0,0,2022-2023,0.5365853658536586,1.6097560975609757
2348,Diadie Samassékou,MLI,"MF,FW",Hoffenheim,Bundesliga,26,1996,0.4,1,0,0,1,0,0,1,0.0,1,0,0,0,0,1,0,0,0,2022-2023,0.0,2.5
2349,Mama Samba Baldé,GNB,FW,Troyes,Ligue 1,26,1995,29.6,46,21,14,21,11,13,28,46.4,15,30,3,27,10,56,13,0,0,2022-2023,0.33783783783783783,1.554054054054054
2350,Brice Samba,FRA,GK,Lens,Ligue 1,28,1994,37.0,1,0,1,0,0,1,2,50.0,1,1,0,1,0,1,12,2,0,2022-2023,0.0,0.02702702702702703
Rk,Player,Nation,Pos,Squad,Comp,0,0,90.0,0,0,3,3,3,Tkl,0,0.0,0,0,0,0,0,0,0,0,0,2022-2023,0.0,0.0
2351,Albert Sambi Lokonga,BEL,MF,Arsenal,Premier League,22,1999,2.2,1,1,0,0,1,0,2,0.0,2,1,0,1,5,6,2,0,0,2022-2023,2.2727272727272725,0.45454545454545453
2352,Albert Sambi Lokonga,BEL,MF,Crystal Palace,Premier League,22,1999,6.0,13,10,7,4,2,8,12,66.7,4,8,3,5,7,20,10,0,0,2022-2023,1.1666666666666667,2.1666666666666665
2353,Junior Sambia,FRA,DF,Salernitana,Serie A,25,1996,7.7,12,5,7,4,1,6,10,60.0,4,9,3,6,8,20,16,1,0,2022-2023,1.0389610389610389,1.5584415584415585
2354,Fede San Emeterio,ESP,MF,Cádiz,La Liga,25,1997,20.5,41,22,23,16,2,22,46,47.8,24,34,14,20,17,58,28,0,0,2022-2023,0.8292682926829268,2.0
2355,Antonio Sanabria,PAR,FW,Torino,Serie A,26,1996,27.0,11,5,3,3,5,1,7,14.3,6,9,2,7,4,15,7,0,0,2022-2023,0.14814814814814814,0.4074074074074074
2356,Leandro Sanca,GNB,"FW,MF",Spezia,Serie A,22,2000,0.4,1,1,0,0,1,1,1,100.0,0,0,0,0,0,1,0,0,0,2022-2023,0.0,2.5
2357,Oihan Sancet,ESP,MF,Athletic Club,La Liga,22,2000,28.1,27,16,2,19,6,11,37,29.7,26,10,0,10,4,31,9,1,0,2022-2023,0.14234875444839856,0.9608540925266903
2358,Renato Sanches,POR,MF,Paris S-G,Ligue 1,24,1997,8.0,8,1,1,3,4,5,14,35.7,9,13,3,10,9,17,4,0,0,2022-2023,1.125,1.0
2359,Alexis Sánchez,CHI,"FW,MF",Marseille,Ligue 1,33,1988,29.8,27,17,5,16,6,3,24,12.5,21,14,0,14,5,32,6,0,0,2022-2023,0.16778523489932887,0.9060402684563759
2360,Antonio Sánchez,ESP,"MF,DF",Mallorca,La Liga,25,1997,12.0,19,8,13,4,2,10,34,29.4,24,18,0,18,22,41,14,1,0,2022-2023,1.8333333333333333,1.5833333333333333
2361,Davinson Sánchez,COL,DF,Tottenham,Premier League,26,1996,9.5,24,11,17,6,1,14,20,70.0,6,16,10,6,12,36,41,0,0,2022-2023,1.263157894736842,2.526315789473684
2362,Iván Sánchez,ESP,"MF,FW",Valladolid,La Liga,29,1992,12.8,20,14,8,8,4,10,27,37.0,17,14,1,13,8,28,4,0,0,2022-2023,0.625,1.5625
2363,Javi Sánchez,ESP,DF,Valladolid,La Liga,25,1997,26.6,43,26,27,15,1,17,26,65.4,9,32,22,10,46,89,116,0,0,2022-2023,1.7293233082706767,1.6165413533834585
2364,Manu Sánchez,ESP,DF,Osasuna,La Liga,21,2000,23.6,51,35,35,9,7,33,63,52.4,30,33,5,28,14,65,51,0,0,2022-2023,0.5932203389830508,2.1610169491525424
2365,Robert Sánchez,ESP,GK,Brighton,Premier League,24,1997,23.0,1,0,1,0,0,0,0,0.0,0,0,0,0,3,4,9,2,0,2022-2023,0.13043478260869565,0.043478260869565216
2366,Jadon Sancho,ENG,"FW,MF",Manchester Utd,Premier League,22,2000,18.7,16,10,7,5,4,8,28,28.6,20,25,2,23,7,23,6,0,0,2022-2023,0.37433155080213903,0.8556149732620321
2367,Alex Sandro,BRA,DF,Juventus,Serie A,31,1991,19.9,35,20,16,16,3,15,22,68.2,7,27,10,17,15,50,64,1,0,2022-2023,0.7537688442211056,1.7587939698492463
2368,Leroy Sané,GER,"MF,FW",Bayern Munich,Bundesliga,26,1996,22.3,38,30,11,19,8,18,36,50.0,18,11,1,10,3,41,1,2,0,2022-2023,0.13452914798206278,1.704035874439462
2369,Sidi Sané,GER,FW,Schalke 04,Bundesliga,19,2003,0.3,1,1,1,0,0,1,1,100.0,0,0,0,0,0,1,0,0,0,2022-2023,0.0,3.3333333333333335
2370,Morgan Sanson,FRA,MF,Aston Villa,Premier League,27,1994,0.1,2,1,1,1,0,1,1,100.0,0,0,0,0,0,2,0,0,0,2022-2023,0.0,20.0
2371,Morgan Sanson,FRA,MF,Strasbourg,Ligue 1,27,1994,15.8,36,25,10,16,10,17,56,30.4,39,21,1,20,22,58,9,0,0,2022-2023,1.3924050632911391,2.2784810126582276
2372,Nicola Sansone,ITA,FW,Bologna,Serie A,30,1991,8.2,12,4,6,4,2,5,10,50.0,5,0,0,0,0,12,4,0,0,2022-2023,0.0,1.4634146341463417
2373,Baptiste Santamaria,FRA,MF,Rennes,Ligue 1,27,1995,20.1,41,22,13,23,5,21,41,51.2,20,21,5,16,21,62,23,0,0,2022-2023,1.044776119402985,2.0398009950248754
2374,Riccardo Saponara,ITA,FW,Fiorentina,Serie A,30,1991,13.4,10,5,3,6,1,5,9,55.6,4,7,1,6,5,15,9,1,0,2022-2023,0.3731343283582089,0.7462686567164178
2375,Pablo Sarabia,ESP,"FW,MF",Wolves,Premier League,30,1992,8.5,12,6,4,5,3,6,15,40.0,9,7,0,7,2,14,4,0,0,2022-2023,0.23529411764705882,1.411764705882353
Rk,Player,Nation,Pos,Squad,Comp,0,0,90.0,0,0,3,3,3,Tkl,0,0.0,0,0,0,0,0,0,0,0,0,2022-2023,0.0,0.0
2376,Pablo Sarabia,ESP,"FW,MF",Paris S-G,Ligue 1,30,1992,4.1,5,4,2,2,1,1,7,14.3,6,3,0,3,2,7,0,0,0,2022-2023,0.48780487804878053,1.2195121951219514
2377,Jeremy Sarmiento,ECU,MF,Brighton,Premier League,20,2002,2.0,6,3,4,1,1,2,5,40.0,3,2,0,2,1,7,0,0,0,2022-2023,0.5,3.0
2378,Amin Sarr,SWE,FW,Lyon,Ligue 1,21,2001,6.0,9,6,1,4,4,1,4,25.0,3,2,0,2,0,9,4,0,0,2022-2023,0.0,1.5
2379,Bouna Sarr,SEN,FW,Bayern Munich,Bundesliga,30,1992,0.0,0,0,0,0,0,0,0,0.0,0,0,0,0,0,0,0,0,0,2022-2023,,
2380,Malang Sarr,FRA,DF,Monaco,Ligue 1,23,1999,8.0,6,3,5,1,0,1,5,20.0,4,11,7,4,15,21,29,2,0,2022-2023,1.875,0.75
2381,Mamadou Sarr,FRA,MF,Lyon,Ligue 1,16,2005,0.1,0,0,0,0,0,0,0,0.0,0,0,0,0,0,0,0,0,0,2022-2023,0.0,0.0
2382,Mouhamadou Sarr,SEN,GK,Cremonese,Serie A,25,1997,2.0,0,0,0,0,0,0,0,0.0,0,0,0,0,0,0,2,0,0,2022-2023,0.0,0.0
2383,Martin Satriano,URU,FW,Empoli,Serie A,21,2001,18.9,13,8,5,6,2,6,14,42.9,8,5,0,5,3,16,22,0,0,2022-2023,0.15873015873015875,0.6878306878306879
2384,Téji Savanier,FRA,MF,Montpellier,Ligue 1,30,1991,28.3,46,30,16,19,11,23,70,32.9,47,30,2,28,30,76,12,1,0,2022-2023,1.0600706713780919,1.6254416961130742
2385,Esteban Saveljich,MNE,FW,Rayo Vallecano,La Liga,31,1991,0.0,0,0,0,0,0,0,0,0.0,0,0,0,0,0,0,0,0,0,2022-2023,,
2386,Stefan Savić,MNE,DF,Atlético Madrid,La Liga,31,1991,21.6,39,26,29,7,3,26,39,66.7,13,17,8,9,33,72,67,2,0,2022-2023,1.5277777777777777,1.8055555555555554
2387,Joe Scally,USA,DF,Gladbach,Bundesliga,19,2002,24.5,31,20,25,5,1,24,31,77.4,7,17,6,11,8,39,61,0,0,2022-2023,0.32653061224489793,1.2653061224489797
2388,Giorgio Scalvini,ITA,DF,Atalanta,Serie A,18,2003,25.9,54,29,30,18,6,29,55,52.7,26,36,13,23,56,110,57,2,0,2022-2023,2.1621621621621623,2.084942084942085
2389,Gianluca Scamacca,ITA,FW,West Ham,Premier League,23,1999,10.3,10,5,1,3,6,2,2,100.0,0,3,0,3,4,14,5,0,0,2022-2023,0.3883495145631068,0.9708737864077669
2390,Gustavo Scarpa,BRA,"MF,FW",Nott'ham Forest,Premier League,28,1994,2.0,5,2,3,1,1,2,5,40.0,3,4,0,4,0,5,3,0,0,2022-2023,0.0,2.5
2391,Kevin Schade,GER,FW,Brentford,Premier League,20,2001,8.1,12,8,7,2,3,5,10,50.0,5,7,0,7,4,16,6,0,0,2022-2023,0.4938271604938272,1.4814814814814816
2392,Kevin Schade,GER,"FW,MF",Freiburg,Bundesliga,20,2001,2.0,6,4,3,2,1,3,5,60.0,2,0,0,0,0,6,2,0,0,2022-2023,0.0,3.0
2393,András Schäfer,HUN,MF,Union Berlin,Bundesliga,23,1999,9.6,21,9,7,12,2,6,14,42.9,8,12,2,10,4,25,11,0,0,2022-2023,0.4166666666666667,2.1875
2394,Fabian Schär,SUI,DF,Newcastle Utd,Premier League,30,1991,35.6,47,22,31,13,3,24,39,61.5,15,34,19,15,52,99,139,0,0,2022-2023,1.4606741573033708,1.3202247191011236
2395,Derry Scherhant,GER,"FW,MF",Hertha BSC,Bundesliga,19,2002,3.2,7,6,3,3,1,4,8,50.0,4,3,0,3,0,7,5,0,0,2022-2023,0.0,2.1875
2396,Patrik Schick,CZE,FW,Leverkusen,Bundesliga,26,1996,10.5,0,0,0,0,0,0,1,0.0,1,4,1,3,1,1,7,0,0,2022-2023,0.09523809523809523,0.0
2397,Kingsley Schindler,GHA,"DF,MF",Köln,Bundesliga,29,1993,12.1,23,12,13,8,2,18,28,64.3,10,14,2,12,15,38,24,0,0,2022-2023,1.2396694214876034,1.9008264462809918
2398,Xaver Schlager,AUT,MF,RB Leipzig,Bundesliga,24,1997,16.7,41,24,13,26,2,20,43,46.5,23,19,2,17,17,58,23,0,0,2022-2023,1.0179640718562875,2.4550898203592815
2399,Keven Schlotterbeck,GER,DF,Freiburg,Bundesliga,25,1997,0.2,0,0,0,0,0,0,0,0.0,0,1,1,0,2,2,2,0,0,2022-2023,10.0,0.0
2400,Keven Schlotterbeck,GER,DF,Bochum,Bundesliga,25,1997,8.2,17,9,12,5,0,9,11,81.8,2,11,5,6,14,31,49,0,0,2022-2023,1.707317073170732,2.073170731707317
Rk,Player,Nation,Pos,Squad,Comp,0,0,90.0,0,0,3,3,3,Tkl,0,0.0,0,0,0,0,0,0,0,0,0,2022-2023,0.0,0.0
2401,Nico Schlotterbeck,GER,DF,Dortmund,Bundesliga,22,1999,25.0,59,34,34,24,1,37,53,69.8,16,38,21,17,32,91,71,1,0,2022-2023,1.28,2.36
2402,Jeffrey Schlupp,GHA,"MF,FW",Crystal Palace,Premier League,29,1992,28.1,66,46,28,29,9,22,43,51.2,21,39,8,31,23,89,38,0,0,2022-2023,0.8185053380782917,2.3487544483985765
2403,Kasper Schmeichel,DEN,GK,Nice,Ligue 1,35,1986,36.0,1,0,1,0,0,1,4,25.0,3,1,0,1,1,2,11,1,0,2022-2023,0.027777777777777776,0.027777777777777776
2404,Jonathan Schmid,FRA,DF,Freiburg,Bundesliga,32,1990,0.5,1,1,1,0,0,0,0,0.0,0,1,0,1,1,2,1,1,0,2022-2023,2.0,2.0
2405,Romano Schmid,AUT,"MF,FW",Werder Bremen,Bundesliga,22,2000,16.9,24,15,5,13,6,10,22,45.5,12,21,3,18,7,31,12,0,0,2022-2023,0.4142011834319527,1.4201183431952664
2406,Kenneth Schmidt,GER,DF,Freiburg,Bundesliga,20,2002,2.8,6,3,4,2,0,5,6,83.3,1,4,2,2,0,6,2,0,0,2022-2023,0.0,2.142857142857143
2407,Niklas Schmidt,GER,MF,Werder Bremen,Bundesliga,24,1998,12.1,25,10,12,11,2,13,28,46.4,15,10,0,10,5,30,12,0,0,2022-2023,0.4132231404958678,2.066115702479339
2408,Benno Schmitz,GER,DF,Köln,Bundesliga,27,1994,26.9,64,42,31,28,5,42,82,51.2,40,34,4,30,26,90,57,0,0,2022-2023,0.966542750929368,2.379182156133829
2409,Jerdy Schouten,NED,MF,Bologna,Serie A,25,1997,27.9,63,38,28,33,2,27,49,55.1,22,40,17,23,40,103,43,1,0,2022-2023,1.4336917562724014,2.2580645161290325
2410,Perr Schuurs,NED,DF,Torino,Serie A,22,1999,25.8,51,25,29,17,5,14,26,53.8,12,28,16,12,28,79,102,0,0,2022-2023,1.0852713178294573,1.9767441860465116
2411,Marvin Schwäbe,GER,GK,Köln,Bundesliga,27,1995,34.0,1,0,1,0,0,1,1,100.0,0,0,0,0,2,3,8,2,0,2022-2023,0.058823529411764705,0.029411764705882353
2412,Alexander Schwolow,GER,GK,Schalke 04,Bundesliga,30,1992,22.6,0,0,0,0,0,0,2,0.0,2,0,0,0,1,1,6,3,0,2022-2023,0.04424778761061947,0.0
2413,Demba Seck,SEN,"MF,FW",Torino,Serie A,21,2001,5.8,5,2,3,2,0,2,3,66.7,1,3,1,2,1,6,1,0,0,2022-2023,0.1724137931034483,0.8620689655172414
2414,Haris Seferović,SUI,FW,Celta Vigo,La Liga,30,1992,9.9,6,3,1,4,1,3,8,37.5,5,7,1,6,1,7,6,1,0,2022-2023,0.10101010101010101,0.6060606060606061
2415,Telasco Segovia,VEN,MF,Sampdoria,Serie A,19,2003,0.0,0,0,0,0,0,0,0,0.0,0,0,0,0,0,0,0,0,0,2022-2023,,
2416,Jacopo Segre,ITA,DF,Torino,Serie A,25,1997,0.2,0,0,0,0,0,0,0,0.0,0,0,0,0,0,0,0,0,0,2022-2023,0.0,0.0
2417,Paul Seguin,GER,MF,Union Berlin,Bundesliga,27,1995,7.7,17,8,9,4,4,8,18,44.4,10,6,0,6,6,23,7,0,0,2022-2023,0.7792207792207793,2.207792207792208
2418,Alidu Seidu,GHA,DF,Clermont Foot,Ligue 1,22,2000,27.3,52,31,35,14,3,31,51,60.8,20,28,14,14,52,104,50,2,0,2022-2023,1.9047619047619047,1.9047619047619047
2419,Davie Selke,GER,FW,Hertha BSC,Bundesliga,27,1995,3.1,2,1,1,1,0,0,1,0.0,1,3,1,2,1,3,5,0,0,2022-2023,0.3225806451612903,0.6451612903225806
2420,Davie Selke,GER,FW,Köln,Bundesliga,27,1995,9.7,0,0,0,0,0,0,4,0.0,4,4,1,3,0,0,11,0,0,2022-2023,0.0,0.0
2421,Matz Sels,BEL,GK,Strasbourg,Ligue 1,30,1992,38.0,4,3,4,0,0,4,4,100.0,0,0,0,0,4,8,23,0,0,2022-2023,0.10526315789473684,0.10526315789473684
2422,Nélson Semedo,POR,DF,Wolves,Premier League,28,1993,29.2,71,42,48,19,4,33,64,51.6,31,42,15,27,29,100,83,2,0,2022-2023,0.9931506849315068,2.4315068493150687
2423,Vivaldo Semedo,POR,"FW,MF",Udinese,Serie A,17,2005,0.4,0,0,0,0,0,0,0,0.0,0,1,0,1,0,0,1,0,0,2022-2023,0.0,0.0
2424,Antoine Semenyo,GHA,"FW,MF",Bournemouth,Premier League,22,2000,2.9,1,0,0,0,1,1,6,16.7,5,10,1,9,2,3,4,0,0,2022-2023,0.6896551724137931,0.3448275862068966
2425,Marvin Senaya,TOG,DF,Strasbourg,Ligue 1,21,2001,0.1,0,0,0,0,0,0,1,0.0,1,1,0,1,0,0,1,0,0,2022-2023,0.0,0.0
Rk,Player,Nation,Pos,Squad,Comp,0,0,90.0,0,0,3,3,3,Tkl,0,0.0,0,0,0,0,0,0,0,0,0,2022-2023,0.0,0.0
2426,Marcos Senesi,ARG,DF,Bournemouth,Premier League,25,1997,27.7,50,35,28,22,0,23,44,52.3,21,38,20,18,43,93,146,2,0,2022-2023,1.552346570397112,1.8050541516245489
2427,Stefano Sensi,ITA,MF,Monza,Serie A,26,1995,18.0,41,26,25,13,3,18,48,37.5,30,13,3,10,20,61,4,0,0,2022-2023,1.1111111111111112,2.2777777777777777
2428,Jaime Seoane,ESP,"MF,FW",Getafe,La Liga,25,1997,3.6,10,4,3,4,3,2,8,25.0,6,7,3,4,1,11,2,0,0,2022-2023,0.2777777777777778,2.7777777777777777
2429,Luigi Sepe,ITA,GK,Salernitana,Serie A,31,1991,17.0,0,0,0,0,0,0,1,0.0,1,0,0,0,0,0,0,0,0,2022-2023,0.0,0.0
2430,Suat Serdar,GER,MF,Hertha BSC,Bundesliga,25,1997,22.5,51,23,14,30,7,20,41,48.8,21,48,12,36,29,80,24,0,0,2022-2023,1.288888888888889,2.2666666666666666
2431,Leonardo Sernicola,ITA,DF,Cremonese,Serie A,25,1997,25.7,45,33,25,13,7,29,43,67.4,14,23,6,17,38,83,55,0,0,2022-2023,1.4785992217898833,1.7509727626459144
2432,Ryan Sessegnon,ENG,DF,Tottenham,Premier League,22,2000,9.0,16,11,9,7,0,6,12,50.0,6,8,1,7,6,22,17,1,0,2022-2023,0.6666666666666666,1.7777777777777777
2433,Stephan El Shaarawy,ITA,"DF,MF",Roma,Serie A,29,1992,16.9,21,9,8,10,3,6,22,27.3,16,11,1,10,15,36,11,0,0,2022-2023,0.8875739644970415,1.2426035502958581
2434,Eniss Shabani,ALB,MF,Mainz 05,Bundesliga,19,2003,0.1,0,0,0,0,0,0,0,0.0,0,0,0,0,0,0,0,0,0,2022-2023,0.0,0.0
2435,Luke Shaw,ENG,DF,Manchester Utd,Premier League,27,1995,28.4,55,36,31,22,2,32,46,69.6,14,51,17,34,36,91,55,2,0,2022-2023,1.267605633802817,1.9366197183098592
2436,Jonjo Shelvey,ENG,MF,Newcastle Utd,Premier League,30,1992,0.4,1,0,1,0,0,0,1,0.0,1,1,0,1,0,1,0,0,0,2022-2023,0.0,2.5
2437,Jonjo Shelvey,ENG,MF,Nott'ham Forest,Premier League,30,1992,6.0,2,1,0,1,1,1,9,11.1,8,7,2,5,5,7,10,1,0,2022-2023,0.8333333333333334,0.3333333333333333
2438,Eldor Shomurodov,UZB,FW,Spezia,Serie A,27,1995,9.0,5,5,3,1,1,2,11,18.2,9,5,1,4,3,8,4,0,0,2022-2023,0.3333333333333333,0.5555555555555556
2439,Eldor Shomurodov,UZB,FW,Roma,Serie A,27,1995,1.3,1,0,1,0,0,0,2,0.0,2,1,0,1,1,2,0,0,0,2022-2023,0.7692307692307692,0.7692307692307692
2440,Kaj Sierhuis,NED,"FW,MF",Reims,Ligue 1,24,1998,2.4,3,3,1,0,2,0,5,0.0,5,3,1,2,1,4,2,0,0,2022-2023,0.4166666666666667,1.25
2441,Vincent Sierro,SUI,MF,Toulouse,Ligue 1,26,1995,7.4,19,11,9,9,1,11,29,37.9,18,12,3,9,4,23,11,1,0,2022-2023,0.5405405405405405,2.5675675675675675
2442,Kiliann Sildillia,FRA,"DF,MF",Freiburg,Bundesliga,20,2002,22.0,33,20,10,19,4,18,30,60.0,12,24,9,15,21,54,47,1,0,2022-2023,0.9545454545454546,1.5
2443,André Silva,POR,FW,RB Leipzig,Bundesliga,26,1995,19.3,12,6,2,5,5,3,8,37.5,5,11,1,10,3,15,3,0,0,2022-2023,0.15544041450777202,0.6217616580310881
2444,Bernardo Silva,POR,"MF,FW",Manchester City,Premier League,27,1994,24.5,44,23,11,25,8,18,45,40.0,27,23,6,17,16,60,6,0,0,2022-2023,0.6530612244897959,1.7959183673469388
2445,Caio Henrique Oliveira Silva,BRA,DF,Monaco,Ligue 1,25,1997,32.2,74,51,42,28,4,44,76,57.9,32,28,8,20,26,100,68,1,0,2022-2023,0.8074534161490683,2.2981366459627326
2446,David Silva,ESP,MF,Real Sociedad,La Liga,36,1986,21.5,36,21,11,18,7,11,19,57.9,8,17,2,15,15,51,16,0,0,2022-2023,0.6976744186046512,1.6744186046511629
2447,Rui Silva,POR,GK,Betis,La Liga,28,1994,26.0,4,1,4,0,0,4,4,100.0,0,0,0,0,0,4,12,1,0,2022-2023,0.0,0.15384615384615385
2448,Thiago Silva,BRA,DF,Chelsea,Premier League,37,1984,26.1,41,27,24,17,0,21,31,67.7,10,38,29,9,34,75,111,3,0,2022-2023,1.3026819923371646,1.5708812260536398
2449,Marco Silvestri,ITA,GK,Udinese,Serie A,31,1991,38.0,2,1,2,0,0,2,3,66.7,1,0,0,0,1,3,15,1,0,2022-2023,0.02631578947368421,0.05263157894736842
2450,Abdallah Sima,SEN,FW,Angers,Ligue 1,21,2001,20.4,22,13,4,15,3,7,19,36.8,12,8,0,8,4,26,19,0,0,2022-2023,0.19607843137254904,1.0784313725490198
Rk,Player,Nation,Pos,Squad,Comp,0,0,90.0,0,0,3,3,3,Tkl,0,0.0,0,0,0,0,0,0,0,0,0,2022-2023,0.0,0.0
2451,Mohamed Simakan,FRA,DF,RB Leipzig,Bundesliga,22,2000,16.2,21,14,12,5,4,14,21,66.7,7,21,4,17,16,37,55,0,0,2022-2023,0.9876543209876544,1.2962962962962963
2452,Giovanni Simeone,ARG,FW,Napoli,Serie A,27,1995,4.5,12,3,3,5,4,3,8,37.5,5,2,1,1,1,13,4,0,0,2022-2023,0.2222222222222222,2.6666666666666665
2453,Ellis Simms,ENG,FW,Everton,Premier League,21,2001,2.5,0,0,0,0,0,0,0,0.0,0,0,0,0,0,0,1,0,0,2022-2023,0.0,0.0
2454,Simo,ESP,DF,Espanyol,La Liga,17,2005,1.6,3,1,3,0,0,2,3,66.7,1,5,4,1,0,3,3,0,0,2022-2023,0.0,1.875
2455,Moses Simon,NGA,"FW,MF",Nantes,Ligue 1,27,1995,26.1,18,9,6,7,5,7,15,46.7,8,14,1,13,11,29,3,0,0,2022-2023,0.421455938697318,0.689655172413793
2456,Unai Simón,ESP,GK,Athletic Club,La Liga,25,1997,30.5,2,0,2,0,0,1,1,100.0,0,1,0,1,0,2,9,3,0,2022-2023,0.0,0.06557377049180328
2457,Lassine Sinayoko,MLI,"MF,FW",Auxerre,Ligue 1,22,1999,17.4,33,15,14,12,7,21,40,52.5,19,12,0,12,18,51,17,0,0,2022-2023,1.0344827586206897,1.8965517241379313
2458,Wilfried Singo,CIV,DF,Torino,Serie A,21,2000,22.7,27,17,14,10,3,12,19,63.2,7,15,2,13,12,39,33,1,0,2022-2023,0.5286343612334802,1.1894273127753305
2459,Luis Sinisterra,COL,FW,Leeds United,Premier League,23,1999,9.6,21,14,8,9,4,11,18,61.1,7,11,1,10,8,29,2,0,0,2022-2023,0.8333333333333334,2.1875
2460,Daley Sinkgraven,NED,"DF,MF",Leverkusen,Bundesliga,27,1995,3.8,10,7,7,3,0,7,9,77.8,2,8,4,4,5,15,7,0,0,2022-2023,1.3157894736842106,2.6315789473684212
2461,Tobias Sippel,GER,GK,Gladbach,Bundesliga,34,1988,5.7,0,0,0,0,0,0,0,0.0,0,0,0,0,0,0,1,1,0,2022-2023,0.0,0.0
2462,Hugo Siquet,BEL,DF,Freiburg,Bundesliga,20,2002,0.2,2,2,2,0,0,2,2,100.0,0,1,0,1,0,2,0,0,0,2022-2023,0.0,10.0
2463,Salvatore Sirigu,ITA,GK,Fiorentina,Serie A,35,1987,1.0,0,0,0,0,0,0,0,0.0,0,0,0,0,0,0,1,0,0,2022-2023,0.0,0.0
2464,Ibrahima Sissoko,MLI,MF,Strasbourg,Ligue 1,24,1997,14.6,40,22,18,17,5,22,42,52.4,20,20,6,14,10,50,19,0,0,2022-2023,0.684931506849315,2.73972602739726
2465,Moussa Sissoko,FRA,MF,Nantes,Ligue 1,32,1989,21.3,26,16,16,7,3,12,18,66.7,6,22,5,17,16,42,17,0,0,2022-2023,0.7511737089201878,1.220657276995305
2466,Tim Skarke,GER,"DF,MF",Union Berlin,Bundesliga,25,1996,0.6,1,1,0,0,1,0,0,0.0,0,1,0,1,0,1,0,0,0,2022-2023,0.0,1.6666666666666667
2467,Tim Skarke,GER,"FW,MF",Schalke 04,Bundesliga,25,1996,4.9,13,7,3,8,2,8,11,72.7,3,5,0,5,0,13,4,0,0,2022-2023,0.0,2.6530612244897958
2468,Ellyes Skhiri,TUN,MF,Köln,Bundesliga,27,1995,31.7,79,44,29,42,8,26,66,39.4,40,52,12,40,56,135,48,0,0,2022-2023,1.7665615141955837,2.4921135646687698
2469,Oliver Skipp,ENG,MF,Tottenham,Premier League,21,2000,16.6,34,17,18,15,1,16,33,48.5,17,17,8,9,17,51,19,1,0,2022-2023,1.0240963855421685,2.048192771084337
2470,Leo Skiri Østigård,NOR,DF,Napoli,Serie A,22,1999,4.7,4,1,3,1,0,1,1,100.0,0,3,3,0,6,10,18,1,0,2022-2023,1.276595744680851,0.851063829787234
2471,Łukasz Skorupski,POL,GK,Bologna,Serie A,31,1991,37.0,2,1,2,0,0,1,2,50.0,1,0,0,0,0,2,19,2,0,2022-2023,0.0,0.05405405405405406
2472,Robert Skov,DEN,DF,Hoffenheim,Bundesliga,26,1996,15.0,22,11,14,7,1,10,26,38.5,16,22,8,14,8,30,20,2,0,2022-2023,0.5333333333333333,1.4666666666666666
2473,Milan Škriniar,SVK,DF,Inter,Serie A,27,1995,19.7,29,18,14,11,4,18,32,56.3,14,18,13,5,13,42,46,3,0,2022-2023,0.6598984771573604,1.4720812182741116
2474,Naatan Skyttä,FIN,MF,Toulouse,Ligue 1,20,2002,0.3,0,0,0,0,0,0,0,0.0,0,0,0,0,1,1,0,0,0,2022-2023,3.3333333333333335,0.0
2475,Islam Slimani,ALG,FW,Brest,Ligue 1,34,1988,11.0,5,3,2,2,1,0,3,0.0,3,2,0,2,1,6,11,0,0,2022-2023,0.09090909090909091,0.45454545454545453
Rk,Player,Nation,Pos,Squad,Comp,0,0,90.0,0,0,3,3,3,Tkl,0,0.0,0,0,0,0,0,0,0,0,0,2022-2023,0.0,0.0
2476,Chris Smalling,ENG,DF,Roma,Serie A,32,1989,31.2,26,15,16,10,0,13,21,61.9,8,51,36,15,43,69,123,0,0,2022-2023,1.3782051282051282,0.8333333333333334
2477,Adam Smith,ENG,DF,Bournemouth,Premier League,31,1991,32.7,49,29,27,19,3,29,60,48.3,31,30,13,17,25,74,81,1,0,2022-2023,0.7645259938837919,1.4984709480122322
2478,Emile Smith Rowe,ENG,"MF,FW",Arsenal,Premier League,22,2000,1.9,1,1,1,0,0,1,3,33.3,2,1,0,1,0,1,2,0,0,2022-2023,0.0,0.5263157894736842
2479,Hrvoje Smolčić,CRO,DF,Eint Frankfurt,Bundesliga,21,2000,5.2,8,7,6,2,0,5,10,50.0,5,11,4,7,6,14,38,0,0,2022-2023,1.1538461538461537,1.5384615384615383
2480,Cédric Soares,POR,DF,Arsenal,Premier League,30,1991,0.3,0,0,0,0,0,0,1,0.0,1,1,0,1,0,0,1,0,0,2022-2023,0.0,0.0
2481,Cédric Soares,POR,DF,Fulham,Premier League,30,1991,2.2,8,5,4,3,1,3,3,100.0,0,3,1,2,1,9,5,0,0,2022-2023,0.45454545454545453,3.6363636363636362
2482,Danilo Soares,BRA,DF,Bochum,Bundesliga,30,1991,19.6,72,46,42,23,7,43,72,59.7,29,29,6,23,30,102,56,1,0,2022-2023,1.530612244897959,3.6734693877551017
2483,Eduard Sobol,UKR,DF,Strasbourg,Ligue 1,27,1995,9.7,19,10,10,6,3,9,13,69.2,4,10,1,9,8,27,19,0,0,2022-2023,0.8247422680412372,1.9587628865979383
2484,Rubén Sobrino,ESP,"MF,FW",Cádiz,La Liga,30,1992,27.4,55,37,29,17,9,23,56,41.1,33,33,3,30,24,79,20,1,0,2022-2023,0.8759124087591241,2.007299270072993
2485,Alex Sola,ESP,DF,Real Sociedad,La Liga,23,1999,3.9,18,9,14,3,1,7,10,70.0,3,7,2,5,7,25,10,0,0,2022-2023,1.794871794871795,4.615384615384616
2486,Dominic Solanke,ENG,"FW,MF",Bournemouth,Premier League,24,1997,31.8,15,9,8,3,4,5,22,22.7,17,26,7,19,6,21,46,0,0,2022-2023,0.18867924528301885,0.4716981132075472
2487,Augusto Solari,ARG,MF,Celta Vigo,La Liga,30,1992,2.9,10,6,6,3,1,3,11,27.3,8,5,0,5,4,14,3,0,0,2022-2023,1.3793103448275863,3.4482758620689657
2488,Ola Solbakken,NOR,"MF,FW",Roma,Serie A,23,1998,5.6,2,2,1,1,0,2,7,28.6,5,2,0,2,2,4,8,0,0,2022-2023,0.35714285714285715,0.35714285714285715
2489,Nikola Soldo,CRO,DF,Köln,Bundesliga,21,2001,6.6,15,9,8,7,0,7,11,63.6,4,7,6,1,7,22,28,0,0,2022-2023,1.0606060606060606,2.272727272727273
2490,Carlos Soler,ESP,MF,Valencia,La Liga,25,1997,2.7,2,0,0,1,1,2,3,66.7,1,1,0,1,0,2,2,0,0,2022-2023,0.0,0.7407407407407407
2491,Carlos Soler,ESP,MF,Paris S-G,Ligue 1,25,1997,13.2,20,12,6,10,4,10,19,52.6,9,12,4,8,4,24,6,0,0,2022-2023,0.30303030303030304,1.5151515151515151
2492,François-Joseph Sollacaro,FRA,GK,Ajaccio,Ligue 1,28,1994,6.0,0,0,0,0,0,0,0,0.0,0,0,0,0,0,0,2,2,0,2022-2023,0.0,0.0
2493,Manor Solomon,ISR,FW,Fulham,Premier League,23,1999,6.4,20,12,12,6,2,9,16,56.3,7,8,0,8,5,25,3,0,0,2022-2023,0.78125,3.125
2494,Yann Sommer,SUI,GK,Gladbach,Bundesliga,33,1988,10.0,1,0,1,0,0,1,1,100.0,0,0,0,0,0,1,8,0,0,2022-2023,0.0,0.1
2495,Yann Sommer,SUI,GK,Bayern Munich,Bundesliga,33,1988,19.0,0,0,0,0,0,0,0,0.0,0,0,0,0,1,1,5,1,0,2022-2023,0.05263157894736842,0.0
2496,Brandon Soppy,FRA,DF,Udinese,Serie A,20,2002,1.0,1,1,0,1,0,0,0,0.0,0,4,0,4,1,2,1,0,0,2022-2023,1.0,1.0
2497,Brandon Soppy,FRA,DF,Atalanta,Serie A,20,2002,7.1,8,5,4,4,0,3,9,33.3,6,10,0,10,3,11,7,0,0,2022-2023,0.4225352112676057,1.1267605633802817
2498,David Soria,ESP,GK,Getafe,La Liga,29,1993,38.0,0,0,0,0,0,0,1,0.0,1,0,0,0,1,1,20,4,0,2022-2023,0.02631578947368421,0.0
2499,Roberto Soriano,ITA,"FW,MF",Bologna,Serie A,31,1991,14.7,31,16,9,16,6,13,25,52.0,12,23,2,21,6,37,14,0,0,2022-2023,0.40816326530612246,2.108843537414966
2500,Borna Sosa,CRO,DF,Stuttgart,Bundesliga,24,1998,21.7,27,21,18,8,1,21,32,65.6,11,20,5,15,19,46,37,0,0,2022-2023,0.8755760368663594,1.2442396313364055
Rk,Player,Nation,Pos,Squad,Comp,0,0,90.0,0,0,3,3,3,Tkl,0,0.0,0,0,0,0,0,0,0,0,0,2022-2023,0.0,0.0
2501,Joaquin Sosa,URU,DF,Bologna,Serie A,20,2002,7.6,6,2,5,1,0,4,18,22.2,14,5,3,2,6,12,31,0,0,2022-2023,0.7894736842105263,0.7894736842105263
2502,Hugo Sotelo,ESP,MF,Celta Vigo,La Liga,18,2003,0.2,0,0,0,0,0,0,0,0.0,0,0,0,0,0,0,0,0,0,2022-2023,0.0,0.0
2503,Florian Sotoca,FRA,"MF,FW",Lens,Ligue 1,31,1990,33.9,39,19,11,17,11,15,40,37.5,25,41,2,39,29,68,51,0,0,2022-2023,0.8554572271386431,1.1504424778761062
2504,Riccardo Sottil,ITA,FW,Fiorentina,Serie A,23,1999,9.3,4,3,2,0,2,2,5,40.0,3,2,0,2,0,4,0,0,0,2022-2023,0.0,0.4301075268817204
2505,Tomáš Souček,CZE,MF,West Ham,Premier League,27,1995,31.3,77,37,41,29,7,28,58,48.3,30,42,17,25,53,130,71,3,0,2022-2023,1.6932907348242812,2.460063897763578
2506,Matìas Soulé,ARG,"MF,FW",Juventus,Serie A,19,2003,4.7,7,4,3,2,2,5,7,71.4,2,7,1,6,3,10,3,0,0,2022-2023,0.6382978723404255,1.4893617021276595
2507,Moussa Soumano,FRA,FW,Ajaccio,Ligue 1,17,2005,5.5,2,2,0,1,1,0,6,0.0,6,2,0,2,0,2,0,0,0,2022-2023,0.0,0.36363636363636365
2508,Adama Soumaoro,FRA,DF,Bologna,Serie A,30,1992,20.7,25,17,11,12,2,5,7,71.4,2,18,13,5,15,40,75,1,0,2022-2023,0.7246376811594203,1.2077294685990339
2509,Boubakary Soumaré,FRA,MF,Leicester City,Premier League,23,1999,18.1,57,34,29,26,2,23,44,52.3,21,15,4,11,33,90,27,1,0,2022-2023,1.8232044198895025,3.1491712707182318
2510,Arnaud Souquet,FRA,"DF,FW",Montpellier,Ligue 1,30,1992,4.0,22,16,13,7,2,11,14,78.6,3,8,3,5,4,26,4,0,0,2022-2023,1.0,5.5
2511,Dyego Sousa,POR,FW,Almería,La Liga,32,1989,5.9,10,6,5,4,1,4,5,80.0,1,4,2,2,1,11,14,0,0,2022-2023,0.1694915254237288,1.694915254237288
2512,Harry Souttar,AUS,DF,Leicester City,Premier League,23,1998,11.0,15,9,10,5,0,7,18,38.9,11,16,12,4,12,27,45,0,0,2022-2023,1.0909090909090908,1.3636363636363635
2513,Vinicius Souza,BRA,MF,Espanyol,La Liga,23,1999,27.0,99,66,41,45,13,33,59,55.9,26,31,14,17,48,147,50,1,0,2022-2023,1.7777777777777777,3.6666666666666665
2514,Djibril Sow,SUI,MF,Eint Frankfurt,Bundesliga,25,1997,29.4,41,25,13,25,3,22,44,50.0,22,22,4,18,28,69,23,0,0,2022-2023,0.9523809523809524,1.3945578231292517
2515,Çağlar Söyüncü,TUR,DF,Leicester City,Premier League,26,1996,5.9,14,9,10,4,0,7,10,70.0,3,9,8,1,7,21,30,0,0,2022-2023,1.1864406779661016,2.3728813559322033
2516,Kevin Spadanuda,SUI,"MF,FW",Ajaccio,Ligue 1,25,1997,11.8,29,18,15,9,5,12,33,36.4,21,18,0,18,11,40,5,0,0,2022-2023,0.9322033898305084,2.4576271186440675
2517,Djed Spence,ENG,"FW,DF",Tottenham,Premier League,21,2000,0.1,0,0,0,0,0,0,0,0.0,0,0,0,0,0,0,0,0,0,2022-2023,0.0,0.0
2518,Djed Spence,ENG,DF,Rennes,Ligue 1,21,2000,6.4,14,6,8,2,4,11,18,61.1,7,10,3,7,4,18,15,0,0,2022-2023,0.625,2.1875
2519,Stijn Spierings,NED,MF,Toulouse,Ligue 1,26,1996,34.7,95,67,37,49,9,43,101,42.6,58,49,11,38,53,148,44,0,0,2022-2023,1.5273775216138328,2.737752161383285
2520,Leonardo Spinazzola,ITA,DF,Roma,Serie A,29,1993,18.4,15,8,7,6,2,8,23,34.8,15,13,3,10,9,24,25,0,0,2022-2023,0.48913043478260876,0.8152173913043479
2521,Marco Sportiello,ITA,GK,Atalanta,Serie A,30,1992,14.9,1,0,1,0,0,1,3,33.3,2,0,0,0,0,1,2,0,0,2022-2023,0.0,0.06711409395973154
2522,Jack Stacey,ENG,DF,Bournemouth,Premier League,26,1996,3.3,5,4,3,1,1,2,5,40.0,3,3,1,2,5,10,15,0,0,2022-2023,1.5151515151515151,1.5151515151515151
2523,Anton Stach,GER,MF,Mainz 05,Bundesliga,23,1998,23.0,27,21,10,15,2,16,38,42.1,22,28,2,26,41,68,25,0,0,2022-2023,1.7826086956521738,1.173913043478261
2524,Kostas Stafylidis,GRE,"DF,MF",Bochum,Bundesliga,28,1993,11.6,27,16,13,8,6,10,24,41.7,14,21,8,13,20,47,31,1,0,2022-2023,1.7241379310344829,2.3275862068965516
2525,Jens Stage,DEN,MF,Werder Bremen,Bundesliga,25,1996,20.6,34,17,15,18,1,10,37,27.0,27,34,11,23,16,50,37,0,0,2022-2023,0.7766990291262136,1.6504854368932038
Rk,Player,Nation,Pos,Squad,Comp,0,0,90.0,0,0,3,3,3,Tkl,0,0.0,0,0,0,0,0,0,0,0,0,2022-2023,0.0,0.0
2526,Veit Stange,GER,MF,Hertha BSC,Bundesliga,18,2004,0.1,1,1,1,0,0,1,1,100.0,0,0,0,0,0,1,0,0,0,2022-2023,0.0,10.0
2527,Josip Stanišić,CRO,DF,Bayern Munich,Bundesliga,22,2000,6.4,19,11,14,2,3,12,17,70.6,5,9,1,8,7,26,11,3,0,2022-2023,1.09375,2.96875
2528,Junior Stanislas,ENG,MF,Bournemouth,Premier League,32,1989,0.7,0,0,0,0,0,0,0,0.0,0,2,1,1,0,0,0,0,0,2022-2023,0.0,0.0
2529,Jay Stansfield,ENG,FW,Fulham,Premier League,19,2002,1.0,0,0,0,0,0,0,2,0.0,2,4,1,3,1,1,1,0,0,2022-2023,1.0,0.0
2530,Niklas Stark,GER,DF,Werder Bremen,Bundesliga,27,1995,23.1,56,36,29,24,3,27,42,64.3,15,24,13,11,37,93,110,0,0,2022-2023,1.6017316017316017,2.4242424242424243
2531,Jason Steele,ENG,GK,Brighton,Premier League,31,1990,15.0,0,0,0,0,0,0,1,0.0,1,0,0,0,0,0,6,1,0,2022-2023,0.0,0.0
2532,Calvin Stengs,NED,FW,Nice,Ligue 1,23,1998,2.4,2,2,1,0,1,1,2,50.0,1,0,0,0,0,2,0,0,0,2022-2023,0.0,0.8333333333333334
2533,Pascal Stenzel,GER,DF,Stuttgart,Bundesliga,26,1996,3.7,12,8,8,4,0,5,9,55.6,4,9,2,7,5,17,6,0,0,2022-2023,1.3513513513513513,3.243243243243243
2534,Jack Stephens,ENG,DF,Southampton,Premier League,28,1994,0.5,2,2,2,0,0,1,1,100.0,0,1,1,0,1,3,2,0,0,2022-2023,2.0,4.0
2535,Jack Stephens,ENG,DF,Bournemouth,Premier League,28,1994,13.0,15,11,10,4,1,6,10,60.0,4,23,16,7,16,31,53,0,0,2022-2023,1.2307692307692308,1.1538461538461537
2536,Raheem Sterling,ENG,"FW,MF",Chelsea,Premier League,27,1994,21.0,18,10,5,4,9,8,14,57.1,6,17,0,17,2,20,5,0,0,2022-2023,0.09523809523809523,0.8571428571428571
2537,Angelo Stiller,GER,MF,Hoffenheim,Bundesliga,21,2001,7.8,26,12,9,13,4,8,12,66.7,4,12,2,10,10,36,14,0,0,2022-2023,1.2820512820512822,3.3333333333333335
2538,Lars Stindl,GER,"FW,MF",Gladbach,Bundesliga,33,1988,19.3,24,14,4,17,3,10,28,35.7,18,24,5,19,11,35,19,0,0,2022-2023,0.5699481865284974,1.2435233160621761
2539,Kevin Stöger,AUT,MF,Bochum,Bundesliga,28,1993,28.9,84,45,38,32,14,31,94,33.0,63,27,4,23,26,110,21,1,0,2022-2023,0.8996539792387543,2.906574394463668
2540,Petar Stojanović,SVN,DF,Empoli,Serie A,26,1995,17.0,42,22,28,10,4,26,43,60.5,17,17,5,12,11,53,55,0,0,2022-2023,0.6470588235294118,2.4705882352941178
2541,John Stones,ENG,"DF,MF",Manchester City,Premier League,28,1994,20.5,23,13,11,8,4,7,10,70.0,3,17,10,7,9,32,40,0,0,2022-2023,0.43902439024390244,1.1219512195121952
2542,Jørgen Strand Larsen,NOR,FW,Celta Vigo,La Liga,22,2000,18.9,15,7,3,5,7,7,30,23.3,23,14,5,9,3,18,24,0,0,2022-2023,0.15873015873015875,0.7936507936507937
2543,Tony Strata,FRA,"MF,DF",Ajaccio,Ligue 1,17,2004,1.5,4,3,4,0,0,4,5,80.0,1,2,0,2,1,5,7,0,0,2022-2023,0.6666666666666666,2.6666666666666665
2544,Gabriel Strefezza,BRA,"FW,MF",Lecce,Serie A,25,1997,27.1,50,24,18,20,12,27,53,50.9,26,36,3,33,16,66,15,0,0,2022-2023,0.5904059040590406,1.8450184501845017
2545,Dávid Strelec,SVK,FW,Spezia,Serie A,21,2001,1.9,2,2,0,1,1,2,2,100.0,0,0,0,0,0,2,0,0,0,2022-2023,0.0,1.0526315789473684
2546,Pascal Struijk,NED,DF,Leeds United,Premier League,22,1999,24.4,84,57,43,31,10,49,75,65.3,26,32,12,20,32,116,70,1,0,2022-2023,1.3114754098360657,3.4426229508196724
2547,Cristhian Stuani,URU,FW,Girona,La Liga,35,1986,12.1,13,6,2,7,4,5,14,35.7,9,10,0,10,2,15,5,0,0,2022-2023,0.1652892561983471,1.0743801652892562
2548,Damián Suárez,URU,"DF,MF",Getafe,La Liga,34,1988,21.6,49,33,23,19,7,26,48,54.2,22,40,0,40,15,64,36,0,0,2022-2023,0.6944444444444444,2.268518518518518
2549,Denis Suárez,ESP,"MF,FW",Espanyol,La Liga,28,1994,10.5,26,20,12,12,2,13,45,28.9,32,11,1,10,5,31,4,0,0,2022-2023,0.47619047619047616,2.4761904761904763
2550,Mario Suárez,ESP,"MF,DF",Rayo Vallecano,La Liga,35,1987,0.1,0,0,0,0,0,0,0,0.0,0,1,0,1,0,0,0,0,0,2022-2023,0.0,0.0
Rk,Player,Nation,Pos,Squad,Comp,0,0,90.0,0,0,3,3,3,Tkl,0,0.0,0,0,0,0,0,0,0,0,0,2022-2023,0.0,0.0
2551,Gabriel Suazo,CHI,DF,Toulouse,Ligue 1,24,1997,14.0,38,22,20,15,3,29,63,46.0,34,21,5,16,22,60,24,1,0,2022-2023,1.5714285714285714,2.7142857142857144
2552,Isaac Success,NGA,FW,Udinese,Serie A,26,1996,20.2,8,4,2,5,1,3,8,37.5,5,13,2,11,4,12,18,0,0,2022-2023,0.19801980198019803,0.39603960396039606
2553,Niklas Süle,GER,DF,Dortmund,Bundesliga,26,1995,23.5,25,19,18,3,4,14,23,60.9,9,28,19,9,17,42,53,0,0,2022-2023,0.723404255319149,1.0638297872340425
2554,Ibrahim Sulemana,GHA,MF,Hellas Verona,Serie A,19,2003,7.2,19,13,10,7,2,6,12,50.0,6,8,2,6,14,33,15,0,0,2022-2023,1.9444444444444444,2.638888888888889
2555,Kamaldeen Sulemana,GHA,"FW,MF",Southampton,Premier League,20,2002,10.7,15,9,4,7,4,4,14,28.6,10,16,0,16,6,21,6,0,0,2022-2023,0.5607476635514019,1.4018691588785048
2556,Kamaldeen Sulemana,GHA,"FW,MF",Rennes,Ligue 1,20,2002,3.6,6,3,1,4,1,1,5,20.0,4,2,0,2,4,10,2,0,0,2022-2023,1.1111111111111112,1.6666666666666665
2557,Crysencio Summerville,NED,FW,Leeds United,Premier League,20,2001,15.8,30,20,14,14,2,11,23,47.8,12,20,2,18,13,43,11,0,0,2022-2023,0.8227848101265822,1.8987341772151898
2558,Ivan Šunjić,CRO,MF,Hertha BSC,Bundesliga,25,1996,11.0,38,20,16,21,1,16,24,66.7,8,17,5,12,13,51,19,1,0,2022-2023,1.1818181818181819,3.4545454545454546
2559,Sam Surridge,ENG,FW,Nott'ham Forest,Premier League,24,1998,3.6,5,0,1,3,1,1,4,25.0,3,5,2,3,0,5,7,0,0,2022-2023,0.0,1.3888888888888888
2560,Suso,ESP,"MF,FW",Sevilla,La Liga,28,1993,11.8,16,10,5,7,4,10,22,45.5,12,7,1,6,2,18,3,0,0,2022-2023,0.1694915254237288,1.3559322033898304
2561,Yuito Suzuki,JPN,"FW,MF",Strasbourg,Ligue 1,20,2001,0.4,0,0,0,0,0,0,0,0.0,0,3,0,3,0,0,0,0,0,2022-2023,0.0,0.0
2562,Mattias Svanberg,SWE,"MF,FW",Wolfsburg,Bundesliga,23,1999,20.4,25,16,8,16,1,10,30,33.3,20,27,5,22,21,46,25,1,0,2022-2023,1.0294117647058825,1.2254901960784315
2563,Mile Svilar,SRB,GK,Roma,Serie A,22,1999,3.0,0,0,0,0,0,0,0,0.0,0,0,0,0,0,0,1,0,0,2022-2023,0.0,0.0
2564,Williot Swedberg,SWE,MF,Celta Vigo,La Liga,18,2004,0.6,3,1,1,0,2,0,0,0.0,0,2,0,2,0,3,1,0,0,2022-2023,0.0,5.0
2565,Issiaga Sylla,GUI,DF,Montpellier,Ligue 1,28,1994,14.5,28,16,19,8,1,15,31,48.4,16,19,3,16,32,60,35,0,0,2022-2023,2.206896551724138,1.9310344827586208
2566,Issiaga Sylla,GUI,DF,Toulouse,Ligue 1,28,1994,15.2,28,15,14,9,5,15,34,44.1,19,15,5,10,38,66,38,0,0,2022-2023,2.5,1.842105263157895
2567,Wojciech Szczęsny,POL,GK,Juventus,Serie A,32,1990,27.5,1,0,1,0,0,0,1,0.0,1,0,0,0,0,1,7,0,0,2022-2023,0.0,0.03636363636363636
2568,Dominik Szoboszlai,HUN,"MF,FW",RB Leipzig,Bundesliga,21,2000,27.2,45,28,12,20,13,17,42,40.5,25,43,2,41,17,62,27,0,0,2022-2023,0.625,1.6544117647058825
2569,Alexander Sørloth,NOR,FW,Real Sociedad,La Liga,26,1995,26.5,18,9,3,6,9,7,14,50.0,7,15,1,14,2,20,26,1,0,2022-2023,0.07547169811320754,0.6792452830188679
2570,Alexander Sørloth,NOR,FW,RB Leipzig,Bundesliga,26,1995,0.1,0,0,0,0,0,0,0,0.0,0,0,0,0,0,0,0,0,0,2022-2023,0.0,0.0
2571,Nicolás Tagliafico,ARG,DF,Lyon,Ligue 1,29,1992,33.2,91,53,36,41,14,50,78,64.1,28,45,11,34,57,148,47,0,0,2022-2023,1.7168674698795179,2.7409638554216866
2572,Jonathan Tah,GER,DF,Leverkusen,Bundesliga,26,1996,27.6,25,12,21,4,0,12,18,66.7,6,30,18,12,40,65,118,0,0,2022-2023,1.4492753623188406,0.9057971014492753
2573,Benjamin Tahirovic,BIH,MF,Roma,Serie A,19,2003,3.9,8,5,5,2,1,4,12,33.3,8,9,4,5,3,11,3,0,0,2022-2023,0.7692307692307693,2.0512820512820515
2574,Waniss Taibi,FRA,MF,Angers,Ligue 1,20,2002,2.1,9,5,4,4,1,2,4,50.0,2,1,0,1,2,11,2,0,0,2022-2023,0.9523809523809523,4.285714285714286
2575,Flavien Tait,FRA,MF,Rennes,Ligue 1,29,1993,18.7,30,15,8,17,5,19,42,45.2,23,16,4,12,20,50,12,0,0,2022-2023,1.0695187165775402,1.6042780748663101
Rk,Player,Nation,Pos,Squad,Comp,0,0,90.0,0,0,3,3,3,Tkl,0,0.0,0,0,0,0,0,0,0,0,0,2022-2023,0.0,0.0
2576,Montassar Talbi,TUN,DF,Lorient,Ligue 1,24,1998,38.0,53,25,40,13,0,22,35,62.9,13,55,34,21,40,93,190,3,0,2022-2023,1.0526315789473684,1.394736842105263
2577,Thibault Tamas,FRA,DF,Montpellier,Ligue 1,21,2001,0.1,0,0,0,0,0,0,0,0.0,0,0,0,0,1,1,0,0,0,2022-2023,10.0,0.0
2578,Adrien Tameze,CMR,MF,Hellas Verona,Serie A,28,1994,33.7,51,30,21,26,4,28,63,44.4,35,51,14,37,37,88,55,2,0,2022-2023,1.0979228486646884,1.5133531157270028
2579,Japhet Tanganga,ENG,DF,Tottenham,Premier League,23,1999,1.6,3,2,3,0,0,1,5,20.0,4,1,0,1,2,5,8,0,0,2022-2023,1.25,1.875
2580,Renato Tapia,PER,"MF,DF",Celta Vigo,La Liga,27,1995,16.1,47,25,21,21,5,18,37,48.6,19,29,11,18,19,66,37,0,0,2022-2023,1.1801242236024843,2.919254658385093
2581,Edmond Tapsoba,BFA,DF,Leverkusen,Bundesliga,23,1999,31.9,51,30,35,12,4,30,42,71.4,12,40,17,23,36,87,109,1,0,2022-2023,1.1285266457680252,1.5987460815047023
2582,Florian Tardieu,FRA,MF,Troyes,Ligue 1,30,1992,11.2,31,20,19,12,0,12,31,38.7,19,19,4,15,23,54,15,0,0,2022-2023,2.053571428571429,2.7678571428571432
2583,Matt Targett,ENG,DF,Newcastle Utd,Premier League,26,1995,6.8,13,10,8,3,2,9,24,37.5,15,8,3,5,9,22,16,0,0,2022-2023,1.3235294117647058,1.911764705882353
2584,James Tarkowski,ENG,DF,Everton,Premier League,29,1992,38.0,51,26,36,13,2,20,39,51.3,19,99,78,21,51,102,201,3,0,2022-2023,1.3421052631578947,1.3421052631578947
2585,Ciprian Tătărușanu,ROU,GK,Milan,Serie A,36,1986,16.0,0,0,0,0,0,0,0,0.0,0,0,0,0,1,1,2,0,0,2022-2023,0.0625,0.0
2586,Niklas Tauer,GER,"DF,MF",Mainz 05,Bundesliga,21,2001,1.0,2,1,2,0,0,1,3,33.3,2,2,1,1,2,4,4,0,0,2022-2023,2.0,2.0
2587,Nuno Tavares,POR,"DF,MF",Marseille,Ligue 1,22,2000,26.1,56,30,19,24,13,28,56,50.0,28,32,4,28,15,71,25,0,0,2022-2023,0.5747126436781609,2.1455938697318007
2588,Marcus Tavernier,ENG,"MF,FW",Bournemouth,Premier League,23,1999,19.4,33,22,19,11,3,11,33,33.3,22,25,4,21,9,42,23,0,0,2022-2023,0.4639175257731959,1.7010309278350517
2589,Enzo Tchato,CMR,DF,Montpellier,Ligue 1,19,2002,12.2,26,17,14,11,1,13,22,59.1,9,17,2,15,7,33,33,0,0,2022-2023,0.5737704918032788,2.1311475409836067
2590,Aurélien Tchouaméni,FRA,MF,Real Madrid,La Liga,22,2000,23.5,64,40,23,36,5,23,38,60.5,15,20,6,14,49,113,50,0,0,2022-2023,2.0851063829787235,2.723404255319149
2591,Mathys Tel,FRA,FW,Bayern Munich,Bundesliga,17,2005,4.6,2,2,0,1,1,1,1,100.0,0,5,1,4,0,2,2,0,0,2022-2023,0.0,0.4347826086956522
2592,Semir Telalovic,GER,"MF,FW",Gladbach,Bundesliga,22,1999,0.1,0,0,0,0,0,0,0,0.0,0,0,0,0,0,0,0,0,0,2022-2023,0.0,0.0
2593,Alex Telles,BRA,DF,Sevilla,La Liga,29,1992,15.9,21,13,15,6,0,13,25,52.0,12,17,5,12,20,41,38,0,0,2022-2023,1.2578616352201257,1.320754716981132
2594,Marc-André ter Stegen,GER,GK,Barcelona,La Liga,30,1992,37.2,0,0,0,0,0,0,0,0.0,0,0,0,0,1,1,7,3,0,2022-2023,0.026881720430107524,0.0
2595,Simon Terodde,GER,FW,Schalke 04,Bundesliga,34,1988,20.3,15,8,4,7,4,3,14,21.4,11,6,2,4,6,21,9,0,0,2022-2023,0.29556650246305416,0.7389162561576355
2596,Filippo Terracciano,ITA,"DF,MF",Hellas Verona,Serie A,19,2003,9.1,20,13,11,7,2,15,20,75.0,5,7,4,3,10,30,14,0,0,2022-2023,1.098901098901099,2.197802197802198
2597,Pietro Terracciano,ITA,GK,Fiorentina,Serie A,32,1990,29.0,2,1,2,0,0,2,3,66.7,1,0,0,0,1,3,14,0,0,2022-2023,0.034482758620689655,0.06896551724137931
2598,Ramón Terrats,ESP,MF,Villarreal,La Liga,21,2000,9.1,15,10,3,8,4,9,17,52.9,8,11,4,7,8,23,6,2,0,2022-2023,0.8791208791208791,1.6483516483516485
2599,Ramón Terrats,ESP,MF,Girona,La Liga,21,2000,2.4,4,2,1,3,0,2,6,33.3,4,6,2,4,3,7,3,1,0,2022-2023,1.25,1.6666666666666667
2600,Martin Terrier,FRA,"FW,MF",Rennes,Ligue 1,25,1997,14.7,25,11,7,9,9,13,24,54.2,11,15,2,13,14,39,6,0,0,2022-2023,0.9523809523809524,1.7006802721088436
Rk,Player,Nation,Pos,Squad,Comp,0,0,90.0,0,0,3,3,3,Tkl,0,0.0,0,0,0,0,0,0,0,0,0,2022-2023,0.0,0.0
2601,Aleksa Terzić,SRB,DF,Fiorentina,Serie A,22,1999,10.4,16,9,9,4,3,11,21,52.4,10,13,4,9,5,21,16,0,0,2022-2023,0.4807692307692307,1.5384615384615383
2602,Tetê,BRA,FW,Leicester City,Premier League,22,2000,8.2,14,8,5,7,2,6,21,28.6,15,9,0,9,2,16,3,0,0,2022-2023,0.24390243902439027,1.707317073170732
2603,Tetê,BRA,"FW,MF",Lyon,Ligue 1,22,2000,12.3,21,10,8,5,8,10,19,52.6,9,9,0,9,13,34,2,0,0,2022-2023,1.056910569105691,1.7073170731707317
2604,Kenny Tete,NED,DF,Fulham,Premier League,26,1995,28.5,83,46,41,29,13,38,51,74.5,13,48,17,31,52,135,81,1,0,2022-2023,1.8245614035087718,2.912280701754386
2605,Florian Thauvin,FRA,"FW,MF",Udinese,Serie A,29,1993,6.1,2,1,0,2,0,2,13,15.4,11,5,0,5,2,4,2,0,0,2022-2023,0.3278688524590164,0.3278688524590164
2606,Arthur Theate,BEL,DF,Rennes,Ligue 1,22,2000,34.7,29,19,17,8,4,17,30,56.7,13,26,14,12,30,59,114,3,0,2022-2023,0.8645533141210374,0.8357348703170028
2607,Malick Thiaw,GER,DF,Milan,Serie A,20,2001,15.1,31,26,22,9,0,11,20,55.0,9,11,5,6,12,43,65,1,0,2022-2023,0.794701986754967,2.052980132450331
2608,Malick Thiaw,GER,DF,Schalke 04,Bundesliga,20,2001,3.0,3,1,2,1,0,1,2,50.0,1,4,3,1,9,12,24,1,0,2022-2023,3.0,1.0
2609,Jan Thielmann,GER,FW,Köln,Bundesliga,20,2002,9.7,9,8,3,4,2,2,11,18.2,9,16,3,13,9,18,7,0,0,2022-2023,0.9278350515463918,0.9278350515463918
2610,Sada Thioub,SEN,"DF,FW",Angers,Ligue 1,27,1995,11.8,19,10,9,8,2,8,17,47.1,9,13,0,13,7,26,5,1,0,2022-2023,0.5932203389830508,1.6101694915254237
2611,Luke Thomas,ENG,DF,Leicester City,Premier League,21,2001,11.9,23,19,15,5,3,15,32,46.9,17,20,4,16,27,50,35,0,0,2022-2023,2.26890756302521,1.9327731092436975
2612,Adrien Thomasson,FRA,MF,Strasbourg,Ligue 1,28,1993,10.4,19,9,8,6,5,9,30,30.0,21,18,0,18,3,22,2,0,0,2022-2023,0.28846153846153844,1.8269230769230769
2613,Adrien Thomasson,FRA,"MF,FW",Lens,Ligue 1,28,1993,14.2,24,17,8,11,5,12,45,26.7,33,25,2,23,4,28,17,0,0,2022-2023,0.28169014084507044,1.6901408450704227
2614,Morten Thorsby,NOR,MF,Union Berlin,Bundesliga,26,1996,9.3,22,10,9,11,2,13,21,61.9,8,11,5,6,3,25,20,0,0,2022-2023,0.3225806451612903,2.365591397849462
2615,Kristian Thorstvedt,NOR,MF,Sassuolo,Serie A,23,1999,12.6,16,7,4,9,3,6,17,35.3,11,19,5,14,14,30,13,0,0,2022-2023,1.1111111111111112,1.2698412698412698
2616,Khéphren Thuram,FRA,MF,Nice,Ligue 1,21,2001,28.3,51,25,22,23,6,19,43,44.2,24,33,13,20,38,89,34,0,0,2022-2023,1.342756183745583,1.802120141342756
2617,Marcus Thuram,FRA,FW,Gladbach,Bundesliga,24,1997,27.9,14,7,3,6,5,6,13,46.2,7,20,3,17,6,20,22,0,0,2022-2023,0.21505376344086022,0.5017921146953406
2618,Alexis Tibidi,FRA,"FW,MF",Troyes,Ligue 1,18,2003,0.8,1,1,1,0,0,0,0,0.0,0,0,0,0,0,1,0,0,0,2022-2023,0.0,1.25
2619,Youri Tielemans,BEL,MF,Leicester City,Premier League,25,1997,26.0,66,39,27,30,9,23,62,37.1,39,35,8,27,28,94,24,1,0,2022-2023,1.0769230769230769,2.5384615384615383
2620,Kieran Tierney,SCO,DF,Arsenal,Premier League,25,1997,8.8,20,11,9,9,2,12,16,75.0,4,8,2,6,11,31,25,0,0,2022-2023,1.25,2.2727272727272725
2621,Steffen Tigges,GER,FW,Köln,Bundesliga,24,1998,17.7,12,7,1,8,3,4,14,28.6,10,13,2,11,8,20,17,0,0,2022-2023,0.4519774011299435,0.6779661016949153
2622,Jean-Clair Todibo,FRA,DF,Nice,Ligue 1,22,1999,31.9,76,48,54,19,3,41,56,73.2,15,41,19,22,41,117,110,2,0,2022-2023,1.2852664576802508,2.3824451410658307
2623,Harry Toffolo,ENG,DF,Nott'ham Forest,Premier League,26,1995,10.4,17,8,10,4,3,10,14,71.4,4,16,8,8,10,27,33,0,0,2022-2023,0.9615384615384615,1.6346153846153846
2624,Umut Tohumcu,GER,"MF,DF",Hoffenheim,Bundesliga,17,2004,3.0,10,5,4,5,1,3,9,33.3,6,4,0,4,2,12,8,0,0,2022-2023,0.6666666666666666,3.3333333333333335
2625,Karl Toko Ekambi,CMR,"FW,MF",Rennes,Ligue 1,29,1992,10.8,3,1,1,1,1,3,9,33.3,6,5,0,5,9,12,3,0,0,2022-2023,0.8333333333333333,0.27777777777777773
Rk,Player,Nation,Pos,Squad,Comp,0,0,90.0,0,0,3,3,3,Tkl,0,0.0,0,0,0,0,0,0,0,0,0,2022-2023,0.0,0.0
2626,Karl Toko Ekambi,CMR,"FW,MF",Lyon,Ligue 1,29,1992,15.0,9,9,2,4,3,4,15,26.7,11,12,2,10,9,18,6,0,0,2022-2023,0.6,0.6
2627,Corentin Tolisso,FRA,MF,Lyon,Ligue 1,27,1994,22.6,44,27,16,23,5,25,66,37.9,41,25,5,20,24,68,23,1,0,2022-2023,1.0619469026548671,1.9469026548672566
2628,Jeremy Toljan,GER,DF,Sassuolo,Serie A,27,1994,29.7,36,23,17,14,5,22,33,66.7,11,31,14,17,18,54,60,1,0,2022-2023,0.6060606060606061,1.2121212121212122
2629,Rafael Tolói,ITA,DF,Atalanta,Serie A,31,1990,30.9,69,44,37,32,0,35,64,54.7,29,42,18,24,57,126,88,1,0,2022-2023,1.8446601941747574,2.233009708737864
2630,Raúl de Tomás,ESP,FW,Rayo Vallecano,La Liga,27,1994,8.9,3,2,0,1,2,2,6,33.3,4,4,0,4,0,3,6,0,0,2022-2023,0.0,0.33707865168539325
2631,Tiago Tomás,POR,"FW,MF",Stuttgart,Bundesliga,20,2002,14.3,10,4,2,4,4,8,13,61.5,5,9,2,7,1,11,5,0,0,2022-2023,0.06993006993006992,0.6993006993006993
2632,Takehiro Tomiyasu,JPN,DF,Arsenal,Premier League,23,1998,7.4,27,18,12,10,5,13,18,72.2,5,7,0,7,14,41,15,1,0,2022-2023,1.8918918918918919,3.6486486486486487
2633,James Tomkins,ENG,DF,Crystal Palace,Premier League,33,1989,3.8,4,2,2,1,1,1,3,33.3,2,3,2,1,5,9,19,0,0,2022-2023,1.3157894736842106,1.0526315789473684
2634,Fikayo Tomori,ENG,DF,Milan,Serie A,24,1997,30.7,70,34,44,25,1,22,34,64.7,12,46,25,21,29,99,88,1,0,2022-2023,0.9446254071661238,2.2801302931596092
2635,Sandro Tonali,ITA,MF,Milan,Serie A,22,2000,30.1,64,41,35,24,5,27,44,61.4,17,34,9,25,25,89,26,1,0,2022-2023,0.8305647840531561,2.1262458471760795
2636,Lorenzo Tonelli,ITA,DF,Empoli,Serie A,32,1990,0.2,0,0,0,0,0,0,1,0.0,1,0,0,0,0,0,0,0,0,2022-2023,0.0,0.0
2637,Ivan Toney,ENG,FW,Brentford,Premier League,26,1996,32.8,23,13,4,9,10,7,23,30.4,16,24,9,15,14,37,36,0,0,2022-2023,0.426829268292683,0.701219512195122
2638,Pablo Torre,ESP,"FW,MF",Barcelona,La Liga,19,2003,1.6,2,1,0,1,1,2,4,50.0,2,1,0,1,2,4,1,0,0,2022-2023,1.25,1.25
2639,David Torres,ESP,DF,Valladolid,La Liga,19,2003,4.3,1,1,0,1,0,1,1,100.0,0,4,2,2,3,4,8,0,0,2022-2023,0.6976744186046512,0.23255813953488372
2640,Ferrán Torres,ESP,"FW,MF",Barcelona,La Liga,22,2000,15.5,13,7,4,5,4,5,20,25.0,15,11,2,9,3,16,5,0,0,2022-2023,0.1935483870967742,0.8387096774193549
2641,Óliver Torres,ESP,"MF,FW",Sevilla,La Liga,27,1994,23.7,39,23,12,13,14,18,59,30.5,41,26,5,21,10,49,10,0,0,2022-2023,0.4219409282700422,1.6455696202531647
2642,Pau Torres,ESP,DF,Villarreal,La Liga,25,1997,33.9,43,25,25,13,5,23,36,63.9,13,36,27,9,13,56,146,3,0,2022-2023,0.3834808259587021,1.2684365781710916
2643,Roberto Torres,ESP,"FW,MF",Osasuna,La Liga,33,1989,0.1,0,0,0,0,0,0,0,0.0,0,0,0,0,0,0,0,0,0,2022-2023,0.0,0.0
2644,Lucas Torró,ESP,MF,Osasuna,La Liga,28,1994,27.5,48,32,28,15,5,18,42,42.9,24,24,3,21,42,90,64,1,0,2022-2023,1.5272727272727273,1.7454545454545454
2645,Nabil Touaizi,MAR,MF,Espanyol,La Liga,21,2001,0.0,0,0,0,0,0,0,0,0.0,0,0,0,0,0,0,0,0,0,2022-2023,,
2646,Almamy Touré,MLI,DF,Eint Frankfurt,Bundesliga,26,1996,4.4,13,7,7,5,1,5,9,55.6,4,9,2,7,10,23,8,0,0,2022-2023,2.2727272727272725,2.954545454545454
2647,Birama Touré,MLI,MF,Auxerre,Ligue 1,30,1992,37.8,80,47,35,35,10,34,93,36.6,59,54,9,45,67,147,49,0,0,2022-2023,1.7724867724867726,2.1164021164021167
2648,Mohamed Toure,AUS,"FW,MF",Reims,Ligue 1,18,2004,0.3,0,0,0,0,0,0,0,0.0,0,0,0,0,0,0,0,0,0,2022-2023,0.0,0.0
2649,Souleymane Touré,FRA,DF,Marseille,Ligue 1,19,2003,0.8,2,1,1,1,0,1,2,50.0,1,1,0,1,0,2,5,0,0,2022-2023,0.0,2.5
2650,Souleymane Touré,FRA,DF,Auxerre,Ligue 1,19,2003,17.6,29,13,19,9,1,16,20,80.0,4,32,12,20,26,55,56,1,0,2022-2023,1.477272727272727,1.6477272727272725
Rk,Player,Nation,Pos,Squad,Comp,0,0,90.0,0,0,3,3,3,Tkl,0,0.0,0,0,0,0,0,0,0,0,0,2022-2023,0.0,0.0
2651,Lucas Tousart,FRA,MF,Hertha BSC,Bundesliga,25,1997,32.7,73,38,35,28,10,27,60,45.0,33,42,6,36,48,121,75,1,0,2022-2023,1.4678899082568806,2.2324159021406724
2652,Yoann Touzghar,TUN,FW,Ajaccio,Ligue 1,35,1986,5.0,3,2,0,2,1,0,1,0.0,1,0,0,0,0,3,1,0,0,2022-2023,0.0,0.6
2653,Adama Traoré,ESP,"FW,MF",Wolves,Premier League,26,1996,16.6,14,7,7,4,3,4,9,44.4,5,8,1,7,3,17,17,0,0,2022-2023,0.18072289156626503,0.8433734939759036
2654,Bertrand Traoré,BFA,"FW,MF",Aston Villa,Premier League,26,1995,2.6,1,1,1,0,0,1,4,25.0,3,5,0,5,2,3,0,0,0,2022-2023,0.7692307692307692,0.3846153846153846
2655,Boubacar Traoré,MLI,MF,Wolves,Premier League,20,2001,4.6,12,5,4,5,3,3,7,42.9,4,4,2,2,7,19,1,0,0,2022-2023,1.5217391304347827,2.608695652173913
2656,Charles Traore,MLI,DF,Nantes,Ligue 1,30,1992,5.4,8,5,5,2,1,5,7,71.4,2,9,2,7,10,18,12,0,0,2022-2023,1.8518518518518516,1.4814814814814814
2657,Hamari Traoré,MLI,DF,Rennes,Ligue 1,30,1992,28.1,48,32,26,15,7,28,52,53.8,24,33,7,26,38,86,64,0,0,2022-2023,1.3523131672597863,1.7081850533807827
2658,Kevin Trapp,GER,GK,Eint Frankfurt,Bundesliga,32,1990,33.0,1,1,1,0,0,0,2,0.0,2,2,0,2,0,1,10,0,0,2022-2023,0.0,0.030303030303030304
2659,Mark Travers,IRL,GK,Bournemouth,Premier League,23,1999,11.5,0,0,0,0,0,0,0,0.0,0,1,0,1,0,0,6,0,0,2022-2023,0.0,0.0
2660,Óscar Trejo,ARG,"MF,FW",Rayo Vallecano,La Liga,34,1988,23.8,48,32,12,23,13,9,44,20.5,35,31,3,28,8,56,8,1,0,2022-2023,0.3361344537815126,2.0168067226890756
2661,Manu Trigueros,ESP,MF,Villarreal,La Liga,30,1991,9.2,20,14,9,5,6,9,22,40.9,13,9,2,7,5,25,4,0,0,2022-2023,0.5434782608695653,2.173913043478261
2662,Christopher Trimmel,AUT,DF,Union Berlin,Bundesliga,35,1987,20.1,31,16,16,12,3,20,31,64.5,11,14,1,13,25,56,48,0,0,2022-2023,1.243781094527363,1.5422885572139302
2663,Théo Trinker,FRA,MF,Nice,Ligue 1,21,2001,0.0,0,0,0,0,0,0,0,0.0,0,0,0,0,0,0,0,0,0,2022-2023,,
2664,Kieran Trippier,ENG,DF,Newcastle Utd,Premier League,31,1990,37.1,71,49,36,27,8,46,90,51.1,44,45,15,30,43,114,84,2,0,2022-2023,1.1590296495956873,1.9137466307277626
2665,William Troost-Ekong,NGA,DF,Salernitana,Serie A,28,1993,4.9,11,3,7,4,0,6,7,85.7,1,7,4,3,6,17,10,0,0,2022-2023,1.2244897959183672,2.2448979591836733
2666,Leandro Trossard,BEL,FW,Arsenal,Premier League,27,1994,10.3,12,7,4,2,6,6,18,33.3,12,18,0,18,6,18,3,1,0,2022-2023,0.5825242718446602,1.1650485436893203
2667,Leandro Trossard,BEL,"FW,MF",Brighton,Premier League,27,1994,14.6,10,6,7,1,2,1,8,12.5,7,17,0,17,6,16,1,0,0,2022-2023,0.4109589041095891,0.684931506849315
2668,Adrien Truffert,FRA,DF,Rennes,Ligue 1,20,2001,21.7,62,32,36,17,9,31,46,67.4,15,32,8,24,22,84,55,0,0,2022-2023,1.0138248847926268,2.857142857142857
2669,Frank Tsadjout,ITA,FW,Cremonese,Serie A,23,1999,11.7,10,8,3,6,1,3,9,33.3,6,7,1,6,8,18,9,0,0,2022-2023,0.6837606837606838,0.8547008547008548
2670,Kostas Tsimikas,GRE,DF,Liverpool,Premier League,26,1996,8.6,14,9,10,2,2,10,16,62.5,6,8,1,7,12,26,15,0,0,2022-2023,1.3953488372093024,1.627906976744186
2671,Theocharis Tsingaras,GRE,MF,Toulouse,Ligue 1,21,2000,0.1,0,0,0,0,0,0,0,0.0,0,0,0,0,0,0,0,0,0,2022-2023,0.0,0.0
2672,Viktor Tsyhankov,UKR,MF,Girona,La Liga,24,1997,16.5,8,8,5,1,2,1,14,7.1,13,13,2,11,7,15,12,0,0,2022-2023,0.42424242424242425,0.48484848484848486
2673,Alessandro Tuia,ITA,DF,Lecce,Serie A,32,1990,5.7,10,6,6,4,0,3,9,33.3,6,3,1,2,15,25,29,0,0,2022-2023,2.631578947368421,1.7543859649122806
2674,Martin Turk,SVN,GK,Sampdoria,Serie A,18,2003,4.0,0,0,0,0,0,0,0,0.0,0,0,0,0,0,0,1,0,0,2022-2023,0.0,0.0
2675,Beñat Turrientes,ESP,"MF,FW",Real Sociedad,La Liga,20,2002,1.2,3,3,3,0,0,1,5,20.0,4,2,0,2,0,3,3,0,0,2022-2023,0.0,2.5
Rk,Player,Nation,Pos,Squad,Comp,0,0,90.0,0,0,3,3,3,Tkl,0,0.0,0,0,0,0,0,0,0,0,0,2022-2023,0.0,0.0
2676,Tuta,BRA,DF,Eint Frankfurt,Bundesliga,23,1999,30.2,53,35,27,19,7,33,57,57.9,24,47,14,33,49,102,134,2,0,2022-2023,1.6225165562913908,1.7549668874172186
2677,Destiny Udogie,ITA,DF,Udinese,Serie A,19,2002,30.0,71,45,42,24,5,34,59,57.6,25,34,6,28,36,107,25,0,0,2022-2023,1.2,2.3666666666666667
2678,Ike Ugbo,CAN,"FW,MF",Troyes,Ligue 1,23,1998,9.9,5,2,2,2,1,3,11,27.3,8,8,2,6,2,7,4,0,0,2022-2023,0.20202020202020202,0.5050505050505051
2679,Lesley Ugochukwu,FRA,MF,Rennes,Ligue 1,18,2004,14.8,36,19,13,20,3,16,24,66.7,8,24,10,14,21,57,16,0,0,2022-2023,1.4189189189189189,2.4324324324324325
2680,Samir Ujkani,KVX,GK,Empoli,Serie A,34,1988,0.1,0,0,0,0,0,0,0,0.0,0,0,0,0,0,0,0,0,0,2022-2023,0.0,0.0
2681,Sven Ulreich,GER,GK,Bayern Munich,Bundesliga,33,1988,3.0,1,1,1,0,0,1,1,100.0,0,0,0,0,0,1,0,1,0,2022-2023,0.0,0.3333333333333333
2682,Lauren Ulrich,GER,MF,Stuttgart,Bundesliga,17,2005,0.1,1,1,0,0,1,0,0,0.0,0,0,0,0,0,1,0,0,0,2022-2023,0.0,10.0
2683,Samuel Umtiti,FRA,DF,Lecce,Serie A,28,1993,23.5,52,34,25,25,2,18,26,69.2,8,26,14,12,26,78,79,0,0,2022-2023,1.1063829787234043,2.2127659574468086
2684,Enes Ünal,TUR,FW,Getafe,La Liga,25,1997,33.0,26,14,5,19,2,7,25,28.0,18,19,2,17,6,32,35,0,0,2022-2023,0.18181818181818182,0.7878787878787878
2685,Deniz Undav,GER,"FW,MF",Brighton,Premier League,26,1996,7.0,7,4,2,2,3,2,8,25.0,6,4,1,3,0,7,1,0,0,2022-2023,0.0,1.0
2686,Cengiz Ünder,TUR,"MF,DF",Marseille,Ligue 1,25,1997,27.7,37,19,15,13,9,13,34,38.2,21,18,2,16,18,55,13,0,0,2022-2023,0.6498194945848376,1.3357400722021662
2687,Dayot Upamecano,FRA,DF,Bayern Munich,Bundesliga,23,1998,26.1,65,37,43,22,0,28,45,62.2,17,26,6,20,27,92,71,4,0,2022-2023,1.0344827586206895,2.490421455938697
2688,Filip Uremović,CRO,DF,Hertha BSC,Bundesliga,25,1997,19.2,38,23,29,8,1,14,22,63.6,8,18,13,5,36,74,88,2,0,2022-2023,1.875,1.9791666666666667
2689,Oscar Ureña,DOM,MF,Girona,La Liga,19,2003,1.1,4,2,2,2,0,2,3,66.7,1,2,0,2,1,5,0,0,0,2022-2023,0.9090909090909091,3.6363636363636362
2690,Jere Uronen,FIN,DF,Brest,Ligue 1,28,1994,3.3,8,5,4,4,0,7,12,58.3,5,6,2,4,7,15,5,0,0,2022-2023,2.121212121212121,2.4242424242424243
2691,Jere Uronen,FIN,DF,Schalke 04,Bundesliga,28,1994,7.5,14,10,6,6,2,6,10,60.0,4,5,2,3,8,22,13,0,0,2022-2023,1.0666666666666667,1.8666666666666667
2692,Mark Uth,GER,"MF,FW",Köln,Bundesliga,30,1991,0.5,0,0,0,0,0,0,0,0.0,0,0,0,0,0,0,0,0,0,2022-2023,0.0,0.0
2693,Josha Vagnoman,GER,DF,Stuttgart,Bundesliga,21,2000,16.4,26,15,12,11,3,15,27,55.6,12,20,2,18,8,34,29,1,0,2022-2023,0.48780487804878053,1.5853658536585367
2694,Diego Valencia,CHI,"MF,FW",Salernitana,Serie A,22,2000,2.6,8,5,4,2,2,2,9,22.2,7,10,1,9,1,9,2,0,0,2022-2023,0.3846153846153846,3.0769230769230766
2695,Óscar Valentín,ESP,MF,Rayo Vallecano,La Liga,27,1994,28.4,92,51,29,50,13,46,121,38.0,75,60,9,51,44,136,30,0,0,2022-2023,1.5492957746478875,3.23943661971831
2696,Emanuele Valeri,ITA,DF,Cremonese,Serie A,23,1998,30.9,54,27,29,21,4,29,69,42.0,40,17,3,14,22,76,44,1,0,2022-2023,0.7119741100323624,1.7475728155339807
2697,Yan Valery,TUN,DF,Southampton,Premier League,23,1999,0.5,0,0,0,0,0,0,0,0.0,0,1,0,1,0,0,3,0,0,2022-2023,0.0,0.0
2698,Yan Valery,TUN,DF,Angers,Ligue 1,23,1999,27.7,54,39,28,20,6,20,37,54.1,17,35,15,20,34,88,82,0,0,2022-2023,1.2274368231046933,1.9494584837545126
2699,Martin Valjent,SVK,DF,Mallorca,La Liga,26,1995,29.5,35,27,22,12,1,19,28,67.9,9,39,21,18,29,64,137,0,0,2022-2023,0.9830508474576272,1.1864406779661016
2700,Jesús Vallejo,ESP,DF,Real Madrid,La Liga,25,1997,0.2,0,0,0,0,0,0,0,0.0,0,0,0,0,0,0,0,0,0,2022-2023,0.0,0.0
Rk,Player,Nation,Pos,Squad,Comp,0,0,90.0,0,0,3,3,3,Tkl,0,0.0,0,0,0,0,0,0,0,0,0,2022-2023,0.0,0.0
2701,Manu Vallejo,ESP,"FW,MF",Girona,La Liga,25,1997,2.3,4,1,1,2,1,1,6,16.7,5,2,0,2,1,5,3,0,0,2022-2023,0.4347826086956522,1.7391304347826089
2702,Mattia Valoti,ITA,"MF,FW",Monza,Serie A,28,1993,5.0,17,10,7,9,1,5,16,31.3,11,13,3,10,3,20,6,0,0,2022-2023,0.6,3.4
2703,Federico Valverde,URU,"MF,FW",Real Madrid,La Liga,24,1998,27.8,31,20,14,11,6,13,26,50.0,13,31,4,27,17,48,15,0,0,2022-2023,0.6115107913669064,1.1151079136690647
2704,Virgil van Dijk,NED,DF,Liverpool,Premier League,31,1991,31.5,27,14,13,11,3,8,19,42.1,11,24,16,8,31,58,138,3,0,2022-2023,0.9841269841269841,0.8571428571428571
2705,Vanderson,BRA,"DF,MF",Monaco,Ligue 1,21,2001,24.6,84,48,36,34,14,44,75,58.7,31,36,9,27,48,132,36,1,0,2022-2023,1.951219512195122,3.4146341463414633
2706,Raphaël Varane,FRA,DF,Manchester Utd,Premier League,29,1993,21.2,24,9,18,6,0,7,17,41.2,10,24,17,7,11,35,91,0,0,2022-2023,0.5188679245283019,1.1320754716981132
2707,Jamie Vardy,ENG,FW,Leicester City,Premier League,35,1987,20.6,9,5,4,2,3,1,8,12.5,7,17,3,14,2,11,30,0,0,2022-2023,0.0970873786407767,0.4368932038834951
2708,Ruben Vargas,SUI,"MF,FW",Augsburg,Bundesliga,23,1998,12.6,15,7,6,7,2,5,11,45.5,6,8,2,6,6,21,16,1,0,2022-2023,0.4761904761904762,1.1904761904761905
2709,Johan Vásquez,MEX,DF,Cremonese,Serie A,23,1998,20.1,41,26,34,7,0,18,39,46.2,21,27,20,7,45,86,93,1,0,2022-2023,2.2388059701492535,2.0398009950248754
2710,Jesus Vazquez,ESP,"DF,MF",Valencia,La Liga,19,2003,3.4,13,8,9,1,3,6,11,54.5,5,4,0,4,1,14,8,0,0,2022-2023,0.29411764705882354,3.823529411764706
2711,Kevin Vázquez,ESP,"DF,MF",Celta Vigo,La Liga,29,1993,4.9,13,8,5,7,1,8,12,66.7,4,4,1,3,2,15,8,0,0,2022-2023,0.4081632653061224,2.6530612244897958
2712,Lucas Vázquez,ESP,DF,Real Madrid,La Liga,31,1991,12.7,34,23,22,10,2,20,28,71.4,8,10,0,10,7,41,13,0,0,2022-2023,0.5511811023622047,2.677165354330709
2713,Matías Vecino,URU,MF,Lazio,Serie A,30,1991,18.8,47,27,13,23,11,23,48,47.9,25,33,10,23,16,63,39,1,0,2022-2023,0.851063829787234,2.5
2714,Gabriel Veiga,ESP,MF,Celta Vigo,La Liga,20,2002,25.5,43,19,14,25,4,16,52,30.8,36,30,3,27,21,64,6,0,0,2022-2023,0.8235294117647058,1.6862745098039216
2715,Renato Veiga,POR,DF,Augsburg,Bundesliga,19,2003,7.1,9,6,4,3,2,7,9,77.8,2,20,6,14,7,16,29,1,0,2022-2023,0.9859154929577465,1.267605633802817
2716,Miloš Veljković,SRB,DF,Werder Bremen,Bundesliga,26,1995,25.2,30,19,17,13,0,18,29,62.1,11,32,16,16,33,63,103,0,0,2022-2023,1.3095238095238095,1.1904761904761905
2717,Miguel Veloso,POR,MF,Hellas Verona,Serie A,36,1986,12.9,33,10,20,12,1,16,26,61.5,10,26,6,20,6,39,14,0,0,2022-2023,0.46511627906976744,2.558139534883721
2718,Joël Veltman,NED,DF,Brighton,Premier League,30,1992,24.3,62,32,44,14,4,37,57,64.9,20,27,8,19,19,81,51,0,0,2022-2023,0.7818930041152263,2.551440329218107
2719,Micky van de Ven,NED,DF,Wolfsburg,Bundesliga,21,2001,33.0,45,30,26,18,1,28,39,71.8,11,42,24,18,26,71,108,2,0,2022-2023,0.7878787878787878,1.3636363636363635
2720,Unai Vencedor Paris,ESP,MF,Athletic Club,La Liga,21,2000,2.1,3,1,0,3,0,1,6,16.7,5,5,0,5,1,4,1,0,0,2022-2023,0.47619047619047616,1.4285714285714286
2721,Lorenzo Venuti,ITA,DF,Fiorentina,Serie A,27,1995,10.3,18,7,6,11,1,11,18,61.1,7,7,2,5,5,23,17,2,0,2022-2023,0.48543689320388345,1.7475728155339805
2722,Daniele Verde,ITA,"FW,MF",Spezia,Serie A,26,1996,11.1,4,4,3,0,1,3,7,42.9,4,6,0,6,8,12,4,0,0,2022-2023,0.7207207207207208,0.3603603603603604
2723,Simone Verdi,ITA,"MF,FW",Hellas Verona,Serie A,30,1992,12.2,15,10,7,5,3,6,17,35.3,11,8,1,7,0,15,2,0,0,2022-2023,0.0,1.2295081967213115
2724,Gonzalo Verdú,ESP,DF,Elche,La Liga,33,1988,7.8,10,5,8,2,0,4,8,50.0,4,8,6,2,10,20,33,0,0,2022-2023,1.2820512820512822,1.2820512820512822
2725,Jordan Veretout,FRA,MF,Marseille,Ligue 1,29,1993,31.8,56,35,17,32,7,25,53,47.2,28,22,7,15,36,92,40,2,0,2022-2023,1.1320754716981132,1.7610062893081762
Rk,Player,Nation,Pos,Squad,Comp,0,0,90.0,0,0,3,3,3,Tkl,0,0.0,0,0,0,0,0,0,0,0,0,2022-2023,0.0,0.0
2726,Marco Verratti,ITA,MF,Paris S-G,Ligue 1,29,1992,24.4,76,49,34,36,6,38,89,42.7,51,42,6,36,27,103,11,3,0,2022-2023,1.1065573770491803,3.114754098360656
2727,Valerio Verre,ITA,MF,Sampdoria,Serie A,28,1994,7.5,14,7,6,5,3,8,17,47.1,9,9,1,8,9,23,3,0,0,2022-2023,1.2,1.8666666666666667
2728,Mikel Vesga,ESP,MF,Athletic Club,La Liga,29,1993,28.6,57,35,21,31,5,25,68,36.8,43,39,8,31,36,93,39,3,0,2022-2023,1.2587412587412588,1.993006993006993
2729,Guglielmo Vicario,ITA,GK,Empoli,Serie A,25,1996,30.9,1,1,1,0,0,1,2,50.0,1,0,0,0,0,1,15,2,0,2022-2023,0.0,0.03236245954692557
2730,João Victor,BRA,DF,Nantes,Ligue 1,24,1998,9.4,19,11,9,7,3,12,22,54.5,10,11,1,10,15,34,30,0,0,2022-2023,1.5957446808510638,2.021276595744681
2731,Aleix Vidal,ESP,"MF,FW",Espanyol,La Liga,32,1989,11.4,11,5,6,3,2,4,22,18.2,18,21,2,19,15,26,14,0,0,2022-2023,1.3157894736842104,0.9649122807017544
2732,Clément Vidal,FRA,"DF,MF",Ajaccio,Ligue 1,22,2000,21.1,25,15,14,11,0,18,38,47.4,20,27,16,11,27,52,73,1,0,2022-2023,1.2796208530805686,1.1848341232227488
2733,Nacho Vidal,ESP,DF,Osasuna,La Liga,27,1995,13.9,27,14,16,6,5,17,32,53.1,15,17,4,13,19,46,33,1,0,2022-2023,1.3669064748201438,1.9424460431654675
2734,Gabriel Vidovic,CRO,FW,Bayern Munich,Bundesliga,18,2003,0.2,0,0,0,0,0,0,0,0.0,0,0,0,0,0,0,0,0,0,2022-2023,0.0,0.0
2735,Fabio Vieira,POR,"MF,FW",Arsenal,Premier League,22,2000,5.7,6,4,3,0,3,3,5,60.0,2,5,0,5,4,10,2,0,0,2022-2023,0.7017543859649122,1.0526315789473684
2736,Ronaldo Vieira,ENG,MF,Torino,Serie A,24,1998,0.2,1,0,0,1,0,1,1,100.0,0,0,0,0,0,1,2,0,0,2022-2023,0.0,5.0
2737,Ronaldo Vieira,ENG,MF,Sampdoria,Serie A,24,1998,9.1,18,10,4,12,2,10,13,76.9,3,15,5,10,13,31,10,2,0,2022-2023,1.4285714285714286,1.978021978021978
2738,Emanuel Vignato,ITA,"MF,FW",Bologna,Serie A,21,2000,2.7,4,4,2,2,0,2,4,50.0,2,2,0,2,3,7,0,0,0,2022-2023,1.111111111111111,1.4814814814814814
2739,Emanuel Vignato,ITA,"MF,FW",Empoli,Serie A,21,2000,0.6,2,0,2,0,0,0,0,0.0,0,0,0,0,0,2,1,0,0,2022-2023,0.0,3.3333333333333335
2740,Samuele Vignato,ITA,"MF,FW",Monza,Serie A,18,2004,0.7,0,0,0,0,0,0,0,0.0,0,1,0,1,0,0,0,0,0,2022-2023,0.0,0.0
2741,Tonny Vilhena,NED,MF,Salernitana,Serie A,27,1995,25.2,44,22,16,23,5,20,50,40.0,30,17,7,10,18,62,21,0,0,2022-2023,0.7142857142857143,1.746031746031746
2742,Toni Villa,ESP,MF,Valladolid,La Liga,27,1995,1.0,6,3,2,3,1,4,9,44.4,5,0,0,0,0,6,0,0,0,2022-2023,0.0,6.0
2743,Toni Villa,ESP,"MF,FW",Girona,La Liga,27,1995,9.9,25,18,9,11,5,10,23,43.5,13,8,0,8,8,33,3,0,0,2022-2023,0.8080808080808081,2.525252525252525
2744,Asier Villalibre,ESP,FW,Athletic Club,La Liga,24,1997,1.1,0,0,0,0,0,0,0,0.0,0,0,0,0,0,0,1,0,0,2022-2023,0.0,0.0
2745,Gonzalo Villar,ESP,MF,Sampdoria,Serie A,24,1998,7.7,13,7,4,8,1,7,15,46.7,8,11,3,8,4,17,9,1,0,2022-2023,0.5194805194805194,1.6883116883116882
2746,Gonzalo Villar,ESP,MF,Getafe,La Liga,24,1998,5.1,10,5,1,6,3,6,14,42.9,8,9,2,7,6,16,5,0,0,2022-2023,1.1764705882352942,1.9607843137254903
2747,Iván Villar,ESP,GK,Celta Vigo,La Liga,25,1997,19.0,0,0,0,0,0,0,1,0.0,1,0,0,0,0,0,7,0,0,2022-2023,0.0,0.0
2748,Matías Viña,URU,DF,Bournemouth,Premier League,24,1997,5.1,19,11,9,8,2,14,30,46.7,16,13,1,12,4,23,22,0,0,2022-2023,0.7843137254901962,3.7254901960784315
2749,Matías Viña,URU,DF,Roma,Serie A,24,1997,0.6,3,1,1,1,1,1,3,33.3,2,5,1,4,2,5,5,0,0,2022-2023,3.3333333333333335,5.0
2750,Rúben Vinagre,POR,"DF,MF",Everton,Premier League,23,1999,0.3,2,2,1,1,0,1,2,50.0,1,0,0,0,0,2,1,0,0,2022-2023,0.0,6.666666666666667
Rk,Player,Nation,Pos,Squad,Comp,0,0,90.0,0,0,3,3,3,Tkl,0,0.0,0,0,0,0,0,0,0,0,0,2022-2023,0.0,0.0
2751,Carlos Vinícius,BRA,FW,Fulham,Premier League,27,1995,12.3,4,1,0,2,2,0,4,0.0,4,7,0,7,0,4,10,0,0,2022-2023,0.0,0.3252032520325203
2752,Alan Virginius,FRA,FW,Lille,Ligue 1,19,2003,2.9,3,2,1,1,1,0,4,0.0,4,0,0,0,2,5,1,0,0,2022-2023,0.6896551724137931,1.0344827586206897
2753,Mattia Viti,ITA,DF,Nice,Ligue 1,20,2002,7.0,4,2,1,1,2,2,5,40.0,3,9,3,6,8,12,22,0,0,2022-2023,1.1428571428571428,0.5714285714285714
2754,Vitinha,POR,FW,Marseille,Ligue 1,22,2000,5.2,15,7,0,6,9,3,11,27.3,8,3,0,3,2,17,6,0,0,2022-2023,0.3846153846153846,2.8846153846153846
2755,Vitinha,POR,MF,Paris S-G,Ligue 1,22,2000,27.2,58,25,21,27,10,27,83,32.5,56,27,4,23,25,83,15,0,0,2022-2023,0.9191176470588236,2.1323529411764706
2756,Daniel Vivian,ESP,DF,Athletic Club,La Liga,23,1999,26.4,57,32,36,16,5,36,45,80.0,9,27,14,13,24,81,90,3,0,2022-2023,0.9090909090909092,2.159090909090909
2757,Dušan Vlahović,SRB,FW,Juventus,Serie A,22,2000,21.4,11,6,0,7,4,4,10,40.0,6,10,3,7,3,14,8,1,0,2022-2023,0.14018691588785048,0.5140186915887851
2758,Nikola Vlašić,CRO,"MF,FW",Torino,Serie A,24,1997,30.3,32,21,9,16,7,15,34,44.1,19,25,2,23,10,42,14,0,0,2022-2023,0.33003300330033003,1.056105610561056
2759,Joel Voelkerling Persson,SWE,"FW,MF",Lecce,Serie A,19,2003,1.1,1,1,0,0,1,0,1,0.0,1,1,0,1,0,1,0,0,0,2022-2023,0.0,0.9090909090909091
2760,Kevin Vogt,GER,DF,Hoffenheim,Bundesliga,30,1991,19.7,15,10,10,5,0,9,22,40.9,13,18,11,7,26,41,67,0,0,2022-2023,1.3197969543147208,0.7614213197969544
2761,Mërgim Vojvoda,KVX,DF,Torino,Serie A,27,1995,19.1,22,12,15,6,1,12,24,50.0,12,14,2,12,10,32,31,1,0,2022-2023,0.5235602094240838,1.1518324607329842
2762,Kevin Volland,GER,"FW,MF",Monaco,Ligue 1,30,1992,7.1,8,4,1,5,2,2,8,25.0,6,8,0,8,2,10,0,0,0,2022-2023,0.28169014084507044,1.1267605633802817
2763,Cristian Volpato,ITA,MF,Roma,Serie A,18,2003,2.5,3,2,1,1,1,0,2,0.0,2,2,0,2,2,5,0,0,0,2022-2023,0.8,1.2
2764,Lukáš Vorlický,CZE,"MF,FW",Atalanta,Serie A,20,2002,0.3,0,0,0,0,0,0,0,0.0,0,0,0,0,1,1,0,0,0,2022-2023,3.3333333333333335,0.0
2765,Aster Vranckx,BEL,MF,Milan,Serie A,19,2002,2.7,3,2,0,2,1,2,7,28.6,5,3,1,2,2,5,1,0,0,2022-2023,0.7407407407407407,1.111111111111111
2766,Aster Vranckx,BEL,MF,Wolfsburg,Bundesliga,19,2002,0.1,0,0,0,0,0,0,0,0.0,0,0,0,0,0,0,1,0,0,2022-2023,0.0,0.0
2767,Stefan de Vrij,NED,DF,Inter,Serie A,30,1992,21.6,28,18,19,9,0,8,14,57.1,6,18,10,8,40,68,80,0,0,2022-2023,1.8518518518518516,1.2962962962962963
2768,Robert Wagner,GER,MF,Freiburg,Bundesliga,19,2003,0.4,0,0,0,0,0,0,0,0.0,0,2,0,2,0,0,2,0,0,2022-2023,0.0,0.0
2769,Elye Wahi,FRA,FW,Montpellier,Ligue 1,19,2003,27.9,9,3,2,3,4,5,14,35.7,9,14,2,12,3,12,5,0,0,2022-2023,0.10752688172043011,0.3225806451612903
2770,Walace,BRA,MF,Udinese,Serie A,27,1995,35.4,82,39,42,31,9,41,90,45.6,49,47,12,35,51,133,51,1,0,2022-2023,1.440677966101695,2.3163841807909606
2771,Theo Walcott,ENG,"FW,MF",Southampton,Premier League,33,1989,12.5,13,6,8,4,1,8,27,29.6,19,8,1,7,9,22,7,0,0,2022-2023,0.72,1.04
2772,Luca Waldschmidt,GER,"FW,MF",Wolfsburg,Bundesliga,26,1996,5.8,5,2,2,1,2,2,10,20.0,8,6,0,6,3,8,5,0,0,2022-2023,0.5172413793103449,0.8620689655172414
2773,Kyle Walker,ENG,DF,Manchester City,Premier League,32,1990,21.8,13,9,8,5,0,4,24,16.7,20,12,2,10,18,31,22,0,0,2022-2023,0.8256880733944953,0.5963302752293578
2774,Kyle Walker-Peters,ENG,DF,Southampton,Premier League,25,1997,29.4,61,32,34,24,3,22,43,51.2,21,47,8,39,27,88,52,0,0,2022-2023,0.9183673469387755,2.0748299319727894
2775,Sebastian Walukiewicz,POL,DF,Empoli,Serie A,22,2000,6.7,9,6,7,2,0,4,6,66.7,2,10,9,1,7,16,30,0,0,2022-2023,1.044776119402985,1.3432835820895521
Rk,Player,Nation,Pos,Squad,Comp,0,0,90.0,0,0,3,3,3,Tkl,0,0.0,0,0,0,0,0,0,0,0,0,2022-2023,0.0,0.0
2776,Aaron Wan-Bissaka,ENG,DF,Manchester Utd,Premier League,24,1997,15.9,40,25,20,17,3,23,25,92.0,2,24,8,16,22,62,41,0,0,2022-2023,1.3836477987421383,2.5157232704402515
2777,Paul Wanner,GER,MF,Bayern Munich,Bundesliga,16,2005,0.3,3,1,1,2,0,1,1,100.0,0,0,0,0,0,3,1,0,0,2022-2023,0.0,10.0
2778,Danny Ward,WAL,GK,Leicester City,Premier League,29,1993,26.0,1,1,1,0,0,1,3,33.3,2,0,0,0,0,1,14,2,0,2022-2023,0.0,0.038461538461538464
2779,Joel Ward,ENG,DF,Crystal Palace,Premier League,32,1989,25.1,50,36,30,11,9,30,41,73.2,11,32,16,16,25,75,80,1,0,2022-2023,0.99601593625498,1.99203187250996
2780,James Ward-Prowse,ENG,MF,Southampton,Premier League,27,1994,37.5,65,37,31,27,7,21,61,34.4,40,30,10,20,55,120,48,0,0,2022-2023,1.4666666666666666,1.7333333333333334
2781,Ollie Watkins,ENG,FW,Aston Villa,Premier League,26,1995,34.7,19,13,3,13,3,10,27,37.0,17,21,4,17,10,29,39,0,0,2022-2023,0.2881844380403458,0.547550432276657
2782,Timothy Weah,USA,"DF,FW",Lille,Ligue 1,22,2000,19.4,24,14,13,9,2,16,29,55.2,13,17,3,14,23,47,18,0,0,2022-2023,1.1855670103092784,1.2371134020618557
2783,Adam Webster,ENG,DF,Brighton,Premier League,27,1995,22.1,22,12,10,9,3,11,19,57.9,8,30,19,11,19,41,55,4,0,2022-2023,0.8597285067873303,0.9954751131221719
2784,Wout Weghorst,NED,"FW,MF",Manchester Utd,Premier League,29,1992,8.9,11,5,6,1,4,2,9,22.2,7,7,2,5,7,18,9,0,0,2022-2023,0.7865168539325842,1.2359550561797752
2785,Julian Weigl,GER,MF,Gladbach,Bundesliga,26,1995,21.0,43,16,21,21,1,23,41,56.1,18,23,2,21,18,61,32,0,0,2022-2023,0.8571428571428571,2.0476190476190474
2786,Nelson Weiper,GER,"FW,DF",Mainz 05,Bundesliga,17,2005,1.1,2,0,0,0,2,1,3,33.3,2,2,0,2,0,2,1,0,0,2022-2023,0.0,1.8181818181818181
2787,Mitchell Weiser,GER,"DF,FW",Werder Bremen,Bundesliga,28,1994,28.0,71,43,38,24,9,38,75,50.7,37,50,7,43,28,99,38,1,0,2022-2023,1.0,2.5357142857142856
2788,Noah Weißhaupt,GER,"MF,DF",Freiburg,Bundesliga,20,2001,4.7,11,6,3,7,1,2,7,28.6,5,4,0,4,6,17,8,0,0,2022-2023,1.276595744680851,2.3404255319148937
2789,Shon Weissman,ISR,FW,Valladolid,La Liga,26,1996,8.3,2,1,1,1,0,0,4,0.0,4,8,0,8,1,3,7,0,0,2022-2023,0.12048192771084336,0.24096385542168672
2790,Danny Welbeck,ENG,FW,Brighton,Premier League,31,1990,20.6,15,7,0,7,8,4,11,36.4,7,24,2,22,5,20,20,0,0,2022-2023,0.24271844660194172,0.7281553398058251
2791,Marcel Wenig,GER,MF,Eint Frankfurt,Bundesliga,18,2004,0.0,0,0,0,0,0,0,0,0.0,0,0,0,0,0,0,0,0,0,2022-2023,,
2792,Axel Werner,ARG,GK,Elche,La Liga,26,1996,2.0,0,0,0,0,0,0,1,0.0,1,0,0,0,0,0,0,0,0,2022-2023,0.0,0.0
2793,Timo Werner,GER,"FW,MF",RB Leipzig,Bundesliga,26,1996,21.5,10,5,4,3,3,4,12,33.3,8,12,0,12,7,17,5,0,0,2022-2023,0.32558139534883723,0.46511627906976744
2794,Ben White,ENG,DF,Arsenal,Premier League,24,1997,33.9,60,31,23,30,7,42,70,60.0,28,47,11,36,22,82,79,1,0,2022-2023,0.6489675516224189,1.7699115044247788
2795,Harvey White,ENG,MF,Tottenham,Premier League,20,2001,0.1,0,0,0,0,0,0,1,0.0,1,0,0,0,0,0,0,0,0,2022-2023,0.0,0.0
2796,Joseph Whitworth,ENG,GK,Crystal Palace,Premier League,18,2004,2.0,0,0,0,0,0,0,0,0.0,0,0,0,0,0,0,1,0,0,2022-2023,0.0,0.0
2797,Silvan Widmer,SUI,DF,Mainz 05,Bundesliga,29,1993,18.8,26,17,15,10,1,20,39,51.3,19,22,8,14,31,57,28,0,0,2022-2023,1.6489361702127658,1.3829787234042552
2798,Mateusz Wieteska,POL,DF,Clermont Foot,Ligue 1,25,1997,34.6,41,23,28,13,0,19,33,57.6,14,44,28,16,56,97,97,4,0,2022-2023,1.6184971098265895,1.1849710982658959
2799,Georginio Wijnaldum,NED,MF,Roma,Serie A,31,1990,8.5,4,3,1,3,0,0,2,0.0,2,7,1,6,2,6,3,0,0,2022-2023,0.23529411764705882,0.47058823529411764
2800,Iñaki Williams,GHA,FW,Athletic Club,La Liga,28,1994,31.5,22,16,5,14,3,9,24,37.5,15,18,3,15,7,29,34,0,0,2022-2023,0.2222222222222222,0.6984126984126984
Rk,Player,Nation,Pos,Squad,Comp,0,0,90.0,0,0,3,3,3,Tkl,0,0.0,0,0,0,0,0,0,0,0,0,2022-2023,0.0,0.0
2801,Neco Williams,WAL,DF,Nott'ham Forest,Premier League,21,2001,20.9,72,47,49,17,6,38,71,53.5,33,33,8,25,33,105,48,0,0,2022-2023,1.5789473684210527,3.444976076555024
2802,Nico Williams,ESP,FW,Athletic Club,La Liga,20,2002,29.5,31,16,10,15,6,19,41,46.3,22,40,2,38,8,39,14,1,0,2022-2023,0.2711864406779661,1.0508474576271187
2803,Willian,BRA,FW,Fulham,Premier League,33,1988,23.6,13,8,8,3,2,7,25,28.0,18,13,0,13,9,22,9,0,0,2022-2023,0.3813559322033898,0.5508474576271186
2804,Joe Willock,ENG,MF,Newcastle Utd,Premier League,22,1999,28.4,51,30,13,26,12,25,58,43.1,33,54,8,46,25,76,17,0,0,2022-2023,0.8802816901408451,1.795774647887324
2805,Callum Wilson,ENG,FW,Newcastle Utd,Premier League,30,1992,20.9,9,3,0,8,1,0,3,0.0,3,8,0,8,1,10,5,0,0,2022-2023,0.04784688995215311,0.430622009569378
2806,Harry Wilson,WAL,FW,Fulham,Premier League,25,1997,12.2,21,13,9,9,3,8,18,44.4,10,17,2,15,6,27,14,0,0,2022-2023,0.49180327868852464,1.7213114754098362
2807,Patrick Wimmer,AUT,"FW,MF",Wolfsburg,Bundesliga,21,2001,18.3,39,26,18,11,10,12,38,31.6,26,27,2,25,15,54,15,0,0,2022-2023,0.819672131147541,2.1311475409836063
2808,Jonas Wind,DEN,FW,Wolfsburg,Bundesliga,23,1999,14.3,14,6,2,7,5,5,10,50.0,5,14,4,10,1,15,10,0,0,2022-2023,0.06993006993006992,0.979020979020979
2809,Harry Winks,ENG,MF,Sampdoria,Serie A,26,1996,19.1,27,12,7,18,2,14,43,32.6,29,14,8,6,24,51,24,0,0,2022-2023,1.256544502617801,1.413612565445026
2810,Frederik Winther,DEN,DF,Augsburg,Bundesliga,21,2001,1.0,2,2,1,1,0,0,2,0.0,2,1,1,0,0,2,7,0,0,2022-2023,0.0,2.0
2811,Florian Wirtz,GER,"FW,MF",Leverkusen,Bundesliga,19,2003,12.1,18,10,9,7,2,8,16,50.0,8,15,1,14,1,19,6,0,0,2022-2023,0.08264462809917356,1.4876033057851241
2812,Przemysław Wiśniewski,POL,DF,Spezia,Serie A,24,1998,11.1,13,6,7,6,0,6,18,33.3,12,16,8,8,11,24,66,0,0,2022-2023,0.990990990990991,1.1711711711711712
2813,Yoane Wissa,COD,FW,Brentford,Premier League,25,1996,17.8,17,12,4,7,6,6,13,46.2,7,10,0,10,6,23,15,0,0,2022-2023,0.33707865168539325,0.9550561797752809
2814,Axel Witsel,BEL,"DF,MF",Atlético Madrid,La Liga,33,1989,25.1,36,22,22,11,3,17,31,54.8,14,20,11,9,23,59,76,0,0,2022-2023,0.9163346613545816,1.4342629482071712
2815,Maximilian Wöber,AUT,DF,Leeds United,Premier League,24,1998,14.1,25,18,9,15,1,16,24,66.7,8,32,14,18,27,52,67,1,0,2022-2023,1.9148936170212767,1.773049645390071
2816,Hannes Wolf,AUT,FW,Gladbach,Bundesliga,23,1999,5.0,11,8,4,5,2,5,13,38.5,8,3,0,3,3,14,9,0,0,2022-2023,0.6,2.2
2817,Marius Wolf,GER,DF,Dortmund,Bundesliga,27,1995,17.4,25,18,9,12,4,16,29,55.2,13,40,10,30,18,43,22,1,0,2022-2023,1.0344827586206897,1.4367816091954024
2818,Jeong Woo-yeong,KOR,"MF,FW",Freiburg,Bundesliga,22,1999,7.3,7,3,4,2,1,2,5,40.0,3,7,1,6,1,8,7,0,0,2022-2023,0.136986301369863,0.9589041095890412
2819,Chris Wood,NZL,FW,Newcastle Utd,Premier League,30,1991,5.0,5,4,0,3,2,3,5,60.0,2,2,2,0,1,6,7,0,0,2022-2023,0.2,1.0
2820,Chris Wood,NZL,FW,Nott'ham Forest,Premier League,30,1991,4.1,0,0,0,0,0,0,1,0.0,1,2,1,1,1,1,2,0,0,2022-2023,0.24390243902439027,0.0
2821,Christopher Wooh,CMR,DF,Rennes,Ligue 1,20,2001,11.2,16,7,8,8,0,9,11,81.8,2,11,5,6,6,22,49,0,0,2022-2023,0.5357142857142857,1.4285714285714286
2822,Christopher Wooh,CMR,MF,Lens,Ligue 1,20,2001,0.0,0,0,0,0,0,0,1,0.0,1,0,0,0,0,0,1,0,0,2022-2023,,
2823,Joe Worrall,ENG,DF,Nott'ham Forest,Premier League,25,1997,24.7,53,25,39,12,2,25,35,71.4,10,33,23,10,26,79,111,1,0,2022-2023,1.0526315789473684,2.145748987854251
2824,Xeka,POR,MF,Rennes,Ligue 1,27,1994,6.1,10,3,6,3,1,7,16,43.8,9,11,2,9,6,16,8,0,0,2022-2023,0.9836065573770493,1.639344262295082
2825,Granit Xhaka,SUI,MF,Arsenal,Premier League,29,1992,33.3,34,27,11,18,5,16,41,39.0,25,28,10,18,15,49,45,1,0,2022-2023,0.4504504504504505,1.021021021021021
Rk,Player,Nation,Pos,Squad,Comp,0,0,90.0,0,0,3,3,3,Tkl,0,0.0,0,0,0,0,0,0,0,0,0,2022-2023,0.0,0.0
2826,Lamine Yamal,ESP,FW,Barcelona,La Liga,15,2007,0.1,0,0,0,0,0,0,0,0.0,0,0,0,0,0,0,0,0,0,2022-2023,0.0,0.0
2827,Jawad El Yamiq,MAR,DF,Valladolid,La Liga,30,1992,17.9,17,11,10,7,0,6,11,54.5,5,27,19,8,37,54,101,0,0,2022-2023,2.0670391061452515,0.9497206703910616
2828,Ryan Yates,ENG,MF,Nott'ham Forest,Premier League,24,1997,20.4,38,19,19,16,3,14,22,63.6,8,26,8,18,10,48,44,0,0,2022-2023,0.4901960784313726,1.8627450980392157
2829,Yusuf Yazıcı,TUR,MF,Lille,Ligue 1,25,1997,2.2,0,0,0,0,0,0,0,0.0,0,2,0,2,0,0,1,0,0,2022-2023,0.0,0.0
2830,Kelvin Yeboah,ITA,"FW,MF",Augsburg,Bundesliga,22,2000,3.9,6,4,2,4,0,2,5,40.0,3,7,0,7,1,7,2,0,0,2022-2023,0.25641025641025644,1.5384615384615385
2831,Gerard Yepes,ESP,MF,Sampdoria,Serie A,19,2002,2.2,5,3,2,3,0,1,3,33.3,2,3,0,3,4,9,3,0,0,2022-2023,1.8181818181818181,2.2727272727272725
2832,Darlin Yongwa,CMR,DF,Lorient,Ligue 1,21,2000,8.7,13,11,7,5,1,4,15,26.7,11,13,1,12,5,18,11,0,0,2022-2023,0.574712643678161,1.4942528735632186
2833,Leny Yoro,FRA,DF,Lille,Ligue 1,16,2005,8.5,11,5,8,3,0,4,9,44.4,5,6,1,5,18,29,27,1,0,2022-2023,2.1176470588235294,1.2941176470588236
2834,Maya Yoshida,JPN,DF,Schalke 04,Bundesliga,33,1988,28.4,34,22,19,13,2,18,29,62.1,11,40,29,11,46,80,132,2,0,2022-2023,1.619718309859155,1.1971830985915493
2835,Ashley Young,ENG,DF,Aston Villa,Premier League,37,1985,22.6,50,27,34,15,1,37,50,74.0,13,25,11,14,21,71,65,0,0,2022-2023,0.9292035398230087,2.2123893805309733
2836,Mohamed Youssouf,COM,DF,Ajaccio,Ligue 1,34,1988,27.3,72,44,41,24,7,38,61,62.3,23,32,8,24,65,137,70,0,0,2022-2023,2.380952380952381,2.6373626373626373
2837,Illia Zabarnyi,UKR,DF,Bournemouth,Premier League,19,2002,3.3,4,2,4,0,0,3,7,42.9,4,7,2,5,3,7,14,0,0,2022-2023,0.9090909090909092,1.2121212121212122
2838,Mattia Zaccagni,ITA,FW,Lazio,Serie A,27,1995,30.8,42,28,16,18,8,14,38,36.8,24,37,3,34,21,63,10,1,0,2022-2023,0.6818181818181818,1.3636363636363635
2839,Dan-Axel Zagadou,FRA,DF,Stuttgart,Bundesliga,23,1999,14.1,14,9,10,4,0,5,14,35.7,9,19,16,3,21,35,81,1,0,2022-2023,1.4893617021276595,0.9929078014184397
2840,Wilfried Zaha,CIV,"FW,MF",Crystal Palace,Premier League,29,1992,25.4,32,20,12,12,8,8,21,38.1,13,21,1,20,16,48,9,0,0,2022-2023,0.6299212598425197,1.2598425196850394
2841,Warren Zaïre-Emery,FRA,"MF,DF",Paris S-G,Ligue 1,16,2006,10.3,17,10,5,10,2,8,29,27.6,21,11,0,11,12,29,17,0,0,2022-2023,1.1650485436893203,1.6504854368932038
2842,Denis Zakaria,SUI,MF,Chelsea,Premier League,25,1996,4.6,9,5,5,2,2,2,8,25.0,6,4,1,3,3,12,10,0,0,2022-2023,0.6521739130434783,1.956521739130435
2843,Denis Zakaria,SUI,MF,Juventus,Serie A,25,1996,1.4,6,3,1,4,1,2,2,100.0,0,2,0,2,2,8,1,0,0,2022-2023,1.4285714285714286,4.285714285714286
2844,Rodrigo Zalazar,URU,"MF,FW",Schalke 04,Bundesliga,22,1999,14.7,16,8,5,9,2,9,24,37.5,15,16,1,15,7,23,13,0,0,2022-2023,0.4761904761904762,1.08843537414966
2845,Joseba Zaldúa,ESP,DF,Cádiz,La Liga,30,1992,7.1,15,8,10,4,1,7,10,70.0,3,4,2,2,11,26,22,0,0,2022-2023,1.5492957746478875,2.1126760563380285
2846,Nicola Zalewski,POL,DF,Roma,Serie A,20,2002,24.4,45,26,25,15,5,22,71,31.0,49,27,1,26,31,76,23,0,0,2022-2023,1.2704918032786885,1.8442622950819674
2847,Andre-Frank Zambo Anguissa,CMR,MF,Napoli,Serie A,26,1995,33.9,53,32,16,29,8,16,64,25.0,48,50,4,46,49,102,25,0,0,2022-2023,1.4454277286135693,1.5634218289085546
2848,Oliver Zandén,SWE,"DF,MF",Toulouse,Ligue 1,20,2001,1.6,2,1,1,0,1,2,5,40.0,3,0,0,0,1,3,7,0,0,2022-2023,0.625,1.25
2849,Luca Zanimacchia,ITA,"MF,FW",Cremonese,Serie A,24,1998,8.3,21,13,11,6,4,8,21,38.1,13,9,0,9,9,30,5,0,0,2022-2023,1.0843373493975903,2.5301204819277108
2850,Nicolò Zaniolo,ITA,"MF,FW",Roma,Serie A,23,1999,9.9,7,5,2,4,1,2,7,28.6,5,11,0,11,2,9,0,0,0,2022-2023,0.20202020202020202,0.7070707070707071
Rk,Player,Nation,Pos,Squad,Comp,0,0,90.0,0,0,3,3,3,Tkl,0,0.0,0,0,0,0,0,0,0,0,0,2022-2023,0.0,0.0
2851,Alessandro Zanoli,ITA,DF,Sampdoria,Serie A,21,2000,17.1,22,14,14,6,2,8,17,47.1,9,19,15,4,12,34,39,0,0,2022-2023,0.7017543859649122,1.286549707602339
2852,Alessandro Zanoli,ITA,DF,Napoli,Serie A,21,2000,0.1,1,0,0,1,0,0,0,0.0,0,0,0,0,0,1,1,0,0,2022-2023,0.0,10.0
2853,Mattia Zanotti,ITA,DF,Inter,Serie A,19,2003,0.3,0,0,0,0,0,0,1,0.0,1,2,0,2,0,0,0,0,0,2022-2023,0.0,0.0
2854,Duván Zapata,COL,FW,Atalanta,Serie A,31,1991,15.4,8,4,1,3,4,3,5,60.0,2,6,2,4,4,12,17,1,0,2022-2023,0.2597402597402597,0.5194805194805194
2855,Davide Zappacosta,ITA,DF,Atalanta,Serie A,30,1992,16.3,34,18,17,12,5,15,22,68.2,7,23,2,21,9,43,16,0,0,2022-2023,0.5521472392638036,2.085889570552147
2856,Oier Zarraga,ESP,MF,Athletic Club,La Liga,23,1999,9.5,14,9,5,7,2,8,20,40.0,12,7,0,7,10,24,5,0,0,2022-2023,1.0526315789473684,1.4736842105263157
2857,Akim Zedadka,ALG,DF,Auxerre,Ligue 1,27,1995,17.8,35,21,21,10,4,18,32,56.3,14,17,3,14,23,58,51,1,0,2022-2023,1.2921348314606742,1.9662921348314606
2858,Akim Zedadka,ALG,"DF,MF",Lille,Ligue 1,27,1995,3.9,1,1,1,0,0,0,2,0.0,2,3,0,3,2,3,6,0,0,2022-2023,0.5128205128205129,0.25641025641025644
2859,Karim Zedadka,FRA,FW,Napoli,Serie A,22,2000,0.2,0,0,0,0,0,0,0,0.0,0,0,0,0,0,0,1,0,0,2022-2023,0.0,0.0
2860,Deyovaisio Zeefuik,NED,DF,Hellas Verona,Serie A,24,1998,0.1,1,1,0,1,0,0,0,0.0,0,0,0,0,0,1,0,0,0,2022-2023,0.0,10.0
2861,Marvin Zeegelaar,NED,DF,Udinese,Serie A,31,1990,3.9,8,4,6,2,0,3,4,75.0,1,2,0,2,3,11,5,0,0,2022-2023,0.7692307692307693,2.0512820512820515
2862,Mehdi Zeffane,ALG,"DF,MF",Clermont Foot,Ligue 1,30,1992,7.3,12,7,5,7,0,4,21,19.0,17,14,6,8,22,34,12,0,0,2022-2023,3.0136986301369864,1.6438356164383563
2863,Aaron Zehnter,GER,DF,Augsburg,Bundesliga,17,2004,0.0,0,0,0,0,0,0,1,0.0,1,0,0,0,1,1,0,0,0,2022-2023,inf,
2864,Jordan Zemura,ZIM,DF,Bournemouth,Premier League,22,1999,16.2,39,24,24,14,1,23,44,52.3,21,31,9,22,16,55,32,0,0,2022-2023,0.9876543209876544,2.4074074074074074
2865,Arber Zeneli,KVX,"FW,MF",Reims,Ligue 1,27,1995,11.1,9,3,3,3,3,5,12,41.7,7,8,0,8,2,11,2,0,0,2022-2023,0.1801801801801802,0.8108108108108109
2866,Robin Zentner,GER,GK,Mainz 05,Bundesliga,27,1994,26.0,0,0,0,0,0,0,4,0.0,4,0,0,0,0,0,17,1,0,2022-2023,0.0,0.0
2867,Alessio Zerbin,ITA,FW,Napoli,Serie A,23,1999,2.2,10,5,4,5,1,4,8,50.0,4,2,0,2,2,12,2,0,0,2022-2023,0.9090909090909091,4.545454545454545
2868,Michael Zetterer,GER,GK,Werder Bremen,Bundesliga,27,1995,1.7,0,0,0,0,0,0,0,0.0,0,0,0,0,0,0,1,0,0,2022-2023,0.0,0.0
2869,Nathan Zeze,FRA,DF,Nantes,Ligue 1,17,2005,0.7,3,2,2,1,0,1,1,100.0,0,0,0,0,0,3,1,0,0,2022-2023,0.0,4.285714285714286
2870,Edon Zhegrova,KVX,"FW,MF",Lille,Ligue 1,23,1999,11.7,18,12,6,7,5,12,20,60.0,8,9,0,9,2,20,2,0,0,2022-2023,0.17094017094017094,1.5384615384615385
2871,Piotr Zieliński,POL,MF,Napoli,Serie A,28,1994,25.4,17,10,1,11,5,12,25,48.0,13,16,5,11,14,31,7,0,0,2022-2023,0.5511811023622047,0.6692913385826772
2872,David Zima,CZE,DF,Torino,Serie A,21,2000,4.5,9,5,5,4,0,3,4,75.0,1,7,2,5,9,18,11,2,0,2022-2023,2.0,2.0
2873,Oleksandr Zinchenko,UKR,DF,Arsenal,Premier League,25,1996,23.5,40,18,14,17,9,21,40,52.5,19,20,2,18,22,62,38,2,0,2022-2023,0.9361702127659575,1.702127659574468
2874,Joshua Zirkzee,NED,FW,Bologna,Serie A,21,2001,9.1,4,2,1,1,2,2,7,28.6,5,4,1,3,4,8,4,0,0,2022-2023,0.43956043956043955,0.43956043956043955
2875,Hakim Ziyech,MAR,"FW,MF",Chelsea,Premier League,29,1993,7.3,20,12,12,5,3,4,9,44.4,5,8,0,8,5,25,5,1,0,2022-2023,0.684931506849315,2.73972602739726
Rk,Player,Nation,Pos,Squad,Comp,0,0,90.0,0,0,3,3,3,Tkl,0,0.0,0,0,0,0,0,0,0,0,0,2022-2023,0.0,0.0
2876,Jeroen Zoet,NED,GK,Spezia,Serie A,31,1991,3.7,1,1,1,0,0,1,1,100.0,0,0,0,0,0,1,1,0,0,2022-2023,0.0,0.27027027027027023
2877,Simon Zoller,GER,FW,Bochum,Bundesliga,31,1991,16.2,11,4,2,8,1,4,12,33.3,8,14,1,13,6,17,21,0,0,2022-2023,0.3703703703703704,0.6790123456790124
2878,Nadir Zortea,ITA,"DF,MF",Atalanta,Serie A,23,1999,2.5,10,5,3,7,0,3,4,75.0,1,4,0,4,0,10,4,0,0,2022-2023,0.0,4.0
2879,Nadir Zortea,ITA,DF,Sassuolo,Serie A,23,1999,7.3,15,8,12,2,1,9,14,64.3,5,10,4,6,4,19,21,0,0,2022-2023,0.547945205479452,2.0547945205479454
2880,Tanguy Zoukrou,FRA,DF,Troyes,Ligue 1,19,2003,5.7,14,7,8,6,0,10,14,71.4,4,18,11,7,2,16,24,0,0,2022-2023,0.3508771929824561,2.456140350877193
2881,Kurt Zouma,FRA,DF,West Ham,Premier League,27,1994,22.1,9,4,4,5,0,5,8,62.5,3,17,14,3,30,39,120,1,0,2022-2023,1.3574660633484161,0.4072398190045249
2882,Petar Zovko,BIH,GK,Spezia,Serie A,20,2002,0.8,1,0,1,0,0,1,1,100.0,0,0,0,0,0,1,0,0,0,2022-2023,0.0,1.25
2883,Igor Zubeldia,ESP,DF,Real Sociedad,La Liga,25,1997,28.2,35,18,28,7,0,25,35,71.4,10,23,17,6,21,56,93,0,0,2022-2023,0.7446808510638298,1.2411347517730498
2884,Martín Zubimendi,ESP,MF,Real Sociedad,La Liga,23,1999,34.5,59,33,23,30,6,24,45,53.3,21,44,17,27,37,96,55,4,0,2022-2023,1.0724637681159421,1.710144927536232
2885,Szymon Żurkowski,POL,MF,Fiorentina,Serie A,24,1997,0.4,0,0,0,0,0,0,0,0.0,0,0,0,0,0,0,0,0,0,2022-2023,0.0,0.0
2886,Szymon Żurkowski,POL,MF,Spezia,Serie A,24,1997,4.7,9,3,4,4,1,2,15,13.3,13,9,2,7,4,13,6,0,0,2022-2023,0.851063829787234,1.9148936170212765
2887,Martin Ødegaard,NOR,MF,Arsenal,Premier League,23,1998,34.7,36,23,12,14,10,14,47,29.8,33,20,5,15,6,42,12,1,0,2022-2023,0.17291066282420747,1.037463976945245
2888,Milan Đurić,BIH,FW,Hellas Verona,Serie A,32,1990,15.2,2,1,1,0,1,1,3,33.3,2,7,4,3,1,3,24,0,0,2022-2023,0.06578947368421052,0.13157894736842105
2889,Filip Đuričić,SRB,"MF,FW",Sampdoria,Serie A,30,1992,24.1,43,22,18,20,5,14,32,43.8,18,19,6,13,7,50,8,0,0,2022-2023,0.2904564315352697,1.784232365145228
1,Max Aarons,ENG,DF,Bournemouth,Premier League,23,2000,13.7,29,19,20,7,2,20,34,58.8,14,9,5,4,8,37,27,0,0,2023-2024,0.5839416058394161,2.1167883211678835
2,Brenden Aaronson,USA,"MF,FW",Union Berlin,Bundesliga,22,2000,14.1,32,18,13,13,6,16,32,50.0,16,26,1,25,2,34,4,0,0,2023-2024,0.14184397163120568,2.269503546099291
3,Paxten Aaronson,USA,MF,Eint Frankfurt,Bundesliga,19,2003,1.1,2,2,1,1,0,1,1,100.0,0,2,0,2,0,2,0,0,0,2023-2024,0.0,1.8181818181818181
4,Keyliane Abdallah,FRA,FW,Marseille,Ligue 1,17,2006,0.0,0,0,0,0,0,0,0,0.0,0,0,0,0,0,0,0,0,0,2023-2024,,
5,Yunis Abdelhamid,MAR,DF,Reims,Ligue 1,35,1987,30.9,64,35,36,23,5,26,45,57.8,19,51,32,19,39,103,109,2,0,2023-2024,1.2621359223300972,2.0711974110032365
6,Salis Abdul Samed,GHA,MF,Lens,Ligue 1,23,2000,16.9,21,14,8,10,3,8,18,44.4,10,12,1,11,12,33,18,0,0,2023-2024,0.7100591715976332,1.2426035502958581
7,Nabil Aberdin,FRA,DF,Getafe,La Liga,20,2002,2.0,0,0,0,0,0,0,1,0.0,1,0,0,0,0,0,4,0,0,2023-2024,0.0,0.0
8,Laurent Abergel,FRA,MF,Lorient,Ligue 1,30,1993,31.8,85,52,43,34,8,38,96,39.6,58,29,6,23,61,146,61,3,0,2023-2024,1.9182389937106918,2.6729559748427674
9,Matthis Abline,FRA,FW,Nantes,Ligue 1,20,2003,11.6,9,4,4,3,2,3,8,37.5,5,3,0,3,3,12,5,0,0,2023-2024,0.25862068965517243,0.7758620689655172
10,Abner,BRA,DF,Betis,La Liga,23,2000,15.6,25,19,15,9,1,17,34,50.0,17,23,5,18,15,40,62,0,0,2023-2024,0.9615384615384616,1.6025641025641026
11,Zakaria Aboukhlal,MAR,"MF,FW",Toulouse,Ligue 1,23,2000,8.4,9,8,1,5,3,3,12,25.0,9,9,1,8,1,10,2,0,0,2023-2024,0.11904761904761904,1.0714285714285714
12,Abdel Abqar,MAR,DF,Alavés,La Liga,24,1999,25.7,35,19,28,5,2,21,35,60.0,14,31,26,5,23,58,115,0,0,2023-2024,0.8949416342412452,1.3618677042801557
13,Tammy Abraham,ENG,FW,Roma,Serie A,25,1997,2.7,3,1,0,1,2,0,0,0.0,0,1,0,1,0,3,4,0,0,2023-2024,0.0,1.111111111111111
14,Francesco Acerbi,ITA,DF,Inter,Serie A,35,1988,26.5,22,13,16,6,0,11,14,78.6,3,20,13,7,32,54,77,1,0,2023-2024,1.2075471698113207,0.8301886792452831
15,Joshua Acheampong,ENG,DF,Chelsea,Premier League,17,2006,0.1,0,0,0,0,0,0,0,0.0,0,3,3,0,0,0,0,0,0,2023-2024,0.0,0.0
16,Marcos Acuña,ARG,DF,Sevilla,La Liga,31,1991,14.4,33,21,20,12,1,9,14,64.3,5,12,2,10,4,37,25,0,0,2023-2024,0.2777777777777778,2.2916666666666665
17,Bénie Adama Traore,CIV,"FW,MF",Sheffield Utd,Premier League,20,2002,4.3,4,2,1,2,1,0,4,0.0,4,4,1,3,1,5,1,0,0,2023-2024,0.23255813953488372,0.9302325581395349
18,Bénie Adama Traore,CIV,"FW,MF",Nantes,Ligue 1,20,2002,5.6,8,4,2,5,1,3,7,42.9,4,3,0,3,1,9,1,0,0,2023-2024,0.17857142857142858,1.4285714285714286
19,Akor Adams,NGA,FW,Montpellier,Ligue 1,23,2000,25.0,12,4,3,4,5,3,7,42.9,4,9,2,7,5,17,11,0,0,2023-2024,0.2,0.48
20,Tyler Adams,USA,MF,Bournemouth,Premier League,24,1999,1.3,4,3,1,3,0,2,3,66.7,1,2,0,2,4,8,2,0,0,2023-2024,3.0769230769230766,3.0769230769230766
21,Junior Adamu,AUT,"FW,MF",Freiburg,Bundesliga,22,2001,1.2,5,1,1,2,2,1,2,50.0,1,1,0,1,0,5,2,0,0,2023-2024,0.0,4.166666666666667
22,Sargis Adamyan,ARM,"FW,MF",Köln,Bundesliga,30,1993,8.9,14,9,2,9,3,6,11,54.5,5,16,1,15,5,19,7,0,0,2023-2024,0.5617977528089887,1.5730337078651684
23,Tosin Adarabioyo,ENG,DF,Fulham,Premier League,25,1997,18.0,21,11,16,5,0,12,21,57.1,9,16,11,5,25,46,80,0,0,2023-2024,1.3888888888888888,1.1666666666666667
24,Elijah Adebayo,ENG,FW,Luton Town,Premier League,25,1998,15.8,4,1,1,0,3,1,12,8.3,11,13,2,11,6,10,25,0,0,2023-2024,0.37974683544303794,0.2531645569620253
25,Karim Adeyemi,GER,"FW,MF",Dortmund,Bundesliga,21,2002,10.1,16,14,9,4,3,8,20,40.0,12,11,0,11,3,19,5,0,0,2023-2024,0.297029702970297,1.5841584158415842
Rk,Player,Nation,Pos,Squad,Comp,0,0,90.0,0,0,3,3,3,Tkl,0,0.0,0,0,0,0,0,0,0,0,0,2023-2024,0.0,0.0
26,Simon Adingra,CIV,FW,Brighton,Premier League,21,2002,24.7,45,20,23,11,11,19,42,45.2,23,31,1,30,19,64,22,0,0,2023-2024,0.7692307692307693,1.8218623481781377
27,Nathaniel Adjei,GHA,DF,Lorient,Ligue 1,20,2002,13.8,13,9,8,3,2,6,7,85.7,1,15,8,7,18,31,64,1,0,2023-2024,1.3043478260869565,0.9420289855072463
28,Amine Adli,MAR,"MF,FW",Leverkusen,Bundesliga,23,2000,10.0,16,7,2,10,4,7,17,41.2,10,10,2,8,6,22,5,0,0,2023-2024,0.6,1.6
29,Yacine Adli,FRA,MF,Milan,Serie A,23,2000,15.6,34,17,17,13,4,13,35,37.1,22,22,8,14,20,54,15,1,0,2023-2024,1.2820512820512822,2.1794871794871797
30,Adryelson,BRA,"DF,FW",Lyon,Ligue 1,25,1998,0.1,0,0,0,0,0,0,0,0.0,0,0,0,0,1,1,3,0,0,2023-2024,10.0,0.0
31,Adson,BRA,"MF,FW",Nantes,Ligue 1,22,2000,2.6,7,6,1,6,0,2,2,100.0,0,5,0,5,2,9,2,0,0,2023-2024,0.7692307692307692,2.692307692307692
32,Michel Aebischer,SUI,MF,Bologna,Serie A,26,1997,24.8,35,20,9,20,6,15,34,44.1,19,28,6,22,12,47,22,0,0,2023-2024,0.48387096774193544,1.411290322580645
33,Emmanuel Agbadou,CIV,DF,Reims,Ligue 1,26,1997,28.8,65,41,38,23,4,44,64,68.8,20,47,25,22,55,120,116,1,0,2023-2024,1.909722222222222,2.256944444444444
34,Julen Agirrezabala,ESP,GK,Athletic Club,La Liga,22,2000,2.6,0,0,0,0,0,0,0,0.0,0,0,0,0,0,0,0,0,0,2023-2024,0.0,0.0
35,Lucien Agoume,FRA,MF,Inter,Serie A,21,2002,0.1,0,0,0,0,0,0,0,0.0,0,0,0,0,0,0,0,0,0,2023-2024,0.0,0.0
36,Lucien Agoume,FRA,MF,Sevilla,La Liga,21,2002,8.6,23,18,7,14,2,9,12,75.0,3,6,1,5,7,30,8,0,0,2023-2024,0.813953488372093,2.674418604651163
37,Felix Agu,GER,"DF,MF",Werder Bremen,Bundesliga,23,1999,17.9,45,29,28,13,4,29,41,70.7,12,27,7,20,13,58,41,0,0,2023-2024,0.7262569832402235,2.5139664804469275
38,Nayef Aguerd,MAR,DF,West Ham,Premier League,27,1996,20.6,26,14,19,7,0,16,22,72.7,6,33,24,9,17,43,85,2,0,2023-2024,0.8252427184466019,1.262135922330097
39,Ruben Aguilar,FRA,DF,Lens,Ligue 1,30,1993,21.4,53,31,27,23,3,27,45,60.0,18,35,5,30,26,79,46,0,0,2023-2024,1.2149532710280375,2.476635514018692
40,Brandon Aguilera,CRC,FW,Nott'ham Forest,Premier League,20,2003,0.1,0,0,0,0,0,0,0,0.0,0,0,0,0,0,0,0,0,0,2023-2024,0.0,0.0
41,Naouirou Ahamada,FRA,"MF,FW",Crystal Palace,Premier League,21,2002,3.9,13,9,5,6,2,8,17,47.1,9,3,0,3,2,15,4,0,0,2023-2024,0.5128205128205129,3.3333333333333335
42,Anel Ahmedhodžić,BIH,DF,Sheffield Utd,Premier League,24,1999,29.4,64,36,48,14,2,30,49,61.2,19,43,26,17,35,99,137,2,0,2023-2024,1.1904761904761905,2.17687074829932
43,Joseph Aidoo,GHA,DF,Celta Vigo,La Liga,27,1995,4.5,8,3,6,2,0,4,8,50.0,4,3,1,2,4,12,28,0,0,2023-2024,0.8888888888888888,1.7777777777777777
44,Ola Aina,NGA,DF,Nott'ham Forest,Premier League,26,1996,18.8,47,31,31,12,4,29,41,70.7,12,19,3,16,18,65,51,1,0,2023-2024,0.9574468085106382,2.5
45,Rayan Aït-Nouri,ALG,"DF,MF",Wolves,Premier League,22,2001,25.9,71,44,41,23,7,28,49,57.1,21,32,6,26,15,86,38,0,0,2023-2024,0.5791505791505792,2.7413127413127416
46,Tosin Aiyegun,BEN,"MF,FW",Lorient,Ligue 1,25,1998,10.0,6,4,2,3,1,3,9,33.3,6,4,1,3,2,8,8,0,0,2023-2024,0.2,0.6
47,Kristoffer Ajer,NOR,DF,Brentford,Premier League,25,1998,20.4,38,21,25,9,4,23,36,63.9,13,26,11,15,25,63,79,1,0,2023-2024,1.2254901960784315,1.8627450980392157
48,Ludovic Ajorque,FRA,FW,Mainz 05,Bundesliga,29,1994,15.1,3,2,1,2,0,2,11,18.2,9,6,2,4,4,7,11,0,0,2023-2024,0.26490066225165565,0.19867549668874174
49,Manuel Akanji,SUI,"DF,MF",Manchester City,Premier League,28,1995,27.9,42,28,16,18,8,22,39,56.4,17,28,12,16,23,65,70,3,0,2023-2024,0.8243727598566308,1.5053763440860215
50,Marley Aké,FRA,FW,Udinese,Serie A,22,2001,0.1,0,0,0,0,0,0,0,0.0,0,0,0,0,0,0,0,0,0,2023-2024,0.0,0.0
Rk,Player,Nation,Pos,Squad,Comp,0,0,90.0,0,0,3,3,3,Tkl,0,0.0,0,0,0,0,0,0,0,0,0,2023-2024,0.0,0.0
51,Nathan Aké,NED,DF,Manchester City,Premier League,28,1995,22.7,26,16,15,8,3,13,20,65.0,7,17,2,15,14,40,54,0,0,2023-2024,0.6167400881057269,1.145374449339207
52,Ilias Akhomach,MAR,"MF,FW",Villarreal,La Liga,19,2004,16.8,36,21,11,16,9,10,20,50.0,10,10,2,8,13,49,13,0,0,2023-2024,0.7738095238095237,2.142857142857143
53,Sergio Akieme,ESP,DF,Almería,La Liga,25,1997,18.6,27,15,18,7,2,13,16,81.3,3,14,4,10,10,37,34,0,0,2023-2024,0.5376344086021505,1.4516129032258063
54,Sergio Akieme,ESP,DF,Reims,Ligue 1,25,1997,9.1,11,5,6,3,2,8,11,72.7,3,9,3,6,10,21,25,0,0,2023-2024,1.098901098901099,1.208791208791209
55,Ebenezer Akinsanmiro,NGA,MF,Inter,Serie A,18,2004,0.2,0,0,0,0,0,0,1,0.0,1,0,0,0,0,0,0,0,0,2023-2024,0.0,0.0
56,Maghnes Akliouche,FRA,"MF,FW",Monaco,Ligue 1,21,2002,17.9,37,23,12,20,5,12,36,33.3,24,21,0,21,9,46,3,0,0,2023-2024,0.5027932960893855,2.0670391061452515
57,Paul Akouokou,CIV,MF,Betis,La Liga,25,1997,0.3,5,3,0,2,3,3,3,100.0,0,3,1,2,1,6,1,0,0,2023-2024,3.3333333333333335,16.666666666666668
58,Paul Akouokou,CIV,MF,Lyon,Ligue 1,25,1997,3.4,14,9,2,10,2,6,7,85.7,1,5,1,4,6,20,11,0,0,2023-2024,1.7647058823529411,4.11764705882353
59,Jean-Daniel Akpa-Akpro,CIV,MF,Monza,Serie A,30,1992,7.8,20,11,14,4,2,3,9,33.3,6,10,4,6,12,32,15,1,0,2023-2024,1.5384615384615385,2.5641025641025643
60,David Akpan Ankeye,NGA,FW,Genoa,Serie A,21,2002,0.6,1,0,0,1,0,0,1,0.0,1,1,0,1,0,1,0,0,0,2023-2024,0.0,1.6666666666666667
61,Kevin Akpoguma,NGA,DF,Hoffenheim,Bundesliga,28,1995,12.2,35,18,22,12,1,26,35,74.3,9,28,8,20,18,53,32,0,0,2023-2024,1.4754098360655739,2.8688524590163937
62,David Alaba,AUT,DF,Real Madrid,La Liga,31,1992,12.8,13,9,7,5,1,4,8,50.0,4,10,7,3,15,28,34,0,0,2023-2024,1.171875,1.015625
63,Luis Alberto,ESP,MF,Lazio,Serie A,30,1992,25.7,35,20,16,12,7,15,53,28.3,38,34,4,30,7,42,13,0,0,2023-2024,0.27237354085603116,1.3618677042801557
64,Raúl Albiol,ESP,DF,Villarreal,La Liga,37,1985,22.6,25,14,15,9,1,18,27,66.7,9,31,24,7,16,41,102,0,0,2023-2024,0.7079646017699115,1.1061946902654867
65,Thiago Alcántara,ESP,MF,Liverpool,Premier League,32,1991,0.1,0,0,0,0,0,0,0,0.0,0,0,0,0,0,0,0,0,0,2023-2024,0.0,0.0
66,Carlos Alcaraz,ARG,MF,Juventus,Serie A,20,2002,4.2,6,6,0,6,0,5,10,50.0,5,5,2,3,5,11,4,0,0,2023-2024,1.1904761904761905,1.4285714285714286
67,Rubén Alcaraz,ESP,MF,Cádiz,La Liga,32,1991,34.8,97,59,39,52,6,50,121,41.3,71,60,14,46,33,130,55,2,0,2023-2024,0.9482758620689656,2.7873563218390807
68,Omar Alderete,PAR,DF,Getafe,La Liga,26,1996,24.4,28,21,15,13,0,19,35,54.3,16,30,18,12,13,41,111,0,0,2023-2024,0.5327868852459017,1.1475409836065575
69,Iván Alejo,ESP,MF,Cádiz,La Liga,28,1995,18.8,40,23,23,11,6,17,57,29.8,40,20,0,20,7,47,17,0,0,2023-2024,0.3723404255319149,2.127659574468085
70,Carles Aleñá,ESP,MF,Getafe,La Liga,25,1998,11.3,24,8,7,14,3,10,24,41.7,14,14,3,11,4,28,13,0,0,2023-2024,0.35398230088495575,2.1238938053097343
71,Trent Alexander-Arnold,ENG,DF,Liverpool,Premier League,24,1998,23.9,39,26,26,11,2,27,87,31.0,60,22,2,20,31,70,48,5,0,2023-2024,1.2970711297071131,1.6317991631799165
72,Aboubacar Ali,FRA,"MF,FW",Strasbourg,Ligue 1,17,2006,1.4,2,0,0,2,0,0,0,0.0,0,1,0,1,1,3,2,0,0,2023-2024,0.7142857142857143,1.4285714285714286
73,Mohamed Ali Cho,FRA,"FW,MF",Real Sociedad,La Liga,19,2004,2.8,4,3,3,1,0,2,7,28.6,5,6,0,6,1,5,1,0,0,2023-2024,0.35714285714285715,1.4285714285714286
74,Mohamed Ali Cho,FRA,FW,Nice,Ligue 1,19,2004,9.6,12,9,4,7,1,3,11,27.3,8,10,0,10,3,15,6,0,0,2023-2024,0.3125,1.25
75,Faride Alidou,GER,"FW,MF",Köln,Bundesliga,22,2001,14.2,10,4,3,6,1,4,18,22.2,14,23,2,21,8,18,15,1,0,2023-2024,0.5633802816901409,0.7042253521126761
Rk,Player,Nation,Pos,Squad,Comp,0,0,90.0,0,0,3,3,3,Tkl,0,0.0,0,0,0,0,0,0,0,0,0,2023-2024,0.0,0.0
76,Nabil Alioui,FRA,"MF,FW",Le Havre,Ligue 1,24,1999,11.2,3,2,2,1,0,2,4,50.0,2,6,1,5,3,6,4,0,0,2023-2024,0.26785714285714285,0.26785714285714285
77,Alisson,BRA,GK,Liverpool,Premier League,30,1992,28.0,0,0,0,0,0,0,1,0.0,1,0,0,0,0,0,11,4,0,2023-2024,0.0,0.0
78,Tadeo Allende,ARG,"MF,FW",Celta Vigo,La Liga,24,1999,3.7,6,1,3,2,1,4,6,66.7,2,3,0,3,3,9,3,0,0,2023-2024,0.8108108108108107,1.6216216216216215
79,Jim Allevinah,GAB,"MF,DF",Clermont Foot,Ligue 1,28,1995,20.7,30,18,11,14,5,14,35,40.0,21,20,3,17,13,43,30,0,0,2023-2024,0.6280193236714976,1.4492753623188406
80,Domingos André Ribeiro Almeida,POR,"FW,MF",Valencia,La Liga,23,2000,10.7,25,15,9,12,4,9,19,47.4,10,13,1,12,6,31,5,0,0,2023-2024,0.5607476635514019,2.336448598130841
81,Miguel Almirón,PAR,FW,Newcastle Utd,Premier League,29,1994,21.5,36,24,13,15,8,11,29,37.9,18,29,2,27,10,46,13,0,0,2023-2024,0.46511627906976744,1.6744186046511629
82,Pontus Almqvist,SWE,"FW,MF",Lecce,Serie A,24,1999,23.4,45,29,16,22,7,23,51,45.1,28,21,2,19,14,59,10,0,0,2023-2024,0.5982905982905983,1.9230769230769231
83,Marcos Alonso,ESP,DF,Barcelona,La Liga,32,1990,2.8,5,3,2,3,0,3,4,75.0,1,2,0,2,4,9,6,0,0,2023-2024,1.4285714285714286,1.7857142857142858
84,Adrià Altimira,ESP,"DF,MF",Villarreal,La Liga,22,2001,8.6,16,7,9,6,1,9,24,37.5,15,18,5,13,5,21,18,0,0,2023-2024,0.5813953488372093,1.8604651162790697
85,Sergi Altimira,ESP,MF,Betis,La Liga,21,2001,6.3,15,8,8,6,1,11,23,47.8,12,12,1,11,9,24,10,0,0,2023-2024,1.4285714285714286,2.380952380952381
86,Edson Álvarez,MEX,MF,West Ham,Premier League,25,1997,26.4,80,39,47,26,7,31,66,47.0,35,59,20,39,42,122,81,0,0,2023-2024,1.590909090909091,3.0303030303030303
87,Gastón Álvarez,URU,DF,Getafe,La Liga,23,2000,28.2,68,37,43,20,5,37,57,64.9,20,40,11,29,35,103,80,0,0,2023-2024,1.2411347517730498,2.4113475177304964
88,Hugo Álvarez,ESP,"MF,DF",Celta Vigo,La Liga,20,2003,8.5,14,9,8,3,3,9,20,45.0,11,4,1,3,5,19,9,0,0,2023-2024,0.5882352941176471,1.6470588235294117
89,Julián Álvarez,ARG,"MF,FW",Manchester City,Premier League,23,2000,29.4,24,13,5,8,11,8,32,25.0,24,30,0,30,2,26,14,1,0,2023-2024,0.06802721088435375,0.8163265306122449
90,Yeray Álvarez,ESP,DF,Athletic Club,La Liga,28,1995,12.8,18,9,15,3,0,12,19,63.2,7,8,5,3,11,29,34,1,0,2023-2024,0.859375,1.40625
91,Skelly Alvero,FRA,MF,Lyon,Ligue 1,21,2002,4.7,8,7,5,2,1,2,9,22.2,7,5,1,4,2,10,5,0,0,2023-2024,0.425531914893617,1.702127659574468
92,Skelly Alvero,FRA,MF,Werder Bremen,Bundesliga,21,2002,1.4,6,4,1,5,0,3,3,100.0,0,3,1,2,1,7,1,0,0,2023-2024,0.7142857142857143,4.285714285714286
93,Papa Amadou Diallo,SEN,FW,Metz,Ligue 1,19,2004,9.9,18,8,10,7,1,7,21,33.3,14,11,1,10,11,29,16,0,0,2023-2024,1.1111111111111112,1.8181818181818181
94,Selim Amallah,MAR,"FW,MF",Valencia,La Liga,26,1996,6.7,17,12,7,7,3,3,9,33.3,6,13,0,13,11,28,6,0,0,2023-2024,1.6417910447761193,2.5373134328358207
95,Amath,SEN,"FW,MF",Mallorca,La Liga,27,1996,4.4,9,6,7,2,0,2,10,20.0,8,2,0,2,3,12,6,0,0,2023-2024,0.6818181818181818,2.0454545454545454
96,Lorenzo Amatucci,ITA,MF,Fiorentina,Serie A,19,2004,0.2,0,0,0,0,0,0,0,0.0,0,0,0,0,0,0,0,0,0,2023-2024,0.0,0.0
97,Jordan Amavi,FRA,DF,Brest,Ligue 1,29,1994,1.0,1,1,0,1,0,1,3,33.3,2,2,1,1,3,4,2,0,0,2023-2024,3.0,1.0
98,Zeki Amdouni,SUI,FW,Burnley,Premier League,22,2000,21.7,27,18,1,15,11,7,25,28.0,18,23,10,13,9,36,10,0,0,2023-2024,0.4147465437788019,1.2442396313364055
99,Kelvin Amian,FRA,DF,Nantes,Ligue 1,25,1998,8.9,16,7,12,4,0,11,15,73.3,4,6,0,6,7,23,28,0,0,2023-2024,0.7865168539325842,1.797752808988764
100,Bruno Amione,ARG,DF,Hellas Verona,Serie A,21,2002,6.4,11,3,9,2,0,4,5,80.0,1,4,2,2,9,20,19,2,0,2023-2024,1.40625,1.71875
Rk,Player,Nation,Pos,Squad,Comp,0,0,90.0,0,0,3,3,3,Tkl,0,0.0,0,0,0,0,0,0,0,0,0,2023-2024,0.0,0.0
101,Michael Amir Murillo,PAN,DF,Marseille,Ligue 1,27,1996,11.1,23,11,13,6,4,15,23,65.2,8,9,2,7,11,34,34,2,0,2023-2024,0.990990990990991,2.0720720720720722
102,Nadiem Amiri,GER,MF,Mainz 05,Bundesliga,26,1996,14.6,22,14,8,10,4,13,19,68.4,6,16,2,14,14,36,18,0,0,2023-2024,0.9589041095890412,1.5068493150684932
103,Nadiem Amiri,GER,MF,Leverkusen,Bundesliga,26,1996,1.0,4,2,0,3,1,0,3,0.0,3,0,0,0,0,4,1,0,0,2023-2024,0.0,4.0
104,Kofi Amoako,GER,MF,Wolfsburg,Bundesliga,18,2005,0.0,0,0,0,0,0,0,0,0.0,0,0,0,0,0,0,0,0,0,2023-2024,,
105,Sofyan Amrabat,MAR,"MF,DF",Manchester Utd,Premier League,26,1996,10.4,27,16,17,8,2,17,31,54.8,14,20,7,13,8,35,19,2,0,2023-2024,0.7692307692307692,2.5961538461538463
106,Joachim Andersen,DEN,DF,Crystal Palace,Premier League,27,1996,37.9,56,35,33,21,2,29,39,74.4,10,33,18,15,41,97,207,1,0,2023-2024,1.0817941952506596,1.4775725593667546
107,Elliot Anderson,SCO,"MF,FW",Newcastle Utd,Premier League,20,2002,11.4,24,18,12,9,3,15,29,51.7,14,23,4,19,8,32,23,0,0,2023-2024,0.7017543859649122,2.1052631578947367
108,Felipe Anderson,BRA,"FW,MF",Lazio,Serie A,30,1993,30.8,78,45,32,33,13,34,90,37.8,56,45,3,42,27,105,23,0,0,2023-2024,0.8766233766233766,2.5324675324675323
109,Benjamin André,FRA,MF,Lille,Ligue 1,32,1990,28.6,89,49,39,45,5,43,81,53.1,38,34,5,29,35,124,60,0,0,2023-2024,1.2237762237762237,3.1118881118881117
110,Komnen Andrić,SRB,FW,Clermont Foot,Ligue 1,28,1995,1.9,2,1,0,1,1,0,4,0.0,4,2,0,2,0,2,1,0,0,2023-2024,0.0,1.0526315789473684
111,Robert Andrich,GER,"MF,DF",Leverkusen,Bundesliga,28,1994,18.8,30,18,8,14,8,13,24,54.2,11,15,4,11,20,50,17,0,0,2023-2024,1.0638297872340425,1.5957446808510638
112,Miguel Ángel Rubio,ESP,DF,Granada,La Liga,25,1998,17.3,20,12,14,6,0,14,21,66.7,7,31,18,13,28,48,74,2,0,2023-2024,1.6184971098265895,1.1560693641618496
113,Angeliño,ESP,DF,Roma,Serie A,26,1997,12.7,21,11,12,6,3,11,19,57.9,8,11,5,6,12,33,37,1,0,2023-2024,0.9448818897637796,1.6535433070866143
114,Fabrizio Angileri,ARG,"DF,MF",Getafe,La Liga,29,1994,1.8,1,1,1,0,0,1,3,33.3,2,0,0,0,4,5,8,0,0,2023-2024,2.2222222222222223,0.5555555555555556
115,Jaidon Anthony,ENG,FW,Bournemouth,Premier League,23,1999,1.7,3,1,1,0,2,1,7,14.3,6,3,0,3,1,4,3,0,0,2023-2024,0.5882352941176471,1.7647058823529411
116,Waldemar Anton,GER,DF,Stuttgart,Bundesliga,27,1996,32.1,39,25,21,16,2,23,42,54.8,19,33,20,13,40,79,150,1,0,2023-2024,1.2461059190031152,1.2149532710280373
117,Michail Antonio,JAM,FW,West Ham,Premier League,33,1990,18.8,15,8,5,6,4,3,11,27.3,8,16,3,13,4,19,4,0,0,2023-2024,0.2127659574468085,0.7978723404255319
118,Antony,BRA,FW,Manchester Utd,Premier League,23,2000,14.7,40,21,15,19,6,20,40,50.0,20,29,1,28,12,52,9,0,0,2023-2024,0.8163265306122449,2.7210884353741496
119,Christopher Antwi-Adjei,GHA,"FW,MF",Bochum,Bundesliga,29,1994,13.5,21,12,10,6,5,12,22,54.5,10,13,2,11,2,23,11,1,0,2023-2024,0.14814814814814814,1.5555555555555556
120,Houssem Aouar,ALG,"MF,FW",Roma,Serie A,25,1998,8.4,16,11,4,10,2,3,12,25.0,9,5,0,5,4,20,2,1,0,2023-2024,0.47619047619047616,1.9047619047619047
121,Stredair Appuah,FRA,"FW,MF",Nantes,Ligue 1,19,2004,0.9,0,0,0,0,0,0,3,0.0,3,0,0,0,1,1,1,0,0,2023-2024,1.1111111111111112,0.0
122,Mauro Arambarri,URU,MF,Getafe,La Liga,27,1995,3.8,6,2,3,2,1,1,6,16.7,5,1,0,1,2,8,7,0,0,2023-2024,0.5263157894736842,1.5789473684210527
123,Jon Aramburu,VEN,DF,Real Sociedad,La Liga,21,2002,6.0,24,15,12,10,2,15,25,60.0,10,8,3,5,7,31,17,0,0,2023-2024,1.1666666666666667,4.0
124,Asaf Arania,ISR,MF,Darmstadt 98,Bundesliga,17,2005,0.1,0,0,0,0,0,0,0,0.0,0,0,0,0,0,0,0,0,0,2023-2024,0.0,0.0
125,Julian Araujo,MEX,DF,Las Palmas,La Liga,21,2001,16.2,41,22,29,7,5,23,33,69.7,10,23,16,7,10,51,52,1,0,2023-2024,0.617283950617284,2.5308641975308643
Rk,Player,Nation,Pos,Squad,Comp,0,0,90.0,0,0,3,3,3,Tkl,0,0.0,0,0,0,0,0,0,0,0,0,2023-2024,0.0,0.0
126,Ronald Araújo,URU,DF,Barcelona,La Liga,24,1999,22.2,27,22,11,15,1,12,17,70.6,5,20,11,9,12,39,66,2,0,2023-2024,0.5405405405405406,1.2162162162162162
127,Oliver Arblaster,ENG,MF,Sheffield Utd,Premier League,19,2004,10.5,23,14,11,8,4,7,15,46.7,8,17,7,10,15,38,9,0,0,2023-2024,1.4285714285714286,2.1904761904761907
128,Cameron Archer,ENG,"FW,MF",Sheffield Utd,Premier League,22,2001,20.4,18,13,6,6,6,8,18,44.4,10,22,3,19,1,19,11,0,0,2023-2024,0.04901960784313726,0.8823529411764707
129,Cameron Archer,ENG,MF,Aston Villa,Premier League,22,2001,0.1,0,0,0,0,0,0,0,0.0,0,0,0,0,0,0,0,0,0,2023-2024,0.0,0.0
130,Alphonse Areola,FRA,GK,West Ham,Premier League,30,1993,30.0,1,1,1,0,0,1,3,33.3,2,0,0,0,1,2,16,0,0,2023-2024,0.03333333333333333,0.03333333333333333
131,Adu Ares,ESP,FW,Athletic Club,La Liga,21,2001,2.9,8,4,4,2,2,2,3,66.7,1,1,0,1,1,9,0,0,0,2023-2024,0.3448275862068966,2.7586206896551726
132,Jesús Areso,ESP,DF,Osasuna,La Liga,24,1999,29.6,45,24,25,13,7,31,38,81.6,7,36,15,21,18,63,58,0,0,2023-2024,0.6081081081081081,1.5202702702702702
133,Simone Aresti,ITA,GK,Cagliari,Serie A,37,1986,0.0,0,0,0,0,0,0,0,0.0,0,0,0,0,0,0,0,0,0,2023-2024,,
134,Matias Arezo,URU,FW,Granada,La Liga,20,2002,4.1,7,3,2,5,0,1,5,20.0,4,4,1,3,1,8,4,0,0,2023-2024,0.24390243902439027,1.707317073170732
135,Iñigo Arguibide,ESP,DF,Osasuna,La Liga,18,2005,0.2,1,0,0,1,0,0,0,0.0,0,0,0,0,0,1,1,0,0,2023-2024,0.0,5.0
136,Yoël Armougom,FRA,"DF,MF",Clermont Foot,Ligue 1,25,1998,2.6,3,3,2,0,1,2,3,66.7,1,1,0,1,1,4,3,0,0,2023-2024,0.3846153846153846,1.1538461538461537
137,José Arnaiz,ESP,"FW,MF",Osasuna,La Liga,28,1995,10.3,14,8,6,4,4,6,21,28.6,15,11,2,9,3,17,2,0,0,2023-2024,0.2912621359223301,1.3592233009708736
138,Hákon Arnar Haraldsson,ISL,"FW,MF",Lille,Ligue 1,20,2003,14.3,12,8,4,7,1,5,21,23.8,16,7,2,5,3,15,5,0,0,2023-2024,0.2097902097902098,0.8391608391608392
139,Marko Arnautović,AUT,FW,Inter,Serie A,34,1989,8.9,10,4,3,5,2,4,7,57.1,3,8,1,7,5,15,5,0,0,2023-2024,0.5617977528089887,1.1235955056179774
140,Maximilian Arnold,GER,MF,Wolfsburg,Bundesliga,29,1994,27.8,51,31,15,27,9,28,57,49.1,29,23,4,19,24,75,60,0,0,2023-2024,0.8633093525179856,1.8345323741007193
141,Mohamed El Arouch,FRA,FW,Lyon,Ligue 1,19,2004,0.0,0,0,0,0,0,0,0,0.0,0,0,0,0,0,0,0,0,0,2023-2024,,
142,Sergio Arribas,ESP,"MF,FW",Almería,La Liga,21,2001,22.7,34,17,16,17,1,14,31,45.2,17,20,1,19,16,50,8,1,0,2023-2024,0.7048458149779736,1.497797356828194
143,Kepa Arrizabalaga,ESP,GK,Real Madrid,La Liga,28,1994,13.3,0,0,0,0,0,0,1,0.0,1,0,0,0,0,0,4,0,0,2023-2024,0.0,0.0
144,Arthur,BRA,DF,Leverkusen,Bundesliga,20,2003,2.0,4,3,2,0,2,2,2,100.0,0,1,1,0,0,4,7,0,0,2023-2024,0.0,2.0
145,Takuma Asano,JPN,"FW,MF",Bochum,Bundesliga,28,1994,22.1,17,6,2,9,6,7,23,30.4,16,17,3,14,4,21,11,0,0,2023-2024,0.18099547511312217,0.7692307692307692
146,Marco Asensio,ESP,"MF,FW",Paris S-G,Ligue 1,27,1996,12.4,12,10,4,7,1,4,13,30.8,9,7,0,7,5,17,2,0,0,2023-2024,0.4032258064516129,0.9677419354838709
147,Kristjan Asllani,ALB,MF,Inter,Serie A,21,2002,8.7,7,2,3,4,0,2,11,18.2,9,9,3,6,11,18,8,0,0,2023-2024,1.264367816091954,0.8045977011494253
148,Joel Asoro,SWE,"FW,MF",Metz,Ligue 1,24,1999,9.4,13,9,7,6,0,3,10,30.0,7,7,1,6,6,19,9,0,0,2023-2024,0.6382978723404255,1.3829787234042552
149,Jonathan Asp Jensen,DEN,FW,Bayern Munich,Bundesliga,17,2006,0.0,0,0,0,0,0,0,0,0.0,0,0,0,0,0,0,1,0,0,2023-2024,,
150,Iago Aspas,ESP,FW,Celta Vigo,La Liga,35,1987,30.1,11,6,4,6,1,1,15,6.7,14,23,3,20,10,21,8,0,0,2023-2024,0.33222591362126247,0.3654485049833887
Rk,Player,Nation,Pos,Squad,Comp,0,0,90.0,0,0,3,3,3,Tkl,0,0.0,0,0,0,0,0,0,0,0,0,2023-2024,0.0,0.0
151,Lorenz Assignon,TOG,DF,Burnley,Premier League,23,2000,13.7,35,17,18,13,4,14,27,51.9,13,22,7,15,19,54,43,1,0,2023-2024,1.3868613138686132,2.5547445255474455
152,Lorenz Assignon,TOG,DF,Rennes,Ligue 1,23,2000,11.2,24,12,12,8,4,9,24,37.5,15,9,4,5,9,33,27,1,0,2023-2024,0.8035714285714286,2.142857142857143
153,Youcef Atal,ALG,DF,Nice,Ligue 1,27,1996,4.0,9,3,6,2,1,6,8,75.0,2,7,1,6,4,13,1,0,0,2023-2024,1.0,2.25
154,Valentin Atangana Edoa,FRA,MF,Reims,Ligue 1,17,2005,6.2,19,13,6,9,4,5,13,38.5,8,5,1,4,6,25,9,0,0,2023-2024,0.9677419354838709,3.064516129032258
155,Arthur Atta,FRA,"MF,FW",Metz,Ligue 1,20,2003,10.3,18,14,8,7,3,8,19,42.1,11,13,3,10,10,28,23,0,0,2023-2024,0.9708737864077669,1.7475728155339805
156,Noah Atubolu,GER,GK,Freiburg,Bundesliga,21,2002,34.0,0,0,0,0,0,0,1,0.0,1,0,0,0,0,0,8,1,0,2023-2024,0.0,0.0
157,Pierre-Emerick Aubameyang,GAB,FW,Marseille,Ligue 1,34,1989,29.1,22,14,4,11,7,7,26,26.9,19,30,5,25,9,31,26,0,0,2023-2024,0.30927835051546393,0.7560137457044673
158,Emil Audero,ITA,GK,Inter,Serie A,26,1997,3.7,0,0,0,0,0,0,0,0.0,0,0,0,0,0,0,1,0,0,2023-2024,0.0,0.0
159,Tommaso Augello,ITA,DF,Cagliari,Serie A,28,1994,26.9,26,19,18,6,2,16,25,64.0,9,21,10,11,17,43,89,0,0,2023-2024,0.6319702602230484,0.966542750929368
160,Carlos Augusto,BRA,DF,Inter,Serie A,24,1999,19.2,29,21,20,9,0,15,22,68.2,7,20,8,12,16,45,52,0,0,2023-2024,0.8333333333333334,1.5104166666666667
161,Yann Aurel Bisseck,GER,DF,Inter,Serie A,22,2000,10.0,14,6,10,3,1,6,9,66.7,3,10,7,3,5,19,23,0,0,2023-2024,0.5,1.4
162,Serge Aurier,CIV,"DF,MF",Nott'ham Forest,Premier League,30,1992,9.3,20,14,9,11,0,5,11,45.5,6,10,3,7,9,29,36,1,0,2023-2024,0.9677419354838709,2.150537634408602
163,Ezequiel Ávila,ARG,"FW,MF",Osasuna,La Liga,29,1994,9.6,3,2,1,1,1,3,11,27.3,8,14,0,14,4,7,8,0,0,2023-2024,0.4166666666666667,0.3125
164,Ezequiel Ávila,ARG,FW,Betis,La Liga,29,1994,3.3,2,1,0,2,0,1,3,33.3,2,2,0,2,1,3,4,0,0,2023-2024,0.30303030303030304,0.6060606060606061
165,Taiwo Awoniyi,NGA,FW,Nott'ham Forest,Premier League,25,1997,11.6,9,7,1,4,4,1,2,50.0,1,7,2,5,1,10,9,0,0,2023-2024,0.08620689655172414,0.7758620689655172
166,André Ayew,GHA,FW,Le Havre,Ligue 1,33,1989,12.3,15,11,7,6,2,6,9,66.7,3,8,3,5,2,17,11,0,0,2023-2024,0.16260162601626016,1.2195121951219512
167,Jordan Ayew,GHA,"FW,MF",Crystal Palace,Premier League,31,1991,28.3,65,36,23,28,14,21,42,50.0,21,43,2,41,16,81,15,0,0,2023-2024,0.5653710247349824,2.2968197879858656
168,Neil El Aynaoui,FRA,MF,Lens,Ligue 1,22,2001,17.4,37,20,13,20,4,20,46,43.5,26,20,6,14,32,69,21,1,0,2023-2024,1.8390804597701151,2.1264367816091956
169,Sardar Azmoun,IRN,"FW,MF",Roma,Serie A,28,1995,6.5,8,5,2,5,1,4,8,50.0,4,4,1,3,3,11,6,1,0,2023-2024,0.46153846153846156,1.2307692307692308
170,César Azpilicueta,ESP,DF,Atlético Madrid,La Liga,33,1989,15.8,25,14,15,9,1,12,19,63.2,7,25,6,19,16,41,46,0,0,2023-2024,1.0126582278481011,1.5822784810126582
171,Paulo Azzi,BRA,"DF,MF",Cagliari,Serie A,29,1994,10.6,19,11,10,6,3,9,18,50.0,9,11,2,9,16,35,23,0,0,2023-2024,1.509433962264151,1.7924528301886793
172,Oussama El Azzouzi,MAR,MF,Bologna,Serie A,22,2001,6.1,12,7,4,5,3,7,14,50.0,7,8,2,6,6,18,12,0,0,2023-2024,0.9836065573770493,1.9672131147540985
173,Abdellah Baallal,MAR,MF,Clermont Foot,Ligue 1,18,2004,0.0,0,0,0,0,0,0,0,0.0,0,1,0,1,0,0,0,0,0,2023-2024,,
174,Iddrisu Baba,GHA,MF,Almería,La Liga,27,1996,15.9,46,26,27,18,1,17,39,43.6,22,20,6,14,11,57,27,2,0,2023-2024,0.6918238993710691,2.893081761006289
175,Srđan Babić,SRB,DF,Almería,La Liga,27,1996,1.0,2,2,0,2,0,1,1,100.0,0,1,1,0,0,2,2,0,0,2023-2024,0.0,2.0
Rk,Player,Nation,Pos,Squad,Comp,0,0,90.0,0,0,3,3,3,Tkl,0,0.0,0,0,0,0,0,0,0,0,0,2023-2024,0.0,0.0
176,Shavy Babicka,GAB,"FW,MF",Toulouse,Ligue 1,23,2000,4.1,11,8,2,7,2,2,5,40.0,3,6,1,5,0,11,2,0,0,2023-2024,0.0,2.682926829268293
177,Loïc Bade,FRA,DF,Sevilla,La Liga,23,2000,25.3,65,41,53,12,0,30,49,61.2,19,23,15,8,38,103,116,2,0,2023-2024,1.5019762845849802,2.569169960474308
178,Milan Badelj,CRO,MF,Genoa,Serie A,34,1989,28.2,51,27,23,24,4,24,61,39.3,37,45,13,32,50,101,54,1,0,2023-2024,1.773049645390071,1.8085106382978724
179,Matthias Bader,GER,"DF,MF",Darmstadt 98,Bundesliga,26,1997,20.0,51,25,32,11,8,33,65,50.8,32,22,4,18,25,76,20,0,0,2023-2024,1.25,2.55
180,Benoît Badiashile,FRA,DF,Chelsea,Premier League,22,2001,14.9,21,15,12,9,0,9,14,64.3,5,21,14,7,18,39,66,2,0,2023-2024,1.2080536912751678,1.4093959731543624
181,Alex Baena,ESP,"MF,FW",Villarreal,La Liga,22,2001,28.7,34,21,10,16,8,20,47,42.6,27,23,2,21,13,47,17,1,0,2023-2024,0.4529616724738676,1.1846689895470384
182,Jaime Báez,URU,"FW,MF",Frosinone,Serie A,28,1995,5.6,4,1,0,2,2,0,7,0.0,7,5,0,5,4,8,1,0,0,2023-2024,0.7142857142857143,0.7142857142857143
183,Nicola Bagnolini,ITA,GK,Bologna,Serie A,19,2004,0.1,0,0,0,0,0,0,0,0.0,0,0,0,0,0,0,0,0,0,2023-2024,0.0,0.0
184,Leon Bailey,JAM,"MF,FW",Aston Villa,Premier League,25,1997,23.0,13,7,7,4,2,5,20,25.0,15,18,1,17,9,22,6,0,0,2023-2024,0.391304347826087,0.5652173913043478
185,Eric Bailly,CIV,DF,Villarreal,La Liga,29,1994,9.3,5,3,4,1,0,2,2,100.0,0,8,8,0,9,14,38,2,0,2023-2024,0.9677419354838709,0.5376344086021505
186,Stefan Bajcetic,ESP,MF,Liverpool,Premier League,18,2004,0.3,4,1,3,1,0,3,5,60.0,2,0,0,0,0,4,0,0,0,2023-2024,0.0,13.333333333333334
187,Nedim Bajrami,ALB,"MF,FW",Sassuolo,Serie A,24,1999,14.6,13,6,6,3,4,5,13,38.5,8,5,1,4,6,19,8,0,0,2023-2024,0.4109589041095891,0.8904109589041096
188,Cédric Bakambu,COD,FW,Betis,La Liga,32,1991,2.2,1,0,0,1,0,0,0,0.0,0,2,0,2,0,1,0,0,0,2023-2024,0.0,0.45454545454545453
189,Tiemoué Bakayoko,FRA,MF,Lorient,Ligue 1,28,1994,14.6,34,17,14,17,3,15,28,53.6,13,10,4,6,26,60,15,1,0,2023-2024,1.7808219178082192,2.328767123287671
190,Mitchel Bakker,NED,DF,Atalanta,Serie A,23,2000,4.2,7,3,6,1,0,2,12,16.7,10,5,0,5,3,10,6,0,0,2023-2024,0.7142857142857143,1.6666666666666665
191,Ridle Baku,GER,"DF,MF",Wolfsburg,Bundesliga,25,1998,22.4,37,20,24,7,6,21,46,45.7,25,27,1,26,21,58,45,1,0,2023-2024,0.9375000000000001,1.6517857142857144
192,Dilane Bakwa,FRA,"FW,MF",Strasbourg,Ligue 1,20,2002,24.2,30,22,12,13,5,11,40,27.5,29,26,1,25,20,50,11,0,0,2023-2024,0.8264462809917356,1.2396694214876034
193,Tommaso Baldanzi,ITA,"MF,FW",Empoli,Serie A,20,2003,8.3,4,2,1,1,2,3,10,30.0,7,7,0,7,2,6,0,0,0,2023-2024,0.24096385542168672,0.48192771084337344
194,Tommaso Baldanzi,ITA,"FW,MF",Roma,Serie A,20,2003,5.8,9,5,3,4,2,1,1,100.0,0,2,0,2,0,9,4,0,0,2023-2024,0.0,1.5517241379310345
195,Alejandro Balde,ESP,DF,Barcelona,La Liga,19,2003,15.3,20,11,11,6,3,7,11,63.6,4,14,1,13,5,25,21,1,0,2023-2024,0.32679738562091504,1.3071895424836601
196,Aliou Baldé,GUI,"FW,DF",Nice,Ligue 1,20,2002,0.8,4,1,0,3,1,1,1,100.0,0,2,1,1,3,7,0,0,0,2023-2024,3.75,5.0
197,George Baldock,GRE,DF,Sheffield Utd,Premier League,30,1993,10.8,18,10,10,7,1,6,15,40.0,9,14,8,6,10,28,33,0,0,2023-2024,0.9259259259259258,1.6666666666666665
198,Carlos Baleba,CMR,MF,Brighton,Premier League,19,2004,14.7,40,20,17,19,4,23,46,50.0,23,35,7,28,18,58,30,3,0,2023-2024,1.2244897959183674,2.7210884353741496
199,Carlos Baleba,CMR,MF,Lille,Ligue 1,19,2004,0.7,6,2,1,4,1,3,4,75.0,1,0,0,0,2,8,0,0,0,2023-2024,2.857142857142857,8.571428571428571
200,Leonardo Balerdi,ARG,DF,Marseille,Ligue 1,24,1999,25.2,79,50,55,23,1,49,67,73.1,18,38,15,23,51,130,91,0,0,2023-2024,2.0238095238095237,3.134920634920635
Rk,Player,Nation,Pos,Squad,Comp,0,0,90.0,0,0,3,3,3,Tkl,0,0.0,0,0,0,0,0,0,0,0,0,2023-2024,0.0,0.0
201,Iván Balliu,ALB,DF,Rayo Vallecano,La Liga,31,1992,31.9,44,31,20,24,0,22,39,56.4,17,27,11,16,29,73,66,1,0,2023-2024,0.9090909090909092,1.3793103448275863
202,Fodé Ballo-Touré,SEN,"DF,MF",Fulham,Premier League,26,1997,0.8,4,2,1,3,0,1,2,50.0,1,1,0,1,3,7,2,0,0,2023-2024,3.75,5.0
203,Folarin Balogun,USA,FW,Monaco,Ligue 1,22,2001,18.8,12,4,3,8,1,5,13,38.5,8,10,0,10,3,15,4,0,0,2023-2024,0.15957446808510636,0.6382978723404255
204,Jonathan Bamba,CIV,"MF,FW",Celta Vigo,La Liga,27,1996,22.0,14,9,4,8,2,2,17,11.8,15,20,0,20,18,32,12,0,0,2023-2024,0.8181818181818182,0.6363636363636364
205,Mohamed Bamba,CIV,FW,Lorient,Ligue 1,21,2001,12.6,14,9,3,8,3,4,10,40.0,6,7,1,6,2,16,3,0,0,2023-2024,0.15873015873015872,1.1111111111111112
206,Samuel Bamba,GER,FW,Dortmund,Bundesliga,19,2004,0.5,1,1,1,0,0,1,2,50.0,1,0,0,0,0,1,1,0,0,2023-2024,0.0,2.0
207,Lameck Banda,ZAM,FW,Lecce,Serie A,22,2001,15.0,27,23,11,12,4,7,21,33.3,14,18,0,18,3,30,7,0,0,2023-2024,0.2,1.8
208,Daniel Bandeira,POR,MF,Hellas Verona,Serie A,23,2000,5.0,6,5,1,4,1,3,7,42.9,4,3,0,3,3,9,9,0,0,2023-2024,0.6,1.2
209,Mamady Bangré,BFA,"FW,MF",Toulouse,Ligue 1,22,2001,1.1,4,2,2,2,0,3,4,75.0,1,0,0,0,4,8,3,0,0,2023-2024,3.6363636363636362,3.6363636363636362
210,Mattia Bani,ITA,DF,Genoa,Serie A,29,1993,25.6,26,10,18,7,1,11,22,50.0,11,51,31,20,22,48,116,1,0,2023-2024,0.859375,1.015625
211,Léo Baptistão,BRA,FW,Almería,La Liga,30,1992,20.4,25,16,12,8,5,9,25,36.0,16,13,1,12,11,36,22,0,0,2023-2024,0.5392156862745099,1.2254901960784315
212,Shandon Baptiste,GRN,MF,Brentford,Premier League,25,1998,2.5,4,4,2,2,0,1,5,20.0,4,5,1,4,3,7,6,0,0,2023-2024,1.2,1.6
213,Antonín Barák,CZE,"MF,FW",Fiorentina,Serie A,28,1994,9.0,6,2,1,3,2,3,7,42.9,4,5,0,5,2,8,4,0,0,2023-2024,0.2222222222222222,0.6666666666666666
214,Valentín Barco,ARG,"DF,FW",Brighton,Premier League,19,2004,3.4,11,5,4,5,2,6,8,75.0,2,3,0,3,4,15,3,1,0,2023-2024,1.1764705882352942,3.235294117647059
215,Bradley Barcola,FRA,FW,Lyon,Ligue 1,20,2002,3.0,5,2,0,2,3,1,7,14.3,6,4,0,4,2,7,0,0,0,2023-2024,0.6666666666666666,1.6666666666666667
216,Bradley Barcola,FRA,"FW,MF",Paris S-G,Ligue 1,20,2002,15.2,34,16,12,13,9,7,25,28.0,18,27,2,25,10,44,13,1,0,2023-2024,0.6578947368421053,2.236842105263158
217,Melvin Bard,FRA,DF,Nice,Ligue 1,22,2000,29.5,69,38,28,30,11,37,63,58.7,26,46,12,34,42,111,46,0,0,2023-2024,1.423728813559322,2.3389830508474576
218,Nicolò Barella,ITA,MF,Inter,Serie A,26,1997,31.6,46,30,17,20,9,19,63,30.2,44,31,1,30,10,56,12,1,0,2023-2024,0.3164556962025316,1.4556962025316456
219,Kike Barja,ESP,"FW,MF",Osasuna,La Liga,26,1997,3.4,6,2,2,2,2,3,8,37.5,5,2,1,1,2,8,2,0,0,2023-2024,0.5882352941176471,1.7647058823529411
220,Ross Barkley,ENG,MF,Luton Town,Premier League,29,1993,29.1,47,19,16,21,10,11,48,22.9,37,25,9,16,25,72,51,2,0,2023-2024,0.8591065292096219,1.6151202749140892
221,Aymen Barkok,MAR,"MF,FW",Mainz 05,Bundesliga,25,1998,3.6,9,5,2,6,1,3,6,50.0,3,7,0,7,2,11,1,0,0,2023-2024,0.5555555555555556,2.5
222,Harvey Barnes,ENG,"FW,MF",Newcastle Utd,Premier League,25,1997,8.9,6,1,3,2,1,1,2,50.0,1,1,0,1,5,11,3,0,0,2023-2024,0.5617977528089887,0.6741573033707865
223,Leandro Barreiro Martins,LUX,MF,Mainz 05,Bundesliga,23,2000,29.0,65,40,19,37,9,30,50,60.0,20,45,16,29,36,101,53,0,0,2023-2024,1.2413793103448276,2.2413793103448274
224,Enzo Barrenechea,ARG,MF,Frosinone,Serie A,22,2001,31.2,65,42,28,29,8,28,70,40.0,42,47,12,35,27,92,61,2,0,2023-2024,0.8653846153846154,2.0833333333333335
225,Ander Barrenetxea,ESP,"FW,MF",Real Sociedad,La Liga,21,2001,15.9,32,21,7,16,9,10,26,38.5,16,18,1,17,6,38,5,0,0,2023-2024,0.3773584905660377,2.0125786163522013
Rk,Player,Nation,Pos,Squad,Comp,0,0,90.0,0,0,3,3,3,Tkl,0,0.0,0,0,0,0,0,0,0,0,0,2023-2024,0.0,0.0
226,Pablo Barrios,ESP,MF,Atlético Madrid,La Liga,20,2003,17.3,45,25,15,29,1,19,40,47.5,21,20,3,17,28,73,24,2,0,2023-2024,1.6184971098265895,2.6011560693641615
227,Davide Bartesaghi,ITA,"DF,MF",Milan,Serie A,17,2005,0.9,2,0,1,1,0,2,4,50.0,2,1,1,0,0,2,7,0,0,2023-2024,0.0,2.2222222222222223
228,Marc Bartra,ESP,DF,Betis,La Liga,32,1991,2.5,4,3,3,1,0,4,5,80.0,1,3,1,2,3,7,10,0,0,2023-2024,1.2,1.6
229,Federico Baschirotto,ITA,DF,Lecce,Serie A,26,1996,36.6,21,12,16,5,0,8,15,53.3,7,42,26,16,23,44,144,1,0,2023-2024,0.628415300546448,0.5737704918032787
230,Steven Baseya,FRA,DF,Strasbourg,Ligue 1,18,2005,0.1,2,1,1,1,0,1,1,100.0,0,0,0,0,0,2,1,0,0,2023-2024,0.0,20.0
231,Chris Basham,ENG,"DF,MF",Sheffield Utd,Premier League,35,1988,3.6,7,2,4,3,0,2,9,22.2,7,9,4,5,5,12,17,0,0,2023-2024,1.3888888888888888,1.9444444444444444
232,Toma Bašić,CRO,MF,Salernitana,Serie A,26,1996,12.9,20,13,10,9,1,10,27,37.0,17,18,6,12,14,34,29,0,0,2023-2024,1.0852713178294573,1.5503875968992247
233,Calvin Bassey,NGA,DF,Fulham,Premier League,23,1999,25.6,49,29,33,15,1,21,29,72.4,8,32,11,21,28,77,84,4,0,2023-2024,1.09375,1.9140625
234,Alessandro Bastoni,ITA,DF,Inter,Serie A,24,1999,25.2,46,33,31,12,3,26,40,65.0,14,25,11,14,23,69,48,1,0,2023-2024,0.9126984126984127,1.8253968253968254
235,Simone Bastoni,ITA,"MF,DF",Empoli,Serie A,26,1996,8.3,22,13,12,7,3,11,22,50.0,11,8,0,8,11,33,18,0,0,2023-2024,1.325301204819277,2.650602409638554
236,Augusto Batalla,ARG,GK,Granada,La Liga,27,1996,17.0,0,0,0,0,0,0,1,0.0,1,0,0,0,0,0,10,2,0,2023-2024,0.0,0.0
237,Daniel Batz,GER,GK,Mainz 05,Bundesliga,32,1991,4.0,0,0,0,0,0,0,0,0.0,0,0,0,0,0,0,3,0,0,2023-2024,0.0,0.0
238,Maximilian Bauer,GER,DF,Augsburg,Bundesliga,23,2000,9.0,19,12,13,4,2,9,17,52.9,8,14,8,6,11,30,30,1,0,2023-2024,1.2222222222222223,2.111111111111111
239,Elias Baum,GER,"DF,MF",Eint Frankfurt,Bundesliga,17,2005,0.3,1,0,0,0,1,0,0,0.0,0,3,2,1,0,1,1,0,0,2023-2024,0.0,3.3333333333333335
240,Oliver Baumann,GER,GK,Hoffenheim,Bundesliga,33,1990,34.0,1,1,1,0,0,1,2,50.0,1,0,0,0,0,1,19,2,0,2023-2024,0.0,0.029411764705882353
241,Christoph Baumgartner,AUT,"MF,FW",RB Leipzig,Bundesliga,23,1999,12.9,26,13,10,12,4,14,38,36.8,24,20,1,19,5,31,14,0,0,2023-2024,0.38759689922480617,2.0155038759689923
242,Bebé,CPV,"MF,FW",Rayo Vallecano,La Liga,33,1990,2.4,2,2,1,1,0,1,5,20.0,4,1,0,1,0,2,0,0,0,2023-2024,0.0,0.8333333333333334
243,Ihlas Bebou,TOG,"FW,DF",Hoffenheim,Bundesliga,29,1994,18.2,22,12,10,8,4,8,16,50.0,8,13,2,11,14,36,15,0,0,2023-2024,0.7692307692307693,1.208791208791209
244,Mohamed Bechikh,FRA,"FW,MF",Strasbourg,Ligue 1,18,2005,0.2,0,0,0,0,0,0,0,0.0,0,0,0,0,0,0,0,0,0,2023-2024,0.0,0.0
245,Adrian Beck,GER,"MF,FW",Heidenheim,Bundesliga,26,1997,10.8,22,13,8,12,2,9,24,37.5,15,17,0,17,4,26,15,0,0,2023-2024,0.37037037037037035,2.0370370370370368
246,Owen Beck,WAL,DF,Liverpool,Premier League,20,2002,0.1,2,1,1,1,0,0,0,0.0,0,0,0,0,0,2,1,0,0,2023-2024,0.0,20.0
247,Sheraldo Becker,SUR,"FW,MF",Real Sociedad,La Liga,28,1995,8.6,2,2,0,2,0,0,1,0.0,1,3,0,3,1,3,0,0,0,2023-2024,0.11627906976744186,0.23255813953488372
248,Sheraldo Becker,SUR,"FW,MF",Union Berlin,Bundesliga,28,1995,7.2,3,3,0,2,1,0,2,0.0,2,2,0,2,0,3,2,0,0,2023-2024,0.0,0.41666666666666663
249,Chris Bedia,CIV,"FW,MF",Union Berlin,Bundesliga,27,1996,1.6,2,1,0,2,0,0,1,0.0,1,3,0,3,0,2,2,0,0,2023-2024,0.0,1.25
250,Donny van de Beek,NED,DF,Manchester Utd,Premier League,26,1997,0.0,0,0,0,0,0,0,0,0.0,0,1,0,1,0,0,0,0,0,2023-2024,,
Rk,Player,Nation,Pos,Squad,Comp,0,0,90.0,0,0,3,3,3,Tkl,0,0.0,0,0,0,0,0,0,0,0,0,2023-2024,0.0,0.0
251,Donny van de Beek,NED,"MF,FW",Eint Frankfurt,Bundesliga,26,1997,4.0,8,3,3,3,2,3,7,42.9,4,5,1,4,3,11,1,0,0,2023-2024,0.75,2.0
252,Yanis Begraoui,MAR,"FW,MF",Toulouse,Ligue 1,22,2001,3.3,5,3,1,3,1,3,9,33.3,6,4,0,4,5,10,5,0,0,2023-2024,1.5151515151515151,1.5151515151515151
253,Kevin Behrens,GER,FW,Wolfsburg,Bundesliga,32,1991,6.8,2,1,0,1,1,0,2,0.0,2,9,0,9,3,5,6,0,0,2023-2024,0.4411764705882353,0.29411764705882354
254,Kevin Behrens,GER,FW,Union Berlin,Bundesliga,32,1991,14.0,13,10,3,7,3,1,4,25.0,3,7,2,5,6,19,19,0,0,2023-2024,0.42857142857142855,0.9285714285714286
255,Maximilian Beier,GER,"FW,MF",Hoffenheim,Bundesliga,20,2002,26.9,20,12,5,11,4,4,19,21.1,15,21,1,20,9,29,12,0,0,2023-2024,0.3345724907063197,0.7434944237918216
256,Jérémie Bela,ANG,"MF,FW",Clermont Foot,Ligue 1,30,1993,2.3,1,1,0,1,0,1,3,33.3,2,1,0,1,0,1,1,0,0,2023-2024,0.0,0.4347826086956522
257,Reda Belahyane,FRA,MF,Hellas Verona,Serie A,19,2004,1.0,1,1,0,1,0,1,1,100.0,0,0,0,0,1,2,0,0,0,2023-2024,1.0,1.0
258,Reda Belahyane,FRA,MF,Nice,Ligue 1,19,2004,0.3,1,0,0,1,0,1,1,100.0,0,0,0,0,0,1,0,0,0,2023-2024,0.0,3.3333333333333335
259,Amari'i Bell,JAM,DF,Luton Town,Premier League,29,1994,19.1,50,33,30,19,1,22,35,62.9,13,33,15,18,25,75,60,1,0,2023-2024,1.3089005235602094,2.6178010471204187
260,Stefan Bell,GER,DF,Mainz 05,Bundesliga,31,1991,7.4,8,8,7,1,0,4,8,50.0,4,7,5,2,6,14,30,0,0,2023-2024,0.8108108108108107,1.081081081081081
261,Alaa Bellaarouch,MAR,GK,Strasbourg,Ligue 1,21,2002,15.0,0,0,0,0,0,0,0,0.0,0,0,0,0,1,1,11,2,0,2023-2024,0.06666666666666667,0.0
262,Raoul Bellanova,ITA,DF,Torino,Serie A,23,2000,33.8,36,26,15,17,4,18,31,58.1,13,21,4,17,15,51,36,3,0,2023-2024,0.44378698224852076,1.0650887573964498
263,Jean-Ricner Bellegarde,FRA,"MF,FW",Wolves,Premier League,25,1998,10.6,17,10,9,6,2,7,15,46.7,8,18,2,16,8,25,14,0,0,2023-2024,0.7547169811320755,1.6037735849056605
264,Jean-Ricner Bellegarde,FRA,"MF,FW",Strasbourg,Ligue 1,25,1998,3.0,5,3,3,2,0,3,6,50.0,3,4,0,4,4,9,0,0,0,2023-2024,1.3333333333333333,1.6666666666666667
265,Héctor Bellerín,ESP,DF,Betis,La Liga,28,1995,19.0,34,22,14,16,4,20,53,37.7,33,13,5,8,22,56,40,1,0,2023-2024,1.1578947368421053,1.7894736842105263
266,Jude Bellingham,ENG,MF,Real Madrid,La Liga,20,2003,25.7,42,34,14,18,10,12,36,33.3,24,55,5,50,21,63,17,0,0,2023-2024,0.8171206225680934,1.6342412451361867
267,Jeanuël Belocian,FRA,DF,Rennes,Ligue 1,18,2005,16.1,32,22,23,8,1,22,28,78.6,6,18,10,8,13,45,49,0,0,2023-2024,0.8074534161490683,1.9875776397515525
268,Andrea Belotti,ITA,FW,Fiorentina,Serie A,29,1993,10.5,8,3,1,5,2,5,12,41.7,7,8,1,7,2,10,3,0,0,2023-2024,0.19047619047619047,0.7619047619047619
269,Andrea Belotti,ITA,FW,Roma,Serie A,29,1993,7.5,8,4,2,3,3,3,6,50.0,3,7,0,7,2,10,3,0,0,2023-2024,0.26666666666666666,1.0666666666666667
270,Fran Beltrán,ESP,MF,Celta Vigo,La Liga,24,1999,27.0,56,32,22,23,11,24,63,38.1,39,28,2,26,18,74,34,0,0,2023-2024,0.6666666666666666,2.074074074074074
271,Lucas Beltrán,ARG,"FW,MF",Fiorentina,Serie A,22,2001,18.8,27,14,4,18,5,11,20,55.0,9,29,3,26,2,29,11,0,0,2023-2024,0.10638297872340426,1.4361702127659575
272,Eliesse Ben Seghir,MAR,"MF,FW",Monaco,Ligue 1,18,2005,4.8,9,6,2,5,2,3,7,42.9,4,6,0,6,2,11,2,0,0,2023-2024,0.4166666666666667,1.875
273,Anis Ben Slimane,TUN,MF,Sheffield Utd,Premier League,22,2001,4.7,11,6,5,2,4,4,10,40.0,6,7,1,6,5,16,7,0,0,2023-2024,1.0638297872340425,2.3404255319148937
274,Wissam Ben Yedder,FRA,FW,Monaco,Ligue 1,32,1990,25.7,4,3,1,2,1,1,11,9.1,10,18,0,18,8,12,1,0,0,2023-2024,0.311284046692607,0.1556420233463035
275,Carlos Benavídez,URU,MF,Alavés,La Liga,25,1998,12.6,56,35,19,26,11,19,34,55.9,15,13,5,8,19,75,31,0,0,2023-2024,1.507936507936508,4.444444444444445
Rk,Player,Nation,Pos,Squad,Comp,0,0,90.0,0,0,3,3,3,Tkl,0,0.0,0,0,0,0,0,0,0,0,0,2023-2024,0.0,0.0
276,Ismaël Bennacer,ALG,MF,Milan,Serie A,25,1997,12.8,29,19,11,16,2,11,22,50.0,11,12,4,8,12,41,9,2,0,2023-2024,0.9375,2.265625
277,Saïd Benrahma,ALG,"FW,MF",West Ham,Premier League,27,1995,6.9,8,4,5,3,0,4,15,26.7,11,8,0,8,5,13,7,0,0,2023-2024,0.7246376811594203,1.1594202898550725
278,Saïd Benrahma,ALG,"FW,MF",Lyon,Ligue 1,27,1995,8.6,9,7,1,6,2,5,7,71.4,2,7,0,7,1,10,3,0,0,2023-2024,0.11627906976744186,1.0465116279069768
279,Ramy Bensebaini,ALG,DF,Dortmund,Bundesliga,28,1995,11.5,34,21,21,11,2,24,34,70.6,10,22,7,15,16,50,37,0,0,2023-2024,1.391304347826087,2.9565217391304346
280,Nabil Bentaleb,ALG,MF,Lille,Ligue 1,28,1994,21.9,49,32,29,18,2,22,43,51.2,21,33,12,21,37,86,33,0,0,2023-2024,1.6894977168949772,2.2374429223744294
281,Rodrigo Bentancur,URU,MF,Tottenham,Premier League,26,1997,11.2,23,15,10,11,2,10,24,41.7,14,15,4,11,17,40,16,1,0,2023-2024,1.517857142857143,2.053571428571429
282,Daniel Bentley,ENG,GK,Wolves,Premier League,30,1993,4.3,0,0,0,0,0,0,1,0.0,1,0,0,0,0,0,1,0,0,2023-2024,0.0,0.0
283,Lucas Beraldo,BRA,DF,Paris S-G,Ligue 1,19,2003,11.2,22,14,14,8,0,10,25,40.0,15,15,6,9,20,42,25,0,0,2023-2024,1.7857142857142858,1.9642857142857144
284,Domenico Berardi,ITA,FW,Sassuolo,Serie A,28,1994,15.9,17,8,7,9,1,2,21,9.5,19,17,0,17,13,30,9,0,0,2023-2024,0.8176100628930817,1.069182389937107
285,Yuri Berchiche,ESP,DF,Athletic Club,La Liga,33,1990,21.4,33,25,13,14,6,19,33,57.6,14,28,9,19,20,53,62,0,0,2023-2024,0.9345794392523366,1.5420560747663552
286,Álex Berenguer,ESP,FW,Athletic Club,La Liga,28,1995,17.7,23,14,9,9,5,7,24,29.2,17,23,0,23,5,28,13,0,0,2023-2024,0.2824858757062147,1.2994350282485876
287,Bartosz Bereszyński,POL,DF,Empoli,Serie A,31,1992,19.6,41,25,25,13,3,24,40,60.0,16,22,10,12,21,62,52,0,0,2023-2024,1.0714285714285714,2.0918367346938775
288,Jóhann Berg Guðmundsson,ISL,"MF,FW",Burnley,Premier League,32,1990,13.2,13,4,6,5,2,7,16,43.8,9,14,0,14,16,29,16,0,0,2023-2024,1.2121212121212122,0.9848484848484849
289,Sander Berge,NOR,MF,Burnley,Premier League,25,1998,33.4,76,46,35,36,5,34,58,58.6,24,49,20,29,23,99,60,2,0,2023-2024,0.688622754491018,2.2754491017964074
290,Etrit Berisha,ALB,GK,Empoli,Serie A,34,1989,14.0,0,0,0,0,0,0,1,0.0,1,0,0,0,0,0,7,1,0,2023-2024,0.0,0.0
291,Medon Berisha,ALB,"FW,MF",Lecce,Serie A,19,2003,2.3,3,1,3,0,0,0,2,0.0,2,2,2,0,1,4,0,0,0,2023-2024,0.4347826086956522,1.3043478260869565
292,Mergim Berisha,GER,FW,Hoffenheim,Bundesliga,25,1998,1.6,0,0,0,0,0,0,0,0.0,0,2,1,1,0,0,0,0,0,2023-2024,0.0,0.0
293,Mergim Berisha,GER,FW,Augsburg,Bundesliga,25,1998,1.4,0,0,0,0,0,0,0,0.0,0,1,0,1,0,0,3,0,0,2023-2024,0.0,0.0
294,Bernardo,BRA,DF,Bochum,Bundesliga,28,1995,32.5,99,58,56,35,8,45,69,65.2,24,66,30,36,55,154,120,1,0,2023-2024,1.6923076923076923,3.046153846153846
295,Victor Bernth Kristiansen,DEN,DF,Bologna,Serie A,20,2002,25.6,52,34,23,22,7,20,35,57.1,15,35,8,27,12,64,45,1,0,2023-2024,0.46875,2.03125
296,Matúš Bero,SVK,"MF,FW",Bochum,Bundesliga,27,1995,18.5,32,22,13,12,7,13,32,40.6,19,24,3,21,12,44,26,0,0,2023-2024,0.6486486486486487,1.7297297297297298
297,Luke Berry,ENG,"MF,DF",Luton Town,Premier League,31,1992,3.6,7,2,2,4,1,2,3,66.7,1,6,1,5,0,7,3,0,0,2023-2024,0.0,1.9444444444444444
298,Dimitry Bertaud,COD,GK,Montpellier,Ligue 1,25,1998,4.0,0,0,0,0,0,0,0,0.0,0,0,0,0,0,0,0,0,0,2023-2024,0.0,0.0
299,Jan-Niklas Beste,GER,"FW,MF",Heidenheim,Bundesliga,24,1999,28.9,77,49,35,24,18,28,55,50.9,27,48,1,47,18,95,31,0,0,2023-2024,0.6228373702422145,2.6643598615916955
300,Beto,GNB,FW,Everton,Premier League,25,1998,10.6,14,6,1,6,7,4,12,33.3,8,11,0,11,1,15,14,0,0,2023-2024,0.09433962264150944,1.3207547169811322
Rk,Player,Nation,Pos,Squad,Comp,0,0,90.0,0,0,3,3,3,Tkl,0,0.0,0,0,0,0,0,0,0,0,0,2023-2024,0.0,0.0
301,Beto,GNB,FW,Udinese,Serie A,25,1998,0.8,1,0,0,0,1,0,0,0.0,0,0,0,0,0,1,0,0,0,2023-2024,0.0,1.25
302,Davide Bettella,ITA,MF,Monza,Serie A,23,2000,0.0,0,0,0,0,0,0,0,0.0,0,0,0,0,0,0,0,0,0,2023-2024,,
303,Sam Beukema,NED,DF,Bologna,Serie A,24,1998,28.3,27,11,14,11,2,16,25,64.0,9,35,21,14,15,42,99,2,0,2023-2024,0.5300353356890459,0.9540636042402827
304,Jordan Beyer,GER,DF,Burnley,Premier League,23,2000,13.7,35,20,22,12,1,14,24,58.3,10,22,15,7,16,51,68,1,0,2023-2024,1.1678832116788322,2.5547445255474455
305,Pep Biel,ESP,"MF,FW",Augsburg,Bundesliga,26,1996,3.2,4,3,0,2,2,1,3,33.3,2,2,1,1,2,6,2,0,0,2023-2024,0.625,1.25
306,Jaka Bijol,SVN,DF,Udinese,Serie A,24,1999,23.2,43,27,34,9,0,22,35,62.9,13,36,21,15,23,66,140,1,0,2023-2024,0.9913793103448276,1.853448275862069
307,El Bilal Touré,MLI,FW,Atalanta,Serie A,21,2001,4.4,1,1,0,1,0,0,1,0.0,1,0,0,0,1,2,2,0,0,2023-2024,0.22727272727272727,0.22727272727272727
308,Philip Billing,DEN,MF,Bournemouth,Premier League,27,1996,15.5,33,16,7,22,4,9,27,33.3,18,31,5,26,20,53,28,1,0,2023-2024,1.2903225806451613,2.129032258064516
309,Cristiano Biraghi,ITA,DF,Fiorentina,Serie A,30,1992,26.2,47,28,20,24,3,28,52,53.8,24,30,5,25,14,61,43,0,0,2023-2024,0.5343511450381679,1.7938931297709924
310,Davide Biraschi,ITA,DF,Genoa,Serie A,29,1994,1.0,3,3,1,2,0,1,3,33.3,2,0,0,0,2,5,5,0,0,2023-2024,2.0,3.0
311,Samuele Birindelli,ITA,DF,Monza,Serie A,24,1999,22.4,28,19,16,7,5,14,25,56.0,11,30,11,19,18,46,48,0,0,2023-2024,0.8035714285714286,1.25
312,Tom Bischof,GER,"MF,FW",Hoffenheim,Bundesliga,18,2005,2.0,8,4,6,1,1,2,9,22.2,7,3,0,3,1,9,2,0,0,2023-2024,0.5,4.0
313,Yves Bissouma,MLI,MF,Tottenham,Premier League,26,1996,23.0,80,52,32,36,12,41,61,67.2,20,28,5,23,37,117,43,3,0,2023-2024,1.608695652173913,3.4782608695652173
314,Leonardo Bittencourt,GER,MF,Werder Bremen,Bundesliga,29,1993,17.5,42,18,20,17,5,15,39,38.5,24,18,1,17,13,55,6,0,0,2023-2024,0.7428571428571429,2.4
315,Marco Bizot,NED,GK,Brest,Ligue 1,32,1991,32.0,0,0,0,0,0,0,1,0.0,1,0,0,0,0,0,18,3,0,2023-2024,0.0,0.0
316,Antonio Blanco,ESP,MF,Alavés,La Liga,23,2000,27.0,61,36,29,27,5,31,86,36.0,55,25,2,23,35,96,30,0,0,2023-2024,1.2962962962962963,2.259259259259259
317,Rubén Blanco,ESP,GK,Marseille,Ligue 1,28,1995,1.3,0,0,0,0,0,0,0,0.0,0,0,0,0,0,0,0,0,0,2023-2024,0.0,0.0
318,Hendry Blank,GER,DF,Dortmund,Bundesliga,18,2004,0.5,1,0,1,0,0,1,1,100.0,0,1,0,1,0,1,4,0,0,2023-2024,0.0,2.0
319,Ludovic Blas,FRA,"FW,MF",Rennes,Ligue 1,25,1997,17.4,30,14,16,13,1,12,28,42.9,16,13,1,12,6,36,9,0,0,2023-2024,0.3448275862068966,1.7241379310344829
320,Janis Blaswich,GER,GK,RB Leipzig,Bundesliga,32,1991,21.0,1,1,1,0,0,0,0,0.0,0,0,0,0,0,1,7,3,0,2023-2024,0.0,0.047619047619047616
321,Alexis Blin,FRA,MF,Lecce,Serie A,26,1996,18.2,33,19,11,19,3,15,43,34.9,28,16,2,14,22,55,39,0,0,2023-2024,1.208791208791209,1.8131868131868132
322,Daley Blind,NED,DF,Girona,La Liga,33,1990,33.0,47,21,33,13,1,29,47,61.7,18,37,19,18,21,68,113,0,0,2023-2024,0.6363636363636364,1.4242424242424243
323,Myron Boadu,NED,FW,Monaco,Ligue 1,22,2001,0.9,2,2,0,1,1,1,2,50.0,1,2,0,2,0,2,0,0,0,2023-2024,0.0,2.2222222222222223
324,Benicio Boaitey,ENG,"FW,DF",Brighton,Premier League,19,2004,0.4,0,0,0,0,0,0,1,0.0,1,1,0,1,0,0,2,0,0,2023-2024,0.0,0.0
325,Jérôme Boateng,GER,DF,Salernitana,Serie A,34,1988,2.6,0,0,0,0,0,0,0,0.0,0,6,5,1,4,4,21,0,0,2023-2024,1.5384615384615383,0.0
Rk,Player,Nation,Pos,Squad,Comp,0,0,90.0,0,0,3,3,3,Tkl,0,0.0,0,0,0,0,0,0,0,0,0,2023-2024,0.0,0.0
326,Oscar Bobb,NOR,"FW,MF",Manchester City,Premier League,20,2003,3.4,7,3,1,2,4,2,4,50.0,2,4,0,4,5,12,1,0,0,2023-2024,1.4705882352941178,2.058823529411765
327,Sacha Boey,FRA,DF,Bayern Munich,Bundesliga,22,2000,1.2,2,0,2,0,0,1,2,50.0,1,1,0,1,1,3,2,0,0,2023-2024,0.8333333333333334,1.6666666666666667
328,Jeremie Boga,CIV,FW,Nice,Ligue 1,26,1997,22.2,18,7,6,10,2,10,20,50.0,10,26,2,24,8,26,4,0,0,2023-2024,0.3603603603603604,0.8108108108108109
329,Jayden Bogle,ENG,DF,Sheffield Utd,Premier League,23,2000,31.0,66,36,43,21,2,35,70,50.0,35,42,11,31,32,98,97,0,0,2023-2024,1.032258064516129,2.129032258064516
330,Emil Bohinen,NOR,MF,Genoa,Serie A,24,1999,0.6,1,1,0,1,0,0,0,0.0,0,1,0,1,0,1,3,0,0,2023-2024,0.0,1.6666666666666667
331,Emil Bohinen,NOR,MF,Salernitana,Serie A,24,1999,5.9,8,6,5,3,0,2,10,20.0,8,8,2,6,14,22,6,1,0,2023-2024,2.3728813559322033,1.3559322033898304
332,Adama Bojang,GAM,FW,Reims,Ligue 1,19,2004,0.9,2,1,1,0,1,0,0,0.0,0,2,1,1,1,3,0,0,0,2023-2024,1.1111111111111112,2.2222222222222223
333,Daniel Boloca,ROU,MF,Sassuolo,Serie A,24,1998,22.5,48,33,18,25,5,27,46,58.7,19,23,13,10,14,62,33,2,0,2023-2024,0.6222222222222222,2.1333333333333333
334,Willy Boly,CIV,DF,Nott'ham Forest,Premier League,32,1991,16.0,46,29,36,9,1,22,40,55.0,18,32,21,11,25,71,90,0,0,2023-2024,1.5625,2.875
335,Giacomo Bonaventura,ITA,MF,Fiorentina,Serie A,33,1989,25.3,26,13,6,10,10,9,21,42.9,12,16,1,15,14,40,10,0,0,2023-2024,0.5533596837944664,1.0276679841897234
336,Federico Bonazzoli,ITA,"FW,MF",Hellas Verona,Serie A,26,1997,11.3,4,1,1,3,0,1,8,12.5,7,9,1,8,3,7,3,0,0,2023-2024,0.2654867256637168,0.35398230088495575
337,Warren Bondo,FRA,MF,Monza,Serie A,19,2003,16.4,29,22,16,10,3,13,17,76.5,4,13,3,10,6,35,13,0,0,2023-2024,0.3658536585365854,1.7682926829268295
338,Giovanni Bonfanti,ITA,DF,Atalanta,Serie A,20,2003,1.0,4,2,2,2,0,2,3,66.7,1,1,1,0,1,5,1,0,0,2023-2024,1.0,4.0
339,Victor Boniface,NGA,FW,Leverkusen,Bundesliga,22,2000,17.2,6,4,0,1,5,1,4,25.0,3,6,1,5,0,6,13,0,0,2023-2024,0.0,0.3488372093023256
340,Kevin Bonifazi,ITA,DF,Bologna,Serie A,27,1996,1.0,4,0,0,4,0,1,2,50.0,1,0,0,0,0,4,7,1,0,2023-2024,0.0,4.0
341,Kevin Bonifazi,ITA,DF,Frosinone,Serie A,27,1996,3.4,5,3,2,3,0,2,3,66.7,1,1,0,1,3,8,9,0,0,2023-2024,0.8823529411764706,1.4705882352941178
342,Leonardo Bonucci,ITA,DF,Union Berlin,Bundesliga,36,1987,5.1,6,5,2,4,0,4,4,100.0,0,5,3,2,7,13,16,0,0,2023-2024,1.3725490196078431,1.1764705882352942
343,Ângelo Borges,BRA,"FW,MF",Strasbourg,Ligue 1,18,2004,12.2,24,11,9,7,8,11,31,35.5,20,18,0,18,9,33,2,0,0,2023-2024,0.7377049180327869,1.9672131147540985
344,Neto Borges,BRA,DF,Clermont Foot,Ligue 1,26,1996,28.0,48,24,25,18,5,28,63,44.4,35,28,6,22,57,105,84,0,0,2023-2024,2.0357142857142856,1.7142857142857142
345,Yvandro Borges Sanches,LUX,"MF,FW",Gladbach,Bundesliga,19,2004,0.2,0,0,0,0,0,0,0,0.0,0,0,0,0,0,0,0,0,0,2023-2024,0.0,0.0
346,Sebastiaan Bornauw,BEL,DF,Wolfsburg,Bundesliga,24,1999,15.9,26,12,19,7,0,13,19,68.4,6,21,12,9,18,44,81,0,0,2023-2024,1.1320754716981132,1.6352201257861634
347,Rafael Borré,COL,FW,Werder Bremen,Bundesliga,27,1995,11.0,10,7,2,4,4,5,16,31.3,11,8,2,6,2,12,10,0,0,2023-2024,0.18181818181818182,0.9090909090909091
348,Gennaro Borrelli,ITA,FW,Frosinone,Serie A,23,2000,0.3,0,0,0,0,0,0,0,0.0,0,0,0,0,0,0,0,0,0,2023-2024,0.0,0.0
349,Adri Bosch,ESP,DF,Granada,La Liga,22,2001,0.3,1,1,1,0,0,0,0,0.0,0,0,0,0,0,1,1,0,0,2023-2024,0.0,3.3333333333333335
350,Erik Botheim,NOR,"FW,MF",Salernitana,Serie A,23,2000,3.5,2,0,2,0,0,0,1,0.0,1,3,0,3,0,2,2,0,0,2023-2024,0.0,0.5714285714285714
Rk,Player,Nation,Pos,Squad,Comp,0,0,90.0,0,0,3,3,3,Tkl,0,0.0,0,0,0,0,0,0,0,0,0,2023-2024,0.0,0.0
351,Sven Botman,NED,DF,Newcastle Utd,Premier League,23,2000,15.3,20,13,14,6,0,8,13,61.5,5,20,16,4,9,29,61,3,0,2023-2024,0.5882352941176471,1.3071895424836601
352,Saïmon Bouabré,FRA,MF,Monaco,Ligue 1,17,2006,0.5,2,2,0,2,0,1,2,50.0,1,1,0,1,0,2,0,0,0,2023-2024,0.0,4.0
353,Ayyoub Bouaddi,FRA,MF,Lille,Ligue 1,15,2007,1.5,6,2,6,0,0,2,5,40.0,3,2,0,2,1,7,3,0,0,2023-2024,0.6666666666666666,4.0
354,Badredine Bouanani,ALG,FW,Nice,Ligue 1,18,2004,1.8,3,2,1,1,1,3,4,75.0,1,5,0,5,3,6,0,0,0,2023-2024,1.6666666666666665,1.6666666666666665
355,Badredine Bouanani,ALG,MF,Lorient,Ligue 1,18,2004,4.9,4,2,1,1,2,2,4,50.0,2,3,0,3,2,6,3,0,0,2023-2024,0.4081632653061224,0.8163265306122448
356,Mohamed Bouchenna,FRA,"MF,FW",Clermont Foot,Ligue 1,17,2006,0.3,1,0,1,0,0,0,0,0.0,0,0,0,0,0,1,0,0,0,2023-2024,0.0,3.3333333333333335
357,Hicham Boudaoui,ALG,MF,Nice,Ligue 1,23,1999,17.9,41,19,16,22,3,21,30,70.0,9,15,1,14,11,52,15,0,0,2023-2024,0.6145251396648045,2.2905027932960897
358,Yassine Bounou,MAR,GK,Sevilla,La Liga,32,1991,1.0,0,0,0,0,0,0,0,0.0,0,0,0,0,0,0,0,0,0,2023-2024,0.0,0.0
359,Mehdi Bourabia,MAR,MF,Frosinone,Serie A,31,1991,2.2,5,4,1,4,0,2,4,50.0,2,3,0,3,0,5,4,0,0,2023-2024,0.0,2.2727272727272725
360,Benjamin Bourigeaud,FRA,"MF,FW",Rennes,Ligue 1,29,1994,26.9,31,18,14,9,8,13,44,29.5,31,31,2,29,22,53,39,2,0,2023-2024,0.8178438661710038,1.1524163568773236
361,Bilal Boutobba,FRA,"FW,MF",Clermont Foot,Ligue 1,24,1998,10.3,22,12,6,10,6,10,23,43.5,13,9,0,9,8,30,3,0,0,2023-2024,0.7766990291262136,2.1359223300970873
362,Hugo Boutsingkham,FRA,"MF,FW",Nantes,Ligue 1,20,2003,0.1,0,0,0,0,0,0,0,0.0,0,0,0,0,0,0,1,0,0,2023-2024,0.0,0.0
363,Edoardo Bove,ITA,MF,Roma,Serie A,21,2002,19.8,60,31,16,31,13,27,46,58.7,19,21,1,20,11,71,11,1,0,2023-2024,0.5555555555555556,3.0303030303030303
364,Jarrod Bowen,ENG,FW,West Ham,Premier League,26,1996,33.5,42,28,14,14,14,13,35,37.1,22,37,5,32,19,61,14,0,0,2023-2024,0.5671641791044776,1.2537313432835822
365,Lucas Boyé,ARG,FW,Granada,La Liga,27,1996,28.2,50,25,14,25,11,14,34,41.2,20,35,5,30,10,60,46,0,0,2023-2024,0.3546099290780142,1.773049645390071
366,Domagoj Bradarić,CRO,DF,Salernitana,Serie A,23,1999,30.5,29,20,13,10,6,15,25,60.0,10,22,7,15,32,61,62,1,0,2023-2024,1.0491803278688525,0.9508196721311475
367,Conor Bradley,NIR,DF,Liverpool,Premier League,20,2003,8.4,33,25,14,12,7,24,38,63.2,14,17,1,16,10,43,14,0,0,2023-2024,1.1904761904761905,3.9285714285714284
368,Bilal Brahimi,ALG,FW,Nice,Ligue 1,23,2000,0.1,0,0,0,0,0,0,1,0.0,1,0,0,0,0,0,0,0,0,2023-2024,0.0,0.0
369,Bilal Brahimi,ALG,"FW,MF",Brest,Ligue 1,23,2000,2.5,0,0,0,0,0,0,3,0.0,3,3,0,3,0,0,0,0,0,2023-2024,0.0,0.0
370,Julian Brandt,GER,"MF,FW",Dortmund,Bundesliga,27,1996,24.7,17,14,8,8,1,10,27,37.0,17,20,3,17,8,25,18,0,0,2023-2024,0.32388663967611336,0.688259109311741
371,Jarrad Branthwaite,ENG,DF,Everton,Premier League,21,2002,34.6,66,32,42,22,2,45,62,72.6,17,51,36,15,50,116,163,2,0,2023-2024,1.445086705202312,1.9075144508670518
372,Darko Brašanac,SRB,MF,Osasuna,La Liga,31,1992,0.5,1,0,1,0,0,1,1,100.0,0,1,0,1,0,1,0,0,0,2023-2024,0.0,2.0
373,Lilian Brassier,FRA,DF,Brest,Ligue 1,23,1999,29.7,31,18,18,13,0,12,24,50.0,12,28,21,7,41,72,93,0,0,2023-2024,1.3804713804713804,1.043771043771044
374,Brau,ESP,DF,Granada,La Liga,21,2001,0.3,1,0,1,0,0,1,1,100.0,0,0,0,0,0,1,2,0,0,2023-2024,0.0,3.3333333333333335
375,Claudio Bravo,CHI,GK,Betis,La Liga,40,1983,7.0,0,0,0,0,0,0,1,0.0,1,0,0,0,0,0,2,0,0,2023-2024,0.0,0.0
Rk,Player,Nation,Pos,Squad,Comp,0,0,90.0,0,0,3,3,3,Tkl,0,0.0,0,0,0,0,0,0,0,0,0,2023-2024,0.0,0.0
376,Fabian Bredlow,GER,GK,Stuttgart,Bundesliga,28,1995,4.0,0,0,0,0,0,0,1,0.0,1,0,0,0,0,0,3,0,0,2023-2024,0.0,0.0
377,Tim Breithaupt,GER,MF,Augsburg,Bundesliga,21,2002,7.0,20,11,11,9,0,13,21,61.9,8,15,3,12,8,28,10,0,0,2023-2024,1.1428571428571428,2.857142857142857
378,Josip Brekalo,CRO,FW,Fiorentina,Serie A,25,1998,7.2,8,6,6,2,0,2,11,18.2,9,7,0,7,1,9,0,0,0,2023-2024,0.1388888888888889,1.1111111111111112
379,Gleison Bremer,BRA,DF,Juventus,Serie A,26,1997,35.9,58,42,32,21,5,21,29,72.4,8,45,27,18,40,98,147,0,0,2023-2024,1.1142061281337048,1.615598885793872
380,Brenner,BRA,"MF,FW",Udinese,Serie A,23,2000,2.1,8,7,1,5,2,4,7,57.1,3,2,0,2,0,8,2,0,0,2023-2024,0.0,3.8095238095238093
381,Ben Brereton,CHI,"FW,MF",Sheffield Utd,Premier League,24,1999,12.3,9,4,4,4,1,4,10,40.0,6,9,3,6,3,12,12,0,0,2023-2024,0.24390243902439024,0.7317073170731707
382,Ben Brereton,CHI,"FW,MF",Villarreal,La Liga,24,1999,3.0,2,2,1,0,1,0,2,0.0,2,0,0,0,0,2,0,0,0,2023-2024,0.0,0.6666666666666666
383,Marco Brescianini,ITA,MF,Frosinone,Serie A,23,2000,25.8,28,13,13,12,3,9,25,36.0,16,22,5,17,10,38,37,0,0,2023-2024,0.38759689922480617,1.0852713178294573
384,Maximilian Breunig,GER,FW,Freiburg,Bundesliga,22,2000,0.1,0,0,0,0,0,0,0,0.0,0,1,0,1,0,0,0,0,0,2023-2024,0.0,0.0
385,Rhian Brewster,ENG,"FW,MF",Sheffield Utd,Premier League,23,2000,3.8,5,1,1,2,2,0,2,0.0,2,2,0,2,1,6,2,0,0,2023-2024,0.2631578947368421,1.3157894736842106
386,Bennit Bröger,GER,FW,Wolfsburg,Bundesliga,17,2006,0.1,0,0,0,0,0,0,0,0.0,0,0,0,0,0,0,0,0,0,2023-2024,0.0,0.0
387,Armando Broja,ALB,FW,Chelsea,Premier League,21,2001,5.0,3,0,0,1,2,1,2,50.0,1,5,1,4,0,3,3,0,0,2023-2024,0.0,0.6
388,Armando Broja,ALB,FW,Fulham,Premier League,21,2001,1.0,0,0,0,0,0,0,0,0.0,0,1,0,1,0,0,0,0,0,2023-2024,0.0,0.0
389,Dylan Bronn,TUN,"DF,MF",Salernitana,Serie A,28,1995,0.6,0,0,0,0,0,0,1,0.0,1,2,0,2,0,0,4,0,0,2023-2024,0.0,0.0
390,Andre Brooks,ENG,"MF,DF",Sheffield Utd,Premier League,19,2003,10.4,22,13,7,11,4,9,21,42.9,12,13,1,12,14,36,20,0,0,2023-2024,1.346153846153846,2.1153846153846154
391,David Brooks,WAL,"FW,MF",Bournemouth,Premier League,26,1997,3.1,5,4,2,1,2,2,4,50.0,2,3,0,3,2,7,2,0,0,2023-2024,0.6451612903225806,1.6129032258064515
392,John Brooks,USA,DF,Hoffenheim,Bundesliga,30,1993,17.1,28,15,17,10,1,15,30,50.0,15,29,17,12,27,55,109,1,0,2023-2024,1.5789473684210524,1.6374269005847952
393,Moritz Broschinski,GER,FW,Bochum,Bundesliga,22,2000,13.9,11,7,2,5,4,2,8,25.0,6,11,2,9,0,11,6,0,0,2023-2024,0.0,0.7913669064748201
394,Jacob Brown,SCO,"MF,FW",Luton Town,Premier League,25,1998,11.3,19,12,7,7,5,7,18,38.9,11,20,1,19,8,27,22,0,0,2023-2024,0.7079646017699115,1.6814159292035398
395,Josh Brownhill,ENG,MF,Burnley,Premier League,27,1995,25.0,61,35,23,28,10,27,37,73.0,10,33,8,25,34,95,40,1,0,2023-2024,1.36,2.44
396,Alexander Brunst,GER,GK,Darmstadt 98,Bundesliga,28,1995,3.0,0,0,0,0,0,0,2,0.0,2,0,0,0,0,0,2,1,0,2023-2024,0.0,0.0
397,Jacob Bruun Larsen,DEN,"MF,FW",Burnley,Premier League,24,1998,13.9,9,4,4,3,2,7,21,33.3,14,16,2,14,7,16,23,0,0,2023-2024,0.5035971223021583,0.6474820143884892
398,Tajon Buchanan,CAN,DF,Inter,Serie A,24,1999,1.8,1,1,0,0,1,1,2,50.0,1,1,0,1,0,1,4,0,0,2023-2024,0.0,0.5555555555555556
399,Ante Budimir,CRO,FW,Osasuna,La Liga,32,1991,27.1,21,15,2,11,8,5,14,35.7,9,19,5,14,5,26,18,0,0,2023-2024,0.18450184501845018,0.7749077490774907
400,Hugo Bueno,ESP,"DF,MF",Wolves,Premier League,20,2002,8.2,21,14,12,7,2,12,19,63.2,7,17,4,13,6,27,24,0,0,2023-2024,0.7317073170731708,2.5609756097560976
Rk,Player,Nation,Pos,Squad,Comp,0,0,90.0,0,0,3,3,3,Tkl,0,0.0,0,0,0,0,0,0,0,0,0,2023-2024,0.0,0.0
401,Manu Bueno,ESP,MF,Sevilla,La Liga,19,2004,1.3,4,2,4,0,0,3,3,100.0,0,3,0,3,0,4,1,0,0,2023-2024,0.0,3.0769230769230766
402,Santiago Bueno,URU,DF,Wolves,Premier League,24,1998,9.1,13,7,5,7,1,5,11,45.5,6,22,12,10,6,19,33,0,0,2023-2024,0.6593406593406593,1.4285714285714286
403,Marius Bülter,GER,"DF,FW",Hoffenheim,Bundesliga,30,1993,15.0,18,11,9,5,4,12,23,52.2,11,17,3,14,10,28,20,0,0,2023-2024,0.6666666666666666,1.2
404,Facundo Buonanotte,ARG,"FW,MF",Brighton,Premier League,18,2004,15.2,42,22,13,22,7,14,44,31.8,30,22,3,19,8,50,5,0,0,2023-2024,0.5263157894736842,2.763157894736842
405,Alessandro Buongiorno,ITA,DF,Torino,Serie A,24,1999,28.1,70,39,43,24,3,24,34,70.6,10,20,12,8,69,139,131,0,0,2023-2024,2.4555160142348753,2.491103202846975
406,Jonathan Burkardt,GER,"FW,MF",Mainz 05,Bundesliga,23,2000,17.1,12,8,2,6,4,4,11,36.4,7,16,3,13,3,15,2,0,0,2023-2024,0.17543859649122806,0.7017543859649122
407,Oliver Burke,SCO,FW,Werder Bremen,Bundesliga,26,1997,0.4,0,0,0,0,0,0,2,0.0,2,0,0,0,0,0,0,0,0,2023-2024,0.0,0.0
408,Reece Burke,ENG,DF,Luton Town,Premier League,26,1996,18.4,37,23,17,14,6,12,26,46.2,14,25,18,7,18,55,78,1,0,2023-2024,0.9782608695652175,2.0108695652173916
409,Dan Burn,ENG,DF,Newcastle Utd,Premier League,31,1992,30.3,61,33,37,20,4,26,61,42.6,35,55,25,30,37,98,124,1,0,2023-2024,1.221122112211221,2.0132013201320134
410,Rareș-Cătălin Burnete,ROU,FW,Lecce,Serie A,19,2004,0.1,0,0,0,0,0,0,0,0.0,0,0,0,0,0,0,0,0,0,2023-2024,0.0,0.0
411,Mason Burstow,ENG,FW,Chelsea,Premier League,19,2003,0.1,0,0,0,0,0,0,0,0.0,0,0,0,0,0,0,0,0,0,2023-2024,0.0,0.0
412,Marnon Busch,GER,DF,Heidenheim,Bundesliga,28,1994,6.6,11,9,6,3,2,7,12,58.3,5,9,2,7,10,21,12,0,0,2023-2024,1.5151515151515151,1.6666666666666667
413,Maxime Busi,BEL,"FW,DF",Reims,Ligue 1,23,1999,1.8,2,0,0,1,1,0,2,0.0,2,6,1,5,4,6,5,0,0,2023-2024,2.2222222222222223,1.1111111111111112
414,Pablo Busto,ESP,DF,Betis,La Liga,17,2005,0.5,1,1,0,0,1,1,1,100.0,0,0,0,0,1,2,3,0,0,2023-2024,2.0,2.0
415,Aurélio Buta,POR,"DF,MF",Eint Frankfurt,Bundesliga,26,1997,19.4,40,25,19,16,5,21,38,55.3,17,24,5,19,15,55,36,0,0,2023-2024,0.7731958762886598,2.061855670103093
416,Marcin Bułka,POL,GK,Nice,Ligue 1,23,1999,34.0,0,0,0,0,0,0,2,0.0,2,0,0,0,0,0,9,3,0,2023-2024,0.0,0.0
417,Rémy Cabella,FRA,"FW,MF",Lille,Ligue 1,33,1990,16.4,54,36,19,20,15,20,54,37.0,34,32,0,32,5,59,5,0,0,2023-2024,0.30487804878048785,3.2926829268292686
418,Jovane Cabral,CPV,"MF,FW",Salernitana,Serie A,25,1998,7.5,13,9,4,7,2,3,9,33.3,6,3,0,3,1,14,4,0,0,2023-2024,0.13333333333333333,1.7333333333333334
419,Liberato Cacace,NZL,DF,Empoli,Serie A,22,2000,21.2,40,24,24,13,3,24,38,63.2,14,23,6,17,19,59,56,0,0,2023-2024,0.8962264150943396,1.8867924528301887
420,Anthony Caci,FRA,DF,Mainz 05,Bundesliga,26,1997,27.6,56,23,30,25,1,27,44,61.4,17,43,7,36,32,88,45,0,0,2023-2024,1.1594202898550725,2.0289855072463765
421,Moisés Caicedo,ECU,MF,Chelsea,Premier League,21,2001,31.8,91,46,38,42,11,36,60,60.0,24,59,25,34,37,128,44,4,0,2023-2024,1.1635220125786163,2.861635220125786
422,Tom Cairney,SCO,MF,Fulham,Premier League,32,1991,16.5,24,16,10,12,2,13,25,52.0,12,16,4,12,13,37,6,0,0,2023-2024,0.7878787878787878,1.4545454545454546
423,Jens Cajuste,SWE,MF,Napoli,Serie A,23,1999,11.3,36,24,13,17,6,20,37,54.1,17,20,3,17,4,40,15,0,0,2023-2024,0.35398230088495575,3.1858407079646014
424,Davide Calabria,ITA,DF,Milan,Serie A,26,1996,24.3,70,38,38,25,7,44,72,61.1,28,26,7,19,24,94,49,1,0,2023-2024,0.9876543209876543,2.8806584362139915
425,Riccardo Calafiori,ITA,DF,Bologna,Serie A,21,2002,26.1,47,32,28,16,3,22,32,68.8,10,38,13,25,50,97,74,3,0,2023-2024,1.9157088122605364,1.800766283524904
Rk,Player,Nation,Pos,Squad,Comp,0,0,90.0,0,0,3,3,3,Tkl,0,0.0,0,0,0,0,0,0,0,0,0,2023-2024,0.0,0.0
426,Mattia Caldara,ITA,DF,Milan,Serie A,29,1994,0.4,1,1,1,0,0,1,1,100.0,0,1,1,0,1,2,1,0,0,2023-2024,2.5,2.5
427,Luca Caldirola,ITA,DF,Monza,Serie A,32,1991,23.8,25,14,19,4,2,13,22,59.1,9,26,17,9,29,54,53,0,0,2023-2024,1.218487394957983,1.050420168067227
428,Duje Ćaleta-Car,CRO,DF,Lyon,Ligue 1,26,1996,22.1,26,11,19,6,1,18,22,81.8,4,27,14,13,18,44,94,1,0,2023-2024,0.8144796380090498,1.176470588235294
429,Hakan Çalhanoğlu,TUR,MF,Inter,Serie A,29,1994,28.4,66,33,29,29,8,32,49,65.3,17,29,13,16,24,90,22,0,0,2023-2024,0.8450704225352114,2.323943661971831
430,José Callejón,ESP,"MF,FW",Granada,La Liga,36,1987,8.9,13,6,10,3,0,8,22,36.4,14,7,1,6,5,18,10,0,0,2023-2024,0.5617977528089887,1.4606741573033708
431,Dominic Calvert-Lewin,ENG,FW,Everton,Premier League,26,1997,24.1,13,6,2,6,5,2,15,13.3,13,14,4,10,4,17,38,0,0,2023-2024,0.16597510373443983,0.5394190871369294
432,Lamine Camara,SEN,MF,Metz,Ligue 1,19,2004,25.1,62,42,26,30,6,24,49,49.0,25,35,2,33,28,90,34,0,0,2023-2024,1.1155378486055776,2.4701195219123506
433,Mahdi Camara,FRA,MF,Brest,Ligue 1,25,1998,22.4,55,39,8,40,7,20,49,40.8,29,24,1,23,27,82,19,0,0,2023-2024,1.205357142857143,2.455357142857143
434,Mohamed Camara,MLI,MF,Monaco,Ligue 1,23,2000,11.5,35,21,10,20,5,15,29,51.7,14,8,2,6,11,46,7,0,0,2023-2024,0.9565217391304348,3.0434782608695654
435,Francesco Camarda,ITA,FW,Milan,Serie A,15,2008,0.2,0,0,0,0,0,0,2,0.0,2,0,0,0,0,0,0,0,0,2023-2024,0.0,0.0
436,Eduardo Camavinga,FRA,"MF,DF",Real Madrid,La Liga,20,2002,20.2,76,47,39,29,8,23,39,59.0,16,36,8,28,29,105,29,1,0,2023-2024,1.4356435643564356,3.7623762376237626
437,Nicolò Cambiaghi,ITA,"FW,MF",Empoli,Serie A,22,2000,28.4,51,39,15,20,16,16,35,45.7,19,26,1,25,14,65,8,0,0,2023-2024,0.49295774647887325,1.795774647887324
438,Andrea Cambiaso,ITA,"DF,FW",Juventus,Serie A,23,2000,26.4,47,30,23,15,9,25,43,58.1,18,28,3,25,11,58,26,1,0,2023-2024,0.4166666666666667,1.7803030303030305
439,Axel Camblan,FRA,FW,Brest,Ligue 1,19,2003,1.0,3,1,0,2,1,2,4,50.0,2,2,0,2,0,3,0,0,0,2023-2024,0.0,3.0
440,Sergio Camello,ESP,FW,Rayo Vallecano,La Liga,22,2001,18.5,16,5,3,10,3,6,15,40.0,9,10,2,8,3,19,15,0,0,2023-2024,0.16216216216216217,0.8648648648648649
441,José Campaña,ESP,MF,Las Palmas,La Liga,30,1993,1.9,2,2,1,1,0,0,2,0.0,2,3,2,1,2,4,3,0,0,2023-2024,1.0526315789473684,1.0526315789473684
442,Emre Can,GER,"MF,DF",Dortmund,Bundesliga,29,1994,21.7,63,45,37,23,3,28,48,58.3,20,30,7,23,22,85,41,2,0,2023-2024,1.0138248847926268,2.903225806451613
443,Matteo Cancellieri,ITA,"FW,MF",Empoli,Serie A,21,2002,19.9,35,22,12,16,7,13,36,36.1,23,19,0,19,6,41,18,0,0,2023-2024,0.30150753768844224,1.7587939698492463
444,João Cancelo,POR,DF,Barcelona,La Liga,29,1994,27.8,64,44,35,21,8,38,58,65.5,20,35,6,29,29,93,59,1,0,2023-2024,1.0431654676258992,2.302158273381295
445,Fali Candé,GNB,DF,Metz,Ligue 1,25,1998,20.5,40,19,31,9,0,20,35,57.1,15,41,28,13,20,60,107,1,0,2023-2024,0.975609756097561,1.951219512195122
446,Antonio Candreva,ITA,"MF,FW",Salernitana,Serie A,36,1987,30.6,18,13,8,8,2,9,25,36.0,16,9,0,9,7,25,23,0,0,2023-2024,0.22875816993464052,0.5882352941176471
447,Thomas Cannon,IRL,FW,Everton,Premier League,20,2002,0.0,0,0,0,0,0,0,0,0.0,0,0,0,0,0,0,0,0,0,2023-2024,,
448,Sergi Canós,ESP,"MF,FW",Valencia,La Liga,26,1997,13.7,23,13,7,11,5,10,24,41.7,14,14,2,12,11,34,9,0,0,2023-2024,0.8029197080291971,1.6788321167883213
449,Luigi Canotto,ITA,FW,Frosinone,Serie A,29,1994,0.2,0,0,0,0,0,0,0,0.0,0,0,0,0,0,0,0,0,0,2023-2024,0.0,0.0
450,Gino Caoki,FRA,MF,Lorient,Ligue 1,19,2004,0.1,0,0,0,0,0,0,1,0.0,1,0,0,0,0,0,0,0,0,2023-2024,0.0,0.0
Rk,Player,Nation,Pos,Squad,Comp,0,0,90.0,0,0,3,3,3,Tkl,0,0.0,0,0,0,0,0,0,0,0,0,2023-2024,0.0,0.0
451,Étienne Capoue,FRA,MF,Villarreal,La Liga,35,1988,16.2,32,18,17,12,3,15,22,68.2,7,20,4,16,22,54,24,1,0,2023-2024,1.3580246913580247,1.9753086419753088
452,Gianluca Caprari,ITA,"MF,FW",Monza,Serie A,30,1993,3.2,2,1,1,1,0,0,1,0.0,1,0,0,0,2,4,0,0,0,2023-2024,0.625,0.625
453,Elia Caprile,ITA,GK,Empoli,Serie A,21,2001,23.0,1,0,1,0,0,1,1,100.0,0,0,0,0,0,1,16,2,0,2023-2024,0.0,0.043478260869565216
454,Francesco Caputo,ITA,FW,Empoli,Serie A,35,1987,14.1,2,0,0,0,2,0,1,0.0,1,4,0,4,1,3,3,0,0,2023-2024,0.07092198581560284,0.14184397163120568
455,Maxence Caqueret,FRA,MF,Lyon,Ligue 1,23,2000,33.6,91,64,39,37,15,38,107,35.5,69,40,9,31,48,139,26,2,0,2023-2024,1.4285714285714286,2.708333333333333
456,Andrea Carboni,ITA,DF,Monza,Serie A,22,2001,16.5,38,22,24,12,2,20,31,64.5,11,23,13,10,17,55,56,1,0,2023-2024,1.0303030303030303,2.303030303030303
457,Valentin Carboni,ARG,"MF,FW",Monza,Serie A,18,2005,13.0,25,15,10,12,3,8,26,30.8,18,12,1,11,7,32,4,0,0,2023-2024,0.5384615384615384,1.9230769230769231
458,Isaac Carcelen,ESP,DF,Cádiz,La Liga,30,1993,29.0,50,31,30,15,5,25,45,55.6,20,24,7,17,27,77,87,2,0,2023-2024,0.9310344827586207,1.7241379310344827
459,Cárdenas,ESP,GK,Rayo Vallecano,La Liga,26,1997,1.0,0,0,0,0,0,0,0,0.0,0,0,0,0,0,0,1,0,0,2023-2024,0.0,0.0
460,Irvin Cardona,FRA,"MF,DF",Augsburg,Bundesliga,25,1997,0.6,1,1,0,0,1,1,3,33.3,2,1,0,1,0,1,1,0,0,2023-2024,0.0,1.6666666666666667
461,Marc Cardona,ESP,FW,Las Palmas,La Liga,28,1995,8.0,9,8,3,4,2,1,12,8.3,11,5,0,5,2,11,7,0,0,2023-2024,0.25,1.125
462,Sergi Cardona,ESP,DF,Las Palmas,La Liga,24,1999,31.3,90,55,52,29,9,55,96,57.3,41,45,7,38,46,136,102,0,0,2023-2024,1.4696485623003195,2.8753993610223643
463,Johnny Cardoso,USA,MF,Betis,La Liga,21,2001,14.8,48,29,19,24,5,22,33,66.7,11,20,5,15,32,80,31,0,0,2023-2024,2.162162162162162,3.243243243243243
464,Igor Carioca,BRA,"DF,MF",Lorient,Ligue 1,26,1996,2.9,8,6,6,1,1,4,6,66.7,2,0,0,0,3,11,6,0,0,2023-2024,1.0344827586206897,2.7586206896551726
465,Diego Carlos,BRA,DF,Aston Villa,Premier League,30,1993,20.2,27,16,22,4,1,13,21,61.9,8,24,19,5,13,40,78,3,0,2023-2024,0.6435643564356436,1.3366336633663367
466,Carmona,ESP,"DF,MF",Getafe,La Liga,21,2002,14.6,30,21,13,14,3,9,28,32.1,19,15,2,13,21,51,25,0,0,2023-2024,1.4383561643835616,2.0547945205479454
467,Marco Carnesecchi,ITA,GK,Atalanta,Serie A,23,2000,26.9,0,0,0,0,0,0,0,0.0,0,0,0,0,0,0,22,3,0,2023-2024,0.0,0.0
468,Yannick Carrasco,BEL,DF,Atlético Madrid,La Liga,29,1993,2.5,4,4,3,1,0,2,7,28.6,5,2,0,2,1,5,6,0,0,2023-2024,0.4,1.6
469,Álvaro Carreras,ESP,"MF,FW",Granada,La Liga,20,2003,5.3,13,8,8,4,1,5,11,45.5,6,5,1,4,7,20,9,1,0,2023-2024,1.3207547169811322,2.452830188679245
470,Rasmus Carstensen,DEN,"DF,FW",Köln,Bundesliga,22,2000,18.4,47,22,23,20,4,31,56,55.4,25,38,9,29,20,67,50,2,0,2023-2024,1.0869565217391306,2.5543478260869565
471,Antonin Cartillier,FRA,DF,Monaco,Ligue 1,19,2004,0.1,0,0,0,0,0,0,0,0.0,0,1,0,1,0,0,0,0,0,2023-2024,0.0,0.0
472,Dani Carvajal,ESP,DF,Real Madrid,La Liga,31,1992,24.1,47,32,28,15,4,23,42,54.8,19,28,9,19,22,69,54,4,0,2023-2024,0.9128630705394191,1.950207468879668
473,Fabio Carvalho,POR,MF,RB Leipzig,Bundesliga,20,2002,1.8,3,1,0,2,1,1,3,33.3,2,8,0,8,0,3,1,0,0,2023-2024,0.0,1.6666666666666665
474,William Carvalho,POR,MF,Betis,La Liga,31,1992,7.6,20,12,11,7,2,10,16,62.5,6,8,1,7,8,28,9,1,0,2023-2024,1.0526315789473684,2.6315789473684212
475,Cesare Casadei,ITA,"FW,MF",Chelsea,Premier League,20,2003,0.9,5,3,2,1,2,2,5,40.0,3,1,0,1,0,5,4,0,0,2023-2024,0.0,5.555555555555555
Rk,Player,Nation,Pos,Squad,Comp,0,0,90.0,0,0,3,3,3,Tkl,0,0.0,0,0,0,0,0,0,0,0,0,2023-2024,0.0,0.0
476,Marc Casado,ESP,MF,Barcelona,La Liga,19,2003,0.2,1,1,1,0,0,1,1,100.0,0,0,0,0,1,2,2,0,0,2023-2024,5.0,5.0
477,Nicolò Casale,ITA,DF,Lazio,Serie A,25,1998,17.3,15,9,13,2,0,6,15,40.0,9,19,16,3,12,27,61,0,0,2023-2024,0.6936416184971098,0.8670520231213873
478,Casemiro,BRA,"MF,DF",Manchester Utd,Premier League,31,1992,22.0,83,56,43,32,8,51,106,48.1,55,74,33,41,18,101,71,1,0,2023-2024,0.8181818181818182,3.772727272727273
479,Kaelan Casey,ENG,DF,West Ham,Premier League,18,2004,0.0,0,0,0,0,0,0,0,0.0,0,0,0,0,0,0,1,0,0,2023-2024,,
480,Matty Cash,POL,DF,Aston Villa,Premier League,25,1997,23.8,54,31,24,24,6,29,59,49.2,30,35,14,21,18,72,59,0,0,2023-2024,0.7563025210084033,2.26890756302521
481,Josué Casimir,FRA,"FW,DF",Le Havre,Ligue 1,21,2001,22.4,31,18,14,14,3,7,18,38.9,11,23,2,21,13,44,25,0,0,2023-2024,0.5803571428571429,1.3839285714285716
482,Giuseppe Caso,ITA,"FW,MF",Frosinone,Serie A,24,1998,4.6,4,3,2,0,2,2,3,66.7,1,0,0,0,0,4,0,0,0,2023-2024,0.0,0.8695652173913044
483,Cristian Cásseres Jr.,VEN,MF,Toulouse,Ligue 1,23,2000,21.6,70,34,31,33,6,29,61,47.5,32,34,4,30,27,97,33,1,0,2023-2024,1.25,3.2407407407407405
484,Timothy Castagne,BEL,DF,Fulham,Premier League,27,1995,29.3,49,24,23,16,10,26,44,59.1,18,38,10,28,38,87,69,1,0,2023-2024,1.2969283276450512,1.6723549488054608
485,Koen Casteels,BEL,GK,Wolfsburg,Bundesliga,31,1992,25.0,2,1,2,0,0,2,3,66.7,1,0,0,0,0,2,16,5,0,2023-2024,0.0,0.08
486,Valentín Castellanos,ARG,FW,Lazio,Serie A,24,1998,18.7,22,10,1,12,9,6,20,30.0,14,22,2,20,2,24,18,0,0,2023-2024,0.10695187165775401,1.1764705882352942
487,Jean-Charles Castelletto,CMR,DF,Nantes,Ligue 1,28,1995,27.4,34,26,22,10,2,18,29,62.1,11,19,10,9,32,66,81,0,0,2023-2024,1.1678832116788322,1.2408759124087592
488,Samu Castillejo,ESP,"FW,MF",Sassuolo,Serie A,28,1995,6.0,12,10,5,5,2,7,19,36.8,12,16,1,15,1,13,3,0,0,2023-2024,0.16666666666666666,2.0
489,Jonny Castro,ESP,MF,Wolves,Premier League,29,1994,0.1,0,0,0,0,0,0,1,0.0,1,1,1,0,0,0,0,0,0,2023-2024,0.0,0.0
490,Santiago Castro,ARG,FW,Bologna,Serie A,18,2004,2.7,2,1,0,1,1,1,3,33.3,2,1,0,1,1,3,1,0,0,2023-2024,0.37037037037037035,0.7407407407407407
491,Gaetano Castrovilli,ITA,"FW,MF",Fiorentina,Serie A,26,1997,4.1,3,2,1,2,0,1,8,12.5,7,4,0,4,2,5,3,0,0,2023-2024,0.48780487804878053,0.7317073170731708
492,Danilo Cataldi,ITA,MF,Lazio,Serie A,28,1994,15.1,24,12,7,16,1,8,18,44.4,10,15,7,8,17,41,19,1,0,2023-2024,1.1258278145695364,1.589403973509934
493,Catena,ESP,DF,Osasuna,La Liga,28,1994,28.2,33,18,26,6,1,19,35,54.3,16,24,15,9,15,48,119,3,0,2023-2024,0.5319148936170213,1.1702127659574468
494,Maximiliano Caufriez,BEL,DF,Clermont Foot,Ligue 1,26,1997,18.4,38,28,31,5,2,19,29,65.5,10,18,12,6,18,56,69,2,0,2023-2024,0.9782608695652175,2.065217391304348
495,Ivan Cavaleiro,POR,FW,Lille,Ligue 1,29,1993,8.6,10,6,3,4,3,7,20,35.0,13,9,2,7,5,15,6,0,0,2023-2024,0.5813953488372093,1.1627906976744187
496,Dani Ceballos,ESP,"MF,FW",Real Madrid,La Liga,26,1996,6.6,10,5,4,5,1,5,14,35.7,9,9,2,7,0,10,4,1,0,2023-2024,0.0,1.5151515151515151
497,Emil Ceide,NOR,"FW,MF",Sassuolo,Serie A,21,2001,2.0,2,2,1,1,0,1,1,100.0,0,6,1,5,0,2,0,0,0,2023-2024,0.0,1.0
498,Zeki Çelik,TUR,DF,Roma,Serie A,26,1997,7.5,23,16,10,10,3,14,25,56.0,11,12,5,7,8,31,25,0,0,2023-2024,1.0666666666666667,3.066666666666667
499,Álex Centelles,ESP,DF,Almería,La Liga,25,1997,10.9,11,6,9,2,0,8,18,44.4,10,5,2,3,18,29,29,0,0,2023-2024,1.6513761467889907,1.0091743119266054
500,Fabien Centonze,FRA,DF,Hellas Verona,Serie A,27,1996,7.5,14,8,10,4,0,5,10,50.0,5,14,2,12,10,24,18,0,0,2023-2024,1.3333333333333333,1.8666666666666667
Rk,Player,Nation,Pos,Squad,Comp,0,0,90.0,0,0,3,3,3,Tkl,0,0.0,0,0,0,0,0,0,0,0,0,2023-2024,0.0,0.0
501,Fabien Centonze,FRA,DF,Nantes,Ligue 1,27,1996,1.0,2,1,2,0,0,2,3,66.7,1,2,1,1,0,2,1,0,0,2023-2024,0.0,2.0
502,Václav Černý,CZE,"FW,MF",Wolfsburg,Bundesliga,25,1997,10.2,8,3,3,4,1,2,14,14.3,12,13,0,13,8,16,6,0,0,2023-2024,0.7843137254901962,0.7843137254901962
503,Michele Cerofolini,ITA,GK,Frosinone,Serie A,24,1999,7.5,0,0,0,0,0,0,0,0.0,0,0,0,0,0,0,5,1,0,2023-2024,0.0,0.0
504,Alberto Cerri,ITA,FW,Empoli,Serie A,27,1996,6.1,3,3,1,1,1,2,5,40.0,3,3,1,2,3,6,7,0,0,2023-2024,0.49180327868852464,0.49180327868852464
505,Leonardo Cerri,ITA,DF,Juventus,Serie A,20,2003,0.1,0,0,0,0,0,0,0,0.0,0,0,0,0,0,0,0,0,0,2023-2024,0.0,0.0
506,Franco Cervi,ARG,"MF,DF",Celta Vigo,La Liga,29,1994,6.1,24,18,13,9,2,13,24,54.2,11,16,0,16,9,33,4,0,0,2023-2024,1.4754098360655739,3.934426229508197
507,Julian Chabot,GER,DF,Köln,Bundesliga,25,1998,30.0,59,42,40,17,2,35,59,59.3,24,66,43,23,45,104,145,0,0,2023-2024,1.5,1.9666666666666666
508,El Chadaille Bitshiabu,FRA,"DF,MF",RB Leipzig,Bundesliga,18,2005,0.4,1,0,1,0,0,0,0,0.0,0,0,0,0,1,2,4,0,0,2023-2024,2.5,2.5
509,Fares Chaïbi,ALG,"FW,MF",Toulouse,Ligue 1,20,2002,0.6,0,0,0,0,0,0,0,0.0,0,0,0,0,0,0,2,0,0,2023-2024,0.0,0.0
510,Fares Chaïbi,ALG,"MF,FW",Eint Frankfurt,Bundesliga,20,2002,21.2,27,17,7,12,8,8,18,44.4,10,37,1,36,5,32,19,0,0,2023-2024,0.2358490566037736,1.2735849056603774
511,Trevoh Chalobah,ENG,DF,Chelsea,Premier League,24,1999,10.6,16,12,10,2,4,10,15,66.7,5,8,7,1,8,24,51,0,0,2023-2024,0.7547169811320755,1.509433962264151
512,Muhammed Cham,AUT,"MF,FW",Clermont Foot,Ligue 1,22,2000,28.4,25,14,10,13,2,11,27,40.7,16,20,2,18,8,33,5,1,0,2023-2024,0.28169014084507044,0.8802816901408451
513,Calum Chambers,ENG,"MF,DF",Aston Villa,Premier League,28,1995,1.7,3,0,3,0,0,0,1,0.0,1,2,1,1,2,5,4,0,0,2023-2024,1.1764705882352942,1.7647058823529411
514,Timothy Chandler,USA,"MF,DF",Eint Frankfurt,Bundesliga,33,1990,0.2,0,0,0,0,0,0,0,0.0,0,0,0,0,0,0,0,0,0,2023-2024,0.0,0.0
515,Brendan Chardonnet,FRA,DF,Brest,Ligue 1,28,1994,33.0,57,34,33,22,2,32,63,50.8,31,58,34,24,53,110,139,3,0,2023-2024,1.606060606060606,1.7272727272727273
516,Charlys,BRA,MF,Hellas Verona,Serie A,19,2004,0.3,0,0,0,0,0,0,0,0.0,0,0,0,0,1,1,0,0,0,2023-2024,3.3333333333333335,0.0
517,Pep Chavarría,ESP,"DF,MF",Rayo Vallecano,La Liga,25,1998,13.0,23,18,15,6,2,11,17,64.7,6,15,3,12,6,29,29,1,0,2023-2024,0.46153846153846156,1.7692307692307692
518,Jhoanner Chávez,ECU,DF,Lens,Ligue 1,21,2002,5.3,6,5,2,2,2,3,9,33.3,6,2,0,2,5,11,11,0,0,2023-2024,0.9433962264150944,1.1320754716981132
519,Walid Cheddira,MAR,FW,Frosinone,Serie A,25,1998,23.6,12,7,1,8,3,4,8,50.0,4,6,1,5,5,17,10,0,0,2023-2024,0.211864406779661,0.5084745762711864
520,Rayan Cherki,FRA,"MF,FW",Lyon,Ligue 1,19,2003,19.1,28,15,4,16,8,17,46,37.0,29,13,3,10,7,35,1,0,0,2023-2024,0.36649214659685864,1.4659685863874345
521,Youssef Chermiti,POR,FW,Everton,Premier League,19,2004,2.3,3,2,2,1,0,1,5,20.0,4,4,1,3,1,4,2,0,0,2023-2024,0.4347826086956522,1.3043478260869565
522,Lucas Chevalier,FRA,GK,Lille,Ligue 1,21,2001,33.0,3,0,3,0,0,3,4,75.0,1,1,0,1,0,3,11,2,0,2023-2024,0.0,0.09090909090909091
523,Fabio Chiarodia,ITA,DF,Gladbach,Bundesliga,18,2005,1.7,8,5,5,1,2,5,7,71.4,2,2,1,1,3,11,9,0,0,2023-2024,1.7647058823529411,4.705882352941177
524,Federico Chiesa,ITA,FW,Juventus,Serie A,25,1997,24.4,20,10,7,6,7,3,13,23.1,10,17,1,16,6,26,4,0,0,2023-2024,0.24590163934426232,0.819672131147541
525,Ben Chilwell,ENG,DF,Chelsea,Premier League,26,1996,8.4,15,10,5,9,1,5,8,62.5,3,11,3,8,4,19,19,1,0,2023-2024,0.47619047619047616,1.7857142857142856
Rk,Player,Nation,Pos,Squad,Comp,0,0,90.0,0,0,3,3,3,Tkl,0,0.0,0,0,0,0,0,0,0,0,0,2023-2024,0.0,0.0
526,Tawanda Chirewa,ZIM,"MF,FW",Wolves,Premier League,19,2003,1.6,7,3,3,3,1,2,3,66.7,1,0,0,0,1,8,0,0,0,2023-2024,0.625,4.375
527,Pedro Chirivella,ESP,MF,Nantes,Ligue 1,26,1997,28.8,50,28,20,29,1,30,76,39.5,46,22,5,17,31,81,28,0,0,2023-2024,1.0763888888888888,1.7361111111111112
528,Leon Chiwome,ENG,FW,Wolves,Premier League,17,2006,1.9,2,1,0,1,1,1,2,50.0,1,3,1,2,0,2,2,0,0,2023-2024,0.0,1.0526315789473684
529,Tahith Chong,NED,"MF,FW",Luton Town,Premier League,23,1999,22.0,36,22,19,13,4,15,33,45.5,18,30,6,24,8,44,11,1,0,2023-2024,0.36363636363636365,1.6363636363636365
530,Joris Chotard,FRA,MF,Montpellier,Ligue 1,21,2001,28.7,81,52,45,25,11,48,96,50.0,48,47,21,26,44,125,60,0,0,2023-2024,1.5331010452961673,2.822299651567944
531,Andreas Christensen,DEN,"DF,MF",Barcelona,La Liga,27,1996,22.0,23,14,7,14,2,16,28,57.1,12,23,10,13,21,44,41,0,0,2023-2024,0.9545454545454546,1.0454545454545454
532,Jacob Christensen,DEN,MF,Köln,Bundesliga,22,2001,2.4,10,6,7,3,0,4,7,57.1,3,8,2,6,4,14,4,0,0,2023-2024,1.6666666666666667,4.166666666666667
533,Oliver Christensen,DEN,GK,Fiorentina,Serie A,24,1999,4.0,0,0,0,0,0,0,0,0.0,0,0,0,0,0,0,1,0,0,2023-2024,0.0,0.0
534,Ryan Christie,SCO,MF,Bournemouth,Premier League,28,1995,32.3,86,44,34,35,17,39,92,42.4,53,52,11,41,52,138,53,1,0,2023-2024,1.6099071207430342,2.6625386996904026
535,Carney Chukwuemeka,ENG,"MF,FW",Chelsea,Premier League,19,2003,2.5,6,4,3,3,0,1,3,33.3,2,1,1,0,0,6,1,0,0,2023-2024,0.0,2.4
536,Samuel Chukwueze,NGA,FW,Milan,Serie A,24,1999,11.3,18,7,11,5,2,9,17,52.9,8,3,1,2,6,24,3,0,0,2023-2024,0.5309734513274336,1.5929203539823007
537,Chumi,ESP,DF,Almería,La Liga,24,1999,27.0,34,22,22,12,0,16,26,61.5,10,38,23,15,14,48,107,3,0,2023-2024,0.5185185185185185,1.2592592592592593
538,Víctor Chust,ESP,DF,Cádiz,La Liga,23,2000,20.7,29,18,23,5,1,18,32,56.3,14,27,21,6,11,40,92,1,0,2023-2024,0.5314009661835749,1.4009661835748792
539,Pathé Ciss,SEN,MF,Rayo Vallecano,La Liga,29,1994,18.5,44,24,16,26,2,16,29,55.2,13,27,10,17,30,74,54,0,0,2023-2024,1.6216216216216217,2.3783783783783785
540,Alphadjo Cissè,ITA,FW,Hellas Verona,Serie A,16,2006,0.1,0,0,0,0,0,0,0,0.0,0,0,0,0,0,0,0,0,0,2023-2024,0.0,0.0
541,Djaoui Cissé,FRA,MF,Rennes,Ligue 1,19,2004,0.0,0,0,0,0,0,0,0,0.0,0,0,0,0,0,0,0,0,0,2023-2024,,
542,Ibrahim Cissoko,NED,"FW,MF",Toulouse,Ligue 1,20,2003,2.7,4,3,3,1,0,1,3,33.3,2,3,0,3,1,5,0,0,0,2023-2024,0.37037037037037035,1.4814814814814814
543,Giorgio Cittadini,ITA,DF,Monza,Serie A,21,2002,0.2,1,1,1,0,0,1,1,100.0,0,1,1,0,0,1,0,0,0,2023-2024,0.0,5.0
544,Giorgio Cittadini,ITA,DF,Genoa,Serie A,21,2002,1.2,5,4,4,1,0,3,3,100.0,0,1,0,1,3,8,5,0,0,2023-2024,2.5,4.166666666666667
545,Patrick Ciurria,ITA,"DF,MF",Monza,Serie A,28,1995,17.8,30,18,13,13,4,13,21,61.9,8,20,5,15,9,39,28,0,0,2023-2024,0.5056179775280899,1.6853932584269662
546,Bobby Clark,ENG,MF,Liverpool,Premier League,18,2005,1.0,2,1,1,1,0,1,5,20.0,4,6,2,4,1,3,1,0,0,2023-2024,1.0,2.0
547,Jordan Clark,ENG,MF,Luton Town,Premier League,29,1993,14.5,30,17,14,11,5,11,39,28.2,28,24,3,21,11,41,15,1,0,2023-2024,0.7586206896551724,2.0689655172413794
548,Alexis Claude-Maurice,FRA,MF,Nice,Ligue 1,25,1998,5.6,12,5,3,6,3,1,5,20.0,4,4,1,3,5,17,7,0,0,2023-2024,0.8928571428571429,2.142857142857143
549,Jonathan Clauss,FRA,DF,Marseille,Ligue 1,30,1992,23.0,47,20,22,19,6,26,49,53.1,23,17,3,14,36,83,46,0,0,2023-2024,1.565217391304348,2.0434782608695654
550,Silvi Clúa,ESP,MF,Girona,La Liga,18,2005,0.0,2,0,2,0,0,2,2,100.0,0,1,0,1,0,2,0,0,0,2023-2024,,inf
Rk,Player,Nation,Pos,Squad,Comp,0,0,90.0,0,0,3,3,3,Tkl,0,0.0,0,0,0,0,0,0,0,0,0,2023-2024,0.0,0.0
551,Nathaniel Clyne,ENG,DF,Crystal Palace,Premier League,32,1991,14.9,24,15,11,11,2,14,21,66.7,7,18,6,12,10,34,33,0,0,2023-2024,0.6711409395973155,1.610738255033557
552,Marcus Coco,FRA,"DF,FW",Nantes,Ligue 1,27,1996,16.5,43,26,29,10,4,28,60,46.7,32,19,1,18,21,64,38,0,0,2023-2024,1.2727272727272727,2.606060606060606
553,Saúl Coco,EQG,DF,Las Palmas,La Liga,24,1999,25.5,32,19,25,7,0,11,18,61.1,7,27,15,12,20,52,120,3,0,2023-2024,0.7843137254901961,1.2549019607843137
554,Séamus Coleman,IRL,DF,Everton,Premier League,34,1988,7.4,17,14,10,3,4,11,16,68.8,5,12,4,8,7,24,26,1,0,2023-2024,0.9459459459459459,2.2972972972972974
555,Maxime Colin,FRA,DF,Metz,Ligue 1,31,1991,20.4,39,23,25,7,7,16,29,55.2,13,22,7,15,20,59,71,0,0,2023-2024,0.9803921568627452,1.911764705882353
556,Nathan Collins,IRL,DF,Brentford,Premier League,22,2001,29.5,38,20,24,12,2,19,29,65.5,10,46,30,16,44,82,141,4,0,2023-2024,1.4915254237288136,1.2881355932203389
557,Nnamdi Collins,GER,DF,Eint Frankfurt,Bundesliga,19,2004,1.0,0,0,0,0,0,0,0,0.0,0,0,0,0,2,2,4,0,0,2023-2024,2.0,0.0
558,Lorenzo Colombo,ITA,FW,Monza,Serie A,21,2002,15.1,17,12,3,9,5,8,14,57.1,6,18,5,13,0,17,14,0,0,2023-2024,0.0,1.1258278145695364
559,Andrea Colpani,ITA,"MF,FW",Monza,Serie A,24,1999,29.5,25,15,6,13,6,11,20,55.0,9,11,4,7,14,39,14,0,0,2023-2024,0.4745762711864407,0.847457627118644
560,Levi Colwill,ENG,DF,Chelsea,Premier League,20,2003,20.0,48,30,26,17,5,26,34,76.5,8,28,10,18,26,74,66,0,0,2023-2024,1.3,2.4
561,Kingsley Coman,FRA,FW,Bayern Munich,Bundesliga,27,1996,12.4,12,7,5,3,4,9,17,52.9,8,15,1,14,2,14,5,0,0,2023-2024,0.16129032258064516,0.9677419354838709
562,Eray Cömert,SUI,DF,Nantes,Ligue 1,25,1998,22.2,42,28,28,13,1,28,38,73.7,10,35,18,17,36,78,77,1,0,2023-2024,1.6216216216216217,1.8918918918918919
563,Santi Comesaña,ESP,MF,Villarreal,La Liga,26,1996,18.4,44,26,15,21,8,19,38,50.0,19,33,9,24,22,66,27,1,0,2023-2024,1.1956521739130437,2.3913043478260874
564,Pietro Comuzzo,ITA,"DF,FW",Fiorentina,Serie A,18,2005,0.5,1,1,1,0,0,1,1,100.0,0,1,0,1,1,2,2,0,0,2023-2024,2.0,2.0
565,Alois Confais,FRA,"MF,FW",Le Havre,Ligue 1,26,1996,0.1,2,2,1,1,0,1,1,100.0,0,0,0,0,0,2,0,0,0,2023-2024,0.0,20.0
566,Andrea Consigli,ITA,GK,Sassuolo,Serie A,36,1987,35.0,0,0,0,0,0,0,0,0.0,0,1,0,1,1,1,19,1,0,2023-2024,0.02857142857142857,0.0
567,Bambasé Conté,GER,"MF,FW",Hoffenheim,Bundesliga,20,2003,0.5,3,3,2,0,1,1,1,100.0,0,0,0,0,0,3,0,0,0,2023-2024,0.0,6.0
568,Nikita Contini Baranovsky,ITA,GK,Napoli,Serie A,27,1996,0.2,0,0,0,0,0,0,0,0.0,0,0,0,0,0,0,1,0,0,2023-2024,0.0,0.0
569,Lewis Cook,ENG,MF,Bournemouth,Premier League,26,1997,31.0,61,41,24,30,7,34,63,54.0,29,32,11,21,65,126,46,1,0,2023-2024,2.096774193548387,1.967741935483871
570,Copete,ESP,DF,Mallorca,La Liga,23,1999,14.8,45,27,27,17,1,30,43,69.8,13,12,6,6,32,77,47,1,0,2023-2024,2.162162162162162,3.0405405405405403
571,Diego Coppola,ITA,DF,Hellas Verona,Serie A,19,2003,18.2,36,22,25,9,2,20,33,60.6,13,26,9,17,27,63,89,1,0,2023-2024,1.4835164835164836,1.978021978021978
572,Francis Coquelin,FRA,MF,Villarreal,La Liga,32,1991,10.1,20,12,8,10,2,5,13,38.5,8,14,4,10,16,36,15,0,0,2023-2024,1.5841584158415842,1.9801980198019802
573,Tommaso Corazza,ITA,DF,Bologna,Serie A,19,2004,2.2,10,4,9,1,0,4,9,44.4,5,2,0,2,5,15,3,0,0,2023-2024,2.2727272727272725,4.545454545454545
574,Theo Corbeanu,CAN,"MF,FW",Granada,La Liga,21,2002,2.0,5,2,2,3,0,1,3,33.3,2,3,0,3,3,8,2,0,0,2023-2024,1.5,2.5
575,Jeppe Corfitzen,DEN,FW,Lecce,Serie A,18,2004,0.1,1,0,0,1,0,1,1,100.0,0,0,0,0,0,1,0,0,0,2023-2024,0.0,10.0
Rk,Player,Nation,Pos,Squad,Comp,0,0,90.0,0,0,3,3,3,Tkl,0,0.0,0,0,0,0,0,0,0,0,0,2023-2024,0.0,0.0
576,Jack Cork,ENG,MF,Burnley,Premier League,34,1989,0.3,2,0,0,2,0,1,3,33.3,2,0,0,0,1,3,1,0,0,2023-2024,3.3333333333333335,6.666666666666667
577,Maxwel Cornet,CIV,"MF,FW",West Ham,Premier League,26,1996,1.2,3,2,3,0,0,1,5,20.0,4,2,0,2,2,5,1,0,0,2023-2024,1.6666666666666667,2.5
578,Giacomo Corona,ITA,FW,Empoli,Serie A,19,2004,0.1,0,0,0,0,0,0,0,0.0,0,0,0,0,0,0,0,0,0,2023-2024,0.0,0.0
579,Jesús Corona,MEX,"MF,DF",Sevilla,La Liga,30,1993,0.2,0,0,0,0,0,0,0,0.0,0,0,0,0,1,1,0,0,0,2023-2024,5.0,0.0
580,Ángel Correa,ARG,"FW,MF",Atlético Madrid,La Liga,28,1995,17.0,22,15,3,11,8,5,17,29.4,12,13,0,13,2,24,6,0,0,2023-2024,0.11764705882352941,1.2941176470588236
581,Joaquín Correa,ARG,"FW,MF",Marseille,Ligue 1,28,1994,4.8,7,5,4,2,1,0,8,0.0,8,2,0,2,1,8,1,0,0,2023-2024,0.20833333333333334,1.4583333333333335
582,Thierry Correia,POR,DF,Valencia,La Liga,24,1999,23.9,63,35,39,20,4,28,49,57.1,21,39,16,23,33,96,61,0,0,2023-2024,1.380753138075314,2.6359832635983267
583,Oscar Cortés,COL,"FW,MF",Lens,Ligue 1,19,2003,0.5,0,0,0,0,0,0,0,0.0,0,1,0,1,0,0,0,0,0,2023-2024,0.0,0.0
584,Danny da Costa,GER,DF,Mainz 05,Bundesliga,30,1993,9.2,18,9,9,7,2,9,19,47.4,10,17,4,13,16,34,24,0,0,2023-2024,1.7391304347826089,1.956521739130435
585,David Pereira da Costa,POR,MF,Lens,Ligue 1,22,2001,16.6,18,10,5,12,1,10,23,43.5,13,21,4,17,16,34,8,1,0,2023-2024,0.9638554216867469,1.0843373493975903
586,Jaume Costa,ESP,DF,Mallorca,La Liga,35,1988,18.7,38,22,23,10,5,18,29,62.1,11,14,4,10,16,54,35,0,0,2023-2024,0.8556149732620321,2.0320855614973263
587,João Costa,BRA,"MF,FW",Roma,Serie A,18,2005,0.2,0,0,0,0,0,0,0,0.0,0,0,0,0,0,0,0,0,0,2023-2024,0.0,0.0
588,Logan Costa,CPV,DF,Toulouse,Ligue 1,22,2001,29.4,40,24,31,9,0,15,24,62.5,9,42,27,15,23,63,120,1,0,2023-2024,0.7823129251700681,1.3605442176870748
589,Samu Costa,POR,MF,Mallorca,La Liga,22,2000,25.6,91,50,40,46,5,46,93,49.5,47,28,14,14,39,130,59,3,0,2023-2024,1.5234375,3.5546875
590,Benoît Costil,FRA,GK,Salernitana,Serie A,36,1987,13.0,2,1,1,1,0,2,3,66.7,1,0,0,0,0,2,5,1,0,2023-2024,0.0,0.15384615384615385
591,Grégoire Coudert,FRA,GK,Brest,Ligue 1,24,1999,2.0,0,0,0,0,0,0,0,0.0,0,0,0,0,0,0,0,0,0,2023-2024,0.0,0.0
592,Vladimír Coufal,CZE,DF,West Ham,Premier League,30,1992,34.8,64,41,50,12,2,38,75,50.7,37,49,15,34,43,107,97,0,0,2023-2024,1.2356321839080462,1.8390804597701151
593,Lassana Coulibaly,MLI,MF,Salernitana,Serie A,27,1996,23.1,47,32,20,21,6,22,49,44.9,27,23,5,18,16,63,29,0,0,2023-2024,0.6926406926406926,2.0346320346320343
594,Mamadou Coulibaly,SEN,DF,Salernitana,Serie A,24,1999,0.0,0,0,0,0,0,0,0,0.0,0,0,0,0,0,0,0,0,0,2023-2024,,
595,Mamadou Coulibaly,FRA,MF,Monaco,Ligue 1,19,2004,1.3,7,4,2,3,2,3,8,37.5,5,4,0,4,0,7,0,0,0,2023-2024,0.0,5.384615384615384
596,Tanguy Coulibaly,FRA,"FW,MF",Montpellier,Ligue 1,22,2001,6.9,13,11,8,4,1,4,9,44.4,5,11,1,10,2,15,2,0,0,2023-2024,0.2898550724637681,1.8840579710144927
597,Thibaut Courtois,BEL,GK,Real Madrid,La Liga,31,1992,3.7,1,0,1,0,0,0,0,0.0,0,0,0,0,0,1,0,0,0,2023-2024,0.0,0.27027027027027023
598,Philippe Coutinho,BRA,"MF,FW",Aston Villa,Premier League,31,1992,0.3,0,0,0,0,0,0,1,0.0,1,0,0,0,0,0,0,0,0,2023-2024,0.0,0.0
599,Yan Couto,BRA,"DF,FW",Girona,La Liga,21,2002,24.9,45,34,25,14,6,20,40,50.0,20,14,2,12,10,55,31,1,0,2023-2024,0.40160642570281124,1.8072289156626506
600,Nicolas Cozza,FRA,DF,Nantes,Ligue 1,24,1999,9.9,35,23,23,10,2,17,24,70.8,7,7,0,7,14,49,32,0,0,2023-2024,1.4141414141414141,3.535353535353535
Rk,Player,Nation,Pos,Squad,Comp,0,0,90.0,0,0,3,3,3,Tkl,0,0.0,0,0,0,0,0,0,0,0,0,2023-2024,0.0,0.0
601,Nicolas Cozza,FRA,DF,Wolfsburg,Bundesliga,24,1999,3.1,8,6,4,4,0,2,7,28.6,5,3,0,3,4,12,6,0,0,2023-2024,1.2903225806451613,2.5806451612903225
602,Alessio Cragno,ITA,GK,Sassuolo,Serie A,29,1994,3.0,0,0,0,0,0,0,0,0.0,0,0,0,0,0,0,3,1,0,2023-2024,0.0,0.0
603,Crespo,POR,MF,Rayo Vallecano,La Liga,26,1996,5.9,16,9,8,6,2,9,17,52.9,8,15,6,9,10,26,7,0,0,2023-2024,1.694915254237288,2.711864406779661
604,Aaron Cresswell,ENG,"DF,FW",West Ham,Premier League,33,1989,4.8,3,2,1,1,1,2,3,66.7,1,5,3,2,3,6,7,0,0,2023-2024,0.625,0.625
605,Bryan Cristante,ITA,"MF,DF",Roma,Serie A,28,1995,36.5,72,41,33,28,11,28,50,56.0,22,36,6,30,25,97,55,2,0,2023-2024,0.684931506849315,1.9726027397260273
606,Cristian,ESP,GK,Valencia,La Liga,25,1998,0.6,0,0,0,0,0,0,0,0.0,0,0,0,0,0,0,0,0,0,2023-2024,0.0,0.0
607,Juan Cruz Armada,ESP,DF,Osasuna,La Liga,31,1992,18.5,27,15,16,10,1,17,25,68.0,8,14,7,7,12,39,39,1,0,2023-2024,0.6486486486486487,1.4594594594594594
608,Juan Cruz,ARG,"FW,MF",Hellas Verona,Serie A,24,1999,1.2,2,2,0,0,2,0,0,0.0,0,1,0,1,1,3,0,0,0,2023-2024,0.8333333333333334,1.6666666666666667
609,Juan Cruz,ESP,FW,Betis,La Liga,23,2000,0.8,0,0,0,0,0,0,1,0.0,1,0,0,0,0,0,0,0,0,2023-2024,0.0,0.0
610,Juan Cuadrado,COL,DF,Inter,Serie A,35,1988,3.0,4,3,2,2,0,3,5,60.0,2,6,1,5,1,5,2,0,0,2023-2024,0.3333333333333333,1.3333333333333333
611,Pau Cubarsí,ESP,DF,Barcelona,La Liga,16,2007,17.3,22,14,18,3,1,13,18,72.2,5,20,16,4,12,34,65,0,0,2023-2024,0.6936416184971098,1.2716763005780347
612,Marc Cucurella,ESP,DF,Chelsea,Premier League,25,1998,19.8,62,38,36,21,5,34,64,53.1,30,36,13,23,22,84,48,0,0,2023-2024,1.1111111111111112,3.131313131313131
613,Iván Cuéllar,ESP,GK,Mallorca,La Liga,39,1984,1.0,0,0,0,0,0,0,0,0.0,0,0,0,0,0,0,0,0,0,2023-2024,0.0,0.0
614,Jorge Cuenca,ESP,DF,Villarreal,La Liga,23,1999,21.8,42,29,26,10,6,19,30,63.3,11,26,15,11,21,63,114,0,0,2023-2024,0.963302752293578,1.926605504587156
615,Josh Cullen,IRL,MF,Burnley,Premier League,27,1996,22.9,42,29,15,22,5,26,46,56.5,20,31,19,12,15,57,26,1,0,2023-2024,0.6550218340611355,1.834061135371179
616,Matheus Cunha,BRA,"FW,MF",Wolves,Premier League,24,1999,27.1,30,16,8,17,5,13,35,37.1,22,28,7,21,13,43,21,1,0,2023-2024,0.4797047970479705,1.107011070110701
617,Marvin Cuni,ALB,FW,Frosinone,Serie A,22,2001,5.9,8,3,1,3,4,3,4,75.0,1,10,1,9,1,9,0,0,0,2023-2024,0.1694915254237288,1.3559322033898304
618,Eric Curbelo,ESP,"DF,MF",Las Palmas,La Liga,29,1994,1.1,4,3,2,2,0,3,4,75.0,1,3,1,2,2,6,5,1,0,2023-2024,1.8181818181818181,3.6363636363636362
619,Sam Curtis,IRL,DF,Sheffield Utd,Premier League,17,2005,0.3,1,0,1,0,0,1,2,50.0,1,2,0,2,0,1,0,0,0,2023-2024,0.0,3.3333333333333335
620,Tomáš Čvančara,CZE,FW,Gladbach,Bundesliga,22,2000,10.0,4,3,0,2,2,1,3,33.3,2,5,1,4,2,6,8,0,0,2023-2024,0.2,0.4
621,Danilo D'Ambrosio,ITA,DF,Monza,Serie A,34,1988,17.1,57,34,34,20,3,28,41,68.3,13,22,13,9,14,71,31,0,0,2023-2024,0.8187134502923976,3.333333333333333
622,Alberto Dadie,ESP,MF,Real Sociedad,La Liga,21,2002,0.3,2,1,2,0,0,0,0,0.0,0,1,0,1,0,2,0,0,0,2023-2024,0.0,6.666666666666667
623,Trévis Dago,CIV,"FW,MF",Lille,Ligue 1,18,2005,0.3,0,0,0,0,0,0,0,0.0,0,0,0,0,1,1,0,0,0,2023-2024,3.3333333333333335,0.0
624,Finn Dahmen,GER,GK,Augsburg,Bundesliga,25,1998,31.0,1,0,1,0,0,1,3,33.3,2,0,0,0,0,1,17,5,0,2023-2024,0.0,0.03225806451612903
625,Mahmoud Dahoud,GER,MF,Brighton,Premier League,27,1996,5.0,9,4,2,4,3,3,9,33.3,6,4,1,3,1,10,5,0,0,2023-2024,0.2,1.8
Rk,Player,Nation,Pos,Squad,Comp,0,0,90.0,0,0,3,3,3,Tkl,0,0.0,0,0,0,0,0,0,0,0,0,2023-2024,0.0,0.0
626,Mahmoud Dahoud,GER,MF,Stuttgart,Bundesliga,27,1996,2.5,5,1,1,4,0,3,7,42.9,4,4,0,4,0,5,1,0,0,2023-2024,0.0,2.0
627,Ameen Al-Dakhil,BEL,DF,Burnley,Premier League,21,2002,11.7,12,5,4,7,1,1,10,10.0,9,13,6,7,12,24,38,2,0,2023-2024,1.0256410256410258,1.0256410256410258
628,Thijs Dallinga,NED,FW,Toulouse,Ligue 1,22,2000,27.9,29,15,6,11,12,9,15,60.0,6,11,4,7,3,32,35,0,0,2023-2024,0.10752688172043011,1.039426523297491
629,Diogo Dalot,POR,DF,Manchester Utd,Premier League,24,1999,35.3,81,51,58,12,11,51,74,68.9,23,44,16,28,37,118,111,0,0,2023-2024,1.048158640226629,2.294617563739377
630,Mikkel Damsgaard,DEN,MF,Brentford,Premier League,23,2000,9.4,29,17,13,9,7,14,40,35.0,26,23,1,22,11,40,10,1,0,2023-2024,1.1702127659574468,3.085106382978723
631,Flavius Daniliuc,AUT,DF,Salernitana,Serie A,22,2001,8.3,19,11,12,5,2,9,19,47.4,10,13,4,9,8,27,15,0,0,2023-2024,0.9638554216867469,2.2891566265060237
632,Danilo,BRA,MF,Nott'ham Forest,Premier League,22,2001,19.9,36,18,22,12,2,21,46,45.7,25,33,8,25,35,71,42,0,0,2023-2024,1.7587939698492463,1.8090452261306533
633,Danilo,BRA,DF,Juventus,Serie A,32,1991,27.2,60,36,38,18,4,32,48,66.7,16,34,15,19,37,97,94,0,0,2023-2024,1.3602941176470589,2.2058823529411766
634,Arnaut Danjuma,NED,"MF,FW",Everton,Premier League,26,1997,6.6,6,4,2,3,1,1,4,25.0,3,4,0,4,3,9,0,0,0,2023-2024,0.4545454545454546,0.9090909090909092
635,Jayden Danns,ENG,FW,Liverpool,Premier League,17,2006,0.1,0,0,0,0,0,0,0,0.0,0,0,0,0,0,0,0,0,0,2023-2024,0.0,0.0
636,Kevin Danso,AUT,DF,Lens,Ligue 1,24,1998,29.5,24,14,12,11,1,15,30,50.0,15,43,30,13,23,47,115,1,0,2023-2024,0.7796610169491526,0.8135593220338984
637,Dante,BRA,DF,Nice,Ligue 1,39,1983,31.6,62,30,44,16,2,38,52,73.1,14,43,22,21,37,99,77,2,0,2023-2024,1.1708860759493671,1.9620253164556962
638,Raimane Daou,COM,"DF,MF",Marseille,Ligue 1,18,2004,0.3,1,1,1,0,0,1,2,50.0,1,0,0,0,0,1,2,0,0,2023-2024,0.0,3.3333333333333335
639,Mohammed Daramy,DEN,"FW,MF",Reims,Ligue 1,21,2002,18.3,10,9,4,4,2,6,16,37.5,10,5,1,4,4,14,4,0,0,2023-2024,0.2185792349726776,0.5464480874316939
640,Sergi Darder,ESP,MF,Mallorca,La Liga,29,1993,24.0,39,26,13,21,5,12,31,38.7,19,20,4,16,16,55,16,0,0,2023-2024,0.6666666666666666,1.625
641,Achraf Dari,MAR,"DF,FW",Brest,Ligue 1,24,1999,1.3,1,1,1,0,0,0,2,0.0,2,2,0,2,5,6,9,1,0,2023-2024,3.846153846153846,0.7692307692307692
642,Matteo Darmian,ITA,DF,Inter,Serie A,33,1989,26.7,48,22,23,15,10,20,53,37.7,33,27,11,16,13,61,55,0,0,2023-2024,0.4868913857677903,1.797752808988764
643,Lukas Daschner,GER,"MF,FW",Bochum,Bundesliga,24,1998,6.0,9,4,2,3,4,4,9,44.4,5,7,0,7,2,11,2,0,0,2023-2024,0.3333333333333333,1.5
644,Josh Dasilva,ENG,"DF,FW",Brentford,Premier League,24,1998,0.3,2,1,0,1,1,0,0,0.0,0,0,0,0,0,2,0,0,0,2023-2024,0.0,6.666666666666667
645,David Datro Fofana,CIV,FW,Burnley,Premier League,20,2002,9.8,10,5,3,5,2,3,6,50.0,3,9,3,6,1,11,2,0,0,2023-2024,0.1020408163265306,1.0204081632653061
646,David Datro Fofana,CIV,"FW,MF",Union Berlin,Bundesliga,20,2002,7.6,10,7,3,5,2,4,9,44.4,5,4,0,4,0,10,5,0,0,2023-2024,0.0,1.3157894736842106
647,Juan David Cabal,COL,DF,Hellas Verona,Serie A,22,2001,16.6,36,27,19,14,3,18,29,62.1,11,30,9,21,26,62,55,2,0,2023-2024,1.5662650602409638,2.1686746987951806
648,Jonathan David,CAN,FW,Lille,Ligue 1,23,2000,29.2,26,15,6,13,7,8,26,30.8,18,16,0,16,9,35,4,0,0,2023-2024,0.3082191780821918,0.8904109589041096
649,Alphonso Davies,CAN,DF,Bayern Munich,Bundesliga,22,2000,22.9,47,24,29,13,5,30,53,56.6,23,30,4,26,26,73,49,1,0,2023-2024,1.1353711790393013,2.052401746724891
650,Ben Davies,WAL,DF,Tottenham,Premier League,30,1993,12.1,24,17,13,8,3,16,21,76.2,5,17,15,2,10,34,35,0,0,2023-2024,0.8264462809917356,1.9834710743801653
Rk,Player,Nation,Pos,Squad,Comp,0,0,90.0,0,0,3,3,3,Tkl,0,0.0,0,0,0,0,0,0,0,0,0,2023-2024,0.0,0.0
651,Tom Davies,ENG,MF,Sheffield Utd,Premier League,25,1998,2.5,10,5,4,3,3,3,9,33.3,6,2,1,1,3,13,6,1,0,2023-2024,1.2,4.0
652,Keinan Davis,ENG,"FW,MF",Udinese,Serie A,25,1998,2.1,0,0,0,0,0,0,0,0.0,0,0,0,0,0,0,3,0,0,2023-2024,0.0,0.0
653,Paweł Dawidowicz,POL,DF,Hellas Verona,Serie A,28,1995,23.8,53,30,33,18,2,17,29,58.6,12,17,9,8,24,77,114,1,0,2023-2024,1.0084033613445378,2.226890756302521
654,Craig Dawson,ENG,DF,Wolves,Premier League,33,1990,24.5,30,20,23,6,1,22,34,64.7,12,51,39,12,16,46,120,1,0,2023-2024,0.6530612244897959,1.2244897959183674
655,Kevin De Bruyne,BEL,MF,Manchester City,Premier League,32,1991,13.6,14,9,1,5,8,7,20,35.0,13,5,0,5,4,18,4,0,0,2023-2024,0.29411764705882354,1.0294117647058825
656,Charles De Ketelaere,BEL,"FW,MF",Atalanta,Serie A,22,2001,22.5,33,21,3,12,18,10,20,50.0,10,30,2,28,7,40,6,0,0,2023-2024,0.3111111111111111,1.4666666666666666
657,Rodrigo De Paul,ARG,MF,Atlético Madrid,La Liga,29,1994,23.1,31,21,11,14,6,15,38,39.5,23,28,1,27,11,42,15,2,0,2023-2024,0.47619047619047616,1.3419913419913418
658,Mattia De Sciglio,ITA,DF,Juventus,Serie A,30,1992,0.5,0,0,0,0,0,0,0,0.0,0,1,0,1,1,1,2,0,0,2023-2024,2.0,0.0
659,Lorenzo De Silvestri,ITA,DF,Bologna,Serie A,35,1988,7.5,10,8,5,2,3,4,7,57.1,3,9,4,5,6,16,27,0,0,2023-2024,0.8,1.3333333333333333
660,Thibault De Smet,BEL,DF,Reims,Ligue 1,25,1998,20.3,56,35,36,16,4,33,59,55.9,26,25,5,20,21,77,51,1,0,2023-2024,1.0344827586206897,2.758620689655172
661,Koni De Winter,BEL,DF,Genoa,Serie A,21,2002,26.4,44,25,26,13,5,21,31,67.7,10,30,10,20,21,65,78,0,0,2023-2024,0.7954545454545455,1.6666666666666667
662,Grégoire Defrel,MTQ,"FW,MF",Sassuolo,Serie A,32,1991,8.4,17,8,7,5,5,7,15,46.7,8,10,0,10,3,20,9,0,0,2023-2024,0.35714285714285715,2.0238095238095237
663,Alessandro Deiola,ITA,MF,Cagliari,Serie A,27,1995,17.9,33,19,13,16,4,18,47,38.3,29,16,6,10,9,42,37,0,0,2023-2024,0.5027932960893855,1.8435754189944136
664,Romain Del Castillo,FRA,FW,Brest,Ligue 1,27,1996,27.7,46,29,14,18,14,18,70,25.7,52,33,1,32,9,55,8,0,0,2023-2024,0.3249097472924188,1.660649819494585
665,Thomas Delaine,FRA,"DF,MF",Strasbourg,Ligue 1,31,1992,22.7,38,19,29,8,1,20,42,47.6,22,18,2,16,17,55,51,0,0,2023-2024,0.748898678414097,1.6740088105726874
666,Sacha Delaye,FRA,"MF,FW",Montpellier,Ligue 1,21,2002,1.4,7,2,2,2,3,1,6,16.7,5,2,0,2,0,7,1,0,0,2023-2024,0.0,5.0
667,Hannes Delcroix,BEL,DF,Burnley,Premier League,24,1999,6.5,10,6,6,4,0,3,4,75.0,1,9,3,6,9,19,26,0,0,2023-2024,1.3846153846153846,1.5384615384615385
668,Alessandro Dellavalle,ITA,DF,Torino,Serie A,19,2004,0.2,0,0,0,0,0,0,0,0.0,0,1,1,0,1,1,0,0,0,2023-2024,5.0,0.0
669,Olivier Deman,BEL,DF,Werder Bremen,Bundesliga,23,2000,15.2,28,15,21,4,3,18,38,47.4,20,24,8,16,14,42,49,1,0,2023-2024,0.9210526315789475,1.842105263157895
670,Karamoko Dembélé,ENG,"MF,FW",Brest,Ligue 1,20,2003,0.2,0,0,0,0,0,0,0,0.0,0,0,0,0,0,0,0,0,0,2023-2024,0.0,0.0
671,Ousmane Dembélé,FRA,"MF,FW",Paris S-G,Ligue 1,26,1997,16.7,19,14,2,7,10,6,13,46.2,7,11,0,11,5,24,4,1,0,2023-2024,0.29940119760479045,1.1377245508982037
672,Jessy Deminguet,FRA,"MF,FW",Strasbourg,Ligue 1,25,1998,7.7,14,9,6,8,0,6,18,33.3,12,8,0,8,9,23,5,1,0,2023-2024,1.1688311688311688,1.8181818181818181
673,Ermedin Demirović,BIH,"FW,MF",Augsburg,Bundesliga,25,1998,31.9,24,14,5,16,3,12,40,30.0,28,28,2,26,11,35,26,0,0,2023-2024,0.3448275862068966,0.7523510971786834
674,Diego Demme,GER,MF,Napoli,Serie A,31,1991,0.8,1,1,0,1,0,0,1,0.0,1,0,0,0,0,1,0,0,0,2023-2024,0.0,1.25
675,Sepp van den Berg,NED,DF,Mainz 05,Bundesliga,21,2001,31.5,38,23,20,15,3,15,26,57.7,11,66,36,30,43,81,159,2,0,2023-2024,1.3650793650793651,1.2063492063492063
Rk,Player,Nation,Pos,Squad,Comp,0,0,90.0,0,0,3,3,3,Tkl,0,0.0,0,0,0,0,0,0,0,0,0,2023-2024,0.0,0.0
676,Leander Dendoncker,BEL,MF,Aston Villa,Premier League,28,1995,1.3,6,4,3,2,1,4,5,80.0,1,5,2,3,2,8,3,1,0,2023-2024,1.5384615384615383,4.615384615384615
677,Leander Dendoncker,BEL,MF,Napoli,Serie A,28,1995,0.3,0,0,0,0,0,0,0,0.0,0,1,1,0,0,0,0,0,0,2023-2024,0.0,0.0
678,Rémy Descamps,FRA,GK,Nantes,Ligue 1,27,1996,6.0,0,0,0,0,0,0,0,0.0,0,0,0,0,0,0,7,0,0,2023-2024,0.0,0.0
679,Mikkel Desler,DEN,DF,Toulouse,Ligue 1,28,1995,17.2,18,12,8,7,3,9,17,52.9,8,32,13,19,19,37,38,0,0,2023-2024,1.1046511627906976,1.0465116279069768
680,Arthur Desmas,FRA,GK,Le Havre,Ligue 1,29,1994,33.0,0,0,0,0,0,0,2,0.0,2,0,0,0,0,0,13,1,0,2023-2024,0.0,0.0
681,Mattia Destro,ITA,"FW,MF",Empoli,Serie A,32,1991,4.1,2,1,0,2,0,1,1,100.0,0,4,0,4,2,4,3,0,0,2023-2024,0.48780487804878053,0.48780487804878053
682,Samuele Di Benedetto,GER,MF,Stuttgart,Bundesliga,18,2005,0.1,0,0,0,0,0,0,0,0.0,0,0,0,0,1,1,0,0,0,2023-2024,10.0,0.0
683,Federico Di Francesco,ITA,"FW,MF",Lecce,Serie A,29,1994,0.2,1,0,0,1,0,0,0,0.0,0,0,0,0,0,1,0,0,0,2023-2024,0.0,5.0
684,Raffaele Di Gennaro,ITA,GK,Inter,Serie A,29,1993,0.3,0,0,0,0,0,0,0,0.0,0,0,0,0,0,0,0,0,0,2023-2024,0.0,0.0
685,Michele Di Gregorio,ITA,GK,Monza,Serie A,26,1997,31.9,1,0,1,0,0,1,4,25.0,3,1,0,1,1,2,10,2,0,2023-2024,0.031347962382445145,0.031347962382445145
686,Giovanni Di Lorenzo,ITA,DF,Napoli,Serie A,29,1993,35.9,58,36,26,26,6,32,68,47.1,36,43,16,27,24,82,45,0,0,2023-2024,0.6685236768802229,1.615598885793872
687,Alessandro Di Pardo,ITA,"DF,MF",Cagliari,Serie A,24,1999,4.0,4,1,3,0,1,0,3,0.0,3,9,2,7,5,9,7,0,0,2023-2024,1.25,1.0
688,Boulaye Dia,SEN,"FW,MF",Salernitana,Serie A,26,1996,12.7,4,2,2,2,0,1,3,33.3,2,5,0,5,3,7,7,0,0,2023-2024,0.2362204724409449,0.31496062992125984
689,Moussa Diaby,FRA,"FW,MF",Aston Villa,Premier League,24,1999,24.2,12,5,5,4,3,4,22,18.2,18,8,1,7,9,21,6,0,0,2023-2024,0.37190082644628103,0.49586776859504134
690,Lamine Diack,SEN,MF,Nantes,Ligue 1,22,2000,0.0,0,0,0,0,0,0,0,0.0,0,0,0,0,0,0,0,0,0,2023-2024,,
691,Mouctar Diakhaby,GUI,"DF,MF",Valencia,La Liga,26,1996,11.9,18,11,9,9,0,11,13,84.6,2,17,7,10,11,29,62,0,0,2023-2024,0.9243697478991596,1.5126050420168067
692,Mamadou Diakhon,FRA,"FW,MF",Reims,Ligue 1,17,2005,2.3,5,3,2,1,2,3,9,33.3,6,1,0,1,1,6,1,0,0,2023-2024,0.4347826086956522,2.173913043478261
693,Bafodé Diakité,FRA,DF,Lille,Ligue 1,22,2001,18.8,29,20,12,15,2,24,32,75.0,8,16,8,8,21,50,49,1,0,2023-2024,1.1170212765957446,1.5425531914893615
694,Ibrahim Diakité,GUI,DF,Reims,Ligue 1,19,2003,1.2,1,0,0,1,0,0,1,0.0,1,3,0,3,2,3,5,0,0,2023-2024,1.6666666666666667,0.8333333333333334
695,Moussa Diakité,MLI,MF,Cádiz,La Liga,19,2003,0.0,0,0,0,0,0,0,0,0.0,0,0,0,0,0,0,0,0,0,2023-2024,,
696,Oumar Diakité,CIV,FW,Reims,Ligue 1,19,2003,17.6,25,12,10,9,6,7,21,33.3,14,13,0,13,7,32,7,0,0,2023-2024,0.3977272727272727,1.4204545454545454
697,Amad Diallo,CIV,"FW,MF",Manchester Utd,Premier League,21,2002,4.3,10,3,1,6,3,3,7,42.9,4,3,1,2,1,11,6,0,0,2023-2024,0.23255813953488372,2.3255813953488373
698,Amadou Diallo,ENG,MF,Newcastle Utd,Premier League,20,2003,0.0,0,0,0,0,0,0,0,0.0,0,0,0,0,0,0,0,0,0,2023-2024,,
699,Assane Diao,ESP,FW,Betis,La Liga,17,2005,11.6,20,12,5,9,6,6,17,35.3,11,22,4,18,7,27,7,0,0,2023-2024,0.603448275862069,1.7241379310344829
700,Habib Diarra,SEN,"MF,FW",Strasbourg,Ligue 1,19,2004,25.6,30,23,8,20,2,9,33,27.3,24,23,4,19,17,47,15,0,0,2023-2024,0.6640625,1.171875
Rk,Player,Nation,Pos,Squad,Comp,0,0,90.0,0,0,3,3,3,Tkl,0,0.0,0,0,0,0,0,0,0,0,0,2023-2024,0.0,0.0
701,Moussa Diarra,MLI,DF,Toulouse,Ligue 1,22,2000,15.5,32,12,16,15,1,13,27,48.1,14,30,14,16,20,52,43,0,0,2023-2024,1.2903225806451613,2.064516129032258
702,Rúben Dias,POR,DF,Manchester City,Premier League,26,1997,28.4,39,20,14,21,4,19,26,73.1,7,32,17,15,30,69,77,0,0,2023-2024,1.0563380281690142,1.3732394366197185
703,Krépin Diatta,SEN,"DF,FW",Monaco,Ligue 1,24,1999,13.4,37,20,17,16,4,27,49,55.1,22,17,2,15,16,53,22,0,0,2023-2024,1.1940298507462686,2.761194029850746
704,Mory Diaw,SEN,GK,Clermont Foot,Ligue 1,30,1993,30.0,1,1,1,0,0,1,2,50.0,1,0,0,0,1,2,13,5,0,2023-2024,0.03333333333333333,0.03333333333333333
705,Mahamadou Diawara,FRA,MF,Lyon,Ligue 1,18,2005,4.0,9,6,4,5,0,3,11,27.3,8,4,1,3,4,13,4,0,0,2023-2024,1.0,2.25
706,Brahim Díaz,MAR,"FW,MF",Real Madrid,La Liga,23,1999,17.2,29,19,4,16,9,6,13,46.2,7,16,1,15,5,34,2,0,0,2023-2024,0.29069767441860467,1.686046511627907
707,Luis Díaz,COL,FW,Liverpool,Premier League,26,1997,29.2,35,25,5,17,13,7,30,23.3,23,15,0,15,3,38,8,0,0,2023-2024,0.10273972602739727,1.1986301369863015
708,Víctor Díaz,ESP,"DF,MF",Granada,La Liga,35,1988,1.8,5,3,2,3,0,1,3,33.3,2,1,0,1,1,6,8,0,0,2023-2024,0.5555555555555556,2.7777777777777777
709,Famara Diedhiou,SEN,"FW,MF",Granada,La Liga,30,1992,1.0,1,1,0,1,0,0,1,0.0,1,0,0,0,0,1,2,0,0,2023-2024,0.0,1.0
710,Justin Diehl,GER,"FW,MF",Köln,Bundesliga,18,2004,1.9,0,0,0,0,0,0,0,0.0,0,1,1,0,0,0,0,1,0,2023-2024,0.0,0.0
711,Bamba Dieng,SEN,FW,Lorient,Ligue 1,23,2000,6.1,3,3,0,3,0,1,3,33.3,2,3,0,3,0,3,7,0,0,2023-2024,0.0,0.49180327868852464
712,Eric Dier,ENG,DF,Tottenham,Premier League,29,1994,2.2,2,1,2,0,0,2,2,100.0,0,3,3,0,2,4,12,0,0,2023-2024,0.9090909090909091,0.9090909090909091
713,Eric Dier,ENG,DF,Bayern Munich,Bundesliga,29,1994,13.0,11,8,5,5,1,5,6,83.3,1,20,12,8,10,21,48,1,0,2023-2024,0.7692307692307693,0.8461538461538461
714,Guillaume Dietsch,FRA,GK,Metz,Ligue 1,22,2001,0.8,0,0,0,0,0,0,0,0.0,0,0,0,0,0,0,0,0,0,2023-2024,0.0,0.0
715,Florian Dietz,GER,"FW,MF",Köln,Bundesliga,24,1998,0.8,0,0,0,0,0,0,0,0.0,0,1,0,1,0,0,0,0,0,2023-2024,0.0,0.0
716,Lucas Digne,FRA,DF,Aston Villa,Premier League,30,1993,26.8,47,19,35,9,3,25,44,56.8,19,20,2,18,26,73,67,0,0,2023-2024,0.9701492537313433,1.753731343283582
717,Federico Dimarco,ITA,DF,Inter,Serie A,25,1997,23.1,42,25,19,14,9,17,35,48.6,18,18,3,15,9,51,34,1,0,2023-2024,0.3896103896103896,1.8181818181818181
718,Stole Dimitrievski,MKD,GK,Rayo Vallecano,La Liga,29,1993,37.0,1,1,1,0,0,1,1,100.0,0,0,0,0,0,1,17,3,0,2023-2024,0.0,0.02702702702702703
719,Junior Dina Ebimbe,FRA,"MF,DF",Eint Frankfurt,Bundesliga,22,2000,21.7,44,29,15,17,12,18,41,43.9,23,28,7,21,9,53,39,1,0,2023-2024,0.4147465437788019,2.0276497695852536
720,Eren Dinkçi,GER,"FW,MF",Heidenheim,Bundesliga,21,2001,29.4,32,18,16,13,3,19,48,39.6,29,40,4,36,12,44,21,0,0,2023-2024,0.40816326530612246,1.08843537414966
721,Sinaly Diomande,CIV,DF,Lyon,Ligue 1,22,2001,9.9,10,4,5,3,2,9,16,56.3,7,12,9,3,15,25,26,1,0,2023-2024,1.5151515151515151,1.0101010101010102
722,Edan Diop,FRA,"MF,DF",Monaco,Ligue 1,18,2004,1.8,10,8,6,3,1,7,9,77.8,2,3,0,3,1,11,5,0,0,2023-2024,0.5555555555555556,5.555555555555555
723,Issa Diop,FRA,DF,Fulham,Premier League,26,1997,15.8,30,16,23,5,2,15,20,75.0,5,28,19,9,17,47,80,1,0,2023-2024,1.0759493670886076,1.8987341772151898
724,Sofiane Diop,FRA,FW,Nice,Ligue 1,23,2000,5.5,8,6,3,4,1,4,10,40.0,6,4,0,4,3,11,3,0,0,2023-2024,0.5454545454545454,1.4545454545454546
725,Andy Diouf,FRA,MF,Lens,Ligue 1,20,2003,14.6,28,19,12,11,5,14,22,63.6,8,13,3,10,3,31,5,1,0,2023-2024,0.20547945205479454,1.9178082191780823
Rk,Player,Nation,Pos,Squad,Comp,0,0,90.0,0,0,3,3,3,Tkl,0,0.0,0,0,0,0,0,0,0,0,0,2023-2024,0.0,0.0
726,Yehvann Diouf,FRA,GK,Reims,Ligue 1,23,1999,34.0,0,0,0,0,0,0,1,0.0,1,0,0,0,1,1,19,3,0,2023-2024,0.029411764705882353,0.0
727,Axel Disasi,FRA,DF,Chelsea,Premier League,25,1998,28.7,33,19,20,10,3,23,30,76.7,7,26,19,7,18,51,102,2,0,2023-2024,0.6271777003484321,1.1498257839721255
728,Tiago Djaló,POR,DF,Juventus,Serie A,23,2000,0.2,0,0,0,0,0,0,0,0.0,0,1,0,1,0,0,1,0,0,2023-2024,0.0,0.0
729,Chaim El Djebali,TUN,MF,Lyon,Ligue 1,19,2004,0.1,0,0,0,0,0,0,0,0.0,0,0,0,0,0,0,0,0,0,2023-2024,0.0,0.0
730,Djené,TOG,"DF,MF",Getafe,La Liga,31,1991,27.6,34,19,18,13,3,15,26,57.7,11,31,15,16,23,57,70,0,0,2023-2024,0.8333333333333333,1.2318840579710144
731,Koffi Djidji,CIV,DF,Torino,Serie A,30,1992,8.4,14,9,9,5,0,3,4,75.0,1,10,5,5,10,24,20,0,0,2023-2024,1.1904761904761905,1.6666666666666665
732,Berat Djimsiti,ALB,DF,Atalanta,Serie A,30,1993,31.5,42,24,29,12,1,19,31,61.3,12,53,33,20,57,99,100,0,0,2023-2024,1.8095238095238095,1.3333333333333333
733,Marko Dmitrović,SRB,GK,Sevilla,La Liga,31,1992,13.0,1,1,1,0,0,1,2,50.0,1,0,0,0,1,2,5,0,0,2023-2024,0.07692307692307693,0.07692307692307693
734,Ben Doak,SCO,FW,Liverpool,Premier League,17,2005,0.2,0,0,0,0,0,0,0,0.0,0,0,0,0,0,0,0,0,0,2023-2024,0.0,0.0
735,Ritsu Doan,JPN,"DF,MF",Freiburg,Bundesliga,25,1998,25.0,50,27,21,19,10,21,36,58.3,15,30,3,27,9,59,29,0,0,2023-2024,0.36,2.0
736,Lewis Dobbin,ENG,MF,Everton,Premier League,20,2003,2.6,9,7,3,5,1,5,9,55.6,4,5,1,4,1,10,0,0,0,2023-2024,0.3846153846153846,3.4615384615384612
737,Dodô,BRA,DF,Fiorentina,Serie A,24,1998,5.8,5,3,1,4,0,2,5,40.0,3,2,0,2,5,10,11,0,0,2023-2024,0.8620689655172414,0.8620689655172414
738,Danilho Doekhi,NED,DF,Union Berlin,Bundesliga,25,1998,24.0,34,23,18,16,0,15,21,71.4,6,46,25,21,38,72,111,1,0,2023-2024,1.5833333333333333,1.4166666666666667
739,Matt Doherty,IRL,"DF,MF",Wolves,Premier League,31,1992,12.8,31,18,17,10,4,12,23,52.2,11,15,5,10,7,38,47,0,0,2023-2024,0.546875,2.421875
740,Josh Doig,SCO,DF,Hellas Verona,Serie A,21,2002,9.2,16,9,9,7,0,13,17,76.5,4,12,3,9,4,20,17,1,0,2023-2024,0.4347826086956522,1.7391304347826089
741,Josh Doig,SCO,DF,Sassuolo,Serie A,21,2002,14.9,25,17,16,9,0,15,27,55.6,12,31,10,21,16,41,38,0,0,2023-2024,1.0738255033557047,1.6778523489932886
742,Jeremy Doku,BEL,"FW,MF",Manchester City,Premier League,21,2002,17.7,39,22,13,12,14,9,20,45.0,11,14,0,14,9,48,5,0,0,2023-2024,0.5084745762711864,2.2033898305084745
743,Jeremy Doku,BEL,FW,Rennes,Ligue 1,21,2002,1.2,2,2,1,0,1,1,1,100.0,0,0,0,0,0,2,0,0,0,2023-2024,0.0,1.6666666666666667
744,Jaume Doménech,ESP,GK,Valencia,La Liga,32,1990,0.9,0,0,0,0,0,0,0,0.0,0,0,0,0,0,0,0,0,0,2023-2024,0.0,0.0
745,Carlos Dominguez,ESP,DF,Celta Vigo,La Liga,22,2001,17.6,33,21,17,9,7,23,37,62.2,14,24,12,12,22,55,78,0,0,2023-2024,1.25,1.8749999999999998
746,Mario Dominguez,ESP,FW,Valencia,La Liga,19,2004,0.3,0,0,0,0,0,0,0,0.0,0,0,0,0,0,0,0,0,0,2023-2024,0.0,0.0
747,Nicolás Domínguez,ARG,"MF,FW",Nott'ham Forest,Premier League,25,1998,16.6,63,34,35,27,1,23,48,47.9,25,31,5,26,18,81,24,0,0,2023-2024,1.0843373493975903,3.795180722891566
748,Nicolás Domínguez,ARG,MF,Bologna,Serie A,25,1998,1.1,1,0,1,0,0,0,2,0.0,2,3,0,3,0,1,2,0,0,2023-2024,0.0,0.9090909090909091
749,Giulio Donati,ITA,DF,Monza,Serie A,33,1990,0.4,0,0,0,0,0,0,0,0.0,0,0,0,0,0,0,1,1,0,2023-2024,0.0,0.0
750,Jamie Donley,ENG,FW,Tottenham,Premier League,18,2005,0.0,0,0,0,0,0,0,0,0.0,0,0,0,0,0,0,3,0,0,2023-2024,,
Rk,Player,Nation,Pos,Squad,Comp,0,0,90.0,0,0,3,3,3,Tkl,0,0.0,0,0,0,0,0,0,0,0,0,2023-2024,0.0,0.0
751,Gianluigi Donnarumma,ITA,GK,Paris S-G,Ligue 1,24,1999,24.1,0,0,0,0,0,0,0,0.0,0,0,0,0,1,1,9,4,0,2023-2024,0.04149377593360996,0.0
752,Patrick Dorgu,DEN,"DF,MF",Lecce,Serie A,18,2004,17.4,43,22,22,17,4,22,34,64.7,12,16,5,11,9,52,45,2,0,2023-2024,0.5172413793103449,2.4712643678160924
753,Niklas Dorsch,GER,MF,Augsburg,Bundesliga,25,1998,15.4,35,24,13,21,1,13,33,39.4,20,15,9,6,16,51,27,0,0,2023-2024,1.0389610389610389,2.2727272727272725
754,Alberto Dossena,ITA,DF,Cagliari,Serie A,24,1998,33.1,55,35,43,12,0,32,48,66.7,16,50,27,23,45,100,172,2,0,2023-2024,1.3595166163141994,1.661631419939577
755,Carlos Dotor,ESP,MF,Celta Vigo,La Liga,22,2001,7.9,14,7,3,8,3,4,13,30.8,9,12,2,10,4,18,4,0,0,2023-2024,0.5063291139240506,1.7721518987341771
756,Abdoulaye Doucouré,MLI,"FW,MF",Everton,Premier League,30,1993,29.2,43,27,20,14,9,18,46,39.1,28,23,3,20,15,58,19,0,0,2023-2024,0.5136986301369864,1.4726027397260275
757,Cheick Doucouré,MLI,MF,Crystal Palace,Premier League,23,2000,10.2,34,17,15,13,6,18,30,60.0,12,13,2,11,20,54,12,0,0,2023-2024,1.9607843137254903,3.3333333333333335
758,Siriné Doucouré,MLI,FW,Lorient,Ligue 1,21,2002,4.7,8,6,0,4,4,3,3,100.0,0,4,0,4,1,9,6,0,0,2023-2024,0.2127659574468085,1.702127659574468
759,Désiré Doué,FRA,"MF,FW",Rennes,Ligue 1,18,2005,18.1,32,18,11,14,7,10,33,30.3,23,30,1,29,14,46,8,0,0,2023-2024,0.7734806629834253,1.7679558011049723
760,Guela Doué,CIV,DF,Rennes,Ligue 1,20,2002,13.7,28,21,14,12,2,22,32,68.8,10,12,1,11,15,43,65,1,0,2023-2024,1.094890510948905,2.0437956204379564
761,Alfie Doughty,ENG,DF,Luton Town,Premier League,23,1999,32.5,63,40,29,18,16,37,82,45.1,45,51,9,42,31,94,43,4,0,2023-2024,0.9538461538461539,1.9384615384615385
762,Douglas,BRA,MF,Nantes,Ligue 1,26,1997,19.7,70,42,34,30,6,30,59,50.8,29,22,8,14,26,96,30,0,0,2023-2024,1.3197969543147208,3.553299492385787
763,Ismaël Doukouré,FRA,"MF,DF",Strasbourg,Ligue 1,20,2003,18.4,23,16,7,14,2,13,21,61.9,8,19,7,12,19,42,29,2,0,2023-2024,1.032608695652174,1.25
764,Kamory Doumbia,MLI,MF,Brest,Ligue 1,20,2003,9.8,28,18,8,10,10,10,29,34.5,19,14,0,14,9,37,6,0,0,2023-2024,0.9183673469387754,2.8571428571428568
765,Anastasios Douvikas,GRE,FW,Celta Vigo,La Liga,23,1999,10.1,15,7,2,6,7,3,8,37.5,5,6,3,3,2,17,9,0,0,2023-2024,0.19801980198019803,1.4851485148514851
766,Artem Dovbyk,UKR,FW,Girona,La Liga,26,1997,28.7,4,3,2,1,1,0,2,0.0,2,8,1,7,0,4,17,0,0,2023-2024,0.0,0.13937282229965156
767,Nikola Dovedan,AUT,"MF,FW",Heidenheim,Bundesliga,29,1994,7.3,14,9,2,10,2,5,25,20.0,20,9,0,9,1,15,3,0,0,2023-2024,0.136986301369863,1.9178082191780823
768,Damion Downs,USA,"FW,MF",Köln,Bundesliga,19,2004,2.0,1,1,1,0,0,1,2,50.0,1,1,0,1,0,1,1,0,0,2023-2024,0.0,0.5
769,Tommy Doyle,ENG,MF,Wolves,Premier League,21,2001,13.6,26,13,11,10,5,14,23,60.9,9,22,9,13,12,38,18,0,0,2023-2024,0.8823529411764706,1.911764705882353
770,Radu Drăgușin,ROU,DF,Tottenham,Premier League,21,2002,4.8,5,3,5,0,0,3,3,100.0,0,5,4,1,8,13,19,0,0,2023-2024,1.6666666666666667,1.0416666666666667
771,Radu Drăgușin,ROU,DF,Genoa,Serie A,21,2002,19.0,16,11,9,6,1,8,9,88.9,1,18,12,6,21,37,87,3,0,2023-2024,1.105263157894737,0.8421052631578947
772,Dion Drena Beljo,CRO,"FW,MF",Augsburg,Bundesliga,21,2002,6.5,0,0,0,0,0,0,2,0.0,2,8,1,7,1,1,4,0,0,2023-2024,0.15384615384615385,0.0
773,Tim Drexler,GER,DF,Hoffenheim,Bundesliga,18,2005,6.4,16,9,12,4,0,8,17,47.1,9,12,8,4,8,24,14,0,0,2023-2024,1.25,2.5
774,Domingos Duarte,POR,DF,Getafe,La Liga,28,1995,10.1,7,4,6,0,1,5,7,71.4,2,7,5,2,8,15,27,0,0,2023-2024,0.7920792079207921,0.6930693069306931
775,Rubén Duarte,ESP,DF,Alavés,La Liga,27,1995,20.9,39,20,21,16,2,21,31,67.7,10,21,6,15,23,62,69,0,0,2023-2024,1.1004784688995215,1.8660287081339715
Rk,Player,Nation,Pos,Squad,Comp,0,0,90.0,0,0,3,3,3,Tkl,0,0.0,0,0,0,0,0,0,0,0,0,2023-2024,0.0,0.0
776,Martin Dúbravka,SVK,GK,Newcastle Utd,Premier League,34,1989,22.1,0,0,0,0,0,0,4,0.0,4,0,0,0,0,0,8,1,0,2023-2024,0.0,0.0
777,Marvin Ducksch,GER,FW,Werder Bremen,Bundesliga,29,1994,30.0,8,3,4,3,1,6,14,42.9,8,2,0,2,4,12,25,0,0,2023-2024,0.13333333333333333,0.26666666666666666
778,Ondrej Duda,SVK,MF,Hellas Verona,Serie A,28,1994,27.3,59,39,17,35,7,31,52,59.6,21,29,12,17,26,85,21,0,0,2023-2024,0.9523809523809523,2.161172161172161
779,Denzel Dumfries,NED,DF,Inter,Serie A,27,1996,18.2,22,13,9,11,2,9,23,39.1,14,15,6,9,12,34,33,1,0,2023-2024,0.6593406593406593,1.208791208791209
780,Paul Dummett,WAL,DF,Newcastle Utd,Premier League,31,1991,0.2,1,0,1,0,0,1,1,100.0,0,0,0,0,0,1,1,0,0,2023-2024,0.0,5.0
781,Alfred Duncan,GHA,MF,Fiorentina,Serie A,30,1993,21.0,35,22,13,15,7,15,35,42.9,20,27,5,22,11,46,13,0,0,2023-2024,0.5238095238095238,1.6666666666666667
782,Lewis Dunk,ENG,DF,Brighton,Premier League,31,1991,31.9,27,14,17,9,1,13,36,36.1,23,49,37,12,31,58,90,1,0,2023-2024,0.9717868338557994,0.8463949843260189
783,Jhon Durán,COL,"FW,MF",Aston Villa,Premier League,19,2003,5.3,6,5,3,1,2,1,6,16.7,5,6,0,6,1,7,10,0,0,2023-2024,0.18867924528301888,1.1320754716981132
784,Julien Duranville,BEL,"FW,MF",Dortmund,Bundesliga,17,2006,0.1,1,0,0,1,0,1,1,100.0,0,0,0,0,0,1,0,0,0,2023-2024,0.0,10.0
785,Hugo Duro,ESP,FW,Valencia,La Liga,23,1999,33.1,16,8,5,8,3,9,29,31.0,20,24,5,19,5,21,27,0,0,2023-2024,0.1510574018126888,0.4833836858006042
786,Jean-Kevin Duverne,HAI,DF,Nantes,Ligue 1,26,1997,15.0,37,19,16,17,4,18,44,40.9,26,17,5,12,18,55,34,0,0,2023-2024,1.2,2.466666666666667
787,Paulo Dybala,ARG,"FW,MF",Roma,Serie A,29,1993,21.8,22,13,3,10,9,2,18,11.1,16,12,0,12,3,25,6,1,0,2023-2024,0.13761467889908258,1.0091743119266054
788,Aron Dønnum,NOR,"FW,MF",Toulouse,Ligue 1,25,1998,17.7,16,10,3,8,5,7,22,31.8,15,13,0,13,8,24,16,1,0,2023-2024,0.4519774011299435,0.903954802259887
789,George Earthy,ENG,FW,West Ham,Premier League,18,2004,0.4,0,0,0,0,0,0,1,0.0,1,0,0,0,1,1,0,0,0,2023-2024,2.5,0.0
790,Simon Ebonog,CMR,MF,Le Havre,Ligue 1,18,2004,0.2,1,1,0,1,0,1,1,100.0,0,1,1,0,0,1,1,0,0,2023-2024,0.0,5.0
791,Festy Ebosele,IRL,DF,Udinese,Serie A,20,2002,18.9,33,20,23,9,1,21,35,60.0,14,33,2,31,10,43,27,0,0,2023-2024,0.5291005291005292,1.7460317460317463
792,Enzo Ebosse,CMR,DF,Udinese,Serie A,24,1999,0.1,1,1,1,0,0,0,1,0.0,1,0,0,0,1,2,0,0,0,2023-2024,10.0,10.0
793,Tyronne Ebuehi,NGA,DF,Empoli,Serie A,27,1995,12.2,14,9,9,5,0,7,11,63.6,4,9,4,5,6,20,27,1,0,2023-2024,0.49180327868852464,1.1475409836065575
794,Ederson,BRA,GK,Manchester City,Premier League,29,1993,30.9,0,0,0,0,0,0,1,0.0,1,0,0,0,0,0,10,1,0,2023-2024,0.0,0.0
795,Éderson,BRA,MF,Atalanta,Serie A,24,1999,31.9,83,49,38,38,7,44,63,69.8,19,48,8,40,41,124,33,1,0,2023-2024,1.2852664576802508,2.6018808777429467
796,Odsonne Édouard,FRA,"FW,MF",Crystal Palace,Premier League,25,1998,17.3,24,12,8,8,8,4,19,21.1,15,17,1,16,6,30,19,0,0,2023-2024,0.3468208092485549,1.3872832369942196
797,John Egan,IRL,DF,Sheffield Utd,Premier League,30,1992,5.4,6,4,4,2,0,4,11,36.4,7,10,4,6,13,19,39,1,0,2023-2024,2.4074074074074074,1.111111111111111
798,Maximilian Eggestein,GER,MF,Freiburg,Bundesliga,26,1996,32.4,49,24,25,19,5,15,36,41.7,21,53,19,34,28,77,40,1,0,2023-2024,0.8641975308641976,1.5123456790123457
799,Lilian Egloff,GER,"MF,DF",Stuttgart,Bundesliga,20,2002,1.2,4,1,3,1,0,2,4,50.0,2,3,1,2,1,5,0,0,0,2023-2024,0.8333333333333334,3.3333333333333335
800,Kingsley Ehizibue,NED,DF,Udinese,Serie A,28,1995,10.6,22,14,16,4,2,11,18,61.1,7,21,3,18,8,30,36,0,0,2023-2024,0.7547169811320755,2.0754716981132075
Rk,Player,Nation,Pos,Squad,Comp,0,0,90.0,0,0,3,3,3,Tkl,0,0.0,0,0,0,0,0,0,0,0,0,2023-2024,0.0,0.0
801,Hjalmar Ekdal,SWE,DF,Burnley,Premier League,24,1998,4.9,4,2,2,2,0,2,4,50.0,2,10,5,5,6,10,21,0,0,2023-2024,1.2244897959183672,0.8163265306122448
802,Hugo Ekitike,FRA,FW,Paris S-G,Ligue 1,21,2002,0.1,0,0,0,0,0,0,0,0.0,0,0,0,0,0,0,0,0,0,2023-2024,0.0,0.0
803,Hugo Ekitike,FRA,FW,Eint Frankfurt,Bundesliga,21,2002,8.0,11,7,3,6,2,4,6,66.7,2,10,0,10,2,13,4,0,0,2023-2024,0.25,1.375
804,Emmanuel Ekong,SWE,FW,Empoli,Serie A,21,2002,0.1,0,0,0,0,0,0,0,0.0,0,0,0,0,0,0,0,0,0,2023-2024,0.0,0.0
805,Caleb Ekuban,GHA,FW,Genoa,Serie A,29,1994,12.6,8,4,2,4,2,5,9,55.6,4,11,3,8,1,9,7,0,0,2023-2024,0.07936507936507936,0.6349206349206349
806,Anthony Elanga,SWE,"FW,MF",Nott'ham Forest,Premier League,21,2002,27.0,33,19,20,6,7,17,36,47.2,19,22,2,20,8,41,20,1,0,2023-2024,0.2962962962962963,1.2222222222222223
807,Simon Elisor,FRA,FW,Metz,Ligue 1,24,1999,8.5,9,2,3,2,4,2,6,33.3,4,6,1,5,0,9,9,0,0,2023-2024,0.0,1.0588235294117647
808,Harvey Elliott,ENG,"MF,FW",Liverpool,Premier League,20,2003,15.0,27,17,8,14,5,10,31,32.3,21,27,0,27,6,33,7,0,0,2023-2024,0.4,1.8
809,Elif Elmas,MKD,"FW,MF",Napoli,Serie A,23,1999,3.8,4,3,1,3,0,2,2,100.0,0,2,0,2,2,6,8,0,0,2023-2024,0.5263157894736842,1.0526315789473684
810,Elif Elmas,MKD,"MF,FW",RB Leipzig,Bundesliga,23,1999,3.0,8,6,1,6,1,6,8,75.0,2,5,0,5,1,9,2,0,0,2023-2024,0.3333333333333333,2.6666666666666665
811,Mohamed Elneny,EGY,MF,Arsenal,Premier League,31,1992,0.3,0,0,0,0,0,0,1,0.0,1,0,0,0,1,1,0,0,0,2023-2024,3.3333333333333335,0.0
812,Aritz Elustondo,ESP,DF,Real Sociedad,La Liga,29,1994,9.0,11,7,5,4,2,6,14,42.9,8,12,10,2,7,18,26,0,0,2023-2024,0.7777777777777778,1.2222222222222223
813,Nico Elvedi,SUI,DF,Gladbach,Bundesliga,26,1996,27.6,33,18,22,10,1,18,24,75.0,6,40,25,15,43,76,150,2,0,2023-2024,1.5579710144927534,1.1956521739130435
814,Adri Embarba,ESP,"FW,MF",Almería,La Liga,31,1992,27.5,55,37,29,15,11,26,53,49.1,27,37,1,36,15,70,12,0,0,2023-2024,0.5454545454545454,2.0
815,Breel Embolo,SUI,FW,Monaco,Ligue 1,26,1997,2.0,3,3,0,2,1,1,4,25.0,3,1,0,1,1,4,2,0,0,2023-2024,0.5,1.5
816,Emanuel Emegha,NED,FW,Strasbourg,Ligue 1,20,2003,23.1,8,5,2,4,2,4,9,44.4,5,13,3,10,2,10,25,0,0,2023-2024,0.08658008658008658,0.3463203463203463
817,Emerson,BRA,DF,Tottenham,Premier League,24,1999,12.9,36,24,23,10,3,21,43,48.8,22,23,10,13,20,56,50,1,0,2023-2024,1.5503875968992247,2.7906976744186047
818,Youssef En-Nesyri,MAR,FW,Sevilla,La Liga,26,1997,28.6,10,7,3,4,3,0,10,0.0,10,9,1,8,7,17,29,1,0,2023-2024,0.24475524475524474,0.34965034965034963
819,Julio Enciso,PAR,"MF,FW",Brighton,Premier League,19,2004,5.3,6,2,3,2,1,2,7,28.6,5,11,0,11,0,6,3,0,0,2023-2024,0.0,1.1320754716981132
820,Wataru Endo,JPN,MF,Liverpool,Premier League,30,1993,19.1,48,28,11,31,6,20,61,32.8,41,24,2,22,20,68,31,3,0,2023-2024,1.0471204188481675,2.513089005235602
821,Arne Engels,BEL,"MF,DF",Augsburg,Bundesliga,19,2003,15.6,33,18,15,14,4,12,29,41.4,17,23,1,22,15,48,21,0,0,2023-2024,0.9615384615384616,2.1153846153846154
822,Christian Eriksen,DEN,MF,Manchester Utd,Premier League,31,1992,12.7,18,13,5,10,3,12,33,36.4,21,17,6,11,4,22,13,0,0,2023-2024,0.31496062992125984,1.4173228346456694
823,Martin Erlic,CRO,DF,Sassuolo,Serie A,25,1998,29.1,37,22,26,8,3,20,30,66.7,10,31,16,15,28,65,128,1,0,2023-2024,0.9621993127147765,1.2714776632302405
824,Gonzalo Escalante,ARG,MF,Cádiz,La Liga,30,1993,18.9,39,24,16,14,9,20,55,36.4,35,23,5,18,26,65,33,2,0,2023-2024,1.3756613756613758,2.0634920634920637
825,Aarón Escandell,ESP,GK,Las Palmas,La Liga,27,1995,1.7,0,0,0,0,0,0,0,0.0,0,0,0,0,0,0,1,1,0,2023-2024,0.0,0.0
Rk,Player,Nation,Pos,Squad,Comp,0,0,90.0,0,0,3,3,3,Tkl,0,0.0,0,0,0,0,0,0,0,0,0,2023-2024,0.0,0.0
826,Alfonso Espino,URU,DF,Rayo Vallecano,La Liga,31,1992,27.9,67,45,43,22,2,30,82,36.6,52,26,4,22,40,107,63,0,0,2023-2024,1.4336917562724014,2.4014336917562726
827,Bernardo Espinosa,COL,DF,Girona,La Liga,34,1989,0.0,1,1,1,0,0,1,1,100.0,0,0,0,0,0,1,2,0,0,2023-2024,,inf
828,Maxime Estève,FRA,DF,Burnley,Premier League,21,2002,14.5,27,10,15,12,0,18,32,56.3,14,21,10,11,27,54,56,0,0,2023-2024,1.8620689655172413,1.8620689655172413
829,Maxime Estève,FRA,DF,Montpellier,Ligue 1,21,2002,11.1,16,12,11,5,0,10,15,66.7,5,13,9,4,18,34,50,0,0,2023-2024,1.6216216216216217,1.4414414414414416
830,Oscar Estupiñan,COL,FW,Metz,Ligue 1,26,1996,2.9,5,4,0,3,2,1,2,50.0,1,2,0,2,0,5,0,0,0,2023-2024,0.0,1.7241379310344829
831,Pervis Estupiñán,ECU,DF,Brighton,Premier League,25,1998,13.8,26,13,12,11,3,14,30,46.7,16,14,4,10,21,47,20,0,0,2023-2024,1.5217391304347825,1.8840579710144927
832,Karl Etta,CMR,FW,Cádiz,La Liga,19,2004,0.2,1,1,0,1,0,0,0,0.0,0,0,0,0,0,1,0,0,0,2023-2024,0.0,5.0
833,Jonny Evans,NIR,DF,Manchester Utd,Premier League,35,1988,15.5,22,14,20,2,0,12,21,57.1,9,25,18,7,23,45,76,0,0,2023-2024,1.4838709677419355,1.4193548387096775
834,Eberechi Eze,ENG,"MF,FW",Crystal Palace,Premier League,25,1998,22.8,35,17,4,18,13,15,31,48.4,16,27,2,25,11,46,6,0,0,2023-2024,0.4824561403508772,1.5350877192982455
835,Abde Ezzalzouli,MAR,"FW,MF",Barcelona,La Liga,21,2001,0.8,1,1,0,0,1,0,1,0.0,1,1,0,1,0,1,0,0,0,2023-2024,0.0,1.25
836,Abde Ezzalzouli,MAR,FW,Betis,La Liga,21,2001,9.6,17,14,7,5,5,4,14,28.6,10,10,0,10,5,22,5,0,0,2023-2024,0.5208333333333334,1.7708333333333335
837,Giovanni Fabbian,ITA,"MF,FW",Bologna,Serie A,20,2003,11.7,17,10,9,7,1,7,12,58.3,5,5,2,3,7,24,11,0,0,2023-2024,0.5982905982905983,1.4529914529914532
838,Łukasz Fabiański,POL,GK,West Ham,Premier League,38,1985,8.0,1,0,1,0,0,1,2,50.0,1,0,0,0,1,2,4,0,0,2023-2024,0.125,0.125
839,Nicolò Fagioli,ITA,MF,Juventus,Serie A,22,2001,4.9,5,3,1,3,1,3,7,42.9,4,3,0,3,4,9,1,0,0,2023-2024,0.8163265306122448,1.0204081632653061
840,Romain Faivre,FRA,"MF,FW",Bournemouth,Premier League,25,1998,0.5,1,1,0,1,0,0,3,0.0,3,0,0,0,0,1,0,0,0,2023-2024,0.0,2.0
841,Romain Faivre,FRA,"MF,FW",Lorient,Ligue 1,25,1998,16.1,13,6,5,4,4,6,15,40.0,9,6,1,5,7,20,3,1,0,2023-2024,0.43478260869565216,0.8074534161490683
842,Ilhan Fakili,FRA,"MF,FW",Clermont Foot,Ligue 1,17,2006,1.0,0,0,0,0,0,0,1,0.0,1,1,0,1,1,1,0,0,0,2023-2024,1.0,0.0
843,Radamel Falcao,COL,"FW,DF",Rayo Vallecano,La Liga,37,1986,4.5,7,5,1,5,1,1,3,33.3,2,2,0,2,3,10,4,0,0,2023-2024,0.6666666666666666,1.5555555555555556
844,Wladimiro Falcone,ITA,GK,Lecce,Serie A,28,1995,38.0,0,0,0,0,0,0,0,0.0,0,1,0,1,1,1,21,2,0,2023-2024,0.02631578947368421,0.0
845,Fali,ESP,DF,Cádiz,La Liga,29,1993,28.3,41,26,29,11,1,21,36,58.3,15,38,24,14,27,68,120,0,0,2023-2024,0.9540636042402827,1.448763250883392
846,Davide Faraoni,ITA,DF,Hellas Verona,Serie A,31,1991,6.7,13,10,5,6,2,7,10,70.0,3,9,5,4,6,19,21,0,0,2023-2024,0.8955223880597015,1.9402985074626866
847,Davide Faraoni,ITA,DF,Fiorentina,Serie A,31,1991,4.4,9,4,5,2,2,5,11,45.5,6,3,1,2,5,14,14,0,0,2023-2024,1.1363636363636362,2.0454545454545454
848,Ansu Fati,ESP,"MF,FW",Brighton,Premier League,20,2002,5.8,5,3,1,2,2,1,11,9.1,10,8,0,8,3,8,3,0,0,2023-2024,0.5172413793103449,0.8620689655172414
849,Ansu Fati,ESP,"MF,FW",Barcelona,La Liga,20,2002,0.6,0,0,0,0,0,0,1,0.0,1,0,0,0,0,0,0,0,0,2023-2024,0.0,0.0
850,Khalil Fayad,FRA,"FW,MF",Montpellier,Ligue 1,19,2004,11.4,28,15,17,7,4,9,22,40.9,13,15,3,12,14,42,6,0,0,2023-2024,1.2280701754385965,2.456140350877193
Rk,Player,Nation,Pos,Squad,Comp,0,0,90.0,0,0,3,3,3,Tkl,0,0.0,0,0,0,0,0,0,0,0,0,2023-2024,0.0,0.0
851,Federico Fazio,ARG,DF,Salernitana,Serie A,36,1987,15.1,18,11,14,4,0,8,14,57.1,6,22,19,3,17,35,99,1,0,2023-2024,1.1258278145695364,1.1920529801324504
852,Jacopo Fazzini,ITA,MF,Empoli,Serie A,20,2003,13.7,49,25,27,13,9,30,53,56.6,23,21,3,18,12,61,18,0,0,2023-2024,0.8759124087591241,3.5766423357664237
853,Peter Federico,DOM,"MF,FW",Valencia,La Liga,21,2002,7.2,5,3,3,1,1,1,10,10.0,9,11,0,11,7,12,10,0,0,2023-2024,0.9722222222222222,0.6944444444444444
854,Nabil Fekir,FRA,"MF,FW",Betis,La Liga,30,1993,11.7,15,10,5,7,3,5,10,50.0,5,9,0,9,7,22,3,0,0,2023-2024,0.5982905982905983,1.2820512820512822
855,Felipe,BRA,DF,Nott'ham Forest,Premier League,34,1989,4.2,12,9,9,3,0,9,12,75.0,3,4,1,3,4,16,12,0,0,2023-2024,0.9523809523809523,2.857142857142857
856,Luiz Felipe,ITA,DF,Betis,La Liga,26,1997,4.0,7,3,5,2,0,4,5,80.0,1,10,4,6,4,11,16,0,0,2023-2024,1.0,1.75
857,João Félix,POR,FW,Barcelona,La Liga,23,1999,17.1,22,16,9,7,6,8,22,36.4,14,14,1,13,10,32,11,0,0,2023-2024,0.5847953216374269,1.286549707602339
858,Ohis Felix Uduokhai,GER,DF,Augsburg,Bundesliga,25,1997,32.5,37,21,18,14,5,16,25,64.0,9,45,35,10,46,83,178,2,0,2023-2024,1.4153846153846155,1.1384615384615384
859,Kiko Femenía,ESP,DF,Villarreal,La Liga,32,1991,17.6,35,25,19,13,3,19,34,55.9,15,21,6,15,31,66,45,0,0,2023-2024,1.7613636363636362,1.9886363636363635
860,Evan Ferguson,IRL,FW,Brighton,Premier League,18,2004,15.2,14,6,4,7,3,5,14,35.7,9,10,3,7,2,16,8,0,0,2023-2024,0.13157894736842105,0.9210526315789475
861,Lewis Ferguson,SCO,MF,Bologna,Serie A,23,1999,30.1,37,21,16,17,4,16,37,43.2,21,25,8,17,17,54,27,1,0,2023-2024,0.5647840531561461,1.229235880398671
862,Bruno Fernandes,POR,"MF,FW",Manchester Utd,Premier League,28,1994,34.6,68,38,27,25,16,30,88,34.1,58,49,6,43,27,95,50,2,0,2023-2024,0.7803468208092486,1.9653179190751444
863,Edimilson Fernandes,SUI,DF,Mainz 05,Bundesliga,27,1996,14.3,25,16,15,9,1,16,24,66.7,8,14,6,8,22,47,52,0,0,2023-2024,1.5384615384615383,1.7482517482517481
864,Aitor Fernández,ESP,GK,Osasuna,La Liga,32,1991,6.1,0,0,0,0,0,0,1,0.0,1,0,0,0,0,0,5,1,0,2023-2024,0.0,0.0
865,Álex Fernández,ESP,MF,Cádiz,La Liga,30,1992,14.3,19,9,10,9,0,11,22,50.0,11,17,5,12,15,34,30,0,0,2023-2024,1.048951048951049,1.3286713286713285
866,Carlos Fernández,ESP,FW,Real Sociedad,La Liga,27,1996,4.5,11,7,3,6,2,0,2,0.0,2,4,0,4,0,11,5,0,0,2023-2024,0.0,2.4444444444444446
867,Enzo Fernández,ARG,MF,Chelsea,Premier League,22,2001,24.5,50,22,22,18,10,27,65,41.5,38,36,13,23,17,67,28,0,0,2023-2024,0.6938775510204082,2.0408163265306123
868,Raúl Fernández,ESP,GK,Granada,La Liga,35,1988,3.1,0,0,0,0,0,0,1,0.0,1,0,0,0,0,0,1,2,0,2023-2024,0.0,0.0
869,Valery Fernández,ESP,"MF,FW",Girona,La Liga,23,1999,5.6,11,9,4,7,0,6,8,75.0,2,6,1,5,1,12,4,0,0,2023-2024,0.17857142857142858,1.9642857142857144
870,Fernando,ESP,GK,Almería,La Liga,33,1990,4.0,0,0,0,0,0,0,0,0.0,0,1,0,1,0,0,2,0,0,2023-2024,0.0,0.0
871,Fernando,BRA,MF,Sevilla,La Liga,36,1987,5.1,9,8,2,4,3,5,9,55.6,4,2,0,2,7,16,9,0,0,2023-2024,1.3725490196078431,1.7647058823529413
872,Ichem Ferrah,FRA,FW,Lille,Ligue 1,17,2005,0.0,0,0,0,0,0,0,0,0.0,0,0,0,0,0,0,0,0,0,2023-2024,,
873,Andrea Ferraris,ITA,MF,Monza,Serie A,20,2003,0.1,1,1,1,0,0,0,0,0.0,0,0,0,0,0,1,0,0,0,2023-2024,0.0,10.0
874,André Ferreira,POR,GK,Granada,La Liga,27,1996,14.9,0,0,0,0,0,0,1,0.0,1,0,0,0,0,0,9,2,0,2023-2024,0.0,0.0
875,João Ferreira,POR,DF,Udinese,Serie A,22,2001,20.2,58,42,36,18,4,34,58,58.6,24,27,6,21,29,87,89,0,0,2023-2024,1.4356435643564356,2.871287128712871
Rk,Player,Nation,Pos,Squad,Comp,0,0,90.0,0,0,3,3,3,Tkl,0,0.0,0,0,0,0,0,0,0,0,0,2023-2024,0.0,0.0
876,Jordan Ferri,FRA,MF,Montpellier,Ligue 1,31,1992,22.6,36,22,16,17,3,20,67,29.9,47,19,1,18,13,49,23,0,0,2023-2024,0.5752212389380531,1.5929203539823007
877,Nacho Ferri,ESP,"FW,MF",Eint Frankfurt,Bundesliga,18,2004,0.8,3,3,1,2,0,2,3,66.7,1,0,0,0,0,3,2,0,0,2023-2024,0.0,3.75
878,Rachad Fettal,MAR,FW,Almería,La Liga,18,2005,0.2,1,1,1,0,0,0,0,0.0,0,0,0,0,0,1,0,0,0,2023-2024,0.0,5.0
879,Seydou Fini,ITA,"DF,FW",Genoa,Serie A,17,2006,0.4,0,0,0,0,0,0,0,0.0,0,0,0,0,0,0,0,0,0,2023-2024,0.0,0.0
880,Max Finkgräfe,GER,"DF,FW",Köln,Bundesliga,19,2004,19.5,65,39,40,25,0,39,74,52.7,35,35,10,25,22,87,39,0,0,2023-2024,1.1282051282051282,3.3333333333333335
881,Vincenzo Fiorillo,ITA,GK,Salernitana,Serie A,33,1990,4.0,0,0,0,0,0,0,0,0.0,0,0,0,0,0,0,0,1,0,2023-2024,0.0,0.0
882,Kilian Fischer,GER,"DF,MF",Wolfsburg,Bundesliga,22,2000,3.2,8,6,4,3,1,2,5,40.0,3,8,1,7,1,9,12,0,0,2023-2024,0.3125,2.5
883,John Fleck,SCO,"MF,DF",Sheffield Utd,Premier League,31,1991,1.0,1,0,0,1,0,0,1,0.0,1,0,0,0,0,1,1,0,0,2023-2024,0.0,1.0
884,Mark Flekken,NED,GK,Brentford,Premier League,30,1993,36.5,1,1,1,0,0,1,5,20.0,4,1,0,1,0,1,17,1,0,2023-2024,0.0,0.0273972602739726
885,Alessandro Florenzi,ITA,DF,Milan,Serie A,32,1991,19.2,43,21,26,12,5,26,48,54.2,22,16,9,7,20,63,25,1,0,2023-2024,1.0416666666666667,2.2395833333333335
886,Phil Foden,ENG,"FW,MF",Manchester City,Premier League,23,2000,31.7,31,20,11,10,10,13,31,41.9,18,30,0,30,13,44,18,1,0,2023-2024,0.41009463722397477,0.9779179810725552
887,Wes Foderingham,ENG,GK,Sheffield Utd,Premier League,32,1991,29.4,5,3,5,0,0,5,6,83.3,1,0,0,0,0,5,18,6,0,2023-2024,0.0,0.17006802721088435
888,Malick Fofana,BEL,FW,Lyon,Ligue 1,18,2005,6.2,5,4,3,1,1,4,9,44.4,5,3,0,3,5,10,9,0,0,2023-2024,0.8064516129032258,0.8064516129032258
889,Youssouf Fofana,FRA,MF,Monaco,Ligue 1,24,1999,30.0,61,39,19,36,6,30,66,45.5,36,35,7,28,37,98,31,1,0,2023-2024,1.2333333333333334,2.033333333333333
890,Jonas Föhrenbach,GER,DF,Heidenheim,Bundesliga,27,1996,31.0,44,24,24,14,6,19,36,52.8,17,34,19,15,31,75,70,0,0,2023-2024,1.0,1.4193548387096775
891,Thomas Foket,BEL,DF,Reims,Ligue 1,28,1994,20.4,32,17,21,8,3,20,45,44.4,25,34,12,22,25,57,36,0,0,2023-2024,1.2254901960784315,1.5686274509803924
892,Michael Folorunsho,ITA,"MF,FW",Hellas Verona,Serie A,25,1998,30.9,50,28,21,22,7,23,57,40.4,34,45,12,33,17,67,44,2,0,2023-2024,0.5501618122977346,1.6181229773462784
893,Tiago Fonseca Morais,POR,FW,Lille,Ligue 1,19,2003,0.5,1,1,0,1,0,0,0,0.0,0,0,0,0,1,2,0,0,0,2023-2024,2.0,2.0
894,Pablo Fornals,ESP,"MF,FW",West Ham,Premier League,27,1996,4.7,10,6,4,3,3,5,16,31.3,11,8,1,7,6,16,7,0,0,2023-2024,1.276595744680851,2.127659574468085
895,Pablo Fornals,ESP,"FW,MF",Betis,La Liga,27,1996,12.8,24,16,8,11,5,12,22,54.5,10,14,0,14,22,46,10,2,0,2023-2024,1.71875,1.875
896,Emil Forsberg,SWE,"MF,FW",RB Leipzig,Bundesliga,31,1991,5.2,7,3,2,5,0,5,12,41.7,7,7,0,7,0,7,5,0,0,2023-2024,0.0,1.346153846153846
897,Omari Forson,ENG,FW,Manchester Utd,Premier League,19,2004,0.8,2,0,0,2,0,1,1,100.0,0,0,0,0,0,2,0,0,0,2023-2024,0.0,2.5
898,Philipp Förster,GER,"MF,FW",Bochum,Bundesliga,28,1995,4.3,9,5,3,4,2,2,6,33.3,4,3,0,3,7,16,3,0,0,2023-2024,1.627906976744186,2.0930232558139537
899,Héctor Fort,ESP,DF,Barcelona,La Liga,16,2006,3.5,6,5,5,1,0,4,10,40.0,6,0,0,0,2,8,4,0,0,2023-2024,0.5714285714285714,1.7142857142857142
900,Lyle Foster,RSA,"FW,MF",Burnley,Premier League,22,2000,21.1,19,10,5,6,8,6,17,35.3,11,13,3,10,3,22,34,0,0,2023-2024,0.14218009478672985,0.9004739336492891
Rk,Player,Nation,Pos,Squad,Comp,0,0,90.0,0,0,3,3,3,Tkl,0,0.0,0,0,0,0,0,0,0,0,0,2023-2024,0.0,0.0
901,Dimitri Foulquier,FRA,"DF,MF",Valencia,La Liga,30,1993,20.5,39,22,22,13,4,18,26,69.2,8,10,1,9,16,55,49,1,0,2023-2024,0.7804878048780488,1.9024390243902438
902,Juan Foyth,ARG,DF,Villarreal,La Liga,25,1998,11.8,26,15,18,8,0,12,27,44.4,15,17,4,13,12,38,44,0,0,2023-2024,1.0169491525423728,2.2033898305084745
903,Matheus França,BRA,"MF,FW",Crystal Palace,Premier League,19,2004,2.6,3,3,2,1,0,1,7,14.3,6,4,0,4,1,4,1,0,0,2023-2024,0.3846153846153846,1.1538461538461537
904,Bartol Franjić,CRO,MF,Darmstadt 98,Bundesliga,23,2000,13.7,15,12,4,10,1,7,28,25.0,21,12,4,8,30,45,29,2,0,2023-2024,2.18978102189781,1.094890510948905
905,Przemysław Frankowski,POL,DF,Lens,Ligue 1,28,1995,24.4,60,39,25,26,9,31,74,41.9,43,30,7,23,25,85,36,0,0,2023-2024,1.0245901639344264,2.459016393442623
906,Nathan Fraser,IRL,FW,Wolves,Premier League,18,2005,2.1,5,2,2,1,2,1,3,33.3,2,2,1,1,1,6,2,0,0,2023-2024,0.47619047619047616,2.380952380952381
907,Davide Frattesi,ITA,MF,Inter,Serie A,23,1999,10.6,10,6,3,7,0,4,8,50.0,4,9,3,6,5,15,19,0,0,2023-2024,0.4716981132075472,0.9433962264150944
908,Jean Frederic N'Guessan,CIV,"MF,FW",Metz,Ligue 1,20,2003,1.2,3,1,0,3,0,0,3,0.0,3,3,0,3,1,4,0,0,0,2023-2024,0.8333333333333334,2.5
909,Morten Frendrup,DEN,MF,Genoa,Serie A,22,2001,34.9,133,72,47,70,16,55,91,60.4,36,55,14,41,51,184,42,1,0,2023-2024,1.4613180515759312,3.810888252148997
910,Remo Freuler,SUI,MF,Bologna,Serie A,31,1992,29.2,78,50,41,32,5,38,69,55.1,31,37,9,28,36,114,53,2,0,2023-2024,1.2328767123287672,2.671232876712329
911,Marco Friedl,AUT,DF,Werder Bremen,Bundesliga,25,1998,24.4,53,32,38,15,0,36,48,75.0,12,45,29,16,35,88,129,0,0,2023-2024,1.4344262295081969,2.1721311475409837
912,Marvin Friedrich,GER,DF,Gladbach,Bundesliga,27,1995,17.4,23,15,16,6,1,12,20,60.0,8,28,20,8,17,40,87,0,0,2023-2024,0.9770114942528736,1.3218390804597702
913,Jeremie Frimpong,NED,DF,Leverkusen,Bundesliga,22,2000,25.0,26,17,12,7,7,8,20,40.0,12,26,0,26,7,33,17,0,0,2023-2024,0.28,1.04
914,Jorge de Frutos,ESP,"FW,MF",Rayo Vallecano,La Liga,26,1997,17.2,19,8,5,8,6,7,22,31.8,15,12,0,12,7,26,18,0,0,2023-2024,0.4069767441860465,1.1046511627906976
915,Chris Führich,GER,"FW,MF",Stuttgart,Bundesliga,25,1998,28.5,30,19,6,14,10,16,37,43.2,21,31,0,31,7,37,7,0,0,2023-2024,0.24561403508771928,1.0526315789473684
916,Shiō Fukuda,JPN,"FW,MF",Gladbach,Bundesliga,19,2004,0.4,2,0,1,1,0,1,2,50.0,1,0,0,0,1,3,0,0,0,2023-2024,2.5,5.0
917,Angelo Fulgini,FRA,MF,Lens,Ligue 1,26,1996,15.3,23,14,6,13,4,11,19,57.9,8,22,1,21,8,31,11,0,0,2023-2024,0.5228758169934641,1.5032679738562091
918,Niclas Füllkrug,GER,FW,Werder Bremen,Bundesliga,30,1993,2.0,1,1,0,1,0,1,1,100.0,0,2,1,1,0,1,1,0,0,2023-2024,0.0,0.5
919,Niclas Füllkrug,GER,FW,Dortmund,Bundesliga,30,1993,24.6,7,2,1,6,0,2,8,25.0,6,17,4,13,2,9,25,0,0,2023-2024,0.08130081300813008,0.2845528455284553
920,Gerardo Fusco,ITA,FW,Salernitana,Serie A,18,2005,0.2,0,0,0,0,0,0,0,0.0,0,0,0,0,0,0,0,0,0,2023-2024,0.0,0.0
921,Daniel Fuzato,BRA,GK,Getafe,La Liga,26,1997,0.1,0,0,0,0,0,0,0,0.0,0,0,0,0,0,0,1,0,0,2023-2024,0.0,0.0
922,Matteo Gabbia,ITA,DF,Milan,Serie A,23,1999,14.2,29,20,15,13,1,18,24,75.0,6,11,6,5,10,39,48,0,0,2023-2024,0.7042253521126761,2.0422535211267605
923,Matteo Gabbia,ITA,DF,Villarreal,La Liga,23,1999,5.3,10,6,4,6,0,5,8,62.5,3,5,2,3,8,18,36,1,0,2023-2024,1.509433962264151,1.8867924528301887
924,Gianluca Gaetano,ITA,"FW,MF",Cagliari,Serie A,23,2000,8.3,7,4,0,4,3,2,7,28.6,5,4,0,4,3,10,4,0,0,2023-2024,0.36144578313253006,0.8433734939759036
925,Gianluca Gaetano,ITA,MF,Napoli,Serie A,23,2000,1.8,4,1,0,4,0,2,4,50.0,2,5,2,3,1,5,4,0,0,2023-2024,0.5555555555555556,2.2222222222222223
Rk,Player,Nation,Pos,Squad,Comp,0,0,90.0,0,0,3,3,3,Tkl,0,0.0,0,0,0,0,0,0,0,0,0,2023-2024,0.0,0.0
926,Roberto Gagliardini,ITA,"MF,DF",Monza,Serie A,29,1994,26.2,61,30,27,25,9,31,50,62.0,19,30,11,19,31,92,38,0,0,2023-2024,1.183206106870229,2.3282442748091605
927,Cody Gakpo,NED,"FW,MF",Liverpool,Premier League,24,1999,18.3,27,17,8,14,5,8,25,32.0,17,21,4,17,14,41,7,0,0,2023-2024,0.7650273224043715,1.4754098360655736
928,Javi Galán,ESP,DF,Atlético Madrid,La Liga,28,1994,1.0,5,4,2,2,1,4,5,80.0,1,1,0,1,1,6,3,0,0,2023-2024,1.0,5.0
929,Javi Galán,ESP,DF,Real Sociedad,La Liga,28,1994,11.9,38,22,15,19,4,15,30,50.0,15,24,1,23,14,52,17,1,0,2023-2024,1.1764705882352942,3.1932773109243695
930,Iñigo Ruiz de Galarreta,ESP,MF,Athletic Club,La Liga,29,1993,23.2,49,31,15,26,8,24,49,49.0,25,18,5,13,12,61,17,0,0,2023-2024,0.5172413793103449,2.1120689655172415
931,Pablo Galdames Millán,CHI,"MF,DF",Genoa,Serie A,26,1996,0.1,0,0,0,0,0,0,0,0.0,0,1,0,1,0,0,0,0,0,2023-2024,0.0,0.0
932,Conor Gallagher,ENG,MF,Chelsea,Premier League,23,2000,34.8,85,52,37,31,17,33,77,42.9,44,50,11,39,43,128,34,0,0,2023-2024,1.2356321839080462,2.4425287356321843
933,Antonino Gallo,ITA,DF,Lecce,Serie A,23,2000,27.7,43,27,31,11,1,31,49,63.3,18,34,9,25,25,68,67,0,0,2023-2024,0.9025270758122744,1.552346570397112
934,Cristian Gamboa,CRC,DF,Bochum,Bundesliga,33,1989,13.2,24,18,12,11,1,14,33,42.4,19,20,7,13,15,39,34,1,0,2023-2024,1.1363636363636365,1.8181818181818183
935,Kévin Gameiro,FRA,"FW,MF",Strasbourg,Ligue 1,36,1987,15.0,10,10,5,3,2,2,17,11.8,15,9,0,9,3,13,7,0,0,2023-2024,0.2,0.6666666666666666
936,Idrissa Gana Gueye,SEN,MF,Everton,Premier League,33,1989,20.9,73,44,32,27,14,29,46,63.0,17,24,7,17,28,101,16,0,0,2023-2024,1.3397129186602872,3.4928229665071773
937,Ignatius Ganago,CMR,"FW,MF",Nantes,Ligue 1,24,1999,2.0,0,0,0,0,0,0,1,0.0,1,1,0,1,1,1,1,0,0,2023-2024,0.5,0.0
938,Aleix García,ESP,MF,Girona,La Liga,26,1997,35.5,49,28,17,26,6,28,54,51.9,26,45,17,28,36,85,53,3,0,2023-2024,1.0140845070422535,1.380281690140845
939,Álvaro García,ESP,"FW,MF",Rayo Vallecano,La Liga,30,1992,27.5,34,25,15,10,9,7,34,20.6,27,35,0,35,36,70,33,0,0,2023-2024,1.309090909090909,1.2363636363636363
940,Dani García,ESP,MF,Athletic Club,La Liga,33,1990,8.3,17,11,4,7,6,12,24,50.0,12,9,3,6,8,25,11,0,0,2023-2024,0.9638554216867469,2.048192771084337
941,David García,ESP,DF,Osasuna,La Liga,29,1994,25.9,29,18,19,9,1,16,26,61.5,10,40,19,21,18,47,115,2,0,2023-2024,0.694980694980695,1.1196911196911197
942,Eric García,ESP,DF,Barcelona,La Liga,22,2001,0.6,0,0,0,0,0,0,0,0.0,0,1,1,0,0,0,0,0,0,2023-2024,0.0,0.0
943,Eric García,ESP,DF,Girona,La Liga,22,2001,29.3,55,37,34,18,3,34,49,69.4,15,36,18,18,30,85,79,2,0,2023-2024,1.023890784982935,1.8771331058020477
944,Fran Garcia,ESP,DF,Real Madrid,La Liga,23,1999,15.5,25,17,11,12,2,13,31,41.9,18,16,3,13,19,44,28,1,0,2023-2024,1.2258064516129032,1.6129032258064515
945,Francisco Jesús Crespo García,ESP,FW,Las Palmas,La Liga,27,1996,5.6,12,8,3,6,3,6,18,33.3,12,4,0,4,2,14,5,0,0,2023-2024,0.35714285714285715,2.142857142857143
946,Gonzalo García,ESP,"FW,MF",Real Madrid,La Liga,19,2004,0.2,0,0,0,0,0,0,1,0.0,1,1,1,0,0,0,1,0,0,2023-2024,0.0,0.0
947,Jastin García,ESP,FW,Girona,La Liga,19,2004,0.4,1,0,0,0,1,0,0,0.0,0,0,0,0,0,1,1,0,0,2023-2024,0.0,2.5
948,Raúl García,ESP,"FW,MF",Athletic Club,La Liga,37,1986,4.7,9,6,2,4,3,4,9,44.4,5,10,1,9,3,12,9,0,0,2023-2024,0.6382978723404255,1.9148936170212765
949,Rubén García,ESP,"FW,MF",Osasuna,La Liga,30,1993,17.2,32,18,8,17,7,13,33,39.4,20,23,3,20,12,44,23,0,0,2023-2024,0.6976744186046512,1.8604651162790697
950,Santiago García,ESP,FW,Getafe,La Liga,21,2001,0.3,1,0,0,0,1,1,1,100.0,0,0,0,0,0,1,0,0,0,2023-2024,0.0,3.3333333333333335
Rk,Player,Nation,Pos,Squad,Comp,0,0,90.0,0,0,3,3,3,Tkl,0,0.0,0,0,0,0,0,0,0,0,0,2023-2024,0.0,0.0
951,Ulisses Garcia,SUI,DF,Marseille,Ligue 1,27,1996,10.1,21,16,6,13,2,13,20,65.0,7,8,3,5,7,28,13,2,0,2023-2024,0.6930693069306931,2.0792079207920793
952,Unai García,ESP,DF,Osasuna,La Liga,31,1992,6.2,12,9,9,2,1,5,10,50.0,5,7,1,6,8,20,18,0,0,2023-2024,1.2903225806451613,1.9354838709677418
953,Alejandro Garnacho,ARG,FW,Manchester Utd,Premier League,19,2004,28.5,22,15,7,6,9,12,45,26.7,33,26,2,24,18,40,18,0,0,2023-2024,0.631578947368421,0.7719298245614035
954,James Garner,ENG,MF,Everton,Premier League,22,2001,33.4,83,44,32,38,13,35,82,42.7,47,45,14,31,45,128,47,1,0,2023-2024,1.347305389221557,2.4850299401197606
955,Luca Garritano,ITA,"MF,DF",Frosinone,Serie A,29,1994,5.4,10,5,7,2,1,5,15,33.3,10,13,0,13,4,14,8,1,0,2023-2024,0.7407407407407407,1.8518518518518516
956,Yarek Gasiorowski,ESP,DF,Valencia,La Liga,18,2005,8.2,22,12,14,5,3,13,19,68.4,6,15,8,7,15,37,50,1,0,2023-2024,1.829268292682927,2.682926829268293
957,Johan Gastien,FRA,MF,Clermont Foot,Ligue 1,35,1988,25.1,43,22,18,21,4,23,81,28.4,58,31,9,22,36,79,24,4,0,2023-2024,1.4342629482071712,1.7131474103585655
958,Federico Gatti,ITA,DF,Juventus,Serie A,25,1998,29.3,33,19,16,16,1,19,24,79.2,5,26,15,11,19,52,90,1,0,2023-2024,0.6484641638225256,1.1262798634812285
959,Federico Gattoni,ARG,"DF,FW",Sevilla,La Liga,24,1999,0.1,1,0,1,0,0,1,1,100.0,0,0,0,0,0,1,1,0,0,2023-2024,0.0,10.0
960,Gavi,ESP,"MF,FW",Barcelona,La Liga,18,2004,10.5,39,21,20,14,5,18,36,50.0,18,19,3,16,8,47,16,1,0,2023-2024,0.7619047619047619,3.7142857142857144
961,Paulo Gazzaniga,ARG,GK,Girona,La Liga,31,1992,38.0,2,2,2,0,0,2,4,50.0,2,0,0,0,0,2,12,1,0,2023-2024,0.0,0.05263157894736842
962,Yann Gboho,FRA,"MF,FW",Toulouse,Ligue 1,22,2001,13.3,14,4,6,6,2,8,23,34.8,15,21,1,20,4,18,2,0,0,2023-2024,0.3007518796992481,1.0526315789473684
963,Dennis Geiger,GER,MF,Hoffenheim,Bundesliga,25,1998,0.7,1,0,1,0,0,0,0,0.0,0,1,1,0,0,1,0,0,0,2023-2024,0.0,1.4285714285714286
964,Gelabert,ESP,"MF,FW",Toulouse,Ligue 1,22,2000,8.4,14,8,5,6,3,7,20,35.0,13,8,2,6,5,19,8,0,0,2023-2024,0.5952380952380952,1.6666666666666665
965,Francesco Gelli,ITA,"MF,DF",Frosinone,Serie A,26,1996,17.3,19,13,8,4,7,10,24,41.7,14,19,3,16,11,30,27,1,0,2023-2024,0.6358381502890174,1.0982658959537572
966,Luca Gemello,ITA,GK,Torino,Serie A,23,2000,2.0,0,0,0,0,0,0,1,0.0,1,0,0,0,0,0,1,1,0,2023-2024,0.0,0.0
967,Valentin Gendrey,FRA,DF,Lecce,Serie A,23,2000,33.8,55,33,35,16,4,30,46,65.2,16,40,11,29,35,90,99,0,0,2023-2024,1.0355029585798818,1.6272189349112427
968,Denis Genreau,AUS,"MF,FW",Toulouse,Ligue 1,24,1999,5.2,12,9,6,6,0,8,15,53.3,7,8,1,7,6,18,8,0,0,2023-2024,1.1538461538461537,2.3076923076923075
969,Yannick Gerhardt,GER,"MF,DF",Wolfsburg,Bundesliga,29,1994,18.1,31,20,16,12,3,9,32,28.1,23,15,2,13,7,38,35,0,0,2023-2024,0.38674033149171266,1.7127071823204418
970,Anwar El Ghazi,NED,"MF,DF",Mainz 05,Bundesliga,28,1995,0.6,0,0,0,0,0,0,1,0.0,1,0,0,0,0,0,0,0,0,2023-2024,0.0,0.0
971,Farés Ghedjemis,FRA,"FW,MF",Frosinone,Serie A,20,2002,2.0,2,0,1,0,1,0,2,0.0,2,2,0,2,1,3,2,0,0,2023-2024,0.5,1.0
972,Saman Ghoddos,IRN,DF,Brentford,Premier League,29,1993,8.2,28,19,19,7,2,17,31,54.8,14,9,2,7,5,33,12,0,0,2023-2024,0.6097560975609757,3.414634146341464
973,Lautaro Gianetti,ARG,DF,Udinese,Serie A,29,1993,7.0,9,4,7,2,0,4,5,80.0,1,10,6,4,19,28,39,0,0,2023-2024,2.7142857142857144,1.2857142857142858
974,Morgan Gibbs-White,ENG,"MF,FW",Nott'ham Forest,Premier League,23,2000,35.1,36,24,6,20,10,14,33,42.4,19,31,8,23,17,53,21,0,0,2023-2024,0.4843304843304843,1.0256410256410255
975,Samuel Gigot,FRA,DF,Marseille,Ligue 1,29,1993,19.2,33,22,16,13,4,13,19,68.4,6,28,18,10,25,58,93,1,0,2023-2024,1.3020833333333335,1.71875
Rk,Player,Nation,Pos,Squad,Comp,0,0,90.0,0,0,3,3,3,Tkl,0,0.0,0,0,0,0,0,0,0,0,0,2023-2024,0.0,0.0
976,Bryan Gil,ESP,"FW,MF",Tottenham,Premier League,22,2001,2.3,1,0,0,0,1,1,4,25.0,3,3,0,3,3,4,4,0,0,2023-2024,1.3043478260869565,0.4347826086956522
977,David Gil,ESP,GK,Cádiz,La Liga,29,1994,4.1,0,0,0,0,0,0,1,0.0,1,0,0,0,0,0,3,0,0,2023-2024,0.0,0.0
978,Mario Gila,ESP,DF,Lazio,Serie A,22,2000,20.1,32,14,23,8,1,19,34,55.9,15,27,14,13,20,52,69,0,0,2023-2024,0.9950248756218905,1.5920398009950247
979,Alfie Gilchrist,ENG,DF,Chelsea,Premier League,19,2003,2.3,4,0,4,0,0,2,5,40.0,3,6,3,3,3,7,11,0,0,2023-2024,1.3043478260869565,1.7391304347826089
980,Billy Gilmour,SCO,MF,Brighton,Premier League,22,2001,23.6,26,16,14,10,2,11,35,31.4,24,23,9,14,11,37,14,1,0,2023-2024,0.4661016949152542,1.1016949152542372
981,Benedikt Gimber,GER,DF,Heidenheim,Bundesliga,26,1997,22.5,40,24,25,14,1,19,35,54.3,16,27,17,10,16,56,101,1,0,2023-2024,0.7111111111111111,1.7777777777777777
982,Gvidas Gineitis,LTU,MF,Torino,Serie A,19,2004,6.0,11,7,3,8,0,4,7,57.1,3,10,4,6,4,15,9,1,0,2023-2024,0.6666666666666666,1.8333333333333333
983,Matthias Ginter,GER,DF,Freiburg,Bundesliga,29,1994,21.3,29,15,19,9,1,16,29,55.2,13,40,26,14,16,45,93,0,0,2023-2024,0.7511737089201878,1.3615023474178403
984,Olivier Giroud,FRA,FW,Milan,Serie A,36,1986,26.3,17,11,6,6,5,2,14,14.3,12,14,3,11,6,23,22,0,0,2023-2024,0.22813688212927757,0.6463878326996197
985,Jamie Gittens,ENG,"FW,MF",Dortmund,Bundesliga,18,2004,11.8,14,7,6,7,1,2,17,11.8,15,11,2,9,4,18,7,0,0,2023-2024,0.3389830508474576,1.1864406779661016
986,Klaus Gjasula,ALB,"DF,MF",Darmstadt 98,Bundesliga,33,1989,15.1,44,22,18,25,1,17,30,56.7,13,26,14,12,19,63,42,2,0,2023-2024,1.2582781456953642,2.913907284768212
987,Serge Gnabry,GER,"FW,MF",Bayern Munich,Bundesliga,28,1995,4.8,8,5,0,5,3,2,13,15.4,11,5,0,5,3,11,2,0,0,2023-2024,0.625,1.6666666666666667
988,Ben Godfrey,ENG,DF,Everton,Premier League,25,1998,12.4,30,20,17,8,5,15,28,53.6,13,14,8,6,16,46,57,0,0,2023-2024,1.2903225806451613,2.4193548387096775
989,Edoardo Goldaniga,ITA,DF,Cagliari,Serie A,29,1993,11.2,12,7,9,3,0,4,10,40.0,6,11,7,4,15,27,37,1,0,2023-2024,1.3392857142857144,1.0714285714285714
990,Pierluigi Gollini,ITA,GK,Napoli,Serie A,28,1995,7.0,1,1,1,0,0,1,1,100.0,0,0,0,0,1,2,2,0,0,2023-2024,0.14285714285714285,0.14285714285714285
991,Aleksandr Golovin,RUS,"MF,FW",Monaco,Ligue 1,27,1996,23.9,42,30,14,22,6,15,42,35.7,27,37,3,34,21,63,14,0,0,2023-2024,0.8786610878661089,1.7573221757322177
992,André Gomes,POR,"MF,FW",Everton,Premier League,30,1993,5.6,7,4,2,3,2,3,13,23.1,10,10,1,9,3,10,4,1,0,2023-2024,0.5357142857142857,1.25
993,Angel Gomes,ENG,MF,Lille,Ligue 1,22,2000,28.6,26,13,4,15,7,14,32,43.8,18,23,6,17,18,44,28,1,0,2023-2024,0.6293706293706294,0.9090909090909091
994,João Gomes,BRA,MF,Wolves,Premier League,22,2001,29.4,128,74,67,49,12,44,99,44.4,55,51,8,43,18,146,29,2,0,2023-2024,0.6122448979591837,4.35374149659864
995,Toti Gomes,POR,DF,Wolves,Premier League,24,1999,30.8,44,25,32,8,4,24,37,64.9,13,40,19,21,26,70,93,2,0,2023-2024,0.8441558441558441,1.4285714285714286
996,Joe Gomez,ENG,DF,Liverpool,Premier League,26,1997,19.8,47,31,24,16,7,30,63,47.6,33,26,4,22,19,66,50,2,0,2023-2024,0.9595959595959596,2.3737373737373737
997,Maxi Gómez,URU,FW,Cádiz,La Liga,26,1996,12.9,6,4,2,3,1,3,5,60.0,2,8,3,5,3,9,3,0,0,2023-2024,0.23255813953488372,0.46511627906976744
998,Moi Gómez,ESP,"MF,FW",Osasuna,La Liga,29,1994,22.3,30,19,7,19,4,9,24,37.5,15,15,1,14,11,41,22,0,0,2023-2024,0.49327354260089684,1.3452914798206277
999,Papu Gómez,ARG,"MF,FW",Monza,Serie A,35,1988,0.5,0,0,0,0,0,0,2,0.0,2,0,0,0,1,1,0,0,0,2023-2024,2.0,0.0
1000,Sergio Gómez,ESP,"FW,MF",Manchester City,Premier League,22,2000,0.6,1,0,0,1,0,1,2,50.0,1,0,0,0,1,2,0,0,0,2023-2024,1.6666666666666667,1.6666666666666667
Rk,Player,Nation,Pos,Squad,Comp,0,0,90.0,0,0,3,3,3,Tkl,0,0.0,0,0,0,0,0,0,0,0,0,2023-2024,0.0,0.0
1001,Unai Gómez,ESP,MF,Athletic Club,La Liga,20,2003,9.7,12,10,2,6,4,5,10,50.0,5,13,2,11,2,14,9,0,0,2023-2024,0.2061855670103093,1.2371134020618557
1002,Iron Gomis,FRA,MF,Salernitana,Serie A,23,1999,1.5,4,1,2,2,0,0,1,0.0,1,2,0,2,2,6,2,0,0,2023-2024,1.3333333333333333,2.6666666666666665
1003,Maxime Gonalons,FRA,MF,Clermont Foot,Ligue 1,34,1989,14.4,47,33,14,27,6,25,57,43.9,32,18,3,15,20,67,11,0,0,2023-2024,1.3888888888888888,3.263888888888889
1004,Édgar González,ESP,"DF,MF",Almería,La Liga,26,1997,28.0,45,21,22,20,3,25,49,51.0,24,48,28,20,38,83,130,3,0,2023-2024,1.3571428571428572,1.6071428571428572
1005,Enso Gonzalez,PAR,"MF,DF",Wolves,Premier League,18,2005,0.0,0,0,0,0,0,0,1,0.0,1,0,0,0,0,0,0,0,0,2023-2024,,
1006,Fabio González,ESP,MF,Las Palmas,La Liga,26,1997,1.4,2,2,2,0,0,1,2,50.0,1,2,0,2,0,2,0,0,0,2023-2024,0.0,1.4285714285714286
1007,Giovanni González,URU,DF,Mallorca,La Liga,28,1994,27.4,73,45,37,32,4,40,81,49.4,41,24,3,21,31,104,60,2,0,2023-2024,1.1313868613138687,2.664233576642336
1008,Hugo González,ESP,"MF,FW",Valencia,La Liga,20,2003,1.0,2,1,0,2,0,0,0,0.0,0,0,0,0,0,2,0,0,0,2023-2024,0.0,2.0
1009,Iñaki González,ESP,MF,Las Palmas,La Liga,19,2004,0.1,1,0,1,0,0,0,0,0.0,0,0,0,0,0,1,1,0,0,2023-2024,0.0,10.0
1010,Joan Gonzàlez,ESP,MF,Lecce,Serie A,21,2002,14.3,31,18,16,12,3,17,28,60.7,11,20,3,17,5,36,9,0,0,2023-2024,0.34965034965034963,2.167832167832168
1011,Nicolás González,ARG,FW,Fiorentina,Serie A,25,1998,21.3,28,18,15,8,5,8,28,28.6,20,26,1,25,12,40,9,0,0,2023-2024,0.5633802816901409,1.3145539906103285
1012,Urko González,ESP,MF,Real Sociedad,La Liga,22,2001,1.7,4,1,0,3,1,2,2,100.0,0,1,0,1,1,5,6,0,0,2023-2024,0.5882352941176471,2.3529411764705883
1013,Anthony Gordon,ENG,FW,Newcastle Utd,Premier League,22,2001,32.1,55,34,16,28,11,22,64,34.4,42,27,0,27,7,62,7,0,0,2023-2024,0.21806853582554517,1.7133956386292835
1014,Kaide Gordon,ENG,FW,Liverpool,Premier League,18,2004,0.0,0,0,0,0,0,0,0,0.0,0,0,0,0,0,0,0,0,0,2023-2024,,
1015,Daniel Gore,ENG,MF,Manchester Utd,Premier League,18,2004,0.0,1,1,0,1,0,1,1,100.0,0,0,0,0,1,2,0,0,0,2023-2024,inf,inf
1016,Leon Goretzka,GER,MF,Bayern Munich,Bundesliga,28,1995,24.9,41,23,18,14,9,24,54,44.4,30,44,8,36,31,72,42,1,0,2023-2024,1.244979919678715,1.6465863453815262
1017,Mathieu Gorgelin,FRA,GK,Le Havre,Ligue 1,32,1990,1.0,0,0,0,0,0,0,0,0.0,0,0,0,0,0,0,0,0,0,2023-2024,0.0,0.0
1018,Andoni Gorosabel,ESP,DF,Alavés,La Liga,26,1996,31.7,62,42,40,17,5,38,75,50.7,37,24,8,16,28,90,69,0,0,2023-2024,0.8832807570977919,1.9558359621451105
1019,Robin Gosens,GER,"DF,MF",Union Berlin,Bundesliga,29,1994,25.4,63,44,25,31,7,30,44,68.2,14,52,9,43,36,99,75,0,0,2023-2024,1.4173228346456694,2.4803149606299213
1020,Mario Götze,GER,MF,Eint Frankfurt,Bundesliga,31,1992,23.0,51,34,18,25,8,28,62,45.2,34,19,3,16,14,65,10,0,0,2023-2024,0.6086956521739131,2.217391304347826
1021,Amine Gouiri,ALG,"FW,MF",Rennes,Ligue 1,23,2000,23.0,20,10,4,11,5,8,19,42.1,11,18,1,17,14,34,12,0,0,2023-2024,0.6086956521739131,0.8695652173913043
1022,Jeffrey Gouweleeuw,NED,DF,Augsburg,Bundesliga,32,1991,28.8,35,23,13,17,5,16,25,64.0,9,44,24,20,35,70,108,0,0,2023-2024,1.2152777777777777,1.2152777777777777
1023,Pablo Gozalbez,ESP,"MF,FW",Valencia,La Liga,22,2001,1.1,1,0,0,0,1,1,6,16.7,5,0,0,0,1,2,2,0,0,2023-2024,0.9090909090909091,0.9090909090909091
1024,Jonathan Gradit,FRA,DF,Lens,Ligue 1,30,1992,23.5,32,20,15,14,3,19,35,54.3,16,30,17,13,37,69,61,0,0,2023-2024,1.574468085106383,1.3617021276595744
1025,Jens Grahl,GER,GK,Eint Frankfurt,Bundesliga,34,1988,2.0,0,0,0,0,0,0,0,0.0,0,0,0,0,0,0,3,0,0,2023-2024,0.0,0.0
Rk,Player,Nation,Pos,Squad,Comp,0,0,90.0,0,0,3,3,3,Tkl,0,0.0,0,0,0,0,0,0,0,0,0,2023-2024,0.0,0.0
1026,Samuel Grandsir,FRA,"MF,FW",Le Havre,Ligue 1,26,1996,6.7,16,12,5,9,2,8,18,44.4,10,4,0,4,3,19,3,1,0,2023-2024,0.44776119402985076,2.388059701492537
1027,Alberto Grassi,ITA,MF,Empoli,Serie A,28,1995,20.1,30,18,13,13,4,10,26,38.5,16,26,11,15,41,71,37,0,0,2023-2024,2.0398009950248754,1.4925373134328357
1028,Ryan Gravenberch,NED,MF,Liverpool,Premier League,21,2002,12.5,26,12,5,13,8,12,29,41.4,17,20,2,18,14,40,11,0,0,2023-2024,1.12,2.08
1029,Ryan Gravenberch,NED,FW,Bayern Munich,Bundesliga,21,2002,0.1,0,0,0,0,0,0,0,0.0,0,0,0,0,0,0,0,0,0,2023-2024,0.0,0.0
1030,Adrian Grbić,AUT,FW,Lorient,Ligue 1,26,1996,0.3,0,0,0,0,0,0,0,0.0,0,0,0,0,0,0,0,0,0,2023-2024,0.0,0.0
1031,Ivo Grbić,CRO,GK,Sheffield Utd,Premier League,27,1996,8.6,0,0,0,0,0,0,1,0.0,1,1,0,1,0,0,9,1,0,2023-2024,0.0,0.0
1032,Jack Grealish,ENG,"FW,MF",Manchester City,Premier League,27,1995,11.2,13,8,6,7,0,6,12,50.0,6,13,2,11,6,19,5,0,0,2023-2024,0.5357142857142857,1.1607142857142858
1033,Mason Greenwood,ENG,"MF,FW",Getafe,La Liga,21,2001,29.6,11,6,3,5,3,4,21,19.0,17,9,0,9,4,15,4,0,0,2023-2024,0.13513513513513511,0.3716216216216216
1034,Michael Gregoritsch,AUT,FW,Freiburg,Bundesliga,29,1994,18.7,16,12,8,5,3,2,14,14.3,12,17,4,13,9,25,27,0,0,2023-2024,0.4812834224598931,0.8556149732620321
1035,Dominik Greif,SVK,GK,Mallorca,La Liga,26,1997,1.0,0,0,0,0,0,0,0,0.0,0,0,0,0,0,0,0,0,0,2023-2024,0.0,0.0
1036,Antoine Griezmann,FRA,"FW,MF",Atlético Madrid,La Liga,32,1991,29.4,33,19,14,14,5,15,41,36.6,26,34,3,31,10,43,23,1,0,2023-2024,0.3401360544217687,1.1224489795918369
1037,Vincenzo Grifo,ITA,"MF,FW",Freiburg,Bundesliga,30,1993,25.8,31,20,14,11,6,14,31,45.2,17,22,1,21,15,46,20,0,0,2023-2024,0.5813953488372093,1.2015503875968991
1038,Florian Grillitsch,AUT,"DF,MF",Hoffenheim,Bundesliga,27,1995,25.5,54,28,31,19,4,22,54,40.7,32,41,20,21,52,106,90,2,0,2023-2024,2.0392156862745097,2.1176470588235294
1039,Álex Grimaldo,ESP,DF,Leverkusen,Bundesliga,27,1995,30.9,45,24,26,10,9,30,55,54.5,25,32,7,25,22,67,41,0,0,2023-2024,0.7119741100323624,1.4563106796116505
1040,Christian Groß,GER,"DF,MF",Werder Bremen,Bundesliga,34,1989,8.9,21,16,11,9,1,11,25,44.0,14,17,6,11,13,34,28,1,0,2023-2024,1.4606741573033708,2.359550561797753
1041,Pascal Groß,GER,"MF,DF",Brighton,Premier League,32,1991,34.6,70,46,33,21,16,31,72,43.1,41,41,8,33,22,92,32,3,0,2023-2024,0.6358381502890174,2.0231213872832368
1042,Brajan Gruda,GER,"MF,FW",Mainz 05,Bundesliga,19,2004,18.2,22,14,5,11,6,14,24,58.3,10,15,0,15,5,27,4,0,0,2023-2024,0.27472527472527475,1.208791208791209
1043,Ilia Gruev,BUL,MF,Werder Bremen,Bundesliga,23,2000,0.0,0,0,0,0,0,0,0,0.0,0,0,0,0,0,0,0,0,0,2023-2024,,
1044,Vicente Guaita,ESP,GK,Celta Vigo,La Liga,36,1987,26.7,1,1,1,0,0,1,2,50.0,1,0,0,0,0,1,9,1,0,2023-2024,0.0,0.03745318352059925
1045,Andrés Guardado,MEX,MF,Betis,La Liga,36,1986,5.0,17,12,5,9,3,7,14,50.0,7,4,2,2,6,23,5,0,0,2023-2024,1.2,3.4
1046,Sergi Guardiola,ESP,"FW,MF",Cádiz,La Liga,32,1991,5.5,10,7,2,6,2,4,9,44.4,5,10,0,10,0,10,4,0,0,2023-2024,0.0,1.8181818181818181
1047,Nemanja Gudelj,SRB,"DF,MF",Sevilla,La Liga,31,1991,19.4,31,24,18,10,3,17,31,54.8,14,17,9,8,27,58,56,0,0,2023-2024,1.3917525773195878,1.597938144329897
1048,Gabriel Gudmundsson,SWE,"DF,FW",Lille,Ligue 1,24,1999,14.1,22,16,7,13,2,12,20,60.0,8,14,3,11,15,37,25,0,0,2023-2024,1.0638297872340425,1.5602836879432624
1049,Gonçalo Guedes,POR,"FW,MF",Villarreal,La Liga,26,1996,10.6,6,4,1,2,3,2,7,28.6,5,8,0,8,2,8,3,0,0,2023-2024,0.18867924528301888,0.5660377358490566
1050,Axel Gueguin,FRA,"DF,FW",Montpellier,Ligue 1,18,2005,1.5,9,5,6,2,1,2,6,33.3,4,2,0,2,2,11,6,0,0,2023-2024,1.3333333333333333,6.0
Rk,Player,Nation,Pos,Squad,Comp,0,0,90.0,0,0,3,3,3,Tkl,0,0.0,0,0,0,0,0,0,0,0,0,2023-2024,0.0,0.0
1051,Marc Guéhi,ENG,DF,Crystal Palace,Premier League,23,2000,22.5,28,19,21,7,0,14,24,58.3,10,22,17,5,18,46,89,1,0,2023-2024,0.8,1.2444444444444445
1052,Mattéo Guendouzi,FRA,MF,Lazio,Serie A,24,1999,26.3,34,15,11,18,5,21,49,42.9,28,24,6,18,21,55,24,1,0,2023-2024,0.7984790874524714,1.2927756653992395
1053,Mattéo Guendouzi,FRA,MF,Marseille,Ligue 1,24,1999,0.2,0,0,0,0,0,0,0,0.0,0,1,1,0,0,0,0,0,0,2023-2024,0.0,0.0
1054,Javier Guerra,ESP,MF,Valencia,La Liga,20,2003,27.8,54,24,25,22,7,22,58,37.9,36,27,7,20,18,72,44,0,0,2023-2024,0.6474820143884892,1.9424460431654675
1055,Raphaël Guerreiro,POR,"DF,MF",Bayern Munich,Bundesliga,29,1993,13.2,19,16,6,9,4,9,15,60.0,6,7,1,6,15,34,5,1,0,2023-2024,1.1363636363636365,1.4393939393939394
1056,Axel Guessand,FRA,DF,Udinese,Serie A,18,2004,0.5,1,1,0,1,0,1,1,100.0,0,1,0,1,0,1,0,0,0,2023-2024,0.0,2.0
1057,Evann Guessand,CIV,FW,Nice,Ligue 1,22,2001,17.3,16,7,2,7,7,6,7,85.7,1,12,1,11,12,28,7,0,0,2023-2024,0.6936416184971098,0.9248554913294798
1058,Ander Guevara,ESP,MF,Alavés,La Liga,26,1997,32.6,59,32,28,25,6,31,64,48.4,33,34,12,22,13,72,46,1,0,2023-2024,0.3987730061349693,1.8098159509202454
1059,Pape Gueye,SEN,"MF,DF",Marseille,Ligue 1,24,1999,8.5,33,21,11,19,3,13,19,68.4,6,17,3,14,13,46,12,0,0,2023-2024,1.5294117647058822,3.8823529411764706
1060,Josuha Guilavogui,FRA,DF,Mainz 05,Bundesliga,32,1990,4.5,15,10,10,5,0,6,7,85.7,1,13,7,6,13,28,21,0,0,2023-2024,2.888888888888889,3.3333333333333335
1061,Morgan Guilavogui,GUI,"FW,MF",Lens,Ligue 1,25,1998,6.3,21,10,4,12,5,5,11,45.5,6,11,2,9,4,25,7,0,0,2023-2024,0.6349206349206349,3.3333333333333335
1062,Frederic Guilbert,FRA,"DF,MF",Strasbourg,Ligue 1,28,1994,27.7,87,50,49,30,8,47,72,65.3,25,39,10,29,71,158,99,1,0,2023-2024,2.563176895306859,3.140794223826715
1063,Hugo Guillamón,ESP,MF,Valencia,La Liga,23,2000,14.6,24,15,7,14,3,11,17,64.7,6,8,3,5,12,36,25,2,0,2023-2024,0.8219178082191781,1.6438356164383563
1064,Bruno Guimarães,BRA,MF,Newcastle Utd,Premier League,25,1997,36.3,88,53,45,32,11,40,77,51.9,37,52,14,38,35,123,20,0,0,2023-2024,0.9641873278236915,2.4242424242424243
1065,Serhou Guirassy,GUI,FW,Stuttgart,Bundesliga,27,1996,24.5,6,3,1,4,1,2,5,40.0,3,8,1,7,6,12,29,0,0,2023-2024,0.24489795918367346,0.24489795918367346
1066,Marc Guiu,ESP,"FW,MF",Barcelona,La Liga,17,2006,0.8,1,0,0,1,0,0,0,0.0,0,0,0,0,0,1,0,0,0,2023-2024,0.0,1.25
1067,Péter Gulácsi,HUN,GK,RB Leipzig,Bundesliga,33,1990,13.0,0,0,0,0,0,0,0,0.0,0,0,0,0,0,0,8,1,0,2023-2024,0.0,0.0
1068,Manuel Gulde,GER,DF,Freiburg,Bundesliga,32,1991,22.7,37,23,23,13,1,17,23,73.9,6,24,14,10,25,62,82,0,0,2023-2024,1.1013215859030838,1.6299559471365639
1069,Arda Güler,TUR,"FW,MF",Real Madrid,La Liga,18,2005,4.2,6,4,1,3,2,5,8,62.5,3,0,0,0,2,8,5,0,0,2023-2024,0.47619047619047616,1.4285714285714286
1070,Gerard Gumbau,ESP,MF,Granada,La Liga,28,1994,29.7,55,34,21,30,4,23,62,37.1,39,24,5,19,25,80,30,2,0,2023-2024,0.8417508417508418,1.8518518518518519
1071,Robert Gumny,POL,DF,Augsburg,Bundesliga,25,1998,5.3,6,5,1,3,2,1,5,20.0,4,13,5,8,7,13,15,0,0,2023-2024,1.3207547169811322,1.1320754716981132
1072,İlkay Gündoğan,GER,MF,Barcelona,La Liga,32,1990,33.3,32,22,14,16,2,12,39,30.8,27,19,4,15,21,53,18,1,0,2023-2024,0.6306306306306307,0.9609609609609611
1073,Christian Günter,GER,DF,Freiburg,Bundesliga,30,1993,11.8,20,12,9,11,0,7,18,38.9,11,9,3,6,2,22,16,0,0,2023-2024,0.1694915254237288,1.694915254237288
1074,Jon Guridi,ESP,MF,Alavés,La Liga,28,1995,29.8,42,24,10,27,5,12,45,26.7,33,23,3,20,22,64,22,0,0,2023-2024,0.7382550335570469,1.4093959731543624
1075,Gorka Guruzeta,ESP,FW,Athletic Club,La Liga,26,1996,24.6,34,23,6,25,3,9,30,30.0,21,36,2,34,17,51,23,0,0,2023-2024,0.6910569105691057,1.3821138211382114
Rk,Player,Nation,Pos,Squad,Comp,0,0,90.0,0,0,3,3,3,Tkl,0,0.0,0,0,0,0,0,0,0,0,0,2023-2024,0.0,0.0
1076,Malo Gusto,FRA,DF,Chelsea,Premier League,20,2003,19.5,55,27,34,15,6,35,52,67.3,17,28,4,24,17,72,43,1,0,2023-2024,0.8717948717948718,2.8205128205128207
1077,Miguel Gutiérrez,ESP,DF,Girona,La Liga,22,2001,33.7,29,18,11,14,4,13,35,37.1,22,27,11,16,22,51,66,2,0,2023-2024,0.6528189910979227,0.8605341246290801
1078,Albert Guðmundsson,ISL,"FW,MF",Genoa,Serie A,26,1997,33.5,23,10,8,10,5,12,44,27.3,32,15,2,13,11,34,13,0,0,2023-2024,0.3283582089552239,0.6865671641791045
1079,Joško Gvardiol,CRO,DF,Manchester City,Premier League,21,2002,25.9,55,33,21,24,10,21,38,55.3,17,36,12,24,27,82,37,3,0,2023-2024,1.0424710424710426,2.1235521235521237
1080,Emmanuel Gyasi,GHA,"DF,FW",Empoli,Serie A,29,1994,20.9,34,17,18,13,3,15,32,46.9,17,30,12,18,5,39,27,1,0,2023-2024,0.23923444976076558,1.6267942583732058
1081,Norbert Gyömbér,SVK,DF,Salernitana,Serie A,31,1992,19.6,36,18,30,6,0,20,26,76.9,6,33,23,10,23,59,77,2,0,2023-2024,1.173469387755102,1.8367346938775508
1082,Erling Haaland,NOR,FW,Manchester City,Premier League,23,2000,28.4,6,3,0,3,3,2,3,66.7,1,11,1,10,2,8,16,0,0,2023-2024,0.07042253521126761,0.21126760563380284
1083,Nicolas Haas,SUI,MF,Empoli,Serie A,27,1996,1.0,5,3,1,2,2,3,3,100.0,0,1,0,1,1,6,1,0,0,2023-2024,1.0,5.0
1084,Janik Haberer,GER,"MF,DF",Union Berlin,Bundesliga,29,1994,13.6,36,24,16,13,7,22,45,48.9,23,21,4,17,12,48,18,0,0,2023-2024,0.8823529411764706,2.6470588235294117
1085,Robin Hack,GER,"FW,MF",Gladbach,Bundesliga,24,1998,15.0,15,8,6,7,2,4,17,23.5,13,16,0,16,14,29,21,0,0,2023-2024,0.9333333333333333,1.0
1086,Antwoine Hackford,ENG,FW,Sheffield Utd,Premier League,19,2004,0.1,0,0,0,0,0,0,0,0.0,0,0,0,0,0,0,0,0,0,2023-2024,0.0,0.0
1087,Munir El Haddadi,MAR,FW,Las Palmas,La Liga,27,1995,27.2,40,27,18,17,5,17,38,44.7,21,27,1,26,11,51,16,0,0,2023-2024,0.40441176470588236,1.4705882352941178
1088,Jaouen Hadjam,ALG,DF,Nantes,Ligue 1,20,2003,1.2,6,4,5,1,0,1,2,50.0,1,0,0,0,3,9,2,0,0,2023-2024,2.5,5.0
1089,Ianis Hagi,ROU,"MF,FW",Alavés,La Liga,24,1998,8.9,17,12,2,14,1,5,12,41.7,7,8,0,8,5,22,4,0,0,2023-2024,0.5617977528089887,1.9101123595505618
1090,Amadou Haidara,MLI,MF,RB Leipzig,Bundesliga,25,1998,17.0,42,27,24,16,2,23,41,56.1,18,28,6,22,21,63,37,0,0,2023-2024,1.2352941176470589,2.4705882352941178
1091,Massadio Haïdara,MLI,DF,Lens,Ligue 1,30,1992,8.2,9,8,5,3,1,4,6,66.7,2,7,2,5,11,20,32,3,0,2023-2024,1.3414634146341464,1.0975609756097562
1092,Oualid El Hajjam,MAR,"DF,MF",Le Havre,Ligue 1,32,1991,4.4,8,7,5,2,1,2,9,22.2,7,5,1,4,6,14,10,0,0,2023-2024,1.3636363636363635,1.8181818181818181
1093,Achraf Hakimi,MAR,DF,Paris S-G,Ligue 1,24,1998,21.5,29,19,14,9,6,17,34,50.0,17,28,4,24,12,41,28,2,0,2023-2024,0.5581395348837209,1.3488372093023255
1094,Lewis Hall,ENG,DF,Newcastle Utd,Premier League,18,2004,8.7,28,18,17,10,1,17,28,60.7,11,17,2,15,12,40,22,1,0,2023-2024,1.3793103448275863,3.218390804597701
1095,Sébastien Haller,CIV,FW,Dortmund,Bundesliga,29,1994,4.4,1,0,0,1,0,1,1,100.0,0,4,1,3,0,1,7,0,0,2023-2024,0.0,0.22727272727272727
1096,Gustavo Hamer,NED,MF,Sheffield Utd,Premier League,26,1997,32.3,39,21,17,15,7,16,59,27.1,43,33,9,24,29,68,35,0,0,2023-2024,0.8978328173374613,1.2074303405572757
1097,Andreas Hanche-Olsen,NOR,DF,Mainz 05,Bundesliga,26,1997,11.0,20,12,10,8,2,10,16,62.5,6,10,4,6,11,31,41,0,0,2023-2024,1.0,1.8181818181818181
1098,Isak Hansen-Aarøen,NOR,MF,Werder Bremen,Bundesliga,18,2004,0.3,0,0,0,0,0,0,1,0.0,1,1,0,1,1,1,0,0,0,2023-2024,3.3333333333333335,0.0
1099,Ridgeciano Haps,SUR,DF,Genoa,Serie A,30,1993,8.6,7,6,3,2,2,5,8,62.5,3,3,0,3,6,13,11,1,0,2023-2024,0.6976744186046512,0.813953488372093
1100,Genki Haraguchi,JPN,MF,Stuttgart,Bundesliga,32,1991,0.3,1,1,1,0,0,0,0,0.0,0,0,0,0,0,1,1,0,0,2023-2024,0.0,3.3333333333333335
Rk,Player,Nation,Pos,Squad,Comp,0,0,90.0,0,0,3,3,3,Tkl,0,0.0,0,0,0,0,0,0,0,0,0,2023-2024,0.0,0.0
1101,Amine Harit,MAR,"MF,FW",Marseille,Ligue 1,26,1997,20.2,28,16,8,17,3,13,37,35.1,24,31,4,27,12,40,4,0,0,2023-2024,0.594059405940594,1.3861386138613863
1102,Luke Harris,WAL,MF,Fulham,Premier League,18,2005,0.8,1,1,1,0,0,0,1,0.0,1,0,0,0,0,1,0,0,0,2023-2024,0.0,1.25
1103,Jack Harrison,ENG,"MF,FW",Everton,Premier League,26,1996,24.6,37,22,12,12,13,17,49,34.7,32,25,5,20,12,49,24,0,0,2023-2024,0.4878048780487805,1.5040650406504064
1104,Abdou Harroui,NED,"MF,FW",Frosinone,Serie A,25,1998,11.3,23,11,11,11,1,8,16,50.0,8,19,3,16,5,28,8,0,0,2023-2024,0.44247787610619466,2.0353982300884956
1105,Makoto Hasebe,JPN,"DF,MF",Eint Frankfurt,Bundesliga,39,1984,2.4,4,2,2,2,0,3,6,50.0,3,2,1,1,2,6,5,0,0,2023-2024,0.8333333333333334,1.6666666666666667
1106,Daiki Hashioka,JPN,DF,Luton Town,Premier League,24,1999,6.6,11,5,6,4,1,5,11,45.5,6,12,7,5,8,19,20,0,0,2023-2024,1.2121212121212122,1.6666666666666667
1107,Hans Hateboer,NED,DF,Atalanta,Serie A,29,1994,12.4,12,5,8,2,2,5,15,33.3,10,21,7,14,4,16,21,0,0,2023-2024,0.3225806451612903,0.9677419354838709
1108,Pantelis Hatzidiakos,GRE,DF,Cagliari,Serie A,26,1997,9.5,22,10,12,10,0,10,17,58.8,7,14,5,9,13,35,30,1,0,2023-2024,1.368421052631579,2.3157894736842106
1109,Kai Havertz,GER,"MF,FW",Arsenal,Premier League,24,1999,29.3,35,15,7,21,7,14,39,35.9,25,26,1,25,20,55,22,0,0,2023-2024,0.68259385665529,1.1945392491467577
1110,Thorgan Hazard,BEL,DF,Dortmund,Bundesliga,30,1993,0.1,0,0,0,0,0,0,0,0.0,0,0,0,0,0,0,0,0,0,2023-2024,0.0,0.0
1111,Jan Paul van Hecke,NED,DF,Brighton,Premier League,23,2000,26.3,47,26,25,19,3,27,45,60.0,18,49,27,22,30,77,76,4,0,2023-2024,1.1406844106463878,1.7870722433460076
1112,Hwang Hee-chan,KOR,"FW,MF",Wolves,Premier League,27,1996,23.5,20,10,11,8,1,9,24,37.5,15,19,1,18,10,30,9,0,0,2023-2024,0.425531914893617,0.851063829787234
1113,Silvan Hefti,SUI,"MF,DF",Genoa,Serie A,25,1997,1.3,6,1,2,3,1,4,7,57.1,3,2,0,2,0,6,1,0,0,2023-2024,0.0,4.615384615384615
1114,Silvan Hefti,SUI,"DF,FW",Montpellier,Ligue 1,25,1997,7.9,21,15,10,7,4,15,29,51.7,14,7,2,5,8,29,11,0,0,2023-2024,1.0126582278481011,2.6582278481012658
1115,Dominique Heintz,GER,DF,Köln,Bundesliga,29,1993,6.3,12,5,6,6,0,8,12,66.7,4,6,1,5,3,15,28,0,0,2023-2024,0.4761904761904762,1.9047619047619049
1116,Dean Henderson,ENG,GK,Crystal Palace,Premier League,26,1997,18.0,1,1,1,0,0,1,2,50.0,1,0,0,0,0,1,8,2,0,2023-2024,0.0,0.05555555555555555
1117,Liam Henderson,SCO,MF,Empoli,Serie A,27,1996,0.1,0,0,0,0,0,0,0,0.0,0,0,0,0,0,0,0,0,0,2023-2024,0.0,0.0
1118,Benjamin Henrichs,GER,DF,RB Leipzig,Bundesliga,26,1997,28.1,68,39,32,26,10,27,58,46.6,31,49,4,45,33,101,37,0,0,2023-2024,1.1743772241992882,2.4199288256227756
1119,Henrique,BRA,DF,Lyon,Ligue 1,29,1994,6.7,10,6,6,4,0,6,11,54.5,5,8,2,6,10,20,3,0,0,2023-2024,1.4925373134328357,1.4925373134328357
1120,Luis Henrique,BRA,"FW,DF",Marseille,Ligue 1,21,2001,8.7,8,7,4,1,3,4,7,57.1,3,9,0,9,8,16,3,0,0,2023-2024,0.9195402298850576,0.9195402298850576
1121,Luiz Henrique,BRA,FW,Betis,La Liga,22,2001,6.8,15,11,4,10,1,9,14,64.3,5,11,0,11,5,20,8,0,0,2023-2024,0.7352941176470589,2.2058823529411766
1122,Matheus Henrique,BRA,MF,Sassuolo,Serie A,25,1997,27.8,43,29,21,18,4,18,43,41.9,25,18,8,10,25,68,31,6,0,2023-2024,0.8992805755395683,1.5467625899280575
1123,Rico Henry,ENG,DF,Brentford,Premier League,26,1997,4.5,7,5,3,3,1,6,7,85.7,1,8,3,5,5,12,5,1,0,2023-2024,1.1111111111111112,1.5555555555555556
1124,Thomas Henry,FRA,FW,Hellas Verona,Serie A,28,1994,3.7,0,0,0,0,0,0,0,0.0,0,0,0,0,0,0,5,0,0,2023-2024,0.0,0.0
1125,Christophe Hérelle,MTQ,DF,Metz,Ligue 1,30,1992,18.0,32,15,24,7,1,13,23,56.5,10,16,9,7,18,50,68,2,0,2023-2024,1.0,1.7777777777777777
Rk,Player,Nation,Pos,Squad,Comp,0,0,90.0,0,0,3,3,3,Tkl,0,0.0,0,0,0,0,0,0,0,0,0,2023-2024,0.0,0.0
1126,Mario Hermoso,ESP,DF,Atlético Madrid,La Liga,28,1995,28.4,46,25,29,13,4,28,51,54.9,23,27,9,18,30,76,93,0,0,2023-2024,1.0563380281690142,1.619718309859155
1127,Javi Hernández,ESP,DF,Cádiz,La Liga,25,1998,27.9,43,24,26,12,5,25,46,54.3,21,34,9,25,19,62,72,1,0,2023-2024,0.6810035842293907,1.5412186379928317
1128,Aridane Hernández,ESP,DF,Rayo Vallecano,La Liga,34,1989,18.8,10,8,5,4,1,4,11,36.4,7,19,14,5,14,24,98,1,0,2023-2024,0.7446808510638298,0.5319148936170213
1129,Lucas Hernández,FRA,DF,Paris S-G,Ligue 1,27,1996,21.2,52,36,28,15,9,29,50,58.0,21,21,5,16,27,79,38,0,0,2023-2024,1.2735849056603774,2.452830188679245
1130,Luis Hernández,ESP,DF,Cádiz,La Liga,34,1989,8.0,7,3,4,3,0,4,8,50.0,4,3,2,1,8,15,25,0,0,2023-2024,1.0,0.875
1131,Theo Hernández,FRA,DF,Milan,Serie A,25,1997,31.0,30,17,19,11,0,11,22,50.0,11,33,13,20,23,53,42,1,0,2023-2024,0.7419354838709677,0.967741935483871
1132,Jorge Herrando,ESP,DF,Osasuna,La Liga,22,2001,18.3,29,19,23,6,0,12,19,63.2,7,20,11,9,15,44,69,1,0,2023-2024,0.819672131147541,1.5846994535519126
1133,Ander Herrera,ESP,MF,Athletic Club,La Liga,33,1989,11.4,44,32,11,26,7,20,36,55.6,16,16,6,10,15,59,18,1,0,2023-2024,1.3157894736842104,3.8596491228070176
1134,Cristian Herrera,ESP,"FW,MF",Las Palmas,La Liga,32,1991,1.8,1,1,0,1,0,1,2,50.0,1,1,0,1,0,1,2,0,0,2023-2024,0.0,0.5555555555555556
1135,Sergio Herrera,ESP,GK,Osasuna,La Liga,30,1993,31.9,2,2,2,0,0,2,3,66.7,1,0,0,0,0,2,22,3,0,2023-2024,0.0,0.06269592476489029
1136,Yangel Herrera,VEN,MF,Girona,La Liga,25,1998,23.4,64,37,28,30,6,30,56,53.6,26,30,8,22,24,88,45,1,0,2023-2024,1.0256410256410258,2.735042735042735
1137,Patrick Herrmann,GER,"FW,DF",Gladbach,Bundesliga,32,1991,1.0,4,4,2,1,1,2,2,100.0,0,1,0,1,1,5,2,0,0,2023-2024,1.0,4.0
1138,Juan Herzog,ESP,DF,Las Palmas,La Liga,20,2003,3.2,6,5,5,1,0,3,6,50.0,3,4,1,3,2,8,17,0,0,2023-2024,0.625,1.875
1139,Son Heung-min,KOR,FW,Tottenham,Premier League,31,1992,32.6,21,13,6,7,8,10,21,47.6,11,4,1,3,8,29,4,0,0,2023-2024,0.24539877300613497,0.6441717791411042
1140,Aaron Hickey,SCO,DF,Brentford,Premier League,21,2002,7.9,16,9,9,3,4,7,7,100.0,0,7,3,4,3,19,10,0,0,2023-2024,0.37974683544303794,2.0253164556962022
1141,Isak Hien,SWE,DF,Hellas Verona,Serie A,24,1999,9.6,17,10,10,7,0,10,19,52.6,9,12,5,7,7,24,33,1,0,2023-2024,0.7291666666666667,1.7708333333333335
1142,Isak Hien,SWE,DF,Atalanta,Serie A,24,1999,10.4,18,12,8,10,0,7,15,46.7,8,12,5,7,14,32,33,0,0,2023-2024,1.346153846153846,1.7307692307692306
1143,James Hill,ENG,DF,Bournemouth,Premier League,21,2002,0.8,3,2,1,2,0,1,1,100.0,0,3,2,1,3,6,8,0,0,2023-2024,3.75,3.75
1144,Piero Hincapié,ECU,DF,Leverkusen,Bundesliga,21,2002,16.5,35,22,14,17,4,13,17,76.5,4,18,7,11,13,48,43,0,0,2023-2024,0.7878787878787878,2.121212121212121
1145,Jack Hinshelwood,ENG,DF,Brighton,Premier League,18,2005,9.7,14,5,7,4,3,5,13,38.5,8,6,2,4,14,28,18,0,0,2023-2024,1.4432989690721651,1.4432989690721651
1146,Adam Hložek,CZE,"MF,FW",Leverkusen,Bundesliga,21,2002,5.1,10,4,2,4,4,3,7,42.9,4,4,1,3,2,12,1,0,0,2023-2024,0.3921568627450981,1.9607843137254903
1147,Nicolas Höfler,GER,MF,Freiburg,Bundesliga,33,1990,25.9,63,40,36,20,7,22,49,44.9,27,30,16,14,31,94,45,0,0,2023-2024,1.196911196911197,2.4324324324324325
1148,Jonas Hofmann,GER,MF,Leverkusen,Bundesliga,31,1992,24.5,20,14,6,9,5,10,24,41.7,14,18,0,18,8,28,6,0,0,2023-2024,0.32653061224489793,0.8163265306122449
1149,Philipp Hofmann,GER,FW,Bochum,Bundesliga,30,1993,17.5,10,5,4,5,1,4,7,57.1,3,11,2,9,4,14,17,0,0,2023-2024,0.22857142857142856,0.5714285714285714
1150,Lucas Höler,GER,"FW,MF",Freiburg,Bundesliga,29,1994,25.6,32,24,14,10,8,4,23,17.4,19,19,4,15,15,47,35,0,0,2023-2024,0.5859375,1.25
Rk,Player,Nation,Pos,Squad,Comp,0,0,90.0,0,0,3,3,3,Tkl,0,0.0,0,0,0,0,0,0,0,0,0,2023-2024,0.0,0.0
1151,Mason Holgate,ENG,DF,Sheffield Utd,Premier League,26,1996,7.9,12,7,5,6,1,5,12,41.7,7,12,5,7,11,23,40,0,0,2023-2024,1.3924050632911391,1.5189873417721518
1152,Fabian Holland,GER,"MF,DF",Darmstadt 98,Bundesliga,33,1990,20.4,47,26,18,21,8,20,37,54.1,17,22,12,10,24,71,29,0,0,2023-2024,1.1764705882352942,2.3039215686274512
1153,Benedict Hollerbach,GER,"FW,MF",Union Berlin,Bundesliga,22,2001,14.2,17,11,5,7,5,7,22,31.8,15,28,0,28,4,21,3,0,0,2023-2024,0.28169014084507044,1.1971830985915493
1154,Emil Holm,SWE,DF,Atalanta,Serie A,23,2000,10.5,28,19,17,9,2,16,36,44.4,20,25,3,22,7,35,25,0,0,2023-2024,0.6666666666666666,2.6666666666666665
1155,Gerrit Holtmann,PHI,"MF,FW",Darmstadt 98,Bundesliga,28,1995,4.4,8,5,3,4,1,7,10,70.0,3,7,0,7,2,10,4,1,0,2023-2024,0.45454545454545453,1.8181818181818181
1156,Martin Hongla,CMR,MF,Hellas Verona,Serie A,25,1998,12.0,24,13,9,13,2,8,11,72.7,3,8,3,5,7,31,24,0,0,2023-2024,0.5833333333333334,2.0
1157,Martin Hongla,CMR,"MF,DF",Granada,La Liga,25,1998,6.2,7,3,2,5,0,3,9,33.3,6,6,3,3,6,13,13,1,0,2023-2024,0.9677419354838709,1.129032258064516
1158,Franck Honorat,FRA,"DF,FW",Gladbach,Bundesliga,26,1996,26.1,25,13,13,10,2,11,20,55.0,9,22,3,19,9,34,35,1,0,2023-2024,0.3448275862068965,0.9578544061302682
1159,Mathias Honsak,AUT,"FW,MF",Darmstadt 98,Bundesliga,26,1996,11.3,14,7,7,6,1,6,20,30.0,14,14,2,12,8,22,25,0,0,2023-2024,0.7079646017699115,1.238938053097345
1160,Sydney van Hooijdonk,NED,FW,Bologna,Serie A,23,2000,2.4,3,0,0,2,1,1,2,50.0,1,1,1,0,1,4,4,0,0,2023-2024,0.4166666666666667,1.25
1161,Fraser Hornby,SCO,"FW,MF",Darmstadt 98,Bundesliga,23,1999,2.4,0,0,0,0,0,0,1,0.0,1,2,1,1,0,0,4,0,0,2023-2024,0.0,0.0
1162,Lukáš Hrádecký,FIN,GK,Leverkusen,Bundesliga,33,1989,33.0,0,0,0,0,0,0,1,0.0,1,1,0,1,0,0,10,2,0,2023-2024,0.0,0.0
1163,Xabier Huarte Armendáriz,ESP,MF,Osasuna,La Liga,22,2001,0.1,0,0,0,0,0,0,0,0.0,0,0,0,0,0,0,0,0,0,2023-2024,0.0,0.0
1164,Timo Hübers,GER,DF,Köln,Bundesliga,27,1996,30.9,68,47,51,14,3,49,80,61.3,31,54,28,26,63,131,168,1,0,2023-2024,2.0388349514563107,2.2006472491909386
1165,Callum Hudson-Odoi,ENG,"FW,MF",Nott'ham Forest,Premier League,22,2000,20.6,18,8,4,5,9,7,28,25.0,21,16,1,15,7,25,12,1,0,2023-2024,0.3398058252427184,0.8737864077669902
1166,Will Hughes,ENG,MF,Crystal Palace,Premier League,28,1995,21.0,61,33,30,20,11,24,48,50.0,24,36,14,22,21,82,25,0,0,2023-2024,1.0,2.9047619047619047
1167,Dean Huijsen,ESP,DF,Roma,Serie A,18,2005,5.7,10,5,5,5,0,1,4,25.0,3,7,4,3,4,14,26,2,0,2023-2024,0.7017543859649122,1.7543859649122806
1168,Dean Huijsen,ESP,DF,Juventus,Serie A,18,2005,0.1,0,0,0,0,0,0,0,0.0,0,0,0,0,0,0,1,0,0,2023-2024,0.0,0.0
1169,Mats Hummels,GER,DF,Dortmund,Bundesliga,34,1988,17.6,52,34,34,12,6,30,53,56.6,23,33,11,22,33,85,82,0,0,2023-2024,1.8749999999999998,2.954545454545454
1170,Denis Huseinbasic,BIH,MF,Köln,Bundesliga,22,2001,18.1,38,18,17,15,6,20,31,64.5,11,26,1,25,13,51,14,0,0,2023-2024,0.718232044198895,2.0994475138121547
1171,Elseid Hysaj,ALB,DF,Lazio,Serie A,29,1994,13.3,24,14,8,13,3,15,24,62.5,9,16,6,10,17,41,31,0,0,2023-2024,1.2781954887218046,1.8045112781954886
1172,Pierre Højbjerg,DEN,MF,Tottenham,Premier League,27,1995,14.6,32,18,13,17,2,13,34,38.2,21,21,7,14,19,51,30,3,0,2023-2024,1.3013698630136987,2.191780821917808
1173,Rasmus Højlund,DEN,FW,Manchester Utd,Premier League,20,2003,24.0,11,7,2,3,6,5,13,38.5,8,9,1,8,1,12,19,0,0,2023-2024,0.041666666666666664,0.4583333333333333
1174,Iago,BRA,DF,Augsburg,Bundesliga,26,1997,18.0,36,17,22,10,4,17,33,51.5,16,39,8,31,18,54,43,0,0,2023-2024,1.0,2.0
1175,Pablo Ibáñez,ESP,MF,Osasuna,La Liga,24,1998,12.8,18,9,5,7,6,5,21,23.8,16,26,3,23,9,27,17,0,0,2023-2024,0.703125,1.40625
Rk,Player,Nation,Pos,Squad,Comp,0,0,90.0,0,0,3,3,3,Tkl,0,0.0,0,0,0,0,0,0,0,0,0,2023-2024,0.0,0.0
1176,Arijon Ibrahimović,GER,"FW,DF",Frosinone,Serie A,17,2005,5.3,7,6,4,2,1,1,9,11.1,8,4,0,4,1,8,3,0,0,2023-2024,0.18867924528301888,1.3207547169811322
1177,Iglesias,ESP,"DF,FW",Getafe,La Liga,25,1998,15.7,41,22,25,11,5,21,33,63.6,12,18,7,11,16,57,53,0,0,2023-2024,1.019108280254777,2.6114649681528666
1178,Borja Iglesias,ESP,FW,Betis,La Liga,30,1993,4.5,0,0,0,0,0,0,3,0.0,3,0,0,0,2,2,2,0,0,2023-2024,0.4444444444444444,0.0
1179,Borja Iglesias,ESP,FW,Leverkusen,Bundesliga,30,1993,2.8,1,0,0,1,0,0,1,0.0,1,2,0,2,1,2,1,0,0,2023-2024,0.35714285714285715,0.35714285714285715
1180,Igor,BRA,DF,Brighton,Premier League,25,1998,18.2,25,18,7,16,2,17,29,58.6,12,22,9,13,14,39,52,1,0,2023-2024,0.7692307692307693,1.3736263736263736
1181,Jonathan Ikone,FRA,FW,Fiorentina,Serie A,25,1998,18.7,22,11,7,9,6,10,17,58.8,7,12,0,12,3,25,8,0,0,2023-2024,0.16042780748663102,1.1764705882352942
1182,Chukwubuikem Ikwuemesi,NGA,FW,Salernitana,Serie A,21,2001,11.8,3,1,0,2,1,2,6,33.3,4,1,1,0,1,4,8,0,0,2023-2024,0.0847457627118644,0.2542372881355932
1183,Andrej Ilic,SRB,FW,Lille,Ligue 1,23,2000,0.1,0,0,0,0,0,0,0,0.0,0,0,0,0,0,0,0,0,0,2023-2024,0.0,0.0
1184,Ivan Ilić,SRB,MF,Torino,Serie A,22,2001,23.3,22,8,9,10,3,13,27,48.1,14,20,7,13,20,42,31,0,0,2023-2024,0.8583690987124464,0.944206008583691
1185,Samuel Iling-Junior,ENG,"DF,MF",Juventus,Serie A,19,2003,9.0,23,13,9,11,3,11,18,61.1,7,17,5,12,6,29,19,0,0,2023-2024,0.6666666666666666,2.5555555555555554
1186,Imanol,ESP,DF,Athletic Club,La Liga,23,2000,5.8,7,5,1,5,1,5,18,27.8,13,6,0,6,7,14,15,0,0,2023-2024,1.206896551724138,1.206896551724138
1187,Joel Imasuen,USA,FW,Werder Bremen,Bundesliga,18,2004,0.0,0,0,0,0,0,0,0,0.0,0,0,0,0,0,0,0,0,0,2023-2024,,
1188,Ciro Immobile,ITA,FW,Lazio,Serie A,33,1990,18.4,11,9,2,5,4,3,14,21.4,11,9,3,6,5,16,11,0,0,2023-2024,0.27173913043478265,0.5978260869565218
1189,Gino Infantino,ARG,MF,Fiorentina,Serie A,20,2003,1.1,1,1,0,1,0,0,1,0.0,1,4,0,4,3,4,1,0,0,2023-2024,2.727272727272727,0.9090909090909091
1190,Danny Ings,ENG,FW,West Ham,Premier League,31,1992,4.5,6,2,0,6,0,4,13,30.8,9,4,1,3,3,9,7,0,0,2023-2024,0.6666666666666666,1.3333333333333333
1191,Bonke Innocent,NGA,MF,Lorient,Ligue 1,27,1996,2.3,6,4,2,2,2,2,9,22.2,7,2,1,1,4,10,2,0,0,2023-2024,1.7391304347826089,2.608695652173913
1192,Tim Iroegbunam,ENG,MF,Aston Villa,Premier League,20,2003,1.8,7,5,4,2,1,4,9,44.4,5,3,0,3,2,9,3,0,0,2023-2024,1.1111111111111112,3.888888888888889
1193,Alexander Isak,SWE,FW,Newcastle Utd,Premier League,23,1999,25.1,5,0,2,1,2,2,8,25.0,6,16,1,15,6,11,13,0,0,2023-2024,0.2390438247011952,0.199203187250996
1194,Gustav Isaksen,DEN,FW,Lazio,Serie A,22,2001,11.9,4,3,2,1,1,1,9,11.1,8,11,1,10,4,8,4,0,0,2023-2024,0.3361344537815126,0.3361344537815126
1195,Isco,ESP,MF,Betis,La Liga,31,1992,25.8,41,27,15,21,5,14,38,36.8,24,19,1,18,10,51,7,0,0,2023-2024,0.38759689922480617,1.5891472868217054
1196,Thomas Isherwood,SWE,DF,Darmstadt 98,Bundesliga,25,1998,7.1,11,5,7,3,1,5,9,55.6,4,10,7,3,10,21,34,0,0,2023-2024,1.4084507042253522,1.5492957746478875
1197,Ismaily,BRA,DF,Lille,Ligue 1,33,1990,27.4,72,47,34,25,13,31,60,51.7,29,33,6,27,32,104,77,0,0,2023-2024,1.1678832116788322,2.6277372262773726
1198,Ardian Ismajli,ALB,DF,Empoli,Serie A,26,1996,22.7,26,16,18,6,2,18,23,78.3,5,28,17,11,23,49,126,1,0,2023-2024,1.013215859030837,1.145374449339207
1199,Yanis Issoufou,FRA,MF,Montpellier,Ligue 1,16,2006,0.1,0,0,0,0,0,0,0,0.0,0,0,0,0,0,0,0,0,0,2023-2024,0.0,0.0
1200,Ko Itakura,JPN,"DF,MF",Gladbach,Bundesliga,26,1997,17.7,34,21,17,15,2,16,26,61.5,10,32,18,14,22,56,62,0,0,2023-2024,1.2429378531073447,1.92090395480226
Rk,Player,Nation,Pos,Squad,Comp,0,0,90.0,0,0,3,3,3,Tkl,0,0.0,0,0,0,0,0,0,0,0,0,2023-2024,0.0,0.0
1201,Hiroki Ito,JPN,DF,Stuttgart,Bundesliga,24,1999,24.8,19,18,13,6,0,11,26,42.3,15,29,17,12,29,48,86,2,0,2023-2024,1.1693548387096775,0.7661290322580645
1202,Junya Ito,JPN,"FW,MF",Reims,Ligue 1,30,1993,30.2,33,15,11,14,8,10,36,27.8,26,23,1,22,14,47,7,0,0,2023-2024,0.4635761589403974,1.0927152317880795
1203,Diego Iturralde,ESP,DF,Sevilla,La Liga,20,2003,0.4,0,0,0,0,0,0,0,0.0,0,1,1,0,0,0,2,0,0,2023-2024,0.0,0.0
1204,Alex Iwobi,NGA,MF,Everton,Premier League,27,1996,1.6,2,0,1,0,1,2,3,66.7,1,2,0,2,1,3,0,0,0,2023-2024,0.625,1.25
1205,Alex Iwobi,NGA,"FW,MF",Fulham,Premier League,27,1996,24.4,29,18,12,15,2,12,25,48.0,13,16,0,16,14,43,9,0,0,2023-2024,0.5737704918032788,1.1885245901639345
1206,Armando Izzo,ITA,DF,Monza,Serie A,31,1992,18.3,27,17,17,9,1,16,27,59.3,11,20,16,4,27,54,49,1,0,2023-2024,1.4754098360655736,1.4754098360655736
1207,Nicolas Jackson,SEN,FW,Chelsea,Premier League,22,2001,31.1,21,13,5,8,8,5,24,20.8,19,20,5,15,4,25,17,0,0,2023-2024,0.12861736334405144,0.67524115755627
1208,Jérémy Jacquet,FRA,MF,Rennes,Ligue 1,18,2005,0.1,1,1,1,0,0,0,1,0.0,1,0,0,0,1,2,0,0,0,2023-2024,10.0,10.0
1209,Jérémy Jacquet,FRA,DF,Clermont Foot,Ligue 1,18,2005,2.8,4,3,4,0,0,3,3,100.0,0,7,3,4,6,10,10,0,0,2023-2024,2.142857142857143,1.4285714285714286
1210,Lee Jae-sung,KOR,"MF,FW",Mainz 05,Bundesliga,30,1992,23.5,33,20,11,16,6,13,39,33.3,26,22,2,20,27,60,23,0,0,2023-2024,1.148936170212766,1.4042553191489362
1211,Paul Jaeckel,GER,DF,Union Berlin,Bundesliga,25,1998,2.6,7,2,4,3,0,5,9,55.6,4,3,2,1,4,11,7,0,0,2023-2024,1.5384615384615383,2.692307692307692
1212,Filip Jagiełło,POL,MF,Genoa,Serie A,25,1997,0.4,0,0,0,0,0,0,1,0.0,1,1,1,0,1,1,0,0,0,2023-2024,2.5,0.0
1213,Kristijan Jakić,CRO,MF,Augsburg,Bundesliga,26,1997,11.7,28,14,14,10,4,15,33,45.5,18,13,1,12,20,48,15,0,0,2023-2024,1.7094017094017095,2.393162393162393
1214,Kristijan Jakić,CRO,"MF,FW",Eint Frankfurt,Bundesliga,26,1997,2.2,3,3,1,2,0,1,3,33.3,2,1,0,1,2,5,2,0,0,2023-2024,0.9090909090909091,1.3636363636363635
1215,Ismail Jakobs,SEN,DF,Monaco,Ligue 1,23,1999,16.3,57,41,27,21,9,29,47,61.7,18,19,2,17,11,68,40,0,0,2023-2024,0.6748466257668712,3.496932515337423
1216,Ablie Jallow,GAM,"MF,FW",Metz,Ligue 1,24,1998,10.2,8,5,2,3,3,3,5,60.0,2,4,0,4,8,16,3,0,0,2023-2024,0.7843137254901962,0.7843137254901962
1217,Reece James,ENG,DF,Chelsea,Premier League,23,1999,4.7,14,9,10,3,1,8,10,80.0,2,4,4,0,3,17,7,1,0,2023-2024,0.6382978723404255,2.978723404255319
1218,Vitaly Janelt,GER,"MF,DF",Brentford,Premier League,25,1998,33.9,63,38,29,25,9,32,64,50.0,32,35,9,26,36,99,64,3,0,2023-2024,1.0619469026548674,1.8584070796460177
1219,Jakub Jankto,CZE,"MF,FW",Cagliari,Serie A,27,1996,9.7,12,9,9,1,2,8,20,40.0,12,5,1,4,5,17,20,0,0,2023-2024,0.5154639175257733,1.2371134020618557
1220,Tony Jantschke,GER,"DF,MF",Gladbach,Bundesliga,33,1990,0.3,1,1,1,0,0,1,1,100.0,0,2,2,0,1,2,4,0,0,2023-2024,3.3333333333333335,3.3333333333333335
1221,Adnan Januzaj,BEL,"FW,MF",Sevilla,La Liga,28,1995,2.1,3,3,2,0,1,0,1,0.0,1,2,0,2,1,4,0,0,0,2023-2024,0.47619047619047616,1.4285714285714286
1222,Nuha Jatta,GAM,FW,RB Leipzig,Bundesliga,17,2006,0.0,0,0,0,0,0,0,0,0.0,0,0,0,0,0,0,0,0,0,2023-2024,,
1223,Mikel Jauregizar,ESP,MF,Athletic Club,La Liga,19,2003,1.7,0,0,0,0,0,0,6,0.0,6,5,0,5,0,0,2,0,0,2023-2024,0.0,0.0
1224,Luis Javier Suárez,COL,FW,Almería,La Liga,25,1997,10.2,7,5,2,5,0,2,6,33.3,4,11,0,11,0,7,13,0,0,2023-2024,0.0,0.6862745098039216
1225,Danley Jean-Jacques,HAI,MF,Metz,Ligue 1,23,2000,29.8,54,28,24,21,9,19,56,33.9,37,48,7,41,44,98,44,0,0,2023-2024,1.4765100671140938,1.8120805369127517
Rk,Player,Nation,Pos,Squad,Comp,0,0,90.0,0,0,3,3,3,Tkl,0,0.0,0,0,0,0,0,0,0,0,0,2023-2024,0.0,0.0
1226,Salim El Jebari,MAR,MF,Atlético Madrid,La Liga,19,2004,0.1,1,0,0,1,0,0,0,0.0,0,0,0,0,0,1,1,0,0,2023-2024,0.0,10.0
1227,Daniel Jebbison,ENG,FW,Sheffield Utd,Premier League,19,2003,0.2,0,0,0,0,0,0,0,0.0,0,1,0,1,0,0,0,0,0,2023-2024,0.0,0.0
1228,Jeffinho,BRA,"FW,MF",Lyon,Ligue 1,23,1999,3.4,11,4,3,5,3,4,11,36.4,7,1,0,1,0,11,0,0,0,2023-2024,0.0,3.235294117647059
1229,Fredrik Jensen,FIN,"MF,FW",Augsburg,Bundesliga,25,1997,14.9,23,11,9,8,6,14,28,50.0,14,30,1,29,12,35,21,0,0,2023-2024,0.8053691275167785,1.5436241610738255
1230,Mathias Jensen,DEN,MF,Brentford,Premier League,27,1996,24.5,54,32,25,22,7,26,95,27.4,69,41,6,35,23,77,25,1,0,2023-2024,0.9387755102040817,2.204081632653061
1231,Moritz Jenz,GER,DF,Wolfsburg,Bundesliga,24,1999,19.4,34,24,21,11,2,14,21,66.7,7,29,17,12,26,60,94,0,0,2023-2024,1.3402061855670104,1.752577319587629
1232,Gabriel Jesus,BRA,FW,Arsenal,Premier League,26,1997,16.4,24,17,11,5,8,5,18,27.8,13,23,1,22,13,37,12,0,0,2023-2024,0.7926829268292683,1.4634146341463417
1233,Juan Jesus,BRA,DF,Napoli,Serie A,32,1991,23.5,42,19,28,12,2,23,33,69.7,10,23,12,11,23,65,67,1,0,2023-2024,0.9787234042553191,1.7872340425531914
1234,Alejandro Jiménez,ESP,DF,Milan,Serie A,18,2005,0.8,2,1,2,0,0,2,5,40.0,3,0,0,0,0,2,4,0,0,2023-2024,0.0,2.5
1235,Raúl Jiménez,MEX,FW,Fulham,Premier League,32,1991,15.5,18,12,4,8,6,7,20,35.0,13,11,3,8,4,22,13,0,0,2023-2024,0.25806451612903225,1.1612903225806452
1236,João Pedro,BRA,"FW,MF",Brighton,Premier League,21,2001,22.7,31,14,10,13,8,14,24,58.3,10,15,2,13,11,42,28,0,0,2023-2024,0.4845814977973568,1.3656387665198237
1237,Joelinton,BRA,"MF,FW",Newcastle Utd,Premier League,26,1996,14.2,39,27,21,15,3,14,38,36.8,24,23,7,16,19,58,11,1,0,2023-2024,1.3380281690140845,2.746478873239437
1238,Ryan John Giles,ENG,"DF,MF",Luton Town,Premier League,23,2000,5.6,8,6,4,3,1,2,7,28.6,5,2,0,2,4,12,22,0,0,2023-2024,0.7142857142857143,1.4285714285714286
1239,Ben Johnson,ENG,"DF,FW",West Ham,Premier League,23,2000,6.0,11,7,7,3,1,9,14,64.3,5,2,1,1,5,16,14,0,0,2023-2024,0.8333333333333334,1.8333333333333333
1240,Brennan Johnson,WAL,FW,Tottenham,Premier League,22,2001,23.2,26,15,14,5,7,12,31,38.7,19,37,1,36,10,36,12,1,0,2023-2024,0.4310344827586207,1.120689655172414
1241,Brennan Johnson,WAL,"FW,MF",Nott'ham Forest,Premier League,22,2001,2.6,4,1,1,1,2,2,4,50.0,2,4,1,3,0,4,0,0,0,2023-2024,0.0,1.5384615384615383
1242,Joseph Johnson,ENG,DF,Luton Town,Premier League,17,2006,0.9,0,0,0,0,0,0,1,0.0,1,0,0,0,0,0,0,0,0,2023-2024,0.0,0.0
1243,Sam Johnstone,ENG,GK,Crystal Palace,Premier League,30,1993,20.0,1,0,1,0,0,1,1,100.0,0,0,0,0,1,2,5,0,0,2023-2024,0.05,0.05
1244,Curtis Jones,ENG,MF,Liverpool,Premier League,22,2001,13.0,27,14,12,12,3,10,23,43.5,13,22,0,22,7,34,8,0,0,2023-2024,0.5384615384615384,2.076923076923077
1245,Frenkie de Jong,NED,MF,Barcelona,La Liga,26,1997,18.2,43,26,14,23,6,8,19,42.1,11,18,8,10,14,57,28,1,0,2023-2024,0.7692307692307693,2.3626373626373627
1246,Joan Jordán,ESP,MF,Sevilla,La Liga,29,1994,4.2,8,7,3,3,2,7,15,46.7,8,4,2,2,4,12,2,0,0,2023-2024,0.9523809523809523,1.9047619047619047
1247,Jordi,ESP,"MF,DF",Getafe,La Liga,22,2001,6.4,16,11,3,11,2,7,15,46.7,8,7,2,5,8,24,7,0,0,2023-2024,1.25,2.5
1248,Jeremy Jorge,ESP,FW,Getafe,La Liga,20,2003,0.0,0,0,0,0,0,0,0,0.0,0,0,0,0,0,0,0,0,0,2023-2024,,
1249,Kaio Jorge,BRA,FW,Frosinone,Serie A,21,2002,9.0,6,4,0,1,5,3,4,75.0,1,6,0,6,1,7,0,0,0,2023-2024,0.1111111111111111,0.6666666666666666
1250,Jorginho,ITA,MF,Arsenal,Premier League,31,1991,10.2,24,10,6,10,8,11,23,47.8,12,17,1,16,12,36,7,1,0,2023-2024,1.1764705882352942,2.3529411764705883
Rk,Player,Nation,Pos,Squad,Comp,0,0,90.0,0,0,3,3,3,Tkl,0,0.0,0,0,0,0,0,0,0,0,0,2023-2024,0.0,0.0
1251,Willian José,BRA,FW,Betis,La Liga,31,1991,21.9,7,3,1,2,4,2,5,40.0,3,8,2,6,2,9,15,0,0,2023-2024,0.09132420091324202,0.31963470319634707
1252,Joselu,ESP,FW,Real Madrid,La Liga,33,1990,18.7,6,3,1,4,1,0,7,0.0,7,11,1,10,6,12,11,0,0,2023-2024,0.32085561497326204,0.32085561497326204
1253,Diogo Jota,POR,FW,Liverpool,Premier League,26,1996,12.7,23,13,6,13,4,10,23,43.5,13,9,1,8,7,30,4,0,0,2023-2024,0.5511811023622047,1.8110236220472442
1254,Antoine Joujou,FRA,"FW,MF",Le Havre,Ligue 1,20,2003,8.7,20,12,7,7,6,11,21,52.4,10,11,2,9,7,27,5,0,0,2023-2024,0.8045977011494253,2.298850574712644
1255,Luka Jović,SRB,FW,Milan,Serie A,25,1997,9.7,6,4,0,3,3,4,6,66.7,2,3,0,3,1,7,9,0,0,2023-2024,0.10309278350515465,0.6185567010309279
1256,Kamil Jóźwiak,POL,MF,Granada,La Liga,25,1998,6.3,13,10,4,6,3,9,17,52.9,8,4,0,4,2,15,6,0,0,2023-2024,0.31746031746031744,2.0634920634920637
1257,Juanmi,ESP,FW,Cádiz,La Liga,30,1993,9.7,9,4,2,7,0,2,9,22.2,7,6,0,6,6,15,3,0,0,2023-2024,0.6185567010309279,0.9278350515463918
1258,Juanpe,ESP,DF,Girona,La Liga,32,1991,8.3,11,8,8,3,0,9,10,90.0,1,17,11,6,7,18,50,1,0,2023-2024,0.8433734939759036,1.325301204819277
1259,Mads Juel Andersen,DEN,DF,Luton Town,Premier League,25,1997,4.4,6,5,4,2,0,4,4,100.0,0,9,6,3,8,14,29,0,0,2023-2024,1.8181818181818181,1.3636363636363635
1260,Christopher Jullien,FRA,DF,Montpellier,Ligue 1,30,1993,13.7,16,12,11,5,0,6,17,35.3,11,25,20,5,12,28,106,2,0,2023-2024,0.8759124087591241,1.1678832116788322
1261,Anthony Jung,GER,DF,Werder Bremen,Bundesliga,31,1991,28.7,37,23,21,14,2,18,33,54.5,15,39,17,22,24,61,102,0,0,2023-2024,0.8362369337979094,1.289198606271777
1262,Eli Junior Kroupi,FRA,"FW,MF",Lorient,Ligue 1,17,2006,12.0,7,4,2,2,3,1,9,11.1,8,6,0,6,10,17,5,0,0,2023-2024,0.8333333333333334,0.5833333333333334
1263,Hamed Junior Traorè,CIV,MF,Bournemouth,Premier League,23,2000,0.5,1,0,1,0,0,1,3,33.3,2,3,0,3,0,1,0,0,0,2023-2024,0.0,2.0
1264,Hamed Junior Traorè,CIV,MF,Napoli,Serie A,23,2000,4.2,4,2,2,0,2,1,6,16.7,5,3,0,3,2,6,1,1,0,2023-2024,0.47619047619047616,0.9523809523809523
1265,Vinicius Júnior,BRA,FW,Real Madrid,La Liga,23,2000,20.7,18,13,5,5,8,3,12,25.0,9,13,0,13,1,19,3,2,0,2023-2024,0.04830917874396135,0.8695652173913043
1266,Josip Juranović,CRO,DF,Union Berlin,Bundesliga,27,1995,14.4,20,14,11,7,2,10,21,47.6,11,17,3,14,12,32,27,1,0,2023-2024,0.8333333333333333,1.3888888888888888
1267,David Jurásek,CZE,DF,Hoffenheim,Bundesliga,22,2000,5.5,14,11,13,1,0,7,17,41.2,10,7,2,5,3,17,22,1,0,2023-2024,0.5454545454545454,2.5454545454545454
1268,Julian Justvan,GER,"FW,MF",Hoffenheim,Bundesliga,25,1998,0.5,1,0,1,0,0,1,2,50.0,1,1,0,1,0,1,0,0,0,2023-2024,0.0,2.0
1269,Julian Justvan,GER,"MF,FW",Darmstadt 98,Bundesliga,25,1998,11.4,10,4,2,7,1,3,17,17.6,14,12,2,10,11,21,6,1,0,2023-2024,0.9649122807017544,0.8771929824561403
1270,Filip Jørgensen,DEN,GK,Villarreal,La Liga,21,2002,36.0,3,1,3,0,0,3,4,75.0,1,0,0,0,2,5,10,3,0,2023-2024,0.05555555555555555,0.08333333333333333
1271,Mathias Jørgensen,DEN,DF,Brentford,Premier League,33,1990,12.1,17,12,15,1,1,11,19,57.9,8,9,5,4,12,29,40,0,0,2023-2024,0.9917355371900827,1.4049586776859504
1272,Mohamed Kaba,FRA,MF,Lecce,Serie A,21,2001,15.3,39,23,15,16,8,17,34,50.0,17,22,4,18,12,51,13,0,0,2023-2024,0.7843137254901961,2.549019607843137
1273,Sory Kaba,GUI,FW,Las Palmas,La Liga,28,1995,8.0,2,0,0,2,0,0,5,0.0,5,6,0,6,0,2,9,0,0,2023-2024,0.0,0.25
1274,Ozan Kabak,TUR,DF,Hoffenheim,Bundesliga,23,2000,25.4,48,35,32,14,2,19,33,57.6,14,43,21,22,46,94,106,2,0,2023-2024,1.8110236220472442,1.8897637795275593
1275,Christian Kabasele,BEL,DF,Udinese,Serie A,32,1991,9.6,10,7,4,5,1,2,11,18.2,9,15,9,6,12,22,56,0,0,2023-2024,1.25,1.0416666666666667
Rk,Player,Nation,Pos,Squad,Comp,0,0,90.0,0,0,3,3,3,Tkl,0,0.0,0,0,0,0,0,0,0,0,0,2023-2024,0.0,0.0
1276,Issa Kaboré,BFA,DF,Luton Town,Premier League,22,2001,19.2,52,28,23,21,8,24,45,53.3,21,22,11,11,16,68,56,2,0,2023-2024,0.8333333333333334,2.7083333333333335
1277,Abdoul Kader Bamba,FRA,"FW,MF",Nantes,Ligue 1,29,1994,6.8,10,7,2,5,3,5,15,33.3,10,4,0,4,4,14,4,1,0,2023-2024,0.5882352941176471,1.4705882352941178
1278,Yaya Kader Fofana,MLI,"MF,DF",Reims,Ligue 1,19,2004,0.4,3,3,1,1,1,0,1,0.0,1,0,0,0,1,4,0,0,0,2023-2024,2.5,7.5
1279,Pavel Kadeřábek,CZE,"DF,FW",Hoffenheim,Bundesliga,31,1992,26.8,31,19,10,15,6,18,40,45.0,22,22,8,14,23,54,68,0,0,2023-2024,0.8582089552238805,1.1567164179104477
1280,Tino Kadewere,ZIM,"FW,MF",Lyon,Ligue 1,27,1996,3.3,1,1,0,1,0,1,5,20.0,4,3,1,2,5,6,7,0,0,2023-2024,1.5151515151515151,0.30303030303030304
1281,Tino Kadewere,ZIM,"FW,MF",Nantes,Ligue 1,27,1996,8.7,9,4,3,3,3,6,11,54.5,5,10,1,9,10,19,8,0,0,2023-2024,1.149425287356322,1.0344827586206897
1282,Kaiky,BRA,DF,Almería,La Liga,19,2004,5.8,7,4,6,0,1,3,6,50.0,3,9,7,2,3,10,29,1,0,2023-2024,0.5172413793103449,1.206896551724138
1283,Florian Kainz,AUT,"MF,FW",Köln,Bundesliga,30,1992,24.4,28,20,8,13,7,17,39,43.6,22,20,6,14,13,41,23,1,0,2023-2024,0.5327868852459017,1.1475409836065575
1284,Sasa Kalajdzic,AUT,FW,Wolves,Premier League,26,1997,1.8,6,2,3,2,1,1,2,50.0,1,3,0,3,1,7,6,0,0,2023-2024,0.5555555555555556,3.333333333333333
1285,Sasa Kalajdzic,AUT,FW,Eint Frankfurt,Bundesliga,26,1997,3.6,2,2,0,2,0,0,0,0.0,0,2,2,0,2,4,6,0,0,2023-2024,0.5555555555555556,0.5555555555555556
1286,Arnaud Kalimuendo,FRA,FW,Rennes,Ligue 1,21,2002,23.8,5,4,2,2,1,2,5,40.0,3,13,2,11,4,9,4,0,0,2023-2024,0.1680672268907563,0.21008403361344538
1287,Yayah Kallon,SLE,FW,Hellas Verona,Serie A,22,2001,0.0,0,0,0,0,0,0,0,0.0,0,0,0,0,0,0,0,0,0,2023-2024,,
1288,Gedeon Kalulu,COD,DF,Lorient,Ligue 1,25,1997,10.8,23,17,13,8,2,12,22,54.5,10,18,2,16,5,28,30,0,0,2023-2024,0.4629629629629629,2.1296296296296293
1289,Pierre Kalulu,FRA,DF,Milan,Serie A,23,2000,4.2,5,1,2,3,0,1,2,50.0,1,4,3,1,1,6,12,1,0,2023-2024,0.23809523809523808,1.1904761904761905
1290,Daichi Kamada,JPN,MF,Lazio,Serie A,26,1996,17.2,53,36,22,22,9,28,52,53.8,24,24,5,19,18,71,7,0,0,2023-2024,1.0465116279069768,3.0813953488372094
1291,Waren Kamanzi,NOR,"DF,FW",Toulouse,Ligue 1,22,2000,13.2,36,24,16,16,4,13,23,56.5,10,11,3,8,9,45,35,0,0,2023-2024,0.6818181818181819,2.7272727272727275
1292,Boubacar Kamara,FRA,MF,Aston Villa,Premier League,23,1999,18.4,43,29,16,21,6,24,47,51.1,23,21,7,14,21,64,16,0,0,2023-2024,1.1413043478260871,2.336956521739131
1293,Hassane Kamara,CIV,DF,Udinese,Serie A,29,1994,24.7,45,32,26,13,6,25,38,65.8,13,29,2,27,26,71,66,0,0,2023-2024,1.0526315789473684,1.8218623481781377
1294,Willy Kambwala,FRA,DF,Manchester Utd,Premier League,18,2004,3.7,3,1,1,2,0,1,3,33.3,2,6,3,3,4,7,14,1,0,2023-2024,1.081081081081081,0.8108108108108107
1295,Jakub Kamiński,POL,"FW,MF",Wolfsburg,Bundesliga,21,2002,5.3,14,5,12,2,0,3,6,50.0,3,3,0,3,2,16,5,0,0,2023-2024,0.37735849056603776,2.6415094339622645
1296,Thomas Kaminski,BEL,GK,Luton Town,Premier League,30,1992,37.8,2,1,2,0,0,2,6,33.3,4,1,0,1,0,2,14,2,0,2023-2024,0.0,0.052910052910052914
1297,Kevin Kampl,SVN,MF,RB Leipzig,Bundesliga,32,1990,15.1,19,8,8,9,2,10,21,47.6,11,19,7,12,11,30,14,1,0,2023-2024,0.728476821192053,1.2582781456953642
1298,Harry Kane,ENG,FW,Bayern Munich,Bundesliga,30,1993,31.5,13,9,4,4,5,6,18,33.3,12,12,4,8,6,19,14,0,0,2023-2024,0.19047619047619047,0.4126984126984127
1299,Lee Kang-in,KOR,"FW,MF",Paris S-G,Ligue 1,22,2001,16.3,26,13,7,9,10,15,36,41.7,21,7,0,7,6,32,3,0,0,2023-2024,0.36809815950920244,1.5950920245398772
1300,Yann Karamoh,FRA,"MF,FW",Torino,Serie A,25,1998,1.8,1,0,0,0,1,0,0,0.0,0,0,0,0,0,1,1,0,0,2023-2024,0.0,0.5555555555555556
Rk,Player,Nation,Pos,Squad,Comp,0,0,90.0,0,0,3,3,3,Tkl,0,0.0,0,0,0,0,0,0,0,0,0,2023-2024,0.0,0.0
1301,Yann Karamoh,FRA,"FW,MF",Montpellier,Ligue 1,25,1998,3.2,1,0,0,0,1,1,2,50.0,1,3,0,3,0,1,0,0,0,2023-2024,0.0,0.3125
1302,Atakan Karazor,GER,MF,Stuttgart,Bundesliga,26,1996,29.1,72,44,23,38,11,29,60,48.3,31,37,8,29,27,99,43,0,0,2023-2024,0.9278350515463917,2.4742268041237114
1303,Ayman Kari,FRA,MF,Lorient,Ligue 1,18,2004,9.9,18,14,9,9,0,12,19,63.2,7,19,2,17,6,24,9,1,0,2023-2024,0.6060606060606061,1.8181818181818181
1304,Emir Karic,AUT,DF,Darmstadt 98,Bundesliga,26,1997,19.8,45,27,23,14,8,21,33,63.6,12,42,11,31,13,58,43,0,0,2023-2024,0.6565656565656566,2.2727272727272725
1305,Loris Karius,GER,GK,Newcastle Utd,Premier League,30,1993,1.0,0,0,0,0,0,0,0,0.0,0,0,0,0,0,0,1,0,0,2023-2024,0.0,0.0
1306,Jesper Karlsson,SWE,FW,Bologna,Serie A,25,1998,3.8,3,3,2,1,0,2,8,25.0,6,4,0,4,4,7,1,0,0,2023-2024,1.0526315789473684,0.7894736842105263
1307,Jon Karrikaburu,ESP,"MF,FW",Alavés,La Liga,20,2002,0.2,0,0,0,0,0,0,0,0.0,0,0,0,0,0,0,0,0,0,2023-2024,0.0,0.0
1308,Rick Karsdorp,NED,DF,Roma,Serie A,28,1995,13.2,25,18,11,8,6,16,24,66.7,8,13,4,9,9,34,16,0,0,2023-2024,0.6818181818181819,1.893939393939394
1309,Grigoris Kastanos,CYP,"MF,DF",Salernitana,Serie A,25,1998,16.4,23,14,8,9,6,9,20,45.0,11,13,4,9,8,31,9,0,0,2023-2024,0.48780487804878053,1.402439024390244
1310,Silas Katompa,COD,"FW,MF",Stuttgart,Bundesliga,24,1998,10.0,5,3,3,2,0,3,12,25.0,9,9,0,9,0,5,4,0,0,2023-2024,0.0,0.5
1311,Panos Katseris,GRE,DF,Lorient,Ligue 1,22,2001,11.6,26,20,16,8,2,16,25,64.0,9,20,4,16,8,34,18,0,0,2023-2024,0.6896551724137931,2.241379310344828
1312,Mikkel Kaufmann,DEN,FW,Union Berlin,Bundesliga,22,2001,5.4,6,3,2,3,1,3,10,30.0,7,12,0,12,1,7,4,0,0,2023-2024,0.18518518518518517,1.111111111111111
1313,Michael Kayode,ITA,DF,Fiorentina,Serie A,19,2004,22.9,53,30,27,15,11,35,48,72.9,13,25,12,13,18,71,46,2,0,2023-2024,0.7860262008733625,2.3144104803493453
1314,Moise Kean,ITA,FW,Juventus,Serie A,23,2000,7.3,7,4,3,2,2,1,3,33.3,2,4,1,3,2,9,5,0,0,2023-2024,0.273972602739726,0.9589041095890412
1315,Michael Keane,ENG,DF,Everton,Premier League,30,1993,4.9,7,3,3,3,1,1,7,14.3,6,5,4,1,5,12,18,1,0,2023-2024,1.0204081632653061,1.4285714285714284
1316,Ibrahima Kebe,MLI,MF,Girona,La Liga,22,2000,0.1,1,1,0,1,0,0,0,0.0,0,1,0,1,1,2,0,0,0,2023-2024,10.0,10.0
1317,Kévin Keben Biakolo,CMR,DF,Toulouse,Ligue 1,19,2004,5.8,4,2,4,0,0,3,6,50.0,3,7,0,7,8,12,17,0,0,2023-2024,1.3793103448275863,0.6896551724137931
1318,Yassine Kechta,MAR,MF,Le Havre,Ligue 1,21,2002,20.5,46,24,24,19,3,31,73,42.5,42,20,3,17,23,69,16,1,0,2023-2024,1.1219512195121952,2.2439024390243905
1319,Thilo Kehrer,GER,"DF,MF",West Ham,Premier League,26,1996,0.2,1,1,0,1,0,0,0,0.0,0,2,2,0,0,1,0,0,0,2023-2024,0.0,5.0
1320,Thilo Kehrer,GER,DF,Monaco,Ligue 1,26,1996,14.7,32,22,22,7,3,22,39,56.4,17,18,6,12,30,62,55,0,0,2023-2024,2.0408163265306123,2.17687074829932
1321,Habib Keita,MLI,MF,Clermont Foot,Ligue 1,21,2002,14.2,34,19,14,15,5,17,28,60.7,11,27,10,17,29,63,30,0,0,2023-2024,2.0422535211267605,2.3943661971830985
1322,Naby Keïta,GUI,"MF,DF",Werder Bremen,Bundesliga,28,1995,1.2,1,1,1,0,0,0,1,0.0,1,2,0,2,2,3,1,0,0,2023-2024,1.6666666666666667,0.8333333333333334
1323,Yannik Keitel,GER,"DF,MF",Freiburg,Bundesliga,23,2000,10.2,20,15,14,5,1,10,15,66.7,5,17,8,9,12,32,44,3,0,2023-2024,1.1764705882352942,1.9607843137254903
1324,Caoimhín Kelleher,IRL,GK,Liverpool,Premier League,24,1998,10.0,0,0,0,0,0,0,0,0.0,0,0,0,0,0,0,4,1,0,2023-2024,0.0,0.0
1325,Thomas Keller,GER,"MF,FW",Heidenheim,Bundesliga,23,1999,0.0,0,0,0,0,0,0,0,0.0,0,0,0,0,0,0,0,0,0,2023-2024,,
Rk,Player,Nation,Pos,Squad,Comp,0,0,90.0,0,0,3,3,3,Tkl,0,0.0,0,0,0,0,0,0,0,0,0,2023-2024,0.0,0.0
1326,Lloyd Kelly,ENG,DF,Bournemouth,Premier League,24,1998,17.3,24,19,10,9,5,14,25,56.0,11,22,12,10,13,37,67,0,0,2023-2024,0.7514450867052023,1.3872832369942196
1327,Omari Kellyman,ENG,FW,Aston Villa,Premier League,17,2005,0.4,1,0,0,1,0,1,2,50.0,1,0,0,0,0,1,0,0,0,2023-2024,0.0,2.5
1328,Aljoscha Kemlein,GER,MF,Union Berlin,Bundesliga,18,2004,0.3,0,0,0,0,0,0,3,0.0,3,1,0,1,0,0,0,0,0,2023-2024,0.0,0.0
1329,Tobias Kempe,GER,MF,Darmstadt 98,Bundesliga,34,1989,15.0,20,13,9,8,3,8,24,33.3,16,16,4,12,9,29,12,0,0,2023-2024,0.6,1.3333333333333333
1330,Milos Kerkez,HUN,DF,Bournemouth,Premier League,19,2003,21.9,47,26,31,13,3,30,42,71.4,12,31,11,20,20,67,60,2,0,2023-2024,0.9132420091324202,2.146118721461187
1331,Kaine Kesler-Hayden,ENG,"MF,DF",Aston Villa,Premier League,20,2002,0.1,0,0,0,0,0,0,0,0.0,0,0,0,0,0,0,0,0,0,2023-2024,0.0,0.0
1332,Reda Khadra,GER,"FW,MF",Reims,Ligue 1,22,2001,15.2,16,10,5,4,7,8,20,40.0,12,8,2,6,3,19,13,0,0,2023-2024,0.19736842105263158,1.0526315789473684
1333,Wahbi Khazri,TUN,FW,Montpellier,Ligue 1,32,1991,12.6,24,17,8,12,4,14,35,40.0,21,10,0,10,3,27,7,0,0,2023-2024,0.2380952380952381,1.9047619047619049
1334,Rani Khedira,GER,MF,Union Berlin,Bundesliga,29,1994,14.9,35,22,15,19,1,17,26,65.4,9,12,5,7,22,57,38,0,0,2023-2024,1.4765100671140938,2.348993288590604
1335,Abdukodir Khusanov,UZB,DF,Lens,Ligue 1,19,2004,9.0,21,12,13,8,0,9,17,52.9,8,13,8,5,13,34,32,2,0,2023-2024,1.4444444444444444,2.3333333333333335
1336,Kiké,ESP,"FW,MF",Alavés,La Liga,33,1989,15.8,8,4,2,3,3,4,9,44.4,5,16,5,11,1,9,12,0,0,2023-2024,0.06329113924050632,0.5063291139240506
1337,Luca Kilian,GER,DF,Köln,Bundesliga,23,1999,7.1,16,9,15,1,0,9,14,64.3,5,12,5,7,7,23,28,0,0,2023-2024,0.9859154929577465,2.2535211267605635
1338,Max Kilman,ENG,DF,Wolves,Premier League,26,1997,38.0,47,21,40,6,1,24,32,75.0,8,64,37,27,39,86,182,4,0,2023-2024,1.0263157894736843,1.236842105263158
1339,Joshua Kimmich,GER,"MF,DF",Bayern Munich,Bundesliga,28,1995,24.2,45,33,25,15,5,26,39,66.7,13,32,4,28,14,59,28,1,0,2023-2024,0.578512396694215,1.859504132231405
1340,Jakub Kiwior,POL,DF,Arsenal,Premier League,23,2000,10.5,20,12,11,8,1,14,19,73.7,5,11,3,8,8,28,28,1,0,2023-2024,0.7619047619047619,1.9047619047619047
1341,Simon Kjær,DEN,DF,Milan,Serie A,34,1989,13.0,24,15,11,11,2,14,22,63.6,8,22,16,6,14,38,46,2,0,2023-2024,1.0769230769230769,1.8461538461538463
1342,Davy Klaassen,NED,MF,Inter,Serie A,30,1993,2.3,4,2,0,4,0,1,3,33.3,2,5,1,4,3,7,4,0,0,2023-2024,1.3043478260869565,1.7391304347826089
1343,Christoph Klarer,AUT,DF,Darmstadt 98,Bundesliga,23,2000,26.2,37,22,30,4,3,24,36,66.7,12,31,20,11,21,58,94,1,0,2023-2024,0.8015267175572519,1.4122137404580153
1344,Tim Kleindienst,GER,FW,Heidenheim,Bundesliga,27,1995,31.9,21,12,6,11,4,7,25,28.0,18,32,8,24,12,33,58,0,0,2023-2024,0.3761755485893417,0.658307210031348
1345,Lukas Klostermann,GER,DF,RB Leipzig,Bundesliga,27,1996,16.0,15,10,7,7,1,4,13,30.8,9,25,12,13,13,28,64,1,0,2023-2024,0.8125,0.9375
1346,Justin Kluivert,NED,"MF,FW",Bournemouth,Premier League,24,1999,21.3,28,14,5,12,11,8,30,26.7,22,16,1,15,8,36,11,0,0,2023-2024,0.3755868544600939,1.3145539906103285
1347,Ansgar Knauff,GER,"MF,DF",Eint Frankfurt,Bundesliga,21,2002,23.4,43,26,17,16,10,17,31,54.8,14,40,3,37,20,63,15,0,0,2023-2024,0.8547008547008548,1.8376068376068377
1348,Robin Knoche,GER,DF,Union Berlin,Bundesliga,31,1992,21.3,34,22,27,7,0,19,30,63.3,11,27,19,8,13,47,73,0,0,2023-2024,0.6103286384976525,1.596244131455399
1349,Gregor Kobel,SUI,GK,Dortmund,Bundesliga,25,1997,26.3,0,0,0,0,0,0,1,0.0,1,0,0,0,0,0,11,0,0,2023-2024,0.0,0.0
1350,Robin Koch,GER,DF,Eint Frankfurt,Bundesliga,27,1996,30.4,38,23,26,12,0,17,27,63.0,10,33,24,9,32,70,136,2,0,2023-2024,1.0526315789473684,1.25
Rk,Player,Nation,Pos,Squad,Comp,0,0,90.0,0,0,3,3,3,Tkl,0,0.0,0,0,0,0,0,0,0,0,0,2023-2024,0.0,0.0
1351,Philipp Köhn,SUI,GK,Monaco,Ligue 1,25,1998,22.0,1,1,1,0,0,1,1,100.0,0,0,0,0,1,2,5,3,0,2023-2024,0.045454545454545456,0.045454545454545456
1352,Dominik Kohr,GER,"DF,MF",Mainz 05,Bundesliga,29,1994,24.3,65,42,36,25,4,36,57,63.2,21,27,6,21,43,108,58,0,0,2023-2024,1.7695473251028806,2.674897119341564
1353,Koke,ESP,MF,Atlético Madrid,La Liga,31,1992,27.7,66,44,27,32,7,36,79,45.6,43,37,12,25,16,82,34,1,0,2023-2024,0.5776173285198556,2.3826714801444044
1354,Sead Kolašinac,BIH,DF,Atalanta,Serie A,30,1993,24.2,44,32,23,19,2,30,49,61.2,19,22,9,13,21,65,47,0,0,2023-2024,0.8677685950413223,1.8181818181818183
1355,Luca Koleosho,ITA,"MF,FW",Burnley,Premier League,18,2004,10.8,7,4,2,5,0,2,10,20.0,8,13,0,13,2,9,0,0,0,2023-2024,0.18518518518518517,0.6481481481481481
1356,Randal Kolo Muani,FRA,"FW,MF",Paris S-G,Ligue 1,24,1998,14.1,10,8,5,3,2,5,13,38.5,8,5,0,5,4,14,10,0,0,2023-2024,0.28368794326241137,0.7092198581560284
1357,Randal Kolo Muani,FRA,FW,Eint Frankfurt,Bundesliga,24,1998,1.7,0,0,0,0,0,0,0,0.0,0,0,0,0,0,0,1,0,0,2023-2024,0.0,0.0
1358,Mert Kömür,GER,"MF,DF",Augsburg,Bundesliga,18,2005,1.3,3,3,3,0,0,3,5,60.0,2,0,0,0,0,3,1,0,0,2023-2024,0.0,2.3076923076923075
1359,Cheick Konaté,MLI,DF,Clermont Foot,Ligue 1,19,2004,11.9,26,15,17,9,0,20,36,55.6,16,16,2,14,13,39,21,0,0,2023-2024,1.0924369747899159,2.1848739495798317
1360,Ibrahima Konaté,FRA,DF,Liverpool,Premier League,24,1999,17.5,36,22,22,13,1,18,24,75.0,6,18,12,6,20,56,51,1,0,2023-2024,1.1428571428571428,2.057142857142857
1361,Geoffrey Kondogbia,CTA,MF,Marseille,Ligue 1,30,1993,16.3,48,31,18,25,5,13,32,40.6,19,21,4,17,30,78,25,0,0,2023-2024,1.840490797546012,2.9447852760736195
1362,Abdoul Koné,FRA,DF,Reims,Ligue 1,18,2005,2.1,7,7,5,2,0,4,11,36.4,7,2,0,2,2,9,9,0,0,2023-2024,0.9523809523809523,3.333333333333333
1363,Amadou Koné,MLI,MF,Reims,Ligue 1,18,2005,5.3,13,8,11,2,0,6,10,60.0,4,8,3,5,10,23,10,0,0,2023-2024,1.8867924528301887,2.452830188679245
1364,Ibrahima Koné,MLI,FW,Almería,La Liga,24,1999,3.1,1,0,1,0,0,1,1,100.0,0,1,0,1,0,1,4,0,0,2023-2024,0.0,0.3225806451612903
1365,Ibrahima Koné,MLI,FW,Lorient,Ligue 1,24,1999,0.4,0,0,0,0,0,0,1,0.0,1,0,0,0,0,0,0,0,0,2023-2024,0.0,0.0
1366,Manu Koné,FRA,MF,Gladbach,Bundesliga,22,2001,17.3,45,26,20,20,5,17,25,68.0,8,22,1,21,15,60,16,1,0,2023-2024,0.8670520231213873,2.6011560693641615
1367,Ezri Konsa,ENG,DF,Aston Villa,Premier League,25,1997,34.1,54,32,28,23,3,23,27,85.2,4,36,20,16,28,82,73,3,0,2023-2024,0.8211143695014662,1.5835777126099706
1368,Teun Koopmeiners,NED,MF,Atalanta,Serie A,25,1998,29.2,39,24,12,22,5,17,50,34.0,33,33,3,30,10,49,35,0,0,2023-2024,0.3424657534246575,1.3356164383561644
1369,Odilon Kossonou,CIV,DF,Leverkusen,Bundesliga,22,2001,20.1,30,20,11,12,7,15,26,57.7,11,27,3,24,27,57,43,1,0,2023-2024,1.3432835820895521,1.4925373134328357
1370,Filip Kostić,SRB,DF,Juventus,Serie A,30,1992,20.2,37,23,20,13,4,17,33,51.5,16,29,8,21,9,46,43,0,0,2023-2024,0.44554455445544555,1.8316831683168318
1371,Christian Kouamé,CIV,FW,Fiorentina,Serie A,25,1997,12.1,13,4,7,6,0,6,10,60.0,4,16,0,16,2,15,10,0,0,2023-2024,0.1652892561983471,1.0743801652892562
1372,Rominigue Kouamé,MLI,MF,Cádiz,La Liga,26,1996,9.1,14,9,6,7,1,7,15,46.7,8,10,2,8,13,27,10,1,0,2023-2024,1.4285714285714286,1.5384615384615385
1373,Koffi Kouao,CIV,DF,Metz,Ligue 1,25,1998,9.6,20,13,12,7,1,11,17,64.7,6,9,6,3,13,33,38,1,0,2023-2024,1.3541666666666667,2.0833333333333335
1374,Tomáš Koubek,CZE,GK,Augsburg,Bundesliga,30,1992,3.0,0,0,0,0,0,0,0,0.0,0,0,0,0,0,0,1,1,0,2023-2024,0.0,0.0
1375,Therence Koudou,FRA,DF,Reims,Ligue 1,18,2004,3.5,2,2,1,1,0,0,2,0.0,2,4,3,1,4,6,9,0,0,2023-2024,1.1428571428571428,0.5714285714285714
Rk,Player,Nation,Pos,Squad,Comp,0,0,90.0,0,0,3,3,3,Tkl,0,0.0,0,0,0,0,0,0,0,0,0,2023-2024,0.0,0.0
1376,Jules Koundé,FRA,DF,Barcelona,La Liga,24,1998,32.2,37,23,22,10,5,28,51,54.9,23,32,12,20,25,62,83,5,0,2023-2024,0.7763975155279502,1.1490683229813663
1377,Boubakar Kouyaté,MLI,DF,Montpellier,Ligue 1,26,1997,21.4,49,30,39,8,2,28,51,54.9,23,31,20,11,29,78,123,1,0,2023-2024,1.355140186915888,2.2897196261682247
1378,Cheikhou Kouyaté,SEN,MF,Nott'ham Forest,Premier League,33,1989,2.4,8,5,3,3,2,1,4,25.0,3,4,1,3,2,10,10,0,0,2023-2024,0.8333333333333334,3.3333333333333335
1379,Mateo Kovačić,CRO,MF,Manchester City,Premier League,29,1994,17.2,36,25,16,15,5,18,28,64.3,10,23,1,22,10,46,10,0,0,2023-2024,0.5813953488372093,2.0930232558139537
1380,Viktor Kovalenko,UKR,MF,Empoli,Serie A,27,1996,6.8,5,2,2,2,1,2,8,25.0,6,12,2,10,1,6,7,0,0,2023-2024,0.14705882352941177,0.7352941176470589
1381,Matej Kovar,CZE,GK,Leverkusen,Bundesliga,23,2000,1.0,0,0,0,0,0,0,0,0.0,0,0,0,0,0,0,0,0,0,2023-2024,0.0,0.0
1382,Dawid Kownacki,POL,FW,Werder Bremen,Bundesliga,26,1997,4.2,1,1,1,0,0,1,4,25.0,3,3,1,2,0,1,1,0,0,2023-2024,0.0,0.23809523809523808
1383,Emil Krafth,SWE,DF,Newcastle Utd,Premier League,28,1994,10.1,21,14,10,7,4,12,25,48.0,13,8,3,5,9,30,21,0,0,2023-2024,0.8910891089108911,2.0792079207920793
1384,Alex Král,CZE,MF,Union Berlin,Bundesliga,25,1998,15.2,19,14,7,10,2,8,20,40.0,12,15,4,11,11,30,30,0,0,2023-2024,0.7236842105263158,1.25
1385,Andrej Kramarić,CRO,"MF,FW",Hoffenheim,Bundesliga,32,1991,24.4,11,2,5,4,2,6,13,46.2,7,14,2,12,10,21,12,2,0,2023-2024,0.4098360655737705,0.45081967213114754
1386,Christoph Kramer,GER,MF,Gladbach,Bundesliga,32,1991,2.8,10,5,5,5,0,2,14,14.3,12,7,1,6,4,14,6,0,0,2023-2024,1.4285714285714286,3.5714285714285716
1387,Frans Krätzig,GER,DF,Bayern Munich,Bundesliga,20,2003,0.6,2,0,2,0,0,1,2,50.0,1,0,0,0,0,2,0,0,0,2023-2024,0.0,3.3333333333333335
1388,Tom Krauß,GER,MF,Mainz 05,Bundesliga,22,2001,15.0,57,33,22,31,4,21,58,36.2,37,33,4,29,17,74,28,0,0,2023-2024,1.1333333333333333,3.8
1389,Rasmus Kristensen,DEN,DF,Roma,Serie A,26,1997,19.4,36,19,25,8,3,28,50,56.0,22,27,7,20,8,44,50,0,0,2023-2024,0.4123711340206186,1.8556701030927836
1390,Thomas Kristensen,DEN,DF,Udinese,Serie A,21,2002,23.3,35,24,25,10,0,21,33,63.6,12,29,20,9,29,64,118,0,0,2023-2024,1.2446351931330473,1.502145922746781
1391,Toni Kroos,GER,MF,Real Madrid,La Liga,33,1990,23.6,53,34,19,25,9,24,59,40.7,35,22,4,18,17,70,11,1,0,2023-2024,0.7203389830508474,2.2457627118644066
1392,Nikola Krstović,MNE,FW,Lecce,Serie A,23,2000,26.4,17,6,3,9,5,6,10,60.0,4,12,4,8,4,21,22,0,0,2023-2024,0.15151515151515152,0.6439393939393939
1393,Rade Krunić,BIH,MF,Milan,Serie A,29,1993,7.6,10,8,3,6,1,4,9,44.4,5,7,3,4,11,21,14,0,0,2023-2024,1.4473684210526316,1.3157894736842106
1394,Lukas Kübler,GER,DF,Freiburg,Bundesliga,30,1992,20.5,50,24,35,13,2,26,42,61.9,16,36,14,22,37,87,57,1,0,2023-2024,1.8048780487804879,2.4390243902439024
1395,Takefusa Kubo,JPN,"FW,MF",Real Sociedad,La Liga,22,2001,23.9,26,17,15,6,5,9,23,39.1,14,21,2,19,11,37,8,1,0,2023-2024,0.46025104602510464,1.087866108786611
1396,Mahmut Kücüksahin,,MF,Augsburg,Bundesliga,19,2004,0.0,0,0,0,0,0,0,0,0.0,0,0,0,0,0,0,0,0,0,2023-2024,,
1397,Mohammed Kudus,GHA,"FW,MF",West Ham,Premier League,22,2000,27.6,65,47,27,27,11,20,40,50.0,20,25,0,25,11,76,9,1,0,2023-2024,0.39855072463768115,2.3550724637681157
1398,Christian Kühlwetter,GER,MF,Heidenheim,Bundesliga,27,1996,0.1,0,0,0,0,0,0,0,0.0,0,0,0,0,0,0,0,0,0,2023-2024,0.0,0.0
1399,Dejan Kulusevski,SWE,"FW,MF",Tottenham,Premier League,23,2000,30.7,62,33,19,20,23,25,67,37.3,42,24,1,23,18,80,2,1,0,2023-2024,0.5863192182410424,2.019543973941368
1400,Sael Kumbedi,FRA,DF,Lyon,Ligue 1,18,2005,10.3,30,20,14,12,4,9,22,40.9,13,12,3,9,14,44,18,2,0,2023-2024,1.3592233009708736,2.9126213592233006
Rk,Player,Nation,Pos,Squad,Comp,0,0,90.0,0,0,3,3,3,Tkl,0,0.0,0,0,0,0,0,0,0,0,0,2023-2024,0.0,0.0
1401,Marash Kumbulla,ALB,DF,Sassuolo,Serie A,23,2000,4.0,3,2,2,1,0,1,2,50.0,1,8,6,2,0,3,22,0,0,2023-2024,0.0,0.75
1402,Justin Kumi,ITA,FW,Sassuolo,Serie A,19,2004,0.0,0,0,0,0,0,0,0,0.0,0,0,0,0,0,0,0,0,0,2023-2024,,
1403,Layvin Kurzawa,FRA,DF,Paris S-G,Ligue 1,30,1992,0.1,0,0,0,0,0,0,0,0.0,0,0,0,0,0,0,0,0,0,2023-2024,0.0,0.0
1404,Berkan Kutlu,TUR,MF,Genoa,Serie A,25,1998,2.2,6,4,5,1,0,3,6,50.0,3,3,0,3,4,10,5,0,0,2023-2024,1.8181818181818181,2.727272727272727
1405,Daler Kuzyaev,RUS,MF,Le Havre,Ligue 1,30,1993,23.2,34,19,11,13,10,15,43,34.9,28,18,5,13,22,56,18,1,0,2023-2024,0.9482758620689655,1.4655172413793105
1406,Khvicha Kvaratskhelia,GEO,FW,Napoli,Serie A,22,2001,30.4,42,21,11,19,12,15,49,30.6,34,15,1,14,13,55,9,0,0,2023-2024,0.4276315789473684,1.381578947368421
1407,Giorgi Kvernadze,GEO,"FW,DF",Frosinone,Serie A,20,2003,0.7,3,0,2,0,1,2,2,100.0,0,1,0,1,1,4,0,0,0,2023-2024,1.4285714285714286,4.285714285714286
1408,Moritz-Broni Kwarteng,GHA,FW,Bochum,Bundesliga,25,1998,3.1,3,0,0,3,0,1,7,14.3,6,4,0,4,2,5,0,0,0,2023-2024,0.6451612903225806,0.9677419354838709
1409,Grejohn Kyei,FRA,FW,Clermont Foot,Ligue 1,27,1995,11.4,6,4,2,2,2,2,3,66.7,1,5,1,4,1,7,10,0,0,2023-2024,0.08771929824561403,0.5263157894736842
1410,Giorgos Kyriakopoulos,GRE,DF,Monza,Serie A,27,1996,19.0,19,10,16,3,0,11,24,45.8,13,18,1,17,13,32,28,0,0,2023-2024,0.6842105263157895,1.0
1411,Luca de la Torre,USA,MF,Celta Vigo,La Liga,25,1998,21.7,39,21,12,22,5,22,43,51.2,21,23,4,19,12,51,17,0,0,2023-2024,0.5529953917050692,1.7972350230414746
1412,Gaëtan Laborde,FRA,"FW,MF",Nice,Ligue 1,29,1994,21.2,18,12,8,4,6,11,30,36.7,19,20,2,18,6,24,8,1,0,2023-2024,0.2830188679245283,0.8490566037735849
1413,Alexandre Lacazette,FRA,FW,Lyon,Ligue 1,32,1991,25.5,19,12,8,9,2,5,17,29.4,12,22,3,19,8,27,9,0,0,2023-2024,0.3137254901960784,0.7450980392156863
1414,Maxence Lacroix,FRA,DF,Wolfsburg,Bundesliga,23,2000,26.2,48,29,28,18,2,29,41,70.7,12,35,12,23,24,72,121,0,0,2023-2024,0.916030534351145,1.83206106870229
1415,Alban Lafont,FRA,GK,Nantes,Ligue 1,24,1999,27.7,0,0,0,0,0,0,2,0.0,2,0,0,0,0,0,14,0,0,2023-2024,0.0,0.0
1416,Yoel Lago,ESP,DF,Celta Vigo,La Liga,19,2004,1.0,2,0,2,0,0,0,0,0.0,0,1,0,1,0,2,2,0,0,2023-2024,0.0,2.0
1417,Aïssa Laïdouni,TUN,MF,Union Berlin,Bundesliga,26,1996,11.9,21,12,4,12,5,4,12,33.3,8,26,2,24,12,33,14,2,0,2023-2024,1.0084033613445378,1.7647058823529411
1418,Konrad Laimer,AUT,"DF,MF",Bayern Munich,Bundesliga,26,1997,19.7,56,36,25,20,11,22,52,42.3,30,42,6,36,18,74,13,2,0,2023-2024,0.9137055837563453,2.8426395939086295
1419,Stefan Lainer,AUT,"DF,MF",Gladbach,Bundesliga,30,1992,8.3,23,16,15,8,0,14,24,58.3,10,13,6,7,5,28,28,0,0,2023-2024,0.6024096385542168,2.7710843373493974
1420,Kenny Lala,MAD,DF,Brest,Ligue 1,31,1991,33.0,78,51,39,28,11,30,56,53.6,26,27,6,21,28,106,75,1,0,2023-2024,0.8484848484848485,2.3636363636363638
1421,Adam Lallana,ENG,"MF,FW",Brighton,Premier League,35,1988,9.4,8,3,4,4,0,0,4,0.0,4,2,1,1,3,11,1,0,0,2023-2024,0.3191489361702127,0.851063829787234
1422,Mathis Lambourde,FRA,FW,Rennes,Ligue 1,17,2006,0.1,0,0,0,0,0,0,1,0.0,1,1,0,1,0,0,1,0,0,2023-2024,0.0,0.0
1423,Érik Lamela,ARG,"FW,MF",Sevilla,La Liga,31,1992,5.1,21,14,4,10,7,10,15,66.7,5,12,0,12,1,22,5,0,0,2023-2024,0.19607843137254904,4.11764705882353
1424,Mohamed Lamine Bayo,GUI,FW,Le Havre,Ligue 1,25,1998,15.4,13,5,2,5,6,2,10,20.0,8,8,1,7,2,15,11,0,0,2023-2024,0.12987012987012986,0.8441558441558441
1425,Didier Lamkel Zé,CMR,"FW,MF",Metz,Ligue 1,26,1996,6.1,7,2,2,4,1,2,5,40.0,3,4,0,4,0,7,11,0,0,2023-2024,0.0,1.1475409836065575
Rk,Player,Nation,Pos,Squad,Comp,0,0,90.0,0,0,3,3,3,Tkl,0,0.0,0,0,0,0,0,0,0,0,0,2023-2024,0.0,0.0
1426,Tariq Lamptey,GHA,"DF,FW",Brighton,Premier League,22,2000,10.2,21,14,14,5,2,13,22,59.1,9,7,3,4,6,27,6,0,0,2023-2024,0.5882352941176471,2.058823529411765
1427,Bruno Langa,MOZ,DF,Almería,La Liga,25,1997,9.1,17,12,10,5,2,6,14,42.9,8,11,4,7,4,21,33,2,0,2023-2024,0.43956043956043955,1.8681318681318682
1428,Gianluca Lapadula,PER,FW,Cagliari,Serie A,33,1990,13.4,1,1,0,0,1,1,10,10.0,9,2,1,1,2,3,5,0,0,2023-2024,0.14925373134328357,0.07462686567164178
1429,Aymeric Laporte,ESP,DF,Manchester City,Premier League,29,1994,0.1,0,0,0,0,0,0,0,0.0,0,1,1,0,0,0,1,0,0,2023-2024,0.0,0.0
1430,Julien Laporte,FRA,DF,Lorient,Ligue 1,29,1993,20.2,23,14,15,7,1,16,36,44.4,20,36,26,10,11,34,116,1,0,2023-2024,0.5445544554455446,1.1386138613861387
1431,Cyle Larin,CAN,FW,Mallorca,La Liga,28,1995,20.3,17,8,6,4,7,2,7,28.6,5,16,5,11,3,20,17,0,0,2023-2024,0.14778325123152708,0.8374384236453202
1432,Yasser Larouci,ALG,DF,Sheffield Utd,Premier League,22,2001,5.9,17,9,10,5,2,10,14,71.4,4,6,1,5,7,24,20,1,0,2023-2024,1.1864406779661016,2.8813559322033897
1433,Hugo Larsson,SWE,MF,Eint Frankfurt,Bundesliga,19,2004,21.0,32,18,18,10,4,15,28,53.6,13,34,7,27,29,61,30,1,0,2023-2024,1.380952380952381,1.5238095238095237
1434,Jamaal Lascelles,ENG,DF,Newcastle Utd,Premier League,29,1993,12.0,14,9,7,7,0,6,11,54.5,5,17,12,5,5,19,42,0,0,2023-2024,0.4166666666666667,1.1666666666666667
1435,Juanmi Latasa,ESP,FW,Getafe,La Liga,22,2001,17.3,9,7,0,6,3,1,11,9.1,10,9,0,9,4,13,21,0,0,2023-2024,0.23121387283236994,0.5202312138728323
1436,Toni Lato,ESP,DF,Mallorca,La Liga,25,1997,17.2,38,23,19,13,6,16,27,59.3,11,17,3,14,17,55,27,0,0,2023-2024,0.9883720930232559,2.2093023255813953
1437,Armand Lauriente,FRA,FW,Sassuolo,Serie A,24,1998,32.3,31,20,8,14,9,13,44,29.5,31,29,4,25,15,46,11,0,0,2023-2024,0.4643962848297214,0.9597523219814242
1438,Roméo Lavia,BEL,MF,Chelsea,Premier League,19,2004,0.4,1,0,0,1,0,0,0,0.0,0,0,0,0,0,1,1,0,0,2023-2024,0.0,2.5
1439,Lázaro,BRA,"FW,MF",Almería,La Liga,21,2002,3.2,4,1,2,0,2,2,8,25.0,6,4,0,4,1,5,1,0,0,2023-2024,0.3125,1.25
1440,Valentino Lazaro,AUT,"DF,MF",Torino,Serie A,27,1996,22.2,18,11,7,9,2,13,19,68.4,6,14,1,13,8,26,29,0,0,2023-2024,0.3603603603603604,0.8108108108108109
1441,Darko Lazović,SRB,"FW,MF",Hellas Verona,Serie A,32,1990,21.4,26,16,11,6,9,16,31,51.6,15,10,1,9,6,32,14,0,0,2023-2024,0.28037383177570097,1.2149532710280375
1442,Manuel Lazzari,ITA,DF,Lazio,Serie A,29,1993,18.6,26,18,13,10,3,18,28,64.3,10,20,4,16,12,38,37,1,0,2023-2024,0.6451612903225806,1.3978494623655913
1443,Théo Le Bris,FRA,"DF,MF",Lorient,Ligue 1,20,2002,16.8,35,22,25,7,3,19,40,47.5,21,24,3,21,12,47,42,0,0,2023-2024,0.7142857142857143,2.083333333333333
1444,Julien Le Cardinal,FRA,DF,Brest,Ligue 1,25,1997,5.3,19,11,11,7,1,8,12,66.7,4,6,3,3,13,32,26,0,0,2023-2024,2.452830188679245,3.5849056603773586
1445,Julien Le Cardinal,FRA,DF,Lens,Ligue 1,25,1997,0.6,6,2,4,2,0,4,9,44.4,5,2,1,1,0,6,0,0,0,2023-2024,0.0,10.0
1446,Jérémy Le Douaron,FRA,FW,Brest,Ligue 1,25,1998,18.0,21,10,7,9,5,11,26,42.3,15,14,1,13,2,23,10,0,0,2023-2024,0.1111111111111111,1.1666666666666667
1447,Enzo Le Fée,FRA,MF,Rennes,Ligue 1,23,2000,17.0,50,35,23,17,10,23,47,48.9,24,17,3,14,19,69,20,0,0,2023-2024,1.1176470588235294,2.9411764705882355
1448,Vincent Le Goff,FRA,"DF,MF",Lorient,Ligue 1,33,1989,6.0,5,0,4,0,1,4,8,50.0,4,11,3,8,3,8,10,0,0,2023-2024,0.5,0.8333333333333334
1449,Robin Le Normand,ESP,DF,Real Sociedad,La Liga,26,1996,27.4,31,22,16,15,0,17,30,56.7,13,26,15,11,28,59,96,1,0,2023-2024,1.0218978102189782,1.1313868613138687
1450,Nicola Leali,ITA,GK,Genoa,Serie A,30,1993,2.0,0,0,0,0,0,0,0,0.0,0,0,0,0,0,0,0,0,0,2023-2024,0.0,0.0
Rk,Player,Nation,Pos,Squad,Comp,0,0,90.0,0,0,3,3,3,Tkl,0,0.0,0,0,0,0,0,0,0,0,0,2023-2024,0.0,0.0
1451,Rafael Leão,POR,FW,Milan,Serie A,24,1999,27.9,16,10,3,8,5,8,13,61.5,5,15,1,14,9,25,19,0,0,2023-2024,0.3225806451612903,0.5734767025089607
1452,Adrien Lebeau,FRA,"MF,FW",Brest,Ligue 1,24,1999,0.6,0,0,0,0,0,0,3,0.0,3,2,1,1,0,0,1,0,0,2023-2024,0.0,0.0
1453,Jean-Louis Leca,FRA,GK,Lens,Ligue 1,37,1985,1.0,0,0,0,0,0,0,0,0.0,0,0,0,0,0,0,1,0,0,2023-2024,0.0,0.0
1454,Benjamin Lecomte,FRA,GK,Montpellier,Ligue 1,32,1991,30.0,0,0,0,0,0,0,1,0.0,1,0,0,0,0,0,16,1,0,2023-2024,0.0,0.0
1455,Jeremías Ledesma,ARG,GK,Cádiz,La Liga,30,1993,33.9,1,1,1,0,0,1,4,25.0,3,0,0,0,0,1,15,3,0,2023-2024,0.0,0.029498525073746312
1456,Pierre Lees-Melou,FRA,MF,Brest,Ligue 1,30,1993,28.0,96,67,51,41,4,49,129,38.0,80,61,11,50,43,139,64,3,0,2023-2024,1.5357142857142858,3.4285714285714284
1457,Diogo Leite,POR,DF,Union Berlin,Bundesliga,24,1999,30.0,52,36,31,15,6,25,51,49.0,26,48,22,26,47,99,155,1,0,2023-2024,1.5666666666666667,1.7333333333333334
1458,Maxim Leitsch,GER,DF,Mainz 05,Bundesliga,25,1998,4.2,6,3,5,1,0,3,6,50.0,3,2,0,2,4,10,13,0,0,2023-2024,0.9523809523809523,1.4285714285714286
1459,Florian Lejeune,FRA,DF,Rayo Vallecano,La Liga,32,1991,37.0,39,25,26,11,2,19,30,63.3,11,33,18,15,23,62,155,1,0,2023-2024,0.6216216216216216,1.054054054054054
1460,Stefan Lekovic,SRB,DF,Villarreal,La Liga,19,2004,0.3,0,0,0,0,0,0,0,0.0,0,1,1,0,0,0,1,0,0,2023-2024,0.0,0.0
1461,Iñigo Lekue,ESP,DF,Athletic Club,La Liga,30,1993,22.2,40,22,25,10,5,27,53,50.9,26,24,6,18,15,55,50,0,0,2023-2024,0.6756756756756757,1.8018018018018018
1462,Thomas Lemar,FRA,MF,Atlético Madrid,La Liga,27,1995,1.8,3,1,2,1,0,1,2,50.0,1,0,0,0,0,3,0,0,0,2023-2024,0.0,1.6666666666666665
1463,Mario Lemina,GAB,MF,Wolves,Premier League,29,1993,33.0,90,58,46,33,11,25,47,53.2,22,36,9,27,41,131,64,0,0,2023-2024,1.2424242424242424,2.727272727272727
1464,Álvaro Lemos,ESP,DF,Las Palmas,La Liga,30,1993,2.8,4,1,1,3,0,0,2,0.0,2,3,1,2,2,6,4,0,0,2023-2024,0.7142857142857143,1.4285714285714286
1465,Ruben Lendinez,ESP,DF,Valencia,La Liga,20,2003,0.1,2,2,0,2,0,1,1,100.0,0,0,0,0,0,2,1,0,0,2023-2024,0.0,20.0
1466,Clément Lenglet,FRA,DF,Aston Villa,Premier League,28,1995,12.8,13,9,7,5,1,7,13,53.8,6,19,11,8,7,20,47,1,0,2023-2024,0.546875,1.015625
1467,Bernd Leno,GER,GK,Fulham,Premier League,31,1992,38.0,0,0,0,0,0,0,0,0.0,0,0,0,0,0,0,14,1,0,2023-2024,0.0,0.0
1468,Christopher Lenz,GER,"DF,MF",RB Leipzig,Bundesliga,28,1994,0.5,2,1,2,0,0,1,1,100.0,0,0,0,0,2,4,2,0,0,2023-2024,4.0,4.0
1469,Christopher Lenz,GER,DF,Eint Frankfurt,Bundesliga,28,1994,0.1,1,1,0,1,0,1,1,100.0,0,0,0,0,0,1,1,0,0,2023-2024,0.0,10.0
1470,Johann Lepenant,FRA,MF,Lyon,Ligue 1,20,2002,2.8,4,3,2,2,0,1,8,12.5,7,5,0,5,4,8,0,0,0,2023-2024,1.4285714285714286,1.4285714285714286
1471,Jefferson Lerma,COL,"MF,DF",Crystal Palace,Premier League,28,1994,26.7,42,25,15,23,4,19,40,47.5,21,31,12,19,36,78,72,0,0,2023-2024,1.348314606741573,1.5730337078651686
1472,Léo Leroy,FRA,MF,Montpellier,Ligue 1,23,2000,5.5,19,10,8,8,3,6,21,28.6,15,12,3,9,7,26,8,0,0,2023-2024,1.2727272727272727,3.4545454545454546
1473,Robert Lewandowski,POL,FW,Barcelona,La Liga,34,1988,30.6,8,5,0,6,2,4,12,33.3,8,13,4,9,9,17,18,0,0,2023-2024,0.29411764705882354,0.26143790849673204
1474,Jamie Leweling,GER,"FW,MF",Stuttgart,Bundesliga,22,2001,16.9,18,10,4,6,8,5,17,29.4,12,21,1,20,5,23,13,0,0,2023-2024,0.2958579881656805,1.0650887573964498
1475,Rico Lewis,ENG,"DF,MF",Manchester City,Premier League,18,2004,9.0,10,7,4,4,2,3,7,42.9,4,7,1,6,4,14,6,0,0,2023-2024,0.4444444444444444,1.1111111111111112
Rk,Player,Nation,Pos,Squad,Comp,0,0,90.0,0,0,3,3,3,Tkl,0,0.0,0,0,0,0,0,0,0,0,0,2023-2024,0.0,0.0
1476,Keane Lewis-Potter,ENG,"FW,DF",Brentford,Premier League,22,2001,16.0,17,7,5,11,1,7,15,46.7,8,10,2,8,7,24,23,0,0,2023-2024,0.4375,1.0625
1477,Philipp Lienhart,AUT,DF,Freiburg,Bundesliga,27,1996,14.1,20,13,14,5,1,13,23,56.5,10,18,11,7,14,34,51,0,0,2023-2024,0.9929078014184397,1.4184397163120568
1478,Matthijs de Ligt,NED,DF,Bayern Munich,Bundesliga,23,1999,15.4,15,12,4,8,3,6,11,54.5,5,14,10,4,19,34,52,0,0,2023-2024,1.2337662337662338,0.974025974025974
1479,Victor Lindelöf,SWE,DF,Manchester Utd,Premier League,29,1994,14.8,15,10,8,7,0,5,13,38.5,8,18,9,9,12,27,40,1,0,2023-2024,0.8108108108108107,1.0135135135135134
1480,Jesper Lindstrøm,DEN,"FW,MF",Napoli,Serie A,23,2000,4.8,8,3,2,3,3,4,8,50.0,4,3,0,3,2,10,6,0,0,2023-2024,0.4166666666666667,1.6666666666666667
1481,Jesper Lindstrøm,DEN,FW,Eint Frankfurt,Bundesliga,23,2000,0.9,1,1,1,0,0,0,0,0.0,0,0,0,0,0,1,0,0,0,2023-2024,0.0,1.1111111111111112
1482,Karol Linetty,POL,MF,Torino,Serie A,28,1995,20.6,30,21,9,20,1,9,29,31.0,20,24,8,16,23,53,27,1,0,2023-2024,1.116504854368932,1.4563106796116503
1483,Samuel Lino,BRA,"DF,MF",Atlético Madrid,La Liga,23,1999,23.1,61,34,32,17,12,35,70,50.0,35,37,1,36,14,75,27,0,0,2023-2024,0.6060606060606061,2.6406926406926403
1484,Luca Lipani,ITA,MF,Sassuolo,Serie A,18,2005,4.3,9,7,4,3,2,3,11,27.3,8,9,2,7,6,15,7,0,0,2023-2024,1.3953488372093024,2.0930232558139537
1485,Pol Lirola,ESP,DF,Frosinone,Serie A,25,1997,17.1,30,18,14,15,1,17,35,48.6,18,12,1,11,19,49,41,1,0,2023-2024,1.111111111111111,1.7543859649122806
1486,Marcin Listkowski,POL,FW,Lecce,Serie A,25,1998,0.1,0,0,0,0,0,0,0,0.0,0,0,0,0,0,0,0,0,0,2023-2024,0.0,0.0
1487,Valentino Livramento,ENG,DF,Newcastle Utd,Premier League,20,2002,14.6,23,13,15,6,2,10,21,47.6,11,16,7,9,25,48,41,1,0,2023-2024,1.7123287671232876,1.5753424657534247
1488,Dejan Ljubicic,AUT,"MF,FW",Köln,Bundesliga,25,1997,22.8,43,27,20,18,5,20,43,46.5,23,22,2,20,18,61,11,0,0,2023-2024,0.7894736842105263,1.8859649122807016
1489,Javier Llabrés,ESP,"MF,FW",Mallorca,La Liga,20,2002,2.7,3,1,1,1,1,1,2,50.0,1,1,0,1,3,6,4,0,0,2023-2024,1.111111111111111,1.111111111111111
1490,Diego Llorente,ESP,DF,Roma,Serie A,29,1993,24.1,31,19,20,10,1,11,24,45.8,13,40,27,13,22,53,79,0,0,2023-2024,0.9128630705394191,1.2863070539419086
1491,Marcos Llorente,ESP,"MF,DF",Atlético Madrid,La Liga,28,1995,28.5,40,23,18,17,5,16,44,36.4,28,36,11,25,14,54,35,0,0,2023-2024,0.49122807017543857,1.4035087719298245
1492,Gautier Lloris,FRA,DF,Le Havre,Ligue 1,28,1995,30.9,50,28,40,9,1,28,42,66.7,14,50,30,20,32,82,142,1,0,2023-2024,1.0355987055016183,1.6181229773462784
1493,Abou Lô,SEN,"MF,DF",Metz,Ligue 1,23,2000,2.2,3,1,2,1,0,1,4,25.0,3,5,2,3,4,7,8,0,0,2023-2024,1.8181818181818181,1.3636363636363635
1494,Giovani Lo Celso,ARG,MF,Tottenham,Premier League,27,1996,5.6,22,13,10,8,4,9,14,64.3,5,4,1,3,5,27,2,0,0,2023-2024,0.8928571428571429,3.928571428571429
1495,Stanislav Lobotka,SVK,MF,Napoli,Serie A,28,1994,36.5,61,39,18,30,13,24,60,40.0,36,30,8,22,30,91,29,0,0,2023-2024,0.821917808219178,1.6712328767123288
1496,Manuel Locatelli,ITA,MF,Juventus,Serie A,25,1998,33.4,69,43,24,35,10,31,58,53.4,27,43,17,26,25,94,65,0,0,2023-2024,0.7485029940119761,2.065868263473054
1497,Bradley Locko,FRA,DF,Brest,Ligue 1,21,2002,32.9,97,55,57,34,6,47,80,58.8,33,28,1,27,40,137,69,0,0,2023-2024,1.21580547112462,2.9483282674772036
1498,Tom Lockyer,WAL,DF,Luton Town,Premier League,28,1994,13.0,25,16,17,6,2,15,22,68.2,7,23,13,10,23,48,68,0,0,2023-2024,1.7692307692307692,1.9230769230769231
1499,Renan Lodi,BRA,DF,Marseille,Ligue 1,25,1998,13.7,24,16,8,13,3,13,21,61.9,8,7,2,5,16,40,35,0,0,2023-2024,1.1678832116788322,1.7518248175182483
1500,Ruben Loftus-Cheek,ENG,MF,Milan,Serie A,27,1996,23.0,28,18,7,14,7,15,27,55.6,12,24,12,12,9,37,10,1,0,2023-2024,0.391304347826087,1.2173913043478262
Rk,Player,Nation,Pos,Squad,Comp,0,0,90.0,0,0,3,3,3,Tkl,0,0.0,0,0,0,0,0,0,0,0,0,2023-2024,0.0,0.0
1501,Andy Logbo,FRA,FW,Le Havre,Ligue 1,19,2004,2.8,0,0,0,0,0,0,3,0.0,3,7,3,4,0,0,2,0,0,2023-2024,0.0,0.0
1502,Enzo Loiodice,FRA,MF,Las Palmas,La Liga,22,2000,19.9,62,35,15,34,13,20,42,47.6,22,20,2,18,12,74,16,1,0,2023-2024,0.6030150753768845,3.1155778894472363
1503,Sean Longstaff,ENG,MF,Newcastle Utd,Premier League,25,1997,30.5,54,30,17,29,8,24,63,38.1,39,43,7,36,17,71,23,0,0,2023-2024,0.5573770491803278,1.7704918032786885
1504,Ademola Lookman,NGA,"FW,MF",Atalanta,Serie A,25,1997,21.0,20,15,2,11,7,8,22,36.4,14,19,0,19,9,29,0,1,0,2023-2024,0.42857142857142855,0.9523809523809523
1505,Noah Loosli,SUI,DF,Bochum,Bundesliga,26,1997,3.8,10,7,6,4,0,7,14,50.0,7,7,1,6,7,17,18,0,0,2023-2024,1.842105263157895,2.6315789473684212
1506,Anthony Lopes,POR,GK,Lyon,Ligue 1,32,1990,31.0,0,0,0,0,0,0,0,0.0,0,0,0,0,0,0,16,0,0,2023-2024,0.0,0.0
1507,David López,ESP,DF,Girona,La Liga,33,1989,21.8,33,20,21,12,0,17,22,77.3,5,28,19,9,20,53,63,4,0,2023-2024,0.9174311926605504,1.5137614678899083
1508,Diego López,ESP,"MF,FW",Valencia,La Liga,21,2002,29.5,37,25,14,16,7,13,56,23.2,43,23,1,22,20,57,12,0,0,2023-2024,0.6779661016949152,1.2542372881355932
1509,Fermin López,ESP,"MF,FW",Barcelona,La Liga,20,2003,16.1,41,21,15,18,8,14,40,35.0,26,14,1,13,4,45,9,0,0,2023-2024,0.24844720496894407,2.5465838509316767
1510,Javi López,ESP,DF,Alavés,La Liga,21,2002,26.5,23,12,11,9,3,15,26,57.7,11,25,9,16,10,33,77,1,0,2023-2024,0.37735849056603776,0.8679245283018868
1511,Maxime Lopez,FRA,MF,Fiorentina,Serie A,25,1997,8.9,18,9,5,10,3,6,12,50.0,6,3,1,2,7,25,6,0,0,2023-2024,0.7865168539325842,2.0224719101123596
1512,Maxime Lopez,FRA,MF,Sassuolo,Serie A,25,1997,1.6,2,1,1,1,0,1,2,50.0,1,1,1,0,2,4,0,0,0,2023-2024,1.25,1.25
1513,Pau López,ESP,GK,Marseille,Ligue 1,28,1994,32.7,0,0,0,0,0,0,2,0.0,2,0,0,0,0,0,10,1,0,2023-2024,0.0,0.0
1514,Unai López,ESP,MF,Rayo Vallecano,La Liga,27,1995,23.4,48,24,18,23,7,21,53,39.6,32,24,3,21,16,64,15,2,0,2023-2024,0.6837606837606838,2.0512820512820515
1515,Dion Lopy,SEN,MF,Almería,La Liga,21,2002,21.3,62,37,36,20,6,17,44,38.6,27,23,5,18,15,77,22,2,0,2023-2024,0.704225352112676,2.9107981220657275
1516,Anthony Losilla,FRA,MF,Bochum,Bundesliga,37,1986,28.6,63,37,15,40,8,23,51,45.1,28,37,8,29,25,88,51,0,0,2023-2024,0.8741258741258741,2.2027972027972025
1517,Jordan Lotomba,SUI,DF,Nice,Ligue 1,24,1998,20.0,36,28,18,9,9,25,35,71.4,10,30,9,21,16,52,26,1,0,2023-2024,0.8,1.8
1518,Tom Louchet,FRA,"MF,DF",Nice,Ligue 1,20,2003,4.5,14,5,6,6,2,7,11,63.6,4,7,3,4,3,17,9,0,0,2023-2024,0.6666666666666666,3.111111111111111
1519,Imran Louza,MAR,MF,Lorient,Ligue 1,24,1999,9.6,13,7,2,8,3,2,8,25.0,6,8,1,7,9,22,4,0,0,2023-2024,0.9375,1.3541666666666667
1520,Matteo Lovato,ITA,DF,Torino,Serie A,23,2000,6.0,10,7,5,5,0,4,5,80.0,1,9,5,4,13,23,10,0,0,2023-2024,2.1666666666666665,1.6666666666666667
1521,Matteo Lovato,ITA,DF,Salernitana,Serie A,23,2000,10.5,27,14,17,8,2,16,24,66.7,8,14,7,7,18,45,41,1,0,2023-2024,1.7142857142857142,2.5714285714285716
1522,Dejan Lovren,CRO,DF,Lyon,Ligue 1,34,1989,8.0,9,7,6,3,0,3,7,42.9,4,6,5,1,12,21,37,0,0,2023-2024,1.5,1.125
1523,Sandi Lovrić,SVN,MF,Udinese,Serie A,25,1998,22.1,25,12,9,11,5,9,23,39.1,14,21,2,19,21,46,24,0,0,2023-2024,0.9502262443438914,1.1312217194570136
1524,Max Lowe,ENG,"DF,MF",Sheffield Utd,Premier League,26,1997,5.6,21,10,13,5,3,8,15,53.3,7,10,4,6,5,26,15,0,0,2023-2024,0.8928571428571429,3.7500000000000004
1525,Anthony Lozano,HON,"MF,FW",Getafe,La Liga,30,1993,1.0,0,0,0,0,0,0,1,0.0,1,0,0,0,0,0,1,0,0,2023-2024,0.0,0.0
Rk,Player,Nation,Pos,Squad,Comp,0,0,90.0,0,0,3,3,3,Tkl,0,0.0,0,0,0,0,0,0,0,0,0,2023-2024,0.0,0.0
1526,Anthony Lozano,HON,FW,Almería,La Liga,30,1993,8.6,7,5,2,5,0,4,7,57.1,3,6,1,5,2,9,12,0,0,2023-2024,0.23255813953488372,0.813953488372093
1527,Lucas,BRA,DF,Cádiz,La Liga,22,2001,17.1,47,27,32,11,4,32,55,58.2,23,27,4,23,17,64,45,0,0,2023-2024,0.9941520467836257,2.7485380116959064
1528,Lorenzo Lucca,ITA,FW,Udinese,Serie A,22,2000,28.8,19,11,4,11,4,5,20,25.0,15,18,3,15,3,22,36,1,0,2023-2024,0.10416666666666666,0.6597222222222222
1529,Jhon Lucumí,COL,DF,Bologna,Serie A,25,1998,24.6,48,29,31,17,0,27,36,75.0,9,32,17,15,16,64,68,2,0,2023-2024,0.6504065040650406,1.951219512195122
1530,José Luis Gayà,ESP,DF,Valencia,La Liga,28,1995,19.9,71,36,44,23,4,43,67,64.2,24,18,3,15,11,82,42,0,0,2023-2024,0.5527638190954774,3.5678391959798996
1531,José Luis Morales,ESP,"FW,MF",Villarreal,La Liga,36,1987,11.6,5,3,1,4,0,3,13,23.1,10,9,1,8,7,12,4,0,0,2023-2024,0.603448275862069,0.4310344827586207
1532,José Luis Palomino,ARG,DF,Atalanta,Serie A,33,1990,0.3,2,1,1,1,0,1,1,100.0,0,2,1,1,1,3,6,0,0,2023-2024,3.3333333333333335,6.666666666666667
1533,Douglas Luiz,BRA,MF,Aston Villa,Premier League,25,1998,33.3,58,38,21,27,10,25,53,47.2,28,32,8,24,23,81,18,2,0,2023-2024,0.6906906906906908,1.7417417417417418
1534,Romelu Lukaku,BEL,FW,Roma,Serie A,30,1993,29.3,6,5,1,2,3,2,4,50.0,2,7,1,6,0,6,19,1,0,2023-2024,0.0,0.20477815699658702
1535,Castello Lukeba,FRA,DF,RB Leipzig,Bundesliga,20,2002,24.3,19,12,10,9,0,10,12,83.3,2,35,13,22,12,31,94,2,0,2023-2024,0.49382716049382713,0.7818930041152263
1536,Dodi Lukebakio,BEL,"FW,MF",Sevilla,La Liga,25,1997,12.5,5,2,2,2,1,1,6,16.7,5,9,2,7,2,7,5,0,0,2023-2024,0.16,0.4
1537,Saša Lukić,SRB,MF,Fulham,Premier League,26,1996,12.5,33,19,9,17,7,18,39,46.2,21,18,5,13,16,49,19,1,0,2023-2024,1.28,2.64
1538,Karlo Lulić,CRO,MF,Frosinone,Serie A,27,1996,0.2,0,0,0,0,0,0,0,0.0,0,1,0,1,1,1,0,0,0,2023-2024,5.0,0.0
1539,Andriy Lunin,UKR,GK,Real Madrid,La Liga,24,1999,21.0,0,0,0,0,0,0,1,0.0,1,0,0,0,0,0,15,1,0,2023-2024,0.0,0.0
1540,Sebastiano Luperto,ITA,DF,Empoli,Serie A,26,1996,37.8,37,26,25,10,2,15,24,62.5,9,46,35,11,32,69,157,1,0,2023-2024,0.8465608465608466,0.978835978835979
1541,Mateus Lusuardi,BRA,DF,Frosinone,Serie A,19,2004,2.4,2,1,1,1,0,1,3,33.3,2,4,2,2,4,6,8,0,0,2023-2024,1.6666666666666667,0.8333333333333334
1542,Andreas Luthe,GER,GK,Bochum,Bundesliga,36,1987,1.0,0,0,0,0,0,0,0,0.0,0,0,0,0,0,0,1,0,0,2023-2024,0.0,0.0
1543,Zito Luvumbo,ANG,"FW,MF",Cagliari,Serie A,21,2002,21.6,9,6,5,2,2,4,15,26.7,11,19,0,19,1,10,2,0,0,2023-2024,0.046296296296296294,0.41666666666666663
1544,Charalambos Lykogiannis,GRE,DF,Bologna,Serie A,29,1993,10.0,10,6,5,4,1,5,10,50.0,5,15,5,10,5,15,30,0,0,2023-2024,0.5,1.0
1545,Senne Lynen,BEL,MF,Werder Bremen,Bundesliga,24,1999,20.0,64,38,33,27,4,30,70,42.9,40,41,8,33,41,105,56,0,0,2023-2024,2.05,3.2
1546,Joshua M'Bahia,CIV,MF,Clermont Foot,Ligue 1,18,2005,0.2,0,0,0,0,0,0,0,0.0,0,0,0,0,0,0,0,0,0,2023-2024,0.0,0.0
1547,Othmane Maamma,FRA,FW,Montpellier,Ligue 1,17,2005,1.0,3,3,2,0,1,1,1,100.0,0,3,0,3,0,3,0,0,0,2023-2024,0.0,3.0
1548,Ian Maatsen,NED,"FW,MF",Chelsea,Premier League,21,2002,2.3,3,2,1,1,1,0,4,0.0,4,4,0,4,3,6,10,0,0,2023-2024,1.3043478260869565,1.3043478260869565
1549,Ian Maatsen,NED,DF,Dortmund,Bundesliga,21,2002,14.0,30,22,15,9,6,16,30,53.3,14,22,4,18,13,43,26,0,0,2023-2024,0.9285714285714286,2.142857142857143
1550,Alexis Mac Allister,ARG,MF,Liverpool,Premier League,24,1998,28.9,99,55,35,50,14,59,125,47.2,66,65,8,57,35,134,25,1,0,2023-2024,1.2110726643598617,3.42560553633218
Rk,Player,Nation,Pos,Squad,Comp,0,0,90.0,0,0,3,3,3,Tkl,0,0.0,0,0,0,0,0,0,0,0,0,2023-2024,0.0,0.0
1551,Deiver Machado,COL,DF,Lens,Ligue 1,29,1993,12.5,24,18,10,10,4,15,20,75.0,5,13,2,11,7,31,8,0,0,2023-2024,0.56,1.92
1552,Darwin Machís,VEN,MF,Cádiz,La Liga,30,1993,8.7,23,14,7,9,7,13,24,54.2,11,8,1,7,4,27,2,0,0,2023-2024,0.4597701149425288,2.6436781609195403
1553,James Maddison,ENG,MF,Tottenham,Premier League,26,1996,23.7,33,19,5,18,10,15,29,51.7,14,15,3,12,13,46,10,1,0,2023-2024,0.5485232067510548,1.3924050632911393
1554,Noni Madueke,ENG,FW,Chelsea,Premier League,21,2002,11.7,16,10,8,4,4,11,34,32.4,23,11,0,11,4,20,14,0,0,2023-2024,0.3418803418803419,1.3675213675213675
1555,Pablo Maffeo,ESP,DF,Mallorca,La Liga,26,1997,16.2,35,22,18,13,4,23,40,57.5,17,12,2,10,10,45,23,0,0,2023-2024,0.617283950617284,2.160493827160494
1556,Gabriel Magalhães,BRA,DF,Arsenal,Premier League,25,1997,33.8,48,28,24,22,2,17,22,77.3,5,44,33,11,31,79,100,1,0,2023-2024,0.9171597633136096,1.4201183431952664
1557,Soungoutou Magassa,FRA,"DF,MF",Monaco,Ligue 1,19,2003,15.0,56,26,22,32,2,26,48,54.2,22,21,4,17,21,77,36,2,0,2023-2024,1.4,3.7333333333333334
1558,Giulio Maggiore,ITA,MF,Salernitana,Serie A,25,1998,20.0,49,29,26,22,1,20,42,47.6,22,27,5,22,24,73,38,0,0,2023-2024,1.2,2.45
1559,Matej Maglica,CRO,DF,Darmstadt 98,Bundesliga,24,1998,18.9,35,21,25,10,0,22,36,61.1,14,29,11,18,22,57,92,5,0,2023-2024,1.1640211640211642,1.851851851851852
1560,Giangiacomo Magnani,ITA,DF,Hellas Verona,Serie A,27,1995,27.2,33,18,23,10,0,15,25,60.0,10,50,28,22,45,78,118,0,0,2023-2024,1.6544117647058825,1.2132352941176472
1561,Hugo Magnetti,FRA,MF,Brest,Ligue 1,25,1998,26.0,49,27,18,26,5,24,58,41.4,34,19,1,18,18,67,18,0,0,2023-2024,0.6923076923076923,1.8846153846153846
1562,Yohann Magnin,FRA,MF,Clermont Foot,Ligue 1,26,1997,18.7,49,31,12,32,5,22,47,46.8,25,38,13,25,19,68,26,1,0,2023-2024,1.0160427807486632,2.6203208556149735
1563,Frank Magri,CMR,"FW,MF",Toulouse,Ligue 1,23,1999,16.0,22,14,5,12,5,15,21,71.4,6,16,4,12,4,26,17,0,0,2023-2024,0.25,1.375
1564,Harry Maguire,ENG,DF,Manchester Utd,Premier League,30,1993,18.4,24,17,14,10,0,12,22,54.5,10,33,24,9,25,49,83,1,0,2023-2024,1.358695652173913,1.3043478260869565
1565,Jon Magunacelaya,ESP,"FW,MF",Real Sociedad,La Liga,23,2000,1.3,5,3,2,3,0,4,8,50.0,4,3,0,3,0,5,2,0,0,2023-2024,0.0,3.846153846153846
1566,Adel Mahamoud,COM,FW,Nantes,Ligue 1,20,2003,0.1,0,0,0,0,0,0,1,0.0,1,0,0,0,0,0,0,0,0,2023-2024,0.0,0.0
1567,Arne Maier,GER,MF,Augsburg,Bundesliga,24,1999,11.1,14,9,5,8,1,5,14,35.7,9,19,2,17,6,20,11,0,0,2023-2024,0.5405405405405406,1.2612612612612613
1568,Habib Maïga,CIV,"MF,FW",Metz,Ligue 1,27,1996,1.6,2,2,1,0,1,1,3,33.3,2,2,0,2,4,6,2,0,0,2023-2024,2.5,1.25
1569,Mike Maignan,FRA,GK,Milan,Serie A,28,1995,29.0,1,0,1,0,0,1,1,100.0,0,1,0,1,1,2,4,3,0,2023-2024,0.034482758620689655,0.034482758620689655
1570,Linton Maina,GER,"FW,MF",Köln,Bundesliga,24,1999,21.1,18,15,11,5,2,9,28,32.1,19,12,1,11,6,24,12,0,0,2023-2024,0.2843601895734597,0.8530805687203791
1571,Patrick Mainka,GER,DF,Heidenheim,Bundesliga,28,1994,34.0,85,49,58,24,3,38,74,51.4,36,66,32,34,49,134,158,1,0,2023-2024,1.4411764705882353,2.5
1572,Kobbie Mainoo,ENG,MF,Manchester Utd,Premier League,18,2005,21.4,47,27,20,16,11,21,45,46.7,24,20,12,8,22,69,30,1,0,2023-2024,1.0280373831775702,2.196261682242991
1573,Ainsley Maitland-Niles,ENG,"DF,MF",Lyon,Ligue 1,25,1997,15.9,34,18,12,14,8,19,37,51.4,18,16,6,10,17,51,29,1,0,2023-2024,1.069182389937107,2.138364779874214
1574,Radosław Majecki,POL,GK,Monaco,Ligue 1,23,1999,12.0,0,0,0,0,0,0,0,0.0,0,1,0,1,0,0,5,1,0,2023-2024,0.0,0.0
1575,Lovro Majer,CRO,MF,Rennes,Ligue 1,25,1998,0.2,0,0,0,0,0,0,0,0.0,0,0,0,0,0,0,1,0,0,2023-2024,0.0,0.0
Rk,Player,Nation,Pos,Squad,Comp,0,0,90.0,0,0,3,3,3,Tkl,0,0.0,0,0,0,0,0,0,0,0,0,2023-2024,0.0,0.0
1576,Lovro Majer,CRO,"MF,FW",Wolfsburg,Bundesliga,25,1998,23.4,39,18,17,22,0,12,31,38.7,19,20,1,19,12,51,13,0,0,2023-2024,0.5128205128205129,1.6666666666666667
1577,Jean-Victor Makengo,FRA,"MF,FW",Lorient,Ligue 1,25,1998,5.3,5,4,3,2,0,2,6,33.3,4,12,1,11,8,13,5,0,0,2023-2024,1.509433962264151,0.9433962264150944
1578,Jordy Makengo,FRA,DF,Freiburg,Bundesliga,21,2001,11.4,17,11,11,5,1,6,10,60.0,4,16,4,12,11,28,37,0,0,2023-2024,0.9649122807017544,1.4912280701754386
1579,Antoine Makoumbou,CGO,MF,Cagliari,Serie A,25,1998,30.0,41,24,21,15,5,15,30,50.0,15,23,4,19,16,57,27,2,0,2023-2024,0.5333333333333333,1.3666666666666667
1580,Nemanja Maksimović,SRB,MF,Getafe,La Liga,28,1995,36.3,65,43,26,31,8,23,41,56.1,18,56,23,33,46,111,61,0,0,2023-2024,1.2672176308539946,1.790633608815427
1581,Julián Malatini,ARG,DF,Werder Bremen,Bundesliga,22,2001,6.7,18,13,12,3,3,16,24,66.7,8,8,1,7,13,31,26,0,0,2023-2024,1.9402985074626866,2.6865671641791042
1582,Daniel Maldini,ITA,"MF,FW",Monza,Serie A,21,2001,3.7,3,2,0,2,1,3,6,50.0,3,2,0,2,2,5,1,0,0,2023-2024,0.5405405405405405,0.8108108108108107
1583,Daniel Maldini,ITA,"FW,MF",Empoli,Serie A,21,2001,2.9,4,2,0,2,2,2,2,100.0,0,5,0,5,2,6,2,0,0,2023-2024,0.6896551724137931,1.3793103448275863
1584,Youssef Maleh,MAR,MF,Empoli,Serie A,24,1998,28.9,74,48,30,36,8,23,52,44.2,29,62,7,55,25,99,29,0,0,2023-2024,0.8650519031141869,2.5605536332179932
1585,Donyell Malen,NED,"FW,MF",Dortmund,Bundesliga,24,1999,19.8,11,7,5,3,3,2,6,33.3,4,11,4,7,2,13,8,0,0,2023-2024,0.10101010101010101,0.5555555555555556
1586,Ruslan Malinovskyi,UKR,MF,Genoa,Serie A,30,1993,17.2,35,20,18,11,6,17,41,41.5,24,22,8,14,5,40,16,0,0,2023-2024,0.29069767441860467,2.0348837209302326
1587,Lennard Maloney,USA,MF,Heidenheim,Bundesliga,23,1999,25.4,43,26,14,24,5,25,59,42.4,34,33,9,24,25,68,88,0,0,2023-2024,0.984251968503937,1.6929133858267718
1588,Aaron Malouda,FRA,FW,Lille,Ligue 1,17,2005,0.0,0,0,0,0,0,0,0,0.0,0,0,0,0,0,0,0,0,0,2023-2024,,
1589,Giorgi Mamardashvili,GEO,GK,Valencia,La Liga,22,2000,36.5,4,3,4,0,0,4,4,100.0,0,1,0,1,2,6,22,2,0,2023-2024,0.0547945205479452,0.1095890410958904
1590,David Mamutovic,GER,"FW,DF",Mainz 05,Bundesliga,22,2000,0.1,1,1,0,1,0,1,1,100.0,0,0,0,0,0,1,0,0,0,2023-2024,0.0,10.0
1591,Wilson Manafá,POR,"DF,MF",Granada,La Liga,29,1994,2.7,6,4,3,2,1,4,7,57.1,3,1,0,1,1,7,4,1,0,2023-2024,0.37037037037037035,2.222222222222222
1592,Hianga Mananga Mbock,FRA,"MF,FW",Brest,Ligue 1,23,1999,0.1,1,0,0,0,1,1,2,50.0,1,0,0,0,1,2,0,0,0,2023-2024,10.0,10.0
1593,Gianluca Mancini,ITA,DF,Roma,Serie A,27,1996,31.9,34,20,21,11,2,11,27,40.7,16,38,26,12,36,70,77,1,0,2023-2024,1.1285266457680252,1.0658307210031348
1594,Marco Mancosu,ITA,"MF,FW",Cagliari,Serie A,34,1988,1.7,3,0,0,2,1,1,2,50.0,1,0,0,0,0,3,0,0,0,2023-2024,0.0,1.7647058823529411
1595,Steve Mandanda,FRA,GK,Rennes,Ligue 1,38,1985,34.0,2,0,2,0,0,2,4,50.0,2,0,0,0,0,2,6,1,0,2023-2024,0.0,0.058823529411764705
1596,Christos Mandas,GRE,GK,Lazio,Serie A,21,2001,8.0,0,0,0,0,0,0,1,0.0,1,0,0,0,1,1,3,1,0,2023-2024,0.125,0.0
1597,Reinildo Mandava,MOZ,DF,Atlético Madrid,La Liga,29,1994,8.1,30,22,16,11,3,19,22,86.4,3,10,2,8,15,45,21,0,0,2023-2024,1.8518518518518519,3.7037037037037037
1598,Aïssa Mandi,ALG,DF,Villarreal,La Liga,31,1991,12.4,13,8,8,5,0,7,14,50.0,7,10,7,3,8,21,41,0,0,2023-2024,0.6451612903225806,1.0483870967741935
1599,Rolando Mandragora,ITA,MF,Fiorentina,Serie A,26,1997,17.6,26,11,8,13,5,10,22,45.5,12,14,3,11,9,35,18,1,0,2023-2024,0.5113636363636364,1.477272727272727
1600,Orel Mangala,BEL,MF,Nott'ham Forest,Premier League,25,1998,17.4,27,13,16,10,1,14,29,48.3,15,12,6,6,26,53,32,0,0,2023-2024,1.4942528735632186,1.5517241379310347
Rk,Player,Nation,Pos,Squad,Comp,0,0,90.0,0,0,3,3,3,Tkl,0,0.0,0,0,0,0,0,0,0,0,0,2023-2024,0.0,0.0
1601,Orel Mangala,BEL,MF,Lyon,Ligue 1,25,1998,4.4,5,3,0,2,3,1,3,33.3,2,3,2,1,5,10,6,0,0,2023-2024,1.1363636363636362,1.1363636363636362
1602,Vito Mannone,ITA,GK,Lille,Ligue 1,35,1988,1.0,0,0,0,0,0,0,0,0.0,0,0,0,0,0,0,0,0,0,2023-2024,0.0,0.0
1603,Kostas Manolas,GRE,DF,Salernitana,Serie A,32,1991,5.4,9,5,6,3,0,6,8,75.0,2,10,7,3,2,11,20,0,0,2023-2024,0.37037037037037035,1.6666666666666665
1604,Javier Manquillo,ESP,"DF,MF",Celta Vigo,La Liga,29,1994,8.3,15,11,6,5,4,8,15,53.3,7,14,3,11,3,18,17,0,0,2023-2024,0.36144578313253006,1.8072289156626504
1605,Braydon Manu,GHA,MF,Darmstadt 98,Bundesliga,26,1997,1.9,2,0,0,1,1,0,0,0.0,0,1,0,1,0,2,0,0,0,2023-2024,0.0,1.0526315789473684
1606,Benson Manuel,ANG,"MF,FW",Burnley,Premier League,26,1997,1.3,3,2,2,1,0,0,0,0.0,0,1,0,1,0,3,0,0,0,2023-2024,0.0,2.3076923076923075
1607,Faitout Maouassa,FRA,"DF,MF",Granada,La Liga,25,1998,2.5,8,5,6,1,1,4,5,80.0,1,6,0,6,1,9,3,0,0,2023-2024,0.4,3.2
1608,Faitout Maouassa,FRA,"MF,DF",Lens,Ligue 1,25,1998,0.8,1,1,1,0,0,1,1,100.0,0,1,0,1,0,1,3,0,0,2023-2024,0.0,1.25
1609,Marcão,BRA,DF,Sevilla,La Liga,27,1996,3.9,9,6,5,4,0,6,10,60.0,4,8,6,2,4,13,11,1,0,2023-2024,1.0256410256410258,2.307692307692308
1610,Solly March,ENG,"FW,DF",Brighton,Premier League,29,1994,6.2,19,14,9,7,3,8,14,57.1,6,5,0,5,11,30,8,0,0,2023-2024,1.7741935483870968,3.064516129032258
1611,Riccardo Marchizza,ITA,DF,Frosinone,Serie A,25,1998,12.8,7,6,4,3,0,3,13,23.1,10,10,2,8,7,14,33,0,0,2023-2024,0.546875,0.546875
1612,Gian Marco Ferrari,ITA,DF,Sassuolo,Serie A,31,1992,25.2,22,10,11,11,0,12,18,66.7,6,28,17,11,25,47,76,0,0,2023-2024,0.9920634920634921,0.873015873015873
1613,Óscar de Marcos,ESP,DF,Athletic Club,La Liga,34,1989,25.1,56,39,26,24,6,42,71,59.2,29,28,6,22,15,71,44,0,0,2023-2024,0.597609561752988,2.231075697211155
1614,Alberto Marí,ESP,FW,Valencia,La Liga,22,2001,3.1,4,2,0,1,3,1,1,100.0,0,3,0,3,0,4,5,0,0,2023-2024,0.0,1.2903225806451613
1615,José Mari,ESP,"MF,FW",Cádiz,La Liga,35,1987,0.2,2,1,0,2,0,1,2,50.0,1,0,0,0,0,2,0,0,0,2023-2024,0.0,10.0
1616,Pablo Marí,ESP,DF,Monza,Serie A,29,1993,29.1,41,25,34,7,0,22,34,64.7,12,40,25,15,37,78,115,1,0,2023-2024,1.2714776632302405,1.40893470790378
1617,José María Giménez,URU,DF,Atlético Madrid,La Liga,28,1995,14.7,18,10,10,7,1,5,16,31.3,11,16,12,4,10,28,95,0,0,2023-2024,0.6802721088435374,1.2244897959183674
1618,Mariano,DOM,"FW,MF",Sevilla,La Liga,29,1993,2.7,1,1,0,1,0,0,1,0.0,1,1,0,1,0,1,2,0,0,2023-2024,0.0,0.37037037037037035
1619,Mirko Marić,CRO,FW,Monza,Serie A,28,1995,3.2,4,0,2,1,1,0,2,0.0,2,4,0,4,2,6,3,0,0,2023-2024,0.625,1.25
1620,Rafa Marín,ESP,DF,Alavés,La Liga,21,2002,27.1,32,20,23,9,0,14,27,51.9,13,34,21,13,33,65,129,2,0,2023-2024,1.2177121771217712,1.1808118081180812
1621,Răzvan Marin,ROU,MF,Empoli,Serie A,27,1996,20.2,40,22,13,23,4,19,29,65.5,10,16,4,12,6,46,30,2,0,2023-2024,0.297029702970297,1.9801980198019802
1622,Diego Mariño,ESP,GK,Almería,La Liga,33,1990,1.0,0,0,0,0,0,0,0,0.0,0,0,0,0,0,0,1,0,0,2023-2024,0.0,0.0
1623,Guillermo Maripán,CHI,DF,Monaco,Ligue 1,29,1994,19.6,22,8,15,6,1,10,27,37.0,17,26,13,13,30,52,106,4,0,2023-2024,1.530612244897959,1.1224489795918366
1624,Mika Màrmol,ESP,DF,Las Palmas,La Liga,21,2002,35.3,70,42,44,24,2,35,53,66.0,18,39,19,20,44,114,147,2,0,2023-2024,1.246458923512748,1.98300283286119
1625,Omar Marmoush,EGY,"FW,MF",Eint Frankfurt,Bundesliga,24,1999,25.6,21,11,7,8,6,6,16,37.5,10,13,0,13,11,32,7,0,0,2023-2024,0.4296875,0.8203125
Rk,Player,Nation,Pos,Squad,Comp,0,0,90.0,0,0,3,3,3,Tkl,0,0.0,0,0,0,0,0,0,0,0,0,2023-2024,0.0,0.0
1626,Marquinhos,BRA,"FW,MF",Nantes,Ligue 1,20,2003,1.7,3,2,2,0,1,1,4,25.0,3,7,2,5,6,9,1,0,0,2023-2024,3.5294117647058822,1.7647058823529411
1627,Marquinhos,BRA,DF,Paris S-G,Ligue 1,29,1994,17.1,19,11,10,7,2,11,17,64.7,6,29,19,10,17,36,58,1,0,2023-2024,0.9941520467836257,1.111111111111111
1628,Unai Marrero,ESP,GK,Real Sociedad,La Liga,21,2001,1.6,0,0,0,0,0,0,0,0.0,0,0,0,0,0,0,0,0,0,2023-2024,0.0,0.0
1629,Agustín Martegani,ARG,MF,Salernitana,Serie A,23,2000,8.1,13,7,7,3,3,6,18,33.3,12,4,1,3,4,17,7,1,0,2023-2024,0.4938271604938272,1.6049382716049383
1630,Eric Martel,GER,MF,Köln,Bundesliga,21,2002,27.3,70,43,32,34,4,37,67,55.2,30,65,19,46,43,113,80,0,0,2023-2024,1.575091575091575,2.564102564102564
1631,Roger Martí,ESP,FW,Cádiz,La Liga,32,1991,15.1,12,6,1,9,2,2,7,28.6,5,16,1,15,7,19,4,0,0,2023-2024,0.4635761589403974,0.794701986754967
1632,Anthony Martial,FRA,FW,Manchester Utd,Premier League,27,1995,5.0,4,1,1,1,2,1,1,100.0,0,4,0,4,0,4,3,0,0,2023-2024,0.0,0.8
1633,Aarón Martín,ESP,DF,Genoa,Serie A,26,1997,15.3,21,10,7,10,4,9,22,40.9,13,12,4,8,9,30,15,0,0,2023-2024,0.5882352941176471,1.3725490196078431
1634,Iván Martín,ESP,MF,Girona,La Liga,24,1999,30.3,44,25,22,15,7,22,57,38.6,35,25,3,22,21,65,14,0,0,2023-2024,0.693069306930693,1.4521452145214522
1635,Jon Martin,ESP,DF,Real Sociedad,La Liga,17,2006,0.3,0,0,0,0,0,0,0,0.0,0,0,0,0,0,0,3,0,0,2023-2024,0.0,0.0
1636,Jonas Martin,FRA,MF,Brest,Ligue 1,33,1990,13.4,43,27,17,24,2,21,36,58.3,15,16,2,14,9,52,28,2,0,2023-2024,0.6716417910447761,3.2089552238805967
1637,Mario Martín,ESP,MF,Real Madrid,La Liga,19,2004,0.2,5,1,0,2,3,3,4,75.0,1,2,1,1,0,5,0,0,0,2023-2024,0.0,25.0
1638,Gabriel Martinelli,BRA,FW,Arsenal,Premier League,22,2001,22.4,30,24,9,12,9,13,32,40.6,19,23,1,22,5,35,9,1,0,2023-2024,0.22321428571428573,1.3392857142857144
1639,Tommaso Martinelli,ITA,GK,Fiorentina,Serie A,17,2006,1.0,0,0,0,0,0,,0,0.0,0,0,0,0,0,0,0,0,0,2023-2024,0.0,0.0
1640,Arnau Martinez,ESP,DF,Girona,La Liga,20,2003,13.8,25,16,17,6,2,15,32,46.9,17,15,5,10,10,35,41,3,0,2023-2024,0.7246376811594203,1.8115942028985506
1641,Emiliano Martínez,ARG,GK,Aston Villa,Premier League,30,1992,33.5,0,0,0,0,0,0,0,0.0,0,0,0,0,0,0,12,3,0,2023-2024,0.0,0.0
1642,Iñigo Martínez,ESP,DF,Barcelona,La Liga,32,1991,14.4,10,7,9,1,0,6,8,75.0,2,13,10,3,11,21,50,0,0,2023-2024,0.7638888888888888,0.6944444444444444
1643,Josep Martinez,ESP,GK,Genoa,Serie A,25,1998,36.0,0,0,0,0,0,0,0,0.0,0,0,0,0,1,1,21,3,0,2023-2024,0.027777777777777776,0.0
1644,Lautaro Martínez,ARG,FW,Inter,Serie A,25,1997,29.5,22,16,4,13,5,4,19,21.1,15,30,1,29,20,42,10,0,0,2023-2024,0.6779661016949152,0.7457627118644068
1645,Lisandro Martínez,ARG,DF,Manchester Utd,Premier League,25,1998,7.2,12,8,8,4,0,5,12,41.7,7,10,8,2,5,17,26,0,0,2023-2024,0.6944444444444444,1.6666666666666665
1646,Marc Martínez,ESP,GK,Granada,La Liga,33,1990,3.0,0,0,0,0,0,0,1,0.0,1,0,0,0,0,0,1,0,0,2023-2024,0.0,0.0
1647,Lucas Martínez Quarta,ARG,DF,Fiorentina,Serie A,27,1996,25.5,75,47,43,28,4,36,54,66.7,18,38,14,24,30,105,69,4,0,2023-2024,1.1764705882352942,2.9411764705882355
1648,Adam Marušić,MNE,DF,Lazio,Serie A,30,1992,34.4,45,31,24,19,2,27,49,55.1,22,27,7,20,29,74,63,2,0,2023-2024,0.8430232558139535,1.308139534883721
1649,Marvin,ESP,"FW,DF",Las Palmas,La Liga,23,2000,20.6,39,25,18,17,4,18,36,50.0,18,28,2,26,14,53,18,1,0,2023-2024,0.6796116504854368,1.8932038834951455
1650,Omar Mascarell,EQG,MF,Mallorca,La Liga,30,1993,17.5,33,16,16,17,0,18,35,51.4,17,24,8,16,31,64,30,1,0,2023-2024,1.7714285714285714,1.8857142857142857
Rk,Player,Nation,Pos,Squad,Comp,0,0,90.0,0,0,3,3,3,Tkl,0,0.0,0,0,0,0,0,0,0,0,0,2023-2024,0.0,0.0
1651,Adam Masina,MAR,DF,Udinese,Serie A,29,1994,0.7,4,0,2,2,0,2,4,50.0,2,2,1,1,2,6,5,0,0,2023-2024,2.857142857142857,5.714285714285714
1652,Adam Masina,MAR,DF,Torino,Serie A,29,1994,11.4,17,12,8,8,1,5,20,25.0,15,12,6,6,11,28,30,0,0,2023-2024,0.9649122807017544,1.4912280701754386
1653,Erhan Mašović,SRB,"DF,MF",Bochum,Bundesliga,24,1998,24.7,64,40,37,22,5,37,70,52.9,33,32,10,22,25,89,75,2,0,2023-2024,1.0121457489878543,2.591093117408907
1654,Han-Noah Massengo,FRA,"MF,DF",Burnley,Premier League,22,2001,0.2,1,1,1,0,0,0,0,0.0,0,1,0,1,0,1,0,0,0,2023-2024,0.0,5.0
1655,Roberto Massimo,GER,"FW,DF",Stuttgart,Bundesliga,22,2000,0.9,1,0,1,0,0,1,2,50.0,1,0,0,0,0,1,1,0,0,2023-2024,0.0,1.1111111111111112
1656,Clinton Mata,ANG,DF,Lyon,Ligue 1,30,1992,24.7,43,24,29,8,6,23,40,57.5,17,35,16,19,40,83,61,0,0,2023-2024,1.6194331983805668,1.7408906882591093
1657,Jaime Mata,ESP,"FW,MF",Getafe,La Liga,34,1988,19.9,24,15,12,8,4,11,26,42.3,15,18,1,17,17,41,31,0,0,2023-2024,0.8542713567839196,1.206030150753769
1658,Pape Matar Sarr,SEN,MF,Tottenham,Premier League,20,2002,23.0,34,24,11,17,6,15,36,41.7,21,21,5,16,31,65,28,1,0,2023-2024,1.3478260869565217,1.4782608695652173
1659,Eliot Matazo,BEL,MF,Monaco,Ligue 1,21,2002,1.1,3,1,0,3,0,2,4,50.0,2,1,1,0,3,6,0,0,0,2023-2024,2.727272727272727,2.727272727272727
1660,Jean-Philippe Mateta,FRA,FW,Crystal Palace,Premier League,26,1997,25.4,22,15,4,11,7,6,10,60.0,4,13,4,9,4,26,14,0,0,2023-2024,0.15748031496062992,0.8661417322834646
1661,Nemanja Matić,SRB,MF,Rennes,Ligue 1,34,1988,11.4,19,10,7,9,3,9,12,75.0,3,15,7,8,27,46,19,0,0,2023-2024,2.3684210526315788,1.6666666666666665
1662,Nemanja Matić,SRB,MF,Lyon,Ligue 1,34,1988,13.9,17,11,8,7,2,9,19,47.4,10,17,6,11,16,33,17,1,0,2023-2024,1.1510791366906474,1.223021582733813
1663,Joël Matip,CMR,DF,Liverpool,Premier League,31,1991,8.7,12,6,7,4,1,8,12,66.7,4,16,12,4,9,21,43,0,0,2023-2024,1.0344827586206897,1.3793103448275863
1664,Alex Matos,ENG,MF,Chelsea,Premier League,18,2004,0.0,0,0,0,0,0,0,0,0.0,0,0,0,0,0,0,0,0,0,2023-2024,,
1665,Chrislain Matsima,FRA,DF,Clermont Foot,Ligue 1,21,2002,13.1,18,11,11,7,0,10,18,55.6,8,14,10,4,13,31,74,1,0,2023-2024,0.9923664122137404,1.3740458015267176
1666,Chrislain Matsima,FRA,DF,Monaco,Ligue 1,21,2002,3.3,9,7,5,3,1,2,7,28.6,5,4,1,3,4,13,4,0,0,2023-2024,1.2121212121212122,2.7272727272727275
1667,Jean Mattéo Bahoya,FRA,"MF,FW",Eint Frankfurt,Bundesliga,18,2005,2.0,3,1,0,3,0,1,4,25.0,3,2,0,2,1,4,1,0,0,2023-2024,0.5,1.5
1668,Remi Matthews,ENG,GK,Crystal Palace,Premier League,29,1994,0.0,0,0,0,0,0,0,0,0.0,0,0,0,0,0,0,1,0,0,2023-2024,,
1669,Alan Matturro,URU,DF,Genoa,Serie A,18,2004,1.2,1,1,1,0,0,1,1,100.0,0,6,3,3,2,3,4,0,0,2023-2024,1.6666666666666667,0.8333333333333334
1670,Azor Matusiwa,NED,MF,Reims,Ligue 1,25,1998,15.4,39,27,17,19,3,22,32,68.8,10,21,3,18,33,72,32,1,0,2023-2024,2.142857142857143,2.5324675324675323
1671,Azor Matusiwa,NED,MF,Rennes,Ligue 1,25,1998,8.8,7,3,3,4,0,4,7,57.1,3,9,2,7,11,18,17,0,0,2023-2024,1.25,0.7954545454545454
1672,Neal Maupay,FRA,FW,Brentford,Premier League,26,1996,14.7,10,7,4,5,1,3,13,23.1,10,11,0,11,2,12,3,0,0,2023-2024,0.1360544217687075,0.6802721088435374
1673,Neal Maupay,FRA,FW,Everton,Premier League,26,1996,1.2,0,0,0,0,0,0,1,0.0,1,2,0,2,0,0,1,0,0,2023-2024,0.0,0.0
1674,Aïman Maurer,MAR,"MF,FW",Clermont Foot,Ligue 1,18,2004,0.6,1,1,1,0,0,1,3,33.3,2,0,0,0,0,1,0,0,0,2023-2024,0.0,1.6666666666666667
1675,Konstantinos Mavropanos,GRE,DF,West Ham,Premier League,25,1997,16.7,28,16,17,9,2,17,21,81.0,4,21,13,8,23,51,79,3,0,2023-2024,1.377245508982036,1.6766467065868265
Rk,Player,Nation,Pos,Squad,Comp,0,0,90.0,0,0,3,3,3,Tkl,0,0.0,0,0,0,0,0,0,0,0,0,2023-2024,0.0,0.0
1676,Christian Mawissa,FRA,DF,Toulouse,Ligue 1,18,2005,12.4,22,15,14,4,4,9,23,39.1,14,22,11,11,22,44,41,1,0,2023-2024,1.7741935483870968,1.7741935483870968
1677,Philipp Max,GER,DF,Eint Frankfurt,Bundesliga,29,1993,15.0,26,17,6,18,2,19,26,73.1,7,18,1,17,7,33,18,2,0,2023-2024,0.4666666666666667,1.7333333333333334
1678,Eric Maxim Choupo-Moting,CMR,"MF,FW",Bayern Munich,Bundesliga,34,1989,8.0,17,12,8,5,4,6,14,42.9,8,5,0,5,7,24,7,0,0,2023-2024,0.875,2.125
1679,Luís Maximiano,POR,GK,Almería,La Liga,24,1999,33.0,0,0,0,0,0,0,1,0.0,1,0,0,0,0,0,19,2,0,2023-2024,0.0,0.0
1680,Noam Mayoka-Tika,BEL,MF,Marseille,Ligue 1,19,2003,0.0,0,0,0,0,0,0,0,0.0,0,0,0,0,0,0,0,0,0,2023-2024,,
1681,Borja Mayoral,ESP,FW,Getafe,La Liga,26,1997,23.9,9,5,2,2,5,5,22,22.7,17,7,0,7,4,13,16,0,0,2023-2024,0.1673640167364017,0.3765690376569038
1682,Senny Mayulu,FRA,"FW,MF",Paris S-G,Ligue 1,17,2006,3.6,13,8,6,6,1,6,7,85.7,1,1,0,1,3,16,0,0,0,2023-2024,0.8333333333333333,3.611111111111111
1683,Youssef Maziz,FRA,"FW,MF",Metz,Ligue 1,25,1998,1.4,0,0,0,0,0,0,2,0.0,2,1,0,1,1,1,2,0,0,2023-2024,0.7142857142857143,0.0
1684,Noussair Mazraoui,MAR,DF,Bayern Munich,Bundesliga,25,1997,13.3,32,21,14,11,7,13,21,61.9,8,14,1,13,20,52,27,1,0,2023-2024,1.5037593984962405,2.406015037593985
1685,Luca Mazzitelli,ITA,MF,Frosinone,Serie A,27,1995,24.6,45,23,15,24,6,26,49,53.1,23,23,7,16,19,64,62,0,0,2023-2024,0.7723577235772358,1.8292682926829267
1686,Pasquale Mazzocchi,ITA,DF,Salernitana,Serie A,28,1995,14.1,25,19,14,10,1,16,29,55.2,13,14,6,8,5,30,31,0,0,2023-2024,0.3546099290780142,1.773049645390071
1687,Pasquale Mazzocchi,ITA,DF,Napoli,Serie A,28,1995,4.8,5,2,1,2,2,2,3,66.7,1,5,1,4,1,6,13,0,0,2023-2024,0.20833333333333334,1.0416666666666667
1688,Kevin Mbabu,SUI,DF,Augsburg,Bundesliga,28,1995,22.7,51,39,25,18,8,23,40,57.5,17,29,9,20,24,75,48,0,0,2023-2024,1.0572687224669604,2.246696035242291
1689,Noah Mbamba,BEL,MF,Leverkusen,Bundesliga,18,2005,0.2,0,0,0,0,0,0,0,0.0,0,0,0,0,1,1,0,0,0,2023-2024,5.0,0.0
1690,Ethan Mbappé,FRA,"MF,DF",Paris S-G,Ligue 1,16,2006,0.5,0,0,0,0,0,0,2,0.0,2,1,0,1,0,0,0,0,0,2023-2024,0.0,0.0
1691,Kylian Mbappé,FRA,FW,Paris S-G,Ligue 1,24,1998,24.0,4,1,1,1,2,4,9,44.4,5,4,0,4,2,6,2,0,0,2023-2024,0.08333333333333333,0.16666666666666666
1692,Malick Mbaye,SEN,"MF,FW",Metz,Ligue 1,19,2004,1.7,5,1,0,1,4,1,2,50.0,1,1,0,1,1,6,2,0,0,2023-2024,0.5882352941176471,2.9411764705882355
1693,Mamadou Mbaye,SEN,DF,Cádiz,La Liga,25,1998,3.2,6,3,3,3,0,2,5,40.0,3,10,7,3,5,11,26,0,0,2023-2024,1.5625,1.875
1694,Chancel Mbemba,COD,DF,Marseille,Ligue 1,28,1994,24.5,33,21,25,7,1,17,30,56.7,13,21,13,8,13,46,95,1,0,2023-2024,0.5306122448979592,1.346938775510204
1695,Nolan Mbemba,CGO,MF,Le Havre,Ligue 1,28,1995,0.2,2,1,0,1,1,1,2,50.0,1,0,0,0,0,2,0,0,0,2023-2024,0.0,10.0
1696,Bryan Mbeumo,CMR,FW,Brentford,Premier League,23,1999,21.8,15,10,6,6,3,5,19,26.3,14,26,2,24,7,22,13,0,0,2023-2024,0.3211009174311926,0.6880733944954128
1697,Christ Mbondi,FRA,FW,Reims,Ligue 1,18,2004,0.0,1,1,1,0,0,1,1,100.0,0,0,0,0,0,1,0,0,0,2023-2024,,inf
1698,Jordi Mboula,ESP,"FW,MF",Hellas Verona,Serie A,24,1999,3.4,4,4,1,2,1,4,7,57.1,3,4,1,3,1,5,0,0,0,2023-2024,0.29411764705882354,1.1764705882352942
1699,Nathanael Mbuku,FRA,FW,Augsburg,Bundesliga,21,2002,0.1,0,0,0,0,0,0,0,0.0,0,1,0,1,0,0,0,0,0,2023-2024,0.0,0.0
1700,James Mcatee,ENG,"MF,FW",Sheffield Utd,Premier League,20,2002,20.2,32,21,9,13,10,13,33,39.4,20,20,0,20,11,43,18,0,0,2023-2024,0.5445544554455446,1.5841584158415842
Rk,Player,Nation,Pos,Squad,Comp,0,0,90.0,0,0,3,3,3,Tkl,0,0.0,0,0,0,0,0,0,0,0,0,2023-2024,0.0,0.0
1701,James Mcatee,ENG,MF,Manchester City,Premier League,20,2002,0.0,0,0,0,0,0,0,0,0.0,0,1,0,1,0,0,0,0,0,2023-2024,,
1702,Oliver McBurnie,SCO,FW,Sheffield Utd,Premier League,27,1996,14.2,17,7,4,7,6,5,12,41.7,7,18,2,16,5,22,28,0,0,2023-2024,0.35211267605633806,1.1971830985915493
1703,James McConnell,ENG,MF,Liverpool,Premier League,18,2004,0.0,0,0,0,0,0,0,0,0.0,0,1,0,1,1,1,0,0,0,2023-2024,inf,
1704,John McGinn,SCO,"MF,FW",Aston Villa,Premier League,28,1994,33.3,59,35,18,34,7,32,77,41.6,45,33,4,29,21,80,21,0,0,2023-2024,0.6306306306306307,1.771771771771772
1705,Scott McKenna,SCO,DF,Nott'ham Forest,Premier League,26,1996,4.6,4,0,3,1,0,2,3,66.7,1,6,4,2,5,9,27,0,0,2023-2024,1.0869565217391306,0.8695652173913044
1706,Weston McKennie,USA,"MF,DF",Juventus,Serie A,24,1998,28.8,48,29,31,11,6,17,27,63.0,10,28,7,21,18,66,69,0,0,2023-2024,0.625,1.6666666666666665
1707,Dwight McNeil,ENG,"MF,FW",Everton,Premier League,23,1999,32.1,44,27,16,14,14,24,55,43.6,31,44,7,37,22,66,37,0,0,2023-2024,0.6853582554517134,1.3707165109034267
1708,Scott McTominay,SCO,"MF,FW",Manchester Utd,Premier League,26,1996,21.1,49,25,23,24,2,22,33,66.7,11,34,12,22,14,63,54,0,0,2023-2024,0.6635071090047393,2.3222748815165875
1709,Facundo Medina,ARG,DF,Lens,Ligue 1,24,1999,30.2,64,38,25,31,8,44,69,63.8,25,38,13,25,24,88,59,2,0,2023-2024,0.794701986754967,2.119205298013245
1710,Ben Mee,ENG,DF,Brentford,Premier League,33,1989,14.1,26,15,12,12,2,17,22,77.3,5,21,13,8,13,39,63,1,0,2023-2024,0.9219858156028369,1.8439716312056738
1711,Marvin Mehlem,GER,MF,Darmstadt 98,Bundesliga,25,1997,16.5,28,21,10,14,4,11,27,40.7,16,21,2,19,33,61,15,0,0,2023-2024,2.0,1.696969696969697
1712,Bamo Meïté,CIV,DF,Marseille,Ligue 1,21,2001,7.1,16,10,13,3,0,8,12,66.7,4,11,5,6,11,27,35,0,0,2023-2024,1.5492957746478875,2.2535211267605635
1713,Bamo Meïté,CIV,DF,Lorient,Ligue 1,21,2001,1.6,2,1,2,0,0,0,1,0.0,1,3,2,1,3,5,9,0,0,2023-2024,1.875,1.25
1714,Hannibal Mejbri,TUN,"MF,FW",Manchester Utd,Premier League,20,2003,1.5,3,3,1,2,0,1,3,33.3,2,1,1,0,0,3,0,0,0,2023-2024,0.0,2.0
1715,Hannibal Mejbri,TUN,MF,Sevilla,La Liga,20,2003,1.2,3,3,1,2,0,0,1,0.0,1,1,0,1,0,3,0,0,0,2023-2024,0.0,2.5
1716,Óscar Melendo,ESP,"MF,FW",Granada,La Liga,25,1997,12.5,14,6,4,10,0,4,12,33.3,8,13,0,13,5,19,4,1,0,2023-2024,0.4,1.12
1717,Gonzalo Melero,ESP,"MF,FW",Almería,La Liga,29,1994,12.3,14,8,7,5,2,7,19,36.8,12,12,4,8,4,18,11,0,0,2023-2024,0.3252032520325203,1.1382113821138211
1718,Birger Meling,NOR,DF,Rennes,Ligue 1,28,1994,0.2,1,1,1,0,0,1,1,100.0,0,1,0,1,0,1,0,0,0,2023-2024,0.0,5.0
1719,Arthur Melo,BRA,MF,Fiorentina,Serie A,26,1996,22.1,45,30,17,24,4,26,42,61.9,16,27,3,24,18,63,8,0,0,2023-2024,0.8144796380090498,2.0361990950226243
1720,Memphis,NED,FW,Atlético Madrid,La Liga,29,1994,9.9,5,2,0,3,2,3,6,50.0,3,2,0,2,1,6,0,0,0,2023-2024,0.10101010101010101,0.5050505050505051
1721,Houboulang Mendes,GNB,DF,Almería,La Liga,25,1998,4.4,16,13,11,5,0,8,16,50.0,8,4,2,2,1,17,17,1,0,2023-2024,0.22727272727272727,3.6363636363636362
1722,Nuno Mendes,POR,DF,Paris S-G,Ligue 1,21,2002,3.0,5,5,4,1,0,4,7,57.1,3,4,0,4,4,9,2,0,0,2023-2024,1.3333333333333333,1.6666666666666667
1723,Tomás Mendes,ESP,MF,Alavés,La Liga,18,2004,0.1,0,0,0,0,0,0,0,0.0,0,0,0,0,0,0,0,0,0,2023-2024,0.0,0.0
1724,Brais Méndez,ESP,"MF,FW",Real Sociedad,La Liga,26,1997,26.8,42,28,13,20,9,15,43,34.9,28,23,4,19,12,54,21,0,0,2023-2024,0.44776119402985076,1.5671641791044775
1725,Bruno Méndez,URU,DF,Granada,La Liga,23,1999,14.8,36,17,19,12,5,21,37,56.8,16,24,6,18,26,62,45,0,0,2023-2024,1.7567567567567566,2.4324324324324325
Rk,Player,Nation,Pos,Squad,Comp,0,0,90.0,0,0,3,3,3,Tkl,0,0.0,0,0,0,0,0,0,0,0,0,2023-2024,0.0,0.0
1726,Diego Méndez,ESP,MF,Rayo Vallecano,La Liga,19,2003,0.1,1,1,1,0,0,1,1,100.0,0,0,0,0,1,2,0,0,0,2023-2024,10.0,10.0
1727,Leonardo Mendicino,ITA,MF,Atalanta,Serie A,17,2006,0.0,0,0,0,0,0,0,0,0.0,0,0,0,0,0,0,0,0,0,2023-2024,,
1728,Antoine Mendy,FRA,DF,Nice,Ligue 1,19,2004,4.6,7,5,4,3,0,3,7,42.9,4,4,1,3,8,15,16,0,0,2023-2024,1.7391304347826089,1.5217391304347827
1729,Benjamin Mendy,FRA,DF,Lorient,Ligue 1,29,1994,7.9,3,1,2,1,0,1,5,20.0,4,8,2,6,7,10,20,0,0,2023-2024,0.8860759493670886,0.37974683544303794
1730,Ferland Mendy,FRA,DF,Real Madrid,La Liga,28,1995,19.1,15,10,12,2,1,11,14,78.6,3,12,2,10,13,28,26,1,0,2023-2024,0.6806282722513088,0.7853403141361256
1731,Formose Mendy,SEN,DF,Lorient,Ligue 1,22,2001,14.0,33,19,24,8,1,20,33,60.6,13,23,12,11,20,53,59,1,0,2023-2024,1.4285714285714286,2.357142857142857
1732,Nampalys Mendy,SEN,MF,Lens,Ligue 1,31,1992,11.7,29,18,10,13,6,16,20,80.0,4,11,4,7,14,43,14,1,0,2023-2024,1.1965811965811965,2.4786324786324787
1733,Teden Mengi,ENG,DF,Luton Town,Premier League,21,2002,27.4,54,22,33,20,1,19,30,63.3,11,39,27,12,57,111,140,1,0,2023-2024,2.0802919708029197,1.9708029197080292
1734,Chris Mepham,WAL,DF,Bournemouth,Premier League,25,1997,6.9,12,11,9,3,0,9,14,64.3,5,13,6,7,7,19,30,1,0,2023-2024,1.0144927536231882,1.7391304347826086
1735,Jorge Meré,ESP,DF,Cádiz,La Liga,26,1997,7.5,8,7,6,2,0,4,7,57.1,3,5,3,2,8,16,33,0,0,2023-2024,1.0666666666666667,1.0666666666666667
1736,Alex Meret,ITA,GK,Napoli,Serie A,26,1997,30.8,1,0,1,0,0,1,2,50.0,1,0,0,0,0,1,10,1,0,2023-2024,0.0,0.032467532467532464
1737,Mikel Merino,ESP,MF,Real Sociedad,La Liga,27,1996,27.6,77,43,25,34,18,22,48,45.8,26,36,11,25,16,93,55,3,0,2023-2024,0.5797101449275363,2.789855072463768
1738,Quentin Merlin,FRA,DF,Marseille,Ligue 1,21,2002,7.8,13,12,7,5,1,8,20,40.0,12,4,0,4,6,19,14,0,0,2023-2024,0.7692307692307693,1.6666666666666667
1739,Quentin Merlin,FRA,DF,Nantes,Ligue 1,21,2002,14.3,29,20,15,12,2,16,25,64.0,9,22,1,21,18,47,22,0,0,2023-2024,1.2587412587412588,2.027972027972028
1740,Junior Messias,BRA,"MF,DF",Genoa,Serie A,32,1991,11.7,26,20,19,5,2,8,19,42.1,11,9,1,8,5,31,22,0,0,2023-2024,0.4273504273504274,2.2222222222222223
1741,Thomas Meunier,BEL,DF,Dortmund,Bundesliga,31,1991,6.5,5,1,3,2,0,3,13,23.1,10,8,2,6,4,9,22,0,0,2023-2024,0.6153846153846154,0.7692307692307693
1742,Bastien Meupiyou,FRA,DF,Nantes,Ligue 1,17,2006,0.1,0,0,0,0,0,0,0,0.0,0,0,0,0,0,0,1,0,0,2023-2024,0.0,0.0
1743,Alexander Meyer,GER,GK,Dortmund,Bundesliga,32,1991,7.7,1,1,1,0,0,1,1,100.0,0,0,0,0,0,1,2,1,0,2023-2024,0.0,0.12987012987012986
1744,Omenuke Mfulu,COD,"MF,FW",Las Palmas,La Liga,29,1994,0.9,4,3,3,1,0,0,1,0.0,1,1,1,0,2,6,5,0,0,2023-2024,2.2222222222222223,4.444444444444445
1745,Lucas Michal,FRA,FW,Monaco,Ligue 1,18,2005,0.1,0,0,0,0,0,0,0,0.0,0,0,0,0,0,0,0,0,0,2023-2024,0.0,0.0
1746,Sven Michel,GER,"FW,MF",Augsburg,Bundesliga,33,1990,6.5,7,5,2,1,4,2,7,28.6,5,1,0,1,0,7,4,0,0,2023-2024,0.0,1.0769230769230769
1747,Miguel,ESP,"FW,MF",Alavés,La Liga,23,1999,0.7,0,0,0,0,0,0,0,0.0,0,2,0,2,0,0,0,0,0,2023-2024,0.0,0.0
1748,Georges Mikautadze,GEO,FW,Metz,Ligue 1,22,2000,19.4,4,3,1,2,1,0,9,0.0,9,11,0,11,8,12,3,0,0,2023-2024,0.4123711340206186,0.2061855670103093
1749,Nikola Milenković,SRB,DF,Fiorentina,Serie A,25,1997,27.9,41,21,24,14,3,22,36,61.1,14,22,14,8,27,68,95,1,0,2023-2024,0.967741935483871,1.4695340501792116
1750,Lewis Miley,ENG,MF,Newcastle Utd,Premier League,17,2006,13.4,33,21,6,20,7,15,32,46.9,17,20,3,17,8,41,18,2,0,2023-2024,0.5970149253731343,2.462686567164179
Rk,Player,Nation,Pos,Squad,Comp,0,0,90.0,0,0,3,3,3,Tkl,0,0.0,0,0,0,0,0,0,0,0,0,2023-2024,0.0,0.0
1751,Arkadiusz Milik,POL,FW,Juventus,Serie A,29,1994,10.2,9,5,2,5,2,3,5,60.0,2,7,1,6,5,14,3,0,0,2023-2024,0.4901960784313726,0.8823529411764707
1752,Vanja Milinković-Savić,SRB,GK,Torino,Serie A,26,1997,36.0,1,0,1,0,0,1,1,100.0,0,0,0,0,1,2,14,4,0,2023-2024,0.027777777777777776,0.027777777777777776
1753,Éder Militão,BRA,DF,Real Madrid,La Liga,25,1998,5.5,7,3,4,3,0,6,9,66.7,3,4,3,1,4,11,19,1,0,2023-2024,0.7272727272727273,1.2727272727272727
1754,Luis Milla,ESP,MF,Getafe,La Liga,28,1994,23.5,57,33,19,28,10,28,47,59.6,19,20,1,19,32,89,10,0,0,2023-2024,1.3617021276595744,2.425531914893617
1755,Enzo Millot,FRA,"MF,FW",Stuttgart,Bundesliga,21,2002,24.9,40,22,9,21,10,18,39,46.2,21,24,2,22,16,56,7,1,0,2023-2024,0.642570281124498,1.606425702811245
1756,James Milner,ENG,"DF,MF",Brighton,Premier League,37,1986,8.6,20,14,9,10,1,9,14,64.3,5,9,0,9,8,28,16,0,0,2023-2024,0.9302325581395349,2.3255813953488373
1757,Jovan Milošević,SRB,"FW,MF",Stuttgart,Bundesliga,18,2005,0.3,0,0,0,0,0,0,0,0.0,0,0,0,0,0,0,0,0,0,2023-2024,0.0,0.0
1758,Marko Milovanović,SRB,"FW,MF",Almería,La Liga,19,2003,3.4,4,4,1,3,0,2,4,50.0,2,2,0,2,0,4,5,0,0,2023-2024,0.0,1.1764705882352942
1759,Kim Min-jae,KOR,DF,Bayern Munich,Bundesliga,26,1996,21.9,37,24,21,11,5,12,24,50.0,12,29,19,10,45,82,70,2,0,2023-2024,2.0547945205479454,1.6894977168949772
1760,Yerry Mina,COL,"DF,MF",Fiorentina,Serie A,28,1994,0.5,1,1,1,0,0,1,2,50.0,1,0,0,0,0,1,2,0,0,2023-2024,0.0,2.0
1761,Yerry Mina,COL,DF,Cagliari,Serie A,28,1994,13.5,20,13,14,6,0,13,19,68.4,6,23,14,9,4,24,77,0,0,2023-2024,0.2962962962962963,1.4814814814814814
1762,Takumi Minamino,JPN,MF,Monaco,Ligue 1,28,1995,23.5,34,17,10,13,11,16,54,29.6,38,29,1,28,11,45,8,0,0,2023-2024,0.46808510638297873,1.446808510638298
1763,Lucas Mincarelli,FRA,"DF,MF",Montpellier,Ligue 1,19,2004,10.9,29,16,19,6,4,17,34,50.0,17,17,4,13,8,37,27,0,0,2023-2024,0.7339449541284403,2.6605504587155964
1764,Tyrone Mings,ENG,DF,Aston Villa,Premier League,30,1993,0.3,0,0,0,0,0,0,0,0.0,0,0,0,0,1,1,1,0,0,2023-2024,3.3333333333333335,0.0
1765,Óscar Mingueza,ESP,"DF,MF",Celta Vigo,La Liga,24,1999,33.3,62,38,44,11,7,37,80,46.3,43,38,7,31,17,79,49,2,0,2023-2024,0.5105105105105106,1.861861861861862
1766,Ignasi Miquel,ESP,DF,Granada,La Liga,30,1992,33.2,47,30,39,6,2,23,40,57.5,17,32,16,16,45,92,132,4,0,2023-2024,1.355421686746988,1.4156626506024095
1767,Rafa Mir,ESP,"FW,MF",Sevilla,La Liga,26,1997,4.3,2,2,1,1,0,1,2,50.0,1,2,0,2,1,3,1,0,0,2023-2024,0.23255813953488372,0.46511627906976744
1768,Ignacio Miramon,ARG,MF,Lille,Ligue 1,20,2003,0.4,1,0,0,1,0,0,1,0.0,1,1,0,1,0,1,0,0,0,2023-2024,0.0,2.5
1769,Aleksei Miranchuk,RUS,"MF,FW",Atalanta,Serie A,27,1995,13.1,12,6,6,4,2,5,13,38.5,8,6,1,5,2,14,5,1,0,2023-2024,0.15267175572519084,0.916030534351145
1770,Juan Miranda,ESP,DF,Betis,La Liga,23,2000,20.6,38,24,21,13,4,17,31,54.8,14,31,6,25,19,57,62,0,0,2023-2024,0.9223300970873786,1.8446601941747571
1771,Kevin Miranda,ITA,DF,Sassuolo,Serie A,20,2003,0.2,0,0,0,0,0,0,0,0.0,0,0,0,0,0,0,1,0,0,2023-2024,0.0,0.0
1772,Antonio Mirante,ITA,GK,Milan,Serie A,40,1983,2.0,0,0,0,0,0,0,0,0.0,0,0,0,0,0,0,1,0,0,2023-2024,0.0,0.0
1773,Fabio Miretti,ITA,MF,Juventus,Serie A,19,2003,12.3,18,14,6,8,4,10,26,38.5,16,10,1,9,7,25,6,0,0,2023-2024,0.5691056910569106,1.4634146341463414
1774,Filippo Missori,ITA,DF,Sassuolo,Serie A,19,2004,3.0,6,3,2,4,0,4,11,36.4,7,3,2,1,4,10,8,0,0,2023-2024,1.3333333333333333,2.0
1775,Tyrick Mitchell,ENG,"DF,MF",Crystal Palace,Premier League,23,1999,35.6,105,60,75,21,9,43,60,71.7,17,63,10,53,26,131,104,0,0,2023-2024,0.7303370786516854,2.9494382022471908
Rk,Player,Nation,Pos,Squad,Comp,0,0,90.0,0,0,3,3,3,Tkl,0,0.0,0,0,0,0,0,0,0,0,0,2023-2024,0.0,0.0
1776,Kaoru Mitoma,JPN,FW,Brighton,Premier League,26,1997,16.5,13,6,3,7,3,5,19,26.3,14,15,1,14,5,18,12,0,0,2023-2024,0.30303030303030304,0.7878787878787878
1777,Aleksandar Mitrović,SRB,FW,Fulham,Premier League,28,1994,0.4,0,0,0,0,0,0,0,0.0,0,0,0,0,0,0,0,0,0,2023-2024,0.0,0.0
1778,Stefan Mitrović,SRB,"FW,MF",Hellas Verona,Serie A,20,2002,4.3,6,3,0,5,1,2,5,40.0,3,6,1,5,0,6,4,0,0,2023-2024,0.0,1.3953488372093024
1779,Stefan Mitrović,SRB,DF,Getafe,La Liga,33,1990,7.8,9,3,7,2,0,4,8,50.0,4,3,2,1,6,15,26,0,0,2023-2024,0.7692307692307693,1.153846153846154
1780,Maximilian Mittelstädt,GER,DF,Stuttgart,Bundesliga,26,1997,23.4,91,51,46,39,6,53,89,59.6,36,36,6,30,46,137,65,0,0,2023-2024,1.965811965811966,3.8888888888888893
1781,Henrikh Mkhitaryan,ARM,MF,Inter,Serie A,34,1989,30.9,62,34,18,35,9,24,49,49.0,25,23,4,19,29,91,43,0,0,2023-2024,0.9385113268608415,2.0064724919093853
1782,Marko Mladenović,SRB,MF,Eint Frankfurt,Bundesliga,18,2005,0.1,0,0,0,0,0,0,0,0.0,0,0,0,0,0,0,0,0,0,2023-2024,0.0,0.0
1783,Jakub Moder,POL,"MF,DF",Brighton,Premier League,24,1999,6.9,19,10,9,5,5,9,18,50.0,9,8,2,6,2,21,12,0,0,2023-2024,0.2898550724637681,2.753623188405797
1784,Luka Modrić,CRO,MF,Real Madrid,La Liga,37,1985,18.8,22,15,10,6,6,9,25,36.0,16,13,4,9,21,43,9,0,0,2023-2024,1.1170212765957446,1.1702127659574468
1785,Max Moerstedt,GER,"DF,FW",Hoffenheim,Bundesliga,0,0,0.1,0,0,0,0,0,0,1,0.0,1,0,0,0,0,0,0,0,0,2023-2024,0.0,0.0
1786,Terem Moffi,NGA,FW,Nice,Ligue 1,24,1999,21.7,7,4,0,5,2,3,12,25.0,9,14,1,13,3,10,15,0,0,2023-2024,0.1382488479262673,0.3225806451612903
1787,Mostafa Mohamed,EGY,FW,Nantes,Ligue 1,25,1997,22.2,21,14,7,11,3,6,28,21.4,22,21,5,16,12,33,29,0,0,2023-2024,0.5405405405405406,0.9459459459459459
1788,Dion Moise Sahi,CIV,"MF,FW",Strasbourg,Ligue 1,21,2001,7.0,5,5,1,2,2,0,3,0.0,3,11,1,10,1,6,7,0,0,2023-2024,0.14285714285714285,0.7142857142857143
1789,Johan Mojica,COL,DF,Osasuna,La Liga,30,1992,22.7,30,22,11,15,4,16,25,64.0,9,15,2,13,21,51,40,2,0,2023-2024,0.9251101321585904,1.3215859030837005
1790,Alberto Moleiro,ESP,"FW,MF",Las Palmas,La Liga,19,2003,20.0,15,6,4,7,4,6,30,20.0,24,11,0,11,7,22,10,0,0,2023-2024,0.35,0.75
1791,Nahuel Molina,ARG,DF,Atlético Madrid,La Liga,25,1998,20.6,38,22,16,18,4,26,54,48.1,28,19,3,16,9,47,36,1,0,2023-2024,0.4368932038834951,1.8446601941747571
1792,Florent Mollet,FRA,"MF,FW",Nantes,Ligue 1,31,1991,23.1,18,11,8,6,4,10,31,32.3,21,18,5,13,13,31,17,0,0,2023-2024,0.5627705627705627,0.7792207792207791
1793,Jon Moncayola,ESP,MF,Osasuna,La Liga,25,1998,20.0,27,18,14,10,3,17,42,40.5,25,31,5,26,15,42,21,0,0,2023-2024,0.75,1.35
1794,Enzo Mongo,FRA,DF,Nantes,Ligue 1,18,2005,0.1,1,1,1,0,0,1,2,50.0,1,1,1,0,1,2,0,0,0,2023-2024,10.0,10.0
1795,Ilario Monterisi,ITA,DF,Frosinone,Serie A,21,2001,16.3,23,13,14,7,2,12,26,46.2,14,22,18,4,8,31,63,0,0,2023-2024,0.49079754601226994,1.411042944785276
1796,César Montes,MEX,DF,Almería,La Liga,26,1997,19.9,22,13,13,9,0,9,18,50.0,9,21,9,12,11,33,94,0,0,2023-2024,0.5527638190954774,1.105527638190955
1797,Gonzalo Montiel,ARG,DF,Nott'ham Forest,Premier League,26,1997,8.9,22,19,12,8,2,16,29,55.2,13,8,3,5,9,31,31,1,0,2023-2024,1.0112359550561798,2.4719101123595504
1798,Lorenzo Montipò,ITA,GK,Hellas Verona,Serie A,27,1996,37.0,1,1,1,0,0,1,3,33.3,2,0,0,0,0,1,25,2,0,2023-2024,0.0,0.02702702702702703
1799,Kieffer Moore,WAL,"FW,MF",Bournemouth,Premier League,30,1992,1.2,0,0,0,0,0,0,0,0.0,0,0,0,0,0,0,0,0,0,2023-2024,0.0,0.0
1800,Mikey Moore,ENG,MF,Tottenham,Premier League,15,2007,0.0,0,0,0,0,0,0,0,0.0,0,0,0,0,0,0,1,0,0,2023-2024,,
Rk,Player,Nation,Pos,Squad,Comp,0,0,90.0,0,0,3,3,3,Tkl,0,0.0,0,0,0,0,0,0,0,0,0,2023-2024,0.0,0.0
1801,Álvaro Morata,ESP,FW,Atlético Madrid,La Liga,30,1992,21.2,16,10,4,7,5,3,5,60.0,2,18,3,15,1,17,26,0,0,2023-2024,0.04716981132075472,0.7547169811320755
1802,Diego Moreira,POR,"FW,MF",Lyon,Ligue 1,18,2004,3.0,0,0,0,0,0,0,3,0.0,3,3,0,3,2,2,5,0,0,2023-2024,0.6666666666666666,0.0
1803,Alberto Moreno,ESP,DF,Villarreal,La Liga,31,1992,16.5,31,21,19,10,2,10,30,33.3,20,12,2,10,24,55,33,0,0,2023-2024,1.4545454545454546,1.878787878787879
1804,Álex Moreno,ESP,DF,Aston Villa,Premier League,30,1993,11.5,18,12,18,0,0,12,19,63.2,7,11,2,9,13,31,37,0,0,2023-2024,1.1304347826086956,1.565217391304348
1805,Gerard Moreno,ESP,FW,Villarreal,La Liga,31,1992,24.6,25,12,10,7,8,11,25,44.0,14,24,7,17,9,34,24,0,0,2023-2024,0.36585365853658536,1.0162601626016259
1806,Jorge Moreno,ESP,DF,Osasuna,La Liga,22,2001,0.2,0,0,0,0,0,0,0,0.0,0,1,0,1,0,0,3,0,0,2023-2024,0.0,0.0
1807,Mateu Morey,ESP,DF,Dortmund,Bundesliga,23,2000,1.2,2,2,1,1,0,2,4,50.0,2,3,1,2,1,3,3,0,0,2023-2024,0.8333333333333334,1.6666666666666667
1808,Ilaix Moriba,GUI,"MF,FW",Getafe,La Liga,20,2003,6.7,20,11,3,11,6,4,9,44.4,5,3,1,2,4,24,10,0,0,2023-2024,0.5970149253731343,2.9850746268656714
1809,Manu Morlanes,ESP,MF,Mallorca,La Liga,24,1999,17.9,50,29,23,26,1,23,53,43.4,30,13,1,12,20,70,21,0,0,2023-2024,1.11731843575419,2.7932960893854752
1810,Nikola Moro,CRO,MF,Bologna,Serie A,25,1998,9.3,21,16,8,12,1,8,15,53.3,7,14,1,13,7,28,10,0,0,2023-2024,0.7526881720430108,2.258064516129032
1811,Carlton Morris,ENG,"FW,MF",Luton Town,Premier League,27,1995,31.8,15,8,4,6,5,9,15,60.0,6,24,5,19,1,16,53,0,0,2023-2024,0.031446540880503145,0.4716981132075472
1812,Cristhian Mosquera,ESP,DF,Valencia,La Liga,19,2004,34.2,57,34,36,18,3,25,39,64.1,14,42,23,19,36,93,137,2,0,2023-2024,1.0526315789473684,1.6666666666666665
1813,Yerson Mosquera,COL,DF,Villarreal,La Liga,22,2001,13.7,27,13,18,7,2,12,15,80.0,3,12,2,10,17,44,65,0,0,2023-2024,1.2408759124087592,1.9708029197080292
1814,Dany Mota,POR,"FW,MF",Monza,Serie A,25,1998,22.8,13,7,2,5,6,8,17,47.1,9,4,1,3,2,15,18,0,0,2023-2024,0.08771929824561403,0.5701754385964912
1815,Lebo Mothiba,RSA,FW,Strasbourg,Ligue 1,27,1996,6.9,5,2,1,4,0,3,4,75.0,1,6,1,5,0,5,11,0,0,2023-2024,0.0,0.7246376811594203
1816,Youssoufa Moukoko,GER,FW,Dortmund,Bundesliga,18,2004,6.9,4,1,2,2,0,3,7,42.9,4,4,1,3,2,6,4,0,0,2023-2024,0.2898550724637681,0.5797101449275363
1817,Steve Mounié,BEN,FW,Brest,Ligue 1,28,1994,19.7,8,7,0,3,5,3,11,27.3,8,13,3,10,2,10,18,0,0,2023-2024,0.10152284263959391,0.40609137055837563
1818,Mason Mount,ENG,"MF,FW",Manchester Utd,Premier League,24,1999,5.7,22,14,6,10,6,6,16,37.5,10,6,1,5,6,28,3,0,0,2023-2024,1.0526315789473684,3.8596491228070176
1819,Samuel Moutoussamy,COD,MF,Nantes,Ligue 1,26,1996,12.3,38,20,14,17,7,17,37,45.9,20,16,3,13,11,49,13,0,0,2023-2024,0.8943089430894309,3.089430894308943
1820,Loris Mouyokolo,FRA,DF,Lorient,Ligue 1,22,2001,1.0,4,1,4,0,0,1,1,100.0,0,1,0,1,0,4,3,0,0,2023-2024,0.0,4.0
1821,Divin Mubama,ENG,FW,West Ham,Premier League,18,2004,0.9,0,0,0,0,0,0,0,0.0,0,0,0,0,0,0,0,0,0,2023-2024,0.0,0.0
1822,Mykhailo Mudryk,UKR,FW,Chelsea,Premier League,22,2001,17.5,21,12,9,7,5,10,32,31.3,22,14,1,13,9,30,9,0,0,2023-2024,0.5142857142857142,1.2
1823,François Mughe,CMR,"MF,DF",Marseille,Ligue 1,19,2004,2.0,0,0,0,0,0,0,3,0.0,3,2,0,2,1,1,1,0,0,2023-2024,0.5,0.0
1824,Nordi Mukiele,FRA,DF,Paris S-G,Ligue 1,25,1997,8.8,12,8,6,5,1,8,15,53.3,7,17,4,13,14,26,28,0,0,2023-2024,1.5909090909090908,1.3636363636363635
1825,Samuele Mulattieri,ITA,"FW,MF",Sassuolo,Serie A,22,2000,5.1,1,1,0,0,1,1,2,50.0,1,7,2,5,1,2,2,0,0,2023-2024,0.19607843137254904,0.19607843137254904
Rk,Player,Nation,Pos,Squad,Comp,0,0,90.0,0,0,3,3,3,Tkl,0,0.0,0,0,0,0,0,0,0,0,0,2023-2024,0.0,0.0
1826,Andreas Müller,GER,MF,Darmstadt 98,Bundesliga,23,2000,3.9,14,9,8,5,1,4,9,44.4,5,5,2,3,4,18,5,0,0,2023-2024,1.0256410256410258,3.58974358974359
1827,Jannik Müller,GER,"DF,MF",Darmstadt 98,Bundesliga,29,1994,12.6,33,16,21,9,3,16,27,59.3,11,24,12,12,17,50,39,1,0,2023-2024,1.3492063492063493,2.619047619047619
1828,Kevin Müller,GER,GK,Heidenheim,Bundesliga,32,1991,34.0,3,0,3,0,0,3,5,60.0,2,0,0,0,0,3,6,1,0,2023-2024,0.0,0.08823529411764706
1829,Marcus Müller,GER,MF,Mainz 05,Bundesliga,20,2002,0.2,0,0,0,0,0,0,0,0.0,0,0,0,0,0,0,0,0,0,2023-2024,0.0,0.0
1830,Thomas Müller,GER,"MF,FW",Bayern Munich,Bundesliga,33,1989,18.4,26,16,5,10,11,13,35,37.1,22,22,0,22,3,29,6,0,0,2023-2024,0.16304347826086957,1.4130434782608696
1831,Abdul Mumin,GHA,DF,Rayo Vallecano,La Liga,25,1998,18.8,19,10,13,4,2,8,10,80.0,2,27,19,8,22,41,82,1,0,2023-2024,1.1702127659574468,1.0106382978723405
1832,Marshall Munetsi,ZIM,MF,Reims,Ligue 1,27,1996,24.1,61,39,18,34,9,33,61,54.1,28,21,7,14,14,75,33,0,0,2023-2024,0.5809128630705394,2.5311203319502074
1833,Iker Muniain,ESP,"MF,FW",Athletic Club,La Liga,30,1992,6.6,5,1,2,3,0,1,3,33.3,2,4,1,3,0,5,0,0,0,2023-2024,0.0,0.7575757575757576
1834,Rodrigo Muniz,BRA,FW,Fulham,Premier League,22,2001,17.7,7,3,1,5,1,1,6,16.7,5,9,3,6,6,13,20,0,0,2023-2024,0.33898305084745767,0.3954802259887006
1835,Aihen Muñoz,ESP,DF,Real Sociedad,La Liga,25,1997,12.5,36,21,20,10,6,24,35,68.6,11,16,8,8,9,45,33,0,0,2023-2024,0.72,2.88
1836,Álvaro Muñoz,URU,FW,Real Madrid,La Liga,19,2004,0.0,0,0,0,0,0,0,0,0.0,0,0,0,0,0,0,1,0,0,2023-2024,,
1837,Daniel Muñoz,COL,"DF,MF",Crystal Palace,Premier League,27,1996,16.0,55,35,31,14,10,19,38,50.0,19,29,7,22,24,79,47,0,0,2023-2024,1.5,3.4375
1838,Iker Muñoz,ESP,MF,Osasuna,La Liga,20,2002,20.6,32,18,13,17,2,15,31,48.4,16,16,5,11,11,43,50,0,0,2023-2024,0.5339805825242718,1.5533980582524272
1839,Javier Muñoz,ESP,MF,Las Palmas,La Liga,28,1995,29.3,42,23,14,22,6,16,44,36.4,28,40,4,36,20,62,29,1,0,2023-2024,0.68259385665529,1.4334470989761092
1840,Finley Munroe,ENG,MF,Aston Villa,Premier League,18,2005,0.0,0,0,0,0,0,0,0,0.0,0,0,0,0,0,0,0,0,0,2023-2024,,
1841,Arijanet Muric,KVX,GK,Burnley,Premier League,24,1998,10.0,1,1,1,0,0,1,1,100.0,0,0,0,0,0,1,10,4,0,2023-2024,0.0,0.1
1842,Luis Muriel,COL,"FW,MF",Atalanta,Serie A,32,1991,4.5,3,2,0,2,1,1,1,100.0,0,4,0,4,1,4,0,0,0,2023-2024,0.2222222222222222,0.6666666666666666
1843,Murillo,BRA,DF,Nott'ham Forest,Premier League,21,2002,31.0,50,31,36,13,1,19,33,57.6,14,41,24,17,37,87,188,0,0,2023-2024,1.1935483870967742,1.6129032258064515
1844,Vedat Muriqi,KVX,FW,Mallorca,La Liga,29,1994,25.9,11,6,4,3,4,2,14,14.3,12,11,4,7,6,17,26,0,0,2023-2024,0.23166023166023167,0.42471042471042475
1845,Alex Murphy,IRL,"DF,FW",Newcastle Utd,Premier League,19,2004,0.1,1,1,0,1,0,1,2,50.0,1,1,0,1,1,2,0,0,0,2023-2024,10.0,10.0
1846,Jacob Murphy,ENG,"FW,DF",Newcastle Utd,Premier League,28,1995,13.2,20,10,8,4,8,12,26,46.2,14,17,0,17,6,26,16,0,0,2023-2024,0.4545454545454546,1.5151515151515151
1847,Yunus Musah,USA,"MF,FW",Milan,Serie A,20,2002,16.4,25,14,15,6,4,8,15,53.3,7,18,4,14,10,35,16,1,0,2023-2024,0.6097560975609757,1.524390243902439
1848,Jamal Musiala,GER,"MF,FW",Bayern Munich,Bundesliga,20,2003,19.5,40,25,9,21,10,14,36,38.9,22,25,1,24,16,56,5,0,0,2023-2024,0.8205128205128205,2.051282051282051
1849,Florent Muslija,KVX,"MF,FW",Freiburg,Bundesliga,25,1998,1.2,5,4,3,2,0,2,5,40.0,3,1,0,1,0,5,2,0,0,2023-2024,0.0,4.166666666666667
1850,Juan Musso,ARG,GK,Atalanta,Serie A,29,1994,11.0,1,0,1,0,0,1,1,100.0,0,0,0,0,0,1,6,0,0,2023-2024,0.0,0.09090909090909091
Rk,Player,Nation,Pos,Squad,Comp,0,0,90.0,0,0,3,3,3,Tkl,0,0.0,0,0,0,0,0,0,0,0,0,2023-2024,0.0,0.0
1851,Kingstone Mutandwa,ZAM,"FW,MF",Cagliari,Serie A,20,2003,0.4,1,0,1,0,0,1,4,25.0,3,1,0,1,0,1,2,0,0,2023-2024,0.0,2.5
1852,Yvon Mvogo,SUI,GK,Lorient,Ligue 1,29,1994,34.0,0,0,0,0,0,0,1,0.0,1,0,0,0,0,0,15,3,0,2023-2024,0.0,0.0
1853,Joel Mvuka,NOR,"DF,FW",Lorient,Ligue 1,20,2002,2.2,5,3,3,1,1,3,7,42.9,4,1,0,1,2,7,1,0,0,2023-2024,0.9090909090909091,2.2727272727272725
1854,Junior Mwanga,FRA,"MF,FW",Strasbourg,Ligue 1,20,2003,16.1,40,20,23,12,5,12,24,50.0,12,20,5,15,18,58,19,0,0,2023-2024,1.1180124223602483,2.484472049689441
1855,Phillipp Mwene,AUT,DF,Mainz 05,Bundesliga,29,1994,22.2,34,15,15,16,3,16,33,48.5,17,27,3,24,17,51,47,0,0,2023-2024,0.7657657657657658,1.5315315315315317
1856,Vitaliy Mykolenko,UKR,DF,Everton,Premier League,24,1999,27.4,69,38,46,21,2,41,66,62.1,25,36,11,25,36,105,92,0,0,2023-2024,1.3138686131386863,2.5182481751824817
1857,Joakim Mæhle,DEN,"DF,MF",Wolfsburg,Bundesliga,26,1997,27.2,62,39,33,18,11,41,64,64.1,23,43,5,38,29,91,65,0,0,2023-2024,1.0661764705882353,2.2794117647058822
1858,Obite N'Dicka,CIV,DF,Roma,Serie A,23,1999,24.1,32,18,12,19,1,12,20,60.0,8,30,16,14,16,48,75,0,0,2023-2024,0.6639004149377593,1.3278008298755186
1859,Kévin N'Doram,FRA,MF,Metz,Ligue 1,27,1996,17.8,31,22,20,9,2,17,38,44.7,21,17,8,9,27,58,38,0,0,2023-2024,1.5168539325842696,1.7415730337078652
1860,Nathan N'Goumou,FRA,"FW,MF",Gladbach,Bundesliga,23,2000,15.4,37,22,17,18,2,16,34,47.1,18,22,0,22,5,42,17,1,0,2023-2024,0.3246753246753247,2.4025974025974026
1861,Stanley N'Soki,FRA,DF,Hoffenheim,Bundesliga,24,1999,7.0,21,10,12,8,1,17,29,58.6,12,13,2,11,8,29,33,0,0,2023-2024,1.1428571428571428,3.0
1862,Nacho,ESP,DF,Real Madrid,La Liga,33,1990,19.4,18,10,9,7,2,6,13,46.2,7,23,13,10,18,36,56,0,0,2023-2024,0.9278350515463918,0.9278350515463918
1863,Bilal Nadir,FRA,"MF,FW",Marseille,Ligue 1,19,2003,1.3,4,3,2,2,0,1,2,50.0,1,0,0,0,2,6,2,0,0,2023-2024,1.5384615384615383,3.0769230769230766
1864,Mahamadou Nagida,CMR,DF,Rennes,Ligue 1,18,2005,1.2,1,1,0,0,1,0,2,0.0,2,2,1,1,4,5,0,0,0,2023-2024,3.3333333333333335,0.8333333333333334
1865,Marvelous Nakamba,ZIM,MF,Luton Town,Premier League,29,1994,12.6,40,24,24,14,2,24,42,57.1,18,23,6,17,11,51,11,1,0,2023-2024,0.873015873015873,3.174603174603175
1866,Keito Nakamura,JPN,"FW,MF",Reims,Ligue 1,23,2000,15.3,28,11,9,10,9,17,37,45.9,20,15,2,13,6,34,7,0,0,2023-2024,0.39215686274509803,1.8300653594771241
1867,Nahitan Nández,URU,"MF,DF",Cagliari,Serie A,27,1995,26.0,59,40,27,23,9,27,64,42.2,37,25,2,23,19,78,32,0,0,2023-2024,0.7307692307692307,2.269230769230769
1868,Matija Nastasić,SRB,DF,Mallorca,La Liga,30,1993,25.1,35,17,26,9,0,24,32,75.0,8,33,20,13,29,64,114,0,0,2023-2024,1.1553784860557768,1.394422310756972
1869,Natan,BRA,DF,Napoli,Serie A,22,2001,10.6,14,10,10,3,1,5,10,50.0,5,12,9,3,8,22,32,0,0,2023-2024,0.7547169811320755,1.3207547169811322
1870,Lapo Nava,ITA,GK,Milan,Serie A,19,2004,0.0,0,0,0,0,0,0,0,0.0,0,0,0,0,0,0,0,0,0,2023-2024,,
1871,Roberto Navarro,ESP,"MF,FW",Cádiz,La Liga,21,2002,21.0,46,29,20,21,5,22,43,51.2,21,33,0,33,19,65,7,1,0,2023-2024,0.9047619047619048,2.1904761904761907
1872,Jesús Navas,ESP,DF,Sevilla,La Liga,37,1985,22.3,37,27,21,14,2,22,40,55.0,18,15,7,8,22,59,48,0,0,2023-2024,0.9865470852017937,1.6591928251121075
1873,Keylor Navas,CRC,GK,Paris S-G,Ligue 1,36,1986,4.0,0,0,0,0,0,0,0,0.0,0,0,0,0,0,0,2,0,0,2023-2024,0.0,0.0
1874,Michel Ndary Adopo,FRA,MF,Atalanta,Serie A,23,2000,1.2,4,3,0,3,1,1,1,100.0,0,0,0,0,0,4,2,1,0,2023-2024,0.0,3.3333333333333335
1875,Youssouf Ndayishimiye,BDI,"MF,DF",Nice,Ligue 1,24,1998,19.0,31,20,17,12,2,12,23,52.2,11,19,11,8,12,43,47,1,0,2023-2024,0.631578947368421,1.631578947368421
Rk,Player,Nation,Pos,Squad,Comp,0,0,90.0,0,0,3,3,3,Tkl,0,0.0,0,0,0,0,0,0,0,0,0,2023-2024,0.0,0.0
1876,Bassirou Ndiaye,SEN,FW,Lorient,Ligue 1,21,2002,1.7,5,2,2,2,1,3,5,60.0,2,1,1,0,1,6,0,0,0,2023-2024,0.5882352941176471,2.9411764705882355
1877,Iliman Ndiaye,SEN,"FW,MF",Marseille,Ligue 1,23,2000,18.0,21,18,5,11,5,11,29,37.9,18,14,2,12,6,27,6,0,0,2023-2024,0.3333333333333333,1.1666666666666667
1878,Massamba Ndiaye,SEN,GK,Clermont Foot,Ligue 1,21,2001,4.0,0,0,0,0,0,0,0,0.0,0,0,0,0,0,0,2,0,0,2023-2024,0.0,0.0
1879,Rassoul Ndiaye,SEN,"MF,FW",Le Havre,Ligue 1,21,2001,5.8,25,17,8,16,1,12,24,50.0,12,2,1,1,4,29,5,0,0,2023-2024,0.6896551724137931,4.310344827586207
1880,Michael Ndiweni,ENG,FW,Newcastle Utd,Premier League,19,2003,0.0,0,0,0,0,0,0,0,0.0,0,0,0,0,0,0,0,0,0,2023-2024,,
1881,Cher Ndour,ITA,MF,Paris S-G,Ligue 1,19,2004,0.3,2,2,0,2,0,1,2,50.0,1,0,0,0,0,2,0,0,0,2023-2024,0.0,6.666666666666667
1882,Dan Ndoye,SUI,"FW,MF",Bologna,Serie A,22,2000,19.7,30,15,17,11,2,17,39,43.6,22,20,1,19,10,40,14,0,0,2023-2024,0.5076142131979695,1.5228426395939088
1883,Joseph Nduquidi,FRA,"MF,DF",Metz,Ligue 1,18,2004,8.3,11,4,6,3,2,1,9,11.1,8,11,3,8,11,22,15,1,0,2023-2024,1.325301204819277,1.325301204819277
1884,Loïc Nego,HUN,"DF,MF",Le Havre,Ligue 1,32,1991,17.3,37,26,21,12,4,18,30,60.0,12,12,2,10,16,53,17,0,0,2023-2024,0.9248554913294798,2.138728323699422
1885,Álvaro Negredo,ESP,"FW,MF",Cádiz,La Liga,37,1985,0.6,0,0,0,0,0,0,0,0.0,0,1,0,1,1,1,0,0,0,2023-2024,1.6666666666666667,0.0
1886,Reiss Nelson,ENG,FW,Arsenal,Premier League,23,1999,3.0,9,6,5,1,3,8,10,80.0,2,5,1,4,1,10,5,0,0,2023-2024,0.3333333333333333,3.0
1887,Zack Nelson,ENG,"MF,DF",Luton Town,Premier League,18,2004,0.1,1,0,1,0,0,0,0,0.0,0,0,0,0,0,1,0,0,0,2023-2024,0.0,10.0
1888,Neto,BRA,GK,Bournemouth,Premier League,34,1989,32.0,0,0,0,0,0,0,0,0.0,0,1,0,1,1,1,12,3,0,2023-2024,0.03125,0.0
1889,Pedro Neto,POR,"FW,MF",Wolves,Premier League,23,2000,16.8,7,3,3,2,2,5,15,33.3,10,5,1,4,5,12,2,0,0,2023-2024,0.2976190476190476,0.41666666666666663
1890,Luca Netz,GER,DF,Gladbach,Bundesliga,20,2003,24.7,38,22,19,16,3,23,43,53.5,20,36,10,26,22,60,76,1,0,2023-2024,0.8906882591093118,1.5384615384615385
1891,Manuel Neuer,GER,GK,Bayern Munich,Bundesliga,37,1986,22.8,1,1,1,0,0,0,0,0.0,0,0,0,0,0,1,14,3,0,2023-2024,0.0,0.043859649122807015
1892,Florian Neuhaus,GER,MF,Gladbach,Bundesliga,26,1997,13.6,15,12,7,8,0,8,26,30.8,18,8,6,2,14,29,8,0,0,2023-2024,1.0294117647058825,1.1029411764705883
1893,Carlos Neva,ESP,DF,Granada,La Liga,27,1996,35.0,32,21,22,9,1,17,40,42.5,23,39,14,25,30,62,108,2,0,2023-2024,0.8571428571428571,0.9142857142857143
1894,Jessic Ngankam,GER,"FW,MF",Mainz 05,Bundesliga,23,2000,2.0,1,1,0,1,0,0,0,0.0,0,3,1,2,3,4,0,0,0,2023-2024,1.5,0.5
1895,Jessic Ngankam,GER,FW,Eint Frankfurt,Bundesliga,23,2000,3.1,3,2,1,1,1,0,0,0.0,0,0,0,0,0,3,1,0,0,2023-2024,0.0,0.9677419354838709
1896,Cyril Ngonge,BEL,"FW,MF",Hellas Verona,Serie A,23,2000,15.9,14,9,5,3,6,5,14,35.7,9,7,1,6,4,18,10,0,0,2023-2024,0.25157232704402516,0.8805031446540881
1897,Cyril Ngonge,BEL,FW,Napoli,Serie A,23,2000,3.5,5,3,1,4,0,2,2,100.0,0,2,0,2,0,5,2,0,0,2023-2024,0.0,1.4285714285714286
1898,Steve Ngoura,FRA,"FW,MF",Le Havre,Ligue 1,18,2005,2.5,2,1,1,1,0,1,4,25.0,3,0,0,0,0,2,3,0,0,2023-2024,0.0,0.8
1899,Moussa Niakhate,SEN,DF,Nott'ham Forest,Premier League,27,1996,16.2,42,25,33,9,0,20,25,80.0,5,19,12,7,14,56,51,0,0,2023-2024,0.8641975308641976,2.5925925925925926
1900,M'Baye Niang,SEN,FW,Empoli,Serie A,28,1994,7.9,3,1,0,1,2,0,6,0.0,6,7,1,6,3,6,10,0,0,2023-2024,0.37974683544303794,0.37974683544303794
Rk,Player,Nation,Pos,Squad,Comp,0,0,90.0,0,0,3,3,3,Tkl,0,0.0,0,0,0,0,0,0,0,0,0,2023-2024,0.0,0.0
1901,Tanguy Nianzou,FRA,DF,Sevilla,La Liga,21,2002,3.5,12,8,9,2,1,8,11,72.7,3,2,0,2,3,15,9,1,0,2023-2024,0.8571428571428571,3.4285714285714284
1902,Shamar Nicholson,JAM,FW,Clermont Foot,Ligue 1,26,1997,16.5,6,2,0,4,2,1,4,25.0,3,6,2,4,0,6,15,0,0,2023-2024,0.0,0.36363636363636365
1903,Rasmus Nicolaisen,DEN,DF,Toulouse,Ligue 1,26,1997,32.5,50,30,39,11,0,26,44,59.1,18,44,33,11,42,92,158,1,0,2023-2024,1.2923076923076924,1.5384615384615385
1904,Moritz Nicolas,GER,GK,Gladbach,Bundesliga,25,1997,27.0,1,0,1,0,0,1,3,33.3,2,0,0,0,0,1,12,5,0,2023-2024,0.0,0.037037037037037035
1905,Hans Nicolussi Caviglia,ITA,MF,Juventus,Serie A,23,2000,3.0,5,2,1,3,1,4,6,66.7,2,5,1,4,0,5,2,0,0,2023-2024,0.0,1.6666666666666667
1906,Saúl Ñíguez,ESP,MF,Atlético Madrid,La Liga,28,1994,15.3,64,39,29,29,6,30,49,61.2,19,36,9,27,14,78,56,0,0,2023-2024,0.9150326797385621,4.183006535947713
1907,Justin Njinmah,GER,FW,Werder Bremen,Bundesliga,22,2000,11.3,5,1,2,2,1,3,9,33.3,6,9,1,8,2,7,6,0,0,2023-2024,0.17699115044247787,0.44247787610619466
1908,Eddie Nketiah,ENG,FW,Arsenal,Premier League,24,1999,12.0,12,7,2,6,4,2,7,28.6,5,11,0,11,4,16,4,0,0,2023-2024,0.3333333333333333,1.0
1909,Niels Nkounkou,FRA,"DF,MF",Eint Frankfurt,Bundesliga,22,2000,14.5,54,30,34,17,3,29,64,45.3,35,30,2,28,16,70,30,0,0,2023-2024,1.103448275862069,3.7241379310344827
1910,Christopher Nkunku,FRA,"FW,MF",Chelsea,Premier League,25,1997,4.9,5,4,0,4,1,1,2,50.0,1,4,1,3,2,7,4,0,0,2023-2024,0.4081632653061224,1.0204081632653061
1911,Felix Nmecha,GER,MF,Dortmund,Bundesliga,22,2000,11.3,19,13,7,8,4,11,22,50.0,11,18,5,13,11,30,19,0,0,2023-2024,0.9734513274336283,1.6814159292035398
1912,Lukas Nmecha,GER,FW,Wolfsburg,Bundesliga,24,1998,0.5,1,1,0,0,1,0,0,0.0,0,1,0,1,0,1,0,0,0,2023-2024,0.0,2.0
1913,Peru Nolaskoain,ESP,"DF,MF",Athletic Club,La Liga,24,1998,0.1,1,1,1,0,0,1,1,100.0,0,0,0,0,0,1,1,0,0,2023-2024,0.0,10.0
1914,Joseph Nonge,BEL,MF,Juventus,Serie A,18,2005,0.3,0,0,0,0,0,0,0,0.0,0,0,0,0,0,0,1,0,0,2023-2024,0.0,0.0
1915,Jonathan Norbye,NOR,MF,RB Leipzig,Bundesliga,16,2007,0.0,0,0,0,0,0,0,0,0.0,0,0,0,0,0,0,0,0,0,2023-2024,,
1916,Arnaud Nordin,FRA,"FW,MF",Montpellier,Ligue 1,25,1998,13.8,12,6,3,5,4,6,16,37.5,10,11,0,11,2,14,10,0,0,2023-2024,0.14492753623188406,0.8695652173913043
1917,Rhys Norrington-Davies,WAL,DF,Sheffield Utd,Premier League,24,1999,1.2,1,1,1,0,0,0,1,0.0,1,2,0,2,1,2,2,0,0,2023-2024,0.8333333333333334,0.8333333333333334
1918,Oliver Norwood,NIR,MF,Sheffield Utd,Premier League,32,1991,16.0,41,26,18,18,5,20,47,42.6,27,24,9,15,21,62,39,0,0,2023-2024,1.3125,2.5625
1919,Tijjani Noslin,NED,"FW,MF",Hellas Verona,Serie A,24,1999,14.9,18,8,5,7,6,6,16,37.5,10,17,2,15,2,20,14,0,0,2023-2024,0.1342281879194631,1.2080536912751678
1920,Randy Nteka,ANG,"FW,MF",Rayo Vallecano,La Liga,25,1997,6.4,11,4,1,6,4,4,10,40.0,6,6,1,5,2,13,11,1,0,2023-2024,0.3125,1.71875
1921,Ernest Nuamah,GHA,"FW,MF",Lyon,Ligue 1,19,2003,20.4,28,14,18,6,4,12,38,31.6,26,15,1,14,8,36,9,0,0,2023-2024,0.3921568627450981,1.3725490196078431
1922,Alexander Nübel,GER,GK,Stuttgart,Bundesliga,26,1996,30.0,2,2,2,0,0,2,4,50.0,2,0,0,0,0,2,13,4,0,2023-2024,0.0,0.06666666666666667
1923,Kasim Nuhu,GHA,DF,Hoffenheim,Bundesliga,28,1995,0.1,0,0,0,0,0,0,0,0.0,0,0,0,0,0,0,0,0,0,2023-2024,0.0,0.0
1924,Matheus Nunes,POR,MF,Wolves,Premier League,24,1998,2.0,3,1,3,0,0,2,6,33.3,4,0,0,0,6,9,1,0,0,2023-2024,3.0,1.5
1925,Matheus Nunes,POR,MF,Manchester City,Premier League,24,1998,7.3,10,4,1,7,2,5,16,31.3,11,7,1,6,1,11,8,1,0,2023-2024,0.136986301369863,1.36986301369863
Rk,Player,Nation,Pos,Squad,Comp,0,0,90.0,0,0,3,3,3,Tkl,0,0.0,0,0,0,0,0,0,0,0,0,2023-2024,0.0,0.0
1926,Darwin Núñez,URU,FW,Liverpool,Premier League,24,1999,22.7,22,12,2,10,10,11,23,47.8,12,18,6,12,3,25,9,0,0,2023-2024,0.13215859030837004,0.9691629955947136
1927,Unai Núñez,ESP,DF,Celta Vigo,La Liga,26,1997,31.1,51,28,30,19,2,23,49,46.9,26,38,24,14,52,103,153,3,0,2023-2024,1.6720257234726688,1.6398713826366558
1928,Fabian Nürnberger,GER,"DF,MF",Darmstadt 98,Bundesliga,24,1999,16.8,29,22,22,6,1,22,41,53.7,19,11,1,10,17,46,26,0,0,2023-2024,1.0119047619047619,1.726190476190476
1929,Ethan Nwaneri,ENG,FW,Arsenal,Premier League,16,2007,0.2,0,0,0,0,0,0,0,0.0,0,1,0,1,0,0,0,0,0,2023-2024,0.0,0.0
1930,Simeon Nwankwo,NGA,FW,Salernitana,Serie A,31,1992,7.6,6,3,0,2,4,1,3,33.3,2,7,0,7,0,6,4,0,0,2023-2024,0.0,0.7894736842105263
1931,Gerzino Nyamsi,FRA,DF,Strasbourg,Ligue 1,26,1997,12.1,18,14,13,5,0,12,18,66.7,6,19,11,8,10,28,43,0,0,2023-2024,0.8264462809917356,1.4876033057851241
1932,Ørjan Nyland,NOR,GK,Sevilla,La Liga,32,1990,24.0,0,0,0,0,0,0,1,0.0,1,0,0,0,0,0,9,1,0,2023-2024,0.0,0.0
1933,Rabby Nzingoula,CGO,"MF,FW",Strasbourg,Ligue 1,17,2005,1.5,3,3,0,3,0,3,4,75.0,1,4,0,4,5,8,0,0,0,2023-2024,3.3333333333333335,2.0
1934,M'Bala Nzola,ANG,FW,Fiorentina,Serie A,26,1996,17.2,11,8,1,4,6,6,7,85.7,1,10,1,9,0,11,22,0,0,2023-2024,0.0,0.6395348837209303
1935,Christian Nørgaard,DEN,MF,Brentford,Premier League,29,1994,27.8,81,50,42,31,8,32,87,36.8,55,48,6,42,54,135,50,0,0,2023-2024,1.9424460431654675,2.9136690647482015
1936,Jake O'Brien,IRL,DF,Lyon,Ligue 1,22,2001,26.3,22,16,16,5,1,14,20,70.0,6,23,18,5,12,34,98,1,0,2023-2024,0.45627376425855515,0.8365019011406843
1937,Mark O'Mahony,IRL,FW,Brighton,Premier League,18,2005,0.7,1,0,1,0,0,1,2,50.0,1,2,1,1,0,1,1,0,0,2023-2024,0.0,1.4285714285714286
1938,Dara O'Shea,IRL,DF,Burnley,Premier League,24,1999,32.1,39,20,22,14,3,11,26,42.3,15,41,30,11,35,74,158,2,0,2023-2024,1.0903426791277258,1.2149532710280373
1939,Michael Obafemi,IRL,"FW,MF",Burnley,Premier League,23,2000,0.2,0,0,0,0,0,0,0,0.0,0,1,0,1,0,0,0,0,0,2023-2024,0.0,0.0
1940,Adam Obert,SVK,DF,Cagliari,Serie A,20,2002,10.5,17,9,8,8,1,8,17,47.1,9,13,7,6,21,38,41,1,0,2023-2024,2.0,1.619047619047619
1941,Pedro Obiang,EQG,MF,Sassuolo,Serie A,31,1992,5.0,8,4,3,4,1,2,10,20.0,8,6,4,2,8,16,10,0,0,2023-2024,1.6,1.6
1942,Jan Oblak,SVN,GK,Atlético Madrid,La Liga,30,1993,38.0,0,0,0,0,0,0,0,0.0,0,0,0,0,0,0,10,0,0,2023-2024,0.0,0.0
1943,Brian Ocampo,URU,"MF,FW",Cádiz,La Liga,24,1999,2.8,4,3,1,3,0,2,5,40.0,3,4,0,4,3,7,0,0,0,2023-2024,1.0714285714285714,1.4285714285714286
1944,Lucas Ocampos,ARG,"FW,MF",Sevilla,La Liga,29,1994,31.9,66,47,22,27,17,29,58,50.0,29,34,1,33,21,87,29,0,0,2023-2024,0.658307210031348,2.0689655172413794
1945,Guillermo Ochoa,MEX,GK,Salernitana,Serie A,38,1985,21.0,0,0,0,0,0,0,1,0.0,1,0,0,0,0,0,9,1,0,2023-2024,0.0,0.0
1946,Jens Odgaard,DEN,"FW,MF",Bologna,Serie A,24,1999,4.8,4,4,1,1,2,1,3,33.3,2,9,0,9,1,5,3,0,0,2023-2024,0.20833333333333334,0.8333333333333334
1947,Wilson Odobert,FRA,"MF,FW",Burnley,Premier League,18,2004,23.3,17,13,8,5,4,6,22,27.3,16,26,2,24,6,23,14,0,0,2023-2024,0.2575107296137339,0.7296137339055794
1948,Álvaro Odriozola,ESP,DF,Real Sociedad,La Liga,27,1995,4.4,9,7,7,1,1,5,5,100.0,0,2,1,1,8,17,7,0,0,2023-2024,1.8181818181818181,2.0454545454545454
1949,Tim Oermann,GER,DF,Bochum,Bundesliga,19,2003,7.9,19,11,11,4,4,9,14,64.3,5,15,6,9,2,21,22,0,0,2023-2024,0.2531645569620253,2.4050632911392404
1950,Odeluga Offiah,ENG,DF,Brighton,Premier League,20,2002,1.4,1,0,1,0,0,1,1,100.0,0,0,0,0,1,2,0,0,0,2023-2024,0.7142857142857143,0.7142857142857143
Rk,Player,Nation,Pos,Squad,Comp,0,0,90.0,0,0,3,3,3,Tkl,0,0.0,0,0,0,0,0,0,0,0,0,2023-2024,0.0,0.0
1951,Chiedozie Ogbene,IRL,"MF,DF",Luton Town,Premier League,26,1997,22.2,17,10,10,7,0,12,22,54.5,10,14,3,11,7,24,34,2,0,2023-2024,0.3153153153153153,0.7657657657657658
1952,Angelo Ogbonna,ITA,DF,West Ham,Premier League,35,1988,7.1,11,5,9,2,0,6,7,85.7,1,13,10,3,3,14,29,0,0,2023-2024,0.4225352112676057,1.5492957746478875
1953,Florent Ogier,FRA,DF,Clermont Foot,Ligue 1,34,1989,10.5,19,9,13,6,0,11,18,61.1,7,25,19,6,9,28,35,3,0,2023-2024,0.8571428571428571,1.8095238095238095
1954,Noah Okafor,SUI,"FW,MF",Milan,Serie A,23,2000,9.9,6,4,1,4,1,3,10,30.0,7,8,1,7,0,6,10,0,0,2023-2024,0.0,0.6060606060606061
1955,David Okereke,NGA,"FW,MF",Torino,Serie A,25,1997,2.8,3,1,1,1,1,0,3,0.0,3,2,0,2,1,4,0,0,0,2023-2024,0.35714285714285715,1.0714285714285714
1956,Caleb Okoli,ITA,DF,Frosinone,Serie A,22,2001,32.4,56,34,33,22,1,29,44,65.9,15,48,32,16,29,85,156,4,0,2023-2024,0.8950617283950618,1.7283950617283952
1957,Maduka Okoye,NGA,GK,Udinese,Serie A,23,1999,21.0,0,0,0,0,0,0,0,0.0,0,0,0,0,1,1,4,2,0,2023-2024,0.047619047619047616,0.0
1958,Masaya Okugawa,JPN,"FW,DF",Augsburg,Bundesliga,27,1996,0.4,0,0,0,0,0,0,0,0.0,0,0,0,0,0,0,2,0,0,2023-2024,0.0,0.0
1959,Joseph Okumu,KEN,DF,Reims,Ligue 1,26,1997,19.4,44,28,28,14,2,24,38,63.2,14,27,19,8,35,79,112,2,0,2023-2024,1.8041237113402062,2.2680412371134024
1960,Aingeru Olabarrieta,ESP,FW,Athletic Club,La Liga,17,2005,0.1,0,0,0,0,0,0,0,0.0,0,0,0,0,0,0,0,0,0,2023-2024,0.0,0.0
1961,Michael Olakigbe,ENG,"DF,FW",Brentford,Premier League,19,2004,0.7,3,0,2,1,0,2,4,50.0,2,7,0,7,1,4,0,1,0,2023-2024,1.4285714285714286,4.285714285714286
1962,Olasagasti,ESP,MF,Real Sociedad,La Liga,22,2000,4.0,16,13,4,7,5,5,8,62.5,3,2,0,2,3,19,5,1,0,2023-2024,0.75,4.0
1963,Finn Ole Becker,GER,MF,Hoffenheim,Bundesliga,23,2000,6.7,10,9,8,2,0,4,17,23.5,13,9,1,8,1,11,10,0,0,2023-2024,0.14925373134328357,1.4925373134328357
1964,Mathias Olesen,LUX,"MF,FW",Köln,Bundesliga,22,2001,1.2,0,0,0,0,0,0,0,0.0,0,0,0,0,2,2,2,0,0,2023-2024,1.6666666666666667,0.0
1965,Michael Olise,FRA,"FW,MF",Crystal Palace,Premier League,21,2001,14.2,19,10,7,10,2,8,24,33.3,16,21,0,21,11,30,9,0,0,2023-2024,0.7746478873239437,1.3380281690140845
1966,Mathías Olivera,URU,DF,Napoli,Serie A,25,1997,17.4,50,29,29,15,6,23,39,59.0,16,35,6,29,20,70,25,0,0,2023-2024,1.149425287356322,2.873563218390805
1967,Dani Olmo,ESP,MF,RB Leipzig,Bundesliga,25,1998,16.1,26,18,14,8,4,10,22,45.5,12,7,0,7,13,39,12,1,0,2023-2024,0.8074534161490683,1.6149068322981366
1968,Robin Olsen,SWE,GK,Aston Villa,Premier League,33,1990,4.5,0,0,0,0,0,0,0,0.0,0,0,0,0,0,0,1,0,0,2023-2024,0.0,0.0
1969,Warmed Omari,FRA,DF,Rennes,Ligue 1,23,2000,23.0,32,19,23,7,2,16,28,57.1,12,30,20,10,33,65,77,2,0,2023-2024,1.434782608695652,1.391304347826087
1970,Becir Omeragic,SUI,"DF,MF",Montpellier,Ligue 1,21,2002,25.7,48,29,31,13,4,20,33,60.6,13,51,29,22,27,75,65,0,0,2023-2024,1.0505836575875487,1.867704280155642
1971,Jonas Omlin,SUI,GK,Gladbach,Bundesliga,29,1994,7.0,1,0,1,0,0,1,1,100.0,0,0,0,0,0,1,3,0,0,2023-2024,0.0,0.14285714285714285
1972,Andrew Omobamidele,IRL,DF,Nott'ham Forest,Premier League,21,2002,8.7,10,3,9,1,0,5,8,62.5,3,12,8,4,13,23,42,1,0,2023-2024,1.4942528735632186,1.149425287356322
1973,Samu Omorodion,ESP,FW,Alavés,La Liga,19,2004,21.3,6,3,1,4,1,0,4,0.0,4,11,2,9,1,7,14,0,0,2023-2024,0.046948356807511735,0.28169014084507044
1974,Samu Omorodion,ESP,FW,Granada,La Liga,19,2004,0.9,1,1,0,1,0,1,1,100.0,0,0,0,0,0,1,0,0,0,2023-2024,0.0,1.1111111111111112
1975,Amadou Onana,BEL,MF,Everton,Premier League,21,2001,23.2,71,38,32,31,8,21,42,50.0,21,25,6,19,21,92,31,0,0,2023-2024,0.9051724137931034,3.060344827586207
Rk,Player,Nation,Pos,Squad,Comp,0,0,90.0,0,0,3,3,3,Tkl,0,0.0,0,0,0,0,0,0,0,0,0,2023-2024,0.0,0.0
1976,André Onana,CMR,GK,Manchester Utd,Premier League,27,1996,38.0,2,0,2,0,0,2,2,100.0,0,0,0,0,0,2,11,2,0,2023-2024,0.0,0.05263157894736842
1977,Jean Onana,CMR,MF,Marseille,Ligue 1,23,2000,6.3,23,14,6,14,3,13,25,52.0,12,10,2,8,11,34,11,1,0,2023-2024,1.746031746031746,3.6507936507936507
1978,Ryan One,SCO,FW,Sheffield Utd,Premier League,17,2006,0.1,0,0,0,0,0,0,0,0.0,0,0,0,0,0,0,0,0,0,2023-2024,0.0,0.0
1979,Karim Onisiwo,AUT,"FW,MF",Mainz 05,Bundesliga,31,1992,16.6,17,8,4,6,7,6,11,54.5,5,18,4,14,2,19,7,0,0,2023-2024,0.12048192771084336,1.0240963855421685
1980,Tyler Onyango,ENG,MF,Everton,Premier League,20,2003,0.0,0,0,0,0,0,0,0,0.0,0,0,0,0,0,0,0,0,0,2023-2024,,
1981,Fred Onyedinma,ENG,"DF,MF",Luton Town,Premier League,26,1996,4.5,10,6,7,3,0,5,12,41.7,7,3,0,3,1,11,13,0,0,2023-2024,0.2222222222222222,2.2222222222222223
1982,Frank Onyeka,NGA,MF,Brentford,Premier League,25,1998,12.9,37,24,9,23,5,16,29,55.2,13,15,7,8,23,60,17,0,0,2023-2024,1.7829457364341086,2.8682170542635657
1983,Loïs Openda,BEL,FW,RB Leipzig,Bundesliga,23,2000,30.0,3,3,0,1,2,0,6,0.0,6,19,3,16,5,8,14,0,0,2023-2024,0.16666666666666666,0.1
1984,Royce Openda Owaga,GAB,FW,Lorient,Ligue 1,21,2002,0.2,0,0,0,0,0,0,0,0.0,0,0,0,0,0,0,0,0,0,2023-2024,0.0,0.0
1985,Christopher Operi,CIV,DF,Le Havre,Ligue 1,26,1997,27.2,55,36,37,15,3,32,59,54.2,27,45,7,38,35,90,68,1,0,2023-2024,1.286764705882353,2.0220588235294117
1986,Leon Opitz,GER,"FW,DF",Werder Bremen,Bundesliga,18,2005,0.2,2,2,1,1,0,2,3,66.7,1,0,0,0,0,2,0,0,0,2023-2024,0.0,10.0
1987,Gift Orban,NGA,FW,Lyon,Ligue 1,21,2002,5.3,4,3,0,1,3,1,4,25.0,3,2,0,2,1,5,2,1,0,2023-2024,0.18867924528301888,0.7547169811320755
1988,Willi Orban,HUN,DF,RB Leipzig,Bundesliga,30,1992,17.6,20,12,8,10,2,9,18,50.0,9,22,13,9,16,36,76,1,0,2023-2024,0.9090909090909091,1.1363636363636362
1989,Ivan Ordets,UKR,DF,Bochum,Bundesliga,31,1992,20.9,19,14,11,6,2,10,17,58.8,7,41,29,12,31,50,130,0,0,2023-2024,1.4832535885167466,0.9090909090909092
1990,Divock Origi,BEL,FW,Nott'ham Forest,Premier League,28,1995,6.7,6,4,5,0,1,0,0,0.0,0,6,0,6,2,8,4,0,0,2023-2024,0.29850746268656714,0.8955223880597015
1991,Gaetano Oristanio,ITA,"FW,MF",Cagliari,Serie A,20,2002,12.3,20,10,5,14,1,5,17,29.4,12,11,0,11,9,29,8,0,0,2023-2024,0.7317073170731707,1.6260162601626016
1992,Aimar Oroz,ESP,MF,Osasuna,La Liga,21,2001,26.0,43,26,18,20,5,13,37,35.1,24,27,2,25,16,59,11,0,0,2023-2024,0.6153846153846154,1.6538461538461537
1993,Riccardo Orsolini,ITA,"FW,MF",Bologna,Serie A,26,1997,19.9,23,14,13,4,6,9,30,30.0,21,25,3,22,8,31,19,1,0,2023-2024,0.4020100502512563,1.155778894472362
1994,Stefan Ortega,GER,GK,Manchester City,Premier League,30,1992,7.1,0,0,0,0,0,0,0,0.0,0,0,0,0,0,0,2,1,0,2023-2024,0.0,0.0
1995,Eneko Ortiz,ESP,DF,Alavés,La Liga,20,2003,0.2,0,0,0,0,0,0,0,0.0,0,0,0,0,0,0,0,0,0,2023-2024,0.0,0.0
1996,Asier Osambela,ESP,MF,Osasuna,La Liga,19,2004,0.1,2,1,0,1,1,0,0,0.0,0,0,0,0,0,2,0,0,0,2023-2024,0.0,20.0
1997,Ben Osborn,ENG,"DF,MF",Sheffield Utd,Premier League,28,1994,15.2,22,9,11,9,2,8,17,47.1,9,18,2,16,8,30,30,0,0,2023-2024,0.5263157894736842,1.4473684210526316
1998,Gabriel Osho,NGA,DF,Luton Town,Premier League,24,1998,20.5,41,22,21,19,1,16,27,59.3,11,37,20,17,31,72,92,0,0,2023-2024,1.5121951219512195,2.0
1999,Victor Osimhen,NGA,FW,Napoli,Serie A,24,1998,22.0,9,5,0,4,5,2,4,50.0,2,5,1,4,2,11,18,0,0,2023-2024,0.09090909090909091,0.4090909090909091
2000,Milutin Osmajić,MNE,MF,Cádiz,La Liga,24,1999,0.1,0,0,0,0,0,0,0,0.0,0,0,0,0,0,0,0,0,0,2023-2024,0.0,0.0
Rk,Player,Nation,Pos,Squad,Comp,0,0,90.0,0,0,3,3,3,Tkl,0,0.0,0,0,0,0,0,0,0,0,0,2023-2024,0.0,0.0
2001,Patrick Osterhage,GER,MF,Bochum,Bundesliga,23,2000,20.7,38,26,14,23,1,17,36,47.2,19,36,9,27,27,65,32,1,0,2023-2024,1.3043478260869565,1.8357487922705316
2002,William Osula,DEN,FW,Sheffield Utd,Premier League,19,2003,8.7,2,2,1,0,1,1,2,50.0,1,3,1,2,2,4,9,0,0,2023-2024,0.2298850574712644,0.2298850574712644
2003,Dango Ouattara,BFA,"FW,DF",Bournemouth,Premier League,21,2002,13.7,45,27,22,11,12,19,34,55.9,15,18,3,15,22,67,35,0,0,2023-2024,1.6058394160583942,3.2846715328467155
2004,Kassoum Ouattara,FRA,"DF,FW",Monaco,Ligue 1,18,2004,7.1,17,12,8,5,4,9,20,45.0,11,11,0,11,13,30,20,0,0,2023-2024,1.8309859154929577,2.3943661971830985
2005,Remi Oudin,FRA,"MF,FW",Lecce,Serie A,26,1996,20.2,26,14,12,12,2,12,19,63.2,7,13,1,12,20,46,22,0,0,2023-2024,0.9900990099009901,1.2871287128712872
2006,Alexandre Oukidja,ALG,GK,Metz,Ligue 1,35,1988,33.2,2,1,2,0,0,1,2,50.0,1,1,0,1,3,5,24,3,0,2023-2024,0.09036144578313252,0.06024096385542168
2007,Azzedine Ounahi,MAR,MF,Marseille,Ligue 1,23,2000,13.4,25,11,9,14,2,11,32,34.4,21,6,1,5,11,36,8,0,0,2023-2024,0.8208955223880596,1.8656716417910448
2008,Adam Ounas,ALG,FW,Lille,Ligue 1,26,1996,4.6,4,3,2,2,0,2,7,28.6,5,2,0,2,6,10,1,0,0,2023-2024,1.3043478260869565,0.8695652173913044
2009,Patrick Ouotro,CIV,FW,Strasbourg,Ligue 1,17,2005,0.1,0,0,0,0,0,0,0,0.0,0,0,0,0,0,0,0,0,0,2023-2024,0.0,0.0
2010,Aiham Ousou,SYR,DF,Cádiz,La Liga,23,2000,4.8,8,5,6,2,0,5,5,100.0,0,1,0,1,7,15,15,0,0,2023-2024,1.4583333333333335,1.6666666666666667
2011,Jesús Owono,EQG,GK,Alavés,La Liga,22,2001,4.0,0,0,0,0,0,0,0,0.0,0,0,0,0,0,0,3,0,0,2023-2024,0.0,0.0
2012,Mikel Oyarzabal,ESP,"FW,MF",Real Sociedad,La Liga,26,1997,24.0,23,18,7,11,5,7,21,33.3,14,25,4,21,4,27,12,0,0,2023-2024,0.16666666666666666,0.9583333333333334
2013,Anthony Oyono,GAB,DF,Frosinone,Serie A,22,2001,13.3,37,26,21,14,2,23,34,67.6,11,17,3,14,9,46,32,0,0,2023-2024,0.6766917293233082,2.781954887218045
2014,Salih Özcan,TUR,MF,Dortmund,Bundesliga,25,1998,13.2,20,12,11,8,1,10,18,55.6,8,28,3,25,17,37,18,1,0,2023-2024,1.2878787878787878,1.5151515151515151
2015,Cenk Özkacar,TUR,DF,Valencia,La Liga,22,2000,17.8,26,15,22,4,0,15,23,65.2,8,18,7,11,18,44,84,1,0,2023-2024,1.0112359550561798,1.4606741573033708
2016,David Ozoh,ENG,"MF,DF",Crystal Palace,Premier League,18,2005,1.7,10,6,3,6,1,5,6,83.3,1,2,0,2,0,10,2,0,0,2023-2024,0.0,5.882352941176471
2017,Jon Pacheco,ESP,DF,Real Sociedad,La Liga,22,2001,17.0,25,15,21,4,0,14,22,63.6,8,17,6,11,10,35,53,1,0,2023-2024,0.5882352941176471,1.4705882352941178
2018,Willian Pacho,ECU,DF,Eint Frankfurt,Bundesliga,21,2001,33.0,62,37,38,23,1,31,53,58.5,22,51,22,29,47,109,152,2,0,2023-2024,1.4242424242424243,1.878787878787879
2019,Gonçalo Paciência,POR,"FW,MF",Bochum,Bundesliga,28,1994,7.2,8,4,2,2,4,3,6,50.0,3,5,0,5,0,8,7,0,0,2023-2024,0.0,1.1111111111111112
2020,Simone Pafundi,ITA,MF,Udinese,Serie A,17,2006,0.1,0,0,0,0,0,0,0,0.0,0,0,0,0,0,0,0,0,0,2023-2024,0.0,0.0
2021,Riccardo Pagano,ITA,"MF,DF",Roma,Serie A,18,2004,0.6,2,2,1,1,0,0,6,0.0,6,3,2,1,0,2,2,0,0,2023-2024,0.0,3.3333333333333335
2022,Pablo Pagis,FRA,MF,Lorient,Ligue 1,20,2002,1.8,10,6,5,4,1,6,10,60.0,4,2,0,2,3,13,1,0,0,2023-2024,1.6666666666666665,5.555555555555555
2023,Exequiel Palacios,ARG,MF,Leverkusen,Bundesliga,24,1998,20.3,60,34,28,26,6,26,53,49.1,27,24,0,24,29,89,20,2,0,2023-2024,1.4285714285714286,2.955665024630542
2024,Isaac Palazón Camacho,ESP,"MF,FW",Rayo Vallecano,La Liga,28,1994,31.0,46,25,16,21,9,20,58,34.5,38,29,2,27,16,62,41,0,0,2023-2024,0.5161290322580645,1.4838709677419355
2025,João Palhinha,POR,MF,Fulham,Premier League,28,1995,30.0,152,75,80,60,12,103,152,67.8,49,57,9,48,46,198,58,0,0,2023-2024,1.5333333333333334,5.066666666666666
Rk,Player,Nation,Pos,Squad,Comp,0,0,90.0,0,0,3,3,3,Tkl,0,0.0,0,0,0,0,0,0,0,0,0,2023-2024,0.0,0.0
2026,Nicolas Pallois,FRA,DF,Nantes,Ligue 1,35,1987,17.7,34,19,21,11,2,19,35,54.3,16,37,26,11,26,60,111,0,0,2023-2024,1.4689265536723164,1.92090395480226
2027,Cole Palmer,ENG,"FW,MF",Chelsea,Premier League,21,2002,29.0,23,12,9,6,8,8,19,42.1,11,20,2,18,20,43,13,2,0,2023-2024,0.6896551724137931,0.7931034482758621
2028,Cole Palmer,ENG,MF,Manchester City,Premier League,21,2002,0.1,0,0,0,0,0,0,0,0.0,0,0,0,0,0,0,0,0,0,2023-2024,0.0,0.0
2029,Emerson Palmieri,ITA,DF,West Ham,Premier League,28,1994,34.9,106,68,48,42,16,57,90,63.3,33,47,15,32,43,149,96,0,0,2023-2024,1.2320916905444126,3.037249283667622
2030,Joaquín Panichelli,ARG,"FW,MF",Alavés,La Liga,20,2002,2.5,3,3,1,1,1,1,2,50.0,1,1,0,1,1,4,4,0,0,2023-2024,0.4,1.2
2031,Miloš Pantović,SRB,MF,Union Berlin,Bundesliga,27,1996,0.2,0,0,0,0,0,0,0,0.0,0,0,0,0,0,0,0,0,0,2023-2024,0.0,0.0
2032,Antonios Papadopoulos,GER,DF,Dortmund,Bundesliga,23,1999,1.3,6,3,6,0,0,6,7,85.7,1,3,2,1,2,8,7,0,0,2023-2024,1.5384615384615383,4.615384615384615
2033,Christos Papadopoulos,GRE,FW,Genoa,Serie A,18,2004,0.0,0,0,0,0,0,0,1,0.0,1,0,0,0,0,0,0,0,0,2023-2024,,
2034,Sokratis Papastathopoulos,GRE,DF,Betis,La Liga,35,1988,12.6,21,14,16,5,0,13,17,76.5,4,15,9,6,6,27,60,0,0,2023-2024,0.4761904761904762,1.6666666666666667
2035,Merveille Papela,GER,"MF,DF",Mainz 05,Bundesliga,22,2001,2.9,5,4,2,3,0,0,4,0.0,4,1,0,1,4,9,2,0,0,2023-2024,1.3793103448275863,1.7241379310344829
2036,Leart Paqarada,KVX,DF,Köln,Bundesliga,28,1994,11.9,21,11,9,9,3,11,22,50.0,11,17,5,12,10,31,30,1,0,2023-2024,0.8403361344537815,1.7647058823529411
2037,Lucas Paquetá,BRA,"FW,MF",West Ham,Premier League,25,1997,29.1,71,48,38,26,7,25,52,48.1,27,28,1,27,21,92,28,2,0,2023-2024,0.7216494845360825,2.4398625429553262
2038,Victor Parada,ESP,"FW,MF",Alavés,La Liga,21,2002,0.0,1,1,0,1,0,1,1,100.0,0,0,0,0,0,1,0,0,0,2023-2024,,inf
2039,Aitor Paredes,ESP,DF,Athletic Club,La Liga,23,2000,30.0,20,11,11,9,0,7,14,50.0,7,23,11,12,33,53,104,0,0,2023-2024,1.1,0.6666666666666666
2040,Kevin Paredes,USA,"FW,MF",Wolfsburg,Bundesliga,20,2003,15.9,42,21,22,13,7,20,34,58.8,14,27,2,25,23,65,26,0,0,2023-2024,1.4465408805031446,2.641509433962264
2041,Leandro Paredes,ARG,MF,Roma,Serie A,29,1994,29.3,57,36,30,22,5,33,77,42.9,44,26,7,19,29,86,43,1,0,2023-2024,0.9897610921501706,1.9453924914675766
2042,Daniel Parejo,ESP,MF,Villarreal,La Liga,34,1989,28.7,43,30,16,21,6,20,46,43.5,26,25,9,16,21,64,29,3,0,2023-2024,0.7317073170731707,1.4982578397212545
2043,Fabiano Parisi,ITA,DF,Fiorentina,Serie A,22,2000,16.2,30,15,11,12,7,15,26,57.7,11,21,5,16,17,47,26,0,0,2023-2024,1.0493827160493827,1.8518518518518519
2044,Ben Parkinson,ENG,FW,Newcastle Utd,Premier League,18,2005,0.3,0,0,0,0,0,0,0,0.0,0,1,0,1,0,0,1,0,0,2023-2024,0.0,0.0
2045,Thomas Partey,GHA,"MF,DF",Arsenal,Premier League,30,1993,8.8,14,11,9,4,1,5,10,50.0,5,9,3,6,11,25,9,0,0,2023-2024,1.25,1.5909090909090908
2046,Mario Pašalić,CRO,MF,Atalanta,Serie A,28,1995,22.8,28,17,9,18,1,14,31,45.2,17,29,6,23,16,44,34,0,0,2023-2024,0.7017543859649122,1.2280701754385965
2047,Triantafyllos Pasaridīs,GRE,DF,Salernitana,Serie A,27,1996,5.0,11,7,9,2,0,9,14,64.3,5,7,3,4,3,14,19,0,0,2023-2024,0.6,2.2
2048,Pascu,ESP,FW,Villarreal,La Liga,20,2003,0.2,0,0,0,0,0,0,0,0.0,0,0,0,0,0,0,0,0,0,2023-2024,0.0,0.0
2049,Felix Passlack,GER,DF,Bochum,Bundesliga,25,1998,10.7,21,14,9,10,2,14,24,58.3,10,13,2,11,10,31,21,0,0,2023-2024,0.9345794392523366,1.9626168224299068
2050,Patric,ESP,DF,Lazio,Serie A,30,1993,17.9,13,8,10,3,0,8,18,44.4,10,15,9,6,6,19,44,0,0,2023-2024,0.335195530726257,0.7262569832402235
Rk,Player,Nation,Pos,Squad,Comp,0,0,90.0,0,0,3,3,3,Tkl,0,0.0,0,0,0,0,0,0,0,0,0,2023-2024,0.0,0.0
2051,Rui Patrício,POR,GK,Roma,Serie A,35,1988,23.0,0,0,0,0,0,0,1,0.0,1,1,0,1,0,0,3,1,0,2023-2024,0.0,0.0
2052,Nathan Patterson,SCO,DF,Everton,Premier League,21,2001,11.2,34,24,21,11,2,14,37,37.8,23,14,3,11,9,43,33,0,0,2023-2024,0.8035714285714286,3.035714285714286
2053,Gabriel Paulista,BRA,DF,Atlético Madrid,La Liga,32,1990,4.5,7,5,4,3,0,3,4,75.0,1,5,3,2,4,11,27,0,0,2023-2024,0.8888888888888888,1.5555555555555556
2054,Gabriel Paulista,BRA,DF,Valencia,La Liga,32,1990,15.5,10,7,8,2,0,6,11,54.5,5,15,7,8,24,34,78,0,0,2023-2024,1.5483870967741935,0.6451612903225806
2055,Benjamin Pavard,FRA,DF,Inter,Serie A,27,1996,18.6,34,21,21,11,2,20,24,83.3,4,25,15,10,32,66,44,1,0,2023-2024,1.7204301075268815,1.8279569892473118
2056,Jiří Pavlenka,CZE,GK,Werder Bremen,Bundesliga,31,1992,7.0,0,0,0,0,0,0,0,0.0,0,0,0,0,0,0,2,0,0,2023-2024,0.0,0.0
2057,Aleksandar Pavlovic,GER,MF,Bayern Munich,Bundesliga,19,2004,13.6,28,16,10,14,4,17,33,51.5,16,13,3,10,17,45,12,0,0,2023-2024,1.25,2.058823529411765
2058,Leonardo Pavoletti,ITA,FW,Cagliari,Serie A,34,1988,7.0,1,1,0,0,1,0,1,0.0,1,2,1,1,0,1,7,0,0,2023-2024,0.0,0.14285714285714285
2059,Martín Payero,ARG,MF,Udinese,Serie A,24,1998,20.0,54,32,28,19,7,19,46,41.3,27,25,7,18,15,69,21,0,0,2023-2024,0.75,2.7
2060,Nicolás Paz,ARG,"MF,FW",Real Madrid,La Liga,18,2004,0.3,0,0,0,0,0,0,0,0.0,0,2,0,2,1,1,0,0,0,2023-2024,3.3333333333333335,0.0
2061,Myles Peart-Harris,ENG,"DF,MF",Brentford,Premier League,20,2002,0.1,0,0,0,0,0,0,0,0.0,0,0,0,0,0,0,1,0,0,2023-2024,0.0,0.0
2062,Sydie Peck,ENG,MF,Sheffield Utd,Premier League,18,2004,0.1,0,0,0,0,0,0,0,0.0,0,0,0,0,0,0,0,0,0,2023-2024,0.0,0.0
2063,Mads Pedersen,DEN,DF,Augsburg,Bundesliga,26,1996,19.8,64,39,31,27,6,24,44,54.5,20,20,3,17,19,83,46,0,0,2023-2024,0.9595959595959596,3.2323232323232323
2064,Marcus Pedersen,NOR,DF,Sassuolo,Serie A,23,2000,17.9,36,24,25,5,6,21,25,84.0,4,19,5,14,10,46,51,0,0,2023-2024,0.558659217877095,2.011173184357542
2065,Alfonso Pedraza,ESP,DF,Villarreal,La Liga,27,1996,12.4,25,9,18,5,2,9,17,52.9,8,16,7,9,13,38,19,0,0,2023-2024,1.0483870967741935,2.0161290322580645
2066,Pedri,ESP,"MF,FW",Barcelona,La Liga,20,2002,16.4,33,24,16,13,4,8,27,29.6,19,27,3,24,14,47,10,0,0,2023-2024,0.853658536585366,2.0121951219512195
2067,Pedro,ESP,"FW,MF",Lazio,Serie A,36,1987,9.1,16,12,5,7,4,3,12,25.0,9,16,2,14,3,19,1,0,0,2023-2024,0.32967032967032966,1.7582417582417582
2068,Adrià Pedrosa,ESP,DF,Sevilla,La Liga,25,1998,19.5,46,26,28,14,4,23,34,67.6,11,26,6,20,15,61,54,0,0,2023-2024,0.7692307692307693,2.358974358974359
2069,Jordan Pefok,USA,FW,Gladbach,Bundesliga,27,1996,15.8,10,4,0,8,2,3,8,37.5,5,12,3,9,5,15,28,0,0,2023-2024,0.3164556962025316,0.6329113924050632
2070,Jordan Pefok,USA,FW,Union Berlin,Bundesliga,27,1996,0.3,0,0,0,0,0,0,0,0.0,0,1,1,0,0,0,0,0,0,2023-2024,0.0,0.0
2071,Dženan Pejčinović,GER,FW,Wolfsburg,Bundesliga,18,2005,0.4,0,0,0,0,0,0,0,0.0,0,1,0,1,0,0,0,0,0,2023-2024,0.0,0.0
2072,Pietro Pellegri,ITA,FW,Torino,Serie A,22,2001,8.4,5,1,1,4,0,1,5,20.0,4,4,1,3,2,7,3,0,0,2023-2024,0.23809523809523808,0.5952380952380952
2073,Lorenzo Pellegrini,ITA,MF,Roma,Serie A,27,1996,20.7,35,20,14,16,5,17,51,33.3,34,28,5,23,20,55,22,0,0,2023-2024,0.9661835748792271,1.6908212560386473
2074,Luca Pellegrini,ITA,DF,Lazio,Serie A,24,1999,8.7,18,13,7,10,1,9,17,52.9,8,7,3,4,9,27,20,0,0,2023-2024,1.0344827586206897,2.0689655172413794
2075,Marco Pellegrino,,DF,Salernitana,Serie A,0,0,6.1,8,6,4,3,1,5,10,50.0,5,11,6,5,10,18,28,0,0,2023-2024,1.639344262295082,1.3114754098360657
Rk,Player,Nation,Pos,Squad,Comp,0,0,90.0,0,0,3,3,3,Tkl,0,0.0,0,0,0,0,0,0,0,0,0,2023-2024,0.0,0.0
2076,Marco Pellegrino,,DF,Milan,Serie A,0,0,0.8,1,1,0,0,1,0,2,0.0,2,1,1,0,1,2,2,0,0,2023-2024,1.25,1.25
2077,Facundo Pellistri,URU,"FW,MF",Manchester Utd,Premier League,21,2001,1.9,5,3,4,1,0,1,3,33.3,2,7,1,6,1,6,5,0,0,2023-2024,0.5263157894736842,2.6315789473684212
2078,Facundo Pellistri,URU,"MF,FW",Granada,La Liga,21,2001,13.7,29,19,12,10,7,6,21,28.6,15,18,0,18,4,33,7,0,0,2023-2024,0.29197080291970806,2.1167883211678835
2079,Andy Pelmard,FRA,DF,Clermont Foot,Ligue 1,23,2000,33.2,51,38,41,9,1,32,40,80.0,8,37,20,17,33,84,99,2,0,2023-2024,0.9939759036144578,1.5361445783132528
2080,Aurélien Pelon,FRA,DF,Lorient,Ligue 1,19,2004,1.0,1,0,1,0,0,0,2,0.0,2,2,2,0,0,1,7,0,0,2023-2024,0.0,1.0
2081,Faris Pemi Moumbagna,CMR,FW,Marseille,Ligue 1,23,2000,6.1,2,1,0,2,0,0,3,0.0,3,4,0,4,3,5,1,0,0,2023-2024,0.49180327868852464,0.3278688524590164
2082,Iñaki Peña,ESP,GK,Barcelona,La Liga,24,1999,10.0,0,0,0,0,0,0,1,0.0,1,0,0,0,0,0,5,1,0,2023-2024,0.0,0.0
2083,Marcos Peña,ESP,MF,Almería,La Liga,18,2005,4.9,19,14,12,7,0,6,12,50.0,6,9,3,6,13,32,8,0,0,2023-2024,2.6530612244897958,3.877551020408163
2084,Rubén Peña,ESP,"DF,FW",Osasuna,La Liga,32,1991,23.2,47,25,22,18,7,20,49,40.8,29,37,8,29,30,77,39,3,0,2023-2024,1.293103448275862,2.0258620689655173
2085,Pepín,EQG,"MF,FW",Monza,Serie A,26,1996,2.7,6,1,1,4,1,2,4,50.0,2,5,2,3,0,6,6,0,0,2023-2024,0.0,2.222222222222222
2086,Alberto Perea,ESP,"MF,FW",Granada,La Liga,32,1990,0.0,0,0,0,0,0,0,2,0.0,2,0,0,0,0,0,0,0,0,2023-2024,,
2087,Andreas Pereira,BRA,MF,Fulham,Premier League,27,1996,29.0,25,12,4,12,9,11,41,26.8,30,16,2,14,4,29,12,0,0,2023-2024,0.13793103448275862,0.8620689655172413
2088,Danilo Pereira,POR,DF,Paris S-G,Ligue 1,31,1991,22.2,22,12,14,6,2,9,17,52.9,8,29,26,3,23,45,100,1,0,2023-2024,1.0360360360360361,0.990990990990991
2089,Mathias Pereira Lage,POR,"FW,MF",Brest,Ligue 1,26,1996,13.2,21,15,7,8,6,7,28,25.0,21,14,5,9,10,31,13,0,0,2023-2024,0.7575757575757576,1.590909090909091
2090,Pedro Pereira,POR,DF,Monza,Serie A,25,1998,9.3,19,13,14,4,1,9,17,52.9,8,15,2,13,4,23,18,0,0,2023-2024,0.4301075268817204,2.043010752688172
2091,Daniel Peretz,ISR,GK,Bayern Munich,Bundesliga,23,2000,0.2,0,0,0,0,0,0,0,0.0,0,0,0,0,0,0,0,0,0,2023-2024,0.0,0.0
2092,Roberto Pereyra,ARG,"FW,MF",Udinese,Serie A,32,1991,20.6,19,9,11,5,3,11,29,37.9,18,20,4,16,7,26,18,0,0,2023-2024,0.3398058252427184,0.9223300970873786
2093,Ayoze Pérez,ESP,FW,Betis,La Liga,30,1993,25.5,59,32,16,33,10,21,49,42.9,28,42,4,38,22,81,18,0,0,2023-2024,0.8627450980392157,2.3137254901960786
2094,Carles Pérez,ESP,"MF,DF",Celta Vigo,La Liga,25,1998,8.6,13,5,6,5,2,7,18,38.9,11,14,1,13,5,18,8,0,0,2023-2024,0.5813953488372093,1.5116279069767442
2095,Francisco Perez,ESP,"MF,FW",Valencia,La Liga,20,2002,22.8,30,17,10,14,6,15,44,34.1,29,19,0,19,14,44,5,0,0,2023-2024,0.6140350877192983,1.3157894736842104
2096,Kike Pérez,ESP,"MF,FW",Rayo Vallecano,La Liga,26,1997,9.3,27,11,11,15,1,11,23,47.8,12,11,0,11,8,35,6,0,0,2023-2024,0.8602150537634408,2.9032258064516125
2097,Nehuén Pérez,ARG,DF,Udinese,Serie A,23,2000,36.0,72,48,42,28,2,39,48,81.3,9,53,26,27,45,117,158,1,0,2023-2024,1.25,2.0
2098,Matteo Perez Vinlöf,SWE,FW,Bayern Munich,Bundesliga,17,2005,0.2,0,0,0,0,0,0,0,0.0,0,0,0,0,1,1,0,0,0,2023-2024,5.0,0.0
2099,Simone Perilli,ITA,GK,Hellas Verona,Serie A,28,1995,1.0,0,0,0,0,0,0,0,0.0,0,0,0,0,0,0,0,0,0,2023-2024,0.0,0.0
2100,Mattia Perin,ITA,GK,Juventus,Serie A,30,1992,2.5,0,0,0,0,0,0,0,0.0,0,0,0,0,0,0,1,0,0,2023-2024,0.0,0.0
Rk,Player,Nation,Pos,Squad,Comp,0,0,90.0,0,0,3,3,3,Tkl,0,0.0,0,0,0,0,0,0,0,0,0,2023-2024,0.0,0.0
2101,Samuele Perisan,ITA,GK,Empoli,Serie A,25,1997,1.0,0,0,0,0,0,0,0,0.0,0,0,0,0,0,0,0,0,0,2023-2024,0.0,0.0
2102,Ivan Perišić,CRO,FW,Tottenham,Premier League,34,1989,1.1,3,2,1,1,1,3,5,60.0,2,1,0,1,2,5,1,0,0,2023-2024,1.8181818181818181,2.727272727272727
2103,Romain Perraud,FRA,"DF,FW",Nice,Ligue 1,25,1997,4.1,7,6,5,1,1,4,11,36.4,7,4,0,4,6,13,15,1,0,2023-2024,1.4634146341463417,1.707317073170732
2104,Lucas Perrin,FRA,DF,Strasbourg,Ligue 1,24,1998,30.3,47,30,33,14,0,28,46,60.9,18,45,32,13,28,75,113,0,0,2023-2024,0.9240924092409241,1.551155115511551
2105,Máximo Perrone,ARG,MF,Las Palmas,La Liga,20,2003,18.0,42,21,17,22,3,19,39,48.7,20,27,4,23,24,66,21,0,0,2023-2024,1.3333333333333333,2.3333333333333335
2106,Pavao Pervan,AUT,GK,Wolfsburg,Bundesliga,35,1987,9.0,0,0,0,0,0,0,0,0.0,0,0,0,0,0,0,4,0,0,2023-2024,0.0,0.0
2107,Matteo Pessina,ITA,MF,Monza,Serie A,26,1997,35.8,44,25,20,20,4,23,49,46.9,26,29,11,18,27,71,46,1,0,2023-2024,0.7541899441340782,1.229050279329609
2108,Andrea Petagna,ITA,FW,Cagliari,Serie A,28,1995,11.1,4,2,1,0,3,1,2,50.0,1,6,3,3,1,5,4,0,0,2023-2024,0.0900900900900901,0.3603603603603604
2109,Denis Petrić,SRB,GK,Nantes,Ligue 1,35,1988,0.3,0,0,0,0,0,0,0,0.0,0,0,0,0,0,0,0,0,0,2023-2024,0.0,0.0
2110,Njegoš Petrović,SRB,"MF,FW",Granada,La Liga,24,1999,1.7,5,2,4,1,0,2,3,66.7,1,2,0,2,1,6,3,0,0,2023-2024,0.5882352941176471,2.9411764705882355
2111,Đorđe Petrović,SRB,GK,Chelsea,Premier League,23,1999,22.1,0,0,0,0,0,0,0,0.0,0,0,0,0,0,0,12,3,0,2023-2024,0.0,0.0
2112,Jens Petter Hauge,NOR,"MF,FW",Eint Frankfurt,Bundesliga,23,1999,1.6,2,1,1,0,1,2,7,28.6,5,5,1,4,0,2,1,0,0,2023-2024,0.0,1.25
2113,Germán Pezzella,ARG,DF,Betis,La Liga,32,1991,30.7,34,24,24,10,0,23,38,60.5,15,31,18,13,31,65,150,0,0,2023-2024,1.009771986970684,1.1074918566775245
2114,Giuseppe Pezzella,ITA,DF,Empoli,Serie A,25,1997,12.1,25,14,19,5,1,20,28,71.4,8,17,6,11,2,27,35,0,0,2023-2024,0.1652892561983471,2.066115702479339
2115,Luca Pfeiffer,GER,"FW,MF",Darmstadt 98,Bundesliga,26,1996,18.0,11,6,2,6,3,5,11,45.5,6,5,1,4,2,13,21,0,0,2023-2024,0.1111111111111111,0.6111111111111112
2116,Patric Pfeiffer,GER,DF,Augsburg,Bundesliga,23,1999,5.7,11,7,6,4,1,5,6,83.3,1,10,6,4,11,22,21,0,0,2023-2024,1.9298245614035088,1.9298245614035088
2117,Maximilian Philipp,GER,"FW,MF",Freiburg,Bundesliga,29,1994,3.6,8,5,4,4,0,1,6,16.7,5,7,0,7,1,9,3,0,0,2023-2024,0.2777777777777778,2.2222222222222223
2118,Kalvin Phillips,ENG,MF,West Ham,Premier League,27,1995,3.4,11,6,2,8,1,5,9,55.6,4,4,1,3,4,15,2,1,0,2023-2024,1.1764705882352942,3.235294117647059
2119,Kalvin Phillips,ENG,MF,Manchester City,Premier League,27,1995,1.0,3,3,1,1,1,0,0,0.0,0,0,0,0,2,5,2,0,0,2023-2024,2.0,3.0
2120,Jaden Philogene Bidace,ENG,FW,Aston Villa,Premier League,21,2002,0.0,0,0,0,0,0,0,0,0.0,0,0,0,0,0,0,0,0,0,2023-2024,,
2121,Kamil Piątkowski,POL,DF,Granada,La Liga,23,2000,5.6,18,10,16,1,1,10,14,71.4,4,6,5,1,8,26,28,1,0,2023-2024,1.4285714285714286,3.2142857142857144
2122,Roberto Piccoli,ITA,FW,Empoli,Serie A,22,2001,0.4,1,1,0,0,1,1,1,100.0,0,0,0,0,0,1,0,0,0,2023-2024,0.0,2.5
2123,Roberto Piccoli,ITA,FW,Lecce,Serie A,22,2001,15.3,10,6,3,5,2,1,4,25.0,3,17,1,16,4,14,16,0,0,2023-2024,0.26143790849673204,0.6535947712418301
2124,Florian Pick,GER,"MF,FW",Heidenheim,Bundesliga,27,1995,3.6,4,4,3,0,1,2,3,66.7,1,2,0,2,2,6,2,0,0,2023-2024,0.5555555555555556,1.1111111111111112
2125,Jordan Pickford,ENG,GK,Everton,Premier League,29,1994,38.0,1,0,1,0,0,1,1,100.0,0,3,0,3,0,1,19,1,0,2023-2024,0.0,0.02631578947368421
Rk,Player,Nation,Pos,Squad,Comp,0,0,90.0,0,0,3,3,3,Tkl,0,0.0,0,0,0,0,0,0,0,0,0,2023-2024,0.0,0.0
2126,Amos Pieper,GER,DF,Werder Bremen,Bundesliga,25,1998,6.6,14,11,8,6,0,7,13,53.8,6,12,7,5,9,23,36,1,0,2023-2024,1.3636363636363638,2.121212121212121
2127,Marvin Pieringer,GER,"MF,FW",Heidenheim,Bundesliga,23,1999,16.8,19,12,5,11,3,8,20,40.0,12,28,4,24,12,31,21,0,0,2023-2024,0.7142857142857143,1.130952380952381
2128,Santiago Pierotti,ARG,"MF,FW",Lecce,Serie A,22,2001,2.2,8,8,2,5,1,2,8,25.0,6,5,0,5,1,9,0,0,0,2023-2024,0.45454545454545453,3.6363636363636362
2129,Niccolò Pierozzi,ITA,DF,Salernitana,Serie A,21,2001,9.7,17,11,13,4,0,11,22,50.0,11,24,7,17,11,28,36,0,0,2023-2024,1.1340206185567012,1.752577319587629
2130,Ronaël Pierre-Gabriel,FRA,DF,Nantes,Ligue 1,25,1998,6.6,15,9,12,2,1,5,7,71.4,2,13,4,9,8,23,25,0,0,2023-2024,1.2121212121212122,2.272727272727273
2131,Andrea Pinamonti,ITA,FW,Sassuolo,Serie A,24,1999,34.2,13,8,1,6,6,5,22,22.7,17,19,2,17,1,14,40,0,0,2023-2024,0.029239766081871343,0.38011695906432746
2132,Ethan Pinnock,JAM,DF,Brentford,Premier League,30,1993,28.0,35,23,22,13,0,9,20,45.0,11,40,24,16,43,78,170,3,0,2023-2024,1.5357142857142858,1.25
2133,Yeremi Pino,ESP,"MF,FW",Villarreal,La Liga,20,2002,5.3,25,18,12,10,3,9,18,50.0,9,11,1,10,5,30,5,0,0,2023-2024,0.9433962264150944,4.716981132075472
2134,Carlo Pinsoglio,ITA,GK,Juventus,Serie A,33,1990,0.5,0,0,0,0,0,0,0,0.0,0,0,0,0,0,0,0,0,0,2023-2024,0.0,0.0
2135,Lorenzo Pirola,ITA,DF,Salernitana,Serie A,21,2002,22.1,39,23,25,14,0,15,28,53.6,13,46,30,16,25,64,93,1,0,2023-2024,1.1312217194570136,1.7647058823529411
2136,Niccolò Pisilli,ITA,MF,Roma,Serie A,18,2004,0.1,0,0,0,0,0,0,0,0.0,0,0,0,0,0,0,0,0,0,2023-2024,0.0,0.0
2137,Alassane Pléa,FRA,"FW,MF",Gladbach,Bundesliga,30,1993,21.3,17,7,5,8,4,7,15,46.7,8,11,0,11,2,19,6,0,0,2023-2024,0.09389671361502347,0.7981220657276995
2138,Tommaso Pobega,ITA,MF,Milan,Serie A,24,1999,3.5,16,9,11,5,0,6,13,46.2,7,10,2,8,6,22,7,0,0,2023-2024,1.7142857142857142,4.571428571428571
2139,Paul Pogba,FRA,MF,Juventus,Serie A,30,1993,0.6,1,1,0,1,0,1,1,100.0,0,0,0,0,1,2,1,0,0,2023-2024,1.6666666666666667,1.6666666666666667
2140,Ole Pohlmann,GER,MF,Dortmund,Bundesliga,22,2001,0.6,1,0,0,1,0,1,2,50.0,1,0,0,0,0,1,1,0,0,2023-2024,0.0,1.6666666666666667
2141,Matteo Politano,ITA,FW,Napoli,Serie A,29,1993,26.2,19,8,8,7,4,11,34,32.4,23,9,1,8,15,34,11,1,0,2023-2024,0.5725190839694657,0.7251908396946565
2142,Sebastian Polter,GER,FW,Darmstadt 98,Bundesliga,32,1991,5.0,1,0,1,0,0,0,1,0.0,1,5,1,4,0,1,4,0,0,2023-2024,0.0,0.2
2143,Julien Ponceau,FRA,MF,Lorient,Ligue 1,22,2000,24.9,32,15,12,14,6,9,30,30.0,21,22,1,21,19,51,20,0,0,2023-2024,0.7630522088353414,1.285140562248996
2144,Marin Pongračić,CRO,DF,Lecce,Serie A,25,1997,35.8,43,30,22,20,1,19,25,76.0,6,37,26,11,51,94,130,1,0,2023-2024,1.4245810055865924,1.2011173184357542
2145,Nick Pope,ENG,GK,Newcastle Utd,Premier League,31,1992,14.9,0,0,0,0,0,0,1,0.0,1,0,0,0,0,0,7,2,0,2023-2024,0.0,0.0
2146,Pedro Porro,ESP,DF,Tottenham,Premier League,23,1999,34.3,91,63,43,34,14,62,120,51.7,58,63,18,45,34,125,102,3,0,2023-2024,0.9912536443148688,2.653061224489796
2147,Portu,ESP,FW,Getafe,La Liga,31,1992,1.1,5,3,4,0,1,5,6,83.3,1,0,0,0,0,5,0,0,0,2023-2024,0.0,4.545454545454545
2148,Portu,ESP,"MF,FW",Girona,La Liga,31,1992,13.2,18,13,3,10,5,3,18,16.7,15,9,1,8,4,22,6,0,0,2023-2024,0.30303030303030304,1.3636363636363638
2149,Stefan Posch,AUT,DF,Bologna,Serie A,26,1997,26.8,77,46,35,38,4,49,88,55.7,39,27,8,19,18,95,72,0,0,2023-2024,0.6716417910447761,2.873134328358209
2150,Yussuf Poulsen,DEN,FW,RB Leipzig,Bundesliga,29,1994,13.5,13,8,1,9,3,4,14,28.6,10,13,3,10,4,17,15,0,0,2023-2024,0.2962962962962963,0.9629629629629629
Rk,Player,Nation,Pos,Squad,Comp,0,0,90.0,0,0,3,3,3,Tkl,0,0.0,0,0,0,0,0,0,0,0,0,2023-2024,0.0,0.0
2151,José Pozo,ESP,MF,Rayo Vallecano,La Liga,27,1996,0.2,1,1,0,1,0,1,1,100.0,0,1,0,1,0,1,0,0,0,2023-2024,0.0,5.0
2152,Alejandro Pozo Pozo,ESP,"DF,MF",Almería,La Liga,24,1999,10.8,19,12,11,6,2,12,20,60.0,8,14,4,10,7,26,21,0,0,2023-2024,0.6481481481481481,1.759259259259259
2153,Beñat Prados,ESP,"MF,DF",Athletic Club,La Liga,22,2001,16.1,45,28,11,23,11,23,42,54.8,19,32,5,27,23,68,27,0,0,2023-2024,1.4285714285714284,2.795031055900621
2154,Matteo Prati,ITA,MF,Cagliari,Serie A,19,2003,21.9,45,25,15,27,3,26,42,61.9,16,29,6,23,15,60,26,1,0,2023-2024,0.6849315068493151,2.0547945205479454
2155,Abdón Prats,ESP,"FW,MF",Mallorca,La Liga,30,1992,14.1,6,4,2,2,2,3,5,60.0,2,6,3,3,2,8,12,0,0,2023-2024,0.14184397163120568,0.425531914893617
2156,Sanjin Prcić,BIH,MF,Strasbourg,Ligue 1,29,1993,1.0,0,0,0,0,0,0,1,0.0,1,2,1,1,3,3,1,0,0,2023-2024,3.0,0.0
2157,Grischa Prömel,GER,MF,Hoffenheim,Bundesliga,28,1995,23.8,32,18,11,15,6,14,32,43.8,18,22,6,16,22,54,36,0,0,2023-2024,0.9243697478991596,1.3445378151260503
2158,Ivan Provedel,ITA,GK,Lazio,Serie A,29,1994,30.0,1,0,1,0,0,1,3,33.3,2,0,0,0,0,1,12,1,0,2023-2024,0.0,0.03333333333333333
2159,Marc Pubill,ESP,DF,Almería,La Liga,20,2003,20.9,47,23,35,8,4,22,39,56.4,17,20,8,12,15,62,83,1,0,2023-2024,0.7177033492822967,2.248803827751196
2160,Gustavo Puerta,COL,"DF,MF",Leverkusen,Bundesliga,20,2003,0.5,5,3,2,2,1,1,2,50.0,1,2,0,2,0,5,0,0,0,2023-2024,0.0,10.0
2161,Antonio Puertas,ESP,"MF,FW",Granada,La Liga,31,1992,8.1,12,8,6,5,1,6,15,40.0,9,5,0,5,6,18,4,0,0,2023-2024,0.7407407407407408,1.4814814814814816
2162,Arnau Puigmal,ESP,"FW,DF",Almería,La Liga,22,2001,2.8,2,1,1,1,0,1,3,33.3,2,3,0,3,3,5,2,0,0,2023-2024,1.0714285714285714,0.7142857142857143
2163,Christian Pulisic,USA,"FW,MF",Milan,Serie A,24,1998,28.9,35,26,14,11,10,17,30,56.7,13,20,1,19,10,45,10,1,0,2023-2024,0.34602076124567477,1.2110726643598617
2164,George Pușcaș,ROU,FW,Genoa,Serie A,27,1996,2.1,0,0,0,0,0,0,3,0.0,3,1,0,1,0,0,1,0,0,2023-2024,0.0,0.0
2165,Jarell Quansah,ENG,DF,Liverpool,Premier League,20,2003,13.2,25,22,17,7,1,14,20,70.0,6,16,8,8,17,42,39,1,0,2023-2024,1.2878787878787878,1.893939393939394
2166,Domingos Quina,POR,MF,Udinese,Serie A,23,1999,0.1,1,1,1,0,0,0,0,0.0,0,0,0,0,0,1,0,0,0,2023-2024,0.0,10.0
2167,Adrien Rabiot,FRA,MF,Juventus,Serie A,28,1995,29.5,58,39,22,30,6,30,45,66.7,15,26,6,20,25,83,34,0,0,2023-2024,0.847457627118644,1.9661016949152543
2168,Uroš Račić,SRB,MF,Sassuolo,Serie A,25,1998,9.1,10,4,6,4,0,0,9,0.0,9,16,7,9,7,17,22,0,0,2023-2024,0.7692307692307693,1.098901098901099
2169,Nemanja Radonjić,SRB,"MF,FW",Torino,Serie A,27,1996,4.2,1,1,0,0,1,1,3,33.3,2,3,0,3,0,1,0,0,0,2023-2024,0.0,0.23809523809523808
2170,Nemanja Radonjić,SRB,"MF,DF",Mallorca,La Liga,27,1996,3.9,4,2,1,3,0,1,4,25.0,3,2,0,2,3,7,3,0,0,2023-2024,0.7692307692307693,1.0256410256410258
2171,Aleksandar Radovanović,SRB,DF,Almería,La Liga,29,1993,6.3,8,7,7,1,0,6,6,100.0,0,8,8,0,11,19,48,0,0,2023-2024,1.746031746031746,1.2698412698412698
2172,Ionuț Radu,ROU,GK,Bournemouth,Premier League,26,1997,2.0,0,0,0,0,0,0,0,0.0,0,0,0,0,0,0,0,0,0,2023-2024,0.0,0.0
2173,Boris Radunović,SRB,GK,Cagliari,Serie A,27,1996,7.0,0,0,0,0,0,0,0,0.0,0,0,0,0,1,1,1,2,0,2023-2024,0.14285714285714285,0.0
2174,Hamza Rafia,TUN,MF,Lecce,Serie A,24,1999,13.4,44,31,13,27,4,13,30,43.3,17,27,1,26,11,55,13,0,0,2023-2024,0.8208955223880596,3.2835820895522385
2175,Abdellah Raihani,MAR,FW,Atlético Madrid,La Liga,19,2004,0.1,0,0,0,0,0,0,1,0.0,1,0,0,0,0,0,0,0,0,2023-2024,0.0,0.0
Rk,Player,Nation,Pos,Squad,Comp,0,0,90.0,0,0,3,3,3,Tkl,0,0.0,0,0,0,0,0,0,0,0,0,2023-2024,0.0,0.0
2176,Antonio Raillo,ESP,DF,Mallorca,La Liga,31,1991,24.4,30,23,18,12,0,17,23,73.9,6,44,30,14,37,67,104,2,0,2023-2024,1.5163934426229508,1.2295081967213115
2177,Luca Raimund,GER,"FW,MF",Stuttgart,Bundesliga,18,2005,0.3,3,1,2,1,0,0,0,0.0,0,2,0,2,0,3,0,0,0,2023-2024,0.0,10.0
2178,Predrag Rajković,SRB,GK,Mallorca,La Liga,27,1995,36.0,2,1,2,0,0,2,2,100.0,0,0,0,0,0,2,14,0,0,2023-2024,0.0,0.05555555555555555
2179,Jesurun Rak Sakyi,ENG,"MF,FW",Crystal Palace,Premier League,20,2002,1.5,4,1,3,1,0,2,3,66.7,1,2,0,2,3,7,1,0,0,2023-2024,2.0,2.6666666666666665
2180,Ivan Rakitić,CRO,MF,Sevilla,La Liga,35,1988,15.8,30,16,9,12,9,11,19,57.9,8,16,5,11,14,44,12,0,0,2023-2024,0.8860759493670886,1.8987341772151898
2181,Ylber Ramadani,ALB,MF,Lecce,Serie A,27,1996,33.0,68,41,32,29,7,37,96,38.5,59,54,13,41,44,112,44,0,0,2023-2024,1.3333333333333333,2.0606060606060606
2182,Largie Ramazani,BEL,"FW,MF",Almería,La Liga,22,2001,17.3,12,7,5,6,1,6,26,23.1,20,16,2,14,34,46,10,0,0,2023-2024,1.9653179190751444,0.6936416184971098
2183,Benito Ramírez,ESP,"FW,MF",Las Palmas,La Liga,28,1995,4.3,5,3,2,3,0,3,6,50.0,3,7,1,6,3,8,0,0,0,2023-2024,0.6976744186046512,1.1627906976744187
2184,Sandro Ramírez,ESP,FW,Las Palmas,La Liga,28,1995,20.1,12,8,4,6,2,6,15,40.0,9,13,1,12,4,16,14,1,0,2023-2024,0.1990049751243781,0.5970149253731343
2185,Chris Ramos,ESP,"FW,MF",Cádiz,La Liga,26,1997,29.0,28,15,9,15,4,8,27,29.6,19,23,7,16,9,37,44,0,0,2023-2024,0.3103448275862069,0.9655172413793104
2186,Gonçalo Ramos,POR,FW,Paris S-G,Ligue 1,22,2001,15.8,25,15,4,12,9,6,20,30.0,14,12,2,10,5,30,16,0,0,2023-2024,0.3164556962025316,1.5822784810126582
2187,Sergio Ramos,ESP,DF,Sevilla,La Liga,37,1986,28.0,45,30,32,11,2,27,40,67.5,13,35,30,5,41,86,156,0,0,2023-2024,1.4642857142857142,1.6071428571428572
2188,Aaron Ramsdale,ENG,GK,Arsenal,Premier League,25,1998,6.0,0,0,0,0,0,0,0,0.0,0,0,0,0,0,0,3,2,0,2023-2024,0.0,0.0
2189,Aaron Ramsey,ENG,"MF,FW",Burnley,Premier League,20,2003,5.9,17,14,7,5,5,8,16,50.0,8,11,2,9,1,18,10,0,0,2023-2024,0.1694915254237288,2.8813559322033897
2190,Jacob Ramsey,ENG,"FW,MF",Aston Villa,Premier League,22,2001,9.5,16,8,7,6,3,5,15,33.3,10,15,2,13,3,19,8,0,0,2023-2024,0.3157894736842105,1.6842105263157894
2191,Luca Ranieri,ITA,DF,Fiorentina,Serie A,24,1999,22.9,14,10,11,1,2,8,13,61.5,5,25,11,14,29,43,64,0,0,2023-2024,1.2663755458515285,0.6113537117903931
2192,Filippo Ranocchia,ITA,"MF,DF",Empoli,Serie A,22,2001,5.3,16,11,7,9,0,7,16,43.8,9,9,1,8,3,19,14,0,0,2023-2024,0.5660377358490566,3.018867924528302
2193,Grant Ranos,ARM,"MF,FW",Gladbach,Bundesliga,20,2003,0.5,1,0,0,0,1,0,0,0.0,0,0,0,0,0,1,0,0,0,2023-2024,0.0,2.0
2194,Raphinha,BRA,"FW,MF",Barcelona,La Liga,26,1996,15.2,14,8,6,6,2,4,18,22.2,14,17,1,16,13,27,11,0,0,2023-2024,0.8552631578947368,0.9210526315789475
2195,Nicolai Rapp,GER,DF,Werder Bremen,Bundesliga,26,1996,0.8,3,2,2,1,0,2,2,100.0,0,2,0,2,2,5,8,0,0,2023-2024,2.5,3.75
2196,Elba Rashani,KVX,"MF,FW",Clermont Foot,Ligue 1,30,1993,13.1,30,18,4,17,9,11,24,45.8,13,17,3,14,12,42,15,0,0,2023-2024,0.916030534351145,2.290076335877863
2197,Marcus Rashford,ENG,FW,Manchester Utd,Premier League,25,1997,25.2,19,12,9,4,6,9,26,34.6,17,15,1,14,4,23,21,0,0,2023-2024,0.15873015873015872,0.753968253968254
2198,Giacomo Raspadori,ITA,"FW,MF",Napoli,Serie A,23,2000,17.6,21,10,6,10,5,6,15,40.0,9,15,1,14,3,24,7,0,0,2023-2024,0.17045454545454544,1.1931818181818181
2199,Andrei Ratiu,ROU,"DF,MF",Rayo Vallecano,La Liga,25,1998,7.0,12,4,6,5,1,8,15,53.3,7,4,1,3,0,12,12,0,0,2023-2024,0.0,1.7142857142857142
2200,Raúl,ESP,FW,Osasuna,La Liga,22,2000,15.1,10,4,4,2,4,2,10,20.0,8,9,1,8,5,15,11,0,0,2023-2024,0.33112582781456956,0.6622516556291391
Rk,Player,Nation,Pos,Squad,Comp,0,0,90.0,0,0,3,3,3,Tkl,0,0.0,0,0,0,0,0,0,0,0,0,2023-2024,0.0,0.0
2201,David Raum,GER,DF,RB Leipzig,Bundesliga,25,1998,30.4,58,35,24,29,5,34,58,58.6,24,51,9,42,27,85,82,2,0,2023-2024,0.8881578947368421,1.9078947368421053
2202,Federico Ravaglia,ITA,GK,Bologna,Serie A,23,1999,5.9,0,0,0,0,0,0,0,0.0,0,0,0,0,0,0,2,0,0,2023-2024,0.0,0.0
2203,David Raya,ESP,GK,Arsenal,Premier League,27,1995,32.0,1,1,1,0,0,1,1,100.0,0,0,0,0,0,1,8,5,0,2023-2024,0.0,0.03125
2204,Tim Ream,USA,DF,Fulham,Premier League,35,1987,16.7,20,9,13,5,2,9,18,50.0,9,23,15,8,25,45,61,2,0,2023-2024,1.4970059880239521,1.1976047904191618
2205,Abderrahman Rebbach,ALG,"FW,MF",Alavés,La Liga,24,1998,8.0,9,5,4,2,3,5,15,33.3,10,10,1,9,3,12,7,0,0,2023-2024,0.375,1.125
2206,Nathan Redmond,ENG,"FW,MF",Burnley,Premier League,29,1994,1.6,2,1,0,0,2,1,4,25.0,3,1,0,1,0,2,3,0,0,2023-2024,0.0,1.25
2207,Harrison Reed,ENG,MF,Fulham,Premier League,28,1995,14.7,29,18,9,17,3,13,31,41.9,18,19,9,10,11,40,24,0,0,2023-2024,0.7482993197278912,1.9727891156462587
2208,Sergio Reguilón,ESP,DF,Manchester Utd,Premier League,26,1996,4.6,13,8,6,2,5,8,17,47.1,9,10,0,10,5,18,7,0,0,2023-2024,1.0869565217391306,2.8260869565217392
2209,Sergio Reguilón,ESP,DF,Brentford,Premier League,26,1996,12.4,45,20,26,18,1,24,40,60.0,16,23,6,17,16,61,41,1,0,2023-2024,1.2903225806451613,3.629032258064516
2210,Bobby Reid,JAM,FW,Fulham,Premier League,30,1993,15.8,22,14,5,15,2,4,16,25.0,12,24,2,22,5,27,14,0,0,2023-2024,0.3164556962025316,1.3924050632911391
2211,Tijjani Reijnders,NED,MF,Milan,Serie A,25,1998,31.3,46,25,10,31,5,21,43,48.8,22,26,8,18,18,64,26,0,0,2023-2024,0.5750798722044729,1.4696485623003195
2212,Pepe Reina,ESP,GK,Villarreal,La Liga,40,1982,2.0,0,0,0,0,0,0,0,0.0,0,0,0,0,0,0,1,0,0,2023-2024,0.0,0.0
2213,Reinier,BRA,"MF,FW",Frosinone,Serie A,21,2002,11.8,21,10,6,12,3,5,17,29.4,12,24,4,20,10,31,5,0,0,2023-2024,0.847457627118644,1.7796610169491525
2214,Rocco Reitz,GER,MF,Gladbach,Bundesliga,21,2002,23.7,61,36,28,29,4,28,55,50.9,27,61,20,41,44,105,31,1,0,2023-2024,1.8565400843881856,2.5738396624472575
2215,Álex Remiro,ESP,GK,Real Sociedad,La Liga,28,1995,36.4,0,0,0,0,0,0,0,0.0,0,0,0,0,0,0,24,2,0,2023-2024,0.0,0.0
2216,Guillaume Restes,FRA,GK,Toulouse,Ligue 1,18,2005,34.0,0,0,0,0,0,0,3,0.0,3,0,0,0,0,0,19,1,0,2023-2024,0.0,0.0
2217,Mateo Retegui,ITA,FW,Genoa,Serie A,24,1999,24.6,17,9,7,8,2,6,20,30.0,14,18,2,16,0,17,30,0,0,2023-2024,0.0,0.6910569105691057
2218,Marco Reus,GER,"MF,FW",Dortmund,Bundesliga,34,1989,17.8,37,25,20,14,3,12,27,44.4,15,17,2,15,5,42,18,0,0,2023-2024,0.28089887640449435,2.0786516853932584
2219,Elvis Rexhbeçaj,GER,MF,Augsburg,Bundesliga,25,1997,22.1,30,19,14,13,3,18,36,50.0,18,32,7,25,20,50,20,0,0,2023-2024,0.9049773755656108,1.3574660633484161
2220,Gio Reyna,USA,"FW,MF",Nott'ham Forest,Premier League,20,2002,2.6,7,3,4,0,3,3,6,50.0,3,3,0,3,2,9,0,0,0,2023-2024,0.7692307692307692,2.692307692307692
2221,Gio Reyna,USA,"MF,FW",Dortmund,Bundesliga,20,2002,3.1,9,6,3,4,2,2,5,40.0,3,5,1,4,2,11,5,0,0,2023-2024,0.6451612903225806,2.903225806451613
2222,Chadi Riad,MAR,DF,Betis,La Liga,20,2003,24.0,35,24,17,18,0,17,27,63.0,10,23,14,9,23,58,108,0,0,2023-2024,0.9583333333333334,1.4583333333333333
2223,Alexsandro Ribeiro,BRA,DF,Lille,Ligue 1,23,1999,24.7,32,22,24,8,0,16,31,51.6,15,25,15,10,35,67,116,5,0,2023-2024,1.417004048582996,1.2955465587044535
2224,Rodrigo Ribeiro,POR,"MF,FW",Nott'ham Forest,Premier League,18,2005,0.2,0,0,0,0,0,0,1,0.0,1,1,0,1,1,1,0,0,0,2023-2024,5.0,0.0
2225,Samuele Ricci,ITA,MF,Torino,Serie A,21,2001,26.6,33,18,17,12,4,15,23,65.2,8,21,3,18,27,60,25,0,0,2023-2024,1.0150375939849623,1.2406015037593985
Rk,Player,Nation,Pos,Squad,Comp,0,0,90.0,0,0,3,3,3,Tkl,0,0.0,0,0,0,0,0,0,0,0,0,2023-2024,0.0,0.0
2226,Declan Rice,ENG,MF,Arsenal,Premier League,24,1999,35.8,83,51,37,38,8,32,57,56.1,25,37,11,26,44,127,52,0,0,2023-2024,1.229050279329609,2.3184357541899443
2227,Chris Richards,USA,"DF,MF",Crystal Palace,Premier League,23,2000,23.3,46,28,21,22,3,20,30,66.7,10,32,12,20,27,73,109,0,0,2023-2024,1.1587982832618025,1.9742489270386265
2228,Amir Richardson,MAR,MF,Reims,Ligue 1,21,2002,15.0,33,23,12,18,3,10,22,45.5,12,26,5,21,15,48,30,0,0,2023-2024,1.0,2.2
2229,Richarlison,BRA,FW,Tottenham,Premier League,26,1997,16.6,16,11,4,8,4,2,10,20.0,8,32,6,26,8,24,23,0,0,2023-2024,0.48192771084337344,0.9638554216867469
2230,Marco Richter,GER,"MF,FW",Mainz 05,Bundesliga,25,1997,8.0,10,4,5,3,2,4,11,36.4,7,9,0,9,2,12,1,0,0,2023-2024,0.25,1.25
2231,Diego Rico,ESP,DF,Getafe,La Liga,30,1993,28.2,64,48,32,23,9,41,76,53.9,35,25,8,17,41,105,76,0,0,2023-2024,1.4539007092198581,2.269503546099291
2232,Clemens Riedel,GER,DF,Darmstadt 98,Bundesliga,20,2003,8.4,22,13,16,5,1,15,24,62.5,9,11,3,8,11,33,26,0,0,2023-2024,1.3095238095238095,2.619047619047619
2233,Fabian Rieder,SUI,MF,Rennes,Ligue 1,21,2002,4.1,13,7,2,9,2,6,11,54.5,5,3,1,2,5,18,2,0,0,2023-2024,1.2195121951219514,3.1707317073170733
2234,Jaïro Riedewald,NED,"MF,FW",Crystal Palace,Premier League,26,1996,2.6,9,3,2,4,3,3,6,50.0,3,0,0,0,2,11,2,0,0,2023-2024,0.7692307692307692,3.4615384615384612
2235,Manuel Riemann,GER,GK,Bochum,Bundesliga,34,1988,33.0,2,1,2,0,0,2,4,50.0,2,0,0,0,1,3,25,1,0,2023-2024,0.030303030303030304,0.06060606060606061
2236,Luis Rioja,ESP,"FW,MF",Alavés,La Liga,29,1993,27.8,27,19,10,12,5,14,43,32.6,29,28,1,27,16,43,28,0,0,2023-2024,0.5755395683453237,0.9712230215827338
2237,Rémy Riou,FRA,GK,Lyon,Ligue 1,35,1987,3.0,0,0,0,0,0,0,1,0.0,1,0,0,0,0,0,1,1,0,2023-2024,0.0,0.0
2238,Rodrigo Riquelme,ESP,"DF,MF",Atlético Madrid,La Liga,23,2000,17.0,30,19,18,4,8,18,46,39.1,28,19,0,19,9,39,20,0,0,2023-2024,0.5294117647058824,1.7647058823529411
2239,Alberto Risco,ESP,MF,Getafe,La Liga,17,2005,1.5,2,2,1,1,0,0,4,0.0,4,0,0,0,0,2,1,0,0,2023-2024,0.0,1.3333333333333333
2240,Mihailo Ristić,SRB,"DF,MF",Celta Vigo,La Liga,27,1995,9.0,15,9,9,6,0,9,12,75.0,3,9,2,7,10,25,23,0,0,2023-2024,1.1111111111111112,1.6666666666666667
2241,Matt Ritchie,SCO,"FW,MF",Newcastle Utd,Premier League,33,1989,1.4,5,3,2,2,1,2,4,50.0,2,3,2,1,1,6,5,0,0,2023-2024,0.7142857142857143,3.5714285714285716
2242,Gorka Rivera Alonso,ESP,DF,Getafe,La Liga,18,2004,0.0,0,0,0,0,0,0,0,0.0,0,0,0,0,0,0,0,0,0,2023-2024,,
2243,Sergi Roberto,ESP,"MF,DF",Barcelona,La Liga,31,1992,9.6,15,10,4,10,1,3,11,27.3,8,7,2,5,8,23,7,1,0,2023-2024,0.8333333333333334,1.5625
2244,Lucas Robertone,ARG,MF,Almería,La Liga,26,1997,26.5,61,33,28,23,10,25,50,50.0,25,43,9,34,51,112,43,0,0,2023-2024,1.9245283018867925,2.30188679245283
2245,Connor Roberts,WAL,DF,Burnley,Premier League,27,1995,9.1,12,5,6,4,2,8,17,47.1,9,8,6,2,4,16,25,2,0,2023-2024,0.43956043956043955,1.3186813186813187
2246,Andrew Robertson,SCO,DF,Liverpool,Premier League,29,1994,18.8,35,24,21,11,3,26,43,60.5,17,20,6,14,13,48,40,0,0,2023-2024,0.6914893617021276,1.8617021276595744
2247,Antonee Robinson,USA,DF,Fulham,Premier League,25,1997,36.3,93,58,60,26,7,52,110,47.3,58,56,8,48,80,173,117,3,0,2023-2024,2.203856749311295,2.5619834710743805
2248,Jack Robinson,ENG,DF,Sheffield Utd,Premier League,29,1993,32.1,43,28,29,14,0,25,39,64.1,14,49,33,16,33,76,132,2,0,2023-2024,1.02803738317757,1.3395638629283488
2249,Marc Roca,ESP,MF,Betis,La Liga,26,1996,22.0,52,36,17,29,6,30,53,56.6,23,29,6,23,17,69,23,1,0,2023-2024,0.7727272727272727,2.3636363636363638
2250,Sebastian Rode,GER,MF,Eint Frankfurt,Bundesliga,32,1990,0.7,6,4,0,5,1,4,6,66.7,2,0,0,0,1,7,1,0,0,2023-2024,1.4285714285714286,8.571428571428571
Rk,Player,Nation,Pos,Squad,Comp,0,0,90.0,0,0,3,3,3,Tkl,0,0.0,0,0,0,0,0,0,0,0,0,2023-2024,0.0,0.0
2251,Sergio Rodelas,ESP,"FW,DF",Granada,La Liga,18,2004,1.4,3,2,1,0,2,0,3,0.0,3,0,0,0,0,3,0,0,0,2023-2024,0.0,2.142857142857143
2252,Rodri,ESP,MF,Manchester City,Premier League,27,1996,32.6,70,43,25,33,12,29,60,48.3,31,32,8,24,26,96,41,4,0,2023-2024,0.7975460122699386,2.147239263803681
2253,Rodri,ESP,"FW,MF",Betis,La Liga,23,2000,11.7,17,10,6,7,4,8,21,38.1,13,11,0,11,8,25,2,0,0,2023-2024,0.6837606837606838,1.4529914529914532
2254,Óscar Rodríguez Arnaiz,ESP,"MF,FW",Getafe,La Liga,25,1998,10.7,24,13,2,15,7,9,15,60.0,6,12,1,11,5,29,5,0,0,2023-2024,0.4672897196261683,2.2429906542056077
2255,Damián Rodríguez,ESP,MF,Celta Vigo,La Liga,20,2003,2.9,6,3,1,3,2,1,3,33.3,2,4,2,2,1,7,2,0,0,2023-2024,0.3448275862068966,2.0689655172413794
2256,Dani Rodríguez,ESP,MF,Mallorca,La Liga,35,1988,29.1,47,24,21,20,6,21,45,46.7,24,34,5,29,15,62,21,0,0,2023-2024,0.5154639175257731,1.6151202749140892
2257,Guido Rodríguez,ARG,MF,Betis,La Liga,29,1994,20.5,53,30,21,24,8,34,55,61.8,21,27,6,21,29,82,44,0,0,2023-2024,1.4146341463414633,2.5853658536585367
2258,Jay Rodriguez,ENG,FW,Burnley,Premier League,34,1989,9.1,14,9,7,4,3,7,13,53.8,6,11,1,10,1,15,8,0,0,2023-2024,0.10989010989010989,1.5384615384615385
2259,Kirian Rodríguez,ESP,MF,Las Palmas,La Liga,27,1996,35.7,52,32,22,25,5,24,67,35.8,43,39,3,36,28,80,23,1,0,2023-2024,0.7843137254901961,1.4565826330532212
2260,Miguel Rodríguez,ESP,MF,Celta Vigo,La Liga,20,2003,3.3,6,3,3,1,2,3,9,33.3,6,8,0,8,4,10,0,0,0,2023-2024,1.2121212121212122,1.8181818181818183
2261,Ricardo Rodríguez,SUI,DF,Torino,Serie A,30,1992,30.8,45,26,21,22,2,28,45,62.2,17,22,9,13,24,69,64,2,0,2023-2024,0.7792207792207793,1.461038961038961
2262,Rodrygo,BRA,FW,Real Madrid,La Liga,22,2001,26.4,16,15,2,9,5,5,19,26.3,14,14,0,14,8,24,6,0,0,2023-2024,0.30303030303030304,0.6060606060606061
2263,Mads Roerslev,DEN,DF,Brentford,Premier League,24,1999,22.1,48,31,34,9,5,27,54,50.0,27,15,3,12,19,67,71,0,0,2023-2024,0.8597285067873303,2.171945701357466
2264,Rogério,BRA,DF,Wolfsburg,Bundesliga,25,1998,10.1,14,6,7,5,2,10,14,71.4,4,16,5,11,5,19,23,1,0,2023-2024,0.49504950495049505,1.3861386138613863
2265,Morgan Rogers,ENG,"MF,FW",Aston Villa,Premier League,21,2002,7.1,8,1,3,2,3,2,11,18.2,9,11,0,11,3,11,11,0,0,2023-2024,0.4225352112676057,1.1267605633802817
2266,Merlin Röhl,GER,"MF,FW",Freiburg,Bundesliga,21,2002,16.4,21,13,10,9,2,8,21,38.1,13,27,3,24,9,30,22,0,0,2023-2024,0.5487804878048781,1.2804878048780488
2267,Alessio Romagnoli,ITA,DF,Lazio,Serie A,28,1995,26.8,25,18,14,11,0,16,24,66.7,8,29,17,12,29,54,115,0,0,2023-2024,1.0820895522388059,0.9328358208955224
2268,Simone Romagnoli,ITA,DF,Frosinone,Serie A,33,1990,30.2,35,15,23,11,1,15,20,75.0,5,51,36,15,29,64,147,0,0,2023-2024,0.9602649006622517,1.1589403973509933
2269,Carlos Romero,ESP,DF,Villarreal,La Liga,21,2001,2.9,11,5,8,1,2,7,12,58.3,5,3,0,3,1,12,11,0,0,2023-2024,0.3448275862068966,3.793103448275862
2270,Cristian Romero,ARG,DF,Tottenham,Premier League,25,1998,31.0,66,40,35,25,6,32,44,72.7,12,46,22,24,44,110,106,1,0,2023-2024,1.4193548387096775,2.129032258064516
2271,Isaac Romero,ESP,FW,Sevilla,La Liga,23,2000,11.5,6,3,2,2,2,5,9,55.6,4,12,0,12,0,6,11,0,0,2023-2024,0.0,0.5217391304347826
2272,Luka Romero,ARG,"FW,MF",Milan,Serie A,18,2004,1.0,0,0,0,0,0,0,3,0.0,3,2,0,2,0,0,0,0,0,2023-2024,0.0,0.0
2273,Luka Romero,ARG,FW,Almería,La Liga,18,2004,4.9,5,1,2,3,0,2,4,50.0,2,12,1,11,1,6,2,1,0,2023-2024,0.2040816326530612,1.0204081632653061
2274,Oriol Romeu,ESP,MF,Barcelona,La Liga,31,1991,10.4,34,20,17,14,3,13,24,54.2,11,12,2,10,10,44,18,0,0,2023-2024,0.9615384615384615,3.269230769230769
2275,Valentin Rongier,FRA,MF,Marseille,Ligue 1,28,1994,9.5,23,12,9,12,2,14,26,53.8,12,16,4,12,15,38,18,0,0,2023-2024,1.5789473684210527,2.4210526315789473
Rk,Player,Nation,Pos,Squad,Comp,0,0,90.0,0,0,3,3,3,Tkl,0,0.0,0,0,0,0,0,0,0,0,0,2023-2024,0.0,0.0
2276,Frank Ronstadt,GER,"DF,MF",Darmstadt 98,Bundesliga,26,1997,0.8,1,0,0,1,0,0,1,0.0,1,1,0,1,1,2,3,0,0,2023-2024,1.25,1.25
2277,Marten de Roon,NED,"MF,DF",Atalanta,Serie A,32,1991,28.9,80,43,36,32,12,35,82,42.7,47,36,10,26,40,120,54,0,0,2023-2024,1.384083044982699,2.768166089965398
2278,Unai Ropero,ESP,MF,Alavés,La Liga,21,2001,0.1,0,0,0,0,0,0,0,0.0,0,0,0,0,0,0,0,0,0,2023-2024,0.0,0.0
2279,Vitor Roque,BRA,FW,Barcelona,La Liga,18,2005,3.6,3,2,2,0,1,0,2,0.0,2,3,0,3,0,3,5,0,0,2023-2024,0.0,0.8333333333333333
2280,Pablo Rosario,NED,"MF,DF",Nice,Ligue 1,26,1997,22.3,36,25,15,16,5,23,34,67.6,11,27,13,14,29,65,39,0,0,2023-2024,1.3004484304932735,1.6143497757847534
2281,Valentin Rosier,FRA,"DF,MF",Nice,Ligue 1,26,1996,0.6,1,0,1,0,0,0,0,0.0,0,1,0,1,2,3,5,0,0,2023-2024,3.3333333333333335,1.6666666666666667
2282,Francesco Rossi,ITA,GK,Atalanta,Serie A,32,1991,0.1,0,0,0,0,0,0,0,0.0,0,0,0,0,0,0,0,0,0,2023-2024,0.0,0.0
2283,Joe Rothwell,ENG,MF,Bournemouth,Premier League,28,1995,4.3,7,2,4,2,1,2,8,25.0,6,4,2,2,3,10,2,0,0,2023-2024,0.6976744186046512,1.627906976744186
2284,Anthony Rouault,FRA,DF,Stuttgart,Bundesliga,22,2001,11.2,21,12,14,5,2,13,21,61.9,8,14,8,6,8,29,28,0,0,2023-2024,0.7142857142857143,1.8750000000000002
2285,Jérôme Roussillon,FRA,DF,Union Berlin,Bundesliga,30,1993,8.4,16,9,6,7,3,8,12,66.7,4,13,4,9,5,21,26,0,0,2023-2024,0.5952380952380952,1.9047619047619047
2286,Nicolò Rovella,ITA,MF,Lazio,Serie A,21,2001,14.6,46,28,25,17,4,16,36,44.4,20,27,6,21,23,69,29,0,0,2023-2024,1.5753424657534247,3.1506849315068495
2287,Amir Rrahmani,KVX,DF,Napoli,Serie A,29,1994,28.9,33,27,17,14,2,16,32,50.0,16,24,10,14,20,53,90,0,0,2023-2024,0.6920415224913495,1.1418685121107266
2288,Ruan,BRA,DF,Sassuolo,Serie A,24,1999,16.8,25,15,11,10,4,10,18,55.6,8,18,15,3,24,49,68,2,0,2023-2024,1.4285714285714286,1.4880952380952381
2289,Pelly Ruddock Mpanzu,COD,MF,Luton Town,Premier League,30,1993,12.2,13,5,6,6,1,5,9,55.6,4,15,7,8,9,22,16,3,0,2023-2024,0.7377049180327869,1.0655737704918034
2290,Antonio Rüdiger,GER,DF,Real Madrid,La Liga,30,1993,30.1,26,15,18,4,4,16,20,80.0,4,27,20,7,11,37,89,0,0,2023-2024,0.3654485049833887,0.8637873754152824
2291,Fabian Rüdlin,GER,MF,Freiburg,Bundesliga,26,1997,0.1,1,0,0,0,1,0,0,0.0,0,0,0,0,0,1,0,0,0,2023-2024,0.0,10.0
2292,Javier Rueda Garcia,ESP,"MF,DF",Celta Vigo,La Liga,21,2002,0.2,0,0,0,0,0,0,0,0.0,0,0,0,0,0,0,0,0,0,2023-2024,0.0,0.0
2293,Daniele Rugani,ITA,DF,Juventus,Serie A,29,1994,13.2,11,9,7,3,1,4,5,80.0,1,11,4,7,9,20,42,0,0,2023-2024,0.6818181818181819,0.8333333333333334
2294,Matteo Ruggeri,ITA,DF,Atalanta,Serie A,21,2002,27.2,29,15,14,7,8,16,30,53.3,14,46,4,42,23,52,44,0,0,2023-2024,0.8455882352941176,1.0661764705882353
2295,Mário Rui,POR,DF,Napoli,Serie A,32,1991,13.4,27,15,17,5,5,14,21,66.7,7,17,2,15,15,42,19,0,0,2023-2024,1.1194029850746268,2.014925373134328
2296,Aitor Ruibal,ESP,"DF,FW",Betis,La Liga,27,1996,11.3,46,27,28,13,5,32,59,54.2,27,12,1,11,14,60,33,1,0,2023-2024,1.238938053097345,4.070796460176991
2297,Fabián Ruiz Peña,ESP,MF,Paris S-G,Ligue 1,27,1996,13.3,34,23,17,14,3,23,42,54.8,19,8,2,6,11,45,21,2,0,2023-2024,0.8270676691729323,2.556390977443609
2298,Sergio Ruiz,ESP,MF,Granada,La Liga,28,1994,27.7,83,46,43,36,4,38,84,45.2,46,24,6,18,28,111,43,1,0,2023-2024,1.0108303249097472,2.996389891696751
2299,Julian Ryerson,NOR,DF,Dortmund,Bundesliga,25,1997,19.6,41,23,26,11,4,27,47,57.4,20,31,7,24,10,51,35,3,0,2023-2024,0.5102040816326531,2.0918367346938775
2300,Frederik Rønnow,DEN,GK,Union Berlin,Bundesliga,30,1992,33.0,1,1,1,0,0,0,0,0.0,0,0,0,0,1,2,20,2,0,2023-2024,0.030303030303030304,0.030303030303030304
Rk,Player,Nation,Pos,Squad,Comp,0,0,90.0,0,0,3,3,3,Tkl,0,0.0,0,0,0,0,0,0,0,0,0,2023-2024,0.0,0.0
2301,José Sá,POR,GK,Wolves,Premier League,30,1993,33.7,0,0,0,0,0,0,1,0.0,1,3,0,3,0,0,21,5,0,2023-2024,0.0,0.0
2302,Youssouf Sabaly,SEN,DF,Betis,La Liga,30,1993,11.6,16,11,12,3,1,8,12,66.7,4,6,3,3,11,27,27,0,0,2023-2024,0.9482758620689655,1.3793103448275863
2303,Emmanuel Sabbi,USA,"FW,MF",Le Havre,Ligue 1,25,1997,17.6,38,19,15,15,8,16,39,41.0,23,26,2,24,19,57,7,0,0,2023-2024,1.0795454545454544,2.1590909090909087
2304,Stefano Sabelli,ITA,DF,Genoa,Serie A,30,1993,27.0,50,24,28,19,3,15,46,32.6,31,27,6,21,23,73,35,0,0,2023-2024,0.8518518518518519,1.8518518518518519
2305,Marcel Sabitzer,AUT,MF,Dortmund,Bundesliga,29,1994,21.8,39,24,18,20,1,23,42,54.8,19,31,12,19,12,51,34,0,0,2023-2024,0.5504587155963303,1.7889908256880733
2306,Falaye Sacko,MLI,DF,Montpellier,Ligue 1,28,1995,15.4,28,16,13,10,5,21,32,65.6,11,19,7,12,24,52,37,0,0,2023-2024,1.5584415584415585,1.8181818181818181
2307,Dominic Sadi,ENG,FW,Bournemouth,Premier League,19,2003,0.0,0,0,0,0,0,0,0,0.0,0,0,0,0,0,0,0,0,0,2023-2024,,
2308,Umar Sadiq,NGA,FW,Real Sociedad,La Liga,26,1997,12.0,15,10,2,8,5,4,8,50.0,4,9,0,9,0,15,10,0,0,2023-2024,0.0,1.25
2309,Alexis Saelemaekers,BEL,"FW,MF",Bologna,Serie A,24,1999,21.0,32,22,13,14,5,12,27,44.4,15,13,1,12,13,45,10,1,0,2023-2024,0.6190476190476191,1.5238095238095237
2310,Pablo Saenz,ESP,MF,Granada,La Liga,22,2001,0.2,3,3,2,0,1,1,3,33.3,2,0,0,0,0,3,0,0,0,2023-2024,0.0,15.0
2311,Modibo Sagnan,MLI,DF,Montpellier,Ligue 1,24,1999,11.7,34,22,23,9,2,15,25,60.0,10,13,9,4,15,49,67,0,0,2023-2024,1.2820512820512822,2.9059829059829063
2312,Wesley Saïd,FRA,"FW,MF",Lens,Ligue 1,28,1995,11.3,8,4,1,2,5,2,9,22.2,7,4,0,4,4,12,3,0,0,2023-2024,0.35398230088495575,0.7079646017699115
2313,Théo Sainte-Luce,FRA,DF,Montpellier,Ligue 1,24,1998,3.8,17,7,10,6,1,11,19,57.9,8,9,4,5,3,20,15,0,0,2023-2024,0.7894736842105263,4.473684210526316
2314,Bukayo Saka,ENG,FW,Arsenal,Premier League,21,2001,32.4,66,35,22,24,20,26,59,44.1,33,43,2,41,15,81,24,1,0,2023-2024,0.46296296296296297,2.037037037037037
2315,Mamadou Sakho,FRA,DF,Montpellier,Ligue 1,33,1990,0.1,1,1,1,0,0,1,1,100.0,0,0,0,0,0,1,1,0,0,2023-2024,0.0,10.0
2316,Ibrahim Salah,MAR,"FW,MF",Rennes,Ligue 1,21,2001,5.8,15,7,5,6,4,11,18,61.1,7,4,0,4,10,25,5,0,0,2023-2024,1.7241379310344829,2.586206896551724
2317,Mohamed Salah,EGY,FW,Liverpool,Premier League,31,1992,28.2,17,11,1,8,8,6,21,28.6,15,19,1,18,2,19,1,0,0,2023-2024,0.07092198581560284,0.6028368794326241
2318,Amine Salama,FRA,FW,Reims,Ligue 1,23,2000,3.5,0,0,0,0,0,0,0,0.0,0,1,0,1,1,1,1,0,0,2023-2024,0.2857142857142857,0.0
2319,Kike Salas,ESP,DF,Sevilla,La Liga,21,2002,17.8,41,23,26,12,3,22,36,61.1,14,25,14,11,26,67,91,1,0,2023-2024,1.4606741573033708,2.303370786516854
2320,William Saliba,FRA,DF,Arsenal,Premier League,22,2001,38.0,41,26,28,12,1,20,27,74.1,7,32,17,15,29,70,81,3,0,2023-2024,0.7631578947368421,1.0789473684210527
2321,Mohammed Salisu,GHA,DF,Monaco,Ligue 1,24,1999,11.5,27,12,11,13,3,17,26,65.4,9,21,12,9,22,49,44,0,0,2023-2024,1.9130434782608696,2.347826086956522
2322,Roland Sallai,HUN,"MF,FW",Freiburg,Bundesliga,26,1997,20.4,17,10,5,5,7,8,20,40.0,12,21,1,20,6,23,23,0,0,2023-2024,0.29411764705882354,0.8333333333333334
2323,Yoann Salmier,GUF,DF,Le Havre,Ligue 1,30,1992,17.4,22,10,13,6,3,13,20,65.0,7,21,15,6,21,43,57,0,0,2023-2024,1.2068965517241381,1.264367816091954
2324,Salvi,ESP,MF,Rayo Vallecano,La Liga,32,1991,0.3,0,0,0,0,0,0,4,0.0,4,0,0,0,1,1,0,0,0,2023-2024,3.3333333333333335,0.0
2325,Lazar Samardzic,SRB,MF,Udinese,Serie A,21,2002,26.4,40,19,18,18,4,16,39,41.0,23,26,6,20,10,50,25,0,0,2023-2024,0.3787878787878788,1.5151515151515151
Rk,Player,Nation,Pos,Squad,Comp,0,0,90.0,0,0,3,3,3,Tkl,0,0.0,0,0,0,0,0,0,0,0,0,2023-2024,0.0,0.0
2326,Diadie Samassékou,MLI,MF,Cádiz,La Liga,27,1996,1.0,5,3,2,2,1,5,6,83.3,1,0,0,0,3,8,1,0,0,2023-2024,3.0,5.0
2327,Diadie Samassékou,MLI,MF,Hoffenheim,Bundesliga,27,1996,0.0,0,0,0,0,0,0,0,0.0,0,0,0,0,1,1,0,0,0,2023-2024,inf,
2328,Mama Samba Baldé,GNB,"FW,MF",Lyon,Ligue 1,27,1995,6.1,8,5,1,2,5,3,9,33.3,6,0,0,0,3,11,1,1,0,2023-2024,0.49180327868852464,1.3114754098360657
2329,Brice Samba,FRA,GK,Lens,Ligue 1,29,1994,33.0,1,1,1,0,0,1,1,100.0,0,0,0,0,0,1,10,3,0,2023-2024,0.0,0.030303030303030304
2330,Albert Sambi Lokonga,BEL,MF,Luton Town,Premier League,23,1999,14.5,29,18,14,12,3,17,24,70.8,7,23,13,10,11,40,14,0,0,2023-2024,0.7586206896551724,2.0
2331,Junior Sambia,FRA,"DF,MF",Salernitana,Serie A,26,1996,11.5,12,5,8,1,3,6,11,54.5,5,15,7,8,11,23,28,0,0,2023-2024,0.9565217391304348,1.0434782608695652
2332,Fede San Emeterio,ESP,MF,Cádiz,La Liga,26,1997,1.7,3,2,2,1,0,1,4,25.0,3,3,2,1,2,5,1,0,0,2023-2024,1.1764705882352942,1.7647058823529411
2333,Antonio Sanabria,PAR,"FW,MF",Torino,Serie A,27,1996,23.7,18,15,5,9,4,4,9,44.4,5,7,1,6,6,24,12,0,0,2023-2024,0.25316455696202533,0.759493670886076
2334,Oihan Sancet,ESP,MF,Athletic Club,La Liga,23,2000,21.9,19,11,3,10,6,8,21,38.1,13,5,1,4,10,29,5,0,0,2023-2024,0.4566210045662101,0.8675799086757991
2335,Renato Sanches,POR,MF,Roma,Serie A,25,1997,1.6,2,1,1,1,0,2,3,66.7,1,2,0,2,0,2,1,0,0,2023-2024,0.0,1.25
2336,Ricard Sánchez,ESP,DF,Granada,La Liga,23,2000,25.5,29,18,15,8,6,12,24,50.0,12,32,4,28,13,42,64,0,0,2023-2024,0.5098039215686274,1.1372549019607843
2337,Alexis Sánchez,CHI,"FW,MF",Inter,Serie A,34,1988,8.5,7,6,0,5,2,1,4,25.0,3,4,1,3,1,8,3,0,0,2023-2024,0.11764705882352941,0.8235294117647058
2338,Antonio Sánchez,ESP,MF,Mallorca,La Liga,26,1997,16.1,25,11,13,10,2,11,32,34.4,21,24,5,19,13,38,13,0,0,2023-2024,0.8074534161490683,1.5527950310559004
2339,Davinson Sánchez,COL,DF,Tottenham,Premier League,27,1996,0.9,0,0,0,0,0,0,0,0.0,0,3,2,1,1,1,2,0,0,2023-2024,1.1111111111111112,0.0
2340,Juanlu Sánchez,ESP,DF,Sevilla,La Liga,19,2003,13.1,56,35,34,18,4,34,58,58.6,24,24,7,17,12,68,36,0,0,2023-2024,0.916030534351145,4.2748091603053435
2341,Manu Sánchez,ESP,"DF,MF",Celta Vigo,La Liga,22,2000,19.7,54,28,21,25,8,31,55,56.4,24,23,3,20,19,73,65,0,0,2023-2024,0.9644670050761421,2.7411167512690358
2342,Robert Sánchez,ESP,GK,Chelsea,Premier League,25,1997,15.9,0,0,0,0,0,0,0,0.0,0,0,0,0,0,0,11,3,0,2023-2024,0.0,0.0
2343,Jadon Sancho,ENG,"FW,MF",Manchester Utd,Premier League,23,2000,0.9,1,0,1,0,0,1,3,33.3,2,1,0,1,1,2,0,0,0,2023-2024,1.1111111111111112,1.1111111111111112
2344,Jadon Sancho,ENG,"FW,MF",Dortmund,Bundesliga,23,2000,10.5,5,4,1,3,1,0,4,0.0,4,11,0,11,4,9,6,0,0,2023-2024,0.38095238095238093,0.47619047619047616
2345,Alex Sandro,BRA,DF,Juventus,Serie A,32,1991,8.0,13,7,7,6,0,4,5,80.0,1,13,7,6,15,28,23,0,0,2023-2024,1.875,1.625
2346,Ibou Sané,SEN,"MF,FW",Metz,Ligue 1,18,2005,1.4,6,4,2,1,3,2,2,100.0,0,3,0,3,1,7,2,0,0,2023-2024,0.7142857142857143,4.285714285714286
2347,Leroy Sané,GER,FW,Bayern Munich,Bundesliga,27,1996,23.7,15,8,6,6,3,4,19,21.1,15,12,0,12,7,22,3,0,0,2023-2024,0.29535864978902954,0.6329113924050633
2348,Sadibou Sané,SEN,DF,Metz,Ligue 1,19,2004,9.4,19,12,16,2,1,6,7,85.7,1,14,9,5,8,27,64,0,0,2023-2024,0.851063829787234,2.021276595744681
2349,Arouna Sangante,SEN,DF,Le Havre,Ligue 1,21,2002,29.9,53,33,27,23,3,24,40,60.0,16,35,18,17,66,119,93,2,0,2023-2024,2.207357859531773,1.7725752508361206
2350,Ibrahim Sangaré,CIV,MF,Nott'ham Forest,Premier League,25,1997,11.5,42,23,25,13,4,12,29,41.4,17,24,7,17,16,58,21,0,0,2023-2024,1.391304347826087,3.652173913043478
Rk,Player,Nation,Pos,Squad,Comp,0,0,90.0,0,0,3,3,3,Tkl,0,0.0,0,0,0,0,0,0,0,0,0,2023-2024,0.0,0.0
2351,Morgan Sanson,FRA,MF,Nice,Ligue 1,28,1994,21.8,26,19,12,7,7,12,31,38.7,19,34,5,29,20,46,16,0,0,2023-2024,0.9174311926605504,1.1926605504587156
2352,Nicola Sansone,ITA,"FW,MF",Lecce,Serie A,31,1991,8.5,11,6,6,2,3,5,16,31.3,11,7,1,6,4,15,5,2,0,2023-2024,0.47058823529411764,1.2941176470588236
2353,Baptiste Santamaria,FRA,MF,Rennes,Ligue 1,28,1995,21.4,52,33,21,25,6,29,46,63.0,17,15,6,9,34,86,33,1,0,2023-2024,1.5887850467289721,2.429906542056075
2354,Jesús Santiago,ESP,MF,Getafe,La Liga,19,2004,7.3,17,8,8,5,4,4,7,57.1,3,3,0,3,0,17,8,0,0,2023-2024,0.0,2.328767123287671
2355,Andrey Santos,BRA,MF,Nott'ham Forest,Premier League,19,2004,0.1,0,0,0,0,0,0,0,0.0,0,1,0,1,0,0,0,0,0,2023-2024,0.0,0.0
2356,Andrey Santos,BRA,MF,Strasbourg,Ligue 1,19,2004,9.2,29,18,15,13,1,17,26,65.4,9,8,0,8,10,39,11,1,0,2023-2024,1.0869565217391306,3.1521739130434785
2357,Tiago Santos,POR,DF,Lille,Ligue 1,21,2002,26.3,63,42,31,19,13,30,52,57.7,22,24,5,19,15,78,37,0,0,2023-2024,0.5703422053231939,2.3954372623574143
2358,Paco Sanz,ESP,DF,Almería,La Liga,18,2004,0.3,0,0,0,0,0,0,1,0.0,1,0,0,0,0,0,4,0,0,2023-2024,0.0,0.0
2359,Riccardo Saponara,ITA,"FW,MF",Hellas Verona,Serie A,31,1991,3.8,3,1,2,0,1,1,7,14.3,6,4,0,4,0,3,2,0,0,2023-2024,0.0,0.7894736842105263
2360,Pablo Sarabia,ESP,"MF,FW",Wolves,Premier League,31,1992,19.4,20,13,8,8,4,12,36,33.3,24,17,1,16,10,30,9,0,0,2023-2024,0.5154639175257733,1.0309278350515465
2361,Amin Sarr,SWE,"FW,MF",Lyon,Ligue 1,22,2001,1.1,1,0,0,1,0,0,0,0.0,0,1,0,1,0,1,1,0,0,2023-2024,0.0,0.9090909090909091
2362,Amin Sarr,SWE,"FW,MF",Wolfsburg,Bundesliga,22,2001,4.3,3,2,1,2,0,1,2,50.0,1,6,1,5,2,5,1,0,0,2023-2024,0.46511627906976744,0.6976744186046512
2363,Bouna Sarr,SEN,DF,Bayern Munich,Bundesliga,31,1992,1.2,2,0,1,1,0,2,2,100.0,0,3,0,3,0,2,1,0,0,2023-2024,0.0,1.6666666666666667
2364,Ismaila Sarr,SEN,"FW,MF",Marseille,Ligue 1,25,1998,16.1,14,8,2,10,2,6,17,35.3,11,21,6,15,13,27,11,0,0,2023-2024,0.8074534161490683,0.8695652173913043
2365,Mamadou Sarr,FRA,DF,Lyon,Ligue 1,17,2005,0.1,0,0,0,0,0,0,0,0.0,0,0,0,0,0,0,0,0,0,2023-2024,0.0,0.0
2366,Martin Satriano,URU,FW,Brest,Ligue 1,22,2001,20.7,24,16,6,13,5,10,25,40.0,15,19,7,12,7,31,28,0,0,2023-2024,0.33816425120772947,1.1594202898550725
2367,Téji Savanier,FRA,MF,Montpellier,Ligue 1,31,1991,30.7,37,20,16,15,6,14,63,22.2,49,36,8,28,33,70,28,1,0,2023-2024,1.0749185667752443,1.205211726384365
2368,Stefan Savić,MNE,DF,Atlético Madrid,La Liga,32,1991,18.1,27,19,16,7,4,15,30,50.0,15,29,15,14,27,54,61,1,0,2023-2024,1.4917127071823204,1.4917127071823204
2369,Sávio,BRA,"FW,MF",Girona,La Liga,19,2004,33.1,42,25,14,22,6,16,28,57.1,12,34,0,34,18,60,11,1,0,2023-2024,0.5438066465256798,1.268882175226586
2370,Zanos Savva,CYP,"DF,MF",Torino,Serie A,17,2005,0.3,1,1,0,1,0,1,3,33.3,2,0,0,0,0,1,1,0,0,2023-2024,0.0,3.3333333333333335
2371,Saba Sazonov,GEO,DF,Torino,Serie A,21,2002,4.0,9,7,4,5,0,3,3,100.0,0,8,5,3,3,12,22,0,0,2023-2024,0.75,2.25
2372,Joe Scally,USA,DF,Gladbach,Bundesliga,20,2002,24.8,41,28,21,17,3,23,40,57.5,17,31,11,20,18,59,78,2,0,2023-2024,0.7258064516129032,1.6532258064516128
2373,Giorgio Scalvini,ITA,DF,Atalanta,Serie A,19,2003,28.3,53,33,29,19,5,19,40,47.5,21,44,17,27,59,112,71,0,0,2023-2024,2.0848056537102475,1.872791519434629
2374,Gianluca Scamacca,ITA,FW,Atalanta,Serie A,24,1999,16.1,15,9,4,5,6,7,14,50.0,7,7,1,6,4,19,9,0,0,2023-2024,0.24844720496894407,0.9316770186335402
2375,Dane Scarlett,ENG,FW,Tottenham,Premier League,19,2004,0.2,1,1,0,0,1,0,1,0.0,1,0,0,0,0,1,0,0,0,2023-2024,0.0,5.0
Rk,Player,Nation,Pos,Squad,Comp,0,0,90.0,0,0,3,3,3,Tkl,0,0.0,0,0,0,0,0,0,0,0,0,2023-2024,0.0,0.0
2376,Kevin Schade,GER,"FW,MF",Brentford,Premier League,21,2001,3.7,3,1,1,2,0,0,5,0.0,5,2,0,2,1,4,4,0,0,2023-2024,0.27027027027027023,0.8108108108108107
2377,András Schäfer,HUN,MF,Union Berlin,Bundesliga,24,1999,13.5,29,16,9,15,5,11,20,55.0,9,25,4,21,20,49,25,0,0,2023-2024,1.4814814814814814,2.1481481481481484
2378,Fabian Schär,SUI,DF,Newcastle Utd,Premier League,31,1991,33.9,42,24,27,13,2,18,40,45.0,22,50,38,12,36,78,133,1,0,2023-2024,1.0619469026548674,1.2389380530973453
2379,Patrik Schick,CZE,FW,Leverkusen,Bundesliga,27,1996,11.8,6,4,0,3,3,1,5,20.0,4,2,0,2,1,7,7,0,0,2023-2024,0.0847457627118644,0.5084745762711864
2380,Stefan Schimmer,GER,"MF,FW",Heidenheim,Bundesliga,29,1994,1.7,1,1,0,1,0,0,3,0.0,3,2,0,2,1,2,6,0,0,2023-2024,0.5882352941176471,0.5882352941176471
2381,Xaver Schlager,AUT,MF,RB Leipzig,Bundesliga,25,1997,27.5,81,50,35,38,8,21,53,39.6,32,41,8,33,19,100,27,0,0,2023-2024,0.6909090909090909,2.9454545454545453
2382,Keven Schlotterbeck,GER,DF,Bochum,Bundesliga,26,1997,24.3,42,22,26,14,2,25,30,83.3,5,33,23,10,33,75,104,2,0,2023-2024,1.3580246913580247,1.728395061728395
2383,Nico Schlotterbeck,GER,DF,Dortmund,Bundesliga,23,1999,31.8,70,50,36,27,7,41,65,63.1,24,52,25,27,45,115,101,3,0,2023-2024,1.4150943396226414,2.20125786163522
2384,Jeffrey Schlupp,GHA,"FW,MF",Crystal Palace,Premier League,30,1992,15.0,38,24,14,16,8,9,18,50.0,9,13,2,11,8,46,24,0,0,2023-2024,0.5333333333333333,2.533333333333333
2385,Romano Schmid,AUT,"MF,FW",Werder Bremen,Bundesliga,23,2000,28.9,35,20,7,22,6,14,46,30.4,32,36,7,29,11,46,17,2,0,2023-2024,0.3806228373702422,1.2110726643598617
2386,Kenneth Schmidt,GER,DF,Freiburg,Bundesliga,21,2002,0.8,2,2,2,0,0,2,4,50.0,2,1,0,1,1,3,2,0,0,2023-2024,1.25,2.5
2387,Niklas Schmidt,GER,MF,Toulouse,Ligue 1,25,1998,14.1,36,21,13,19,4,16,33,48.5,17,14,7,7,4,40,13,0,0,2023-2024,0.28368794326241137,2.5531914893617023
2388,Benno Schmitz,GER,DF,Köln,Bundesliga,28,1994,12.8,27,15,20,7,0,17,34,50.0,17,19,4,15,7,34,29,0,0,2023-2024,0.546875,2.109375
2389,Fabian Schnellhardt,GER,MF,Darmstadt 98,Bundesliga,29,1994,2.6,4,1,2,1,1,1,3,33.3,2,1,0,1,4,8,5,0,0,2023-2024,1.5384615384615383,1.5384615384615383
2390,Jan Schöppner,GER,MF,Heidenheim,Bundesliga,24,1999,22.2,48,26,26,20,2,21,42,50.0,21,37,7,30,26,74,57,0,0,2023-2024,1.1711711711711712,2.1621621621621623
2391,Marcel Schuhen,GER,GK,Darmstadt 98,Bundesliga,30,1993,31.0,1,0,1,0,0,1,3,33.3,2,0,0,0,2,3,11,4,0,2023-2024,0.06451612903225806,0.03225806451612903
2392,Perr Schuurs,NED,DF,Torino,Serie A,23,1999,8.6,20,12,11,8,1,3,9,33.3,6,10,2,8,9,29,23,0,0,2023-2024,1.0465116279069768,2.3255813953488373
2393,Marvin Schwäbe,GER,GK,Köln,Bundesliga,28,1995,34.0,1,0,1,0,0,1,1,100.0,0,0,0,0,0,1,10,1,0,2023-2024,0.0,0.029411764705882353
2394,Alexander Schwolow,GER,GK,Union Berlin,Bundesliga,31,1992,1.0,0,0,0,0,0,0,0,0.0,0,0,0,0,0,0,2,0,0,2023-2024,0.0,0.0
2395,Alex Scott,ENG,MF,Bournemouth,Premier League,19,2003,11.3,24,15,8,10,6,12,28,42.9,16,14,4,10,12,36,18,2,0,2023-2024,1.0619469026548671,2.1238938053097343
2396,Simone Scuffet,ITA,GK,Cagliari,Serie A,27,1996,31.0,1,0,1,0,0,1,2,50.0,1,1,0,1,1,2,9,0,0,2023-2024,0.03225806451612903,0.03225806451612903
2397,Jérémy Sebas,MTQ,"FW,MF",Strasbourg,Ligue 1,20,2003,4.4,7,1,2,3,2,3,5,60.0,2,3,1,2,1,8,1,0,0,2023-2024,0.22727272727272727,1.5909090909090908
2398,Demba Seck,SEN,MF,Torino,Serie A,22,2001,4.7,5,3,1,4,0,3,4,75.0,1,1,0,1,1,6,0,0,0,2023-2024,0.2127659574468085,1.0638297872340425
2399,Demba Seck,SEN,"FW,MF",Frosinone,Serie A,22,2001,3.3,7,4,2,3,2,4,5,80.0,1,3,0,3,1,8,1,0,0,2023-2024,0.30303030303030304,2.121212121212121
2400,Aleksandar Sedlar,SRB,DF,Alavés,La Liga,31,1991,10.5,14,10,10,4,0,10,16,62.5,6,8,4,4,13,27,43,0,0,2023-2024,1.2380952380952381,1.3333333333333333
Rk,Player,Nation,Pos,Squad,Comp,0,0,90.0,0,0,3,3,3,Tkl,0,0.0,0,0,0,0,0,0,0,0,0,2023-2024,0.0,0.0
2401,Alidu Seidu,GHA,DF,Rennes,Ligue 1,23,2000,6.6,21,9,17,3,1,14,19,73.7,5,11,3,8,10,31,13,0,0,2023-2024,1.5151515151515151,3.181818181818182
2402,Alidu Seidu,GHA,DF,Clermont Foot,Ligue 1,23,2000,12.6,32,24,17,15,0,24,31,77.4,7,15,7,8,25,57,37,0,0,2023-2024,1.9841269841269842,2.5396825396825395
2403,Nicolas Seiwald,AUT,MF,RB Leipzig,Bundesliga,22,2001,8.0,33,18,16,15,2,16,25,64.0,9,12,2,10,8,41,15,0,0,2023-2024,1.0,4.125
2404,Nikola Sekulov,ITA,FW,Juventus,Serie A,21,2002,0.1,0,0,0,0,0,0,0,0.0,0,0,0,0,0,0,0,0,0,2023-2024,0.0,0.0
2405,Davie Selke,GER,FW,Köln,Bundesliga,28,1995,14.1,4,2,1,3,0,0,2,0.0,2,5,3,2,0,4,20,0,0,2023-2024,0.0,0.28368794326241137
2406,Matz Sels,BEL,GK,Nott'ham Forest,Premier League,31,1992,16.0,0,0,0,0,0,0,0,0.0,0,0,0,0,0,0,11,1,0,2023-2024,0.0,0.0
2407,Matz Sels,BEL,GK,Strasbourg,Ligue 1,31,1992,19.0,0,0,0,0,0,0,0,0.0,0,2,0,2,0,0,13,1,0,2023-2024,0.0,0.0
2408,Nélson Semedo,POR,"DF,MF",Wolves,Premier League,29,1993,34.3,79,48,52,19,8,38,64,59.4,26,44,8,36,36,115,85,1,0,2023-2024,1.0495626822157436,2.303206997084548
2409,Vivaldo Semedo,POR,FW,Udinese,Serie A,18,2005,0.1,0,0,0,0,0,0,0,0.0,0,0,0,0,0,0,0,0,0,2023-2024,0.0,0.0
2410,Antoine Semenyo,GHA,FW,Bournemouth,Premier League,23,2000,23.4,24,17,7,9,8,9,27,33.3,18,39,2,37,6,30,21,0,0,2023-2024,0.25641025641025644,1.0256410256410258
2411,Marvin Senaya,TOG,"DF,MF",Strasbourg,Ligue 1,22,2001,23.8,72,53,38,25,9,42,68,61.8,26,40,13,27,41,113,68,0,0,2023-2024,1.722689075630252,3.0252100840336134
2412,Marcos Senesi,ARG,DF,Bournemouth,Premier League,26,1997,24.9,55,32,28,23,4,24,56,42.9,32,50,23,27,35,90,109,1,0,2023-2024,1.4056224899598395,2.208835341365462
2413,Stefano Sensi,ITA,MF,Inter,Serie A,27,1995,0.5,1,1,0,1,0,1,3,33.3,2,1,0,1,1,2,0,0,0,2023-2024,2.0,2.0
2414,Suat Serdar,GER,MF,Hellas Verona,Serie A,26,1997,18.4,51,39,24,23,4,22,45,48.9,23,29,7,22,20,71,25,1,0,2023-2024,1.0869565217391306,2.7717391304347827
2415,Benjamin Šeško,SVN,FW,RB Leipzig,Bundesliga,20,2003,17.0,13,5,2,7,4,2,9,22.2,7,23,2,21,3,16,27,0,0,2023-2024,0.17647058823529413,0.7647058823529411
2416,Kevin Sessa,GER,"MF,FW",Heidenheim,Bundesliga,23,2000,11.2,17,10,9,6,2,7,16,43.8,9,12,1,11,4,21,17,0,0,2023-2024,0.35714285714285715,1.517857142857143
2417,Aaron Seydel,GER,FW,Darmstadt 98,Bundesliga,27,1996,6.9,3,2,0,2,1,0,3,0.0,3,8,2,6,1,4,9,0,0,2023-2024,0.14492753623188406,0.43478260869565216
2418,Andres Sfait,ROU,"DF,MF",Salernitana,Serie A,18,2004,0.3,1,1,1,0,0,1,2,50.0,1,0,0,0,0,1,0,0,0,2023-2024,0.0,3.3333333333333335
2419,Stephan El Shaarawy,ITA,"FW,DF",Roma,Serie A,30,1992,19.3,21,13,14,4,3,6,15,40.0,9,11,4,7,13,34,15,2,0,2023-2024,0.6735751295336787,1.088082901554404
2420,Luke Shaw,ENG,DF,Manchester Utd,Premier League,28,1995,10.7,11,8,7,3,1,9,15,60.0,6,18,11,7,6,17,39,0,0,2023-2024,0.5607476635514019,1.0280373831775702
2421,James Shea,ENG,GK,Luton Town,Premier League,32,1991,0.2,0,0,0,0,0,0,0,0.0,0,0,0,0,0,0,2,0,0,2023-2024,0.0,0.0
2422,Eldor Shomurodov,UZB,"FW,MF",Cagliari,Serie A,28,1995,10.4,11,4,2,6,3,6,10,60.0,4,5,0,5,4,15,4,0,0,2023-2024,0.3846153846153846,1.0576923076923077
2423,Steven Shpendi,ALB,"FW,MF",Empoli,Serie A,20,2003,4.6,0,0,0,0,0,0,4,0.0,4,2,1,1,1,1,0,0,0,2023-2024,0.2173913043478261,0.0
2424,Sofiane Sidi Ali,FRA,MF,Marseille,Ligue 1,28,1995,0.2,2,0,0,2,0,1,2,50.0,1,1,0,1,2,4,0,0,0,2023-2024,10.0,10.0
2425,Vincent Sierro,SUI,MF,Toulouse,Ligue 1,27,1995,25.1,41,24,15,20,6,27,77,35.1,50,37,13,24,27,68,33,0,0,2023-2024,1.0756972111553784,1.6334661354581672
Rk,Player,Nation,Pos,Squad,Comp,0,0,90.0,0,0,3,3,3,Tkl,0,0.0,0,0,0,0,0,0,0,0,0,2023-2024,0.0,0.0
2426,Tim Siersleben,GER,DF,Heidenheim,Bundesliga,23,2000,10.1,27,11,21,6,0,8,20,40.0,12,16,10,6,21,48,29,1,0,2023-2024,2.0792079207920793,2.6732673267326734
2427,Kiliann Sildillia,FRA,DF,Freiburg,Bundesliga,21,2002,20.1,43,19,28,8,7,26,42,61.9,16,33,15,18,22,65,64,0,0,2023-2024,1.0945273631840795,2.1393034825870645
2428,André Silva,POR,FW,Real Sociedad,La Liga,27,1995,8.1,2,2,0,0,2,0,4,0.0,4,3,0,3,1,3,3,0,0,2023-2024,0.1234567901234568,0.2469135802469136
2429,Bernardo Silva,POR,"MF,FW",Manchester City,Premier League,28,1994,28.6,51,23,13,25,13,25,57,43.9,32,32,4,28,17,68,15,1,0,2023-2024,0.5944055944055944,1.7832167832167831
2430,Caio Henrique Oliveira Silva,BRA,DF,Monaco,Ligue 1,26,1997,6.9,13,7,3,7,3,6,9,66.7,3,8,2,6,6,19,9,0,0,2023-2024,0.8695652173913043,1.8840579710144927
2431,Fábio Silva,POR,FW,Wolves,Premier League,21,2002,2.9,7,4,3,4,0,2,3,66.7,1,1,0,1,2,9,0,0,0,2023-2024,0.6896551724137931,2.413793103448276
2432,Rui Silva,POR,GK,Betis,La Liga,29,1994,27.5,0,0,0,0,0,0,3,0.0,3,0,0,0,1,1,13,1,0,2023-2024,0.03636363636363636,0.0
2433,Thiago Silva,BRA,DF,Chelsea,Premier League,38,1984,28.1,29,15,22,6,1,20,34,58.8,14,33,24,9,26,55,153,4,0,2023-2024,0.9252669039145907,1.0320284697508897
2434,Marco Silvestri,ITA,GK,Udinese,Serie A,32,1991,17.0,0,0,0,0,0,0,3,0.0,3,1,0,1,0,0,5,3,0,2023-2024,0.0,0.0
2435,Mohamed Simakan,FRA,DF,RB Leipzig,Bundesliga,23,2000,23.8,48,29,28,19,1,32,44,72.7,12,36,14,22,29,77,69,0,0,2023-2024,1.218487394957983,2.0168067226890756
2436,Giovanni Simeone,ARG,FW,Napoli,Serie A,28,1995,8.9,12,4,1,3,8,3,12,25.0,9,11,0,11,1,13,7,0,0,2023-2024,0.11235955056179775,1.348314606741573
2437,Giuliano Simeone,ARG,FW,Alavés,La Liga,20,2002,7.0,7,5,2,3,2,5,17,29.4,12,10,0,10,5,12,3,0,0,2023-2024,0.7142857142857143,1.0
2438,Jan-Carlo Simic,SRB,DF,Milan,Serie A,18,2005,1.6,1,1,1,0,0,0,0,0.0,0,5,4,1,0,1,3,0,0,2023-2024,0.0,0.625
2439,Moses Simon,NGA,"FW,MF",Nantes,Ligue 1,28,1995,19.9,7,5,2,5,0,2,8,25.0,6,9,1,8,3,10,5,1,0,2023-2024,0.15075376884422112,0.35175879396984927
2440,Unai Simón,ESP,GK,Athletic Club,La Liga,26,1997,35.4,2,1,1,1,0,2,3,66.7,1,0,0,0,1,3,9,0,0,2023-2024,0.02824858757062147,0.05649717514124294
2441,Xavi Simons,NED,MF,RB Leipzig,Bundesliga,20,2003,29.5,30,17,10,11,9,15,31,48.4,16,23,0,23,16,46,4,0,0,2023-2024,0.5423728813559322,1.0169491525423728
2442,Wilfried Singo,CIV,DF,Monaco,Ligue 1,22,2000,24.3,34,25,18,14,2,17,26,65.4,9,27,14,13,51,85,81,2,0,2023-2024,2.0987654320987654,1.3991769547325101
2443,Luis Sinisterra,COL,"FW,MF",Bournemouth,Premier League,24,1999,7.8,23,12,9,10,4,9,16,56.3,7,18,0,18,8,31,4,0,0,2023-2024,1.0256410256410258,2.948717948717949
2444,Daley Sinkgraven,NED,DF,Las Palmas,La Liga,28,1995,4.3,11,5,6,5,0,2,8,25.0,6,5,3,2,6,17,9,0,0,2023-2024,1.3953488372093024,2.558139534883721
2445,Jailson Siqueira,BRA,"DF,MF",Celta Vigo,La Liga,27,1995,10.0,27,18,22,5,0,13,24,54.2,11,13,5,8,12,39,32,0,0,2023-2024,1.2,2.7
2446,Ayanda Sishuba,BEL,"MF,FW",Lens,Ligue 1,18,2005,0.7,3,1,0,2,1,1,2,50.0,1,1,0,1,0,3,0,0,0,2023-2024,0.0,4.285714285714286
2447,Ibrahima Sissoko,MLI,MF,Strasbourg,Ligue 1,25,1997,18.2,47,33,13,25,9,23,30,76.7,7,21,8,13,19,66,30,0,0,2023-2024,1.043956043956044,2.5824175824175826
2448,Moussa Sissoko,FRA,MF,Nantes,Ligue 1,33,1989,20.2,27,16,13,8,6,12,25,48.0,13,8,2,6,12,39,31,0,0,2023-2024,0.594059405940594,1.3366336633663367
2449,Antonio Sivera,ESP,GK,Alavés,La Liga,26,1996,34.0,0,0,0,0,0,0,1,0.0,1,0,0,0,0,0,17,1,0,2023-2024,0.0,0.0
2450,Tim Skarke,GER,"FW,DF",Darmstadt 98,Bundesliga,26,1996,26.7,26,16,12,10,4,10,28,35.7,18,25,2,23,6,32,20,0,0,2023-2024,0.2247191011235955,0.9737827715355806
Rk,Player,Nation,Pos,Squad,Comp,0,0,90.0,0,0,3,3,3,Tkl,0,0.0,0,0,0,0,0,0,0,0,0,2023-2024,0.0,0.0
2451,Ellyes Skhiri,TUN,MF,Eint Frankfurt,Bundesliga,28,1995,24.1,44,24,18,19,7,19,36,52.8,17,33,4,29,39,83,47,2,0,2023-2024,1.6182572614107882,1.8257261410788381
2452,Oliver Skipp,ENG,"MF,DF",Tottenham,Premier League,22,2000,7.9,18,12,9,6,3,11,18,61.1,7,12,1,11,3,21,9,0,0,2023-2024,0.37974683544303794,2.2784810126582276
2453,Leo Skiri Østigård,NOR,DF,Napoli,Serie A,23,1999,18.1,24,12,13,10,1,6,11,54.5,5,18,12,6,16,40,65,0,0,2023-2024,0.8839779005524862,1.3259668508287292
2454,Łukasz Skorupski,POL,GK,Bologna,Serie A,32,1991,32.0,2,2,2,0,0,2,3,66.7,1,0,0,0,1,3,11,3,0,2023-2024,0.03125,0.0625
2455,Robert Skov,DEN,"DF,FW",Hoffenheim,Bundesliga,27,1996,14.0,24,16,15,8,1,17,36,47.2,19,17,4,13,10,34,23,1,0,2023-2024,0.7142857142857143,1.7142857142857142
2456,Milan Škriniar,SVK,DF,Paris S-G,Ligue 1,28,1995,18.1,24,18,17,7,0,14,22,63.6,8,19,10,9,12,36,51,2,0,2023-2024,0.6629834254143646,1.3259668508287292
2457,Naatan Skyttä,FIN,"MF,FW",Toulouse,Ligue 1,21,2002,1.3,4,4,2,1,1,1,1,100.0,0,0,0,0,0,4,0,0,0,2023-2024,0.0,3.0769230769230766
2458,Chris Smalling,ENG,DF,Roma,Serie A,33,1989,4.3,1,1,1,0,0,1,4,25.0,3,6,5,1,5,6,8,0,0,2023-2024,1.1627906976744187,0.23255813953488372
2459,Adam Smith,ENG,DF,Bournemouth,Premier League,32,1991,23.9,37,23,18,11,8,19,39,48.7,20,28,11,17,21,58,62,0,0,2023-2024,0.8786610878661089,1.5481171548117156
2460,Emile Smith Rowe,ENG,MF,Arsenal,Premier League,23,2000,3.9,4,1,2,2,0,2,4,50.0,2,3,1,2,3,7,1,0,0,2023-2024,0.7692307692307693,1.0256410256410258
2461,Hrvoje Smolčić,CRO,DF,Eint Frankfurt,Bundesliga,22,2000,3.9,7,3,7,0,0,4,5,80.0,1,3,1,2,6,13,23,1,0,2023-2024,1.5384615384615385,1.794871794871795
2462,Cédric Soares,POR,DF,Arsenal,Premier League,31,1991,0.7,0,0,0,0,0,0,0,0.0,0,0,0,0,0,0,0,0,0,2023-2024,0.0,0.0
2463,Danilo Soares,BRA,DF,Bochum,Bundesliga,31,1991,3.9,10,6,5,3,2,5,8,62.5,3,6,0,6,7,17,11,0,0,2023-2024,1.794871794871795,2.5641025641025643
2464,Eduard Sobol,UKR,DF,Strasbourg,Ligue 1,28,1995,0.3,0,0,0,0,0,0,0,0.0,0,0,0,0,0,0,1,0,0,2023-2024,0.0,0.0
2465,Rubén Sobrino,ESP,"MF,FW",Cádiz,La Liga,31,1992,18.3,52,28,18,26,8,22,51,43.1,29,26,2,24,16,68,18,0,0,2023-2024,0.8743169398907104,2.841530054644809
2466,Andrea Sodero,ITA,MF,Empoli,Serie A,18,2004,0.1,0,0,0,0,0,0,0,0.0,0,0,0,0,0,0,0,0,0,2023-2024,0.0,0.0
2467,Emran Soglo,ENG,"MF,DF",Marseille,Ligue 1,18,2005,1.2,2,1,0,2,0,1,3,33.3,2,6,0,6,1,3,3,0,0,2023-2024,0.8333333333333334,1.6666666666666667
2468,Alex Sola,ESP,"FW,MF",Alavés,La Liga,24,1999,14.0,27,15,11,9,7,14,26,53.8,12,18,2,16,11,38,16,0,0,2023-2024,0.7857142857142857,1.9285714285714286
2469,Alex Sola,ESP,"DF,MF",Real Sociedad,La Liga,24,1999,0.3,0,0,0,0,0,0,0,0.0,0,0,0,0,1,1,2,0,0,2023-2024,3.3333333333333335,0.0
2470,Dominic Solanke,ENG,FW,Bournemouth,Premier League,25,1997,36.9,23,11,3,13,7,10,29,34.5,19,24,5,19,7,30,43,0,0,2023-2024,0.1897018970189702,0.6233062330623307
2471,Ola Solbakken,NOR,FW,Roma,Serie A,24,1998,0.3,0,0,0,0,0,0,0,0.0,0,0,0,0,0,0,0,0,0,2023-2024,0.0,0.0
2472,Carlos Soler,ESP,"MF,DF",Paris S-G,Ligue 1,26,1997,12.1,15,10,9,2,4,6,21,28.6,15,10,3,7,5,20,11,1,0,2023-2024,0.4132231404958678,1.2396694214876034
2473,Jhon Solis,COL,MF,Girona,La Liga,18,2004,4.3,10,8,4,5,1,4,12,33.3,8,8,3,5,8,18,7,1,0,2023-2024,1.8604651162790697,2.3255813953488373
2474,Manor Solomon,ISR,FW,Tottenham,Premier League,24,1999,2.2,3,3,1,1,1,1,2,50.0,1,4,0,4,3,6,2,0,0,2023-2024,1.3636363636363635,1.3636363636363635
2475,Daniele Sommariva,ITA,GK,Genoa,Serie A,26,1997,0.1,0,0,0,0,0,0,0,0.0,0,0,0,0,0,0,0,0,0,2023-2024,0.0,0.0
Rk,Player,Nation,Pos,Squad,Comp,0,0,90.0,0,0,3,3,3,Tkl,0,0.0,0,0,0,0,0,0,0,0,0,2023-2024,0.0,0.0
2476,Yann Sommer,SUI,GK,Inter,Serie A,34,1988,34.0,2,1,2,0,0,2,2,100.0,0,1,0,1,0,2,7,1,0,2023-2024,0.0,0.058823529411764705
2477,Brandon Soppy,FRA,DF,Torino,Serie A,21,2002,2.0,2,2,1,1,0,2,6,33.3,4,2,0,2,0,2,3,1,0,2023-2024,0.0,1.0
2478,David Soria,ESP,GK,Getafe,La Liga,30,1993,37.9,0,0,0,0,0,0,2,0.0,2,0,0,0,0,0,21,6,0,2023-2024,0.0,0.0
2479,Alberto Soro,ESP,MF,Granada,La Liga,24,1999,0.1,0,0,0,0,0,0,0,0.0,0,0,0,0,0,0,0,0,0,2023-2024,0.0,0.0
2480,Alessandro Sorrentino,ITA,GK,Monza,Serie A,21,2002,6.1,0,0,0,0,0,0,0,0.0,0,0,0,0,0,0,0,0,0,2023-2024,0.0,0.0
2481,Borna Sosa,CRO,"FW,DF",Stuttgart,Bundesliga,25,1998,0.5,0,0,0,0,0,0,1,0.0,1,0,0,0,0,0,0,0,0,2023-2024,0.0,0.0
2482,Hugo Sotelo,ESP,MF,Celta Vigo,La Liga,19,2003,8.0,19,17,3,13,3,8,20,40.0,12,7,1,6,2,21,5,0,0,2023-2024,0.25,2.375
2483,Florian Sotoca,FRA,"MF,FW",Lens,Ligue 1,32,1990,28.9,33,22,9,21,3,17,38,44.7,21,41,4,37,20,53,34,0,0,2023-2024,0.6920415224913495,1.1418685121107266
2484,Riccardo Sottil,ITA,FW,Fiorentina,Serie A,24,1999,12.3,10,5,5,1,4,3,8,37.5,5,12,0,12,2,12,2,0,0,2023-2024,0.16260162601626016,0.8130081300813008
2485,Tomáš Souček,CZE,MF,West Ham,Premier League,28,1995,31.9,53,35,24,26,3,21,47,44.7,26,55,28,27,37,90,109,0,0,2023-2024,1.1598746081504703,1.6614420062695925
2486,Matìas Soulé,ARG,"FW,MF",Frosinone,Serie A,20,2003,34.7,41,27,12,14,15,19,40,47.5,21,38,4,34,18,59,9,0,0,2023-2024,0.5187319884726225,1.1815561959654177
2487,Boubakary Soumaré,FRA,MF,Sevilla,La Liga,24,1999,25.4,39,28,24,14,1,14,26,53.8,12,25,7,18,26,65,20,1,0,2023-2024,1.0236220472440944,1.535433070866142
2488,Issa Soumaré,SEN,"FW,MF",Le Havre,Ligue 1,22,2000,2.6,2,0,2,0,0,0,4,0.0,4,0,0,0,0,2,2,0,0,2023-2024,0.0,0.7692307692307692
2489,Vinicius Souza,BRA,MF,Sheffield Utd,Premier League,24,1999,29.6,125,76,59,51,15,41,74,55.4,33,57,17,40,32,157,75,1,0,2023-2024,1.081081081081081,4.222972972972973
2490,Djibril Sow,SUI,MF,Sevilla,La Liga,26,1997,16.2,28,21,15,8,5,9,25,36.0,16,20,3,17,17,45,8,1,0,2023-2024,1.0493827160493827,1.7283950617283952
2491,Saidou Sow,GUI,DF,Strasbourg,Ligue 1,21,2002,8.0,20,12,17,3,0,9,13,69.2,4,7,4,3,12,32,36,3,0,2023-2024,1.5,2.5
2492,Çağlar Söyüncü,TUR,DF,Atlético Madrid,La Liga,27,1996,1.3,1,1,1,0,0,0,0,0.0,0,1,0,1,1,2,7,0,0,2023-2024,0.7692307692307692,0.7692307692307692
2493,Djed Spence,ENG,DF,Genoa,Serie A,22,2000,9.5,16,10,12,4,0,8,10,80.0,2,20,5,15,8,24,28,0,0,2023-2024,0.8421052631578947,1.6842105263157894
2494,Stijn Spierings,NED,MF,Toulouse,Ligue 1,27,1996,16.8,53,40,26,20,7,29,52,55.8,23,22,5,17,26,79,32,0,0,2023-2024,1.5476190476190474,3.1547619047619047
2495,Stijn Spierings,NED,MF,Lens,Ligue 1,27,1996,1.3,1,0,0,1,0,1,1,100.0,0,2,1,1,2,3,1,0,0,2023-2024,1.5384615384615383,0.7692307692307692
2496,Leonardo Spinazzola,ITA,DF,Roma,Serie A,30,1993,14.6,15,7,10,5,0,8,18,44.4,10,8,2,6,3,18,15,0,0,2023-2024,0.20547945205479454,1.0273972602739727
2497,Marco Sportiello,ITA,GK,Milan,Serie A,31,1992,7.0,0,0,0,0,0,0,0,0.0,0,0,0,0,0,0,2,0,0,2023-2024,0.0,0.0
2498,Anton Stach,GER,MF,Hoffenheim,Bundesliga,24,1998,25.8,73,42,40,27,6,33,63,52.4,30,38,12,26,72,145,67,1,0,2023-2024,2.7906976744186047,2.8294573643410854
2499,Anton Stach,GER,MF,Mainz 05,Bundesliga,24,1998,1.9,3,0,2,0,1,2,4,50.0,2,5,0,5,2,5,5,0,0,2023-2024,1.0526315789473684,1.5789473684210527
2500,Jens Stage,DEN,MF,Werder Bremen,Bundesliga,26,1996,25.9,52,22,21,23,8,18,50,36.0,32,42,23,19,23,75,55,0,0,2023-2024,0.888030888030888,2.0077220077220077
Rk,Player,Nation,Pos,Squad,Comp,0,0,90.0,0,0,3,3,3,Tkl,0,0.0,0,0,0,0,0,0,0,0,0,2023-2024,0.0,0.0
2501,Benjamin Stambouli,FRA,MF,Reims,Ligue 1,32,1990,3.2,9,7,3,5,1,6,11,54.5,5,3,1,2,2,11,8,0,0,2023-2024,0.625,2.8125
2502,Josip Stanišić,CRO,DF,Leverkusen,Bundesliga,23,2000,14.0,38,20,19,13,6,22,33,66.7,11,18,3,15,9,47,26,0,0,2023-2024,0.6428571428571429,2.7142857142857144
2503,Carl Starfelt,SWE,DF,Celta Vigo,La Liga,28,1995,24.6,36,30,30,5,1,19,28,67.9,9,35,28,7,34,70,159,2,0,2023-2024,1.3821138211382114,1.4634146341463414
2504,Niklas Stark,GER,DF,Werder Bremen,Bundesliga,28,1995,12.1,26,15,13,11,2,12,18,66.7,6,14,7,7,19,45,61,1,0,2023-2024,1.5702479338842976,2.1487603305785123
2505,Jason Steele,ENG,GK,Brighton,Premier League,32,1990,17.0,0,0,0,0,0,0,3,0.0,3,0,0,0,0,0,8,1,0,2023-2024,0.0,0.0
2506,Pascal Stenzel,GER,DF,Stuttgart,Bundesliga,27,1996,11.8,18,8,7,9,2,10,30,33.3,20,22,8,14,15,33,26,0,0,2023-2024,1.271186440677966,1.5254237288135593
2507,Leonidas Stergiou,SUI,DF,Stuttgart,Bundesliga,21,2002,6.6,15,8,7,7,1,9,13,69.2,4,8,1,7,5,20,13,0,0,2023-2024,0.7575757575757576,2.272727272727273
2508,Raheem Sterling,ENG,"FW,MF",Chelsea,Premier League,28,1994,22.0,21,10,7,8,6,12,26,46.2,14,13,0,13,13,34,9,1,0,2023-2024,0.5909090909090909,0.9545454545454546
2509,Trivante Stewart,JAM,"FW,MF",Salernitana,Serie A,23,2000,1.1,0,0,0,0,0,0,0,0.0,0,1,0,1,0,0,0,0,0,2023-2024,0.0,0.0
2510,Angelo Stiller,GER,MF,Hoffenheim,Bundesliga,22,2001,0.9,0,0,0,0,0,0,1,0.0,1,2,0,2,0,0,3,0,0,2023-2024,0.0,0.0
2511,Angelo Stiller,GER,MF,Stuttgart,Bundesliga,22,2001,29.9,55,33,15,34,6,24,42,57.1,18,41,13,28,28,83,25,2,0,2023-2024,0.9364548494983278,1.839464882943144
2512,Kevin Stöger,AUT,MF,Bochum,Bundesliga,29,1993,29.6,49,30,21,21,7,25,63,39.7,38,46,4,42,19,68,18,0,0,2023-2024,0.6418918918918919,1.6554054054054053
2513,Filip Stojilković,SUI,"FW,MF",Darmstadt 98,Bundesliga,23,2000,1.7,1,1,0,0,1,0,0,0.0,0,0,0,0,0,1,1,0,0,2023-2024,0.0,0.5882352941176471
2514,John Stones,ENG,"DF,MF",Manchester City,Premier League,29,1994,11.8,2,1,1,0,1,0,3,0.0,3,11,7,4,10,12,21,0,0,2023-2024,0.847457627118644,0.1694915254237288
2515,Thomas Strakosha,ALB,GK,Brentford,Premier League,28,1995,1.5,0,0,0,0,0,0,0,0.0,0,0,0,0,0,0,0,0,0,2023-2024,0.0,0.0
2516,Jørgen Strand Larsen,NOR,FW,Celta Vigo,La Liga,23,2000,31.8,21,11,1,15,5,8,38,21.1,30,15,1,14,5,26,17,0,0,2023-2024,0.15723270440251572,0.660377358490566
2517,Gabriel Strefezza,BRA,FW,Lecce,Serie A,26,1997,12.4,24,17,8,7,9,14,20,70.0,6,17,0,17,7,31,11,0,0,2023-2024,0.564516129032258,1.9354838709677418
2518,Kevin Strootman,NED,MF,Genoa,Serie A,33,1990,13.4,34,19,13,18,3,15,31,48.4,16,20,6,14,7,41,22,0,0,2023-2024,0.5223880597014925,2.5373134328358207
2519,Cristhian Stuani,URU,FW,Girona,La Liga,36,1986,8.9,14,11,4,6,4,4,7,57.1,3,9,2,7,5,19,13,0,0,2023-2024,0.5617977528089887,1.5730337078651684
2520,Álex Suárez,ESP,DF,Las Palmas,La Liga,30,1993,28.5,53,36,33,15,5,31,37,83.8,6,33,14,19,18,71,84,0,0,2023-2024,0.631578947368421,1.8596491228070176
2521,Damián Suárez,URU,DF,Getafe,La Liga,35,1988,14.4,36,21,16,16,4,26,45,57.8,19,13,3,10,10,46,31,0,0,2023-2024,0.6944444444444444,2.5
2522,Denis Suárez,ESP,"MF,FW",Villarreal,La Liga,29,1994,1.5,0,0,0,0,0,0,2,0.0,2,2,2,0,0,0,4,0,0,2023-2024,0.0,0.0
2523,Gabriel Suazo,CHI,DF,Toulouse,Ligue 1,25,1997,26.2,66,32,40,19,7,38,86,44.2,48,37,4,33,26,92,33,0,0,2023-2024,0.9923664122137404,2.519083969465649
2524,Isaac Success,NGA,"FW,MF",Udinese,Serie A,27,1996,9.8,6,4,0,5,1,1,3,33.3,2,6,1,5,2,8,11,0,0,2023-2024,0.2040816326530612,0.6122448979591836
2525,Niklas Süle,GER,DF,Dortmund,Bundesliga,27,1995,16.8,18,10,14,3,1,11,16,68.8,5,25,14,11,25,43,58,2,0,2023-2024,1.4880952380952381,1.0714285714285714
Rk,Player,Nation,Pos,Squad,Comp,0,0,90.0,0,0,3,3,3,Tkl,0,0.0,0,0,0,0,0,0,0,0,0,2023-2024,0.0,0.0
2526,Ibrahim Sulemana,GHA,MF,Cagliari,Serie A,20,2003,14.9,36,14,15,15,6,17,27,63.0,10,24,5,19,7,43,23,0,0,2023-2024,0.4697986577181208,2.4161073825503356
2527,Tomáš Suslov,SVK,"MF,FW",Hellas Verona,Serie A,21,2002,23.2,42,30,11,22,9,15,47,31.9,32,15,0,15,6,48,8,0,0,2023-2024,0.25862068965517243,1.8103448275862069
2528,Suso,ESP,"MF,FW",Sevilla,La Liga,29,1993,16.9,24,17,14,8,2,8,28,28.6,20,9,0,9,5,29,4,0,0,2023-2024,0.2958579881656805,1.4201183431952664
2529,Mattias Svanberg,SWE,MF,Wolfsburg,Bundesliga,24,1999,19.1,37,17,8,19,10,12,38,31.6,26,25,5,20,21,58,28,0,0,2023-2024,1.0994764397905759,1.9371727748691099
2530,Max Svensson,ESP,FW,Osasuna,La Liga,0,0,0.0,1,0,0,0,1,0,0,0.0,0,0,0,0,0,1,0,0,0,2023-2024,,inf
2531,Mile Svilar,SRB,GK,Roma,Serie A,23,1999,15.0,0,0,0,0,0,0,0,0.0,0,0,0,0,0,0,2,1,0,2023-2024,0.0,0.0
2532,Williot Swedberg,SWE,"FW,MF",Celta Vigo,La Liga,19,2004,4.9,9,4,3,6,0,5,8,62.5,3,11,1,10,0,9,4,0,0,2023-2024,0.0,1.8367346938775508
2533,Karol Świderski,POL,"FW,MF",Hellas Verona,Serie A,26,1997,5.6,7,3,1,3,3,2,3,66.7,1,6,4,2,1,8,8,0,0,2023-2024,0.17857142857142858,1.25
2534,Abakar Sylla,CIV,DF,Strasbourg,Ligue 1,20,2002,19.9,54,23,30,19,5,29,40,72.5,11,40,11,29,26,80,70,2,0,2023-2024,1.306532663316583,2.71356783919598
2535,Dembo Sylla,GUI,DF,Lorient,Ligue 1,20,2002,0.5,1,1,0,1,0,0,0,0.0,0,0,0,0,1,2,2,0,0,2023-2024,2.0,2.0
2536,Issiaga Sylla,GUI,"DF,FW",Montpellier,Ligue 1,29,1994,16.2,28,17,20,6,2,16,34,47.1,18,21,7,14,23,51,53,0,0,2023-2024,1.4197530864197532,1.7283950617283952
2537,Mamadou Sylla,SEN,"FW,MF",Alavés,La Liga,29,1994,0.2,0,0,0,0,0,0,0,0.0,0,1,1,0,0,0,1,0,0,2023-2024,0.0,0.0
2538,Attila Szalai,HUN,DF,Hoffenheim,Bundesliga,25,1998,3.2,3,1,3,0,0,1,4,25.0,3,6,2,4,1,4,7,0,0,2023-2024,0.3125,0.9375
2539,Attila Szalai,HUN,DF,Freiburg,Bundesliga,25,1998,1.1,1,1,1,0,0,1,2,50.0,1,5,2,3,1,2,11,1,0,2023-2024,0.9090909090909091,0.9090909090909091
2540,Wojciech Szczęsny,POL,GK,Juventus,Serie A,33,1990,35.0,0,0,0,0,0,0,0,0.0,0,0,0,0,1,1,11,2,0,2023-2024,0.02857142857142857,0.0
2541,Dominik Szoboszlai,HUN,MF,Liverpool,Premier League,22,2000,23.4,32,19,12,12,8,16,50,32.0,34,37,2,35,15,47,16,1,0,2023-2024,0.6410256410256411,1.3675213675213675
2542,Przemysław Szymiński,POL,MF,Frosinone,Serie A,29,1994,0.1,0,0,0,0,0,0,0,0.0,0,1,1,0,0,0,0,0,0,2023-2024,0.0,0.0
2543,Alexander Sørloth,NOR,FW,Villarreal,La Liga,27,1995,27.7,6,3,1,2,3,2,6,33.3,4,9,4,5,0,6,26,0,0,2023-2024,0.0,0.21660649819494585
2544,Musa Al-Taamari,JOR,FW,Montpellier,Ligue 1,26,1997,21.4,20,16,10,5,5,9,21,42.9,12,18,2,16,4,24,5,0,0,2023-2024,0.1869158878504673,0.9345794392523366
2545,Nicolás Tagliafico,ARG,DF,Lyon,Ligue 1,30,1992,23.6,54,34,23,22,9,22,49,44.9,27,25,8,17,28,82,43,0,0,2023-2024,1.1864406779661016,2.2881355932203387
2546,Jonathan Tah,GER,DF,Leverkusen,Bundesliga,27,1996,29.2,19,9,10,7,2,5,16,31.3,11,28,23,5,23,42,97,1,0,2023-2024,0.7876712328767124,0.6506849315068494
2547,Montassar Talbi,TUN,DF,Lorient,Ligue 1,25,1998,24.5,38,22,23,13,2,19,32,59.4,13,39,23,16,32,70,114,0,0,2023-2024,1.3061224489795917,1.5510204081632653
2548,Yassin Tallal,ESP,FW,Getafe,La Liga,18,2005,0.0,0,0,0,0,0,0,0,0.0,0,0,0,0,0,0,0,0,0,2023-2024,,
2549,Adrien Tameze,CMR,"DF,MF",Torino,Serie A,29,1994,23.8,35,16,13,18,4,18,37,48.6,19,24,11,13,47,82,25,2,0,2023-2024,1.9747899159663864,1.4705882352941175
2550,Renato Tapia,PER,"MF,DF",Celta Vigo,La Liga,28,1995,14.9,41,29,19,19,3,14,25,56.0,11,31,7,24,21,62,50,1,0,2023-2024,1.4093959731543624,2.751677852348993
Rk,Player,Nation,Pos,Squad,Comp,0,0,90.0,0,0,3,3,3,Tkl,0,0.0,0,0,0,0,0,0,0,0,0,2023-2024,0.0,0.0
2551,Edmond Tapsoba,BFA,DF,Leverkusen,Bundesliga,24,1999,23.2,34,25,17,15,2,17,24,70.8,7,21,10,11,24,58,52,3,0,2023-2024,1.0344827586206897,1.4655172413793105
2552,Matt Targett,ENG,DF,Newcastle Utd,Premier League,27,1995,0.9,2,0,1,1,0,1,1,100.0,0,1,0,1,0,2,2,0,0,2023-2024,0.0,2.2222222222222223
2553,Oussama Targhalline,MAR,MF,Le Havre,Ligue 1,21,2002,11.4,23,11,16,7,0,15,25,60.0,10,9,3,6,20,43,14,2,0,2023-2024,1.7543859649122806,2.017543859649123
2554,James Tarkowski,ENG,DF,Everton,Premier League,30,1992,38.0,61,42,46,14,1,27,48,56.3,21,82,56,26,56,117,191,2,0,2023-2024,1.4736842105263157,1.605263157894737
2555,César Tárrega,ESP,DF,Valencia,La Liga,21,2002,0.1,0,0,0,0,0,0,0,0.0,0,0,0,0,0,0,2,0,0,2023-2024,0.0,0.0
2556,Jimi Tauriainen,ENG,FW,Chelsea,Premier League,19,2004,0.0,0,0,0,0,0,0,0,0.0,0,0,0,0,0,0,0,0,0,2023-2024,,
2557,Nuno Tavares,POR,DF,Nott'ham Forest,Premier League,23,2000,5.1,11,7,9,1,1,8,9,88.9,1,6,0,6,1,12,21,0,0,2023-2024,0.19607843137254904,2.1568627450980395
2558,Marcus Tavernier,ENG,FW,Bournemouth,Premier League,24,1999,23.5,53,34,25,22,6,26,48,54.2,22,31,3,28,5,58,23,0,0,2023-2024,0.2127659574468085,2.25531914893617
2559,Elayis Tavsan,NED,"MF,FW",Hellas Verona,Serie A,22,2001,0.6,0,0,0,0,0,0,1,0.0,1,0,0,0,0,0,1,0,0,2023-2024,0.0,0.0
2560,Charlie Taylor,ENG,DF,Burnley,Premier League,29,1993,25.9,35,20,19,14,2,17,35,48.6,18,27,11,16,19,54,78,0,0,2023-2024,0.7335907335907337,1.3513513513513513
2561,Marciano Tchami,GNB,"FW,MF",Almería,La Liga,19,2004,0.5,0,0,0,0,0,0,0,0.0,0,0,0,0,0,0,0,0,0,2023-2024,0.0,0.0
2562,Loum Tchaouna,FRA,"FW,MF",Salernitana,Serie A,19,2003,23.3,20,10,5,13,2,10,20,50.0,10,20,1,19,4,24,16,1,0,2023-2024,0.17167381974248927,0.8583690987124464
2563,Jackson Tchatchoua,CMR,DF,Hellas Verona,Serie A,21,2001,19.2,39,26,25,12,2,23,48,47.9,25,17,7,10,23,62,49,2,0,2023-2024,1.1979166666666667,2.03125
2564,Enzo Tchato,CMR,DF,Montpellier,Ligue 1,20,2002,12.5,26,17,18,4,4,11,25,44.0,14,20,7,13,11,37,25,0,0,2023-2024,0.88,2.08
2565,Aurélien Tchouaméni,FRA,"MF,DF",Real Madrid,La Liga,23,2000,22.1,38,23,19,17,2,9,18,50.0,9,21,13,8,28,66,52,1,0,2023-2024,1.2669683257918551,1.7194570135746605
2566,Mathys Tel,FRA,"FW,MF",Bayern Munich,Bundesliga,18,2005,11.7,12,2,3,4,5,4,6,66.7,2,11,0,11,6,18,6,0,0,2023-2024,0.5128205128205129,1.0256410256410258
2567,Nathan Tella,NGA,"DF,MF",Leverkusen,Bundesliga,24,1999,9.1,13,8,6,5,2,5,10,50.0,5,10,0,10,3,16,8,0,0,2023-2024,0.32967032967032966,1.4285714285714286
2568,Nahuel Tenaglia,ARG,DF,Alavés,La Liga,27,1996,12.7,29,19,22,4,3,16,28,57.1,12,14,8,6,12,41,59,0,0,2023-2024,0.9448818897637796,2.283464566929134
2569,Arnau Tenas,ESP,GK,Paris S-G,Ligue 1,22,2001,5.9,0,0,0,0,0,0,0,0.0,0,0,0,0,0,0,0,0,0,2023-2024,0.0,0.0
2570,Marc-André ter Stegen,GER,GK,Barcelona,La Liga,31,1992,28.0,0,0,0,0,0,0,0,0.0,0,0,0,0,0,0,3,3,0,2023-2024,0.0,0.0
2571,Filippo Terracciano,ITA,DF,Hellas Verona,Serie A,20,2003,14.4,30,19,23,6,1,17,31,54.8,14,24,6,18,20,50,17,0,0,2023-2024,1.3888888888888888,2.0833333333333335
2572,Filippo Terracciano,ITA,"DF,FW",Milan,Serie A,20,2003,0.8,2,2,1,1,0,1,3,33.3,2,3,0,3,0,2,1,0,0,2023-2024,0.0,2.5
2573,Pietro Terracciano,ITA,GK,Fiorentina,Serie A,33,1990,33.0,1,1,1,0,0,1,3,33.3,2,1,0,1,0,1,8,0,0,2023-2024,0.0,0.030303030303030304
2574,Ramón Terrats,ESP,"MF,DF",Villarreal,La Liga,22,2000,8.7,17,13,8,8,1,7,15,46.7,8,11,1,10,3,20,9,0,0,2023-2024,0.3448275862068966,1.9540229885057472
2575,Martin Terrier,FRA,"FW,MF",Rennes,Ligue 1,26,1997,17.0,14,9,3,8,3,6,14,42.9,8,21,4,17,9,23,17,0,0,2023-2024,0.5294117647058824,0.8235294117647058
Rk,Player,Nation,Pos,Squad,Comp,0,0,90.0,0,0,3,3,3,Tkl,0,0.0,0,0,0,0,0,0,0,0,0,2023-2024,0.0,0.0
2576,Kenny Tete,NED,DF,Fulham,Premier League,27,1995,9.6,27,17,19,6,2,11,19,57.9,8,10,3,7,16,43,35,0,0,2023-2024,1.6666666666666667,2.8125
2577,Benjamin Tetteh,GHA,"FW,MF",Metz,Ligue 1,26,1997,3.1,6,6,1,5,0,4,7,57.1,3,0,0,0,0,6,1,0,0,2023-2024,0.0,1.9354838709677418
2578,Teddy Teuma,MLT,MF,Reims,Ligue 1,29,1993,23.5,54,36,19,21,14,25,62,40.3,37,33,4,29,20,74,6,0,0,2023-2024,0.851063829787234,2.297872340425532
2579,Florian Thauvin,FRA,FW,Udinese,Serie A,30,1993,19.0,7,4,2,4,1,4,13,30.8,9,9,1,8,3,10,2,0,0,2023-2024,0.15789473684210525,0.3684210526315789
2580,Arthur Theate,BEL,DF,Rennes,Ligue 1,23,2000,25.5,30,17,19,6,5,24,37,64.9,13,40,23,17,31,61,90,2,0,2023-2024,1.2156862745098038,1.1764705882352942
2581,Norman Theuerkauf,GER,"MF,DF",Heidenheim,Bundesliga,36,1987,14.0,24,16,13,7,4,13,22,59.1,9,16,6,10,14,38,21,0,0,2023-2024,1.0,1.7142857142857142
2582,Malick Thiaw,GER,DF,Milan,Serie A,21,2001,18.0,34,17,15,17,2,12,25,48.0,13,23,13,10,13,47,55,0,0,2023-2024,0.7222222222222222,1.8888888888888888
2583,Jan Thielmann,GER,"FW,DF",Köln,Bundesliga,21,2002,17.5,28,18,13,9,6,12,24,50.0,12,31,6,25,8,36,28,0,0,2023-2024,0.45714285714285713,1.6
2584,Denis Thomalla,GER,"MF,FW",Heidenheim,Bundesliga,30,1992,5.0,9,6,4,4,1,5,11,45.5,6,3,2,1,4,13,13,0,0,2023-2024,0.8,1.8
2585,Luke Thomas,ENG,DF,Sheffield Utd,Premier League,22,2001,10.2,20,9,13,6,1,8,14,57.1,6,23,5,18,10,30,27,0,0,2023-2024,0.9803921568627452,1.9607843137254903
2586,Adrien Thomasson,FRA,MF,Lens,Ligue 1,29,1993,13.3,25,14,4,16,5,11,34,32.4,23,14,0,14,9,34,10,1,0,2023-2024,0.6766917293233082,1.8796992481203008
2587,Morten Thorsby,NOR,MF,Genoa,Serie A,27,1996,12.9,19,11,9,8,2,7,14,50.0,7,21,5,16,4,23,20,0,0,2023-2024,0.31007751937984496,1.4728682170542635
2588,Kristian Thorstvedt,NOR,MF,Sassuolo,Serie A,24,1999,26.6,40,22,7,28,5,22,44,50.0,22,25,9,16,21,61,36,0,0,2023-2024,0.7894736842105263,1.5037593984962405
2589,Khéphren Thuram,FRA,MF,Nice,Ligue 1,22,2001,23.4,42,29,13,23,6,20,40,50.0,20,21,10,11,18,60,37,0,0,2023-2024,0.7692307692307693,1.794871794871795
2590,Marcus Thuram,FRA,FW,Inter,Serie A,25,1997,29.9,23,15,9,9,5,4,13,30.8,9,26,3,23,4,27,19,0,0,2023-2024,0.13377926421404682,0.7692307692307693
2591,Cheikh Tidiane Sabaly,SEN,"FW,MF",Metz,Ligue 1,24,1999,15.3,40,20,23,12,5,16,40,40.0,24,19,2,17,10,50,14,0,0,2023-2024,0.6535947712418301,2.6143790849673203
2592,Youri Tielemans,BEL,"MF,FW",Aston Villa,Premier League,26,1997,18.0,41,20,17,18,6,16,40,40.0,24,23,3,20,15,56,9,0,0,2023-2024,0.8333333333333334,2.2777777777777777
2593,Kieran Tierney,SCO,DF,Real Sociedad,La Liga,26,1997,13.8,37,24,16,18,3,18,27,66.7,9,22,8,14,10,47,45,0,0,2023-2024,0.7246376811594203,2.681159420289855
2594,Phillip Tietz,GER,FW,Augsburg,Bundesliga,26,1997,26.5,23,14,7,13,3,6,15,40.0,9,17,3,14,6,29,35,0,0,2023-2024,0.22641509433962265,0.8679245283018868
2595,Steffen Tigges,GER,FW,Köln,Bundesliga,25,1998,8.1,10,6,4,5,1,3,7,42.9,4,4,2,2,1,11,12,0,0,2023-2024,0.1234567901234568,1.234567901234568
2596,Antonio Tikvić,CRO,DF,Udinese,Serie A,19,2004,0.0,0,0,0,0,0,0,0,0.0,0,0,0,0,0,0,0,0,0,2023-2024,,
2597,Jurriën Timber,NED,DF,Arsenal,Premier League,22,2001,0.8,2,2,1,1,0,0,0,0.0,0,1,0,1,0,2,1,0,0,2023-2024,0.0,2.5
2598,Jean-Clair Todibo,FRA,DF,Nice,Ligue 1,23,1999,29.5,58,28,35,17,6,34,56,60.7,22,34,15,19,38,96,97,1,0,2023-2024,1.2881355932203389,1.9661016949152543
2599,Harry Toffolo,ENG,DF,Nott'ham Forest,Premier League,27,1995,16.2,26,14,20,6,0,15,24,62.5,9,34,13,21,14,40,49,0,0,2023-2024,0.8641975308641976,1.6049382716049383
2600,Umut Tohumcu,GER,MF,Hoffenheim,Bundesliga,18,2004,11.2,16,12,9,7,0,6,19,31.6,13,11,1,10,6,22,12,0,0,2023-2024,0.5357142857142857,1.4285714285714286
Rk,Player,Nation,Pos,Squad,Comp,0,0,90.0,0,0,3,3,3,Tkl,0,0.0,0,0,0,0,0,0,0,0,0,2023-2024,0.0,0.0
2601,Corentin Tolisso,FRA,MF,Lyon,Ligue 1,28,1994,19.3,33,21,13,11,9,14,33,42.4,19,26,9,17,10,43,18,0,0,2023-2024,0.5181347150259067,1.709844559585492
2602,Jeremy Toljan,GER,DF,Sassuolo,Serie A,28,1994,23.1,13,10,8,4,1,9,15,60.0,6,17,5,12,16,29,49,1,0,2023-2024,0.6926406926406926,0.5627705627705627
2603,Rafael Tolói,ITA,DF,Atalanta,Serie A,32,1990,10.7,20,9,7,8,5,14,27,51.9,13,9,4,5,13,33,29,0,0,2023-2024,1.2149532710280375,1.869158878504673
2604,Raúl de Tomás,ESP,FW,Rayo Vallecano,La Liga,28,1994,14.1,9,5,4,3,2,3,6,50.0,3,3,0,3,1,10,8,0,0,2023-2024,0.07092198581560284,0.6382978723404256
2605,Tiago Tomás,POR,"FW,MF",Wolfsburg,Bundesliga,21,2002,11.5,5,2,3,0,2,1,6,16.7,5,13,0,13,3,8,9,0,0,2023-2024,0.2608695652173913,0.43478260869565216
2606,Takehiro Tomiyasu,JPN,DF,Arsenal,Premier League,24,1998,12.8,20,9,15,4,1,11,18,61.1,7,10,4,6,18,38,33,0,0,2023-2024,1.40625,1.5625
2607,James Tomkins,ENG,DF,Crystal Palace,Premier League,34,1989,0.1,0,0,0,0,0,0,0,0.0,0,0,0,0,1,1,0,0,0,2023-2024,10.0,0.0
2608,Fikayo Tomori,ENG,DF,Milan,Serie A,25,1997,23.6,42,24,29,10,3,18,29,62.1,11,34,23,11,26,68,75,1,0,2023-2024,1.1016949152542372,1.7796610169491525
2609,Sandro Tonali,ITA,MF,Newcastle Utd,Premier League,23,2000,4.9,7,7,4,2,1,3,9,33.3,6,3,0,3,2,9,4,0,0,2023-2024,0.4081632653061224,1.4285714285714284
2610,Ivan Toney,ENG,FW,Brentford,Premier League,27,1996,16.1,15,5,2,7,6,6,14,42.9,8,5,1,4,10,25,18,0,0,2023-2024,0.6211180124223602,0.9316770186335402
2611,Pablo Torre,ESP,"MF,FW",Girona,La Liga,20,2003,7.8,5,2,0,5,0,4,10,40.0,6,10,2,8,4,9,6,1,0,2023-2024,0.5128205128205129,0.6410256410256411
2612,Raúl Torrente,ESP,DF,Granada,La Liga,21,2001,13.9,29,16,20,9,0,17,22,77.3,5,16,10,6,11,40,68,2,0,2023-2024,0.7913669064748201,2.0863309352517985
2613,Ferrán Torres,ESP,FW,Barcelona,La Liga,23,2000,13.5,9,6,1,6,2,5,16,31.3,11,7,1,6,5,14,6,0,0,2023-2024,0.37037037037037035,0.6666666666666666
2614,Óliver Torres,ESP,MF,Sevilla,La Liga,28,1994,18.0,37,22,17,15,5,22,57,38.6,35,40,4,36,6,43,6,0,0,2023-2024,0.3333333333333333,2.0555555555555554
2615,Pau Torres,ESP,DF,Aston Villa,Premier League,26,1997,27.4,29,18,17,11,1,14,30,46.7,16,28,12,16,14,43,75,0,0,2023-2024,0.5109489051094891,1.0583941605839418
2616,Lucas Torró,ESP,MF,Osasuna,La Liga,29,1994,19.9,25,15,11,8,6,11,28,39.3,17,10,2,8,33,58,37,0,0,2023-2024,1.6582914572864322,1.256281407035176
2617,Fabio Torsiello,ITA,"FW,DF",Darmstadt 98,Bundesliga,18,2005,1.7,1,0,1,0,0,1,8,12.5,7,1,0,1,1,2,1,0,0,2023-2024,0.5882352941176471,0.5882352941176471
2618,Ahmed Touba,ALG,DF,Lecce,Serie A,25,1998,3.1,6,4,3,3,0,3,4,75.0,1,4,3,1,7,13,20,0,0,2023-2024,2.258064516129032,1.9354838709677418
2619,Abdoulaye Touré,GUI,MF,Le Havre,Ligue 1,29,1994,25.4,47,28,22,22,3,30,60,50.0,30,30,8,22,25,72,33,0,0,2023-2024,0.984251968503937,1.8503937007874016
2620,Souleymane Touré,FRA,DF,Lorient,Ligue 1,20,2003,22.8,25,12,16,9,0,8,14,57.1,6,38,20,18,36,61,101,2,0,2023-2024,1.5789473684210527,1.0964912280701753
2621,Lucas Tousart,FRA,MF,Union Berlin,Bundesliga,26,1997,17.5,35,20,14,17,4,17,37,45.9,20,32,9,23,25,60,41,0,0,2023-2024,1.4285714285714286,2.0
2622,Andros Townsend,ENG,"MF,FW",Luton Town,Premier League,32,1991,13.4,21,13,11,2,8,13,27,48.1,14,12,0,12,5,26,10,0,0,2023-2024,0.3731343283582089,1.5671641791044775
2623,James Trafford,ENG,GK,Burnley,Premier League,20,2002,28.0,2,1,2,0,0,2,2,100.0,0,0,0,0,1,3,18,1,0,2023-2024,0.03571428571428571,0.07142857142857142
2624,Adama Traoré,ESP,"FW,MF",Fulham,Premier League,27,1996,4.2,4,3,1,2,1,3,6,50.0,3,2,0,2,1,5,2,0,0,2023-2024,0.23809523809523808,0.9523809523809523
2625,Bertrand Traoré,BFA,"DF,FW",Aston Villa,Premier League,27,1995,0.1,1,1,1,0,0,0,0,0.0,0,0,0,0,0,1,1,0,0,2023-2024,0.0,10.0
Rk,Player,Nation,Pos,Squad,Comp,0,0,90.0,0,0,3,3,3,Tkl,0,0.0,0,0,0,0,0,0,0,0,0,2023-2024,0.0,0.0
2626,Bertrand Traoré,BFA,MF,Villarreal,La Liga,27,1995,6.3,5,4,2,1,2,1,4,25.0,3,6,0,6,1,6,2,0,0,2023-2024,0.15873015873015872,0.7936507936507937
2627,Boubacar Traoré,MLI,MF,Wolves,Premier League,21,2001,9.1,35,23,16,17,2,9,21,42.9,12,12,2,10,5,40,7,0,0,2023-2024,0.5494505494505495,3.8461538461538463
2628,Chaka Traorè,CIV,FW,Milan,Serie A,18,2004,0.2,2,1,2,0,0,1,2,50.0,1,1,1,0,0,2,0,0,0,2023-2024,0.0,10.0
2629,Daouda Traoré,FRA,MF,Nice,Ligue 1,17,2006,0.2,0,0,0,0,0,0,0,0.0,0,0,0,0,0,0,0,0,0,2023-2024,0.0,0.0
2630,Hamari Traoré,MLI,DF,Real Sociedad,La Liga,31,1992,25.5,44,19,24,17,3,25,43,58.1,18,27,8,19,24,68,59,2,0,2023-2024,0.9411764705882353,1.7254901960784315
2631,Ismaël Traoré,CIV,DF,Metz,Ligue 1,36,1986,24.7,19,12,13,6,0,8,21,38.1,13,33,20,13,30,49,86,0,0,2023-2024,1.2145748987854252,0.7692307692307693
2632,Omar Traoré,GER,DF,Heidenheim,Bundesliga,25,1998,27.5,60,33,33,21,6,32,56,57.1,24,32,7,25,40,100,54,1,0,2023-2024,1.4545454545454546,2.1818181818181817
2633,Kevin Trapp,GER,GK,Eint Frankfurt,Bundesliga,33,1990,32.0,0,0,0,0,0,0,0,0.0,0,0,0,0,1,1,9,1,0,2023-2024,0.03125,0.0
2634,Mark Travers,IRL,GK,Bournemouth,Premier League,24,1999,4.0,0,0,0,0,0,0,0,0.0,0,0,0,0,0,0,2,0,0,2023-2024,0.0,0.0
2635,Óscar Trejo,ARG,"FW,MF",Rayo Vallecano,La Liga,35,1988,15.3,27,15,11,9,7,13,21,61.9,8,21,1,20,5,32,9,0,0,2023-2024,0.32679738562091504,1.7647058823529411
2636,Mike Trésor,BEL,"FW,MF",Burnley,Premier League,24,1999,4.7,10,6,9,1,0,8,18,44.4,10,5,0,5,1,11,1,0,0,2023-2024,0.2127659574468085,2.127659574468085
2637,Manu Trigueros,ESP,MF,Villarreal,La Liga,31,1991,3.4,7,5,6,1,0,4,10,40.0,6,1,1,0,3,10,9,0,0,2023-2024,0.8823529411764706,2.058823529411765
2638,Christopher Trimmel,AUT,DF,Union Berlin,Bundesliga,36,1987,18.3,23,15,12,10,1,13,33,39.4,20,16,3,13,13,36,57,0,0,2023-2024,0.7103825136612022,1.256830601092896
2639,Kieran Trippier,ENG,DF,Newcastle Utd,Premier League,32,1990,24.8,57,27,30,16,11,37,77,48.1,40,41,8,33,24,81,57,3,0,2023-2024,0.9677419354838709,2.2983870967741935
2640,Leandro Trossard,BEL,"FW,MF",Arsenal,Premier League,28,1994,18.3,27,16,8,9,10,9,25,36.0,16,27,1,26,8,35,6,0,0,2023-2024,0.4371584699453552,1.4754098360655736
2641,Adrien Truffert,FRA,DF,Rennes,Ligue 1,21,2001,23.8,39,21,23,10,6,25,40,62.5,15,31,5,26,19,58,49,0,0,2023-2024,0.7983193277310924,1.638655462184874
2642,Auston Trusty,USA,DF,Sheffield Utd,Premier League,24,1998,28.6,47,30,31,13,3,21,43,48.8,22,41,22,19,35,82,153,3,0,2023-2024,1.2237762237762237,1.6433566433566433
2643,Kostas Tsimikas,GRE,DF,Liverpool,Premier League,27,1996,7.5,19,13,9,6,4,9,15,60.0,6,9,1,8,6,25,10,0,0,2023-2024,0.8,2.533333333333333
2644,Viktor Tsyhankov,UKR,"MF,FW",Girona,La Liga,25,1997,22.8,29,20,11,13,5,14,26,53.8,12,18,1,17,12,41,24,0,0,2023-2024,0.5263157894736842,1.2719298245614035
2645,Stefano Turati,ITA,GK,Frosinone,Serie A,21,2001,30.5,0,0,0,0,0,0,0,0.0,0,0,0,0,0,0,6,3,0,2023-2024,0.0,0.0
2646,Matt Turner,USA,GK,Nott'ham Forest,Premier League,29,1994,17.0,0,0,0,0,0,0,0,0.0,0,0,0,0,0,0,8,4,0,2023-2024,0.0,0.0
2647,Beñat Turrientes,ESP,MF,Real Sociedad,La Liga,21,2002,18.7,31,17,6,20,5,13,30,43.3,17,19,8,11,6,37,17,0,0,2023-2024,0.32085561497326204,1.6577540106951871
2648,Tuta,BRA,DF,Eint Frankfurt,Bundesliga,24,1999,28.9,63,33,38,19,6,39,59,66.1,20,29,12,17,36,99,99,0,0,2023-2024,1.245674740484429,2.179930795847751
2649,Destiny Udogie,ITA,DF,Tottenham,Premier League,20,2002,26.6,68,33,41,16,11,27,49,55.1,22,27,8,19,37,105,80,5,0,2023-2024,1.3909774436090225,2.556390977443609
2650,Matthieu Udol,FRA,DF,Metz,Ligue 1,27,1996,30.0,55,37,38,12,5,38,56,67.9,18,62,16,46,50,105,108,0,0,2023-2024,1.6666666666666667,1.8333333333333333
Rk,Player,Nation,Pos,Squad,Comp,0,0,90.0,0,0,3,3,3,Tkl,0,0.0,0,0,0,0,0,0,0,0,0,2023-2024,0.0,0.0
2651,Manuel Ugarte Ribeiro,URU,MF,Paris S-G,Ligue 1,22,2001,21.5,98,57,39,43,16,43,89,48.3,46,27,6,21,40,138,25,2,0,2023-2024,1.8604651162790697,4.558139534883721
2652,Lesley Ugochukwu,FRA,MF,Chelsea,Premier League,19,2004,3.3,14,10,4,8,2,4,10,40.0,6,6,2,4,1,15,5,0,0,2023-2024,0.30303030303030304,4.242424242424242
2653,Lukas Ullrich,GER,"DF,FW",Gladbach,Bundesliga,19,2004,0.5,1,0,1,0,0,1,4,25.0,3,0,0,0,0,1,1,0,0,2023-2024,0.0,2.0
2654,Sven Ulreich,GER,GK,Bayern Munich,Bundesliga,34,1988,11.0,1,0,1,0,0,1,1,100.0,0,0,0,0,0,1,3,2,0,2023-2024,0.0,0.09090909090909091
2655,Samuel Umtiti,FRA,DF,Lille,Ligue 1,29,1993,2.1,1,1,0,1,0,1,4,25.0,3,0,0,0,2,3,4,0,0,2023-2024,0.9523809523809523,0.47619047619047616
2656,Enes Ünal,TUR,"FW,MF",Bournemouth,Premier League,26,1997,3.6,6,4,2,3,1,2,5,40.0,3,4,2,2,1,7,6,0,0,2023-2024,0.2777777777777778,1.6666666666666665
2657,Enes Ünal,TUR,"FW,MF",Getafe,La Liga,26,1997,1.6,0,0,0,0,0,0,0,0.0,0,1,0,1,0,0,2,0,0,2023-2024,0.0,0.0
2658,Deniz Undav,GER,"FW,MF",Stuttgart,Bundesliga,27,1996,23.2,28,13,6,8,14,4,15,26.7,11,17,0,17,6,34,5,0,0,2023-2024,0.25862068965517243,1.206896551724138
2659,Dayot Upamecano,FRA,DF,Bayern Munich,Bundesliga,24,1998,19.6,34,21,21,11,2,15,29,51.7,14,19,7,12,19,53,56,3,0,2023-2024,0.9693877551020408,1.7346938775510203
2660,Kacper Urbanski,POL,"MF,FW",Bologna,Serie A,18,2004,10.3,16,10,5,10,1,6,13,46.2,7,15,1,14,4,20,14,0,0,2023-2024,0.3883495145631068,1.5533980582524272
2661,Mark Uth,GER,"MF,FW",Köln,Bundesliga,31,1991,4.1,8,4,2,3,3,4,12,33.3,8,6,0,6,1,9,2,0,0,2023-2024,0.24390243902439027,1.9512195121951221
2662,Myrto Uzuni,ALB,FW,Granada,La Liga,28,1995,27.2,18,14,8,7,3,6,27,22.2,21,19,3,16,4,22,7,0,0,2023-2024,0.14705882352941177,0.6617647058823529
2663,Josha Vagnoman,GER,DF,Stuttgart,Bundesliga,22,2000,13.1,28,18,15,11,2,15,30,50.0,15,11,5,6,2,30,16,1,0,2023-2024,0.15267175572519084,2.1374045801526718
2664,Óscar Valentín,ESP,MF,Rayo Vallecano,La Liga,28,1994,29.9,107,66,39,62,6,46,101,45.5,55,62,10,52,35,142,52,1,0,2023-2024,1.1705685618729098,3.578595317725753
2665,Emanuele Valeri,ITA,DF,Frosinone,Serie A,24,1998,13.1,19,16,10,5,4,10,21,47.6,11,14,3,11,9,28,22,0,0,2023-2024,0.6870229007633588,1.450381679389313
2666,Martin Valjent,SVK,DF,Mallorca,La Liga,27,1995,26.1,34,18,19,13,2,18,30,60.0,12,26,11,15,29,63,112,1,0,2023-2024,1.1111111111111112,1.3026819923371646
2667,Jesús Vallejo,ESP,DF,Granada,La Liga,26,1997,1.2,3,1,1,2,0,2,2,100.0,0,3,2,1,0,3,1,1,0,2023-2024,0.0,2.5
2668,Álvaro Vallés,ESP,GK,Las Palmas,La Liga,26,1997,36.3,3,2,3,0,0,3,8,37.5,5,0,0,0,0,3,40,1,0,2023-2024,0.0,0.08264462809917356
2669,Federico Valverde,URU,MF,Real Madrid,La Liga,25,1998,32.3,47,34,22,13,12,24,42,57.1,18,39,2,37,43,90,40,0,0,2023-2024,1.3312693498452013,1.455108359133127
2670,Kévin Van Den Kerkhof,ALG,"FW,MF",Metz,Ligue 1,27,1996,21.3,31,24,11,13,7,13,32,40.6,19,15,2,13,11,42,32,1,0,2023-2024,0.5164319248826291,1.4553990610328638
2671,Siebe Van Der Heyden,BEL,DF,Mallorca,La Liga,25,1998,3.2,9,2,7,2,0,4,6,66.7,2,1,1,0,7,16,12,0,0,2023-2024,2.1875,2.8125
2672,Virgil van Dijk,NED,DF,Liverpool,Premier League,32,1991,35.3,40,23,24,13,3,12,14,85.7,2,47,34,13,39,79,144,0,0,2023-2024,1.104815864022663,1.13314447592068
2673,Vanderson,BRA,DF,Monaco,Ligue 1,22,2001,18.2,60,41,20,30,10,32,70,45.7,38,29,2,27,35,95,37,1,0,2023-2024,1.9230769230769231,3.296703296703297
2674,Raphaël Varane,FRA,DF,Manchester Utd,Premier League,30,1993,15.3,18,11,10,7,1,10,14,71.4,4,23,18,5,15,33,88,0,0,2023-2024,0.9803921568627451,1.1764705882352942
2675,Ruben Vargas,SUI,"MF,FW",Augsburg,Bundesliga,24,1998,21.8,23,10,6,10,7,10,25,40.0,15,19,4,15,7,30,17,0,0,2023-2024,0.3211009174311926,1.055045871559633
Rk,Player,Nation,Pos,Squad,Comp,0,0,90.0,0,0,3,3,3,Tkl,0,0.0,0,0,0,0,0,0,0,0,0,2023-2024,0.0,0.0
2676,Johan Vásquez,MEX,DF,Genoa,Serie A,24,1998,31.7,51,33,38,11,2,32,50,64.0,18,50,26,24,45,96,113,0,0,2023-2024,1.4195583596214512,1.608832807570978
2677,José Luis García Vayá,ESP,MF,Valencia,La Liga,24,1998,36.7,78,53,36,36,6,37,71,52.1,34,41,10,31,49,127,71,0,0,2023-2024,1.335149863760218,2.1253405994550407
2678,Borja Vázquez,ESP,FW,Cádiz,La Liga,18,2005,0.0,1,0,1,0,0,1,1,100.0,0,0,0,0,0,1,1,0,0,2023-2024,,inf
2679,Jesus Vazquez,ESP,"DF,MF",Valencia,La Liga,20,2003,8.0,24,12,13,8,3,10,16,62.5,6,17,4,13,3,27,24,0,0,2023-2024,0.375,3.0
2680,Kevin Vázquez,ESP,DF,Celta Vigo,La Liga,30,1993,7.8,15,13,7,7,1,12,21,57.1,9,11,3,8,5,20,25,0,0,2023-2024,0.6410256410256411,1.9230769230769231
2681,Lucas Vázquez,ESP,DF,Real Madrid,La Liga,32,1991,15.8,37,25,22,14,1,18,25,72.0,7,27,5,22,12,49,36,0,0,2023-2024,0.7594936708860759,2.3417721518987342
2682,Matías Vecino,URU,MF,Lazio,Serie A,31,1991,12.8,32,17,12,20,0,20,31,64.5,11,17,5,12,12,44,21,0,0,2023-2024,0.9375,2.5
2683,Gabriel Veiga,ESP,FW,Celta Vigo,La Liga,21,2002,0.2,0,0,0,0,0,0,0,0.0,0,0,0,0,0,0,0,0,0,2023-2024,0.0,0.0
2684,Alejo Véliz,ARG,FW,Tottenham,Premier League,19,2003,0.6,1,0,1,0,0,0,0,0.0,0,0,0,0,0,1,0,0,0,2023-2024,0.0,1.6666666666666667
2685,Alejo Véliz,ARG,FW,Sevilla,La Liga,19,2003,0.4,1,0,0,1,0,1,2,50.0,1,0,0,0,0,1,1,0,0,2023-2024,0.0,2.5
2686,Miloš Veljković,SRB,DF,Werder Bremen,Bundesliga,27,1995,21.3,31,15,17,13,1,16,31,51.6,15,31,20,11,17,48,57,0,0,2023-2024,0.7981220657276995,1.4553990610328638
2687,Joël Veltman,NED,DF,Brighton,Premier League,31,1992,17.6,54,41,32,17,5,39,58,67.2,19,17,7,10,18,72,57,1,0,2023-2024,1.0227272727272727,3.068181818181818
2688,Micky van de Ven,NED,DF,Tottenham,Premier League,22,2001,26.0,49,35,34,12,3,24,33,72.7,9,25,15,10,18,67,78,1,0,2023-2024,0.6923076923076923,1.8846153846153846
2689,Lorenzo Venuti,ITA,DF,Lecce,Serie A,28,1995,4.0,6,4,5,1,0,6,10,60.0,4,4,3,1,5,11,14,0,0,2023-2024,1.25,1.5
2690,Bart Verbruggen,NED,GK,Brighton,Premier League,20,2002,21.0,1,1,1,0,0,1,2,50.0,1,0,0,0,0,1,11,3,0,2023-2024,0.0,0.047619047619047616
2691,Simone Verdi,ITA,FW,Torino,Serie A,31,1992,0.0,0,0,0,0,0,0,0,0.0,0,0,0,0,0,0,0,0,0,2023-2024,,
2692,Jordan Veretout,FRA,MF,Marseille,Ligue 1,30,1993,24.3,38,22,19,13,6,18,39,46.2,21,20,4,16,13,51,25,0,0,2023-2024,0.5349794238683128,1.5637860082304527
2693,Arthur Vermeeren,BEL,MF,Atlético Madrid,La Liga,18,2005,1.8,1,0,0,1,0,0,1,0.0,1,5,0,5,6,7,2,0,0,2023-2024,3.333333333333333,0.5555555555555556
2694,Yorbe Vertessen,BEL,"FW,MF",Union Berlin,Bundesliga,22,2001,6.6,3,2,0,3,0,1,4,25.0,3,8,0,8,1,4,3,0,0,2023-2024,0.15151515151515152,0.4545454545454546
2695,Mikel Vesga,ESP,MF,Athletic Club,La Liga,30,1993,17.0,40,20,11,23,6,19,49,38.8,30,19,7,12,32,72,35,1,0,2023-2024,1.8823529411764706,2.3529411764705883
2696,Guglielmo Vicario,ITA,GK,Tottenham,Premier League,26,1996,38.0,0,0,0,0,0,0,1,0.0,1,0,0,0,1,1,31,2,0,2023-2024,0.02631578947368421,0.0
2697,Carlos Vicente,ESP,FW,Alavés,La Liga,24,1999,12.4,16,6,7,7,2,10,25,40.0,15,4,0,4,4,20,9,0,0,2023-2024,0.3225806451612903,1.2903225806451613
2698,Nacho Vidal,ESP,"DF,FW",Osasuna,La Liga,28,1995,1.1,5,4,2,2,1,2,5,40.0,3,2,0,2,0,5,6,0,0,2023-2024,0.0,4.545454545454545
2699,Nacho Vidal,ESP,DF,Mallorca,La Liga,28,1995,4.6,12,5,4,5,3,6,13,46.2,7,5,2,3,3,15,9,0,0,2023-2024,0.6521739130434783,2.608695652173913
2700,Fabio Vieira,POR,"MF,FW",Arsenal,Premier League,23,2000,3.3,3,2,2,0,1,3,3,100.0,0,0,0,0,2,5,2,0,0,2023-2024,0.6060606060606061,0.9090909090909092
Rk,Player,Nation,Pos,Squad,Comp,0,0,90.0,0,0,3,3,3,Tkl,0,0.0,0,0,0,0,0,0,0,0,0,2023-2024,0.0,0.0
2701,Fran Vieites,ESP,GK,Betis,La Liga,24,1999,3.5,1,0,1,0,0,1,1,100.0,0,0,0,0,0,1,2,1,0,2023-2024,0.0,0.2857142857142857
2702,Jonathan Viera,ESP,"MF,FW",Las Palmas,La Liga,33,1989,6.9,6,3,1,2,3,1,9,11.1,8,0,0,0,0,6,1,0,0,2023-2024,0.0,0.8695652173913043
2703,Jonathan Viera,ESP,MF,Almería,La Liga,33,1989,10.1,19,9,6,9,4,10,19,52.6,9,4,0,4,4,23,1,0,0,2023-2024,0.39603960396039606,1.8811881188118813
2704,Emanuel Vignato,ITA,"MF,FW",Salernitana,Serie A,22,2000,3.5,10,7,4,5,1,5,6,83.3,1,1,0,1,1,11,7,0,0,2023-2024,0.2857142857142857,2.857142857142857
2705,Samuele Vignato,ITA,"MF,FW",Monza,Serie A,19,2004,3.8,6,4,2,3,1,2,3,66.7,1,2,0,2,1,7,1,0,0,2023-2024,0.2631578947368421,1.5789473684210527
2706,Oscar Vilhelmsson,SWE,"FW,MF",Darmstadt 98,Bundesliga,19,2003,15.3,13,6,3,7,3,7,10,70.0,3,15,5,10,3,16,19,0,0,2023-2024,0.19607843137254902,0.8496732026143791
2707,Toni Villa,ESP,FW,Girona,La Liga,28,1995,0.1,0,0,0,0,0,0,0,0.0,0,0,0,0,0,0,0,0,0,2023-2024,0.0,0.0
2708,Asier Villalibre,ESP,FW,Athletic Club,La Liga,25,1997,5.7,2,1,0,0,2,2,2,100.0,0,2,1,1,0,2,6,0,0,2023-2024,0.0,0.3508771929824561
2709,Gonzalo Villar,ESP,MF,Granada,La Liga,25,1998,20.0,51,33,26,20,5,26,41,63.4,15,32,10,22,6,57,26,1,0,2023-2024,0.3,2.55
2710,Iván Villar,ESP,GK,Celta Vigo,La Liga,26,1997,11.3,0,0,0,0,0,0,1,0.0,1,0,0,0,0,0,6,0,0,2023-2024,0.0,0.0
2711,Matías Viña,URU,DF,Sassuolo,Serie A,25,1997,11.3,34,21,22,7,5,20,36,55.6,16,12,2,10,9,43,34,0,0,2023-2024,0.7964601769911503,3.0088495575221237
2712,Rúben Vinagre,POR,"DF,FW",Hellas Verona,Serie A,24,1999,3.1,4,2,1,1,2,3,4,75.0,1,6,3,3,1,5,4,0,0,2023-2024,0.3225806451612903,1.2903225806451613
2713,Carlos Vinícius,BRA,FW,Fulham,Premier League,28,1995,3.5,3,2,0,1,2,0,4,0.0,4,4,0,4,0,3,1,0,0,2023-2024,0.0,0.8571428571428571
2714,Nicolas Viola,ITA,"MF,FW",Cagliari,Serie A,33,1989,13.4,13,9,2,8,3,7,17,41.2,10,9,0,9,2,15,6,0,0,2023-2024,0.14925373134328357,0.9701492537313433
2715,Alan Virginius,FRA,FW,Lille,Ligue 1,20,2003,0.8,1,1,1,0,0,0,1,0.0,1,0,0,0,0,1,0,0,0,2023-2024,0.0,1.25
2716,Alan Virginius,FRA,FW,Clermont Foot,Ligue 1,20,2003,10.4,9,5,4,4,1,4,11,36.4,7,7,0,7,3,12,7,0,0,2023-2024,0.28846153846153844,0.8653846153846153
2717,Ricardo Visus,ESP,DF,Betis,La Liga,22,2001,1.8,2,2,1,1,0,2,2,100.0,0,2,2,0,2,4,9,1,0,2023-2024,1.1111111111111112,1.1111111111111112
2718,Mattia Viti,ITA,DF,Sassuolo,Serie A,21,2002,10.9,24,15,14,7,3,10,22,45.5,12,20,10,10,10,34,44,0,0,2023-2024,0.9174311926605504,2.2018348623853212
2719,Vitinha,POR,"FW,MF",Genoa,Serie A,23,2000,3.2,2,2,1,0,1,1,2,50.0,1,2,0,2,0,2,2,0,0,2023-2024,0.0,0.625
2720,Vitinha,POR,FW,Marseille,Ligue 1,23,2000,10.3,14,8,3,5,6,3,12,25.0,9,11,2,9,5,19,8,0,0,2023-2024,0.48543689320388345,1.3592233009708736
2721,Vitinha,POR,MF,Paris S-G,Ligue 1,23,2000,23.6,39,24,12,16,11,16,48,33.3,32,29,11,18,23,62,30,2,0,2023-2024,0.9745762711864406,1.6525423728813557
2722,Vitinho,BRA,"DF,MF",Burnley,Premier League,24,1999,25.7,64,34,36,22,6,43,86,50.0,43,44,6,38,12,76,47,4,0,2023-2024,0.4669260700389105,2.490272373540856
2723,Daniel Vivian,ESP,DF,Athletic Club,La Liga,24,1999,32.0,42,28,29,11,2,28,45,62.2,17,49,25,24,31,73,104,0,0,2023-2024,0.96875,1.3125
2724,Odisseas Vlachodimos,GRE,GK,Nott'ham Forest,Premier League,29,1994,5.0,0,0,0,0,0,0,1,0.0,1,0,0,0,0,0,1,0,0,2023-2024,0.0,0.0
2725,Dušan Vlahović,SRB,FW,Juventus,Serie A,23,2000,25.6,9,5,0,6,3,4,11,36.4,7,4,2,2,1,10,11,0,0,2023-2024,0.0390625,0.3515625
Rk,Player,Nation,Pos,Squad,Comp,0,0,90.0,0,0,3,3,3,Tkl,0,0.0,0,0,0,0,0,0,0,0,0,2023-2024,0.0,0.0
2726,Nikola Vlašić,CRO,"MF,FW",Torino,Serie A,25,1997,29.0,28,16,6,14,8,4,30,13.3,26,26,7,19,11,39,16,0,0,2023-2024,0.3793103448275862,0.9655172413793104
2727,Alessandro Vogliacco,ITA,DF,Genoa,Serie A,24,1998,13.0,23,15,14,8,1,12,15,80.0,3,16,10,6,30,53,40,1,0,2023-2024,2.3076923076923075,1.7692307692307692
2728,Kevin Vogt,GER,DF,Hoffenheim,Bundesliga,31,1991,14.7,14,10,7,7,0,8,13,61.5,5,16,13,3,9,23,54,0,0,2023-2024,0.6122448979591837,0.9523809523809524
2729,Kevin Vogt,GER,DF,Union Berlin,Bundesliga,31,1991,14.7,10,9,6,4,0,6,12,50.0,6,22,15,7,7,17,72,2,0,2023-2024,0.4761904761904762,0.6802721088435374
2730,Mërgim Vojvoda,KVX,DF,Torino,Serie A,28,1995,15.3,17,8,7,6,4,11,16,68.8,5,12,2,10,13,30,28,0,0,2023-2024,0.8496732026143791,1.1111111111111112
2731,Kevin Volland,GER,"FW,MF",Union Berlin,Bundesliga,31,1992,14.9,22,9,8,8,6,8,20,40.0,12,8,0,8,6,28,12,0,0,2023-2024,0.40268456375838924,1.4765100671140938
2732,Cristian Volpato,ITA,"MF,FW",Sassuolo,Serie A,19,2003,7.2,16,8,9,6,1,9,25,36.0,16,7,0,7,1,17,5,0,0,2023-2024,0.1388888888888889,2.2222222222222223
2733,Aster Vranckx,BEL,MF,Wolfsburg,Bundesliga,20,2002,12.8,32,15,11,11,10,15,28,53.6,13,17,6,11,14,46,29,0,0,2023-2024,1.09375,2.5
2734,Stefan de Vrij,NED,DF,Inter,Serie A,31,1992,17.6,18,13,13,4,1,8,15,53.3,7,22,10,12,24,42,51,0,0,2023-2024,1.3636363636363635,1.0227272727272727
2735,Elye Wahi,FRA,FW,Montpellier,Ligue 1,20,2003,0.2,0,0,0,0,0,0,0,0.0,0,0,0,0,0,0,0,0,0,2023-2024,0.0,0.0
2736,Elye Wahi,FRA,FW,Lens,Ligue 1,20,2003,18.8,6,4,1,3,2,2,10,20.0,8,5,1,4,3,9,3,0,0,2023-2024,0.15957446808510636,0.3191489361702127
2737,Walace,BRA,MF,Udinese,Serie A,28,1995,36.0,66,43,40,26,0,36,77,46.8,41,43,6,37,43,109,66,1,0,2023-2024,1.1944444444444444,1.8333333333333333
2738,Luca Waldschmidt,GER,"MF,FW",Köln,Bundesliga,27,1996,12.7,19,12,4,12,3,5,16,31.3,11,18,3,15,6,25,8,1,0,2023-2024,0.4724409448818898,1.4960629921259843
2739,Kyle Walker,ENG,DF,Manchester City,Premier League,33,1990,30.7,38,24,19,17,2,19,39,48.7,20,19,6,13,27,65,40,1,0,2023-2024,0.8794788273615636,1.237785016286645
2740,Sebastian Walukiewicz,POL,DF,Empoli,Serie A,23,2000,22.8,39,28,33,6,0,28,41,68.3,13,50,31,19,15,54,121,0,0,2023-2024,0.6578947368421052,1.7105263157894737
2741,Aaron Wan-Bissaka,ENG,DF,Manchester Utd,Premier League,25,1997,19.8,42,25,18,20,4,19,26,73.1,7,29,15,14,41,83,68,1,0,2023-2024,2.0707070707070705,2.121212121212121
2742,Joel Ward,ENG,DF,Crystal Palace,Premier League,33,1989,22.0,45,28,26,18,1,30,47,63.8,17,17,10,7,14,59,94,1,0,2023-2024,0.6363636363636364,2.0454545454545454
2743,James Ward-Prowse,ENG,MF,West Ham,Premier League,28,1994,33.3,45,29,14,23,8,18,44,40.9,26,31,9,22,38,83,49,0,0,2023-2024,1.1411411411411412,1.3513513513513515
2744,Lewis Warrington,ENG,FW,Everton,Premier League,20,2002,0.0,0,0,0,0,0,0,0,0.0,0,0,0,0,0,0,0,0,0,2023-2024,,
2745,Deivid Washington,BRA,"DF,FW",Chelsea,Premier League,18,2005,0.1,1,1,1,0,0,0,1,0.0,1,0,0,0,0,1,0,0,0,2023-2024,0.0,10.0
2746,Kjell-Arik Wätjen,GER,"MF,FW",Dortmund,Bundesliga,17,2006,1.2,3,2,2,1,0,2,5,40.0,3,1,1,0,0,3,3,0,0,2023-2024,0.0,2.5
2747,Ollie Watkins,ENG,FW,Aston Villa,Premier League,27,1995,35.7,12,7,0,5,7,5,11,45.5,6,26,4,22,4,16,20,0,0,2023-2024,0.11204481792717086,0.3361344537815126
2748,Timothy Weah,USA,"DF,FW",Juventus,Serie A,23,2000,14.0,27,20,16,8,3,15,20,75.0,5,12,1,11,5,32,15,0,0,2023-2024,0.35714285714285715,1.9285714285714286
2749,Adam Webster,ENG,DF,Brighton,Premier League,28,1995,12.7,14,12,8,5,1,6,18,33.3,12,16,12,4,16,30,43,1,0,2023-2024,1.2598425196850394,1.1023622047244095
2750,Wout Weghorst,NED,FW,Hoffenheim,Bundesliga,30,1992,22.0,13,6,4,7,2,9,15,60.0,6,25,8,17,6,19,24,0,0,2023-2024,0.2727272727272727,0.5909090909090909
Rk,Player,Nation,Pos,Squad,Comp,0,0,90.0,0,0,3,3,3,Tkl,0,0.0,0,0,0,0,0,0,0,0,0,2023-2024,0.0,0.0
2751,Julian Weigl,GER,MF,Gladbach,Bundesliga,27,1995,30.7,66,40,28,32,6,41,67,61.2,26,47,14,33,48,114,61,1,0,2023-2024,1.5635179153094463,2.1498371335504887
2752,Nelson Weiper,GER,"FW,MF",Mainz 05,Bundesliga,18,2005,1.4,2,1,2,0,0,2,3,66.7,1,1,0,1,1,3,0,0,0,2023-2024,0.7142857142857143,1.4285714285714286
2753,Mitchell Weiser,GER,"DF,MF",Werder Bremen,Bundesliga,29,1994,29.3,64,38,29,25,10,31,53,58.5,22,36,6,30,20,84,43,0,0,2023-2024,0.68259385665529,2.1843003412969284
2754,Noah Weißhaupt,GER,"DF,FW",Freiburg,Bundesliga,21,2001,8.4,9,4,6,0,3,5,11,45.5,6,8,1,7,8,17,12,0,0,2023-2024,0.9523809523809523,1.0714285714285714
2755,Shon Weissman,ISR,"FW,DF",Salernitana,Serie A,27,1996,5.5,4,3,2,0,2,0,4,0.0,4,2,1,1,3,7,4,0,0,2023-2024,0.5454545454545454,0.7272727272727273
2756,Shon Weissman,ISR,FW,Granada,La Liga,27,1996,0.9,1,1,0,0,1,1,4,25.0,3,3,0,3,0,1,1,0,0,2023-2024,0.0,1.1111111111111112
2757,Danny Welbeck,ENG,"FW,MF",Brighton,Premier League,32,1990,18.8,35,17,9,17,9,10,17,58.8,7,12,0,12,9,44,17,1,0,2023-2024,0.4787234042553191,1.8617021276595744
2758,Timo Werner,GER,FW,Tottenham,Premier League,27,1996,9.0,7,4,3,4,0,5,18,27.8,13,12,0,12,3,10,2,0,0,2023-2024,0.3333333333333333,0.7777777777777778
2759,Timo Werner,GER,"FW,MF",RB Leipzig,Bundesliga,27,1996,2.3,2,1,0,1,1,0,0,0.0,0,1,0,1,1,3,0,0,0,2023-2024,0.4347826086956522,0.8695652173913044
2760,Adam Wharton,ENG,MF,Crystal Palace,Premier League,19,2004,14.4,48,32,18,22,8,23,46,50.0,23,17,3,14,20,68,24,1,0,2023-2024,1.3888888888888888,3.333333333333333
2761,Ethan Wheatley,ENG,FW,Manchester Utd,Premier League,17,2006,0.2,1,1,0,1,0,1,1,100.0,0,2,0,2,2,3,0,0,0,2023-2024,10.0,5.0
2762,Ben White,ENG,DF,Arsenal,Premier League,25,1997,33.2,48,28,20,22,6,26,58,44.8,32,48,22,26,32,80,77,1,0,2023-2024,0.9638554216867469,1.4457831325301203
2763,Joe White,ENG,MF,Newcastle Utd,Premier League,20,2002,0.1,1,1,1,0,0,0,0,0.0,0,0,0,0,0,1,0,0,0,2023-2024,0.0,10.0
2764,Silvan Widmer,SUI,DF,Mainz 05,Bundesliga,30,1993,13.8,23,10,12,8,3,17,28,60.7,11,18,5,13,16,39,37,0,0,2023-2024,1.1594202898550725,1.6666666666666665
2765,Mateusz Wieteska,POL,DF,Cagliari,Serie A,26,1997,10.7,14,11,9,3,2,3,10,30.0,7,10,5,5,14,28,48,0,0,2023-2024,1.3084112149532712,1.3084112149532712
2766,Mateusz Wieteska,POL,DF,Clermont Foot,Ligue 1,26,1997,1.9,4,1,3,1,0,3,5,60.0,2,4,2,2,5,9,8,0,0,2023-2024,2.6315789473684212,2.1052631578947367
2767,Iñaki Williams,GHA,FW,Athletic Club,La Liga,29,1994,31.6,24,17,6,8,10,13,34,38.2,21,42,8,34,14,38,29,0,0,2023-2024,0.4430379746835443,0.7594936708860759
2768,Neco Williams,WAL,DF,Nott'ham Forest,Premier League,22,2001,18.2,69,40,42,18,9,35,56,62.5,21,44,13,31,22,91,53,0,0,2023-2024,1.208791208791209,3.7912087912087915
2769,Nico Williams,ESP,FW,Athletic Club,La Liga,21,2002,25.1,31,12,9,15,7,13,36,36.1,23,18,2,16,3,34,4,1,0,2023-2024,0.1195219123505976,1.2350597609561753
2770,Willian,BRA,FW,Fulham,Premier League,34,1988,22.8,18,11,6,7,5,3,21,14.3,18,13,0,13,9,27,12,1,0,2023-2024,0.39473684210526316,0.7894736842105263
2771,Joe Willock,ENG,MF,Newcastle Utd,Premier League,23,1999,4.7,13,7,7,6,0,4,11,36.4,7,7,0,7,1,14,1,0,0,2023-2024,0.2127659574468085,2.7659574468085104
2772,Callum Wilson,ENG,FW,Newcastle Utd,Premier League,31,1992,11.0,5,3,0,2,3,0,4,0.0,4,6,0,6,2,7,4,0,0,2023-2024,0.18181818181818182,0.45454545454545453
2773,Harry Wilson,WAL,FW,Fulham,Premier League,26,1997,18.0,21,14,9,8,4,11,28,39.3,17,27,3,24,10,31,12,0,0,2023-2024,0.5555555555555556,1.1666666666666667
2774,Josh Wilson-Esbrand,ENG,"DF,MF",Reims,Ligue 1,20,2002,5.1,5,4,2,3,0,2,8,25.0,6,5,2,3,6,11,7,0,0,2023-2024,1.1764705882352942,0.9803921568627452
2775,Patrick Wimmer,AUT,"FW,MF",Wolfsburg,Bundesliga,22,2001,6.5,14,5,5,5,4,8,18,44.4,10,14,0,14,3,17,7,0,0,2023-2024,0.46153846153846156,2.1538461538461537
Rk,Player,Nation,Pos,Squad,Comp,0,0,90.0,0,0,3,3,3,Tkl,0,0.0,0,0,0,0,0,0,0,0,0,2023-2024,0.0,0.0
2776,Jonas Wind,DEN,FW,Wolfsburg,Bundesliga,24,1999,29.5,13,10,4,6,3,7,17,41.2,10,13,4,9,3,16,21,0,0,2023-2024,0.1016949152542373,0.4406779661016949
2777,Florian Wirtz,GER,MF,Leverkusen,Bundesliga,20,2003,26.4,27,18,7,14,6,9,29,31.0,20,36,2,34,9,36,3,0,0,2023-2024,0.34090909090909094,1.0227272727272727
2778,Yoane Wissa,COD,FW,Brentford,Premier League,26,1996,27.7,28,16,13,10,5,5,20,25.0,15,24,3,21,9,37,15,0,0,2023-2024,0.3249097472924188,1.0108303249097472
2779,Axel Witsel,BEL,DF,Atlético Madrid,La Liga,34,1989,30.9,35,21,23,12,0,17,24,70.8,7,40,21,19,16,51,119,0,0,2023-2024,0.5177993527508091,1.132686084142395
2780,Maximilian Wittek,GER,"DF,FW",Bochum,Bundesliga,27,1995,11.9,23,17,9,11,3,13,21,61.9,8,12,1,11,18,41,23,0,0,2023-2024,1.5126050420168067,1.9327731092436975
2781,Maximilian Wöber,AUT,DF,Gladbach,Bundesliga,25,1998,23.0,66,31,40,25,1,31,53,58.5,22,47,26,21,38,104,111,0,0,2023-2024,1.6521739130434783,2.869565217391304
2782,Marius Wolf,GER,DF,Dortmund,Bundesliga,28,1995,13.0,20,12,8,11,1,11,23,47.8,12,12,2,10,8,28,20,0,0,2023-2024,0.6153846153846154,1.5384615384615385
2783,Nick Woltemade,GER,"FW,MF",Werder Bremen,Bundesliga,21,2002,13.2,34,23,7,20,7,15,21,71.4,6,12,0,12,5,39,17,0,0,2023-2024,0.3787878787878788,2.5757575757575757
2784,Jeong Woo-yeong,KOR,"MF,FW",Stuttgart,Bundesliga,23,1999,7.0,15,9,6,8,1,6,8,75.0,2,5,0,5,7,22,5,0,0,2023-2024,1.0,2.142857142857143
2785,Chris Wood,NZL,FW,Nott'ham Forest,Premier League,31,1991,20.1,7,4,1,4,2,3,9,33.3,6,11,3,8,1,8,26,0,0,2023-2024,0.04975124378109452,0.34825870646766166
2786,Cauley Woodrow,ENG,"FW,MF",Luton Town,Premier League,28,1994,4.7,16,10,8,4,4,9,16,56.3,7,7,1,6,1,17,14,0,0,2023-2024,0.2127659574468085,3.404255319148936
2787,Christopher Wooh,CMR,DF,Rennes,Ligue 1,21,2001,15.4,18,12,12,6,0,8,15,53.3,7,19,9,10,18,36,51,0,0,2023-2024,1.1688311688311688,1.1688311688311688
2788,Joe Worrall,ENG,DF,Nott'ham Forest,Premier League,26,1997,4.9,7,5,6,1,0,3,6,50.0,3,5,4,1,3,10,32,1,0,2023-2024,0.6122448979591836,1.4285714285714284
2789,Xeber,ESP,"FW,MF",Alavés,La Liga,26,1997,3.4,5,5,3,2,0,3,7,42.9,4,2,1,1,1,6,2,0,0,2023-2024,0.29411764705882354,1.4705882352941178
2790,Granit Xhaka,SUI,MF,Leverkusen,Bundesliga,30,1992,31.3,29,21,11,14,4,9,30,30.0,21,29,8,21,19,48,42,0,0,2023-2024,0.6070287539936102,0.926517571884984
2791,Antal Yaakobishvili,HUN,DF,Girona,La Liga,19,2004,0.7,2,1,1,1,0,1,1,100.0,0,0,0,0,3,5,3,0,0,2023-2024,4.285714285714286,2.857142857142857
2792,Lamine Yamal,ESP,FW,Barcelona,La Liga,16,2007,24.5,61,37,32,15,14,18,48,37.5,30,32,0,32,19,80,11,0,0,2023-2024,0.7755102040816326,2.489795918367347
2793,Roman Yaremchuk,UKR,FW,Valencia,La Liga,27,1995,10.3,5,2,1,2,2,3,6,50.0,3,4,0,4,1,6,9,0,0,2023-2024,0.0970873786407767,0.48543689320388345
2794,Yehor Yarmoliuk,UKR,MF,Brentford,Premier League,19,2004,7.6,17,11,6,8,3,7,17,41.2,10,17,4,13,6,23,5,0,0,2023-2024,0.7894736842105263,2.236842105263158
2795,Ryan Yates,ENG,MF,Nott'ham Forest,Premier League,25,1997,22.1,66,39,39,21,6,19,34,55.9,15,42,15,27,21,87,44,1,0,2023-2024,0.9502262443438914,2.9864253393665154
2796,Yusuf Yazıcı,TUR,"MF,FW",Lille,Ligue 1,26,1997,14.6,19,11,6,9,4,4,15,26.7,11,10,1,9,5,24,5,0,0,2023-2024,0.3424657534246575,1.3013698630136987
2797,Kelvin Yeboah,ITA,FW,Montpellier,Ligue 1,23,2000,3.1,4,2,2,2,0,1,3,33.3,2,3,2,1,1,5,3,0,0,2023-2024,0.3225806451612903,1.2903225806451613
2798,Bertuğ Yıldırım,TUR,FW,Rennes,Ligue 1,21,2002,5.2,7,5,2,3,2,3,8,37.5,5,8,0,8,0,7,4,0,0,2023-2024,0.0,1.346153846153846
2799,Kenan Yıldız,TUR,"FW,MF",Juventus,Serie A,18,2005,10.6,13,9,5,6,2,4,8,50.0,4,6,0,6,1,14,4,0,0,2023-2024,0.09433962264150944,1.2264150943396226
2800,Darlin Yongwa,CMR,DF,Lorient,Ligue 1,22,2000,12.9,30,23,17,11,2,14,25,56.0,11,14,2,12,15,45,36,0,0,2023-2024,1.1627906976744187,2.3255813953488373
Rk,Player,Nation,Pos,Squad,Comp,0,0,90.0,0,0,3,3,3,Tkl,0,0.0,0,0,0,0,0,0,0,0,0,2023-2024,0.0,0.0
2801,Leny Yoro,FRA,DF,Lille,Ligue 1,17,2005,29.7,36,25,27,7,2,17,31,54.8,14,20,14,6,36,72,97,1,0,2023-2024,1.2121212121212122,1.2121212121212122
2802,Ashley Young,ENG,"DF,MF",Everton,Premier League,38,1985,25.3,53,38,28,19,6,30,54,55.6,24,24,6,18,22,75,50,3,0,2023-2024,0.8695652173913043,2.0948616600790513
2803,Etienne Youte Kinkoue,FRA,DF,Le Havre,Ligue 1,21,2002,21.6,15,9,13,2,0,7,11,63.6,4,21,16,5,44,59,104,0,0,2023-2024,2.0370370370370368,0.6944444444444444
2804,Illia Zabarnyi,UKR,DF,Bournemouth,Premier League,20,2002,37.0,59,32,29,29,1,23,50,46.0,27,53,34,19,33,92,143,4,0,2023-2024,0.8918918918918919,1.5945945945945945
2805,Mattia Zaccagni,ITA,"FW,MF",Lazio,Serie A,28,1995,21.7,27,16,11,15,1,9,21,42.9,12,26,2,24,21,48,15,0,0,2023-2024,0.967741935483871,1.2442396313364055
2806,Dan-Axel Zagadou,FRA,DF,Stuttgart,Bundesliga,24,1999,16.1,21,14,16,5,0,4,8,50.0,4,23,18,5,20,41,78,1,0,2023-2024,1.2422360248447204,1.3043478260869563
2807,Yoram Zague,FRA,DF,Paris S-G,Ligue 1,17,2006,4.1,18,8,11,4,3,11,24,45.8,13,3,0,3,4,22,9,1,0,2023-2024,0.9756097560975611,4.390243902439025
2808,Warren Zaïre-Emery,FRA,"MF,DF",Paris S-G,Ligue 1,17,2006,21.8,51,28,18,24,9,28,51,54.9,23,32,8,24,15,66,22,2,0,2023-2024,0.6880733944954128,2.3394495412844036
2809,Denis Zakaria,SUI,"MF,DF",Monaco,Ligue 1,26,1996,23.7,38,27,11,20,7,12,30,40.0,18,39,13,26,47,85,41,0,0,2023-2024,1.9831223628691983,1.6033755274261603
2810,Arsen Zakharyan,RUS,"MF,FW",Real Sociedad,La Liga,20,2003,13.6,22,15,8,11,3,9,22,40.9,13,16,0,16,4,26,10,0,0,2023-2024,0.29411764705882354,1.6176470588235294
2811,Joseba Zaldúa,ESP,DF,Cádiz,La Liga,31,1992,7.8,20,12,17,2,1,13,21,61.9,8,6,4,2,2,22,20,0,0,2023-2024,0.25641025641025644,2.5641025641025643
2812,Nicola Zalewski,POL,"DF,FW",Roma,Serie A,21,2002,10.8,20,14,10,9,1,8,22,36.4,14,12,4,8,9,29,17,0,0,2023-2024,0.8333333333333333,1.8518518518518516
2813,Andre-Frank Zambo Anguissa,CMR,MF,Napoli,Serie A,27,1995,31.0,61,33,21,29,11,34,69,49.3,35,40,5,35,28,89,19,1,0,2023-2024,0.9032258064516129,1.967741935483871
2814,Nicolò Zaniolo,ITA,"FW,MF",Aston Villa,Premier League,24,1999,9.3,19,9,10,7,2,9,17,52.9,8,13,0,13,1,20,11,0,0,2023-2024,0.1075268817204301,2.043010752688172
2815,Alessandro Zanoli,ITA,DF,Salernitana,Serie A,22,2000,10.2,16,13,9,7,0,7,12,58.3,5,10,2,8,1,17,17,0,0,2023-2024,0.09803921568627452,1.5686274509803924
2816,Alessandro Zanoli,ITA,"DF,FW",Napoli,Serie A,22,2000,0.6,1,1,1,0,0,0,0,0.0,0,0,0,0,1,2,1,0,0,2023-2024,1.6666666666666667,1.6666666666666667
2817,Duván Zapata,COL,FW,Torino,Serie A,32,1991,32.0,18,7,9,2,7,3,12,25.0,9,20,6,14,7,25,26,0,0,2023-2024,0.21875,0.5625
2818,Duván Zapata,COL,FW,Atalanta,Serie A,32,1991,1.2,0,0,0,0,0,0,1,0.0,1,0,0,0,0,0,1,0,0,2023-2024,0.0,0.0
2819,Gabriele Zappa,ITA,DF,Cagliari,Serie A,23,1999,28.5,54,31,29,16,9,29,41,70.7,12,29,5,24,20,74,75,2,0,2023-2024,0.7017543859649122,1.894736842105263
2820,Davide Zappacosta,ITA,DF,Atalanta,Serie A,31,1992,20.7,30,20,15,10,5,16,34,47.1,18,29,4,25,5,35,19,0,0,2023-2024,0.24154589371980678,1.4492753623188406
2821,Bryan Zaragoza,ESP,"MF,FW",Granada,La Liga,22,2001,18.2,18,9,8,6,4,8,23,34.8,15,9,0,9,3,21,3,0,0,2023-2024,0.16483516483516483,0.989010989010989
2822,Bryan Zaragoza,ESP,"FW,MF",Bayern Munich,Bundesliga,22,2001,2.0,4,4,2,1,1,3,3,100.0,0,0,0,0,2,6,0,0,0,2023-2024,1.0,2.0
2823,Anass Zaroury,MAR,"FW,MF",Burnley,Premier League,22,2000,1.7,1,0,1,0,0,0,4,0.0,4,2,0,2,0,1,1,1,0,2023-2024,0.0,0.5882352941176471
2824,Oier Zarraga,ESP,MF,Udinese,Serie A,24,1999,4.5,3,3,2,1,0,1,5,20.0,4,5,2,3,5,8,16,1,0,2023-2024,1.1111111111111112,0.6666666666666666
2825,Mehdi Zeffane,ALG,"DF,MF",Clermont Foot,Ligue 1,31,1992,13.7,31,20,17,11,3,17,34,50.0,17,14,3,11,16,47,34,0,0,2023-2024,1.1678832116788322,2.2627737226277373
Rk,Player,Nation,Pos,Squad,Comp,0,0,90.0,0,0,3,3,3,Tkl,0,0.0,0,0,0,0,0,0,0,0,0,2023-2024,0.0,0.0
2826,Jordan Zemura,ZIM,DF,Udinese,Serie A,23,1999,11.5,24,16,13,7,4,11,19,57.9,8,5,1,4,13,37,21,0,0,2023-2024,1.1304347826086956,2.0869565217391304
2827,Robin Zentner,GER,GK,Mainz 05,Bundesliga,28,1994,30.0,2,2,2,0,0,2,5,40.0,3,1,0,1,1,3,19,1,0,2023-2024,0.03333333333333333,0.06666666666666667
2828,Alessio Zerbin,ITA,"DF,FW",Monza,Serie A,24,1999,7.6,18,10,13,2,3,4,13,30.8,9,16,3,13,3,21,5,0,0,2023-2024,0.39473684210526316,2.368421052631579
2829,Alessio Zerbin,ITA,"FW,DF",Napoli,Serie A,24,1999,1.7,5,2,1,3,1,2,7,28.6,5,1,0,1,0,5,0,0,0,2023-2024,0.0,2.9411764705882355
2830,Kevin Zeroli,ITA,MF,Milan,Serie A,18,2005,0.3,1,1,1,0,0,0,0,0.0,0,1,0,1,0,1,1,0,0,2023-2024,0.0,3.3333333333333335
2831,Cedric Zesiger,SUI,DF,Wolfsburg,Bundesliga,25,1998,18.2,19,9,13,4,2,10,22,45.5,12,32,21,11,15,34,88,1,0,2023-2024,0.8241758241758242,1.043956043956044
2832,Michael Zetterer,GER,GK,Werder Bremen,Bundesliga,28,1995,27.0,3,1,3,0,0,3,3,100.0,0,0,0,0,0,3,7,3,0,2023-2024,0.0,0.1111111111111111
2833,Nathan Zeze,FRA,DF,Nantes,Ligue 1,18,2005,11.4,11,6,9,2,0,7,14,50.0,7,12,3,9,12,23,47,1,0,2023-2024,1.0526315789473684,0.9649122807017544
2834,Edon Zhegrova,KVX,FW,Lille,Ligue 1,24,1999,25.4,32,18,9,15,8,14,36,38.9,22,17,1,16,8,40,8,0,0,2023-2024,0.31496062992125984,1.2598425196850394
2835,Piotr Zieliński,POL,MF,Napoli,Serie A,29,1994,21.4,23,15,6,13,4,12,24,50.0,12,12,1,11,9,32,15,0,0,2023-2024,0.42056074766355145,1.074766355140187
2836,David Zima,CZE,DF,Torino,Serie A,22,2000,1.0,1,1,1,0,0,0,0,0.0,0,0,0,0,3,4,7,0,0,2023-2024,3.0,1.0
2837,Christoph Zimmermann,GER,DF,Darmstadt 98,Bundesliga,30,1993,13.6,33,21,26,7,0,19,39,48.7,20,21,14,7,21,54,66,1,0,2023-2024,1.5441176470588236,2.4264705882352944
2838,Oleksandr Zinchenko,UKR,DF,Arsenal,Premier League,26,1996,19.1,50,30,19,24,7,35,52,67.3,17,18,3,15,20,70,26,2,0,2023-2024,1.0471204188481675,2.6178010471204187
2839,Joshua Zirkzee,NED,FW,Bologna,Serie A,22,2001,30.7,32,20,8,15,9,13,24,54.2,11,25,2,23,3,35,36,0,0,2023-2024,0.09771986970684039,1.0423452768729642
2840,Luc Zogbé,CIV,DF,Brest,Ligue 1,18,2005,0.1,0,0,0,0,0,0,1,0.0,1,1,1,0,1,1,0,0,0,2023-2024,10.0,0.0
2841,Simon Zoller,GER,"FW,MF",Bochum,Bundesliga,32,1991,0.5,0,0,0,0,0,0,0,0.0,0,1,0,1,0,0,0,0,0,2023-2024,0.0,0.0
2842,Nadir Zortea,ITA,DF,Frosinone,Serie A,24,1999,14.0,21,14,8,13,0,10,22,45.5,12,13,5,8,4,25,29,1,0,2023-2024,0.2857142857142857,1.5
2843,Nadir Zortea,ITA,DF,Atalanta,Serie A,24,1999,1.7,5,4,3,1,1,1,4,25.0,3,2,0,2,1,6,3,0,0,2023-2024,0.5882352941176471,2.9411764705882355
2844,Kurt Zouma,FRA,DF,West Ham,Premier League,28,1994,31.5,23,17,14,9,0,10,16,62.5,6,38,28,10,29,52,160,0,0,2023-2024,0.9206349206349206,0.7301587301587301
2845,Igor Zubeldia,ESP,DF,Real Sociedad,La Liga,26,1997,28.0,32,25,20,10,2,19,26,73.1,7,28,19,9,32,64,97,3,0,2023-2024,1.1428571428571428,1.1428571428571428
2846,Martín Zubimendi,ESP,MF,Real Sociedad,La Liga,24,1999,29.5,49,27,18,29,2,23,42,54.8,19,33,9,24,37,86,54,0,0,2023-2024,1.2542372881355932,1.6610169491525424
2847,Szymon Żurkowski,POL,MF,Empoli,Serie A,25,1997,9.6,15,6,5,8,2,5,15,33.3,10,5,1,4,6,21,11,0,0,2023-2024,0.625,1.5625
2848,Lovro Zvonarek,CRO,"FW,MF",Bayern Munich,Bundesliga,18,2005,1.8,0,0,0,0,0,0,5,0.0,5,3,0,3,0,0,2,0,0,2023-2024,0.0,0.0
2849,Martin Ødegaard,NOR,MF,Arsenal,Premier League,24,1998,34.3,49,17,18,21,10,17,58,29.3,41,23,1,22,15,64,5,0,0,2023-2024,0.4373177842565598,1.4285714285714286
2850,Milan Đurić,BIH,FW,Hellas Verona,Serie A,33,1990,13.4,1,0,0,0,1,0,3,0.0,3,0,0,0,1,2,13,0,0,2023-2024,0.07462686567164178,0.07462686567164178
Rk,Player,Nation,Pos,Squad,Comp,0,0,90.0,0,0,3,3,3,Tkl,0,0.0,0,0,0,0,0,0,0,0,0,2023-2024,0.0,0.0
2851,Milan Đurić,BIH,FW,Monza,Serie A,33,1990,14.0,5,5,0,5,0,2,4,50.0,2,6,2,4,0,5,27,0,0,2023-2024,0.0,0.35714285714285715
2852,Mateusz Łęgowski,POL,MF,Salernitana,Serie A,20,2003,12.7,23,12,8,12,3,11,26,42.3,15,13,2,11,7,30,16,0,0,2023-2024,0.5511811023622047,1.8110236220472442
