Rk,Player,Nation,Pos,Squad,Comp,Age,Born,90s,Tkl,TklW,Def 3rd,Mid 3rd,Att 3rd,DribTkl,Att,Tkl%,Lost,Blocks,Sh,Pass,Int,Tkl+Int,Clr,Err,Matches,Season,90s Played,Interceptions/90,Tackles/90
1,Patrick van Aanholt,NED,DF,Crystal Palace,Premier League,26,1990,24.3,47,32,29,15,3,16,34,47.1,18,24,5,19,47,94,64,2,0,2017-2018,90.0,174.07407407407408,174.07407407407408
2,Rolando Aarons,ENG,"MF,FW",Newcastle Utd,Premier League,21,1995,1.5,4,4,3,1,0,4,6,66.7,2,3,0,3,1,5,0,0,0,2017-2018,90.0,60.0,240.0
3,Rolando Aarons,ENG,"MF,FW",Hellas Verona,Serie A,21,1995,5.7,13,8,4,4,5,1,7,14.3,6,3,1,2,2,15,0,0,0,2017-2018,90.0,31.57894736842105,205.26315789473682
4,Ignazio Abate,ITA,DF,Milan,Serie A,30,1986,11.7,20,17,10,9,1,6,11,54.5,5,22,2,20,8,28,29,0,0,2017-2018,89.99999999999999,61.53846153846153,153.84615384615384
5,Aymen Abdennour,TUN,DF,Marseille,Ligue 1,27,1989,5.5,7,3,5,2,0,4,7,57.1,3,5,5,0,4,11,20,0,0,2017-2018,90.0,65.45454545454545,114.54545454545455
6,Aly Abeid,MTN,DF,Levante,La Liga,19,1997,0.9,2,1,1,1,0,0,1,0.0,1,1,0,1,3,5,3,0,0,2017-2018,90.0,300.0,200.0
7,Mehdi Abeid,ALG,MF,Dijon,Ligue 1,24,1992,13.1,23,15,8,14,1,8,32,25.0,24,11,6,5,18,41,25,2,0,2017-2018,90.0,123.66412213740459,158.01526717557252
8,David Abraham,ARG,DF,Eint Frankfurt,Bundesliga,31,1986,25.6,40,32,29,10,1,27,36,75.0,9,29,15,14,40,80,141,1,0,2017-2018,90.0,140.625,140.625
9,Tammy Abraham,ENG,FW,Swansea City,Premier League,19,1997,19.2,10,8,1,7,2,1,13,7.7,12,8,1,7,1,11,11,0,0,2017-2018,90.0,4.6875,46.875
10,Amir Abrashi,ALB,MF,Freiburg,Bundesliga,27,1990,9.4,35,32,15,18,2,16,23,69.6,7,22,5,17,19,54,20,0,0,2017-2018,90.0,181.91489361702128,335.1063829787234
11,Francesco Acerbi,ITA,DF,Sassuolo,Serie A,29,1988,38.0,51,32,26,22,3,22,36,61.1,14,42,21,21,88,139,255,1,0,2017-2018,90.0,208.42105263157896,120.78947368421052
12,Afriyie Acquah,GHA,MF,Torino,Serie A,25,1992,10.6,8,6,2,6,0,1,7,14.3,6,8,1,7,16,24,10,2,0,2017-2018,90.0,135.8490566037736,67.9245283018868
13,Charlie Adam,SCO,MF,Stoke City,Premier League,31,1985,4.6,9,5,2,5,2,5,17,29.4,12,2,0,2,9,18,11,2,0,2017-2018,90.0,176.08695652173915,176.08695652173915
14,Antonio Adán,ESP,GK,Betis,La Liga,30,1987,30.0,1,0,1,0,0,1,1,100.0,0,1,0,1,0,1,11,2,0,2017-2018,90.0,0.0,3.0
15,Aday,ESP,DF,Girona,La Liga,29,1987,20.4,17,15,11,4,2,6,17,35.3,11,19,3,16,25,42,52,1,0,2017-2018,90.0,110.29411764705883,75.0
16,Khaled Adénon,BEN,DF,Amiens,Ligue 1,32,1985,32.5,38,24,26,12,0,15,32,46.9,17,42,26,16,65,103,221,1,0,2017-2018,90.0,180.0,105.23076923076923
17,Claud Adjapong,ITA,"DF,FW",Sassuolo,Serie A,19,1998,13.6,35,26,24,5,6,11,13,84.6,2,16,3,13,23,58,37,0,0,2017-2018,90.0,152.2058823529412,231.61764705882354
18,René Adler,GER,GK,Mainz 05,Bundesliga,32,1985,14.0,1,1,1,0,0,1,1,100.0,0,0,0,0,0,1,8,1,0,2017-2018,90.0,0.0,6.428571428571429
19,Yacine Adli,FRA,FW,Paris S-G,Ligue 1,17,2000,0.1,0,0,0,0,0,0,0,0.0,0,0,0,0,0,0,0,0,0,2017-2018,90.0,0.0,0.0
20,Ali Adnan Kadhim,IRQ,"DF,FW",Udinese,Serie A,23,1993,18.6,54,35,35,14,5,29,50,58.0,21,31,6,25,41,95,90,0,0,2017-2018,90.0,198.3870967741935,261.2903225806451
21,Adrián,ESP,GK,West Ham,Premier League,30,1987,19.0,2,1,2,0,0,1,4,25.0,3,1,0,1,0,2,15,1,0,2017-2018,90.0,0.0,9.473684210526315
22,Aritz Aduriz,ESP,FW,Athletic Club,La Liga,36,1981,23.9,11,8,2,6,3,1,6,16.7,5,6,0,6,3,14,18,0,0,2017-2018,90.0,11.297071129707113,41.42259414225941
23,Ibrahim Afellay,NED,MF,Stoke City,Premier League,31,1986,1.8,3,3,0,3,0,1,2,50.0,1,1,0,1,1,4,1,0,0,2017-2018,90.0,50.0,150.0
24,Benik Afobe,COD,FW,Bournemouth,Premier League,24,1993,6.8,4,3,1,2,1,1,6,16.7,5,4,0,4,0,4,6,0,0,2017-2018,90.0,0.0,52.94117647058823
25,Martin Agirregabiria,ESP,DF,Alavés,La Liga,21,1996,20.3,50,33,31,17,2,32,50,64.0,18,13,7,6,41,91,66,0,0,2017-2018,90.0,181.7733990147783,221.67487684729062
26,Imanol Agirretxe,ESP,FW,Real Sociedad,La Liga,30,1987,2.6,0,0,0,0,0,0,1,0.0,1,0,0,0,0,0,2,0,0,2017-2018,90.0,0.0,0.0
27,Sergio Agüero,ARG,FW,Manchester City,Premier League,29,1988,21.8,9,6,2,6,1,2,17,11.8,15,12,1,11,6,15,3,0,0,2017-2018,90.0,24.77064220183486,37.15596330275229
28,Ruben Aguilar,FRA,DF,Montpellier,Ligue 1,24,1993,27.3,91,50,37,41,13,36,71,50.7,35,25,3,22,37,128,90,0,0,2017-2018,90.0,121.97802197802197,300.0
29,Matías Aguirregaray,URU,DF,Las Palmas,La Liga,28,1989,12.8,26,20,12,12,2,12,32,37.5,20,13,1,12,24,50,25,0,0,2017-2018,90.0,168.75,182.8125
30,Jean-Eudes Aholou,CIV,MF,Strasbourg,Ligue 1,23,1994,33.4,70,34,32,37,1,17,55,30.9,38,29,7,22,75,145,58,1,0,2017-2018,90.0,202.09580838323353,188.62275449101796
31,Ailton,BRA,"DF,MF",Stuttgart,Bundesliga,22,1995,1.2,8,5,3,5,0,4,8,50.0,4,5,0,5,2,10,5,0,0,2017-2018,90.0,150.0,600.0
32,Youssef Aït Bennasser,MAR,MF,Caen,Ligue 1,21,1996,22.7,47,28,17,27,3,15,64,23.4,49,35,2,33,32,79,30,0,0,2017-2018,89.99999999999999,126.87224669603523,186.34361233480175
33,Arlind Ajeti,ALB,DF,Crotone,Serie A,23,1993,14.1,42,23,25,14,3,18,30,60.0,12,27,15,12,34,76,82,0,0,2017-2018,89.99999999999999,217.02127659574467,268.0851063829787
34,Manuel Akanji,SUI,DF,Dortmund,Bundesliga,22,1995,10.0,22,15,14,8,0,15,17,88.2,2,11,4,7,7,29,43,2,0,2017-2018,90.0,63.0,198.0
35,Nathan Aké,NED,DF,Bournemouth,Premier League,22,1995,37.3,53,32,34,16,3,22,40,55.0,18,47,24,23,48,101,246,2,0,2017-2018,90.0,115.81769436997321,127.88203753351208
36,Ager Aketxe,ESP,MF,Athletic Club,La Liga,23,1993,0.4,1,1,1,0,0,1,2,50.0,1,1,0,1,1,2,0,0,0,2017-2018,90.0,225.0,225.0
37,Chadrac Akolo,COD,"MF,FW",Stuttgart,Bundesliga,22,1995,12.2,20,14,3,12,5,6,14,42.9,8,19,0,19,5,25,5,0,0,2017-2018,90.0,36.88524590163935,147.5409836065574
38,Kevin Akpoguma,NGA,DF,Hoffenheim,Bundesliga,22,1995,18.8,47,39,29,16,2,24,35,68.6,11,18,4,14,22,69,60,1,0,2017-2018,90.0,105.31914893617021,225.0
39,David Alaba,AUT,DF,Bayern Munich,Bundesliga,25,1992,17.2,23,14,11,9,3,14,20,70.0,6,21,6,15,10,33,23,0,0,2017-2018,90.0,52.32558139534884,120.34883720930233
40,Lucas Alario,ARG,FW,Leverkusen,Bundesliga,24,1992,17.2,16,10,2,12,2,3,8,37.5,5,17,4,13,4,20,16,0,0,2017-2018,90.0,20.930232558139537,83.72093023255815
41,David Alba,ESP,DF,Getafe,La Liga,18,1999,0.7,1,1,1,0,0,1,1,100.0,0,0,0,0,0,1,7,1,0,2017-2018,90.0,0.0,128.57142857142858
42,Jordi Alba,ESP,DF,Barcelona,La Liga,28,1989,30.5,63,42,35,22,6,26,52,50.0,26,34,5,29,68,131,67,1,0,2017-2018,90.0,200.655737704918,185.9016393442623
43,Raúl Albentosa,ESP,DF,La Coruña,La Liga,28,1988,19.4,13,6,9,4,0,7,20,35.0,13,26,19,7,26,39,92,1,0,2017-2018,90.0,120.61855670103094,60.30927835051547
44,Luis Alberto,ESP,"FW,MF",Lazio,Serie A,24,1992,29.7,39,28,8,23,8,10,44,22.7,34,30,2,28,16,55,7,0,0,2017-2018,90.0,48.484848484848484,118.18181818181817
45,Raúl Albiol,ESP,DF,Napoli,Serie A,31,1985,30.5,29,19,15,14,0,13,19,68.4,6,18,13,5,32,61,129,1,0,2017-2018,90.0,94.42622950819671,85.57377049180327
46,Miiko Albornoz,CHI,"DF,MF",Hannover 96,Bundesliga,26,1990,7.8,24,20,17,4,3,11,16,68.8,5,15,2,13,5,29,23,0,0,2017-2018,90.0,57.69230769230769,276.9230769230769
47,Marc Albrighton,ENG,"MF,FW",Leicester City,Premier League,27,1989,28.2,52,33,16,29,7,16,52,30.8,36,32,4,28,27,79,34,0,0,2017-2018,89.99999999999999,86.17021276595744,165.95744680851064
48,Paco Alcácer,ESP,"MF,FW",Barcelona,La Liga,23,1993,7.7,4,3,0,2,2,0,6,0.0,6,5,0,5,11,15,3,0,0,2017-2018,90.0,128.57142857142858,46.753246753246756
49,Pedro Alcalá,ESP,DF,Girona,La Liga,28,1989,7.7,9,5,5,4,0,1,3,33.3,2,7,3,4,14,23,41,0,0,2017-2018,90.0,163.63636363636365,105.1948051948052
50,Thiago Alcántara,ESP,"MF,FW",Bayern Munich,Bundesliga,26,1991,13.9,45,35,11,25,9,15,26,57.7,11,22,3,19,27,72,6,1,0,2017-2018,90.0,174.8201438848921,291.36690647482015
51,David Alcibiade,FRA,DF,Nantes,Ligue 1,25,1991,2.3,9,5,5,3,1,2,4,50.0,2,5,3,2,7,16,8,0,0,2017-2018,90.0,273.9130434782609,352.1739130434783
52,Toby Alderweireld,BEL,DF,Tottenham,Premier League,28,1989,13.1,19,13,7,11,1,8,15,53.3,7,11,5,6,4,23,55,0,0,2017-2018,90.0,27.480916030534353,130.5343511450382
53,Steve Aldo One,CMR,DF,La Coruña,La Liga,22,1995,1.0,1,0,0,1,0,0,0,0.0,0,0,0,0,0,1,7,0,0,2017-2018,90.0,0.0,90.0
54,Álex Alegría,ESP,FW,Levante,La Liga,24,1992,7.0,8,5,1,3,4,2,6,33.3,4,7,0,7,4,12,9,0,0,2017-2018,90.0,51.42857142857143,102.85714285714286
55,Iván Alejo,ESP,"MF,FW",Eibar,La Liga,22,1995,12.2,20,16,4,9,7,1,10,10.0,9,9,0,9,5,25,1,0,0,2017-2018,90.0,36.88524590163935,147.5409836065574
56,Alexander,ARG,"MF,FW",Leganés,La Liga,28,1988,11.8,14,11,2,11,1,2,12,16.7,10,11,0,11,22,36,4,0,0,2017-2018,90.0,167.79661016949152,106.77966101694915
57,Trent Alexander-Arnold,ENG,DF,Liverpool,Premier League,18,1998,17.5,37,25,23,9,5,22,36,61.1,14,20,5,15,28,65,46,1,0,2017-2018,90.0,144.0,190.28571428571428
58,Alexis,ESP,DF,Alavés,La Liga,31,1985,24.3,33,24,24,7,2,20,45,44.4,25,28,14,14,30,63,114,3,0,2017-2018,90.0,111.1111111111111,122.22222222222221
59,Alisson,BRA,GK,Roma,Serie A,24,1992,37.0,1,0,1,0,0,0,1,0.0,1,0,0,0,2,3,22,4,0,2017-2018,90.0,4.864864864864865,2.4324324324324325
60,Allan,BRA,MF,Napoli,Serie A,26,1991,31.7,107,68,24,65,18,36,104,34.6,68,52,3,49,28,135,16,0,0,2017-2018,90.0,79.49526813880126,303.7854889589905
61,Joe Allen,WAL,MF,Stoke City,Premier League,27,1990,34.9,96,62,41,43,12,27,87,31.0,60,43,9,34,58,154,68,1,0,2017-2018,90.0,149.5702005730659,247.5644699140401
62,Dele Alli,ENG,"MF,FW",Tottenham,Premier League,21,1996,32.9,46,30,15,21,10,8,34,23.5,26,33,7,26,19,65,22,1,0,2017-2018,90.0,51.975683890577514,125.83586626139818
63,Júnior Alonso,PAR,DF,Lille,Ligue 1,24,1993,30.9,58,31,36,22,0,28,50,56.0,22,26,16,10,56,114,153,1,0,2017-2018,90.0,163.10679611650485,168.93203883495147
64,José Alonso Lara,ESP,MF,Sevilla,La Liga,17,2000,0.1,0,0,0,0,0,0,0,0.0,0,0,0,0,0,0,0,0,0,2017-2018,90.0,0.0,0.0
65,Marcos Alonso,ESP,"DF,MF",Chelsea,Premier League,26,1990,31.7,51,33,30,18,3,23,44,52.3,21,36,5,31,47,98,76,1,0,2017-2018,90.0,133.43848580441642,144.79495268138803
66,Ricky Álvarez,ARG,MF,Sampdoria,Serie A,29,1988,3.0,4,2,1,3,0,1,4,25.0,3,5,0,5,2,6,3,0,0,2017-2018,90.0,60.0,120.0
67,Sergio Álvarez,ESP,GK,Celta Vigo,La Liga,30,1986,16.4,0,0,0,0,0,0,1,0.0,1,1,0,1,0,0,11,1,0,2017-2018,90.0,0.0,0.0
68,Yeray Álvarez,ESP,DF,Athletic Club,La Liga,22,1995,7.5,12,7,8,4,0,6,9,66.7,3,8,2,6,11,23,18,0,0,2017-2018,90.0,132.0,144.0
69,Dani Alves,BRA,DF,Paris S-G,Ligue 1,34,1983,22.9,80,57,45,27,8,33,58,56.9,25,24,3,21,28,108,21,0,0,2017-2018,90.0,110.04366812227076,314.410480349345
70,Ibrahim Amadou,FRA,"MF,DF",Lille,Ligue 1,24,1993,26.7,43,29,24,19,0,14,27,51.9,13,30,13,17,41,84,70,3,0,2017-2018,90.00000000000001,138.20224719101125,144.9438202247191
71,Eloi Amagat,ESP,MF,Girona,La Liga,32,1985,0.2,0,0,0,0,0,0,1,0.0,1,0,0,0,0,0,0,0,0,2017-2018,90.0,0.0,0.0
72,Morgan Amalfitano,FRA,"MF,FW",Rennes,Ligue 1,32,1985,8.3,8,5,3,3,2,2,5,40.0,3,6,0,6,4,12,7,0,0,2017-2018,90.0,43.37349397590361,86.74698795180721
73,Romain Amalfitano,FRA,MF,Dijon,Ligue 1,27,1989,30.0,59,37,18,38,3,25,69,36.2,44,29,7,22,85,144,35,2,0,2017-2018,90.0,255.0,177.0
74,Daniel Amartey,GHA,DF,Leicester City,Premier League,22,1994,5.4,8,4,7,1,0,3,7,42.9,4,7,3,4,7,15,21,1,0,2017-2018,90.0,116.66666666666666,133.33333333333331
75,Jordi Amat,IDN,"DF,MF",Betis,La Liga,25,1992,22.7,32,23,15,16,1,11,24,45.8,13,14,4,10,38,70,77,2,0,2017-2018,89.99999999999999,150.66079295154185,126.87224669603523
76,Amath,SEN,"MF,FW",Getafe,La Liga,21,1996,31.8,78,53,32,28,18,24,89,27.0,65,36,3,33,33,111,20,0,0,2017-2018,90.0,93.39622641509435,220.75471698113208
77,Jordan Amavi,FRA,DF,Marseille,Ligue 1,23,1994,24.4,52,35,32,12,8,23,56,41.1,33,28,11,17,45,97,86,1,0,2017-2018,90.0,165.98360655737707,191.8032786885246
78,Stephan Ambrosius,GHA,DF,Hamburger SV,Bundesliga,18,1998,0.5,0,0,0,0,0,0,0,0.0,0,2,1,1,1,1,4,0,0,2017-2018,90.0,180.0,0.0
79,Kelvin Amian,FRA,DF,Toulouse,Ligue 1,19,1998,35.0,59,43,45,10,4,22,31,71.0,9,25,7,18,45,104,127,1,0,2017-2018,90.0,115.71428571428571,151.71428571428572
80,Nadiem Amiri,GER,MF,Hoffenheim,Bundesliga,20,1996,19.4,39,26,13,21,5,19,42,45.2,23,33,4,29,17,56,7,0,0,2017-2018,90.0,78.86597938144331,180.92783505154642
81,Ethan Ampadu,WAL,DF,Chelsea,Premier League,16,2000,0.1,1,1,0,1,0,0,0,0.0,0,0,0,0,0,1,2,0,0,2017-2018,90.0,0.0,900.0
82,Nordin Amrabat,MAR,FW,Watford,Premier League,30,1987,2.2,6,3,1,5,0,1,3,33.3,2,1,0,1,0,6,2,0,0,2017-2018,90.0,0.0,245.45454545454544
83,Nordin Amrabat,MAR,"FW,MF",Leganés,La Liga,30,1987,18.0,19,10,5,10,4,5,17,29.4,12,13,0,13,5,24,2,0,0,2017-2018,90.0,25.0,95.0
84,Jon Ander Serantes,ESP,GK,Leganés,La Liga,27,1989,1.0,0,0,0,0,0,0,0,0.0,0,0,0,0,0,0,0,1,0,2017-2018,90.0,0.0,0.0
85,Joachim Andersen,DEN,DF,Sampdoria,Serie A,21,1996,6.1,8,3,6,2,0,4,4,100.0,0,6,4,2,9,17,41,1,0,2017-2018,90.0,132.78688524590166,118.03278688524591
86,Felipe Anderson,BRA,"FW,MF",Lazio,Serie A,24,1993,12.9,34,21,7,11,16,6,35,17.1,29,17,0,17,11,45,8,1,0,2017-2018,90.0,76.74418604651163,237.20930232558138
87,Florin Andone,ROU,FW,La Coruña,La Liga,24,1993,18.2,9,7,4,4,1,4,17,23.5,13,9,2,7,3,12,12,0,0,2017-2018,90.0,14.835164835164836,44.505494505494504
88,Nícolas Andrade,BRA,GK,Hellas Verona,Serie A,29,1988,36.0,2,1,2,0,0,1,4,25.0,3,2,0,2,2,4,16,7,0,2017-2018,90.0,5.0,5.0
89,Benjamin André,FRA,MF,Rennes,Ligue 1,26,1990,33.5,93,54,36,50,7,43,113,38.1,70,56,4,52,57,150,96,1,0,2017-2018,90.0,153.13432835820896,249.8507462686567
90,Marco Andreolli,ITA,DF,Cagliari,Serie A,31,1986,20.3,25,17,20,4,1,12,20,60.0,8,24,17,7,30,55,139,0,0,2017-2018,90.0,133.00492610837438,110.83743842364531
91,Yoann Andreu,FRA,DF,Angers,Ligue 1,28,1989,23.0,48,30,40,6,2,16,39,41.0,23,23,5,18,37,85,75,1,0,2017-2018,90.0,144.7826086956522,187.82608695652175
92,Miguel Ángel Guerrero,ESP,FW,Leganés,La Liga,27,1990,16.0,7,5,0,2,5,1,11,9.1,10,11,0,11,9,16,16,0,0,2017-2018,90.0,50.625,39.375
93,José Ángel,ESP,DF,Eibar,La Liga,27,1989,27.0,61,44,36,19,6,38,58,65.5,20,31,1,30,38,99,76,0,0,2017-2018,90.0,126.66666666666667,203.33333333333334
94,Miguel Ángel Moyá,ESP,GK,Real Sociedad,La Liga,33,1984,8.5,0,0,0,0,0,0,1,0.0,1,0,0,0,2,2,7,0,0,2017-2018,90.0,21.176470588235293,0.0
95,Miguel Ángel Rubio,ESP,DF,Getafe,La Liga,19,1998,0.3,0,0,0,0,0,0,0,0.0,0,0,0,0,0,0,1,0,0,2017-2018,90.0,0.0,0.0
96,Gabriele Angella,ITA,DF,Udinese,Serie A,28,1989,9.9,15,13,11,3,1,8,11,72.7,3,11,9,2,21,36,66,0,0,2017-2018,90.0,190.9090909090909,136.36363636363637
97,Cristian Ansaldi,ARG,DF,Torino,Serie A,30,1986,20.8,49,33,25,20,4,14,37,37.8,23,23,5,18,20,69,61,0,0,2017-2018,90.0,86.53846153846153,212.01923076923075
98,Luca Antei,ITA,DF,Benevento,Serie A,25,1992,6.6,19,14,12,7,0,6,11,54.5,5,10,8,2,26,45,35,0,0,2017-2018,90.0,354.54545454545456,259.09090909090907
99,Mirco Antenucci,ITA,FW,SPAL,Serie A,32,1984,28.6,16,13,6,8,2,0,21,0.0,21,14,0,14,11,27,15,0,0,2017-2018,90.0,34.61538461538461,50.349650349650354
100,Waldemar Anton,GER,"DF,MF",Hannover 96,Bundesliga,21,1996,25.3,65,49,39,21,5,41,65,63.1,24,56,27,29,39,104,112,3,0,2017-2018,89.99999999999999,138.73517786561263,231.22529644268772
101,Luca Antonelli,ITA,"DF,FW",Milan,Serie A,30,1987,1.6,1,1,0,0,1,0,2,0.0,2,1,0,1,1,2,8,0,0,2017-2018,90.0,56.25,56.25
102,Michail Antonio,JAM,"FW,MF",West Ham,Premier League,27,1990,15.0,15,9,7,6,2,4,14,28.6,10,14,0,14,13,28,16,0,0,2017-2018,90.0,78.0,90.0
103,Mirko Antonucci,ITA,FW,Roma,Serie A,18,1999,0.3,0,0,0,0,0,0,0,0.0,0,0,0,0,0,0,0,0,0,2017-2018,90.0,0.0,0.0
104,Vitorino Antunes,POR,DF,Getafe,La Liga,30,1987,31.1,58,44,42,14,2,38,74,51.4,36,31,3,28,58,116,89,1,0,2017-2018,90.0,167.84565916398714,167.84565916398714
105,Dennis Aogo,GER,"MF,DF",Stuttgart,Bundesliga,30,1987,21.7,35,26,17,18,0,14,22,63.6,8,27,3,24,29,64,27,1,0,2017-2018,90.0,120.27649769585254,145.16129032258064
106,Houssem Aouar,ALG,"MF,FW",Lyon,Ligue 1,19,1998,27.0,66,42,22,39,5,20,66,30.3,46,30,0,30,39,105,34,0,0,2017-2018,90.0,130.0,220.0
107,Alberto Aquilani,ITA,MF,Las Palmas,La Liga,33,1984,14.4,33,19,13,17,3,11,31,35.5,20,20,4,16,23,56,23,0,0,2017-2018,90.0,143.75,206.25
108,Mauro Arambarri,URU,MF,Getafe,La Liga,21,1995,23.6,56,41,19,30,7,14,47,29.8,33,26,3,23,25,81,36,0,0,2017-2018,90.0,95.33898305084745,213.5593220338983
109,Guilherme Arana,BRA,DF,Sevilla,La Liga,20,1997,2.1,4,2,3,1,0,1,1,100.0,0,0,0,0,5,9,8,0,0,2017-2018,90.0,214.28571428571428,171.42857142857142
110,Charles Aránguiz,CHI,MF,Leverkusen,Bundesliga,28,1989,25.6,75,61,17,50,8,33,62,53.2,29,46,5,41,48,123,27,2,0,2017-2018,90.0,168.75,263.671875
111,Luiz Araújo,BRA,"FW,MF",Lille,Ligue 1,21,1996,22.4,41,31,23,17,1,10,47,21.3,37,24,0,24,16,57,11,1,0,2017-2018,90.0,64.28571428571429,164.73214285714286
112,Sergio Araujo,ARG,"MF,FW",Las Palmas,La Liga,25,1992,0.4,3,2,0,0,3,1,1,100.0,0,0,0,0,0,3,0,0,0,2017-2018,90.0,0.0,675.0
113,Anaitz Arbilla,ESP,DF,Eibar,La Liga,30,1987,26.8,38,30,24,12,2,21,40,52.5,19,21,10,11,78,116,108,2,0,2017-2018,90.0,261.94029850746267,127.61194029850745
114,Alphonse Areola,FRA,GK,Paris S-G,Ligue 1,24,1993,34.0,0,0,0,0,0,0,1,0.0,1,0,0,0,0,0,7,4,0,2017-2018,90.0,0.0,0.0
115,Scott Arfield,CAN,"MF,FW",Burnley,Premier League,28,1988,14.8,36,26,20,13,3,19,44,43.2,25,22,1,21,11,47,24,0,0,2017-2018,90.0,66.89189189189189,218.9189189189189
116,Samuel Armenteros,SWE,FW,Benevento,Serie A,27,1990,4.8,4,2,1,3,0,0,3,0.0,3,1,1,0,1,5,3,0,0,2017-2018,90.0,18.75,75.0
117,Yoël Armougom,FRA,"DF,MF",Caen,Ligue 1,19,1998,1.5,2,1,0,1,1,1,1,100.0,0,1,1,0,1,3,2,1,0,2017-2018,90.0,60.0,120.0
118,José Arnaiz,ESP,MF,Barcelona,La Liga,22,1995,0.1,1,1,0,1,0,0,0,0.0,0,0,0,0,0,1,0,0,0,2017-2018,90.0,0.0,900.0
119,Marko Arnautović,AUT,"FW,MF",West Ham,Premier League,28,1989,25.7,21,16,9,8,4,7,19,36.8,12,20,3,17,13,34,35,0,0,2017-2018,90.0,45.525291828793776,73.5408560311284
120,Maximilian Arnold,GER,MF,Wolfsburg,Bundesliga,23,1994,27.3,51,41,23,23,5,25,57,43.9,32,31,4,27,28,79,34,0,0,2017-2018,90.0,92.3076923076923,168.13186813186812
121,Jann-Fiete Arp,GER,"FW,MF",Hamburger SV,Bundesliga,17,2000,9.4,7,5,0,3,4,1,7,14.3,6,6,0,6,2,9,7,0,0,2017-2018,90.0,19.148936170212764,67.02127659574468
122,Alejandro Arribas,ESP,DF,La Coruña,La Liga,28,1989,3.0,2,2,1,1,0,1,5,20.0,4,5,3,2,6,8,8,0,0,2017-2018,90.0,180.0,60.0
123,Kepa Arrizabalaga,ESP,GK,Athletic Club,La Liga,22,1994,30.0,0,0,0,0,0,0,2,0.0,2,0,0,0,2,2,6,2,0,2017-2018,90.0,6.0,0.0
124,Harry Arter,IRL,MF,Bournemouth,Premier League,27,1989,10.7,19,16,10,7,2,6,23,26.1,17,18,5,13,9,28,6,0,0,2017-2018,90.0,75.70093457943926,159.81308411214954
125,Aythami Artiles,ESP,DF,Las Palmas,La Liga,31,1986,2.0,2,2,2,0,0,0,1,0.0,1,2,1,1,2,4,19,0,0,2017-2018,90.0,90.0,90.0
126,Kwadwo Asamoah,GHA,DF,Juventus,Serie A,28,1988,17.4,28,21,12,14,2,15,23,65.2,8,11,0,11,18,46,30,0,0,2017-2018,90.0,93.10344827586206,144.82758620689654
127,Takuma Asano,JPN,"FW,MF",Stuttgart,Bundesliga,22,1994,8.0,7,5,3,3,1,2,8,25.0,6,7,0,7,3,10,2,0,0,2017-2018,90.0,33.75,78.75
128,Santiago Ascacíbar,ARG,MF,Stuttgart,Bundesliga,20,1997,26.5,91,65,41,43,7,41,74,55.4,33,45,10,35,47,138,38,1,0,2017-2018,90.0,159.62264150943395,309.0566037735849
129,Sergio Asenjo,ESP,GK,Villarreal,La Liga,28,1989,23.0,2,2,2,0,0,1,5,20.0,4,0,0,0,0,2,11,2,0,2017-2018,90.0,0.0,7.82608695652174
130,Marco Asensio,ESP,"FW,MF",Real Madrid,La Liga,21,1996,20.5,26,17,7,13,6,11,26,42.3,15,15,0,15,9,35,2,0,0,2017-2018,90.0,39.51219512195122,114.14634146341464
131,Iago Aspas,ESP,FW,Celta Vigo,La Liga,29,1987,32.6,26,22,10,10,6,5,34,14.7,29,15,1,14,23,49,11,1,0,2017-2018,90.0,63.49693251533742,71.77914110429448
132,Benoît Assou-Ekotto,CMR,DF,Metz,Ligue 1,33,1984,11.7,12,9,5,6,1,5,15,33.3,10,7,4,3,46,58,21,0,0,2017-2018,89.99999999999999,353.8461538461538,92.3076923076923
133,Simon Asta,GER,MF,Augsburg,Bundesliga,16,2001,0.1,2,1,2,0,0,2,2,100.0,0,1,0,1,0,2,0,0,0,2017-2018,90.0,0.0,1800.0
134,Davide Astori,ITA,DF,Fiorentina,Serie A,30,1987,25.0,47,31,33,13,1,18,29,62.1,11,29,17,12,51,98,131,2,0,2017-2018,90.0,183.6,169.2
135,Christian Atsu,GHA,"FW,MF",Newcastle Utd,Premier League,25,1992,19.8,17,16,10,7,0,7,20,35.0,13,35,5,30,13,30,27,1,0,2017-2018,90.0,59.09090909090909,77.27272727272727
136,Pierre-Emerick Aubameyang,GAB,FW,Arsenal,Premier League,28,1989,11.7,5,4,3,2,0,1,7,14.3,6,14,1,13,3,8,7,0,0,2017-2018,89.99999999999999,23.076923076923077,38.46153846153846
137,Pierre-Emerick Aubameyang,GAB,FW,Dortmund,Bundesliga,28,1989,15.7,5,5,1,1,3,2,8,25.0,6,16,1,15,3,8,1,0,0,2017-2018,90.0,17.197452229299365,28.662420382165607
138,Jean-Kévin Augustin,FRA,FW,RB Leipzig,Bundesliga,20,1997,14.1,16,11,4,11,1,3,7,42.9,4,17,1,16,4,20,4,0,0,2017-2018,89.99999999999999,25.53191489361702,102.12765957446808
139,Ludwig Augustinsson,SWE,"DF,FW",Werder Bremen,Bundesliga,23,1994,28.1,45,34,22,20,3,22,32,68.8,10,25,3,22,39,84,53,0,0,2017-2018,90.0,124.91103202846975,144.12811387900356
140,Yann Aurel Bisseck,GER,"DF,MF",Köln,Bundesliga,16,2000,1.7,2,2,2,0,0,1,1,100.0,0,1,1,0,3,5,8,0,0,2017-2018,90.0,158.8235294117647,105.88235294117646
141,Serge Aurier,CIV,DF,Tottenham,Premier League,24,1992,15.9,48,27,27,13,8,11,31,35.5,20,20,1,19,31,79,54,1,0,2017-2018,90.0,175.47169811320754,271.6981132075472
142,Charlie Austin,ENG,FW,Southampton,Premier League,28,1989,11.5,7,5,1,3,3,3,10,30.0,7,15,3,12,1,8,10,0,0,2017-2018,90.0,7.82608695652174,54.78260869565218
143,Danilo Avelar,BRA,DF,Amiens,Ligue 1,28,1989,19.2,41,33,27,9,5,14,45,31.1,31,16,7,9,37,78,83,1,0,2017-2018,90.0,173.4375,192.1875
144,Felipe Avenatti,URU,FW,Bologna,Serie A,24,1993,5.2,6,4,1,5,0,1,2,50.0,1,7,1,6,1,7,6,0,0,2017-2018,90.0,17.307692307692307,103.84615384615384
145,Durel Avounou,CGO,"DF,MF",Caen,Ligue 1,19,1997,7.2,16,11,6,9,1,5,17,29.4,12,12,1,11,10,26,25,0,0,2017-2018,90.0,125.0,200.0
146,Chidozie Awaziem,NGA,DF,Nantes,Ligue 1,20,1997,16.8,43,30,33,10,0,28,40,70.0,12,18,11,7,16,59,97,0,0,2017-2018,90.0,85.71428571428571,230.35714285714283
147,André Ayew,GHA,"MF,FW",West Ham,Premier League,27,1989,9.9,19,14,6,10,3,6,19,31.6,13,5,0,5,4,23,3,0,0,2017-2018,90.0,36.36363636363637,172.72727272727272
148,André Ayew,GHA,"MF,FW",Swansea City,Premier League,27,1989,10.6,15,10,3,10,2,2,13,15.4,11,13,1,12,5,20,8,0,0,2017-2018,90.0,42.45283018867925,127.35849056603774
149,Jordan Ayew,GHA,"FW,MF",Swansea City,Premier League,25,1991,31.7,82,60,20,35,27,15,54,27.8,39,43,3,40,24,106,20,1,0,2017-2018,90.0,68.13880126182966,232.80757097791798
150,Karim Azamoum,FRA,MF,Troyes,Ligue 1,27,1990,25.0,84,57,41,37,6,27,68,39.7,41,30,11,19,26,110,61,3,0,2017-2018,90.0,93.6,302.4
151,César Azpilicueta,ESP,DF,Chelsea,Premier League,27,1989,37.0,80,59,47,26,7,27,54,50.0,27,48,22,26,54,134,135,1,0,2017-2018,90.0,131.35135135135135,194.5945945945946
152,Ludovic Baal,GUF,DF,Rennes,Ligue 1,31,1986,12.9,41,27,29,8,4,13,35,37.1,22,13,2,11,15,56,37,1,0,2017-2018,90.0,104.65116279069767,286.04651162790697
153,Khouma Babacar,SEN,FW,Fiorentina,Serie A,24,1993,5.0,4,4,3,0,1,2,4,50.0,2,0,0,0,2,6,5,0,0,2017-2018,90.0,36.0,72.0
154,Khouma Babacar,SEN,FW,Sassuolo,Serie A,24,1993,8.3,10,6,2,4,4,2,6,33.3,4,8,0,8,3,13,1,0,0,2017-2018,90.0,32.53012048192771,108.43373493975902
155,Carlos Bacca,COL,FW,Villarreal,La Liga,30,1986,27.7,10,2,2,4,4,1,12,8.3,11,16,1,15,8,18,16,0,0,2017-2018,90.0,25.9927797833935,32.49097472924188
156,Milan Badelj,CRO,MF,Fiorentina,Serie A,28,1989,26.1,71,41,26,38,7,28,71,39.4,43,48,2,46,71,142,52,3,0,2017-2018,90.0,244.8275862068965,244.8275862068965
157,Holger Badstuber,GER,"DF,MF",Stuttgart,Bundesliga,28,1989,24.1,44,32,29,14,1,22,39,56.4,17,27,14,13,41,85,111,4,0,2017-2018,90.0,153.11203319502076,164.31535269709542
158,Dylan Bahamboula,CGO,"FW,MF",Dijon,Ligue 1,22,1995,0.3,0,0,0,0,0,0,0,0.0,0,0,0,0,0,0,0,0,0,2017-2018,90.0,0.0,0.0
159,Farès Bahlouli,FRA,"MF,FW",Lille,Ligue 1,22,1995,3.4,10,8,4,3,3,2,7,28.6,5,7,0,7,1,11,1,0,0,2017-2018,90.0,26.470588235294116,264.70588235294116
160,Stéphane Bahoken,CMR,FW,Strasbourg,Ligue 1,25,1992,18.5,16,11,3,8,5,4,22,18.2,18,18,1,17,9,25,1,0,0,2017-2018,90.0,43.78378378378378,77.83783783783784
161,Daniel Baier,GER,MF,Augsburg,Bundesliga,33,1984,28.2,83,62,38,40,5,46,83,55.4,37,26,5,21,57,140,41,1,0,2017-2018,89.99999999999999,181.91489361702128,264.89361702127655
162,Leon Bailey,JAM,"FW,DF",Leverkusen,Bundesliga,19,1997,24.6,16,12,7,4,5,8,13,61.5,5,28,0,28,15,31,6,0,0,2017-2018,89.99999999999999,54.878048780487795,58.536585365853654
163,Eric Bailly,CIV,DF,Manchester Utd,Premier League,23,1994,11.1,17,10,10,5,2,5,12,41.7,7,11,6,5,25,42,58,1,0,2017-2018,90.0,202.7027027027027,137.83783783783784
164,Leighton Baines,ENG,DF,Everton,Premier League,32,1984,21.2,25,13,18,3,4,9,14,64.3,5,18,6,12,25,50,56,0,0,2017-2018,90.0,106.13207547169812,106.13207547169812
165,Riad Bajić,BIH,"FW,MF",Udinese,Serie A,23,1994,0.9,0,0,0,0,0,0,0,0.0,0,0,0,0,0,0,3,0,0,2017-2018,90.0,0.0,0.0
166,Marvin Bakalorz,GER,MF,Hannover 96,Bundesliga,27,1989,22.8,44,25,19,23,2,22,37,59.5,15,38,7,31,20,64,46,1,0,2017-2018,90.0,78.94736842105263,173.68421052631578
167,Cédric Bakambu,COD,FW,Villarreal,La Liga,26,1991,14.0,10,7,3,6,1,1,7,14.3,6,9,1,8,3,13,27,0,0,2017-2018,90.0,19.285714285714285,64.28571428571428
168,Tiemoué Bakayoko,FRA,MF,Chelsea,Premier League,22,1994,23.6,64,41,25,32,7,16,48,33.3,32,23,6,17,37,101,38,4,0,2017-2018,90.0,141.10169491525423,244.06779661016947
169,Zakaria Bakkali,BEL,"FW,MF",La Coruña,La Liga,21,1996,10.1,12,10,7,4,1,4,14,28.6,10,5,0,5,4,16,6,0,0,2017-2018,90.0,35.64356435643565,106.93069306930693
170,Ridle Baku,GER,MF,Mainz 05,Bundesliga,19,1998,2.6,3,3,1,1,1,0,1,0.0,1,3,0,3,3,6,2,0,0,2017-2018,90.0,103.84615384615384,103.84615384615384
171,Keita Baldé,SEN,"FW,MF",Monaco,Ligue 1,22,1995,16.4,12,8,5,6,1,1,11,9.1,10,10,1,9,6,18,5,0,0,2017-2018,90.0,32.926829268292686,65.85365853658537
172,Sam Baldock,ENG,FW,Brighton,Premier League,28,1989,0.4,0,0,0,0,0,0,0,0.0,0,0,0,0,0,0,0,0,0,2017-2018,90.0,0.0,0.0
173,Gareth Bale,WAL,"FW,MF",Real Madrid,La Liga,28,1989,20.0,19,13,7,8,4,3,14,21.4,11,13,1,12,12,31,18,0,0,2017-2018,90.0,54.0,85.5
174,Mikel Balenziaga,ESP,DF,Athletic Club,La Liga,29,1988,17.2,34,24,17,13,4,15,27,55.6,12,24,5,19,17,51,61,0,0,2017-2018,90.0,88.95348837209303,177.90697674418607
175,Andrija Balić,CRO,MF,Udinese,Serie A,19,1997,12.0,18,9,5,12,1,8,27,29.6,19,6,3,3,16,34,13,0,0,2017-2018,90.0,120.0,135.0
176,Iván Balliu,ALB,DF,Metz,Ligue 1,25,1992,21.7,34,22,22,6,6,12,28,42.9,16,23,9,14,27,61,64,1,0,2017-2018,90.0,111.9815668202765,141.01382488479263
177,Fodé Ballo-Touré,SEN,DF,Lille,Ligue 1,20,1997,22.8,50,36,29,16,5,21,47,44.7,26,27,2,25,28,78,47,1,0,2017-2018,90.0,110.52631578947367,197.36842105263156
178,Florent Balmont,FRA,MF,Dijon,Ligue 1,37,1980,9.6,14,9,4,9,1,4,25,16.0,21,15,1,14,8,22,5,0,0,2017-2018,90.0,75.0,131.25
179,Leon Balogun,NGA,DF,Mainz 05,Bundesliga,29,1988,13.0,39,32,27,11,1,22,31,71.0,9,21,9,12,32,71,64,0,0,2017-2018,90.00000000000001,221.53846153846155,270.0
180,Mario Balotelli,ITA,FW,Nice,Ligue 1,26,1990,25.2,7,4,1,3,3,0,6,0.0,6,9,2,7,8,15,26,0,0,2017-2018,90.0,28.571428571428573,25.000000000000004
181,Abdoulaye Bamba,CIV,DF,Angers,Ligue 1,27,1990,17.0,29,22,23,6,0,16,30,53.3,14,8,1,7,11,40,52,0,0,2017-2018,90.0,58.23529411764706,153.52941176470588
182,Jonathan Bamba,CIV,FW,Saint-Étienne,Ligue 1,21,1996,28.6,30,21,18,11,1,12,61,19.7,49,30,4,26,19,49,17,0,0,2017-2018,90.0,59.79020979020979,94.40559440559441
183,Yacine Bammou,MAR,"MF,FW",Nantes,Ligue 1,25,1991,8.1,18,11,6,10,2,4,14,28.6,10,16,4,12,6,24,9,0,0,2017-2018,90.0,66.66666666666667,200.0
184,Éver Banega,ARG,MF,Sevilla,La Liga,29,1988,26.7,71,53,25,37,9,22,63,34.9,41,23,1,22,12,83,17,3,0,2017-2018,90.00000000000001,40.449438202247194,239.32584269662925
185,Mattia Bani,ITA,DF,Chievo,Serie A,23,1993,14.6,28,20,22,6,0,11,26,42.3,15,19,10,9,27,55,111,0,0,2017-2018,90.0,166.43835616438358,172.6027397260274
186,Beni Baningime,COD,MF,Everton,Premier League,18,1998,2.2,6,2,1,2,3,0,4,0.0,4,5,1,4,2,8,2,0,0,2017-2018,90.0,81.81818181818181,245.45454545454544
187,Léo Baptistão,BRA,"FW,MF",Espanyol,La Liga,24,1992,29.7,54,34,12,28,14,13,52,25.0,39,22,1,21,23,77,25,0,0,2017-2018,90.0,69.69696969696969,163.63636363636363
188,Sekou Baradji,FRA,MF,Amiens,Ligue 1,33,1984,0.1,0,0,0,0,0,0,0,0.0,0,0,0,0,1,1,0,0,0,2017-2018,90.0,900.0,0.0
189,Antonín Barák,CZE,MF,Udinese,Serie A,22,1994,30.1,58,38,22,27,9,21,58,36.2,37,34,2,32,18,76,26,1,0,2017-2018,90.00000000000001,53.82059800664452,173.42192691029902
190,Andrea Barberis,ITA,MF,Crotone,Serie A,23,1993,33.7,80,44,33,42,5,16,68,23.5,52,52,5,47,58,138,67,1,0,2017-2018,90.0,154.89614243323442,213.64985163204747
191,Mariano Barbosa,ARG,GK,Villarreal,La Liga,33,1984,12.5,0,0,0,0,0,0,0,0.0,0,0,0,0,1,1,4,0,0,2017-2018,90.0,7.199999999999999,0.0
192,Enis Bardhi,MKD,MF,Levante,La Liga,22,1995,17.6,39,26,14,16,9,10,38,26.3,28,11,0,11,16,55,7,0,0,2017-2018,90.0,81.81818181818181,199.43181818181816
193,Phil Bardsley,SCO,DF,Burnley,Premier League,32,1985,12.5,17,16,9,7,1,4,11,36.4,7,22,6,16,22,39,77,0,0,2017-2018,90.0,158.4,122.39999999999999
194,Nicolò Barella,ITA,MF,Cagliari,Serie A,20,1997,32.8,92,69,37,43,12,25,78,32.1,53,48,6,42,45,137,53,0,0,2017-2018,90.0,123.47560975609757,252.43902439024393
195,Philipp Bargfrede,GER,MF,Werder Bremen,Bundesliga,28,1989,20.7,60,45,29,30,1,33,55,60.0,22,35,12,23,47,107,52,0,0,2017-2018,90.0,204.34782608695653,260.8695652173913
196,Ross Barkley,ENG,MF,Chelsea,Premier League,23,1993,1.4,0,0,0,0,0,0,1,0.0,1,3,1,2,0,0,2,0,0,2017-2018,90.0,0.0,0.0
197,Aymen Barkok,MAR,"FW,MF",Eint Frankfurt,Bundesliga,19,1998,3.5,11,11,6,4,1,5,7,71.4,2,8,2,6,2,13,3,0,0,2017-2018,90.0,51.42857142857143,282.85714285714283
198,Ashley Barnes,ENG,FW,Burnley,Premier League,27,1989,24.1,21,14,1,14,6,5,29,17.2,24,26,5,21,2,23,19,0,0,2017-2018,90.0,7.468879668049793,78.42323651452283
199,Harvey Barnes,ENG,"MF,FW",Leicester City,Premier League,19,1997,0.1,0,0,0,0,0,0,0,0.0,0,0,0,0,0,0,0,0,0,2017-2018,90.0,0.0,0.0
200,Antonio Barragán,ESP,DF,Betis,La Liga,30,1987,26.4,59,42,40,11,8,24,36,66.7,12,22,5,17,24,83,66,0,0,2017-2018,90.0,81.81818181818181,201.13636363636363
201,Antonio Barreca,ITA,DF,Torino,Serie A,22,1995,5.2,9,8,3,5,1,4,4,100.0,0,3,0,3,5,14,16,0,0,2017-2018,90.0,86.53846153846153,155.76923076923075
202,Édgar Barreto,PAR,MF,Sampdoria,Serie A,33,1984,21.8,67,42,23,32,12,18,70,25.7,52,45,2,43,21,88,29,3,0,2017-2018,90.0,86.69724770642202,276.60550458715596
203,Barri,ESP,"MF,FW",Getafe,La Liga,21,1995,1.3,1,0,0,1,0,0,4,0.0,4,1,1,0,1,2,3,0,0,2017-2018,90.0,69.23076923076923,69.23076923076923
204,Musa Barrow,GAM,FW,Atalanta,Serie A,18,1998,4.9,5,2,1,3,1,2,4,50.0,2,2,0,2,1,6,2,0,0,2017-2018,90.0,18.36734693877551,91.83673469387755
205,Gareth Barry,ENG,MF,West Brom,Premier League,36,1981,21.4,35,19,17,14,4,15,45,33.3,30,19,11,8,14,49,34,0,0,2017-2018,90.0,58.8785046728972,147.196261682243
206,Fin Bartels,GER,FW,Werder Bremen,Bundesliga,30,1987,12.5,12,9,4,3,5,4,12,33.3,8,5,1,4,7,19,1,1,0,2017-2018,90.0,50.4,86.39999999999999
207,Kyle Bartley,ENG,DF,Swansea City,Premier League,26,1991,2.6,3,2,3,0,0,2,2,100.0,0,6,6,0,4,7,21,0,0,2017-2018,90.0,138.46153846153845,103.84615384615384
208,Marc Bartra,ESP,DF,Betis,La Liga,26,1991,15.8,38,28,30,8,0,21,39,53.8,18,19,10,9,32,70,97,1,0,2017-2018,90.0,182.2784810126582,216.4556962025316
209,Marc Bartra,ESP,DF,Dortmund,Bundesliga,26,1991,9.0,28,19,16,12,0,15,24,62.5,9,14,2,12,28,56,43,1,0,2017-2018,90.0,280.0,280.0
210,Andrea Barzagli,ITA,DF,Juventus,Serie A,36,1981,16.1,26,15,14,11,1,9,16,56.3,7,14,7,7,17,43,46,0,0,2017-2018,90.0,95.03105590062111,145.3416149068323
211,Daniele Baselli,ITA,MF,Torino,Serie A,25,1992,28.0,63,33,23,36,4,20,56,35.7,36,29,5,24,57,120,40,1,0,2017-2018,90.0,183.21428571428572,202.5
212,Nicolas Basin,FRA,DF,Metz,Ligue 1,19,1998,3.5,9,7,5,3,1,4,9,44.4,5,6,3,3,8,17,14,0,0,2017-2018,90.0,205.71428571428572,231.42857142857142
213,Dušan Basta,SRB,DF,Lazio,Serie A,32,1984,8.6,9,7,4,3,2,6,14,42.9,8,10,3,7,13,22,15,0,0,2017-2018,90.0,136.046511627907,94.18604651162792
214,Gil Bastião Dias,POR,"FW,MF",Fiorentina,Serie A,20,1996,13.2,49,31,28,15,6,19,48,39.6,29,23,0,23,19,68,12,1,0,2017-2018,90.0,129.54545454545453,334.09090909090907
215,Gil Bastião Dias,POR,MF,Monaco,Ligue 1,20,1996,0.1,1,1,0,1,0,0,0,0.0,0,0,0,0,0,1,0,0,0,2017-2018,90.0,0.0,900.0
216,Samuel Bastien,COD,MF,Chievo,Serie A,20,1996,15.1,17,13,7,8,2,7,23,30.4,16,23,2,21,18,35,25,0,0,2017-2018,90.0,107.28476821192054,101.32450331125828
217,Borja Bastón,ESP,FW,Málaga,La Liga,24,1992,10.9,9,7,1,6,2,1,13,7.7,12,7,0,7,3,12,5,0,0,2017-2018,90.0,24.77064220183486,74.31192660550458
218,Alessandro Bastoni,ITA,DF,Atalanta,Serie A,18,1999,1.0,2,2,2,0,0,1,1,100.0,0,0,0,0,1,3,3,0,0,2017-2018,90.0,90.0,180.0
219,Bastos,ANG,DF,Lazio,Serie A,26,1991,15.6,33,24,19,13,1,19,30,63.3,11,13,8,5,24,57,67,0,0,2017-2018,90.0,138.46153846153845,190.3846153846154
220,Michy Batshuayi,BEL,FW,Chelsea,Premier League,23,1993,4.0,5,4,2,3,0,1,3,33.3,2,0,0,0,1,6,3,0,0,2017-2018,90.0,22.5,112.5
221,Michy Batshuayi,BEL,FW,Dortmund,Bundesliga,23,1993,9.3,8,6,1,4,3,2,4,50.0,2,4,0,4,0,8,5,0,0,2017-2018,90.0,0.0,77.41935483870967
222,Moritz Bauer,AUT,"DF,MF",Stoke City,Premier League,25,1992,14.5,24,17,17,7,0,10,26,38.5,16,9,1,8,12,36,48,0,0,2017-2018,90.0,74.48275862068965,148.9655172413793
223,Robert Bauer,GER,"DF,FW",Werder Bremen,Bundesliga,22,1995,10.6,31,25,21,9,1,15,25,60.0,10,8,2,6,21,52,25,2,0,2017-2018,90.0,178.30188679245285,263.20754716981133
224,Oliver Baumann,GER,GK,Hoffenheim,Bundesliga,27,1990,34.0,0,0,0,0,0,0,2,0.0,2,0,0,0,1,1,15,6,0,2017-2018,90.0,2.6470588235294117,0.0
225,Timo Baumgartl,GER,DF,Stuttgart,Bundesliga,21,1996,29.0,87,71,55,29,3,56,75,74.7,19,50,21,29,34,121,132,1,0,2017-2018,90.0,105.51724137931033,270.0
226,Julian Baumgartlinger,AUT,"MF,DF",Leverkusen,Bundesliga,29,1988,15.5,47,37,21,21,5,14,29,48.3,15,25,2,23,18,65,23,0,0,2017-2018,90.0,104.51612903225806,272.9032258064516
227,Jon Bautista,ESP,"FW,MF",Real Sociedad,La Liga,22,1995,2.0,0,0,0,0,0,0,1,0.0,1,2,0,2,0,0,0,0,0,2017-2018,90.0,0.0,0.0
228,Paul Baysse,FRA,DF,Málaga,La Liga,29,1988,13.8,25,16,21,3,1,10,17,58.8,7,10,6,4,20,45,84,0,0,2017-2018,90.0,130.43478260869563,163.04347826086953
229,Paul Baysse,FRA,DF,Bordeaux,Ligue 1,29,1988,6.3,4,2,3,1,0,1,5,20.0,4,4,3,1,7,11,38,1,0,2017-2018,90.0,100.00000000000001,57.142857142857146
230,Noah Joel Sarenren Bazee,NGA,"FW,MF",Hannover 96,Bundesliga,20,1996,1.3,0,0,0,0,0,0,0,0.0,0,3,0,3,0,0,3,0,0,2017-2018,90.0,0.0,0.0
231,Hervé Bazile,HAI,"MF,FW",Caen,Ligue 1,27,1990,9.7,21,15,9,7,5,5,15,33.3,10,22,0,22,15,36,8,0,0,2017-2018,90.0,139.1752577319588,194.8453608247423
232,Riechedly Bazoer,NED,MF,Wolfsburg,Bundesliga,20,1996,6.6,8,7,5,2,1,2,4,50.0,2,2,1,1,8,16,4,1,0,2017-2018,90.0,109.0909090909091,109.0909090909091
233,Enrico Bearzotti,ITA,"DF,FW",Hellas Verona,Serie A,20,1996,4.6,3,2,2,0,1,1,4,25.0,3,3,1,2,4,7,18,0,0,2017-2018,90.0,78.26086956521739,58.69565217391305
234,Claudio Beauvue,GLP,FW,Leganés,La Liga,29,1988,18.6,5,3,2,2,1,1,12,8.3,11,7,0,7,2,7,16,0,0,2017-2018,90.0,9.677419354838708,24.193548387096772
235,Bebé,CPV,"MF,FW",Eibar,La Liga,27,1990,4.1,9,7,1,4,4,3,8,37.5,5,5,0,5,3,12,1,0,0,2017-2018,90.0,65.85365853658537,197.56097560975613
236,Ihlas Bebou,TOG,"MF,FW",Hannover 96,Bundesliga,23,1994,23.8,37,29,15,17,5,14,27,51.9,13,34,3,31,24,61,27,0,0,2017-2018,90.00000000000001,90.75630252100841,139.91596638655463
237,Andreas Beck,GER,DF,Stuttgart,Bundesliga,30,1987,21.4,46,29,27,16,3,21,31,67.7,10,32,2,30,19,65,46,1,0,2017-2018,90.0,79.90654205607477,193.45794392523365
238,Henri Bedimo,CMR,"DF,FW",Marseille,Ligue 1,33,1984,0.5,0,0,0,0,0,0,1,0.0,1,0,0,0,1,1,1,0,0,2017-2018,90.0,180.0,0.0
239,Jan Bednarek,POL,DF,Southampton,Premier League,21,1996,4.7,6,3,6,0,0,3,6,50.0,3,2,1,1,5,11,27,0,0,2017-2018,90.0,95.74468085106382,114.89361702127658
240,Asmir Begović,BIH,GK,Bournemouth,Premier League,30,1987,38.0,0,0,0,0,0,0,2,0.0,2,0,0,0,2,2,16,7,0,2017-2018,90.0,4.7368421052631575,0.0
241,Valon Behrami,SUI,MF,Udinese,Serie A,32,1985,15.5,63,46,30,27,6,8,44,18.2,36,47,15,32,22,85,19,0,0,2017-2018,90.0,127.74193548387098,365.80645161290323
242,Vid Belec,SVN,GK,Benevento,Serie A,27,1990,12.4,0,0,0,0,0,0,0,0.0,0,0,0,0,1,1,6,1,0,2017-2018,90.0,7.258064516129032,0.0
243,Vid Belec,SVN,GK,Sampdoria,Serie A,27,1990,2.0,0,0,0,0,0,0,0,0.0,0,0,0,0,0,0,1,0,0,2017-2018,90.0,0.0,0.0
244,Ishak Belfodil,ALG,FW,Werder Bremen,Bundesliga,25,1992,15.0,7,6,2,3,2,0,3,0.0,3,10,1,9,1,8,9,0,0,2017-2018,90.0,6.0,42.0
245,Stefan Bell,GER,DF,Mainz 05,Bundesliga,25,1991,24.2,36,25,23,13,0,27,39,69.2,12,35,18,17,46,82,123,2,0,2017-2018,90.0,171.07438016528926,133.88429752066116
246,Karim Bellarabi,GER,"MF,FW",Leverkusen,Bundesliga,27,1990,12.7,22,17,10,9,3,10,19,52.6,9,26,1,25,13,35,5,0,0,2017-2018,90.0,92.1259842519685,155.90551181102364
247,Héctor Bellerín,ESP,DF,Arsenal,Premier League,22,1995,33.9,57,43,36,12,9,25,52,48.1,27,42,8,34,23,80,89,4,0,2017-2018,90.0,61.06194690265487,151.3274336283186
248,François Bellugou,FRA,MF,Troyes,Ligue 1,30,1987,24.2,48,33,23,21,4,21,49,42.9,28,20,6,14,28,76,45,0,0,2017-2018,90.0,104.13223140495867,178.51239669421486
249,Andrea Belotti,ITA,FW,Torino,Serie A,23,1993,29.8,32,23,9,15,8,3,30,10.0,27,14,1,13,6,38,19,1,0,2017-2018,90.0,18.120805369127517,96.64429530201342
250,Chaouki Ben Saada,TUN,"FW,MF",Troyes,Ligue 1,33,1984,3.8,11,8,5,3,3,2,11,18.2,9,3,0,3,2,13,3,0,0,2017-2018,90.0,47.368421052631575,260.5263157894737
251,Wissam Ben Yedder,FRA,FW,Sevilla,La Liga,26,1990,18.9,12,8,2,5,5,1,2,50.0,1,10,0,10,5,17,2,0,0,2017-2018,90.0,23.80952380952381,57.142857142857146
252,Diego Benaglio,SUI,GK,Monaco,Ligue 1,33,1983,2.5,0,0,0,0,0,0,0,0.0,0,0,0,0,0,0,0,0,0,2017-2018,90.0,0.0,0.0
253,Ahmad Benali,LBY,MF,Crotone,Serie A,25,1992,9.0,19,10,8,10,1,5,27,18.5,22,14,1,13,8,27,15,0,0,2017-2018,90.0,80.0,190.0
254,Yohan Benalouane,TUN,DF,Leicester City,Premier League,30,1987,1.0,7,3,6,1,0,4,6,66.7,2,1,1,0,1,8,4,0,0,2017-2018,90.0,90.0,630.0
255,Marco Benassi,ITA,"MF,FW",Fiorentina,Serie A,22,1994,30.9,54,38,18,22,14,17,52,32.7,35,52,2,50,28,82,36,0,0,2017-2018,90.0,81.55339805825243,157.28155339805826
256,Medhi Benatia,MAR,DF,Juventus,Serie A,30,1987,19.5,28,21,20,6,2,8,15,53.3,7,18,13,5,43,71,89,1,0,2017-2018,90.0,198.46153846153845,129.23076923076923
257,Lars Bender,GER,"DF,MF",Leverkusen,Bundesliga,28,1989,17.7,63,52,26,32,5,35,53,66.0,18,34,7,27,28,91,40,0,0,2017-2018,90.0,142.3728813559322,320.3389830508475
258,Sven Bender,GER,DF,Leverkusen,Bundesliga,28,1989,26.1,51,37,33,18,0,26,34,76.5,8,49,21,28,50,101,123,1,0,2017-2018,90.0,172.41379310344826,175.8620689655172
259,László Bénes,SVK,MF,Gladbach,Bundesliga,19,1997,0.4,0,0,0,0,0,0,1,0.0,1,2,1,1,1,1,2,0,0,2017-2018,90.0,225.0,0.0
260,Nicolas Benezet,FRA,"FW,MF",Guingamp,Ligue 1,26,1991,18.3,38,30,18,16,4,11,37,29.7,26,8,2,6,12,50,7,0,0,2017-2018,90.0,59.01639344262295,186.88524590163934
261,Marcel Benger,GER,MF,Gladbach,Bundesliga,19,1998,0.0,0,0,0,0,0,0,0,0.0,0,0,0,0,0,0,0,0,0,2017-2018,,,
262,Walter Benítez,ARG,GK,Nice,Ligue 1,24,1993,28.0,0,0,0,0,0,0,2,0.0,2,0,0,0,0,0,5,3,0,2017-2018,90.0,0.0,0.0
263,Charlison Benschop,CUW,"MF,DF",Hannover 96,Bundesliga,27,1989,2.0,4,4,1,3,0,3,8,37.5,5,1,0,1,2,6,2,0,0,2017-2018,90.0,90.0,180.0
264,Ramy Bensebaini,ALG,DF,Rennes,Ligue 1,22,1995,26.0,56,39,31,21,4,26,55,47.3,29,24,16,8,37,93,177,1,0,2017-2018,90.00000000000001,128.0769230769231,193.84615384615387
265,Nabil Bentaleb,ALG,MF,Schalke 04,Bundesliga,22,1994,11.2,25,22,7,17,1,8,23,34.8,15,18,6,12,23,48,27,2,0,2017-2018,90.0,184.82142857142858,200.89285714285714
266,Rodrigo Bentancur,URU,MF,Juventus,Serie A,20,1997,6.5,18,11,10,7,1,2,16,12.5,14,5,1,4,3,21,14,0,0,2017-2018,90.00000000000001,41.53846153846154,249.23076923076925
267,Christian Benteke,BEL,FW,Crystal Palace,Premier League,26,1990,24.9,11,4,3,7,1,2,17,11.8,15,15,3,12,3,14,44,0,0,2017-2018,90.0,10.843373493975903,39.75903614457831
268,Karim Benzema,FRA,FW,Real Madrid,La Liga,29,1987,23.9,14,8,2,6,6,3,20,15.0,17,18,0,18,8,22,19,0,0,2017-2018,90.0,30.125523012552303,52.71966527196653
269,Yassine Benzia,ALG,"MF,FW",Lille,Ligue 1,22,1994,25.4,62,41,21,31,10,17,62,27.4,45,31,4,27,28,90,14,0,0,2017-2018,90.0,99.21259842519686,219.68503937007875
270,Saido Berahino,BDI,FW,Stoke City,Premier League,23,1993,5.5,2,2,0,1,1,0,1,0.0,1,4,1,3,1,3,2,0,0,2017-2018,90.0,16.363636363636363,32.72727272727273
271,Domenico Berardi,ITA,FW,Sassuolo,Serie A,22,1994,25.5,31,17,9,16,6,11,65,16.9,54,23,0,23,17,48,14,1,0,2017-2018,90.0,60.0,109.41176470588236
272,Yuri Berchiche,ESP,DF,Paris S-G,Ligue 1,27,1990,19.1,39,27,21,11,7,12,25,48.0,13,15,2,13,24,63,53,0,0,2017-2018,90.0,113.08900523560209,183.7696335078534
273,Álex Berenguer,ESP,FW,Torino,Serie A,22,1995,11.6,18,15,7,8,3,5,17,29.4,12,22,3,19,10,28,13,0,0,2017-2018,90.0,77.58620689655173,139.6551724137931
274,Bartosz Bereszyński,POL,DF,Sampdoria,Serie A,25,1992,27.6,63,47,30,28,5,31,53,58.5,22,33,8,25,30,93,98,2,0,2017-2018,90.0,97.82608695652173,205.43478260869563
275,Jóhann Berg Guðmundsson,ISL,MF,Burnley,Premier League,26,1990,31.5,43,27,16,19,8,20,47,42.6,27,21,1,20,34,77,43,0,0,2017-2018,90.0,97.14285714285715,122.85714285714286
276,Markel Bergara,ESP,MF,Getafe,La Liga,31,1986,16.3,35,22,17,17,1,7,25,28.0,18,10,3,7,23,58,20,0,0,2017-2018,90.0,126.99386503067484,193.25153374233128
277,Emil Berggreen,DEN,FW,Mainz 05,Bundesliga,24,1993,7.4,2,2,0,0,2,1,4,25.0,3,7,1,6,1,3,10,0,0,2017-2018,90.0,12.162162162162161,24.324324324324323
278,Robert Berić,SVN,FW,Saint-Étienne,Ligue 1,26,1991,11.6,6,4,1,3,2,1,16,6.3,15,9,1,8,5,11,4,0,0,2017-2018,90.0,38.793103448275865,46.55172413793103
279,Kévin Bérigaud,FRA,"FW,MF",Montpellier,Ligue 1,29,1988,3.0,4,3,1,1,2,2,6,33.3,4,1,0,1,0,4,1,0,0,2017-2018,90.0,0.0,120.0
280,Etrit Berisha,ALB,GK,Atalanta,Serie A,28,1989,31.0,1,1,1,0,0,1,1,100.0,0,0,0,0,1,2,5,3,0,2017-2018,90.0,2.903225806451613,2.903225806451613
281,Federico Bernardeschi,ITA,"FW,MF",Juventus,Serie A,23,1994,9.4,8,5,4,3,1,1,7,14.3,6,9,0,9,11,19,18,1,0,2017-2018,90.0,105.31914893617021,76.59574468085106
282,Bernardo,BRA,DF,RB Leipzig,Bundesliga,22,1995,15.0,43,30,18,22,3,29,40,72.5,11,30,6,24,18,61,81,0,0,2017-2018,90.0,108.0,258.0
283,Juan Bernat,ESP,"DF,FW",Bayern Munich,Bundesliga,24,1993,9.9,25,19,13,8,4,11,18,61.1,7,11,1,10,10,35,9,1,0,2017-2018,90.0,90.9090909090909,227.27272727272728
284,Andrea Bertolacci,ITA,MF,Genoa,Serie A,26,1991,32.2,85,53,40,38,7,21,63,33.3,42,46,12,34,46,131,37,1,0,2017-2018,90.0,128.57142857142856,237.57763975155277
285,Ryan Bertrand,ENG,DF,Southampton,Premier League,27,1989,34.8,48,35,27,17,4,19,31,61.3,12,28,9,19,44,92,74,0,0,2017-2018,90.0,113.79310344827586,124.13793103448276
286,Muhamed Bešić,BIH,MF,Everton,Premier League,24,1992,0.5,1,1,1,0,0,1,3,33.3,2,2,2,0,0,1,1,0,0,2017-2018,90.0,0.0,180.0
287,Daniel Bessa,ITA,"MF,FW",Hellas Verona,Serie A,24,1993,15.4,26,19,9,15,2,8,29,27.6,21,12,2,10,14,40,8,1,0,2017-2018,90.0,81.81818181818183,151.94805194805195
288,Daniel Bessa,ITA,MF,Genoa,Serie A,24,1993,4.9,6,6,2,2,2,0,1,0.0,1,7,0,7,3,9,6,0,0,2017-2018,90.0,55.10204081632653,110.20408163265306
289,Vincent Bessat,FRA,"DF,MF",Caen,Ligue 1,31,1985,17.4,41,27,23,16,2,22,48,45.8,26,19,1,18,18,59,18,0,0,2017-2018,90.0,93.10344827586206,212.0689655172414
290,Quentin Beunardeau,FRA,GK,Metz,Ligue 1,23,1994,0.4,0,0,0,0,0,0,0,0.0,0,0,0,0,0,0,0,0,0,2017-2018,90.0,0.0,0.0
291,Matteo Bianchetti,ITA,DF,Hellas Verona,Serie A,24,1993,1.4,3,1,3,0,0,1,3,33.3,2,3,2,1,2,5,8,0,0,2017-2018,90.0,128.57142857142858,192.85714285714286
292,Ermin Bičakčić,BIH,DF,Hoffenheim,Bundesliga,27,1990,6.1,17,15,8,8,1,8,12,66.7,4,4,2,2,9,26,26,0,0,2017-2018,90.0,132.78688524590166,250.81967213114757
293,Pedro Bigas,ESP,DF,Las Palmas,La Liga,26,1990,9.9,14,9,10,4,0,7,13,53.8,6,18,11,7,16,30,41,2,0,2017-2018,90.0,145.45454545454547,127.27272727272727
294,Lucas Biglia,ARG,MF,Milan,Serie A,31,1986,22.7,59,36,28,26,5,22,61,36.1,39,49,12,37,28,87,51,1,0,2017-2018,89.99999999999999,111.01321585903084,233.92070484581495
295,Philip Billing,DEN,MF,Huddersfield,Premier League,21,1996,8.5,25,16,11,11,3,8,22,36.4,14,17,1,16,18,43,19,0,0,2017-2018,90.0,190.58823529411765,264.70588235294116
296,Jean-Claude Billong,CMR,DF,Benevento,Serie A,23,1993,3.3,9,7,5,4,0,5,8,62.5,3,4,3,1,6,15,17,0,0,2017-2018,90.0,163.63636363636363,245.45454545454547
297,Davide Biondini,ITA,MF,Sassuolo,Serie A,34,1983,2.3,4,4,2,2,0,1,2,50.0,1,1,0,1,3,7,1,0,0,2017-2018,90.0,117.3913043478261,156.52173913043478
298,Cristiano Biraghi,ITA,DF,Fiorentina,Serie A,24,1992,33.1,74,48,33,32,9,36,58,62.1,22,42,5,37,43,117,103,2,0,2017-2018,90.0,116.91842900302113,201.2084592145015
299,Mame Biram Diouf,SEN,"FW,DF",Stoke City,Premier League,29,1987,28.8,48,36,26,15,7,8,21,38.1,13,22,0,22,14,62,76,1,0,2017-2018,90.0,43.75,150.0
300,Davide Biraschi,ITA,DF,Genoa,Serie A,23,1994,20.0,33,25,13,19,1,18,25,72.0,7,19,10,9,38,71,78,0,0,2017-2018,90.0,171.0,148.5
301,Valter Birsa,SVN,"MF,FW",Chievo,Serie A,30,1986,27.8,28,14,7,18,3,7,54,13.0,47,22,2,20,24,52,20,1,0,2017-2018,90.0,77.6978417266187,90.64748201438849
302,Milan Biševac,SRB,DF,Metz,Ligue 1,33,1983,7.9,7,5,5,1,1,5,7,71.4,2,2,0,2,5,12,43,0,0,2017-2018,90.0,56.96202531645569,79.74683544303797
303,Yves Bissouma,MLI,"MF,DF",Lille,Ligue 1,20,1996,17.3,67,50,30,32,5,19,39,48.7,20,13,2,11,31,98,31,1,0,2017-2018,90.0,161.271676300578,348.55491329479764
304,Leonardo Bittencourt,GER,"MF,FW",Köln,Bundesliga,23,1993,17.9,49,42,17,21,11,19,43,44.2,24,26,0,26,17,66,11,1,0,2017-2018,90.0,85.47486033519554,246.36871508379892
305,Albano Bizzarri,ARG,GK,Udinese,Serie A,39,1977,32.0,2,2,2,0,0,2,2,100.0,0,0,0,0,1,3,12,4,0,2017-2018,90.0,2.8125,5.625
306,Rubén Blanco,ESP,GK,Celta Vigo,La Liga,22,1995,21.6,0,0,0,0,0,0,2,0.0,2,1,0,1,3,3,16,1,0,2017-2018,90.0,12.499999999999998,0.0
307,Ludovic Blas,FRA,MF,Guingamp,Ligue 1,19,1997,19.9,23,14,10,12,1,7,36,19.4,29,15,3,12,19,42,9,1,0,2017-2018,90.0,85.92964824120604,104.02010050251258
308,Pablo de Blasis,ARG,"FW,MF",Mainz 05,Bundesliga,29,1988,18.4,39,23,19,11,9,16,33,48.5,17,33,0,33,10,49,34,0,0,2017-2018,90.0,48.913043478260875,190.7608695652174
309,Jérémy Blayac,FRA,FW,Strasbourg,Ligue 1,34,1983,10.2,5,3,0,3,2,2,9,22.2,7,7,2,5,1,6,11,0,0,2017-2018,90.0,8.823529411764707,44.11764705882353
310,Alexis Blin,FRA,MF,Toulouse,Ligue 1,20,1996,21.0,57,37,23,30,4,22,69,31.9,47,27,6,21,31,88,31,0,0,2017-2018,90.0,132.85714285714286,244.28571428571428
311,Daley Blind,NED,"DF,MF",Manchester Utd,Premier League,27,1990,4.0,6,4,3,2,1,2,7,28.6,5,3,0,3,7,13,14,0,0,2017-2018,90.0,157.5,135.0
312,Danny Blum,GER,"MF,DF",Eint Frankfurt,Bundesliga,26,1991,0.3,0,0,0,0,0,0,0,0.0,0,0,0,0,1,1,0,0,0,2017-2018,90.0,300.0,0.0
313,Emmanuel Boateng,GHA,FW,Levante,La Liga,21,1996,14.2,4,3,0,0,4,0,6,0.0,6,8,1,7,5,9,17,0,0,2017-2018,90.0,31.690140845070424,25.35211267605634
314,Jérôme Boateng,GER,DF,Bayern Munich,Bundesliga,28,1988,18.2,26,18,18,7,1,19,32,59.4,13,20,12,8,21,47,52,1,0,2017-2018,90.0,103.84615384615385,128.57142857142858
315,Kevin-Prince Boateng,GHA,"MF,FW",Eint Frankfurt,Bundesliga,30,1987,26.2,34,22,10,22,2,11,36,30.6,25,29,6,23,23,57,43,1,0,2017-2018,90.0,79.00763358778626,116.79389312977099
316,Raúl Bobadilla,PAR,"FW,MF",Gladbach,Bundesliga,30,1987,5.0,7,6,1,3,3,4,8,50.0,4,6,0,6,0,7,1,0,0,2017-2018,90.0,0.0,126.0
317,Yann Bodiger,FRA,MF,Toulouse,Ligue 1,22,1995,2.5,3,1,0,3,0,1,6,16.7,5,0,0,0,2,5,3,0,0,2017-2018,90.0,72.0,108.0
318,Mathieu Bodmer,FRA,"DF,MF",Amiens,Ligue 1,34,1982,4.4,6,3,5,1,0,5,6,83.3,1,6,3,3,1,7,15,0,0,2017-2018,90.0,20.454545454545453,122.72727272727272
319,Jeremie Boga,CIV,MF,Chelsea,Premier League,20,1997,0.2,0,0,0,0,0,0,0,0.0,0,0,0,0,0,0,0,0,0,2017-2018,90.0,0.0,0.0
320,Quentin Boisgard,FRA,MF,Toulouse,Ligue 1,20,1997,2.0,2,2,0,2,0,0,3,0.0,3,2,0,2,0,2,1,0,0,2017-2018,90.0,0.0,90.0
321,Yannick Bolasie,COD,FW,Everton,Premier League,28,1989,9.5,8,7,4,1,3,2,7,28.6,5,5,0,5,4,12,8,0,0,2017-2018,90.0,37.89473684210526,75.78947368421052
322,Deian Boldor,ROU,DF,Hellas Verona,Serie A,22,1995,1.0,3,2,3,0,0,2,3,66.7,1,5,2,3,3,6,11,0,0,2017-2018,90.0,270.0,270.0
323,Giacomo Bonaventura,ITA,MF,Milan,Serie A,27,1989,28.2,31,20,7,19,5,9,45,20.0,36,31,6,25,33,64,17,0,0,2017-2018,89.99999999999999,105.31914893617021,98.93617021276596
324,Federico Bonazzoli,ITA,"FW,DF",SPAL,Serie A,20,1997,2.0,1,0,0,1,0,0,0,0.0,0,3,0,3,0,1,0,0,0,2017-2018,90.0,0.0,45.0
325,Federico Bonazzoli,ITA,FW,Sampdoria,Serie A,20,1997,0.3,0,0,0,0,0,0,0,0.0,0,0,0,0,0,0,0,0,0,2017-2018,90.0,0.0,0.0
326,Daniele Bonera,ITA,DF,Villarreal,La Liga,36,1981,13.2,16,11,8,7,1,10,15,66.7,5,17,12,5,12,28,72,0,0,2017-2018,90.0,81.81818181818181,109.0909090909091
327,Gaëtan Bong,CMR,DF,Brighton,Premier League,29,1988,24.8,39,32,25,11,3,15,26,57.7,11,24,6,18,40,79,81,1,0,2017-2018,90.0,145.16129032258064,141.53225806451613
328,Kevin Bonifazi,ITA,"DF,MF",Torino,Serie A,21,1996,4.5,11,7,6,5,0,4,6,66.7,2,7,5,2,13,24,15,0,0,2017-2018,90.0,260.0,220.0
329,Landry Bonnefoi,FRA,GK,Strasbourg,Ligue 1,33,1983,3.0,0,0,0,0,0,0,0,0.0,0,0,0,0,0,0,2,0,0,2017-2018,90.0,0.0,0.0
330,Leonardo Bonucci,ITA,DF,Milan,Serie A,30,1987,34.3,30,21,22,7,1,11,18,61.1,7,31,22,9,51,81,132,0,0,2017-2018,90.0,133.8192419825073,78.71720116618077
331,Wilfried Bony,CIV,FW,Swansea City,Premier League,28,1988,7.9,5,4,2,2,1,1,5,20.0,4,4,1,3,2,7,15,0,0,2017-2018,90.0,22.784810126582276,56.96202531645569
332,Celso Borges,CRC,MF,La Coruña,La Liga,29,1988,25.6,61,39,34,22,5,15,47,31.9,32,39,7,32,34,95,36,0,0,2017-2018,90.0,119.53125,214.453125
333,Fabio Borini,ITA,"DF,FW",Milan,Serie A,26,1991,17.9,38,23,12,18,8,16,37,43.2,21,32,6,26,13,51,43,0,0,2017-2018,90.0,65.36312849162012,191.06145251396651
334,Marco Borriello,ITA,FW,SPAL,Serie A,35,1982,8.6,4,2,2,1,1,0,1,0.0,1,1,0,1,1,5,6,0,0,2017-2018,90.0,10.465116279069768,41.86046511627907
335,Gabriel Boschilia,BRA,"FW,MF",Monaco,Ligue 1,21,1996,0.9,4,1,1,2,1,1,4,25.0,3,1,0,1,0,4,0,0,0,2017-2018,90.0,0.0,400.0
336,Ryad Boudebouz,ALG,"MF,FW",Betis,La Liga,27,1990,15.1,32,18,6,21,5,6,26,23.1,20,18,1,17,7,39,8,0,0,2017-2018,90.0,41.72185430463576,190.72847682119206
337,Jean-Christophe Bouet,FRA,GK,Amiens,Ligue 1,34,1983,1.0,0,0,0,0,0,0,0,0.0,0,0,0,0,0,0,0,0,0,2017-2018,90.0,0.0,0.0
338,Sofiane Boufal,MAR,"FW,MF",Southampton,Premier League,23,1993,13.5,37,24,12,14,11,12,35,34.3,23,20,1,19,6,43,6,0,0,2017-2018,90.0,40.0,246.66666666666669
339,Arnold Bouka Moutou,CGO,DF,Dijon,Ligue 1,28,1988,3.7,8,5,6,0,2,6,8,75.0,2,4,1,3,4,12,5,0,0,2017-2018,90.0,97.29729729729729,194.59459459459458
340,Farid Boulaya,ALG,"MF,FW",Metz,Ligue 1,24,1993,2.0,5,1,4,1,0,3,6,50.0,3,1,0,1,1,6,2,0,0,2017-2018,90.0,45.0,225.0
341,Yassine Bounou,MAR,GK,Girona,La Liga,26,1991,29.5,1,1,1,0,0,0,2,0.0,2,0,0,0,4,5,14,0,0,2017-2018,90.0,12.203389830508474,3.0508474576271185
342,Emmanuel Bourgaud,FRA,"FW,MF",Amiens,Ligue 1,29,1987,6.0,17,11,5,9,3,10,23,43.5,13,5,0,5,6,23,11,0,0,2017-2018,90.0,90.0,255.0
343,Benjamin Bourigeaud,FRA,"MF,FW",Rennes,Ligue 1,23,1994,34.5,55,30,18,30,7,20,93,21.5,73,48,4,44,45,100,29,0,0,2017-2018,90.0,117.39130434782608,143.47826086956522
344,Eneko Bóveda,ESP,DF,La Coruña,La Liga,28,1988,7.4,24,16,13,10,1,8,13,61.5,5,18,7,11,16,40,36,2,0,2017-2018,90.0,194.59459459459458,291.8918918918919
345,Eneko Bóveda,ESP,DF,Athletic Club,La Liga,28,1988,5.8,12,11,7,4,1,5,11,45.5,6,3,0,3,14,26,14,0,0,2017-2018,90.0,217.24137931034483,186.20689655172413
346,Lucas Boyé,ARG,FW,Torino,Serie A,21,1996,1.7,9,8,5,3,1,1,3,33.3,2,5,0,5,2,11,2,0,0,2017-2018,90.0,105.88235294117646,476.4705882352941
347,Lucas Boyé,ARG,"FW,MF",Celta Vigo,La Liga,21,1996,3.1,12,8,3,7,2,3,10,30.0,7,5,0,5,6,18,4,0,0,2017-2018,90.0,174.19354838709677,348.38709677419354
348,Robbie Brady,IRL,MF,Burnley,Premier League,25,1992,14.2,32,21,14,17,1,8,28,28.6,20,17,3,14,7,39,29,0,0,2017-2018,90.0,44.36619718309859,202.81690140845072
349,Martin Braithwaite,DEN,FW,Bordeaux,Ligue 1,26,1991,10.2,6,4,0,4,2,1,6,16.7,5,6,2,4,0,6,3,0,0,2017-2018,90.0,0.0,52.94117647058824
350,Brandon,ESP,"FW,MF",Rennes,Ligue 1,22,1995,4.0,10,9,3,4,3,1,11,9.1,10,11,1,10,5,15,1,0,0,2017-2018,90.0,112.5,225.0
351,Julian Brandt,GER,"FW,MF",Leverkusen,Bundesliga,21,1996,25.8,24,18,11,9,4,11,29,37.9,18,23,1,22,16,40,12,1,0,2017-2018,90.0,55.81395348837209,83.72093023255813
352,Darko Brašanac,SRB,"MF,FW",Leganés,La Liga,25,1992,13.4,32,17,11,17,4,13,33,39.4,20,14,3,11,14,46,12,0,0,2017-2018,90.0,94.02985074626865,214.92537313432834
353,Claudio Bravo,CHI,GK,Manchester City,Premier League,34,1983,2.5,0,0,0,0,0,0,1,0.0,1,0,0,0,0,0,0,0,0,2017-2018,90.0,0.0,0.0
354,Josip Brekalo,CRO,FW,Wolfsburg,Bundesliga,19,1998,9.7,15,12,6,7,2,6,12,50.0,6,17,0,17,4,19,3,0,0,2017-2018,90.0,37.11340206185567,139.1752577319588
355,Josip Brekalo,CRO,"MF,FW",Stuttgart,Bundesliga,19,1998,8.1,20,12,7,8,5,6,8,75.0,2,8,2,6,3,23,1,0,0,2017-2018,90.0,33.333333333333336,222.22222222222223
356,Jimmy Briand,FRA,FW,Guingamp,Ligue 1,31,1985,35.7,33,21,13,15,5,4,42,9.5,38,17,2,15,12,45,51,0,0,2017-2018,90.0,30.25210084033613,83.19327731092436
357,Enrico Brignola,ITA,"MF,FW",Benevento,Serie A,18,1999,15.0,28,21,17,10,1,12,38,31.6,26,13,0,13,6,34,7,0,0,2017-2018,90.0,36.0,168.0
358,Alberto Brignoli,ITA,GK,Benevento,Serie A,25,1991,12.5,0,0,0,0,0,0,0,0.0,0,0,0,0,0,0,15,3,0,2017-2018,90.0,0.0,0.0
359,Miguel Britos,URU,DF,Watford,Premier League,32,1985,8.9,15,11,10,5,0,6,11,54.5,5,9,1,8,12,27,45,1,0,2017-2018,90.0,121.34831460674158,151.68539325842696
360,Leon Britton,ENG,MF,Swansea City,Premier League,34,1982,3.4,6,5,0,5,1,5,8,62.5,3,3,1,2,1,7,1,0,0,2017-2018,90.0,26.470588235294116,158.8235294117647
361,Petar Brlek,CRO,MF,Genoa,Serie A,23,1994,2.6,9,7,4,5,0,3,7,42.9,4,0,0,0,1,10,3,0,0,2017-2018,90.0,34.61538461538461,311.5384615384615
362,John Brooks,USA,DF,Wolfsburg,Bundesliga,24,1993,8.1,20,13,15,4,1,16,22,72.7,6,11,5,6,10,30,46,0,0,2017-2018,90.0,111.11111111111111,222.22222222222223
363,Daniel Brosinski,GER,"DF,FW",Mainz 05,Bundesliga,29,1988,27.8,45,35,21,18,6,22,44,50.0,22,46,11,35,24,69,75,2,0,2017-2018,90.0,77.6978417266187,145.68345323741008
364,Izzy Brown,ENG,"MF,FW",Brighton,Premier League,20,1997,3.5,3,3,2,1,0,1,7,14.3,6,3,0,3,1,4,3,0,0,2017-2018,90.0,25.714285714285715,77.14285714285714
365,Marcelo Brozović,CRO,MF,Inter,Serie A,24,1992,21.4,60,43,21,31,8,19,63,30.2,44,30,7,23,18,78,18,0,0,2017-2018,90.0,75.70093457943926,252.33644859813086
366,Bruma,POR,"MF,FW",RB Leipzig,Bundesliga,22,1994,17.9,18,16,7,7,4,9,18,50.0,9,28,2,26,12,30,11,0,0,2017-2018,90.0,60.33519553072627,90.5027932960894
367,Jeffrey Bruma,NED,DF,Wolfsburg,Bundesliga,25,1991,11.0,13,11,13,0,0,6,14,42.9,8,17,12,5,14,27,43,2,0,2017-2018,90.0,114.54545454545455,106.36363636363637
368,Bruno,ESP,DF,Brighton,Premier League,36,1980,22.4,30,17,21,6,3,14,22,63.6,8,17,11,6,38,68,76,0,0,2017-2018,90.0,152.67857142857144,120.53571428571429
369,Chris Brunt,NIR,"MF,DF",West Brom,Premier League,32,1984,21.3,41,24,19,21,1,11,31,35.5,20,28,4,24,22,63,45,1,0,2017-2018,90.0,92.95774647887325,173.2394366197183
370,Jacob Bruun Larsen,DEN,"MF,DF",Stuttgart,Bundesliga,18,1998,1.2,0,0,0,0,0,0,0,0.0,0,1,0,1,1,1,2,0,0,2017-2018,90.0,75.0,0.0
371,Jacob Bruun Larsen,DEN,DF,Dortmund,Bundesliga,18,1998,0.1,1,1,1,0,0,1,2,50.0,1,0,0,0,0,1,0,0,0,2017-2018,90.0,0.0,900.0
372,Marcel Büchel,LIE,MF,Hellas Verona,Serie A,26,1991,18.8,37,21,15,21,1,13,48,27.1,35,35,6,29,45,82,46,1,0,2017-2018,90.0,215.4255319148936,177.12765957446808
373,Ante Budimir,CRO,FW,Crotone,Serie A,26,1991,17.6,28,20,4,16,8,2,20,10.0,18,20,3,17,7,35,27,0,0,2017-2018,90.0,35.79545454545455,143.1818181818182
374,Alberto Bueno,ESP,"MF,FW",Málaga,La Liga,29,1988,2.5,3,2,2,1,0,2,11,18.2,9,2,0,2,1,4,2,0,0,2017-2018,90.0,36.0,108.0
375,Gianluigi Buffon,ITA,GK,Juventus,Serie A,39,1978,20.7,0,0,0,0,0,0,0,0.0,0,0,0,0,0,0,11,2,0,2017-2018,90.0,0.0,0.0
376,Onur Bulut,TUR,FW,Freiburg,Bundesliga,23,1994,0.4,0,0,0,0,0,0,1,0.0,1,0,0,0,0,0,0,0,0,2017-2018,90.0,0.0,0.0
377,Alessandro Buongiorno,ITA,DF,Torino,Serie A,18,1999,0.1,0,0,0,0,0,0,0,0.0,0,0,0,0,0,0,1,0,0,2017-2018,90.0,0.0,0.0
378,Nicolás Burdisso,ARG,DF,Torino,Serie A,36,1981,23.0,20,11,13,7,0,7,11,63.6,4,23,14,9,30,50,124,3,0,2017-2018,90.0,117.3913043478261,78.26086956521739
379,Guido Burgstaller,AUT,FW,Schalke 04,Bundesliga,28,1989,25.8,14,9,0,10,4,4,14,28.6,10,28,3,25,10,24,9,0,0,2017-2018,90.0,34.883720930232556,48.837209302325576
380,Burgui,ESP,"MF,FW",Alavés,La Liga,23,1993,11.5,10,5,2,4,4,2,6,33.3,4,5,0,5,7,17,1,0,0,2017-2018,90.0,54.78260869565218,78.26086956521739
381,Oliver Burke,SCO,"FW,MF",West Brom,Premier League,20,1997,4.1,6,4,3,2,1,4,12,33.3,8,3,0,3,7,13,3,0,0,2017-2018,90.0,153.65853658536588,131.70731707317074
382,Roman Bürki,SUI,GK,Dortmund,Bundesliga,26,1990,33.0,1,1,1,0,0,1,3,33.3,2,1,0,1,0,1,10,4,0,2017-2018,90.0,0.0,2.7272727272727275
383,Patrick Burner,MTQ,DF,Nice,Ligue 1,21,1996,10.0,18,12,13,5,0,7,20,35.0,13,6,0,6,13,31,23,0,0,2017-2018,90.0,117.0,162.0
384,Dženis Burnić,BIH,MF,Stuttgart,Bundesliga,19,1998,3.4,9,6,2,5,2,4,10,40.0,6,2,0,2,4,13,3,0,0,2017-2018,90.0,105.88235294117646,238.23529411764704
385,Sergio Busquets,ESP,MF,Barcelona,La Liga,29,1988,28.8,88,48,27,46,15,39,79,49.4,40,37,10,27,51,139,15,1,0,2017-2018,90.0,159.375,275.0
386,Unai Bustinza,ESP,DF,Leganés,La Liga,25,1992,18.2,36,21,25,8,3,21,38,55.3,17,17,9,8,47,83,64,0,0,2017-2018,90.0,232.41758241758242,178.02197802197801
387,Ludovic Butelle,FRA,GK,Angers,Ligue 1,34,1983,18.4,0,0,0,0,0,0,0,0.0,0,0,0,0,1,1,10,2,0,2017-2018,90.0,4.891304347826087,0.0
388,Jack Butland,ENG,GK,Stoke City,Premier League,24,1993,35.0,1,1,1,0,0,1,1,100.0,0,1,0,1,1,2,26,1,0,2017-2018,90.0,2.571428571428571,2.571428571428571
389,Sam Byram,ENG,"DF,MF",West Ham,Premier League,23,1993,2.8,9,5,6,3,0,4,9,44.4,5,6,2,4,9,18,16,0,0,2017-2018,90.0,289.2857142857143,289.2857142857143
390,Jakub Błaszczykowski,POL,"FW,MF",Wolfsburg,Bundesliga,31,1985,5.8,12,8,8,2,2,6,13,46.2,7,11,3,8,5,17,3,0,0,2017-2018,90.0,77.58620689655173,186.20689655172413
391,Erick Cabaco,URU,DF,Levante,La Liga,22,1995,11.6,25,14,21,4,0,14,20,70.0,6,10,8,2,17,42,71,2,0,2017-2018,90.0,131.89655172413794,193.9655172413793
392,Willy Caballero,ARG,GK,Chelsea,Premier League,35,1981,3.0,0,0,0,0,0,0,0,0.0,0,0,0,0,0,0,3,0,0,2017-2018,90.0,0.0,0.0
393,Yohan Cabaye,FRA,MF,Crystal Palace,Premier League,31,1986,26.4,70,44,39,28,3,24,97,24.7,73,47,4,43,79,149,29,4,0,2017-2018,90.0,269.3181818181818,238.63636363636363
394,Rémy Cabella,FRA,"FW,MF",Marseille,Ligue 1,27,1990,0.7,7,4,2,2,3,2,4,50.0,2,0,0,0,1,8,0,0,0,2017-2018,90.0,128.57142857142858,900.0
395,Rémy Cabella,FRA,"MF,FW",Saint-Étienne,Ligue 1,27,1990,25.1,58,39,29,22,7,17,73,23.3,56,31,0,31,14,72,4,2,0,2017-2018,90.0,50.199203187250994,207.96812749003982
396,Gustavo Cabral,ARG,DF,Celta Vigo,La Liga,31,1985,21.0,29,21,14,15,0,14,38,36.8,24,22,11,11,43,72,106,2,0,2017-2018,90.0,184.28571428571428,124.28571428571428
397,Leandro Cabrera,URU,DF,Crotone,Serie A,26,1991,4.1,8,5,8,0,0,0,3,0.0,3,5,2,3,6,14,33,0,0,2017-2018,90.0,131.70731707317074,175.609756097561
398,Leandro Cabrera,URU,DF,Getafe,La Liga,26,1991,8.0,19,10,12,7,0,7,17,41.2,10,9,5,4,22,41,37,0,0,2017-2018,90.0,247.5,213.75
399,Fabrizio Cacciatore,ITA,DF,Chievo,Serie A,30,1986,31.9,34,27,20,9,5,15,30,50.0,15,33,11,22,38,72,99,3,0,2017-2018,90.0,107.21003134796238,95.92476489028213
400,Martín Cáceres,URU,DF,Hellas Verona,Serie A,30,1987,12.9,16,11,14,1,1,7,18,38.9,11,9,5,4,19,35,41,1,0,2017-2018,90.0,132.5581395348837,111.62790697674419
401,Martín Cáceres,URU,DF,Lazio,Serie A,30,1987,4.9,12,7,9,2,1,10,14,71.4,4,4,4,0,4,16,13,0,0,2017-2018,90.0,73.46938775510203,220.40816326530611
402,Cafú,POR,MF,Metz,Ligue 1,24,1993,7.6,9,7,3,4,2,3,11,27.3,8,3,1,2,12,21,13,0,0,2017-2018,90.0,142.10526315789474,106.57894736842105
403,Jonathan Cafu,BRA,"FW,MF",Bordeaux,Ligue 1,26,1991,7.0,16,9,7,6,3,5,13,38.5,8,6,1,5,10,26,1,0,0,2017-2018,90.0,128.57142857142856,205.71428571428572
404,Gary Cahill,ENG,DF,Chelsea,Premier League,31,1985,23.2,29,21,15,9,5,10,21,47.6,11,21,14,7,27,56,127,1,0,2017-2018,90.0,104.74137931034483,112.5
405,Yannick Cahuzac,FRA,MF,Toulouse,Ligue 1,32,1985,16.9,39,28,20,19,0,15,26,57.7,11,29,10,19,30,69,42,0,0,2017-2018,90.0,159.76331360946747,207.6923076923077
406,Felipe Caicedo,ECU,"FW,MF",Lazio,Serie A,28,1988,8.0,11,10,3,5,3,2,7,28.6,5,6,0,6,1,12,4,0,0,2017-2018,90.0,11.25,123.75
407,Caiuby,BRA,FW,Augsburg,Bundesliga,29,1988,31.7,53,40,20,27,6,17,42,40.5,25,36,1,35,15,68,42,2,0,2017-2018,90.0,42.586750788643535,150.47318611987382
408,Cala,ESP,DF,Getafe,La Liga,27,1989,20.0,21,14,16,5,0,13,27,48.1,14,21,10,11,39,60,124,0,0,2017-2018,90.0,175.5,94.5
409,Davide Calabria,ITA,DF,Milan,Serie A,20,1996,17.4,64,50,33,24,7,21,41,51.2,20,19,4,15,33,97,82,1,0,2017-2018,90.0,170.6896551724138,331.0344827586207
410,Mattia Caldara,ITA,DF,Atalanta,Serie A,23,1994,24.0,39,26,15,24,0,13,33,39.4,20,31,18,13,41,80,113,1,0,2017-2018,90.0,153.75,146.25
411,Carlos Calderón,ESP,MF,Getafe,La Liga,22,1995,0.0,1,1,0,0,1,0,0,0.0,0,0,0,0,0,1,0,0,0,2017-2018,,,inf
412,Luca Caldirola,ITA,DF,Werder Bremen,Bundesliga,26,1991,1.0,1,0,0,1,0,1,1,100.0,0,1,0,1,3,4,3,0,0,2017-2018,90.0,270.0,90.0
413,Hakan Çalhanoğlu,TUR,"FW,MF",Milan,Serie A,23,1994,24.1,37,27,11,18,8,8,31,25.8,23,29,2,27,22,59,15,0,0,2017-2018,90.0,82.15767634854771,138.17427385892117
414,Fabrizio Caligara,ITA,MF,Cagliari,Serie A,17,2000,0.2,0,0,0,0,0,0,0,0.0,0,1,1,0,1,1,1,0,0,2017-2018,90.0,450.0,0.0
415,Daniel Caligiuri,ITA,"DF,MF",Schalke 04,Bundesliga,29,1988,32.4,100,66,48,43,9,49,94,52.1,45,59,4,55,67,167,71,0,0,2017-2018,90.0,186.11111111111111,277.77777777777777
416,José Callejón,ESP,FW,Napoli,Serie A,30,1987,36.0,33,27,15,14,4,10,47,21.3,37,42,5,37,22,55,31,0,0,2017-2018,90.0,55.0,82.5
417,Jonathan Calleri,ARG,FW,Las Palmas,La Liga,23,1993,34.5,24,16,5,10,9,4,23,17.4,19,15,2,13,7,31,35,0,0,2017-2018,90.0,18.26086956521739,62.60869565217391
418,Simone Calvano,ITA,MF,Hellas Verona,Serie A,24,1993,7.2,13,12,4,9,0,3,16,18.8,13,10,4,6,15,28,14,1,0,2017-2018,90.0,187.5,162.5
419,Dominic Calvert-Lewin,ENG,FW,Everton,Premier League,20,1997,20.9,15,8,5,3,7,2,15,13.3,13,13,1,12,10,25,23,1,0,2017-2018,90.0,43.0622009569378,64.5933014354067
420,Ignacio Camacho,ESP,"MF,DF",Wolfsburg,Bundesliga,27,1990,10.6,27,21,10,16,1,9,23,39.1,14,14,5,9,41,68,43,0,0,2017-2018,90.0,348.11320754716985,229.24528301886792
421,Abdoul Camara,GUI,"FW,MF",Guingamp,Ligue 1,27,1990,9.9,6,4,2,3,1,3,11,27.3,8,7,1,6,7,13,4,0,0,2017-2018,90.0,63.63636363636363,54.54545454545455
422,Souleymane Camara,SEN,FW,Montpellier,Ligue 1,34,1982,10.4,6,4,0,5,1,0,3,0.0,3,3,1,2,2,8,15,0,0,2017-2018,90.0,17.307692307692307,51.92307692307692
423,Víctor Camarasa,ESP,MF,Betis,La Liga,23,1994,13.9,20,15,8,10,2,3,13,23.1,10,8,0,8,15,35,13,0,0,2017-2018,90.0,97.12230215827338,129.49640287769785
424,Geoff Cameron,USA,"DF,MF",Stoke City,Premier League,32,1985,16.9,34,21,20,12,2,11,27,40.7,16,28,8,20,36,70,68,0,0,2017-2018,90.0,191.71597633136096,181.06508875739647
425,José Campaña,ESP,MF,Levante,La Liga,24,1993,30.4,57,36,25,27,5,19,58,32.8,39,31,10,21,45,102,37,0,0,2017-2018,90.0,133.2236842105263,168.75
426,Joel Campbell,CRC,"MF,FW",Betis,La Liga,25,1992,2.4,6,2,3,3,0,3,6,50.0,3,2,0,2,0,6,0,0,0,2017-2018,90.0,0.0,225.00000000000003
427,Tyrese Campbell,ENG,FW,Stoke City,Premier League,17,1999,0.9,2,1,0,2,0,1,1,100.0,0,1,1,0,1,3,0,0,0,2017-2018,90.0,100.0,200.0
428,Emre Can,GER,MF,Liverpool,Premier League,23,1994,23.2,67,54,32,29,6,18,43,41.9,25,32,4,28,28,95,37,1,0,2017-2018,90.0,108.62068965517241,259.91379310344826
429,Sergio Canales,ESP,"MF,FW",Real Sociedad,La Liga,26,1991,21.4,30,24,6,18,6,9,32,28.1,23,25,0,25,11,41,3,0,0,2017-2018,90.0,46.26168224299066,126.16822429906543
430,João Cancelo,POR,DF,Inter,Serie A,23,1994,20.6,42,29,27,11,4,17,42,40.5,25,15,2,13,35,77,51,0,0,2017-2018,90.0,152.9126213592233,183.49514563106797
431,João Cancelo,POR,MF,Valencia,La Liga,23,1994,1.0,1,1,0,1,0,1,1,100.0,0,1,0,1,2,3,0,0,0,2017-2018,90.0,180.0,90.0
432,Antonio Candreva,ITA,FW,Inter,Serie A,30,1987,28.2,12,7,7,5,0,8,39,20.5,31,20,2,18,22,34,24,0,0,2017-2018,89.99999999999999,70.2127659574468,38.29787234042553
433,Paolo Cannavaro,ITA,DF,Sassuolo,Serie A,36,1981,16.0,17,9,11,5,1,8,20,40.0,12,17,13,4,27,44,94,1,0,2017-2018,90.0,151.875,95.625
434,Ander Capa,ESP,DF,Eibar,La Liga,25,1992,25.0,57,38,34,14,9,25,38,65.8,13,21,2,19,52,109,50,1,0,2017-2018,90.0,187.2,205.2
435,Pierrick Capelle,FRA,MF,Angers,Ligue 1,30,1987,20.9,50,37,29,17,4,16,70,22.9,54,29,0,29,34,84,26,0,0,2017-2018,90.0,146.41148325358853,215.311004784689
436,Leonardo Capezzi,ITA,MF,Sampdoria,Serie A,22,1995,2.4,8,4,5,3,0,4,6,66.7,2,6,0,6,0,8,3,0,0,2017-2018,90.0,0.0,300.0
437,Étienne Capoue,FRA,MF,Watford,Premier League,29,1988,17.1,43,26,15,25,3,19,47,40.4,28,21,1,20,43,86,38,0,0,2017-2018,90.0,226.31578947368422,226.31578947368422
438,Elio Capradossi,UGA,DF,Roma,Serie A,21,1996,0.9,1,0,1,0,0,0,0,0.0,0,2,2,0,2,3,13,0,0,2017-2018,90.0,200.0,100.0
439,Gianluca Caprari,ITA,"FW,MF",Sampdoria,Serie A,24,1993,20.1,19,11,2,11,6,0,10,0.0,10,25,2,23,5,24,3,0,0,2017-2018,90.0,22.388059701492534,85.07462686567163
440,Marco Capuano,ITA,DF,Crotone,Serie A,25,1991,15.6,20,10,14,6,0,5,15,33.3,10,19,13,6,28,48,93,0,0,2017-2018,90.0,161.53846153846152,115.38461538461539
441,Marco Capuano,ITA,DF,Cagliari,Serie A,25,1991,7.7,13,9,6,7,0,4,8,50.0,4,7,2,5,6,19,23,1,0,2017-2018,90.0,70.12987012987013,151.94805194805195
442,Antonio Caracciolo,ITA,DF,Hellas Verona,Serie A,27,1990,31.7,52,34,41,8,3,17,30,56.7,13,64,44,20,39,91,203,0,0,2017-2018,90.0,110.72555205047318,147.63406940063092
443,Yoan Cardinale,FRA,GK,Nice,Ligue 1,23,1994,10.0,0,0,0,0,0,0,0,0.0,0,0,0,0,0,0,0,3,0,2017-2018,90.0,0.0,0.0
444,Diego Carlos,BRA,DF,Nantes,Ligue 1,24,1993,25.5,70,42,51,15,4,28,38,73.7,10,50,29,21,29,99,155,3,0,2017-2018,90.0,102.3529411764706,247.05882352941177
445,Lionel Carole,FRA,DF,Sevilla,La Liga,26,1991,6.0,12,6,7,5,0,5,7,71.4,2,6,3,3,6,18,29,0,0,2017-2018,90.0,90.0,180.0
446,Yannick Carrasco,BEL,"MF,FW",Atlético Madrid,La Liga,23,1993,10.0,17,13,7,5,5,3,8,37.5,5,9,0,9,4,21,3,0,0,2017-2018,90.0,36.0,153.0
447,Michael Carrick,ENG,MF,Manchester Utd,Premier League,36,1981,1.2,1,1,0,1,0,0,1,0.0,1,2,0,2,1,2,3,0,0,2017-2018,90.0,75.0,75.0
448,Daniel Carriço,POR,DF,Sevilla,La Liga,28,1988,5.1,7,7,6,1,0,4,7,57.1,3,6,3,3,10,17,22,0,0,2017-2018,90.0,176.47058823529412,123.52941176470588
449,André Carrillo,PER,"FW,MF",Watford,Premier League,26,1991,17.1,31,24,16,12,3,8,33,24.2,25,7,0,7,15,46,16,0,0,2017-2018,90.0,78.94736842105263,163.1578947368421
450,Guido Carrillo,ARG,FW,Southampton,Premier League,26,1991,5.0,5,1,0,3,2,0,1,0.0,1,4,0,4,0,5,5,0,0,2017-2018,90.0,0.0,90.0
451,Guido Carrillo,ARG,FW,Monaco,Ligue 1,26,1991,4.7,3,1,0,2,1,0,4,0.0,4,3,1,2,0,3,8,0,0,2017-2018,90.0,0.0,57.44680851063829
452,Thomas Carrique,FRA,DF,Bordeaux,Ligue 1,18,1999,1.0,1,0,0,1,0,1,3,33.3,2,0,0,0,2,3,3,0,0,2017-2018,90.0,180.0,90.0
453,Andy Carroll,ENG,FW,West Ham,Premier League,28,1989,8.3,3,3,2,0,1,0,1,0.0,1,3,2,1,2,5,15,0,0,2017-2018,90.0,21.686746987951803,32.53012048192771
454,Tom Carroll,ENG,MF,Swansea City,Premier League,25,1992,28.6,53,33,22,23,8,14,53,26.4,39,37,8,29,29,82,18,1,0,2017-2018,90.0,91.25874125874127,166.7832167832168
455,Federico Cartabia,ARG,"FW,MF",La Coruña,La Liga,24,1993,14.7,37,23,15,15,7,11,30,36.7,19,15,0,15,18,55,10,0,0,2017-2018,90.0,110.20408163265306,226.53061224489795
456,Dani Carvajal,ESP,DF,Real Madrid,La Liga,25,1992,24.7,59,40,27,22,10,22,38,57.9,16,33,15,18,38,97,42,2,0,2017-2018,90.0,138.46153846153845,214.97975708502025
457,Casemiro,BRA,MF,Real Madrid,La Liga,25,1992,28.8,109,78,64,39,6,42,84,50.0,42,56,11,45,63,172,49,3,0,2017-2018,90.0,196.875,340.625
458,Kiko Casilla,ESP,GK,Real Madrid,La Liga,30,1986,10.0,1,0,1,0,0,1,1,100.0,0,0,0,0,2,3,6,2,0,2017-2018,90.0,18.0,9.0
459,Francesco Cassata,ITA,MF,Sassuolo,Serie A,20,1997,5.1,12,7,6,5,1,2,10,20.0,8,3,0,3,5,17,0,0,0,2017-2018,90.0,88.23529411764706,211.76470588235296
460,Timothy Castagne,BEL,DF,Atalanta,Serie A,21,1995,16.7,54,37,32,14,8,13,27,48.1,14,25,4,21,26,80,48,0,0,2017-2018,90.0,140.11976047904193,291.0179640718563
461,Leandro Castán,BRA,DF,Cagliari,Serie A,30,1986,12.7,24,15,16,8,0,15,20,75.0,5,16,10,6,23,47,48,1,0,2017-2018,90.0,162.99212598425197,170.07874015748033
462,Koen Casteels,BEL,GK,Wolfsburg,Bundesliga,25,1992,34.0,2,1,2,0,0,2,2,100.0,0,0,0,0,1,3,16,1,0,2017-2018,90.0,2.6470588235294117,5.294117647058823
463,Dani Castellano,ESP,DF,Las Palmas,La Liga,29,1987,22.5,46,29,29,16,1,25,48,52.1,23,28,7,21,42,88,64,1,0,2017-2018,90.0,168.0,184.0
464,Javi Castellano,ESP,MF,Las Palmas,La Liga,29,1987,17.4,47,27,20,25,2,20,37,54.1,17,23,6,17,38,85,16,1,0,2017-2018,90.0,196.55172413793105,243.10344827586206
465,Samu Castillejo,ESP,"MF,FW",Villarreal,La Liga,22,1995,23.0,41,28,22,10,9,13,62,21.0,49,39,5,34,22,63,37,0,0,2017-2018,90.0,86.08695652173914,160.43478260869566
466,Chory Castro,URU,"MF,FW",Málaga,La Liga,32,1984,22.9,37,24,15,14,8,11,32,34.4,21,21,2,19,23,60,13,0,0,2017-2018,90.0,90.39301310043669,145.41484716157206
467,Gonzalo Castro,GER,MF,Dortmund,Bundesliga,30,1987,13.4,26,18,7,18,1,5,22,22.7,17,23,3,20,10,36,13,1,0,2017-2018,90.0,67.16417910447761,174.62686567164178
468,Jonny Castro,ESP,DF,Celta Vigo,La Liga,23,1994,35.6,102,78,60,31,11,43,91,47.3,48,48,8,40,93,195,92,1,0,2017-2018,90.0,235.1123595505618,257.86516853932585
469,Lucas Castro,ARG,MF,Chievo,Serie A,28,1989,22.1,54,40,14,29,11,16,43,37.2,27,39,7,32,38,92,35,0,0,2017-2018,90.0,154.75113122171945,219.90950226244343
470,Rubén Castro,ESP,FW,Betis,La Liga,36,1981,4.0,1,1,0,0,1,0,0,0.0,0,0,0,0,0,1,2,0,0,2017-2018,90.0,0.0,22.5
471,Danilo Cataldi,ITA,MF,Benevento,Serie A,22,1994,25.4,33,25,12,19,2,5,28,17.9,23,18,5,13,37,70,20,1,0,2017-2018,90.0,131.10236220472441,116.92913385826772
472,Craig Cathcart,NIR,DF,Watford,Premier League,28,1989,5.8,8,5,5,3,0,4,5,80.0,1,8,6,2,3,11,38,0,0,2017-2018,90.0,46.55172413793103,124.13793103448276
473,Edinson Cavani,URU,FW,Paris S-G,Ligue 1,30,1987,28.7,15,9,5,4,6,2,16,12.5,14,10,1,9,5,20,22,0,0,2017-2018,90.0,15.679442508710801,47.038327526132406
474,Marijan Ćavar,BIH,MF,Eint Frankfurt,Bundesliga,19,1998,0.4,0,0,0,0,0,0,3,0.0,3,0,0,0,0,0,0,0,0,2017-2018,90.0,0.0,0.0
475,Dani Ceballos,ESP,MF,Real Madrid,La Liga,20,1996,4.5,8,7,3,2,3,4,16,25.0,12,6,0,6,5,13,1,0,0,2017-2018,90.0,100.0,160.0
476,Federico Ceccherini,ITA,DF,Crotone,Serie A,25,1992,35.9,35,21,28,4,3,13,25,52.0,12,39,21,18,83,118,276,1,0,2017-2018,90.0,208.0779944289694,87.74373259052926
477,Emanuel Cecchini,ARG,"MF,DF",Málaga,La Liga,20,1996,0.3,3,1,2,1,0,2,3,66.7,1,0,0,0,2,5,2,0,0,2017-2018,90.0,600.0,900.0000000000001
478,Petr Čech,CZE,GK,Arsenal,Premier League,35,1982,33.8,1,1,1,0,0,1,1,100.0,0,0,0,0,0,1,23,7,0,2017-2018,90.0,0.0,2.6627218934911245
479,Ricardo Centurión,ARG,"MF,FW",Genoa,Serie A,24,1993,0.6,0,0,0,0,0,0,0,0.0,0,0,0,0,0,0,0,0,0,2017-2018,90.0,0.0,0.0
480,Luca Ceppitelli,ITA,DF,Cagliari,Serie A,27,1989,24.7,45,33,31,12,2,16,34,47.1,18,33,21,12,50,95,156,0,0,2017-2018,90.0,182.18623481781378,163.9676113360324
481,Fabio Ceravolo,ITA,FW,Benevento,Serie A,30,1987,0.6,0,0,0,0,0,0,1,0.0,1,1,0,1,0,0,0,0,0,2017-2018,90.0,0.0,0.0
482,Alessio Cerci,ITA,FW,Hellas Verona,Serie A,30,1987,18.2,15,10,7,3,5,4,16,25.0,12,4,0,4,4,19,8,0,0,2017-2018,90.0,19.78021978021978,74.17582417582418
483,Boštjan Cesar,SVN,DF,Chievo,Serie A,35,1982,6.1,4,3,3,1,0,3,4,75.0,1,6,4,2,3,7,40,0,0,2017-2018,90.0,44.26229508196722,59.016393442622956
484,Damir Ceter,COL,FW,Cagliari,Serie A,19,1997,2.2,2,1,0,2,0,0,0,0.0,0,3,0,3,0,2,1,0,0,2017-2018,90.0,0.0,81.81818181818181
485,Nacer Chadli,BEL,"FW,MF",West Brom,Premier League,27,1989,2.9,1,0,1,0,0,1,4,25.0,3,0,0,0,0,1,4,0,0,2017-2018,90.0,0.0,31.03448275862069
486,Fouad Chafik,MAR,DF,Dijon,Ligue 1,30,1986,17.9,58,49,31,19,8,20,35,57.1,15,17,1,16,33,91,46,1,0,2017-2018,90.0,165.92178770949724,291.6201117318436
487,Nathaniel Chalobah,ENG,MF,Watford,Premier League,22,1994,5.0,9,6,2,6,1,2,5,40.0,3,6,5,1,6,15,6,0,0,2017-2018,90.0,108.0,162.0
488,Calum Chambers,ENG,DF,Arsenal,Premier League,22,1995,9.6,17,10,10,6,1,5,14,35.7,9,14,11,3,18,35,47,0,0,2017-2018,90.0,168.75,159.375
489,Nereo Champagne,ARG,GK,Leganés,La Liga,32,1985,2.0,0,0,0,0,0,0,0,0.0,0,0,0,0,0,0,3,0,0,2017-2018,90.0,0.0,0.0
490,Timothy Chandler,USA,"DF,FW",Eint Frankfurt,Bundesliga,27,1990,21.0,27,21,11,13,3,11,17,64.7,6,15,0,15,33,60,52,0,0,2017-2018,90.0,141.42857142857142,115.71428571428571
491,Kwon Chang-hoon,KOR,"FW,MF",Dijon,Ligue 1,23,1994,23.7,37,22,10,18,9,11,35,31.4,24,32,1,31,24,61,30,0,0,2017-2018,90.0,91.13924050632912,140.50632911392407
492,Charles,BRA,FW,Eibar,La Liga,33,1984,17.6,11,8,2,5,4,1,8,12.5,7,7,0,7,7,18,10,0,0,2017-2018,90.0,35.79545454545455,56.25
493,Charly Charrier,FRA,"MF,FW",Amiens,Ligue 1,31,1986,1.2,1,0,1,0,0,0,2,0.0,2,1,0,1,2,3,0,0,0,2017-2018,90.0,150.0,75.0
494,Pape Cheikh Diop,SEN,MF,Lyon,Ligue 1,19,1997,0.1,0,0,0,0,0,0,0,0.0,0,0,0,0,0,0,0,0,0,2017-2018,90.0,0.0,0.0
495,Chema,ESP,DF,Levante,La Liga,25,1992,22.4,20,13,14,6,0,9,18,50.0,9,43,27,16,30,50,110,1,0,2017-2018,90.0,120.53571428571429,80.35714285714286
496,Denis Cheryshev,RUS,"MF,FW",Villarreal,La Liga,26,1990,10.3,27,16,12,10,5,6,23,26.1,17,18,1,17,13,40,10,0,0,2017-2018,90.0,113.59223300970874,235.92233009708738
497,Raman Chibsah,GHA,MF,Benevento,Serie A,24,1993,11.6,20,13,10,7,3,4,14,28.6,10,13,2,11,4,24,16,0,0,2017-2018,90.0,31.03448275862069,155.17241379310346
498,Leandro Chichizola,ARG,GK,Las Palmas,La Liga,27,1990,27.0,2,0,2,0,0,2,6,33.3,4,0,0,0,4,6,29,3,0,2017-2018,90.0,13.333333333333334,6.666666666666667
499,Giorgio Chiellini,ITA,DF,Juventus,Serie A,32,1984,24.0,28,19,17,10,1,7,15,46.7,8,21,14,7,47,75,142,3,0,2017-2018,90.0,176.25,105.0
500,Federico Chiesa,ITA,"FW,MF",Fiorentina,Serie A,19,1997,33.5,62,41,22,22,18,16,54,29.6,38,34,1,33,18,80,16,0,0,2017-2018,90.0,48.35820895522388,166.56716417910448
501,Ben Chilwell,ENG,DF,Leicester City,Premier League,20,1996,20.6,36,26,21,10,5,15,32,46.9,17,31,4,27,28,64,71,3,0,2017-2018,90.0,122.33009708737863,157.28155339805826
502,Vlad Chiricheș,ROU,DF,Napoli,Serie A,27,1989,6.5,8,4,7,1,0,2,5,40.0,3,2,1,1,16,24,19,1,0,2017-2018,90.00000000000001,221.53846153846155,110.76923076923077
503,Hamza Choudhury,ENG,"MF,DF",Leicester City,Premier League,19,1997,4.2,9,5,6,3,0,2,10,20.0,8,12,1,11,8,17,4,0,0,2017-2018,90.0,171.42857142857142,192.85714285714286
504,Andreas Christensen,DEN,DF,Chelsea,Premier League,21,1996,23.2,26,13,23,3,0,10,15,66.7,5,25,17,8,39,65,109,5,0,2017-2018,90.0,151.29310344827587,100.86206896551724
505,Chuca,ESP,MF,Villarreal,La Liga,20,1997,1.0,1,0,1,0,0,1,3,33.3,2,1,1,0,1,2,1,1,0,2017-2018,90.0,90.0,90.0
506,Lee Chung-yong,KOR,"FW,MF",Crystal Palace,Premier League,29,1988,1.5,2,0,0,1,1,0,0,0.0,0,3,0,3,2,4,0,1,0,2017-2018,90.0,120.0,120.0
507,Amato Ciciretti,ITA,"MF,FW",Benevento,Serie A,23,1993,9.0,14,8,5,6,3,2,11,18.2,9,9,0,9,6,20,4,0,0,2017-2018,90.0,60.0,140.0
508,Cifu,ESP,DF,Málaga,La Liga,26,1990,1.2,2,1,0,1,1,1,5,20.0,4,1,1,0,2,4,2,0,0,2017-2018,90.0,150.0,150.0
509,Luca Cigarini,ITA,MF,Cagliari,Serie A,31,1986,22.5,42,30,16,25,1,18,64,28.1,46,32,5,27,42,84,27,1,0,2017-2018,90.0,168.0,168.0
510,Per Ciljan Skjelbred,NOR,MF,Hertha BSC,Bundesliga,30,1987,24.3,89,66,33,54,2,42,64,65.6,22,31,6,25,45,134,23,0,0,2017-2018,90.0,166.66666666666666,329.6296296296296
511,Jasper Cillessen,NED,GK,Barcelona,La Liga,28,1989,1.0,0,0,0,0,0,0,0,0.0,0,0,0,0,0,0,0,0,0,2017-2018,90.0,0.0,0.0
512,Thiago Cionek,POL,DF,SPAL,Serie A,31,1986,15.0,28,21,18,6,4,11,20,55.0,9,19,9,10,35,63,99,0,0,2017-2018,90.0,210.0,168.0
513,Saliou Ciss,SEN,"DF,MF",Angers,Ligue 1,27,1989,1.6,3,2,1,1,1,2,5,40.0,3,0,0,0,2,5,1,0,0,2017-2018,90.0,112.5,168.75
514,Karamoko Cissé,GUI,"FW,MF",Benevento,Serie A,28,1988,0.2,1,1,1,0,0,0,0,0.0,0,0,0,0,0,1,0,0,0,2017-2018,90.0,0.0,450.0
515,Issa Cissokho,SEN,DF,Amiens,Ligue 1,32,1985,18.1,31,23,22,9,0,18,32,56.3,14,18,8,10,34,65,87,1,0,2017-2018,90.0,169.06077348066296,154.14364640883977
516,Ciaran Clark,IRL,DF,Newcastle Utd,Premier League,27,1989,19.4,25,17,17,8,0,11,21,52.4,10,15,10,5,17,42,144,1,0,2017-2018,90.0,78.86597938144331,115.97938144329899
517,Christian Clemens,GER,"MF,FW",Köln,Bundesliga,25,1991,7.2,12,11,6,5,1,4,13,30.8,9,8,0,8,4,16,7,0,0,2017-2018,90.0,50.0,150.0
518,Tom Cleverley,ENG,MF,Watford,Premier League,27,1989,21.1,48,26,25,16,7,21,52,40.4,31,11,1,10,25,73,21,0,0,2017-2018,90.0,106.63507109004739,204.739336492891
519,Sam Clucas,ENG,MF,Swansea City,Premier League,26,1990,22.7,34,19,21,11,2,10,29,34.5,19,31,7,24,29,63,34,1,0,2017-2018,89.99999999999999,114.97797356828193,134.80176211453744
520,Nathaniel Clyne,ENG,"DF,FW",Liverpool,Premier League,26,1991,1.9,3,1,2,1,0,0,1,0.0,1,2,1,1,0,3,3,0,0,2017-2018,90.0,0.0,142.10526315789474
521,Marcus Coco,FRA,"FW,MF",Guingamp,Ligue 1,21,1996,17.6,40,28,17,13,10,7,35,20.0,28,22,3,19,15,55,9,0,0,2017-2018,90.0,76.70454545454545,204.54545454545453
522,Massimo Coda,ITA,FW,Benevento,Serie A,28,1988,15.7,12,9,3,4,5,2,13,15.4,11,7,2,5,6,18,11,0,0,2017-2018,90.0,34.39490445859873,68.78980891719746
523,Isaac Cofie,GHA,MF,Genoa,Serie A,25,1991,6.6,13,10,3,9,1,7,15,46.7,8,9,3,6,10,23,7,0,0,2017-2018,90.0,136.36363636363637,177.27272727272728
524,Renaud Cohade,FRA,MF,Metz,Ligue 1,32,1984,36.6,143,86,63,71,9,46,119,38.7,73,70,10,60,53,196,91,0,0,2017-2018,90.0,130.327868852459,351.6393442622951
525,Coke,ESP,DF,Levante,La Liga,30,1987,15.4,35,23,26,7,2,18,39,46.2,21,17,5,12,34,69,46,0,0,2017-2018,90.0,198.7012987012987,204.54545454545456
526,Coke,ESP,MF,Schalke 04,Bundesliga,30,1987,0.0,0,0,0,0,0,0,0,0.0,0,0,0,0,0,0,0,0,0,2017-2018,,,
527,Emre Çolak,TUR,MF,La Coruña,La Liga,26,1991,16.1,24,19,4,14,6,7,28,25.0,21,7,1,6,7,31,5,1,0,2017-2018,90.0,39.130434782608695,134.1614906832298
528,Séamus Coleman,IRL,DF,Everton,Premier League,28,1988,11.5,14,14,9,3,2,6,11,54.5,5,16,12,4,10,24,29,2,0,2017-2018,90.0,78.26086956521739,109.56521739130436
529,James Collins,WAL,DF,West Ham,Premier League,33,1983,11.7,15,9,11,4,0,8,11,72.7,3,13,10,3,16,31,120,1,0,2017-2018,89.99999999999999,123.07692307692307,115.38461538461539
530,Racine Coly,SEN,DF,Nice,Ligue 1,21,1995,6.9,15,12,9,5,1,9,19,47.4,10,5,2,3,15,30,18,0,0,2017-2018,90.0,195.65217391304347,195.65217391304347
531,Kingsley Coman,FRA,"FW,MF",Bayern Munich,Bundesliga,21,1996,12.8,11,10,2,6,3,5,10,50.0,5,6,0,6,7,18,1,0,0,2017-2018,90.0,49.21875,77.34375
532,Marvin Compper,GER,DF,RB Leipzig,Bundesliga,32,1985,1.0,2,2,0,2,0,2,3,66.7,1,2,2,0,0,2,8,0,0,2017-2018,90.0,0.0,180.0
533,Alois Confais,FRA,"MF,DF",Troyes,Ligue 1,20,1996,6.8,8,6,7,1,0,3,9,33.3,6,7,4,3,4,12,15,1,0,2017-2018,90.0,52.94117647058823,105.88235294117646
534,Daniel Congré,FRA,DF,Montpellier,Ligue 1,32,1985,29.3,62,46,36,24,2,31,59,52.5,28,29,16,13,56,118,124,2,0,2017-2018,90.0,172.0136518771331,190.44368600682594
535,Andrea Consigli,ITA,GK,Sassuolo,Serie A,30,1987,36.8,0,0,0,0,0,0,2,0.0,2,0,0,0,0,0,27,6,0,2017-2018,90.0,0.0,0.0
536,Diego Contento,GER,"DF,MF",Bordeaux,Ligue 1,27,1990,1.2,3,0,1,2,0,1,1,100.0,0,2,1,1,1,4,9,0,0,2017-2018,90.0,75.0,225.00000000000003
537,Andrea Conti,ITA,DF,Milan,Serie A,23,1994,1.7,4,2,1,3,0,2,3,66.7,1,3,0,3,1,5,5,0,0,2017-2018,90.0,52.94117647058823,211.76470588235293
538,Lewis Cook,ENG,MF,Bournemouth,Premier League,20,1997,24.9,67,35,37,30,0,26,69,37.7,43,33,12,21,35,102,25,2,0,2017-2018,90.0,126.50602409638554,242.16867469879517
539,Steve Cook,ENG,DF,Bournemouth,Premier League,26,1991,30.7,37,19,28,7,2,19,29,65.5,10,63,45,18,54,91,232,4,0,2017-2018,90.0,158.30618892508144,108.46905537459284
540,Duje Čop,CRO,"FW,MF",Cagliari,Serie A,27,1990,1.1,1,1,0,0,1,0,1,0.0,1,1,0,1,0,1,0,0,0,2017-2018,90.0,0.0,81.81818181818181
541,Francis Coquelin,FRA,"MF,DF",Arsenal,Premier League,26,1991,1.9,5,4,2,3,0,1,3,33.3,2,1,0,1,3,8,2,0,0,2017-2018,90.0,142.10526315789474,236.8421052631579
542,Francis Coquelin,FRA,"MF,DF",Valencia,La Liga,26,1991,7.3,18,14,11,6,1,9,16,56.3,7,9,2,7,20,38,23,0,0,2017-2018,90.0,246.57534246575344,221.91780821917808
543,Sébastien Corchia,FRA,DF,Sevilla,La Liga,26,1990,9.1,18,13,7,8,3,9,16,56.3,7,18,4,14,16,34,20,0,0,2017-2018,90.0,158.24175824175825,178.02197802197801
544,Alex Cordaz,ITA,GK,Crotone,Serie A,34,1983,38.0,0,0,0,0,0,0,0,0.0,0,0,0,0,2,2,16,4,0,2017-2018,90.0,4.7368421052631575,0.0
545,Iñigo Córdoba,ESP,FW,Athletic Club,La Liga,20,1997,16.2,44,30,18,21,5,16,58,27.6,42,31,0,31,21,65,9,0,0,2017-2018,90.0,116.66666666666667,244.44444444444446
546,Jhon Córdoba,COL,FW,Köln,Bundesliga,24,1993,10.6,13,10,0,11,2,1,5,20.0,4,6,2,4,1,14,9,0,0,2017-2018,90.0,8.49056603773585,110.37735849056604
547,Sergio Córdova,VEN,"FW,MF",Augsburg,Bundesliga,19,1997,6.5,5,5,0,2,3,3,4,75.0,1,12,2,10,0,5,6,0,0,2017-2018,90.00000000000001,0.0,69.23076923076924
548,Jérémy Cordoval,GLP,DF,Troyes,Ligue 1,27,1990,10.2,20,16,12,7,1,9,14,64.3,5,12,2,10,9,29,35,0,0,2017-2018,90.0,79.41176470588236,176.47058823529412
549,Benjamin Corgnet,FRA,"MF,FW",Strasbourg,Ligue 1,30,1987,15.3,28,19,5,16,7,6,28,21.4,22,18,1,17,11,39,11,0,0,2017-2018,90.0,64.70588235294117,164.70588235294116
550,Jack Cork,ENG,MF,Burnley,Premier League,28,1989,38.0,60,44,25,27,8,20,62,32.3,42,36,15,21,41,101,86,1,0,2017-2018,90.0,97.10526315789474,142.10526315789474
551,Andreas Cornelius,DEN,FW,Atalanta,Serie A,24,1993,10.4,9,5,3,3,3,1,7,14.3,6,7,0,7,2,11,7,0,0,2017-2018,90.0,17.307692307692307,77.88461538461537
552,Maxwel Cornet,CIV,FW,Lyon,Ligue 1,20,1996,14.1,17,12,6,9,2,3,25,12.0,22,11,1,10,14,31,14,0,0,2017-2018,89.99999999999999,89.36170212765957,108.51063829787233
553,Quentin Cornette,FRA,"FW,MF",Amiens,Ligue 1,23,1994,5.0,11,8,5,3,3,3,13,23.1,10,7,0,7,3,14,5,0,0,2017-2018,90.0,54.0,198.0
554,Ángel Correa,ARG,"MF,FW",Atlético Madrid,La Liga,22,1995,25.0,41,29,12,16,13,8,57,14.0,49,30,1,29,25,66,17,0,0,2017-2018,90.0,90.0,147.6
555,Joaquín Correa,ARG,FW,Sevilla,La Liga,22,1994,13.3,15,10,7,6,2,8,29,27.6,21,15,1,14,2,17,12,0,0,2017-2018,90.0,13.533834586466165,101.50375939849623
556,Andrea Cossu,ITA,"MF,FW",Cagliari,Serie A,37,1980,2.7,1,0,0,0,1,0,2,0.0,2,2,0,2,3,4,2,0,0,2017-2018,90.0,99.99999999999999,33.33333333333333
557,Andrea Costa,ITA,DF,Benevento,Serie A,31,1986,15.3,19,14,13,6,0,9,19,47.4,10,21,15,6,37,56,78,2,0,2017-2018,90.0,217.6470588235294,111.76470588235293
558,Danny da Costa,GER,"DF,FW",Eint Frankfurt,Bundesliga,24,1993,13.4,41,34,17,14,10,24,28,85.7,4,21,4,17,13,54,47,0,0,2017-2018,90.0,87.31343283582089,275.37313432835816
559,Diego Costa,ESP,FW,Atlético Madrid,La Liga,28,1988,11.6,17,11,2,10,5,4,15,26.7,11,14,4,10,5,22,3,0,0,2017-2018,90.0,38.793103448275865,131.89655172413794
560,Douglas Costa,BRA,"FW,MF",Juventus,Serie A,26,1990,19.9,17,14,10,5,2,8,25,32.0,17,15,0,15,7,24,7,0,0,2017-2018,90.0,31.658291457286435,76.88442211055278
561,Filippo Costa,ITA,DF,SPAL,Serie A,22,1995,16.4,19,12,7,7,5,7,17,41.2,10,23,6,17,22,41,50,0,0,2017-2018,90.0,120.73170731707319,104.26829268292684
562,Jaume Costa,ESP,DF,Villarreal,La Liga,29,1988,28.2,67,43,39,22,6,33,51,64.7,18,30,8,22,46,113,97,0,0,2017-2018,89.99999999999999,146.80851063829786,213.82978723404253
563,Angelo da Costa Júnior,BRA,GK,Bologna,Serie A,33,1983,4.0,0,0,0,0,0,0,0,0.0,0,0,0,0,0,0,2,0,0,2017-2018,90.0,0.0,0.0
564,Nuno da Costa,CPV,"FW,MF",Strasbourg,Ligue 1,26,1991,19.2,50,32,12,29,9,7,35,20.0,28,21,0,21,19,69,9,0,0,2017-2018,90.0,89.0625,234.37500000000003
565,Benoît Costil,FRA,GK,Bordeaux,Ligue 1,30,1987,36.0,0,0,0,0,0,0,2,0.0,2,0,0,0,3,3,13,4,0,2017-2018,90.0,7.5,0.0
566,Kalifa Coulibaly,MLI,FW,Nantes,Ligue 1,25,1991,3.8,6,6,3,1,2,2,4,50.0,2,0,0,0,0,6,6,0,0,2017-2018,90.0,0.0,142.10526315789474
567,Lassana Coulibaly,MLI,MF,Angers,Ligue 1,21,1996,9.3,26,17,13,10,3,10,35,28.6,25,15,1,14,8,34,10,0,0,2017-2018,90.0,77.41935483870967,251.6129032258064
568,Thibaut Courtois,BEL,GK,Chelsea,Premier League,25,1992,35.0,0,0,0,0,0,0,0,0.0,0,0,0,0,0,0,8,1,0,2017-2018,90.0,0.0,0.0
569,Philippe Coutinho,BRA,"MF,FW",Liverpool,Premier League,25,1992,12.3,17,14,4,10,3,3,21,14.3,18,10,0,10,10,27,5,1,0,2017-2018,89.99999999999999,73.17073170731706,124.39024390243901
570,Philippe Coutinho,BRA,"MF,FW",Barcelona,La Liga,25,1992,14.4,27,14,8,14,5,9,32,28.1,23,14,0,14,6,33,4,0,0,2017-2018,90.0,37.5,168.75
571,Nicolas Cozza,FRA,"DF,MF",Montpellier,Ligue 1,18,1999,6.4,21,11,12,8,1,7,16,43.8,9,5,2,3,13,34,12,0,0,2017-2018,90.0,182.8125,295.3125
572,Alessio Cragno,ITA,GK,Cagliari,Serie A,23,1994,28.2,0,0,0,0,0,0,0,0.0,0,1,0,1,0,0,12,0,0,2017-2018,89.99999999999999,0.0,0.0
573,Martin Cranie,ENG,DF,Huddersfield,Premier League,30,1986,2.0,3,2,2,1,0,0,1,0.0,1,3,3,0,1,4,10,0,0,2017-2018,90.0,45.0,135.0
574,Michele Cremonesi,ITA,DF,SPAL,Serie A,29,1988,4.3,4,2,2,2,0,1,4,25.0,3,5,3,2,7,11,28,0,0,2017-2018,90.0,146.51162790697677,83.72093023255815
575,Aaron Cresswell,ENG,DF,West Ham,Premier League,27,1989,34.1,34,21,12,20,2,19,30,63.3,11,42,17,25,44,78,117,1,0,2017-2018,90.0,116.12903225806451,89.73607038123167
576,Lorenzo Crisetig,ITA,MF,Bologna,Serie A,24,1993,6.2,18,14,8,9,1,7,24,29.2,17,8,2,6,13,31,16,1,0,2017-2018,90.0,188.70967741935485,261.2903225806452
577,Bryan Cristante,ITA,MF,Atalanta,Serie A,22,1995,31.4,66,50,21,32,13,18,59,30.5,41,43,6,37,23,89,27,0,0,2017-2018,90.0,65.92356687898089,189.171974522293
578,Sebastián Cristóforo,URU,MF,Fiorentina,Serie A,23,1993,3.0,16,12,6,8,2,9,19,47.4,10,4,0,4,4,20,6,0,0,2017-2018,90.0,120.0,480.0
579,Enzo Crivelli,FRA,FW,Angers,Ligue 1,22,1995,11.4,13,9,2,6,5,1,5,20.0,4,4,0,4,2,15,6,0,0,2017-2018,90.0,15.789473684210526,102.63157894736841
580,Enzo Crivelli,FRA,FW,Caen,Ligue 1,22,1995,8.1,4,2,2,1,1,1,5,20.0,4,1,0,1,2,6,2,0,0,2017-2018,90.0,22.22222222222222,44.44444444444444
581,Giovanni Crociata,ITA,"MF,FW",Crotone,Serie A,19,1997,3.2,9,6,3,4,2,1,4,25.0,3,7,0,7,4,13,3,0,0,2017-2018,90.0,112.5,253.125
582,Luca Crosta,ITA,GK,Cagliari,Serie A,19,1998,1.0,0,0,0,0,0,0,0,0.0,0,0,0,0,0,0,1,0,0,2017-2018,90.0,0.0,0.0
583,Peter Crouch,ENG,FW,Stoke City,Premier League,36,1981,17.4,2,0,0,1,1,0,12,0.0,12,7,4,3,1,3,31,0,0,2017-2018,90.0,5.172413793103448,10.344827586206897
584,Juan Cruz,ESP,FW,Málaga,La Liga,17,2000,0.1,2,2,0,2,0,0,0,0.0,0,0,0,0,0,2,0,0,0,2017-2018,90.0,0.0,1800.0
585,Juan Cuadrado,COL,"FW,MF",Juventus,Serie A,29,1988,15.0,28,19,17,9,2,11,27,40.7,16,14,0,14,19,47,14,1,0,2017-2018,90.0,114.0,168.0
586,Iván Cuéllar,ESP,GK,Leganés,La Liga,33,1984,35.0,4,3,4,0,0,3,4,75.0,1,0,0,0,3,7,22,6,0,2017-2018,90.0,7.714285714285714,10.285714285714285
587,Mickaël Cuisance,FRA,"MF,FW",Gladbach,Bundesliga,17,1999,13.4,31,20,16,11,4,19,29,65.5,10,22,4,18,10,41,10,1,0,2017-2018,90.0,67.16417910447761,208.20895522388057
588,Josh Cullen,IRL,MF,West Ham,Premier League,21,1996,0.1,0,0,0,0,0,0,1,0.0,1,1,1,0,2,2,0,0,0,2017-2018,90.0,1800.0,0.0
589,Patrick Cutrone,ITA,FW,Milan,Serie A,19,1998,16.7,11,10,2,7,2,1,10,10.0,9,11,1,10,3,14,12,0,0,2017-2018,90.0,16.16766467065868,59.2814371257485
590,Wylan Cyprien,FRA,MF,Nice,Ligue 1,22,1995,10.6,9,7,4,4,1,2,11,18.2,9,7,1,6,11,20,7,2,0,2017-2018,90.0,93.39622641509435,76.41509433962264
591,Marco D'Alessandro,ITA,"MF,FW",Benevento,Serie A,26,1991,11.6,31,22,15,9,7,8,24,33.3,16,12,1,11,10,41,8,1,0,2017-2018,90.0,77.58620689655173,240.51724137931035
592,Danilo D'Ambrosio,ITA,DF,Inter,Serie A,28,1988,33.1,82,64,38,35,9,30,59,50.8,29,31,7,24,45,127,68,1,0,2017-2018,90.0,122.35649546827793,222.96072507552867
593,Damien Da Silva,FRA,DF,Caen,Ligue 1,29,1988,31.5,52,35,40,12,0,20,33,60.6,13,45,25,20,36,88,184,2,0,2017-2018,90.0,102.85714285714286,148.57142857142858
594,Kouadio-Yves Dabila,CIV,DF,Lille,Ligue 1,20,1997,10.5,20,11,14,4,2,6,10,60.0,4,14,6,8,10,30,46,0,0,2017-2018,90.0,85.71428571428571,171.42857142857142
595,Bryan Dabo,BFA,MF,Fiorentina,Serie A,25,1992,6.6,17,11,6,10,1,6,15,40.0,9,13,1,12,15,32,24,1,0,2017-2018,90.0,204.54545454545453,231.8181818181818
596,Bryan Dabo,BFA,"MF,FW",Saint-Étienne,Ligue 1,25,1992,14.3,25,16,12,10,3,7,29,24.1,22,12,1,11,11,36,22,0,0,2017-2018,90.0,69.23076923076923,157.34265734265733
597,Mahmoud Dahoud,GER,MF,Dortmund,Bundesliga,21,1996,12.7,38,23,11,21,6,13,30,43.3,17,18,2,16,12,50,7,0,0,2017-2018,90.0,85.03937007874016,269.29133858267716
598,Dario Dainelli,ITA,DF,Chievo,Serie A,38,1979,16.7,19,14,14,4,1,10,21,47.6,11,27,22,5,46,65,126,0,0,2017-2018,90.0,247.90419161676647,102.39520958083833
599,Felipe dal Belo,BRA,DF,SPAL,Serie A,33,1984,28.6,51,34,32,16,3,25,49,51.0,24,42,24,18,48,99,157,1,0,2017-2018,90.0,151.04895104895104,160.48951048951048
600,Charlie Daniels,ENG,"DF,MF",Bournemouth,Premier League,30,1986,33.4,48,34,32,12,4,22,41,53.7,19,34,7,27,31,79,114,0,0,2017-2018,90.0,83.53293413173652,129.34131736526945
601,Danilo,BRA,DF,Manchester City,Premier League,26,1991,15.0,43,29,25,12,6,19,35,54.3,16,15,6,9,19,62,33,0,0,2017-2018,90.0,114.0,258.0
602,Scott Dann,ENG,DF,Crystal Palace,Premier League,30,1987,15.9,10,5,8,2,0,7,17,41.2,10,17,14,3,23,33,98,1,0,2017-2018,90.0,130.18867924528303,56.60377358490566
603,Kevin Danso,AUT,DF,Augsburg,Bundesliga,18,1998,12.3,18,12,13,5,0,12,16,75.0,4,21,14,7,20,38,63,1,0,2017-2018,89.99999999999999,146.34146341463412,131.7073170731707
604,Dante,BRA,DF,Nice,Ligue 1,33,1983,32.4,43,28,32,10,1,21,36,58.3,15,44,25,19,47,90,130,2,0,2017-2018,90.0,130.55555555555557,119.44444444444444
605,Romain Danzé,FRA,DF,Rennes,Ligue 1,31,1986,7.6,12,7,3,4,5,8,13,61.5,5,11,2,9,3,15,34,0,0,2017-2018,90.0,35.526315789473685,142.10526315789474
606,Andrea Danzi,ITA,MF,Hellas Verona,Serie A,18,1999,4.4,11,6,7,4,0,5,13,38.5,8,3,0,3,5,16,5,1,0,2017-2018,90.0,102.27272727272727,225.0
607,Stéphane Darbion,FRA,"FW,MF",Troyes,Ligue 1,33,1984,19.0,19,14,13,4,2,5,40,12.5,35,21,2,19,20,39,17,0,0,2017-2018,90.0,94.73684210526316,90.0
608,Palkó Dárdai,HUN,"FW,MF",Hertha BSC,Bundesliga,18,1999,0.3,0,0,0,0,0,0,0,0.0,0,0,0,0,0,0,1,0,0,2017-2018,90.0,0.0,0.0
609,Sergi Darder,ESP,MF,Espanyol,La Liga,23,1993,30.9,64,43,29,28,7,19,62,30.6,43,31,5,26,52,116,48,1,0,2017-2018,90.0,151.45631067961165,186.40776699029126
610,Sergi Darder,ESP,MF,Lyon,Ligue 1,23,1993,2.3,9,3,1,5,3,1,7,14.3,6,0,0,0,3,12,3,0,0,2017-2018,90.0,117.3913043478261,352.1739130434783
611,Vladimír Darida,CZE,MF,Hertha BSC,Bundesliga,26,1990,18.2,38,28,11,18,9,11,26,42.3,15,22,4,18,24,62,23,0,0,2017-2018,90.0,118.68131868131869,187.9120879120879
612,Karl Darlow,ENG,GK,Newcastle Utd,Premier League,26,1990,10.0,0,0,0,0,0,0,0,0.0,0,0,0,0,0,0,3,4,0,2017-2018,90.0,0.0,0.0
613,Matteo Darmian,ITA,DF,Manchester Utd,Premier League,27,1989,4.9,16,14,7,7,2,6,19,31.6,13,5,3,2,7,23,23,0,0,2017-2018,90.0,128.57142857142856,293.87755102040813
614,Ben Davies,WAL,DF,Tottenham,Premier League,24,1993,25.8,47,33,13,21,13,25,48,52.1,23,24,5,19,28,75,70,1,0,2017-2018,90.0,97.67441860465115,163.953488372093
615,Tom Davies,ENG,MF,Everton,Premier League,19,1998,21.1,30,20,14,11,5,12,54,22.2,42,19,5,14,24,54,21,0,0,2017-2018,90.0,102.3696682464455,127.96208530805687
616,Steven Davis,NIR,MF,Southampton,Premier League,32,1985,16.9,30,21,10,17,3,11,30,36.7,19,22,6,16,15,45,24,1,0,2017-2018,90.0,79.88165680473374,159.76331360946747
617,Salem Al-Dawsari,KSA,MF,Villarreal,La Liga,25,1991,0.4,1,0,0,1,0,1,1,100.0,0,1,0,1,0,1,0,0,0,2017-2018,90.0,0.0,225.0
618,Craig Dawson,ENG,DF,West Brom,Premier League,27,1990,27.9,38,28,25,7,6,13,36,36.1,23,39,26,13,52,90,140,0,0,2017-2018,90.0,167.74193548387098,122.58064516129032
619,Kevin De Bruyne,BEL,MF,Manchester City,Premier League,26,1991,34.1,62,43,23,25,14,23,80,28.8,57,45,2,43,25,87,14,2,0,2017-2018,90.0,65.98240469208211,163.63636363636363
620,Sebastien De Maio,FRA,DF,Bologna,Serie A,30,1987,22.8,26,17,15,11,0,10,25,40.0,15,35,18,17,36,62,147,0,0,2017-2018,90.0,142.1052631578947,102.63157894736841
621,Rodrigo De Paul,ARG,"FW,MF",Udinese,Serie A,23,1994,25.8,31,18,10,17,4,4,32,12.5,28,34,1,33,16,47,8,0,0,2017-2018,90.0,55.81395348837209,108.13953488372093
622,Daniele De Rossi,ITA,MF,Roma,Serie A,34,1983,20.3,23,13,12,9,2,9,33,27.3,24,18,13,5,43,66,45,2,0,2017-2018,90.0,190.64039408866995,101.9704433497537
623,Mattia De Sciglio,ITA,DF,Juventus,Serie A,24,1992,10.8,22,17,7,13,2,9,13,69.2,4,12,2,10,14,36,32,0,0,2017-2018,90.0,116.66666666666666,183.33333333333331
624,Lorenzo De Silvestri,ITA,DF,Torino,Serie A,29,1988,32.8,39,25,19,13,7,16,26,61.5,10,47,10,37,27,66,165,0,0,2017-2018,90.0,74.08536585365854,107.01219512195124
625,Lucas Deaux,FRA,MF,Guingamp,Ligue 1,28,1988,21.6,62,45,21,37,4,20,67,29.9,47,41,6,35,32,94,19,0,0,2017-2018,90.0,133.33333333333331,258.3333333333333
626,Mathieu Debuchy,FRA,DF,Saint-Étienne,Ligue 1,32,1985,14.6,34,25,22,8,4,17,30,56.7,13,16,10,6,27,61,73,0,0,2017-2018,90.0,166.43835616438358,209.58904109589042
627,Troy Deeney,ENG,FW,Watford,Premier League,29,1988,20.5,15,11,3,8,4,3,11,27.3,8,14,1,13,5,20,20,0,0,2017-2018,90.0,21.951219512195124,65.85365853658537
628,Jermain Defoe,ENG,FW,Bournemouth,Premier League,34,1982,12.1,12,9,2,6,4,2,10,20.0,8,10,0,10,4,16,1,0,0,2017-2018,90.0,29.75206611570248,89.25619834710743
629,Steven Defour,BEL,MF,Burnley,Premier League,29,1988,22.2,33,22,12,18,3,10,46,21.7,36,35,7,28,46,79,25,0,0,2017-2018,90.0,186.4864864864865,133.7837837837838
630,Grégoire Defrel,MTQ,"FW,MF",Roma,Serie A,26,1991,5.4,8,3,1,1,6,2,8,25.0,6,5,0,5,3,11,6,0,0,2017-2018,90.0,49.99999999999999,133.33333333333331
631,Alessandro Deiola,ITA,MF,Cagliari,Serie A,21,1995,5.0,9,7,5,3,1,6,13,46.2,7,8,0,8,4,13,12,0,0,2017-2018,90.0,72.0,162.0
632,Lorenzo Del Pinto,ITA,MF,Benevento,Serie A,27,1990,8.4,23,17,10,10,3,7,25,28.0,18,13,4,9,16,39,7,2,0,2017-2018,90.0,171.42857142857142,246.42857142857142
633,Damien Delaney,IRL,DF,Crystal Palace,Premier League,36,1981,1.1,2,1,2,0,0,1,1,100.0,0,5,4,1,3,5,7,0,0,2017-2018,90.0,245.45454545454544,163.63636363636363
634,Thomas Delaney,DEN,MF,Werder Bremen,Bundesliga,25,1991,31.1,79,61,27,46,6,36,53,67.9,17,37,12,25,43,122,74,4,0,2017-2018,90.0,124.43729903536978,228.61736334405145
635,Jonathan Delaplace,FRA,MF,Caen,Ligue 1,31,1986,6.5,10,8,1,8,1,3,10,30.0,7,13,5,8,8,18,8,0,0,2017-2018,90.00000000000001,110.76923076923077,138.46153846153848
636,Cristian Dell'Orco,ITA,DF,Sassuolo,Serie A,23,1994,4.7,4,1,1,2,1,1,3,33.3,2,5,1,4,10,14,19,0,0,2017-2018,90.0,191.48936170212764,76.59574468085106
637,Andy Delort,ALG,FW,Toulouse,Ligue 1,25,1991,25.9,20,13,2,9,9,4,19,21.1,15,10,0,10,12,32,22,0,0,2017-2018,90.0,41.698841698841704,69.49806949806951
638,Fabian Delph,ENG,DF,Manchester City,Premier League,27,1989,19.3,46,34,21,16,9,18,37,48.6,19,16,0,16,30,76,42,2,0,2017-2018,90.0,139.8963730569948,214.50777202072535
639,Mousa Dembélé,BEL,MF,Tottenham,Premier League,30,1987,20.9,36,24,19,11,6,9,37,24.3,28,20,0,20,33,69,15,0,0,2017-2018,90.0,142.10526315789474,155.02392344497608
640,Ousmane Dembélé,FRA,"FW,MF",Barcelona,La Liga,20,1997,10.3,10,7,2,5,3,1,13,7.7,12,8,0,8,5,15,2,0,0,2017-2018,90.0,43.689320388349515,87.37864077669903
641,Jessy Deminguet,FRA,"MF,FW",Caen,Ligue 1,19,1998,5.9,12,9,4,6,2,4,14,28.6,10,5,0,5,10,22,13,0,0,2017-2018,90.0,152.54237288135593,183.0508474576271
642,Kerem Demirbay,GER,MF,Hoffenheim,Bundesliga,24,1993,13.5,38,30,15,17,6,12,28,42.9,16,21,3,18,14,52,21,0,0,2017-2018,90.0,93.33333333333334,253.33333333333334
643,Ermedin Demirović,BIH,FW,Alavés,La Liga,19,1998,2.0,1,1,0,1,0,0,1,0.0,1,5,0,5,0,1,2,0,0,2017-2018,90.0,0.0,45.0
644,Diego Demme,GER,MF,RB Leipzig,Bundesliga,25,1991,25.4,81,57,29,48,4,47,87,54.0,40,31,3,28,48,129,29,0,0,2017-2018,90.0,170.07874015748033,287.00787401574803
645,Fabio Depaoli,ITA,"DF,MF",Chievo,Serie A,20,1997,13.2,31,22,21,7,3,21,40,52.5,19,27,10,17,15,46,42,0,0,2017-2018,90.0,102.27272727272727,211.36363636363637
646,Mathieu Deplagne,FRA,DF,Troyes,Ligue 1,25,1991,26.8,52,38,33,14,5,20,48,41.7,28,26,10,16,60,112,95,2,0,2017-2018,90.0,201.49253731343282,174.62686567164178
647,Laurent Depoitre,BEL,FW,Huddersfield,Premier League,28,1988,20.2,14,8,4,8,2,3,21,14.3,18,15,3,12,11,25,36,0,0,2017-2018,90.0,49.00990099009901,62.37623762376238
648,Mike van der Hoorn,NED,DF,Swansea City,Premier League,24,1992,21.6,32,22,23,8,1,16,24,66.7,8,24,14,10,39,71,127,0,0,2017-2018,90.0,162.5,133.33333333333331
649,Gregory van der Wiel,NED,DF,Cagliari,Serie A,29,1988,3.2,5,3,4,1,0,3,5,60.0,2,1,0,1,10,15,12,0,0,2017-2018,90.0,281.25,140.625
650,Daniele Dessena,ITA,"MF,DF",Cagliari,Serie A,30,1987,6.4,18,10,12,5,1,6,12,50.0,6,7,1,6,6,24,17,0,0,2017-2018,90.0,84.375,253.125
651,Mattia Destro,ITA,FW,Bologna,Serie A,26,1991,18.0,15,13,4,9,2,3,11,27.3,8,10,1,9,5,20,26,0,0,2017-2018,90.0,25.0,75.0
652,Gerard Deulofeu,ESP,"FW,MF",Watford,Premier League,23,1994,4.8,5,3,2,2,1,2,11,18.2,9,0,0,0,4,9,3,1,0,2017-2018,90.0,75.0,93.75
653,Gerard Deulofeu,ESP,"MF,FW",Barcelona,La Liga,23,1994,5.6,8,5,6,1,1,3,4,75.0,1,2,0,2,8,16,0,0,0,2017-2018,90.0,128.57142857142858,128.57142857142858
654,Gianluca Di Chiara,ITA,DF,Benevento,Serie A,23,1993,11.2,26,19,18,6,2,7,21,33.3,14,10,3,7,11,37,37,1,0,2017-2018,90.0,88.39285714285714,208.92857142857144
655,Federico Di Francesco,ITA,"FW,DF",Bologna,Serie A,23,1994,17.7,26,13,14,8,4,5,20,25.0,15,24,2,22,16,42,25,0,0,2017-2018,90.0,81.35593220338984,132.20338983050848
656,Davide Di Gennaro,ITA,MF,Lazio,Serie A,29,1988,0.1,1,0,1,0,0,1,1,100.0,0,0,0,0,0,1,0,0,0,2017-2018,90.0,0.0,900.0
657,Ángel Di María,ARG,FW,Paris S-G,Ligue 1,29,1988,23.5,13,10,5,3,5,7,39,17.9,32,18,2,16,10,23,8,0,0,2017-2018,90.0,38.29787234042553,49.78723404255319
658,Franco Di Santo,ARG,"FW,MF",Schalke 04,Bundesliga,28,1989,18.4,17,13,3,13,1,7,15,46.7,8,12,1,11,2,19,24,0,0,2017-2018,90.0,9.782608695652174,83.15217391304348
659,Cheick Diabaté,MLI,FW,Benevento,Serie A,29,1988,7.4,1,1,0,1,0,1,3,33.3,2,2,0,2,0,1,6,0,0,2017-2018,90.0,0.0,12.162162162162161
660,Fousseni Diabaté,MLI,"MF,FW",Leicester City,Premier League,21,1995,6.5,9,6,5,3,1,1,4,25.0,3,6,0,6,8,17,8,0,0,2017-2018,90.00000000000001,110.76923076923077,124.61538461538463
661,Moussa Diaby,FRA,MF,Crotone,Serie A,18,1999,0.8,1,0,1,0,0,1,4,25.0,3,1,0,1,1,2,0,0,0,2017-2018,90.0,112.5,112.5
662,Fallou Diagne,SEN,"DF,MF",Metz,Ligue 1,27,1989,24.9,33,20,21,12,0,7,22,31.8,15,33,18,15,46,79,116,3,0,2017-2018,90.0,166.26506024096386,119.27710843373494
663,Adama Diakhaby,FRA,FW,Monaco,Ligue 1,21,1996,9.4,23,15,6,12,5,6,16,37.5,10,13,0,13,13,36,5,0,0,2017-2018,90.0,124.46808510638297,220.2127659574468
664,Mouctar Diakhaby,GUI,DF,Lyon,Ligue 1,20,1996,8.1,10,6,7,3,0,4,7,57.1,3,14,9,5,12,22,52,1,0,2017-2018,90.0,133.33333333333334,111.11111111111111
665,Abdou Diallo,SEN,DF,Mainz 05,Bundesliga,21,1996,26.8,75,53,45,25,5,38,50,76.0,12,37,14,23,50,125,75,0,0,2017-2018,90.0,167.910447761194,251.865671641791
666,Abdoulaye Diallo,SEN,GK,Rennes,Ligue 1,25,1992,3.0,0,0,0,0,0,0,0,0.0,0,0,0,0,0,0,4,1,0,2017-2018,90.0,0.0,0.0
667,Habib Diallo,SEN,"FW,MF",Metz,Ligue 1,22,1995,0.2,0,0,0,0,0,0,0,0.0,0,0,0,0,0,0,0,0,0,2017-2018,90.0,0.0,0.0
668,Mustapha Diallo,SEN,MF,Guingamp,Ligue 1,31,1986,15.4,48,36,15,29,4,15,33,45.5,18,20,4,16,20,68,29,0,0,2017-2018,90.0,116.88311688311688,280.5194805194805
669,Mohamed Diamé,SEN,MF,Newcastle Utd,Premier League,30,1987,22.7,89,64,33,48,8,16,62,25.8,46,44,7,37,48,137,30,2,0,2017-2018,89.99999999999999,190.30837004405285,352.863436123348
670,Lassana Diarra,FRA,MF,Paris S-G,Ligue 1,32,1985,6.7,12,4,4,7,1,8,12,66.7,4,3,1,2,6,18,6,0,0,2017-2018,90.0,80.59701492537313,161.19402985074626
671,Amadou Diawara,GUI,MF,Napoli,Serie A,20,1997,7.3,11,9,3,7,1,1,7,14.3,6,12,2,10,9,20,5,0,0,2017-2018,90.0,110.95890410958904,135.6164383561644
672,Brahim Díaz,MAR,"FW,DF",Manchester City,Premier League,17,1999,0.6,1,0,1,0,0,0,0,0.0,0,3,0,3,1,2,0,0,0,2017-2018,90.0,150.0,150.0
673,Bakaye Dibassy,MLI,DF,Amiens,Ligue 1,27,1989,30.9,71,51,45,22,4,24,50,48.0,26,52,26,26,58,129,148,0,0,2017-2018,90.0,168.93203883495147,206.79611650485438
674,Daniel Didavi,GER,MF,Wolfsburg,Bundesliga,27,1990,24.9,34,19,10,19,5,14,33,42.4,19,20,1,19,7,41,12,0,0,2017-2018,90.0,25.301204819277107,122.89156626506023
675,Thomas Didillon,FRA,GK,Metz,Ligue 1,21,1995,9.0,0,0,0,0,0,0,1,0.0,1,0,0,0,0,0,5,2,0,2017-2018,90.0,0.0,0.0
676,Étienne Didot,FRA,MF,Guingamp,Ligue 1,34,1983,18.0,54,33,20,33,1,20,43,46.5,23,21,7,14,19,73,29,0,0,2017-2018,90.0,95.0,270.0
677,Adrián Diéguez,ESP,DF,Alavés,La Liga,21,1996,4.8,10,5,5,5,0,6,13,46.2,7,5,0,5,11,21,24,1,0,2017-2018,90.0,206.25,187.5
678,Dennis Diekmeier,GER,DF,Hamburger SV,Bundesliga,27,1989,20.8,47,43,31,10,6,25,36,69.4,11,22,11,11,16,63,50,0,0,2017-2018,90.0,69.23076923076923,203.3653846153846
679,Eric Dier,ENG,"MF,DF",Tottenham,Premier League,23,1994,31.4,61,43,15,39,7,17,42,40.5,25,32,11,21,48,109,93,7,0,2017-2018,90.0,137.57961783439492,174.8407643312102
680,Lucas Digne,FRA,DF,Barcelona,La Liga,24,1993,7.8,22,17,13,6,3,8,12,66.7,4,15,3,12,12,34,18,0,0,2017-2018,90.0,138.46153846153845,253.84615384615384
681,Landry Dimata,BEL,FW,Wolfsburg,Bundesliga,19,1997,10.0,7,6,4,3,0,5,6,83.3,1,6,2,4,2,9,5,0,0,2017-2018,90.0,18.0,63.0
682,Tristan Dingomé,CMR,MF,Troyes,Ligue 1,26,1991,13.2,25,20,12,9,4,5,13,38.5,8,12,0,12,12,37,16,1,0,2017-2018,90.0,81.81818181818181,170.45454545454547
683,Ismaël Diomandé,CIV,"DF,MF",Caen,Ligue 1,24,1992,7.9,14,8,7,6,1,10,15,66.7,5,11,5,6,5,19,20,0,0,2017-2018,90.0,56.96202531645569,159.49367088607593
684,Lois Diony,FRA,FW,Saint-Étienne,Ligue 1,24,1992,10.3,3,0,1,2,0,0,3,0.0,3,5,1,4,1,4,8,0,0,2017-2018,90.0,8.737864077669903,26.21359223300971
685,Issa Diop,FRA,DF,Toulouse,Ligue 1,20,1997,34.0,58,43,35,22,1,21,48,43.8,27,38,25,13,76,134,128,0,0,2017-2018,90.0,201.1764705882353,153.52941176470588
686,Papakouli Diop,SEN,MF,Espanyol,La Liga,31,1986,2.9,5,3,1,3,1,0,3,0.0,3,5,2,3,6,11,6,0,0,2017-2018,90.0,186.20689655172413,155.17241379310346
687,Papakouli Diop,SEN,MF,Eibar,La Liga,31,1986,10.4,26,20,6,16,4,11,26,42.3,15,3,0,3,13,39,10,0,0,2017-2018,90.0,112.49999999999999,224.99999999999997
688,Assane Dioussé,SEN,MF,Saint-Étienne,Ligue 1,19,1997,14.9,32,21,14,14,4,13,34,38.2,21,29,2,27,11,43,16,2,0,2017-2018,90.0,66.44295302013423,193.28859060402684
689,Djené,TOG,DF,Getafe,La Liga,25,1991,36.0,87,65,71,15,1,34,52,65.4,18,33,14,19,78,165,190,1,0,2017-2018,90.0,195.0,217.5
690,Koffi Djidji,CIV,DF,Nantes,Ligue 1,24,1992,26.8,55,39,32,20,3,19,29,65.5,10,34,15,19,45,100,126,0,0,2017-2018,90.0,151.1194029850746,184.7014925373134
691,Alexander Djiku,GHA,DF,Caen,Ligue 1,22,1994,28.0,65,43,52,11,2,25,52,48.1,27,34,5,29,57,122,155,2,0,2017-2018,90.0,183.21428571428572,208.92857142857142
692,Papy Djilobodji,SEN,DF,Dijon,Ligue 1,28,1988,30.0,45,29,34,11,0,21,43,48.8,22,38,25,13,71,116,211,5,0,2017-2018,90.0,213.0,135.0
693,Berat Djimsiti,ALB,DF,Benevento,Serie A,24,1993,30.0,32,17,28,4,0,12,30,40.0,18,37,23,14,62,94,178,1,0,2017-2018,90.0,186.0,96.0
694,Marko Dmitrović,SRB,GK,Eibar,La Liga,25,1992,36.0,4,4,4,0,0,4,11,36.4,7,1,0,1,2,6,26,2,0,2017-2018,90.0,5.0,10.0
695,Keagan Dolly,RSA,"MF,FW",Montpellier,Ligue 1,24,1993,9.8,12,7,2,7,3,1,11,9.1,10,11,0,11,1,13,2,0,0,2017-2018,90.0,9.183673469387754,110.20408163265306
696,Jaume Doménech,ESP,GK,Valencia,La Liga,26,1990,5.0,0,0,0,0,0,0,0,0.0,0,0,0,0,0,0,2,0,0,2017-2018,90.0,0.0,0.0
697,Jean-Luc Dompé,FRA,FW,Amiens,Ligue 1,21,1995,0.3,0,0,0,0,0,0,0,0.0,0,0,0,0,0,0,0,0,0,2017-2018,90.0,0.0,0.0
698,Giulio Donati,ITA,"DF,FW",Mainz 05,Bundesliga,27,1990,25.4,56,42,30,21,5,34,50,68.0,16,38,8,30,35,91,66,1,0,2017-2018,90.0,124.01574803149607,198.42519685039372
699,Ji Dong-won,KOR,"FW,MF",Augsburg,Bundesliga,26,1991,0.2,2,1,0,1,1,0,0,0.0,0,1,1,0,1,3,0,0,0,2017-2018,90.0,450.0,900.0
700,Anastasios Donis,GRE,"MF,FW",Stuttgart,Bundesliga,20,1996,10.5,20,14,10,6,4,6,8,75.0,2,2,0,2,9,29,7,0,0,2017-2018,90.0,77.14285714285714,171.42857142857142
701,Gianluigi Donnarumma,ITA,GK,Milan,Serie A,18,1999,38.0,1,0,1,0,0,1,1,100.0,0,0,0,0,1,2,13,8,0,2017-2018,90.0,2.3684210526315788,2.3684210526315788
702,Godfred Donsah,GHA,MF,Bologna,Serie A,21,1996,19.9,29,20,11,14,4,10,17,58.8,7,25,0,25,22,51,43,0,0,2017-2018,90.0,99.49748743718594,131.15577889447238
703,Dória,BRA,DF,Marseille,Ligue 1,22,1994,0.9,2,2,0,2,0,0,0,0.0,0,3,1,2,1,3,1,0,0,2017-2018,90.0,100.0,200.0
704,Niklas Dorsch,GER,MF,Bayern Munich,Bundesliga,19,1998,1.0,1,1,0,1,0,0,2,0.0,2,0,0,0,1,2,0,0,0,2017-2018,90.0,90.0,90.0
705,Mauro dos Santos,ARG,DF,Leganés,La Liga,28,1989,10.9,16,14,11,5,0,10,15,66.7,5,7,5,2,12,28,53,1,0,2017-2018,90.0,99.08256880733944,132.11009174311926
706,Mathieu Dossevi,TOG,"FW,MF",Metz,Ligue 1,29,1988,27.9,35,25,15,15,5,7,39,17.9,32,24,3,21,28,63,12,0,0,2017-2018,90.0,90.3225806451613,112.90322580645162
707,Abdoulaye Doucouré,MLI,MF,Watford,Premier League,24,1993,36.9,79,52,28,42,9,27,79,34.2,52,43,10,33,54,133,61,0,0,2017-2018,90.0,131.70731707317074,192.6829268292683
708,Cheick Doukouré,CIV,MF,Levante,La Liga,24,1992,11.4,34,19,18,15,1,6,22,27.3,16,15,4,11,14,48,4,0,0,2017-2018,90.0,110.52631578947367,268.4210526315789
709,Mohamed Dräger,TUN,"MF,FW",Freiburg,Bundesliga,21,1996,0.6,0,0,0,0,0,0,1,0.0,1,1,0,1,0,0,0,0,0,2017-2018,90.0,0.0,0.0
710,Aleksandar Dragović,AUT,DF,Leicester City,Premier League,26,1991,8.5,13,10,13,0,0,7,13,53.8,6,16,8,8,16,29,46,0,0,2017-2018,90.0,169.41176470588235,137.64705882352942
711,Aleksandar Dragović,AUT,DF,Leverkusen,Bundesliga,26,1991,0.5,0,0,0,0,0,0,1,0.0,1,0,0,0,0,0,0,1,0,2017-2018,90.0,0.0,0.0
712,Bartłomiej Drągowski,POL,GK,Fiorentina,Serie A,19,1997,2.4,0,0,0,0,0,0,0,0.0,0,0,0,0,0,0,0,1,0,2017-2018,90.0,0.0,0.0
713,Boukary Dramé,SEN,"DF,MF",SPAL,Serie A,32,1985,1.1,1,1,1,0,0,0,0,0.0,0,0,0,0,2,3,4,0,0,2017-2018,90.0,163.63636363636363,81.81818181818181
714,Julian Draxler,GER,"MF,FW",Paris S-G,Ligue 1,23,1993,18.9,20,14,4,13,3,6,32,18.8,26,18,2,16,28,48,8,0,0,2017-2018,90.0,133.33333333333334,95.23809523809524
715,Danny Drinkwater,ENG,MF,Chelsea,Premier League,27,1990,5.9,15,10,6,8,1,3,17,17.6,14,10,2,8,8,23,7,0,0,2017-2018,90.0,122.03389830508473,228.81355932203388
716,Josip Drmić,SUI,"FW,MF",Gladbach,Bundesliga,24,1992,5.2,0,0,0,0,0,0,4,0.0,4,1,0,1,0,0,1,1,0,2017-2018,90.0,0.0,0.0
717,Rick van Drongelen,NED,DF,Hamburger SV,Bundesliga,18,1998,16.0,30,25,23,7,0,21,28,75.0,7,20,11,9,19,49,58,1,0,2017-2018,90.0,106.875,168.75
718,Óscar Duarte,CRC,DF,Espanyol,La Liga,28,1989,11.0,12,9,8,4,0,4,11,36.4,7,8,8,0,9,21,60,2,0,2017-2018,90.0,73.63636363636364,98.18181818181819
719,Rubén Duarte,ESP,DF,Alavés,La Liga,21,1995,23.8,76,40,42,27,7,35,59,59.3,24,40,10,30,44,120,94,0,0,2017-2018,90.00000000000001,166.38655462184875,287.3949579831933
720,Leo Dubois,FRA,DF,Nantes,Ligue 1,22,1994,33.6,50,39,33,15,2,20,47,42.6,27,47,13,34,50,100,99,2,0,2017-2018,90.0,133.92857142857142,133.92857142857142
721,Martin Dúbravka,SVK,GK,Newcastle Utd,Premier League,28,1989,12.0,0,0,0,0,0,0,0,0.0,0,0,0,0,0,0,3,2,0,2017-2018,90.0,0.0,0.0
722,Ondrej Duda,SVK,MF,Hertha BSC,Bundesliga,22,1994,8.3,16,12,7,6,3,6,14,42.9,8,15,0,15,4,20,8,0,0,2017-2018,90.0,43.37349397590361,173.49397590361443
723,Shane Duffy,IRL,DF,Brighton,Premier League,25,1992,36.6,31,19,22,9,0,7,20,35.0,13,66,59,7,50,81,332,5,0,2017-2018,90.0,122.95081967213115,76.22950819672131
724,Paul Dummett,WAL,DF,Newcastle Utd,Premier League,25,1991,17.8,28,19,21,7,0,13,27,48.1,14,27,10,17,23,51,107,1,0,2017-2018,90.0,116.29213483146067,141.57303370786516
725,Alfred Duncan,GHA,MF,Sassuolo,Serie A,24,1993,21.6,39,29,16,18,5,15,52,28.8,37,32,2,30,19,58,29,1,0,2017-2018,90.0,79.16666666666666,162.5
726,Lewis Dunk,ENG,DF,Brighton,Premier League,25,1991,38.0,67,33,49,18,0,25,48,52.1,23,73,58,15,71,138,230,2,0,2017-2018,90.0,168.1578947368421,158.68421052631578
727,Maxime Dupé,FRA,GK,Nantes,Ligue 1,24,1993,1.0,0,0,0,0,0,0,0,0.0,0,0,0,0,0,0,2,0,0,2017-2018,90.0,0.0,0.0
728,Jimmy Durmaz,SWE,"MF,FW",Toulouse,Ligue 1,28,1989,11.4,16,9,5,5,6,6,14,42.9,8,2,0,2,14,30,9,0,0,2017-2018,90.0,110.52631578947367,126.3157894736842
729,Riza Durmisi,DEN,DF,Betis,La Liga,23,1994,23.1,39,21,24,14,1,10,18,55.6,8,18,7,11,15,54,65,1,0,2017-2018,89.99999999999999,58.441558441558435,151.94805194805193
730,Hugo Duro,ESP,FW,Getafe,La Liga,17,1999,0.2,0,0,0,0,0,0,1,0.0,1,0,0,0,0,0,0,0,0,2017-2018,90.0,0.0,0.0
731,Noë Dussenne,BEL,FW,Crotone,Serie A,25,1992,0.9,2,0,2,0,0,0,0,0.0,0,0,0,0,1,3,8,0,0,2017-2018,90.0,100.0,200.0
732,Paulo Dybala,ARG,"MF,FW",Juventus,Serie A,23,1993,26.1,19,11,4,10,5,4,32,12.5,28,22,0,22,12,31,4,0,0,2017-2018,90.0,41.37931034482758,65.51724137931033
733,Nathan Dyer,ENG,"MF,FW",Swansea City,Premier League,29,1987,14.5,22,16,8,9,5,6,24,25.0,18,13,0,13,11,33,3,0,0,2017-2018,90.0,68.27586206896551,136.55172413793102
734,Edin Džeko,BIH,FW,Roma,Serie A,31,1986,33.5,15,10,1,9,5,3,15,20.0,12,9,1,8,4,19,36,0,0,2017-2018,90.0,10.746268656716417,40.298507462686565
735,Blerim Džemaili,SUI,"MF,FW",Bologna,Serie A,31,1986,13.3,27,19,11,15,1,9,27,33.3,18,15,4,11,18,45,11,0,0,2017-2018,90.0,121.80451127819548,182.70676691729324
736,Félix Eboa Eboa,CMR,DF,Guingamp,Ligue 1,20,1997,16.9,19,11,12,7,0,8,16,50.0,8,21,11,10,39,58,119,2,0,2017-2018,90.0,207.6923076923077,101.18343195266273
737,Éder,ITA,"FW,MF",Inter,Serie A,30,1986,8.9,10,7,2,4,4,0,10,0.0,10,6,1,5,5,15,4,0,0,2017-2018,90.0,50.56179775280899,101.12359550561798
738,Simone Edera,ITA,"FW,MF",Torino,Serie A,20,1997,3.6,6,2,2,4,0,3,10,30.0,7,0,0,0,2,8,1,0,0,2017-2018,90.0,50.0,150.0
739,Ederson,BRA,GK,Manchester City,Premier League,23,1993,35.5,1,1,1,0,0,0,0,0.0,0,1,0,1,0,1,15,6,0,2017-2018,90.0,0.0,2.535211267605634
740,Tom Edwards,ENG,"DF,MF",Stoke City,Premier League,18,1999,5.3,15,9,10,5,0,8,8,100.0,0,5,2,3,5,20,20,0,0,2017-2018,90.0,84.9056603773585,254.7169811320755
741,Mandela Egbo,ENG,"DF,MF",Gladbach,Bundesliga,19,1997,0.1,0,0,0,0,0,0,0,0.0,0,0,0,0,0,0,2,0,0,2017-2018,90.0,0.0,0.0
742,Johannes Eggestein,GER,"FW,DF",Werder Bremen,Bundesliga,19,1998,1.1,0,0,0,0,0,0,1,0.0,1,2,1,1,1,1,0,0,0,2017-2018,90.0,81.81818181818181,0.0
743,Maximilian Eggestein,GER,MF,Werder Bremen,Bundesliga,20,1996,29.9,70,48,32,34,4,34,58,58.6,24,41,6,35,40,110,51,0,0,2017-2018,90.0,120.40133779264215,210.70234113712377
744,Albin Ekdal,SWE,MF,Hamburger SV,Bundesliga,28,1989,12.3,39,28,19,19,1,18,29,62.1,11,20,3,17,21,60,19,0,0,2017-2018,89.99999999999999,153.65853658536582,285.36585365853654
745,Josip Elez,CRO,DF,Hannover 96,Bundesliga,23,1994,8.6,12,8,9,2,1,5,9,55.6,4,9,7,2,16,28,39,1,0,2017-2018,90.0,167.4418604651163,125.58139534883722
746,Rob Elliot,IRL,GK,Newcastle Utd,Premier League,31,1986,16.0,0,0,0,0,0,0,1,0.0,1,0,0,0,0,0,8,0,0,2017-2018,90.0,0.0,0.0
747,Mohamed Elneny,EGY,MF,Arsenal,Premier League,25,1992,9.6,12,6,6,3,3,6,10,60.0,4,11,0,11,10,22,12,2,0,2017-2018,90.0,93.75,112.50000000000001
748,Aritz Elustondo,ESP,DF,Real Sociedad,La Liga,23,1994,17.7,32,20,20,9,3,19,30,63.3,11,20,7,13,45,77,84,0,0,2017-2018,90.0,228.8135593220339,162.71186440677968
749,Nico Elvedi,SUI,DF,Gladbach,Bundesliga,20,1996,32.4,66,46,41,22,3,37,55,67.3,18,39,9,30,51,117,108,3,0,2017-2018,90.0,141.66666666666669,183.33333333333334
750,Rodrigo Ely,BRA,DF,Alavés,La Liga,23,1993,29.9,32,18,26,6,0,19,34,55.9,15,45,36,9,50,82,183,0,0,2017-2018,90.0,150.5016722408027,96.32107023411372
751,Breel Embolo,SUI,"FW,MF",Schalke 04,Bundesliga,20,1997,10.2,14,10,3,7,4,2,9,22.2,7,13,0,13,6,20,3,0,0,2017-2018,90.0,52.94117647058824,123.52941176470588
752,Youssef En-Nesyri,MAR,FW,Málaga,La Liga,20,1997,17.7,31,25,10,14,7,6,26,23.1,20,11,0,11,9,40,32,0,0,2017-2018,90.0,45.76271186440678,157.6271186440678
753,Sergi Enrich,ESP,FW,Eibar,La Liga,27,1990,14.8,11,8,3,3,5,2,8,25.0,6,13,1,12,6,17,8,0,0,2017-2018,90.0,36.486486486486484,66.89189189189189
754,Javier Eraso,ESP,"MF,FW",Leganés,La Liga,27,1990,28.1,32,15,10,18,4,13,42,31.0,29,16,5,11,23,55,17,0,0,2017-2018,90.0,73.66548042704626,102.49110320284697
755,Christian Eriksen,DEN,"MF,FW",Tottenham,Premier League,25,1992,35.8,51,29,16,30,5,17,59,28.8,42,38,1,37,31,82,21,0,0,2017-2018,90.0,77.93296089385476,128.2122905027933
756,Gonzalo Escalante,ARG,MF,Eibar,La Liga,24,1993,17.4,59,35,21,32,6,17,39,43.6,22,26,3,23,32,91,19,0,0,2017-2018,90.0,165.51724137931035,305.17241379310343
757,Sergio Escudero,ESP,DF,Sevilla,La Liga,27,1989,25.9,78,49,40,26,12,32,62,51.6,30,35,6,29,66,144,69,1,0,2017-2018,90.0,229.34362934362937,271.04247104247105
758,Bernardo Espinosa,COL,DF,Girona,La Liga,28,1989,31.9,36,22,29,6,1,18,33,54.5,15,27,19,8,66,102,169,0,0,2017-2018,90.0,186.20689655172413,101.56739811912226
759,Michael Esser,GER,GK,Hannover 96,Bundesliga,29,1987,3.0,0,0,0,0,0,0,1,0.0,1,0,0,0,0,0,0,0,0,2017-2018,90.0,0.0,0.0
760,Alexander Esswein,GER,"FW,MF",Hertha BSC,Bundesliga,27,1990,6.9,25,16,13,10,2,12,25,48.0,13,4,0,4,9,34,11,0,0,2017-2018,90.0,117.39130434782608,326.08695652173907
761,Oghenekaro Etebo,NGA,MF,Las Palmas,La Liga,21,1995,13.5,24,17,9,12,3,12,26,46.2,14,17,3,14,27,51,10,0,0,2017-2018,90.0,180.0,160.0
762,Beñat Etxebarria,ESP,MF,Athletic Club,La Liga,30,1987,12.4,28,20,12,13,3,13,36,36.1,23,6,1,5,28,56,12,0,0,2017-2018,90.0,203.2258064516129,203.2258064516129
763,Xabier Etxeita,ESP,DF,Athletic Club,La Liga,29,1987,4.2,2,2,2,0,0,1,4,25.0,3,3,2,1,7,9,25,1,0,2017-2018,90.0,150.0,42.857142857142854
764,Jonny Evans,NIR,DF,West Brom,Premier League,29,1988,25.2,29,22,19,8,2,14,33,42.4,19,22,13,9,48,77,131,1,0,2017-2018,90.0,171.42857142857144,103.57142857142858
765,Franck Evina,CMR,FW,Bayern Munich,Bundesliga,17,2000,1.2,2,2,2,0,0,2,2,100.0,0,5,0,5,0,2,0,0,0,2017-2018,90.0,0.0,150.0
766,Patrice Evra,FRA,"DF,MF",West Ham,Premier League,36,1981,2.5,6,4,5,1,0,6,8,75.0,2,4,1,3,7,13,6,0,0,2017-2018,90.0,252.0,216.0
767,Patrice Evra,FRA,DF,Marseille,Ligue 1,36,1981,3.9,6,5,5,1,0,3,6,50.0,3,2,2,0,3,9,16,0,0,2017-2018,90.0,69.23076923076923,138.46153846153845
768,Edu Expósito,ESP,"MF,FW",La Coruña,La Liga,20,1996,1.1,1,0,0,0,1,0,1,0.0,1,1,0,1,2,3,2,0,0,2017-2018,90.0,163.63636363636363,81.81818181818181
769,Erik Expósito,ESP,FW,Las Palmas,La Liga,21,1996,5.2,1,1,0,1,0,0,6,0.0,6,6,0,6,1,2,5,0,0,2017-2018,90.0,17.307692307692307,17.307692307692307
770,Valentin Eysseric,FRA,"FW,MF",Fiorentina,Serie A,25,1992,7.8,17,13,7,4,6,6,20,30.0,14,10,2,8,6,23,6,0,0,2017-2018,90.0,69.23076923076923,196.15384615384616
771,Valentin Eysseric,FRA,FW,Nice,Ligue 1,25,1992,1.0,0,0,0,0,0,0,0,0.0,0,4,0,4,1,1,0,0,0,2017-2018,90.0,90.0,0.0
772,Imoh Ezekiel,NGA,"MF,FW",Las Palmas,La Liga,23,1993,5.2,8,6,3,2,3,3,4,75.0,1,4,0,4,2,10,3,0,0,2017-2018,90.0,34.61538461538461,138.46153846153845
773,Marco Fabián,MEX,"MF,FW",Eint Frankfurt,Bundesliga,28,1989,4.7,5,3,2,3,0,3,4,75.0,1,2,0,2,3,8,1,0,0,2017-2018,90.0,57.44680851063829,95.74468085106382
774,Łukasz Fabiański,POL,GK,Swansea City,Premier League,32,1985,38.0,0,0,0,0,0,0,0,0.0,0,0,0,0,0,0,10,2,0,2017-2018,90.0,0.0,0.0
775,Fabinho,BRA,MF,Monaco,Ligue 1,23,1993,34.0,114,64,38,67,9,48,112,42.9,64,48,13,35,43,157,62,0,0,2017-2018,90.0,113.82352941176471,301.7647058823529
776,Cesc Fàbregas,ESP,MF,Chelsea,Premier League,30,1987,25.6,68,49,30,29,9,18,69,26.1,51,25,4,21,22,90,26,2,0,2017-2018,90.0,77.34375,239.0625
777,Ralf Fährmann,GER,GK,Schalke 04,Bundesliga,28,1988,33.5,1,0,1,0,0,1,3,33.3,2,1,0,1,1,2,12,7,0,2017-2018,90.0,2.6865671641791042,2.6865671641791042
778,Fayçal Fajr,MAR,"MF,FW",Getafe,La Liga,28,1988,26.5,62,45,22,34,6,17,66,25.8,49,26,4,22,30,92,42,0,0,2017-2018,90.0,101.88679245283019,210.56603773584905
779,Radamel Falcao,COL,FW,Monaco,Ligue 1,31,1986,23.7,11,6,0,8,3,2,13,15.4,11,13,3,10,10,21,11,0,0,2017-2018,90.0,37.9746835443038,41.77215189873418
780,Diego Falcinelli,ITA,FW,Fiorentina,Serie A,26,1991,4.9,1,1,1,0,0,0,5,0.0,5,5,1,4,1,2,4,0,0,2017-2018,90.0,18.36734693877551,18.36734693877551
781,Diego Falcinelli,ITA,FW,Sassuolo,Serie A,26,1991,14.6,4,4,1,2,1,1,13,7.7,12,12,2,10,2,6,9,0,0,2017-2018,90.0,12.328767123287673,24.657534246575345
782,Simon Falette,GUI,DF,Metz,Ligue 1,25,1992,1.0,0,0,0,0,0,0,0,0.0,0,0,0,0,1,1,8,0,0,2017-2018,90.0,90.0,0.0
783,Simon Falette,GUI,DF,Eint Frankfurt,Bundesliga,25,1992,24.6,34,30,23,10,1,19,31,61.3,12,37,15,22,58,92,134,1,0,2017-2018,89.99999999999999,212.19512195121948,124.39024390243901
784,Cesar Falletti,URU,"MF,FW",Bologna,Serie A,24,1992,3.6,11,7,4,6,1,4,8,50.0,4,10,0,10,0,11,5,0,0,2017-2018,90.0,0.0,275.0
785,Iago Falque,ESP,"FW,MF",Torino,Serie A,27,1990,31.3,41,31,15,20,6,6,43,14.0,37,22,0,22,15,56,15,0,0,2017-2018,90.0,43.13099041533546,117.89137380191693
786,Paolo Faragò,ITA,DF,Cagliari,Serie A,24,1993,27.3,92,67,53,24,15,24,60,40.0,36,41,5,36,23,115,76,0,0,2017-2018,90.0,75.82417582417582,303.2967032967033
787,Imad Faraj,MAR,"MF,DF",Lille,Ligue 1,18,1999,1.8,5,2,2,1,2,4,8,50.0,4,1,0,1,4,9,3,0,0,2017-2018,90.0,200.0,250.0
788,Davide Faraoni,ITA,"DF,MF",Crotone,Serie A,25,1991,19.5,62,39,36,20,6,28,47,59.6,19,30,8,22,58,120,76,0,0,2017-2018,90.0,267.6923076923077,286.15384615384613
789,Mohamed Fares,ALG,"DF,MF",Hellas Verona,Serie A,21,1996,28.9,50,33,29,17,4,16,42,38.1,26,24,5,19,50,100,132,2,0,2017-2018,90.00000000000001,155.70934256055367,155.70934256055367
790,Diego Farias,BRA,"FW,MF",Cagliari,Serie A,27,1990,17.9,21,15,3,9,9,6,24,25.0,18,17,0,17,8,29,6,0,0,2017-2018,90.0,40.22346368715084,105.58659217877096
791,Federico Fazio,ARG,DF,Roma,Serie A,30,1987,32.5,56,43,38,18,0,25,31,80.6,6,30,22,8,46,102,161,3,0,2017-2018,90.0,127.38461538461539,155.07692307692307
792,Zouhair Feddal,MAR,DF,Betis,La Liga,28,1989,14.0,22,14,14,6,2,7,12,58.3,5,17,13,4,36,58,95,2,0,2017-2018,90.0,231.42857142857142,141.42857142857142
793,Nabil Fekir,FRA,"MF,FW",Lyon,Ligue 1,24,1993,27.5,45,33,11,24,10,8,40,20.0,32,11,0,11,8,53,5,0,0,2017-2018,89.99999999999999,26.18181818181818,147.27272727272725
794,Felipe,BRA,DF,Hannover 96,Bundesliga,30,1987,5.1,8,8,4,4,0,2,4,50.0,2,4,3,1,11,19,29,0,0,2017-2018,90.0,194.11764705882354,141.1764705882353
795,Luiz Felipe,ITA,DF,Lazio,Serie A,20,1997,13.0,40,28,24,16,0,15,25,60.0,10,26,14,12,18,58,50,1,0,2017-2018,90.00000000000001,124.61538461538463,276.92307692307696
796,Ohis Felix Uduokhai,GER,DF,Wolfsburg,Bundesliga,19,1997,17.3,42,23,27,13,2,17,24,70.8,7,23,10,13,34,76,66,6,0,2017-2018,90.0,176.878612716763,218.49710982658956
797,Marouane Fellaini,BEL,MF,Manchester Utd,Premier League,29,1987,7.6,15,8,6,8,1,2,11,18.2,9,12,3,9,14,29,19,1,0,2017-2018,90.0,165.78947368421052,177.6315789473684
798,Kiko Femenía,ESP,"DF,FW",Watford,Premier League,26,1991,19.0,36,28,22,11,3,14,27,51.9,13,15,2,13,34,70,31,1,0,2017-2018,90.0,161.05263157894737,170.52631578947367
799,Leroy Fer,NED,MF,Swansea City,Premier League,27,1990,15.5,44,32,18,21,5,13,30,43.3,17,18,4,14,12,56,24,3,0,2017-2018,90.0,69.6774193548387,255.48387096774195
800,Julien Féret,FRA,MF,Caen,Ligue 1,35,1982,34.0,40,27,10,25,5,14,75,18.7,61,52,7,45,49,89,58,2,0,2017-2018,90.0,129.7058823529412,105.88235294117648
801,Edimilson Fernandes,SUI,"MF,DF",West Ham,Premier League,21,1996,9.4,17,9,10,7,0,9,21,42.9,12,13,1,12,16,33,8,0,0,2017-2018,90.0,153.1914893617021,162.7659574468085
802,Gelson Fernandes,SUI,MF,Eint Frankfurt,Bundesliga,30,1986,11.5,58,46,25,29,4,23,45,51.1,22,23,3,20,16,74,21,0,0,2017-2018,90.0,125.21739130434784,453.91304347826093
803,Andrés Fernández,ESP,GK,Villarreal,La Liga,30,1986,2.5,1,0,1,0,0,0,0,0.0,0,0,0,0,0,1,4,0,0,2017-2018,90.0,0.0,36.0
804,Augusto Fernández,ARG,MF,Atlético Madrid,La Liga,31,1986,1.2,3,2,1,2,0,1,3,33.3,2,3,2,1,2,5,3,0,0,2017-2018,90.0,150.0,225.00000000000003
805,Brian Fernández,ARG,FW,Metz,Ligue 1,22,1994,1.4,0,0,0,0,0,0,1,0.0,1,2,0,2,0,0,0,0,0,2017-2018,90.0,0.0,0.0
806,Carlos Fernández,ESP,FW,Sevilla,La Liga,21,1996,1.5,2,1,1,1,0,0,2,0.0,2,1,0,1,0,2,0,0,0,2017-2018,90.0,0.0,120.0
807,Federico Fernández,ARG,DF,Swansea City,Premier League,28,1989,29.7,40,29,30,6,4,20,30,66.7,10,35,27,8,38,78,201,1,0,2017-2018,90.0,115.15151515151514,121.2121212121212
808,Raúl Fernández,ESP,GK,Levante,La Liga,29,1988,11.0,0,0,0,0,0,0,0,0.0,0,1,0,1,0,0,10,1,0,2017-2018,90.0,0.0,0.0
809,Fernandinho,BRA,MF,Manchester City,Premier League,32,1985,32.0,62,35,22,28,12,24,65,36.9,41,38,6,32,47,109,68,2,0,2017-2018,90.0,132.1875,174.375
810,Alex Ferrari,ITA,DF,Hellas Verona,Serie A,23,1994,23.7,73,54,42,23,8,36,67,53.7,31,41,15,26,47,120,117,4,0,2017-2018,90.0,178.48101265822785,277.2151898734177
811,Jordan Ferri,FRA,MF,Lyon,Ligue 1,25,1992,7.1,20,11,8,11,1,7,20,35.0,13,11,1,10,5,25,11,2,0,2017-2018,90.0,63.38028169014085,253.5211267605634
812,Sam Field,ENG,MF,West Brom,Premier League,19,1998,6.0,14,11,8,4,2,3,10,30.0,7,6,1,5,11,25,8,0,0,2017-2018,90.0,165.0,210.0
813,Afonso Figueiredo,POR,"DF,FW",Rennes,Ligue 1,24,1993,2.5,6,3,3,3,0,3,5,60.0,2,0,0,0,0,6,4,0,0,2017-2018,90.0,0.0,216.0
814,Gian Filippo Felicioli,ITA,"MF,DF",Hellas Verona,Serie A,19,1997,3.1,13,8,5,5,3,0,4,0.0,4,0,0,0,5,18,6,0,0,2017-2018,90.0,145.16129032258064,377.4193548387097
815,Alfreð Finnbogason,ISL,FW,Augsburg,Bundesliga,28,1989,20.2,18,13,7,5,6,8,15,53.3,7,15,1,14,14,32,7,0,0,2017-2018,90.0,62.37623762376238,80.1980198019802
816,Roberto Firmino,BRA,FW,Liverpool,Premier League,25,1991,30.7,65,50,9,36,20,8,58,13.8,50,40,2,38,18,83,10,0,0,2017-2018,90.0,52.76872964169382,190.55374592833877
817,Junior Firpo,DOM,DF,Betis,La Liga,20,1996,13.2,26,17,15,8,3,10,18,55.6,8,21,2,19,20,46,37,1,0,2017-2018,90.0,136.36363636363637,177.27272727272728
818,Viktor Fischer,DEN,"FW,MF",Mainz 05,Bundesliga,23,1994,3.7,4,4,2,1,1,2,5,40.0,3,2,0,2,3,7,2,0,0,2017-2018,90.0,72.97297297297297,97.29729729729729
819,Mathieu Flamini,FRA,MF,Getafe,La Liga,33,1984,5.3,11,5,3,7,1,4,9,44.4,5,2,0,2,8,19,8,0,0,2017-2018,90.0,135.8490566037736,186.7924528301887
820,Darren Fletcher,SCO,MF,Stoke City,Premier League,33,1984,24.7,47,26,23,20,4,15,55,27.3,40,13,3,10,26,73,33,3,0,2017-2018,90.0,94.73684210526316,171.25506072874495
821,Sergio Floccari,ITA,FW,SPAL,Serie A,35,1981,9.8,13,9,7,5,1,6,11,54.5,5,6,1,5,2,15,6,0,0,2017-2018,90.0,18.36734693877551,119.38775510204081
822,Alessandro Florenzi,ITA,DF,Roma,Serie A,26,1991,26.5,38,28,20,13,5,18,47,38.3,29,19,8,11,44,82,62,1,0,2017-2018,90.0,149.43396226415095,129.0566037735849
823,Phil Foden,ENG,"MF,FW",Manchester City,Premier League,17,2000,0.5,1,1,0,1,0,0,1,0.0,1,0,0,0,0,1,1,0,0,2017-2018,90.0,0.0,180.0
824,Guessouma Fofana,MTN,MF,Amiens,Ligue 1,24,1992,8.3,20,13,8,12,0,6,13,46.2,7,7,1,6,12,32,11,0,0,2017-2018,90.0,130.12048192771084,216.86746987951804
825,Seko Fofana,CIV,MF,Udinese,Serie A,22,1995,20.8,20,17,8,12,0,4,20,20.0,16,17,3,14,27,47,26,1,0,2017-2018,90.0,116.82692307692307,86.53846153846153
826,Andreu Fontàs,ESP,DF,Celta Vigo,La Liga,27,1989,9.8,13,9,8,5,0,3,13,23.1,10,9,5,4,14,27,30,0,0,2017-2018,90.0,128.57142857142856,119.38775510204081
827,José Fonte,POR,DF,West Ham,Premier League,33,1983,7.6,11,6,5,6,0,2,6,33.3,4,12,9,3,14,25,37,1,0,2017-2018,90.0,165.78947368421052,130.26315789473685
828,Pablo Fornals,ESP,"MF,FW",Villarreal,La Liga,21,1996,29.1,52,33,19,26,7,18,60,30.0,42,29,3,26,22,74,18,0,0,2017-2018,90.0,68.04123711340206,160.82474226804123
829,Emil Forsberg,SWE,MF,RB Leipzig,Bundesliga,25,1991,15.2,24,17,3,15,6,9,21,42.9,12,19,1,18,8,32,4,0,0,2017-2018,90.0,47.368421052631575,142.10526315789474
830,Fraser Forster,ENG,GK,Southampton,Premier League,29,1988,20.0,0,0,0,0,0,0,0,0.0,0,0,0,0,0,0,7,4,0,2017-2018,90.0,0.0,0.0
831,Steven Fortes,CPV,DF,Toulouse,Ligue 1,25,1992,1.7,4,2,3,1,0,1,3,33.3,2,0,0,0,3,7,6,0,0,2017-2018,90.0,158.8235294117647,211.76470588235293
832,Marco Fossati,ITA,MF,Hellas Verona,Serie A,24,1992,12.2,27,13,11,14,2,11,33,33.3,22,19,6,13,23,50,31,1,0,2017-2018,90.0,169.672131147541,199.1803278688525
833,Iver Fossum,NOR,MF,Hannover 96,Bundesliga,21,1996,14.5,27,19,8,13,6,10,31,32.3,21,28,3,25,15,42,14,0,0,2017-2018,90.0,93.10344827586206,167.58620689655172
834,Ben Foster,ENG,GK,West Brom,Premier League,34,1983,37.0,1,0,1,0,0,0,7,0.0,7,0,0,0,1,2,12,1,0,2017-2018,90.0,2.4324324324324325,2.4324324324324325
835,Timothy Fosu-Mensah,NED,DF,Crystal Palace,Premier League,19,1998,17.7,42,33,33,8,1,21,34,61.8,13,17,9,8,31,73,74,1,0,2017-2018,90.0,157.6271186440678,213.55932203389833
836,Dimitri Foulquier,FRA,DF,Strasbourg,Ligue 1,24,1993,13.8,25,12,15,8,2,7,17,41.2,10,15,4,11,14,39,33,0,0,2017-2018,90.0,91.30434782608695,163.04347826086953
837,Lilian Fournier,FRA,FW,Metz,Ligue 1,19,1998,0.2,0,0,0,0,0,0,0,0.0,0,0,0,0,0,0,0,0,0,2017-2018,90.0,0.0,0.0
838,Raphael Framberger,GER,DF,Augsburg,Bundesliga,21,1995,7.7,22,18,14,6,2,15,16,93.8,1,12,3,9,14,36,15,0,0,2017-2018,90.0,163.63636363636365,257.14285714285717
839,Simon Francis,ENG,DF,Bournemouth,Premier League,32,1985,30.1,49,34,26,16,7,24,43,55.8,19,29,18,11,49,98,194,4,0,2017-2018,90.00000000000001,146.51162790697674,146.51162790697674
840,Mike Frantz,GER,MF,Freiburg,Bundesliga,30,1986,11.6,23,16,9,11,3,6,16,37.5,10,13,3,10,13,36,15,0,0,2017-2018,90.0,100.86206896551724,178.44827586206898
841,Ryan Fraser,SCO,"MF,DF",Bournemouth,Premier League,23,1994,22.3,11,8,7,2,2,7,20,35.0,13,20,4,16,17,28,34,0,0,2017-2018,90.0,68.60986547085201,44.39461883408072
842,Fabian Frei,SUI,MF,Mainz 05,Bundesliga,28,1989,8.9,22,15,7,12,3,8,15,53.3,7,10,0,10,16,38,17,1,0,2017-2018,90.0,161.79775280898878,222.47191011235955
843,Remo Freuler,SUI,MF,Atalanta,Serie A,25,1992,33.4,89,62,35,41,13,27,82,32.9,55,46,13,33,28,117,37,2,0,2017-2018,90.0,75.44910179640719,239.82035928143713
844,Marco Friedl,AUT,"DF,MF",Werder Bremen,Bundesliga,19,1998,6.7,9,8,4,4,1,7,10,70.0,3,10,1,9,8,17,17,1,0,2017-2018,90.0,107.46268656716417,120.89552238805969
845,Marco Friedl,AUT,MF,Bayern Munich,Bundesliga,19,1998,0.5,0,0,0,0,0,0,0,0.0,0,1,0,1,1,1,0,0,0,2017-2018,90.0,180.0,0.0
846,Christian Fuchs,AUT,DF,Leicester City,Premier League,31,1986,21.3,41,27,25,12,4,14,40,35.0,26,23,3,20,58,99,86,0,0,2017-2018,90.0,245.07042253521126,173.2394366197183
847,Javi Fuego,ESP,MF,Villarreal,La Liga,33,1984,6.0,20,13,8,11,1,7,14,50.0,7,7,4,3,3,23,14,0,0,2017-2018,90.0,45.0,300.0
848,Javi Fuego,ESP,MF,Espanyol,La Liga,33,1984,14.9,34,25,19,12,3,11,28,39.3,17,15,6,9,19,53,23,0,0,2017-2018,90.0,114.76510067114093,205.36912751677852
849,Chris Führich,GER,MF,Köln,Bundesliga,19,1998,1.1,4,3,1,2,1,2,5,40.0,3,3,0,3,0,4,1,0,0,2017-2018,90.0,0.0,327.27272727272725
850,Angelo Fulgini,FRA,MF,Angers,Ligue 1,20,1996,17.0,21,11,9,8,4,8,27,29.6,19,21,2,19,20,41,7,0,0,2017-2018,90.0,105.88235294117648,111.17647058823529
851,Niclas Füllkrug,GER,FW,Hannover 96,Bundesliga,24,1993,26.5,16,11,4,8,4,10,20,50.0,10,22,3,19,8,24,30,0,0,2017-2018,90.0,27.169811320754715,54.33962264150943
852,Jay Fulton,SCO,MF,Swansea City,Premier League,23,1994,0.2,0,0,0,0,0,0,0,0.0,0,0,0,0,0,0,1,0,0,2017-2018,90.0,0.0,0.0
853,Ramiro Funes Mori,ARG,DF,Everton,Premier League,26,1991,1.3,0,0,0,0,0,0,0,0.0,0,1,1,0,3,3,14,0,0,2017-2018,90.0,207.69230769230768,0.0
854,Manolo Gabbiadini,ITA,FW,Southampton,Premier League,25,1991,12.0,3,2,0,2,1,1,15,6.7,14,3,0,3,4,7,6,0,0,2017-2018,90.0,30.0,22.5
855,Gabi,ESP,MF,Atlético Madrid,La Liga,34,1983,26.1,80,49,39,37,4,38,104,36.5,66,28,10,18,44,124,38,0,0,2017-2018,90.0,151.72413793103448,275.8620689655172
856,Gabriel,BRA,MF,Leganés,La Liga,23,1993,26.4,90,69,28,54,8,29,74,39.2,45,38,4,34,38,128,27,0,0,2017-2018,90.0,129.54545454545453,306.8181818181818
857,Mijat Gaćinović,SRB,"MF,FW",Eint Frankfurt,Bundesliga,22,1995,20.2,56,44,21,27,8,20,52,38.5,32,38,1,37,39,95,22,1,0,2017-2018,90.0,173.76237623762376,249.5049504950495
858,Roberto Gagliardini,ITA,MF,Inter,Serie A,23,1994,22.1,63,45,28,29,6,20,54,37.0,34,18,3,15,45,108,32,2,0,2017-2018,90.0,183.2579185520362,256.56108597285066
859,Nicolás Gaitán,ARG,"MF,FW",Atlético Madrid,La Liga,29,1988,2.4,9,6,3,5,1,3,9,33.3,6,2,0,2,1,10,3,0,0,2017-2018,90.0,37.5,337.5
860,Milan Gajić,SRB,DF,Bordeaux,Ligue 1,21,1996,4.0,6,3,4,2,0,2,4,50.0,2,7,0,7,4,10,14,0,0,2017-2018,90.0,90.0,135.0
861,Serge Gakpé,TOG,"FW,MF",Amiens,Ligue 1,30,1987,20.3,16,11,9,7,0,6,27,22.2,21,18,1,17,10,26,15,0,0,2017-2018,90.0,44.33497536945813,70.935960591133
862,Andrey Galabinov,BUL,FW,Genoa,Serie A,28,1988,12.5,7,5,0,5,2,0,5,0.0,5,17,1,16,2,9,11,0,0,2017-2018,90.0,14.399999999999999,50.4
863,Álex Gálvez,ESP,DF,Las Palmas,La Liga,28,1989,18.0,50,36,26,24,0,22,41,53.7,19,20,11,9,43,93,74,2,0,2017-2018,90.0,215.0,250.0
864,Álex Gálvez,ESP,DF,Eibar,La Liga,28,1989,4.0,11,4,5,6,0,7,12,58.3,5,5,1,4,13,24,17,0,0,2017-2018,90.0,292.5,247.5
865,Bruno Gama,POR,"FW,MF",La Coruña,La Liga,29,1987,1.3,1,1,1,0,0,1,3,33.3,2,0,0,0,0,1,2,0,0,2017-2018,90.0,0.0,69.23076923076923
866,Alessandro Gamberini,ITA,DF,Chievo,Serie A,35,1981,20.2,13,8,11,2,0,8,12,66.7,4,32,25,7,16,29,117,1,0,2017-2018,90.0,71.2871287128713,57.92079207920792
867,Kévin Gameiro,FRA,FW,Atlético Madrid,La Liga,30,1987,12.5,11,9,3,4,4,1,10,10.0,9,6,0,6,4,15,11,0,0,2017-2018,90.0,28.799999999999997,79.2
868,Jesús Gámez,ESP,DF,Newcastle Utd,Premier League,32,1985,1.1,4,2,1,0,3,1,3,33.3,2,2,0,2,2,6,5,0,0,2017-2018,90.0,163.63636363636363,327.27272727272725
869,Idrissa Gana Gueye,SEN,MF,Everton,Premier League,27,1989,30.6,117,93,65,41,11,35,86,40.7,51,59,9,50,62,179,48,1,0,2017-2018,90.0,182.35294117647058,344.1176470588235
870,Ignatius Ganago,CMR,"FW,MF",Nice,Ligue 1,18,1999,0.8,0,0,0,0,0,0,2,0.0,2,1,0,1,0,0,1,0,0,2017-2018,90.0,0.0,0.0
871,Najib Gandi,FRA,"FW,MF",Nantes,Ligue 1,23,1994,1.1,6,5,3,2,1,4,6,66.7,2,4,1,3,4,10,3,0,0,2017-2018,90.0,327.27272727272725,490.9090909090909
872,Ganso,BRA,MF,Sevilla,La Liga,27,1989,5.8,15,11,3,12,0,3,11,27.3,8,7,0,7,2,17,4,0,0,2017-2018,90.0,31.03448275862069,232.75862068965517
873,Ezequiel Garay,ARG,DF,Valencia,La Liga,30,1986,22.5,18,12,15,3,0,10,14,71.4,4,22,11,11,24,42,139,0,0,2017-2018,90.0,96.0,72.0
874,Aleix García,ESP,MF,Girona,La Liga,20,1997,9.5,24,14,13,9,2,12,22,54.5,10,9,1,8,17,41,12,0,0,2017-2018,90.0,161.05263157894737,227.3684210526316
875,Borja García,ESP,MF,Girona,La Liga,26,1990,31.1,39,18,15,18,6,13,39,33.3,26,31,2,29,30,69,15,0,0,2017-2018,90.0,86.81672025723472,112.86173633440514
876,Dani García,ESP,MF,Eibar,La Liga,27,1990,30.8,80,59,23,47,10,31,80,38.8,49,28,4,24,70,150,25,0,0,2017-2018,90.0,204.54545454545456,233.76623376623377
877,David García,ESP,DF,Las Palmas,La Liga,35,1982,9.6,16,10,10,4,2,8,12,66.7,4,15,8,7,19,35,33,1,0,2017-2018,90.0,178.125,150.0
878,Javi García,ESP,"MF,DF",Betis,La Liga,30,1987,26.8,34,22,18,16,0,13,40,32.5,27,19,12,7,25,59,78,1,0,2017-2018,90.0,83.955223880597,114.17910447761193
879,Manu García,ESP,MF,Alavés,La Liga,31,1986,27.1,95,65,38,51,6,24,89,27.0,65,34,11,23,35,130,67,0,0,2017-2018,90.0,116.23616236162361,315.4981549815498
880,Raúl García,ESP,"MF,FW",Athletic Club,La Liga,31,1986,29.2,82,51,28,36,18,26,71,36.6,45,55,3,52,30,112,23,0,0,2017-2018,90.0,92.46575342465754,252.73972602739727
881,Raúl García,ESP,DF,Leganés,La Liga,28,1989,15.5,34,25,24,9,1,18,30,60.0,12,18,3,15,19,53,50,1,0,2017-2018,90.0,110.3225806451613,197.41935483870967
882,Samu García,ESP,MF,Málaga,La Liga,27,1990,2.0,8,6,4,3,1,3,10,30.0,7,4,0,4,6,14,3,0,0,2017-2018,90.0,270.0,360.0
883,Samu García,ESP,"FW,MF",Levante,La Liga,27,1990,2.1,9,7,1,6,2,2,5,40.0,3,3,0,3,1,10,2,0,0,2017-2018,90.0,42.857142857142854,385.7142857142857
884,Sergio García,ESP,"FW,MF",Espanyol,La Liga,34,1983,18.2,15,12,1,10,4,3,22,13.6,19,6,3,3,10,25,12,0,0,2017-2018,90.0,49.45054945054945,74.17582417582418
885,Ulisses Garcia,SUI,FW,Werder Bremen,Bundesliga,21,1996,1.0,1,1,1,0,0,1,2,50.0,1,0,0,0,0,1,3,0,0,2017-2018,90.0,0.0,90.0
886,Luca Garritano,ITA,"MF,FW",Chievo,Serie A,23,1994,2.1,4,3,2,1,1,0,4,0.0,4,3,1,2,1,5,6,0,0,2017-2018,90.0,42.857142857142854,171.42857142857142
887,Bruno Gaspar,ANG,DF,Fiorentina,Serie A,24,1993,8.7,20,11,13,6,1,9,15,60.0,6,8,1,7,9,29,25,0,0,2017-2018,90.0,93.10344827586206,206.89655172413794
888,Mario Gaspar,ESP,DF,Villarreal,La Liga,26,1990,31.2,110,66,63,37,10,58,87,66.7,29,58,11,47,58,168,114,0,0,2017-2018,90.0,167.3076923076923,317.3076923076923
889,Gianluca Gaudino,GER,MF,Chievo,Serie A,20,1996,0.2,0,0,0,0,0,0,0,0.0,0,1,0,1,0,0,1,0,0,2017-2018,90.0,0.0,0.0
890,Dwight Gayle,ENG,FW,Newcastle Utd,Premier League,26,1990,21.8,12,10,2,8,2,1,21,4.8,20,16,2,14,6,18,17,0,0,2017-2018,90.0,24.77064220183486,49.54128440366972
891,Paulo Gazzaniga,ARG,GK,Tottenham,Premier League,25,1992,1.0,0,0,0,0,0,0,1,0.0,1,0,0,0,0,0,0,0,0,2017-2018,90.0,0.0,0.0
892,Marcello Gazzola,ITA,DF,Sassuolo,Serie A,32,1985,8.2,10,9,3,6,1,8,12,66.7,4,10,2,8,8,18,25,0,0,2017-2018,90.0,87.8048780487805,109.75609756097562
893,Jean-Philippe Gbamin,CIV,"MF,DF",Mainz 05,Bundesliga,21,1995,28.8,78,63,48,26,4,43,65,66.2,22,50,10,40,50,128,80,0,0,2017-2018,90.0,156.25,243.75
894,David de Gea,ESP,GK,Manchester Utd,Premier League,26,1990,37.0,0,0,0,0,0,0,1,0.0,1,1,0,1,0,0,9,3,0,2017-2018,90.0,0.0,0.0
895,Theodor Gebre Selassie,CZE,"DF,FW",Werder Bremen,Bundesliga,30,1986,31.4,67,41,36,25,6,36,57,63.2,21,34,2,32,51,118,83,1,0,2017-2018,90.0,146.1783439490446,192.03821656050957
896,Dennis Geiger,GER,MF,Hoffenheim,Bundesliga,19,1998,17.6,52,36,19,31,2,16,40,40.0,24,38,2,36,15,67,7,0,0,2017-2018,90.0,76.70454545454545,265.9090909090909
897,Johannes Geis,GER,"DF,MF",Sevilla,La Liga,23,1993,7.5,20,15,12,7,1,11,21,52.4,10,13,5,8,10,30,27,1,0,2017-2018,90.0,120.0,240.0
898,Jérémy Gélin,FRA,"DF,MF",Rennes,Ligue 1,20,1997,25.7,37,18,22,14,1,20,53,37.7,33,22,12,10,37,74,92,3,0,2017-2018,90.0,129.57198443579767,129.57198443579767
899,Romain Genevois,HAI,DF,Caen,Ligue 1,29,1987,20.1,48,28,27,13,8,21,39,53.8,18,25,11,14,31,79,76,0,0,2017-2018,90.0,138.8059701492537,214.92537313432834
900,Santiago Gentiletti,ARG,DF,Genoa,Serie A,32,1985,3.2,4,3,4,0,0,1,6,16.7,5,1,0,1,3,7,11,1,0,2017-2018,90.0,84.375,112.5
901,Christian Gentner,GER,MF,Stuttgart,Bundesliga,31,1985,26.8,91,67,35,44,12,44,84,52.4,40,41,5,36,35,126,52,0,0,2017-2018,90.0,117.5373134328358,305.5970149253731
902,Yannick Gerhardt,GER,"DF,MF",Wolfsburg,Bundesliga,23,1994,13.6,37,28,18,14,5,22,34,64.7,12,25,5,20,15,52,31,0,0,2017-2018,90.0,99.26470588235294,244.85294117647058
903,Valère Germain,FRA,FW,Marseille,Ligue 1,27,1990,24.1,16,11,5,7,4,3,18,16.7,15,11,0,11,6,22,19,0,0,2017-2018,90.0,22.406639004149376,59.75103734439834
904,Gerson,BRA,"MF,FW",Roma,Serie A,20,1997,10.1,20,12,10,8,2,2,7,28.6,5,15,2,13,11,31,11,1,0,2017-2018,90.0,98.01980198019803,178.21782178217822
905,Willem Geubbels,FRA,"FW,MF",Lyon,Ligue 1,15,2001,0.4,2,2,1,1,0,0,1,0.0,1,0,0,0,0,2,0,0,0,2017-2018,90.0,0.0,450.0
906,Yassine El Ghanassy,BEL,"MF,FW",Nantes,Ligue 1,27,1990,7.2,7,4,1,3,3,1,4,25.0,3,1,0,1,4,11,4,0,0,2017-2018,90.0,50.0,87.5
907,Anwar El Ghazi,NED,"FW,MF",Lille,Ligue 1,22,1995,18.3,23,18,7,13,3,9,29,31.0,20,11,1,10,7,30,7,1,0,2017-2018,90.0,34.42622950819672,113.11475409836065
908,Rachid Ghezzal,ALG,"FW,MF",Monaco,Ligue 1,25,1992,11.2,31,24,6,22,3,7,34,20.6,27,17,0,17,11,42,2,1,0,2017-2018,90.0,88.39285714285714,249.10714285714286
909,Faouzi Ghoulam,ALG,DF,Napoli,Serie A,26,1991,10.9,8,4,3,5,0,4,6,66.7,2,10,2,8,15,23,19,0,0,2017-2018,90.0,123.8532110091743,66.05504587155963
910,Emanuele Giaccherini,ITA,"MF,FW",Chievo,Serie A,32,1985,10.0,7,4,4,2,1,5,25,20.0,20,9,3,6,5,12,6,0,0,2017-2018,90.0,45.0,63.0
911,Emanuele Giaccherini,ITA,"FW,MF",Napoli,Serie A,32,1985,0.7,1,1,0,1,0,0,0,0.0,0,0,0,0,0,1,0,0,0,2017-2018,90.0,0.0,128.57142857142858
912,Niccolò Giannetti,ITA,"FW,DF",Cagliari,Serie A,26,1991,3.3,5,4,2,3,0,2,6,33.3,4,1,0,1,1,6,3,0,0,2017-2018,90.0,27.272727272727273,136.36363636363637
913,Kieran Gibbs,ENG,DF,West Brom,Premier League,27,1989,31.4,41,24,27,10,4,16,30,53.3,14,32,12,20,48,89,102,0,0,2017-2018,90.0,137.57961783439492,117.515923566879
914,Rafał Gikiewicz,POL,GK,Freiburg,Bundesliga,29,1987,1.7,0,0,0,0,0,0,0,0.0,0,0,0,0,0,0,0,0,0,2017-2018,90.0,0.0,0.0
915,Carles Gil,ESP,"FW,MF",La Coruña,La Liga,24,1992,5.3,6,4,1,4,1,1,5,20.0,4,5,0,5,4,10,0,0,0,2017-2018,90.0,67.9245283018868,101.88679245283019
916,Nacho Gil,ESP,"FW,MF",Las Palmas,La Liga,21,1995,8.1,10,6,6,2,2,5,21,23.8,16,9,0,9,6,16,2,0,0,2017-2018,90.0,66.66666666666667,111.11111111111111
917,Nacho Gil,ESP,MF,Valencia,La Liga,21,1995,2.5,6,1,2,4,0,1,8,12.5,7,6,0,6,2,8,2,0,0,2017-2018,90.0,72.0,216.0
918,Guillaume Gillet,BEL,MF,Nantes,Ligue 1,33,1984,0.2,0,0,0,0,0,0,0,0.0,0,1,1,0,0,0,0,0,0,2017-2018,90.0,0.0,0.0
919,Dani Giménez,ESP,GK,Betis,La Liga,34,1983,3.4,0,0,0,0,0,0,0,0.0,0,0,0,0,0,0,0,0,0,2017-2018,90.0,0.0,0.0
920,Daniel Ginczek,GER,FW,Stuttgart,Bundesliga,26,1991,16.9,8,4,3,5,0,2,12,16.7,10,16,1,15,5,13,13,0,0,2017-2018,90.0,26.627218934911244,42.60355029585799
921,Matthias Ginter,GER,DF,Gladbach,Bundesliga,23,1994,34.0,48,37,27,20,1,35,45,77.8,10,40,17,23,40,88,114,1,0,2017-2018,90.0,105.88235294117648,127.05882352941177
922,Jimmy Giraudon,FRA,DF,Troyes,Ligue 1,25,1992,23.2,26,16,20,6,0,10,16,62.5,6,30,22,8,31,57,128,2,0,2017-2018,90.0,120.25862068965517,100.86206896551724
923,Thibault Giresse,FRA,"FW,MF",Guingamp,Ligue 1,36,1981,0.3,0,0,0,0,0,0,0,0.0,0,0,0,0,1,1,0,0,0,2017-2018,90.0,300.0,0.0
924,Andrei Girotto,BRA,MF,Nantes,Ligue 1,25,1992,16.9,57,38,15,37,5,21,52,40.4,31,32,7,25,15,72,45,1,0,2017-2018,90.0,79.88165680473374,303.5502958579882
925,Olivier Giroud,FRA,FW,Arsenal,Premier League,30,1986,4.3,5,4,1,2,2,1,5,20.0,4,1,0,1,1,6,4,0,0,2017-2018,90.0,20.930232558139537,104.65116279069768
926,Olivier Giroud,FRA,FW,Chelsea,Premier League,30,1986,6.8,4,3,1,2,1,1,3,33.3,2,0,0,0,1,5,5,0,0,2017-2018,90.0,13.235294117647058,52.94117647058823
927,Kamil Glik,POL,DF,Monaco,Ligue 1,29,1988,36.0,36,23,22,12,2,15,29,51.7,14,28,18,10,54,90,279,2,0,2017-2018,90.0,135.0,90.0
928,Serge Gnabry,GER,FW,Hoffenheim,Bundesliga,22,1995,16.7,32,22,10,18,4,13,24,54.2,11,15,1,14,8,40,9,2,0,2017-2018,90.0,43.11377245508982,172.4550898203593
929,Joris Gnagnon,FRA,DF,Rennes,Ligue 1,20,1997,32.4,42,29,29,9,4,21,31,67.7,10,22,16,6,29,71,154,2,0,2017-2018,90.0,80.55555555555556,116.66666666666667
930,Massimo Gobbi,ITA,DF,Chievo,Serie A,36,1980,22.8,24,18,13,9,2,11,26,42.3,15,20,5,15,22,46,90,1,0,2017-2018,90.0,86.84210526315789,94.73684210526315
931,Diego Godín,URU,DF,Atlético Madrid,La Liga,31,1986,28.4,50,33,37,11,2,26,47,55.3,21,33,20,13,59,109,145,1,0,2017-2018,90.0,186.97183098591552,158.45070422535213
932,Edoardo Goldaniga,ITA,DF,Sassuolo,Serie A,23,1993,12.8,14,8,10,4,0,5,9,55.6,4,10,5,5,19,33,56,0,0,2017-2018,90.0,133.59375,98.4375
933,Connor Goldson,ENG,DF,Brighton,Premier League,24,1992,2.2,2,2,1,1,0,1,4,25.0,3,3,3,0,1,3,9,0,0,2017-2018,90.0,40.90909090909091,81.81818181818181
934,Pierluigi Gollini,ITA,GK,Atalanta,Serie A,22,1995,6.9,0,0,0,0,0,0,0,0.0,0,0,0,0,0,0,1,0,0,2017-2018,90.0,0.0,0.0
935,André Gomes,POR,MF,Barcelona,La Liga,24,1993,7.1,19,12,8,10,1,5,13,38.5,8,7,1,6,4,23,6,0,0,2017-2018,90.0,50.70422535211268,240.84507042253523
936,Heurelho Gomes,BRA,GK,Watford,Premier League,36,1981,23.6,0,0,0,0,0,0,1,0.0,1,1,0,1,2,2,15,3,0,2017-2018,90.0,7.627118644067796,0.0
937,Ibai Gómez,ESP,"MF,FW",Alavés,La Liga,27,1989,25.8,19,15,11,4,4,6,30,20.0,24,16,1,15,15,34,20,1,0,2017-2018,90.0,52.325581395348834,66.27906976744185
938,Joe Gomez,ENG,DF,Liverpool,Premier League,20,1997,21.1,58,45,32,23,3,21,40,52.5,19,19,8,11,34,92,57,1,0,2017-2018,90.0,145.02369668246445,247.39336492890993
939,Mario Gómez,GER,FW,Wolfsburg,Bundesliga,32,1985,10.4,6,6,2,3,1,2,6,33.3,4,10,1,9,0,6,16,0,0,2017-2018,90.0,0.0,51.92307692307692
940,Mario Gómez,GER,FW,Stuttgart,Bundesliga,32,1985,15.4,13,11,0,8,5,2,10,20.0,8,6,0,6,4,17,17,0,0,2017-2018,90.0,23.376623376623378,75.97402597402598
941,Maxi Gómez,URU,FW,Celta Vigo,La Liga,20,1996,34.1,7,4,1,4,2,0,18,0.0,18,9,4,5,3,10,34,0,0,2017-2018,90.0,7.9178885630498534,18.475073313782993
942,Papu Gómez,ARG,"MF,FW",Atalanta,Serie A,29,1988,30.6,14,9,6,5,3,5,26,19.2,21,16,1,15,22,36,7,0,0,2017-2018,90.0,64.70588235294117,41.17647058823529
943,Sergi Gómez,ESP,DF,Celta Vigo,La Liga,25,1992,29.8,52,37,38,13,1,20,34,58.8,14,32,22,10,56,108,118,1,0,2017-2018,90.0,169.12751677852347,157.0469798657718
944,Sergio Gómez,ESP,MF,Dortmund,Bundesliga,16,2000,0.1,0,0,0,0,0,0,0,0.0,0,0,0,0,0,0,0,0,0,2017-2018,90.0,0.0,0.0
945,Vicente Gómez,ESP,MF,Las Palmas,La Liga,28,1988,16.9,21,13,6,11,4,10,29,34.5,19,18,4,14,17,38,14,1,0,2017-2018,90.0,90.53254437869823,111.83431952662723
946,Alfred Gomis,SEN,GK,SPAL,Serie A,23,1993,25.1,0,0,0,0,0,0,1,0.0,1,0,0,0,1,1,10,3,0,2017-2018,90.0,3.585657370517928,0.0
947,Maxime Gonalons,FRA,MF,Roma,Serie A,28,1989,12.2,26,18,7,12,7,9,23,39.1,14,15,4,11,23,49,19,1,0,2017-2018,90.0,169.672131147541,191.8032786885246
948,Anthony Gonçalves,FRA,"MF,FW",Strasbourg,Ligue 1,31,1986,19.5,50,31,14,32,4,15,50,30.0,35,27,0,27,25,75,27,0,0,2017-2018,90.0,115.38461538461539,230.76923076923077
949,Vagner Gonçalves,CPV,FW,Saint-Étienne,Ligue 1,21,1996,1.2,0,0,0,0,0,0,3,0.0,3,2,0,2,0,0,0,0,0,2017-2018,90.0,0.0,0.0
950,Jérôme Gondorf,GER,"MF,FW",Werder Bremen,Bundesliga,29,1988,8.9,12,9,3,9,0,4,18,22.2,14,11,2,9,6,18,12,0,0,2017-2018,90.0,60.67415730337079,121.34831460674158
951,Adrián González,ESP,"MF,FW",Málaga,La Liga,29,1988,26.0,40,25,14,22,4,12,50,24.0,38,25,8,17,38,78,34,0,0,2017-2018,90.00000000000001,131.53846153846155,138.46153846153848
952,Álvaro González,ESP,DF,Villarreal,La Liga,27,1990,32.2,38,26,30,7,1,22,41,53.7,19,34,23,11,53,91,188,0,0,2017-2018,90.0,148.1366459627329,106.21118012422359
953,Bruno González,ESP,DF,Getafe,La Liga,27,1990,17.1,25,18,18,7,0,13,26,50.0,13,11,3,8,31,56,107,0,0,2017-2018,90.0,163.1578947368421,131.57894736842104
954,Diego González,ESP,DF,Málaga,La Liga,22,1995,15.9,27,19,20,7,0,18,26,69.2,8,25,10,15,19,46,69,0,0,2017-2018,90.0,107.54716981132076,152.83018867924528
955,Fabio González,ESP,MF,Las Palmas,La Liga,20,1997,0.7,2,1,2,0,0,1,4,25.0,3,1,0,1,1,3,1,0,0,2017-2018,90.0,128.57142857142858,257.14285714285717
956,Giancarlo González,CRC,DF,Bologna,Serie A,29,1988,20.6,20,15,14,5,1,9,13,69.2,4,26,18,8,33,53,152,1,0,2017-2018,90.0,144.17475728155338,87.37864077669903
957,Mario González,ESP,FW,Villarreal,La Liga,21,1996,0.2,0,0,0,0,0,0,0,0.0,0,1,0,1,0,0,0,0,0,2017-2018,90.0,0.0,0.0
958,Georges Gope-Fenepej,NCL,FW,Amiens,Ligue 1,28,1988,0.5,0,0,0,0,0,0,0,0.0,0,0,0,0,0,0,0,0,0,2017-2018,90.0,0.0,0.0
959,Leon Goretzka,GER,MF,Schalke 04,Bundesliga,22,1995,22.0,50,34,22,22,6,14,50,28.0,36,45,4,41,41,91,35,0,0,2017-2018,90.0,167.72727272727272,204.54545454545456
960,Mathieu Gorgelin,FRA,GK,Lyon,Ligue 1,26,1990,4.0,0,0,0,0,0,0,0,0.0,0,0,0,0,0,0,0,1,0,2017-2018,90.0,0.0,0.0
961,Andoni Gorosabel,ESP,DF,Real Sociedad,La Liga,20,1996,0.8,3,2,1,2,0,2,5,40.0,3,1,0,1,4,7,1,0,0,2017-2018,90.0,450.0,337.5
962,Robin Gosens,GER,DF,Atalanta,Serie A,23,1994,16.1,61,46,35,22,4,27,46,58.7,19,17,2,15,22,83,40,0,0,2017-2018,90.0,122.98136645962732,340.99378881987576
963,Dan Gosling,ENG,MF,Bournemouth,Premier League,27,1990,21.6,50,25,19,26,5,19,68,27.9,49,36,8,28,25,75,35,0,0,2017-2018,90.0,104.16666666666666,208.33333333333331
964,Mario Götze,GER,MF,Dortmund,Bundesliga,25,1992,17.8,50,43,19,24,7,14,34,41.2,20,17,1,16,8,58,9,0,0,2017-2018,90.0,40.449438202247194,252.80898876404495
965,Mohamed Gouaida,TUN,MF,Hamburger SV,Bundesliga,24,1993,0.6,3,3,1,1,1,0,0,0.0,0,0,0,0,0,3,3,0,0,2017-2018,90.0,0.0,450.00000000000006
966,Prince-Désir Gouano,FRA,DF,Amiens,Ligue 1,23,1993,30.5,42,29,32,8,2,22,31,71.0,9,58,47,11,49,91,191,6,0,2017-2018,90.0,144.59016393442622,123.93442622950819
967,Lemouya Goudiaby,SEN,DF,Metz,Ligue 1,20,1997,0.9,2,1,0,2,0,1,3,33.3,2,2,1,1,0,2,3,0,0,2017-2018,90.0,0.0,200.0
968,Amine Gouiri,ALG,"FW,MF",Lyon,Ligue 1,17,2000,0.9,1,1,1,0,0,0,1,0.0,1,0,0,0,2,3,0,0,0,2017-2018,90.0,200.0,100.0
969,Yoann Gourcuff,FRA,"MF,FW",Rennes,Ligue 1,31,1986,4.7,7,5,1,3,3,0,2,0.0,2,5,0,5,2,9,2,0,0,2017-2018,90.0,38.29787234042553,134.04255319148936
970,Jeffrey Gouweleeuw,NED,DF,Augsburg,Bundesliga,26,1991,26.5,57,44,36,18,3,27,41,65.9,14,36,10,26,54,111,128,0,0,2017-2018,90.0,183.39622641509433,193.58490566037736
971,Julio Gracia,ESP,"DF,FW",Betis,La Liga,19,1998,0.3,0,0,0,0,0,0,0,0.0,0,0,0,0,1,1,0,0,0,2017-2018,90.0,300.0,0.0
972,Max Gradel,CIV,"FW,MF",Toulouse,Ligue 1,29,1987,26.8,63,36,28,21,14,24,72,33.3,48,39,2,37,14,77,30,0,0,2017-2018,90.0,47.014925373134325,211.56716417910445
973,Samuel Grandsir,FRA,"FW,MF",Troyes,Ligue 1,20,1996,28.9,69,43,39,18,12,21,73,28.8,52,31,3,28,23,92,19,1,0,2017-2018,90.00000000000001,71.62629757785469,214.87889273356404
974,Álex Granell,ESP,MF,Girona,La Liga,28,1988,31.6,78,53,31,39,8,38,114,33.3,76,46,3,43,47,125,29,0,0,2017-2018,90.0,133.86075949367088,222.1518987341772
975,Esteban Granero,ESP,MF,Espanyol,La Liga,30,1987,13.7,32,22,15,13,4,9,27,33.3,18,19,0,19,19,51,21,0,0,2017-2018,90.0,124.8175182481752,210.2189781021898
976,Lee Grant,ENG,GK,Stoke City,Premier League,34,1983,3.0,1,1,1,0,0,1,1,100.0,0,0,0,0,0,1,0,0,0,2017-2018,90.0,0.0,30.0
977,Alberto Grassi,ITA,MF,SPAL,Serie A,22,1995,25.0,44,33,22,12,10,16,35,45.7,19,27,8,19,47,91,55,0,0,2017-2018,90.0,169.2,158.4
978,Andrew Gravillon,GLP,DF,Benevento,Serie A,19,1998,0.9,2,1,2,0,0,0,1,0.0,1,1,1,0,3,5,10,0,0,2017-2018,90.0,300.0,200.0
979,Andre Gray,JAM,FW,Watford,Premier League,26,1991,16.6,2,1,0,1,1,0,3,0.0,3,11,0,11,4,6,3,0,0,2017-2018,90.0,21.686746987951803,10.843373493975902
980,Demarai Gray,JAM,"MF,FW",Leicester City,Premier League,21,1996,18.9,17,15,6,9,2,4,23,17.4,19,27,0,27,11,28,14,1,0,2017-2018,90.0,52.38095238095238,80.95238095238095
981,Michael Gregoritsch,AUT,"MF,FW",Augsburg,Bundesliga,23,1994,28.1,35,27,13,15,7,11,26,42.3,15,27,1,26,10,45,56,0,0,2017-2018,90.0,32.02846975088968,112.09964412811388
982,Clément Grenier,FRA,MF,Guingamp,Ligue 1,26,1991,13.4,23,14,3,13,7,12,42,28.6,30,16,1,15,14,37,15,1,0,2017-2018,90.0,94.02985074626865,154.4776119402985
983,Clément Grenier,FRA,FW,Lyon,Ligue 1,26,1991,0.1,1,1,1,0,0,0,0,0.0,0,0,0,0,0,1,0,0,0,2017-2018,90.0,0.0,900.0
984,Anto Grgić,SUI,MF,Stuttgart,Bundesliga,20,1996,0.1,0,0,0,0,0,0,0,0.0,0,0,0,0,0,0,0,0,0,2017-2018,90.0,0.0,0.0
985,Antoine Griezmann,FRA,"FW,MF",Atlético Madrid,La Liga,26,1991,28.0,36,24,6,23,7,10,30,33.3,20,20,1,19,10,46,14,0,0,2017-2018,90.0,32.14285714285714,115.71428571428571
986,Vincenzo Grifo,ITA,"MF,FW",Gladbach,Bundesliga,24,1993,8.7,8,5,3,3,2,4,8,50.0,4,8,1,7,5,13,6,0,0,2017-2018,90.0,51.724137931034484,82.75862068965517
987,Florian Grillitsch,AUT,MF,Hoffenheim,Bundesliga,21,1995,21.0,68,46,30,36,2,35,58,60.3,23,26,3,23,39,107,25,1,0,2017-2018,90.0,167.14285714285714,291.42857142857144
988,Jérémy Grimm,FRA,MF,Strasbourg,Ligue 1,30,1987,9.0,23,17,15,6,2,9,24,37.5,15,11,3,8,19,42,31,1,0,2017-2018,90.0,190.0,230.0
989,Pascal Groß,GER,"FW,MF",Brighton,Premier League,26,1991,32.5,36,24,18,16,2,10,67,14.9,57,31,5,26,14,50,20,0,0,2017-2018,90.0,38.76923076923077,99.6923076923077
990,Marko Grujić,SRB,"MF,DF",Liverpool,Premier League,21,1996,0.2,2,2,0,1,1,2,2,100.0,0,0,0,0,0,2,0,0,0,2017-2018,90.0,0.0,900.0
991,Vicente Guaita,ESP,GK,Getafe,La Liga,30,1987,33.0,0,0,0,0,0,0,0,0.0,0,0,0,0,3,3,12,1,0,2017-2018,90.0,8.181818181818182,0.0
992,Andrés Guardado,MEX,MF,Betis,La Liga,30,1986,25.2,41,27,17,18,6,15,55,27.3,40,27,5,22,22,63,29,1,0,2017-2018,90.0,78.57142857142858,146.42857142857144
993,Karim Guédé,SVK,FW,Freiburg,Bundesliga,32,1985,0.7,2,2,2,0,0,2,2,100.0,0,1,1,0,1,3,0,0,0,2017-2018,90.0,128.57142857142858,257.14285714285717
994,Gonçalo Guedes,POR,MF,Valencia,La Liga,20,1996,27.1,38,26,18,15,5,16,51,31.4,35,22,0,22,16,54,10,0,0,2017-2018,90.0,53.13653136531365,126.19926199261992
995,Gonçalo Guedes,POR,FW,Paris S-G,Ligue 1,20,1996,0.1,0,0,0,0,0,0,0,0.0,0,0,0,0,0,0,0,0,0,2017-2018,90.0,0.0,0.0
996,Ramiro Guerra,URU,MF,Villarreal,La Liga,20,1997,0.8,3,2,1,0,2,2,3,66.7,1,0,0,0,0,3,2,0,0,2017-2018,90.0,0.0,337.5
997,Raphaël Guerreiro,POR,"DF,MF",Dortmund,Bundesliga,23,1993,6.1,10,8,5,4,1,2,5,40.0,3,3,0,3,11,21,8,0,0,2017-2018,90.0,162.29508196721312,147.5409836065574
998,Francis Guerrero,ESP,"DF,MF",Betis,La Liga,21,1996,11.0,31,19,22,7,2,16,34,47.1,18,16,4,12,21,52,26,0,0,2017-2018,90.0,171.8181818181818,253.63636363636365
999,John Guidetti,SWE,FW,Alavés,La Liga,25,1992,13.6,7,7,3,1,3,2,10,20.0,8,10,1,9,2,9,7,0,0,2017-2018,90.0,13.235294117647058,46.3235294117647
1000,John Guidetti,SWE,"FW,MF",Celta Vigo,La Liga,25,1992,1.3,0,0,0,0,0,0,0,0.0,0,0,0,0,0,0,0,0,0,2017-2018,90.0,0.0,0.0
1001,Josuha Guilavogui,FRA,MF,Wolfsburg,Bundesliga,26,1990,26.7,65,46,43,20,2,30,50,60.0,20,34,10,24,66,131,63,0,0,2017-2018,90.00000000000001,222.47191011235958,219.10112359550564
1002,Frederic Guilbert,FRA,DF,Caen,Ligue 1,22,1994,36.0,136,89,71,58,7,50,105,47.6,55,43,13,30,88,224,136,0,0,2017-2018,90.0,220.0,340.0
1003,Guilherme,BRA,"MF,FW",Benevento,Serie A,26,1991,10.5,20,11,7,7,6,3,19,15.8,16,14,1,13,8,28,4,0,0,2017-2018,90.0,68.57142857142857,171.42857142857142
1004,Guilherme,BRA,MF,La Coruña,La Liga,26,1991,29.3,79,56,35,37,7,28,77,36.4,49,36,9,27,46,125,62,0,0,2017-2018,90.0,141.29692832764505,242.66211604095565
1005,Baptiste Guillaume,BEL,"FW,MF",Angers,Ligue 1,22,1995,5.1,4,1,0,2,2,0,5,0.0,5,4,1,3,2,6,1,0,0,2017-2018,90.0,35.294117647058826,70.58823529411765
1006,Serhou Guirassy,GUI,FW,Köln,Bundesliga,21,1996,9.5,3,3,0,2,1,1,5,20.0,4,9,1,8,1,4,11,0,0,2017-2018,90.0,9.473684210526315,28.42105263157895
1007,Péter Gulácsi,HUN,GK,RB Leipzig,Bundesliga,27,1990,33.0,0,0,0,0,0,0,2,0.0,2,0,0,0,0,0,12,4,0,2017-2018,90.0,0.0,0.0
1008,Manuel Gulde,GER,DF,Freiburg,Bundesliga,26,1991,17.0,16,10,14,2,0,10,19,52.6,9,24,17,7,14,30,71,0,0,2017-2018,90.0,74.11764705882354,84.70588235294117
1009,Gerard Gumbau,ESP,MF,Leganés,La Liga,22,1994,15.9,35,26,13,21,1,12,37,32.4,25,12,4,8,14,49,27,0,0,2017-2018,90.0,79.24528301886792,198.11320754716982
1010,İlkay Gündoğan,GER,MF,Manchester City,Premier League,26,1990,16.9,27,15,8,14,5,9,37,24.3,28,14,1,13,16,43,12,0,0,2017-2018,90.0,85.20710059171599,143.78698224852073
1011,Christian Günter,GER,"DF,MF",Freiburg,Bundesliga,24,1993,34.0,73,54,45,21,7,38,63,60.3,25,38,7,31,20,93,68,0,0,2017-2018,90.0,52.94117647058824,193.23529411764707
1012,Jon Guridi,ESP,MF,Real Sociedad,La Liga,22,1995,0.6,1,0,1,0,0,0,1,0.0,1,1,0,1,0,1,0,0,0,2017-2018,90.0,0.0,150.0
1013,Régis Gurtner,FRA,GK,Amiens,Ligue 1,30,1986,37.0,1,0,1,0,0,1,1,100.0,0,0,0,0,4,5,15,4,0,2017-2018,90.0,9.72972972972973,2.4324324324324325
1014,Samuel Gustafson,SWE,"MF,FW",Torino,Serie A,22,1995,0.9,3,2,3,0,0,1,3,33.3,2,2,0,2,0,3,0,0,0,2017-2018,90.0,0.0,300.0
1015,Luiz Gustavo,BRA,"MF,DF",Marseille,Ligue 1,30,1987,33.5,89,54,45,40,4,26,62,41.9,36,44,13,31,50,139,56,1,0,2017-2018,90.0,134.32835820895522,239.1044776119403
1016,Alejandro Gutiérrez Mozo,ESP,MF,Leganés,La Liga,22,1995,0.5,3,2,1,2,0,1,4,25.0,3,0,0,0,0,3,0,0,0,2017-2018,90.0,0.0,540.0
1017,Jonathan de Guzmán,NED,MF,Eint Frankfurt,Bundesliga,29,1987,12.1,16,16,8,8,0,6,16,37.5,10,13,0,13,13,29,12,0,0,2017-2018,90.0,96.69421487603306,119.00826446280992
1018,Bright Gyamfi,GHA,DF,Benevento,Serie A,21,1996,3.6,2,2,1,1,0,1,2,50.0,1,3,1,2,7,9,8,0,0,2017-2018,90.0,175.0,50.0
1019,Nicolas Haas,SUI,MF,Atalanta,Serie A,21,1996,1.9,1,1,1,0,0,0,2,0.0,2,1,1,0,1,2,4,1,0,2017-2018,90.0,47.368421052631575,47.368421052631575
1020,Janik Haberer,GER,"MF,FW",Freiburg,Bundesliga,23,1994,30.5,62,49,20,34,8,23,57,40.4,34,43,1,42,30,92,42,0,0,2017-2018,90.0,88.52459016393442,182.95081967213113
1021,Hacen,MTN,"FW,MF",Levante,La Liga,19,1997,0.9,0,0,0,0,0,0,0,0.0,0,4,2,2,1,1,0,0,0,2017-2018,90.0,100.0,0.0
1022,Alexander Hack,GER,DF,Mainz 05,Bundesliga,23,1993,14.3,46,34,25,19,2,24,37,64.9,13,31,18,13,26,72,87,2,0,2017-2018,90.0,163.63636363636365,289.5104895104895
1023,Robin Hack,GER,"FW,MF",Hoffenheim,Bundesliga,18,1998,0.8,2,2,1,0,1,0,1,0.0,1,1,1,0,0,2,1,0,0,2017-2018,90.0,0.0,225.0
1024,Munir El Haddadi,MAR,FW,Alavés,La Liga,21,1995,27.2,25,20,8,9,8,5,14,35.7,9,13,2,11,9,34,5,0,0,2017-2018,90.0,29.77941176470588,82.72058823529412
1025,Oussama Haddadi,TUN,DF,Dijon,Ligue 1,25,1992,27.8,44,29,33,9,2,14,47,29.8,33,29,12,17,43,87,79,1,0,2017-2018,90.0,139.20863309352518,142.44604316546764
1026,Florent Hadergjonaj,KVX,"DF,MF",Huddersfield,Premier League,23,1994,18.6,21,16,7,10,4,12,30,40.0,18,22,10,12,17,38,45,0,0,2017-2018,90.0,82.25806451612902,101.61290322580643
1027,André Hahn,GER,FW,Hamburger SV,Bundesliga,26,1990,15.1,33,24,15,13,5,10,32,31.3,22,30,2,28,10,43,26,0,0,2017-2018,90.0,59.60264900662252,196.6887417218543
1028,Massadio Haïdara,MLI,FW,Newcastle Utd,Premier League,24,1992,0.0,0,0,0,0,0,0,0,0.0,0,0,0,0,0,0,0,0,0,2017-2018,,,
1029,Oualid El Hajjam,MAR,DF,Amiens,Ligue 1,26,1991,24.4,64,44,37,22,5,23,49,46.9,26,25,5,20,59,123,91,1,0,2017-2018,90.0,217.62295081967216,236.06557377049182
1030,Izet Hajrović,BIH,"MF,FW",Werder Bremen,Bundesliga,25,1991,2.1,1,0,1,0,0,0,1,0.0,1,0,0,0,2,3,1,0,0,2017-2018,90.0,85.71428571428571,42.857142857142854
1031,Achraf Hakimi,MAR,DF,Real Madrid,La Liga,18,1998,8.4,21,15,9,6,6,11,25,44.0,14,9,1,8,10,31,19,1,0,2017-2018,90.0,107.14285714285714,225.0
1032,Alen Halilović,CRO,"FW,MF",Las Palmas,La Liga,21,1996,14.5,11,7,5,6,0,4,17,23.5,13,10,1,9,5,16,4,0,0,2017-2018,90.0,31.034482758620687,68.27586206896551
1033,Sébastien Haller,CIV,FW,Eint Frankfurt,Bundesliga,23,1994,26.1,25,16,4,16,5,7,14,50.0,7,17,4,13,8,33,39,0,0,2017-2018,90.0,27.586206896551722,86.20689655172413
1034,Emil Hallfreðsson,ISL,MF,Udinese,Serie A,33,1984,8.5,19,14,9,7,3,7,24,29.2,17,13,2,11,20,39,16,0,0,2017-2018,90.0,211.76470588235296,201.1764705882353
1035,Marcel Halstenberg,GER,DF,RB Leipzig,Bundesliga,25,1991,13.1,29,19,16,9,4,15,19,78.9,4,15,1,14,23,52,42,1,0,2017-2018,90.0,158.01526717557252,199.23664122137404
1036,Ben Hamer,ENG,GK,Leicester City,Premier League,29,1987,3.1,0,0,0,0,0,0,1,0.0,1,0,0,0,0,0,3,1,0,2017-2018,90.0,0.0,0.0
1037,Romain Hamouma,FRA,FW,Saint-Étienne,Ligue 1,30,1987,20.5,19,13,7,6,6,1,22,4.5,21,15,4,11,13,32,8,1,0,2017-2018,90.0,57.07317073170732,83.41463414634147
1038,Marek Hamšík,SVK,MF,Napoli,Serie A,30,1987,26.3,36,22,10,15,11,15,37,40.5,22,35,2,33,14,50,16,0,0,2017-2018,90.0,47.90874524714829,123.19391634980988
1039,Samir Handanović,SVN,GK,Inter,Serie A,33,1984,38.0,0,0,0,0,0,0,0,0.0,0,1,0,1,0,0,7,1,0,2017-2018,90.0,0.0,0.0
1040,Tim Handwerker,GER,"MF,DF",Köln,Bundesliga,19,1998,4.4,12,7,9,2,1,5,7,71.4,2,3,0,3,6,18,10,0,0,2017-2018,90.0,122.72727272727272,245.45454545454544
1041,Genki Haraguchi,JPN,FW,Hertha BSC,Bundesliga,26,1991,2.3,6,6,2,3,1,2,6,33.3,4,4,0,4,2,8,3,0,0,2017-2018,90.0,78.26086956521739,234.7826086956522
1042,Amine Harit,MAR,"MF,FW",Schalke 04,Bundesliga,20,1997,22.7,39,27,11,21,7,13,37,35.1,24,23,0,23,19,58,11,0,0,2017-2018,89.99999999999999,75.33039647577093,154.62555066079295
1043,Martin Harnik,AUT,"FW,MF",Hannover 96,Bundesliga,30,1987,21.0,17,10,4,10,3,4,25,16.0,21,21,2,19,8,25,26,0,0,2017-2018,90.0,34.285714285714285,72.85714285714286
1044,Rekeem Harper,ENG,MF,West Brom,Premier League,17,2000,0.2,1,1,0,1,0,0,0,0.0,0,0,0,0,0,1,0,0,0,2017-2018,90.0,0.0,450.0
1045,Joe Hart,ENG,GK,West Ham,Premier League,30,1987,19.0,1,1,1,0,0,1,2,50.0,1,1,0,1,0,1,2,4,0,2017-2018,90.0,0.0,4.7368421052631575
1046,Makoto Hasebe,JPN,"DF,MF",Eint Frankfurt,Bundesliga,33,1984,23.2,38,23,19,19,0,21,33,63.6,12,40,19,21,25,63,74,0,0,2017-2018,90.0,96.98275862068965,147.41379310344828
1047,Hans Hateboer,NED,DF,Atalanta,Serie A,23,1994,26.6,31,25,13,13,5,15,26,57.7,11,32,5,27,30,61,46,1,0,2017-2018,90.0,101.50375939849623,104.88721804511277
1048,Kai Havertz,GER,"MF,FW",Leverkusen,Bundesliga,18,1999,23.8,34,23,8,23,3,12,25,48.0,13,33,2,31,19,53,23,0,0,2017-2018,90.00000000000001,71.84873949579833,128.57142857142858
1049,Isaac Hayden,ENG,MF,Newcastle Utd,Premier League,22,1995,15.3,40,23,23,16,1,12,34,35.3,22,21,6,15,23,63,43,0,0,2017-2018,90.0,135.2941176470588,235.2941176470588
1050,Eden Hazard,BEL,"FW,MF",Chelsea,Premier League,26,1991,26.9,6,3,2,3,1,3,21,14.3,18,11,0,11,3,9,0,0,0,2017-2018,90.0,10.037174721189592,20.074349442379184
1051,Thorgan Hazard,BEL,"MF,FW",Gladbach,Bundesliga,24,1993,32.7,49,32,16,23,10,20,54,37.0,34,39,1,38,28,77,18,0,0,2017-2018,90.0,77.06422018348624,134.8623853211009
1052,Tom Heaton,ENG,GK,Burnley,Premier League,31,1986,3.4,0,0,0,0,0,0,0,0.0,0,0,0,0,0,0,0,0,0,2017-2018,90.0,0.0,0.0
1053,Jonas Hector,GER,"DF,MF",Köln,Bundesliga,27,1990,19.5,47,35,23,18,6,18,40,45.0,22,39,6,33,28,75,65,2,0,2017-2018,90.0,129.23076923076923,216.9230769230769
1054,Michael Hefele,GER,DF,Huddersfield,Premier League,26,1990,0.4,0,0,0,0,0,0,0,0.0,0,0,0,0,1,1,5,0,0,2017-2018,90.0,225.0,0.0
1055,Ahmed Hegazi,EGY,DF,West Brom,Premier League,26,1991,37.6,58,38,46,12,0,26,50,52.0,24,55,37,18,60,118,278,2,0,2017-2018,90.0,143.61702127659572,138.82978723404256
1056,Gauthier Hein,FRA,FW,Metz,Ligue 1,20,1996,0.9,2,2,2,0,0,2,4,50.0,2,1,0,1,2,4,1,0,0,2017-2018,90.0,200.0,200.0
1057,Dominique Heintz,GER,DF,Köln,Bundesliga,23,1993,31.0,60,42,47,13,0,38,64,59.4,26,35,17,18,53,113,140,0,0,2017-2018,90.0,153.8709677419355,174.19354838709677
1058,Filip Helander,SWE,DF,Bologna,Serie A,24,1993,27.8,48,32,33,15,0,15,29,51.7,14,47,25,22,37,85,160,2,0,2017-2018,90.0,119.78417266187051,155.3956834532374
1059,Marcel Heller,GER,"FW,MF",Augsburg,Bundesliga,31,1986,14.4,37,24,21,14,2,12,28,42.9,16,22,1,21,10,47,7,0,0,2017-2018,90.0,62.5,231.25
1060,Tomer Hemed,ISR,FW,Brighton,Premier League,30,1987,9.4,7,5,3,4,0,2,10,20.0,8,10,1,9,2,9,12,0,0,2017-2018,90.0,19.148936170212764,67.02127659574468
1061,Jordan Henderson,ENG,MF,Liverpool,Premier League,27,1990,24.1,51,33,13,32,6,18,52,34.6,34,33,2,31,31,82,27,0,0,2017-2018,90.0,115.76763485477179,190.4564315352697
1062,Jeff Hendrick,IRL,"FW,MF",Burnley,Premier League,25,1992,25.9,16,10,4,10,2,3,17,17.6,14,11,2,9,8,24,21,1,0,2017-2018,90.0,27.799227799227804,55.59845559845561
1063,Wayne Hennessey,WAL,GK,Crystal Palace,Premier League,30,1987,27.0,0,0,0,0,0,0,0,0.0,0,1,0,1,2,2,5,1,0,2017-2018,90.0,6.666666666666667,0.0
1064,Benjamin Henrichs,GER,DF,Leverkusen,Bundesliga,20,1997,14.1,42,28,23,16,3,27,43,62.8,16,23,3,20,31,73,32,0,0,2017-2018,89.99999999999999,197.87234042553192,268.0851063829787
1065,Dalbert Henrique,BRA,DF,Inter,Serie A,23,1993,5.9,15,10,11,3,1,7,13,53.8,6,7,4,3,13,28,19,0,0,2017-2018,90.0,198.30508474576268,228.81355932203388
1066,Christophe Hérelle,MTQ,DF,Troyes,Ligue 1,24,1992,32.9,39,26,27,12,0,16,30,53.3,14,38,27,11,56,95,241,1,0,2017-2018,90.0,153.19148936170214,106.68693009118542
1067,Mario Hermoso,ESP,DF,Espanyol,La Liga,22,1995,21.4,14,12,13,1,0,8,21,38.1,13,15,8,7,25,39,122,0,0,2017-2018,90.0,105.14018691588787,58.8785046728972
1068,Hernán,ESP,MF,Las Palmas,La Liga,26,1990,3.9,18,9,8,7,3,10,17,58.8,7,2,0,2,8,26,5,0,0,2017-2018,90.0,184.6153846153846,415.38461538461536
1069,Héctor Hernández,ESP,DF,Alavés,La Liga,26,1991,0.2,1,1,0,1,0,1,1,100.0,0,0,0,0,0,1,1,0,0,2017-2018,90.0,0.0,450.0
1070,Javier Hernández,MEX,FW,West Ham,Premier League,29,1988,17.2,11,7,2,7,2,3,14,21.4,11,6,1,5,6,17,1,0,0,2017-2018,90.0,31.395348837209305,57.55813953488373
1071,Lucas Hernández,FRA,DF,Atlético Madrid,La Liga,21,1996,23.5,93,68,51,35,7,55,74,74.3,19,35,10,25,40,133,90,0,0,2017-2018,90.0,153.1914893617021,356.17021276595744
1072,Luis Hernández,ESP,DF,Málaga,La Liga,28,1989,36.0,49,43,37,9,3,17,33,51.5,16,32,21,11,77,126,185,1,0,2017-2018,90.0,192.5,122.5
1073,Pablo Hernández,CHI,MF,Celta Vigo,La Liga,30,1986,20.2,48,33,17,27,4,14,46,30.4,32,29,11,18,40,88,72,0,0,2017-2018,90.0,178.21782178217822,213.86138613861385
1074,Theo Hernández,FRA,DF,Real Madrid,La Liga,19,1997,10.7,21,15,16,2,3,13,25,52.0,12,9,2,7,17,38,20,0,0,2017-2018,90.0,142.99065420560748,176.6355140186916
1075,Hernani,BRA,"MF,FW",Saint-Étienne,Ligue 1,23,1994,6.0,21,13,9,9,3,10,22,45.5,12,15,2,13,6,27,5,0,0,2017-2018,90.0,90.0,315.0
1076,Ander Herrera,ESP,MF,Manchester Utd,Premier League,27,1989,14.1,56,29,32,20,4,20,69,29.0,49,33,6,27,34,90,22,2,0,2017-2018,89.99999999999999,217.02127659574467,357.4468085106383
1077,Borja Herrera,ESP,DF,Las Palmas,La Liga,24,1993,2.7,2,1,2,0,0,2,7,28.6,5,6,1,5,3,5,4,0,0,2017-2018,90.0,99.99999999999999,66.66666666666666
1078,Iago Herrerín,ESP,GK,Athletic Club,La Liga,29,1988,8.0,2,1,2,0,0,2,2,100.0,0,0,0,0,0,2,7,1,0,2017-2018,90.0,0.0,22.5
1079,Patrick Herrmann,GER,"MF,FW",Gladbach,Bundesliga,26,1991,12.5,29,21,9,13,7,17,29,58.6,12,13,0,13,17,46,19,0,0,2017-2018,90.0,122.39999999999999,208.79999999999998
1080,Përparim Hetemaj,FIN,MF,Chievo,Serie A,30,1986,26.8,74,48,34,25,15,29,78,37.2,49,39,6,33,39,113,47,1,0,2017-2018,90.0,130.97014925373134,248.50746268656715
1081,Son Heung-min,KOR,FW,Tottenham,Premier League,25,1992,25.7,17,10,2,12,3,2,28,7.1,26,18,0,18,10,27,12,0,0,2017-2018,90.0,35.019455252918284,59.53307392996109
1082,Thomas Heurtaux,FRA,DF,Hellas Verona,Serie A,29,1988,15.5,14,11,12,2,0,4,8,50.0,4,25,16,9,37,51,97,1,0,2017-2018,90.0,214.83870967741936,81.29032258064517
1083,Gonzalo Higuaín,ARG,FW,Juventus,Serie A,29,1987,31.3,19,17,3,7,9,2,19,10.5,17,19,4,15,7,26,20,0,0,2017-2018,90.0,20.127795527156547,54.632587859424916
1084,Oscar Hiljemark,SWE,MF,Genoa,Serie A,25,1992,14.2,12,8,2,8,2,3,24,12.5,21,14,4,10,9,21,12,0,0,2017-2018,90.0,57.04225352112677,76.05633802816902
1085,Vitorino Hilton,BRA,DF,Montpellier,Ligue 1,39,1977,27.0,44,26,33,11,0,13,36,36.1,23,28,14,14,58,102,140,5,0,2017-2018,90.0,193.33333333333334,146.66666666666669
1086,Kaylen Hinds,ENG,FW,Wolfsburg,Bundesliga,19,1998,1.0,1,1,1,0,0,0,0,0.0,0,1,0,1,1,2,0,0,0,2017-2018,90.0,90.0,90.0
1087,Martin Hinteregger,AUT,DF,Augsburg,Bundesliga,24,1992,29.5,79,51,55,22,2,47,61,77.0,14,40,27,13,49,128,135,3,0,2017-2018,90.0,149.4915254237288,241.01694915254237
1088,Marwin Hitz,SUI,GK,Augsburg,Bundesliga,29,1987,32.0,1,1,1,0,0,1,3,33.3,2,0,0,0,0,1,12,3,0,2017-2018,90.0,0.0,2.8125
1089,Andrew Hjulsager,DEN,"DF,MF",Celta Vigo,La Liga,22,1995,0.2,0,0,0,0,0,0,2,0.0,2,1,0,1,0,0,0,0,0,2017-2018,90.0,0.0,0.0
1090,Wesley Hoedt,NED,DF,Southampton,Premier League,23,1994,28.0,60,51,48,12,0,36,61,59.0,25,32,17,15,40,100,177,2,0,2017-2018,90.0,128.57142857142856,192.85714285714286
1091,Nicolas Höfler,GER,MF,Freiburg,Bundesliga,27,1990,25.1,57,36,23,30,4,31,50,62.0,19,42,10,32,44,101,51,2,0,2017-2018,90.0,157.76892430278883,204.3824701195219
1092,Jonas Hofmann,GER,"MF,FW",Gladbach,Bundesliga,25,1992,11.5,23,19,12,11,0,12,26,46.2,14,15,4,11,12,35,16,0,0,2017-2018,90.0,93.91304347826087,180.0
1093,Marco Höger,GER,MF,Köln,Bundesliga,27,1989,18.6,60,40,31,28,1,30,64,46.9,34,35,5,30,25,85,27,1,0,2017-2018,90.0,120.96774193548386,290.3225806451613
1094,Jonathan Hogg,ENG,MF,Huddersfield,Premier League,28,1988,26.6,93,64,29,59,5,26,89,29.2,63,51,12,39,69,162,48,0,0,2017-2018,90.0,233.45864661654133,314.6616541353383
1095,Rob Holding,ENG,DF,Arsenal,Premier League,21,1995,9.1,19,14,13,5,1,4,12,33.3,8,16,10,6,21,40,40,2,0,2017-2018,90.0,207.6923076923077,187.9120879120879
1096,José Holebas,GRE,DF,Watford,Premier League,33,1984,26.5,51,31,34,14,3,18,44,40.9,26,24,8,16,29,80,95,2,0,2017-2018,90.0,98.49056603773585,173.2075471698113
1097,Lucas Höler,GER,"FW,MF",Freiburg,Bundesliga,23,1994,10.1,24,20,8,13,3,9,24,37.5,15,10,0,10,7,31,13,0,0,2017-2018,90.0,62.37623762376238,213.86138613861385
1098,Mason Holgate,ENG,DF,Everton,Premier League,20,1996,13.2,23,16,15,7,1,10,21,47.6,11,12,9,3,23,46,86,2,0,2017-2018,90.0,156.8181818181818,156.8181818181818
1099,Lewis Holtby,GER,"MF,FW",Hamburger SV,Bundesliga,26,1990,13.3,44,29,14,26,4,17,32,53.1,15,23,2,21,10,54,9,0,0,2017-2018,90.0,67.66917293233082,297.7443609022556
1100,Gerrit Holtmann,PHI,"FW,DF",Mainz 05,Bundesliga,22,1995,10.0,16,13,8,5,3,11,22,50.0,11,19,2,17,12,28,9,0,0,2017-2018,90.0,108.0,144.0
1101,Jannes Horn,GER,DF,Köln,Bundesliga,20,1997,9.2,16,11,11,4,1,11,14,78.6,3,12,3,9,17,33,26,0,0,2017-2018,90.0,166.30434782608697,156.52173913043478
1102,Timo Horn,GER,GK,Köln,Bundesliga,24,1993,34.0,3,2,3,0,0,3,6,50.0,3,0,0,0,0,3,18,2,0,2017-2018,90.0,0.0,7.9411764705882355
1103,Benedikt Höwedes,GER,DF,Juventus,Serie A,29,1988,2.7,1,1,1,0,0,0,0,0.0,0,0,0,0,8,9,10,1,0,2017-2018,90.0,266.66666666666663,33.33333333333333
1104,Lukáš Hrádecký,FIN,GK,Eint Frankfurt,Bundesliga,27,1989,34.0,0,0,0,0,0,0,2,0.0,2,0,0,0,0,0,23,3,0,2017-2018,90.0,0.0,0.0
1105,Branimir Hrgota,SWE,"MF,FW",Eint Frankfurt,Bundesliga,24,1993,2.2,5,4,0,3,2,4,7,57.1,3,2,0,2,0,5,1,0,0,2017-2018,90.0,0.0,204.54545454545453
1106,Timo Hübers,GER,DF,Hannover 96,Bundesliga,21,1996,5.0,11,10,9,2,0,9,15,60.0,6,13,8,5,9,20,31,0,0,2017-2018,90.0,162.0,198.0
1107,Benjamin Hübner,GER,DF,Hoffenheim,Bundesliga,28,1989,25.7,71,56,43,27,1,31,46,67.4,15,40,18,22,51,122,114,0,0,2017-2018,90.0,178.59922178988327,248.63813229571983
1108,Florian Hübner,GER,DF,Hannover 96,Bundesliga,26,1991,3.6,10,9,8,2,0,5,9,55.6,4,3,2,1,6,16,21,0,0,2017-2018,90.0,150.0,250.0
1109,Tomáš Hubočan,SVK,DF,Marseille,Ligue 1,31,1985,1.0,1,0,1,0,0,0,4,0.0,4,0,0,0,0,1,1,0,0,2017-2018,90.0,0.0,90.0
1110,Callum Hudson-Odoi,ENG,"FW,DF",Chelsea,Premier League,16,2000,0.3,0,0,0,0,0,0,0,0.0,0,0,0,0,0,0,0,0,0,2017-2018,90.0,0.0,0.0
1111,Will Hughes,ENG,MF,Watford,Premier League,22,1995,11.0,34,18,7,18,9,9,19,47.4,10,16,1,15,15,49,6,0,0,2017-2018,90.0,122.72727272727273,278.1818181818182
1112,Jordan Hugill,ENG,FW,West Ham,Premier League,25,1992,0.3,0,0,0,0,0,0,1,0.0,1,0,0,0,0,0,0,0,0,2017-2018,90.0,0.0,0.0
1113,Vitor Hugo,BRA,DF,Fiorentina,Serie A,26,1991,13.4,32,21,26,6,0,10,17,58.8,7,10,6,4,43,75,92,0,0,2017-2018,90.0,288.8059701492537,214.92537313432834
1114,Mats Hummels,GER,DF,Bayern Munich,Bundesliga,28,1988,24.6,62,52,41,18,3,35,51,68.6,16,31,12,19,55,117,59,2,0,2017-2018,89.99999999999999,201.21951219512192,226.82926829268288
1115,Uwe Hünemeier,GER,DF,Brighton,Premier League,31,1986,0.2,0,0,0,0,0,0,0,0.0,0,0,0,0,0,0,4,0,0,2017-2018,90.0,0.0,0.0
1116,Adrien Hunou,FRA,"FW,MF",Rennes,Ligue 1,23,1994,16.2,27,15,11,8,8,11,42,26.2,31,22,1,21,9,36,8,1,0,2017-2018,90.0,50.0,150.0
1117,Aaron Hunt,GER,"MF,FW",Hamburger SV,Bundesliga,30,1986,23.1,36,24,12,20,4,11,37,29.7,26,20,2,18,14,50,18,2,0,2017-2018,89.99999999999999,54.54545454545454,140.25974025974023
1118,Emerson Hyndman,USA,MF,Bournemouth,Premier League,21,1996,0.6,0,0,0,0,0,0,1,0.0,1,2,0,2,1,1,1,0,0,2017-2018,90.0,150.0,0.0
1119,Elseid Hysaj,ALB,DF,Napoli,Serie A,23,1994,34.7,64,45,28,30,6,32,56,57.1,24,35,4,31,43,107,68,4,0,2017-2018,90.0,111.52737752161381,165.99423631123918
1120,Suk Hyun-jun,KOR,FW,Troyes,Ligue 1,26,1991,13.3,6,5,2,2,2,1,9,11.1,8,10,0,10,1,7,7,0,0,2017-2018,90.0,6.7669172932330826,40.6015037593985
1121,Pierre Højbjerg,DEN,MF,Southampton,Premier League,21,1995,18.6,45,29,24,18,3,13,56,23.2,43,30,3,27,37,82,26,1,0,2017-2018,90.0,179.0322580645161,217.74193548387095
1122,Jordon Ibe,ENG,"MF,FW",Bournemouth,Premier League,21,1995,22.2,14,12,7,5,2,6,22,27.3,16,5,0,5,10,24,11,0,0,2017-2018,90.0,40.54054054054055,56.756756756756765
1123,Vedad Ibišević,BIH,FW,Hertha BSC,Bundesliga,32,1984,16.1,10,8,1,5,4,4,7,57.1,3,8,1,7,4,14,23,0,0,2017-2018,90.0,22.360248447204967,55.90062111801242
1124,Vicente Iborra,ESP,MF,Leicester City,Premier League,29,1988,15.7,23,18,13,10,0,9,36,25.0,27,25,11,14,19,42,49,1,0,2017-2018,90.0,108.9171974522293,131.84713375796179
1125,Zlatan Ibrahimović,SWE,"MF,FW",Manchester Utd,Premier League,35,1981,1.2,2,1,1,0,1,0,1,0.0,1,0,0,0,0,2,1,0,0,2017-2018,90.0,0.0,150.0
1126,Mauro Icardi,ARG,FW,Inter,Serie A,24,1993,32.9,3,2,1,2,0,1,8,12.5,7,14,6,8,5,8,23,1,0,2017-2018,90.0,13.677811550151977,8.206686930091186
1127,Brown Ideye,NGA,FW,Málaga,La Liga,28,1988,8.1,2,2,0,2,0,0,5,0.0,5,2,0,2,1,3,11,0,0,2017-2018,90.0,11.11111111111111,22.22222222222222
1128,Edgar Ié,GNB,DF,Lille,Ligue 1,23,1994,35.0,74,42,55,18,1,31,69,44.9,38,57,26,31,84,158,135,3,0,2017-2018,90.0,216.0,190.28571428571428
1129,Julien Ielsch,FRA,"MF,DF",Amiens,Ligue 1,34,1983,6.8,28,18,12,11,5,7,25,28.0,18,16,3,13,11,39,15,2,0,2017-2018,90.0,145.58823529411765,370.5882352941176
1130,Pietro Iemmello,ITA,FW,Benevento,Serie A,25,1992,9.8,2,2,1,1,0,2,8,25.0,6,4,0,4,1,3,11,2,0,2017-2018,90.0,9.183673469387754,18.36734693877551
1131,Kelechi Iheanacho,NGA,"FW,MF",Leicester City,Premier League,20,1996,9.2,9,6,3,5,1,3,20,15.0,17,10,2,8,3,12,4,0,0,2017-2018,90.0,29.347826086956523,88.04347826086958
1132,Jordan Ikoko,COD,DF,Guingamp,Ligue 1,23,1994,26.9,44,29,24,15,5,22,42,52.4,20,20,2,18,48,92,74,0,0,2017-2018,90.0,160.59479553903347,147.21189591078067
1133,Jonathan Ikone,FRA,"MF,FW",Montpellier,Ligue 1,19,1998,11.1,13,10,3,6,4,4,14,28.6,10,8,0,8,6,19,3,0,0,2017-2018,90.0,48.64864864864865,105.40540540540542
1134,Josip Iličić,SVN,"MF,FW",Atalanta,Serie A,29,1988,22.2,24,19,5,13,6,8,29,27.6,21,19,0,19,16,40,2,0,0,2017-2018,90.0,64.86486486486487,97.2972972972973
1135,Asier Illarramendi,ESP,MF,Real Sociedad,La Liga,27,1990,35.1,85,57,35,41,9,37,90,41.1,53,44,8,36,75,160,35,0,0,2017-2018,90.0,192.3076923076923,217.94871794871793
1136,Jules Iloki,FRA,"MF,FW",Nantes,Ligue 1,25,1992,15.8,13,9,1,9,3,3,16,18.8,13,8,0,8,12,25,16,0,0,2017-2018,90.0,68.35443037974683,74.0506329113924
1137,Stefan Ilsanker,AUT,"DF,MF",RB Leipzig,Bundesliga,28,1989,14.3,37,29,23,11,3,22,39,56.4,17,23,10,13,25,62,55,1,0,2017-2018,90.0,157.34265734265733,232.86713286713288
1138,Giannelli Imbula,COD,MF,Toulouse,Ligue 1,24,1992,24.9,29,19,10,15,4,7,29,24.1,22,17,2,15,20,49,13,3,0,2017-2018,90.0,72.28915662650603,104.81927710843374
1139,Ciro Immobile,ITA,FW,Lazio,Serie A,27,1990,29.8,4,2,0,3,1,0,17,0.0,17,14,1,13,0,4,9,0,0,2017-2018,90.0,0.0,12.080536912751677
1140,Emmanuel Imorou,BEN,DF,Caen,Ligue 1,28,1988,0.4,0,0,0,0,0,0,0,0.0,0,0,0,0,1,1,1,0,0,2017-2018,90.0,225.0,0.0
1141,Tom Ince,ENG,"MF,FW",Huddersfield,Premier League,25,1992,27.2,35,27,14,16,5,10,29,34.5,19,20,0,20,12,47,12,0,0,2017-2018,90.0,39.705882352941174,115.80882352941177
1142,Svante Ingelsson,SWE,MF,Udinese,Serie A,19,1998,3.6,9,6,3,3,3,2,10,20.0,8,4,0,4,6,15,4,0,0,2017-2018,90.0,150.0,225.0
1143,Roberto Inglese,ITA,FW,Chievo,Serie A,25,1991,30.9,31,21,13,9,9,7,30,23.3,23,21,2,19,8,39,17,1,0,2017-2018,90.0,23.300970873786408,90.29126213592234
1144,Danny Ings,ENG,FW,Liverpool,Premier League,25,1992,3.0,5,3,1,3,1,0,0,0.0,0,4,0,4,2,7,1,0,0,2017-2018,90.0,60.0,150.0
1145,Andrés Iniesta,ESP,MF,Barcelona,La Liga,33,1984,20.3,28,22,11,8,9,6,31,19.4,25,21,2,19,10,38,12,1,0,2017-2018,90.0,44.33497536945813,124.13793103448275
1146,Lorenzo Insigne,ITA,FW,Napoli,Serie A,26,1991,34.3,29,17,11,13,5,13,33,39.4,20,20,0,20,17,46,4,0,0,2017-2018,90.0,44.6064139941691,76.0932944606414
1147,Emiliano Insúa,ARG,DF,Stuttgart,Bundesliga,28,1989,23.4,46,34,27,16,3,17,32,53.1,15,30,4,26,36,82,48,1,0,2017-2018,89.99999999999999,138.46153846153845,176.9230769230769
1148,Pablo Insua,ESP,DF,Schalke 04,Bundesliga,23,1993,0.3,0,0,0,0,0,0,0,0.0,0,1,1,0,0,0,1,0,0,2017-2018,90.0,0.0,0.0
1149,Takashi Inui,JPN,"MF,FW",Eibar,La Liga,29,1988,29.2,39,21,12,19,8,13,42,31.0,29,36,0,36,18,57,10,0,0,2017-2018,90.0,55.47945205479452,120.2054794520548
1150,Artur Ioniță,MDA,MF,Cagliari,Serie A,26,1990,29.7,63,45,30,24,9,17,38,44.7,21,39,7,32,28,91,29,0,0,2017-2018,90.0,84.84848484848484,190.9090909090909
1151,Gorka Iraizoz,ESP,GK,Girona,La Liga,36,1981,8.5,1,1,1,0,0,1,2,50.0,1,0,0,0,1,2,9,2,0,2017-2018,90.0,10.588235294117647,10.588235294117647
1152,Stephen Ireland,IRL,"MF,FW",Stoke City,Premier League,30,1986,1.5,3,1,2,1,0,1,5,20.0,4,4,2,2,1,4,1,0,0,2017-2018,90.0,60.0,180.0
1153,Carlos Isaac,ESP,DF,Atlético Madrid,La Liga,19,1998,0.7,1,0,1,0,0,1,3,33.3,2,0,0,0,2,3,1,0,0,2017-2018,90.0,257.14285714285717,128.57142857142858
1154,Alexander Isak,SWE,"FW,MF",Dortmund,Bundesliga,17,1999,1.3,1,0,0,1,0,0,1,0.0,1,1,0,1,0,1,0,0,0,2017-2018,90.0,0.0,69.23076923076923
1155,Isco,ESP,MF,Real Madrid,La Liga,25,1992,19.7,22,12,5,10,7,5,35,14.3,30,11,0,11,15,37,2,0,0,2017-2018,90.0,68.52791878172589,100.50761421319797
1156,Tatsuya Ito,JPN,"MF,FW",Hamburger SV,Bundesliga,20,1997,11.2,16,13,4,8,4,11,22,50.0,11,28,0,28,6,22,1,0,0,2017-2018,90.0,48.214285714285715,128.57142857142858
1157,Gian-Luca Itter,GER,DF,Wolfsburg,Bundesliga,18,1999,4.6,19,12,15,2,2,14,22,63.6,8,6,0,6,5,24,15,0,0,2017-2018,90.0,97.82608695652175,371.7391304347826
1158,Manuel Iturra,CHI,MF,Málaga,La Liga,33,1984,17.6,70,45,36,27,7,22,55,40.0,33,19,2,17,29,99,23,0,0,2017-2018,90.0,148.29545454545453,357.95454545454544
1159,Ander Iturraspe,ESP,MF,Athletic Club,La Liga,28,1989,21.2,42,31,18,22,2,10,32,31.3,22,22,7,15,35,77,57,0,0,2017-2018,90.0,148.58490566037736,178.30188679245285
1160,Ivi,ESP,"MF,FW",Levante,La Liga,23,1994,19.6,48,34,19,23,6,21,62,33.9,41,21,1,20,15,63,15,0,0,2017-2018,90.0,68.87755102040816,220.40816326530611
1161,Alex Iwobi,NGA,"MF,FW",Arsenal,Premier League,21,1996,20.3,19,15,8,8,3,5,18,27.8,13,19,1,18,7,26,10,1,0,2017-2018,90.0,31.034482758620687,84.23645320197043
1162,José Izquierdo,COL,"MF,FW",Brighton,Premier League,25,1992,22.0,23,15,12,9,2,7,19,36.8,12,6,0,6,16,39,34,0,0,2017-2018,90.0,65.45454545454545,94.0909090909091
1163,Armando Izzo,ITA,DF,Genoa,Serie A,25,1992,15.4,30,23,14,10,6,12,18,66.7,6,15,6,9,34,64,70,0,0,2017-2018,90.0,198.7012987012987,175.32467532467533
1164,Koo Ja-cheol,KOR,MF,Augsburg,Bundesliga,28,1989,22.7,54,41,18,31,5,27,44,61.4,17,22,3,19,27,81,34,2,0,2017-2018,89.99999999999999,107.04845814977973,214.09691629955947
1165,Paul Jaeckel,GER,DF,Wolfsburg,Bundesliga,19,1998,3.0,3,3,3,0,0,1,2,50.0,1,5,2,3,1,4,8,0,0,2017-2018,90.0,30.0,90.0
1166,Phil Jagielka,ENG,DF,Everton,Premier League,34,1982,22.9,33,23,24,9,0,8,21,38.1,13,30,20,10,39,72,179,1,0,2017-2018,90.0,153.27510917030568,129.69432314410483
1167,Kilian Jakob,GER,FW,Augsburg,Bundesliga,19,1998,0.6,0,0,0,0,0,0,0,0.0,0,1,0,1,0,0,1,0,0,2017-2018,90.0,0.0,0.0
1168,Eldin Jakupović,SUI,GK,Leicester City,Premier League,32,1984,2.0,0,0,0,0,0,0,0,0.0,0,0,0,0,0,0,4,0,0,2017-2018,90.0,0.0,0.0
1169,Christophe Jallet,FRA,DF,Nice,Ligue 1,33,1983,13.0,29,21,21,8,0,11,26,42.3,15,18,6,12,16,45,47,0,0,2017-2018,90.00000000000001,110.76923076923077,200.7692307692308
1170,Ablie Jallow,GAM,FW,Metz,Ligue 1,18,1998,1.4,1,1,1,0,0,0,5,0.0,5,1,0,1,3,4,1,0,0,2017-2018,90.0,192.85714285714286,64.28571428571429
1171,Matty James,ENG,MF,Leicester City,Premier League,26,1991,11.0,19,10,7,11,1,2,10,20.0,8,14,2,12,17,36,25,0,0,2017-2018,90.0,139.0909090909091,155.45454545454547
1172,Vasilije Janjicic,SUI,MF,Hamburger SV,Bundesliga,18,1998,3.6,14,11,5,9,0,2,4,50.0,2,6,1,5,3,17,5,0,0,2017-2018,90.0,75.0,350.0
1173,Christoph Janker,GER,"DF,MF",Augsburg,Bundesliga,32,1985,0.9,4,3,3,1,0,2,3,66.7,1,0,0,0,1,5,4,1,0,2017-2018,90.0,100.0,400.0
1174,Saidy Janko,GAM,DF,Saint-Étienne,Ligue 1,21,1995,15.8,43,30,25,14,4,14,24,58.3,10,21,1,20,14,57,50,0,0,2017-2018,90.0,79.74683544303797,244.93670886075947
1175,Jakub Jankto,CZE,"MF,FW",Udinese,Serie A,21,1996,29.5,29,18,9,14,6,10,46,21.7,36,46,8,38,20,49,27,0,0,2017-2018,90.0,61.016949152542374,88.47457627118644
1176,Daryl Janmaat,NED,DF,Watford,Premier League,28,1989,20.2,46,31,29,10,7,22,52,42.3,30,16,5,11,33,79,61,0,0,2017-2018,90.0,147.02970297029702,204.95049504950495
1177,Vincent Janssen,NED,DF,Tottenham,Premier League,23,1994,0.0,0,0,0,0,0,0,0,0.0,0,0,0,0,0,0,0,0,0,2017-2018,,,
1178,Tony Jantschke,GER,DF,Gladbach,Bundesliga,27,1990,8.1,13,11,9,4,0,8,13,61.5,5,10,1,9,6,19,25,0,0,2017-2018,90.0,66.66666666666667,144.44444444444446
1179,Adnan Januzaj,BEL,FW,Real Sociedad,La Liga,22,1995,17.5,16,11,2,8,6,5,18,27.8,13,12,0,12,11,27,5,0,0,2017-2018,90.0,56.57142857142857,82.28571428571428
1180,Nicolas Janvier,FRA,MF,Rennes,Ligue 1,18,1998,0.8,4,1,1,1,2,1,2,50.0,1,1,0,1,1,5,0,0,0,2017-2018,90.0,112.5,450.0
1181,Paweł Jaroszyński,POL,DF,Chievo,Serie A,22,1994,9.0,20,12,14,5,1,9,18,50.0,9,11,4,7,21,41,40,1,0,2017-2018,90.0,210.0,200.0
1182,Rune Jarstein,NOR,GK,Hertha BSC,Bundesliga,32,1984,31.0,1,1,1,0,0,1,2,50.0,1,0,0,0,0,1,8,5,0,2017-2018,90.0,0.0,2.903225806451613
1183,Jason,ESP,"FW,MF",Levante,La Liga,23,1994,19.8,32,25,11,14,7,11,38,28.9,27,14,1,13,20,52,8,0,0,2017-2018,90.0,90.9090909090909,145.45454545454547
1184,Bakery Jatta,GAM,"MF,FW",Hamburger SV,Bundesliga,19,1998,3.3,14,12,2,12,0,4,6,66.7,2,6,1,5,3,17,5,0,0,2017-2018,90.0,81.81818181818181,381.8181818181818
1185,Corentin Jean,FRA,"FW,MF",Toulouse,Ligue 1,22,1995,18.8,12,8,4,7,1,5,21,23.8,16,14,1,13,14,26,10,0,0,2017-2018,90.0,67.02127659574468,57.44680851063829
1186,Benjamin Jeannot,FRA,FW,Dijon,Ligue 1,25,1992,15.6,12,7,5,6,1,1,13,7.7,12,9,3,6,6,18,26,0,0,2017-2018,90.0,34.61538461538461,69.23076923076923
1187,Tin Jedvaj,CRO,DF,Leverkusen,Bundesliga,21,1995,6.7,10,6,2,6,2,8,15,53.3,7,9,1,8,9,19,18,0,0,2017-2018,90.0,120.89552238805969,134.32835820895522
1188,Jemerson,BRA,DF,Monaco,Ligue 1,24,1992,31.7,48,32,32,15,1,24,31,77.4,7,46,32,14,56,104,169,1,0,2017-2018,90.0,158.99053627760253,136.2776025236593
1189,Jesé,ESP,"FW,MF",Stoke City,Premier League,24,1993,6.8,10,7,3,5,2,3,13,23.1,10,5,0,5,0,10,3,0,0,2017-2018,90.0,0.0,132.35294117647058
1190,Gabriel Jesus,BRA,FW,Manchester City,Premier League,20,1997,18.5,23,15,6,10,7,3,22,13.6,19,16,0,16,8,31,6,0,0,2017-2018,90.0,38.91891891891892,111.8918918918919
1191,Juan Jesus,BRA,DF,Roma,Serie A,26,1991,18.4,42,30,25,15,2,18,34,52.9,16,18,9,9,39,81,63,0,0,2017-2018,90.0,190.7608695652174,205.43478260869566
1192,Álvaro Jiménez,ESP,"MF,FW",Getafe,La Liga,22,1995,5.9,15,8,5,6,4,8,21,38.1,13,6,0,6,1,16,6,0,0,2017-2018,90.0,15.254237288135592,228.81355932203388
1193,Joaquín,ESP,"MF,FW",Betis,La Liga,36,1981,27.5,22,19,11,10,1,4,16,25.0,12,17,2,15,15,37,38,0,0,2017-2018,89.99999999999999,49.090909090909086,72.0
1194,Aron Jóhannsson,USA,"MF,FW",Werder Bremen,Bundesliga,26,1990,3.1,4,3,2,2,0,1,7,14.3,6,3,0,3,1,5,5,0,0,2017-2018,90.0,29.032258064516128,116.12903225806451
1195,Fabian Johnson,USA,"MF,DF",Gladbach,Bundesliga,29,1987,5.2,16,10,7,7,2,6,7,85.7,1,10,2,8,2,18,13,0,0,2017-2018,90.0,34.61538461538461,276.9230769230769
1196,Glen Johnson,ENG,DF,Stoke City,Premier League,32,1984,6.1,7,5,5,2,0,3,12,25.0,9,7,2,5,10,17,23,0,0,2017-2018,90.0,147.5409836065574,103.27868852459018
1197,Karl-Johan Johnsson,SWE,GK,Guingamp,Ligue 1,27,1990,38.0,0,0,0,0,0,0,1,0.0,1,0,0,0,0,0,14,4,0,2017-2018,90.0,0.0,0.0
1198,Miloš Jojić,SRB,MF,Köln,Bundesliga,25,1992,16.2,36,26,18,15,3,16,40,40.0,24,31,4,27,15,51,16,0,0,2017-2018,90.0,83.33333333333334,200.0
1199,Jonathas,BRA,FW,Hannover 96,Bundesliga,28,1989,7.0,7,3,2,4,1,1,2,50.0,1,3,1,2,0,7,9,0,0,2017-2018,90.0,0.0,90.0
1200,Phil Jones,ENG,DF,Manchester Utd,Premier League,25,1992,21.9,25,18,20,5,0,9,20,45.0,11,25,17,8,41,66,133,2,0,2017-2018,90.0,168.49315068493152,102.73972602739727
1201,Nigel de Jong,NED,MF,Mainz 05,Bundesliga,32,1984,8.2,17,12,7,9,1,10,14,71.4,4,5,1,4,12,29,22,1,0,2017-2018,90.0,131.70731707317074,186.58536585365854
1202,Jony,ESP,"FW,MF",Málaga,La Liga,26,1991,2.4,3,2,2,0,1,0,4,0.0,4,1,0,1,2,5,1,0,0,2017-2018,90.0,75.0,112.50000000000001
1203,Joan Jordán,ESP,MF,Eibar,La Liga,23,1994,27.0,31,24,8,19,4,10,68,14.7,58,24,0,24,30,61,12,0,0,2017-2018,90.0,100.0,103.33333333333334
1204,Jorge,BRA,DF,Monaco,Ligue 1,21,1996,21.3,69,40,34,25,10,23,38,60.5,15,19,2,17,66,135,86,0,0,2017-2018,90.0,278.8732394366197,291.5492957746479
1205,Jorginho,ITA,MF,Napoli,Serie A,25,1991,29.4,62,46,14,39,9,15,68,22.1,53,32,3,29,50,112,12,2,0,2017-2018,90.0,153.06122448979593,189.79591836734693
1206,Willian José,BRA,FW,Real Sociedad,La Liga,25,1991,30.8,10,7,1,5,4,2,9,22.2,7,10,1,9,5,15,31,0,0,2017-2018,90.0,14.61038961038961,29.22077922077922
1207,Joselu,ESP,FW,Newcastle Utd,Premier League,27,1990,19.0,22,17,10,11,1,7,34,20.6,27,25,2,23,11,33,39,0,0,2017-2018,90.0,52.10526315789474,104.21052631578948
1208,Yann Jouffre,FRA,"FW,MF",Metz,Ligue 1,33,1984,3.1,3,2,0,2,1,1,6,16.7,5,5,1,4,3,6,2,0,0,2017-2018,90.0,87.09677419354838,87.09677419354838
1209,Vukašin Jovanović,SRB,DF,Bordeaux,Ligue 1,21,1996,16.0,18,14,11,7,0,6,14,42.9,8,18,10,8,27,45,67,0,0,2017-2018,90.0,151.875,101.25
1210,Stevan Jovetić,MNE,FW,Monaco,Ligue 1,27,1989,8.4,4,4,0,3,1,0,9,0.0,9,5,0,5,3,7,3,0,0,2017-2018,90.0,32.14285714285714,42.857142857142854
1211,Luka Jović,SRB,FW,Eint Frankfurt,Bundesliga,19,1997,10.4,5,5,0,5,0,1,3,33.3,2,6,2,4,1,6,2,0,0,2017-2018,90.0,8.653846153846153,43.26923076923077
1212,Jozabed,ESP,MF,Celta Vigo,La Liga,26,1991,16.4,18,12,7,9,2,3,18,16.7,15,18,2,16,16,34,19,0,0,2017-2018,90.0,87.8048780487805,98.78048780487806
1213,Juanfran,ESP,DF,La Coruña,La Liga,28,1988,34.0,64,44,38,22,4,35,65,53.8,30,29,11,18,63,127,121,0,0,2017-2018,90.0,166.76470588235296,169.41176470588235
1214,Juanfran,ESP,DF,Atlético Madrid,La Liga,32,1985,14.5,33,24,21,9,3,21,32,65.6,11,14,4,10,26,59,35,0,0,2017-2018,90.0,161.3793103448276,204.82758620689654
1215,Juankar,ESP,DF,Málaga,La Liga,27,1990,8.7,23,17,13,8,2,11,20,55.0,9,8,1,7,19,42,26,0,0,2017-2018,90.0,196.55172413793105,237.93103448275863
1216,Juanmi,ESP,"FW,MF",Real Sociedad,La Liga,24,1993,16.5,22,13,7,12,3,4,22,18.2,18,11,0,11,10,32,6,0,0,2017-2018,90.0,54.54545454545455,120.00000000000001
1217,Juanpe,ESP,DF,Girona,La Liga,26,1991,34.1,48,30,28,20,0,30,43,69.8,13,27,19,8,53,101,137,0,0,2017-2018,90.0,139.88269794721407,126.68621700879766
1218,Juanpi,VEN,"MF,FW",Málaga,La Liga,23,1994,6.8,11,8,2,7,2,3,8,37.5,5,7,0,7,6,17,1,0,0,2017-2018,90.0,79.41176470588235,145.58823529411765
1219,Mariano Julio Izco,ARG,MF,Crotone,Serie A,34,1983,2.0,6,4,2,4,0,2,4,50.0,2,2,0,2,4,10,1,0,0,2017-2018,90.0,180.0,270.0
1220,Christopher Jullien,FRA,DF,Toulouse,Ligue 1,24,1993,28.9,36,25,27,9,0,15,32,46.9,17,29,19,10,40,76,182,5,0,2017-2018,90.00000000000001,124.56747404844292,112.11072664359862
1221,David Juncà,ESP,DF,Eibar,La Liga,23,1993,10.0,15,13,9,6,0,7,19,36.8,12,7,1,6,11,26,25,0,0,2017-2018,90.0,99.0,135.0
1222,Gideon Jung,GER,"MF,DF",Hamburger SV,Bundesliga,22,1994,28.6,59,41,32,24,3,22,38,57.9,16,29,12,17,38,97,71,1,0,2017-2018,90.0,119.58041958041959,185.66433566433568
1223,Sebastian Jung,GER,DF,Wolfsburg,Bundesliga,27,1990,0.9,2,2,1,1,0,1,1,100.0,0,0,0,0,0,2,5,0,0,2017-2018,90.0,0.0,200.0
1224,Zlatko Junuzović,AUT,"MF,FW",Werder Bremen,Bundesliga,29,1987,18.1,35,23,17,12,6,18,38,47.4,20,23,2,21,18,53,12,0,0,2017-2018,90.0,89.50276243093921,174.0331491712707
1225,Mathias Jørgensen,DEN,DF,Huddersfield,Premier League,27,1990,38.0,55,36,40,13,2,19,45,42.2,26,49,20,29,76,131,249,5,0,2017-2018,90.0,180.0,130.26315789473685
1226,Christian Kabasele,BEL,DF,Watford,Premier League,26,1991,25.9,42,25,28,14,0,21,36,58.3,15,37,23,14,34,76,185,0,0,2017-2018,90.0,118.14671814671816,145.94594594594597
1227,Younès Kaboul,FRA,DF,Watford,Premier League,31,1986,1.7,3,2,0,3,0,0,0,0.0,0,4,2,2,2,5,15,0,0,2017-2018,90.0,105.88235294117646,158.8235294117647
1228,Alexander Kačaniklić,SWE,"MF,FW",Nantes,Ligue 1,25,1991,3.5,8,5,7,1,0,5,10,50.0,5,5,2,3,6,14,7,0,0,2017-2018,90.0,154.28571428571428,205.71428571428572
1229,Gojko Kačar,SRB,DF,Augsburg,Bundesliga,30,1987,2.5,7,6,6,1,0,3,7,42.9,4,3,2,1,4,11,7,0,0,2017-2018,90.0,144.0,252.0
1230,Elias Kachunga,COD,"FW,MF",Huddersfield,Premier League,25,1992,14.8,30,26,13,12,5,8,19,42.1,11,14,1,13,2,32,9,0,0,2017-2018,90.0,12.162162162162161,182.43243243243242
1231,Pavel Kadeřábek,CZE,"FW,DF",Hoffenheim,Bundesliga,25,1992,24.4,44,30,22,18,4,20,44,45.5,24,27,8,19,34,78,45,1,0,2017-2018,90.0,125.40983606557378,162.29508196721312
1232,Shinji Kagawa,JPN,MF,Dortmund,Bundesliga,28,1989,13.0,32,22,11,14,7,18,27,66.7,9,6,0,6,6,38,2,0,0,2017-2018,90.00000000000001,41.53846153846154,221.53846153846155
1233,Sullay Kaikai,SLE,MF,Crystal Palace,Premier League,21,1995,0.2,1,0,0,1,0,0,0,0.0,0,1,0,1,0,1,1,0,0,2017-2018,90.0,0.0,450.0
1234,Florian Kainz,AUT,"MF,FW",Werder Bremen,Bundesliga,24,1992,19.0,33,25,9,18,6,9,19,47.4,10,23,0,23,17,50,13,0,0,2017-2018,90.0,80.52631578947368,156.31578947368422
1235,Dominik Kaiser,GER,"MF,FW",RB Leipzig,Bundesliga,28,1988,3.1,5,5,1,3,1,4,11,36.4,7,6,0,6,1,6,8,0,0,2017-2018,90.0,29.032258064516128,145.16129032258064
1236,Gaël Kakuta,COD,"MF,FW",Amiens,Ligue 1,26,1991,34.3,54,32,14,27,13,9,40,22.5,31,33,3,30,26,80,19,0,0,2017-2018,90.0,68.22157434402334,141.6909620991254
1237,Nikola Kalinić,CRO,FW,Milan,Serie A,29,1988,20.1,6,5,1,4,1,0,8,0.0,8,4,1,3,3,9,12,0,0,2017-2018,90.0,13.432835820895521,26.865671641791042
1238,Salomon Kalou,CIV,"FW,MF",Hertha BSC,Bundesliga,31,1985,24.5,19,11,12,5,2,9,17,52.9,8,37,1,36,10,29,29,0,0,2017-2018,90.00000000000001,36.734693877551024,69.79591836734694
1239,Daichi Kamada,JPN,"MF,FW",Eint Frankfurt,Bundesliga,20,1996,1.6,1,1,0,1,0,0,0,0.0,0,0,0,0,1,2,0,0,0,2017-2018,90.0,56.25,56.25
1240,François Kamano,GUI,FW,Bordeaux,Ligue 1,21,1996,22.4,32,24,11,14,7,10,35,28.6,25,18,2,16,15,47,8,0,0,2017-2018,90.0,60.267857142857146,128.57142857142858
1241,Bingourou Kamara,SEN,GK,Strasbourg,Ligue 1,20,1996,18.8,0,0,0,0,0,0,2,0.0,2,0,0,0,1,1,6,3,0,2017-2018,90.0,4.787234042553191,0.0
1242,Boubacar Kamara,FRA,"DF,MF",Marseille,Ligue 1,17,1999,5.1,14,14,9,5,0,8,12,66.7,4,7,3,4,3,17,18,0,0,2017-2018,90.0,52.94117647058824,247.05882352941177
1243,Marcin Kamiński,POL,DF,Stuttgart,Bundesliga,25,1992,12.6,17,14,5,11,1,12,18,66.7,6,12,3,9,30,47,55,0,0,2017-2018,90.0,214.2857142857143,121.42857142857144
1244,Kevin Kampl,SVN,MF,RB Leipzig,Bundesliga,26,1990,22.4,42,33,16,20,6,16,39,41.0,23,37,2,35,33,75,33,0,0,2017-2018,90.0,132.58928571428572,168.75
1245,Kevin Kampl,SVN,MF,Leverkusen,Bundesliga,26,1990,0.3,1,1,1,0,0,1,1,100.0,0,0,0,0,0,1,0,0,0,2017-2018,90.0,0.0,300.0
1246,Harry Kane,ENG,FW,Tottenham,Premier League,24,1993,34.2,17,12,2,8,7,4,15,26.7,11,15,4,11,5,22,19,0,0,2017-2018,90.0,13.157894736842104,44.73684210526316
1247,Wilfried Kanga,CIV,"FW,MF",Angers,Ligue 1,19,1998,1.9,2,2,0,2,0,0,2,0.0,2,0,0,0,0,2,1,0,0,2017-2018,90.0,0.0,94.73684210526315
1248,Mamadou Kanouté,SEN,"FW,MF",Benevento,Serie A,23,1993,0.4,0,0,0,0,0,0,0,0.0,0,0,0,0,1,1,1,0,0,2017-2018,90.0,225.0,0.0
1249,N'Golo Kanté,FRA,MF,Chelsea,Premier League,26,1991,33.3,113,77,55,52,6,33,92,35.9,59,40,4,36,85,198,29,3,0,2017-2018,90.0,229.72972972972974,305.4054054054054
1250,Bartosz Kapustka,POL,"FW,MF",Freiburg,Bundesliga,20,1996,2.6,9,5,2,6,1,4,6,66.7,2,4,0,4,3,12,0,0,0,2017-2018,90.0,103.84615384615384,311.5384615384615
1251,Kenan Karaman,TUR,"MF,FW",Hannover 96,Bundesliga,23,1994,9.5,16,13,9,6,1,6,7,85.7,1,10,4,6,1,17,17,0,0,2017-2018,90.0,9.473684210526315,151.57894736842104
1252,Yann Karamoh,FRA,"FW,MF",Inter,Serie A,19,1998,5.4,3,1,1,1,1,0,3,0.0,3,4,0,4,4,7,1,1,0,2017-2018,90.0,66.66666666666666,49.99999999999999
1253,Loris Karius,GER,GK,Liverpool,Premier League,24,1993,19.0,0,0,0,0,0,0,0,0.0,0,0,0,0,1,1,4,0,0,2017-2018,90.0,4.7368421052631575,0.0
1254,Orestis Karnezis,GRE,GK,Watford,Premier League,32,1985,14.4,0,0,0,0,0,0,2,0.0,2,0,0,0,1,1,3,3,0,2017-2018,90.0,6.25,0.0
1255,Rick Karsdorp,NED,DF,Roma,Serie A,22,1995,0.9,1,1,1,0,0,0,0,0.0,0,0,0,0,1,2,0,0,0,2017-2018,90.0,100.0,100.0
1256,Aleksandar Katai,SRB,"MF,DF",Alavés,La Liga,26,1991,0.6,1,1,0,1,0,0,1,0.0,1,0,0,0,0,1,0,0,0,2017-2018,90.0,0.0,150.0
1257,Florian Kath,GER,"FW,MF",Freiburg,Bundesliga,22,1994,7.5,15,10,3,9,3,9,17,52.9,8,9,0,9,8,23,1,0,0,2017-2018,90.0,96.0,180.0
1258,Ole Käuper,GER,MF,Werder Bremen,Bundesliga,20,1997,0.8,6,5,2,4,0,1,4,25.0,3,1,0,1,2,8,0,0,0,2017-2018,90.0,225.0,675.0
1259,Eiji Kawashima,JPN,GK,Metz,Ligue 1,34,1983,28.5,1,1,1,0,0,1,3,33.3,2,0,0,0,3,4,9,2,0,2017-2018,90.0,9.473684210526317,3.1578947368421053
1260,Beram Kayal,ISR,MF,Brighton,Premier League,29,1988,8.3,18,11,10,7,1,6,26,23.1,20,11,4,7,12,30,9,0,0,2017-2018,90.0,130.12048192771084,195.18072289156623
1261,Joris Kayembe,COD,"FW,MF",Nantes,Ligue 1,22,1994,1.0,1,0,1,0,0,0,4,0.0,4,0,0,0,0,1,4,0,0,2017-2018,90.0,0.0,90.0
1262,Olarenwaju Kayode,NGA,"FW,MF",Girona,La Liga,24,1993,4.3,3,3,1,2,0,0,4,0.0,4,1,0,1,1,4,0,0,0,2017-2018,90.0,20.930232558139537,62.79069767441861
1263,Moise Kean,ITA,FW,Hellas Verona,Serie A,17,2000,12.6,8,5,1,3,4,1,6,16.7,5,6,0,6,7,15,4,0,0,2017-2018,90.0,50.00000000000001,57.142857142857146
1264,Michael Keane,ENG,DF,Everton,Premier League,24,1993,28.4,33,25,26,5,2,19,43,44.2,24,39,28,11,53,86,214,0,0,2017-2018,90.0,167.95774647887325,104.5774647887324
1265,Thilo Kehrer,GER,DF,Schalke 04,Bundesliga,20,1996,26.3,81,64,41,36,4,46,68,67.6,22,42,12,30,35,116,113,2,0,2017-2018,90.0,119.77186311787072,277.18631178707227
1266,Cheick Keita,MLI,DF,Bologna,Serie A,21,1996,1.4,2,2,1,1,0,1,3,33.3,2,5,0,5,2,4,1,0,0,2017-2018,90.0,128.57142857142858,128.57142857142858
1267,Naby Keïta,GUI,MF,RB Leipzig,Bundesliga,22,1995,21.8,65,48,25,33,7,17,43,39.5,26,26,3,23,36,101,18,0,0,2017-2018,90.0,148.62385321100916,268.348623853211
1268,Keko,ESP,"MF,FW",Málaga,La Liga,25,1991,13.4,38,23,17,13,8,15,47,31.9,32,25,3,22,13,51,9,0,0,2017-2018,90.0,87.31343283582089,255.2238805970149
1269,Martin Kelly,ENG,DF,Crystal Palace,Premier League,27,1990,13.3,19,13,15,4,0,14,26,53.8,12,16,11,5,9,28,67,3,0,2017-2018,90.0,60.90225563909774,128.57142857142856
1270,Marc-Oliver Kempf,GER,DF,Freiburg,Bundesliga,22,1995,10.0,13,12,9,4,0,5,8,62.5,3,7,7,0,17,30,52,0,0,2017-2018,90.0,153.0,117.0
1271,Kenedy,BRA,"MF,DF",Newcastle Utd,Premier League,21,1996,11.4,31,17,16,13,2,12,35,34.3,23,12,1,11,14,45,11,0,0,2017-2018,90.0,110.52631578947367,244.73684210526315
1272,Jonjoe Kenny,ENG,DF,Everton,Premier League,20,1997,17.7,41,33,28,10,3,20,32,62.5,12,17,7,10,28,69,95,0,0,2017-2018,90.0,142.3728813559322,208.47457627118646
1273,Ryan Kent,ENG,"FW,MF",Freiburg,Bundesliga,20,1996,2.7,4,3,2,1,1,2,5,40.0,3,6,0,6,1,5,1,0,0,2017-2018,90.0,33.33333333333333,133.33333333333331
1274,Christophe Kerbrat,FRA,DF,Guingamp,Ligue 1,30,1986,36.9,62,45,47,14,1,35,65,53.8,30,49,40,9,62,124,249,2,0,2017-2018,90.0,151.21951219512195,151.21951219512195
1275,Franck Kessié,CIV,MF,Milan,Serie A,20,1996,36.3,48,34,20,19,9,17,44,38.6,27,47,11,36,26,74,45,3,0,2017-2018,90.0,64.46280991735537,119.00826446280992
1276,Billy Ketkeophomphone,LAO,MF,Angers,Ligue 1,27,1990,4.9,14,9,4,5,5,5,15,33.3,10,9,0,9,5,19,8,0,0,2017-2018,90.0,91.83673469387755,257.1428571428571
1277,Driss Khalid,MAR,FW,Toulouse,Ligue 1,18,1999,0.3,1,0,0,0,1,0,0,0.0,0,0,0,0,0,1,2,0,0,2017-2018,90.0,0.0,300.0
1278,Saîf-Eddine Khaoui,TUN,"MF,FW",Troyes,Ligue 1,22,1995,21.7,57,25,22,27,8,15,50,30.0,35,12,2,10,27,84,9,0,0,2017-2018,90.0,111.9815668202765,236.40552995391704
1279,Wahbi Khazri,TUN,"FW,MF",Rennes,Ligue 1,26,1991,21.3,26,18,7,10,9,7,39,17.9,32,29,0,29,7,33,7,0,0,2017-2018,90.0,29.577464788732396,109.85915492957747
1280,Rani Khedira,GER,"MF,DF",Augsburg,Bundesliga,23,1994,25.3,62,47,25,28,9,33,47,70.2,14,41,18,23,36,98,96,0,0,2017-2018,89.99999999999999,128.06324110671935,220.55335968379444
1281,Sami Khedira,GER,MF,Juventus,Serie A,30,1987,21.2,14,9,1,9,4,2,23,8.7,21,13,3,10,20,34,20,0,0,2017-2018,90.0,84.9056603773585,59.43396226415095
1282,Stefan Kießling,GER,"DF,MF",Leverkusen,Bundesliga,33,1984,0.9,0,0,0,0,0,0,0,0.0,0,2,0,2,0,0,1,0,0,2017-2018,90.0,0.0,0.0
1283,Kiké,ESP,FW,Eibar,La Liga,27,1989,27.3,14,8,1,7,6,2,11,18.2,9,15,1,14,10,24,14,0,0,2017-2018,90.0,32.967032967032964,46.15384615384615
1284,Joshua Kimmich,GER,DF,Bayern Munich,Bundesliga,22,1995,25.9,32,23,14,13,5,20,38,52.6,18,26,5,21,20,52,40,0,0,2017-2018,90.0,69.49806949806951,111.19691119691122
1285,Presnel Kimpembe,FRA,DF,Paris S-G,Ligue 1,21,1995,26.9,39,28,20,18,1,9,14,64.3,5,17,10,7,24,63,80,1,0,2017-2018,90.0,80.29739776951673,130.48327137546468
1286,Andy King,WAL,MF,Leicester City,Premier League,28,1988,6.0,8,5,0,5,3,0,3,0.0,3,4,2,2,5,13,13,0,0,2017-2018,90.0,75.0,120.0
1287,Andy King,WAL,MF,Swansea City,Premier League,28,1988,7.9,18,11,10,8,0,5,14,35.7,9,7,0,7,6,24,14,1,0,2017-2018,90.0,68.35443037974683,205.06329113924048
1288,Joshua King,NOR,"FW,MF",Bournemouth,Premier League,25,1992,27.3,36,26,11,17,8,4,27,14.8,23,23,3,20,4,40,14,1,0,2017-2018,90.0,13.186813186813186,118.68131868131867
1289,Simon Kjær,DEN,DF,Sevilla,La Liga,28,1989,17.5,35,24,25,8,2,13,22,59.1,9,16,10,6,32,67,109,0,0,2017-2018,90.0,164.57142857142856,180.0
1290,Davy Klaassen,NED,"MF,FW",Everton,Premier League,24,1993,2.8,3,1,1,2,0,2,6,33.3,4,2,1,1,1,4,2,0,0,2017-2018,90.0,32.142857142857146,96.42857142857143
1291,Felix Klaus,GER,"MF,FW",Hannover 96,Bundesliga,24,1992,22.0,48,38,20,21,7,23,50,46.0,27,29,4,25,8,56,28,0,0,2017-2018,90.0,32.72727272727273,196.36363636363637
1292,Ragnar Klavan,EST,DF,Liverpool,Premier League,31,1985,16.1,14,10,6,7,1,6,12,50.0,6,11,5,6,15,29,85,1,0,2017-2018,90.0,83.85093167701862,78.26086956521739
1293,Tim Kleindienst,GER,"FW,DF",Freiburg,Bundesliga,21,1995,12.6,22,15,6,12,4,4,17,23.5,13,17,3,14,6,28,21,0,0,2017-2018,90.0,42.85714285714286,157.14285714285717
1294,Lukas Klostermann,GER,DF,RB Leipzig,Bundesliga,21,1996,24.3,56,41,34,18,4,28,37,75.7,9,33,6,27,33,89,79,0,0,2017-2018,90.0,122.22222222222221,207.4074074074074
1295,Lukas Klünter,GER,"DF,FW",Köln,Bundesliga,21,1996,14.8,25,20,16,8,1,16,24,66.7,8,11,2,9,13,38,28,1,0,2017-2018,90.0,79.05405405405405,152.02702702702703
1296,Robin Knoche,GER,DF,Wolfsburg,Bundesliga,25,1992,23.4,34,20,26,8,0,25,35,71.4,10,36,24,12,25,59,89,1,0,2017-2018,89.99999999999999,96.15384615384615,130.76923076923077
1297,Anthony Knockaert,FRA,"MF,FW",Brighton,Premier League,25,1991,26.9,39,26,25,11,3,16,55,29.1,39,29,3,26,23,62,16,0,0,2017-2018,90.0,76.95167286245353,130.48327137546468
1298,Törles Knöll,GER,"MF,FW",Hamburger SV,Bundesliga,19,1997,0.2,0,0,0,0,0,0,0,0.0,0,1,0,1,0,0,0,0,0,2017-2018,90.0,0.0,0.0
1299,Robin Koch,GER,"MF,DF",Freiburg,Bundesliga,21,1996,21.3,34,24,21,13,0,10,18,55.6,8,27,11,16,35,69,67,0,0,2017-2018,90.0,147.88732394366198,143.66197183098592
1300,Kenan Kodro,BIH,"FW,DF",Mainz 05,Bundesliga,23,1993,2.6,1,1,0,1,0,0,0,0.0,0,1,0,1,3,4,0,0,0,2017-2018,90.0,103.84615384615384,34.61538461538461
1301,Hervé Koffi,BFA,GK,Lille,Ligue 1,20,1996,4.0,0,0,0,0,0,0,0,0.0,0,0,0,0,1,1,1,1,0,2017-2018,90.0,22.5,0.0
1302,Dominik Kohr,GER,MF,Leverkusen,Bundesliga,23,1994,18.5,49,26,20,25,4,25,41,61.0,16,39,5,34,30,79,24,0,0,2017-2018,90.0,145.94594594594597,238.3783783783784
1303,Seybou Koita,NIG,FW,Amiens,Ligue 1,23,1994,2.4,1,1,1,0,0,1,1,100.0,0,0,0,0,0,1,2,0,0,2017-2018,90.0,0.0,37.5
1304,Koke,ESP,MF,Atlético Madrid,La Liga,25,1992,30.6,75,45,31,32,12,27,95,28.4,68,40,3,37,24,99,38,0,0,2017-2018,90.0,70.58823529411764,220.58823529411762
1305,Aleksandar Kolarov,SRB,DF,Roma,Serie A,31,1985,34.0,58,47,34,16,8,27,49,55.1,22,24,7,17,53,111,100,2,0,2017-2018,90.0,140.29411764705884,153.52941176470588
1306,Sead Kolašinac,BIH,DF,Arsenal,Premier League,24,1993,23.9,49,37,28,13,8,20,39,51.3,19,15,3,12,26,75,56,0,0,2017-2018,90.0,97.90794979079499,184.51882845188285
1307,Vincent Kompany,BEL,DF,Manchester City,Premier League,31,1986,15.5,20,11,14,5,1,13,19,68.4,6,10,8,2,16,36,73,1,0,2017-2018,90.0,92.90322580645162,116.12903225806451
1308,Ibrahima Konaté,FRA,DF,RB Leipzig,Bundesliga,18,1999,13.6,32,25,20,12,0,18,23,78.3,5,14,3,11,20,52,66,0,0,2017-2018,90.0,132.35294117647058,211.76470588235293
1309,Moussa Konaté,SEN,FW,Amiens,Ligue 1,24,1993,27.5,8,6,1,4,3,3,23,13.0,20,10,2,8,3,11,11,0,0,2017-2018,89.99999999999999,9.818181818181817,26.18181818181818
1310,Geoffrey Kondogbia,CTA,MF,Valencia,La Liga,24,1993,29.0,88,57,38,43,7,23,68,33.8,45,46,14,32,62,150,66,0,0,2017-2018,90.0,192.41379310344826,273.10344827586204
1311,Bakary Koné,BFA,DF,Strasbourg,Ligue 1,29,1988,27.4,26,17,23,3,0,12,31,38.7,19,20,10,10,33,59,122,2,0,2017-2018,90.0,108.39416058394161,85.4014598540146
1312,Terence Kongolo,NED,DF,Huddersfield,Premier League,23,1994,11.7,33,20,19,13,1,14,22,63.6,8,12,6,6,32,65,71,0,0,2017-2018,89.99999999999999,246.15384615384613,253.84615384615384
1313,Terence Kongolo,NED,DF,Monaco,Ligue 1,23,1994,2.9,6,4,4,2,0,0,2,0.0,2,5,3,2,5,11,14,0,0,2017-2018,90.0,155.17241379310346,186.20689655172413
1314,Yevhen Konoplyanka,UKR,"FW,MF",Schalke 04,Bundesliga,27,1989,17.4,11,9,3,4,4,3,11,27.3,8,18,1,17,5,16,6,0,0,2017-2018,90.0,25.862068965517242,56.89655172413793
1315,Julian Korb,GER,"DF,MF",Hannover 96,Bundesliga,25,1992,26.0,52,41,27,19,6,37,68,54.4,31,30,2,28,22,74,77,0,0,2017-2018,90.00000000000001,76.15384615384616,180.00000000000003
1316,Laurent Koscielny,FRA,DF,Arsenal,Premier League,31,1985,24.7,43,21,27,12,4,19,33,57.6,14,28,15,13,54,97,138,3,0,2017-2018,90.0,196.76113360323887,156.68016194331983
1317,Filip Kostić,SRB,"FW,MF",Hamburger SV,Bundesliga,24,1992,27.1,48,38,16,21,11,20,41,48.8,21,42,1,41,10,58,12,0,0,2017-2018,90.0,33.210332103321036,159.40959409594097
1318,Christian Kouakou,CIV,"MF,FW",Caen,Ligue 1,26,1991,9.4,24,13,14,8,2,5,19,26.3,14,16,1,15,8,32,6,1,0,2017-2018,90.0,76.59574468085106,229.78723404255317
1319,Rominigue Kouamé,MLI,"DF,MF",Lille,Ligue 1,20,1996,2.2,5,2,2,2,1,2,3,66.7,1,1,0,1,5,10,0,0,0,2017-2018,90.0,204.54545454545453,204.54545454545453
1320,Tomáš Koubek,CZE,GK,Rennes,Ligue 1,24,1992,34.0,0,0,0,0,0,0,1,0.0,1,0,0,0,3,3,22,3,0,2017-2018,90.0,7.9411764705882355,0.0
1321,Kalidou Koulibaly,SEN,DF,Napoli,Serie A,26,1991,34.1,54,42,31,19,4,20,40,50.0,20,36,16,20,40,94,119,3,0,2017-2018,90.0,105.57184750733138,142.52199413489737
1322,Jules Koundé,FRA,DF,Bordeaux,Ligue 1,18,1998,17.7,26,19,19,7,0,13,17,76.5,4,14,11,3,14,40,97,0,0,2017-2018,90.0,71.1864406779661,132.20338983050848
1323,Cheikhou Kouyaté,SEN,MF,West Ham,Premier League,27,1989,31.1,71,49,43,26,2,23,62,37.1,39,31,11,20,32,103,56,1,0,2017-2018,90.0,92.60450160771704,205.46623794212218
1324,Mateo Kovačić,CRO,MF,Real Madrid,La Liga,23,1994,11.0,37,27,19,18,0,8,27,29.6,19,9,4,5,5,42,5,0,0,2017-2018,90.0,40.909090909090914,302.72727272727275
1325,Maksym Koval,UKR,GK,La Coruña,La Liga,24,1992,1.3,0,0,0,0,0,0,0,0.0,0,0,0,0,0,0,0,2,0,2017-2018,90.0,0.0,0.0
1326,Dawid Kownacki,POL,FW,Sampdoria,Serie A,20,1997,9.1,8,7,1,4,3,3,11,27.3,8,7,0,7,1,9,5,0,0,2017-2018,90.0,9.89010989010989,79.12087912087912
1327,Vincent Koziello,FRA,MF,Nice,Ligue 1,21,1995,9.0,16,8,9,5,2,5,16,31.3,11,8,3,5,19,35,7,1,0,2017-2018,90.0,190.0,160.0
1328,Vincent Koziello,FRA,MF,Köln,Bundesliga,21,1995,8.8,28,21,6,21,1,10,21,47.6,11,9,0,9,10,38,5,1,0,2017-2018,90.0,102.27272727272727,286.3636363636364
1329,Thomas Kraft,GER,GK,Hertha BSC,Bundesliga,29,1988,3.0,0,0,0,0,0,0,0,0.0,0,0,0,0,0,0,1,0,0,2017-2018,90.0,0.0,0.0
1330,Emil Krafth,SWE,DF,Bologna,Serie A,22,1994,10.5,23,16,14,8,1,10,19,52.6,9,12,4,8,16,39,39,1,0,2017-2018,90.0,137.14285714285714,197.14285714285714
1331,Oliver Kragl,GER,MF,Crotone,Serie A,27,1990,1.1,1,0,0,1,0,0,0,0.0,0,1,0,1,2,3,2,0,0,2017-2018,90.0,163.63636363636363,81.81818181818181
1332,Andrej Kramarić,CRO,"FW,MF",Hoffenheim,Bundesliga,26,1991,24.8,8,6,4,3,1,3,8,37.5,5,15,0,15,6,14,7,0,0,2017-2018,90.0,21.774193548387096,29.032258064516128
1333,Christoph Kramer,GER,MF,Gladbach,Bundesliga,26,1991,23.9,89,70,43,34,12,39,76,51.3,37,29,4,25,43,132,37,1,0,2017-2018,90.0,161.9246861924686,335.1464435146444
1334,Ladislav Krejčí,CZE,"MF,FW",Bologna,Serie A,25,1992,4.4,7,5,1,3,3,1,5,20.0,4,3,0,3,2,9,3,0,0,2017-2018,90.0,40.90909090909091,143.1818181818182
1335,Rene Krhin,SVN,MF,Nantes,Ligue 1,27,1990,14.6,18,12,7,11,0,3,17,17.6,14,11,2,9,16,34,39,0,0,2017-2018,90.0,98.63013698630138,110.95890410958904
1336,Bojan Krkić,ESP,MF,Stoke City,Premier League,26,1990,0.8,0,0,0,0,0,0,1,0.0,1,1,0,1,0,0,0,0,0,2017-2018,90.0,0.0,0.0
1337,Bojan Krkić,ESP,"FW,MF",Alavés,La Liga,26,1990,4.9,2,1,1,1,0,1,2,50.0,1,5,0,5,3,5,0,0,0,2017-2018,90.0,55.10204081632653,36.73469387755102
1338,Michael Krohn-Dehli,DEN,MF,La Coruña,La Liga,34,1983,8.1,12,9,6,5,1,4,17,23.5,13,2,0,2,13,25,7,0,0,2017-2018,90.0,144.44444444444446,133.33333333333334
1339,Michael Krohn-Dehli,DEN,"MF,FW",Sevilla,La Liga,34,1983,6.0,13,7,4,5,4,6,11,54.5,5,5,0,5,4,17,7,0,0,2017-2018,90.0,60.0,195.0
1340,Toni Kroos,GER,MF,Real Madrid,La Liga,27,1990,25.1,55,35,19,29,7,22,59,37.3,37,20,2,18,16,71,10,1,0,2017-2018,90.0,57.37051792828685,197.21115537848604
1341,Max Kruse,GER,FW,Werder Bremen,Bundesliga,29,1988,27.3,17,12,3,10,4,5,22,22.7,17,9,0,9,11,28,4,1,0,2017-2018,90.0,36.26373626373626,56.043956043956044
1342,Grzegorz Krychowiak,POL,MF,West Brom,Premier League,27,1990,18.2,39,24,18,17,4,12,49,24.5,37,23,5,18,45,84,23,0,0,2017-2018,90.0,222.52747252747253,192.85714285714286
1343,Lukas Kübler,GER,"DF,MF",Freiburg,Bundesliga,24,1992,12.8,31,19,16,15,0,13,23,56.5,10,15,6,9,18,49,41,0,0,2017-2018,90.0,126.5625,217.96875
1344,Jasmin Kurtić,SVN,"MF,FW",SPAL,Serie A,28,1989,16.0,28,18,13,11,4,5,21,23.8,16,13,1,12,17,45,25,0,0,2017-2018,90.0,95.625,157.5
1345,Jasmin Kurtić,SVN,MF,Atalanta,Serie A,28,1989,7.4,12,7,6,3,3,3,7,42.9,4,7,0,7,5,17,4,0,0,2017-2018,90.0,60.81081081081081,145.94594594594594
1346,Layvin Kurzawa,FRA,DF,Paris S-G,Ligue 1,24,1992,18.9,44,32,20,15,9,15,39,38.5,24,16,3,13,35,79,41,2,0,2017-2018,90.0,166.66666666666669,209.52380952380952
1347,Filip Kusić,SRB,"DF,MF",Köln,Bundesliga,21,1996,0.2,0,0,0,0,0,0,0,0.0,0,0,0,0,0,0,1,0,0,2017-2018,90.0,0.0,0.0
1348,Zdravko Kuzmanović,SRB,MF,Málaga,La Liga,29,1987,5.3,4,4,1,3,0,0,5,0.0,5,2,2,0,4,8,9,0,0,2017-2018,90.0,67.9245283018868,67.9245283018868
1349,Han Kwang-song,PRK,FW,Cagliari,Serie A,18,1998,3.1,1,1,0,0,1,0,4,0.0,4,4,0,4,0,1,0,0,0,2017-2018,90.0,0.0,29.032258064516128
1350,Enock Kwateng,FRA,DF,Nantes,Ligue 1,20,1997,1.0,8,6,6,2,0,7,11,63.6,4,2,0,2,1,9,7,0,0,2017-2018,90.0,90.0,720.0
1351,Alberto de la Bella,ESP,DF,Real Sociedad,La Liga,31,1985,17.0,36,22,25,10,1,16,28,57.1,12,19,5,14,21,57,54,0,0,2017-2018,90.0,111.17647058823529,190.58823529411765
1352,Rajiv van La Parra,NED,"FW,MF",Huddersfield,Premier League,26,1991,23.7,41,29,18,15,8,12,41,29.3,29,27,1,26,21,62,8,1,0,2017-2018,90.0,79.74683544303798,155.69620253164558
1353,Brighton Labeau,MTQ,FW,Amiens,Ligue 1,21,1996,0.3,0,0,0,0,0,0,0,0.0,0,0,0,0,0,0,0,0,0,2017-2018,90.0,0.0,0.0
1354,Gaëtan Laborde,FRA,FW,Bordeaux,Ligue 1,23,1994,10.6,9,7,1,6,2,2,7,28.6,5,8,2,6,1,10,7,1,0,2017-2018,90.0,8.49056603773585,76.41509433962264
1355,Alexandre Lacazette,FRA,FW,Arsenal,Premier League,26,1991,24.5,24,17,6,11,7,4,27,14.8,23,19,3,16,7,31,5,0,0,2017-2018,90.00000000000001,25.714285714285715,88.16326530612245
1356,Mehdi Lacen,ALG,MF,Málaga,La Liga,33,1984,11.7,35,19,18,17,0,14,38,36.8,24,13,1,12,15,50,11,0,0,2017-2018,89.99999999999999,115.38461538461539,269.2307692307692
1357,Mehdi Lacen,ALG,MF,Getafe,La Liga,33,1984,0.7,3,1,2,1,0,0,0,0.0,0,1,0,1,0,3,1,0,0,2017-2018,90.0,0.0,385.7142857142857
1358,Léo Lacroix,SUI,DF,Saint-Étienne,Ligue 1,25,1992,8.6,13,8,8,5,0,5,9,55.6,4,6,3,3,11,24,54,1,0,2017-2018,90.0,115.11627906976746,136.046511627907
1359,Freddie Ladapo,ENG,FW,Crystal Palace,Premier League,24,1993,0.2,0,0,0,0,0,0,0,0.0,0,0,0,0,0,0,0,0,0,2017-2018,90.0,0.0,0.0
1360,Alban Lafont,FRA,GK,Toulouse,Ligue 1,18,1999,38.0,1,0,1,0,0,1,4,25.0,3,0,0,0,2,3,20,5,0,2017-2018,90.0,4.7368421052631575,2.3684210526315788
1361,Víctor Laguardia,ESP,DF,Alavés,La Liga,27,1989,17.0,20,15,13,5,2,11,19,57.9,8,23,14,9,29,49,109,0,0,2017-2018,90.0,153.52941176470588,105.88235294117648
1362,Konrad Laimer,AUT,"DF,MF",RB Leipzig,Bundesliga,20,1997,14.9,57,39,31,22,4,28,57,49.1,29,37,2,35,11,68,32,0,0,2017-2018,90.0,66.44295302013423,344.29530201342277
1363,Kenny Lala,MAD,DF,Strasbourg,Ligue 1,25,1991,30.3,87,47,53,28,6,21,47,44.7,26,18,10,8,42,129,70,2,0,2017-2018,90.0,124.75247524752476,258.4158415841584
1364,Adam Lallana,ENG,"MF,FW",Liverpool,Premier League,29,1988,3.4,3,1,3,0,0,2,10,20.0,8,3,0,3,1,4,1,0,0,2017-2018,90.0,26.470588235294116,79.41176470588235
1365,Eugenio Lamanna,ITA,GK,Genoa,Serie A,27,1989,1.0,0,0,0,0,0,0,0,0.0,0,0,0,0,0,0,1,0,0,2017-2018,90.0,0.0,0.0
1366,Érik Lamela,ARG,"FW,MF",Tottenham,Premier League,25,1992,9.4,23,13,9,7,7,3,20,15.0,17,11,1,10,7,30,5,0,0,2017-2018,90.0,67.02127659574468,220.2127659574468
1367,Ádám Lang,HUN,DF,Dijon,Ligue 1,24,1993,2.6,3,1,3,0,0,3,5,60.0,2,2,1,1,3,6,12,0,0,2017-2018,90.0,103.84615384615384,103.84615384615384
1368,Sebastian Langkamp,GER,DF,Hertha BSC,Bundesliga,29,1988,10.6,15,12,9,6,0,11,18,61.1,7,7,4,3,21,36,58,1,0,2017-2018,90.0,178.30188679245285,127.35849056603774
1369,Sebastian Langkamp,GER,DF,Werder Bremen,Bundesliga,29,1988,4.6,7,3,4,3,0,4,4,100.0,0,7,5,2,8,15,18,0,0,2017-2018,90.0,156.52173913043478,136.95652173913044
1370,Manuel Lanzini,ARG,"MF,FW",West Ham,Premier League,24,1993,22.7,20,11,6,11,3,2,34,5.9,32,7,1,6,30,50,5,2,0,2017-2018,89.99999999999999,118.94273127753303,79.29515418502203
1371,Gianluca Lapadula,PER,FW,Genoa,Serie A,27,1990,16.6,8,5,4,4,0,1,11,9.1,10,7,1,6,3,11,8,0,0,2017-2018,90.0,16.265060240963855,43.37349397590361
1372,Aymeric Laporte,ESP,DF,Manchester City,Premier League,23,1994,9.0,8,7,6,2,0,3,8,37.5,5,2,1,1,11,19,27,0,0,2017-2018,90.0,110.0,80.0
1373,Aymeric Laporte,ESP,DF,Athletic Club,La Liga,23,1994,19.0,38,23,27,11,0,14,25,56.0,11,19,13,6,27,65,94,1,0,2017-2018,90.0,127.89473684210526,180.0
1374,Danilo Larangeira,BRA,DF,Udinese,Serie A,33,1984,30.8,35,21,26,8,1,16,29,55.2,13,50,38,12,50,85,161,2,0,2017-2018,90.0,146.10389610389612,102.27272727272728
1375,Kevin Lasagna,ITA,FW,Udinese,Serie A,24,1992,23.7,10,7,0,8,2,2,7,28.6,5,27,4,23,8,18,18,0,0,2017-2018,90.0,30.37974683544304,37.9746835443038
1376,Jamaal Lascelles,ENG,DF,Newcastle Utd,Premier League,23,1993,32.5,31,19,19,11,1,12,19,63.2,7,33,24,9,28,59,232,1,0,2017-2018,90.0,77.53846153846153,85.84615384615385
1377,Paul Lasne,FRA,MF,Montpellier,Ligue 1,28,1989,34.0,68,45,27,39,2,12,54,22.2,42,20,1,19,57,125,26,0,0,2017-2018,90.0,150.88235294117646,180.0
1378,Borja Lasso,ESP,MF,Sevilla,La Liga,23,1994,0.6,4,1,2,2,0,1,2,50.0,1,3,0,3,0,4,0,0,0,2017-2018,90.0,0.0,600.0
1379,Toni Lato,ESP,"DF,MF",Valencia,La Liga,19,1997,8.9,30,16,22,6,2,16,27,59.3,11,9,3,6,9,39,23,0,0,2017-2018,90.0,91.01123595505618,303.3707865168539
1380,Danny Latza,GER,MF,Mainz 05,Bundesliga,27,1989,26.1,67,48,28,33,6,33,73,45.2,40,43,8,35,26,93,47,1,0,2017-2018,90.0,89.6551724137931,231.03448275862067
1381,Vincent Laurini,FRA,DF,Fiorentina,Serie A,28,1989,17.9,34,23,21,9,4,12,22,54.5,10,20,5,15,11,45,72,1,0,2017-2018,90.0,55.30726256983241,170.9497206703911
1382,Wesley Lautoa,NCL,"DF,MF",Dijon,Ligue 1,29,1987,6.9,17,13,11,6,0,6,12,50.0,6,10,4,6,19,36,24,1,0,2017-2018,90.0,247.82608695652172,221.7391304347826
1383,Diego Laxalt,URU,DF,Genoa,Serie A,24,1993,31.2,54,43,31,17,6,22,59,37.3,37,38,3,35,25,79,55,1,0,2017-2018,90.0,72.11538461538461,155.76923076923077
1384,Miguel Layún,MEX,DF,Sevilla,La Liga,29,1988,13.2,28,19,14,12,2,17,36,47.2,19,18,4,14,15,43,44,1,0,2017-2018,90.0,102.27272727272727,190.9090909090909
1385,Achraf Lazaar,MAR,"MF,DF",Benevento,Serie A,25,1992,5.3,12,8,9,2,1,5,11,45.5,6,5,1,4,6,18,10,0,0,2017-2018,90.0,101.88679245283019,203.77358490566039
1386,Valentino Lazaro,AUT,"MF,FW",Hertha BSC,Bundesliga,21,1996,20.7,33,28,11,12,10,15,31,48.4,16,35,2,33,15,48,32,0,0,2017-2018,90.0,65.21739130434783,143.47826086956522
1387,Darko Lazović,SRB,"DF,MF",Genoa,Serie A,26,1990,13.8,19,12,16,2,1,9,18,50.0,9,8,0,8,13,32,12,0,0,2017-2018,90.0,84.78260869565217,123.91304347826086
1388,Manuel Lazzari,ITA,DF,SPAL,Serie A,23,1993,34.6,61,47,33,21,7,27,62,43.5,35,32,7,25,31,92,73,2,0,2017-2018,90.0,80.635838150289,158.67052023121386
1389,Mickaël Le Bihan,FRA,"FW,MF",Nice,Ligue 1,27,1990,1.2,0,0,0,0,0,0,3,0.0,3,0,0,0,1,1,0,0,0,2017-2018,90.0,75.0,0.0
1390,Maxime Le Marchand,FRA,DF,Nice,Ligue 1,27,1989,28.2,48,36,28,18,2,20,41,48.8,21,36,13,23,65,113,105,4,0,2017-2018,89.99999999999999,207.44680851063828,153.1914893617021
1391,James Lea Siliki,CMR,MF,Rennes,Ligue 1,21,1996,20.2,31,21,9,19,3,6,41,14.6,35,21,1,20,18,49,14,1,0,2017-2018,90.0,80.1980198019802,138.11881188118812
1392,Mathew Leckie,AUS,"FW,MF",Hertha BSC,Bundesliga,26,1991,20.6,35,30,16,15,4,20,35,57.1,15,26,3,23,19,54,32,1,0,2017-2018,90.0,83.00970873786407,152.9126213592233
1393,Benjamin Lecomte,FRA,GK,Montpellier,Ligue 1,26,1991,38.0,1,1,1,0,0,0,0,0.0,0,1,0,1,0,1,14,1,0,2017-2018,90.0,0.0,2.3684210526315788
1394,Pierre Lees-Melou,FRA,"MF,FW",Nice,Ligue 1,24,1993,32.1,78,47,29,39,10,27,76,35.5,49,52,11,41,34,112,38,2,0,2017-2018,90.0,95.32710280373831,218.69158878504672
1395,Matthias Lehmann,GER,MF,Köln,Bundesliga,34,1983,16.8,33,23,14,18,1,17,29,58.6,12,15,7,8,26,59,24,1,0,2017-2018,90.0,139.28571428571428,176.78571428571428
1396,Lucas Leiva,BRA,MF,Lazio,Serie A,30,1987,32.0,107,80,43,59,5,29,100,29.0,71,33,7,26,70,177,59,0,0,2017-2018,90.0,196.875,300.9375
1397,Florian Lejeune,FRA,DF,Newcastle Utd,Premier League,26,1991,23.4,34,20,26,8,0,14,30,46.7,16,21,15,6,46,80,154,0,0,2017-2018,89.99999999999999,176.9230769230769,130.76923076923077
1398,Iñigo Lekue,ESP,"DF,FW",Athletic Club,La Liga,24,1993,23.5,71,42,37,26,8,34,53,64.2,19,29,3,26,16,87,46,1,0,2017-2018,90.0,61.27659574468085,271.9148936170213
1399,Thomas Lemar,FRA,"MF,FW",Monaco,Ligue 1,21,1995,26.4,33,17,9,19,5,10,41,24.4,31,22,1,21,18,51,16,1,0,2017-2018,90.0,61.36363636363637,112.5
1400,Mario Lemina,GAB,MF,Southampton,Premier League,23,1993,19.1,55,40,21,29,5,12,30,40.0,18,18,6,12,36,91,36,4,0,2017-2018,90.0,169.63350785340313,259.16230366492147
1401,Mauricio Lemos,URU,DF,Sassuolo,Serie A,21,1995,7.8,11,9,8,3,0,7,14,50.0,7,10,5,5,9,20,33,1,0,2017-2018,90.0,103.84615384615384,126.92307692307692
1402,Mauricio Lemos,URU,"DF,MF",Las Palmas,La Liga,21,1995,14.0,22,10,17,5,0,15,27,55.6,12,16,13,3,25,47,51,1,0,2017-2018,90.0,160.71428571428572,141.42857142857142
1403,Dylan Lempereur,FRA,DF,Metz,Ligue 1,18,1998,1.6,5,3,3,1,1,2,6,33.3,4,1,0,1,0,5,6,0,0,2017-2018,90.0,0.0,281.25
1404,Clément Lenglet,FRA,DF,Sevilla,La Liga,22,1995,33.3,67,50,32,35,0,21,38,55.3,17,44,27,17,35,102,157,1,0,2017-2018,90.0,94.5945945945946,181.0810810810811
1405,Aaron Lennon,ENG,MF,Burnley,Premier League,30,1987,12.4,20,14,5,14,1,2,20,10.0,18,20,5,15,8,28,18,0,0,2017-2018,90.0,58.064516129032256,145.16129032258064
1406,Aaron Lennon,ENG,"FW,MF",Everton,Premier League,30,1987,8.8,17,10,10,5,2,5,21,23.8,16,13,1,12,11,28,9,0,0,2017-2018,90.0,112.5,173.86363636363635
1407,Bernd Leno,GER,GK,Leverkusen,Bundesliga,25,1992,33.0,0,0,0,0,0,0,1,0.0,1,0,0,0,1,1,11,2,0,2017-2018,90.0,2.7272727272727275,0.0
1408,Pedro León,ESP,"FW,MF",Eibar,La Liga,30,1986,10.3,9,4,0,2,7,0,4,0.0,4,18,2,16,9,18,5,0,0,2017-2018,90.0,78.64077669902913,78.64077669902913
1409,Sergio León,ESP,FW,Betis,La Liga,28,1989,22.0,13,7,3,6,4,3,11,27.3,8,12,1,11,6,19,5,0,0,2017-2018,90.0,24.545454545454547,53.18181818181819
1410,Lukas Lerager,DEN,MF,Bordeaux,Ligue 1,24,1993,36.5,107,74,33,61,13,33,107,30.8,74,44,8,36,67,174,66,1,0,2017-2018,90.0,165.2054794520548,263.83561643835617
1411,Mehdi Léris,ALG,"MF,FW",Chievo,Serie A,19,1998,0.5,1,1,1,0,0,0,1,0.0,1,0,0,0,1,2,0,0,0,2017-2018,90.0,180.0,180.0
1412,Jefferson Lerma,COL,MF,Levante,La Liga,22,1994,23.7,51,35,26,23,2,17,45,37.8,28,25,10,15,49,100,43,0,0,2017-2018,90.0,186.0759493670886,193.6708860759494
1413,Maxime Lestienne,BEL,MF,Málaga,La Liga,25,1992,7.4,8,5,5,0,3,3,15,20.0,12,7,1,6,6,14,6,0,0,2017-2018,90.0,72.97297297297297,97.29729729729729
1414,Alexandre Letellier,FRA,GK,Angers,Ligue 1,26,1990,13.0,0,0,0,0,0,0,0,0.0,0,0,0,0,0,0,1,2,0,2017-2018,90.00000000000001,0.0,0.0
1415,Gaetano Letizia,ITA,DF,Benevento,Serie A,27,1990,23.8,36,26,21,14,1,19,49,38.8,30,24,3,21,33,69,47,3,0,2017-2018,90.00000000000001,124.78991596638656,136.1344537815126
1416,Timo Letschert,NED,DF,Sassuolo,Serie A,24,1993,4.6,13,8,10,3,0,5,8,62.5,3,9,3,6,7,20,23,0,0,2017-2018,90.0,136.95652173913044,254.34782608695653
1417,Robert Lewandowski,POL,FW,Bayern Munich,Bundesliga,28,1988,24.1,5,3,1,1,3,0,3,0.0,3,6,0,6,5,10,10,0,0,2017-2018,90.0,18.672199170124482,18.672199170124482
1418,Igor Lewczuk,POL,DF,Bordeaux,Ligue 1,32,1985,4.9,9,7,5,3,1,3,6,50.0,3,2,2,0,7,16,11,0,0,2017-2018,90.0,128.57142857142856,165.30612244897958
1419,Stephan Lichtsteiner,SUI,DF,Juventus,Serie A,33,1984,18.9,31,27,16,10,5,9,17,52.9,8,11,2,9,15,46,38,1,0,2017-2018,90.0,71.42857142857143,147.61904761904762
1420,Dimitri Liénard,FRA,"MF,FW",Strasbourg,Ligue 1,29,1988,28.9,77,51,37,32,8,30,84,35.7,54,35,2,33,52,129,41,1,0,2017-2018,90.00000000000001,161.9377162629758,239.79238754325263
1421,Philipp Lienhart,AUT,DF,Freiburg,Bundesliga,21,1996,9.6,16,14,12,4,0,6,17,35.3,11,14,9,5,11,27,60,0,0,2017-2018,90.0,103.125,150.0
1422,Lucas Lima,BRA,"DF,FW",Nantes,Ligue 1,25,1991,29.5,73,46,40,27,6,31,68,45.6,37,42,6,36,38,111,85,0,0,2017-2018,90.0,115.9322033898305,222.71186440677965
1423,Victor Lindelöf,SWE,DF,Manchester Utd,Premier League,23,1994,14.3,17,11,10,6,1,9,14,64.3,5,15,11,4,13,30,67,1,0,2017-2018,90.0,81.81818181818183,106.993006993007
1424,Karol Linetty,POL,MF,Sampdoria,Serie A,22,1995,23.8,66,49,25,31,10,17,77,22.1,60,40,2,38,18,84,13,0,0,2017-2018,90.00000000000001,68.0672268907563,249.57983193277312
1425,Jesse Lingard,ENG,"MF,FW",Manchester Utd,Premier League,24,1992,20.2,30,21,10,13,7,5,27,18.5,22,18,3,15,9,39,13,0,0,2017-2018,90.0,40.0990099009901,133.66336633663366
1426,Pol Lirola,ESP,"DF,FW",Sassuolo,Serie A,19,1997,22.5,34,21,26,6,2,20,35,57.1,15,11,4,7,28,62,88,1,0,2017-2018,90.0,112.0,136.0
1427,Jake Livermore,ENG,MF,West Brom,Premier League,27,1989,29.7,72,41,27,35,10,24,64,37.5,40,44,9,35,26,98,36,2,0,2017-2018,90.0,78.78787878787878,218.18181818181816
1428,Raúl Lizoain,ESP,GK,Las Palmas,La Liga,26,1991,11.0,1,0,1,0,0,1,3,33.3,2,0,0,0,1,2,2,3,0,2017-2018,90.0,8.181818181818182,8.181818181818182
1429,Adem Ljajić,SRB,"MF,FW",Torino,Serie A,25,1991,24.1,12,9,4,6,2,5,13,38.5,8,11,1,10,9,21,13,0,0,2017-2018,90.0,33.60995850622407,44.81327800829875
1430,Diego Llorente,ESP,DF,Real Sociedad,La Liga,23,1993,25.8,30,22,16,13,1,18,29,62.1,11,41,18,23,43,73,96,0,0,2017-2018,90.0,150.0,104.65116279069767
1431,Fernando Llorente,ESP,"FW,MF",Tottenham,Premier League,32,1985,2.6,6,3,1,2,3,1,2,50.0,1,0,0,0,0,6,6,0,0,2017-2018,90.0,0.0,207.69230769230768
1432,Marcos Llorente,ESP,MF,Real Madrid,La Liga,22,1995,6.1,15,8,7,8,0,6,11,54.5,5,7,0,7,5,20,8,0,0,2017-2018,90.0,73.7704918032787,221.31147540983608
1433,Hugo Lloris,FRA,GK,Tottenham,Premier League,30,1986,36.0,1,1,1,0,0,1,4,25.0,3,0,0,0,2,3,34,8,0,2017-2018,90.0,5.0,2.5
1434,Giovani Lo Celso,ARG,MF,Paris S-G,Ligue 1,21,1996,19.7,77,58,26,36,15,26,74,35.1,48,30,5,25,19,96,12,1,0,2017-2018,90.0,86.80203045685279,351.7766497461929
1435,Simone Lo Faso,ITA,FW,Fiorentina,Serie A,19,1998,0.4,1,1,1,0,0,0,1,0.0,1,0,0,0,1,2,0,0,0,2017-2018,90.0,225.0,225.0
1436,Stanislav Lobotka,SVK,MF,Celta Vigo,La Liga,22,1994,34.0,64,45,24,35,5,23,65,35.4,42,25,9,16,39,103,22,0,0,2017-2018,90.0,103.23529411764706,169.41176470588235
1437,Jürgen Locadia,CUW,"FW,MF",Brighton,Premier League,23,1993,2.5,1,0,0,1,0,0,1,0.0,1,0,0,0,1,2,1,1,0,2017-2018,90.0,36.0,36.0
1438,Manuel Locatelli,ITA,MF,Milan,Serie A,19,1998,7.6,16,13,6,9,1,4,18,22.2,14,10,2,8,9,25,13,0,0,2017-2018,90.0,106.57894736842105,189.4736842105263
1439,Ruben Loftus-Cheek,ENG,MF,Crystal Palace,Premier League,21,1996,20.8,21,15,7,13,1,7,30,23.3,23,19,2,17,22,43,31,0,0,2017-2018,90.0,95.19230769230768,90.86538461538461
1440,Enzo Loiodice,FRA,MF,Dijon,Ligue 1,16,2000,1.9,9,5,4,5,0,4,7,57.1,3,0,0,0,2,11,0,0,0,2017-2018,90.0,94.73684210526315,426.3157894736842
1441,Joe Lolley,ENG,"FW,MF",Huddersfield,Premier League,24,1992,2.5,2,0,1,1,0,0,2,0.0,2,0,0,0,3,5,2,1,0,2017-2018,90.0,108.0,72.0
1442,David Lombán,ESP,DF,Eibar,La Liga,30,1987,11.0,16,8,12,3,1,10,15,66.7,5,6,4,2,29,45,66,2,0,2017-2018,90.0,237.27272727272728,130.9090909090909
1443,Cristiano Lombardi,ITA,"MF,DF",Benevento,Serie A,21,1995,12.4,25,19,16,7,2,6,27,22.2,21,12,2,10,13,38,22,0,0,2017-2018,90.0,94.35483870967742,181.4516129032258
1444,Kevin Long,IRL,DF,Burnley,Premier League,26,1990,16.0,32,23,28,4,0,16,26,61.5,10,25,14,11,19,51,129,1,0,2017-2018,90.0,106.875,180.0
1445,Shane Long,IRL,FW,Southampton,Premier League,30,1987,17.6,25,20,1,19,5,10,30,33.3,20,14,2,12,12,37,29,0,0,2017-2018,90.0,61.36363636363636,127.84090909090908
1446,Ademola Lookman,NGA,"FW,MF",Everton,Premier League,19,1997,1.8,1,1,0,1,0,0,2,0.0,2,2,0,2,1,2,3,0,0,2017-2018,90.0,50.0,50.0
1447,Ademola Lookman,NGA,"MF,FW",RB Leipzig,Bundesliga,19,1997,6.4,5,4,2,3,0,0,0,0.0,0,3,0,3,2,7,2,0,0,2017-2018,90.0,28.125,70.3125
1448,Anthony Lopes,POR,GK,Lyon,Ligue 1,26,1990,34.0,0,0,0,0,0,0,0,0.0,0,0,0,0,1,1,17,4,0,2017-2018,90.0,2.6470588235294117,0.0
1449,Rony Lopes,POR,"FW,MF",Monaco,Ligue 1,21,1995,28.1,55,32,15,27,13,21,78,26.9,57,23,2,21,16,71,22,0,0,2017-2018,90.0,51.245551601423486,176.15658362989322
1450,Adrián López,ESP,"FW,MF",La Coruña,La Liga,29,1988,26.1,24,14,11,8,5,7,25,28.0,18,22,4,18,10,34,49,0,0,2017-2018,90.0,34.48275862068965,82.75862068965516
1451,Alberto López,ESP,DF,Málaga,La Liga,22,1995,0.5,1,1,0,1,0,1,1,100.0,0,1,0,1,2,3,2,0,0,2017-2018,90.0,360.0,180.0
1452,Andoni López,ESP,DF,Athletic Club,La Liga,21,1996,1.0,1,0,1,0,0,1,1,100.0,0,1,0,1,1,2,6,0,0,2017-2018,90.0,90.0,90.0
1453,David López,ESP,"DF,MF",Espanyol,La Liga,27,1989,37.0,67,49,47,19,1,27,54,50.0,27,43,26,17,67,134,161,0,0,2017-2018,90.0,162.97297297297297,162.97297297297297
1454,Diego López,ESP,GK,Espanyol,La Liga,35,1981,9.5,0,0,0,0,0,0,1,0.0,1,0,0,0,0,0,1,0,0,2017-2018,90.0,0.0,0.0
1455,Iván López,ESP,DF,Levante,La Liga,23,1993,1.9,1,1,1,0,0,0,0,0.0,0,2,2,0,8,9,2,0,0,2017-2018,90.0,378.9473684210526,47.368421052631575
1456,Javi López,ESP,DF,Espanyol,La Liga,31,1986,10.7,47,35,31,12,4,18,35,51.4,17,7,2,5,18,65,48,0,0,2017-2018,90.0,151.40186915887853,395.32710280373834
1457,Lisandro López,ARG,DF,Inter,Serie A,27,1989,0.5,2,2,1,1,0,0,2,0.0,2,0,0,0,1,3,3,0,0,2017-2018,90.0,180.0,360.0
1458,Maxi López,ARG,FW,Udinese,Serie A,33,1984,18.7,12,8,2,7,3,0,4,0.0,4,8,2,6,2,14,18,0,0,2017-2018,90.0,9.62566844919786,57.75401069518716
1459,Maxime Lopez,FRA,"MF,FW",Marseille,Ligue 1,19,1997,15.3,30,20,12,12,6,12,56,21.4,44,16,2,14,7,37,6,1,0,2017-2018,90.0,41.17647058823529,176.47058823529412
1460,Pedro López Muñoz,ESP,DF,Levante,La Liga,33,1983,17.7,33,23,21,10,2,17,30,56.7,13,22,7,15,26,59,45,0,0,2017-2018,90.0,132.20338983050848,167.79661016949154
1461,Pau López,ESP,GK,Espanyol,La Liga,22,1994,28.5,0,0,0,0,0,0,0,0.0,0,0,0,0,1,1,15,2,0,2017-2018,90.0,3.1578947368421053,0.0
1462,Pedro López,ESP,GK,Betis,La Liga,22,1995,4.6,0,0,0,0,0,0,0,0.0,0,1,0,1,0,0,3,0,0,2017-2018,90.0,0.0,0.0
1463,Víctor López,ESP,MF,Alavés,La Liga,20,1997,0.7,2,1,0,2,0,0,1,0.0,1,0,0,0,1,3,1,0,0,2017-2018,90.0,128.57142857142858,257.14285714285717
1464,Jonas Lössl,DEN,GK,Huddersfield,Premier League,28,1989,38.0,1,0,1,0,0,1,5,20.0,4,0,0,0,4,5,13,6,0,2017-2018,90.0,9.473684210526315,2.3684210526315788
1465,Dejan Lovren,CRO,DF,Liverpool,Premier League,28,1989,23.6,26,17,14,11,1,12,22,54.5,10,26,15,11,38,64,146,2,0,2017-2018,90.0,144.9152542372881,99.15254237288134
1466,Chris Löwe,GER,DF,Huddersfield,Premier League,28,1989,17.6,43,29,26,15,2,20,44,45.5,24,21,8,13,34,77,65,3,0,2017-2018,90.0,173.86363636363635,219.88636363636363
1467,Matthew Lowton,ENG,DF,Burnley,Premier League,28,1989,25.5,55,34,26,27,2,28,60,46.7,32,35,15,20,39,94,141,2,0,2017-2018,90.0,137.64705882352942,194.11764705882354
1468,Anthony Lozano,HON,"FW,MF",Girona,La Liga,24,1993,5.2,9,5,2,7,0,1,5,20.0,4,3,0,3,3,12,2,0,0,2017-2018,90.0,51.92307692307692,155.76923076923075
1469,Fabio Lucioni,ITA,DF,Benevento,Serie A,29,1987,8.0,11,9,7,4,0,7,11,63.6,4,14,11,3,7,18,61,0,0,2017-2018,90.0,78.75,123.75
1470,Filipe Luís,BRA,DF,Atlético Madrid,La Liga,31,1985,18.4,83,52,41,33,9,36,49,73.5,13,27,7,20,35,118,34,0,0,2017-2018,90.0,171.19565217391306,405.97826086956525
1471,José Luis Gayà,ESP,DF,Valencia,La Liga,22,1995,32.4,77,60,52,22,3,43,68,63.2,25,43,12,31,56,133,90,1,0,2017-2018,90.0,155.55555555555557,213.88888888888889
1472,José Luis Morales,ESP,"MF,FW",Levante,La Liga,30,1987,34.0,37,23,15,15,7,13,65,20.0,52,28,0,28,26,63,20,0,0,2017-2018,90.0,68.82352941176471,97.94117647058823
1473,José Luis Palomino,ARG,DF,Atalanta,Serie A,27,1990,22.0,60,39,36,19,5,24,51,47.1,27,36,21,15,39,99,111,1,0,2017-2018,90.0,159.54545454545456,245.45454545454547
1474,Luisinho,POR,DF,La Coruña,La Liga,32,1985,29.1,111,77,64,40,7,65,96,67.7,31,24,4,20,55,166,113,0,0,2017-2018,90.0,170.10309278350513,343.29896907216494
1475,David Luiz,BRA,"DF,MF",Chelsea,Premier League,30,1987,9.3,18,11,13,4,1,11,21,52.4,10,9,5,4,24,42,45,2,0,2017-2018,90.0,232.258064516129,174.19354838709674
1476,Douglas Luiz,BRA,"MF,FW",Girona,La Liga,19,1998,3.4,10,9,4,6,0,3,11,27.3,8,1,0,1,4,14,0,0,0,2017-2018,90.0,105.88235294117646,264.70588235294116
1477,Everton Luiz,BRA,MF,SPAL,Serie A,29,1988,7.1,22,16,10,10,2,6,29,20.7,23,8,1,7,10,32,8,1,0,2017-2018,90.0,126.7605633802817,278.8732394366197
1478,Jordan Lukaku,BEL,DF,Lazio,Serie A,23,1994,15.1,28,15,14,11,3,10,16,62.5,6,14,2,12,15,43,23,0,0,2017-2018,90.0,89.40397350993378,166.88741721854305
1479,Romelu Lukaku,BEL,FW,Manchester Utd,Premier League,24,1993,31.9,7,4,1,3,3,0,13,0.0,13,9,2,7,3,10,22,2,0,2017-2018,90.0,8.463949843260188,19.74921630094044
1480,Lars Lukas Mai,GER,DF,Bayern Munich,Bundesliga,17,2000,2.0,4,4,4,0,0,3,4,75.0,1,3,2,1,3,7,3,0,0,2017-2018,90.0,135.0,180.0
1481,Dodi Lukebakio,BEL,"MF,FW",Watford,Premier League,19,1997,0.2,1,0,1,0,0,0,0,0.0,0,0,0,0,0,1,0,0,0,2017-2018,90.0,0.0,450.0
1482,Saša Lukić,SRB,MF,Levante,La Liga,20,1996,11.0,21,16,9,8,4,5,16,31.3,11,14,6,8,17,38,13,0,0,2017-2018,90.0,139.0909090909091,171.8181818181818
1483,Senad Lulić,BIH,"DF,MF",Lazio,Serie A,31,1986,27.0,66,40,32,22,12,21,80,26.3,59,32,4,28,36,102,39,0,0,2017-2018,90.0,120.0,220.0
1484,Levi Lumeka,ENG,FW,Crystal Palace,Premier League,18,1998,0.3,1,1,1,0,0,0,0,0.0,0,0,0,0,1,2,0,0,0,2017-2018,90.0,300.0,300.0
1485,Antonio Luna,ESP,DF,Levante,La Liga,26,1991,22.5,39,26,23,13,3,24,41,58.5,17,26,9,17,36,75,68,0,0,2017-2018,90.0,144.0,156.0
1486,Arnaud Lusamba,COD,MF,Nice,Ligue 1,20,1997,1.8,12,9,4,6,2,3,7,42.9,4,5,0,5,1,13,1,0,0,2017-2018,90.0,50.0,600.0
1487,Fabian Lustenberger,SUI,"MF,DF",Hertha BSC,Bundesliga,29,1988,17.6,47,34,26,20,1,21,31,67.7,10,31,12,19,24,71,74,1,0,2017-2018,90.0,122.72727272727272,240.34090909090907
1488,Andreas Luthe,GER,GK,Augsburg,Bundesliga,30,1987,2.0,0,0,0,0,0,0,0,0.0,0,0,0,0,0,0,2,0,0,2017-2018,90.0,0.0,0.0
1489,Lyanco,BRA,DF,Torino,Serie A,20,1997,3.5,11,8,8,3,0,5,8,62.5,3,4,3,1,5,16,17,0,0,2017-2018,90.0,128.57142857142856,282.85714285714283
1490,Charalambos Lykogiannis,GRE,DF,Cagliari,Serie A,23,1993,7.6,16,12,9,5,2,11,18,61.1,7,12,3,9,15,31,28,0,0,2017-2018,90.0,177.6315789473684,189.4736842105263
1491,Cheikh M'Bengue,SEN,DF,Saint-Étienne,Ligue 1,29,1988,5.4,8,4,8,0,0,4,4,100.0,0,6,4,2,8,16,22,1,0,2017-2018,90.0,133.33333333333331,133.33333333333331
1492,Raïs M'Bolhi,ALG,GK,Rennes,Ligue 1,31,1986,1.0,0,0,0,0,0,0,1,0.0,1,0,0,0,0,0,0,0,0,2017-2018,90.0,0.0,0.0
1493,Yann M'Vila,FRA,MF,Saint-Étienne,Ligue 1,27,1990,16.4,26,16,11,12,3,7,24,29.2,17,13,1,12,31,57,56,0,0,2017-2018,90.0,170.12195121951223,142.6829268292683
1494,Zinédine Machach,FRA,"FW,MF",Toulouse,Ligue 1,21,1996,2.1,7,3,5,1,1,4,5,80.0,1,1,0,1,2,9,2,0,0,2017-2018,90.0,85.71428571428571,300.0
1495,Pablo Maffeo,ESP,DF,Girona,La Liga,20,1997,29.4,74,55,39,23,12,25,49,51.0,24,28,7,21,50,124,82,0,0,2017-2018,90.0,153.06122448979593,226.53061224489795
1496,Gabriel Magalhães,BRA,DF,Troyes,Ligue 1,19,1997,0.9,1,1,1,0,0,0,1,0.0,1,2,1,1,0,1,4,1,0,2017-2018,90.0,0.0,100.0
1497,Christian Maggio,ITA,DF,Napoli,Serie A,35,1982,7.1,17,10,9,6,2,7,19,36.8,12,15,4,11,13,30,21,0,0,2017-2018,90.0,164.7887323943662,215.49295774647888
1498,Francesco Magnanelli,ITA,MF,Sassuolo,Serie A,32,1984,27.7,56,38,30,20,6,20,65,30.8,45,26,7,19,58,114,78,2,0,2017-2018,90.0,188.4476534296029,181.9494584837545
1499,Harry Maguire,ENG,DF,Leicester City,Premier League,24,1993,38.0,63,46,47,15,1,26,43,60.5,17,35,28,7,48,111,181,1,0,2017-2018,90.0,113.6842105263158,149.21052631578948
1500,Hicham Mahou,FRA,"MF,FW",Nice,Ligue 1,18,1999,0.6,1,1,1,0,0,1,3,33.3,2,0,0,0,3,4,0,0,0,2017-2018,90.0,450.00000000000006,150.0
1501,Riyad Mahrez,ALG,"MF,FW",Leicester City,Premier League,26,1991,32.8,39,27,16,17,6,10,63,15.9,53,32,1,31,18,57,15,0,0,2017-2018,90.0,49.39024390243903,107.01219512195124
1502,Thiago Maia,BRA,"MF,DF",Lille,Ligue 1,20,1997,27.4,55,40,26,26,3,15,61,24.6,46,32,10,22,61,116,47,1,0,2017-2018,90.0,200.36496350364965,180.65693430656935
1503,Arne Maier,GER,MF,Hertha BSC,Bundesliga,18,1999,13.6,29,23,12,16,1,18,24,75.0,6,19,3,16,24,53,20,0,0,2017-2018,90.0,158.8235294117647,191.91176470588235
1504,Sebastian Maier,GER,MF,Hannover 96,Bundesliga,23,1993,2.9,11,6,4,7,0,2,12,16.7,10,6,1,5,4,15,1,1,0,2017-2018,90.0,124.13793103448276,341.3793103448276
1505,Domenico Maietta,ITA,DF,Bologna,Serie A,34,1982,5.2,5,4,4,1,0,3,9,33.3,6,8,6,2,7,12,13,1,0,2017-2018,90.0,121.15384615384615,86.53846153846153
1506,Habib Maïga,CIV,"MF,DF",Saint-Étienne,Ligue 1,21,1996,7.9,29,18,16,10,3,12,30,40.0,18,8,4,4,19,48,10,0,0,2017-2018,90.0,216.4556962025316,330.379746835443
1507,Mike Maignan,FRA,GK,Lille,Ligue 1,22,1995,33.7,1,1,1,0,0,1,1,100.0,0,0,0,0,0,1,8,6,0,2017-2018,90.0,0.0,2.6706231454005933
1508,Linton Maina,GER,MF,Hannover 96,Bundesliga,18,1999,0.1,1,1,0,0,1,0,0,0.0,0,0,0,0,1,2,0,0,0,2017-2018,90.0,900.0,900.0
1509,Ainsley Maitland-Niles,ENG,"DF,MF",Arsenal,Premier League,19,1997,10.2,25,17,12,7,6,14,31,45.2,17,15,1,14,12,37,35,2,0,2017-2018,90.0,105.88235294117648,220.58823529411765
1510,Jean-Victor Makengo,FRA,"FW,MF",Nice,Ligue 1,19,1998,2.7,4,2,2,2,0,1,2,50.0,1,1,0,1,3,7,1,1,0,2017-2018,90.0,99.99999999999999,133.33333333333331
1511,Nemanja Maksimović,SRB,MF,Valencia,La Liga,22,1995,6.2,21,13,10,8,3,8,16,50.0,8,15,6,9,16,37,8,0,0,2017-2018,90.0,232.25806451612902,304.83870967741933
1512,Nikola Maksimović,SRB,DF,Napoli,Serie A,25,1991,1.1,1,1,0,1,0,1,1,100.0,0,1,0,1,0,1,5,0,0,2017-2018,90.0,0.0,81.81818181818181
1513,Malcom,BRA,FW,Bordeaux,Ligue 1,20,1997,31.7,15,10,3,7,5,1,28,3.6,27,13,1,12,14,29,6,0,0,2017-2018,90.0,39.74763406940063,42.586750788643535
1514,Kévin Malcuit,MAR,DF,Lille,Ligue 1,26,1991,20.2,51,37,31,16,4,17,25,68.0,8,13,5,8,38,89,47,0,0,2017-2018,90.0,169.30693069306932,227.22772277227722
1515,Yunus Mallı,TUR,"FW,MF",Wolfsburg,Bundesliga,25,1992,24.9,25,17,8,14,3,12,25,48.0,13,23,0,23,12,37,17,0,0,2017-2018,90.0,43.373493975903614,90.36144578313252
1516,Hugo Mallo,ESP,DF,Celta Vigo,La Liga,26,1991,33.3,84,55,55,26,3,35,53,66.0,18,30,15,15,68,152,111,1,0,2017-2018,90.0,183.78378378378378,227.02702702702703
1517,Scott Malone,ENG,DF,Huddersfield,Premier League,26,1991,12.4,39,29,27,10,2,17,24,70.8,7,12,2,10,26,65,43,2,0,2017-2018,90.0,188.70967741935485,283.06451612903226
1518,Vincent Manceau,FRA,DF,Angers,Ligue 1,28,1989,33.0,84,49,56,22,6,42,76,55.3,34,34,2,32,34,118,103,0,0,2017-2018,90.0,92.72727272727273,229.0909090909091
1519,Gianluca Mancini,ITA,DF,Atalanta,Serie A,21,1996,7.6,20,14,11,8,1,10,17,58.8,7,8,2,6,15,35,22,0,0,2017-2018,90.0,177.6315789473684,236.8421052631579
1520,Steve Mandanda,FRA,GK,Marseille,Ligue 1,32,1985,30.0,0,0,0,0,0,0,0,0.0,0,0,0,0,0,0,10,3,0,2017-2018,90.0,0.0,0.0
1521,Aïssa Mandi,ALG,DF,Betis,La Liga,25,1991,33.6,54,35,27,25,2,19,34,55.9,15,39,24,15,71,125,133,3,0,2017-2018,90.0,190.17857142857142,144.64285714285714
1522,Georges Mandjeck,CMR,"MF,DF",Metz,Ligue 1,28,1988,10.8,25,14,8,16,1,8,18,44.4,10,9,3,6,18,43,21,1,0,2017-2018,90.0,150.0,208.33333333333331
1523,Rolando Mandragora,ITA,MF,Crotone,Serie A,20,1997,36.0,91,60,48,34,9,26,69,37.7,43,41,13,28,86,177,75,0,0,2017-2018,90.0,215.0,227.5
1524,Mario Mandžukić,CRO,FW,Juventus,Serie A,31,1986,25.8,36,23,13,11,12,8,29,27.6,21,20,3,17,25,61,42,2,0,2017-2018,90.0,87.20930232558139,125.5813953488372
1525,Sadio Mané,SEN,FW,Liverpool,Premier League,25,1992,24.3,28,20,8,11,9,3,23,13.0,20,20,0,20,9,37,8,0,0,2017-2018,90.0,33.33333333333333,103.7037037037037
1526,Eliaquim Mangala,FRA,DF,Everton,Premier League,26,1991,1.5,2,1,1,1,0,0,0,0.0,0,0,0,0,1,3,4,1,0,2017-2018,90.0,60.0,120.0
1527,Eliaquim Mangala,FRA,DF,Manchester City,Premier League,26,1991,5.4,5,3,5,0,0,1,3,33.3,2,4,3,1,2,7,24,0,0,2017-2018,90.0,33.33333333333333,83.33333333333333
1528,Orel Mangala,BEL,MF,Stuttgart,Bundesliga,19,1998,8.7,28,18,7,19,2,11,21,52.4,10,8,2,6,18,46,15,0,0,2017-2018,90.0,186.20689655172413,289.6551724137931
1529,Kader Mangane,SEN,DF,Strasbourg,Ligue 1,34,1983,19.1,37,24,29,8,0,11,21,52.4,10,28,18,10,24,61,120,4,0,2017-2018,90.0,113.08900523560209,174.3455497382199
1530,Thomas Mangani,FRA,MF,Angers,Ligue 1,30,1987,33.6,92,59,35,46,11,28,120,23.3,92,40,5,35,40,132,45,1,0,2017-2018,90.0,107.14285714285714,246.42857142857142
1531,Kostas Manolas,GRE,DF,Roma,Serie A,26,1991,26.0,23,20,14,7,2,9,15,60.0,6,31,24,7,46,69,133,2,0,2017-2018,90.00000000000001,159.23076923076925,79.61538461538463
1532,Javier Manquillo,ESP,DF,Newcastle Utd,Premier League,23,1994,19.5,36,22,25,8,3,15,30,50.0,15,25,6,19,18,54,65,0,0,2017-2018,90.0,83.07692307692308,166.15384615384616
1533,Martín Mantovani,ARG,DF,Leganés,La Liga,33,1984,11.4,12,5,10,2,0,7,10,70.0,3,10,6,4,22,34,67,0,0,2017-2018,90.0,173.68421052631578,94.73684210526315
1534,José Manuel Jurado,ESP,"MF,FW",Espanyol,La Liga,31,1986,16.7,18,14,8,8,2,5,14,35.7,9,13,1,12,16,34,5,0,0,2017-2018,90.0,86.22754491017965,97.0059880239521
1535,Harrison Manzala,COD,"FW,MF",Amiens,Ligue 1,23,1994,20.7,32,23,16,9,7,8,25,32.0,17,22,3,19,18,50,15,0,0,2017-2018,90.0,78.26086956521739,139.13043478260872
1536,Myziane Maolida,COM,"FW,MF",Lyon,Ligue 1,18,1999,3.7,5,5,3,2,0,0,2,0.0,2,1,0,1,0,5,0,0,0,2017-2018,90.0,0.0,121.62162162162161
1537,Faitout Maouassa,FRA,"MF,FW",Rennes,Ligue 1,19,1998,9.9,6,3,2,3,1,2,10,20.0,8,12,2,10,6,12,5,0,0,2017-2018,90.0,54.54545454545455,54.54545454545455
1538,Fernando Marçal,BRA,DF,Lyon,Ligue 1,28,1989,14.4,34,20,22,8,4,14,29,48.3,15,14,6,8,26,60,69,0,0,2017-2018,90.0,162.5,212.5
1539,Vincent Marcel,FRA,"MF,FW",Nice,Ligue 1,20,1997,0.5,1,1,0,1,0,0,1,0.0,1,1,0,1,0,1,0,0,0,2017-2018,90.0,0.0,180.0
1540,Marcelo,BRA,DF,Real Madrid,La Liga,29,1988,25.1,53,37,19,23,11,22,58,37.9,36,26,2,24,30,83,23,2,0,2017-2018,90.0,107.56972111553785,190.0398406374502
1541,Marcelo,BRA,DF,Lyon,Ligue 1,30,1987,34.5,27,25,16,10,1,9,25,36.0,16,32,18,14,57,84,235,4,0,2017-2018,90.0,148.69565217391303,70.43478260869564
1542,Solly March,ENG,"MF,FW",Brighton,Premier League,23,1994,20.6,54,41,34,14,6,22,54,40.7,32,27,3,24,13,67,49,0,0,2017-2018,90.0,56.79611650485437,235.92233009708738
1543,Gabriele Marchegiani,ITA,GK,SPAL,Serie A,21,1996,0.0,0,0,0,0,0,0,0,0.0,0,0,0,0,0,0,0,0,0,2017-2018,,,
1544,Claudio Marchisio,ITA,MF,Juventus,Serie A,31,1986,9.1,17,10,9,5,3,6,21,28.6,15,7,2,5,4,21,7,0,0,2017-2018,90.0,39.56043956043956,168.13186813186815
1545,Gian Marco Ferrari,ITA,DF,Sampdoria,Serie A,25,1992,29.4,12,8,8,4,0,5,10,50.0,5,42,38,4,31,43,149,4,0,2017-2018,90.0,94.89795918367346,36.734693877551024
1546,Óscar de Marcos,ESP,"DF,FW",Athletic Club,La Liga,28,1989,18.4,28,21,11,15,2,13,29,44.8,16,15,2,13,19,47,36,0,0,2017-2018,90.0,92.93478260869566,136.95652173913044
1547,José María Giménez,URU,DF,Atlético Madrid,La Liga,22,1995,18.8,38,27,29,6,3,23,35,65.7,12,28,15,13,30,68,101,1,0,2017-2018,90.0,143.61702127659572,181.91489361702128
1548,Mariano,DOM,FW,Lyon,Ligue 1,23,1993,27.9,16,11,0,5,11,2,23,8.7,21,9,1,8,3,19,20,0,0,2017-2018,90.0,9.67741935483871,51.612903225806456
1549,Adrian Mariappa,JAM,DF,Watford,Premier League,30,1986,24.6,45,26,33,12,0,14,34,41.2,20,25,16,9,45,90,133,4,0,2017-2018,89.99999999999999,164.63414634146338,164.63414634146338
1550,Jordan Marié,FRA,MF,Dijon,Ligue 1,25,1991,20.9,63,38,22,36,5,18,66,27.3,48,26,9,17,40,103,25,2,0,2017-2018,90.0,172.2488038277512,271.2918660287081
1551,Adrián Marín,ESP,DF,Villarreal,La Liga,20,1997,2.6,6,4,3,3,0,2,8,25.0,6,2,0,2,3,9,8,0,0,2017-2018,90.0,103.84615384615384,207.69230769230768
1552,João Mário,POR,MF,West Ham,Premier League,24,1993,11.4,14,11,6,5,3,6,19,31.6,13,7,0,7,8,22,4,1,0,2017-2018,90.0,63.1578947368421,110.52631578947367
1553,João Mário,POR,"MF,FW",Inter,Serie A,24,1993,6.2,8,4,3,3,2,2,8,25.0,6,6,1,5,4,12,5,0,0,2017-2018,90.0,58.064516129032256,116.12903225806451
1554,Guillermo Maripán,CHI,DF,Alavés,La Liga,23,1994,17.0,28,16,24,4,0,17,32,53.1,15,19,10,9,36,64,108,0,0,2017-2018,90.0,190.58823529411765,148.23529411764707
1555,Marlon,BRA,DF,Nice,Ligue 1,21,1995,21.4,36,26,22,13,1,15,22,68.2,7,19,15,4,15,51,72,2,0,2017-2018,90.0,63.084112149532714,151.40186915887853
1556,Dominic Maroh,SVN,DF,Köln,Bundesliga,30,1987,10.2,22,15,18,4,0,15,18,83.3,3,17,9,8,21,43,68,1,0,2017-2018,90.0,185.29411764705884,194.11764705882354
1557,Marquinhos,BRA,DF,Paris S-G,Ligue 1,23,1994,25.1,28,14,14,14,0,13,21,61.9,8,36,22,14,14,42,114,2,0,2017-2018,90.0,50.199203187250994,100.39840637450199
1558,Bruno Martella,ITA,DF,Crotone,Serie A,24,1992,29.1,30,21,19,7,4,12,30,40.0,18,22,9,13,48,78,151,1,0,2017-2018,90.0,148.45360824742266,92.78350515463917
1559,Roger Martí,ESP,FW,Levante,La Liga,26,1991,10.7,8,4,2,5,1,2,13,15.4,11,11,0,11,1,9,5,0,0,2017-2018,90.0,8.41121495327103,67.28971962616824
1560,Anthony Martial,FRA,FW,Manchester Utd,Premier League,21,1995,17.6,15,13,9,2,4,3,12,25.0,9,5,1,4,3,18,7,0,0,2017-2018,90.0,15.34090909090909,76.70454545454545
1561,Aarón Martín,ESP,DF,Espanyol,La Liga,20,1997,31.3,56,36,41,12,3,31,59,52.5,28,26,5,21,49,105,78,0,0,2017-2018,90.0,140.89456869009584,161.02236421725237
1562,Jonas Martin,FRA,MF,Strasbourg,Ligue 1,27,1990,33.6,73,50,41,28,4,17,54,31.5,37,30,3,27,33,106,36,0,0,2017-2018,90.0,88.39285714285714,195.53571428571428
1563,Cuco Martina,CUW,DF,Everton,Premier League,27,1989,20.3,61,35,38,15,8,27,46,58.7,19,17,4,13,42,103,130,2,0,2017-2018,90.0,186.20689655172413,270.4433497536946
1564,Carlos Martínez,ESP,DF,Real Sociedad,La Liga,31,1986,0.0,0,0,0,0,0,0,0,0.0,0,0,0,0,0,0,0,0,0,2017-2018,,,
1565,Emiliano Martínez,ARG,GK,Getafe,La Liga,24,1992,5.0,0,0,0,0,0,0,0,0.0,0,0,0,0,0,0,3,0,0,2017-2018,90.0,0.0,0.0
1566,Iñigo Martínez,ESP,DF,Athletic Club,La Liga,26,1991,16.0,28,20,20,8,0,18,29,62.1,11,17,8,9,30,58,82,0,0,2017-2018,90.0,168.75,157.5
1567,Iñigo Martínez,ESP,DF,Real Sociedad,La Liga,26,1991,11.7,14,9,9,4,1,5,11,45.5,6,9,4,5,23,37,55,0,0,2017-2018,89.99999999999999,176.9230769230769,107.6923076923077
1568,Javi Martínez,ESP,"MF,DF",Bayern Munich,Bundesliga,28,1988,17.9,31,22,11,15,5,9,19,47.4,10,16,5,11,33,64,40,1,0,2017-2018,90.0,165.92178770949724,155.8659217877095
1569,Pablo Martinez,FRA,DF,Strasbourg,Ligue 1,28,1989,23.5,41,34,28,12,1,22,49,44.9,27,25,12,13,51,92,112,3,0,2017-2018,90.0,195.3191489361702,157.02127659574467
1570,Roger Martínez,COL,FW,Villarreal,La Liga,23,1994,2.6,1,1,0,1,0,0,2,0.0,2,2,0,2,0,1,1,0,0,2017-2018,90.0,0.0,34.61538461538461
1571,Christopher Martins,LUX,MF,Lyon,Ligue 1,20,1997,0.8,3,2,0,3,0,1,2,50.0,1,0,0,0,1,4,0,0,0,2017-2018,90.0,112.5,337.5
1572,Bruno Martins Indi,NED,DF,Stoke City,Premier League,25,1992,13.8,21,12,18,3,0,10,19,52.6,9,16,11,5,21,42,77,1,0,2017-2018,90.0,136.9565217391304,136.9565217391304
1573,Jonathan Martins Pereira,FRA,DF,Guingamp,Ligue 1,31,1986,12.6,34,18,21,10,3,8,23,34.8,15,9,3,6,37,71,39,1,0,2017-2018,90.0,264.28571428571433,242.8571428571429
1574,Adam Marušić,MNE,DF,Lazio,Serie A,24,1992,28.0,28,21,17,8,3,12,28,42.9,16,22,2,20,31,59,33,0,0,2017-2018,90.0,99.64285714285714,90.0
1575,Omar Mascarell,EQG,MF,Eint Frankfurt,Bundesliga,24,1993,8.6,20,16,8,12,0,10,18,55.6,8,14,1,13,21,41,10,0,0,2017-2018,90.0,219.76744186046514,209.30232558139537
1576,Javier Mascherano,ARG,DF,Barcelona,La Liga,33,1984,6.0,15,13,9,6,0,8,9,88.9,1,14,8,6,8,23,20,0,0,2017-2018,90.0,120.0,225.0
1577,Andrea Masiello,ITA,DF,Atalanta,Serie A,31,1986,30.1,58,38,34,20,4,30,54,55.6,24,24,6,18,72,130,137,0,0,2017-2018,90.00000000000001,215.2823920265781,173.42192691029902
1578,Adam Masina,MAR,DF,Bologna,Serie A,23,1994,31.4,82,57,49,26,7,36,84,42.9,48,46,7,39,51,133,127,0,0,2017-2018,90.0,146.1783439490446,235.031847133758
1579,Eden Massouema,CGO,"MF,FW",Dijon,Ligue 1,20,1997,2.1,2,1,2,0,0,2,2,100.0,0,3,0,3,5,7,2,0,0,2017-2018,90.0,214.28571428571428,85.71428571428571
1580,Arthur Masuaku,COD,DF,West Ham,Premier League,23,1993,20.8,58,37,36,16,6,25,58,43.1,33,25,2,23,26,84,38,1,0,2017-2018,90.0,112.49999999999999,250.96153846153845
1581,Juan Mata,ESP,FW,Manchester Utd,Premier League,29,1988,21.4,18,13,4,12,2,2,24,8.3,22,10,0,10,15,33,10,1,0,2017-2018,90.0,63.084112149532714,75.70093457943926
1582,Christian Mathenia,GER,GK,Hamburger SV,Bundesliga,25,1992,24.0,0,0,0,0,0,0,3,0.0,3,0,0,0,0,0,11,3,0,2017-2018,90.0,0.0,0.0
1583,Nemanja Matić,SRB,MF,Manchester Utd,Premier League,28,1988,34.6,70,42,32,34,4,23,71,32.4,48,50,13,37,64,134,62,2,0,2017-2018,90.0,166.47398843930634,182.0809248554913
1584,Joël Matip,CMR,DF,Liverpool,Premier League,25,1991,22.2,35,24,23,11,1,12,24,50.0,12,26,15,11,35,70,101,1,0,2017-2018,90.0,141.8918918918919,141.8918918918919
1585,Ryder Matos,BRA,MF,Udinese,Serie A,24,1993,1.9,3,1,1,1,1,1,1,100.0,0,2,0,2,2,5,3,0,0,2017-2018,90.0,94.73684210526315,142.10526315789474
1586,Ryder Matos,BRA,"FW,MF",Hellas Verona,Serie A,24,1993,10.9,18,15,11,5,2,4,9,44.4,5,5,0,5,3,21,9,1,0,2017-2018,90.0,24.77064220183486,148.62385321100916
1587,Alessandro Matri,ITA,FW,Sassuolo,Serie A,32,1984,10.2,2,1,1,1,0,0,3,0.0,3,1,0,1,0,2,5,0,0,2017-2018,90.0,0.0,17.647058823529413
1588,Ville Matti Steinmann,GER,MF,Hamburger SV,Bundesliga,22,1995,6.6,16,10,6,8,2,8,17,47.1,9,6,1,5,18,34,9,1,0,2017-2018,90.0,245.45454545454547,218.1818181818182
1589,Federico Mattiello,ITA,DF,SPAL,Serie A,22,1995,24.5,59,40,31,22,6,21,44,47.7,23,53,15,38,64,123,66,0,0,2017-2018,90.00000000000001,235.10204081632656,216.73469387755105
1590,Blaise Matuidi,FRA,MF,Juventus,Serie A,30,1987,26.2,49,35,14,25,10,10,35,28.6,25,28,4,24,32,81,22,1,0,2017-2018,90.0,109.92366412213741,168.3206106870229
1591,Blaise Matuidi,FRA,MF,Paris S-G,Ligue 1,30,1987,0.3,1,1,1,0,0,0,0,0.0,0,2,1,1,0,1,0,0,0,2017-2018,90.0,0.0,300.0
1592,José Mauri,ITA,MF,Milan,Serie A,21,1996,0.1,0,0,0,0,0,0,0,0.0,0,0,0,0,0,0,0,0,0,2017-2018,90.0,0.0,0.0
1593,Maurício,BRA,DF,Lazio,Serie A,28,1988,0.1,0,0,0,0,0,0,0,0.0,0,0,0,0,0,0,0,0,0,2017-2018,90.0,0.0,0.0
1594,Mërgim Mavraj,ALB,DF,Hamburger SV,Bundesliga,31,1986,16.1,45,32,32,11,2,22,37,59.5,15,28,12,16,21,66,91,3,0,2017-2018,90.0,117.39130434782608,251.5527950310559
1595,Konstantinos Mavropanos,GRE,DF,Arsenal,Premier League,19,1997,2.2,1,1,1,0,0,1,2,50.0,1,4,3,1,6,7,11,1,0,2017-2018,90.0,245.45454545454544,40.90909090909091
1596,Alfie Mawson,ENG,DF,Swansea City,Premier League,23,1994,38.0,32,22,24,8,0,16,27,59.3,11,41,32,9,35,67,229,5,0,2017-2018,90.0,82.89473684210526,75.78947368421052
1597,Philipp Max,GER,DF,Augsburg,Bundesliga,23,1993,32.9,65,47,36,19,10,34,59,57.6,25,27,8,19,33,98,65,1,0,2017-2018,90.0,90.27355623100304,177.8115501519757
1598,Alexandru Maxim,ROU,MF,Mainz 05,Bundesliga,27,1990,10.6,17,12,6,8,3,7,22,31.8,15,20,2,18,6,23,3,0,0,2017-2018,90.0,50.943396226415096,144.33962264150944
1599,Eric Maxim Choupo-Moting,CMR,"FW,MF",Stoke City,Premier League,28,1989,25.7,42,30,21,16,5,9,32,28.1,23,31,3,28,23,65,29,1,0,2017-2018,90.0,80.54474708171206,147.0817120622568
1600,Florian Mayer,GER,DF,Gladbach,Bundesliga,19,1998,0.2,1,1,1,0,0,1,1,100.0,0,0,0,0,0,1,1,0,0,2017-2018,90.0,0.0,450.0
1601,Borja Mayoral,ESP,"FW,MF",Real Madrid,La Liga,20,1997,3.8,6,3,0,4,2,1,5,20.0,4,3,0,3,0,6,0,0,0,2017-2018,90.0,0.0,142.10526315789474
1602,Róbert Mazáň,SVK,DF,Celta Vigo,La Liga,23,1994,0.9,0,0,0,0,0,0,1,0.0,1,1,0,1,2,2,0,0,0,2017-2018,90.0,200.0,0.0
1603,Luca Mazzitelli,ITA,MF,Sassuolo,Serie A,21,1995,11.3,37,24,14,15,8,10,36,27.8,26,21,2,19,21,58,19,0,0,2017-2018,90.0,167.2566371681416,294.69026548672565
1604,Kylian Mbappé,FRA,"FW,MF",Monaco,Ligue 1,18,1998,0.8,1,1,0,1,0,0,0,0.0,0,0,0,0,1,2,0,0,0,2017-2018,90.0,112.5,112.5
1605,Kylian Mbappé,FRA,FW,Paris S-G,Ligue 1,18,1998,23.3,11,8,3,3,5,1,13,7.7,12,4,1,3,0,11,1,0,0,2017-2018,90.0,0.0,42.48927038626609
1606,Ibrahima Mbaye,SEN,DF,Bologna,Serie A,22,1994,19.6,59,34,40,17,2,25,36,69.4,11,25,6,19,28,87,95,0,0,2017-2018,90.0,128.57142857142856,270.91836734693874
1607,Chancel Mbemba,COD,DF,Newcastle Utd,Premier League,22,1994,7.5,16,12,13,3,0,10,17,58.8,7,7,3,4,15,31,44,1,0,2017-2018,90.0,180.0,192.0
1608,Adama Mbengue,SEN,DF,Caen,Ligue 1,23,1993,17.7,71,48,48,18,5,41,65,63.1,24,21,1,20,28,99,50,0,0,2017-2018,90.0,142.3728813559322,361.0169491525424
1609,Isaac Mbenza,BEL,"FW,MF",Montpellier,Ligue 1,21,1996,23.3,16,11,4,8,4,6,16,37.5,10,8,1,7,4,20,5,0,0,2017-2018,90.0,15.450643776824034,61.802575107296136
1610,Bryan Mbeumo,CMR,"FW,MF",Troyes,Ligue 1,17,1999,0.7,0,0,0,0,0,0,3,0.0,3,2,0,2,0,0,2,0,0,2017-2018,90.0,0.0,0.0
1611,Jordi Mboula,ESP,MF,Monaco,Ligue 1,18,1999,0.3,0,0,0,0,0,0,0,0.0,0,2,0,2,0,0,2,0,0,2017-2018,90.0,0.0,0.0
1612,James McArthur,SCO,MF,Crystal Palace,Premier League,29,1987,27.0,58,44,28,27,3,23,61,37.7,38,39,2,37,36,94,44,2,0,2017-2018,90.0,120.0,193.33333333333334
1613,Gareth McAuley,NIR,DF,West Brom,Premier League,37,1979,5.1,8,7,6,2,0,3,7,42.9,4,7,4,3,11,19,16,0,0,2017-2018,90.0,194.11764705882354,141.1764705882353
1614,Oliver McBurnie,SCO,"FW,MF",Swansea City,Premier League,21,1996,3.1,4,3,0,2,2,1,3,33.3,2,2,0,2,0,4,3,0,0,2017-2018,90.0,0.0,116.12903225806451
1615,Alex McCarthy,ENG,GK,Southampton,Premier League,27,1989,18.0,0,0,0,0,0,0,0,0.0,0,0,0,0,1,1,8,0,0,2017-2018,90.0,5.0,0.0
1616,James McCarthy,IRL,MF,Everton,Premier League,26,1990,2.3,9,9,3,4,2,1,5,20.0,4,9,2,7,5,14,3,1,0,2017-2018,90.0,195.6521739130435,352.1739130434783
1617,James McClean,IRL,"MF,FW",West Brom,Premier League,28,1989,15.6,40,28,23,14,3,10,55,18.2,45,18,4,14,20,60,22,0,0,2017-2018,90.0,115.38461538461539,230.76923076923077
1618,Weston McKennie,USA,MF,Schalke 04,Bundesliga,18,1998,14.0,36,23,11,21,4,13,32,40.6,19,16,2,14,20,56,32,0,0,2017-2018,90.0,128.57142857142856,231.42857142857142
1619,Sam McQueen,ENG,"DF,MF",Southampton,Premier League,22,1995,1.6,4,4,4,0,0,2,4,50.0,2,2,1,1,3,7,3,0,0,2017-2018,90.0,168.75,225.0
1620,Scott McTominay,SCO,MF,Manchester Utd,Premier League,20,1996,7.0,11,9,4,5,2,5,13,38.5,8,3,0,3,13,24,9,0,0,2017-2018,90.0,167.14285714285714,141.42857142857142
1621,Iuri Medeiros,POR,"FW,MF",Genoa,Serie A,23,1994,7.1,6,4,3,2,1,4,8,50.0,4,3,1,2,2,8,3,0,0,2017-2018,90.0,25.35211267605634,76.05633802816902
1622,Slobodan Medojević,SRB,MF,Eint Frankfurt,Bundesliga,26,1990,0.3,0,0,0,0,0,0,0,0.0,0,0,0,0,0,0,1,0,0,2017-2018,90.0,0.0,0.0
1623,Álvaro Medrán,ESP,MF,Alavés,La Liga,23,1994,10.5,20,14,5,10,5,8,21,38.1,13,7,0,7,13,33,10,0,0,2017-2018,90.0,111.42857142857143,171.42857142857142
1624,Álvaro Medrán,ESP,MF,Valencia,La Liga,23,1994,0.8,1,1,1,0,0,1,2,50.0,1,0,0,0,3,4,1,0,0,2017-2018,90.0,337.5,112.5
1625,Ben Mee,ENG,DF,Burnley,Premier League,27,1989,29.0,33,20,22,11,0,16,29,55.2,13,51,42,9,33,66,217,1,0,2017-2018,90.0,102.41379310344827,102.41379310344827
1626,Riccardo Meggiorini,ITA,FW,Chievo,Serie A,31,1985,8.7,9,6,3,6,0,1,6,16.7,5,12,3,9,2,11,9,0,0,2017-2018,90.0,20.689655172413794,93.10344827586206
1627,Admir Mehmedi,SUI,"FW,MF",Wolfsburg,Bundesliga,26,1991,3.2,4,2,3,1,0,2,2,100.0,0,1,1,0,1,5,3,0,0,2017-2018,90.0,28.125,112.5
1628,Admir Mehmedi,SUI,"DF,MF",Leverkusen,Bundesliga,26,1991,7.8,20,18,6,11,3,4,13,30.8,9,13,0,13,13,33,5,0,0,2017-2018,90.0,150.0,230.76923076923077
1629,Alexander Meier,GER,FW,Eint Frankfurt,Bundesliga,34,1983,0.0,0,0,0,0,0,0,0,0.0,0,0,0,0,0,0,0,0,0,2017-2018,,,
1630,Soualiho Meïté,FRA,MF,Bordeaux,Ligue 1,23,1994,14.8,25,13,4,19,2,9,32,28.1,23,22,6,16,23,48,13,1,0,2017-2018,90.0,139.86486486486487,152.02702702702703
1631,Soualiho Meïté,FRA,MF,Monaco,Ligue 1,23,1994,1.1,2,1,1,1,0,2,5,40.0,3,1,0,1,3,5,3,0,0,2017-2018,90.0,245.45454545454544,163.63636363636363
1632,Óscar Melendo,ESP,"MF,FW",Espanyol,La Liga,19,1997,7.6,2,2,2,0,0,0,5,0.0,5,2,0,2,3,5,3,0,0,2017-2018,90.0,35.526315789473685,23.684210526315788
1633,Memphis,NED,FW,Lyon,Ligue 1,23,1994,28.4,13,9,4,3,6,3,28,10.7,25,15,0,15,9,22,5,0,0,2017-2018,90.0,28.521126760563384,41.19718309859155
1634,Ledian Memushaj,ALB,MF,Benevento,Serie A,30,1986,14.0,28,18,11,13,4,7,30,23.3,23,24,5,19,10,38,10,1,0,2017-2018,90.0,64.28571428571428,180.0
1635,Pedro Mendes,POR,DF,Montpellier,Ligue 1,26,1990,31.7,62,50,37,19,6,23,41,56.1,18,36,25,11,44,106,152,0,0,2017-2018,90.0,124.9211356466877,176.02523659305993
1636,Thiago Mendes,BRA,MF,Lille,Ligue 1,25,1992,25.5,25,16,10,11,4,5,23,21.7,18,21,3,18,25,50,29,0,0,2017-2018,90.0,88.23529411764706,88.23529411764706
1637,Brais Méndez,ESP,"MF,FW",Celta Vigo,La Liga,20,1997,10.5,19,15,9,6,4,7,17,41.2,10,13,0,13,4,23,12,0,0,2017-2018,90.0,34.285714285714285,162.85714285714286
1638,Stiven Mendoza,COL,"FW,MF",Amiens,Ligue 1,25,1992,11.5,18,10,7,7,4,2,11,18.2,9,11,1,10,15,33,8,0,0,2017-2018,90.0,117.3913043478261,140.8695652173913
1639,Alexandre Mendy,GNB,FW,Bordeaux,Ligue 1,23,1994,8.8,4,4,1,2,1,1,6,16.7,5,5,1,4,1,5,4,0,0,2017-2018,90.0,10.227272727272727,40.90909090909091
1640,Benjamin Mendy,FRA,"DF,FW",Manchester City,Premier League,23,1994,4.0,5,4,2,0,3,5,7,71.4,2,5,0,5,8,13,9,0,0,2017-2018,90.0,180.0,112.5
1641,Ferland Mendy,FRA,DF,Lyon,Ligue 1,22,1995,23.6,45,28,29,13,3,20,31,64.5,11,18,5,13,25,70,43,0,0,2017-2018,90.0,95.33898305084745,171.6101694915254
1642,Nampalys Mendy,SEN,MF,Nice,Ligue 1,25,1992,10.7,13,6,8,5,0,5,17,29.4,12,9,1,8,13,26,10,1,0,2017-2018,90.0,109.34579439252337,109.34579439252337
1643,Hamza Mendyl,MAR,"DF,MF",Lille,Ligue 1,19,1997,9.5,18,10,12,6,0,11,20,55.0,9,5,0,5,17,35,26,0,0,2017-2018,90.0,161.05263157894737,170.52631578947367
1644,Gabriel Mercado,ARG,DF,Sevilla,La Liga,30,1987,23.5,55,37,35,18,2,36,67,53.7,31,32,20,12,42,97,83,1,0,2017-2018,90.0,160.85106382978722,210.63829787234042
1645,Jorge Meré,ESP,DF,Köln,Bundesliga,20,1997,21.0,34,23,25,9,0,23,35,65.7,12,25,13,12,34,68,110,1,0,2017-2018,90.0,145.71428571428572,145.71428571428572
1646,Alex Meret,ITA,GK,SPAL,Serie A,20,1997,12.9,0,0,0,0,0,0,1,0.0,1,0,0,0,0,0,5,0,0,2017-2018,90.0,0.0,0.0
1647,Mikel Merino,ESP,MF,Newcastle Utd,Premier League,21,1996,15.0,56,40,21,32,3,17,56,30.4,39,36,8,28,34,90,25,0,0,2017-2018,90.0,204.0,336.0
1648,Sabin Merino,ESP,"FW,MF",Athletic Club,La Liga,25,1992,4.2,7,3,2,3,2,3,8,37.5,5,6,2,4,1,8,10,0,0,2017-2018,90.0,21.428571428571427,150.0
1649,Dries Mertens,BEL,FW,Napoli,Serie A,30,1987,33.4,28,22,5,13,10,5,36,13.9,31,18,2,16,5,33,8,1,0,2017-2018,90.0,13.47305389221557,75.44910179640719
1650,Per Mertesacker,GER,DF,Arsenal,Premier League,32,1984,4.1,2,2,0,2,0,0,1,0.0,1,4,3,1,6,8,22,2,0,2017-2018,90.0,131.70731707317074,43.90243902439025
1651,Roque Mesa,ESP,MF,Swansea City,Premier League,28,1989,8.4,20,13,8,8,4,10,37,27.0,27,6,0,6,13,33,8,1,0,2017-2018,90.0,139.28571428571428,214.28571428571428
1652,Roque Mesa,ESP,MF,Sevilla,La Liga,28,1989,3.8,13,10,2,7,4,6,8,75.0,2,3,2,1,0,13,5,0,0,2017-2018,90.0,0.0,307.89473684210526
1653,Lionel Messi,ARG,FW,Barcelona,La Liga,30,1987,33.3,17,8,0,11,6,2,18,11.1,16,11,1,10,7,24,0,0,0,2017-2018,90.0,18.91891891891892,45.945945945945944
1654,Thomas Meunier,BEL,DF,Paris S-G,Ligue 1,25,1991,17.5,38,21,22,12,4,18,34,52.9,16,7,2,5,18,56,54,2,0,2017-2018,90.0,92.57142857142857,195.42857142857142
1655,Mexer,MOZ,DF,Rennes,Ligue 1,28,1988,13.3,15,12,9,6,0,9,12,75.0,3,13,7,6,16,31,98,2,0,2017-2018,90.0,108.27067669172932,101.50375939849623
1656,Max Meyer,GER,MF,Schalke 04,Bundesliga,21,1995,19.2,48,38,23,21,4,19,47,40.4,28,25,3,22,54,102,11,0,0,2017-2018,90.0,253.12500000000003,225.00000000000003
1657,Senna Miangue,BEL,"DF,FW",Cagliari,Serie A,20,1997,8.9,7,5,4,2,1,3,7,42.9,4,8,1,7,7,14,35,0,0,2017-2018,90.0,70.78651685393258,70.78651685393258
1658,Michel,BRA,DF,Las Palmas,La Liga,27,1990,23.7,33,24,21,8,4,14,25,56.0,11,21,11,10,39,72,64,1,0,2017-2018,90.0,148.10126582278482,125.31645569620254
1659,Mathieu Michel,FRA,GK,Angers,Ligue 1,25,1991,6.6,0,0,0,0,0,0,1,0.0,1,0,0,0,0,0,0,1,0,2017-2018,90.0,0.0,0.0
1660,Clément Michelin,FRA,DF,Toulouse,Ligue 1,20,1997,3.1,11,7,7,4,0,7,11,63.6,4,3,1,2,4,15,12,0,0,2017-2018,90.0,116.12903225806451,319.35483870967744
1661,Francesco Migliore,ITA,DF,Genoa,Serie A,29,1988,3.7,5,5,4,1,0,2,6,33.3,4,1,0,1,3,8,9,1,0,2017-2018,90.0,72.97297297297297,121.62162162162161
1662,Simon Mignolet,BEL,GK,Liverpool,Premier League,29,1988,19.0,2,1,2,0,0,1,3,33.3,2,0,0,0,0,2,5,3,0,2017-2018,90.0,0.0,9.473684210526315
1663,Nikola Milenković,SRB,DF,Fiorentina,Serie A,19,1997,13.9,39,25,20,16,3,16,29,55.2,13,18,8,10,23,62,70,0,0,2017-2018,90.0,148.9208633093525,252.5179856115108
1664,Danijel Milićević,BIH,"MF,FW",Metz,Ligue 1,31,1986,7.9,8,4,0,4,4,1,9,11.1,8,5,0,5,3,11,2,0,0,2017-2018,90.0,34.177215189873415,91.1392405063291
1665,Arkadiusz Milik,POL,"FW,MF",Napoli,Serie A,23,1994,5.0,2,1,0,1,1,0,1,0.0,1,5,0,5,1,3,4,0,0,2017-2018,90.0,18.0,36.0
1666,Sergej Milinković-Savić,SRB,MF,Lazio,Serie A,22,1995,31.6,55,39,11,34,10,13,52,25.0,39,29,6,23,33,88,36,1,0,2017-2018,90.0,93.9873417721519,156.64556962025316
1667,Vanja Milinković-Savić,SRB,GK,Torino,Serie A,20,1997,1.0,0,0,0,0,0,0,0,0.0,0,0,0,0,0,0,0,0,0,2017-2018,90.0,0.0,0.0
1668,Luka Milivojević,SRB,MF,Crystal Palace,Premier League,26,1991,34.2,85,52,40,37,8,31,86,36.0,55,50,12,38,71,156,81,3,0,2017-2018,90.0,186.8421052631579,223.68421052631578
1669,James Milner,ENG,MF,Liverpool,Premier League,31,1986,19.7,58,45,18,32,8,15,39,38.5,24,33,5,28,21,79,23,0,0,2017-2018,90.0,95.93908629441624,264.9746192893401
1670,Santi Mina,ESP,FW,Valencia,La Liga,21,1995,17.3,17,9,4,9,4,4,22,18.2,18,14,1,13,2,19,19,0,0,2017-2018,90.0,10.404624277456646,88.4393063583815
1671,Yerry Mina,COL,DF,Barcelona,La Liga,22,1994,4.1,10,8,6,4,0,4,6,66.7,2,6,3,3,6,16,16,0,0,2017-2018,90.0,131.70731707317074,219.51219512195124
1672,Tyrone Mings,ENG,DF,Bournemouth,Premier League,24,1993,2.2,1,1,1,0,0,0,0,0.0,0,2,2,0,6,7,13,1,0,2017-2018,90.0,245.45454545454544,40.90909090909091
1673,Ignasi Miquel,ESP,DF,Málaga,La Liga,24,1992,19.7,19,10,11,7,1,4,15,26.7,11,23,13,10,33,52,113,0,0,2017-2018,90.0,150.76142131979697,86.80203045685279
1674,Kevin Mirallas,BEL,"FW,MF",Everton,Premier League,29,1987,1.5,4,3,1,2,1,0,1,0.0,1,0,0,0,0,4,3,0,0,2017-2018,90.0,0.0,240.0
1675,Miranda,BRA,DF,Inter,Serie A,32,1984,30.3,48,37,38,10,0,22,25,88.0,3,30,23,7,38,86,131,2,0,2017-2018,90.0,112.87128712871286,142.5742574257426
1676,Antonio Mirante,ITA,GK,Bologna,Serie A,34,1983,33.0,0,0,0,0,0,0,3,0.0,3,1,0,1,0,0,11,5,0,2017-2018,90.0,0.0,0.0
1677,Simone Missiroli,ITA,MF,Sassuolo,Serie A,31,1986,32.4,62,37,25,31,6,14,72,19.4,58,46,8,38,67,129,70,0,0,2017-2018,90.0,186.11111111111111,172.22222222222223
1678,Kostas Mitroglou,GRE,FW,Marseille,Ligue 1,29,1988,9.7,3,2,1,2,0,1,4,25.0,3,1,1,0,0,3,2,0,0,2017-2018,90.0,0.0,27.835051546391757
1679,Aleksandar Mitrović,SRB,FW,Newcastle Utd,Premier League,22,1994,1.1,1,1,0,1,0,0,1,0.0,1,1,0,1,0,1,2,0,0,2017-2018,90.0,0.0,81.81818181818181
1680,Maximilian Mittelstädt,GER,"MF,DF",Hertha BSC,Bundesliga,20,1997,4.7,19,11,14,4,1,10,19,52.6,9,8,1,7,9,28,11,0,0,2017-2018,90.0,172.3404255319149,363.82978723404256
1681,Henrikh Mkhitaryan,ARM,"FW,MF",Arsenal,Premier League,28,1989,8.8,18,13,9,7,2,5,21,23.8,16,16,2,14,8,26,7,0,0,2017-2018,90.0,81.81818181818181,184.0909090909091
1682,Henrikh Mkhitaryan,ARM,"MF,FW",Manchester Utd,Premier League,28,1989,10.2,15,11,4,7,4,5,25,20.0,20,8,0,8,7,22,3,0,0,2017-2018,90.0,61.76470588235294,132.3529411764706
1683,Luka Modrić,CRO,MF,Real Madrid,La Liga,31,1985,21.9,33,22,14,15,4,15,41,36.6,26,13,4,9,31,64,7,0,0,2017-2018,90.0,127.3972602739726,135.6164383561644
1684,Niklas Moisander,FIN,DF,Werder Bremen,Bundesliga,31,1985,25.0,36,28,22,13,1,24,36,66.7,12,21,9,12,38,74,98,2,0,2017-2018,90.0,136.79999999999998,129.6
1685,Johan Mojica,COL,DF,Girona,La Liga,24,1992,23.7,42,27,31,8,3,21,37,56.8,16,24,3,21,32,74,42,2,0,2017-2018,90.0,121.51898734177216,159.49367088607596
1686,Jorge Molina,ESP,FW,Getafe,La Liga,35,1982,31.0,18,10,3,6,9,4,27,14.8,23,25,4,21,7,25,27,0,0,2017-2018,90.0,20.322580645161292,52.25806451612903
1687,Daniel Molina Orta,ESP,MF,Celta Vigo,La Liga,21,1996,0.1,0,0,0,0,0,0,0,0.0,0,0,0,0,0,0,0,0,0,2017-2018,90.0,0.0,0.0
1688,Cristian Molinaro,ITA,DF,Torino,Serie A,34,1983,17.4,37,29,19,14,4,11,18,61.1,7,15,4,11,22,59,70,1,0,2017-2018,90.0,113.79310344827586,191.3793103448276
1689,Francisco Molinero,ESP,DF,Getafe,La Liga,32,1985,6.4,13,10,10,3,0,7,16,43.8,9,6,0,6,14,27,27,0,0,2017-2018,90.0,196.875,182.8125
1690,Florent Mollet,FRA,"MF,FW",Metz,Ligue 1,25,1991,15.7,25,18,10,12,3,3,25,12.0,22,8,1,7,11,36,8,0,0,2017-2018,90.0,63.05732484076434,143.31210191082803
1691,Momo,ESP,"FW,MF",Las Palmas,La Liga,35,1982,7.5,14,8,8,3,3,4,13,30.8,9,5,0,5,5,19,1,0,0,2017-2018,90.0,60.0,168.0
1692,Thomas Monconduit,FRA,MF,Amiens,Ligue 1,26,1991,32.8,81,49,33,43,5,34,87,39.1,53,52,17,35,55,136,81,2,0,2017-2018,90.0,150.91463414634148,222.25609756097563
1693,Kévin Monnet-Paquet,FRA,"FW,MF",Saint-Étienne,Ligue 1,28,1988,19.6,33,25,9,19,5,11,48,22.9,37,15,2,13,13,46,23,1,0,2017-2018,90.0,59.69387755102041,151.53061224489795
1694,Nacho Monreal,ESP,DF,Arsenal,Premier League,31,1986,24.9,54,32,19,29,6,21,48,43.8,27,26,7,19,56,110,83,2,0,2017-2018,90.0,202.40963855421685,195.18072289156626
1695,Jefferson Montero,ECU,"MF,FW",Getafe,La Liga,27,1989,0.6,1,1,1,0,0,1,1,100.0,0,0,0,0,0,1,2,0,0,2017-2018,90.0,0.0,150.0
1696,Riccardo Montolivo,ITA,MF,Milan,Serie A,32,1985,12.1,29,21,11,15,3,7,24,29.2,17,17,4,13,19,48,15,0,0,2017-2018,90.0,141.32231404958677,215.70247933884298
1697,Martín Montoya,ESP,DF,Valencia,La Liga,26,1991,23.9,66,48,36,22,8,30,55,54.5,25,35,10,25,53,119,89,0,0,2017-2018,90.0,199.58158995815901,248.5355648535565
1698,Walter Montoya,ARG,FW,Sevilla,La Liga,24,1993,0.8,1,1,1,0,0,1,3,33.3,2,1,0,1,0,1,3,0,0,2017-2018,90.0,0.0,112.5
1699,Shaq Moore,USA,DF,Levante,La Liga,20,1996,4.7,8,6,3,3,2,3,7,42.9,4,4,0,4,13,21,11,0,0,2017-2018,90.0,248.93617021276594,153.1914893617021
1700,Aaron Mooy,AUS,MF,Huddersfield,Premier League,26,1990,34.1,102,60,39,51,12,23,55,41.8,32,39,5,34,38,140,52,0,0,2017-2018,90.0,100.29325513196481,269.208211143695
1701,Emre Mor,TUR,"FW,MF",Celta Vigo,La Liga,20,1997,7.4,14,7,6,7,1,6,11,54.5,5,7,1,6,4,18,7,0,0,2017-2018,90.0,48.648648648648646,170.27027027027026
1702,Luca Mora,ITA,MF,SPAL,Serie A,29,1988,10.4,19,17,6,8,5,5,17,29.4,12,9,3,6,4,23,20,0,0,2017-2018,90.0,34.61538461538461,164.4230769230769
1703,Sergio Mora,ESP,MF,Getafe,La Liga,37,1979,9.0,21,15,8,12,1,14,31,45.2,17,10,2,8,15,36,11,0,0,2017-2018,90.0,150.0,210.0
1704,Erik Morán,ESP,MF,Leganés,La Liga,26,1991,2.5,2,2,1,0,1,0,3,0.0,3,1,1,0,4,6,0,0,0,2017-2018,90.0,144.0,72.0
1705,Álvaro Morata,ESP,FW,Chelsea,Premier League,24,1992,22.9,13,8,0,7,6,1,21,4.8,20,17,4,13,6,19,20,0,0,2017-2018,90.0,23.580786026200876,51.091703056768566
1706,Jan Morávek,CZE,MF,Augsburg,Bundesliga,27,1989,7.8,41,37,17,23,1,21,36,58.3,15,19,3,16,11,52,11,0,0,2017-2018,90.0,126.92307692307692,473.07692307692304
1707,Jérémy Morel,MAD,DF,Lyon,Ligue 1,33,1984,32.4,39,27,23,15,1,18,23,78.3,5,28,23,5,46,85,129,5,0,2017-2018,90.0,127.77777777777779,108.33333333333334
1708,Alberto Moreno,ESP,DF,Liverpool,Premier League,25,1992,14.1,35,26,21,12,2,13,29,44.8,16,19,2,17,12,47,44,0,0,2017-2018,89.99999999999999,76.59574468085106,223.40425531914892
1709,Gerard Moreno,ESP,FW,Espanyol,La Liga,25,1992,37.9,41,28,7,22,12,12,53,22.6,41,27,6,21,19,60,46,0,0,2017-2018,90.0,45.11873350923483,97.36147757255937
1710,Héctor Moreno,MEX,DF,Roma,Serie A,29,1988,2.6,2,2,1,1,0,0,1,0.0,1,1,1,0,3,5,5,0,0,2017-2018,90.0,103.84615384615384,69.23076923076923
1711,Héctor Moreno,MEX,DF,Real Sociedad,La Liga,29,1988,8.0,7,3,7,0,0,5,7,71.4,2,3,3,0,10,17,17,0,0,2017-2018,90.0,112.5,78.75
1712,Marlos Moreno,COL,"MF,DF",Girona,La Liga,20,1996,0.3,1,1,0,0,1,0,1,0.0,1,1,0,1,0,1,0,0,0,2017-2018,90.0,0.0,300.0
1713,Emiliano Moretti,ITA,DF,Torino,Serie A,36,1981,19.8,31,18,25,6,0,14,16,87.5,2,30,23,7,21,52,77,2,0,2017-2018,90.0,95.45454545454545,140.9090909090909
1714,Wes Morgan,JAM,DF,Leicester City,Premier League,33,1984,31.3,35,25,26,8,1,12,18,66.7,6,41,27,14,31,66,146,1,0,2017-2018,90.0,89.13738019169328,100.63897763578274
1715,Loren Morón,ESP,FW,Betis,La Liga,23,1993,11.8,14,8,4,5,5,4,17,23.5,13,14,1,13,1,15,12,0,0,2017-2018,90.0,7.627118644067796,106.77966101694915
1716,James Morrison,SCO,MF,West Brom,Premier League,31,1986,2.3,2,1,0,2,0,1,4,25.0,3,1,1,0,1,3,1,0,0,2017-2018,90.0,39.130434782608695,78.26086956521739
1717,Victor Moses,NGA,"DF,MF",Chelsea,Premier League,26,1990,23.4,37,29,21,13,3,14,24,58.3,10,29,4,25,15,52,39,2,0,2017-2018,89.99999999999999,57.69230769230769,142.3076923076923
1718,Pedro Mosquera,ESP,MF,La Coruña,La Liga,29,1988,15.5,48,31,15,29,4,13,38,34.2,25,26,6,20,23,71,38,0,0,2017-2018,90.0,133.5483870967742,278.7096774193548
1719,Lebo Mothiba,RSA,FW,Lille,Ligue 1,21,1996,13.2,8,5,4,0,4,0,7,0.0,7,6,2,4,2,10,11,0,0,2017-2018,90.0,13.636363636363637,54.54545454545455
1720,Thiago Motta,ITA,MF,Paris S-G,Ligue 1,34,1982,12.8,28,21,14,11,3,8,24,33.3,16,15,6,9,21,49,26,1,0,2017-2018,90.0,147.65625,196.875
1721,François Moubandje,SUI,DF,Toulouse,Ligue 1,27,1990,18.9,28,15,20,7,1,10,34,29.4,24,23,7,16,27,55,75,0,0,2017-2018,90.0,128.57142857142858,133.33333333333334
1722,Jessy Moulin,FRA,GK,Saint-Étienne,Ligue 1,31,1986,3.4,0,0,0,0,0,0,0,0.0,0,0,0,0,0,0,3,2,0,2017-2018,90.0,0.0,0.0
1723,Steve Mounié,BEN,FW,Huddersfield,Premier League,22,1994,20.6,11,8,2,4,5,0,19,0.0,19,23,3,20,7,18,30,0,0,2017-2018,90.0,30.582524271844658,48.05825242718446
1724,Lucas Moura,BRA,"FW,MF",Tottenham,Premier League,24,1992,2.3,4,2,3,0,1,1,3,33.3,2,2,0,2,2,6,2,0,0,2017-2018,90.0,78.26086956521739,156.52173913043478
1725,Lucas Moura,BRA,FW,Paris S-G,Ligue 1,24,1992,0.8,1,1,0,1,0,0,1,0.0,1,0,0,0,0,1,0,0,0,2017-2018,90.0,0.0,112.5
1726,Lys Mousset,FRA,"FW,MF",Bournemouth,Premier League,21,1996,6.6,9,5,6,3,0,0,8,0.0,8,5,2,3,3,12,9,0,0,2017-2018,90.0,40.90909090909091,122.72727272727273
1727,João Moutinho,POR,MF,Monaco,Ligue 1,30,1986,31.1,65,41,19,37,9,27,80,33.8,53,52,12,40,36,101,54,0,0,2017-2018,90.0,104.18006430868166,188.10289389067523
1728,Samuel Moutoussamy,COD,MF,Nantes,Ligue 1,20,1996,4.8,15,7,6,7,2,5,8,62.5,3,7,1,6,3,18,4,0,0,2017-2018,90.0,56.25000000000001,281.25
1729,Toni Moya,ESP,MF,Atlético Madrid,La Liga,19,1998,0.0,0,0,0,0,0,0,0,0.0,0,0,0,0,0,0,0,0,0,2017-2018,,,
1730,Ndombe Mubele,COD,"FW,MF",Toulouse,Ligue 1,23,1994,4.1,8,4,6,2,0,4,10,40.0,6,11,0,11,9,17,4,0,0,2017-2018,90.0,197.56097560975613,175.609756097561
1731,Ndombe Mubele,COD,"FW,MF",Rennes,Ligue 1,23,1994,13.6,14,8,5,6,3,5,13,38.5,8,9,0,9,3,17,3,0,0,2017-2018,90.0,19.852941176470587,92.6470588235294
1732,Nordi Mukiele,FRA,DF,Montpellier,Ligue 1,19,1997,31.0,70,55,41,25,4,25,44,56.8,19,26,14,12,73,143,104,2,0,2017-2018,90.0,211.93548387096774,203.2258064516129
1733,Álex Mula,ESP,"FW,MF",Málaga,La Liga,21,1996,6.2,7,3,3,4,0,2,12,16.7,10,5,0,5,6,13,1,0,0,2017-2018,90.0,87.09677419354838,101.61290322580645
1734,Florian Müller,GER,GK,Mainz 05,Bundesliga,19,1997,5.0,0,0,0,0,0,0,0,0.0,0,0,0,0,0,0,1,1,0,2017-2018,90.0,0.0,0.0
1735,Nicolai Müller,GER,"DF,MF",Hamburger SV,Bundesliga,29,1987,1.1,2,0,0,1,1,0,0,0.0,0,1,0,1,0,2,0,0,0,2017-2018,90.0,0.0,163.63636363636363
1736,Thomas Müller,GER,"MF,FW",Bayern Munich,Bundesliga,27,1989,22.3,35,30,10,15,10,13,27,48.1,14,17,1,16,7,42,14,1,0,2017-2018,90.0,28.251121076233183,141.2556053811659
1737,Iker Muniain,ESP,"MF,FW",Athletic Club,La Liga,24,1992,8.7,10,8,2,6,2,1,7,14.3,6,4,0,4,4,14,3,0,0,2017-2018,90.0,41.37931034482759,103.44827586206897
1738,Marc Muniesa,ESP,DF,Girona,La Liga,25,1992,12.5,33,18,17,15,1,11,23,47.8,12,12,5,7,33,66,40,0,0,2017-2018,90.0,237.6,237.6
1739,Ezequiel Muñoz,ARG,DF,Leganés,La Liga,26,1990,15.6,36,28,24,12,0,11,20,55.0,9,18,11,7,24,60,84,0,0,2017-2018,90.0,138.46153846153845,207.69230769230768
1740,Sulley Muntari,GHA,MF,La Coruña,La Liga,32,1984,4.5,9,7,2,7,0,1,7,14.3,6,10,4,6,11,20,10,0,0,2017-2018,90.0,220.0,180.0
1741,Alessandro Murgia,ITA,MF,Lazio,Serie A,20,1996,8.6,19,12,9,9,1,5,19,26.3,14,14,3,11,17,36,13,0,0,2017-2018,90.0,177.90697674418607,198.8372093023256
1742,Luis Muriel,COL,FW,Sevilla,La Liga,26,1991,17.9,16,9,2,8,6,2,23,8.7,21,16,2,14,3,19,4,1,0,2017-2018,90.0,15.083798882681567,80.44692737430168
1743,Jeison Murillo,COL,DF,Valencia,La Liga,25,1992,15.3,31,24,25,6,0,14,21,66.7,7,18,9,9,29,60,85,1,0,2017-2018,90.0,170.58823529411762,182.35294117647058
1744,Jacob Murphy,ENG,"MF,FW",Newcastle Utd,Premier League,22,1995,12.8,13,10,5,4,4,7,27,25.9,20,16,0,16,6,19,13,2,0,2017-2018,90.0,42.1875,91.40625
1745,Jamie Murphy,SCO,MF,Brighton,Premier League,27,1989,1.9,2,2,2,0,0,2,4,50.0,2,0,0,0,1,3,3,0,0,2017-2018,90.0,47.368421052631575,94.73684210526315
1746,Glenn Murray,ENG,FW,Brighton,Premier League,33,1983,24.4,18,12,4,11,3,2,18,11.1,16,16,4,12,5,23,27,0,0,2017-2018,90.0,18.442622950819676,66.39344262295083
1747,Nicola Murru,ITA,DF,Sampdoria,Serie A,22,1994,16.1,40,31,18,18,4,24,38,63.2,14,29,4,25,17,57,60,1,0,2017-2018,90.0,95.03105590062111,223.60248447204967
1748,Mateo Musacchio,ARG,DF,Milan,Serie A,26,1990,13.4,22,15,13,7,2,8,16,50.0,8,9,3,6,12,34,58,1,0,2017-2018,90.0,80.59701492537313,147.76119402985074
1749,Charly Musonda Jr.,BEL,FW,Chelsea,Premier League,20,1996,0.4,1,0,0,0,1,1,1,100.0,0,0,0,0,0,1,0,0,0,2017-2018,90.0,0.0,225.0
1750,Shkodran Mustafi,GER,DF,Arsenal,Premier League,25,1992,25.3,64,46,42,18,4,28,54,51.9,26,23,15,8,57,121,175,2,0,2017-2018,89.99999999999999,202.76679841897231,227.66798418972328
1751,Yoshinori Mutō,JPN,FW,Mainz 05,Bundesliga,25,1992,21.2,21,15,6,8,7,5,14,35.7,9,16,0,16,6,27,12,0,0,2017-2018,90.0,25.471698113207548,89.15094339622642
1752,Fahad Al Muwallad,KSA,MF,Levante,La Liga,22,1994,0.3,0,0,0,0,0,0,1,0.0,1,0,0,0,1,1,0,0,0,2017-2018,90.0,300.0,0.0
1753,Yvon Mvogo,SUI,GK,RB Leipzig,Bundesliga,23,1994,1.0,0,0,0,0,0,0,0,0.0,0,0,0,0,0,0,1,1,0,2017-2018,90.0,0.0,0.0
1754,Boaz Myhill,WAL,GK,West Brom,Premier League,34,1982,1.0,0,0,0,0,0,0,0,0.0,0,0,0,0,0,0,1,0,0,2017-2018,90.0,0.0,0.0
1755,Alfred N'Diaye,SEN,"DF,MF",Villarreal,La Liga,27,1990,1.1,3,1,1,1,1,1,1,100.0,0,0,0,0,3,6,3,0,0,2017-2018,90.0,245.45454545454544,245.45454545454544
1756,Kévin N'Doram,FRA,"MF,DF",Monaco,Ligue 1,21,1996,8.0,16,10,6,9,1,6,24,25.0,18,6,2,4,16,32,29,0,0,2017-2018,90.0,180.0,180.0
1757,Abdallah N'dour,SEN,DF,Strasbourg,Ligue 1,23,1993,2.8,9,5,6,3,0,5,10,50.0,5,6,1,5,2,11,5,0,0,2017-2018,90.0,64.28571428571429,289.2857142857143
1758,Clinton N'Jie,CMR,FW,Marseille,Ligue 1,23,1993,9.7,10,6,2,5,3,2,9,22.2,7,5,0,5,3,13,0,0,0,2017-2018,90.0,27.835051546391757,92.78350515463919
1759,Georges-Kévin N'Koudou,CMR,MF,Tottenham,Premier League,22,1995,0.0,0,0,0,0,0,0,0,0.0,0,0,0,0,0,0,1,0,0,2017-2018,,,
1760,Georges-Kévin N'Koudou,CMR,"MF,FW",Burnley,Premier League,22,1995,2.5,7,6,5,1,1,3,8,37.5,5,4,0,4,1,8,1,0,0,2017-2018,90.0,36.0,252.0
1761,Stanley N'Soki,FRA,DF,Paris S-G,Ligue 1,18,1999,0.3,0,0,0,0,0,0,1,0.0,1,0,0,0,0,0,1,0,0,2017-2018,90.0,0.0,0.0
1762,Nacho,ESP,DF,Real Madrid,La Liga,27,1990,23.0,55,40,29,19,7,20,38,52.6,18,21,9,12,46,101,51,0,0,2017-2018,90.0,180.0,215.21739130434784
1763,Yuto Nagatomo,JPN,DF,Inter,Serie A,30,1986,8.8,10,6,4,5,1,5,14,35.7,9,8,3,5,10,20,28,0,0,2017-2018,90.0,102.27272727272727,102.27272727272727
1764,Ádám Nagy,HUN,MF,Bologna,Serie A,22,1995,7.9,16,9,6,8,2,7,13,53.8,6,11,0,11,7,23,5,0,0,2017-2018,90.0,79.74683544303797,182.2784810126582
1765,Matías Nahuel,ESP,"MF,FW",Betis,La Liga,20,1996,2.8,4,4,1,1,2,2,5,40.0,3,2,0,2,2,6,1,0,0,2017-2018,90.0,64.28571428571429,128.57142857142858
1766,Radja Nainggolan,BEL,MF,Roma,Serie A,29,1988,29.0,49,36,14,28,7,9,33,27.3,24,18,1,17,18,67,31,1,0,2017-2018,90.0,55.86206896551724,152.06896551724137
1767,Préjuce Nakoulma,BFA,FW,Nantes,Ligue 1,30,1987,12.8,10,8,3,6,1,2,7,28.6,5,2,0,2,5,15,0,0,0,2017-2018,90.0,35.15625,70.3125
1768,Naldo,BRA,DF,Espanyol,La Liga,28,1988,10.2,14,8,12,1,1,5,10,50.0,5,13,10,3,16,30,57,1,0,2017-2018,90.0,141.1764705882353,123.52941176470588
1769,Naldo,BRA,DF,Schalke 04,Bundesliga,34,1982,34.0,51,36,38,12,1,31,46,67.4,15,39,21,18,55,106,200,1,0,2017-2018,90.0,145.58823529411765,135.0
1770,Andrea Nalini,ITA,"FW,MF",Crotone,Serie A,27,1990,18.2,43,32,22,16,5,16,25,64.0,9,25,2,23,15,58,19,1,0,2017-2018,90.0,74.17582417582418,212.63736263736263
1771,Nani,POR,"FW,MF",Lazio,Serie A,30,1986,4.3,9,6,2,2,5,3,9,33.3,6,8,0,8,2,11,0,0,0,2017-2018,90.0,41.86046511627907,188.37209302325584
1772,Nano,ESP,FW,Levante,La Liga,22,1995,3.1,7,6,2,4,1,1,1,100.0,0,4,0,4,0,7,0,0,0,2017-2018,90.0,0.0,203.2258064516129
1773,Naranjo,ESP,"MF,FW",Leganés,La Liga,23,1994,6.2,17,10,3,12,2,4,12,33.3,8,11,1,10,3,20,4,0,0,2017-2018,90.0,43.54838709677419,246.7741935483871
1774,Luciano Narsingh,NED,"FW,MF",Swansea City,Premier League,26,1990,6.9,7,5,1,5,1,2,7,28.6,5,7,0,7,3,10,3,0,0,2017-2018,90.0,39.13043478260869,91.30434782608695
1775,Nikolas Nartey,DEN,MF,Köln,Bundesliga,17,2000,0.1,0,0,0,0,0,0,0,0.0,0,0,0,0,0,0,0,0,0,2017-2018,90.0,0.0,0.0
1776,Juanjo Narváez,COL,MF,Betis,La Liga,22,1995,3.4,8,6,4,4,0,3,6,50.0,3,3,0,3,8,16,4,0,0,2017-2018,90.0,211.76470588235293,211.76470588235293
1777,Matija Nastasić,SRB,DF,Schalke 04,Bundesliga,24,1993,22.1,48,38,37,10,1,28,37,75.7,9,40,22,18,36,84,85,0,0,2017-2018,90.0,146.60633484162895,195.47511312217193
1778,Nathan,BRA,MF,Amiens,Ligue 1,21,1996,0.1,0,0,0,0,0,0,0,0.0,0,0,0,0,0,0,0,0,0,2017-2018,90.0,0.0,0.0
1779,Kyle Naughton,ENG,DF,Swansea City,Premier League,28,1988,33.7,92,60,49,35,8,54,100,54.0,46,60,13,47,60,152,144,4,0,2017-2018,90.0,160.2373887240356,245.69732937685458
1780,Fernando Navarro,ESP,DF,La Coruña,La Liga,35,1982,11.6,32,22,24,7,1,16,25,64.0,9,13,3,10,29,61,49,0,0,2017-2018,90.0,225.0,248.27586206896552
1781,Marc Navarro,ESP,DF,Espanyol,La Liga,22,1995,12.3,20,13,12,8,0,10,20,50.0,10,11,6,5,22,42,17,0,0,2017-2018,89.99999999999999,160.97560975609753,146.34146341463412
1782,Rafa Navarro,ESP,DF,Betis,La Liga,23,1994,1.5,3,2,3,0,0,0,4,0.0,4,0,0,0,1,4,6,0,0,2017-2018,90.0,60.0,180.0
1783,Ximo Navarro,ESP,DF,Las Palmas,La Liga,27,1990,29.0,63,43,44,19,0,28,50,56.0,22,27,16,11,66,129,131,4,0,2017-2018,90.0,204.82758620689654,195.51724137931032
1784,Jesús Navas,ESP,"FW,DF",Sevilla,La Liga,31,1985,19.6,32,25,17,9,6,12,26,46.2,14,14,5,9,19,51,37,0,0,2017-2018,90.0,87.24489795918367,146.93877551020407
1785,Keylor Navas,CRC,GK,Real Madrid,La Liga,30,1986,27.0,2,1,2,0,0,1,1,100.0,0,0,0,0,3,5,10,2,0,2017-2018,90.0,10.0,6.666666666666667
1786,Raúl Navas,ESP,DF,Real Sociedad,La Liga,29,1988,19.9,22,15,18,4,0,14,26,53.8,12,23,13,10,30,52,73,0,0,2017-2018,90.0,135.678391959799,99.49748743718594
1787,Badou Ndiaye,SEN,MF,Stoke City,Premier League,26,1990,12.6,53,28,22,25,6,16,41,39.0,25,21,9,12,13,66,18,0,0,2017-2018,90.0,92.85714285714286,378.5714285714286
1788,Wilfred Ndidi,NGA,MF,Leicester City,Premier League,20,1996,32.2,138,89,68,65,5,45,119,37.8,74,67,10,57,51,189,103,2,0,2017-2018,90.0,142.54658385093165,385.71428571428567
1789,Merveille Ndockyt,CGO,"MF,FW",Getafe,La Liga,19,1998,0.8,1,1,0,1,0,0,1,0.0,1,2,0,2,2,3,0,0,0,2017-2018,90.0,225.0,112.5
1790,Tanguy Ndombele,FRA,MF,Amiens,Ligue 1,20,1996,2.6,6,5,2,4,0,1,4,25.0,3,4,0,4,5,11,3,0,0,2017-2018,90.0,173.07692307692307,207.69230769230768
1791,Tanguy Ndombele,FRA,MF,Lyon,Ligue 1,20,1996,26.1,62,39,23,31,8,11,40,27.5,29,53,8,45,36,98,9,0,0,2017-2018,90.0,124.13793103448275,213.79310344827584
1792,Reiss Nelson,ENG,"FW,MF",Arsenal,Premier League,17,1999,1.6,4,3,1,1,2,0,0,0.0,0,4,0,4,3,7,0,0,0,2017-2018,90.0,168.75,225.0
1793,Neto,BRA,GK,Valencia,La Liga,28,1989,33.0,1,1,1,0,0,1,2,50.0,1,1,0,1,1,2,8,3,0,2017-2018,90.0,2.7272727272727275,2.7272727272727275
1794,Manuel Neuer,GER,GK,Bayern Munich,Bundesliga,31,1986,3.0,0,0,0,0,0,0,0,0.0,0,0,0,0,0,0,1,0,0,2017-2018,90.0,0.0,0.0
1795,Neymar,BRA,FW,Paris S-G,Ligue 1,25,1992,19.8,20,14,3,11,6,7,40,17.5,33,4,0,4,5,25,2,0,0,2017-2018,90.0,22.727272727272727,90.9090909090909
1796,Yeni Ngbakoto,COD,"FW,MF",Guingamp,Ligue 1,25,1992,6.4,11,10,4,6,1,3,10,30.0,7,10,0,10,9,20,6,0,0,2017-2018,90.0,126.5625,154.6875
1797,Santy Ngom,SEN,"FW,MF",Nantes,Ligue 1,24,1993,5.2,10,5,5,5,0,1,8,12.5,7,9,1,8,2,12,2,0,0,2017-2018,90.0,34.61538461538461,173.07692307692307
1798,Guy Ngosso,CMR,MF,Amiens,Ligue 1,32,1985,6.8,8,5,4,4,0,4,20,20.0,16,5,3,2,9,17,19,0,0,2017-2018,90.0,119.11764705882352,105.88235294117646
1799,Julien Ngoy,BEL,MF,Stoke City,Premier League,19,1997,0.2,1,1,0,1,0,1,2,50.0,1,0,0,0,0,1,0,0,0,2017-2018,90.0,0.0,450.0
1800,Opa Nguette,SEN,"FW,MF",Metz,Ligue 1,23,1994,11.4,27,22,11,12,4,5,21,23.8,16,10,0,10,18,45,13,0,0,2017-2018,90.0,142.1052631578947,213.15789473684208
1801,Moussa Niakhate,SEN,DF,Metz,Ligue 1,21,1996,34.5,57,38,44,12,1,22,37,59.5,15,27,14,13,55,112,139,1,0,2017-2018,90.0,143.47826086956522,148.69565217391303
1802,Adama Niane,MLI,FW,Troyes,Ligue 1,24,1993,24.0,22,12,5,10,7,6,26,23.1,20,11,2,9,9,31,13,0,0,2017-2018,90.0,33.75,82.5
1803,Ibrahima Niane,SEN,"FW,MF",Metz,Ligue 1,18,1999,9.4,6,5,4,1,1,2,8,25.0,6,6,0,6,4,10,8,0,0,2017-2018,90.0,38.29787234042553,57.44680851063829
1804,M'Baye Niang,SEN,FW,Torino,Serie A,22,1994,17.0,29,23,11,9,9,6,18,33.3,12,17,3,14,13,42,15,0,0,2017-2018,90.0,68.82352941176471,153.52941176470588
1805,Oumar Niasse,SEN,FW,Everton,Premier League,27,1990,12.1,10,6,2,5,3,4,19,21.1,15,3,2,1,2,12,6,0,0,2017-2018,90.0,14.87603305785124,74.3801652892562
1806,Florian Niederlechner,GER,"FW,MF",Freiburg,Bundesliga,26,1990,7.7,8,6,1,5,2,2,5,40.0,3,5,1,4,3,11,6,0,0,2017-2018,90.0,35.064935064935064,93.50649350649351
1807,Saúl Ñíguez,ESP,MF,Atlético Madrid,La Liga,22,1994,35.1,132,90,53,69,10,40,104,38.5,64,61,12,49,55,187,77,0,0,2017-2018,90.0,141.02564102564102,338.46153846153845
1808,Casimir Ninga,CHA,"FW,MF",Montpellier,Ligue 1,24,1993,14.3,12,7,1,6,5,2,10,20.0,8,12,2,10,4,16,13,0,0,2017-2018,90.0,25.174825174825177,75.52447552447552
1809,Benjamin Nivet,FRA,"MF,FW",Troyes,Ligue 1,40,1977,15.2,31,14,12,14,5,11,51,21.6,40,18,1,17,16,47,20,0,0,2017-2018,90.0,94.73684210526315,183.55263157894737
1810,Eddie Nketiah,ENG,FW,Arsenal,Premier League,18,1999,0.2,1,1,0,1,0,0,0,0.0,0,0,0,0,0,1,0,0,0,2017-2018,90.0,0.0,450.0
1811,Jordan Nkololo,COD,"MF,FW",Caen,Ligue 1,24,1992,4.7,9,6,4,5,0,1,4,25.0,3,7,1,6,1,10,0,0,0,2017-2018,90.0,19.148936170212764,172.3404255319149
1812,Nicolas Nkoulou,CMR,DF,Torino,Serie A,27,1990,36.2,56,40,40,15,1,22,33,66.7,11,44,22,22,57,113,163,1,0,2017-2018,90.0,141.71270718232043,139.22651933701655
1813,Christopher Nkunku,FRA,"FW,MF",Paris S-G,Ligue 1,19,1997,7.0,5,2,2,2,1,3,14,21.4,11,8,2,6,5,10,2,1,0,2017-2018,90.0,64.28571428571428,64.28571428571428
1814,Lukas Nmecha,GER,FW,Manchester City,Premier League,18,1998,0.2,0,0,0,0,0,0,0,0.0,0,0,0,0,0,0,0,0,0,2017-2018,90.0,0.0,0.0
1815,Mark Noble,ENG,MF,West Ham,Premier League,30,1987,26.7,61,36,32,22,7,16,76,21.1,60,28,10,18,47,108,32,1,0,2017-2018,90.00000000000001,158.42696629213484,205.6179775280899
1816,Vincent Nogueira,FRA,MF,Strasbourg,Ligue 1,29,1988,0.7,0,0,0,0,0,0,0,0.0,0,0,0,0,0,0,2,0,0,2017-2018,90.0,0.0,0.0
1817,Nolito,ESP,"FW,MF",Sevilla,La Liga,30,1986,17.8,49,36,21,21,7,14,33,42.4,19,17,2,15,10,59,17,0,0,2017-2018,90.0,50.56179775280899,247.75280898876406
1818,Håvard Nordtveit,NOR,DF,Hoffenheim,Bundesliga,27,1990,10.8,19,16,10,9,0,13,18,72.2,5,19,8,11,10,29,50,0,0,2017-2018,90.0,83.33333333333333,158.33333333333331
1819,Paul-Georges Ntep,CMR,"FW,MF",Saint-Étienne,Ligue 1,25,1992,5.7,14,8,8,5,1,8,17,47.1,9,4,1,3,3,17,4,0,0,2017-2018,90.0,47.368421052631575,221.05263157894734
1820,Paul-Georges Ntep,CMR,"FW,MF",Wolfsburg,Bundesliga,25,1992,1.8,2,2,0,0,2,0,1,0.0,1,3,1,2,1,3,0,0,0,2017-2018,90.0,50.0,100.0
1821,Alexander Nübel,GER,GK,Schalke 04,Bundesliga,20,1996,0.5,0,0,0,0,0,0,0,0.0,0,0,0,0,0,0,0,0,0,2017-2018,90.0,0.0,0.0
1822,Unai Núñez,ESP,DF,Athletic Club,La Liga,20,1997,32.7,73,52,54,19,0,38,56,67.9,18,52,27,25,67,140,155,2,0,2017-2018,90.0,184.40366972477065,200.91743119266056
1823,Bram Nuytinck,NED,DF,Udinese,Serie A,27,1990,26.2,65,41,40,24,1,25,39,64.1,14,43,24,19,37,102,124,1,0,2017-2018,90.0,127.09923664122138,223.28244274809163
1824,Simeon Nwankwo,NGA,FW,Crotone,Serie A,25,1992,13.5,12,9,1,5,6,1,12,8.3,11,16,3,13,1,13,20,0,0,2017-2018,90.0,6.666666666666667,80.0
1825,Gerzino Nyamsi,FRA,DF,Rennes,Ligue 1,20,1997,3.0,4,2,4,0,0,0,3,0.0,3,2,2,0,3,7,18,2,0,2017-2018,90.0,90.0,120.0
1826,Allan Nyom,CMR,DF,West Brom,Premier League,29,1988,25.7,64,39,43,17,4,28,43,65.1,15,20,9,11,27,91,93,0,0,2017-2018,90.0,94.55252918287937,224.12451361867704
1827,Steven Nzonzi,FRA,MF,Sevilla,La Liga,28,1988,24.6,39,26,14,19,6,20,30,66.7,10,27,8,19,28,67,36,2,0,2017-2018,89.99999999999999,102.43902439024389,142.68292682926827
1828,Aiden O'Neill,AUS,MF,Burnley,Premier League,19,1998,0.0,0,0,0,0,0,,0,0.0,0,0,0,0,0,0,0,0,0,2017-2018,,,
1829,Michael Obafemi,IRL,FW,Southampton,Premier League,17,2000,0.1,0,0,0,0,0,0,0,0.0,0,0,0,0,0,0,0,0,0,2017-2018,90.0,0.0,0.0
1830,Joel Obi,NGA,MF,Torino,Serie A,26,1991,13.9,45,25,20,20,5,8,26,30.8,18,17,3,14,24,69,15,0,0,2017-2018,90.0,155.3956834532374,291.36690647482015
1831,Johann Obiang,GAB,DF,Troyes,Ligue 1,24,1993,5.2,13,9,9,2,2,6,13,46.2,7,9,1,8,7,20,15,0,0,2017-2018,90.0,121.15384615384615,224.99999999999997
1832,Pedro Obiang,EQG,MF,West Ham,Premier League,25,1992,17.4,53,34,20,29,4,17,51,33.3,34,37,16,21,24,77,27,1,0,2017-2018,90.0,124.13793103448276,274.1379310344828
1833,Jan Oblak,SVN,GK,Atlético Madrid,La Liga,24,1993,37.0,0,0,0,0,0,0,0,0.0,0,0,0,0,2,2,7,0,0,2017-2018,90.0,4.864864864864865,0.0
1834,Lucas Ocampos,ARG,FW,Marseille,Ligue 1,23,1994,22.6,83,57,30,44,9,30,93,32.3,63,42,3,39,30,113,26,0,0,2017-2018,90.0,119.46902654867256,330.53097345132744
1835,Philipp Ochs,GER,"FW,DF",Hoffenheim,Bundesliga,20,1997,0.8,5,4,1,3,1,1,2,50.0,1,0,0,0,1,6,0,0,0,2017-2018,90.0,112.5,562.5
1836,Bastian Oczipka,GER,"DF,MF",Schalke 04,Bundesliga,28,1989,25.8,60,48,29,26,5,29,37,78.4,8,41,2,39,40,100,40,1,0,2017-2018,90.0,139.53488372093022,209.30232558139534
1837,Álvaro Odriozola,ESP,DF,Real Sociedad,La Liga,21,1995,32.4,41,27,22,15,4,20,35,57.1,15,25,7,18,26,67,50,0,0,2017-2018,90.0,72.22222222222223,113.8888888888889
1838,Ebenezer Ofori,GHA,MF,Stuttgart,Bundesliga,22,1995,0.1,0,0,0,0,0,0,1,0.0,1,1,0,1,0,0,0,0,0,2017-2018,90.0,0.0,0.0
1839,Angelo Ogbonna,ITA,DF,West Ham,Premier League,29,1988,32.0,30,24,18,10,2,8,18,44.4,10,40,27,13,58,88,197,1,0,2017-2018,90.0,163.125,84.375
1840,Marios Oikonomou,GRE,DF,SPAL,Serie A,24,1992,1.9,5,3,4,1,0,0,2,0.0,2,0,0,0,4,9,12,0,0,2017-2018,90.0,189.4736842105263,236.8421052631579
1841,Stefano Okaka,ITA,FW,Watford,Premier League,27,1989,5.0,6,4,0,6,0,3,6,50.0,3,3,0,3,0,6,0,0,0,2017-2018,90.0,0.0,108.0
1842,Shinji Okazaki,JPN,"FW,MF",Leicester City,Premier League,31,1986,14.7,25,16,3,18,4,4,28,14.3,24,15,1,14,8,33,6,0,0,2017-2018,90.0,48.97959183673469,153.06122448979593
1843,Orji Okwonkwo,NGA,"FW,MF",Bologna,Serie A,19,1998,2.9,9,3,6,3,0,1,4,25.0,3,2,0,2,1,10,1,0,0,2017-2018,90.0,31.03448275862069,279.3103448275862
1844,Kwasi Okyere Wriedt,GHA,MF,Bayern Munich,Bundesliga,23,1994,0.3,2,2,1,1,0,0,0,0.0,0,0,0,0,0,2,0,0,0,2017-2018,90.0,0.0,600.0
1845,Oier Olazábal,ESP,GK,Levante,La Liga,27,1989,26.0,0,0,0,0,0,0,2,0.0,2,1,0,1,1,1,12,3,0,2017-2018,90.00000000000001,3.4615384615384617,0.0
1846,Paulo Oliveira,POR,DF,Eibar,La Liga,25,1992,24.6,41,22,28,13,0,16,22,72.7,6,23,9,14,62,103,140,0,0,2017-2018,89.99999999999999,226.82926829268288,149.99999999999997
1847,Mathías Olivera,URU,MF,Getafe,La Liga,19,1997,1.1,3,1,1,0,2,3,5,60.0,2,3,0,3,1,4,2,0,0,2017-2018,90.0,81.81818181818181,245.45454545454544
1848,Maximiliano Olivera,URU,DF,Fiorentina,Serie A,25,1992,4.6,12,9,5,4,3,3,8,37.5,5,4,1,3,11,23,11,0,0,2017-2018,90.0,215.21739130434784,234.7826086956522
1849,Paweł Olkowski,POL,DF,Köln,Bundesliga,27,1990,5.0,17,12,9,8,0,5,9,55.6,4,11,2,9,3,20,17,0,0,2017-2018,90.0,54.0,306.0
1850,Martin Olsson,SWE,DF,Swansea City,Premier League,29,1988,35.0,34,26,18,10,6,12,29,41.4,17,21,4,17,31,65,81,0,0,2017-2018,90.0,79.71428571428571,87.42857142857143
1851,Michael Olunga,KEN,"FW,MF",Girona,La Liga,23,1994,4.8,6,5,1,3,2,1,3,33.3,2,5,0,5,3,9,5,0,0,2017-2018,90.0,56.25000000000001,112.50000000000001
1852,Stephane Omeonga,BEL,"MF,DF",Genoa,Serie A,21,1996,8.9,25,15,16,8,1,7,18,38.9,11,20,1,19,5,30,6,0,0,2017-2018,90.0,50.56179775280899,252.80898876404495
1853,Prince Oniangué,CGO,MF,Angers,Ligue 1,28,1988,11.7,16,11,5,9,2,8,31,25.8,23,20,4,16,11,27,8,0,0,2017-2018,89.99999999999999,84.61538461538461,123.07692307692307
1854,Karim Onisiwo,AUT,"DF,FW",Mainz 05,Bundesliga,25,1992,2.8,7,5,5,1,1,3,7,42.9,4,4,0,4,1,8,8,0,0,2017-2018,90.0,32.142857142857146,225.0
1855,Javier Ontiveros,ESP,"MF,FW",Málaga,La Liga,19,1997,4.3,10,7,8,2,0,2,4,50.0,2,4,2,2,4,14,4,0,0,2017-2018,90.0,83.72093023255815,209.30232558139537
1856,Daniel Opare,GHA,DF,Augsburg,Bundesliga,26,1990,15.7,31,27,20,10,1,21,27,77.8,6,14,5,9,28,59,56,0,0,2017-2018,90.0,160.5095541401274,177.70700636942678
1857,Willi Orban,HUN,DF,RB Leipzig,Bundesliga,24,1992,23.6,49,30,35,14,0,29,43,67.4,14,45,18,27,28,77,155,1,0,2017-2018,90.0,106.77966101694915,186.864406779661
1858,Fabián Orellana,CHI,"MF,FW",Eibar,La Liga,31,1986,13.1,14,8,5,8,1,4,23,17.4,19,10,1,9,7,21,3,0,0,2017-2018,90.0,48.091603053435115,96.18320610687023
1859,Divock Origi,BEL,FW,Liverpool,Premier League,22,1995,0.1,0,0,0,0,0,0,0,0.0,0,0,0,0,0,0,0,0,0,2017-2018,90.0,0.0,0.0
1860,Divock Origi,BEL,FW,Wolfsburg,Bundesliga,22,1995,21.9,6,5,2,3,1,1,7,14.3,6,16,2,14,3,9,17,0,0,2017-2018,90.0,12.328767123287673,24.657534246575345
1861,Riccardo Orsolini,ITA,"FW,DF",Bologna,Serie A,20,1997,3.8,5,5,4,1,0,1,5,20.0,4,2,1,1,3,8,4,0,0,2017-2018,90.0,71.05263157894737,118.42105263157895
1862,Riccardo Orsolini,ITA,"MF,FW",Atalanta,Serie A,20,1997,1.4,3,2,3,0,0,1,1,100.0,0,1,0,1,0,3,0,0,0,2017-2018,90.0,0.0,192.85714285714286
1863,Yuya Osako,JPN,"FW,MF",Köln,Bundesliga,27,1990,21.1,13,10,4,9,0,4,18,22.2,14,13,2,11,8,21,22,0,0,2017-2018,90.0,34.12322274881517,55.45023696682464
1864,Victor Osimhen,NGA,"FW,MF",Wolfsburg,Bundesliga,18,1998,3.2,4,4,3,1,0,2,5,40.0,3,2,1,1,2,6,7,0,0,2017-2018,90.0,56.25,112.5
1865,David Ospina,COL,GK,Arsenal,Premier League,28,1988,4.2,0,0,0,0,0,0,0,0.0,0,0,0,0,0,0,1,0,0,2017-2018,90.0,0.0,0.0
1866,Matthias Ostrzolek,GER,"DF,MF",Hannover 96,Bundesliga,27,1990,26.4,68,53,43,20,5,38,57,66.7,19,39,10,29,30,98,58,1,0,2017-2018,90.0,102.27272727272727,231.8181818181818
1867,Nicolás Otamendi,ARG,DF,Manchester City,Premier League,29,1988,33.0,58,43,35,22,1,19,44,43.2,25,21,10,11,48,106,129,3,0,2017-2018,90.0,130.9090909090909,158.1818181818182
1868,Otávio,BRA,MF,Bordeaux,Ligue 1,23,1994,16.5,64,42,25,37,2,20,61,32.8,41,26,4,22,32,96,35,0,0,2017-2018,90.0,174.54545454545456,349.0909090909091
1869,Anas Ouahim,GER,MF,Köln,Bundesliga,19,1997,0.2,1,1,0,1,0,1,1,100.0,0,0,0,0,0,1,0,0,0,2017-2018,90.0,0.0,450.0
1870,Alexandre Oukidja,ALG,GK,Strasbourg,Ligue 1,29,1988,16.2,0,0,0,0,0,0,1,0.0,1,0,0,0,3,3,9,1,0,2017-2018,90.0,16.666666666666668,0.0
1871,Adam Ounas,ALG,FW,Napoli,Serie A,20,1996,1.1,4,3,0,2,2,1,4,25.0,3,2,0,2,0,4,2,0,0,2017-2018,90.0,0.0,327.27272727272725
1872,Reece Oxford,ENG,MF,West Ham,Premier League,18,1998,0.1,2,1,1,1,0,1,1,100.0,0,0,0,0,0,2,0,0,0,2017-2018,90.0,0.0,1800.0
1873,Reece Oxford,ENG,"DF,MF",Gladbach,Bundesliga,18,1998,5.1,8,6,3,4,1,3,4,75.0,1,4,0,4,9,17,26,1,0,2017-2018,90.0,158.82352941176472,141.1764705882353
1874,Alex Oxlade-Chamberlain,ENG,DF,Arsenal,Premier League,23,1993,2.7,5,3,2,2,1,2,3,66.7,1,5,2,3,6,11,8,0,0,2017-2018,90.0,199.99999999999997,166.66666666666666
1875,Alex Oxlade-Chamberlain,ENG,"MF,FW",Liverpool,Premier League,23,1993,16.6,32,21,13,14,5,6,21,28.6,15,24,0,24,20,52,14,0,0,2017-2018,90.0,108.43373493975902,173.49397590361443
1876,Mikel Oyarzabal,ESP,"FW,MF",Real Sociedad,La Liga,20,1997,30.8,33,23,10,13,10,7,39,17.9,32,32,2,30,18,51,19,0,0,2017-2018,90.0,52.5974025974026,96.42857142857143
1877,Ambroise Oyongo,CMR,DF,Montpellier,Ligue 1,26,1991,2.2,2,1,1,1,0,0,1,0.0,1,2,1,1,6,8,6,0,0,2017-2018,90.0,245.45454545454544,81.81818181818181
1878,Berkay Özcan,TUR,"MF,FW",Stuttgart,Bundesliga,19,1998,11.1,19,10,7,9,3,7,11,63.6,4,14,2,12,3,22,8,0,0,2017-2018,90.0,24.324324324324326,154.05405405405406
1879,Ramazan Özcan,AUT,GK,Leverkusen,Bundesliga,33,1984,1.0,0,0,0,0,0,0,1,0.0,1,0,0,0,0,0,0,0,0,2017-2018,90.0,0.0,0.0
1880,Salih Özcan,TUR,MF,Köln,Bundesliga,19,1998,18.6,56,42,24,29,3,28,54,51.9,26,27,5,22,29,85,22,1,0,2017-2018,90.0,140.32258064516128,270.96774193548384
1881,Mesut Özil,GER,"MF,FW",Arsenal,Premier League,28,1988,24.0,20,13,6,10,4,5,22,22.7,17,11,1,10,12,32,9,0,0,2017-2018,90.0,45.0,75.0
1882,Levin Öztunalı,GER,"FW,MF",Mainz 05,Bundesliga,21,1996,19.3,26,19,8,15,3,10,20,50.0,10,25,0,25,11,37,9,0,0,2017-2018,90.0,51.295336787564764,121.24352331606217
1883,Pablo,BRA,DF,Bordeaux,Ligue 1,26,1991,14.3,16,15,13,3,0,10,16,62.5,6,13,7,6,16,32,96,1,0,2017-2018,90.0,100.69930069930071,100.69930069930071
1884,Daniel Pacheco,ESP,"MF,FW",Getafe,La Liga,26,1991,1.9,4,4,1,2,1,0,1,0.0,1,2,0,2,2,6,1,0,0,2017-2018,90.0,94.73684210526315,189.4736842105263
1885,Fernando Pacheco,ESP,GK,Alavés,La Liga,25,1992,37.3,0,0,0,0,0,0,0,0.0,0,1,0,1,3,3,12,4,0,2017-2018,90.0,7.238605898123326,0.0
1886,Simone Padoin,ITA,"DF,MF",Cagliari,Serie A,33,1984,34.5,22,18,8,10,4,12,28,42.9,16,38,14,24,24,46,74,0,0,2017-2018,90.0,62.60869565217391,57.391304347826086
1887,Vincent Pajot,FRA,MF,Saint-Étienne,Ligue 1,26,1990,14.3,24,16,9,13,2,3,17,17.6,14,21,9,12,24,48,34,0,0,2017-2018,90.0,151.04895104895104,151.04895104895104
1888,Rodrigo Palacio,ARG,"FW,MF",Bologna,Serie A,35,1982,22.9,25,18,6,12,7,10,28,35.7,18,16,2,14,12,37,14,0,0,2017-2018,90.0,47.16157205240175,98.25327510917032
1889,Raffaele Palladino,ITA,"MF,FW",Genoa,Serie A,33,1984,2.6,1,1,1,0,0,0,1,0.0,1,0,0,0,1,2,0,0,0,2017-2018,90.0,34.61538461538461,34.61538461538461
1890,Nicolas Pallois,FRA,DF,Nantes,Ligue 1,29,1987,27.0,39,28,25,9,5,18,36,50.0,18,34,19,15,35,74,182,3,0,2017-2018,90.0,116.66666666666667,130.0
1891,Kasey Palmer,JAM,"MF,FW",Huddersfield,Premier League,20,1996,1.9,6,3,2,3,1,2,8,25.0,6,5,0,5,0,6,2,0,0,2017-2018,90.0,0.0,284.2105263157895
1892,Emerson Palmieri,ITA,DF,Chelsea,Premier League,22,1994,3.1,6,4,4,2,0,5,5,100.0,0,2,0,2,2,8,10,0,0,2017-2018,90.0,58.064516129032256,174.19354838709677
1893,Emerson Palmieri,ITA,DF,Roma,Serie A,22,1994,0.2,0,0,0,0,0,0,0,0.0,0,0,0,0,0,0,0,0,0,2017-2018,90.0,0.0,0.0
1894,Julian Palmieri,FRA,DF,Metz,Ligue 1,30,1986,12.5,29,15,17,9,3,17,29,58.6,12,16,2,14,22,51,31,0,0,2017-2018,90.0,158.4,208.79999999999998
1895,Simone Palombi,ITA,FW,Lazio,Serie A,21,1996,0.7,0,0,0,0,0,0,0,0.0,0,0,0,0,0,0,0,0,0,2017-2018,90.0,0.0,0.0
1896,Alberto Paloschi,ITA,FW,SPAL,Serie A,27,1990,24.3,10,7,0,9,1,0,10,0.0,10,2,1,1,4,14,11,0,0,2017-2018,90.0,14.814814814814813,37.03703703703704
1897,Goran Pandev,MKD,"FW,MF",Genoa,Serie A,34,1983,20.0,10,9,3,6,1,2,13,15.4,11,8,0,8,4,14,5,0,0,2017-2018,90.0,18.0,45.0
1898,Costel Pantilimon,ROU,GK,La Coruña,La Liga,30,1987,6.0,0,0,0,0,0,0,1,0.0,1,0,0,0,0,0,0,1,0,2017-2018,90.0,0.0,0.0
1899,Kyriakos Papadopoulos,GRE,DF,Hamburger SV,Bundesliga,25,1992,29.0,60,54,36,24,0,41,69,59.4,28,54,35,19,43,103,181,2,0,2017-2018,90.0,133.44827586206895,186.20689655172413
1900,Sokratis Papastathopoulos,GRE,DF,Dortmund,Bundesliga,29,1988,26.4,65,47,50,13,2,39,47,83.0,8,36,11,25,30,95,112,0,0,2017-2018,90.0,102.27272727272727,221.5909090909091
1901,Rubén Pardo,ESP,MF,Real Sociedad,La Liga,24,1992,2.5,1,0,0,1,0,1,2,50.0,1,5,0,5,5,6,1,0,0,2017-2018,90.0,180.0,36.0
1902,Nicolás Pareja,ARG,DF,Sevilla,La Liga,33,1984,4.5,11,8,7,3,1,3,5,60.0,2,8,1,7,13,24,24,0,0,2017-2018,90.0,260.0,220.0
1903,Daniel Parejo,ESP,MF,Valencia,La Liga,28,1989,33.3,88,57,35,43,10,31,87,35.6,56,37,10,27,34,122,27,1,0,2017-2018,90.0,91.89189189189189,237.83783783783784
1904,Vittorio Parigini,ITA,"MF,FW",Benevento,Serie A,21,1996,9.5,18,11,11,6,1,6,17,35.3,11,8,1,7,5,23,1,0,0,2017-2018,90.0,47.36842105263158,170.52631578947367
1905,Shawn Parker,GER,"FW,MF",Augsburg,Bundesliga,24,1993,0.5,0,0,0,0,0,0,0,0.0,0,0,0,0,0,0,0,0,0,2017-2018,90.0,0.0,0.0
1906,Marco Parolo,ITA,MF,Lazio,Serie A,32,1985,29.0,70,37,27,36,7,14,58,24.1,44,49,8,41,43,113,64,0,0,2017-2018,90.0,133.44827586206895,217.24137931034483
1907,Thomas Partey,GHA,"MF,DF",Atlético Madrid,La Liga,24,1993,26.4,94,64,48,39,7,33,69,47.8,36,32,7,25,53,147,34,1,0,2017-2018,90.0,180.6818181818182,320.45454545454544
1908,Felix Passlack,GER,"FW,DF",Hoffenheim,Bundesliga,19,1998,0.7,2,2,2,0,0,2,3,66.7,1,0,0,0,0,2,2,0,0,2017-2018,90.0,0.0,257.14285714285717
1909,Felix Passlack,GER,DF,Dortmund,Bundesliga,19,1998,0.1,0,0,0,0,0,0,0,0.0,0,0,0,0,1,1,0,0,0,2017-2018,90.0,900.0,0.0
1910,Javier Pastore,ARG,"MF,FW",Paris S-G,Ligue 1,28,1989,15.0,33,21,9,16,8,5,23,21.7,18,13,0,13,10,43,14,1,0,2017-2018,90.0,60.0,198.0
1911,Patric,ESP,DF,Lazio,Serie A,24,1993,6.6,11,6,8,2,1,4,6,66.7,2,3,0,3,3,14,32,0,0,2017-2018,90.0,40.90909090909091,150.0
1912,Paulinho,BRA,MF,Barcelona,La Liga,29,1988,21.6,39,28,17,15,7,11,38,28.9,27,25,3,22,15,54,16,1,0,2017-2018,90.0,62.49999999999999,162.5
1913,Gabriel Paulista,BRA,DF,Valencia,La Liga,26,1990,28.7,47,27,41,4,2,32,46,69.6,14,30,14,16,51,98,142,2,0,2017-2018,90.0,159.93031358885017,147.38675958188153
1914,Benjamin Pavard,FRA,DF,Stuttgart,Bundesliga,21,1996,34.0,55,40,40,13,2,36,47,76.6,11,59,34,25,70,125,192,1,0,2017-2018,90.0,185.29411764705884,145.58823529411765
1915,Jiří Pavlenka,CZE,GK,Werder Bremen,Bundesliga,25,1992,34.0,1,1,1,0,0,0,0,0.0,0,2,0,2,0,1,17,4,0,2017-2018,90.0,0.0,2.6470588235294117
1916,Daniel Pavlović,BIH,DF,Crotone,Serie A,29,1988,8.4,10,5,9,0,1,5,10,50.0,5,4,3,1,5,15,22,0,0,2017-2018,90.0,53.57142857142857,107.14285714285714
1917,Daniel Pavlović,BIH,DF,Sampdoria,Serie A,29,1988,1.0,3,1,1,1,1,1,1,100.0,0,0,0,0,0,3,5,0,0,2017-2018,90.0,0.0,270.0
1918,Mateo Pavlović,BIH,DF,Angers,Ligue 1,27,1990,21.8,13,7,10,3,0,7,20,35.0,13,14,11,3,21,34,120,0,0,2017-2018,90.0,86.69724770642202,53.6697247706422
1919,Leonardo Pavoletti,ITA,FW,Cagliari,Serie A,28,1988,30.2,27,13,5,14,8,2,21,9.5,19,13,5,8,13,40,28,0,0,2017-2018,90.0,38.741721854304636,80.4635761589404
1920,Dimitri Payet,FRA,"MF,FW",Marseille,Ligue 1,30,1987,26.1,22,11,5,13,4,8,37,21.6,29,19,2,17,19,41,7,1,0,2017-2018,90.0,65.51724137931033,75.86206896551724
1921,Giampaolo Pazzini,ITA,FW,Hellas Verona,Serie A,32,1984,11.0,0,0,0,0,0,0,4,0.0,4,2,0,2,1,1,13,0,0,2017-2018,90.0,8.181818181818182,0.0
1922,Giampaolo Pazzini,ITA,FW,Levante,La Liga,32,1984,4.9,0,0,0,0,0,0,0,0.0,0,1,0,1,1,1,1,0,0,2017-2018,90.0,18.36734693877551,0.0
1923,Alfonso Pedraza,ESP,"MF,DF",Alavés,La Liga,21,1996,27.1,57,40,24,21,12,19,56,33.9,37,39,5,34,32,89,26,0,0,2017-2018,90.0,106.2730627306273,189.29889298892988
1924,Pedro,ESP,"MF,FW",Chelsea,Premier League,30,1987,16.9,20,11,6,8,6,5,18,27.8,13,13,1,12,13,33,7,1,0,2017-2018,90.0,69.23076923076924,106.50887573964498
1925,João Pedro,ITA,"MF,FW",Cagliari,Serie A,25,1992,18.4,15,9,4,9,2,0,12,0.0,12,9,1,8,11,26,24,0,0,2017-2018,90.0,53.80434782608696,73.36956521739131
1926,Stef Peeters,BEL,MF,Caen,Ligue 1,25,1992,12.3,22,11,6,14,2,6,31,19.4,25,17,3,14,7,29,11,0,0,2017-2018,89.99999999999999,51.21951219512194,160.97560975609753
1927,Gianluca Pegolo,ITA,GK,Sassuolo,Serie A,36,1981,1.2,0,0,0,0,0,0,0,0.0,0,0,0,0,0,0,0,0,0,2017-2018,90.0,0.0,0.0
1928,Peter Pekarík,SVK,DF,Hertha BSC,Bundesliga,30,1986,15.3,42,33,17,21,4,21,29,72.4,8,23,3,20,18,60,44,0,0,2017-2018,90.0,105.88235294117646,247.05882352941174
1929,Bryan Pelé,FRA,"FW,MF",Troyes,Ligue 1,25,1992,17.9,20,9,9,8,3,4,28,14.3,24,11,0,11,15,35,13,0,0,2017-2018,90.0,75.41899441340783,100.5586592178771
1930,Yohann Pelé,FRA,GK,Marseille,Ligue 1,34,1982,8.2,0,0,0,0,0,0,1,0.0,1,0,0,0,1,1,2,0,0,2017-2018,90.0,10.975609756097562,0.0
1931,Pietro Pellegri,ITA,FW,Genoa,Serie A,16,2001,3.1,1,0,0,0,1,0,5,0.0,5,3,0,3,2,3,1,0,0,2017-2018,90.0,58.064516129032256,29.032258064516128
1932,Pietro Pellegri,ITA,FW,Monaco,Ligue 1,16,2001,0.3,0,0,0,0,0,0,2,0.0,2,1,0,1,0,0,0,0,0,2017-2018,90.0,0.0,0.0
1933,Lorenzo Pellegrini,ITA,MF,Roma,Serie A,21,1996,20.0,36,20,16,11,9,10,35,28.6,25,21,2,19,41,77,21,1,0,2017-2018,90.0,184.5,162.0
1934,Théo Pellenard,FRA,DF,Bordeaux,Ligue 1,23,1994,15.9,32,20,13,15,4,10,28,35.7,18,15,6,9,32,64,31,0,0,2017-2018,90.0,181.1320754716981,181.1320754716981
1935,Sergio Pellissier,ITA,FW,Chievo,Serie A,38,1979,6.2,6,2,1,3,2,1,3,33.3,2,3,0,3,1,7,2,0,0,2017-2018,90.0,14.516129032258064,87.09677419354838
1936,Federico Peluso,ITA,DF,Sassuolo,Serie A,33,1984,28.8,46,34,29,13,4,14,26,53.8,12,39,13,26,40,86,132,1,0,2017-2018,90.0,125.0,143.75
1937,Rubén Peña,ESP,"DF,MF",Eibar,La Liga,26,1991,19.2,41,28,20,17,4,20,42,47.6,22,24,6,18,30,71,31,0,0,2017-2018,90.0,140.625,192.1875
1938,Gabriel Peñalba,ARG,MF,Las Palmas,La Liga,32,1984,6.3,6,5,4,2,0,5,11,45.5,6,7,4,3,8,14,15,0,0,2017-2018,90.0,114.28571428571429,85.71428571428572
1939,Adalberto Peñaranda,VEN,"FW,MF",Málaga,La Liga,20,1997,8.9,10,6,2,6,2,2,3,66.7,1,8,1,7,0,10,1,0,0,2017-2018,90.0,0.0,101.12359550561798
1940,Nicolas Pépé,CIV,"FW,MF",Lille,Ligue 1,22,1995,31.6,30,18,14,11,5,11,42,26.2,31,23,0,23,10,40,20,0,0,2017-2018,90.0,28.481012658227844,85.44303797468353
1941,Andreas Pereira,BRA,MF,Valencia,La Liga,21,1996,12.0,26,15,12,11,3,10,30,33.3,20,9,1,8,11,37,5,0,0,2017-2018,90.0,82.5,195.0
1942,Pedro Pereira,POR,DF,Genoa,Serie A,19,1998,4.2,5,4,2,1,2,3,5,60.0,2,5,2,3,5,10,15,0,0,2017-2018,90.0,107.14285714285714,107.14285714285714
1943,Bruno Peres,BRA,DF,Roma,Serie A,27,1990,12.8,26,17,16,7,3,10,23,43.5,13,9,2,7,22,48,28,1,0,2017-2018,90.0,154.6875,182.8125
1944,Roberto Pereyra,ARG,"MF,FW",Watford,Premier League,26,1991,18.0,10,8,4,5,1,2,13,15.4,11,16,0,16,9,19,6,0,0,2017-2018,90.0,45.0,50.0
1945,Ayoze Pérez,ESP,"MF,FW",Newcastle Utd,Premier League,24,1993,27.7,39,21,11,15,13,12,54,22.2,42,36,1,35,24,63,28,0,0,2017-2018,90.0,77.9783393501805,126.71480144404333
1946,Hernán Pérez,PAR,MF,Alavés,La Liga,28,1989,4.2,11,8,6,4,1,2,19,10.5,17,5,0,5,3,14,6,0,0,2017-2018,90.0,64.28571428571428,235.7142857142857
1947,Hernán Pérez,PAR,"MF,DF",Espanyol,La Liga,28,1989,1.6,4,3,1,1,2,2,3,66.7,1,1,0,1,1,5,1,0,0,2017-2018,90.0,56.25,225.0
1948,Lucas Pérez,ESP,FW,La Coruña,La Liga,28,1988,31.1,17,12,5,8,4,1,32,3.1,31,19,1,18,9,26,1,0,0,2017-2018,90.0,26.045016077170416,49.19614147909968
1949,Rubén Pérez,ESP,MF,Leganés,La Liga,28,1989,28.0,99,61,47,48,4,48,101,47.5,53,30,5,25,77,176,40,0,0,2017-2018,90.0,247.5,318.2142857142857
1950,Stipe Perica,CRO,FW,Udinese,Serie A,22,1995,10.5,8,5,2,5,1,2,13,15.4,11,7,1,6,3,11,9,0,0,2017-2018,90.0,25.714285714285715,68.57142857142857
1951,Mattia Perin,ITA,GK,Genoa,Serie A,24,1992,37.0,0,0,0,0,0,0,1,0.0,1,0,0,0,1,1,14,2,0,2017-2018,90.0,2.4324324324324325,0.0
1952,Ivan Perišić,CRO,FW,Inter,Serie A,28,1989,36.8,47,31,15,23,9,8,56,14.3,48,47,6,41,45,92,62,0,0,2017-2018,90.0,110.05434782608697,114.94565217391305
1953,Diego Perotti,ARG,"FW,MF",Roma,Serie A,29,1988,17.9,25,17,6,14,5,8,20,40.0,12,19,0,19,11,36,13,0,0,2017-2018,90.0,55.30726256983241,125.69832402234638
1954,Romain Perraud,FRA,FW,Nice,Ligue 1,19,1997,0.0,0,0,0,0,0,0,0,0.0,0,0,0,0,0,0,0,0,0,2017-2018,,,
1955,Loïc Perrin,FRA,DF,Saint-Étienne,Ligue 1,31,1985,27.4,39,26,28,10,1,21,31,67.7,10,35,22,13,36,75,142,1,0,2017-2018,90.0,118.24817518248177,128.1021897810219
1956,Andrea Petagna,ITA,FW,Atalanta,Serie A,22,1995,18.0,8,3,2,4,2,1,11,9.1,10,14,3,11,4,12,5,0,0,2017-2018,90.0,20.0,40.0
1957,Nils Petersen,GER,FW,Freiburg,Bundesliga,28,1988,24.9,27,18,7,18,2,10,27,37.0,17,28,2,26,17,44,33,0,0,2017-2018,90.0,61.44578313253012,97.59036144578313
1958,Bruno Petković,CRO,FW,Hellas Verona,Serie A,22,1994,10.2,14,12,3,8,3,6,13,46.2,7,11,1,10,7,21,12,0,0,2017-2018,90.0,61.76470588235294,123.52941176470588
1959,Bruno Petković,CRO,"FW,MF",Bologna,Serie A,22,1994,3.7,7,6,0,5,2,1,1,100.0,0,3,0,3,4,11,5,0,0,2017-2018,90.0,97.29729729729729,170.27027027027026
1960,Germán Pezzella,ARG,DF,Fiorentina,Serie A,26,1991,33.1,63,47,42,19,2,19,41,46.3,22,33,16,17,63,126,185,1,0,2017-2018,90.0,171.2990936555891,171.2990936555891
1961,Giuseppe Pezzella,ITA,"DF,FW",Udinese,Serie A,19,1997,10.0,19,11,10,4,5,7,19,36.8,12,8,1,7,6,25,32,0,0,2017-2018,90.0,54.0,171.0
1962,Maximilian Philipp,GER,FW,Dortmund,Bundesliga,23,1994,13.4,24,19,9,12,3,6,19,31.6,13,12,0,12,6,30,7,0,0,2017-2018,90.0,40.298507462686565,161.19402985074626
1963,Chris Philipps,LUX,"MF,DF",Metz,Ligue 1,23,1994,9.4,22,12,10,10,2,5,26,19.2,21,13,5,8,30,52,18,0,0,2017-2018,90.0,287.23404255319144,210.63829787234042
1964,Matt Phillips,SCO,"MF,DF",West Brom,Premier League,26,1991,23.3,27,16,17,5,5,10,29,34.5,19,21,1,20,24,51,43,0,0,2017-2018,90.0,92.70386266094421,104.29184549356223
1965,Lebogang Phiri,RSA,MF,Guingamp,Ligue 1,22,1994,11.5,28,17,14,12,2,11,43,25.6,32,9,2,7,19,47,13,0,0,2017-2018,90.0,148.69565217391306,219.13043478260872
1966,Pablo Piatti,ARG,"MF,FW",Espanyol,La Liga,28,1989,19.3,45,32,14,21,10,17,57,29.8,40,28,3,25,22,67,16,0,0,2017-2018,90.0,102.59067357512953,209.84455958549222
1967,Jordan Pickford,ENG,GK,Everton,Premier League,23,1994,38.0,0,0,0,0,0,0,2,0.0,2,0,0,0,2,2,26,5,0,2017-2018,90.0,4.7368421052631575,0.0
1968,Jérémy Pied,FRA,DF,Southampton,Premier League,28,1989,2.0,9,6,8,1,0,6,9,66.7,3,3,2,1,8,17,4,0,0,2017-2018,90.0,360.0,405.0
1969,Nicholas Pierini,ITA,"MF,FW",Sassuolo,Serie A,18,1998,0.5,1,1,0,0,1,0,0,0.0,0,1,0,1,1,2,0,0,0,2017-2018,90.0,180.0,180.0
1970,Ronaël Pierre-Gabriel,FRA,DF,Saint-Étienne,Ligue 1,19,1998,13.0,43,31,33,7,3,17,28,60.7,11,11,2,9,9,52,35,0,0,2017-2018,90.00000000000001,62.307692307692314,297.69230769230774
1971,Erik Pieters,NED,DF,Stoke City,Premier League,28,1988,30.2,71,47,43,26,2,24,51,47.1,27,70,25,45,61,132,127,5,0,2017-2018,90.0,181.78807947019868,211.58940397350995
1972,Tomás Pina Isla,ESP,MF,Alavés,La Liga,29,1987,26.5,71,49,27,38,6,20,40,50.0,20,28,10,18,43,114,37,0,0,2017-2018,90.0,146.0377358490566,241.1320754716981
1973,Andrea Pinamonti,ITA,FW,Inter,Serie A,18,1999,0.2,0,0,0,0,0,0,0,0.0,0,0,0,0,0,0,0,0,0,2017-2018,90.0,0.0,0.0
1974,Carlo Pinsoglio,ITA,GK,Juventus,Serie A,27,1990,0.3,0,0,0,0,0,0,0,0.0,0,0,0,0,0,0,0,0,0,2017-2018,90.0,0.0,0.0
1975,Gerard Piqué,ESP,DF,Barcelona,La Liga,30,1987,29.2,31,22,22,9,0,16,36,44.4,20,40,27,13,30,61,127,0,0,2017-2018,90.0,92.46575342465754,95.54794520547946
1976,Facundo Píriz,URU,MF,Montpellier,Ligue 1,27,1990,9.0,25,16,9,12,4,6,35,17.1,29,10,1,9,18,43,14,0,0,2017-2018,90.0,180.0,250.0
1977,Fabio Pisacane,ITA,DF,Cagliari,Serie A,31,1986,21.4,52,39,36,13,3,15,41,36.6,26,29,16,13,38,90,105,1,0,2017-2018,90.0,159.81308411214954,218.69158878504675
1978,Łukasz Piszczek,POL,DF,Dortmund,Bundesliga,32,1985,23.8,51,37,23,23,5,30,52,57.7,22,39,11,28,42,93,64,1,0,2017-2018,90.00000000000001,158.82352941176472,192.85714285714286
1979,Claudio Pizarro,PER,"FW,MF",Köln,Bundesliga,38,1978,6.4,11,9,3,6,2,6,9,66.7,3,10,2,8,3,14,5,0,0,2017-2018,90.0,42.1875,154.6875
1980,Guido Pizarro,ARG,MF,Sevilla,La Liga,27,1990,19.5,75,47,36,36,3,29,67,43.3,38,20,7,13,26,101,48,0,0,2017-2018,90.0,120.0,346.15384615384613
1981,Marko Pjaca,CRO,"FW,MF",Schalke 04,Bundesliga,22,1995,2.9,5,3,2,3,0,4,6,66.7,2,3,0,3,1,6,2,0,0,2017-2018,90.0,31.03448275862069,155.17241379310346
1982,Miralem Pjanić,BIH,MF,Juventus,Serie A,27,1990,27.6,36,30,13,18,5,13,51,25.5,38,25,5,20,64,100,27,2,0,2017-2018,90.0,208.69565217391303,117.39130434782608
1983,Carles Planas,ESP,DF,Girona,La Liga,26,1991,2.1,5,2,4,1,0,3,6,50.0,3,1,0,1,5,10,6,0,0,2017-2018,90.0,214.28571428571428,214.28571428571428
1984,Jaroslav Plašil,CZE,MF,Bordeaux,Ligue 1,35,1982,11.6,24,14,7,17,0,7,31,22.6,24,18,6,12,21,45,15,0,0,2017-2018,90.0,162.93103448275863,186.20689655172413
1985,Marvin Plattenhardt,GER,DF,Hertha BSC,Bundesliga,25,1992,33.0,57,43,39,15,3,35,50,70.0,15,24,7,17,27,84,92,0,0,2017-2018,90.0,73.63636363636364,155.45454545454547
1986,Alassane Pléa,FRA,FW,Nice,Ligue 1,24,1993,33.8,15,9,5,7,3,5,32,15.6,27,14,3,11,8,23,21,0,0,2017-2018,90.0,21.301775147928996,39.94082840236687
1987,Morgan Poaty,CGO,DF,Montpellier,Ligue 1,20,1997,1.9,0,0,0,0,0,0,1,0.0,1,5,3,2,1,1,2,0,0,2017-2018,90.0,47.368421052631575,0.0
1988,Gerónimo Poblete,ARG,MF,Metz,Ligue 1,24,1993,18.4,58,37,23,29,6,25,66,37.9,41,19,0,19,24,82,22,1,0,2017-2018,90.0,117.3913043478261,283.69565217391306
1989,Florentin Pogba,GUI,DF,Saint-Étienne,Ligue 1,26,1990,3.6,6,0,4,2,0,3,5,60.0,2,2,2,0,1,7,12,0,0,2017-2018,90.0,25.0,150.0
1990,Paul Pogba,FRA,MF,Manchester Utd,Premier League,24,1993,23.9,33,23,13,15,5,5,33,15.2,28,16,0,16,21,54,26,0,0,2017-2018,90.0,79.0794979079498,124.26778242677825
1991,Joel Pohjanpalo,FIN,"MF,FW",Leverkusen,Bundesliga,22,1994,1.3,0,0,0,0,0,0,2,0.0,2,1,1,0,0,0,2,0,0,2017-2018,90.0,0.0,0.0
1992,Eugen Polanski,POL,MF,Hoffenheim,Bundesliga,31,1986,2.9,8,7,3,4,1,5,6,83.3,1,6,1,5,4,12,4,0,0,2017-2018,90.0,124.13793103448276,248.27586206896552
1993,Andrea Poli,ITA,MF,Bologna,Serie A,27,1989,28.3,66,53,33,27,6,18,64,28.1,46,55,3,52,43,109,27,0,0,2017-2018,90.0,136.74911660777383,209.89399293286218
1994,Matteo Politano,ITA,FW,Sassuolo,Serie A,23,1993,31.2,23,16,8,10,5,3,32,9.4,29,13,2,11,14,37,13,0,0,2017-2018,90.0,40.38461538461538,66.34615384615384
1995,Julian Pollersbeck,GER,GK,Hamburger SV,Bundesliga,22,1994,10.0,0,0,0,0,0,0,1,0.0,1,0,0,0,0,0,4,1,0,2017-2018,90.0,0.0,0.0
1996,Ezequiel Ponce,ARG,FW,Lille,Ligue 1,20,1997,12.2,9,8,3,5,1,0,7,0.0,7,2,1,1,3,12,11,0,0,2017-2018,90.0,22.13114754098361,66.39344262295083
1997,Pere Pons,ESP,MF,Girona,La Liga,24,1993,28.4,80,54,28,48,4,23,87,26.4,64,28,3,25,30,110,25,0,0,2017-2018,90.0,95.07042253521128,253.5211267605634
1998,Simone Pontisso,ITA,MF,Udinese,Serie A,20,1997,0.1,1,0,0,1,0,0,0,0.0,0,0,0,0,0,1,0,0,0,2017-2018,90.0,0.0,900.0
1999,Nick Pope,ENG,GK,Burnley,Premier League,25,1992,34.6,0,0,0,0,0,0,1,0.0,1,0,0,0,0,0,21,0,0,2017-2018,90.0,0.0,0.0
2000,Jérémie Porsan-Clémenté,FRA,DF,Montpellier,Ligue 1,19,1997,1.0,3,2,1,2,0,2,2,100.0,0,1,0,1,1,4,4,1,0,2017-2018,90.0,90.0,270.0
2001,Francisco Portillo,ESP,"MF,FW",Getafe,La Liga,27,1990,27.3,38,23,15,18,5,11,45,24.4,34,25,1,24,22,60,21,0,0,2017-2018,90.0,72.52747252747253,125.27472527472527
2002,Portu,ESP,MF,Girona,La Liga,25,1992,33.3,30,24,9,11,10,8,33,24.2,25,14,0,14,12,42,1,0,0,2017-2018,90.0,32.432432432432435,81.08108108108108
2003,Stefan Posch,AUT,DF,Hoffenheim,Bundesliga,20,1997,8.4,28,21,18,7,3,15,27,55.6,12,15,4,11,24,52,30,0,0,2017-2018,90.0,257.1428571428571,300.0
2004,Sergio Postigo,ESP,DF,Levante,La Liga,28,1988,26.9,36,23,30,5,1,18,32,56.3,14,27,13,14,40,76,140,1,0,2017-2018,90.0,133.8289962825279,120.4460966542751
2005,Yussuf Poulsen,DEN,FW,RB Leipzig,Bundesliga,23,1994,18.5,23,19,2,13,8,7,12,58.3,5,24,5,19,9,32,8,0,0,2017-2018,90.0,43.78378378378378,111.8918918918919
2006,Maxime Poundjé,FRA,DF,Bordeaux,Ligue 1,24,1992,18.9,53,29,32,16,5,28,51,54.9,23,14,6,8,35,88,63,1,0,2017-2018,90.0,166.66666666666669,252.38095238095238
2007,Darío Poveda,ESP,MF,Villarreal,La Liga,20,1997,0.0,1,0,0,1,0,1,1,100.0,0,0,0,0,0,1,0,0,0,2017-2018,,,inf
2008,Dennis Praet,BEL,MF,Sampdoria,Serie A,23,1994,29.5,85,57,34,36,15,38,73,52.1,35,49,1,48,37,122,22,0,0,2017-2018,90.0,112.88135593220339,259.3220338983051
2009,Sanjin Prcić,BIH,MF,Rennes,Ligue 1,23,1993,17.4,37,18,9,24,4,8,39,20.5,31,19,5,14,30,67,25,0,0,2017-2018,90.0,155.17241379310346,191.3793103448276
2010,Nicolas de Préville,FRA,FW,Bordeaux,Ligue 1,26,1991,21.5,34,27,10,15,9,9,33,27.3,24,25,4,21,21,55,12,0,0,2017-2018,90.0,87.90697674418604,142.32558139534882
2011,Nicolas de Préville,FRA,"FW,MF",Lille,Ligue 1,26,1991,3.2,3,3,0,1,2,1,5,20.0,4,3,0,3,0,3,2,0,0,2017-2018,90.0,0.0,84.375
2012,Andrés Prieto,ESP,GK,Málaga,La Liga,23,1993,4.0,0,0,0,0,0,0,0,0.0,0,0,0,0,0,0,2,0,0,2017-2018,90.0,0.0,0.0
2013,Xabi Prieto,ESP,"MF,FW",Real Sociedad,La Liga,33,1983,21.4,18,14,5,9,4,2,10,20.0,8,8,2,6,7,25,20,0,0,2017-2018,90.0,29.4392523364486,75.70093457943926
2014,Jérôme Prior,FRA,GK,Bordeaux,Ligue 1,21,1995,2.0,0,0,0,0,0,0,0,0.0,0,0,0,0,0,0,2,2,0,2017-2018,90.0,0.0,0.0
2015,Alex Pritchard,ENG,"MF,FW",Huddersfield,Premier League,24,1993,11.1,18,8,2,6,10,10,21,47.6,11,6,1,5,5,23,11,0,0,2017-2018,90.0,40.54054054054055,145.94594594594597
2016,Sloan Privat,FRA,FW,Guingamp,Ligue 1,28,1989,0.0,0,0,0,0,0,0,0,0.0,0,0,0,0,0,0,0,0,0,2017-2018,,,
2017,Sebastian Prödl,AUT,DF,Watford,Premier League,30,1987,17.4,22,17,19,3,0,8,15,53.3,7,20,9,11,31,53,92,1,0,2017-2018,90.0,160.3448275862069,113.79310344827586
2018,Davy Pröpper,NED,MF,Brighton,Premier League,25,1991,34.7,73,44,35,35,3,18,83,21.7,65,35,11,24,60,133,80,2,0,2017-2018,90.0,155.61959654178673,189.3371757925072
2019,Manuel Pucciarelli,ITA,"FW,MF",Chievo,Serie A,26,1991,15.3,23,14,3,11,9,8,21,38.1,13,15,0,15,7,30,4,0,0,2017-2018,90.0,41.17647058823529,135.2941176470588
2020,Christian Puggioni,ITA,GK,Benevento,Serie A,36,1981,13.1,0,0,0,0,0,0,0,0.0,0,0,0,0,0,0,5,1,0,2017-2018,90.0,0.0,0.0
2021,Christian Puggioni,ITA,GK,Sampdoria,Serie A,36,1981,9.0,0,0,0,0,0,0,0,0.0,0,0,0,0,0,0,6,1,0,2017-2018,90.0,0.0,0.0
2022,Marc Pugh,ENG,"MF,FW",Bournemouth,Premier League,30,1987,10.9,7,3,2,4,1,2,10,20.0,8,6,1,5,13,20,13,2,0,2017-2018,90.0,107.3394495412844,57.798165137614674
2023,Erick Pulgar,CHI,MF,Bologna,Serie A,23,1994,30.8,70,48,41,29,0,24,75,32.0,51,49,13,36,46,116,83,1,0,2017-2018,90.0,134.41558441558442,204.54545454545456
2024,Christian Pulisic,USA,"FW,DF",Dortmund,Bundesliga,18,1998,25.6,46,30,12,20,14,26,44,59.1,18,24,2,22,16,62,11,0,0,2017-2018,90.0,56.25,161.71875
2025,Jason Puncheon,ENG,MF,Crystal Palace,Premier League,31,1986,7.2,13,4,3,7,3,1,5,20.0,4,3,0,3,5,18,4,0,0,2017-2018,90.0,62.5,162.5
2026,George Pușcaș,ROU,"FW,MF",Benevento,Serie A,21,1996,7.8,0,0,0,0,0,0,3,0.0,3,0,0,0,1,1,13,0,0,2017-2018,90.0,11.538461538461538,0.0
2027,Loïc Puyo,FRA,MF,Angers,Ligue 1,28,1988,1.9,9,5,2,5,2,3,4,75.0,1,7,3,4,4,13,2,0,0,2017-2018,90.0,189.4736842105263,426.3157894736842
2028,Fabio Quagliarella,ITA,FW,Sampdoria,Serie A,34,1983,30.2,11,9,1,3,7,2,25,8.0,23,34,0,34,7,18,23,0,0,2017-2018,90.0,20.86092715231788,32.78145695364238
2029,Robin Quaison,SWE,FW,Mainz 05,Bundesliga,23,1993,15.7,17,14,1,10,6,7,11,63.6,4,16,2,14,7,24,9,0,0,2017-2018,90.0,40.12738853503185,97.45222929936307
2030,Collin Quaner,GER,"FW,MF",Huddersfield,Premier League,26,1991,14.2,22,15,8,8,6,9,26,34.6,17,24,4,20,11,33,15,0,0,2017-2018,90.0,69.71830985915493,139.43661971830986
2031,Dani Raba,ESP,"MF,FW",Villarreal,La Liga,21,1995,12.3,25,21,9,12,4,9,45,20.0,36,21,1,20,17,42,10,0,0,2017-2018,89.99999999999999,124.39024390243901,182.92682926829266
2032,Adrien Rabiot,FRA,MF,Paris S-G,Ligue 1,22,1995,26.2,59,36,27,23,9,15,36,41.7,21,29,10,19,33,92,22,1,0,2017-2018,90.0,113.3587786259542,202.67175572519085
2033,Nemanja Radoja,SRB,MF,Celta Vigo,La Liga,24,1993,12.3,18,16,6,8,4,3,8,37.5,5,8,2,6,10,28,11,0,0,2017-2018,89.99999999999999,73.17073170731706,131.7073170731707
2034,Ivan Radovanović,SRB,MF,Chievo,Serie A,28,1988,34.9,55,35,30,22,3,18,48,37.5,30,39,16,23,47,102,107,1,0,2017-2018,90.0,121.20343839541547,141.83381088825215
2035,Ștefan Radu,ROU,DF,Lazio,Serie A,30,1986,28.8,53,38,36,16,1,25,41,61.0,16,30,14,16,55,108,105,1,0,2017-2018,90.0,171.875,165.625
2036,Rafael,BRA,GK,Cagliari,Serie A,35,1982,8.8,0,0,0,0,0,0,0,0.0,0,0,0,0,1,1,9,0,0,2017-2018,90.0,10.227272727272727,0.0
2037,Rafael,BRA,DF,Lyon,Ligue 1,27,1990,20.1,54,28,30,18,6,22,43,51.2,21,20,3,17,42,96,53,0,0,2017-2018,90.0,188.0597014925373,241.79104477611938
2038,Raffael,BRA,FW,Gladbach,Bundesliga,32,1985,23.0,40,32,12,23,5,17,36,47.2,19,18,0,18,8,48,2,0,0,2017-2018,90.0,31.30434782608696,156.52173913043478
2039,Rafinha,BRA,MF,Inter,Serie A,24,1993,11.6,14,9,1,10,3,3,16,18.8,13,15,0,15,7,21,9,0,0,2017-2018,90.0,54.310344827586206,108.62068965517241
2040,Rafinha,BRA,DF,Bayern Munich,Bundesliga,31,1985,20.6,39,33,24,11,4,28,47,59.6,19,17,6,11,32,71,30,0,0,2017-2018,90.0,139.80582524271844,170.38834951456312
2041,Andrea Raggi,ITA,DF,Monaco,Ligue 1,33,1984,17.9,20,10,15,4,1,10,27,37.0,17,12,6,6,31,51,66,0,0,2017-2018,90.0,155.8659217877095,100.5586592178771
2042,Antonino Ragusa,ITA,"FW,MF",Sassuolo,Serie A,27,1990,9.2,17,7,11,4,2,8,23,34.8,15,12,1,11,6,23,16,0,0,2017-2018,90.0,58.69565217391305,166.30434782608697
2043,Baba Rahman,GHA,DF,Schalke 04,Bundesliga,23,1994,0.4,1,0,0,1,0,0,0,0.0,0,2,0,2,2,3,1,0,0,2017-2018,90.0,450.0,225.0
2044,Ivan Rakitić,CRO,MF,Barcelona,La Liga,29,1988,31.5,52,31,16,30,6,15,45,33.3,30,42,7,35,44,96,16,0,0,2017-2018,90.0,125.71428571428572,148.57142857142858
2045,André Ramalho,BRA,"DF,FW",Leverkusen,Bundesliga,25,1992,0.4,3,1,2,1,0,2,2,100.0,0,1,0,1,1,4,1,0,0,2017-2018,90.0,225.0,675.0
2046,Jonás Ramalho,ESP,DF,Girona,La Liga,24,1993,25.5,25,16,20,5,0,15,24,62.5,9,25,11,14,35,60,115,0,0,2017-2018,90.0,123.52941176470588,88.23529411764706
2047,Adil Rami,FRA,DF,Marseille,Ligue 1,31,1985,32.8,39,29,22,15,2,22,41,53.7,19,25,19,6,45,84,163,3,0,2017-2018,90.0,123.47560975609757,107.01219512195124
2048,Benito Ramírez,ESP,"FW,DF",Las Palmas,La Liga,22,1995,1.8,6,3,2,3,1,1,5,20.0,4,0,0,0,2,8,3,0,0,2017-2018,90.0,100.0,300.0
2049,Gastón Ramírez,URU,MF,Sampdoria,Serie A,26,1990,24.6,33,20,4,15,14,9,56,16.1,47,30,3,27,18,51,24,0,0,2017-2018,89.99999999999999,65.85365853658536,120.73170731707316
2050,Sandro Ramírez,ESP,"FW,MF",Everton,Premier League,22,1995,3.1,2,1,0,1,1,0,3,0.0,3,1,0,1,1,3,0,0,0,2017-2018,90.0,29.032258064516128,58.064516129032256
2051,Sandro Ramírez,ESP,"FW,MF",Sevilla,La Liga,22,1995,8.0,8,8,1,5,2,1,7,14.3,6,2,0,2,4,12,2,0,0,2017-2018,90.0,45.0,90.0
2052,Toño Ramírez,ESP,GK,Real Sociedad,La Liga,30,1986,3.5,0,0,0,0,0,0,1,0.0,1,0,0,0,0,0,1,3,0,2017-2018,90.0,0.0,0.0
2053,Iván Ramis,ESP,DF,Eibar,La Liga,32,1984,14.5,20,14,8,12,0,8,19,42.1,11,12,5,7,25,45,51,2,0,2017-2018,90.0,155.17241379310343,124.13793103448275
2054,Omar Ramos,ESP,"FW,MF",Leganés,La Liga,29,1988,16.1,22,14,6,8,8,9,22,40.9,13,16,1,15,14,36,15,0,0,2017-2018,90.0,78.26086956521739,122.98136645962732
2055,Sergio Ramos,ESP,DF,Real Madrid,La Liga,31,1986,25.4,40,29,22,18,0,19,28,67.9,9,22,12,10,47,87,91,0,0,2017-2018,90.0,166.53543307086616,141.73228346456693
2056,Aaron Ramsey,WAL,MF,Arsenal,Premier League,26,1990,20.5,35,27,18,17,0,8,44,18.2,36,14,3,11,24,59,6,1,0,2017-2018,90.0,105.3658536585366,153.65853658536585
2057,Àngel Rangel,ESP,DF,Swansea City,Premier League,34,1982,1.7,4,3,2,2,0,1,3,33.3,2,0,0,0,3,7,4,0,0,2017-2018,90.0,158.8235294117647,211.76470588235293
2058,Andrea Ranocchia,ITA,DF,Inter,Serie A,29,1988,7.0,8,4,6,2,0,3,6,50.0,3,6,5,1,12,20,35,0,0,2017-2018,90.0,154.28571428571428,102.85714285714286
2059,Marcus Rashford,ENG,"FW,MF",Manchester Utd,Premier League,19,1997,20.1,14,11,4,5,5,6,18,33.3,12,18,0,18,8,22,19,0,0,2017-2018,90.0,35.82089552238806,62.686567164179095
2060,Milot Rashica,KVX,"FW,MF",Werder Bremen,Bundesliga,21,1996,4.3,2,2,1,1,0,1,8,12.5,7,3,0,3,3,5,4,0,0,2017-2018,90.0,62.79069767441861,41.86046511627907
2061,Konstantin Rausch,RUS,DF,Köln,Bundesliga,27,1990,10.3,21,16,13,7,1,11,26,42.3,15,9,2,7,17,38,25,0,0,2017-2018,90.0,148.54368932038835,183.49514563106797
2062,Yoric Ravet,FRA,"FW,MF",Freiburg,Bundesliga,27,1989,5.5,9,7,3,6,0,3,7,42.9,4,7,0,7,3,12,6,0,0,2017-2018,90.0,49.09090909090909,147.27272727272728
2063,Ante Rebić,CRO,FW,Eint Frankfurt,Bundesliga,23,1993,19.5,37,29,7,21,9,7,24,29.2,17,27,2,25,6,43,13,0,0,2017-2018,90.0,27.69230769230769,170.76923076923077
2064,Pedro Rebocho,POR,DF,Guingamp,Ligue 1,22,1995,19.1,29,22,18,8,3,12,28,42.9,16,20,6,14,19,48,76,0,0,2017-2018,90.0,89.52879581151832,136.64921465968587
2065,Recio,ESP,MF,Málaga,La Liga,26,1991,20.4,54,42,26,23,5,17,62,27.4,45,15,3,12,30,84,17,0,0,2017-2018,90.0,132.3529411764706,238.23529411764707
2066,Nathan Redmond,ENG,"FW,MF",Southampton,Premier League,23,1994,21.6,32,17,16,14,2,12,31,38.7,19,20,0,20,15,47,17,2,0,2017-2018,90.0,62.49999999999999,133.33333333333331
2067,Alberto Redondo,ESP,DF,Getafe,La Liga,20,1997,1.0,4,3,4,0,0,2,4,50.0,2,2,1,1,0,4,1,0,0,2017-2018,90.0,0.0,360.0
2068,Fabian Reese,GER,"FW,MF",Schalke 04,Bundesliga,19,1997,0.8,2,2,1,1,0,1,2,50.0,1,1,0,1,2,4,1,0,0,2017-2018,90.0,225.0,225.0
2069,Vasco Regini,ITA,DF,Sampdoria,Serie A,26,1990,12.0,13,7,11,0,2,6,11,54.5,5,14,7,7,11,24,68,0,0,2017-2018,90.0,82.5,97.5
2070,Xesc Regis,ESP,FW,Eibar,La Liga,20,1996,0.0,1,1,0,1,0,0,0,0.0,0,0,0,0,0,1,0,0,0,2017-2018,,,inf
2071,Winston Reid,NZL,DF,West Ham,Premier League,29,1988,16.1,11,9,7,4,0,4,15,26.7,11,27,14,13,22,33,104,0,0,2017-2018,90.0,122.98136645962732,61.49068322981366
2072,Pepe Reina,ESP,GK,Napoli,Serie A,34,1982,37.0,1,0,1,0,0,1,2,50.0,1,0,0,0,0,1,13,2,0,2017-2018,90.0,0.0,2.4324324324324325
2073,Jeff Reine-Adélaïde,FRA,MF,Angers,Ligue 1,19,1998,4.9,13,8,7,5,1,6,17,35.3,11,7,2,5,1,14,9,0,0,2017-2018,90.0,18.36734693877551,238.77551020408163
2074,Karim Rekik,NED,DF,Hertha BSC,Bundesliga,22,1994,25.6,38,29,32,6,0,24,26,92.3,2,27,11,16,28,66,116,2,0,2017-2018,90.0,98.4375,133.59375
2075,Loïc Rémy,FRA,FW,Las Palmas,La Liga,30,1987,8.5,4,3,1,3,0,0,1,0.0,1,0,0,0,1,5,2,0,0,2017-2018,90.0,10.588235294117647,42.35294117647059
2076,Loïc Rémy,FRA,"FW,MF",Getafe,La Liga,30,1987,5.1,4,2,1,3,0,1,5,20.0,4,4,0,4,1,5,2,0,0,2017-2018,90.0,17.647058823529413,70.58823529411765
2077,Jan Repas,SVN,"MF,FW",Caen,Ligue 1,20,1997,10.0,14,11,5,5,4,4,18,22.2,14,10,0,10,7,21,3,0,0,2017-2018,90.0,63.0,126.0
2078,Panagiotis Retsos,GRE,DF,Leverkusen,Bundesliga,18,1998,19.1,48,40,32,14,2,33,46,71.7,13,29,8,21,29,77,47,0,0,2017-2018,90.0,136.64921465968587,226.17801047120417
2079,Marco Reus,GER,"MF,FW",Dortmund,Bundesliga,28,1989,10.3,16,8,2,12,2,5,12,41.7,7,16,3,13,4,20,9,0,0,2017-2018,90.0,34.95145631067961,139.80582524271844
2080,Elvis Rexhbeçaj,GER,"DF,MF",Wolfsburg,Bundesliga,19,1997,1.4,4,2,1,2,1,1,1,100.0,0,3,0,3,2,6,3,0,0,2017-2018,90.0,128.57142857142858,257.14285714285717
2081,Baptiste Reynet,FRA,GK,Dijon,Ligue 1,26,1990,38.0,6,4,5,1,0,5,7,71.4,2,2,0,2,2,8,35,1,0,2017-2018,90.0,4.7368421052631575,14.210526315789474
2082,Franck Ribéry,FRA,"FW,MF",Bayern Munich,Bundesliga,34,1983,13.4,19,16,9,5,5,13,17,76.5,4,11,0,11,7,26,3,0,0,2017-2018,90.0,47.014925373134325,127.61194029850745
2083,Federico Ricca,URU,DF,Málaga,La Liga,22,1994,12.3,43,24,32,9,2,23,33,69.7,10,10,2,8,24,67,46,0,0,2017-2018,89.99999999999999,175.60975609756096,314.63414634146335
2084,Federico Ricci,ITA,FW,Crotone,Serie A,23,1994,10.2,25,18,9,10,6,9,28,32.1,19,14,0,14,11,36,5,0,0,2017-2018,90.0,97.05882352941177,220.58823529411765
2085,Federico Ricci,ITA,MF,Genoa,Serie A,23,1994,2.4,2,2,2,0,0,1,3,33.3,2,2,0,2,1,3,1,0,0,2017-2018,90.0,37.5,75.0
2086,Declan Rice,ENG,"DF,MF",West Ham,Premier League,18,1999,15.9,36,24,25,10,1,15,25,60.0,10,19,13,6,27,63,77,1,0,2017-2018,90.0,152.83018867924528,203.77358490566039
2087,Richarlison,BRA,"FW,MF",Watford,Premier League,20,1997,31.4,64,44,26,28,10,10,39,25.6,29,39,5,34,24,88,32,1,0,2017-2018,90.0,68.78980891719746,183.4394904458599
2088,Marco Richter,GER,FW,Augsburg,Bundesliga,19,1997,7.2,17,14,8,8,1,8,17,47.1,9,5,1,4,1,18,10,0,0,2017-2018,90.0,12.5,212.5
2089,Diego Rico,ESP,DF,Leganés,La Liga,24,1993,24.8,68,43,37,21,10,36,53,67.9,17,30,6,24,76,144,61,0,0,2017-2018,90.0,275.80645161290323,246.7741935483871
2090,Mikel Rico,ESP,MF,Athletic Club,La Liga,32,1984,13.0,24,13,7,16,1,12,34,35.3,22,15,5,10,23,47,12,1,0,2017-2018,90.00000000000001,159.23076923076925,166.15384615384616
2091,Sergio Rico,ESP,GK,Sevilla,La Liga,23,1993,24.0,1,1,1,0,0,0,2,0.0,2,0,0,0,1,2,5,3,0,2017-2018,90.0,3.75,3.75
2092,Jaïro Riedewald,NED,"MF,DF",Crystal Palace,Premier League,20,1996,4.9,11,8,6,4,1,0,2,0.0,2,7,1,6,12,23,13,0,0,2017-2018,90.0,220.40816326530611,202.0408163265306
2093,Asier Riesgo,ESP,GK,Eibar,La Liga,33,1983,1.0,0,0,0,0,0,0,0,0.0,0,0,0,0,0,0,0,0,0,2017-2018,90.0,0.0,0.0
2094,Luca Rigoni,ITA,MF,Genoa,Serie A,32,1984,17.5,32,22,11,20,1,7,35,20.0,28,24,2,22,19,51,13,0,0,2017-2018,90.0,97.71428571428571,164.57142857142856
2095,Nicola Rigoni,ITA,MF,Chievo,Serie A,26,1990,10.4,29,20,15,12,2,9,26,34.6,17,8,3,5,11,40,22,1,0,2017-2018,90.0,95.19230769230768,250.96153846153845
2096,Kévin Rimane,GUF,DF,Paris S-G,Ligue 1,26,1991,0.1,0,0,0,0,0,0,0,0.0,0,0,0,0,0,0,0,0,0,2017-2018,90.0,0.0,0.0
2097,Tomás Rincón,VEN,MF,Torino,Serie A,29,1988,33.3,66,40,30,34,2,24,66,36.4,42,33,8,25,57,123,61,1,0,2017-2018,90.0,154.05405405405406,178.3783783783784
2098,Birk Risa,NOR,FW,Köln,Bundesliga,19,1998,0.9,1,1,0,1,0,0,3,0.0,3,2,1,1,0,1,0,0,0,2017-2018,90.0,0.0,100.0
2099,Marcel Risse,GER,"DF,MF",Köln,Bundesliga,27,1989,13.0,21,14,17,4,0,11,19,57.9,8,21,3,18,6,27,10,2,0,2017-2018,90.00000000000001,41.53846153846154,145.3846153846154
2100,Matt Ritchie,SCO,"MF,FW",Newcastle Utd,Premier League,27,1989,31.2,46,32,22,18,6,14,53,26.4,39,37,5,32,35,81,63,1,0,2017-2018,90.0,100.96153846153845,132.69230769230768
2101,Cristian Rivera,ESP,MF,Eibar,La Liga,20,1997,2.7,13,10,4,8,1,5,7,71.4,2,2,2,0,3,16,2,0,0,2017-2018,90.0,99.99999999999999,433.3333333333333
2102,Emmanuel Rivière,FRA,FW,Metz,Ligue 1,27,1990,22.3,10,3,1,6,3,1,12,8.3,11,8,0,8,2,12,5,0,0,2017-2018,90.0,8.071748878923767,40.35874439461883
2103,Jonathan Rivierez,MTQ,DF,Metz,Ligue 1,28,1989,22.9,81,59,50,26,5,41,80,51.3,39,21,7,14,39,120,73,0,0,2017-2018,90.0,153.27510917030568,318.34061135371184
2104,Luca Rizzo,ITA,MF,SPAL,Serie A,25,1992,5.4,18,10,7,10,1,5,17,29.4,12,10,0,10,3,21,5,1,0,2017-2018,90.0,49.99999999999999,300.0
2105,Arjen Robben,NED,"FW,MF",Bayern Munich,Bundesliga,33,1984,16.7,14,11,1,7,6,4,12,33.3,8,9,0,9,4,18,4,0,0,2017-2018,90.0,21.55688622754491,75.44910179640719
2106,Rober,ESP,"DF,MF",Levante,La Liga,22,1995,21.2,35,22,27,8,0,17,32,53.1,15,29,18,11,41,76,75,1,0,2017-2018,90.0,174.05660377358492,148.58490566037736
2107,Roberto,ESP,GK,Málaga,La Liga,31,1986,34.0,0,0,0,0,0,0,0,0.0,0,0,0,0,2,2,15,0,0,2017-2018,90.0,5.294117647058823,0.0
2108,Sergi Roberto,ESP,DF,Barcelona,La Liga,25,1992,24.7,63,40,30,25,8,25,49,51.0,24,18,8,10,39,102,30,1,0,2017-2018,90.0,142.10526315789474,229.55465587044534
2109,Connor Roberts,WAL,DF,Swansea City,Premier League,21,1995,3.0,6,4,5,1,0,3,3,100.0,0,2,0,2,3,9,6,0,0,2017-2018,90.0,90.0,180.0
2110,Andrew Robertson,SCO,DF,Liverpool,Premier League,23,1994,21.6,31,17,19,9,3,15,29,51.7,14,22,2,20,26,57,56,0,0,2017-2018,90.0,108.33333333333333,129.16666666666666
2111,Álex Robles,ESP,DF,Málaga,La Liga,18,1999,1.0,2,1,1,1,0,0,0,0.0,0,1,0,1,3,5,4,0,0,2017-2018,90.0,270.0,180.0
2112,Hal Robson-Kanu,WAL,"FW,MF",West Brom,Premier League,28,1989,9.2,5,4,1,2,2,0,13,0.0,13,9,3,6,4,9,9,0,0,2017-2018,90.0,39.130434782608695,48.913043478260875
2113,Marc Roca,ESP,MF,Espanyol,La Liga,20,1996,2.9,8,7,3,5,0,3,4,75.0,1,4,2,2,4,12,10,0,0,2017-2018,90.0,124.13793103448276,248.27586206896552
2114,Rubén Rochina,ESP,"MF,DF",Levante,La Liga,26,1991,1.7,8,5,5,2,1,4,6,66.7,2,0,0,0,2,10,0,0,0,2017-2018,90.0,105.88235294117646,423.52941176470586
2115,Ronny Rodelin,FRA,"FW,MF",Caen,Ligue 1,27,1989,35.1,33,22,7,18,8,8,42,19.0,34,21,2,19,28,61,41,1,0,2017-2018,90.0,71.7948717948718,84.61538461538461
2116,Rodri,ESP,MF,Villarreal,La Liga,21,1996,35.9,104,71,50,48,6,30,86,34.9,56,49,21,28,52,156,100,1,0,2017-2018,90.0,130.36211699164346,260.7242339832869
2117,Rodrigo,ESP,FW,Valencia,La Liga,26,1991,29.8,23,13,9,12,2,3,21,14.3,18,14,2,12,17,40,11,1,0,2017-2018,90.0,51.34228187919463,69.46308724832214
2118,Kévin Rodrigues,POR,DF,Real Sociedad,La Liga,23,1994,18.2,44,32,18,20,6,19,34,55.9,15,22,6,16,27,71,39,0,0,2017-2018,90.0,133.5164835164835,217.58241758241758
2119,Ángel Rodríguez,ESP,FW,Getafe,La Liga,30,1987,25.5,28,19,3,19,6,3,26,11.5,23,18,3,15,6,34,14,0,0,2017-2018,90.0,21.176470588235293,98.82352941176471
2120,Iván Rodríguez,ESP,DF,Málaga,La Liga,21,1996,0.2,1,1,0,1,0,0,0,0.0,0,0,0,0,1,2,1,0,0,2017-2018,90.0,450.0,450.0
2121,James Rodríguez,COL,"MF,FW",Bayern Munich,Bundesliga,26,1991,18.0,35,27,10,15,10,15,30,50.0,15,16,1,15,12,47,4,0,0,2017-2018,90.0,60.0,175.0
2122,Jay Rodriguez,ENG,"FW,MF",West Brom,Premier League,28,1989,31.2,31,21,12,11,8,9,50,18.0,41,32,2,30,19,50,41,0,0,2017-2018,90.0,54.80769230769231,89.42307692307692
2123,Ricardo Rodríguez,SUI,DF,Milan,Serie A,24,1992,33.4,48,29,24,18,6,18,28,64.3,10,36,6,30,33,81,93,3,0,2017-2018,90.0,88.92215568862275,129.34131736526945
2124,Marko Rog,CRO,"MF,FW",Napoli,Serie A,22,1995,3.2,11,7,3,6,2,1,11,9.1,10,4,1,3,2,13,1,0,0,2017-2018,90.0,56.25,309.375
2125,Rogério,BRA,DF,Sassuolo,Serie A,19,1998,10.1,18,14,10,5,3,7,15,46.7,8,11,1,10,9,27,31,0,0,2017-2018,90.0,80.1980198019802,160.3960396039604
2126,Marcus Rohdén,SWE,MF,Crotone,Serie A,26,1991,18.1,33,19,21,10,2,14,50,28.0,36,14,1,13,18,51,30,0,0,2017-2018,90.0,89.50276243093921,164.08839779005524
2127,Marcos Rojo,ARG,DF,Manchester Utd,Premier League,27,1990,7.1,7,5,6,0,1,1,8,12.5,7,11,6,5,7,14,56,2,0,2017-2018,90.0,88.73239436619718,88.73239436619718
2128,Diego Rolán,URU,"FW,MF",Málaga,La Liga,24,1993,21.6,33,25,7,13,13,9,44,20.5,35,18,1,17,12,45,9,0,0,2017-2018,90.0,49.99999999999999,137.5
2129,Rolando,POR,DF,Marseille,Ligue 1,31,1985,27.9,44,29,28,15,1,23,40,57.5,17,22,14,8,37,81,126,0,0,2017-2018,90.0,119.35483870967742,141.93548387096774
2130,Esteban Rolón,ARG,MF,Málaga,La Liga,22,1995,4.6,6,4,4,2,0,2,4,50.0,2,7,1,6,9,15,8,1,0,2017-2018,90.0,176.08695652173915,117.3913043478261
2131,Filippo Romagna,ITA,DF,Cagliari,Serie A,20,1997,21.0,33,18,20,12,1,16,26,61.5,10,20,11,9,33,66,96,0,0,2017-2018,90.0,141.42857142857142,141.42857142857142
2132,Alessio Romagnoli,ITA,DF,Milan,Serie A,22,1995,26.1,20,14,17,2,1,9,14,64.3,5,24,14,10,23,43,154,1,0,2017-2018,90.0,79.31034482758619,68.9655172413793
2133,Simone Romagnoli,ITA,DF,Bologna,Serie A,27,1990,6.2,12,9,10,2,0,4,9,44.4,5,12,8,4,7,19,41,2,0,2017-2018,90.0,101.61290322580645,174.19354838709677
2134,Aristóteles Romero,VEN,"MF,FW",Crotone,Serie A,21,1995,1.0,11,7,7,4,0,3,5,60.0,2,3,0,3,5,16,0,0,0,2017-2018,90.0,450.0,990.0
2135,Óscar Romero,PAR,"MF,FW",Alavés,La Liga,25,1992,2.8,5,2,4,1,0,0,3,0.0,3,3,0,3,3,8,2,0,0,2017-2018,90.0,96.42857142857143,160.71428571428572
2136,Sergio Romero,ARG,GK,Manchester Utd,Premier League,30,1987,1.0,0,0,0,0,0,0,0,0.0,0,0,0,0,0,0,0,0,0,2017-2018,90.0,0.0,0.0
2137,Oriol Romeu,ESP,MF,Southampton,Premier League,25,1991,32.2,93,64,41,44,8,32,100,32.0,68,59,19,40,69,162,77,2,0,2017-2018,90.0,192.85714285714283,259.9378881987577
2138,Rômulo,ITA,"MF,DF",Hellas Verona,Serie A,30,1987,35.2,58,44,23,29,6,13,54,24.1,41,29,2,27,43,101,41,0,0,2017-2018,90.0,109.94318181818181,148.29545454545453
2139,Cristiano Ronaldo,POR,FW,Real Madrid,La Liga,32,1985,25.4,7,4,3,3,1,1,6,16.7,5,10,3,7,6,13,14,0,0,2017-2018,90.0,21.25984251968504,24.803149606299215
2140,Facundo Roncaglia,ARG,DF,Celta Vigo,La Liga,30,1987,16.6,35,25,30,5,0,22,36,61.1,14,18,6,12,31,66,50,1,0,2017-2018,90.0,168.07228915662648,189.7590361445783
2141,Salomón Rondón,VEN,FW,West Brom,Premier League,27,1989,30.7,14,6,0,7,7,5,26,19.2,21,27,0,27,14,28,20,0,0,2017-2018,90.0,41.042345276872965,41.042345276872965
2142,Valentin Rongier,FRA,MF,Nantes,Ligue 1,22,1994,26.1,73,49,25,39,9,17,64,26.6,47,42,6,36,40,113,13,1,0,2017-2018,90.0,137.9310344827586,251.72413793103445
2143,Marten de Roon,NED,MF,Atalanta,Serie A,26,1991,28.6,77,50,27,44,6,29,82,35.4,53,40,5,35,46,123,36,0,0,2017-2018,90.0,144.75524475524475,242.30769230769232
2144,Wayne Rooney,ENG,"MF,FW",Everton,Premier League,31,1985,25.2,28,19,11,13,4,10,42,23.8,32,25,6,19,16,44,43,2,0,2017-2018,90.0,57.142857142857146,100.00000000000001
2145,Roberto Rosales,VEN,DF,Málaga,La Liga,28,1988,34.7,104,69,52,40,12,50,84,59.5,34,37,13,24,58,162,104,1,0,2017-2018,90.0,150.4322766570605,269.74063400576364
2146,Danny Rose,ENG,DF,Tottenham,Premier League,27,1990,8.9,15,11,6,7,2,8,15,53.3,7,12,6,6,9,24,15,0,0,2017-2018,90.0,91.01123595505618,151.68539325842696
2147,Liam Rosenior,ENG,DF,Brighton,Premier League,33,1984,1.8,4,3,2,1,1,2,5,40.0,3,2,1,1,4,8,7,0,0,2017-2018,90.0,200.0,200.0
2148,Aleandro Rosi,ITA,DF,Genoa,Serie A,30,1987,18.9,24,17,7,13,4,5,19,26.3,14,24,5,19,20,44,61,1,0,2017-2018,90.0,95.23809523809524,114.28571428571429
2149,Valentin Rosier,FRA,DF,Dijon,Ligue 1,20,1996,30.9,73,54,47,23,3,26,68,38.2,42,43,9,34,58,131,124,0,0,2017-2018,90.0,168.93203883495147,212.62135922330097
2150,Luca Rossettini,ITA,DF,Genoa,Serie A,32,1985,22.5,16,8,12,3,1,6,17,35.3,11,31,21,10,29,45,151,1,0,2017-2018,90.0,116.0,64.0
2151,Francesco Rossi,ITA,GK,Atalanta,Serie A,26,1991,0.1,0,0,0,0,0,0,0,0.0,0,0,0,0,0,0,0,0,0,2017-2018,90.0,0.0,0.0
2152,Giuseppe Rossi,ITA,"FW,MF",Genoa,Serie A,30,1987,2.9,1,1,0,1,0,0,3,0.0,3,2,0,2,1,2,1,0,0,2017-2018,90.0,31.03448275862069,31.03448275862069
2153,Jérôme Roussillon,FRA,DF,Montpellier,Ligue 1,24,1993,20.9,40,27,17,19,4,15,26,57.7,11,26,3,23,15,55,52,0,0,2017-2018,90.0,64.5933014354067,172.2488038277512
2154,Wayne Routledge,ENG,"MF,FW",Swansea City,Premier League,32,1985,4.8,10,5,2,6,2,2,8,25.0,6,5,0,5,2,12,5,0,0,2017-2018,90.0,37.5,187.5
2155,Nolan Roux,FRA,"FW,MF",Metz,Ligue 1,29,1988,31.5,24,17,8,10,6,7,38,18.4,31,32,2,30,25,49,22,0,0,2017-2018,90.0,71.42857142857143,68.57142857142857
2156,Rubén,ESP,GK,La Coruña,La Liga,33,1984,27.5,1,0,1,0,0,1,3,33.3,2,0,0,0,1,2,5,4,0,2017-2018,89.99999999999999,3.2727272727272725,3.2727272727272725
2157,Antonio Rüdiger,GER,DF,Chelsea,Premier League,24,1993,26.0,31,21,20,10,1,15,31,48.4,16,29,15,14,24,55,115,1,0,2017-2018,90.00000000000001,83.07692307692308,107.30769230769232
2158,Sebastian Rudy,GER,MF,Bayern Munich,Bundesliga,27,1990,16.8,50,40,12,33,5,28,55,50.9,27,11,1,10,18,68,7,1,0,2017-2018,90.0,96.42857142857143,267.85714285714283
2159,Stéphane Ruffier,FRA,GK,Saint-Étienne,Ligue 1,30,1986,34.6,0,0,0,0,0,0,0,0.0,0,0,0,0,0,0,14,1,0,2017-2018,90.0,0.0,0.0
2160,Vincent Rüfli,SUI,"DF,FW",Dijon,Ligue 1,29,1988,0.3,4,1,3,1,0,3,3,100.0,0,1,0,1,1,5,0,0,0,2017-2018,90.0,300.0,1200.0
2161,Daniele Rugani,ITA,DF,Juventus,Serie A,23,1994,21.5,18,12,11,5,2,7,13,53.8,6,18,14,4,20,38,87,1,0,2017-2018,90.0,83.72093023255813,75.34883720930232
2162,Mário Rui,POR,DF,Napoli,Serie A,26,1991,23.2,55,39,18,32,5,30,52,57.7,22,30,5,25,14,69,43,1,0,2017-2018,90.0,54.310344827586206,213.36206896551724
2163,Aitor Ruibal,ESP,MF,Betis,La Liga,21,1996,0.1,0,0,0,0,0,0,0,0.0,0,0,0,0,0,0,0,0,0,2017-2018,90.0,0.0,0.0
2164,Fabián Ruiz Peña,ESP,MF,Betis,La Liga,21,1996,29.5,83,53,34,40,9,26,73,35.6,47,35,3,32,42,125,36,1,0,2017-2018,90.0,128.135593220339,253.22033898305085
2165,Víctor Ruiz,ESP,DF,Villarreal,La Liga,28,1989,26.8,33,22,29,4,0,13,25,52.0,12,27,18,9,58,91,134,1,0,2017-2018,90.0,194.77611940298505,110.82089552238804
2166,Antonio Rukavina,SRB,DF,Villarreal,La Liga,33,1984,14.1,25,22,12,9,4,17,25,68.0,8,11,3,8,16,41,68,0,0,2017-2018,89.99999999999999,102.12765957446808,159.57446808510636
2167,Gerónimo Rulli,ARG,GK,Real Sociedad,La Liga,25,1992,26.0,2,1,2,0,0,2,6,33.3,4,0,0,0,0,2,10,2,0,2017-2018,90.00000000000001,0.0,6.923076923076923
2168,Lukas Rupp,GER,"MF,FW",Hoffenheim,Bundesliga,26,1991,12.9,36,32,18,14,4,19,36,52.8,17,18,0,18,13,49,13,2,0,2017-2018,90.0,90.69767441860465,251.1627906976744
2169,Marco Russ,GER,DF,Eint Frankfurt,Bundesliga,31,1985,12.7,17,11,9,8,0,13,19,68.4,6,23,11,12,24,41,66,0,0,2017-2018,90.0,170.07874015748033,120.4724409448819
2170,Mathew Ryan,AUS,GK,Brighton,Premier League,25,1992,38.0,0,0,0,0,0,0,3,0.0,3,0,0,0,3,3,10,3,0,2017-2018,90.0,7.105263157894737,0.0
2171,Idriss Saadi,ALG,FW,Strasbourg,Ligue 1,25,1992,10.5,6,5,2,3,1,2,11,18.2,9,3,2,1,5,11,1,0,0,2017-2018,90.0,42.857142857142854,51.42857142857143
2172,Youssouf Sabaly,SEN,DF,Bordeaux,Ligue 1,24,1993,34.4,93,61,54,34,5,43,68,63.2,25,26,6,20,54,147,104,0,0,2017-2018,90.0,141.27906976744188,243.3139534883721
2173,Abdelhamid Sabiri,MAR,MF,Huddersfield,Premier League,20,1996,2.4,5,4,2,0,3,1,7,14.3,6,4,0,4,1,6,2,0,0,2017-2018,90.0,37.5,187.5
2174,Marcel Sabitzer,AUT,"MF,FW",RB Leipzig,Bundesliga,23,1994,19.9,38,28,12,20,6,23,49,46.9,26,23,2,21,24,62,21,1,0,2017-2018,90.0,108.5427135678392,171.85929648241208
2175,Enric Saborit,ESP,DF,Athletic Club,La Liga,25,1992,15.9,50,27,31,17,2,19,29,65.5,10,17,5,12,24,74,55,0,0,2017-2018,90.0,135.8490566037736,283.0188679245283
2176,Ihsan Sacko,FRA,"FW,MF",Nice,Ligue 1,20,1997,2.9,1,1,0,1,0,0,1,0.0,1,1,0,1,2,3,1,0,0,2017-2018,90.0,62.06896551724138,31.03448275862069
2177,Ihsan Sacko,FRA,"FW,MF",Strasbourg,Ligue 1,20,1997,7.9,10,8,6,0,4,2,10,20.0,8,2,0,2,5,15,6,0,0,2017-2018,90.0,56.96202531645569,113.92405063291137
2178,Mujaid Sadick,ESP,DF,La Coruña,La Liga,17,2000,1.2,4,2,2,2,0,2,3,66.7,1,3,2,1,1,5,4,0,0,2017-2018,90.0,75.0,300.0
2179,Armando Sadiku,ALB,FW,Levante,La Liga,26,1991,3.0,1,1,0,1,0,0,1,0.0,1,4,2,2,2,3,2,0,0,2017-2018,90.0,60.0,30.0
2180,Umar Sadiq,NGA,FW,Torino,Serie A,20,1997,2.5,0,0,0,0,0,0,3,0.0,3,1,0,1,1,1,2,0,0,2017-2018,90.0,36.0,0.0
2181,Bacary Sagna,FRA,DF,Benevento,Serie A,34,1983,10.6,9,7,5,3,1,1,7,14.3,6,9,2,7,20,29,28,0,0,2017-2018,90.0,169.811320754717,76.41509433962264
2182,Adrián Sahibeddine,FRA,"FW,MF",Dijon,Ligue 1,22,1994,0.4,0,0,0,0,0,0,1,0.0,1,1,0,1,0,0,0,0,0,2017-2018,90.0,0.0,0.0
2183,Nuri Şahin,TUR,MF,Dortmund,Bundesliga,28,1988,13.6,40,34,9,28,3,15,39,38.5,24,12,0,12,20,60,29,1,0,2017-2018,90.0,132.35294117647058,264.70588235294116
2184,Wesley Saïd,FRA,"FW,MF",Dijon,Ligue 1,22,1995,20.4,33,22,17,11,5,7,26,26.9,19,15,1,14,15,48,4,0,0,2017-2018,90.0,66.1764705882353,145.58823529411765
2185,Allan Saint-Maximin,FRA,"FW,MF",Nice,Ligue 1,20,1997,25.0,18,14,13,2,3,12,28,42.9,16,12,1,11,11,29,10,0,0,2017-2018,90.0,39.6,64.8
2186,Allan Saint-Maximin,FRA,MF,Monaco,Ligue 1,20,1997,0.2,0,0,0,0,0,0,0,0.0,0,0,0,0,0,0,0,0,0,2017-2018,90.0,0.0,0.0
2187,Henri Saivet,SEN,MF,Newcastle Utd,Premier League,26,1990,0.9,5,3,4,1,0,2,5,40.0,3,0,0,0,4,9,8,1,0,2017-2018,90.0,400.0,500.0
2188,Gōtoku Sakai,JPN,"DF,MF",Hamburger SV,Bundesliga,26,1991,25.4,50,40,25,18,7,22,47,46.8,25,40,12,28,44,94,55,0,0,2017-2018,90.0,155.90551181102364,177.16535433070868
2189,Hiroki Sakai,JPN,DF,Marseille,Ligue 1,27,1990,28.0,66,45,30,30,6,32,49,65.3,17,32,7,25,45,111,90,1,0,2017-2018,90.0,144.64285714285714,212.14285714285714
2190,Diafra Sakho,SEN,FW,West Ham,Premier League,27,1989,3.4,5,2,1,4,0,0,3,0.0,3,3,0,3,1,6,2,0,0,2017-2018,90.0,26.470588235294116,132.35294117647058
2191,Diafra Sakho,SEN,FW,Rennes,Ligue 1,27,1989,8.6,5,4,1,2,2,0,7,0.0,7,4,0,4,2,7,11,0,0,2017-2018,90.0,20.930232558139537,52.32558139534884
2192,Mamadou Sakho,FRA,DF,Crystal Palace,Premier League,27,1990,17.8,21,14,15,5,1,9,16,56.3,7,19,11,8,30,51,101,3,0,2017-2018,90.0,151.68539325842696,106.17977528089888
2193,Bakary Sako,MLI,"FW,MF",Crystal Palace,Premier League,29,1988,5.3,7,6,5,0,2,2,9,22.2,7,2,0,2,1,8,2,0,0,2017-2018,90.0,16.9811320754717,118.8679245283019
2194,Emiliano Sala,ARG,FW,Nantes,Ligue 1,26,1990,33.7,19,11,3,9,7,5,33,15.2,28,27,3,24,9,28,50,0,0,2017-2018,90.0,24.03560830860534,50.74183976261127
2195,Jacopo Sala,ITA,DF,Sampdoria,Serie A,25,1991,11.0,17,10,12,4,1,4,10,40.0,6,9,1,8,8,25,28,2,0,2017-2018,90.0,65.45454545454545,139.0909090909091
2196,Mohamed Salah,EGY,FW,Liverpool,Premier League,25,1992,32.3,12,6,2,5,5,3,23,13.0,20,10,0,10,5,17,5,0,0,2017-2018,90.0,13.931888544891642,33.43653250773994
2197,Bartosz Salamon,POL,DF,SPAL,Serie A,26,1991,19.2,28,22,21,7,0,12,21,57.1,9,24,18,6,58,86,148,0,0,2017-2018,90.0,271.875,131.25
2198,Carlos Salcedo,MEX,DF,Eint Frankfurt,Bundesliga,23,1993,17.9,26,22,16,9,1,19,29,65.5,10,28,12,16,21,47,94,1,0,2017-2018,90.0,105.58659217877096,130.72625698324023
2199,Eddie Salcedo,ITA,FW,Genoa,Serie A,15,2001,0.4,0,0,0,0,0,0,0,0.0,0,0,0,0,0,0,0,0,0,2017-2018,90.0,0.0,0.0
2200,Yannis Salibur,FRA,"FW,MF",Guingamp,Ligue 1,26,1991,16.9,11,9,4,6,1,4,15,26.7,11,7,1,6,7,18,2,0,0,2017-2018,90.0,37.278106508875744,58.57988165680474
2201,Sejad Salihović,BIH,MF,Hamburger SV,Bundesliga,32,1984,4.1,7,5,3,3,1,0,3,0.0,3,5,0,5,5,12,1,0,0,2017-2018,90.0,109.75609756097562,153.65853658536588
2202,Yoann Salmier,GUF,DF,Strasbourg,Ligue 1,24,1992,12.3,15,13,10,5,0,5,12,41.7,7,11,6,5,26,41,62,1,0,2017-2018,89.99999999999999,190.24390243902437,109.75609756097559
2203,Mamadou Samassa,MLI,GK,Troyes,Ligue 1,27,1990,21.0,0,0,0,0,0,0,2,0.0,2,0,0,0,0,0,12,3,0,2017-2018,90.0,0.0,0.0
2204,Brice Samba,FRA,GK,Caen,Ligue 1,23,1994,3.5,0,0,0,0,0,0,0,0.0,0,0,0,0,0,0,2,0,0,2017-2018,90.0,0.0,0.0
2205,Junior Sambia,FRA,MF,Montpellier,Ligue 1,20,1996,17.1,21,12,6,11,4,6,28,21.4,22,16,0,16,20,41,18,0,0,2017-2018,90.0,105.26315789473684,110.52631578947368
2206,Frédéric Sammaritano,FRA,"FW,MF",Dijon,Ligue 1,31,1986,15.9,29,25,17,9,3,10,36,27.8,26,14,0,14,5,34,15,0,0,2017-2018,90.0,28.30188679245283,164.1509433962264
2207,Sergi Samper,ESP,MF,Las Palmas,La Liga,22,1995,1.6,10,4,4,6,0,2,3,66.7,1,0,0,0,0,10,0,0,0,2017-2018,90.0,0.0,562.5
2208,Jairo Samperio,ESP,"FW,MF",Las Palmas,La Liga,24,1993,6.2,9,6,2,6,1,3,13,23.1,10,5,1,4,1,10,5,0,0,2017-2018,90.0,14.516129032258064,130.6451612903226
2209,Jairo Samperio,ESP,"MF,FW",Mainz 05,Bundesliga,24,1993,0.4,1,1,0,1,0,1,1,100.0,0,0,0,0,0,1,0,0,0,2017-2018,90.0,0.0,225.0
2210,Mario Sampirisi,ITA,DF,Crotone,Serie A,24,1992,24.4,44,32,29,12,3,13,22,59.1,9,27,14,13,43,87,116,2,0,2017-2018,90.0,158.6065573770492,162.29508196721312
2211,Mikel San José,ESP,MF,Athletic Club,La Liga,28,1989,23.9,52,37,19,23,10,19,73,26.0,54,43,13,30,41,93,30,0,0,2017-2018,90.0,154.39330543933056,195.81589958158997
2212,Antonio Sanabria,PAR,FW,Betis,La Liga,21,1996,9.5,8,8,0,4,4,0,3,0.0,3,5,0,5,4,12,6,0,0,2017-2018,90.0,37.89473684210526,75.78947368421052
2213,Renato Sanches,POR,MF,Swansea City,Premier League,19,1997,7.8,12,7,6,6,0,6,18,33.3,12,9,1,8,7,19,5,1,0,2017-2018,90.0,80.76923076923076,138.46153846153845
2214,Alexis Sánchez,CHI,"MF,FW",Arsenal,Premier League,28,1988,16.7,20,9,9,4,7,7,32,21.9,25,5,2,3,6,26,1,0,0,2017-2018,90.0,32.33532934131736,107.78443113772455
2215,Alexis Sánchez,CHI,"FW,MF",Manchester Utd,Premier League,28,1988,11.6,21,17,10,4,7,4,27,14.8,23,8,0,8,17,38,0,0,0,2017-2018,90.0,131.89655172413794,162.93103448275863
2216,Carlos Sánchez,COL,"MF,DF",Fiorentina,Serie A,31,1986,4.1,7,6,2,5,0,4,6,66.7,2,3,1,2,8,15,10,0,0,2017-2018,90.0,175.609756097561,153.65853658536588
2217,Carlos Sánchez,COL,MF,Espanyol,La Liga,31,1986,12.5,25,12,6,16,3,9,24,37.5,15,13,5,8,18,43,24,2,0,2017-2018,90.0,129.6,180.0
2218,Davinson Sánchez,COL,DF,Tottenham,Premier League,21,1996,28.2,38,24,28,9,1,18,40,45.0,22,26,10,16,38,76,162,0,0,2017-2018,89.99999999999999,121.27659574468085,121.27659574468085
2219,Sergio Sánchez,ESP,DF,Espanyol,La Liga,31,1986,1.1,4,3,4,0,0,3,4,75.0,1,1,0,1,3,7,3,0,0,2017-2018,90.0,245.45454545454544,327.27272727272725
2220,Víctor Sánchez,ESP,"MF,DF",Espanyol,La Liga,29,1987,27.3,106,72,56,45,5,49,113,43.4,64,38,14,24,79,185,73,1,0,2017-2018,90.0,260.4395604395604,349.45054945054943
2221,Jadon Sancho,ENG,FW,Dortmund,Bundesliga,17,2000,7.7,5,5,2,2,1,2,7,28.6,5,8,0,8,5,10,2,0,0,2017-2018,90.0,58.44155844155844,58.44155844155844
2222,Sandro,BRA,MF,Benevento,Serie A,28,1989,12.8,29,21,15,13,1,12,18,66.7,6,23,16,7,18,47,43,1,0,2017-2018,90.0,126.5625,203.90625
2223,Alex Sandro,BRA,DF,Juventus,Serie A,26,1991,23.5,57,31,33,17,7,20,39,51.3,19,21,1,20,30,87,45,0,0,2017-2018,90.0,114.89361702127658,218.29787234042553
2224,Arona Sané,SEN,"MF,FW",Atlético Madrid,La Liga,22,1995,0.7,1,0,1,0,0,0,0,0.0,0,1,0,1,0,1,0,0,0,2017-2018,90.0,0.0,128.57142857142858
2225,Lamine Sané,SEN,DF,Werder Bremen,Bundesliga,30,1987,8.7,19,14,15,4,0,8,10,80.0,2,8,6,2,20,39,49,1,0,2017-2018,90.0,206.89655172413794,196.55172413793105
2226,Leroy Sané,GER,FW,Manchester City,Premier League,21,1996,26.9,27,21,14,7,6,8,22,36.4,14,22,1,21,13,40,6,0,0,2017-2018,90.0,43.49442379182156,90.33457249070632
2227,Salif Sané,SEN,DF,Hannover 96,Bundesliga,26,1990,32.0,57,43,46,10,1,40,64,62.5,24,49,29,20,57,114,238,6,0,2017-2018,90.0,160.3125,160.3125
2228,Ibrahim Sangaré,CIV,MF,Toulouse,Ligue 1,19,1997,17.6,72,47,35,34,3,29,69,42.0,40,33,7,26,24,96,19,1,0,2017-2018,90.0,122.72727272727272,368.1818181818182
2229,Younousse Sankharé,SEN,MF,Bordeaux,Ligue 1,27,1989,20.9,33,23,10,20,3,4,34,11.8,30,15,4,11,21,54,7,0,0,2017-2018,90.0,90.43062200956938,142.10526315789474
2230,Baissama Sankoh,GUI,"MF,DF",Caen,Ligue 1,25,1992,17.1,27,19,8,18,1,8,28,28.6,20,20,8,12,25,52,64,1,0,2017-2018,90.0,131.57894736842104,142.10526315789474
2231,Siriki Sanogo,CIV,MF,Benevento,Serie A,15,2001,0.4,1,1,0,1,0,0,0,0.0,0,0,0,0,1,2,1,0,0,2017-2018,90.0,225.0,225.0
2232,Yaya Sanogo,FRA,FW,Toulouse,Ligue 1,24,1993,16.8,11,6,1,5,5,3,11,27.3,8,6,1,5,6,17,14,1,0,2017-2018,90.0,32.14285714285714,58.92857142857142
2233,Morgan Sanson,FRA,MF,Marseille,Ligue 1,22,1994,24.1,64,40,13,34,17,21,71,29.6,50,30,0,30,25,89,5,1,0,2017-2018,90.0,93.3609958506224,239.00414937759336
2234,Nicola Sansone,ITA,"FW,MF",Villarreal,La Liga,25,1991,7.1,8,4,2,4,2,2,17,11.8,15,1,0,1,1,9,2,0,0,2017-2018,90.0,12.67605633802817,101.40845070422536
2235,Baptiste Santamaria,FRA,MF,Angers,Ligue 1,22,1995,28.8,59,40,25,29,5,23,83,27.7,60,39,8,31,43,102,48,2,0,2017-2018,90.0,134.375,184.375
2236,Ivan Santini,CRO,FW,Caen,Ligue 1,28,1989,30.9,19,12,5,8,6,4,29,13.8,25,13,5,8,4,23,33,0,0,2017-2018,90.0,11.650485436893204,55.33980582524272
2237,Davide Santon,ITA,DF,Inter,Serie A,26,1991,9.3,19,14,13,6,0,9,17,52.9,8,10,3,7,20,39,32,2,0,2017-2018,90.0,193.54838709677418,183.87096774193546
2238,Christian Santos,VEN,FW,Alavés,La Liga,29,1988,4.8,2,0,1,0,1,0,4,0.0,4,2,1,1,2,4,9,0,0,2017-2018,90.0,37.5,37.5
2239,Douglas Santos,BRA,DF,Hamburger SV,Bundesliga,23,1994,26.4,90,60,53,34,3,50,87,57.5,37,63,2,61,56,146,96,1,0,2017-2018,90.0,190.9090909090909,306.8181818181818
2240,Samir Santos,BRA,DF,Udinese,Serie A,22,1994,28.5,55,38,35,17,3,19,38,50.0,19,33,16,17,75,130,161,1,0,2017-2018,90.0,236.84210526315792,173.6842105263158
2241,Antonio Santurro,DOM,GK,Bologna,Serie A,25,1992,1.0,0,0,0,0,0,0,0,0.0,0,0,0,0,0,0,1,0,0,2017-2018,90.0,0.0,0.0
2242,Riccardo Saponara,ITA,"MF,FW",Fiorentina,Serie A,25,1991,10.0,12,8,2,8,2,2,11,18.2,9,3,1,2,1,13,5,0,0,2017-2018,90.0,9.0,108.0
2243,Pablo Sarabia,ESP,"FW,MF",Sevilla,La Liga,25,1992,26.6,27,19,10,13,4,11,49,22.4,38,39,1,38,30,57,34,1,0,2017-2018,90.0,101.50375939849623,91.35338345864662
2244,Yusuf Sari,TUR,FW,Marseille,Ligue 1,18,1998,0.0,0,0,0,0,0,0,0,0.0,0,0,0,0,0,0,0,0,0,2017-2018,,,
2245,Bouna Sarr,SEN,"DF,FW",Marseille,Ligue 1,25,1992,19.9,65,42,42,20,3,22,38,57.9,16,20,4,16,32,97,53,2,0,2017-2018,90.0,144.72361809045228,293.9698492462312
2246,Ismaila Sarr,SEN,"FW,MF",Rennes,Ligue 1,19,1998,20.6,20,10,5,10,5,7,29,24.1,22,17,0,17,9,29,3,1,0,2017-2018,90.0,39.320388349514566,87.37864077669903
2247,Malang Sarr,FRA,DF,Nice,Ligue 1,18,1999,14.7,24,18,17,7,0,8,18,44.4,10,14,6,8,31,55,44,2,0,2017-2018,90.0,189.79591836734693,146.9387755102041
2248,Imanol Sarriegi,ESP,"MF,FW",Eibar,La Liga,22,1995,0.5,2,2,1,0,1,2,3,66.7,1,2,0,2,1,3,0,0,0,2017-2018,90.0,180.0,360.0
2249,Marco Sau,ITA,"FW,MF",Cagliari,Serie A,29,1987,14.6,9,6,2,4,3,1,17,5.9,16,10,0,10,9,18,1,0,0,2017-2018,90.0,55.47945205479452,55.47945205479452
2250,Stefan Savić,MNE,DF,Atlético Madrid,La Liga,26,1991,25.5,30,20,23,7,0,16,39,41.0,23,38,23,15,45,75,150,1,0,2017-2018,90.0,158.8235294117647,105.88235294117648
2251,Gianluca Scamacca,ITA,"FW,MF",Sassuolo,Serie A,18,1999,0.3,0,0,0,0,0,0,0,0.0,0,1,0,1,0,0,0,0,0,2017-2018,90.0,0.0,0.0
2252,Fabian Schär,SUI,DF,La Coruña,La Liga,25,1991,24.7,59,45,45,14,0,32,61,52.5,29,36,20,16,45,104,141,1,0,2017-2018,90.0,163.9676113360324,214.97975708502025
2253,Ezequiel Schelotto,ITA,DF,Brighton,Premier League,28,1989,14.6,20,13,14,6,0,12,27,44.4,15,7,3,4,19,39,58,2,0,2017-2018,90.0,117.12328767123289,123.28767123287672
2254,Pasquale Schiattarella,ITA,MF,SPAL,Serie A,30,1987,22.1,40,31,20,15,5,13,43,30.2,30,7,2,5,24,64,26,0,0,2017-2018,90.0,97.73755656108597,162.89592760180994
2255,Eros Schiavon,ITA,"MF,DF",SPAL,Serie A,34,1983,4.3,6,5,2,3,1,1,7,14.3,6,6,2,4,2,8,4,0,0,2017-2018,90.0,41.86046511627907,125.58139534883722
2256,Patrik Schick,CZE,"FW,MF",Roma,Serie A,21,1996,11.0,9,7,1,5,3,1,9,11.1,8,14,0,14,2,11,11,0,0,2017-2018,90.0,16.363636363636363,73.63636363636364
2257,Julian Schieber,GER,"MF,FW",Hertha BSC,Bundesliga,28,1989,0.6,1,1,0,0,1,1,1,100.0,0,1,0,1,0,1,2,0,0,2017-2018,90.0,0.0,150.0
2258,Christopher Schindler,GER,DF,Huddersfield,Premier League,27,1990,36.3,83,61,56,27,0,24,41,58.5,17,54,30,24,75,158,275,1,0,2017-2018,90.0,185.95041322314052,205.78512396694217
2259,Sven Schipplock,GER,"FW,MF",Hamburger SV,Bundesliga,28,1988,3.8,7,6,1,5,1,0,1,0.0,1,4,0,4,1,8,3,0,0,2017-2018,90.0,23.684210526315788,165.78947368421052
2260,Jeffrey Schlupp,GHA,"DF,MF",Crystal Palace,Premier League,24,1992,19.4,57,36,35,20,2,23,43,53.5,20,34,8,26,24,81,67,0,0,2017-2018,90.0,111.34020618556703,264.4329896907217
2261,Kasper Schmeichel,DEN,GK,Leicester City,Premier League,30,1986,32.9,1,0,1,0,0,1,3,33.3,2,1,0,1,0,1,18,5,0,2017-2018,90.0,0.0,2.7355623100303954
2262,Marcel Schmelzer,GER,DF,Dortmund,Bundesliga,29,1988,16.6,35,27,21,12,2,20,30,66.7,10,27,6,21,30,65,57,1,0,2017-2018,90.0,162.65060240963854,189.7590361445783
2263,Jonathan Schmid,FRA,"DF,FW",Augsburg,Bundesliga,27,1990,16.4,23,16,6,13,4,11,18,61.1,7,16,1,15,10,33,35,1,0,2017-2018,90.0,54.87804878048781,126.21951219512196
2264,Manuel Schmiedebach,GER,MF,Hannover 96,Bundesliga,28,1988,1.8,5,5,5,0,0,4,9,44.4,5,2,0,2,5,10,6,0,0,2017-2018,90.0,250.0,250.0
2265,Benno Schmitz,GER,DF,RB Leipzig,Bundesliga,22,1994,0.9,3,2,2,1,0,2,3,66.7,1,0,0,0,0,3,1,0,0,2017-2018,90.0,0.0,300.0
2266,Morgan Schneiderlin,FRA,MF,Everton,Premier League,27,1989,23.7,58,40,34,21,3,15,44,34.1,29,18,7,11,61,119,59,1,0,2017-2018,90.0,231.64556962025318,220.25316455696205
2267,Alessandro Schöpf,AUT,"DF,FW",Schalke 04,Bundesliga,23,1994,9.0,22,17,10,9,3,11,23,47.8,12,16,0,16,15,37,13,1,0,2017-2018,90.0,150.0,220.0
2268,Nico Schulz,GER,"FW,MF",Hoffenheim,Bundesliga,24,1993,19.8,40,29,17,14,9,20,27,74.1,7,33,5,28,23,63,24,0,0,2017-2018,90.0,104.54545454545455,181.8181818181818
2269,André Schürrle,GER,FW,Dortmund,Bundesliga,26,1990,13.7,22,19,8,7,7,9,18,50.0,9,13,1,12,7,29,7,1,0,2017-2018,90.0,45.98540145985402,144.52554744525548
2270,Julian Schuster,GER,"DF,MF",Freiburg,Bundesliga,32,1985,14.5,14,10,6,7,1,6,11,54.5,5,17,10,7,19,33,56,0,0,2017-2018,90.0,117.93103448275862,86.89655172413792
2271,Pirmin Schwegler,SUI,MF,Hannover 96,Bundesliga,30,1987,25.8,81,57,25,55,1,42,70,60.0,28,33,9,24,49,130,46,1,0,2017-2018,90.0,170.93023255813952,282.5581395348837
2272,Alexander Schwolow,GER,GK,Freiburg,Bundesliga,25,1992,32.3,0,0,0,0,0,0,1,0.0,1,0,0,0,0,0,9,1,0,2017-2018,90.0,0.0,0.0
2273,Simone Scuffet,ITA,GK,Udinese,Serie A,21,1996,6.0,0,0,0,0,0,0,0,0.0,0,0,0,0,1,1,1,1,0,2017-2018,90.0,15.0,0.0
2274,Sergio Segura García,ESP,DF,Leganés,La Liga,21,1995,0.3,0,2,0,0,0,,0,0.0,0,0,0,0,1,0,0,0,0,2017-2018,90.0,300.0,0.0
2275,Ernest Seka,GUI,DF,Strasbourg,Ligue 1,30,1987,24.2,60,47,41,14,5,40,61,65.6,21,25,8,17,51,111,98,1,0,2017-2018,90.0,189.6694214876033,223.14049586776858
2276,Vahid Selimović,LUX,DF,Metz,Ligue 1,20,1997,11.7,20,14,10,9,1,11,14,78.6,3,10,8,2,17,37,58,1,0,2017-2018,89.99999999999999,130.76923076923077,153.84615384615384
2277,Davie Selke,GER,FW,Hertha BSC,Bundesliga,22,1995,21.0,13,10,1,5,7,4,9,44.4,5,26,5,21,2,15,20,1,0,2017-2018,90.0,8.571428571428571,55.714285714285715
2278,Ole Selnæs,NOR,MF,Saint-Étienne,Ligue 1,23,1994,22.9,73,45,29,42,2,18,61,29.5,43,37,15,22,34,107,53,1,0,2017-2018,90.0,133.62445414847164,286.8995633187773
2279,Nélson Semedo,POR,DF,Barcelona,La Liga,23,1993,16.6,34,25,19,11,4,17,29,58.6,12,16,2,14,22,56,26,1,0,2017-2018,90.0,119.27710843373492,184.33734939759034
2280,Rúben Semedo,POR,"DF,MF",Villarreal,La Liga,23,1994,2.6,6,5,6,0,0,4,6,66.7,2,5,1,4,5,11,13,2,0,2017-2018,90.0,173.07692307692307,207.69230769230768
2281,Stefano Sensi,ITA,MF,Sassuolo,Serie A,21,1995,11.6,17,13,11,6,0,9,22,40.9,13,16,3,13,22,39,10,1,0,2017-2018,90.0,170.6896551724138,131.89655172413794
2282,Luigi Sepe,ITA,GK,Napoli,Serie A,26,1991,1.0,0,0,0,0,0,0,0,0.0,0,0,0,0,0,0,1,0,0,2017-2018,90.0,0.0,0.0
2283,Suat Serdar,GER,MF,Mainz 05,Bundesliga,20,1997,18.9,59,47,21,26,12,27,64,42.2,37,38,3,35,21,80,17,1,0,2017-2018,90.0,100.0,280.95238095238096
2284,Jean Seri,CIV,MF,Nice,Ligue 1,26,1991,29.1,25,14,9,12,4,9,56,16.1,47,16,4,12,26,51,15,4,0,2017-2018,90.0,80.41237113402062,77.31958762886597
2285,Julien Serrano,FRA,DF,Monaco,Ligue 1,19,1998,3.1,2,2,1,0,1,1,2,50.0,1,2,0,2,4,6,14,0,0,2017-2018,90.0,116.12903225806451,58.064516129032256
2286,Grégory Sertic,FRA,"DF,MF",Marseille,Ligue 1,27,1989,3.9,5,3,3,2,0,2,6,33.3,4,8,7,1,6,11,23,0,0,2017-2018,90.0,138.46153846153845,115.38461538461539
2287,Stéphane Sessègnon,BEN,"MF,FW",Montpellier,Ligue 1,33,1984,10.9,4,4,2,2,0,1,7,14.3,6,0,0,0,0,4,2,0,0,2017-2018,90.0,0.0,33.027522935779814
2288,Lee Seung-woo,KOR,"MF,FW",Hellas Verona,Serie A,19,1998,4.0,3,2,0,1,2,0,6,0.0,6,1,0,1,2,5,0,0,0,2017-2018,90.0,45.0,67.5
2289,Stephan El Shaarawy,ITA,FW,Roma,Serie A,24,1992,23.9,22,16,9,8,5,5,21,23.8,16,16,1,15,24,46,8,0,0,2017-2018,90.0,90.3765690376569,82.84518828451883
2290,Meritan Shabani,ALB,FW,Bayern Munich,Bundesliga,18,1999,0.6,2,1,1,0,1,1,2,50.0,1,1,0,1,0,2,0,1,0,2017-2018,90.0,0.0,300.0
2291,Xherdan Shaqiri,SUI,"MF,FW",Stoke City,Premier League,25,1991,33.8,25,17,9,11,5,10,39,25.6,29,9,1,8,16,41,6,2,0,2017-2018,90.0,42.60355029585799,66.56804733727812
2292,Luke Shaw,ENG,DF,Manchester Utd,Premier League,22,1995,8.8,18,15,10,7,1,11,18,61.1,7,16,2,14,4,22,22,1,0,2017-2018,90.0,40.90909090909091,184.0909090909091
2293,Ryan Shawcross,ENG,DF,Stoke City,Premier League,29,1987,26.3,36,20,25,9,2,13,25,52.0,12,33,23,10,40,76,224,1,0,2017-2018,90.0,136.88212927756655,123.19391634980988
2294,Jonjo Shelvey,ENG,MF,Newcastle Utd,Premier League,25,1992,25.2,39,24,17,21,1,8,26,30.8,18,26,5,21,28,67,33,0,0,2017-2018,90.0,100.00000000000001,139.2857142857143
2295,Gaku Shibasaki,JPN,"MF,FW",Getafe,La Liga,25,1992,11.1,21,10,8,10,3,6,21,28.6,15,6,1,5,19,40,9,0,0,2017-2018,90.0,154.05405405405406,170.2702702702703
2296,Djibril Sidibé,FRA,DF,Monaco,Ligue 1,25,1992,23.9,59,39,24,27,8,23,45,51.1,22,20,4,16,46,105,52,1,0,2017-2018,90.0,173.22175732217573,222.17573221757323
2297,Sidnei,BRA,DF,La Coruña,La Liga,27,1989,19.8,41,28,30,11,0,18,25,72.0,7,26,9,17,31,72,101,1,0,2017-2018,90.0,140.9090909090909,186.36363636363637
2298,Jaime Sierra Mateos,ESP,"FW,MF",Leganés,La Liga,19,1998,0.3,1,1,1,0,0,0,1,0.0,1,0,0,0,1,2,0,0,0,2017-2018,90.0,300.0,300.0
2299,Vincent Sierro,SUI,"MF,FW",Freiburg,Bundesliga,21,1995,2.4,8,6,2,6,0,4,9,44.4,5,2,1,1,4,12,0,0,0,2017-2018,90.0,150.0,300.0
2300,Gylfi Sigurðsson,ISL,"MF,FW",Everton,Premier League,27,1989,25.1,38,26,15,14,9,16,57,28.1,41,37,7,30,34,72,36,0,0,2017-2018,90.0,121.91235059760956,136.25498007968127
2301,Kolbeinn Sigþórsson,ISL,FW,Nantes,Ligue 1,27,1990,0.3,0,0,0,0,0,0,0,0.0,0,0,0,0,1,1,0,0,0,2017-2018,90.0,300.0,0.0
2302,Adrien Silva,POR,MF,Leicester City,Premier League,28,1989,8.5,22,13,8,13,1,6,28,21.4,22,12,2,10,14,36,0,0,0,2017-2018,90.0,148.23529411764707,232.94117647058823
2303,André Silva,POR,FW,Milan,Serie A,21,1995,10.4,5,4,1,0,4,2,7,28.6,5,10,1,9,4,9,6,0,0,2017-2018,90.0,34.61538461538461,43.26923076923077
2304,Bernardo Silva,POR,"FW,MF",Manchester City,Premier League,22,1994,17.0,27,18,11,9,7,6,30,20.0,24,17,1,16,10,37,12,1,0,2017-2018,90.0,52.94117647058824,142.94117647058823
2305,David Silva,ESP,MF,Manchester City,Premier League,31,1986,27.0,32,21,11,17,4,9,45,20.0,36,28,5,23,18,50,7,0,0,2017-2018,90.0,60.0,106.66666666666667
2306,Gabriel Silva,BRA,DF,Saint-Étienne,Ligue 1,26,1991,23.1,28,20,19,4,5,19,31,61.3,12,21,6,15,37,65,83,1,0,2017-2018,89.99999999999999,144.15584415584414,109.09090909090908
2307,Jonathan Silva,ARG,DF,Roma,Serie A,23,1994,1.2,0,0,0,0,0,0,1,0.0,1,1,1,0,3,3,1,0,0,2017-2018,90.0,225.00000000000003,0.0
2308,Thiago Silva,BRA,DF,Paris S-G,Ligue 1,32,1984,23.5,31,23,19,12,0,12,21,57.1,9,28,18,10,18,49,114,0,0,2017-2018,90.0,68.93617021276596,118.72340425531914
2309,Matías Silvestre,ARG,DF,Sampdoria,Serie A,32,1984,34.0,12,8,10,1,1,6,12,50.0,6,33,26,7,11,23,154,3,0,2017-2018,90.0,29.11764705882353,31.764705882352942
2310,Marco Silvestri,ITA,GK,Hellas Verona,Serie A,26,1991,2.0,0,0,0,0,0,0,0,0.0,0,0,0,0,1,1,0,0,0,2017-2018,90.0,45.0,0.0
2311,Giovanni Simeone,ARG,FW,Fiorentina,Serie A,22,1995,33.3,32,23,9,17,6,8,40,20.0,32,27,1,26,12,44,32,0,0,2017-2018,90.0,32.432432432432435,86.48648648648648
2312,Lorenco Šimić,CRO,DF,SPAL,Serie A,21,1996,3.5,5,3,5,0,0,3,4,75.0,1,7,4,3,11,16,15,0,0,2017-2018,90.0,282.85714285714283,128.57142857142856
2313,Stefan Simić,CZE,DF,Crotone,Serie A,22,1995,6.2,13,8,11,2,0,10,11,90.9,1,6,3,3,10,23,44,0,0,2017-2018,90.0,145.16129032258064,188.70967741935485
2314,David Simón,ESP,DF,Las Palmas,La Liga,28,1988,8.0,24,17,11,10,3,9,16,56.3,7,13,4,9,22,46,11,1,0,2017-2018,90.0,247.5,270.0
2315,Danny Simpson,ENG,DF,Leicester City,Premier League,30,1987,25.6,38,22,31,6,1,22,45,48.9,23,31,19,12,34,72,132,1,0,2017-2018,90.0,119.53125,133.59375
2316,Jack Simpson,ENG,DF,Bournemouth,Premier League,20,1996,0.8,1,1,1,0,0,0,1,0.0,1,1,0,1,0,1,4,0,0,2017-2018,90.0,0.0,112.5
2317,Josh Sims,ENG,"FW,MF",Southampton,Premier League,20,1997,1.8,4,3,1,2,1,2,7,28.6,5,5,0,5,1,5,0,0,0,2017-2018,90.0,50.0,200.0
2318,Jerome Sinclair,ENG,"MF,FW",Watford,Premier League,20,1996,0.3,0,0,0,0,0,0,1,0.0,1,0,0,0,1,1,0,0,0,2017-2018,90.0,300.0,0.0
2319,Giovanni Sio,CIV,FW,Montpellier,Ligue 1,28,1989,24.4,14,8,2,9,3,0,20,0.0,20,11,0,11,6,20,23,1,0,2017-2018,90.0,22.13114754098361,51.63934426229509
2320,Dimitris Siovas,GRE,DF,Leganés,La Liga,28,1988,22.9,48,33,43,5,0,29,46,63.0,17,27,12,15,62,110,89,0,0,2017-2018,90.0,243.66812227074237,188.646288209607
2321,Tobias Sippel,GER,GK,Gladbach,Bundesliga,29,1988,4.8,1,1,1,0,0,1,2,50.0,1,0,0,0,0,1,5,1,0,2017-2018,90.0,0.0,18.75
2322,Salvatore Sirigu,ITA,GK,Torino,Serie A,30,1987,37.0,0,0,0,0,0,0,0,0.0,0,0,0,0,1,1,35,3,0,2017-2018,90.0,2.4324324324324325,0.0
2323,Moussa Sissoko,FRA,"MF,FW",Tottenham,Premier League,27,1989,15.4,23,17,14,5,4,9,12,75.0,3,11,1,10,9,32,23,1,0,2017-2018,90.0,52.5974025974026,134.41558441558442
2324,Pione Sisto,DEN,"FW,MF",Celta Vigo,La Liga,22,1995,28.0,18,12,8,6,4,9,33,27.3,24,12,1,11,12,30,7,1,0,2017-2018,90.0,38.57142857142857,57.857142857142854
2325,Antonio Sivera,ESP,GK,Alavés,La Liga,20,1996,0.7,0,0,0,0,0,0,0,0.0,0,0,0,0,0,0,0,0,0,2017-2018,90.0,0.0,0.0
2326,Ellyes Skhiri,TUN,MF,Montpellier,Ligue 1,22,1995,33.9,89,54,34,47,8,37,88,42.0,51,59,10,49,77,166,57,4,0,2017-2018,90.0,204.42477876106196,236.28318584070797
2327,Łukasz Skorupski,POL,GK,Roma,Serie A,26,1991,1.0,0,0,0,0,0,0,0,0.0,0,0,0,0,0,0,1,0,0,2017-2018,90.0,0.0,0.0
2328,Milan Škriniar,SVK,DF,Inter,Serie A,22,1995,38.0,86,55,69,16,1,44,70,62.9,26,38,26,12,35,121,180,0,0,2017-2018,90.0,82.89473684210526,203.68421052631578
2329,Islam Slimani,ALG,FW,Leicester City,Premier League,29,1988,2.8,2,2,1,1,0,1,4,25.0,3,2,0,2,0,2,2,0,0,2017-2018,90.0,0.0,64.28571428571429
2330,Islam Slimani,ALG,FW,Newcastle Utd,Premier League,29,1988,1.5,0,0,0,0,0,0,2,0.0,2,0,0,0,1,1,1,0,0,2017-2018,90.0,60.0,0.0
2331,Naïm Sliti,TUN,"FW,MF",Dijon,Ligue 1,25,1992,25.4,47,32,20,17,10,20,52,38.5,32,22,2,20,13,60,7,0,0,2017-2018,90.0,46.06299212598425,166.53543307086616
2332,Chris Smalling,ENG,DF,Manchester Utd,Premier League,27,1989,28.2,40,25,28,12,0,16,28,57.1,12,32,28,4,63,103,162,1,0,2017-2018,89.99999999999999,201.06382978723403,127.6595744680851
2333,Adam Smith,ENG,"DF,MF",Bournemouth,Premier League,26,1991,23.0,50,36,33,16,1,24,53,45.3,29,46,8,38,31,81,73,0,0,2017-2018,90.0,121.30434782608697,195.6521739130435
2334,Tommy Smith,ENG,DF,Huddersfield,Premier League,25,1992,21.2,38,27,18,14,6,23,36,63.9,13,22,6,16,26,64,80,3,0,2017-2018,90.0,110.37735849056604,161.32075471698113
2335,Wesley Sneijder,NED,"MF,FW",Nice,Ligue 1,33,1984,4.4,0,0,0,0,0,0,3,0.0,3,1,0,1,2,2,2,1,0,2017-2018,90.0,40.90909090909091,0.0
2336,Cédric Soares,POR,DF,Southampton,Premier League,25,1991,31.0,54,34,40,10,4,22,31,71.0,9,32,8,24,24,78,109,2,0,2017-2018,90.0,69.6774193548387,156.7741935483871
2337,Ramadan Sobhi,EGY,"MF,FW",Stoke City,Premier League,20,1997,13.8,32,21,17,14,1,11,36,30.6,25,14,0,14,14,46,14,0,0,2017-2018,90.0,91.30434782608695,208.69565217391303
2338,Rubén Sobrino,ESP,"FW,MF",Alavés,La Liga,25,1992,16.3,33,24,12,16,5,6,27,22.2,21,19,2,17,18,51,10,0,0,2017-2018,90.0,99.38650306748467,182.2085889570552
2339,Dominic Solanke,ENG,FW,Liverpool,Premier League,19,1997,6.6,7,4,0,6,1,1,4,25.0,3,5,1,4,2,9,9,0,0,2017-2018,90.0,27.272727272727273,95.45454545454545
2340,Carlos Soler,ESP,MF,Valencia,La Liga,20,1997,26.3,51,32,21,21,9,22,53,41.5,31,25,1,24,5,56,19,0,0,2017-2018,90.0,17.11026615969582,174.52471482889734
2341,Somália,BRA,"MF,FW",Toulouse,Ligue 1,28,1988,22.2,65,45,21,36,8,14,54,25.9,40,34,2,32,34,99,35,0,0,2017-2018,90.0,137.83783783783784,263.51351351351354
2342,Yann Sommer,SUI,GK,Gladbach,Bundesliga,28,1988,29.2,0,0,0,0,0,0,0,0.0,0,0,0,0,3,3,6,3,0,2017-2018,90.0,9.246575342465754,0.0
2343,Kévin Soni,CMR,MF,Girona,La Liga,19,1998,0.2,1,1,0,1,0,0,0,0.0,0,0,0,0,0,1,0,0,0,2017-2018,90.0,0.0,450.0
2344,Jérémy Sorbon,FRA,DF,Guingamp,Ligue 1,33,1983,29.0,32,19,24,7,1,10,32,31.3,22,37,24,13,53,85,152,4,0,2017-2018,90.0,164.48275862068965,99.3103448275862
2345,Oliver Sorg,GER,"DF,MF",Hannover 96,Bundesliga,27,1990,18.7,46,28,27,18,1,23,53,43.4,30,24,7,17,42,88,71,0,0,2017-2018,90.0,202.13903743315507,221.3903743315508
2346,David Soria,ESP,GK,Sevilla,La Liga,24,1993,14.0,1,0,1,0,0,1,1,100.0,0,0,0,0,2,3,13,2,0,2017-2018,90.0,12.857142857142858,6.428571428571429
2347,Roberto Soriano,ITA,"MF,FW",Villarreal,La Liga,26,1991,12.7,30,20,10,16,4,3,16,18.8,13,14,0,14,4,34,9,0,0,2017-2018,90.0,28.34645669291339,212.5984251968504
2348,Stefano Sorrentino,ITA,GK,Chievo,Serie A,38,1979,38.0,0,0,0,0,0,0,0,0.0,0,0,0,0,0,0,23,3,0,2017-2018,90.0,0.0,0.0
2349,Pape Souaré,SEN,DF,Crystal Palace,Premier League,27,1990,0.1,0,0,0,0,0,0,0,0.0,0,0,0,0,0,0,0,0,0,2017-2018,90.0,0.0,0.0
2350,Rayan Souici,FRA,MF,Saint-Étienne,Ligue 1,19,1998,0.1,0,0,0,0,0,0,0,0.0,0,1,0,1,0,0,0,0,0,2017-2018,90.0,0.0,0.0
2351,Adama Soumaoro,FRA,DF,Lille,Ligue 1,25,1992,13.2,9,5,7,2,0,2,3,66.7,1,22,16,6,16,25,50,1,0,2017-2018,90.0,109.0909090909091,61.36363636363637
2352,Boubakary Soumaré,FRA,MF,Lille,Ligue 1,18,1999,5.7,13,9,8,5,0,3,14,21.4,11,8,1,7,7,20,6,1,0,2017-2018,90.0,110.52631578947367,205.26315789473682
2353,Samuel Souprayen,FRA,DF,Hellas Verona,Serie A,28,1989,17.6,29,19,25,3,1,12,19,63.2,7,18,9,9,22,51,67,1,0,2017-2018,90.0,112.5,148.29545454545453
2354,Arnaud Souquet,FRA,DF,Nice,Ligue 1,25,1992,26.8,89,68,58,26,5,36,56,64.3,20,46,16,30,39,128,72,2,0,2017-2018,90.0,130.97014925373134,298.88059701492534
2355,Çağlar Söyüncü,TUR,DF,Freiburg,Bundesliga,21,1996,23.9,42,26,26,15,1,15,26,57.7,11,30,20,10,54,96,91,2,0,2017-2018,90.0,203.34728033472805,158.1589958158996
2356,Luca Sparandeo,ITA,DF,Benevento,Serie A,17,1999,0.4,0,0,0,0,0,0,1,0.0,1,1,0,1,0,0,0,0,0,2017-2018,90.0,0.0,0.0
2357,Julián Speroni,ARG,GK,Crystal Palace,Premier League,38,1979,11.0,0,0,0,0,0,0,0,0.0,0,0,0,0,1,1,4,0,0,2017-2018,90.0,8.181818181818182,0.0
2358,Leonardo Spinazzola,ITA,DF,Atalanta,Serie A,24,1993,16.7,14,5,9,4,1,7,15,46.7,8,25,6,19,18,32,44,1,0,2017-2018,90.0,97.0059880239521,75.44910179640719
2359,Nicolás Spolli,ARG,DF,Genoa,Serie A,34,1983,20.0,27,21,24,2,1,13,22,59.1,9,26,17,9,36,63,120,2,0,2017-2018,90.0,162.0,121.5
2360,Marco Sportiello,ITA,GK,Fiorentina,Serie A,25,1992,35.6,0,0,0,0,0,0,1,0.0,1,0,0,0,1,1,13,4,0,2017-2018,90.0,2.5280898876404496,0.0
2361,Bassem Srarfi,TUN,"FW,MF",Nice,Ligue 1,20,1997,9.7,17,11,6,9,2,4,14,28.6,10,12,0,12,7,24,6,1,0,2017-2018,90.0,64.94845360824743,157.73195876288662
2362,Kostas Stafylidis,GRE,"DF,MF",Stoke City,Premier League,23,1993,3.7,12,6,6,4,2,6,9,66.7,3,7,2,5,5,17,19,0,0,2017-2018,90.0,121.62162162162161,291.8918918918919
2363,Kostas Stafylidis,GRE,"FW,DF",Augsburg,Bundesliga,23,1993,0.4,1,1,1,0,0,0,0,0.0,0,1,0,1,0,1,2,0,0,2017-2018,90.0,0.0,225.0
2364,Benjamin Stambouli,FRA,"DF,MF",Schalke 04,Bundesliga,26,1990,24.4,95,75,45,48,2,49,74,66.2,25,39,7,32,64,159,76,1,0,2017-2018,90.0,236.06557377049182,350.4098360655738
2365,Junior Stanislas,ENG,"MF,FW",Bournemouth,Premier League,27,1989,14.3,16,8,8,4,4,7,15,46.7,8,21,6,15,6,22,15,0,0,2017-2018,90.0,37.76223776223776,100.69930069930071
2366,Caleb Stanko,USA,DF,Freiburg,Bundesliga,24,1993,2.1,2,2,1,1,0,1,2,50.0,1,3,0,3,1,3,8,0,0,2017-2018,90.0,42.857142857142854,85.71428571428571
2367,Niklas Stark,GER,"DF,MF",Hertha BSC,Bundesliga,22,1995,24.6,49,31,32,17,0,22,30,73.3,8,39,14,25,34,83,165,0,0,2017-2018,89.99999999999999,124.39024390243901,179.2682926829268
2368,Tom Starke,GER,GK,Bayern Munich,Bundesliga,36,1981,2.0,0,0,0,0,0,0,0,0.0,0,0,0,0,0,0,0,0,0,2017-2018,90.0,0.0,0.0
2369,Timo Stavitski,FIN,"MF,FW",Caen,Ligue 1,18,1999,4.5,4,3,1,1,2,1,16,6.3,15,7,0,7,3,7,1,0,0,2017-2018,90.0,60.0,80.0
2370,Renato Steffen,SUI,"FW,MF",Wolfsburg,Bundesliga,25,1991,7.3,10,9,6,3,1,8,12,66.7,4,6,0,6,5,15,6,0,0,2017-2018,90.0,61.64383561643836,123.28767123287672
2371,Marc Stendera,GER,MF,Eint Frankfurt,Bundesliga,21,1995,4.1,23,20,6,15,2,8,20,40.0,12,10,1,9,8,31,2,0,0,2017-2018,90.0,175.609756097561,504.87804878048786
2372,Pascal Stenzel,GER,"MF,DF",Freiburg,Bundesliga,21,1996,21.6,62,45,35,25,2,34,57,59.6,23,20,3,17,35,97,51,1,0,2017-2018,90.0,145.83333333333331,258.3333333333333
2373,Dale Stephens,ENG,MF,Brighton,Premier League,28,1989,36.0,104,62,63,39,2,32,114,28.1,82,53,16,37,63,167,69,1,0,2017-2018,90.0,157.5,260.0
2374,Jack Stephens,ENG,DF,Southampton,Premier League,23,1994,22.0,29,20,24,5,0,13,25,52.0,12,30,18,12,41,70,108,2,0,2017-2018,90.0,167.72727272727272,118.63636363636364
2375,Mariusz Stępiński,POL,FW,Chievo,Serie A,22,1995,7.9,9,5,4,4,1,2,10,20.0,8,5,1,4,4,13,5,0,0,2017-2018,90.0,45.56962025316455,102.53164556962024
2376,Mariusz Stępiński,POL,FW,Nantes,Ligue 1,22,1995,0.0,0,0,0,0,0,0,0,0.0,0,0,0,0,0,0,0,0,0,2017-2018,,,
2377,Raheem Sterling,ENG,FW,Manchester City,Premier League,22,1994,28.7,19,14,7,7,5,3,32,9.4,29,24,0,24,9,28,9,0,0,2017-2018,90.0,28.222996515679444,59.58188153310105
2378,Ognjen Stijepović,MNE,"FW,MF",Sampdoria,Serie A,17,1999,0.1,0,0,0,0,0,0,0,0.0,0,0,0,0,0,0,0,0,0,2017-2018,90.0,0.0,0.0
2379,Lars Stindl,GER,"FW,MF",Gladbach,Bundesliga,28,1988,30.3,52,39,11,29,12,14,38,36.8,24,53,4,49,31,83,32,1,0,2017-2018,90.0,92.07920792079207,154.45544554455446
2380,Valentin Stocker,SUI,MF,Hertha BSC,Bundesliga,28,1989,0.6,1,0,0,1,0,0,0,0.0,0,1,0,1,0,1,0,0,0,2017-2018,90.0,0.0,150.0
2381,Adrian Stoian,ROU,"MF,FW",Crotone,Serie A,26,1991,23.7,23,19,12,10,1,11,44,25.0,33,29,0,29,25,48,26,0,0,2017-2018,90.0,94.93670886075951,87.34177215189874
2382,John Stones,ENG,DF,Manchester City,Premier League,23,1994,14.5,15,11,11,4,0,4,11,36.4,7,8,5,3,19,34,44,0,0,2017-2018,90.0,117.93103448275862,93.10344827586206
2383,Thomas Strakosha,ALB,GK,Lazio,Serie A,22,1995,38.0,0,0,0,0,0,0,0,0.0,0,0,0,0,2,2,13,4,0,2017-2018,90.0,4.7368421052631575,0.0
2384,Ivan Strinić,CRO,DF,Sampdoria,Serie A,30,1987,13.9,35,24,22,12,1,17,38,44.7,21,21,2,19,22,57,46,2,0,2017-2018,90.0,142.44604316546764,226.61870503597123
2385,Tobias Strobl,GER,MF,Gladbach,Bundesliga,27,1990,1.3,3,1,0,2,1,0,1,0.0,1,2,0,2,6,9,2,0,0,2017-2018,90.0,415.38461538461536,207.69230769230768
2386,Kevin Strootman,NED,MF,Roma,Serie A,27,1990,25.1,57,38,19,24,14,15,46,32.6,31,27,3,24,27,84,21,0,0,2017-2018,90.0,96.81274900398405,204.3824701195219
2387,Jens Stryger Larsen,DEN,DF,Udinese,Serie A,26,1991,28.1,36,27,25,10,1,21,39,53.8,18,35,14,21,31,67,82,2,0,2017-2018,90.0,99.288256227758,115.30249110320284
2388,Cristhian Stuani,URU,FW,Girona,La Liga,30,1986,30.1,22,14,2,17,3,3,29,10.3,26,10,0,10,5,27,32,0,0,2017-2018,90.00000000000001,14.950166112956811,65.78073089700997
2389,Stefano Sturaro,ITA,"MF,DF",Juventus,Serie A,24,1993,6.8,17,11,5,9,3,4,11,36.4,7,9,2,7,5,22,18,1,0,2017-2018,90.0,66.17647058823529,225.0
2390,Daniel Sturridge,ENG,FW,West Brom,Premier League,27,1989,1.3,0,0,0,0,0,0,0,0.0,0,0,0,0,0,0,0,0,0,2017-2018,90.0,0.0,0.0
2391,Daniel Sturridge,ENG,FW,Liverpool,Premier League,27,1989,4.8,0,0,0,0,0,0,1,0.0,1,1,0,1,0,0,1,0,0,2017-2018,90.0,0.0,0.0
2392,Damián Suárez,URU,DF,Getafe,La Liga,29,1988,32.0,86,64,54,21,11,44,90,48.9,46,34,8,26,46,132,76,1,0,2017-2018,90.0,129.375,241.875
2393,Denis Suárez,ESP,"MF,FW",Barcelona,La Liga,23,1994,6.6,11,9,3,8,0,3,8,37.5,5,7,0,7,2,13,3,0,0,2017-2018,90.0,27.272727272727273,150.0
2394,Leonardo Suárez,ARG,MF,Villarreal,La Liga,21,1996,0.3,0,0,0,0,0,0,0,0.0,0,0,0,0,0,0,1,0,0,2017-2018,90.0,0.0,0.0
2395,Luis Suárez,URU,FW,Barcelona,La Liga,30,1987,32.2,17,10,4,5,8,4,19,21.1,15,4,3,1,8,25,31,0,0,2017-2018,90.0,22.360248447204967,47.515527950310556
2396,Danijel Subašić,CRO,GK,Monaco,Ligue 1,32,1984,32.7,0,0,0,0,0,0,2,0.0,2,1,0,1,0,0,13,2,0,2017-2018,90.0,0.0,0.0
2397,Neven Subotić,SRB,DF,Saint-Étienne,Ligue 1,28,1988,16.0,23,14,16,7,0,10,27,37.0,17,13,9,4,18,41,96,1,0,2017-2018,90.0,101.25,129.375
2398,Neven Subotić,SRB,DF,Dortmund,Bundesliga,28,1988,3.0,9,9,5,3,1,6,7,85.7,1,6,2,4,5,14,16,0,0,2017-2018,90.0,150.0,270.0
2399,Isaac Success,NGA,"MF,FW",Málaga,La Liga,21,1996,5.5,9,7,4,4,1,3,8,37.5,5,2,0,2,5,14,0,0,0,2017-2018,90.0,81.81818181818183,147.27272727272728
2400,Niklas Süle,GER,DF,Bayern Munich,Bundesliga,21,1995,21.4,34,25,25,7,2,24,31,77.4,7,24,16,8,33,67,58,0,0,2017-2018,90.0,138.78504672897196,142.99065420560748
2401,Ki Sung-yueng,KOR,MF,Swansea City,Premier League,28,1989,20.8,25,18,10,13,2,4,16,25.0,12,16,1,15,32,57,23,0,0,2017-2018,90.0,138.46153846153845,108.17307692307692
2402,Gilles Sunu,TOG,"MF,FW",Angers,Ligue 1,26,1991,7.3,4,4,1,3,0,0,4,0.0,4,7,0,7,3,7,3,0,0,2017-2018,90.0,36.986301369863014,49.31506849315069
2403,Andrew Surman,ENG,MF,Bournemouth,Premier League,30,1986,20.6,16,12,5,8,3,6,23,26.1,17,33,12,21,16,32,52,2,0,2017-2018,90.0,69.90291262135922,69.90291262135922
2404,Markel Susaeta,ESP,"FW,MF",Athletic Club,La Liga,29,1987,25.2,42,29,16,15,11,16,65,24.6,49,17,0,17,18,60,13,0,0,2017-2018,90.0,64.28571428571429,150.00000000000003
2405,Suso,ESP,"FW,MF",Milan,Serie A,23,1993,31.4,18,14,3,5,10,4,31,12.9,27,25,0,25,16,34,2,1,0,2017-2018,90.0,45.85987261146497,51.592356687898096
2406,Markus Suttner,AUT,DF,Brighton,Premier League,30,1987,13.1,25,15,18,4,3,10,22,45.5,12,16,2,14,12,37,49,1,0,2017-2018,90.0,82.44274809160305,171.7557251908397
2407,Seydou Sy,SEN,GK,Monaco,Ligue 1,21,1995,2.8,0,0,0,0,0,0,0,0.0,0,0,0,0,0,0,2,0,0,2017-2018,90.0,0.0,0.0
2408,Issiaga Sylla,GUI,"DF,FW",Toulouse,Ligue 1,23,1994,17.8,44,32,22,16,6,19,47,40.4,28,31,4,27,34,78,65,1,0,2017-2018,90.0,171.91011235955057,222.47191011235955
2409,Moussa Sylla,MLI,FW,Monaco,Ligue 1,17,1999,3.4,0,0,0,0,0,0,2,0.0,2,2,0,2,0,0,1,0,0,2017-2018,90.0,0.0,0.0
2410,Ádám Szalai,HUN,FW,Hoffenheim,Bundesliga,29,1987,10.0,8,7,1,4,3,2,5,40.0,3,9,2,7,0,8,10,0,0,2017-2018,90.0,0.0,72.0
2411,Wojciech Szczęsny,POL,GK,Juventus,Serie A,27,1990,17.0,0,0,0,0,0,0,0,0.0,0,0,0,0,0,0,4,0,0,2017-2018,90.0,0.0,0.0
2412,Alexander Søderlund,NOR,FW,Saint-Étienne,Ligue 1,29,1987,4.0,1,1,1,0,0,0,2,0.0,2,1,0,1,2,3,2,0,0,2017-2018,90.0,45.0,22.5
2413,Frederik Sørensen,DEN,DF,Köln,Bundesliga,25,1992,22.2,56,45,40,14,2,30,41,73.2,11,35,17,18,37,93,130,3,0,2017-2018,90.0,150.0,227.02702702702706
2414,Lasse Sørensen,DEN,MF,Stoke City,Premier League,17,1999,0.8,2,2,2,0,0,1,5,20.0,4,2,0,2,0,2,3,0,0,2017-2018,90.0,0.0,225.0
2415,Alexander Sørloth,NOR,FW,Crystal Palace,Premier League,21,1995,4.0,6,3,1,4,1,4,12,33.3,8,5,0,5,2,8,5,0,0,2017-2018,90.0,45.0,135.0
2416,Adel Taarabt,MAR,"FW,MF",Genoa,Serie A,28,1989,17.9,18,11,5,11,2,7,16,43.8,9,13,3,10,12,30,7,0,0,2017-2018,90.0,60.33519553072627,90.5027932960894
2417,Franck Tabanou,FRA,DF,Guingamp,Ligue 1,28,1989,11.6,23,17,17,5,1,10,26,38.5,16,5,3,2,26,49,48,0,0,2017-2018,90.0,201.72413793103448,178.44827586206898
2418,Dušan Tadić,SRB,"MF,FW",Southampton,Premier League,28,1988,31.0,46,29,16,22,8,11,35,31.4,24,38,2,36,19,65,29,1,0,2017-2018,90.0,55.16129032258065,133.5483870967742
2419,Jonathan Tah,GER,DF,Leverkusen,Bundesliga,21,1996,27.0,47,34,35,12,0,30,38,78.9,8,22,13,9,34,81,112,2,0,2017-2018,90.0,113.33333333333334,156.66666666666669
2420,Ervin Taha,FRA,FW,Bordeaux,Ligue 1,18,1999,0.4,1,1,0,1,0,0,1,0.0,1,0,0,0,0,1,0,0,0,2017-2018,90.0,0.0,225.0
2421,Mehdi Tahrat,ALG,MF,Angers,Ligue 1,27,1990,4.9,7,6,4,3,0,2,5,40.0,3,3,1,2,9,16,15,1,0,2017-2018,90.0,165.30612244897958,128.57142857142856
2422,Saphir Taïder,ALG,MF,Bologna,Serie A,25,1992,4.3,6,2,4,2,0,1,2,50.0,1,3,2,1,1,7,4,0,0,2017-2018,90.0,20.930232558139537,125.58139534883722
2423,Flavien Tait,FRA,MF,Angers,Ligue 1,24,1993,24.8,50,36,26,18,6,18,78,23.1,60,43,4,39,20,70,17,1,0,2017-2018,90.0,72.58064516129032,181.4516129032258
2424,Adrien Tameze,CMR,MF,Nice,Ligue 1,23,1994,18.7,58,36,32,21,5,26,47,55.3,21,26,5,21,41,99,22,1,0,2017-2018,90.0,197.32620320855614,279.14438502673795
2425,Tana,ESP,"MF,FW",Las Palmas,La Liga,26,1990,17.2,31,24,13,14,4,12,36,33.3,24,8,0,8,23,54,5,0,0,2017-2018,90.0,120.34883720930233,162.2093023255814
2426,Oussama Tannane,MAR,FW,Las Palmas,La Liga,23,1994,6.4,15,13,6,8,1,7,12,58.3,5,5,0,5,5,20,0,0,0,2017-2018,90.0,70.3125,210.9375
2427,Oussama Tannane,MAR,FW,Saint-Étienne,Ligue 1,23,1994,2.3,12,6,4,5,3,2,5,40.0,3,2,0,2,3,15,2,0,0,2017-2018,90.0,117.3913043478261,469.5652173913044
2428,Matt Targett,ENG,DF,Southampton,Premier League,21,1995,1.8,6,3,5,0,1,1,3,33.3,2,3,2,1,3,9,7,1,0,2017-2018,90.0,150.0,300.0
2429,James Tarkowski,ENG,DF,Burnley,Premier League,24,1992,31.0,46,26,36,10,0,17,38,44.7,21,55,43,12,50,96,223,2,0,2017-2018,90.0,145.16129032258064,133.5483870967742
2430,Ciprian Tătărușanu,ROU,GK,Nantes,Ligue 1,31,1986,37.0,1,0,1,0,0,1,2,50.0,1,0,0,0,1,2,12,3,0,2017-2018,90.0,2.4324324324324325,2.4324324324324325
2431,Júlio Tavares,CPV,FW,Dijon,Ligue 1,28,1988,22.8,3,1,1,1,1,1,11,9.1,10,11,6,5,3,6,36,0,0,2017-2018,90.0,11.842105263157894,11.842105263157894
2432,Taleb Tawatha,ISR,"DF,MF",Eint Frankfurt,Bundesliga,25,1992,4.9,12,7,7,5,0,5,9,55.6,4,7,1,6,6,18,18,0,0,2017-2018,90.0,110.20408163265306,220.40816326530611
2433,Charlie Taylor,ENG,DF,Burnley,Premier League,23,1993,10.6,16,4,9,6,1,7,12,58.3,5,13,5,8,15,31,52,0,0,2017-2018,90.0,127.35849056603774,135.8490566037736
2434,Jordan Tell,GLP,"FW,MF",Rennes,Ligue 1,20,1997,1.3,4,4,1,3,0,0,1,0.0,1,0,0,0,1,5,0,0,0,2017-2018,90.0,69.23076923076923,276.9230769230769
2435,Cristian Tello,ESP,"FW,MF",Betis,La Liga,25,1991,18.8,32,24,12,14,6,7,37,18.9,30,19,0,19,16,48,4,1,0,2017-2018,90.0,76.59574468085106,153.1914893617021
2436,Marc-André ter Stegen,GER,GK,Barcelona,La Liga,25,1992,37.0,1,0,1,0,0,1,3,33.3,2,1,0,1,4,5,12,1,0,2017-2018,90.0,9.72972972972973,2.4324324324324325
2437,Simon Terodde,GER,FW,Stuttgart,Bundesliga,29,1988,10.6,9,6,1,7,1,2,5,40.0,3,8,2,6,5,14,8,0,0,2017-2018,90.0,42.45283018867925,76.41509433962264
2438,Simon Terodde,GER,FW,Köln,Bundesliga,29,1988,12.9,11,9,3,8,0,4,11,36.4,7,3,0,3,4,15,7,0,0,2017-2018,90.0,27.906976744186046,76.74418604651163
2439,Marco Terrazzino,GER,"MF,FW",Freiburg,Bundesliga,26,1991,16.5,31,24,12,13,6,21,39,53.8,18,16,0,16,9,40,19,0,0,2017-2018,90.0,49.09090909090909,169.0909090909091
2440,Martin Terrier,FRA,"FW,MF",Strasbourg,Ligue 1,20,1997,18.6,42,30,16,23,3,9,28,32.1,19,11,1,10,14,56,6,0,0,2017-2018,90.0,67.74193548387096,203.22580645161287
2441,Kenny Tete,NED,DF,Lyon,Ligue 1,21,1995,17.9,37,25,24,10,3,15,26,57.7,11,20,7,13,29,66,52,0,0,2017-2018,90.0,145.8100558659218,186.03351955307264
2442,Cedric Teuchert,GER,FW,Schalke 04,Bundesliga,20,1997,0.4,0,0,0,0,0,0,0,0.0,0,1,0,1,0,0,0,0,0,2017-2018,90.0,0.0,0.0
2443,Florian Thauvin,FRA,FW,Marseille,Ligue 1,24,1993,32.8,44,28,16,20,8,15,46,32.6,31,22,1,21,17,61,20,0,0,2017-2018,90.0,46.646341463414636,120.73170731707319
2444,Kévin Théophile-Catherine,FRA,DF,Saint-Étienne,Ligue 1,27,1989,24.1,36,27,23,13,0,11,24,45.8,13,19,15,4,31,67,113,1,0,2017-2018,90.0,115.76763485477179,134.43983402489627
2445,Cyril Théréau,FRA,"FW,MF",Udinese,Serie A,34,1983,2.0,1,1,1,0,0,1,2,50.0,1,0,0,0,0,1,2,0,0,2017-2018,90.0,0.0,45.0
2446,Cyril Théréau,FRA,"FW,MF",Fiorentina,Serie A,34,1983,12.4,11,6,3,6,2,7,19,36.8,12,13,0,13,8,19,9,0,0,2017-2018,90.0,58.064516129032256,79.83870967741936
2447,Vincent Thill,LUX,MF,Metz,Ligue 1,17,2000,0.3,0,0,0,0,0,0,0,0.0,0,0,0,0,0,0,0,0,0,2017-2018,90.0,0.0,0.0
2448,Romain Thomas,FRA,DF,Angers,Ligue 1,29,1988,27.4,31,21,16,15,0,14,29,48.3,15,32,19,13,34,65,151,1,0,2017-2018,90.0,111.67883211678833,101.82481751824818
2449,Adrien Thomasson,FRA,"MF,FW",Nantes,Ligue 1,23,1993,28.6,71,52,41,23,7,22,73,30.1,51,58,4,54,18,89,20,0,0,2017-2018,90.0,56.64335664335665,223.42657342657344
2450,Erik Thommy,GER,FW,Augsburg,Bundesliga,22,1994,1.9,6,5,1,3,2,3,8,37.5,5,2,0,2,5,11,0,0,0,2017-2018,90.0,236.8421052631579,284.2105263157895
2451,Erik Thommy,GER,MF,Stuttgart,Bundesliga,22,1994,10.9,19,11,7,7,5,9,17,52.9,8,17,2,15,9,28,8,1,0,2017-2018,90.0,74.31192660550458,156.88073394495413
2452,Marcus Thuram,FRA,FW,Guingamp,Ligue 1,19,1997,21.4,20,15,6,10,4,6,25,24.0,19,14,0,14,5,25,12,0,0,2017-2018,90.0,21.028037383177573,84.11214953271029
2453,Youri Tielemans,BEL,MF,Monaco,Ligue 1,20,1997,17.4,47,24,14,28,5,17,55,30.9,38,24,5,19,34,81,20,1,0,2017-2018,90.0,175.86206896551724,243.10344827586206
2454,David Timor,ESP,"MF,DF",Girona,La Liga,27,1989,10.3,17,10,7,7,3,7,18,38.9,11,10,5,5,20,37,30,1,0,2017-2018,90.0,174.75728155339806,148.54368932038835
2455,Jonathan Tinhan,BEN,"MF,FW",Troyes,Ligue 1,28,1989,0.8,1,0,0,1,0,0,1,0.0,1,1,0,1,1,2,0,0,0,2017-2018,90.0,112.5,112.5
2456,Marcel Tisserand,COD,DF,Wolfsburg,Bundesliga,24,1993,13.9,15,10,10,4,1,7,14,50.0,7,18,13,5,31,46,50,0,0,2017-2018,90.0,200.71942446043167,97.12230215827338
2457,Tito,ESP,DF,Leganés,La Liga,32,1985,6.8,8,5,5,3,0,6,18,33.3,12,12,5,7,12,20,16,0,0,2017-2018,90.0,158.8235294117647,105.88235294117646
2458,Ola Toivonen,SWE,"FW,MF",Toulouse,Ligue 1,31,1986,8.9,4,4,1,0,3,0,7,0.0,7,2,0,2,2,6,12,0,0,2017-2018,90.0,20.224719101123597,40.449438202247194
2459,Karl Toko Ekambi,CMR,"FW,MF",Angers,Ligue 1,24,1992,33.8,17,8,2,5,10,5,29,17.2,24,13,0,13,15,32,2,0,0,2017-2018,90.0,39.94082840236687,45.26627218934912
2460,Hernán Toledo,ARG,"FW,MF",Las Palmas,La Liga,21,1996,6.9,5,5,2,2,1,1,11,9.1,10,2,0,2,5,10,5,0,0,2017-2018,90.0,65.21739130434781,65.21739130434781
2461,Corentin Tolisso,FRA,MF,Bayern Munich,Bundesliga,22,1994,17.5,33,22,8,18,7,14,32,43.8,18,13,3,10,16,49,8,0,0,2017-2018,90.0,82.28571428571428,169.71428571428572
2462,Jeremy Toljan,GER,"DF,FW",Hoffenheim,Bundesliga,22,1994,2.0,3,1,1,2,0,2,3,66.7,1,3,0,3,0,3,3,0,0,2017-2018,90.0,0.0,135.0
2463,Jeremy Toljan,GER,DF,Dortmund,Bundesliga,22,1994,13.5,29,20,17,11,1,19,32,59.4,13,17,2,15,12,41,45,0,0,2017-2018,90.0,80.0,193.33333333333334
2464,Rafael Tolói,ITA,DF,Atalanta,Serie A,26,1990,27.2,72,40,34,38,0,35,68,51.5,33,35,14,21,63,135,119,1,0,2017-2018,90.0,208.4558823529412,238.23529411764704
2465,James Tomkins,ENG,DF,Crystal Palace,Premier League,28,1989,26.5,47,26,36,10,1,16,31,51.6,15,24,12,12,63,110,216,1,0,2017-2018,90.0,213.96226415094338,159.62264150943395
2466,Nenad Tomović,SRB,DF,Fiorentina,Serie A,29,1987,1.5,2,1,1,1,0,0,2,0.0,2,0,0,0,3,5,5,1,0,2017-2018,90.0,180.0,120.0
2467,Nenad Tomović,SRB,DF,Chievo,Serie A,29,1987,25.6,23,17,17,6,0,10,17,58.8,7,29,21,8,50,73,146,0,0,2017-2018,90.0,175.78125,80.859375
2468,Lorenzo Tonelli,ITA,DF,Napoli,Serie A,27,1990,3.9,7,1,4,3,0,5,9,55.6,4,2,1,1,7,14,10,0,0,2017-2018,90.0,161.53846153846152,161.53846153846152
2469,Aleksandar Tonev,BUL,"FW,MF",Crotone,Serie A,27,1990,4.5,5,3,1,2,2,0,1,0.0,1,4,1,3,1,6,6,0,0,2017-2018,90.0,20.0,100.0
2470,Toño,ESP,DF,Levante,La Liga,27,1989,12.0,12,11,11,1,0,5,10,50.0,5,4,0,4,6,18,29,0,0,2017-2018,90.0,45.0,90.0
2471,Ömer Toprak,TUR,DF,Dortmund,Bundesliga,28,1989,22.4,36,25,29,6,1,26,29,89.7,3,27,16,11,21,57,104,1,0,2017-2018,90.0,84.375,144.64285714285714
2472,Vasilis Torosidis,GRE,DF,Bologna,Serie A,32,1985,9.1,8,7,5,2,1,4,9,44.4,5,8,3,5,15,23,42,0,0,2017-2018,90.0,148.35164835164835,79.12087912087912
2473,Emanuele Torrasi,ITA,MF,Milan,Serie A,18,1999,0.1,0,0,0,0,0,,0,0.0,0,0,0,0,0,0,0,0,0,2017-2018,90.0,0.0,0.0
2474,Emanuele Torrasi,ITA,MF,Milan,Serie A,18,1999,0.1,0,0,0,0,0,0,0,0.0,0,0,0,0,0,0,0,0,0,2017-2018,90.0,0.0,0.0
2475,Lucas Torreira,URU,MF,Sampdoria,Serie A,21,1996,35.3,101,73,36,57,8,30,77,39.0,47,52,17,35,72,173,36,1,0,2017-2018,90.0,183.56940509915015,257.50708215297453
2476,Daniel Torres,COL,MF,Alavés,La Liga,27,1989,13.5,19,11,14,5,0,7,31,22.6,24,15,7,8,19,38,32,2,0,2017-2018,90.0,126.66666666666667,126.66666666666667
2477,Fernando Torres,ESP,FW,Atlético Madrid,La Liga,33,1984,10.9,11,8,3,7,1,2,6,33.3,4,4,1,3,2,13,9,0,0,2017-2018,90.0,16.513761467889907,90.82568807339449
2478,Ferrán Torres,ESP,MF,Valencia,La Liga,17,2000,3.5,8,7,3,5,0,2,6,33.3,4,1,0,1,3,11,1,0,0,2017-2018,90.0,77.14285714285714,205.71428571428572
2479,Miguel Torres,ESP,DF,Málaga,La Liga,31,1986,7.5,16,13,13,3,0,6,14,42.9,8,9,7,2,13,29,35,0,0,2017-2018,90.0,156.0,192.0
2480,Pau Torres,ESP,DF,Villarreal,La Liga,20,1997,0.6,0,0,0,0,0,0,1,0.0,1,1,1,0,0,0,4,0,0,2017-2018,90.0,0.0,0.0
2481,Jordan Torunarigha,GER,DF,Hertha BSC,Bundesliga,19,1997,7.4,18,12,16,2,0,7,13,53.8,6,20,13,7,23,41,43,1,0,2017-2018,90.0,279.72972972972974,218.9189189189189
2482,Alin Toșca,ROU,DF,Benevento,Serie A,25,1992,13.0,11,8,7,4,0,6,12,50.0,6,9,4,5,13,24,69,0,0,2017-2018,90.00000000000001,90.00000000000001,76.15384615384616
2483,Alin Toșca,ROU,DF,Betis,La Liga,25,1992,4.7,12,9,7,5,0,5,9,55.6,4,7,1,6,5,17,17,1,0,2017-2018,90.0,95.74468085106382,229.78723404255317
2484,Cenk Tosun,TUR,FW,Everton,Premier League,26,1991,11.0,6,3,2,2,2,1,11,9.1,10,9,4,5,1,7,13,0,0,2017-2018,90.0,8.181818181818182,49.09090909090909
2485,Jérémy Toulalan,FRA,DF,Bordeaux,Ligue 1,33,1983,21.0,43,25,35,7,1,17,39,43.6,22,25,16,9,28,71,121,0,0,2017-2018,90.0,120.0,184.28571428571428
2486,Abdoulaye Touré,GUI,MF,Nantes,Ligue 1,23,1994,31.2,74,52,28,38,8,23,67,34.3,44,40,10,30,62,136,49,1,0,2017-2018,90.0,178.84615384615384,213.46153846153845
2487,Almamy Touré,MLI,DF,Monaco,Ligue 1,21,1996,13.9,51,29,31,13,7,18,30,60.0,12,15,2,13,22,73,61,0,0,2017-2018,90.0,142.44604316546764,330.2158273381295
2488,Thomas Touré,CIV,FW,Bordeaux,Ligue 1,23,1993,0.1,0,0,0,0,0,0,0,0.0,0,0,0,0,1,1,0,0,0,2017-2018,90.0,900.0,0.0
2489,Thomas Touré,CIV,MF,Angers,Ligue 1,23,1993,1.4,2,1,0,1,1,0,7,0.0,7,5,0,5,1,3,0,0,0,2017-2018,90.0,64.28571428571429,128.57142857142858
2490,Yaya Touré,CIV,MF,Manchester City,Premier League,34,1983,2.6,2,2,1,0,1,1,1,100.0,0,3,1,2,5,7,4,0,0,2017-2018,90.0,173.07692307692307,69.23076923076923
2491,Lucas Tousart,FRA,MF,Lyon,Ligue 1,20,1997,34.8,98,59,41,55,2,38,98,38.8,60,41,16,25,52,150,79,0,0,2017-2018,90.0,134.48275862068965,253.44827586206898
2492,Andros Townsend,ENG,"FW,MF",Crystal Palace,Premier League,26,1991,34.7,60,34,35,12,13,24,75,32.0,51,49,1,48,35,95,28,0,0,2017-2018,90.0,90.77809798270893,155.61959654178673
2493,Adama Traoré,MLI,"MF,FW",Monaco,Ligue 1,22,1995,2.1,6,4,0,4,2,1,4,25.0,3,3,0,3,3,9,1,0,0,2017-2018,90.0,128.57142857142856,257.1428571428571
2494,Bertrand Traoré,BFA,FW,Lyon,Ligue 1,21,1995,25.4,32,20,7,20,5,10,35,28.6,25,24,3,21,39,71,31,1,0,2017-2018,90.0,138.18897637795277,113.38582677165356
2495,Charles Traore,MLI,DF,Troyes,Ligue 1,25,1992,33.3,60,32,46,9,5,26,56,46.4,30,52,16,36,57,117,171,0,0,2017-2018,90.0,154.05405405405406,162.16216216216216
2496,Hamari Traoré,MLI,DF,Rennes,Ligue 1,25,1992,29.3,79,55,43,31,5,41,66,62.1,25,31,12,19,61,140,117,0,0,2017-2018,90.0,187.37201365187715,242.66211604095565
2497,Ibrahima Traoré,GUI,MF,Gladbach,Bundesliga,29,1988,2.2,4,2,2,2,0,4,7,57.1,3,2,0,2,0,4,1,0,0,2017-2018,90.0,0.0,163.63636363636363
2498,Ismaël Traoré,CIV,DF,Angers,Ligue 1,30,1986,31.7,54,32,40,13,1,14,29,48.3,15,25,10,15,52,106,132,2,0,2017-2018,90.0,147.63406940063092,153.3123028391167
2499,Lacina Traoré,CIV,FW,Amiens,Ligue 1,27,1990,8.7,9,9,2,3,4,3,7,42.9,4,6,3,3,2,11,21,0,0,2017-2018,90.0,20.689655172413794,93.10344827586206
2500,Kevin Trapp,GER,GK,Paris S-G,Ligue 1,27,1990,4.0,0,0,0,0,0,0,0,0.0,0,0,0,0,0,0,1,0,0,2017-2018,90.0,0.0,0.0
2501,Manu Trigueros,ESP,MF,Villarreal,La Liga,25,1991,30.0,61,41,23,34,4,21,71,29.6,50,38,13,25,22,83,44,0,0,2017-2018,90.0,66.0,183.0
2502,Kieran Trippier,ENG,DF,Tottenham,Premier League,26,1990,21.3,52,30,29,21,2,21,44,47.7,23,31,6,25,20,72,53,1,0,2017-2018,90.0,84.50704225352112,219.71830985915494
2503,Marcello Trotta,ITA,FW,Crotone,Serie A,24,1992,25.1,39,21,12,18,9,10,55,18.2,45,22,2,20,14,53,20,0,0,2017-2018,90.0,50.199203187250994,139.84063745019918
2504,Philipp Tschauner,GER,GK,Hannover 96,Bundesliga,31,1985,31.0,1,0,1,0,0,1,2,50.0,1,2,0,2,0,1,8,5,0,2017-2018,90.0,0.0,2.903225806451613
2505,Axel Tuanzebe,COD,FW,Manchester Utd,Premier League,19,1997,0.0,0,0,0,0,0,0,0,0.0,0,0,0,0,0,0,0,0,0,2017-2018,,,
2506,Marco Tumminello,ITA,FW,Crotone,Serie A,18,1998,2.3,2,2,0,1,1,0,2,0.0,2,2,0,2,0,2,0,0,0,2017-2018,90.0,0.0,78.26086956521739
2507,Marco Tumminello,ITA,FW,Roma,Serie A,18,1998,0.0,0,0,0,0,0,0,0,0.0,0,0,0,0,0,0,0,0,0,2017-2018,,,
2508,Ľubomír Tupta,SVK,"MF,FW",Hellas Verona,Serie A,19,1998,0.4,0,0,0,0,0,0,3,0.0,3,0,0,0,0,0,0,0,0,2017-2018,90.0,0.0,0.0
2509,Josh Tymon,ENG,DF,Stoke City,Premier League,18,1999,1.8,5,1,4,1,0,2,3,66.7,1,1,0,1,1,6,3,0,0,2017-2018,90.0,50.0,250.0
2510,Przemysław Tytoń,POL,GK,La Coruña,La Liga,30,1987,1.1,0,0,0,0,0,0,0,0.0,0,0,0,0,0,0,0,0,0,2017-2018,90.0,0.0,0.0
2511,Matthieu Udol,FRA,DF,Metz,Ligue 1,21,1996,3.9,14,8,13,1,0,5,14,35.7,9,10,2,8,5,19,17,0,0,2017-2018,90.0,115.38461538461539,323.07692307692304
2512,Anthony Ujah,NGA,FW,Mainz 05,Bundesliga,26,1990,2.3,4,3,0,2,2,1,1,100.0,0,2,0,2,0,4,6,0,0,2017-2018,90.0,0.0,156.52173913043478
2513,Leonardo Ulloa,ARG,FW,Leicester City,Premier League,31,1986,0.2,1,0,0,0,1,0,0,0.0,0,0,0,0,0,1,1,0,0,2017-2018,90.0,0.0,450.0
2514,Leonardo Ulloa,ARG,FW,Brighton,Premier League,31,1986,3.0,3,1,0,1,2,1,7,14.3,6,1,0,1,0,3,3,0,0,2017-2018,90.0,0.0,90.0
2515,Sven Ulreich,GER,GK,Bayern Munich,Bundesliga,28,1988,29.0,1,0,1,0,0,1,1,100.0,0,0,0,0,3,4,6,1,0,2017-2018,90.0,9.310344827586206,3.103448275862069
2516,Samuel Umtiti,FRA,DF,Barcelona,La Liga,23,1993,24.3,50,35,35,15,0,20,29,69.0,9,25,17,8,37,87,72,3,0,2017-2018,90.0,137.03703703703704,185.18518518518516
2517,Enes Ünal,TUR,FW,Villarreal,La Liga,20,1997,12.5,9,5,0,4,5,0,12,0.0,12,16,3,13,4,13,11,0,0,2017-2018,90.0,28.799999999999997,64.8
2518,Enes Ünal,TUR,FW,Levante,La Liga,20,1997,6.6,6,6,2,2,2,1,10,10.0,9,7,1,6,2,8,5,0,0,2017-2018,90.0,27.272727272727273,81.81818181818181
2519,Cengiz Ünder,TUR,FW,Roma,Serie A,20,1997,13.9,10,6,4,6,0,3,18,16.7,15,8,1,7,9,19,10,0,0,2017-2018,90.0,58.27338129496403,64.74820143884892
2520,Dayot Upamecano,FRA,DF,RB Leipzig,Bundesliga,18,1998,25.2,57,43,36,17,4,31,45,68.9,14,32,9,23,55,112,141,1,0,2017-2018,90.0,196.42857142857144,203.57142857142858
2521,Mark Uth,GER,FW,Hoffenheim,Bundesliga,25,1991,24.2,32,23,4,21,7,5,22,22.7,17,30,3,27,9,41,19,0,0,2017-2018,90.0,33.47107438016529,119.00826446280992
2522,Francis Uzoho,NGA,GK,La Coruña,La Liga,18,1998,2.0,0,0,0,0,0,0,0,0.0,0,0,0,0,0,0,1,0,0,2017-2018,90.0,0.0,0.0
2523,Valentín Vada,ARG,MF,Bordeaux,Ligue 1,21,1996,9.6,22,11,7,14,1,8,32,25.0,24,8,1,7,6,28,5,1,0,2017-2018,90.0,56.25000000000001,206.25
2524,Josha Vagnoman,GER,MF,Hamburger SV,Bundesliga,16,2000,0.2,1,1,0,1,0,1,1,100.0,0,0,0,0,0,1,0,0,0,2017-2018,90.0,0.0,450.0
2525,Sauli Väisänen,FIN,DF,SPAL,Serie A,23,1994,6.0,12,9,9,3,0,6,8,75.0,2,5,4,1,13,25,26,0,0,2017-2018,90.0,195.0,180.0
2526,Mirko Valdifiori,ITA,MF,Torino,Serie A,31,1986,6.9,13,9,5,7,1,2,11,18.2,9,3,1,2,6,19,9,0,0,2017-2018,90.0,78.26086956521738,169.56521739130434
2527,Antonio Valencia,ECU,DF,Manchester Utd,Premier League,31,1985,30.4,57,32,21,28,8,16,36,44.4,20,47,6,41,48,105,80,0,0,2017-2018,90.0,142.10526315789474,168.75
2528,Gerard Valentín,ESP,"DF,FW",La Coruña,La Liga,24,1993,1.8,5,4,4,0,1,1,2,50.0,1,1,0,1,3,8,3,0,0,2017-2018,90.0,150.0,250.0
2529,Borja Valero,ESP,MF,Inter,Serie A,32,1985,28.5,46,31,17,25,4,20,58,34.5,38,15,4,11,18,64,41,1,0,2017-2018,90.0,56.8421052631579,145.26315789473685
2530,Borja Valle,ESP,"FW,MF",La Coruña,La Liga,25,1992,5.4,6,6,3,3,0,1,4,25.0,3,2,0,2,3,9,4,0,0,2017-2018,90.0,49.99999999999999,99.99999999999999
2531,Jesús Vallejo,ESP,DF,Real Madrid,La Liga,20,1997,7.0,8,7,6,2,0,2,5,40.0,3,6,5,1,16,24,21,1,0,2017-2018,90.0,205.71428571428572,102.85714285714286
2532,Mattia Valoti,ITA,"MF,FW",Hellas Verona,Serie A,23,1993,17.5,62,41,21,35,6,11,53,20.8,42,25,3,22,41,103,37,1,0,2017-2018,90.0,210.85714285714286,318.85714285714283
2533,Federico Valverde,URU,"MF,FW",La Coruña,La Liga,19,1998,13.7,25,16,12,10,3,8,15,53.3,7,12,1,11,21,46,17,0,0,2017-2018,90.0,137.95620437956205,164.23357664233578
2534,Virgil van Dijk,NED,DF,Southampton,Premier League,26,1991,11.0,10,7,6,2,2,2,3,66.7,1,14,13,1,29,39,81,1,0,2017-2018,90.0,237.27272727272728,81.81818181818183
2535,Virgil van Dijk,NED,DF,Liverpool,Premier League,26,1991,14.0,15,8,7,7,1,4,5,80.0,1,8,2,6,18,33,80,1,0,2017-2018,90.0,115.71428571428571,96.42857142857143
2536,Raphaël Varane,FRA,DF,Real Madrid,La Liga,24,1993,25.8,28,19,20,7,1,8,15,53.3,7,27,10,17,33,61,109,2,0,2017-2018,90.0,115.11627906976743,97.67441860465115
2537,Jamie Vardy,ENG,FW,Leicester City,Premier League,30,1987,36.1,15,9,3,7,5,1,8,12.5,7,21,1,20,2,17,17,0,0,2017-2018,90.0,4.986149584487534,37.396121883656505
2538,Cédric Varrault,FRA,DF,Dijon,Ligue 1,37,1980,9.8,13,7,6,7,0,9,12,75.0,3,14,11,3,16,29,72,0,0,2017-2018,90.0,146.93877551020407,119.38775510204081
2539,Franco Vázquez,ARG,MF,Sevilla,La Liga,28,1989,20.4,39,32,16,15,8,6,34,17.6,28,20,2,18,11,50,11,0,0,2017-2018,90.0,48.529411764705884,172.05882352941177
2540,Lucas Vázquez,ESP,"MF,FW",Real Madrid,La Liga,26,1991,18.7,48,33,16,21,11,12,42,28.6,30,28,2,26,7,55,9,0,0,2017-2018,90.0,33.68983957219251,231.01604278074865
2541,Matías Vecino,URU,MF,Inter,Serie A,25,1991,23.7,54,34,15,30,9,19,49,38.8,30,28,6,22,20,74,31,0,0,2017-2018,90.0,75.9493670886076,205.06329113924053
2542,Koke Vegas,ESP,GK,Levante,La Liga,21,1995,1.0,0,0,0,0,0,0,0,0.0,0,0,0,0,0,0,1,0,0,2017-2018,90.0,0.0,0.0
2543,Carlos Vela,MEX,FW,Real Sociedad,La Liga,28,1989,4.2,12,7,5,3,4,6,7,85.7,1,2,0,2,0,12,1,0,0,2017-2018,90.0,0.0,257.1428571428571
2544,Miloš Veljković,SRB,DF,Werder Bremen,Bundesliga,21,1995,29.5,45,32,30,13,2,30,52,57.7,22,34,12,22,34,79,134,1,0,2017-2018,90.0,103.72881355932203,137.28813559322035
2545,Miguel Veloso,POR,MF,Genoa,Serie A,31,1986,19.3,40,29,18,19,3,11,41,26.8,30,26,3,23,13,53,35,0,0,2017-2018,90.0,60.62176165803108,186.5284974093264
2546,Lorenzo Venuti,ITA,DF,Benevento,Serie A,22,1995,26.6,44,34,26,12,6,16,37,43.2,21,40,16,24,40,84,105,3,0,2017-2018,90.0,135.33834586466165,148.8721804511278
2547,Rémy Vercoutre,FRA,GK,Caen,Ligue 1,37,1980,34.5,2,2,2,0,0,2,2,100.0,0,0,0,0,2,4,14,2,0,2017-2018,90.0,5.217391304347826,5.217391304347826
2548,Daniele Verde,ITA,"FW,MF",Hellas Verona,Serie A,21,1996,21.7,10,9,8,1,1,6,20,30.0,14,8,0,8,30,40,19,0,0,2017-2018,90.0,124.42396313364056,41.474654377880185
2549,Simone Verdi,ITA,"FW,MF",Bologna,Serie A,25,1992,31.4,33,24,17,13,3,11,43,25.6,32,20,1,19,36,69,12,0,0,2017-2018,90.0,103.18471337579619,94.5859872611465
2550,Olivier Verdon,BEN,DF,Bordeaux,Ligue 1,21,1995,0.1,0,0,0,0,0,0,0,0.0,0,0,0,0,0,0,3,0,0,2017-2018,90.0,0.0,0.0
2551,Jordan Veretout,FRA,MF,Fiorentina,Serie A,24,1993,35.7,65,45,34,23,8,20,69,29.0,49,39,4,35,37,102,59,0,0,2017-2018,90.0,93.27731092436973,163.86554621848737
2552,Paul Verhaegh,NED,DF,Wolfsburg,Bundesliga,33,1983,29.0,45,38,21,22,2,24,33,72.7,9,38,10,28,33,78,60,0,0,2017-2018,90.0,102.41379310344827,139.65517241379308
2553,Thomas Vermaelen,BEL,DF,Barcelona,La Liga,31,1985,11.3,13,9,7,5,1,5,11,45.5,6,10,3,7,18,31,28,0,0,2017-2018,90.0,143.36283185840708,103.53982300884955
2554,Marco Verratti,ITA,MF,Paris S-G,Ligue 1,24,1992,19.1,51,33,20,25,6,12,55,21.8,43,25,6,19,26,77,11,3,0,2017-2018,90.0,122.5130890052356,240.31413612565444
2555,Valerio Verre,ITA,MF,Sampdoria,Serie A,23,1994,4.0,7,3,3,2,2,2,7,28.6,5,12,0,12,8,15,7,0,0,2017-2018,90.0,180.0,157.5
2556,Jan Vertonghen,BEL,DF,Tottenham,Premier League,30,1987,35.6,64,41,40,20,4,25,36,69.4,11,29,11,18,60,124,177,0,0,2017-2018,90.0,151.68539325842696,161.79775280898878
2557,Mikel Vesga,ESP,MF,Athletic Club,La Liga,24,1993,9.0,17,8,6,11,0,4,25,16.0,21,14,3,11,8,25,15,0,0,2017-2018,90.0,80.0,170.0
2558,Jannik Vestergaard,DEN,DF,Gladbach,Bundesliga,24,1992,32.0,58,41,43,15,0,32,48,66.7,16,55,39,16,40,98,161,3,0,2017-2018,90.0,112.5,163.125
2559,Rúben Vezo,POR,DF,Valencia,La Liga,23,1994,17.3,43,24,30,12,1,16,32,50.0,16,25,9,16,23,66,83,0,0,2017-2018,90.0,119.65317919075143,223.6994219653179
2560,Francesco Vicari,ITA,DF,SPAL,Serie A,22,1994,31.7,38,22,25,13,0,21,39,53.8,18,33,27,6,45,83,210,1,0,2017-2018,90.0,127.7602523659306,107.88643533123029
2561,Aleix Vidal,ESP,"MF,FW",Barcelona,La Liga,27,1989,5.1,6,4,2,3,1,1,10,10.0,9,4,0,4,9,15,1,0,0,2017-2018,90.0,158.82352941176472,105.88235294117648
2562,Arturo Vidal,CHI,MF,Bayern Munich,Bundesliga,30,1987,16.2,69,51,36,28,5,33,69,47.8,36,22,1,21,28,97,20,1,0,2017-2018,90.0,155.55555555555557,383.33333333333337
2563,Nacho Vidal,ESP,DF,Valencia,La Liga,22,1995,5.0,17,14,15,1,1,14,22,63.6,8,5,2,3,10,27,18,0,0,2017-2018,90.0,180.0,306.0
2564,Luca Vido,ITA,"FW,MF",Atalanta,Serie A,20,1997,0.8,5,5,2,3,0,1,1,100.0,0,1,0,1,0,5,0,0,0,2017-2018,90.0,0.0,562.5
2565,Jonathan Viera,ESP,MF,Las Palmas,La Liga,27,1989,22.1,36,25,10,22,4,3,28,10.7,25,21,0,21,11,47,2,0,0,2017-2018,90.0,44.796380090497735,146.60633484162895
2566,Luciano Vietto,ARG,FW,Atlético Madrid,La Liga,23,1993,3.0,5,4,1,2,2,0,3,0.0,3,3,0,3,3,8,3,0,0,2017-2018,90.0,90.0,150.0
2567,Luciano Vietto,ARG,FW,Valencia,La Liga,23,1993,5.9,8,6,2,3,3,1,4,25.0,3,3,0,3,2,10,5,0,0,2017-2018,90.0,30.508474576271183,122.03389830508473
2568,Carlos Vigaray,ESP,DF,Alavés,La Liga,22,1994,9.9,27,16,16,9,2,11,16,68.8,5,5,1,4,14,41,13,0,0,2017-2018,90.0,127.27272727272727,245.45454545454547
2569,Dídac Vilà,ESP,"DF,MF",Espanyol,La Liga,28,1989,8.1,29,26,15,9,5,13,18,72.2,5,14,3,11,14,43,27,0,0,2017-2018,90.0,155.55555555555557,322.22222222222223
2570,Julio Villalba,PAR,DF,Gladbach,Bundesliga,18,1998,0.1,0,0,0,0,0,0,0,0.0,0,0,0,0,0,0,0,0,0,2017-2018,90.0,0.0,0.0
2571,Nicolas Viola,ITA,MF,Benevento,Serie A,27,1989,20.6,37,27,20,14,3,15,39,38.5,24,29,8,21,24,61,23,2,0,2017-2018,90.0,104.85436893203884,161.6504854368932
2572,Mattia Vitale,ITA,"MF,FW",SPAL,Serie A,19,1997,1.1,2,1,2,0,0,0,0,0.0,0,1,0,1,3,5,1,0,0,2017-2018,90.0,245.45454545454544,163.63636363636363
2573,Vitolo,ESP,"FW,MF",Las Palmas,La Liga,27,1989,7.7,15,12,9,5,1,4,17,23.5,13,10,3,7,6,21,9,0,0,2017-2018,90.0,70.12987012987013,175.32467532467533
2574,Vitolo,ESP,"MF,FW",Atlético Madrid,La Liga,27,1989,6.9,9,6,4,3,2,3,15,20.0,12,10,1,9,6,15,5,0,0,2017-2018,90.0,78.26086956521738,117.39130434782608
2575,Federico Viviani,ITA,MF,SPAL,Serie A,25,1992,27.6,52,36,23,26,3,18,55,32.7,37,39,9,30,58,110,26,2,0,2017-2018,90.0,189.1304347826087,169.56521739130434
2576,Emiliano Viviano,ITA,GK,Sampdoria,Serie A,31,1985,27.0,0,0,0,0,0,0,0,0.0,0,0,0,0,2,2,10,4,0,2017-2018,90.0,6.666666666666667,0.0
2577,Oswaldo Vizcarrondo,VEN,DF,Troyes,Ligue 1,33,1984,19.1,21,15,17,3,1,14,37,37.8,23,18,16,2,20,41,129,2,0,2017-2018,90.0,94.24083769633508,98.95287958115183
2578,Nikola Vlašić,CRO,"MF,FW",Everton,Premier League,19,1997,6.4,9,5,3,6,0,2,9,22.2,7,14,2,12,9,18,10,0,0,2017-2018,90.0,126.5625,126.5625
2579,Kevin Vogt,GER,DF,Hoffenheim,Bundesliga,25,1991,31.0,38,28,30,7,1,23,34,67.6,11,37,23,14,25,63,114,2,0,2017-2018,90.0,72.58064516129032,110.3225806451613
2580,Sam Vokes,WAL,FW,Burnley,Premier League,27,1989,11.1,3,1,1,2,0,0,3,0.0,3,6,2,4,3,6,15,0,0,2017-2018,90.0,24.324324324324326,24.324324324324326
2581,Kevin Volland,GER,"FW,MF",Leverkusen,Bundesliga,25,1992,28.8,23,20,7,8,8,11,26,42.3,15,16,1,15,3,26,35,0,0,2017-2018,90.0,9.375,71.875
2582,Giovanni Volpicelli,ITA,MF,Benevento,Serie A,17,1999,0.0,0,0,0,0,0,0,1,0.0,1,0,0,0,0,0,0,0,0,2017-2018,,,
2583,Michel Vorm,NED,GK,Tottenham,Premier League,33,1983,1.0,0,0,0,0,0,0,0,0.0,0,0,0,0,0,0,1,0,0,2017-2018,90.0,0.0,0.0
2584,Stefan de Vrij,NED,DF,Lazio,Serie A,25,1992,33.7,31,22,14,17,0,14,23,60.9,9,43,24,19,71,102,156,1,0,2017-2018,90.0,189.6142433234421,82.78931750741839
2585,Šime Vrsaljko,CRO,DF,Atlético Madrid,La Liga,25,1992,18.8,48,30,25,17,6,26,40,65.0,14,24,8,16,36,84,63,0,0,2017-2018,90.0,172.3404255319149,229.78723404255317
2586,Jagoš Vuković,SRB,DF,Hellas Verona,Serie A,29,1988,14.8,5,4,3,1,1,3,6,50.0,3,19,14,5,20,25,113,0,0,2017-2018,90.0,121.62162162162161,30.405405405405403
2587,Sandro Wagner,GER,FW,Hoffenheim,Bundesliga,29,1987,9.7,8,5,3,5,0,5,6,83.3,1,11,3,8,3,11,13,0,0,2017-2018,90.0,27.835051546391757,74.22680412371135
2588,Sandro Wagner,GER,FW,Bayern Munich,Bundesliga,29,1987,8.1,9,6,3,5,1,1,1,100.0,0,4,0,4,2,11,1,0,0,2017-2018,90.0,22.22222222222222,100.0
2589,Molla Wagué,MLI,DF,Watford,Premier League,26,1991,4.9,5,3,3,2,0,2,5,40.0,3,1,0,1,9,14,30,0,0,2017-2018,90.0,165.30612244897958,91.83673469387755
2590,Molla Wagué,MLI,DF,Udinese,Serie A,26,1991,0.6,1,0,0,1,0,0,0,0.0,0,0,0,0,2,3,5,0,0,2017-2018,90.0,300.0,150.0
2591,Wakaso,GHA,MF,Alavés,La Liga,27,1990,12.2,43,30,25,15,3,13,39,33.3,26,22,1,21,35,78,21,0,0,2017-2018,90.0,258.1967213114754,317.2131147540984
2592,Walace,BRA,MF,Hamburger SV,Bundesliga,22,1995,14.6,38,25,13,23,2,19,44,43.2,25,25,3,22,21,59,14,1,0,2017-2018,90.0,129.45205479452056,234.24657534246577
2593,Theo Walcott,ENG,"FW,MF",Arsenal,Premier League,28,1989,0.8,1,0,1,0,0,0,0,0.0,0,0,0,0,1,2,0,0,0,2017-2018,90.0,112.5,112.5
2594,Theo Walcott,ENG,FW,Everton,Premier League,28,1989,12.8,27,19,12,13,2,7,15,46.7,8,9,0,9,8,35,12,0,0,2017-2018,90.0,56.25,189.84375
2595,Luca Waldschmidt,GER,"MF,FW",Hamburger SV,Bundesliga,21,1996,8.8,10,6,1,8,1,3,10,30.0,7,11,0,11,3,13,2,0,0,2017-2018,90.0,30.68181818181818,102.27272727272727
2596,Kyle Walker,ENG,DF,Manchester City,Premier League,27,1990,30.9,47,31,20,21,6,18,31,58.1,13,21,2,19,29,76,75,2,0,2017-2018,90.0,84.46601941747574,136.89320388349515
2597,Kyle Walker-Peters,ENG,DF,Tottenham,Premier League,20,1997,2.1,5,4,4,1,0,2,4,50.0,2,2,0,2,3,8,8,0,0,2017-2018,90.0,128.57142857142856,214.28571428571428
2598,Wallace,BRA,DF,Lazio,Serie A,22,1994,11.1,17,7,11,6,0,4,13,30.8,9,13,5,8,29,46,43,3,0,2017-2018,90.0,235.13513513513516,137.83783783783784
2599,Anthony Walongwa,,DF,Nantes,Ligue 1,23,1993,1.0,2,1,2,0,0,0,0,0.0,0,0,0,0,1,3,8,0,0,2017-2018,90.0,90.0,180.0
2600,Rémi Walter,FRA,"MF,FW",Nice,Ligue 1,22,1995,5.5,11,7,4,6,1,3,7,42.9,4,2,1,1,5,16,3,0,0,2017-2018,90.0,81.81818181818183,180.0
2601,Rémi Walter,FRA,MF,Troyes,Ligue 1,22,1995,11.1,23,10,9,13,1,2,23,8.7,21,7,3,4,11,34,14,0,0,2017-2018,90.0,89.1891891891892,186.4864864864865
2602,Jonathan Walters,IRL,FW,Burnley,Premier League,33,1983,0.4,0,0,0,0,0,0,0,0.0,0,0,0,0,0,0,1,0,0,2017-2018,90.0,0.0,0.0
2603,Aaron Wan-Bissaka,ENG,DF,Crystal Palace,Premier League,19,1997,7.0,30,19,20,7,3,15,19,78.9,4,18,7,11,15,45,45,0,0,2017-2018,90.0,192.85714285714286,385.7142857142857
2604,Victor Wanyama,KEN,MF,Tottenham,Premier League,26,1991,9.4,30,20,13,16,1,14,31,45.2,17,13,3,10,10,40,20,1,0,2017-2018,90.0,95.74468085106382,287.23404255319144
2605,Joel Ward,ENG,DF,Crystal Palace,Premier League,27,1989,17.9,35,30,23,12,0,16,28,57.1,12,27,11,16,28,63,76,0,0,2017-2018,90.0,140.78212290502796,175.97765363128494
2606,Stephen Ward,IRL,DF,Burnley,Premier League,31,1985,27.3,39,31,27,8,4,20,42,47.6,22,27,12,15,42,81,126,0,0,2017-2018,90.0,138.46153846153845,128.57142857142856
2607,James Ward-Prowse,ENG,"FW,MF",Southampton,Premier League,22,1994,19.1,23,16,9,11,3,3,27,11.1,24,29,1,28,8,31,31,0,0,2017-2018,90.0,37.69633507853403,108.37696335078533
2608,Daniel Wass,DEN,"MF,DF",Celta Vigo,La Liga,28,1989,32.6,30,21,8,18,4,8,25,32.0,17,23,3,20,30,60,47,0,0,2017-2018,90.0,82.82208588957056,82.82208588957056
2609,Ben Watson,ENG,MF,Watford,Premier League,32,1985,5.1,19,9,9,9,1,10,31,32.3,21,6,1,5,7,26,10,0,0,2017-2018,90.0,123.52941176470588,335.29411764705884
2610,Timothy Weah,USA,FW,Paris S-G,Ligue 1,17,2000,1.4,1,1,1,0,0,1,1,100.0,0,0,0,0,0,1,0,0,0,2017-2018,90.0,0.0,64.28571428571429
2611,Roman Weidenfeller,GER,GK,Dortmund,Bundesliga,36,1980,1.0,0,0,0,0,0,0,0,0.0,0,0,0,0,0,0,0,1,0,2017-2018,90.0,0.0,0.0
2612,Julian Weigl,GER,MF,Dortmund,Bundesliga,21,1995,21.6,69,49,20,42,7,42,66,63.6,24,26,6,20,34,103,29,2,0,2017-2018,90.0,141.66666666666666,287.5
2613,Mitchell Weiser,GER,"DF,FW",Hertha BSC,Bundesliga,23,1994,22.0,54,43,20,27,7,17,38,44.7,21,28,1,27,44,98,37,1,0,2017-2018,90.0,180.0,220.9090909090909
2614,Danny Welbeck,ENG,"FW,MF",Arsenal,Premier League,26,1990,13.3,20,13,9,5,6,4,12,33.3,8,22,1,21,11,31,13,0,0,2017-2018,90.0,74.4360902255639,135.33834586466165
2615,Nahki Wells,BER,"FW,MF",Burnley,Premier League,27,1990,0.6,4,3,0,3,1,1,1,100.0,0,2,0,2,0,4,0,0,0,2017-2018,90.0,0.0,600.0
2616,Wendell,BRA,DF,Leverkusen,Bundesliga,24,1993,23.5,54,41,29,20,5,32,58,55.2,26,44,8,36,28,82,58,0,0,2017-2018,90.0,107.23404255319149,206.80851063829786
2617,Oscar Wendt,SWE,DF,Gladbach,Bundesliga,31,1985,27.3,54,40,31,19,4,30,45,66.7,15,46,12,34,27,81,71,0,0,2017-2018,90.0,89.01098901098901,178.02197802197801
2618,Axel Werner,ARG,GK,Atlético Madrid,La Liga,21,1996,1.0,0,0,0,0,0,0,0,0.0,0,0,0,0,0,0,1,0,0,2017-2018,90.0,0.0,0.0
2619,Timo Werner,GER,FW,RB Leipzig,Bundesliga,21,1996,27.7,16,11,2,8,6,3,19,15.8,16,26,0,26,7,23,11,0,0,2017-2018,90.0,22.743682310469314,51.985559566787
2620,Ashley Westwood,ENG,MF,Burnley,Premier League,27,1990,12.3,13,10,10,3,0,2,16,12.5,14,17,9,8,19,32,16,0,0,2017-2018,89.99999999999999,139.02439024390242,95.12195121951218
2621,Dean Whitehead,ENG,MF,Huddersfield,Premier League,35,1982,0.8,0,0,0,0,0,0,1,0.0,1,1,0,1,2,2,0,0,0,2017-2018,90.0,225.0,0.0
2622,Silvan Widmer,SUI,"DF,FW",Udinese,Serie A,24,1993,18.1,45,32,30,15,0,22,40,55.0,18,22,5,17,28,73,59,0,0,2017-2018,90.0,139.22651933701655,223.75690607734805
2623,Georginio Wijnaldum,NED,MF,Liverpool,Premier League,26,1990,26.5,34,23,13,16,5,11,23,47.8,12,20,2,18,25,59,20,0,0,2017-2018,90.0,84.90566037735849,115.47169811320754
2624,Jetro Willems,NED,"FW,DF",Eint Frankfurt,Bundesliga,23,1994,18.5,55,42,28,23,4,27,42,64.3,15,31,1,30,20,75,53,0,0,2017-2018,90.0,97.2972972972973,267.56756756756755
2625,William,BRA,DF,Wolfsburg,Bundesliga,22,1995,17.9,76,61,43,26,7,46,86,53.5,40,41,6,35,46,122,65,1,0,2017-2018,90.0,231.28491620111734,382.12290502793303
2626,Ashley Williams,WAL,DF,Everton,Premier League,32,1984,20.4,23,13,17,6,0,9,18,50.0,9,31,23,8,36,59,173,3,0,2017-2018,90.0,158.82352941176472,101.47058823529412
2627,Danny Williams,USA,MF,Huddersfield,Premier League,28,1989,12.5,23,14,13,9,1,7,22,31.8,15,12,2,10,26,49,27,0,0,2017-2018,90.0,187.2,165.6
2628,Iñaki Williams,GHA,"FW,MF",Athletic Club,La Liga,23,1994,31.7,28,17,11,15,2,8,41,19.5,33,24,2,22,17,45,13,0,0,2017-2018,90.0,48.26498422712934,79.49526813880126
2629,Willian,BRA,"MF,FW",Chelsea,Premier League,28,1988,21.0,22,17,7,12,3,0,16,0.0,16,13,1,12,10,32,10,0,0,2017-2018,90.0,42.857142857142854,94.28571428571428
2630,Joe Willock,ENG,MF,Arsenal,Premier League,17,1999,0.9,4,2,4,0,0,1,1,100.0,0,3,0,3,1,5,2,0,0,2017-2018,90.0,100.0,400.0
2631,Jack Wilshere,ENG,MF,Arsenal,Premier League,25,1992,13.3,15,10,3,7,5,4,20,20.0,16,10,2,8,8,23,5,0,0,2017-2018,90.0,54.13533834586466,101.50375939849623
2632,Callum Wilson,ENG,FW,Bournemouth,Premier League,25,1992,22.0,9,5,2,6,1,1,14,7.1,13,15,3,12,3,12,15,0,0,2017-2018,90.0,12.272727272727273,36.81818181818182
2633,Kevin Wimmer,AUT,DF,Stoke City,Premier League,24,1992,14.7,24,17,17,7,0,9,20,45.0,11,25,12,13,30,54,88,0,0,2017-2018,90.0,183.67346938775512,146.9387755102041
2634,Harry Winks,ENG,MF,Tottenham,Premier League,21,1996,8.6,15,12,8,5,2,8,16,50.0,8,12,2,10,11,26,10,1,0,2017-2018,90.0,115.11627906976746,156.97674418604652
2635,Marius Wolf,GER,"MF,FW",Eint Frankfurt,Bundesliga,22,1995,26.3,37,28,15,18,4,18,46,39.1,28,45,1,44,27,64,46,0,0,2017-2018,90.0,92.39543726235742,126.61596958174906
2636,Bobby Wood,USA,"FW,MF",Hamburger SV,Bundesliga,24,1992,17.9,13,8,2,4,7,3,9,33.3,6,4,0,4,2,15,13,0,0,2017-2018,90.0,10.05586592178771,65.36312849162012
2637,Chris Wood,NZL,FW,Burnley,Premier League,25,1991,18.0,7,3,2,3,2,3,13,23.1,10,12,4,8,0,7,16,0,0,2017-2018,90.0,0.0,35.0
2638,Ben Woodburn,WAL,FW,Liverpool,Premier League,17,1999,0.1,0,0,0,0,0,0,0,0.0,0,0,0,0,0,0,0,0,0,2017-2018,90.0,0.0,0.0
2639,Xeka,POR,MF,Dijon,Ligue 1,22,1994,15.5,25,14,10,11,4,10,38,26.3,28,13,2,11,16,41,21,0,0,2017-2018,90.0,92.90322580645162,145.16129032258064
2640,Xeka,POR,MF,Lille,Ligue 1,22,1994,0.2,1,0,1,0,0,0,0,0.0,0,1,0,1,1,2,0,0,0,2017-2018,90.0,450.0,450.0
2641,Granit Xhaka,SUI,MF,Arsenal,Premier League,24,1992,36.2,78,57,35,40,3,26,69,37.7,43,30,9,21,37,115,68,4,0,2017-2018,90.0,91.98895027624309,193.92265193370164
2642,Claudio Yacob,ARG,MF,West Brom,Premier League,30,1987,10.0,36,27,23,13,0,13,27,48.1,14,14,6,8,16,52,25,2,0,2017-2018,90.0,144.0,324.0
2643,Steeve Yago,BFA,DF,Toulouse,Ligue 1,24,1992,17.5,49,36,28,17,4,20,37,54.1,17,16,7,9,34,83,64,1,0,2017-2018,90.0,174.85714285714286,252.0
2644,Cédric Yamberé,CTA,DF,Dijon,Ligue 1,26,1990,31.4,58,42,46,12,0,16,34,47.1,18,24,16,8,54,112,138,5,0,2017-2018,90.0,154.77707006369428,166.24203821656053
2645,Jawad El Yamiq,MAR,DF,Genoa,Serie A,25,1992,4.0,8,5,7,1,0,6,8,75.0,2,11,5,6,5,13,22,1,0,2017-2018,90.0,112.5,180.0
2646,Mapou Yanga-Mbiwa,FRA,DF,Lyon,Ligue 1,28,1989,1.4,3,2,3,0,0,1,1,100.0,0,0,0,0,1,4,2,0,0,2017-2018,90.0,64.28571428571429,192.85714285714286
2647,Andriy Yarmolenko,UKR,"FW,MF",Dortmund,Bundesliga,27,1989,11.5,17,12,6,6,5,7,16,43.8,9,4,0,4,7,24,4,0,0,2017-2018,90.0,54.78260869565218,133.04347826086956
2648,DeAndre Yedlin,USA,DF,Newcastle Utd,Premier League,24,1993,31.6,57,33,39,14,4,26,54,48.1,28,37,7,30,44,101,114,0,0,2017-2018,90.0,125.31645569620251,162.3417721518987
2649,Yoel,ESP,GK,Eibar,La Liga,28,1988,1.0,0,0,0,0,0,0,0,0.0,0,0,0,0,0,0,2,0,0,2017-2018,90.0,0.0,0.0
2650,Maya Yoshida,JPN,DF,Southampton,Premier League,28,1988,22.8,27,20,22,5,0,18,25,72.0,7,32,14,18,41,68,133,2,0,2017-2018,90.0,161.8421052631579,106.57894736842104
2651,Ashley Young,ENG,DF,Manchester Utd,Premier League,32,1985,27.1,53,32,30,17,6,18,47,38.3,29,24,5,19,57,110,86,1,0,2017-2018,90.0,189.29889298892988,176.01476014760146
2652,Zaydou Youssouf,FRA,FW,Bordeaux,Ligue 1,18,1999,1.5,3,1,2,1,0,1,2,50.0,1,1,0,1,1,4,1,0,0,2017-2018,90.0,60.0,180.0
2653,Pablo Zabaleta,ARG,"DF,MF",West Ham,Premier League,32,1985,36.5,96,67,54,28,14,48,98,49.0,50,72,13,59,61,157,152,0,0,2017-2018,90.0,150.41095890410958,236.7123287671233
2654,Mattia Zaccagni,ITA,"MF,FW",Hellas Verona,Serie A,22,1995,1.7,7,5,4,0,3,2,3,66.7,1,0,0,0,5,12,0,0,0,2017-2018,90.0,264.70588235294116,370.5882352941176
2655,Dan-Axel Zagadou,FRA,DF,Dortmund,Bundesliga,18,1999,7.3,9,8,5,3,1,6,7,85.7,1,9,0,9,11,20,20,1,0,2017-2018,90.0,135.6164383561644,110.95890410958904
2656,Wilfried Zaha,CIV,"FW,MF",Crystal Palace,Premier League,24,1992,28.3,30,23,9,13,8,4,23,17.4,19,24,0,24,7,37,4,0,0,2017-2018,90.0,22.261484098939928,95.40636042402826
2657,Denis Zakaria,SUI,MF,Gladbach,Bundesliga,20,1996,25.5,74,48,38,32,4,40,61,65.6,21,52,9,43,45,119,40,1,0,2017-2018,90.0,158.8235294117647,261.1764705882353
2658,Joseba Zaldúa,ESP,DF,Leganés,La Liga,25,1992,28.4,68,52,31,31,6,39,62,62.9,23,28,5,23,61,129,85,0,0,2017-2018,90.0,193.3098591549296,215.49295774647888
2659,Andre-Frank Zambo Anguissa,CMR,MF,Marseille,Ligue 1,21,1995,27.1,88,65,23,57,8,32,94,34.0,62,50,7,43,67,155,46,3,0,2017-2018,90.0,222.50922509225092,292.2509225092251
2660,Francesco Zampano,ITA,DF,Udinese,Serie A,23,1993,4.6,9,7,5,3,1,5,10,50.0,5,4,0,4,6,15,7,0,0,2017-2018,90.0,117.3913043478261,176.08695652173915
2661,Niccolò Zanellato,ITA,MF,Crotone,Serie A,19,1998,0.8,3,2,0,3,0,1,2,50.0,1,3,0,3,0,3,0,0,0,2017-2018,90.0,0.0,337.5
2662,Cristián Zapata,COL,DF,Milan,Serie A,30,1986,11.0,25,20,21,4,0,15,16,93.8,1,12,6,6,15,40,50,1,0,2017-2018,90.0,122.72727272727273,204.54545454545456
2663,Duván Zapata,COL,FW,Sampdoria,Serie A,26,1991,23.4,12,7,1,7,4,1,6,16.7,5,13,0,13,5,17,22,1,0,2017-2018,89.99999999999999,19.23076923076923,46.15384615384615
2664,Davide Zappacosta,ITA,"DF,MF",Chelsea,Premier League,25,1992,12.2,26,11,14,9,3,11,25,44.0,14,11,2,9,6,32,26,0,0,2017-2018,90.0,44.26229508196722,191.8032786885246
2665,Davide Zappacosta,ITA,"DF,FW",Torino,Serie A,25,1992,1.1,1,0,1,0,0,0,0,0.0,0,0,0,0,2,3,1,0,0,2017-2018,90.0,163.63636363636363,81.81818181818181
2666,Simone Zaza,ITA,FW,Valencia,La Liga,26,1991,23.1,21,14,4,10,7,1,20,5.0,19,26,1,25,8,29,34,0,0,2017-2018,89.99999999999999,31.168831168831165,81.8181818181818
2667,Marvin Zeegelaar,NED,DF,Watford,Premier League,26,1990,11.0,23,18,15,3,5,11,24,45.8,13,5,1,4,20,43,30,0,0,2017-2018,90.0,163.63636363636365,188.1818181818182
2668,Mehdi Zeffane,ALG,"DF,MF",Rennes,Ligue 1,25,1992,11.0,17,12,10,5,2,9,25,36.0,16,10,2,8,12,29,44,0,0,2017-2018,90.0,98.18181818181819,139.0909090909091
2669,Rafik Zekhnini,NOR,FW,Fiorentina,Serie A,19,1998,0.1,0,0,0,0,0,0,0,0.0,0,0,0,0,0,0,0,0,0,2017-2018,90.0,0.0,0.0
2670,Erwin Zelazny,FRA,GK,Troyes,Ligue 1,25,1991,17.0,1,1,1,0,0,1,2,50.0,1,0,0,0,2,3,10,1,0,2017-2018,90.0,10.588235294117647,5.294117647058823
2671,Robin Zentner,GER,GK,Mainz 05,Bundesliga,22,1994,15.0,0,0,0,0,0,0,1,0.0,1,0,0,0,1,1,10,2,0,2017-2018,90.0,6.0,0.0
2672,Nabil El Zhar,MAR,"FW,MF",Leganés,La Liga,30,1986,22.0,11,6,4,6,1,3,18,16.7,15,14,1,13,18,29,3,0,0,2017-2018,90.0,73.63636363636364,45.0
2673,Enzo Zidane,ESP,MF,Alavés,La Liga,22,1995,0.8,2,2,2,0,0,0,0,0.0,0,0,0,0,0,2,1,0,0,2017-2018,90.0,0.0,225.0
2674,Luca Zidane,FRA,GK,Real Madrid,La Liga,19,1998,1.0,0,0,0,0,0,0,1,0.0,1,0,0,0,0,0,0,0,0,2017-2018,90.0,0.0,0.0
2675,Ron-Robert Zieler,GER,GK,Stuttgart,Bundesliga,28,1989,34.0,1,1,1,0,0,1,1,100.0,0,2,0,2,1,2,14,5,0,2017-2018,90.0,2.6470588235294117,2.6470588235294117
2676,Piotr Zieliński,POL,"MF,FW",Napoli,Serie A,23,1994,18.5,31,19,7,21,3,9,24,37.5,15,32,3,29,13,44,19,1,0,2017-2018,90.0,63.24324324324325,150.8108108108108
2677,Matthias Zimmermann,GER,DF,Stuttgart,Bundesliga,25,1992,0.9,3,1,2,1,0,3,4,75.0,1,0,0,0,1,4,5,1,0,2017-2018,90.0,100.0,300.0
2678,Oleksandr Zinchenko,UKR,DF,Manchester City,Premier League,20,1996,5.9,23,16,11,9,3,7,13,53.8,6,3,0,3,6,29,7,0,0,2017-2018,90.0,91.52542372881355,350.8474576271186
2679,Kévin Zohi,MLI,MF,Strasbourg,Ligue 1,20,1996,0.0,0,0,0,0,0,0,0,0.0,0,0,0,0,0,0,0,0,0,2017-2018,,,
2680,Simon Zoller,GER,"MF,FW",Köln,Bundesliga,26,1991,10.7,11,7,3,6,2,7,10,70.0,3,5,2,3,8,19,9,0,0,2017-2018,90.0,67.28971962616824,92.52336448598132
2681,Kurt Zouma,FRA,DF,Stoke City,Premier League,22,1994,32.1,50,38,35,13,2,21,28,75.0,7,42,23,19,61,111,246,2,0,2017-2018,90.0,171.02803738317755,140.18691588785046
2682,Igor Zubeldia,ESP,MF,Real Sociedad,La Liga,20,1997,17.6,39,29,17,16,6,14,42,33.3,28,20,5,15,32,71,31,0,0,2017-2018,90.0,163.63636363636363,199.43181818181816
2683,Steven Zuber,SUI,"FW,DF",Hoffenheim,Bundesliga,25,1991,15.9,40,30,22,13,5,26,41,63.4,15,18,3,15,17,57,27,0,0,2017-2018,90.0,96.22641509433963,226.41509433962264
2684,Bruno Zuculini,ARG,MF,Hellas Verona,Serie A,24,1993,13.5,68,49,37,28,3,20,48,41.7,28,35,8,27,38,106,31,0,0,2017-2018,90.0,253.33333333333334,453.33333333333337
2685,Franco Zuculini,ARG,"MF,FW",Hellas Verona,Serie A,26,1990,3.7,11,8,5,5,1,5,14,35.7,9,4,0,4,5,16,6,1,0,2017-2018,90.0,121.62162162162161,267.56756756756755
2686,Ervin Zukanović,BIH,DF,Genoa,Serie A,30,1987,31.9,50,41,33,16,1,20,51,39.2,31,32,19,13,48,98,175,0,0,2017-2018,90.0,135.423197492163,141.06583072100312
2687,Robert Žulj,AUT,"MF,FW",Hoffenheim,Bundesliga,25,1992,2.3,3,3,1,2,0,1,1,100.0,0,3,0,3,0,3,2,0,0,2017-2018,90.0,0.0,117.3913043478261
2688,Bongani Zungu,RSA,MF,Amiens,Ligue 1,24,1992,23.2,54,37,21,26,7,24,56,42.9,32,30,5,25,38,92,41,2,0,2017-2018,90.0,147.41379310344828,209.48275862068965
2689,David Zurutuza,ESP,MF,Real Sociedad,La Liga,31,1986,24.9,49,36,22,25,2,20,49,40.8,29,32,10,22,41,90,24,1,0,2017-2018,90.0,148.19277108433735,177.10843373493975
2690,Filip Đuričić,SRB,"MF,FW",Benevento,Serie A,25,1992,10.8,22,14,11,8,3,5,9,55.6,4,7,1,6,9,31,5,0,0,2017-2018,90.0,75.0,183.33333333333331
2691,Filip Đuričić,SRB,MF,Sampdoria,Serie A,25,1992,0.1,0,0,0,0,0,0,1,0.0,1,0,0,0,0,0,0,0,0,2017-2018,90.0,0.0,0.0
2692,Christian Rutjens,,,Benevento,Serie A,0,0,0.0,0,0,0,0,0,,0,0.0,0,0,0,0,0,0,0,0,0,2017-2018,,,
1,Ismael Aaneba,FRA,DF,Strasbourg,Ligue 1,19,1999,2.3,12,6,7,5,0,5,10,50.0,5,5,0,5,8,20,9,0,0,2018-2019,90.0,313.04347826086956,469.5652173913044
2,Patrick van Aanholt,NED,DF,Crystal Palace,Premier League,27,1990,35.5,48,24,35,11,2,24,40,60.0,16,33,9,24,40,88,91,2,0,2018-2019,90.0,101.40845070422536,121.69014084507043
3,Ignazio Abate,ITA,DF,Milan,Serie A,31,1986,14.5,34,19,16,13,5,14,22,63.6,8,19,6,13,18,52,50,0,0,2018-2019,90.0,111.72413793103448,211.03448275862067
4,Yunis Abdelhamid,MAR,DF,Reims,Ligue 1,30,1987,38.0,60,33,48,11,1,30,40,75.0,10,44,24,20,65,125,196,0,0,2018-2019,90.0,153.94736842105263,142.10526315789474
5,Mehdi Abeid,ALG,MF,Dijon,Ligue 1,25,1992,22.5,51,33,27,16,8,15,45,33.3,30,33,7,26,29,80,23,1,0,2018-2019,90.0,116.0,204.0
6,Charles Abi,FRA,"DF,FW",Saint-Étienne,Ligue 1,18,2000,0.4,4,4,2,1,1,2,2,100.0,0,1,0,1,0,4,1,0,0,2018-2019,90.0,0.0,900.0
7,David Abraham,ARG,DF,Eint Frankfurt,Bundesliga,32,1986,15.8,22,14,13,8,1,11,25,44.0,14,23,12,11,24,46,64,0,0,2018-2019,90.0,136.70886075949366,125.31645569620251
8,Amir Abrashi,ALB,MF,Freiburg,Bundesliga,28,1990,8.8,20,11,7,10,3,6,19,31.6,13,11,3,8,14,34,15,0,0,2018-2019,90.0,143.1818181818182,204.54545454545453
9,Francesco Acerbi,ITA,DF,Lazio,Serie A,30,1988,36.8,40,30,22,13,5,12,16,75.0,4,50,32,18,61,101,169,1,0,2018-2019,90.0,149.18478260869566,97.82608695652175
10,Afriyie Acquah,GHA,MF,Empoli,Serie A,26,1992,16.8,27,9,9,12,6,4,11,36.4,7,11,1,10,12,39,16,0,0,2018-2019,90.0,64.28571428571428,144.64285714285714
11,Tyler Adams,USA,MF,RB Leipzig,Bundesliga,19,1999,8.0,29,17,12,16,1,11,26,42.3,15,17,1,16,16,45,8,0,0,2018-2019,90.0,180.0,326.25
12,Antonio Adán,ESP,GK,Atlético Madrid,La Liga,31,1987,1.0,0,0,0,0,0,0,0,0.0,0,0,0,0,0,0,0,0,0,2018-2019,90.0,0.0,0.0
13,Aday,ESP,"DF,MF",Girona,La Liga,30,1987,7.2,9,8,2,5,2,6,7,85.7,1,1,0,1,7,16,17,1,0,2018-2019,90.0,87.5,112.5
14,Khaled Adénon,BEN,DF,Amiens,Ligue 1,33,1985,22.2,31,22,20,11,0,16,28,57.1,12,26,11,15,31,62,101,0,0,2018-2019,90.0,125.67567567567569,125.67567567567569
15,Claud Adjapong,ITA,"MF,FW",Sassuolo,Serie A,20,1998,3.0,4,2,1,3,0,1,2,50.0,1,3,1,2,1,5,4,0,0,2018-2019,90.0,30.0,120.0
16,Yacine Adli,FRA,MF,Bordeaux,Ligue 1,18,2000,2.4,7,2,2,3,2,3,9,33.3,6,3,0,3,2,9,0,0,0,2018-2019,90.0,75.0,262.5
17,Ali Adnan Kadhim,IRQ,DF,Atalanta,Serie A,24,1993,1.8,1,1,1,0,0,1,2,50.0,1,1,1,0,3,4,6,0,0,2018-2019,90.0,150.0,50.0
18,Aritz Aduriz,ESP,FW,Athletic Club,La Liga,37,1981,10.5,4,2,1,1,2,1,7,14.3,6,2,1,1,0,4,4,0,0,2018-2019,90.0,0.0,34.285714285714285
19,Luis Advíncula,PER,DF,Rayo Vallecano,La Liga,28,1990,26.5,52,38,38,12,2,21,31,67.7,10,22,2,20,19,71,60,1,0,2018-2019,90.0,64.52830188679245,176.60377358490567
20,Martin Agirregabiria,ESP,DF,Alavés,La Liga,22,1996,22.6,45,29,32,10,3,28,46,60.9,18,33,11,22,27,72,65,1,0,2018-2019,90.0,107.5221238938053,179.20353982300884
21,Nayef Aguerd,MAR,DF,Dijon,Ligue 1,22,1996,11.7,17,12,8,9,0,8,19,42.1,11,20,11,9,14,31,59,1,0,2018-2019,89.99999999999999,107.6923076923077,130.76923076923077
22,Sergio Agüero,ARG,FW,Manchester City,Premier League,30,1988,27.3,17,9,1,10,6,5,9,55.6,4,15,1,14,9,26,3,0,0,2018-2019,90.0,29.670329670329668,56.043956043956044
23,Ruben Aguilar,FRA,DF,Montpellier,Ligue 1,25,1993,28.1,88,51,40,33,15,39,69,56.5,30,23,3,20,37,125,50,1,0,2018-2019,90.0,118.50533807829181,281.85053380782915
24,Juan Aguilera,ESP,MF,Huesca,La Liga,32,1985,3.8,2,2,0,1,1,1,4,25.0,3,4,2,2,4,6,2,0,0,2018-2019,90.0,94.73684210526315,47.368421052631575
25,Emmanuel Agyemang-Badu,GHA,MF,Udinese,Serie A,27,1990,1.8,4,0,1,2,1,1,1,100.0,0,2,0,2,1,5,2,0,0,2018-2019,90.0,50.0,200.0
Rk,Player,Nation,Pos,Squad,Comp,0,0,90.0,0,0,3,3,3,Tkl,0,0.0,0,0,0,0,0,0,0,0,0,2018-2019,90.0,0.0,0.0
26,Jean-Eudes Aholou,CIV,MF,Monaco,Ligue 1,24,1994,11.9,20,11,6,11,3,8,16,50.0,8,7,0,7,17,37,12,0,0,2018-2019,90.00000000000001,128.57142857142858,151.26050420168067
27,Antonis Aidonis,GER,DF,Stuttgart,Bundesliga,17,2001,0.9,3,1,1,1,1,1,4,25.0,3,1,0,1,2,5,2,0,0,2018-2019,90.0,200.0,300.0
28,Ola Aina,NGA,DF,Torino,Serie A,21,1996,24.0,54,36,32,20,2,23,48,47.9,25,30,3,27,39,93,59,2,0,2018-2019,90.0,146.25,202.5
29,Youssef Aït Bennasser,MAR,MF,Saint-Étienne,Ligue 1,22,1996,10.4,25,13,9,12,4,13,28,46.4,15,15,2,13,19,44,6,2,0,2018-2019,90.0,164.4230769230769,216.34615384615384
30,Youssef Aït Bennasser,MAR,MF,Monaco,Ligue 1,22,1996,11.9,33,16,14,18,1,13,29,44.8,16,15,5,10,15,48,19,0,0,2018-2019,90.00000000000001,113.44537815126051,249.57983193277312
31,Rayan Aït-Nouri,ALG,"DF,MF",Angers,Ligue 1,17,2001,0.6,2,2,1,1,0,0,1,0.0,1,0,0,0,0,2,1,0,0,2018-2019,90.0,0.0,300.0
32,Ludovic Ajorque,FRA,FW,Strasbourg,Ligue 1,24,1994,17.0,17,13,1,10,6,4,9,44.4,5,5,0,5,5,22,9,0,0,2018-2019,90.0,26.47058823529412,90.0
33,Manuel Akanji,SUI,DF,Dortmund,Bundesliga,23,1995,24.5,29,19,14,13,2,14,25,56.0,11,22,13,9,27,56,92,2,0,2018-2019,90.00000000000001,99.18367346938777,106.53061224489797
34,Carlos Akapo,EQG,DF,Huesca,La Liga,25,1993,11.4,28,15,18,8,2,19,33,57.6,14,12,2,10,23,51,36,0,0,2018-2019,90.0,181.57894736842104,221.05263157894734
35,Nathan Aké,NED,DF,Bournemouth,Premier League,23,1995,37.9,66,35,42,21,3,22,35,62.9,13,51,35,16,32,98,241,0,0,2018-2019,90.0,75.98944591029024,156.72823218997362
36,Sergio Akieme,ESP,DF,Rayo Vallecano,La Liga,20,1997,2.0,3,3,3,0,0,2,2,100.0,0,0,0,0,1,4,5,0,0,2018-2019,90.0,45.0,135.0
37,Chadrac Akolo,COD,"MF,FW",Stuttgart,Bundesliga,23,1995,5.8,9,6,2,7,0,1,3,33.3,2,7,0,7,4,13,1,0,0,2018-2019,90.0,62.06896551724138,139.6551724137931
38,Kevin Akpoguma,NGA,DF,Hoffenheim,Bundesliga,23,1995,5.5,23,15,13,10,0,11,21,52.4,10,18,5,13,12,35,20,2,0,2018-2019,90.0,196.36363636363637,376.3636363636364
39,Kevin Akpoguma,NGA,DF,Hannover 96,Bundesliga,23,1995,3.5,10,6,5,5,0,6,7,85.7,1,7,2,5,10,20,7,2,0,2018-2019,90.0,257.1428571428571,257.1428571428571
40,David Alaba,AUT,DF,Bayern Munich,Bundesliga,26,1992,28.1,34,21,13,13,8,17,26,65.4,9,24,3,21,31,65,40,0,0,2018-2019,90.0,99.288256227758,108.8967971530249
41,Sofiane Alakouch,MAR,DF,Nîmes,Ligue 1,20,1998,21.1,81,44,44,31,6,36,63,57.1,27,15,4,11,46,127,57,0,0,2018-2019,90.0,196.2085308056872,345.49763033175356
42,Lucas Alario,ARG,"FW,MF",Leverkusen,Bundesliga,25,1992,14.1,15,8,5,6,4,4,14,28.6,10,9,0,9,1,16,16,0,0,2018-2019,89.99999999999999,6.382978723404255,95.74468085106382
43,Jordi Alba,ESP,DF,Barcelona,La Liga,29,1989,33.2,42,22,20,15,7,20,48,41.7,28,24,6,18,60,102,76,1,0,2018-2019,90.0,162.65060240963854,113.85542168674698
44,Luis Alberto,ESP,"MF,FW",Lazio,Serie A,25,1992,22.1,53,22,15,29,9,21,55,38.2,34,23,3,20,10,63,10,0,0,2018-2019,90.0,40.723981900452486,215.83710407239818
45,Raúl Albiol,ESP,DF,Napoli,Serie A,32,1985,19.0,16,8,12,4,0,8,15,53.3,7,19,16,3,20,36,90,1,0,2018-2019,90.0,94.73684210526316,75.78947368421052
46,Miiko Albornoz,CHI,"DF,MF",Hannover 96,Bundesliga,27,1990,18.4,46,26,31,10,5,21,45,46.7,24,23,3,20,16,62,37,1,0,2018-2019,90.0,78.26086956521739,225.00000000000003
47,Marc Albrighton,ENG,"FW,MF",Leicester City,Premier League,28,1989,18.1,35,22,18,14,3,13,31,41.9,18,26,3,23,23,58,30,0,0,2018-2019,90.0,114.36464088397788,174.0331491712707
48,Paco Alcácer,ESP,FW,Dortmund,Bundesliga,24,1993,13.5,3,1,2,0,1,0,6,0.0,6,5,0,5,6,9,7,0,0,2018-2019,90.0,40.0,20.0
49,Pedro Alcalá,ESP,DF,Girona,La Liga,29,1989,20.8,32,23,23,9,0,15,23,65.2,8,21,18,3,36,68,120,0,0,2018-2019,90.0,155.76923076923075,138.46153846153845
50,Thiago Alcántara,ESP,MF,Bayern Munich,Bundesliga,27,1991,26.8,87,65,31,44,12,25,48,52.1,23,23,4,19,44,131,17,1,0,2018-2019,90.0,147.76119402985074,292.16417910447757
Rk,Player,Nation,Pos,Squad,Comp,0,0,90.0,0,0,3,3,3,Tkl,0,0.0,0,0,0,0,0,0,0,0,0,2018-2019,90.0,0.0,0.0
51,Rubén Alcaraz,ESP,MF,Valladolid,La Liga,27,1991,33.1,96,54,50,40,6,32,89,36.0,57,59,10,49,38,134,52,1,0,2018-2019,90.0,103.32326283987915,261.02719033232626
52,Toby Alderweireld,BEL,DF,Tottenham,Premier League,29,1989,32.5,37,23,25,10,2,12,22,54.5,10,41,22,19,24,61,175,0,0,2018-2019,90.0,66.46153846153847,102.46153846153847
53,Álex Alegría,ESP,"FW,MF",Rayo Vallecano,La Liga,25,1992,1.6,1,1,0,1,0,0,3,0.0,3,1,0,1,0,1,0,0,0,2018-2019,90.0,0.0,56.25
54,Alexis Alegue,FRA,FW,Nantes,Ligue 1,21,1996,0.1,1,0,0,1,0,0,0,0.0,0,0,0,0,0,1,0,0,0,2018-2019,90.0,0.0,900.0
55,Iván Alejo,ESP,MF,Getafe,La Liga,23,1995,1.6,2,0,0,2,0,0,4,0.0,4,2,0,2,0,2,3,0,0,2018-2019,90.0,0.0,112.5
56,Carles Aleñá,ESP,MF,Barcelona,La Liga,20,1998,7.1,7,4,0,6,1,2,8,25.0,6,4,0,4,2,9,0,0,0,2018-2019,90.0,25.35211267605634,88.73239436619718
57,Rúnar Alex Rúnarsson,ISL,GK,Dijon,Ligue 1,23,1995,25.0,2,0,2,0,0,2,6,33.3,4,0,0,0,1,3,7,2,0,2018-2019,90.0,3.5999999999999996,7.199999999999999
58,Alexander,ARG,FW,Leganés,La Liga,29,1988,0.1,1,0,1,0,0,1,1,100.0,0,0,0,0,0,1,0,0,0,2018-2019,90.0,0.0,900.0
59,Trent Alexander-Arnold,ENG,DF,Liverpool,Premier League,19,1998,27.4,61,39,31,22,8,36,68,52.9,32,19,3,16,35,96,68,0,0,2018-2019,90.0,114.96350364963504,200.36496350364965
60,Alfonso,MOZ,MF,Hoffenheim,Bundesliga,18,1999,0.1,1,1,0,1,0,1,2,50.0,1,0,0,0,1,2,0,0,0,2018-2019,90.0,900.0,900.0
61,Rachid Alioui,MAR,FW,Nîmes,Ligue 1,26,1992,13.9,15,5,3,9,3,4,9,44.4,5,8,1,7,10,25,11,0,0,2018-2019,90.0,64.74820143884892,97.12230215827338
62,Alisson,BRA,GK,Liverpool,Premier League,25,1992,38.0,2,1,2,0,0,2,2,100.0,0,0,0,0,1,3,14,6,0,2018-2019,90.0,2.3684210526315788,4.7368421052631575
63,Bobby Allain,FRA,GK,Dijon,Ligue 1,26,1991,13.0,0,0,0,0,0,0,1,0.0,1,1,0,1,0,0,16,1,0,2018-2019,90.00000000000001,0.0,0.0
64,Allan,BRA,MF,Napoli,Serie A,27,1991,29.1,106,70,39,55,12,36,107,33.6,71,55,13,42,36,142,28,0,0,2018-2019,90.0,111.340206185567,327.8350515463917
65,Allan,BRA,MF,Eint Frankfurt,Bundesliga,21,1997,2.0,4,4,2,2,0,0,4,0.0,4,4,2,2,0,4,1,0,0,2018-2019,90.0,0.0,180.0
66,Dele Alli,ENG,MF,Tottenham,Premier League,22,1996,20.3,33,19,6,14,13,5,24,20.8,19,33,5,28,19,52,20,0,0,2018-2019,90.0,84.23645320197043,146.30541871921181
67,Miguel Almirón,PAR,MF,Newcastle Utd,Premier League,24,1994,8.4,20,12,7,10,3,4,10,40.0,6,14,1,13,8,28,5,0,0,2018-2019,90.0,85.71428571428571,214.28571428571428
68,Júnior Alonso,PAR,"DF,MF",Celta Vigo,La Liga,25,1993,6.0,13,9,8,4,1,7,12,58.3,5,8,3,5,5,18,24,1,0,2018-2019,90.0,75.0,195.0
69,Marcos Alonso,ESP,DF,Chelsea,Premier League,27,1990,30.7,73,46,44,22,7,33,58,56.9,25,25,2,23,39,112,101,0,0,2018-2019,90.0,114.33224755700327,214.00651465798046
70,Mickaël Alphonse,GLP,DF,Dijon,Ligue 1,29,1989,6.3,10,5,6,1,3,3,4,75.0,1,3,1,2,9,19,30,0,0,2018-2019,90.0,128.57142857142858,142.85714285714286
71,Sergio Álvarez,ESP,"DF,MF",Eibar,La Liga,26,1992,11.9,34,25,12,20,2,13,23,56.5,10,9,4,5,17,51,43,0,0,2018-2019,90.00000000000001,128.57142857142858,257.14285714285717
72,Sergio Álvarez,ESP,GK,Celta Vigo,La Liga,31,1986,13.0,0,0,0,0,0,0,0,0.0,0,0,0,0,0,0,4,0,0,2018-2019,90.00000000000001,0.0,0.0
73,Yeray Álvarez,ESP,DF,Athletic Club,La Liga,23,1995,29.0,55,30,39,14,2,19,33,57.6,14,35,16,19,63,118,149,1,0,2018-2019,90.0,195.51724137931032,170.68965517241378
74,Bruno Alves,POR,DF,Parma,Serie A,36,1981,32.5,15,8,11,4,0,4,7,57.1,3,36,28,8,29,44,210,0,0,2018-2019,90.0,80.3076923076923,41.53846153846154
75,Dani Alves,BRA,"MF,DF",Paris S-G,Ligue 1,35,1983,18.0,42,22,16,23,3,13,38,34.2,25,18,5,13,8,50,11,0,0,2018-2019,90.0,40.0,210.0
Rk,Player,Nation,Pos,Squad,Comp,0,0,90.0,0,0,3,3,3,Tkl,0,0.0,0,0,0,0,0,0,0,0,0,2018-2019,90.0,0.0,0.0
76,Ibrahim Amadou,FRA,"MF,DF",Sevilla,La Liga,25,1993,8.5,27,20,9,15,3,2,9,22.2,7,7,4,3,11,38,24,0,0,2018-2019,90.0,116.47058823529412,285.88235294117646
77,Romain Amalfitano,FRA,"MF,FW",Dijon,Ligue 1,28,1989,28.0,52,33,20,28,4,25,67,37.3,42,45,13,32,47,99,35,0,0,2018-2019,90.0,151.07142857142856,167.14285714285714
78,Daniel Amartey,GHA,DF,Leicester City,Premier League,23,1994,7.1,18,12,11,6,1,10,15,66.7,5,6,4,2,17,35,28,1,0,2018-2019,90.0,215.49295774647888,228.16901408450707
79,Jordi Amat,IDN,DF,Rayo Vallecano,La Liga,26,1992,30.7,54,31,34,19,1,24,42,57.1,18,31,10,21,43,97,133,1,0,2018-2019,90.0,126.05863192182412,158.30618892508144
80,Amath,SEN,MF,Getafe,La Liga,22,1996,11.1,20,13,7,11,2,6,27,22.2,21,17,0,17,10,30,12,0,0,2018-2019,90.0,81.0810810810811,162.1621621621622
81,Jordan Amavi,FRA,DF,Marseille,Ligue 1,24,1994,24.2,74,50,34,26,14,35,56,62.5,21,24,8,16,46,120,93,4,0,2018-2019,90.0,171.07438016528926,275.2066115702479
82,Kelvin Amian,FRA,DF,Toulouse,Ligue 1,20,1998,32.0,68,45,54,12,2,20,30,66.7,10,36,13,23,36,104,113,1,0,2018-2019,90.0,101.25,191.25
83,Nadiem Amiri,GER,MF,Hoffenheim,Bundesliga,21,1996,8.4,14,9,8,4,2,3,13,23.1,10,11,0,11,7,21,4,0,0,2018-2019,90.0,75.0,150.0
84,Yanis Ammour,FRA,MF,Montpellier,Ligue 1,19,1999,0.0,0,0,0,0,0,0,0,0.0,0,0,0,0,0,0,0,0,0,2018-2019,,,
85,Luke Amos,ENG,MF,Tottenham,Premier League,21,1997,0.0,1,0,0,1,0,0,0,0.0,0,0,0,0,0,1,0,0,0,2018-2019,,,inf
86,Joachim Andersen,DEN,DF,Sampdoria,Serie A,22,1996,32.0,40,27,31,8,1,19,31,61.3,12,30,15,15,35,75,147,1,0,2018-2019,90.0,98.4375,112.5
87,Felipe Anderson,BRA,"MF,FW",West Ham,Premier League,25,1993,33.8,89,49,33,44,12,31,101,30.7,70,71,0,71,41,130,18,1,0,2018-2019,90.0,109.1715976331361,236.98224852071007
88,Florin Andone,ROU,FW,Brighton,Premier League,25,1993,9.8,10,2,3,4,3,1,6,16.7,5,9,1,8,3,13,12,0,0,2018-2019,90.0,27.551020408163264,91.83673469387755
89,Benjamin André,FRA,MF,Rennes,Ligue 1,27,1990,27.7,101,60,39,50,12,33,85,38.8,52,40,6,34,54,155,58,0,0,2018-2019,90.0,175.45126353790616,328.15884476534296
90,Marco Andreolli,ITA,DF,Cagliari,Serie A,32,1986,1.2,1,1,1,0,0,1,1,100.0,0,2,1,1,1,2,5,0,0,2018-2019,90.0,75.0,75.0
91,Marco Andreolli,ITA,DF,Chievo,Serie A,32,1986,7.2,10,6,7,2,1,6,10,60.0,4,4,2,2,6,16,33,0,0,2018-2019,90.0,75.0,125.0
92,Yoann Andreu,FRA,DF,Angers,Ligue 1,29,1989,0.0,1,0,1,0,0,0,1,0.0,1,0,0,0,1,2,0,0,0,2018-2019,,inf,inf
93,José Ángel,ESP,DF,Eibar,La Liga,28,1989,33.6,66,46,36,23,7,31,56,55.4,25,24,5,19,41,107,113,1,0,2018-2019,90.0,109.82142857142857,176.78571428571428
94,Miguel Ángel Moyá,ESP,GK,Real Sociedad,La Liga,34,1984,11.0,1,1,1,0,0,1,2,50.0,1,0,0,0,1,2,9,2,0,2018-2019,90.0,8.181818181818182,8.181818181818182
95,Cristian Ansaldi,ARG,"DF,MF",Torino,Serie A,31,1986,20.1,50,26,19,21,10,15,30,50.0,15,21,4,17,15,65,31,0,0,2018-2019,90.0,67.16417910447761,223.88059701492534
96,Mirco Antenucci,ITA,FW,SPAL,Serie A,33,1984,23.7,11,9,5,1,5,1,10,10.0,9,14,0,14,5,16,5,0,0,2018-2019,90.0,18.9873417721519,41.77215189873418
97,Waldemar Anton,GER,DF,Hannover 96,Bundesliga,22,1996,34.0,49,32,33,14,2,22,50,44.0,28,56,33,23,69,118,169,3,0,2018-2019,90.0,182.64705882352942,129.7058823529412
98,Luca Antonelli,ITA,DF,Empoli,Serie A,31,1987,8.4,13,11,4,5,4,7,17,41.2,10,19,4,15,16,29,25,1,0,2018-2019,90.0,171.42857142857142,139.28571428571428
99,Mauro Antonio Burruchaga,ARG,MF,Chievo,Serie A,20,1998,0.6,2,2,1,1,0,0,2,0.0,2,2,1,1,0,2,3,0,0,2018-2019,90.0,0.0,300.0
100,Michail Antonio,JAM,"MF,FW",West Ham,Premier League,28,1990,23.4,23,14,12,6,5,6,12,50.0,6,38,3,35,18,41,26,1,0,2018-2019,89.99999999999999,69.23076923076923,88.46153846153845
Rk,Player,Nation,Pos,Squad,Comp,0,0,90.0,0,0,3,3,3,Tkl,0,0.0,0,0,0,0,0,0,0,0,0,2018-2019,90.0,0.0,0.0
101,Antoñito,ESP,"DF,MF",Valladolid,La Liga,30,1987,20.7,35,21,16,15,4,18,42,42.9,24,21,8,13,18,53,31,0,0,2018-2019,90.0,78.26086956521739,152.17391304347828
102,Vitorino Antunes,POR,"DF,MF",Getafe,La Liga,31,1987,24.2,41,26,22,17,2,27,45,60.0,18,33,7,26,43,84,75,1,0,2018-2019,90.0,159.9173553719008,152.4793388429752
103,Anuar,MAR,"MF,FW",Valladolid,La Liga,23,1995,12.0,33,19,15,16,2,6,14,42.9,8,14,1,13,11,44,25,1,0,2018-2019,90.0,82.5,247.5
104,Dennis Aogo,GER,MF,Stuttgart,Bundesliga,31,1987,11.4,15,10,6,7,2,6,15,40.0,9,8,1,7,9,24,19,0,0,2018-2019,90.0,71.05263157894736,118.42105263157893
105,Houssem Aouar,ALG,MF,Lyon,Ligue 1,20,1998,34.0,63,38,28,25,10,17,61,27.9,44,33,6,27,32,95,25,3,0,2018-2019,90.0,84.70588235294117,166.76470588235296
106,Emmanuel Apeh,NGA,"FW,MF",Celta Vigo,La Liga,21,1996,0.2,0,0,0,0,0,0,1,0.0,1,0,0,0,0,0,0,0,0,2018-2019,90.0,0.0,0.0
107,Mauro Arambarri,URU,MF,Getafe,La Liga,22,1995,29.7,59,33,18,37,4,23,76,30.3,53,44,9,35,30,89,36,0,0,2018-2019,90.0,90.9090909090909,178.78787878787878
108,Guilherme Arana,BRA,DF,Sevilla,La Liga,21,1997,7.0,11,6,5,5,1,6,7,85.7,1,6,3,3,9,20,8,0,0,2018-2019,90.0,115.71428571428571,141.42857142857142
109,Charles Aránguiz,CHI,MF,Leverkusen,Bundesliga,29,1989,21.0,48,30,21,22,5,21,66,31.8,45,31,2,29,25,73,27,1,0,2018-2019,90.0,107.14285714285714,205.71428571428572
110,Luiz Araújo,BRA,"FW,MF",Lille,Ligue 1,22,1996,8.7,23,17,8,9,6,9,24,37.5,15,6,1,5,3,26,4,0,0,2018-2019,90.0,31.03448275862069,237.93103448275863
111,Néstor Araujo,MEX,DF,Celta Vigo,La Liga,26,1991,29.8,42,22,32,9,1,18,22,81.8,4,32,21,11,35,77,153,1,0,2018-2019,90.0,105.70469798657717,126.84563758389261
112,Anaitz Arbilla,ESP,DF,Eibar,La Liga,31,1987,21.7,31,24,25,5,1,17,27,63.0,10,12,5,7,46,77,92,2,0,2018-2019,90.0,190.78341013824885,128.57142857142858
113,Joaquín Ardaiz,URU,FW,Frosinone,Serie A,19,1999,0.2,0,0,0,0,0,0,0,0.0,0,0,0,0,0,0,0,0,0,2018-2019,90.0,0.0,0.0
114,Alphonse Areola,FRA,GK,Paris S-G,Ligue 1,25,1993,21.0,1,1,1,0,0,1,1,100.0,0,0,0,0,0,1,4,1,0,2018-2019,90.0,0.0,4.285714285714286
115,Santiago Arias,COL,DF,Atlético Madrid,La Liga,26,1992,19.7,48,32,31,16,1,20,31,64.5,11,14,2,12,34,82,43,0,0,2018-2019,90.0,155.32994923857868,219.28934010152284
116,Lorenzo Ariaudo,ITA,DF,Frosinone,Serie A,29,1989,18.7,20,14,15,4,1,6,10,60.0,4,31,20,11,14,34,103,0,0,2018-2019,90.0,67.37967914438502,96.2566844919786
117,Nicolò Armini,ITA,DF,Lazio,Serie A,17,2001,0.4,1,1,0,1,0,1,2,50.0,1,1,0,1,0,1,0,0,0,2018-2019,90.0,0.0,225.0
118,Yoël Armougom,FRA,DF,Caen,Ligue 1,20,1998,20.6,31,21,20,9,2,15,29,51.7,14,9,3,6,21,52,66,0,0,2018-2019,90.0,91.74757281553399,135.4368932038835
119,Stuart Armstrong,SCO,MF,Southampton,Premier League,26,1992,15.9,28,20,14,6,8,8,42,19.0,34,14,0,14,12,40,12,0,0,2018-2019,90.0,67.9245283018868,158.49056603773585
120,José Arnaiz,ESP,"MF,FW",Leganés,La Liga,23,1995,1.3,1,1,1,0,0,0,3,0.0,3,0,0,0,2,3,1,0,0,2018-2019,90.0,138.46153846153845,69.23076923076923
121,Marko Arnautović,AUT,FW,West Ham,Premier League,29,1989,22.1,9,5,4,3,2,1,7,14.3,6,4,2,2,3,12,6,0,0,2018-2019,90.0,12.217194570135746,36.65158371040724
122,Maximilian Arnold,GER,MF,Wolfsburg,Bundesliga,24,1994,31.9,52,30,21,27,4,21,61,34.4,40,31,10,21,35,87,48,1,0,2018-2019,90.0,98.74608150470219,146.70846394984326
123,Kepa Arrizabalaga,ESP,GK,Chelsea,Premier League,23,1994,36.0,1,1,1,0,0,1,2,50.0,1,1,0,1,0,1,4,2,0,2018-2019,90.0,0.0,2.5
124,Harry Arter,IRL,MF,Cardiff City,Premier League,28,1989,22.2,62,37,27,26,9,16,46,34.8,30,33,5,28,21,83,21,2,0,2018-2019,90.0,85.13513513513514,251.35135135135138
125,Kwadwo Asamoah,GHA,DF,Inter,Serie A,29,1988,29.7,44,26,22,14,8,29,51,56.9,22,21,4,17,40,84,46,1,0,2018-2019,90.0,121.2121212121212,133.33333333333331
Rk,Player,Nation,Pos,Squad,Comp,0,0,90.0,0,0,3,3,3,Tkl,0,0.0,0,0,0,0,0,0,0,0,0,2018-2019,90.0,0.0,0.0
126,Takuma Asano,JPN,"MF,FW",Hannover 96,Bundesliga,23,1994,7.8,5,3,1,1,3,1,6,16.7,5,9,0,9,2,7,2,0,0,2018-2019,90.0,23.076923076923077,57.69230769230769
127,Santiago Ascacíbar,ARG,MF,Stuttgart,Bundesliga,21,1997,27.0,78,50,43,29,6,34,74,45.9,40,48,10,38,43,121,34,1,0,2018-2019,90.0,143.33333333333334,260.0
128,Sergio Asenjo,ESP,GK,Villarreal,La Liga,29,1989,32.0,0,0,0,0,0,0,1,0.0,1,0,0,0,3,3,26,2,0,2018-2019,90.0,8.4375,0.0
129,Marco Asensio,ESP,FW,Real Madrid,La Liga,22,1996,19.8,12,8,3,5,4,2,24,8.3,22,16,1,15,14,26,7,0,0,2018-2019,90.0,63.63636363636363,54.54545454545455
130,Iago Aspas,ESP,"FW,MF",Celta Vigo,La Liga,30,1987,25.0,16,11,4,8,4,4,20,20.0,16,14,0,14,16,32,5,0,0,2018-2019,90.0,57.599999999999994,57.599999999999994
131,Simon Asta,GER,DF,Augsburg,Bundesliga,17,2001,1.0,6,3,4,2,0,2,2,100.0,0,2,1,1,3,9,1,0,0,2018-2019,90.0,270.0,540.0
132,Youcef Atal,ALG,"DF,FW",Nice,Ligue 1,22,1996,25.1,68,44,34,25,9,34,67,50.7,33,38,8,30,56,124,42,0,0,2018-2019,90.0,200.79681274900398,243.82470119521912
133,Christian Atsu,GHA,MF,Newcastle Utd,Premier League,26,1992,16.6,24,15,9,11,4,5,16,31.3,11,13,3,10,7,31,16,0,0,2018-2019,90.0,37.951807228915655,130.12048192771084
134,Pierre-Emerick Aubameyang,GAB,FW,Arsenal,Premier League,29,1989,30.3,21,17,6,9,6,8,28,28.6,20,26,0,26,8,29,22,0,0,2018-2019,90.0,23.762376237623762,62.37623762376238
135,Emil Audero,ITA,GK,Sampdoria,Serie A,21,1997,36.0,4,3,4,0,0,3,3,100.0,0,0,0,0,1,5,21,4,0,2018-2019,90.0,2.5,10.0
136,Jean-Kévin Augustin,FRA,FW,RB Leipzig,Bundesliga,21,1997,5.1,2,0,0,0,2,0,1,0.0,1,6,0,6,3,5,0,0,0,2018-2019,90.0,52.94117647058824,35.294117647058826
137,Ludwig Augustinsson,SWE,DF,Werder Bremen,Bundesliga,24,1994,33.6,53,31,25,22,6,23,39,59.0,16,37,11,26,38,91,86,1,0,2018-2019,90.0,101.78571428571428,141.9642857142857
138,Serge Aurier,CIV,DF,Tottenham,Premier League,25,1992,6.3,20,12,12,4,4,8,15,53.3,7,8,2,6,7,27,20,0,0,2018-2019,90.0,100.00000000000001,285.7142857142857
139,Charlie Austin,ENG,FW,Southampton,Premier League,29,1989,10.9,13,7,3,6,4,6,11,54.5,5,12,2,10,2,15,13,0,0,2018-2019,90.0,16.513761467889907,107.3394495412844
140,Ezequiel Ávila,ARG,"FW,MF",Huesca,La Liga,24,1994,22.2,18,10,7,7,4,4,26,15.4,22,21,2,19,13,31,22,0,0,2018-2019,90.0,52.70270270270271,72.97297297297298
141,Jordan Ayew,GHA,FW,Crystal Palace,Premier League,26,1991,13.1,38,23,12,19,7,6,20,30.0,14,16,0,16,7,45,6,0,0,2018-2019,90.0,48.091603053435115,261.0687022900764
142,Kaan Ayhan,TUR,DF,Düsseldorf,Bundesliga,23,1994,27.2,53,29,38,15,0,23,47,48.9,24,34,16,18,59,112,118,3,0,2018-2019,90.0,195.22058823529412,175.36764705882354
143,Floyd Ayité,TOG,"FW,MF",Fulham,Premier League,29,1988,5.3,4,4,2,1,1,2,6,33.3,4,8,1,7,7,11,5,0,0,2018-2019,90.0,118.8679245283019,67.9245283018868
144,César Azpilicueta,ESP,DF,Chelsea,Premier League,28,1989,37.8,105,60,52,40,13,38,67,56.7,29,63,16,47,43,148,91,3,0,2018-2019,90.0,102.38095238095238,250.0
145,Abdoulaye Ba,SEN,DF,Rayo Vallecano,La Liga,27,1991,23.4,46,33,37,8,1,29,39,74.4,10,32,18,14,29,75,165,4,0,2018-2019,89.99999999999999,111.53846153846153,176.9230769230769
146,Florian Baak,GER,MF,Hertha BSC,Bundesliga,19,1999,0.0,0,0,0,0,0,0,0,0.0,0,0,0,0,0,0,0,0,0,2018-2019,,,
147,Ludovic Baal,GUF,DF,Rennes,Ligue 1,32,1986,1.4,4,3,3,1,0,0,0,0.0,0,1,0,1,2,6,1,0,0,2018-2019,90.0,128.57142857142858,257.14285714285717
148,Khouma Babacar,SEN,FW,Sassuolo,Serie A,25,1993,16.5,7,3,2,5,0,2,10,20.0,8,8,2,6,3,10,25,1,0,2018-2019,90.0,16.363636363636363,38.18181818181819
149,Ryan Babel,NED,"FW,MF",Fulham,Premier League,31,1986,13.9,8,4,1,5,2,3,9,33.3,6,12,0,12,6,14,13,1,0,2018-2019,90.0,38.84892086330935,51.79856115107914
150,Carlos Bacca,COL,FW,Villarreal,La Liga,31,1986,14.1,4,2,1,2,1,0,5,0.0,5,4,0,4,8,12,5,0,0,2018-2019,89.99999999999999,51.06382978723404,25.53191489361702
Rk,Player,Nation,Pos,Squad,Comp,0,0,90.0,0,0,3,3,3,Tkl,0,0.0,0,0,0,0,0,0,0,0,0,2018-2019,90.0,0.0,0.0
151,Juninho Bacuna,CUW,"MF,DF",Huddersfield,Premier League,20,1997,15.7,46,29,22,19,5,22,54,40.7,32,21,1,20,24,70,12,1,0,2018-2019,90.0,137.57961783439492,263.69426751592357
152,Leandro Bacuna,CUW,MF,Cardiff City,Premier League,26,1991,6.2,15,10,5,7,3,8,22,36.4,14,5,2,3,15,30,9,0,0,2018-2019,90.0,217.74193548387098,217.74193548387098
153,Milan Badelj,CRO,MF,Lazio,Serie A,29,1989,12.7,33,20,10,19,4,16,37,43.2,21,27,9,18,33,66,20,1,0,2018-2019,90.0,233.85826771653544,233.85826771653544
154,Benoît Badiashile,FRA,DF,Monaco,Ligue 1,17,2001,19.6,25,18,18,7,0,17,25,68.0,8,12,5,7,21,46,79,2,0,2018-2019,90.0,96.42857142857142,114.79591836734693
155,Holger Badstuber,GER,DF,Stuttgart,Bundesliga,29,1989,5.8,12,4,8,4,0,7,8,87.5,1,6,2,4,9,21,21,1,0,2018-2019,90.0,139.6551724137931,186.20689655172413
156,Stéphane Bahoken,CMR,FW,Angers,Ligue 1,26,1992,27.4,15,7,0,10,5,3,21,14.3,18,35,3,32,8,23,5,0,0,2018-2019,90.0,26.277372262773724,49.27007299270073
157,Daniel Baier,GER,MF,Augsburg,Bundesliga,34,1984,31.3,62,39,21,37,4,24,66,36.4,42,27,8,19,60,122,48,2,0,2018-2019,90.0,172.52396166134184,178.27476038338656
158,Leon Bailey,JAM,FW,Leverkusen,Bundesliga,20,1997,21.3,15,11,9,2,4,6,20,30.0,14,20,0,20,14,29,11,0,0,2018-2019,90.0,59.15492957746479,63.38028169014085
159,Eric Bailly,CIV,DF,Manchester Utd,Premier League,24,1994,7.1,15,9,14,1,0,8,10,80.0,2,9,4,5,13,28,39,1,0,2018-2019,90.0,164.7887323943662,190.14084507042256
160,Leighton Baines,ENG,DF,Everton,Premier League,33,1984,4.2,8,6,4,3,1,4,6,66.7,2,2,0,2,2,10,8,0,0,2018-2019,90.0,42.857142857142854,171.42857142857142
161,Marvin Bakalorz,GER,MF,Hannover 96,Bundesliga,28,1989,16.3,18,11,7,9,2,6,36,16.7,30,29,4,25,28,46,47,0,0,2018-2019,90.0,154.60122699386503,99.38650306748467
162,Tiemoué Bakayoko,FRA,MF,Milan,Serie A,23,1994,25.6,69,43,22,40,7,26,62,41.9,36,34,5,29,50,119,42,2,0,2018-2019,90.0,175.78125,242.578125
163,Ridle Baku,GER,MF,Mainz 05,Bundesliga,20,1998,10.4,18,9,6,9,3,2,7,28.6,5,13,1,12,8,26,9,0,0,2018-2019,90.0,69.23076923076923,155.76923076923075
164,Fabián Balbuena,PAR,DF,West Ham,Premier League,26,1991,22.4,40,20,34,6,0,16,42,38.1,26,23,15,8,53,93,175,0,0,2018-2019,90.0,212.94642857142858,160.71428571428572
165,Keita Baldé,SEN,FW,Inter,Serie A,23,1995,9.9,10,6,4,2,4,2,9,22.2,7,8,0,8,3,13,1,0,0,2018-2019,90.0,27.272727272727273,90.9090909090909
166,Gareth Bale,WAL,FW,Real Madrid,La Liga,29,1989,19.8,16,8,5,7,4,6,20,30.0,14,19,3,16,11,27,13,0,0,2018-2019,90.0,50.0,72.72727272727273
167,Mikel Balenziaga,ESP,DF,Athletic Club,La Liga,30,1988,5.8,10,6,7,1,2,5,8,62.5,3,6,2,4,2,12,21,0,0,2018-2019,90.0,31.03448275862069,155.17241379310346
168,Andrija Balić,CRO,"FW,MF",Udinese,Serie A,20,1997,0.3,1,0,0,0,1,0,1,0.0,1,0,0,0,0,1,1,0,0,2018-2019,90.0,0.0,300.0
169,Fodé Ballo-Touré,SEN,DF,Lille,Ligue 1,21,1997,17.7,47,35,26,19,2,21,32,65.6,11,25,7,18,27,74,42,2,0,2018-2019,90.0,137.28813559322035,238.98305084745763
170,Fodé Ballo-Touré,SEN,DF,Monaco,Ligue 1,21,1997,17.7,46,31,26,16,4,20,40,50.0,20,20,2,18,28,74,38,2,0,2018-2019,90.0,142.3728813559322,233.89830508474577
171,Florent Balmont,FRA,MF,Dijon,Ligue 1,38,1980,12.0,29,16,16,10,3,9,36,25.0,27,13,2,11,6,35,8,0,0,2018-2019,90.0,45.0,217.5
172,Leon Balogun,NGA,DF,Brighton,Premier League,30,1988,6.6,12,6,11,1,0,8,9,88.9,1,5,3,2,17,29,32,1,0,2018-2019,90.0,231.8181818181818,163.63636363636363
173,Mario Balotelli,ITA,FW,Nice,Ligue 1,27,1990,8.4,1,0,0,1,0,1,4,25.0,3,9,1,8,1,2,8,0,0,2018-2019,90.0,10.714285714285714,10.714285714285714
174,Mario Balotelli,ITA,FW,Marseille,Ligue 1,27,1990,10.4,5,3,1,3,1,2,7,28.6,5,8,2,6,3,8,6,0,0,2018-2019,90.0,25.96153846153846,43.26923076923077
175,Abdoulaye Bamba,CIV,DF,Angers,Ligue 1,28,1990,28.6,51,29,31,14,6,24,44,54.5,20,20,4,16,37,88,86,0,0,2018-2019,90.0,116.43356643356644,160.48951048951048
Rk,Player,Nation,Pos,Squad,Comp,0,0,90.0,0,0,3,3,3,Tkl,0,0.0,0,0,0,0,0,0,0,0,0,2018-2019,90.0,0.0,0.0
176,Jonathan Bamba,CIV,"FW,MF",Lille,Ligue 1,22,1996,33.4,29,19,7,17,5,13,39,33.3,26,24,1,23,41,70,18,0,0,2018-2019,90.0,110.47904191616766,78.1437125748503
177,Sol Bamba,CIV,DF,Cardiff City,Premier League,33,1985,27.5,74,42,44,30,0,31,55,56.4,24,72,32,40,82,156,181,3,0,2018-2019,89.99999999999999,268.3636363636363,242.18181818181816
178,Yacine Bammou,MAR,"FW,MF",Caen,Ligue 1,26,1991,10.3,14,7,7,4,3,3,8,37.5,5,14,3,11,9,23,17,0,0,2018-2019,90.0,78.64077669902913,122.33009708737863
179,Éver Banega,ARG,MF,Sevilla,La Liga,30,1988,29.6,71,50,32,35,4,20,70,28.6,50,26,5,21,28,99,28,0,0,2018-2019,90.0,85.13513513513513,215.8783783783784
180,Mattia Bani,ITA,DF,Chievo,Serie A,24,1993,29.0,67,40,46,21,0,27,40,67.5,13,51,35,16,57,124,162,2,0,2018-2019,90.0,176.8965517241379,207.9310344827586
181,Léo Baptistão,BRA,"FW,MF",Espanyol,La Liga,25,1992,13.7,22,14,11,5,6,8,27,29.6,19,17,0,17,8,30,14,0,0,2018-2019,90.0,52.55474452554745,144.52554744525548
182,Antonín Barák,CZE,"MF,FW",Udinese,Serie A,23,1994,3.7,9,6,4,5,0,2,11,18.2,9,4,0,4,2,11,2,0,0,2018-2019,90.0,48.648648648648646,218.9189189189189
183,Federico Barba,ITA,DF,Chievo,Serie A,24,1993,27.6,30,14,21,9,0,8,21,38.1,13,29,15,14,65,95,129,0,0,2018-2019,90.0,211.9565217391304,97.82608695652173
184,Danilo Barbosa,BRA,MF,Nice,Ligue 1,22,1996,17.2,29,20,13,13,3,6,17,35.3,11,17,2,15,15,44,25,1,0,2018-2019,90.0,78.48837209302326,151.74418604651163
185,Enis Bardhi,MKD,MF,Levante,La Liga,23,1995,31.5,70,43,30,34,6,28,87,32.2,59,35,3,32,31,101,36,1,0,2018-2019,90.0,88.57142857142858,200.0
186,Francesco Bardi,ITA,GK,Frosinone,Serie A,26,1992,3.0,0,0,0,0,0,0,0,0.0,0,0,0,0,0,0,2,0,0,2018-2019,90.0,0.0,0.0
187,Phil Bardsley,SCO,DF,Burnley,Premier League,33,1985,18.6,32,19,15,14,3,12,21,57.1,9,25,12,13,31,63,68,1,0,2018-2019,90.0,149.99999999999997,154.83870967741933
188,Nicolò Barella,ITA,MF,Cagliari,Serie A,21,1997,34.5,99,65,38,41,20,30,82,36.6,52,61,2,59,38,137,27,0,0,2018-2019,90.0,99.13043478260869,258.2608695652174
189,Philipp Bargfrede,GER,"MF,DF",Werder Bremen,Bundesliga,29,1989,12.0,23,15,9,12,2,10,28,35.7,18,35,11,24,34,57,45,1,0,2018-2019,90.0,255.0,172.5
190,Antonino Barillà,ITA,MF,Parma,Serie A,30,1988,29.1,64,36,40,17,7,19,53,35.8,34,40,13,27,36,100,50,1,0,2018-2019,90.0,111.340206185567,197.9381443298969
191,Ross Barkley,ENG,MF,Chelsea,Premier League,24,1993,13.8,15,10,5,7,3,4,14,28.6,10,8,1,7,9,24,17,2,0,2018-2019,90.0,58.69565217391304,97.82608695652173
192,Aymen Barkok,MAR,MF,Düsseldorf,Bundesliga,20,1998,5.7,13,6,4,9,0,4,19,21.1,15,8,1,7,4,17,3,0,0,2018-2019,90.0,63.1578947368421,205.26315789473682
193,Ashley Barnes,ENG,FW,Burnley,Premier League,28,1989,26.5,28,17,4,17,7,6,29,20.7,23,29,8,21,2,30,25,0,0,2018-2019,90.0,6.792452830188679,95.09433962264151
194,Harvey Barnes,ENG,"MF,FW",Leicester City,Premier League,20,1997,11.2,10,6,5,4,1,4,6,66.7,2,7,1,6,3,13,7,0,0,2018-2019,90.0,24.107142857142858,80.35714285714286
195,Antonio Barragán,ESP,"DF,FW",Betis,La Liga,31,1987,10.4,14,8,9,4,1,2,12,16.7,10,15,4,11,5,19,30,2,0,2018-2019,90.0,43.26923076923077,121.15384615384615
196,Antonio Barreca,ITA,DF,Newcastle Utd,Premier League,23,1995,0.1,0,0,0,0,0,0,0,0.0,0,0,0,0,0,0,0,0,0,2018-2019,90.0,0.0,0.0
197,Antonio Barreca,ITA,DF,Monaco,Ligue 1,23,1995,6.6,11,8,8,3,0,7,11,63.6,4,3,2,1,7,18,18,0,0,2018-2019,90.0,95.45454545454545,150.0
198,Leandro Barreiro Martins,LUX,MF,Mainz 05,Bundesliga,18,2000,1.0,4,4,2,0,2,1,2,50.0,1,0,0,0,2,6,1,0,0,2018-2019,90.0,180.0,360.0
199,Ander Barrenetxea,ESP,"FW,MF",Real Sociedad,La Liga,16,2001,4.4,7,2,2,0,5,2,8,25.0,6,8,0,8,4,11,1,0,0,2018-2019,90.0,81.81818181818181,143.1818181818182
200,Édgar Barreto,PAR,MF,Sampdoria,Serie A,34,1984,8.7,28,19,15,6,7,10,26,38.5,16,11,3,8,17,45,7,0,0,2018-2019,90.0,175.86206896551724,289.6551724137931
Rk,Player,Nation,Pos,Squad,Comp,0,0,90.0,0,0,3,3,3,Tkl,0,0.0,0,0,0,0,0,0,0,0,0,2018-2019,90.0,0.0,0.0
201,Musa Barrow,GAM,FW,Atalanta,Serie A,19,1998,6.7,9,5,5,3,1,4,6,66.7,2,4,0,4,0,9,2,0,0,2018-2019,90.0,0.0,120.89552238805969
202,Fin Bartels,GER,"MF,FW",Werder Bremen,Bundesliga,31,1987,0.3,0,0,0,0,0,0,1,0.0,1,0,0,0,1,1,0,0,0,2018-2019,90.0,300.0,0.0
203,Marc Bartra,ESP,DF,Betis,La Liga,27,1991,32.5,86,55,55,26,5,41,76,53.9,35,46,21,25,60,146,132,2,0,2018-2019,90.0,166.15384615384616,238.15384615384616
204,Andrea Barzagli,ITA,DF,Juventus,Serie A,37,1981,2.9,1,1,0,1,0,1,2,50.0,1,2,2,0,4,5,10,0,0,2018-2019,90.0,124.13793103448276,31.03448275862069
205,Daniele Baselli,ITA,MF,Torino,Serie A,26,1992,26.4,65,45,22,34,9,16,44,36.4,28,30,6,24,34,99,32,0,0,2018-2019,90.0,115.9090909090909,221.5909090909091
206,Toma Bašić,CRO,MF,Bordeaux,Ligue 1,21,1996,14.8,32,16,5,21,6,11,31,35.5,20,13,1,12,9,41,22,1,0,2018-2019,90.0,54.729729729729726,194.59459459459458
207,Thomas Basila,FRA,DF,Nantes,Ligue 1,19,1999,1.0,2,1,1,1,0,0,0,0.0,0,2,1,1,0,2,8,0,0,2018-2019,90.0,0.0,180.0
208,Borja Bastón,ESP,FW,Alavés,La Liga,25,1992,16.0,16,7,4,9,3,2,24,8.3,22,16,5,11,4,20,10,0,0,2018-2019,90.0,22.5,90.0
209,Alessandro Bastoni,ITA,DF,Parma,Serie A,19,1999,18.8,25,12,20,5,0,6,15,40.0,9,26,18,8,22,47,96,0,0,2018-2019,90.0,105.31914893617021,119.68085106382978
210,Bastos,ANG,DF,Lazio,Serie A,27,1991,12.7,22,17,16,4,2,17,27,63.0,10,16,8,8,7,29,49,1,0,2018-2019,90.0,49.60629921259843,155.90551181102364
211,Michy Batshuayi,BEL,FW,Crystal Palace,Premier League,24,1993,8.3,2,1,1,1,0,1,2,50.0,1,8,3,5,3,5,0,0,0,2018-2019,90.0,32.53012048192771,21.686746987951803
212,Michy Batshuayi,BEL,FW,Valencia,La Liga,24,1993,5.9,1,1,0,1,0,0,3,0.0,3,5,2,3,0,1,3,0,0,2018-2019,90.0,0.0,15.254237288135592
213,Robert Bauer,GER,DF,Nürnberg,Bundesliga,23,1995,19.1,48,29,32,13,3,20,39,51.3,19,19,5,14,28,76,80,0,0,2018-2019,90.0,131.9371727748691,226.17801047120417
214,Oliver Baumann,GER,GK,Hoffenheim,Bundesliga,28,1990,33.0,0,0,0,0,0,0,0,0.0,0,0,0,0,2,2,11,5,0,2018-2019,90.0,5.454545454545455,0.0
215,Timo Baumgartl,GER,DF,Stuttgart,Bundesliga,22,1996,18.0,33,23,21,12,0,11,19,57.9,8,31,22,9,26,59,100,0,0,2018-2019,90.0,130.0,165.0
216,Julian Baumgartlinger,AUT,MF,Leverkusen,Bundesliga,30,1988,17.3,52,30,24,20,8,20,45,44.4,25,18,6,12,26,78,21,1,0,2018-2019,90.0,135.2601156069364,270.5202312138728
217,Christoph Baumgartner,AUT,MF,Hoffenheim,Bundesliga,18,1999,0.9,1,0,0,0,1,1,3,33.3,2,2,0,2,0,1,0,0,0,2018-2019,90.0,0.0,100.0
218,Jon Bautista,ESP,FW,Real Sociedad,La Liga,23,1995,6.6,5,3,0,3,2,0,3,0.0,3,8,1,7,5,10,4,0,0,2018-2019,90.0,68.18181818181819,68.18181818181819
219,Paul Baysse,FRA,DF,Bordeaux,Ligue 1,30,1988,0.8,1,0,1,0,0,0,1,0.0,1,1,1,0,1,2,6,0,0,2018-2019,90.0,112.5,112.5
220,Paul Baysse,FRA,DF,Caen,Ligue 1,30,1988,19.9,25,14,20,5,0,13,18,72.2,5,25,20,5,31,56,113,1,0,2018-2019,90.0,140.20100502512565,113.06532663316584
221,Noah Joel Sarenren Bazee,NGA,"FW,MF",Hannover 96,Bundesliga,21,1996,1.7,0,0,0,0,0,0,0,0.0,0,1,0,1,0,0,3,0,0,2018-2019,90.0,0.0,0.0
222,Claudio Beauvue,GLP,"FW,MF",Caen,Ligue 1,30,1988,16.7,18,11,7,9,2,1,14,7.1,13,11,2,9,10,28,21,0,0,2018-2019,90.0,53.89221556886228,97.0059880239521
223,Bebé,CPV,"FW,MF",Rayo Vallecano,La Liga,28,1990,14.5,19,9,10,4,5,9,19,47.4,10,16,1,15,9,28,16,1,0,2018-2019,90.0,55.86206896551724,117.93103448275862
224,Bebé,CPV,MF,Eibar,La Liga,28,1990,0.7,0,0,0,0,0,0,0,0.0,0,1,0,1,1,1,0,0,0,2018-2019,90.0,128.57142857142858,0.0
225,Ihlas Bebou,TOG,"MF,FW",Hannover 96,Bundesliga,24,1994,11.8,15,9,4,10,1,4,9,44.4,5,18,2,16,9,24,9,0,0,2018-2019,90.0,68.64406779661016,114.40677966101694
Rk,Player,Nation,Pos,Squad,Comp,0,0,90.0,0,0,3,3,3,Tkl,0,0.0,0,0,0,0,0,0,0,0,0,2018-2019,90.0,0.0,0.0
226,Uffe Bech,DEN,FW,Hannover 96,Bundesliga,25,1993,0.2,0,0,0,0,0,0,1,0.0,1,0,0,0,0,0,0,0,0,2018-2019,90.0,0.0,0.0
227,Andreas Beck,GER,DF,Stuttgart,Bundesliga,31,1987,19.7,35,19,17,17,1,11,27,40.7,16,32,6,26,22,57,54,0,0,2018-2019,90.0,100.50761421319797,159.89847715736042
228,Jan Bednarek,POL,DF,Southampton,Premier League,22,1996,23.9,41,25,25,16,0,21,37,56.8,16,44,27,17,71,112,171,0,0,2018-2019,90.0,267.3640167364017,154.39330543933056
229,Andrea Beghetto,ITA,DF,Frosinone,Serie A,23,1994,24.7,26,14,13,10,3,15,25,60.0,10,20,4,16,17,43,59,0,0,2018-2019,90.0,61.94331983805668,94.73684210526316
230,Asmir Begović,BIH,GK,Bournemouth,Premier League,31,1987,24.0,0,0,0,0,0,0,3,0.0,3,1,0,1,1,1,15,7,0,2018-2019,90.0,3.75,0.0
231,Valon Behrami,SUI,MF,Udinese,Serie A,33,1985,15.1,65,38,25,34,6,18,44,40.9,26,29,12,17,18,83,26,0,0,2018-2019,90.0,107.28476821192054,387.4172185430464
232,Hanno Behrens,GER,MF,Nürnberg,Bundesliga,28,1990,29.3,46,26,29,17,0,21,47,44.7,26,43,13,30,33,79,49,0,0,2018-2019,90.0,101.36518771331059,141.29692832764505
233,Ishak Belfodil,ALG,"FW,MF",Hoffenheim,Bundesliga,26,1992,20.7,13,10,5,6,2,4,16,25.0,12,6,0,6,3,16,14,0,0,2018-2019,90.0,13.043478260869566,56.52173913043479
234,Stefan Bell,GER,DF,Mainz 05,Bundesliga,26,1991,25.0,31,20,18,13,0,15,34,44.1,19,31,11,20,54,85,122,1,0,2018-2019,90.0,194.39999999999998,111.6
235,Karim Bellarabi,GER,FW,Leverkusen,Bundesliga,28,1990,11.7,13,6,7,4,2,3,19,15.8,16,13,0,13,10,23,8,0,0,2018-2019,89.99999999999999,76.92307692307692,100.0
236,Héctor Bellerín,ESP,DF,Arsenal,Premier League,23,1995,17.0,15,12,8,4,3,6,13,46.2,7,17,5,12,20,35,37,3,0,2018-2019,90.0,105.88235294117648,79.41176470588235
237,Andrea Belotti,ITA,FW,Torino,Serie A,24,1993,36.7,33,22,8,15,10,6,30,20.0,24,36,5,31,15,48,23,0,0,2018-2019,90.0,36.78474114441417,80.92643051771117
238,Fran Beltrán,ESP,MF,Celta Vigo,La Liga,19,1999,16.9,23,17,8,12,3,13,31,41.9,18,19,2,17,19,42,15,1,0,2018-2019,90.0,101.18343195266273,122.48520710059172
239,Hatem Ben Arfa,FRA,"FW,MF",Rennes,Ligue 1,31,1987,22.6,15,7,4,8,3,7,16,43.8,9,9,0,9,4,19,0,0,0,2018-2019,90.0,15.929203539823009,59.73451327433628
240,Wissam Ben Yedder,FRA,FW,Sevilla,La Liga,27,1990,31.2,18,16,3,11,4,2,12,16.7,10,18,0,18,11,29,2,0,0,2018-2019,90.0,31.73076923076923,51.92307692307692
241,Diego Benaglio,SUI,GK,Monaco,Ligue 1,34,1983,22.9,1,0,1,0,0,1,1,100.0,0,0,0,0,0,1,16,0,0,2018-2019,90.0,0.0,3.9301310043668125
242,Marco Benassi,ITA,MF,Fiorentina,Serie A,23,1994,25.4,30,19,8,15,7,14,41,34.1,27,16,3,13,9,39,27,1,0,2018-2019,90.0,31.88976377952756,106.2992125984252
243,Medhi Benatia,MAR,DF,Juventus,Serie A,31,1987,5.0,7,6,6,1,0,3,5,60.0,2,10,5,5,16,23,18,0,0,2018-2019,90.0,288.0,126.0
244,Lars Bender,GER,"MF,DF",Leverkusen,Bundesliga,29,1989,15.1,43,29,20,20,3,18,35,51.4,17,26,4,22,21,64,26,0,0,2018-2019,90.0,125.16556291390728,256.2913907284768
245,Sven Bender,GER,DF,Leverkusen,Bundesliga,29,1989,22.1,40,25,25,15,0,18,30,60.0,12,31,14,17,52,92,98,0,0,2018-2019,90.0,211.76470588235293,162.89592760180994
246,László Bénes,SVK,"MF,FW",Gladbach,Bundesliga,20,1997,0.3,3,1,3,0,0,3,3,100.0,0,1,0,1,0,3,0,0,0,2018-2019,90.0,0.0,900.0000000000001
247,Nicolas Benezet,FRA,"MF,FW",Guingamp,Ligue 1,27,1991,18.5,32,19,14,15,3,5,19,26.3,14,12,0,12,19,51,4,0,0,2018-2019,90.0,92.43243243243244,155.67567567567568
248,Walter Benítez,ARG,GK,Nice,Ligue 1,25,1993,35.0,1,0,1,0,0,1,2,50.0,1,0,0,0,2,3,6,2,0,2018-2019,90.0,5.142857142857142,2.571428571428571
249,Ismaël Bennacer,ALG,MF,Empoli,Serie A,20,1997,32.9,94,57,43,41,10,32,75,42.7,43,38,9,29,57,151,34,0,0,2018-2019,90.0,155.92705167173253,257.14285714285717
250,Joe Bennett,ENG,DF,Cardiff City,Premier League,28,1990,29.3,50,29,34,16,0,22,38,57.9,16,30,8,22,60,110,93,0,0,2018-2019,90.0,184.30034129692834,153.5836177474403
Rk,Player,Nation,Pos,Squad,Comp,0,0,90.0,0,0,3,3,3,Tkl,0,0.0,0,0,0,0,0,0,0,0,0,2018-2019,90.0,0.0,0.0
251,Ryan Bennett,ENG,DF,Wolves,Premier League,28,1990,34.0,58,32,41,16,1,25,41,61.0,16,42,21,21,43,101,131,1,0,2018-2019,90.0,113.82352941176471,153.52941176470588
252,Yassine Benrahou,FRA,"MF,FW",Bordeaux,Ligue 1,19,1999,2.0,9,6,1,7,1,2,5,40.0,3,4,0,4,2,11,1,0,0,2018-2019,90.0,90.0,405.0
253,Ramy Bensebaini,ALG,DF,Rennes,Ligue 1,23,1995,23.9,69,48,42,19,8,40,58,69.0,18,24,10,14,41,110,98,0,0,2018-2019,90.0,154.39330543933056,259.83263598326363
254,Nabil Bentaleb,ALG,MF,Schalke 04,Bundesliga,23,1994,19.9,32,17,8,21,3,4,18,22.2,14,28,8,20,35,67,19,0,0,2018-2019,90.0,158.29145728643218,144.72361809045228
255,Rodrigo Bentancur,URU,MF,Juventus,Serie A,21,1997,22.3,53,34,22,29,2,18,39,46.2,21,20,8,12,43,96,42,1,0,2018-2019,90.0,173.542600896861,213.9013452914798
256,Christian Benteke,BEL,FW,Crystal Palace,Premier League,27,1990,9.0,5,1,0,4,1,1,4,25.0,3,7,2,5,0,5,14,0,0,2018-2019,90.0,0.0,50.0
257,Karim Benzema,FRA,FW,Real Madrid,La Liga,30,1987,32.8,24,11,2,11,11,2,17,11.8,15,16,1,15,8,32,25,0,0,2018-2019,90.0,21.951219512195124,65.85365853658537
258,Yassine Benzia,ALG,MF,Lille,Ligue 1,23,1994,1.8,1,1,0,1,0,1,1,100.0,0,0,0,0,1,2,1,0,0,2018-2019,90.0,50.0,50.0
259,Domenico Berardi,ITA,"FW,MF",Sassuolo,Serie A,23,1994,31.9,38,21,16,9,13,15,73,20.5,58,31,2,29,27,65,24,0,0,2018-2019,90.0,76.17554858934169,107.21003134796238
260,Yuri Berchiche,ESP,"DF,FW",Athletic Club,La Liga,28,1990,34.7,46,31,26,11,9,23,46,50.0,23,34,9,25,42,88,82,0,0,2018-2019,90.0,108.93371757925071,119.30835734870315
261,Álex Berenguer,ESP,"MF,DF",Torino,Serie A,23,1995,16.5,31,20,12,17,2,14,34,41.2,20,20,1,19,8,39,14,0,0,2018-2019,90.0,43.63636363636364,169.0909090909091
262,Bartosz Bereszyński,POL,DF,Sampdoria,Serie A,26,1992,24.4,46,30,27,15,4,24,51,47.1,27,22,7,15,31,77,76,0,0,2018-2019,90.0,114.34426229508198,169.672131147541
263,Jóhann Berg Guðmundsson,ISL,MF,Burnley,Premier League,27,1990,19.5,27,11,14,10,3,16,34,47.1,18,25,4,21,33,60,34,0,0,2018-2019,90.0,152.3076923076923,124.61538461538461
264,Markel Bergara,ESP,MF,Getafe,La Liga,32,1986,0.6,2,2,0,1,1,2,3,66.7,1,3,0,3,1,3,2,0,0,2018-2019,90.0,150.0,300.0
265,Robert Berić,SVN,FW,Saint-Étienne,Ligue 1,27,1991,13.1,12,5,1,9,2,1,11,9.1,10,8,2,6,4,16,3,0,0,2018-2019,90.0,27.480916030534353,82.44274809160305
266,Etrit Berisha,ALB,GK,Atalanta,Serie A,29,1989,18.0,0,0,0,0,0,0,2,0.0,2,0,0,0,0,0,5,3,0,2018-2019,90.0,0.0,0.0
267,Valon Berisha,KVX,"MF,FW",Lazio,Serie A,25,1993,2.2,8,5,1,6,1,4,6,66.7,2,6,0,6,4,12,3,0,0,2018-2019,90.0,163.63636363636363,327.27272727272725
268,Bernard,BRA,"FW,MF",Everton,Premier League,25,1992,23.5,49,30,19,22,8,15,55,27.3,40,37,2,35,27,76,14,1,0,2018-2019,90.0,103.40425531914893,187.65957446808508
269,Federico Bernardeschi,ITA,"MF,FW",Juventus,Serie A,24,1994,16.4,14,8,5,6,3,7,18,38.9,11,9,0,9,6,20,10,0,0,2018-2019,90.0,32.926829268292686,76.82926829268294
270,Bernardo,BRA,DF,Brighton,Premier League,23,1995,19.5,62,43,43,13,6,31,45,68.9,14,32,13,19,34,96,82,0,0,2018-2019,90.0,156.9230769230769,286.15384615384613
271,Paul Bernardoni,FRA,GK,Nîmes,Ligue 1,21,1997,38.0,1,1,1,0,0,1,2,50.0,1,0,0,0,1,2,20,1,0,2018-2019,90.0,2.3684210526315788,2.3684210526315788
272,Juan Bernat,ESP,"DF,MF",Paris S-G,Ligue 1,25,1993,20.4,47,32,22,19,6,22,46,47.8,24,19,5,14,20,67,41,1,0,2018-2019,90.0,88.23529411764706,207.3529411764706
273,Antoine Bernede,FRA,MF,Paris S-G,Ligue 1,19,1999,1.9,13,7,3,8,2,5,9,55.6,4,3,1,2,3,16,1,1,0,2018-2019,90.0,142.10526315789474,615.7894736842105
274,Dimitry Bertaud,COD,GK,Montpellier,Ligue 1,20,1998,1.0,0,0,0,0,0,0,0,0.0,0,0,0,0,0,0,0,0,0,2018-2019,90.0,0.0,0.0
275,Ryan Bertrand,ENG,DF,Southampton,Premier League,28,1989,24.0,46,27,22,20,4,16,31,51.6,15,27,5,22,28,74,51,0,0,2018-2019,90.0,105.0,172.5
Rk,Player,Nation,Pos,Squad,Comp,0,0,90.0,0,0,3,3,3,Tkl,0,0.0,0,0,0,0,0,0,0,0,0,2018-2019,90.0,0.0,0.0
276,Daniel Bessa,ITA,MF,Genoa,Serie A,25,1993,27.1,60,35,28,23,9,11,39,28.2,28,30,4,26,19,79,16,1,0,2018-2019,90.0,63.09963099630996,199.2619926199262
277,Marcus Bettinelli,ENG,GK,Fulham,Premier League,26,1992,7.0,0,0,0,0,0,0,0,0.0,0,0,0,0,0,0,5,0,0,2018-2019,90.0,0.0,0.0
278,Jordan Beyer,GER,DF,Gladbach,Bundesliga,18,2000,8.0,32,18,21,10,1,17,24,70.8,7,12,6,6,11,43,32,0,0,2018-2019,90.0,123.75,360.0
279,Jonathan Biabiany,FRA,FW,Parma,Serie A,30,1988,11.9,30,22,18,10,2,9,17,52.9,8,8,1,7,11,41,11,1,0,2018-2019,90.00000000000001,83.19327731092437,226.89075630252103
280,Giulian Biancone,FRA,DF,Monaco,Ligue 1,18,2000,1.0,4,3,4,0,0,1,3,33.3,2,0,0,0,3,7,2,0,0,2018-2019,90.0,270.0,360.0
281,Ermin Bičakčić,BIH,DF,Hoffenheim,Bundesliga,28,1990,19.9,32,19,18,11,3,13,22,59.1,9,36,15,21,56,88,79,1,0,2018-2019,90.0,253.26633165829148,144.72361809045228
282,Pedro Bigas,ESP,DF,Eibar,La Liga,27,1990,6.5,4,3,2,0,2,1,5,20.0,4,6,2,4,8,12,22,0,0,2018-2019,90.00000000000001,110.76923076923077,55.38461538461539
283,Lucas Biglia,ARG,MF,Milan,Serie A,32,1986,12.4,60,33,31,25,4,20,45,44.4,25,19,3,16,22,82,21,1,0,2018-2019,90.0,159.67741935483872,435.48387096774195
284,Philip Billing,DEN,MF,Huddersfield,Premier League,22,1996,24.3,73,44,26,39,8,19,42,45.2,23,57,16,41,53,126,43,0,0,2018-2019,90.0,196.29629629629628,270.3703703703704
285,Cristiano Biraghi,ITA,DF,Fiorentina,Serie A,25,1992,35.5,52,33,31,17,4,18,38,47.4,20,40,17,23,44,96,113,0,0,2018-2019,90.0,111.54929577464789,131.83098591549296
286,Davide Biraschi,ITA,DF,Genoa,Serie A,24,1994,31.6,58,38,37,19,2,25,42,59.5,17,32,13,19,64,122,107,1,0,2018-2019,90.0,182.2784810126582,165.1898734177215
287,Valter Birsa,SVN,"MF,FW",Cagliari,Serie A,31,1986,3.9,5,3,1,3,1,4,8,50.0,4,5,0,5,4,9,3,0,0,2018-2019,90.0,92.3076923076923,115.38461538461539
288,Valter Birsa,SVN,"MF,FW",Chievo,Serie A,31,1986,12.2,14,9,4,7,3,4,17,23.5,13,9,1,8,6,20,13,0,0,2018-2019,90.0,44.26229508196722,103.27868852459018
289,Yves Bissouma,MLI,MF,Brighton,Premier League,21,1996,19.7,62,30,33,27,2,20,38,52.6,18,21,5,16,33,95,29,2,0,2018-2019,90.0,150.76142131979697,283.24873096446703
290,Leonardo Bittencourt,GER,MF,Hoffenheim,Bundesliga,24,1993,11.9,37,26,9,22,6,8,32,25.0,24,22,1,21,13,50,7,0,0,2018-2019,90.00000000000001,98.31932773109244,279.83193277310926
291,Alejandro Blanco,ESP,"FW,MF",Alavés,La Liga,19,1998,0.2,1,1,1,0,0,1,3,33.3,2,1,0,1,0,1,0,0,0,2018-2019,90.0,0.0,450.0
292,Rubén Blanco,ESP,GK,Celta Vigo,La Liga,23,1995,25.0,1,0,1,0,0,1,2,50.0,1,1,0,1,2,3,13,2,0,2018-2019,90.0,7.199999999999999,3.5999999999999996
293,Ludovic Blas,FRA,"MF,FW",Guingamp,Ligue 1,20,1997,26.4,62,38,22,32,8,20,43,46.5,23,44,7,37,26,88,14,0,0,2018-2019,90.0,88.63636363636364,211.36363636363637
294,Pablo de Blasis,ARG,"DF,MF",Eibar,La Liga,30,1988,16.9,32,19,17,8,7,12,32,37.5,20,18,0,18,13,45,20,0,0,2018-2019,90.0,69.23076923076924,170.41420118343197
295,Pablo de Blasis,ARG,FW,Mainz 05,Bundesliga,30,1988,1.0,2,0,0,1,1,2,3,66.7,1,0,0,0,1,3,0,0,0,2018-2019,90.0,90.0,180.0
296,Alexis Blin,FRA,MF,Amiens,Ligue 1,21,1996,22.1,77,45,33,36,8,35,89,39.3,54,39,14,25,33,110,48,1,0,2018-2019,90.0,134.3891402714932,313.57466063348414
297,Danny Blum,GER,MF,Eint Frankfurt,Bundesliga,27,1991,0.0,0,0,0,0,0,0,0,0.0,0,0,0,0,0,0,5,0,0,2018-2019,,,
298,Emmanuel Boateng,GHA,FW,Levante,La Liga,22,1996,7.8,4,3,0,0,4,0,3,0.0,3,5,0,5,1,5,7,0,0,2018-2019,90.0,11.538461538461538,46.15384615384615
299,Jérôme Boateng,GER,DF,Bayern Munich,Bundesliga,29,1988,18.8,21,15,12,9,0,10,22,45.5,12,8,3,5,25,46,49,0,0,2018-2019,90.0,119.68085106382978,100.53191489361701
300,Kevin-Prince Boateng,GHA,FW,Sassuolo,Serie A,31,1987,10.4,5,4,0,4,1,1,4,25.0,3,7,3,4,3,8,13,0,0,2018-2019,90.0,25.96153846153846,43.26923076923077
Rk,Player,Nation,Pos,Squad,Comp,0,0,90.0,0,0,3,3,3,Tkl,0,0.0,0,0,0,0,0,0,0,0,0,2018-2019,90.0,0.0,0.0
301,Kevin-Prince Boateng,GHA,FW,Barcelona,La Liga,31,1987,2.7,3,2,0,1,2,0,1,0.0,1,1,0,1,1,4,4,0,0,2018-2019,90.0,33.33333333333333,99.99999999999999
302,Antonin Bobichon,FRA,MF,Nîmes,Ligue 1,22,1995,23.9,34,16,17,12,5,16,58,27.6,42,15,3,12,15,49,13,0,0,2018-2019,90.0,56.48535564853557,128.03347280334728
303,Yann Bodiger,FRA,MF,Toulouse,Ligue 1,23,1995,0.1,0,0,0,0,0,0,1,0.0,1,0,0,0,0,0,0,0,0,2018-2019,90.0,0.0,0.0
304,Mathieu Bodmer,FRA,"MF,FW",Amiens,Ligue 1,35,1982,11.9,15,11,3,11,1,3,10,30.0,7,3,0,3,2,17,10,0,0,2018-2019,90.00000000000001,15.126050420168069,113.44537815126051
305,Adam Bodzek,GER,"MF,DF",Düsseldorf,Bundesliga,32,1985,17.7,44,27,27,16,1,17,43,39.5,26,15,6,9,26,70,39,0,0,2018-2019,90.0,132.20338983050848,223.72881355932205
306,Jean-Paul Boëtius,NED,MF,Mainz 05,Bundesliga,24,1994,23.6,51,32,21,25,5,16,44,36.4,28,59,2,57,37,88,13,0,0,2018-2019,90.0,141.10169491525423,194.4915254237288
307,Sacha Boey,FRA,DF,Rennes,Ligue 1,17,2000,0.2,0,0,0,0,0,0,0,0.0,0,0,0,0,0,0,0,0,0,2018-2019,90.0,0.0,0.0
308,Jeremie Boga,CIV,"FW,MF",Sassuolo,Serie A,21,1997,16.0,7,4,5,1,1,4,14,28.6,10,19,0,19,2,9,4,0,0,2018-2019,90.0,11.25,39.375
309,Willy Boly,CIV,DF,Wolves,Premier League,27,1991,35.2,85,52,49,34,2,34,56,60.7,22,55,32,23,72,157,177,6,0,2018-2019,90.0,184.0909090909091,217.32954545454544
310,Léo Bonatini,BRA,FW,Wolves,Premier League,24,1994,1.5,1,1,0,0,1,1,5,20.0,4,1,0,1,0,1,0,0,0,2018-2019,90.0,0.0,60.0
311,Giacomo Bonaventura,ITA,MF,Milan,Serie A,28,1989,7.2,6,2,2,4,0,2,7,28.6,5,3,0,3,7,13,8,0,0,2018-2019,90.0,87.5,75.0
312,Daniele Bonera,ITA,DF,Villarreal,La Liga,37,1981,2.6,2,2,2,0,0,1,1,100.0,0,5,5,0,4,6,10,0,0,2018-2019,90.0,138.46153846153845,69.23076923076923
313,Gaëtan Bong,CMR,DF,Brighton,Premier League,30,1988,20.1,16,10,7,6,3,6,10,60.0,4,16,6,10,25,41,57,2,0,2018-2019,90.0,111.94029850746267,71.64179104477611
314,Kevin Bonifazi,ITA,DF,SPAL,Serie A,22,1996,25.6,40,24,31,8,1,15,33,45.5,18,38,21,17,36,76,79,0,0,2018-2019,90.0,126.5625,140.625
315,Leonardo Bonucci,ITA,DF,Juventus,Serie A,31,1987,27.5,18,9,11,6,1,10,13,76.9,3,32,21,11,38,56,88,3,0,2018-2019,89.99999999999999,124.36363636363636,58.90909090909091
316,Fabio Borini,ITA,"FW,DF",Milan,Serie A,27,1991,11.7,14,10,7,7,0,3,9,33.3,6,17,0,17,12,26,28,0,0,2018-2019,89.99999999999999,92.3076923076923,107.6923076923077
317,Robin Bormuth,GER,DF,Düsseldorf,Bundesliga,22,1995,6.8,7,4,7,0,0,5,10,50.0,5,6,4,2,10,17,49,1,0,2018-2019,90.0,132.35294117647058,92.6470588235294
318,Artur Boruc,POL,GK,Bournemouth,Premier League,38,1980,12.0,1,0,1,0,0,1,3,33.3,2,0,0,0,0,1,1,0,0,2018-2019,90.0,0.0,7.5
319,Olivier Boscagli,FRA,DF,Nice,Ligue 1,20,1997,9.6,20,12,14,4,2,9,20,45.0,11,12,1,11,17,37,37,0,0,2018-2019,90.0,159.375,187.5
320,Gabriel Boschilia,BRA,"FW,MF",Nantes,Ligue 1,22,1996,14.7,33,23,11,9,13,8,33,24.2,25,14,2,12,8,41,7,0,0,2018-2019,90.0,48.97959183673469,202.0408163265306
321,John Bostock,TRI,MF,Toulouse,Ligue 1,26,1992,10.9,24,14,14,10,0,9,30,30.0,21,12,2,10,17,41,11,0,0,2018-2019,90.0,140.36697247706422,198.16513761467888
322,Denis Bouanga,GAB,"MF,FW",Nîmes,Ligue 1,23,1994,29.3,52,32,21,22,9,13,61,21.3,48,24,3,21,20,72,16,0,0,2018-2019,90.0,61.43344709897611,159.7269624573379
323,Zacharie Boucher,FRA,GK,Angers,Ligue 1,26,1992,2.0,0,0,0,0,0,0,0,0.0,0,1,0,1,0,0,1,0,0,2018-2019,90.0,0.0,0.0
324,Ryad Boudebouz,ALG,"MF,FW",Celta Vigo,La Liga,28,1990,8.0,14,4,4,6,4,3,8,37.5,5,9,1,8,3,17,9,0,0,2018-2019,90.0,33.75,157.5
325,Ryad Boudebouz,ALG,"MF,FW",Betis,La Liga,28,1990,6.0,8,4,4,1,3,4,10,40.0,6,5,1,4,5,13,2,0,0,2018-2019,90.0,75.0,120.0
Rk,Player,Nation,Pos,Squad,Comp,0,0,90.0,0,0,3,3,3,Tkl,0,0.0,0,0,0,0,0,0,0,0,0,2018-2019,90.0,0.0,0.0
326,Sofiane Boufal,MAR,"MF,FW",Celta Vigo,La Liga,24,1993,23.2,35,21,18,11,6,15,47,31.9,32,24,0,24,10,45,12,0,0,2018-2019,90.0,38.793103448275865,135.77586206896552
327,Nassim Boujellab,MAR,MF,Schalke 04,Bundesliga,19,1999,4.2,10,4,3,6,1,3,11,27.3,8,6,0,6,2,12,3,0,0,2018-2019,90.0,42.857142857142854,214.28571428571428
328,Arnold Bouka Moutou,CGO,"DF,FW",Dijon,Ligue 1,29,1988,0.7,3,1,2,1,0,0,4,0.0,4,1,0,1,3,6,1,0,0,2018-2019,90.0,385.7142857142857,385.7142857142857
329,Yassine Bounou,MAR,GK,Girona,La Liga,27,1991,31.8,0,0,0,0,0,0,2,0.0,2,0,0,0,1,1,7,2,0,2018-2019,90.0,2.830188679245283,0.0
330,Mehdi Bourabia,MAR,MF,Sassuolo,Serie A,26,1991,22.3,51,28,23,21,7,15,46,32.6,31,28,5,23,33,84,32,0,0,2018-2019,90.0,133.18385650224215,205.82959641255604
331,Benjamin Bourigeaud,FRA,"MF,FW",Rennes,Ligue 1,24,1994,26.9,55,35,23,21,11,20,67,29.9,47,44,5,39,32,87,34,1,0,2018-2019,90.0,107.06319702602231,184.01486988847586
332,Bilal Boutobba,FRA,"FW,MF",Montpellier,Ligue 1,19,1998,0.4,0,0,0,0,0,0,2,0.0,2,0,0,0,0,0,0,0,0,2018-2019,90.0,0.0,0.0
333,Umut Bozok,TUR,FW,Nîmes,Ligue 1,21,1996,13.7,9,6,0,3,6,2,4,50.0,2,3,0,3,5,14,1,0,0,2018-2019,90.0,32.846715328467155,59.12408759124089
334,Filip Bradarić,CRO,MF,Cagliari,Serie A,26,1992,16.6,26,21,11,12,3,10,20,50.0,10,13,3,10,39,65,50,0,0,2018-2019,90.0,211.4457831325301,140.96385542168673
335,Robbie Brady,IRL,MF,Burnley,Premier League,26,1992,8.0,15,7,5,5,5,6,17,35.3,11,7,1,6,7,22,18,1,0,2018-2019,90.0,78.75,168.75
336,Martin Braithwaite,DEN,FW,Leganés,La Liga,27,1991,15.6,5,3,0,0,5,0,4,0.0,4,9,0,9,3,8,4,0,0,2018-2019,90.0,17.307692307692307,28.846153846153847
337,Julian Brandt,GER,"MF,FW",Leverkusen,Bundesliga,22,1996,29.6,27,16,13,10,4,7,43,16.3,36,27,1,26,17,44,12,1,0,2018-2019,90.0,51.689189189189186,82.0945945945946
338,Darko Brašanac,SRB,MF,Alavés,La Liga,26,1992,17.6,32,16,15,13,4,10,26,38.5,16,17,4,13,13,45,19,0,0,2018-2019,90.0,66.47727272727272,163.63636363636363
339,Pedro Brazão,POR,"MF,FW",Nice,Ligue 1,15,2002,0.2,0,0,0,0,0,0,1,0.0,1,0,0,0,0,0,0,0,0,2018-2019,90.0,0.0,0.0
340,Fabian Bredlow,GER,GK,Nürnberg,Bundesliga,23,1995,12.5,1,1,1,0,0,1,1,100.0,0,0,0,0,1,2,3,4,0,2018-2019,90.0,7.199999999999999,7.199999999999999
341,Josip Brekalo,CRO,"FW,MF",Wolfsburg,Bundesliga,20,1998,15.7,15,7,7,6,2,5,18,27.8,13,15,1,14,12,27,9,1,0,2018-2019,90.0,68.78980891719746,85.98726114649682
342,Gleison Bremer,BRA,DF,Torino,Serie A,21,1997,2.0,3,1,1,2,0,1,2,50.0,1,4,1,3,8,11,9,0,0,2018-2019,90.0,360.0,135.0
343,Joshua Brenet,CUW,DF,Hoffenheim,Bundesliga,24,1994,10.1,20,13,12,5,3,7,13,53.8,6,16,1,15,8,28,19,0,0,2018-2019,90.0,71.2871287128713,178.21782178217822
344,Rajko Brežančić,SRB,DF,Huesca,La Liga,28,1989,0.7,1,0,0,0,1,0,0,0.0,0,0,0,0,0,1,0,0,0,2018-2019,90.0,0.0,128.57142857142858
345,Anthony Briançon,FRA,DF,Nîmes,Ligue 1,23,1994,32.5,46,27,36,10,0,27,50,54.0,23,51,38,13,70,116,184,1,0,2018-2019,90.0,193.84615384615384,127.38461538461539
346,Jimmy Briand,FRA,FW,Bordeaux,Ligue 1,32,1985,27.7,14,8,2,10,2,4,24,16.7,20,14,6,8,4,18,29,0,0,2018-2019,90.0,12.99638989169675,45.48736462093863
347,Nicolò Brighenti,ITA,DF,Frosinone,Serie A,28,1989,11.0,27,17,9,15,3,6,14,42.9,8,17,8,9,31,58,37,0,0,2018-2019,90.0,253.63636363636365,220.9090909090909
348,Matteo Brighi,ITA,MF,Empoli,Serie A,37,1981,2.6,11,4,2,9,0,2,9,22.2,7,2,0,2,3,14,4,0,0,2018-2019,90.0,103.84615384615384,380.7692307692307
349,Enrico Brignola,ITA,"FW,MF",Sassuolo,Serie A,19,1999,1.9,2,2,2,0,0,0,2,0.0,2,0,0,0,1,3,1,0,0,2018-2019,90.0,47.368421052631575,94.73684210526315
350,Miguel Britos,URU,DF,Watford,Premier League,33,1985,2.1,4,2,4,0,0,2,4,50.0,2,1,1,0,3,7,11,1,0,2018-2019,90.0,128.57142857142856,171.42857142857142
Rk,Player,Nation,Pos,Squad,Comp,0,0,90.0,0,0,3,3,3,Tkl,0,0.0,0,0,0,0,0,0,0,0,0,2018-2019,90.0,0.0,0.0
351,David Brooks,WAL,"MF,FW",Bournemouth,Premier League,21,1997,25.1,37,26,12,19,6,19,44,43.2,25,36,7,29,24,61,28,0,0,2018-2019,90.0,86.05577689243027,132.66932270916334
352,John Brooks,USA,DF,Wolfsburg,Bundesliga,25,1993,29.0,29,15,18,9,2,13,27,48.1,14,28,13,15,37,66,135,3,0,2018-2019,90.0,114.82758620689654,90.0
353,Daniel Brosinski,GER,DF,Mainz 05,Bundesliga,30,1988,24.5,27,16,16,10,1,18,33,54.5,15,30,9,21,26,53,58,0,0,2018-2019,90.00000000000001,95.51020408163266,99.18367346938777
354,Marcelo Brozović,CRO,MF,Inter,Serie A,25,1992,29.4,101,70,47,40,14,31,86,36.0,55,45,8,37,44,145,32,3,0,2018-2019,90.0,134.69387755102042,309.18367346938777
355,Bruma,POR,MF,RB Leipzig,Bundesliga,23,1994,6.1,5,2,3,1,1,1,5,20.0,4,4,0,4,4,9,2,0,0,2018-2019,90.0,59.016393442622956,73.7704918032787
356,Jeffrey Bruma,NED,DF,Schalke 04,Bundesliga,26,1991,6.9,12,11,8,4,0,6,12,50.0,6,8,2,6,4,16,35,0,0,2018-2019,90.0,52.17391304347826,156.52173913043475
357,Bruno,ESP,DF,Brighton,Premier League,37,1980,12.6,25,16,20,3,2,14,18,77.8,4,7,2,5,11,36,30,1,0,2018-2019,90.0,78.57142857142858,178.57142857142858
358,Jacob Bruun Larsen,DEN,FW,Dortmund,Bundesliga,19,1998,14.1,15,9,8,2,5,7,17,41.2,10,15,1,14,13,28,12,0,0,2018-2019,89.99999999999999,82.97872340425532,95.74468085106382
359,Joe Bryan,ENG,"DF,MF",Fulham,Premier League,24,1993,26.1,61,41,35,21,5,24,42,57.1,18,34,12,22,31,92,82,1,0,2018-2019,90.0,106.89655172413792,210.34482758620686
360,Gianluigi Buffon,ITA,GK,Paris S-G,Ligue 1,40,1978,17.0,0,0,0,0,0,0,1,0.0,1,0,0,0,0,0,5,0,0,2018-2019,90.0,0.0,0.0
361,Niko Bungert,GER,DF,Mainz 05,Bundesliga,31,1986,3.2,7,5,5,2,0,5,5,100.0,0,7,6,1,4,11,16,0,0,2018-2019,90.0,112.5,196.875
362,Guido Burgstaller,AUT,FW,Schalke 04,Bundesliga,29,1989,17.0,11,9,2,5,4,3,8,37.5,5,5,0,5,2,13,10,0,0,2018-2019,90.0,10.588235294117647,58.23529411764706
363,Burgui,ESP,"MF,FW",Alavés,La Liga,24,1993,6.2,6,6,4,2,0,1,3,33.3,2,4,0,4,0,6,2,1,0,2018-2019,90.0,0.0,87.09677419354838
364,Jonathan Burkardt,GER,"FW,MF",Mainz 05,Bundesliga,18,2000,2.9,4,4,2,1,1,1,2,50.0,1,2,0,2,3,7,5,0,0,2018-2019,90.0,93.10344827586206,124.13793103448276
365,Roman Bürki,SUI,GK,Dortmund,Bundesliga,27,1990,32.0,1,0,1,0,0,1,2,50.0,1,1,0,1,2,3,8,4,0,2018-2019,90.0,5.625,2.8125
366,Patrick Burner,MTQ,DF,Nice,Ligue 1,22,1996,15.0,36,23,22,10,4,16,34,47.1,18,15,5,10,31,67,40,0,0,2018-2019,90.0,186.0,216.0
367,Sergio Busquets,ESP,MF,Barcelona,La Liga,30,1988,30.2,90,60,35,45,10,41,89,46.1,48,43,8,35,54,144,22,1,0,2018-2019,90.0,160.9271523178808,268.2119205298013
368,Gaëtan Bussmann,FRA,DF,Mainz 05,Bundesliga,27,1991,1.0,2,1,2,0,0,2,5,40.0,3,0,0,0,1,3,2,0,0,2018-2019,90.0,90.0,180.0
369,Unai Bustinza,ESP,DF,Leganés,La Liga,26,1992,22.5,41,31,25,14,2,17,33,51.5,16,31,13,18,53,94,110,2,0,2018-2019,90.0,212.0,164.0
370,Ludovic Butelle,FRA,GK,Angers,Ligue 1,35,1983,36.0,1,0,1,0,0,1,1,100.0,0,0,0,0,1,2,31,1,0,2018-2019,90.0,2.5,2.5
371,David Button,ENG,GK,Brighton,Premier League,29,1989,4.0,0,0,0,0,0,0,0,0.0,0,0,0,0,0,0,2,0,0,2018-2019,90.0,0.0,0.0
372,Jakub Błaszczykowski,POL,MF,Wolfsburg,Bundesliga,32,1985,0.1,0,0,0,0,0,0,0,0.0,0,0,0,0,0,0,0,0,0,2018-2019,90.0,0.0,0.0
373,Erick Cabaco,URU,DF,Levante,La Liga,23,1995,18.1,22,13,19,3,0,12,29,41.4,17,29,14,15,29,51,69,0,0,2018-2019,90.0,144.1988950276243,109.39226519337015
374,Willy Caballero,ARG,GK,Chelsea,Premier League,36,1981,2.0,0,0,0,0,0,0,0,0.0,0,0,0,0,0,0,1,0,0,2018-2019,90.0,0.0,0.0
375,Rémy Cabella,FRA,"MF,FW",Saint-Étienne,Ligue 1,28,1990,33.3,88,51,31,38,19,30,87,34.5,57,39,1,38,19,107,5,3,0,2018-2019,90.0,51.351351351351354,237.83783783783784
Rk,Player,Nation,Pos,Squad,Comp,0,0,90.0,0,0,3,3,3,Tkl,0,0.0,0,0,0,0,0,0,0,0,0,2018-2019,90.0,0.0,0.0
376,Gustavo Cabral,ARG,DF,Celta Vigo,La Liga,32,1985,21.1,37,26,28,7,2,17,27,63.0,10,31,11,20,33,70,102,1,0,2018-2019,90.0,140.75829383886256,157.81990521327015
377,Rafael Cabral,BRA,GK,Sampdoria,Serie A,28,1990,2.0,0,0,0,0,0,0,0,0.0,0,0,0,0,0,0,0,0,0,2018-2019,90.0,0.0,0.0
378,Leandro Cabrera,URU,DF,Getafe,La Liga,27,1991,31.0,47,26,28,17,2,24,41,58.5,17,29,16,13,52,99,216,2,0,2018-2019,90.0,150.96774193548387,136.4516129032258
379,Fabrizio Cacciatore,ITA,DF,Cagliari,Serie A,31,1986,6.4,9,7,7,0,2,1,5,20.0,4,6,4,2,7,16,17,0,0,2018-2019,90.0,98.4375,126.5625
380,Fabrizio Cacciatore,ITA,DF,Chievo,Serie A,31,1986,5.5,8,4,6,2,0,4,9,44.4,5,8,2,6,5,13,20,0,0,2018-2019,90.0,81.81818181818183,130.9090909090909
381,Martín Cáceres,URU,DF,Lazio,Serie A,31,1987,3.4,4,2,3,1,0,4,6,66.7,2,4,0,4,0,4,12,1,0,2018-2019,90.0,0.0,105.88235294117646
382,Martín Cáceres,URU,DF,Juventus,Serie A,31,1987,7.0,7,3,6,0,1,4,4,100.0,0,6,3,3,4,11,14,0,0,2018-2019,90.0,51.42857142857143,90.0
383,Anthony Caci,FRA,DF,Strasbourg,Ligue 1,21,1997,25.5,56,30,38,14,4,24,46,52.2,22,20,10,10,47,103,63,0,0,2018-2019,90.0,165.88235294117646,197.64705882352942
384,Mathieu Cafaro,FRA,"FW,MF",Reims,Ligue 1,21,1997,23.3,59,28,29,24,6,18,63,28.6,45,28,0,28,20,79,14,0,0,2018-2019,90.0,77.25321888412017,227.8969957081545
385,Gary Cahill,ENG,DF,Chelsea,Premier League,32,1985,0.3,0,0,0,0,0,0,0,0.0,0,0,0,0,0,0,1,0,0,2018-2019,90.0,0.0,0.0
386,Yannick Cahuzac,FRA,"MF,DF",Toulouse,Ligue 1,33,1985,15.9,33,19,15,15,3,17,32,53.1,15,16,4,12,24,57,55,0,0,2018-2019,90.0,135.8490566037736,186.7924528301887
387,Felipe Caicedo,ECU,FW,Lazio,Serie A,29,1988,15.2,16,12,4,6,6,1,8,12.5,7,9,2,7,5,21,5,0,0,2018-2019,90.0,29.605263157894736,94.73684210526315
388,Marc-Aurèle Caillard,FRA,GK,Guingamp,Ligue 1,24,1994,21.0,0,0,0,0,0,0,2,0.0,2,0,0,0,2,2,8,3,0,2018-2019,90.0,8.571428571428571,0.0
389,Tom Cairney,SCO,"MF,FW",Fulham,Premier League,27,1991,24.4,37,21,9,22,6,12,16,75.0,4,21,5,16,10,47,13,1,0,2018-2019,90.0,36.88524590163935,136.47540983606558
390,Caiuby,BRA,"MF,FW",Augsburg,Bundesliga,30,1988,11.2,12,10,5,6,1,3,11,27.3,8,16,1,15,5,17,10,0,0,2018-2019,90.0,40.17857142857143,96.42857142857143
391,Arturo Calabresi,ITA,DF,Bologna,Serie A,22,1996,15.7,46,27,22,17,7,22,40,55.0,18,18,3,15,34,80,60,0,0,2018-2019,90.0,194.90445859872614,263.69426751592357
392,Davide Calabria,ITA,DF,Milan,Serie A,21,1996,21.7,79,51,58,16,5,37,67,55.2,30,33,1,32,32,111,78,1,0,2018-2019,90.0,132.7188940092166,327.64976958525347
393,Jordi Calavera,ESP,DF,Eibar,La Liga,22,1995,0.0,0,0,0,0,0,0,0,0.0,0,0,0,0,0,0,0,0,0,2018-2019,,,
394,Fernando Calero,ESP,DF,Valladolid,La Liga,22,1995,34.8,51,31,33,18,0,23,38,60.5,15,55,31,24,55,106,170,0,0,2018-2019,90.0,142.24137931034483,131.89655172413794
395,Duje Ćaleta-Car,CRO,DF,Marseille,Ligue 1,21,1996,17.2,22,16,14,8,0,14,18,77.8,4,15,9,6,20,42,86,2,0,2018-2019,90.0,104.65116279069768,115.11627906976746
396,Hakan Çalhanoğlu,TUR,"MF,FW",Milan,Serie A,24,1994,32.0,52,31,27,16,9,23,46,50.0,23,27,5,22,28,80,19,0,0,2018-2019,90.0,78.75,146.25
397,Daniel Caligiuri,ITA,"DF,FW",Schalke 04,Bundesliga,30,1988,30.6,93,52,55,29,9,44,103,42.7,59,66,10,56,50,143,72,1,0,2018-2019,90.0,147.05882352941177,273.52941176470586
398,José Callejón,ESP,"MF,FW",Napoli,Serie A,31,1987,29.4,34,18,12,14,8,18,57,31.6,39,34,5,29,22,56,11,0,0,2018-2019,90.0,67.34693877551021,104.08163265306122
399,Jonathan Calleri,ARG,FW,Alavés,La Liga,24,1993,31.9,20,13,3,11,6,1,24,4.2,23,34,7,27,7,27,53,0,0,2018-2019,90.0,19.74921630094044,56.426332288401255
400,Jan-Ingwer Callsen-Bracker,GER,DF,Augsburg,Bundesliga,33,1984,0.1,0,0,0,0,0,0,0,0.0,0,0,0,0,0,0,0,0,0,2018-2019,90.0,0.0,0.0
Rk,Player,Nation,Pos,Squad,Comp,0,0,90.0,0,0,3,3,3,Tkl,0,0.0,0,0,0,0,0,0,0,0,0,2018-2019,90.0,0.0,0.0
401,Dominic Calvert-Lewin,ENG,FW,Everton,Premier League,21,1997,19.8,13,7,3,3,7,7,15,46.7,8,16,3,13,7,20,19,0,0,2018-2019,90.0,31.818181818181817,59.09090909090909
402,Ignacio Camacho,ESP,MF,Wolfsburg,Bundesliga,28,1990,6.0,15,9,9,6,0,3,7,42.9,4,7,2,5,18,33,12,0,0,2018-2019,90.0,270.0,225.0
403,Juanjo Camacho,ESP,"MF,DF",Huesca,La Liga,37,1980,0.4,1,1,1,0,0,1,1,100.0,0,0,0,0,0,1,1,0,0,2018-2019,90.0,0.0,225.0
404,Rafael Camacho,POR,DF,Liverpool,Premier League,18,2000,0.0,1,0,1,0,0,1,1,100.0,0,0,0,0,0,1,0,0,0,2018-2019,,,inf
405,Mahdi Camara,FRA,FW,Saint-Étienne,Ligue 1,20,1998,0.1,0,0,0,0,0,0,0,0.0,0,0,0,0,0,0,2,0,0,2018-2019,90.0,0.0,0.0
406,Souleymane Camara,SEN,"FW,MF",Montpellier,Ligue 1,35,1982,1.5,0,0,0,0,0,0,2,0.0,2,0,0,0,0,0,3,0,0,2018-2019,90.0,0.0,0.0
407,Víctor Camarasa,ESP,MF,Cardiff City,Premier League,24,1994,28.5,28,15,8,15,5,6,31,19.4,25,17,2,15,33,61,28,1,0,2018-2019,90.0,104.21052631578948,88.42105263157895
408,Eduardo Camavinga,FRA,MF,Rennes,Ligue 1,15,2002,4.0,23,15,8,12,3,8,18,44.4,10,13,2,11,4,27,4,0,0,2018-2019,90.0,90.0,517.5
409,Sergio Camello,ESP,FW,Atlético Madrid,La Liga,17,2001,0.5,1,0,1,0,0,1,1,100.0,0,0,0,0,0,1,0,0,0,2018-2019,90.0,0.0,180.0
410,José Campaña,ESP,MF,Levante,La Liga,25,1993,35.7,65,45,31,29,5,27,86,31.4,59,51,7,44,48,113,46,1,0,2018-2019,90.0,121.00840336134452,163.86554621848737
411,Joel Campbell,CRC,"FW,MF",Frosinone,Serie A,26,1992,9.9,15,10,5,8,2,3,17,17.6,14,2,0,2,3,18,2,1,0,2018-2019,90.0,27.272727272727273,136.36363636363637
412,Emre Can,GER,MF,Juventus,Serie A,24,1994,20.1,64,38,28,27,9,24,40,60.0,16,43,13,30,28,92,36,2,0,2018-2019,90.0,125.37313432835819,286.56716417910445
413,Sergio Canales,ESP,MF,Betis,La Liga,27,1991,29.5,44,30,19,18,7,11,53,20.8,42,34,3,31,9,53,8,1,0,2018-2019,90.0,27.45762711864407,134.23728813559322
414,João Cancelo,POR,DF,Juventus,Serie A,24,1994,21.9,43,28,18,18,7,27,49,55.1,22,14,4,10,15,58,48,0,0,2018-2019,90.0,61.64383561643836,176.7123287671233
415,Antonio Candreva,ITA,"FW,MF",Inter,Serie A,31,1987,5.6,1,1,0,1,0,1,8,12.5,7,0,0,0,4,5,9,0,0,2018-2019,90.0,64.28571428571429,16.071428571428573
416,Ander Capa,ESP,"DF,FW",Athletic Club,La Liga,26,1992,18.2,43,27,32,8,3,13,27,48.1,14,20,2,18,30,73,47,0,0,2018-2019,90.0,148.35164835164835,212.63736263736263
417,Luan Capanni,BRA,FW,Lazio,Serie A,18,2000,0.1,1,1,0,0,1,0,0,0.0,0,0,0,0,0,1,0,0,0,2018-2019,90.0,0.0,900.0
418,Pierrick Capelle,FRA,"DF,MF",Angers,Ligue 1,31,1987,20.5,51,31,23,22,6,19,54,35.2,35,23,2,21,38,89,49,0,0,2018-2019,90.0,166.82926829268294,223.90243902439025
419,Leonardo Capezzi,ITA,MF,Empoli,Serie A,23,1995,8.6,14,9,6,8,0,7,13,53.8,6,14,4,10,10,24,13,0,0,2018-2019,90.0,104.65116279069768,146.51162790697677
420,Étienne Capoue,FRA,MF,Watford,Premier League,30,1988,32.7,91,56,36,48,7,33,87,37.9,54,50,13,37,85,176,96,1,0,2018-2019,90.0,233.94495412844037,250.45871559633028
421,Gianluca Caprari,ITA,"FW,MF",Sampdoria,Serie A,25,1993,11.5,15,9,4,9,2,5,12,41.7,7,7,0,7,4,19,3,0,0,2018-2019,90.0,31.30434782608696,117.3913043478261
422,Marco Capuano,ITA,DF,Frosinone,Serie A,26,1991,25.6,53,33,37,15,1,26,46,56.5,20,44,31,13,34,87,101,2,0,2018-2019,90.0,119.53125,186.328125
423,Francesco Caputo,ITA,FW,Empoli,Serie A,30,1987,38.0,13,9,2,4,7,3,10,30.0,7,11,1,10,2,15,11,0,0,2018-2019,90.0,4.7368421052631575,30.789473684210527
424,Yoan Cardinale,FRA,GK,Nice,Ligue 1,24,1994,3.0,1,0,1,0,0,1,1,100.0,0,0,0,0,0,1,1,0,0,2018-2019,90.0,0.0,30.0
425,Marc Cardona,ESP,"FW,MF",Eibar,La Liga,23,1995,6.7,7,5,2,1,4,2,6,33.3,4,7,0,7,1,8,3,0,0,2018-2019,90.0,13.432835820895521,94.02985074626865
Rk,Player,Nation,Pos,Squad,Comp,0,0,90.0,0,0,3,3,3,Tkl,0,0.0,0,0,0,0,0,0,0,0,0,2018-2019,90.0,0.0,0.0
426,Diego Carlos,BRA,DF,Nantes,Ligue 1,25,1993,35.0,58,34,43,14,1,26,33,78.8,7,44,31,13,50,108,186,1,0,2018-2019,90.0,128.57142857142856,149.14285714285714
427,Jonas Carls,GER,FW,Schalke 04,Bundesliga,21,1997,1.0,5,2,4,0,1,5,5,100.0,0,0,0,0,1,6,0,0,0,2018-2019,90.0,90.0,450.0
428,Louis Carnot,FRA,MF,Guingamp,Ligue 1,17,2001,0.1,0,0,0,0,0,0,0,0.0,0,0,0,0,0,0,0,0,0,2018-2019,90.0,0.0,0.0
429,Lionel Carole,FRA,"DF,FW",Strasbourg,Ligue 1,27,1991,19.2,25,12,16,7,2,11,16,68.8,5,19,5,14,32,57,51,0,0,2018-2019,90.0,150.0,117.18750000000001
430,Daniel Carriço,POR,DF,Sevilla,La Liga,29,1988,23.7,35,18,23,11,1,12,20,60.0,8,19,12,7,31,66,104,1,0,2018-2019,90.0,117.72151898734178,132.9113924050633
431,Guido Carrillo,ARG,FW,Leganés,La Liga,27,1991,22.1,25,14,4,12,9,6,19,31.6,13,12,1,11,8,33,25,0,0,2018-2019,90.0,32.57918552036199,101.80995475113122
432,Andy Carroll,ENG,FW,West Ham,Premier League,29,1989,5.1,4,2,1,3,0,1,4,25.0,3,3,2,1,1,5,8,0,0,2018-2019,90.0,17.647058823529413,70.58823529411765
433,Dani Carvajal,ESP,DF,Real Madrid,La Liga,26,1992,23.4,40,24,17,15,8,18,41,43.9,23,31,7,24,26,66,35,0,0,2018-2019,89.99999999999999,100.0,153.84615384615384
434,William Carvalho,POR,MF,Betis,La Liga,26,1992,26.5,45,27,20,21,4,16,29,55.2,13,8,0,8,12,57,30,0,0,2018-2019,90.0,40.75471698113208,152.83018867924528
435,Casemiro,BRA,MF,Real Madrid,La Liga,26,1992,25.7,86,52,44,35,7,38,94,40.4,56,52,12,40,41,127,56,3,0,2018-2019,90.0,143.57976653696497,301.16731517509726
436,Santiago Cáseres,ARG,MF,Villarreal,La Liga,21,1997,17.6,67,35,20,38,9,25,57,43.9,32,22,9,13,14,81,24,1,0,2018-2019,90.0,71.5909090909091,342.6136363636364
437,Moreto Cassamã,GNB,MF,Reims,Ligue 1,20,1998,0.7,3,3,1,2,0,1,7,14.3,6,1,0,1,1,4,2,0,0,2018-2019,90.0,128.57142857142858,385.7142857142857
438,Francesco Cassata,ITA,MF,Frosinone,Serie A,21,1997,12.5,20,11,12,4,4,9,23,39.1,14,8,1,7,6,26,15,1,0,2018-2019,90.0,43.199999999999996,144.0
439,Timothy Castagne,BEL,DF,Atalanta,Serie A,22,1995,22.3,61,39,30,22,9,32,57,56.1,25,32,6,26,28,89,50,0,0,2018-2019,90.0,113.00448430493273,246.18834080717488
440,Koen Casteels,BEL,GK,Wolfsburg,Bundesliga,26,1992,25.5,1,0,1,0,0,1,2,50.0,1,1,0,1,0,1,11,1,0,2018-2019,90.0,0.0,3.5294117647058822
441,Samu Castillejo,ESP,"FW,MF",Milan,Serie A,23,1995,11.4,15,10,10,2,3,4,25,16.0,21,16,0,16,8,23,11,0,0,2018-2019,90.0,63.1578947368421,118.42105263157893
442,Gonzalo Castro,GER,MF,Stuttgart,Bundesliga,31,1987,18.8,50,28,21,25,4,19,43,44.2,24,23,5,18,29,79,22,1,0,2018-2019,90.0,138.82978723404256,239.36170212765956
443,Jonny Castro,ESP,"DF,MF",Wolves,Premier League,24,1994,30.8,79,43,42,33,4,31,60,51.7,29,45,8,37,60,139,64,2,0,2018-2019,90.0,175.32467532467533,230.84415584415586
444,Lucas Castro,ARG,MF,Cagliari,Serie A,29,1989,10.0,18,11,8,8,2,8,23,34.8,15,20,4,16,17,35,6,0,0,2018-2019,90.0,153.0,162.0
445,Danilo Cataldi,ITA,"MF,FW",Lazio,Serie A,23,1994,6.4,12,7,4,5,3,2,9,22.2,7,3,0,3,7,19,6,0,0,2018-2019,90.0,98.4375,168.75
446,Catena,ESP,DF,Rayo Vallecano,La Liga,23,1994,2.0,4,4,3,1,0,2,2,100.0,0,4,2,2,8,12,8,0,0,2018-2019,90.0,360.0,180.0
447,Craig Cathcart,NIR,DF,Watford,Premier League,29,1989,34.4,50,31,36,11,3,21,37,56.8,16,42,30,12,38,88,184,4,0,2018-2019,90.0,99.4186046511628,130.8139534883721
448,Ivan Cavaleiro,POR,"FW,MF",Wolves,Premier League,24,1993,7.7,5,4,3,1,1,1,14,7.1,13,12,0,12,4,9,5,0,0,2018-2019,90.0,46.753246753246756,58.44155844155844
449,Edinson Cavani,URU,FW,Paris S-G,Ligue 1,31,1987,18.6,11,8,1,4,6,3,13,23.1,10,11,2,9,6,17,16,0,0,2018-2019,90.0,29.032258064516125,53.2258064516129
450,Santi Cazorla,ESP,"MF,FW",Villarreal,La Liga,33,1984,29.4,69,34,32,26,11,24,69,34.8,45,35,6,29,28,97,17,1,0,2018-2019,90.0,85.71428571428572,211.22448979591837
Rk,Player,Nation,Pos,Squad,Comp,0,0,90.0,0,0,3,3,3,Tkl,0,0.0,0,0,0,0,0,0,0,0,0,2018-2019,90.0,0.0,0.0
451,Dani Ceballos,ESP,"MF,FW",Real Madrid,La Liga,21,1996,13.9,32,21,9,16,7,11,31,35.5,20,26,1,25,15,47,6,0,0,2018-2019,90.0,97.12230215827338,207.19424460431657
452,Federico Ceccherini,ITA,DF,Fiorentina,Serie A,26,1992,11.0,13,10,8,3,2,5,9,55.6,4,12,8,4,21,34,40,0,0,2018-2019,90.0,171.8181818181818,106.36363636363637
453,Petr Čech,CZE,GK,Arsenal,Premier League,36,1982,6.5,1,1,1,0,0,1,1,100.0,0,0,0,0,0,1,5,2,0,2018-2019,90.00000000000001,0.0,13.846153846153847
454,Žan Celar,SVN,FW,Roma,Serie A,19,1999,0.1,0,0,0,0,0,0,0,0.0,0,0,0,0,0,0,0,0,0,2018-2019,90.0,0.0,0.0
455,Zeki Çelik,TUR,DF,Lille,Ligue 1,21,1997,33.0,90,59,40,39,11,36,89,40.4,53,34,5,29,34,124,89,1,0,2018-2019,90.0,92.72727272727273,245.45454545454547
456,Luca Ceppitelli,ITA,DF,Cagliari,Serie A,28,1989,22.8,40,24,28,11,1,13,22,59.1,9,34,24,10,20,60,111,2,0,2018-2019,90.0,78.94736842105263,157.89473684210526
457,Fabio Ceravolo,ITA,FW,Parma,Serie A,31,1987,13.2,5,1,2,1,2,1,11,9.1,10,9,1,8,2,7,19,0,0,2018-2019,90.0,13.636363636363637,34.09090909090909
458,Alberto Cerri,ITA,FW,Cagliari,Serie A,22,1996,7.4,3,2,2,1,0,0,7,0.0,7,7,1,6,2,5,4,0,0,2018-2019,90.0,24.324324324324323,36.486486486486484
459,Boštjan Cesar,SVN,DF,Chievo,Serie A,36,1982,12.0,16,10,9,7,0,7,17,41.2,10,14,8,6,14,30,60,2,0,2018-2019,90.0,105.0,120.0
460,Nacer Chadli,BEL,"MF,DF",Monaco,Ligue 1,28,1989,7.7,11,5,4,4,3,3,8,37.5,5,7,1,6,3,14,7,0,0,2018-2019,90.0,35.064935064935064,128.57142857142858
461,Fouad Chafik,MAR,DF,Dijon,Ligue 1,31,1986,20.5,44,31,29,12,3,23,36,63.9,13,17,3,14,25,69,71,0,0,2018-2019,90.0,109.75609756097562,193.1707317073171
462,Nathaniel Chalobah,ENG,MF,Watford,Premier League,23,1994,3.0,3,2,1,2,0,2,7,28.6,5,2,1,1,5,8,7,0,0,2018-2019,90.0,150.0,90.0
463,Calum Chambers,ENG,"MF,DF",Fulham,Premier League,23,1995,28.8,64,36,32,27,5,16,48,33.3,32,37,12,25,69,133,113,4,0,2018-2019,90.0,215.625,200.0
464,Timothy Chandler,USA,DF,Eint Frankfurt,Bundesliga,28,1990,0.2,0,0,0,0,0,0,0,0.0,0,0,0,0,0,0,0,0,0,2018-2019,90.0,0.0,0.0
465,Kwon Chang-hoon,KOR,"FW,MF",Dijon,Ligue 1,24,1994,10.4,7,4,3,2,2,0,12,0.0,12,16,0,16,8,15,8,0,0,2018-2019,90.0,69.23076923076923,60.57692307692307
466,Charles,BRA,FW,Eibar,La Liga,34,1984,19.3,7,5,1,3,3,2,13,15.4,11,14,1,13,4,11,14,0,0,2018-2019,90.0,18.65284974093264,32.64248704663212
467,Xavier Chavalerin,FRA,MF,Reims,Ligue 1,27,1991,36.0,106,61,56,39,11,28,72,38.9,44,44,12,32,72,178,39,1,0,2018-2019,90.0,180.0,265.0
468,Pablo Chavarría,ARG,FW,Reims,Ligue 1,30,1988,21.9,20,12,8,6,6,3,15,20.0,12,11,0,11,4,24,19,0,0,2018-2019,90.0,16.438356164383563,82.19178082191782
469,Chechu,ESP,DF,Rayo Vallecano,La Liga,36,1982,1.0,0,0,0,0,0,0,2,0.0,2,0,0,0,2,2,5,0,0,2018-2019,90.0,180.0,0.0
470,Pape Cheikh Diop,SEN,MF,Lyon,Ligue 1,20,1997,5.0,1,0,0,1,0,0,5,0.0,5,6,2,4,2,3,2,1,0,2018-2019,90.0,36.0,18.0
471,Chema,ESP,DF,Levante,La Liga,26,1992,13.9,27,19,16,9,2,13,19,68.4,6,19,11,8,19,46,83,0,0,2018-2019,90.0,123.02158273381295,174.8201438848921
472,Denis Cheryshev,RUS,MF,Valencia,La Liga,27,1990,19.0,46,32,15,22,9,17,37,45.9,20,35,3,32,15,61,16,0,0,2018-2019,90.0,71.05263157894737,217.89473684210526
473,Raman Chibsah,GHA,MF,Frosinone,Serie A,25,1993,29.1,46,27,25,19,2,16,54,29.6,38,45,10,35,32,78,28,1,0,2018-2019,90.0,98.96907216494844,142.26804123711338
474,Leandro Chichizola,ARG,GK,Getafe,La Liga,28,1990,1.0,0,0,0,0,0,0,0,0.0,0,0,0,0,0,0,1,0,0,2018-2019,90.0,0.0,0.0
475,Giorgio Chiellini,ITA,DF,Juventus,Serie A,33,1984,22.1,24,13,20,2,2,5,8,62.5,3,22,15,7,30,54,96,1,0,2018-2019,90.0,122.17194570135746,97.73755656108597
Rk,Player,Nation,Pos,Squad,Comp,0,0,90.0,0,0,3,3,3,Tkl,0,0.0,0,0,0,0,0,0,0,0,0,2018-2019,90.0,0.0,0.0
476,Federico Chiesa,ITA,FW,Fiorentina,Serie A,20,1997,33.7,46,27,8,17,21,10,40,25.0,30,24,1,23,10,56,12,0,0,2018-2019,90.0,26.706231454005934,122.84866468842729
477,Ben Chilwell,ENG,DF,Leicester City,Premier League,21,1996,36.0,55,29,34,18,3,24,55,43.6,31,37,7,30,38,93,156,0,0,2018-2019,90.0,95.0,137.5
478,Vlad Chiricheș,ROU,DF,Napoli,Serie A,28,1989,1.6,2,1,1,1,0,0,2,0.0,2,2,2,0,1,3,2,0,0,2018-2019,90.0,56.25,112.5
479,Tahith Chong,NED,FW,Manchester Utd,Premier League,18,1999,0.4,0,0,0,0,0,0,0,0.0,0,1,0,1,0,0,1,0,0,2018-2019,90.0,0.0,0.0
480,Hamza Choudhury,ENG,MF,Leicester City,Premier League,20,1997,6.6,24,10,13,10,1,9,15,60.0,6,12,3,9,15,39,13,0,0,2018-2019,90.0,204.54545454545453,327.27272727272725
481,Andreas Christensen,DEN,DF,Chelsea,Premier League,22,1996,6.9,10,4,2,6,2,2,5,40.0,3,4,2,2,4,14,29,0,0,2018-2019,90.0,52.17391304347826,130.43478260869563
482,Cyrus Christie,IRL,"DF,MF",Fulham,Premier League,25,1992,21.6,43,23,26,13,4,18,41,43.9,23,25,11,14,29,72,96,1,0,2018-2019,90.0,120.83333333333333,179.16666666666666
483,Samuel Chukwueze,NGA,"MF,FW",Villarreal,La Liga,19,1999,19.0,19,11,7,10,2,9,31,29.0,22,11,2,9,10,29,2,0,0,2018-2019,90.0,47.36842105263158,90.0
484,Camillo Ciano,ITA,"FW,MF",Frosinone,Serie A,28,1990,27.3,33,15,12,10,11,8,50,16.0,42,28,4,24,8,41,16,0,0,2018-2019,90.0,26.373626373626372,108.79120879120879
485,Amato Ciciretti,ITA,"FW,MF",Parma,Serie A,24,1993,1.5,1,0,1,0,0,0,0,0.0,0,3,0,3,3,4,0,0,0,2018-2019,90.0,180.0,60.0
486,Luca Cigarini,ITA,MF,Cagliari,Serie A,32,1986,18.7,54,33,27,22,5,28,63,44.4,35,28,5,23,26,80,41,0,0,2018-2019,90.0,125.13368983957218,259.89304812834223
487,Per Ciljan Skjelbred,NOR,MF,Hertha BSC,Bundesliga,31,1987,11.1,26,18,13,12,1,5,22,22.7,17,10,1,9,20,46,14,0,0,2018-2019,90.0,162.1621621621622,210.81081081081084
488,Jasper Cillessen,NED,GK,Barcelona,La Liga,29,1989,3.0,0,0,0,0,0,0,0,0.0,0,0,0,0,0,0,3,2,0,2018-2019,90.0,0.0,0.0
489,Laurent Ciman,BEL,DF,Dijon,Ligue 1,32,1985,8.0,11,6,9,2,0,7,16,43.8,9,13,9,4,7,18,37,0,0,2018-2019,90.0,78.75,123.75
490,Daniel Ciofani,ITA,FW,Frosinone,Serie A,33,1985,18.0,8,6,2,5,1,3,7,42.9,4,4,0,4,3,11,9,0,0,2018-2019,90.0,15.0,40.0
491,Thiago Cionek,POL,DF,SPAL,Serie A,32,1986,28.2,75,44,46,25,4,29,56,51.8,27,34,22,12,55,130,144,0,0,2018-2019,89.99999999999999,175.531914893617,239.36170212765956
492,Ibrahima Cissé,GUI,MF,Fulham,Premier League,24,1994,1.0,0,0,0,0,0,0,1,0.0,1,0,0,0,3,3,4,0,0,2018-2019,90.0,270.0,0.0
493,Till Cissokho,FRA,DF,Bordeaux,Ligue 1,18,2000,0.9,1,0,1,0,0,0,0,0.0,0,0,0,0,2,3,3,0,0,2018-2019,90.0,200.0,100.0
494,Ciaran Clark,IRL,DF,Newcastle Utd,Premier League,28,1989,9.5,20,17,15,5,0,9,12,75.0,3,11,7,4,12,32,58,0,0,2018-2019,90.0,113.6842105263158,189.47368421052633
495,Tom Cleverley,ENG,MF,Watford,Premier League,28,1989,5.3,17,9,11,4,2,6,22,27.3,16,4,0,4,5,22,11,0,0,2018-2019,90.0,84.9056603773585,288.6792452830189
496,Nathaniel Clyne,ENG,DF,Bournemouth,Premier League,27,1991,12.7,33,18,16,14,3,11,23,47.8,12,13,3,10,16,49,33,1,0,2018-2019,90.0,113.38582677165356,233.85826771653544
497,Nathaniel Clyne,ENG,DF,Liverpool,Premier League,27,1991,1.2,4,3,2,2,0,2,4,50.0,2,1,0,1,2,6,1,0,0,2018-2019,90.0,150.0,300.0
498,Conor Coady,ENG,DF,Wolves,Premier League,25,1993,38.0,31,19,26,5,0,17,32,53.1,15,35,27,8,30,61,133,3,0,2018-2019,90.0,71.05263157894737,73.42105263157895
499,Marcus Coco,FRA,"FW,MF",Guingamp,Ligue 1,22,1996,20.4,39,23,20,10,9,16,33,48.5,17,24,0,24,23,62,14,0,0,2018-2019,90.0,101.47058823529412,172.05882352941177
500,Coke,ESP,DF,Levante,La Liga,31,1987,20.2,44,27,24,17,3,26,56,46.4,30,18,8,10,40,84,54,1,0,2018-2019,90.0,178.21782178217822,196.03960396039605
Rk,Player,Nation,Pos,Squad,Comp,0,0,90.0,0,0,3,3,3,Tkl,0,0.0,0,0,0,0,0,0,0,0,0,2018-2019,90.0,0.0,0.0
501,Joel Coleman,ENG,GK,Huddersfield,Premier League,22,1995,1.0,0,0,0,0,0,0,0,0.0,0,0,0,0,0,0,0,0,0,2018-2019,90.0,0.0,0.0
502,Séamus Coleman,IRL,DF,Everton,Premier League,29,1988,28.4,44,25,23,18,3,19,30,63.3,11,14,5,9,26,70,86,0,0,2018-2019,90.0,82.3943661971831,139.43661971830986
503,Álex Collado,ESP,FW,Barcelona,La Liga,19,1999,0.9,1,0,0,1,0,0,1,0.0,1,3,0,3,0,1,2,0,0,2018-2019,90.0,0.0,100.0
504,Omar Colley,GAM,DF,Sampdoria,Serie A,25,1992,19.6,18,11,12,6,0,12,13,92.3,1,24,16,8,22,40,102,0,0,2018-2019,90.0,101.0204081632653,82.65306122448979
505,Racine Coly,SEN,"DF,MF",Nice,Ligue 1,22,1995,5.6,7,2,1,5,1,4,11,36.4,7,6,1,5,9,16,11,1,0,2018-2019,90.0,144.64285714285714,112.5
506,Kingsley Coman,FRA,"FW,MF",Bayern Munich,Bundesliga,22,1996,15.3,11,6,4,4,3,6,19,31.6,13,20,0,20,5,16,3,0,0,2018-2019,90.0,29.41176470588235,64.70588235294117
507,Santi Comesaña,ESP,MF,Rayo Vallecano,La Liga,21,1996,22.6,56,35,29,25,2,22,61,36.1,39,30,5,25,30,86,45,2,0,2018-2019,90.0,119.46902654867256,223.00884955752213
508,Daniel Congré,FRA,DF,Montpellier,Ligue 1,33,1985,36.6,75,45,46,26,3,38,65,58.5,27,35,15,20,67,142,106,1,0,2018-2019,90.0,164.75409836065575,184.4262295081967
509,Andrea Consigli,ITA,GK,Sassuolo,Serie A,31,1987,35.7,0,0,0,0,0,0,2,0.0,2,0,0,0,1,1,15,6,0,2018-2019,90.0,2.521008403361344,0.0
510,Andrea Conti,ITA,DF,Milan,Serie A,24,1994,5.6,9,5,3,4,2,2,9,22.2,7,4,0,4,15,24,12,1,0,2018-2019,90.0,241.07142857142858,144.64285714285714
511,Lewis Cook,ENG,MF,Bournemouth,Premier League,21,1997,8.0,13,6,6,7,0,8,19,42.1,11,8,2,6,8,21,7,1,0,2018-2019,90.0,90.0,146.25
512,Steve Cook,ENG,DF,Bournemouth,Premier League,27,1991,31.0,36,19,31,5,0,20,27,74.1,7,36,21,15,50,86,202,1,0,2018-2019,90.0,145.16129032258064,104.51612903225806
513,Duje Čop,CRO,FW,Valladolid,La Liga,28,1990,7.6,5,4,1,2,2,0,8,0.0,8,8,3,5,3,8,3,0,0,2018-2019,90.0,35.526315789473685,59.21052631578947
514,Francis Coquelin,FRA,MF,Valencia,La Liga,27,1991,19.6,46,31,25,14,7,17,35,48.6,18,21,5,16,49,95,29,1,0,2018-2019,90.0,224.99999999999997,211.22448979591834
515,Gabriele Corbo,ITA,DF,Bologna,Serie A,18,2000,0.1,0,0,0,0,0,0,0,0.0,0,0,0,0,0,0,0,0,0,2018-2019,90.0,0.0,0.0
516,Iñigo Córdoba,ESP,"FW,MF",Athletic Club,La Liga,21,1997,14.7,37,23,15,17,5,14,47,29.8,33,27,0,27,17,54,13,0,0,2018-2019,90.0,104.08163265306122,226.53061224489795
517,Sergio Córdova,VEN,FW,Augsburg,Bundesliga,20,1997,5.9,9,5,3,4,2,2,6,33.3,4,0,0,0,3,12,5,0,0,2018-2019,90.0,45.762711864406775,137.28813559322032
518,Benjamin Corgnet,FRA,"MF,FW",Strasbourg,Ligue 1,31,1987,7.5,21,12,7,9,5,4,11,36.4,7,1,0,1,6,27,9,0,0,2018-2019,90.0,72.0,252.0
519,Ante Ćorić,CRO,MF,Roma,Serie A,21,1997,0.3,0,0,0,0,0,0,0,0.0,0,0,0,0,0,0,0,0,0,2018-2019,90.0,0.0,0.0
520,Jack Cork,ENG,MF,Burnley,Premier League,29,1989,36.8,51,27,12,34,5,18,46,39.1,28,39,16,23,29,80,82,2,0,2018-2019,90.0,70.92391304347827,124.72826086956523
521,Andreas Cornelius,DEN,FW,Bordeaux,Ligue 1,25,1993,8.8,4,1,1,3,0,1,4,25.0,3,4,1,3,1,5,21,0,0,2018-2019,90.0,10.227272727272727,40.90909090909091
522,Maxwel Cornet,CIV,FW,Lyon,Ligue 1,21,1996,14.2,14,11,4,7,3,1,11,9.1,10,10,0,10,5,19,8,0,0,2018-2019,90.0,31.690140845070424,88.73239436619718
523,Quentin Cornette,FRA,"FW,MF",Amiens,Ligue 1,24,1994,2.3,5,1,2,2,1,3,6,50.0,3,3,0,3,1,6,5,0,0,2018-2019,90.0,39.130434782608695,195.6521739130435
524,Ángel Correa,ARG,"MF,FW",Atlético Madrid,La Liga,23,1995,21.3,38,19,19,12,7,10,53,18.9,43,28,5,23,17,55,20,0,0,2018-2019,90.0,71.83098591549296,160.56338028169014
525,Joaquín Correa,ARG,"FW,MF",Lazio,Serie A,23,1994,21.4,21,13,6,12,3,5,18,27.8,13,14,3,11,2,23,7,0,0,2018-2019,90.0,8.41121495327103,88.3177570093458
Rk,Player,Nation,Pos,Squad,Comp,0,0,90.0,0,0,3,3,3,Tkl,0,0.0,0,0,0,0,0,0,0,0,0,2018-2019,90.0,0.0,0.0
526,Danny da Costa,GER,"DF,FW",Eint Frankfurt,Bundesliga,25,1993,33.7,61,35,29,25,7,18,42,42.9,24,51,9,42,32,93,67,0,0,2018-2019,90.0,85.45994065281899,162.9080118694362
527,Diego Costa,ESP,FW,Atlético Madrid,La Liga,29,1988,12.4,4,1,0,4,0,1,8,12.5,7,5,0,5,2,6,6,0,0,2018-2019,90.0,14.516129032258064,29.032258064516128
528,Douglas Costa,BRA,"FW,MF",Juventus,Serie A,27,1990,6.9,10,8,2,8,0,4,9,44.4,5,8,0,8,4,14,2,0,0,2018-2019,90.0,52.17391304347826,130.43478260869563
529,Filippo Costa,ITA,"DF,FW",SPAL,Serie A,23,1995,6.3,15,13,6,6,3,4,9,44.4,5,10,3,7,8,23,31,1,0,2018-2019,90.0,114.28571428571429,214.2857142857143
530,Hélder Costa,ANG,"FW,MF",Wolves,Premier League,24,1994,14.9,18,14,7,7,4,7,23,30.4,16,15,0,15,9,27,6,0,0,2018-2019,90.0,54.36241610738254,108.72483221476509
531,Jaume Costa,ESP,DF,Villarreal,La Liga,30,1988,16.6,33,21,26,5,2,20,33,60.6,13,12,3,9,21,54,61,0,0,2018-2019,90.0,113.85542168674698,178.9156626506024
532,Nuno da Costa,CPV,FW,Strasbourg,Ligue 1,27,1991,22.8,39,27,10,19,10,10,38,26.3,28,24,1,23,14,53,9,0,0,2018-2019,90.0,55.263157894736835,153.94736842105263
533,David Costas,ESP,DF,Celta Vigo,La Liga,23,1995,13.0,25,13,21,4,0,10,15,66.7,5,12,6,6,18,43,58,1,0,2018-2019,90.00000000000001,124.61538461538463,173.0769230769231
534,Benoît Costil,FRA,GK,Bordeaux,Ligue 1,31,1987,37.0,2,0,2,0,0,2,2,100.0,0,0,0,0,0,2,14,3,0,2018-2019,90.0,0.0,4.864864864864865
535,Kalifa Coulibaly,MLI,FW,Nantes,Ligue 1,26,1991,19.5,15,7,1,10,4,4,11,36.4,7,8,1,7,4,19,22,0,0,2018-2019,90.0,18.46153846153846,69.23076923076923
536,Senou Coulibaly,MLI,DF,Dijon,Ligue 1,23,1994,4.6,13,7,10,3,0,3,8,37.5,5,8,2,6,11,24,20,0,0,2018-2019,90.0,215.21739130434784,254.34782608695653
537,Thibaut Courtois,BEL,GK,Real Madrid,La Liga,26,1992,27.0,0,0,0,0,0,0,2,0.0,2,0,0,0,2,2,5,0,0,2018-2019,90.0,6.666666666666667,0.0
538,Philippe Coutinho,BRA,"FW,MF",Barcelona,La Liga,26,1992,22.4,16,11,1,6,9,7,22,31.8,15,21,2,19,12,28,8,0,0,2018-2019,90.0,48.214285714285715,64.28571428571429
539,Nicolas Cozza,FRA,DF,Montpellier,Ligue 1,19,1999,10.9,19,15,14,5,0,4,10,40.0,6,13,10,3,23,42,37,1,0,2018-2019,90.0,189.90825688073394,156.88073394495413
540,Alessio Cragno,ITA,GK,Cagliari,Serie A,24,1994,38.0,0,0,0,0,0,0,1,0.0,1,0,0,0,2,2,19,1,0,2018-2019,90.0,4.7368421052631575,0.0
541,Aaron Cresswell,ENG,DF,West Ham,Premier League,28,1989,17.7,29,16,14,11,4,13,25,52.0,12,28,7,21,23,52,58,0,0,2018-2019,90.0,116.94915254237289,147.45762711864407
542,Domenico Criscito,ITA,DF,Genoa,Serie A,31,1986,34.1,111,75,64,36,11,57,83,68.7,26,40,11,29,70,181,142,0,0,2018-2019,90.0,184.7507331378299,292.96187683284455
543,Lorenzo Crisetig,ITA,MF,Frosinone,Serie A,25,1993,5.6,14,11,4,8,2,6,15,40.0,9,8,3,5,12,26,12,0,0,2018-2019,90.0,192.85714285714286,225.0
544,Bryan Cristante,ITA,MF,Roma,Serie A,23,1995,26.9,63,34,21,35,7,19,49,38.8,30,37,5,32,29,92,48,0,0,2018-2019,90.0,97.02602230483272,210.78066914498143
545,Sebastián Cristóforo,URU,MF,Getafe,La Liga,24,1993,5.0,15,8,4,8,3,5,14,35.7,9,13,0,13,8,23,5,0,0,2018-2019,90.0,144.0,270.0
546,Enzo Crivelli,FRA,FW,Caen,Ligue 1,23,1995,25.1,20,14,10,8,2,8,13,61.5,5,5,0,5,4,24,28,1,0,2018-2019,90.0,14.342629482071713,71.71314741035856
547,Peter Crouch,ENG,FW,Burnley,Premier League,37,1981,1.0,1,1,0,1,0,1,1,100.0,0,0,0,0,0,1,2,0,0,2018-2019,90.0,0.0,90.0
548,Alessio da Cruz,,"FW,MF",Parma,Serie A,21,1997,1.6,2,1,0,2,0,0,1,0.0,1,0,0,0,0,2,0,0,0,2018-2019,90.0,0.0,112.5
549,Juan Cuadrado,COL,"MF,DF",Juventus,Serie A,30,1988,13.6,20,15,6,9,5,5,23,21.7,18,14,3,11,18,38,11,0,0,2018-2019,90.0,119.11764705882352,132.35294117647058
550,Cucho,COL,FW,Huesca,La Liga,19,1999,23.9,22,13,6,10,6,6,18,33.3,12,23,2,21,9,31,21,0,0,2018-2019,90.0,33.89121338912134,82.84518828451883
Rk,Player,Nation,Pos,Squad,Comp,0,0,90.0,0,0,3,3,3,Tkl,0,0.0,0,0,0,0,0,0,0,0,0,2018-2019,90.0,0.0,0.0
551,Marc Cucurella,ESP,"MF,FW",Eibar,La Liga,20,1998,26.2,49,37,13,21,15,10,23,43.5,13,36,3,33,20,69,24,0,0,2018-2019,90.0,68.70229007633588,168.3206106870229
552,Iván Cuéllar,ESP,GK,Leganés,La Liga,34,1984,33.9,0,0,0,0,0,0,1,0.0,1,0,0,0,2,2,10,0,0,2018-2019,90.0,5.3097345132743365,0.0
553,Mickaël Cuisance,FRA,MF,Gladbach,Bundesliga,18,1999,3.1,11,6,6,3,2,3,8,37.5,5,3,0,3,5,16,4,0,0,2018-2019,90.0,145.16129032258064,319.35483870967744
554,Matheus Cunha,BRA,"FW,MF",RB Leipzig,Bundesliga,19,1999,9.5,10,6,3,5,2,3,13,23.1,10,13,1,12,4,14,8,0,0,2018-2019,90.0,37.89473684210526,94.73684210526316
555,Greg Cunningham,IRL,DF,Cardiff City,Premier League,27,1991,7.0,18,7,11,4,3,9,16,56.3,7,9,3,6,17,35,16,1,0,2018-2019,90.0,218.57142857142856,231.42857142857142
556,Patrick Cutrone,ITA,FW,Milan,Serie A,20,1998,16.2,9,5,0,3,6,2,16,12.5,14,13,2,11,7,16,13,0,0,2018-2019,90.0,38.88888888888889,50.0
557,Wylan Cyprien,FRA,MF,Nice,Ligue 1,23,1995,26.2,40,20,16,21,3,15,43,34.9,28,20,5,15,11,51,15,0,0,2018-2019,90.0,37.786259541984734,137.40458015267177
558,Marco D'Alessandro,ITA,DF,Udinese,Serie A,27,1991,16.6,55,34,34,15,6,29,49,59.2,20,24,2,22,9,64,50,1,0,2018-2019,90.0,48.79518072289156,298.1927710843373
559,Danilo D'Ambrosio,ITA,DF,Inter,Serie A,29,1988,28.7,69,40,34,27,8,24,57,42.1,33,25,8,17,27,96,39,0,0,2018-2019,90.0,84.66898954703832,216.37630662020905
560,Damien Da Silva,FRA,DF,Rennes,Ligue 1,30,1988,31.9,41,25,31,9,1,18,24,75.0,6,42,36,6,39,80,152,0,0,2018-2019,90.0,110.03134796238244,115.67398119122257
561,Kouadio-Yves Dabila,CIV,DF,Lille,Ligue 1,21,1997,8.7,11,6,10,1,0,5,6,83.3,1,13,9,4,6,17,44,0,0,2018-2019,90.0,62.06896551724138,113.79310344827586
562,Abdoulaye Dabo,FRA,FW,Nantes,Ligue 1,17,2001,1.3,3,1,1,0,2,0,0,0.0,0,0,0,0,0,3,0,0,0,2018-2019,90.0,0.0,207.69230769230768
563,Bryan Dabo,BFA,"MF,DF",Fiorentina,Serie A,26,1992,9.2,10,6,1,8,1,1,6,16.7,5,11,6,5,10,20,21,0,0,2018-2019,90.0,97.82608695652175,97.82608695652175
564,Christoph Daferner,GER,FW,Freiburg,Bundesliga,20,1998,0.3,1,0,1,0,0,0,0,0.0,0,0,0,0,1,2,0,0,0,2018-2019,90.0,300.0,300.0
565,Colin Dagba,FRA,"DF,MF",Paris S-G,Ligue 1,19,1998,10.2,24,12,10,12,2,13,19,68.4,6,10,0,10,9,33,10,1,0,2018-2019,90.0,79.41176470588236,211.76470588235296
566,Mahmoud Dahoud,GER,MF,Dortmund,Bundesliga,22,1996,7.7,16,10,4,10,2,3,15,20.0,12,10,0,10,17,33,8,0,0,2018-2019,90.0,198.7012987012987,187.01298701298703
567,Leon Dajaku,GER,"DF,MF",Stuttgart,Bundesliga,17,2001,0.3,2,1,0,1,1,0,0,0.0,0,1,0,1,0,2,0,0,0,2018-2019,90.0,0.0,600.0
568,Felipe dal Belo,BRA,DF,SPAL,Serie A,34,1984,26.2,36,25,21,13,2,16,32,50.0,16,29,18,11,17,53,88,1,0,2018-2019,90.0,58.396946564885496,123.66412213740459
569,Nicola Dalmonte,ITA,"FW,MF",Genoa,Serie A,20,1997,0.5,2,2,0,2,0,0,0,0.0,0,0,0,0,0,2,0,0,0,2018-2019,90.0,0.0,360.0
570,Diogo Dalot,POR,"DF,FW",Manchester Utd,Premier League,19,1999,11.3,24,12,8,14,2,14,19,73.7,5,15,2,13,10,34,35,1,0,2018-2019,90.0,79.64601769911505,191.1504424778761
571,Matty Daly,ENG,MF,Huddersfield,Premier League,17,2001,0.8,0,0,0,0,0,0,0,0.0,0,0,0,0,0,0,0,0,0,2018-2019,90.0,0.0,0.0
572,Vitalie Damașcan,MDA,MF,Torino,Serie A,19,1999,0.0,1,1,0,1,0,1,1,100.0,0,0,0,0,0,1,0,0,0,2018-2019,,,inf
573,Loïc Damour,FRA,MF,Cardiff City,Premier League,27,1991,0.3,0,0,0,0,0,0,1,0.0,1,0,0,0,0,0,0,0,0,2018-2019,90.0,0.0,0.0
574,Charlie Daniels,ENG,DF,Bournemouth,Premier League,31,1986,17.6,25,15,18,6,1,13,22,59.1,9,14,4,10,20,45,56,2,0,2018-2019,90.0,102.27272727272727,127.84090909090908
575,Danilo,BRA,DF,Manchester City,Premier League,27,1991,9.0,20,16,6,12,2,12,17,70.6,5,5,0,5,15,35,22,1,0,2018-2019,90.0,150.0,200.0
Rk,Player,Nation,Pos,Squad,Comp,0,0,90.0,0,0,3,3,3,Tkl,0,0.0,0,0,0,0,0,0,0,0,0,2018-2019,90.0,0.0,0.0
576,Scott Dann,ENG,DF,Crystal Palace,Premier League,31,1987,7.4,6,2,5,1,0,3,7,42.9,4,16,12,4,5,11,46,0,0,2018-2019,90.0,60.81081081081081,72.97297297297297
577,Kevin Danso,AUT,DF,Augsburg,Bundesliga,19,1998,13.9,25,14,21,3,1,11,14,78.6,3,25,17,8,19,44,72,0,0,2018-2019,90.0,123.02158273381295,161.8705035971223
578,Dante,BRA,DF,Nice,Ligue 1,34,1983,35.8,54,40,36,16,2,24,41,58.5,17,56,30,26,38,92,156,2,0,2018-2019,90.0,95.53072625698326,135.75418994413408
579,Palkó Dárdai,HUN,"FW,MF",Hertha BSC,Bundesliga,19,1999,1.3,1,1,1,0,0,0,0,0.0,0,1,0,1,0,1,0,0,0,2018-2019,90.0,0.0,69.23076923076923
580,Sergi Darder,ESP,MF,Espanyol,La Liga,24,1993,30.1,60,35,23,32,5,25,69,36.2,44,18,3,15,22,82,30,0,0,2018-2019,90.00000000000001,65.78073089700997,179.40199335548172
581,Vladimír Darida,CZE,MF,Hertha BSC,Bundesliga,27,1990,4.2,8,5,3,4,1,2,3,66.7,1,5,0,5,8,16,5,0,0,2018-2019,90.0,171.42857142857142,171.42857142857142
582,Matteo Darmian,ITA,DF,Manchester Utd,Premier League,28,1989,4.9,14,8,10,4,0,4,11,36.4,7,9,0,9,7,21,20,0,0,2018-2019,90.0,128.57142857142856,257.1428571428571
583,Alphonso Davies,CAN,"MF,FW",Bayern Munich,Bundesliga,17,2000,0.9,1,1,1,0,0,0,0,0.0,0,2,0,2,2,3,1,0,0,2018-2019,90.0,200.0,100.0
584,Ben Davies,WAL,DF,Tottenham,Premier League,25,1993,20.5,56,30,39,13,4,38,54,70.4,16,23,10,13,23,79,68,1,0,2018-2019,90.0,100.97560975609757,245.85365853658536
585,Tom Davies,ENG,MF,Everton,Premier League,20,1998,10.9,27,17,9,17,1,7,23,30.4,16,15,1,14,16,43,9,1,0,2018-2019,90.0,132.11009174311926,222.93577981651376
586,Steven Davis,NIR,MF,Southampton,Premier League,33,1985,1.1,2,2,0,2,0,0,0,0.0,0,2,0,2,1,3,5,0,0,2018-2019,90.0,81.81818181818181,163.63636363636363
587,Kevin De Bruyne,BEL,MF,Manchester City,Premier League,27,1991,10.8,22,15,6,12,4,7,21,33.3,14,13,1,12,3,25,2,1,0,2018-2019,90.0,24.999999999999996,183.33333333333331
588,Sebastien De Maio,FRA,DF,Udinese,Serie A,31,1987,13.0,11,7,7,4,0,3,12,25.0,9,22,17,5,12,23,93,0,0,2018-2019,90.00000000000001,83.07692307692308,76.15384615384616
589,Sebastien De Maio,FRA,DF,Bologna,Serie A,31,1987,5.5,5,4,3,2,0,1,2,50.0,1,8,5,3,1,6,32,0,0,2018-2019,90.0,16.363636363636363,81.81818181818183
590,Rodrigo De Paul,ARG,"MF,FW",Udinese,Serie A,24,1994,35.4,53,33,21,27,5,13,42,31.0,29,35,2,33,32,85,28,0,0,2018-2019,90.0,81.35593220338984,134.74576271186442
591,Daniele De Rossi,ITA,MF,Roma,Serie A,35,1983,14.1,16,10,6,7,3,3,14,21.4,11,18,12,6,26,42,33,0,0,2018-2019,89.99999999999999,165.95744680851064,102.12765957446808
592,Mattia De Sciglio,ITA,DF,Juventus,Serie A,25,1992,19.4,40,28,24,14,2,17,28,60.7,11,18,6,12,26,66,58,1,0,2018-2019,90.0,120.61855670103094,185.56701030927837
593,Lorenzo De Silvestri,ITA,DF,Torino,Serie A,30,1988,26.8,15,11,8,5,2,7,24,29.2,17,53,3,50,22,37,69,2,0,2018-2019,90.0,73.88059701492537,50.373134328358205
594,Lucas Deaux,FRA,MF,Guingamp,Ligue 1,29,1988,13.2,41,28,21,18,2,20,41,48.8,21,10,0,10,11,52,7,0,0,2018-2019,90.0,75.0,279.54545454545456
595,Mathieu Debuchy,FRA,DF,Saint-Étienne,Ligue 1,33,1985,21.6,43,26,25,13,5,22,37,59.5,15,17,7,10,47,90,64,0,0,2018-2019,90.0,195.83333333333331,179.16666666666666
596,Troy Deeney,ENG,FW,Watford,Premier League,30,1988,28.3,24,14,8,10,6,7,32,21.9,25,22,4,18,7,31,29,0,0,2018-2019,90.0,22.261484098939928,76.3250883392226
597,Jermain Defoe,ENG,FW,Bournemouth,Premier League,35,1982,0.3,0,0,0,0,0,0,0,0.0,0,0,0,0,0,0,0,0,0,2018-2019,90.0,0.0,0.0
598,Steven Defour,BEL,MF,Burnley,Premier League,30,1988,5.0,8,4,2,4,2,3,14,21.4,11,11,3,8,8,16,7,0,0,2018-2019,90.0,144.0,144.0
599,Grégoire Defrel,MTQ,"FW,MF",Sampdoria,Serie A,27,1991,26.0,40,29,10,16,14,9,21,42.9,12,15,0,15,3,43,9,0,0,2018-2019,90.00000000000001,10.384615384615385,138.46153846153848
600,Alessandro Deiola,ITA,MF,Cagliari,Serie A,22,1995,5.0,7,3,1,6,0,3,13,23.1,10,14,0,14,6,13,8,0,0,2018-2019,90.0,108.0,126.0
Rk,Player,Nation,Pos,Squad,Comp,0,0,90.0,0,0,3,3,3,Tkl,0,0.0,0,0,0,0,0,0,0,0,0,2018-2019,90.0,0.0,0.0
601,Alessandro Deiola,ITA,"MF,FW",Parma,Serie A,22,1995,6.1,12,8,4,7,1,4,10,40.0,6,15,4,11,11,23,10,0,0,2018-2019,90.0,162.29508196721312,177.04918032786887
602,Romain Del Castillo,FRA,"MF,FW",Rennes,Ligue 1,22,1996,14.9,36,20,15,13,8,13,37,35.1,24,19,0,19,20,56,7,1,0,2018-2019,90.0,120.80536912751677,217.44966442953017
603,Thomas Delaney,DEN,MF,Dortmund,Bundesliga,26,1991,25.4,69,54,28,39,2,19,30,63.3,11,30,9,21,58,127,43,0,0,2018-2019,90.0,205.51181102362204,244.48818897637796
604,Moisés Delgado,ESP,DF,Valladolid,La Liga,24,1994,3.0,7,6,3,3,1,2,3,66.7,1,2,1,1,3,10,9,0,0,2018-2019,90.0,90.0,210.0
605,Cristian Dell'Orco,ITA,DF,Empoli,Serie A,24,1994,11.5,18,11,11,5,2,4,11,36.4,7,13,7,6,17,35,44,0,0,2018-2019,90.0,133.04347826086956,140.8695652173913
606,Cristian Dell'Orco,ITA,DF,Sassuolo,Serie A,24,1994,1.2,1,1,1,0,0,1,3,33.3,2,1,0,1,1,2,3,0,0,2018-2019,90.0,75.0,75.0
607,Andy Delort,ALG,FW,Montpellier,Ligue 1,26,1991,34.6,34,20,7,20,7,8,34,23.5,26,28,7,21,4,38,7,0,0,2018-2019,90.0,10.404624277456646,88.4393063583815
608,Fabian Delph,ENG,DF,Manchester City,Premier League,28,1989,8.1,23,14,11,7,5,12,23,52.2,11,3,0,3,13,36,19,1,0,2018-2019,90.0,144.44444444444446,255.55555555555557
609,Mousa Dembélé,BEL,MF,Tottenham,Premier League,31,1987,5.7,13,9,6,6,1,4,7,57.1,3,4,1,3,7,20,5,2,0,2018-2019,90.0,110.52631578947367,205.26315789473682
610,Moussa Dembélé,FRA,FW,Lyon,Ligue 1,22,1996,22.4,12,4,0,8,4,4,14,28.6,10,15,2,13,2,14,13,0,0,2018-2019,90.0,8.035714285714286,48.214285714285715
611,Ousmane Dembélé,FRA,"FW,MF",Barcelona,La Liga,21,1997,18.5,23,15,4,13,6,6,18,33.3,12,13,0,13,5,28,4,0,0,2018-2019,90.0,24.324324324324326,111.8918918918919
612,Jessy Deminguet,FRA,MF,Caen,Ligue 1,20,1998,14.1,37,25,18,17,2,15,40,37.5,25,19,3,16,18,55,28,1,0,2018-2019,89.99999999999999,114.89361702127658,236.17021276595744
613,Merih Demiral,TUR,DF,Sassuolo,Serie A,20,1998,14.0,24,16,23,1,0,10,13,76.9,3,16,11,5,19,43,80,0,0,2018-2019,90.0,122.14285714285714,154.28571428571428
614,Kerem Demirbay,GER,MF,Hoffenheim,Bundesliga,25,1993,22.4,57,35,20,27,10,11,51,21.6,40,34,10,24,22,79,25,0,0,2018-2019,90.0,88.39285714285714,229.01785714285714
615,Diego Demme,GER,MF,RB Leipzig,Bundesliga,26,1991,22.8,75,47,24,43,8,33,67,49.3,34,36,3,33,26,101,15,0,0,2018-2019,90.0,102.63157894736841,296.05263157894734
616,Jason Denayer,BEL,DF,Lyon,Ligue 1,23,1995,30.6,33,21,22,11,0,16,24,66.7,8,36,32,4,26,59,122,1,0,2018-2019,90.0,76.47058823529412,97.05882352941175
617,Leander Dendoncker,BEL,MF,Wolves,Premier League,23,1995,16.3,53,26,25,25,3,16,47,34.0,31,35,6,29,23,76,34,1,0,2018-2019,90.0,126.99386503067484,292.63803680981596
618,Fabio Depaoli,ITA,DF,Chievo,Serie A,21,1997,27.4,74,43,37,32,5,34,67,50.7,33,42,16,26,35,109,99,3,0,2018-2019,90.0,114.96350364963504,243.06569343065698
619,Laurent Depoitre,BEL,FW,Huddersfield,Premier League,29,1988,11.9,6,4,2,3,1,0,3,0.0,3,9,0,9,2,8,8,0,0,2018-2019,90.00000000000001,15.126050420168069,45.378151260504204
620,Clément Depres,FRA,FW,Nîmes,Ligue 1,23,1994,4.9,2,2,1,1,0,1,4,25.0,3,3,0,3,0,2,6,0,0,2018-2019,90.0,0.0,36.73469387755102
621,Kiril Despodov,BUL,"FW,MF",Cagliari,Serie A,21,1996,1.2,0,0,0,0,0,0,1,0.0,1,1,0,1,0,0,0,0,0,2018-2019,90.0,0.0,0.0
622,Daniele Dessena,ITA,MF,Cagliari,Serie A,31,1987,3.9,2,2,0,2,0,1,3,33.3,2,3,1,2,3,5,5,0,0,2018-2019,90.0,69.23076923076923,46.15384615384615
623,Mattia Destro,ITA,FW,Bologna,Serie A,27,1991,5.5,3,2,2,0,1,0,0,0.0,0,4,0,4,0,3,6,0,0,2018-2019,90.0,0.0,49.09090909090909
624,Gerard Deulofeu,ESP,"FW,MF",Watford,Premier League,24,1994,23.0,11,6,5,3,3,4,26,15.4,22,16,0,16,14,25,3,0,0,2018-2019,90.0,54.78260869565218,43.04347826086957
625,Jacopo Dezi,ITA,MF,Parma,Serie A,26,1992,1.0,1,1,1,0,0,0,1,0.0,1,1,0,1,3,4,2,0,0,2018-2019,90.0,270.0,90.0
Rk,Player,Nation,Pos,Squad,Comp,0,0,90.0,0,0,3,3,3,Tkl,0,0.0,0,0,0,0,0,0,0,0,0,2018-2019,90.0,0.0,0.0
626,Federico Di Francesco,ITA,"FW,MF",Sassuolo,Serie A,24,1994,11.9,10,6,3,4,3,4,7,57.1,3,12,1,11,5,15,5,0,0,2018-2019,90.00000000000001,37.81512605042017,75.63025210084034
627,Antonio Di Gaudio,ITA,FW,Parma,Serie A,28,1989,7.8,2,0,0,1,1,1,5,20.0,4,6,1,5,3,5,5,0,0,2018-2019,90.0,34.61538461538461,23.076923076923077
628,Giovanni Di Lorenzo,ITA,"DF,FW",Empoli,Serie A,24,1993,37.0,66,43,38,23,5,24,44,54.5,20,34,13,21,36,102,93,3,0,2018-2019,90.0,87.56756756756756,160.54054054054055
629,Ángel Di María,ARG,"FW,MF",Paris S-G,Ligue 1,30,1988,25.8,29,17,12,10,7,10,42,23.8,32,24,1,23,16,45,4,0,0,2018-2019,90.0,55.81395348837209,101.16279069767441
630,Franco Di Santo,ARG,FW,Rayo Vallecano,La Liga,29,1989,1.9,2,2,1,0,1,1,2,50.0,1,0,0,0,0,2,2,0,0,2018-2019,90.0,0.0,94.73684210526315
631,Franco Di Santo,ARG,"MF,FW",Schalke 04,Bundesliga,29,1989,2.7,2,1,0,2,0,1,4,25.0,3,3,1,2,1,3,3,0,0,2018-2019,90.0,33.33333333333333,66.66666666666666
632,Boulaye Dia,SEN,FW,Reims,Ligue 1,21,1996,8.3,12,6,3,8,1,5,11,45.5,6,4,2,2,4,16,9,0,0,2018-2019,90.0,43.37349397590361,130.12048192771084
633,Fousseni Diabaté,MLI,FW,Leicester City,Premier League,22,1995,0.6,2,0,2,0,0,0,1,0.0,1,2,0,2,0,2,0,0,0,2018-2019,90.0,0.0,300.0
634,Moussa Diaby,FRA,"MF,DF",Paris S-G,Ligue 1,19,1999,12.7,14,8,7,2,5,2,11,18.2,9,7,1,6,12,26,6,0,0,2018-2019,90.0,85.03937007874016,99.21259842519686
635,Adama Diakhaby,FRA,"FW,MF",Huddersfield,Premier League,22,1996,6.1,6,3,4,1,1,3,11,27.3,8,7,0,7,1,7,2,0,0,2018-2019,90.0,14.754098360655739,88.52459016393443
636,Mouctar Diakhaby,GUI,DF,Valencia,La Liga,21,1996,17.6,14,8,10,4,0,5,10,50.0,5,24,16,8,20,34,94,1,0,2018-2019,90.0,102.27272727272727,71.5909090909091
637,Bafodé Diakité,FRA,DF,Toulouse,Ligue 1,17,2001,7.0,15,7,5,9,1,10,14,71.4,4,15,3,12,11,26,29,0,0,2018-2019,90.0,141.42857142857142,192.85714285714286
638,Abdou Diallo,SEN,DF,Dortmund,Bundesliga,22,1996,26.4,36,20,20,13,3,11,15,73.3,4,28,15,13,26,62,91,1,0,2018-2019,90.0,88.63636363636364,122.72727272727273
639,Abdoulaye Diallo,SEN,GK,Rennes,Ligue 1,26,1992,5.5,1,1,1,0,0,1,1,100.0,0,0,0,0,0,1,1,0,0,2018-2019,90.0,0.0,16.363636363636363
640,Mustapha Diallo,SEN,MF,Nîmes,Ligue 1,32,1986,5.1,16,11,6,9,1,5,13,38.5,8,7,1,6,10,26,14,1,0,2018-2019,90.0,176.47058823529412,282.3529411764706
641,Mohamed Diamé,SEN,MF,Newcastle Utd,Premier League,31,1987,24.1,76,46,35,36,5,16,54,29.6,38,42,9,33,30,106,39,1,0,2018-2019,90.0,112.03319502074689,283.81742738589213
642,Grady Diangana,COD,"MF,FW",West Ham,Premier League,20,1998,6.8,20,9,8,8,4,5,14,35.7,9,11,0,11,1,21,4,0,0,2018-2019,90.0,13.235294117647058,264.70588235294116
643,Lassana Diarra,FRA,MF,Paris S-G,Ligue 1,33,1985,1.8,2,1,0,2,0,0,1,0.0,1,0,0,0,2,4,3,0,0,2018-2019,90.0,100.0,100.0
644,Amadou Diawara,GUI,MF,Napoli,Serie A,21,1997,7.3,12,4,1,9,2,4,5,80.0,1,6,0,6,11,23,12,0,0,2018-2019,90.0,135.6164383561644,147.94520547945206
645,Brahim Díaz,MAR,FW,Real Madrid,La Liga,18,1999,4.2,9,7,5,4,0,3,8,37.5,5,2,0,2,0,9,0,0,0,2018-2019,90.0,0.0,192.85714285714286
646,Javier Díaz,ESP,GK,Sevilla,La Liga,21,1997,1.0,0,0,0,0,0,0,0,0.0,0,0,0,0,0,0,0,0,0,2018-2019,90.0,0.0,0.0
647,Bakaye Dibassy,MLI,DF,Amiens,Ligue 1,28,1989,32.7,38,26,18,16,4,18,27,66.7,9,40,21,19,44,82,102,0,0,2018-2019,90.0,121.10091743119266,104.58715596330275
648,Lorenzo Dickmann,ITA,"DF,MF",SPAL,Serie A,21,1996,1.9,5,4,4,1,0,5,7,71.4,2,0,0,0,1,6,5,0,0,2018-2019,90.0,47.368421052631575,236.8421052631579
649,Daniel Didavi,GER,"MF,FW",Stuttgart,Bundesliga,28,1990,10.6,21,15,8,10,3,7,20,35.0,13,11,1,10,4,25,5,0,0,2018-2019,90.0,33.9622641509434,178.30188679245285
650,Étienne Didot,FRA,MF,Guingamp,Ligue 1,35,1983,23.4,41,29,12,27,2,17,44,38.6,27,37,10,27,37,78,35,0,0,2018-2019,89.99999999999999,142.3076923076923,157.69230769230768
Rk,Player,Nation,Pos,Squad,Comp,0,0,90.0,0,0,3,3,3,Tkl,0,0.0,0,0,0,0,0,0,0,0,0,2018-2019,90.0,0.0,0.0
651,Adrián Diéguez,ESP,DF,Huesca,La Liga,22,1996,8.3,16,10,11,4,1,9,16,56.3,7,9,4,5,12,28,46,1,0,2018-2019,90.0,130.12048192771084,173.49397590361443
652,Eric Dier,ENG,"MF,DF",Tottenham,Premier League,24,1994,16.7,26,16,7,15,4,19,47,40.4,28,27,12,15,21,47,46,1,0,2018-2019,90.0,113.17365269461078,140.11976047904193
653,Tim Dierßen,GER,MF,Hannover 96,Bundesliga,22,1996,0.2,0,0,0,0,0,0,0,0.0,0,1,0,1,0,0,0,0,0,2018-2019,90.0,0.0,0.0
654,Lucas Digne,FRA,DF,Everton,Premier League,25,1993,32.9,71,46,45,18,8,28,45,62.2,17,43,9,34,60,131,116,0,0,2018-2019,90.0,164.13373860182372,194.22492401215808
655,Mitchell Dijks,NED,DF,Bologna,Serie A,25,1993,22.5,30,18,19,7,4,13,36,36.1,23,18,1,17,23,53,49,0,0,2018-2019,90.0,92.0,120.0
656,Javairô Dilrosun,NED,"FW,MF",Hertha BSC,Bundesliga,20,1998,10.0,14,10,7,5,2,3,7,42.9,4,18,2,16,7,21,9,0,0,2018-2019,90.0,63.0,126.0
657,Federico Dimarco,ITA,"DF,MF",Parma,Serie A,20,1997,9.9,22,7,10,8,4,10,20,50.0,10,13,6,7,15,37,27,0,0,2018-2019,90.0,136.36363636363637,200.0
658,Stole Dimitrievski,MKD,GK,Rayo Vallecano,La Liga,24,1993,21.0,0,0,0,0,0,0,1,0.0,1,0,0,0,0,0,8,1,0,2018-2019,90.0,0.0,0.0
659,Tristan Dingomé,CMR,MF,Reims,Ligue 1,27,1991,14.9,27,15,11,10,6,7,24,29.2,17,16,3,13,11,38,5,0,0,2018-2019,90.0,66.44295302013423,163.08724832214764
660,Ismaël Diomandé,CIV,"MF,DF",Caen,Ligue 1,25,1992,14.4,28,15,15,12,1,11,20,55.0,9,17,7,10,10,38,37,0,0,2018-2019,90.0,62.5,175.0
661,Federico Dionisi,ITA,"FW,MF",Frosinone,Serie A,31,1987,2.3,3,1,0,2,1,0,2,0.0,2,0,0,0,0,3,0,0,0,2018-2019,90.0,0.0,117.3913043478261
662,Lois Diony,FRA,FW,Saint-Étienne,Ligue 1,25,1992,17.7,17,12,3,9,5,4,10,40.0,6,14,0,14,1,18,9,0,0,2018-2019,90.0,5.084745762711865,86.4406779661017
663,Issa Diop,FRA,DF,West Ham,Premier League,21,1997,33.0,68,38,47,21,0,37,57,64.9,20,58,36,22,64,132,161,4,0,2018-2019,90.0,174.54545454545456,185.45454545454547
664,Papakouli Diop,SEN,MF,Eibar,La Liga,32,1986,26.1,66,40,14,44,8,14,34,41.2,20,21,1,20,37,103,27,0,0,2018-2019,90.0,127.58620689655172,227.5862068965517
665,Sofiane Diop,FRA,"MF,FW",Monaco,Ligue 1,18,2000,8.2,12,7,3,6,3,1,15,6.7,14,6,0,6,8,20,6,0,0,2018-2019,90.0,87.8048780487805,131.70731707317074
666,Assane Dioussé,SEN,MF,Chievo,Serie A,20,1997,9.9,24,16,11,8,5,10,23,43.5,13,14,4,10,19,43,13,2,0,2018-2019,90.0,172.72727272727272,218.1818181818182
667,Assane Dioussé,SEN,MF,Saint-Étienne,Ligue 1,20,1997,2.4,6,4,3,3,0,2,4,50.0,2,2,0,2,1,7,7,1,0,2018-2019,90.0,37.5,225.00000000000003
668,Axel Disasi,FRA,DF,Reims,Ligue 1,20,1998,1.8,2,1,1,1,0,1,2,50.0,1,2,1,1,2,4,16,0,0,2018-2019,90.0,100.0,100.0
669,Djené,TOG,DF,Getafe,La Liga,26,1991,33.1,54,34,43,11,0,26,43,60.5,17,27,11,16,74,128,154,3,0,2018-2019,90.0,201.2084592145015,146.82779456193353
670,Koffi Djidji,CIV,DF,Torino,Serie A,25,1992,15.4,37,23,27,9,1,12,20,60.0,8,26,19,7,24,61,72,1,0,2018-2019,90.0,140.25974025974025,216.23376623376623
671,Koffi Djidji,CIV,DF,Nantes,Ligue 1,25,1992,1.0,1,1,1,0,0,0,0,0.0,0,1,1,0,1,2,3,0,0,2018-2019,90.0,90.0,90.0
672,Alexander Djiku,GHA,DF,Caen,Ligue 1,23,1994,30.6,48,37,33,13,2,23,43,53.5,20,56,31,25,83,131,183,3,0,2018-2019,90.0,244.1176470588235,141.17647058823528
673,Papy Djilobodji,SEN,DF,Guingamp,Ligue 1,29,1988,1.9,1,1,1,0,0,0,0,0.0,0,4,2,2,0,1,11,0,0,2018-2019,90.0,0.0,47.368421052631575
674,Berat Djimsiti,ALB,DF,Atalanta,Serie A,25,1993,20.1,32,22,18,12,2,13,29,44.8,16,21,11,10,34,66,96,0,0,2018-2019,90.0,152.23880597014923,143.28358208955223
675,Johan Djourou,SUI,DF,SPAL,Serie A,31,1987,3.1,3,1,3,0,0,2,2,100.0,0,5,3,2,4,7,20,0,0,2018-2019,90.0,116.12903225806451,87.09677419354838
Rk,Player,Nation,Pos,Squad,Comp,0,0,90.0,0,0,3,3,3,Tkl,0,0.0,0,0,0,0,0,0,0,0,0,2018-2019,90.0,0.0,0.0
676,Marko Dmitrović,SRB,GK,Eibar,La Liga,26,1992,24.0,0,0,0,0,0,0,0,0.0,0,0,0,0,2,2,11,3,0,2018-2019,90.0,7.5,0.0
677,Matt Doherty,IRL,"DF,MF",Wolves,Premier League,26,1992,34.9,67,42,48,15,4,35,58,60.3,23,49,7,42,60,127,107,2,0,2018-2019,90.0,154.72779369627509,172.77936962750715
678,Keagan Dolly,RSA,FW,Montpellier,Ligue 1,25,1993,1.0,1,1,0,1,0,0,3,0.0,3,0,0,0,0,1,0,0,0,2018-2019,90.0,0.0,90.0
679,Jaume Doménech,ESP,GK,Valencia,La Liga,27,1990,4.0,0,0,0,0,0,0,1,0.0,1,0,0,0,0,0,1,0,0,2018-2019,90.0,0.0,0.0
680,Giulio Donati,ITA,DF,Mainz 05,Bundesliga,28,1990,6.9,9,7,6,3,0,8,10,80.0,2,5,3,2,16,25,24,0,0,2018-2019,90.0,208.69565217391303,117.39130434782608
681,Ji Dong-won,KOR,"MF,FW",Augsburg,Bundesliga,27,1991,9.9,10,6,5,3,2,6,16,37.5,10,13,2,11,8,18,10,0,0,2018-2019,90.0,72.72727272727273,90.9090909090909
682,Anastasios Donis,GRE,"FW,MF",Stuttgart,Bundesliga,21,1996,10.7,15,13,8,4,3,3,11,27.3,8,7,0,7,4,19,0,0,0,2018-2019,90.0,33.64485981308412,126.16822429906543
683,Gianluigi Donnarumma,ITA,GK,Milan,Serie A,19,1999,34.3,1,1,1,0,0,1,2,50.0,1,0,0,0,1,2,13,3,0,2018-2019,90.0,2.623906705539359,2.623906705539359
684,Godfred Donsah,GHA,MF,Bologna,Serie A,22,1996,1.7,3,1,3,0,0,3,5,60.0,2,4,2,2,0,3,7,0,0,2018-2019,90.0,0.0,158.8235294117647
685,Riccardo Doratiotto,ITA,FW,Cagliari,Serie A,19,1999,0.9,1,1,0,0,1,0,0,0.0,0,0,0,0,0,1,0,0,0,2018-2019,90.0,0.0,100.0
686,Mathieu Dossevi,TOG,"FW,MF",Toulouse,Ligue 1,30,1988,27.4,42,28,20,11,11,13,40,32.5,27,29,1,28,33,75,13,0,0,2018-2019,90.0,108.39416058394161,137.95620437956205
687,Abdoulaye Doucouré,MLI,MF,Watford,Premier League,25,1993,34.0,71,38,27,32,12,19,57,33.3,38,31,8,23,34,105,55,5,0,2018-2019,90.0,90.0,187.94117647058823
688,Cheick Doukouré,CIV,MF,Levante,La Liga,25,1992,3.5,13,7,3,7,3,4,15,26.7,11,10,2,8,3,16,3,1,0,2018-2019,90.0,77.14285714285714,334.2857142857143
689,Moussa Doumbia,MLI,"FW,MF",Reims,Ligue 1,23,1994,17.8,28,13,13,13,2,11,39,28.2,28,7,2,5,7,35,13,0,0,2018-2019,90.0,35.39325842696629,141.57303370786516
690,Seydou Doumbia,CIV,FW,Girona,La Liga,30,1987,6.0,5,1,1,2,2,0,2,0.0,2,2,0,2,3,8,1,0,0,2018-2019,90.0,45.0,75.0
691,Souleyman Doumbia,CIV,DF,Rennes,Ligue 1,21,1996,6.7,11,7,9,2,0,6,10,60.0,4,6,1,5,4,15,20,0,0,2018-2019,90.0,53.731343283582085,147.76119402985074
692,Aleksandar Dragović,AUT,DF,Leverkusen,Bundesliga,27,1991,14.8,18,12,14,4,0,9,14,64.3,5,15,8,7,25,43,66,0,0,2018-2019,90.0,152.02702702702703,109.45945945945945
693,Bartłomiej Drągowski,POL,GK,Fiorentina,Serie A,20,1997,2.5,0,0,0,0,0,0,0,0.0,0,0,0,0,0,0,2,0,0,2018-2019,90.0,0.0,0.0
694,Bartłomiej Drągowski,POL,GK,Empoli,Serie A,20,1997,14.0,0,0,0,0,0,0,1,0.0,1,0,0,0,0,0,7,1,0,2018-2019,90.0,0.0,0.0
695,Julian Draxler,GER,"MF,FW",Paris S-G,Ligue 1,24,1993,22.7,41,22,11,19,11,16,43,37.2,27,20,1,19,15,56,2,1,0,2018-2019,89.99999999999999,59.471365638766514,162.55506607929516
696,Luke Dreher,ENG,FW,Crystal Palace,Premier League,19,1998,0.0,0,0,0,0,0,0,0,0.0,0,0,0,0,0,0,0,0,0,2018-2019,,,
697,Josip Drmić,SUI,FW,Gladbach,Bundesliga,25,1992,2.5,2,0,0,2,0,1,2,50.0,1,1,0,1,1,3,0,0,0,2018-2019,90.0,36.0,72.0
698,Jaroslav Drobný,CZE,GK,Düsseldorf,Bundesliga,38,1979,2.0,0,0,0,0,0,0,0,0.0,0,0,0,0,0,0,1,0,0,2018-2019,90.0,0.0,0.0
699,Óscar Duarte,CRC,"DF,MF",Espanyol,La Liga,29,1989,7.3,12,5,7,5,0,4,7,57.1,3,7,7,0,13,25,34,0,0,2018-2019,90.0,160.27397260273975,147.94520547945206
700,Rubén Duarte,ESP,DF,Alavés,La Liga,22,1995,30.8,72,35,45,20,7,34,64,53.1,30,46,12,34,57,129,130,1,0,2018-2019,90.0,166.55844155844156,210.3896103896104
Rk,Player,Nation,Pos,Squad,Comp,0,0,90.0,0,0,3,3,3,Tkl,0,0.0,0,0,0,0,0,0,0,0,0,2018-2019,90.0,0.0,0.0
701,Leo Dubois,FRA,DF,Lyon,Ligue 1,23,1994,22.7,51,22,25,21,5,20,35,57.1,15,30,10,20,22,73,61,1,0,2018-2019,89.99999999999999,87.22466960352422,202.20264317180616
702,Martin Dúbravka,SVK,GK,Newcastle Utd,Premier League,29,1989,38.0,2,0,2,0,0,1,3,33.3,2,0,0,0,0,2,20,5,0,2018-2019,90.0,0.0,4.7368421052631575
703,Marvin Ducksch,GER,FW,Düsseldorf,Bundesliga,24,1994,9.1,3,1,0,2,1,1,5,20.0,4,4,0,4,4,7,11,0,0,2018-2019,90.0,39.56043956043956,29.67032967032967
704,Ondrej Duda,SVK,MF,Hertha BSC,Bundesliga,23,1994,28.5,54,33,13,35,6,15,55,27.3,40,36,4,32,15,69,17,1,0,2018-2019,90.0,47.36842105263158,170.5263157894737
705,Shane Duffy,IRL,DF,Brighton,Premier League,26,1992,34.3,35,20,23,7,5,14,25,56.0,11,57,47,10,36,71,244,3,0,2018-2019,90.0,94.46064139941691,91.83673469387756
706,Demeaco Duhaney,ENG,DF,Huddersfield,Premier League,19,1998,0.5,1,0,1,0,0,1,3,33.3,2,2,0,2,1,2,1,0,0,2018-2019,90.0,180.0,180.0
707,Paul Dummett,WAL,DF,Newcastle Utd,Premier League,26,1991,22.1,34,22,24,9,1,19,32,59.4,13,25,11,14,37,71,133,0,0,2018-2019,90.0,150.6787330316742,138.46153846153845
708,Alfred Duncan,GHA,MF,Sassuolo,Serie A,25,1993,20.5,33,21,15,15,3,19,48,39.6,29,20,6,14,15,48,18,0,0,2018-2019,90.0,65.85365853658537,144.8780487804878
709,Lewis Dunk,ENG,DF,Brighton,Premier League,26,1991,35.0,42,26,31,10,1,17,39,43.6,22,49,38,11,46,88,196,5,0,2018-2019,90.0,118.28571428571428,108.0
710,Maxime Dupé,FRA,GK,Nantes,Ligue 1,25,1993,10.4,0,0,0,0,0,0,0,0.0,0,0,0,0,0,0,3,1,0,2018-2019,90.0,0.0,0.0
711,Erik Durm,GER,DF,Huddersfield,Premier League,26,1992,22.8,35,22,24,8,3,14,33,42.4,19,26,6,20,41,76,42,0,0,2018-2019,90.0,161.8421052631579,138.15789473684208
712,Jimmy Durmaz,SWE,"MF,FW",Toulouse,Ligue 1,29,1989,21.1,34,22,8,13,13,15,38,39.5,23,14,2,12,11,45,16,1,0,2018-2019,90.0,46.91943127962085,145.02369668246445
713,Riza Durmisi,DEN,DF,Lazio,Serie A,24,1994,3.6,4,4,2,0,2,2,3,66.7,1,0,0,0,1,5,9,0,0,2018-2019,90.0,25.0,100.0
714,Hugo Duro,ESP,"MF,FW",Getafe,La Liga,18,1999,4.6,6,4,1,2,3,3,6,50.0,3,6,1,5,3,9,4,0,0,2018-2019,90.0,58.69565217391305,117.3913043478261
715,Raphael Dwamena,GHA,FW,Levante,La Liga,22,1995,2.5,0,0,0,0,0,0,0,0.0,0,2,1,1,0,0,2,0,0,2018-2019,90.0,0.0,0.0
716,Paulo Dybala,ARG,"FW,MF",Juventus,Serie A,24,1993,23.7,17,8,3,9,5,7,23,30.4,16,20,2,18,14,31,1,0,0,2018-2019,90.0,53.16455696202532,64.55696202531647
717,Edin Džeko,BIH,FW,Roma,Serie A,32,1986,28.7,13,7,3,5,5,4,16,25.0,12,10,1,9,0,13,36,1,0,2018-2019,90.0,0.0,40.76655052264808
718,Blerim Džemaili,SUI,MF,Bologna,Serie A,32,1986,19.4,44,27,22,19,3,19,58,32.8,39,22,1,21,17,61,12,1,0,2018-2019,90.0,78.86597938144331,204.1237113402062
719,Félix Eboa Eboa,CMR,DF,Guingamp,Ligue 1,21,1997,27.0,47,33,26,20,1,16,22,72.7,6,37,24,13,39,86,136,2,0,2018-2019,90.0,130.0,156.66666666666669
720,Dennis Eckert,GER,FW,Celta Vigo,La Liga,21,1997,2.4,3,2,0,1,2,0,2,0.0,2,1,0,1,2,5,3,0,0,2018-2019,90.0,75.0,112.50000000000001
721,Bruno Ecuele Manga,GAB,DF,Cardiff City,Premier League,30,1988,37.5,69,36,48,16,5,29,58,50.0,29,62,28,34,81,150,179,4,0,2018-2019,90.0,194.39999999999998,165.6
722,Simone Edera,ITA,MF,Torino,Serie A,21,1997,0.9,0,0,0,0,0,0,1,0.0,1,1,0,1,1,1,0,0,0,2018-2019,90.0,100.0,0.0
723,Simone Edera,ITA,FW,Bologna,Serie A,21,1997,2.2,4,4,3,0,1,1,3,33.3,2,5,1,4,0,4,1,0,0,2018-2019,90.0,0.0,163.63636363636363
724,Ederson,BRA,GK,Manchester City,Premier League,24,1993,38.0,3,3,2,1,0,3,3,100.0,0,0,0,0,1,4,12,2,0,2018-2019,90.0,2.3684210526315788,7.105263157894737
725,Johannes Eggestein,GER,"FW,MF",Werder Bremen,Bundesliga,20,1998,12.4,13,9,7,4,2,5,19,26.3,14,13,0,13,4,17,7,0,0,2018-2019,90.0,29.032258064516128,94.35483870967742
Rk,Player,Nation,Pos,Squad,Comp,0,0,90.0,0,0,3,3,3,Tkl,0,0.0,0,0,0,0,0,0,0,0,0,2018-2019,90.0,0.0,0.0
726,Maximilian Eggestein,GER,MF,Werder Bremen,Bundesliga,21,1996,33.9,68,42,29,34,5,24,54,44.4,30,49,10,39,30,98,69,0,0,2018-2019,90.0,79.64601769911505,180.53097345132744
727,Albin Ekdal,SWE,MF,Sampdoria,Serie A,29,1989,29.4,61,39,16,38,7,37,68,54.4,31,42,12,30,53,114,62,1,0,2018-2019,90.0,162.24489795918367,186.73469387755102
728,Josip Elez,CRO,DF,Hannover 96,Bundesliga,24,1994,7.2,8,3,5,3,0,2,11,18.2,9,13,4,9,6,14,27,0,0,2018-2019,90.0,75.0,100.0
729,Harvey Elliott,ENG,MF,Fulham,Premier League,15,2003,0.2,0,0,0,0,0,0,0,0.0,0,1,0,1,0,0,0,0,0,2018-2019,90.0,0.0,0.0
730,Mohamed Elneny,EGY,MF,Arsenal,Premier League,26,1992,4.2,13,4,9,1,3,1,2,50.0,1,7,4,3,2,15,8,0,0,2018-2019,90.0,42.857142857142854,278.57142857142856
731,Aritz Elustondo,ESP,DF,Real Sociedad,La Liga,24,1994,25.0,47,29,31,14,2,26,41,63.4,15,23,7,16,39,86,150,0,0,2018-2019,90.0,140.4,169.2
732,Gorka Elustondo,ESP,"MF,DF",Rayo Vallecano,La Liga,31,1987,3.2,7,5,4,3,0,5,8,62.5,3,6,1,5,6,13,10,0,0,2018-2019,90.0,168.75,196.875
733,Nico Elvedi,SUI,DF,Gladbach,Bundesliga,21,1996,29.1,41,19,34,7,0,23,33,69.7,10,30,13,17,47,88,135,6,0,2018-2019,90.0,145.36082474226802,126.8041237113402
734,Rodrigo Ely,BRA,DF,Alavés,La Liga,24,1993,4.8,8,5,5,3,0,5,7,71.4,2,9,7,2,7,15,30,0,0,2018-2019,90.0,131.25,150.0
735,Mohamed Elyounoussi,NOR,MF,Southampton,Premier League,23,1994,8.8,16,12,7,6,3,6,19,31.6,13,11,1,10,6,22,5,0,0,2018-2019,90.0,61.36363636363636,163.63636363636363
736,Adri Embarba,ESP,"MF,FW",Rayo Vallecano,La Liga,26,1992,25.4,54,26,20,24,10,22,61,36.1,39,38,2,36,29,83,22,0,0,2018-2019,90.0,102.75590551181102,191.33858267716536
737,Breel Embolo,SUI,FW,Schalke 04,Bundesliga,21,1997,14.9,22,17,4,13,5,1,9,11.1,8,11,0,11,4,26,6,0,0,2018-2019,90.0,24.161073825503355,132.88590604026845
738,Emerson,BRA,"FW,DF",Betis,La Liga,19,1999,3.5,9,7,6,1,2,3,10,30.0,7,6,0,6,7,16,12,0,0,2018-2019,90.0,180.0,231.42857142857142
739,Youssef En-Nesyri,MAR,FW,Leganés,La Liga,21,1997,23.4,16,8,6,5,5,4,24,16.7,20,18,3,15,6,22,23,0,0,2018-2019,89.99999999999999,23.076923076923077,61.53846153846153
740,Björn Engels,BEL,DF,Reims,Ligue 1,23,1994,33.0,11,8,6,5,0,6,16,37.5,10,30,24,6,44,55,181,3,0,2018-2019,90.0,120.00000000000001,30.000000000000004
741,Sergi Enrich,ESP,FW,Eibar,La Liga,28,1990,28.7,27,17,3,11,13,7,30,23.3,23,11,1,10,6,33,14,0,0,2018-2019,90.0,18.81533101045296,84.66898954703832
742,Javier Eraso,ESP,"MF,FW",Leganés,La Liga,28,1990,7.0,6,3,3,2,1,0,6,0.0,6,3,1,2,7,13,4,0,0,2018-2019,90.0,90.0,77.14285714285714
743,Christian Eriksen,DEN,MF,Tottenham,Premier League,26,1992,30.8,41,25,8,20,13,17,59,28.8,42,26,3,23,15,56,13,0,0,2018-2019,90.0,43.83116883116883,119.80519480519482
744,Patrick Erras,GER,MF,Nürnberg,Bundesliga,23,1995,13.6,15,10,7,7,1,7,19,36.8,12,24,13,11,23,38,45,0,0,2018-2019,90.0,152.2058823529412,99.26470588235294
745,Gonzalo Escalante,ARG,MF,Eibar,La Liga,25,1993,19.9,49,28,11,35,3,19,46,41.3,27,37,2,35,21,70,21,0,0,2018-2019,90.0,94.9748743718593,221.60804020100505
746,Sergio Escudero,ESP,"DF,FW",Sevilla,La Liga,28,1989,17.2,43,29,20,18,5,18,35,51.4,17,22,4,18,24,67,52,0,0,2018-2019,90.0,125.58139534883722,225.00000000000003
747,Bernardo Espinosa,COL,DF,Girona,La Liga,29,1989,30.3,20,14,16,4,0,8,17,47.1,9,46,31,15,40,60,197,5,0,2018-2019,90.0,118.81188118811882,59.40594059405941
748,Michael Esser,GER,GK,Hannover 96,Bundesliga,30,1987,32.0,3,2,3,0,0,2,5,40.0,3,1,0,1,1,4,15,0,0,2018-2019,90.0,2.8125,8.4375
749,Alexander Esswein,GER,"MF,FW",Stuttgart,Bundesliga,28,1990,13.9,17,11,6,4,7,6,21,28.6,15,17,0,17,12,29,16,0,0,2018-2019,90.0,77.6978417266187,110.07194244604317
750,Neil Etheridge,PHI,GK,Cardiff City,Premier League,28,1990,38.0,1,1,1,0,0,1,2,50.0,1,0,0,0,7,8,19,1,0,2018-2019,90.0,16.57894736842105,2.3684210526315788
Rk,Player,Nation,Pos,Squad,Comp,0,0,90.0,0,0,3,3,3,Tkl,0,0.0,0,0,0,0,0,0,0,0,0,2018-2019,90.0,0.0,0.0
751,Beñat Etxebarria,ESP,MF,Athletic Club,La Liga,31,1987,22.6,47,24,14,25,8,19,59,32.2,40,18,1,17,24,71,11,0,0,2018-2019,90.0,95.57522123893806,187.16814159292034
752,Xabier Etxeita,ESP,DF,Huesca,La Liga,30,1987,29.7,47,23,32,12,3,26,47,55.3,21,38,25,13,39,86,163,3,0,2018-2019,90.0,118.18181818181817,142.4242424242424
753,Lucas Evangelista,BRA,"FW,MF",Nantes,Ligue 1,23,1995,8.0,30,17,11,12,7,14,25,56.0,11,10,0,10,9,39,6,0,0,2018-2019,90.0,101.25,337.5
754,Jonny Evans,NIR,DF,Leicester City,Premier League,30,1988,22.2,24,13,20,4,0,13,18,72.2,5,28,10,18,33,57,152,3,0,2018-2019,90.0,133.7837837837838,97.2972972972973
755,Ewerton,BRA,DF,Nürnberg,Bundesliga,29,1989,14.9,24,20,21,3,0,8,14,57.1,6,23,16,7,25,49,108,1,0,2018-2019,90.0,151.00671140939596,144.96644295302013
756,Valentin Eysseric,FRA,"FW,MF",Fiorentina,Serie A,26,1992,4.0,6,5,3,2,1,2,4,50.0,2,6,1,5,4,10,1,0,0,2018-2019,90.0,90.0,135.0
757,Valentin Eysseric,FRA,"MF,FW",Nantes,Ligue 1,26,1992,2.3,1,1,0,1,0,0,2,0.0,2,2,0,2,0,1,0,0,0,2018-2019,90.0,0.0,39.130434782608695
758,Marco Fabián,MEX,FW,Eint Frankfurt,Bundesliga,29,1989,0.7,3,2,2,1,0,1,1,100.0,0,0,0,0,3,6,0,0,0,2018-2019,90.0,385.7142857142857,385.7142857142857
759,Łukasz Fabiański,POL,GK,West Ham,Premier League,33,1985,38.0,1,0,1,0,0,1,3,33.3,2,0,0,0,1,2,10,1,0,2018-2019,90.0,2.3684210526315788,2.3684210526315788
760,Fabinho,BRA,MF,Liverpool,Premier League,24,1993,22.4,59,31,17,38,4,24,59,40.7,35,34,6,28,28,87,27,2,0,2018-2019,90.0,112.5,237.05357142857144
761,Fábio,BRA,"DF,FW",Nantes,Ligue 1,28,1990,14.2,53,34,25,27,1,26,53,49.1,27,18,4,14,18,71,27,0,0,2018-2019,90.0,114.08450704225353,335.9154929577465
762,Cesc Fàbregas,ESP,MF,Chelsea,Premier League,31,1987,2.0,6,4,4,2,0,1,5,20.0,4,2,1,1,1,7,0,0,0,2018-2019,90.0,45.0,270.0
763,Cesc Fàbregas,ESP,MF,Monaco,Ligue 1,31,1987,10.7,14,10,5,5,4,8,28,28.6,20,12,3,9,9,23,5,1,0,2018-2019,90.0,75.70093457943926,117.7570093457944
764,Fabricio,ESP,GK,Fulham,Premier League,30,1987,2.0,1,1,1,0,0,0,0,0.0,0,0,0,0,0,1,3,2,0,2018-2019,90.0,0.0,45.0
765,Ralf Fährmann,GER,GK,Schalke 04,Bundesliga,29,1988,16.3,0,0,0,0,0,0,0,0.0,0,0,0,0,2,2,10,4,0,2018-2019,90.0,11.042944785276074,0.0
766,Romain Faivre,FRA,MF,Monaco,Ligue 1,20,1998,1.0,1,0,0,1,0,0,1,0.0,1,0,0,0,1,2,1,1,0,2018-2019,90.0,90.0,90.0
767,Fayçal Fajr,MAR,MF,Caen,Ligue 1,29,1988,36.0,65,32,22,33,10,25,66,37.9,41,27,6,21,29,94,19,2,0,2018-2019,90.0,72.5,162.5
768,Radamel Falcao,COL,FW,Monaco,Ligue 1,32,1986,28.4,34,15,6,16,12,8,27,29.6,19,11,6,5,3,37,23,2,0,2018-2019,90.0,9.507042253521128,107.74647887323944
769,Diego Falcinelli,ITA,FW,Bologna,Serie A,27,1991,7.8,8,5,1,3,4,2,3,66.7,1,4,1,3,1,9,5,0,0,2018-2019,90.0,11.538461538461538,92.3076923076923
770,Simon Falette,GUI,DF,Eint Frankfurt,Bundesliga,26,1992,6.7,9,6,7,1,1,2,6,33.3,4,11,5,6,14,23,32,0,0,2018-2019,90.0,188.0597014925373,120.89552238805969
771,Iago Falque,ESP,"FW,MF",Torino,Serie A,28,1990,17.9,13,8,3,8,2,3,16,18.8,13,14,0,14,3,16,2,0,0,2018-2019,90.0,15.083798882681567,65.36312849162012
772,Paolo Faragò,ITA,"MF,DF",Cagliari,Serie A,25,1993,18.9,46,29,20,16,10,13,43,30.2,30,28,2,26,15,61,38,0,0,2018-2019,90.0,71.42857142857143,219.04761904761907
773,Mohamed Fares,ALG,DF,SPAL,Serie A,22,1996,32.8,63,43,37,18,8,25,54,46.3,29,48,4,44,54,117,83,2,0,2018-2019,90.0,148.1707317073171,172.8658536585366
774,Diego Farias,BRA,FW,Empoli,Serie A,28,1990,13.3,11,4,2,8,1,3,10,30.0,7,7,1,6,0,11,4,0,0,2018-2019,90.0,0.0,74.4360902255639
775,Diego Farias,BRA,FW,Cagliari,Serie A,28,1990,7.8,13,9,3,7,3,2,11,18.2,9,7,1,6,1,14,5,0,0,2018-2019,90.0,11.538461538461538,150.0
Rk,Player,Nation,Pos,Squad,Comp,0,0,90.0,0,0,3,3,3,Tkl,0,0.0,0,0,0,0,0,0,0,0,0,2018-2019,90.0,0.0,0.0
776,Andrea Favilli,ITA,"FW,DF",Genoa,Serie A,21,1997,1.9,1,1,0,0,1,0,1,0.0,1,1,0,1,0,1,1,0,0,2018-2019,90.0,0.0,47.368421052631575
777,Federico Fazio,ARG,DF,Roma,Serie A,31,1987,31.2,28,20,14,11,3,12,25,48.0,13,45,33,12,53,81,171,2,0,2018-2019,90.0,152.8846153846154,80.76923076923076
778,Zouhair Feddal,MAR,DF,Betis,La Liga,29,1989,18.9,38,23,31,6,1,16,28,57.1,12,19,8,11,31,69,94,2,0,2018-2019,90.0,147.61904761904762,180.95238095238096
779,Nabil Fekir,FRA,MF,Lyon,Ligue 1,25,1993,22.1,51,31,16,19,16,13,38,34.2,25,42,0,42,7,58,3,0,0,2018-2019,90.0,28.50678733031674,207.69230769230768
780,Yassin Fekir,FRA,FW,Lyon,Ligue 1,21,1997,0.1,0,0,0,0,0,0,1,0.0,1,0,0,0,0,0,0,0,0,2018-2019,90.0,0.0,0.0
781,Felipe,BRA,DF,Hannover 96,Bundesliga,31,1987,12.2,23,15,21,2,0,9,17,52.9,8,17,9,8,35,58,71,0,0,2018-2019,90.0,258.1967213114754,169.672131147541
782,Luiz Felipe,ITA,DF,Lazio,Serie A,21,1997,14.3,27,18,20,7,0,13,20,65.0,7,27,15,12,26,53,57,1,0,2018-2019,90.0,163.63636363636365,169.93006993006995
783,Ohis Felix Uduokhai,GER,DF,Wolfsburg,Bundesliga,20,1997,2.7,13,7,7,5,1,9,10,90.0,1,6,2,4,6,19,11,1,0,2018-2019,90.0,199.99999999999997,433.3333333333333
784,Marouane Fellaini,BEL,MF,Manchester Utd,Premier League,30,1987,8.4,21,13,11,9,1,9,17,52.9,8,9,5,4,4,25,34,1,0,2018-2019,90.0,42.857142857142854,225.0
785,Kiko Femenía,ESP,DF,Watford,Premier League,27,1991,22.8,48,30,34,12,2,24,51,47.1,27,24,6,18,36,84,68,0,0,2018-2019,90.0,142.1052631578947,189.4736842105263
786,Edimilson Fernandes,SUI,MF,Fiorentina,Serie A,22,1996,21.9,36,24,17,16,3,14,36,38.9,22,31,6,25,26,62,31,0,0,2018-2019,90.0,106.84931506849315,147.94520547945206
787,Gelson Fernandes,SUI,MF,Eint Frankfurt,Bundesliga,31,1986,24.7,74,48,33,38,3,23,65,35.4,42,45,9,36,53,127,16,0,0,2018-2019,90.0,193.1174089068826,269.6356275303644
788,Aitor Fernández,ESP,GK,Levante,La Liga,27,1991,16.0,1,0,1,0,0,1,1,100.0,0,0,0,0,1,2,10,1,0,2018-2019,90.0,5.625,5.625
789,Andrés Fernández,ESP,GK,Villarreal,La Liga,31,1986,6.0,1,0,1,0,0,1,1,100.0,0,0,0,0,0,1,4,1,0,2018-2019,90.0,0.0,15.0
790,Borja Fernández,ESP,"MF,DF",Valladolid,La Liga,37,1981,9.3,17,12,7,9,1,6,16,37.5,10,14,2,12,14,31,25,0,0,2018-2019,90.0,135.48387096774192,164.51612903225805
791,Federico Fernández,ARG,DF,Newcastle Utd,Premier League,29,1989,16.5,16,12,12,4,0,10,18,55.6,8,19,12,7,25,41,106,1,0,2018-2019,90.0,136.36363636363637,87.27272727272728
792,Joaquín Fernández,ESP,"DF,MF",Valladolid,La Liga,22,1996,9.3,16,9,14,1,1,8,16,50.0,8,9,7,2,17,33,45,0,0,2018-2019,90.0,164.51612903225805,154.83870967741933
793,Valery Fernández,ESP,"DF,FW",Girona,La Liga,18,1999,9.9,20,15,13,6,1,10,17,58.8,7,15,1,14,8,28,10,0,0,2018-2019,90.0,72.72727272727273,181.8181818181818
794,Fernandinho,BRA,MF,Manchester City,Premier League,33,1985,26.4,57,43,19,30,8,26,47,55.3,21,28,4,24,41,98,70,0,0,2018-2019,90.0,139.77272727272728,194.3181818181818
795,Juan Ferney Otero,COL,"FW,MF",Amiens,Ligue 1,23,1995,24.2,29,13,11,12,6,13,46,28.3,33,23,3,20,22,51,18,0,0,2018-2019,90.0,81.81818181818181,107.85123966942149
796,Alex Ferrari,ITA,DF,Sampdoria,Serie A,24,1994,6.0,10,8,4,6,0,5,7,71.4,2,7,4,3,9,19,26,0,0,2018-2019,90.0,135.0,150.0
797,David Ferreiro,ESP,"MF,FW",Huesca,La Liga,30,1988,25.3,36,22,13,19,4,11,64,17.2,53,27,1,26,24,60,14,2,0,2018-2019,89.99999999999999,85.37549407114624,128.06324110671935
798,Facundo Ferreyra,ARG,FW,Espanyol,La Liga,27,1991,2.3,5,2,0,4,1,1,3,33.3,2,3,0,3,0,5,5,0,0,2018-2019,90.0,0.0,195.6521739130435
799,Jordan Ferri,FRA,MF,Nîmes,Ligue 1,26,1992,20.8,52,31,22,23,7,26,62,41.9,36,27,2,25,15,67,9,1,0,2018-2019,90.0,64.90384615384615,224.99999999999997
800,Jordan Ferri,FRA,MF,Lyon,Ligue 1,26,1992,1.3,5,3,3,1,1,1,4,25.0,3,4,2,2,1,6,3,0,0,2018-2019,90.0,69.23076923076923,346.15384615384613
Rk,Player,Nation,Pos,Squad,Comp,0,0,90.0,0,0,3,3,3,Tkl,0,0.0,0,0,0,0,0,0,0,0,0,2018-2019,90.0,0.0,0.0
801,Oliver Fink,GER,MF,Düsseldorf,Bundesliga,36,1982,11.7,38,22,17,17,4,12,38,31.6,26,20,3,17,13,51,19,0,0,2018-2019,89.99999999999999,100.0,292.3076923076923
802,Alfreð Finnbogason,ISL,FW,Augsburg,Bundesliga,29,1989,14.8,7,3,2,5,0,1,9,11.1,8,6,1,5,3,10,11,0,0,2018-2019,90.0,18.243243243243242,42.567567567567565
803,Roberto Firmino,BRA,"FW,MF",Liverpool,Premier League,26,1991,29.0,30,20,5,16,9,7,34,20.6,27,35,1,34,6,36,16,0,0,2018-2019,90.0,18.620689655172413,93.10344827586206
804,Junior Firpo,DOM,"DF,FW",Betis,La Liga,21,1996,21.5,38,25,16,14,8,10,24,41.7,14,27,2,25,23,61,48,0,0,2018-2019,90.0,96.27906976744185,159.06976744186045
805,Mathieu Flamini,FRA,MF,Getafe,La Liga,34,1984,5.0,9,4,4,4,1,4,7,57.1,3,3,1,2,5,14,4,0,0,2018-2019,90.0,90.0,162.0
806,Mark Flekken,NED,GK,Freiburg,Bundesliga,25,1993,1.0,0,0,0,0,0,0,0,0.0,0,0,0,0,0,0,0,0,0,2018-2019,90.0,0.0,0.0
807,Sergio Floccari,ITA,FW,SPAL,Serie A,36,1981,10.8,13,5,1,5,7,1,7,14.3,6,6,2,4,2,15,6,0,0,2018-2019,90.0,16.666666666666664,108.33333333333333
808,Alessandro Florenzi,ITA,"DF,FW",Roma,Serie A,27,1991,24.2,38,21,22,11,5,17,37,45.9,20,27,5,22,46,84,58,0,0,2018-2019,90.0,171.07438016528926,141.32231404958677
809,Phil Foden,ENG,MF,Manchester City,Premier League,18,2000,3.7,7,6,1,3,3,2,9,22.2,7,1,0,1,4,11,1,0,0,2018-2019,90.0,97.29729729729729,170.27027027027026
810,Guessouma Fofana,MTN,MF,Amiens,Ligue 1,25,1992,2.1,6,4,3,3,0,1,3,33.3,2,2,1,1,3,9,0,0,0,2018-2019,90.0,128.57142857142856,257.1428571428571
811,Guessouma Fofana,MTN,MF,Guingamp,Ligue 1,25,1992,5.3,14,9,2,10,2,4,10,40.0,6,3,0,3,6,20,8,0,0,2018-2019,90.0,101.88679245283019,237.7358490566038
812,Seko Fofana,CIV,MF,Udinese,Serie A,23,1995,29.3,25,13,14,10,1,6,36,16.7,30,20,7,13,29,54,18,3,0,2018-2019,90.0,89.07849829351537,76.79180887372014
813,Wesley Fofana,FRA,DF,Saint-Étienne,Ligue 1,17,2000,1.8,7,6,5,2,0,6,13,46.2,7,1,0,1,4,11,9,0,0,2018-2019,90.0,200.0,350.0
814,Youssouf Fofana,FRA,MF,Strasbourg,Ligue 1,19,1999,10.1,28,20,5,20,3,9,27,33.3,18,7,0,7,11,39,8,0,0,2018-2019,90.0,98.01980198019803,249.5049504950495
815,Thomas Foket,BEL,DF,Reims,Ligue 1,23,1994,32.0,91,52,55,23,13,42,69,60.9,27,30,4,26,49,140,80,1,0,2018-2019,90.0,137.8125,255.9375
816,Thomas Fontaine,MAD,"DF,MF",Reims,Ligue 1,27,1991,4.7,6,3,5,0,1,2,5,40.0,3,6,2,4,7,13,28,1,0,2018-2019,90.0,134.04255319148936,114.89361702127658
817,José Fonte,POR,DF,Lille,Ligue 1,34,1983,34.6,27,15,15,9,3,17,24,70.8,7,33,26,7,37,64,153,1,0,2018-2019,90.0,96.24277456647398,70.23121387283237
818,Rui Fonte,POR,"FW,MF",Lille,Ligue 1,28,1990,7.0,25,12,4,16,5,6,11,54.5,5,4,0,4,2,27,8,0,0,2018-2019,90.0,25.714285714285715,321.42857142857144
819,Pablo Fornals,ESP,"MF,FW",Villarreal,La Liga,22,1996,27.5,49,26,14,26,9,15,54,27.8,39,32,4,28,24,73,19,0,0,2018-2019,89.99999999999999,78.54545454545453,160.36363636363635
820,Emil Forsberg,SWE,"MF,FW",RB Leipzig,Bundesliga,26,1991,13.9,12,7,0,12,0,5,16,31.3,11,16,1,15,3,15,6,0,0,2018-2019,90.0,19.424460431654676,77.6978417266187
821,Fraser Forster,ENG,GK,Southampton,Premier League,30,1988,1.0,0,0,0,0,0,0,0,0.0,0,0,0,0,0,0,1,0,0,2018-2019,90.0,0.0,0.0
822,Steven Fortes,CPV,DF,Toulouse,Ligue 1,26,1992,1.5,3,1,1,2,0,0,0,0.0,0,1,1,0,2,5,9,2,0,2018-2019,90.0,120.0,180.0
823,Iver Fossum,NOR,MF,Hannover 96,Bundesliga,22,1996,5.1,9,5,1,7,1,4,8,50.0,4,8,2,6,7,16,10,0,0,2018-2019,90.0,123.52941176470588,158.82352941176472
824,Ben Foster,ENG,GK,Watford,Premier League,35,1983,38.0,2,2,2,0,0,2,6,33.3,4,0,0,0,2,4,34,3,0,2018-2019,90.0,4.7368421052631575,4.7368421052631575
825,Timothy Fosu-Mensah,NED,DF,Fulham,Premier League,20,1998,8.8,18,7,12,6,0,8,13,61.5,5,11,5,6,12,30,30,1,0,2018-2019,90.0,122.72727272727272,184.0909090909091
Rk,Player,Nation,Pos,Squad,Comp,0,0,90.0,0,0,3,3,3,Tkl,0,0.0,0,0,0,0,0,0,0,0,0,2018-2019,90.0,0.0,0.0
826,Dimitri Foulquier,FRA,"MF,DF",Getafe,La Liga,25,1993,20.0,29,12,10,14,5,11,22,50.0,11,23,2,21,20,49,38,0,0,2018-2019,90.0,90.0,130.5
827,Juan Foyth,ARG,DF,Tottenham,Premier League,20,1998,9.9,31,17,20,11,0,14,19,73.7,5,12,5,7,10,41,50,1,0,2018-2019,90.0,90.9090909090909,281.8181818181818
828,Raphael Framberger,GER,"DF,MF",Augsburg,Bundesliga,22,1995,6.1,8,6,4,4,0,0,3,0.0,3,10,3,7,11,19,15,1,0,2018-2019,90.0,162.29508196721312,118.03278688524591
829,Simon Francis,ENG,DF,Bournemouth,Premier League,33,1985,13.7,25,14,19,5,1,12,24,50.0,12,15,7,8,19,44,73,1,0,2018-2019,90.0,124.8175182481752,164.23357664233578
830,Mike Frantz,GER,"MF,FW",Freiburg,Bundesliga,31,1986,24.6,34,26,15,15,4,6,20,30.0,14,24,4,20,21,55,32,0,0,2018-2019,89.99999999999999,76.82926829268291,124.39024390243901
831,Ryan Fraser,SCO,"MF,FW",Bournemouth,Premier League,24,1994,35.2,19,11,9,8,2,10,32,31.3,22,23,6,17,22,41,33,0,0,2018-2019,90.0,56.25,48.57954545454545
832,Pierluigi Frattali,ITA,GK,Parma,Serie A,32,1985,1.0,0,0,0,0,0,0,0,0.0,0,0,0,0,0,0,1,0,0,2018-2019,90.0,0.0,0.0
833,Fred,BRA,MF,Manchester Utd,Premier League,25,1993,11.6,29,17,12,16,1,15,33,45.5,18,26,2,24,16,45,14,2,0,2018-2019,90.0,124.13793103448276,225.0
834,Ryan Fredericks,ENG,DF,West Ham,Premier League,25,1992,12.1,38,23,33,5,0,21,32,65.6,11,15,5,10,13,51,49,1,0,2018-2019,90.0,96.69421487603306,282.64462809917353
835,Remo Freuler,SUI,MF,Atalanta,Serie A,26,1992,33.6,84,45,34,34,16,30,70,42.9,40,62,12,50,38,122,45,0,0,2018-2019,90.0,101.78571428571428,225.0
836,Nicolas Frey,FRA,DF,Chievo,Serie A,34,1984,2.5,3,1,2,1,0,0,3,0.0,3,3,3,0,7,10,18,0,0,2018-2019,90.0,252.0,108.0
837,Marco Friedl,AUT,DF,Werder Bremen,Bundesliga,20,1998,5.3,8,6,4,3,1,3,11,27.3,8,9,6,3,13,21,21,0,0,2018-2019,90.0,220.75471698113208,135.8490566037736
838,Alexander Fuchs,GER,"MF,FW",Nürnberg,Bundesliga,21,1997,7.3,14,12,5,7,2,5,15,33.3,10,9,1,8,5,19,10,0,0,2018-2019,90.0,61.64383561643836,172.6027397260274
839,Christian Fuchs,AUT,DF,Leicester City,Premier League,32,1986,2.3,4,3,0,4,0,1,2,50.0,1,0,0,0,4,8,8,0,0,2018-2019,90.0,156.52173913043478,156.52173913043478
840,Javi Fuego,ESP,MF,Villarreal,La Liga,34,1984,2.6,6,3,5,1,0,4,8,50.0,4,2,0,2,3,9,9,0,0,2018-2019,90.0,103.84615384615384,207.69230769230768
841,Angelo Fulgini,FRA,"MF,FW",Angers,Ligue 1,21,1996,18.2,38,22,18,13,7,12,31,38.7,19,21,3,18,28,66,15,0,0,2018-2019,90.0,138.46153846153845,187.9120879120879
842,Niclas Füllkrug,GER,FW,Hannover 96,Bundesliga,25,1993,12.4,3,0,0,1,2,1,5,20.0,4,10,4,6,1,4,17,0,0,2018-2019,90.0,7.258064516129032,21.774193548387096
843,Ramiro Funes Mori,ARG,"DF,MF",Villarreal,La Liga,27,1991,29.2,41,29,30,9,2,19,44,43.2,25,36,24,12,42,83,149,2,0,2018-2019,90.0,129.45205479452056,126.36986301369863
844,Manolo Gabbiadini,ITA,"FW,MF",Southampton,Premier League,26,1991,5.3,6,2,1,4,1,1,2,50.0,1,5,0,5,3,9,6,0,0,2018-2019,90.0,50.943396226415096,101.88679245283019
845,Manolo Gabbiadini,ITA,FW,Sampdoria,Serie A,26,1991,9.0,5,2,1,3,1,3,11,27.3,8,6,1,5,4,9,4,0,0,2018-2019,90.0,40.0,50.0
846,Mijat Gaćinović,SRB,MF,Eint Frankfurt,Bundesliga,23,1995,18.1,31,20,7,13,11,11,42,26.2,31,26,1,25,24,55,10,0,0,2018-2019,90.0,119.33701657458562,154.14364640883977
847,Gianluca Gaetano,ITA,"MF,FW",Napoli,Serie A,18,2000,0.1,0,0,0,0,0,0,0,0.0,0,0,0,0,0,0,0,0,0,2018-2019,90.0,0.0,0.0
848,Roberto Gagliardini,ITA,MF,Inter,Serie A,24,1994,12.1,23,14,13,8,2,10,27,37.0,17,21,3,18,16,39,19,0,0,2018-2019,90.0,119.00826446280992,171.07438016528926
849,Riccardo Gagliolo,SWE,DF,Parma,Serie A,28,1990,33.8,69,45,52,15,2,33,68,48.5,35,60,33,27,66,135,213,2,0,2018-2019,90.0,175.73964497041422,183.7278106508876
850,Milan Gajić,SRB,DF,Bordeaux,Ligue 1,22,1996,1.0,2,1,1,0,1,1,1,100.0,0,0,0,0,1,3,7,0,0,2018-2019,90.0,90.0,180.0
Rk,Player,Nation,Pos,Squad,Comp,0,0,90.0,0,0,3,3,3,Tkl,0,0.0,0,0,0,0,0,0,0,0,0,2018-2019,90.0,0.0,0.0
851,Javi Galán,ESP,"DF,FW",Huesca,La Liga,23,1994,16.0,61,39,36,23,2,34,59,57.6,25,22,1,21,19,80,52,1,0,2018-2019,90.0,106.875,343.125
852,Sam Gallagher,ENG,FW,Southampton,Premier League,22,1995,0.4,0,0,0,0,0,0,0,0.0,0,1,0,1,0,0,1,0,0,2018-2019,90.0,0.0,0.0
853,Álex Gallar,ESP,"MF,FW",Huesca,La Liga,26,1992,11.2,15,9,6,5,4,8,19,42.1,11,9,1,8,9,24,5,0,0,2018-2019,90.0,72.32142857142857,120.53571428571429
854,Enric Gallego,ESP,FW,Huesca,La Liga,31,1986,17.1,21,15,3,13,5,3,19,15.8,16,17,2,15,8,29,32,0,0,2018-2019,90.0,42.10526315789474,110.52631578947368
855,Álex Gálvez,ESP,DF,Rayo Vallecano,La Liga,29,1989,15.7,38,28,25,13,0,14,28,50.0,14,7,2,5,45,83,69,1,0,2018-2019,90.0,257.9617834394905,217.8343949044586
856,Kévin Gameiro,FRA,FW,Valencia,La Liga,31,1987,17.9,14,9,4,6,4,1,6,16.7,5,12,2,10,5,19,3,0,0,2018-2019,90.0,25.139664804469277,70.39106145251398
857,Idrissa Gana Gueye,SEN,MF,Everton,Premier League,28,1989,31.4,142,89,70,63,9,38,76,50.0,38,52,8,44,74,216,48,1,0,2018-2019,90.0,212.1019108280255,407.00636942675163
858,Ignatius Ganago,CMR,FW,Nice,Ligue 1,19,1999,11.5,3,1,0,2,1,0,7,0.0,7,2,0,2,1,4,7,0,0,2018-2019,90.0,7.82608695652174,23.47826086956522
859,Cristian Ganea,ROU,DF,Athletic Club,La Liga,26,1992,0.5,0,0,0,0,0,0,3,0.0,3,1,0,1,1,1,2,0,0,2018-2019,90.0,180.0,0.0
860,Ganso,BRA,"MF,FW",Amiens,Ligue 1,28,1989,5.8,12,8,2,8,2,2,15,13.3,13,5,1,4,6,18,0,0,0,2018-2019,90.0,93.10344827586206,186.20689655172413
861,Ezequiel Garay,ARG,DF,Valencia,La Liga,31,1986,23.7,20,17,15,3,2,9,18,50.0,9,30,23,7,16,36,140,0,0,2018-2019,90.0,60.75949367088608,75.9493670886076
862,Borja Garcés,ESP,FW,Atlético Madrid,La Liga,18,1999,0.2,0,0,0,0,0,0,0,0.0,0,0,0,0,0,0,0,0,0,2018-2019,90.0,0.0,0.0
863,Alberto García,ESP,GK,Rayo Vallecano,La Liga,33,1985,17.0,1,1,1,0,0,1,3,33.3,2,1,0,1,2,3,1,2,0,2018-2019,90.0,10.588235294117647,5.294117647058823
864,Aleix García,ESP,MF,Girona,La Liga,21,1997,18.5,37,19,17,20,0,13,36,36.1,23,21,6,15,21,58,18,0,0,2018-2019,90.0,102.16216216216216,180.0
865,Álvaro García,ESP,"FW,MF",Rayo Vallecano,La Liga,25,1992,19.6,22,19,11,7,4,4,25,16.0,21,24,0,24,19,41,30,0,0,2018-2019,90.0,87.24489795918367,101.0204081632653
866,Borja García,ESP,"MF,FW",Girona,La Liga,27,1990,29.2,39,27,17,15,7,22,44,50.0,22,23,2,21,38,77,17,0,0,2018-2019,90.0,117.12328767123289,120.2054794520548
867,Dani García,ESP,MF,Athletic Club,La Liga,28,1990,27.5,56,34,21,32,3,24,63,38.1,39,28,8,20,49,105,46,1,0,2018-2019,89.99999999999999,160.36363636363635,183.27272727272725
868,Javi García,ESP,"DF,MF",Betis,La Liga,31,1987,5.8,3,1,3,0,0,2,3,66.7,1,5,1,4,5,8,27,0,0,2018-2019,90.0,77.58620689655173,46.55172413793103
869,Manu García,ESP,MF,Alavés,La Liga,32,1986,25.9,83,48,29,40,14,24,77,31.2,53,42,7,35,23,106,67,0,0,2018-2019,90.0,79.92277992277994,288.41698841698843
870,Manu García,ESP,MF,Toulouse,Ligue 1,20,1998,20.5,37,26,14,17,6,15,49,30.6,34,16,1,15,15,52,5,0,0,2018-2019,90.0,65.85365853658537,162.4390243902439
871,Raúl García,ESP,"MF,FW",Athletic Club,La Liga,32,1986,26.3,61,41,13,37,11,22,68,32.4,46,56,1,55,21,82,39,0,0,2018-2019,90.0,71.86311787072243,208.74524714828897
872,Raúl García,ESP,DF,Leganés,La Liga,29,1989,4.2,8,6,4,4,0,6,8,75.0,2,5,2,3,6,14,28,1,0,2018-2019,90.0,128.57142857142856,171.42857142857142
873,Raúl García,ESP,DF,Girona,La Liga,29,1989,9.4,21,12,11,7,3,11,16,68.8,5,14,4,10,11,32,35,1,0,2018-2019,90.0,105.31914893617021,201.06382978723403
874,Sergio García,ESP,"FW,MF",Espanyol,La Liga,35,1983,16.5,18,10,4,11,3,3,16,18.8,13,6,1,5,10,28,4,0,0,2018-2019,90.0,54.54545454545455,98.18181818181819
875,James Garner,ENG,MF,Manchester Utd,Premier League,17,2001,0.0,0,0,0,0,0,0,0,0.0,0,0,0,0,0,0,0,0,0,2018-2019,,,
Rk,Player,Nation,Pos,Squad,Comp,0,0,90.0,0,0,3,3,3,Tkl,0,0.0,0,0,0,0,0,0,0,0,0,2018-2019,90.0,0.0,0.0
876,Mario Gaspar,ESP,DF,Villarreal,La Liga,27,1990,28.9,62,43,39,17,6,29,49,59.2,20,48,11,37,42,104,91,0,0,2018-2019,90.00000000000001,130.79584775086508,193.07958477508652
877,Paulo Gazzaniga,ARG,GK,Tottenham,Premier League,26,1992,3.0,0,0,0,0,0,0,0,0.0,0,0,0,0,0,0,1,0,0,2018-2019,90.0,0.0,0.0
878,Marcello Gazzola,ITA,"DF,MF",Parma,Serie A,33,1985,10.2,9,4,2,5,2,5,9,55.6,4,6,3,3,4,13,33,0,0,2018-2019,90.0,35.294117647058826,79.41176470588236
879,Jean-Philippe Gbamin,CIV,MF,Mainz 05,Bundesliga,22,1995,29.7,51,31,29,15,7,23,51,45.1,28,39,5,34,30,81,32,1,0,2018-2019,90.0,90.9090909090909,154.54545454545453
880,David de Gea,ESP,GK,Manchester Utd,Premier League,27,1990,38.0,0,0,0,0,0,0,2,0.0,2,1,0,1,0,0,11,4,0,2018-2019,90.0,0.0,0.0
881,Theodor Gebre Selassie,CZE,DF,Werder Bremen,Bundesliga,31,1986,31.3,53,38,27,16,10,22,51,43.1,29,33,8,25,69,122,100,0,0,2018-2019,90.0,198.40255591054313,152.3961661341853
882,Dennis Geiger,GER,MF,Hoffenheim,Bundesliga,20,1998,2.7,2,1,1,1,0,1,6,16.7,5,1,0,1,3,5,1,0,0,2018-2019,90.0,99.99999999999999,66.66666666666666
883,Jérémy Gélin,FRA,"DF,MF",Rennes,Ligue 1,21,1997,14.2,30,16,18,10,2,18,34,52.9,16,14,6,8,19,49,29,0,0,2018-2019,90.0,120.42253521126761,190.14084507042256
884,Romain Genevois,HAI,DF,Caen,Ligue 1,30,1987,4.0,10,6,9,1,0,6,11,54.5,5,3,0,3,8,18,13,0,0,2018-2019,90.0,180.0,225.0
885,Christian Gentner,GER,"MF,FW",Stuttgart,Bundesliga,32,1985,22.4,61,38,29,26,6,16,50,32.0,34,30,3,27,31,92,41,1,0,2018-2019,90.0,124.55357142857143,245.08928571428572
886,Yannick Gerhardt,GER,MF,Wolfsburg,Bundesliga,24,1994,27.3,52,34,22,20,10,16,43,37.2,27,35,7,28,30,82,34,0,0,2018-2019,90.0,98.90109890109889,171.42857142857142
887,Valère Germain,FRA,FW,Marseille,Ligue 1,28,1990,24.1,38,25,8,22,8,8,33,24.2,25,20,5,15,6,44,30,0,0,2018-2019,90.0,22.406639004149376,141.90871369294607
888,Gerson,BRA,"MF,FW",Fiorentina,Serie A,21,1997,27.0,42,26,22,15,5,12,38,31.6,26,46,9,37,16,58,32,0,0,2018-2019,90.0,53.333333333333336,140.0
889,Gervinho,CIV,FW,Parma,Serie A,31,1987,25.6,19,12,11,5,3,5,13,38.5,8,7,0,7,10,29,2,0,0,2018-2019,90.0,35.15625,66.796875
890,Willem Geubbels,FRA,MF,Monaco,Ligue 1,16,2001,0.1,0,0,0,0,0,0,0,0.0,0,0,0,0,0,0,0,0,0,2018-2019,90.0,0.0,0.0
891,Lamine Ghezali,FRA,"FW,MF",Saint-Étienne,Ligue 1,19,1999,0.5,1,1,0,1,0,1,2,50.0,1,0,0,0,0,1,2,0,0,2018-2019,90.0,0.0,180.0
892,Rachid Ghezzal,ALG,"FW,MF",Leicester City,Premier League,26,1992,8.3,14,5,3,7,4,3,18,16.7,15,10,1,9,7,21,4,1,0,2018-2019,90.0,75.90361445783131,151.80722891566262
893,Paolo Ghiglione,ITA,DF,Frosinone,Serie A,21,1997,5.7,8,4,6,1,1,6,14,42.9,8,2,0,2,4,12,22,0,0,2018-2019,90.0,63.1578947368421,126.3157894736842
894,Saman Ghoddos,IRN,"FW,MF",Amiens,Ligue 1,24,1993,20.3,33,17,14,15,4,13,32,40.6,19,15,2,13,7,40,13,0,0,2018-2019,90.0,31.034482758620687,146.30541871921181
895,Faouzi Ghoulam,ALG,DF,Napoli,Serie A,27,1991,12.8,9,7,3,5,1,8,9,88.9,1,6,2,4,8,17,17,0,0,2018-2019,90.0,56.25,63.28125
896,Emanuele Giaccherini,ITA,"MF,FW",Chievo,Serie A,33,1985,22.3,14,8,5,7,2,6,31,19.4,25,21,2,19,16,30,10,2,0,2018-2019,90.0,64.57399103139014,56.502242152466366
897,Morgan Gibbs-White,ENG,"MF,FW",Wolves,Premier League,18,2000,7.4,6,3,2,4,0,1,4,25.0,3,6,0,6,1,7,0,0,0,2018-2019,90.0,12.162162162162161,72.97297297297297
898,Ben Gibson,ENG,DF,Burnley,Premier League,25,1993,0.7,1,1,1,0,0,0,0,0.0,0,1,1,0,0,1,2,0,0,2018-2019,90.0,0.0,128.57142857142858
899,Fabian Giefer,GER,GK,Augsburg,Bundesliga,28,1990,4.0,0,0,0,0,0,0,2,0.0,2,0,0,0,0,0,1,2,0,2018-2019,90.0,0.0,0.0
900,Niko Gießelmann,GER,DF,Düsseldorf,Bundesliga,26,1991,28.8,57,37,38,14,5,26,59,44.1,33,25,6,19,36,93,85,1,0,2018-2019,90.0,112.5,178.125
Rk,Player,Nation,Pos,Squad,Comp,0,0,90.0,0,0,3,3,3,Tkl,0,0.0,0,0,0,0,0,0,0,0,0,2018-2019,90.0,0.0,0.0
901,Bryan Gil,ESP,"MF,FW",Sevilla,La Liga,17,2001,1.9,6,4,4,1,1,1,5,20.0,4,0,0,0,1,7,0,0,0,2018-2019,90.0,47.368421052631575,284.2105263157895
902,Daniel Ginczek,GER,FW,Wolfsburg,Bundesliga,27,1991,14.2,9,7,4,3,2,5,19,26.3,14,12,2,10,3,12,23,1,0,2018-2019,90.0,19.014084507042256,57.04225352112677
903,Matthias Ginter,GER,DF,Gladbach,Bundesliga,24,1994,26.4,24,14,16,7,1,9,17,52.9,8,31,19,12,17,41,98,1,0,2018-2019,90.0,57.95454545454545,81.81818181818181
904,Andrei Girotto,BRA,MF,Nantes,Ligue 1,26,1992,16.4,57,40,18,36,3,20,44,45.5,24,22,6,16,29,86,43,1,0,2018-2019,90.0,159.14634146341464,312.8048780487805
905,Olivier Giroud,FRA,FW,Chelsea,Premier League,31,1986,9.4,3,2,0,1,2,1,4,25.0,3,6,1,5,3,6,7,0,0,2018-2019,90.0,28.723404255319146,28.723404255319146
906,Kamil Glik,POL,DF,Monaco,Ligue 1,30,1988,33.0,32,23,26,5,1,16,32,50.0,16,25,17,8,61,93,200,1,0,2018-2019,90.0,166.36363636363637,87.27272727272728
907,Serge Gnabry,GER,"FW,MF",Bayern Munich,Bundesliga,23,1995,19.6,36,20,12,13,11,5,30,16.7,25,18,0,18,11,47,3,0,0,2018-2019,90.0,50.51020408163265,165.30612244897958
908,Joris Gnagnon,FRA,"DF,MF",Sevilla,La Liga,21,1997,5.0,11,8,6,4,1,4,7,57.1,3,2,2,0,10,21,16,0,0,2018-2019,90.0,180.0,198.0
909,Eddy Gnahoré,FRA,MF,Amiens,Ligue 1,24,1993,24.9,39,27,17,17,5,9,39,23.1,30,29,4,25,23,62,23,1,0,2018-2019,90.0,83.13253012048193,140.96385542168673
910,Massimo Gobbi,ITA,DF,Parma,Serie A,37,1980,13.1,14,7,5,5,4,8,25,32.0,17,16,8,8,9,23,48,0,0,2018-2019,90.0,61.832061068702295,96.18320610687023
911,Kevin Goden,GER,"DF,MF",Nürnberg,Bundesliga,19,1999,3.0,4,3,3,1,0,2,7,28.6,5,4,1,3,4,8,11,0,0,2018-2019,90.0,120.0,120.0
912,Diego Godín,URU,DF,Atlético Madrid,La Liga,32,1986,27.9,52,30,33,19,0,20,42,47.6,22,22,9,13,45,97,141,2,0,2018-2019,90.0,145.16129032258064,167.74193548387098
913,Mauro Goicoechea,URU,GK,Toulouse,Ligue 1,30,1988,7.9,0,0,0,0,0,0,0,0.0,0,0,0,0,0,0,7,0,0,2018-2019,90.0,0.0,0.0
914,Edoardo Goldaniga,ITA,DF,Frosinone,Serie A,24,1993,29.0,43,28,34,7,2,19,32,59.4,13,29,16,13,57,100,119,0,0,2018-2019,90.0,176.8965517241379,133.44827586206895
915,Pierluigi Gollini,ITA,GK,Atalanta,Serie A,23,1995,20.0,2,2,2,0,0,1,2,50.0,1,0,0,0,0,2,3,2,0,2018-2019,90.0,0.0,9.0
916,Aleksandr Golovin,RUS,"MF,FW",Monaco,Ligue 1,22,1996,25.4,36,17,3,20,13,10,44,22.7,34,34,3,31,22,58,12,0,0,2018-2019,90.0,77.95275590551182,127.55905511811024
917,André Gomes,POR,MF,Everton,Premier League,25,1993,22.0,39,23,12,24,3,13,59,22.0,46,27,4,23,20,59,18,0,0,2018-2019,90.0,81.81818181818183,159.54545454545456
918,Angel Gomes,ENG,"MF,FW",Manchester Utd,Premier League,17,2000,0.3,1,0,0,0,1,0,0,0.0,0,0,0,0,0,1,0,0,0,2018-2019,90.0,0.0,300.0
919,Ibai Gómez,ESP,FW,Athletic Club,La Liga,28,1989,6.4,6,3,3,2,1,4,9,44.4,5,8,1,7,2,8,8,0,0,2018-2019,90.0,28.125,84.375
920,Ibai Gómez,ESP,"MF,FW",Alavés,La Liga,28,1989,16.1,14,8,9,3,2,6,19,31.6,13,10,0,10,8,22,17,0,0,2018-2019,90.0,44.72049689440993,78.26086956521739
921,Joe Gomez,ENG,DF,Liverpool,Premier League,21,1997,11.8,18,11,10,7,1,9,15,60.0,6,10,5,5,14,32,42,0,0,2018-2019,90.0,106.77966101694915,137.28813559322032
922,Mario Gómez,GER,FW,Stuttgart,Bundesliga,33,1985,24.6,19,11,6,10,3,2,12,16.7,10,17,6,11,5,24,33,0,0,2018-2019,89.99999999999999,18.292682926829265,69.51219512195121
923,Maxi Gómez,URU,FW,Celta Vigo,La Liga,21,1996,32.9,6,4,1,4,1,1,12,8.3,11,3,0,3,2,8,43,0,0,2018-2019,90.0,5.471124620060791,16.41337386018237
924,Moi Gómez,ESP,MF,Huesca,La Liga,24,1994,33.9,42,28,15,25,2,11,46,23.9,35,27,3,24,28,70,27,0,0,2018-2019,90.0,74.33628318584071,111.50442477876106
925,Papu Gómez,ARG,"MF,FW",Atalanta,Serie A,30,1988,32.2,19,14,5,10,4,6,30,20.0,24,21,0,21,16,35,4,0,0,2018-2019,90.0,44.72049689440993,53.105590062111794
Rk,Player,Nation,Pos,Squad,Comp,0,0,90.0,0,0,3,3,3,Tkl,0,0.0,0,0,0,0,0,0,0,0,0,2018-2019,90.0,0.0,0.0
926,Sergi Gómez,ESP,DF,Sevilla,La Liga,26,1992,30.7,49,38,33,12,4,18,28,64.3,10,30,20,10,40,89,135,1,0,2018-2019,90.0,117.26384364820848,143.6482084690554
927,Alfred Gomis,SEN,GK,SPAL,Serie A,24,1993,19.2,0,0,0,0,0,0,1,0.0,1,0,0,0,1,1,14,1,0,2018-2019,90.0,4.6875,0.0
928,Maxime Gonalons,FRA,MF,Sevilla,La Liga,29,1989,6.0,8,4,2,5,1,1,15,6.7,14,10,4,6,5,13,12,0,0,2018-2019,90.0,75.0,120.0
929,Anthony Gonçalves,FRA,"MF,FW",Strasbourg,Ligue 1,32,1986,11.8,22,15,12,8,2,7,22,31.8,15,21,2,19,10,32,17,0,0,2018-2019,90.0,76.27118644067797,167.79661016949152
930,Jérôme Gondorf,GER,"MF,FW",Freiburg,Bundesliga,30,1988,14.4,33,18,12,19,2,14,28,50.0,14,29,5,24,19,52,23,1,0,2018-2019,90.0,118.75,206.25
931,Álvaro González,ESP,DF,Villarreal,La Liga,28,1990,32.9,49,35,33,14,2,25,35,71.4,10,34,24,10,37,86,177,2,0,2018-2019,90.0,101.21580547112463,134.04255319148936
932,Bruno González,ESP,DF,Getafe,La Liga,28,1990,18.9,23,10,14,8,1,9,18,50.0,9,13,6,7,22,45,110,0,0,2018-2019,90.0,104.76190476190476,109.52380952380953
933,Cristo González,ESP,FW,Real Madrid,La Liga,20,1997,0.5,1,0,0,1,0,0,0,0.0,0,0,0,0,1,2,0,0,0,2018-2019,90.0,180.0,180.0
934,Giancarlo González,CRC,DF,Bologna,Serie A,30,1988,8.3,13,7,12,1,0,5,9,55.6,4,15,11,4,12,25,42,0,0,2018-2019,90.0,130.12048192771084,140.96385542168673
935,Nicolás González,ARG,"FW,MF",Stuttgart,Bundesliga,20,1998,24.0,19,14,3,7,9,9,19,47.4,10,32,2,30,11,30,27,0,0,2018-2019,90.0,41.25,71.25
936,Jon Gorenc Stanković,SVN,"MF,DF",Huddersfield,Premier League,22,1996,7.9,26,18,18,7,1,14,26,53.8,12,16,9,7,9,35,20,1,0,2018-2019,90.0,102.53164556962024,296.2025316455696
937,Leon Goretzka,GER,MF,Bayern Munich,Bundesliga,23,1995,22.5,41,22,7,27,7,14,38,36.8,24,25,4,21,26,67,14,1,0,2018-2019,90.0,104.0,164.0
938,Mathieu Gorgelin,FRA,GK,Lyon,Ligue 1,27,1990,4.0,0,0,0,0,0,0,0,0.0,0,0,0,0,0,0,3,0,0,2018-2019,90.0,0.0,0.0
939,Mirko Gori,ITA,MF,Frosinone,Serie A,25,1993,3.7,16,13,7,9,0,5,16,31.3,11,2,0,2,4,20,9,0,0,2018-2019,90.0,97.29729729729729,389.18918918918916
940,Andoni Gorosabel,ESP,DF,Real Sociedad,La Liga,21,1996,5.1,16,9,10,5,1,8,13,61.5,5,5,1,4,4,20,20,1,0,2018-2019,90.0,70.58823529411765,282.3529411764706
941,Robin Gosens,GER,"DF,MF",Atalanta,Serie A,24,1994,21.6,63,46,32,26,5,37,54,68.5,17,41,3,38,38,101,60,0,0,2018-2019,90.0,158.33333333333331,262.5
942,Dan Gosling,ENG,MF,Bournemouth,Premier League,28,1990,19.3,57,23,27,21,9,28,53,52.8,25,33,11,22,20,77,46,1,0,2018-2019,90.0,93.2642487046632,265.8031088082901
943,Felix Götze,GER,MF,Augsburg,Bundesliga,20,1998,1.4,4,2,2,2,0,3,3,100.0,0,1,0,1,3,7,7,0,0,2018-2019,90.0,192.85714285714286,257.14285714285717
944,Mario Götze,GER,"FW,MF",Dortmund,Bundesliga,26,1992,18.6,26,19,6,11,9,4,25,16.0,21,10,0,10,8,34,4,1,0,2018-2019,90.0,38.70967741935483,125.8064516129032
945,Prince-Désir Gouano,FRA,DF,Amiens,Ligue 1,24,1993,29.1,31,18,25,5,1,12,22,54.5,10,36,27,9,46,77,127,6,0,2018-2019,90.0,142.26804123711338,95.8762886597938
946,Yoann Gourcuff,FRA,"MF,FW",Dijon,Ligue 1,32,1986,1.5,0,0,0,0,0,0,2,0.0,2,1,1,0,0,0,1,0,0,2018-2019,90.0,0.0,0.0
947,Jeffrey Gouweleeuw,NED,DF,Augsburg,Bundesliga,27,1991,23.2,42,31,23,19,0,24,39,61.5,15,44,21,23,56,98,71,1,0,2018-2019,90.0,217.24137931034483,162.93103448275863
948,Paolo Gozzi Iweru,ITA,DF,Juventus,Serie A,17,2001,1.0,3,2,2,1,0,0,0,0.0,0,0,0,0,3,6,3,0,0,2018-2019,90.0,270.0,270.0
949,Max Gradel,CIV,"FW,MF",Toulouse,Ligue 1,30,1987,36.0,58,35,34,19,5,24,70,34.3,46,53,9,44,18,76,41,0,0,2018-2019,90.0,45.0,145.0
950,Jonathan Gradit,FRA,DF,Caen,Ligue 1,25,1992,22.3,52,28,30,21,1,28,52,53.8,24,40,15,25,45,97,82,3,0,2018-2019,90.0,181.61434977578475,209.86547085201792
Rk,Player,Nation,Pos,Squad,Comp,0,0,90.0,0,0,3,3,3,Tkl,0,0.0,0,0,0,0,0,0,0,0,0,2018-2019,90.0,0.0,0.0
951,Samuel Grandsir,FRA,"MF,FW",Strasbourg,Ligue 1,21,1996,2.6,9,6,5,3,1,3,7,42.9,4,2,0,2,1,10,0,0,0,2018-2019,90.0,34.61538461538461,311.5384615384615
952,Samuel Grandsir,FRA,"FW,MF",Monaco,Ligue 1,21,1996,5.2,12,7,4,5,3,2,10,20.0,8,11,0,11,1,13,5,1,0,2018-2019,90.0,17.307692307692307,207.69230769230768
953,Álex Granell,ESP,"MF,DF",Girona,La Liga,29,1988,26.6,64,28,30,31,3,34,83,41.0,49,34,5,29,35,99,36,1,0,2018-2019,90.0,118.42105263157895,216.54135338345864
954,Esteban Granero,ESP,MF,Espanyol,La Liga,31,1987,22.4,50,32,26,18,6,17,50,34.0,33,42,8,34,26,76,34,2,0,2018-2019,90.0,104.46428571428572,200.89285714285714
955,Karlan Grant,ENG,FW,Huddersfield,Premier League,20,1997,9.7,5,2,1,2,2,1,3,33.3,2,8,0,8,2,7,1,1,0,2018-2019,90.0,18.556701030927837,46.39175257731959
956,Alberto Grassi,ITA,MF,Parma,Serie A,23,1995,5.1,20,12,7,10,3,2,10,20.0,8,8,2,6,8,28,10,0,0,2018-2019,90.0,141.1764705882353,352.94117647058823
957,Andre Gray,JAM,FW,Watford,Premier League,27,1991,15.2,3,1,0,2,1,1,6,16.7,5,3,1,2,2,5,6,0,0,2018-2019,90.0,11.842105263157894,17.763157894736842
958,Demarai Gray,JAM,"FW,MF",Leicester City,Premier League,22,1996,22.1,25,12,7,14,4,6,16,37.5,10,19,0,19,9,34,15,0,0,2018-2019,90.0,36.65158371040724,101.80995475113122
959,Mason Greenwood,ENG,FW,Manchester Utd,Premier League,16,2001,1.3,3,3,2,0,1,2,3,66.7,1,2,0,2,0,3,1,0,0,2018-2019,90.0,0.0,207.69230769230768
960,Michael Gregoritsch,AUT,"MF,FW",Augsburg,Bundesliga,24,1994,27.6,22,13,7,9,6,4,28,14.3,24,29,10,19,15,37,58,0,0,2018-2019,90.0,48.91304347826087,71.7391304347826
961,Clément Grenier,FRA,MF,Rennes,Ligue 1,27,1991,29.6,44,27,7,33,4,21,61,34.4,40,28,4,24,29,73,34,1,0,2018-2019,90.0,88.17567567567568,133.78378378378378
962,Antoine Griezmann,FRA,"FW,MF",Atlético Madrid,La Liga,27,1991,35.5,31,19,8,13,10,8,28,28.6,20,18,1,17,12,43,21,0,0,2018-2019,90.0,30.422535211267608,78.59154929577466
963,Vincenzo Grifo,ITA,"MF,FW",Hoffenheim,Bundesliga,25,1993,3.7,6,3,2,3,1,0,5,0.0,5,2,1,1,2,8,5,0,0,2018-2019,90.0,48.648648648648646,145.94594594594594
964,Vincenzo Grifo,ITA,"MF,FW",Freiburg,Bundesliga,25,1993,15.9,26,14,11,8,7,14,27,51.9,13,10,1,9,2,28,10,0,0,2018-2019,90.0,11.320754716981131,147.16981132075472
965,Florian Grillitsch,AUT,MF,Hoffenheim,Bundesliga,22,1995,26.6,77,49,30,38,9,36,80,45.0,44,34,8,26,72,149,56,1,0,2018-2019,90.0,243.60902255639095,260.52631578947364
966,Jérémy Grimm,FRA,MF,Strasbourg,Ligue 1,31,1987,1.9,4,2,2,2,0,3,5,60.0,2,1,0,1,4,8,5,0,0,2018-2019,90.0,189.4736842105263,189.4736842105263
967,Pascal Groß,GER,"MF,FW",Brighton,Premier League,27,1991,20.7,27,12,12,12,3,11,36,30.6,25,20,8,12,13,40,23,0,0,2018-2019,90.0,56.52173913043479,117.3913043478261
968,Sergej Grubac,MNE,FW,Chievo,Serie A,18,2000,1.7,2,1,1,0,1,1,1,100.0,0,1,0,1,0,2,1,0,0,2018-2019,90.0,0.0,105.88235294117646
969,Marko Grujić,SRB,MF,Hertha BSC,Bundesliga,22,1996,19.8,45,33,17,20,8,13,38,34.2,25,29,6,23,29,74,51,1,0,2018-2019,90.0,131.8181818181818,204.54545454545453
970,Vicente Guaita,ESP,GK,Crystal Palace,Premier League,31,1987,19.5,0,0,0,0,0,0,0,0.0,0,0,0,0,0,0,5,2,0,2018-2019,90.0,0.0,0.0
971,Andrés Guardado,MEX,"MF,DF",Betis,La Liga,31,1986,25.9,24,15,9,12,3,11,47,23.4,36,27,1,26,28,52,28,1,0,2018-2019,90.0,97.2972972972973,83.39768339768341
972,Sergi Guardiola,ESP,FW,Valladolid,La Liga,27,1991,16.8,19,11,1,10,8,2,13,15.4,11,12,0,12,5,24,17,0,0,2018-2019,90.0,26.785714285714285,101.78571428571428
973,Sergi Guardiola,ESP,"MF,FW",Getafe,La Liga,27,1991,0.3,1,1,0,1,0,0,0,0.0,0,0,0,0,0,1,0,0,0,2018-2019,90.0,0.0,300.0
974,Metehan Güçlü,TUR,MF,Paris S-G,Ligue 1,19,1999,0.2,0,0,0,0,0,0,0,0.0,0,0,0,0,0,0,0,0,0,2018-2019,90.0,0.0,0.0
975,Gonçalo Guedes,POR,"MF,FW",Valencia,La Liga,21,1996,16.3,31,13,16,12,3,14,43,32.6,29,15,0,15,7,38,1,0,0,2018-2019,90.0,38.65030674846626,171.16564417177915
Rk,Player,Nation,Pos,Squad,Comp,0,0,90.0,0,0,3,3,3,Tkl,0,0.0,0,0,0,0,0,0,0,0,0,2018-2019,90.0,0.0,0.0
976,Mattéo Guendouzi,FRA,MF,Arsenal,Premier League,19,1999,23.9,44,26,18,23,3,17,47,36.2,30,28,5,23,30,74,24,3,0,2018-2019,90.0,112.97071129707113,165.69037656903765
977,Javi Guerra,ESP,"FW,MF",Rayo Vallecano,La Liga,36,1982,2.6,3,3,1,1,1,0,3,0.0,3,2,0,2,1,4,0,0,0,2018-2019,90.0,34.61538461538461,103.84615384615384
978,Raphaël Guerreiro,POR,"FW,DF",Dortmund,Bundesliga,24,1993,17.0,25,12,11,7,7,12,23,52.2,11,7,1,6,18,43,12,1,0,2018-2019,90.0,95.29411764705883,132.35294117647058
979,Francis Guerrero,ESP,"DF,FW",Betis,La Liga,22,1996,19.8,51,28,25,16,10,23,41,56.1,18,15,1,14,21,72,47,4,0,2018-2019,90.0,95.45454545454545,231.8181818181818
980,Guido Guerrieri,ITA,GK,Lazio,Serie A,22,1996,1.0,0,0,0,0,0,0,0,0.0,0,0,0,0,0,0,2,0,0,2018-2019,90.0,0.0,0.0
981,Ander Guevara,ESP,MF,Real Sociedad,La Liga,21,1997,1.0,3,1,0,3,0,2,6,33.3,4,1,0,1,1,4,0,0,0,2018-2019,90.0,90.0,270.0
982,Makhtar Gueye,SEN,"FW,MF",Saint-Étienne,Ligue 1,20,1997,0.6,2,1,2,0,0,2,2,100.0,0,2,0,2,0,2,0,0,0,2018-2019,90.0,0.0,300.0
983,John Guidetti,SWE,FW,Alavés,La Liga,26,1992,7.0,4,1,0,3,1,0,4,0.0,4,4,0,4,1,5,6,0,0,2018-2019,90.0,12.857142857142858,51.42857142857143
984,Josuha Guilavogui,FRA,MF,Wolfsburg,Bundesliga,27,1990,17.4,31,16,18,13,0,14,25,56.0,11,17,8,9,43,74,56,2,0,2018-2019,90.0,222.41379310344828,160.3448275862069
985,Frederic Guilbert,FRA,DF,Caen,Ligue 1,23,1994,32.4,98,67,59,29,10,41,83,49.4,42,49,21,28,78,176,121,2,0,2018-2019,90.0,216.66666666666669,272.22222222222223
986,Baptiste Guillaume,BEL,FW,Nîmes,Ligue 1,23,1995,13.1,12,6,1,8,3,2,9,22.2,7,6,0,6,2,14,6,0,0,2018-2019,90.0,13.740458015267176,82.44274809160305
987,Serhou Guirassy,GUI,FW,Amiens,Ligue 1,22,1996,12.3,7,5,1,5,1,0,4,0.0,4,7,0,7,4,11,14,0,0,2018-2019,89.99999999999999,29.268292682926827,51.21951219512194
988,Péter Gulácsi,HUN,GK,RB Leipzig,Bundesliga,28,1990,32.5,0,0,0,0,0,0,0,0.0,0,0,0,0,0,0,11,0,0,2018-2019,90.0,0.0,0.0
989,Manuel Gulde,GER,DF,Freiburg,Bundesliga,27,1991,19.0,24,16,18,5,1,12,16,75.0,4,25,13,12,26,50,90,0,0,2018-2019,90.0,123.15789473684211,113.6842105263158
990,Gerard Gumbau,ESP,MF,Leganés,La Liga,23,1994,13.3,22,16,9,13,0,6,25,24.0,19,15,2,13,13,35,13,0,0,2018-2019,90.0,87.96992481203007,148.8721804511278
991,İlkay Gündoğan,GER,MF,Manchester City,Premier League,27,1990,23.7,19,12,4,12,3,6,31,19.4,25,12,3,9,28,47,19,1,0,2018-2019,90.0,106.32911392405065,72.15189873417722
992,Angus Gunn,SCO,GK,Southampton,Premier League,22,1996,12.0,0,0,0,0,0,0,0,0.0,0,0,0,0,0,0,8,3,0,2018-2019,90.0,0.0,0.0
993,Aron Gunnarsson,ISL,MF,Cardiff City,Premier League,29,1989,25.2,51,29,23,25,3,23,84,27.4,61,40,12,28,38,89,55,1,0,2018-2019,90.0,135.71428571428572,182.14285714285717
994,Christian Günter,GER,"DF,MF",Freiburg,Bundesliga,25,1993,32.0,38,26,16,16,6,20,43,46.5,23,31,7,24,14,52,55,0,0,2018-2019,90.0,39.375,106.875
995,Koray Günter,GER,DF,Genoa,Serie A,23,1994,9.3,18,13,13,3,2,9,16,56.3,7,9,7,2,18,36,34,0,0,2018-2019,90.0,174.19354838709674,174.19354838709674
996,Serdar Gürler,TUR,"MF,FW",Huesca,La Liga,26,1991,5.4,5,5,3,2,0,3,11,27.3,8,8,0,8,1,6,2,0,0,2018-2019,90.0,16.666666666666664,83.33333333333333
997,Ahmet Gürleyen,GER,DF,Mainz 05,Bundesliga,19,1999,0.1,0,0,0,0,0,0,0,0.0,0,0,0,0,0,0,1,0,0,2018-2019,90.0,0.0,0.0
998,Régis Gurtner,FRA,GK,Amiens,Ligue 1,31,1986,38.0,1,1,1,0,0,0,1,0.0,1,0,0,0,1,2,7,3,0,2018-2019,90.0,2.3684210526315788,2.3684210526315788
999,Gorka Guruzeta,ESP,"MF,FW",Athletic Club,La Liga,21,1996,0.6,1,1,1,0,0,0,2,0.0,2,1,0,1,2,3,0,0,0,2018-2019,90.0,300.0,150.0
1000,Luiz Gustavo,BRA,"MF,DF",Marseille,Ligue 1,31,1987,27.1,72,43,49,18,5,30,66,45.5,36,26,12,14,34,106,61,0,0,2018-2019,90.0,112.91512915129151,239.11439114391143
Rk,Player,Nation,Pos,Squad,Comp,0,0,90.0,0,0,3,3,3,Tkl,0,0.0,0,0,0,0,0,0,0,0,0,2018-2019,90.0,0.0,0.0
1001,Jonathan de Guzmán,NED,MF,Eint Frankfurt,Bundesliga,30,1987,17.4,34,24,11,20,3,13,28,46.4,15,18,2,16,11,45,16,0,0,2018-2019,90.0,56.89655172413793,175.86206896551724
1002,Janik Haberer,GER,"MF,FW",Freiburg,Bundesliga,24,1994,26.0,71,47,37,24,10,30,75,40.0,45,31,4,27,36,107,49,0,0,2018-2019,90.00000000000001,124.61538461538463,245.7692307692308
1003,Hacen,MTN,MF,Valladolid,La Liga,20,1997,0.0,0,0,0,0,0,0,0,0.0,0,1,0,1,1,1,1,0,0,2018-2019,,inf,
1004,Alexander Hack,GER,DF,Mainz 05,Bundesliga,24,1993,11.3,29,13,20,9,0,19,28,67.9,9,26,15,11,41,70,59,2,0,2018-2019,90.0,326.5486725663717,230.97345132743362
1005,Munir El Haddadi,MAR,"FW,MF",Sevilla,La Liga,22,1995,11.6,17,10,5,7,5,2,7,28.6,5,15,0,15,6,23,9,0,0,2018-2019,90.0,46.55172413793103,131.89655172413794
1006,Munir El Haddadi,MAR,FW,Barcelona,La Liga,22,1995,1.7,3,3,1,1,1,1,3,33.3,2,1,0,1,0,3,1,0,0,2018-2019,90.0,0.0,158.8235294117647
1007,Oussama Haddadi,TUN,DF,Dijon,Ligue 1,26,1992,29.7,51,25,38,11,2,24,43,55.8,19,33,8,25,45,96,93,2,0,2018-2019,90.0,136.36363636363635,154.54545454545453
1008,Florent Hadergjonaj,KVX,"DF,MF",Huddersfield,Premier League,24,1994,20.5,30,17,10,18,2,13,37,35.1,24,21,7,14,21,51,37,1,0,2018-2019,90.0,92.19512195121952,131.70731707317074
1009,Benjamin Hadžić,BIH,"FW,MF",Hannover 96,Bundesliga,19,1999,0.3,0,0,0,0,0,0,1,0.0,1,0,0,0,0,0,0,0,0,2018-2019,90.0,0.0,0.0
1010,André Hahn,GER,"FW,MF",Augsburg,Bundesliga,27,1990,22.8,64,38,22,39,3,22,53,41.5,31,28,2,26,27,91,32,0,0,2018-2019,90.0,106.57894736842104,252.6315789473684
1011,Amadou Haidara,MLI,MF,RB Leipzig,Bundesliga,20,1998,4.2,13,11,4,8,1,8,14,57.1,6,9,1,8,4,17,7,0,0,2018-2019,90.0,85.71428571428571,278.57142857142856
1012,Oualid El Hajjam,MAR,"DF,MF",Amiens,Ligue 1,27,1991,6.0,14,9,10,3,1,5,15,33.3,10,8,2,6,12,26,26,0,0,2018-2019,90.0,180.0,210.0
1013,Achraf Hakimi,MAR,DF,Dortmund,Bundesliga,19,1998,19.3,34,19,25,8,1,17,36,47.2,19,27,4,23,29,63,45,2,0,2018-2019,90.0,135.23316062176164,158.54922279792746
1014,Sébastien Haller,CIV,FW,Eint Frankfurt,Bundesliga,24,1994,24.2,24,11,7,10,7,8,21,38.1,13,21,1,20,15,39,23,0,0,2018-2019,90.0,55.785123966942145,89.25619834710743
1015,Emil Hallfreðsson,ISL,MF,Udinese,Serie A,34,1984,1.5,0,0,0,0,0,0,1,0.0,1,1,1,0,3,3,4,0,0,2018-2019,90.0,180.0,0.0
1016,Emil Hallfreðsson,ISL,MF,Frosinone,Serie A,34,1984,4.4,10,6,5,4,1,0,9,0.0,9,4,1,3,2,12,3,0,0,2018-2019,90.0,40.90909090909091,204.54545454545453
1017,Marcel Halstenberg,GER,"DF,FW",RB Leipzig,Bundesliga,26,1991,26.8,68,44,31,24,13,42,65,64.6,23,27,4,23,38,106,69,0,0,2018-2019,90.0,127.61194029850745,228.35820895522386
1018,Ben Hamer,ENG,GK,Huddersfield,Premier League,30,1987,6.1,0,0,0,0,0,0,3,0.0,3,0,0,0,1,1,3,2,0,2018-2019,90.0,14.754098360655739,0.0
1019,Romain Hamouma,FRA,"FW,MF",Saint-Étienne,Ligue 1,31,1987,17.6,30,19,6,18,6,12,32,37.5,20,12,1,11,9,39,7,0,0,2018-2019,90.0,46.02272727272727,153.4090909090909
1020,Marek Hamšík,SVK,MF,Napoli,Serie A,31,1987,10.2,7,5,2,4,1,0,11,0.0,11,8,1,7,12,19,14,1,0,2018-2019,90.0,105.88235294117648,61.76470588235294
1021,Dávid Hancko,SVK,DF,Fiorentina,Serie A,20,1997,3.1,7,6,4,3,0,6,9,66.7,3,3,1,2,3,10,12,0,0,2018-2019,90.0,87.09677419354838,203.2258064516129
1022,Samir Handanović,SVN,GK,Inter,Serie A,34,1984,38.0,1,0,1,0,0,1,1,100.0,0,0,0,0,0,1,12,1,0,2018-2019,90.0,0.0,2.3684210526315788
1023,Genki Haraguchi,JPN,"MF,DF",Hannover 96,Bundesliga,27,1991,23.7,44,26,21,20,3,17,66,25.8,49,34,5,29,21,65,33,0,0,2018-2019,90.0,79.74683544303798,167.08860759493672
1024,Féthi Harek,ALG,DF,Nîmes,Ligue 1,35,1982,2.0,4,4,2,2,0,3,4,75.0,1,1,0,1,1,5,6,0,0,2018-2019,90.0,45.0,180.0
1025,Amine Harit,MAR,"MF,FW",Schalke 04,Bundesliga,21,1997,12.0,15,8,4,9,2,8,24,33.3,16,11,1,10,9,24,2,0,0,2018-2019,90.0,67.5,112.5
Rk,Player,Nation,Pos,Squad,Comp,0,0,90.0,0,0,3,3,3,Tkl,0,0.0,0,0,0,0,0,0,0,0,0,2018-2019,90.0,0.0,0.0
1026,Martin Harnik,AUT,"FW,MF",Werder Bremen,Bundesliga,31,1987,9.2,12,7,4,3,5,4,15,26.7,11,8,0,8,3,15,10,0,0,2018-2019,90.0,29.347826086956523,117.3913043478261
1027,Kadeem Harris,ENG,MF,Cardiff City,Premier League,25,1993,4.2,12,5,6,4,2,7,8,87.5,1,3,0,3,3,15,5,0,0,2018-2019,90.0,64.28571428571428,257.1428571428571
1028,Joe Hart,ENG,GK,Burnley,Premier League,31,1987,19.0,0,0,0,0,0,0,1,0.0,1,0,0,0,0,0,11,3,0,2018-2019,90.0,0.0,0.0
1029,Makoto Hasebe,JPN,"DF,MF",Eint Frankfurt,Bundesliga,34,1984,28.0,52,34,35,17,0,25,42,59.5,17,43,22,21,40,92,101,3,0,2018-2019,90.0,128.57142857142856,167.14285714285714
1030,Hans Hateboer,NED,DF,Atalanta,Serie A,24,1994,33.0,43,31,19,19,5,17,34,50.0,17,29,5,24,23,66,47,1,0,2018-2019,90.0,62.727272727272734,117.27272727272728
1031,Kai Havertz,GER,"MF,FW",Leverkusen,Bundesliga,19,1999,32.2,26,17,10,11,5,8,32,25.0,24,31,4,27,16,42,29,0,0,2018-2019,90.0,44.72049689440993,72.67080745341615
1032,Isaac Hayden,ENG,MF,Newcastle Utd,Premier League,23,1995,20.7,73,43,19,45,9,23,41,56.1,18,32,4,28,40,113,30,0,0,2018-2019,90.0,173.91304347826087,317.3913043478261
1033,Eden Hazard,BEL,FW,Chelsea,Premier League,27,1991,32.5,14,9,2,1,11,5,17,29.4,12,10,0,10,13,27,6,1,0,2018-2019,90.0,36.0,38.76923076923077
1034,Thorgan Hazard,BEL,"FW,MF",Gladbach,Bundesliga,25,1993,31.9,50,33,22,20,8,17,48,35.4,31,35,2,33,27,77,12,0,0,2018-2019,90.0,76.17554858934169,141.06583072100312
1035,Rhys Healey,WAL,FW,Cardiff City,Premier League,23,1994,0.6,1,0,0,1,0,0,1,0.0,1,0,0,0,0,1,0,0,0,2018-2019,90.0,0.0,150.0
1036,Tom Heaton,ENG,GK,Burnley,Premier League,32,1986,19.0,0,0,0,0,0,0,2,0.0,2,0,0,0,0,0,8,2,0,2018-2019,90.0,0.0,0.0
1037,Dominique Heintz,GER,DF,Freiburg,Bundesliga,24,1993,33.9,41,21,34,6,1,18,32,56.3,14,45,22,23,45,86,214,0,0,2018-2019,90.0,119.46902654867257,108.8495575221239
1038,Filip Helander,SWE,DF,Bologna,Serie A,25,1993,19.0,42,26,25,13,4,19,23,82.6,4,27,16,11,14,56,84,0,0,2018-2019,90.0,66.3157894736842,198.94736842105263
1039,Jordan Henderson,ENG,MF,Liverpool,Premier League,28,1990,22.1,46,36,20,22,4,16,39,41.0,23,27,3,24,30,76,17,0,0,2018-2019,90.0,122.17194570135746,187.33031674208144
1040,Jeff Hendrick,IRL,"MF,FW",Burnley,Premier League,26,1992,22.9,24,12,13,7,4,9,32,28.1,23,20,5,15,12,36,31,0,0,2018-2019,90.0,47.16157205240175,94.3231441048035
1041,Wayne Hennessey,WAL,GK,Crystal Palace,Premier League,31,1987,17.5,0,0,0,0,0,0,2,0.0,2,0,0,0,0,0,5,1,0,2018-2019,90.0,0.0,0.0
1042,Rouwen Hennings,GER,FW,Düsseldorf,Bundesliga,30,1987,20.4,14,10,1,8,5,2,13,15.4,11,16,1,15,4,18,20,0,0,2018-2019,90.0,17.647058823529413,61.76470588235294
1043,Benjamin Henrichs,GER,"DF,MF",Monaco,Ligue 1,21,1997,20.3,58,39,32,22,4,16,38,42.1,22,18,0,18,35,93,45,0,0,2018-2019,90.0,155.17241379310343,257.1428571428571
1044,Benjamin Henrichs,GER,DF,Leverkusen,Bundesliga,21,1997,0.7,0,0,0,0,0,0,0,0.0,0,2,0,2,3,3,0,0,0,2018-2019,90.0,385.7142857142857,0.0
1045,Dalbert Henrique,BRA,DF,Inter,Serie A,24,1993,8.6,33,24,18,14,1,12,21,57.1,9,9,3,6,8,41,20,0,0,2018-2019,90.0,83.72093023255815,345.34883720930236
1046,Uche Henry Agbo,NGA,MF,Rayo Vallecano,La Liga,22,1995,4.1,7,4,3,4,0,5,10,50.0,5,3,1,2,6,13,1,0,0,2018-2019,90.0,131.70731707317074,153.65853658536588
1047,Christophe Hérelle,MTQ,DF,Nice,Ligue 1,25,1992,32.6,72,52,51,19,2,40,50,80.0,10,39,16,23,61,133,158,2,0,2018-2019,90.0,168.40490797546013,198.77300613496934
1048,Mario Hermoso,ESP,DF,Espanyol,La Liga,23,1995,31.2,38,24,29,7,2,21,39,53.8,18,34,25,9,37,75,175,2,0,2018-2019,90.0,106.73076923076923,109.61538461538461
1049,Javier Hernández,MEX,FW,West Ham,Premier League,30,1988,14.8,3,0,0,3,0,0,6,0.0,6,8,1,7,1,4,8,0,0,2018-2019,90.0,6.081081081081081,18.243243243243242
1050,Lucas Hernández,FRA,DF,Atlético Madrid,La Liga,22,1996,12.4,35,25,20,14,1,17,20,85.0,3,17,9,8,14,49,49,0,0,2018-2019,90.0,101.61290322580645,254.03225806451613
Rk,Player,Nation,Pos,Squad,Comp,0,0,90.0,0,0,3,3,3,Tkl,0,0.0,0,0,0,0,0,0,0,0,0,2018-2019,90.0,0.0,0.0
1051,Theo Hernández,FRA,DF,Real Sociedad,La Liga,20,1997,22.0,54,33,30,15,9,28,44,63.6,16,21,5,16,33,87,42,3,0,2018-2019,90.0,135.0,220.9090909090909
1052,Ander Herrera,ESP,MF,Manchester Utd,Premier League,28,1989,15.6,54,28,24,22,8,21,61,34.4,40,38,6,32,37,91,25,1,0,2018-2019,90.0,213.46153846153845,311.53846153846155
1053,Yangel Herrera,VEN,"MF,DF",Huesca,La Liga,20,1998,12.8,48,24,18,25,5,23,43,53.5,20,13,1,12,14,62,32,0,0,2018-2019,90.0,98.4375,337.5
1054,Iago Herrerín,ESP,GK,Athletic Club,La Liga,30,1988,31.0,0,0,0,0,0,0,2,0.0,2,0,0,0,0,0,11,2,0,2018-2019,90.0,0.0,0.0
1055,Patrick Herrmann,GER,"FW,DF",Gladbach,Bundesliga,27,1991,12.0,20,14,8,7,5,6,17,35.3,11,6,3,3,6,26,12,0,0,2018-2019,90.0,45.0,150.0
1056,Pablo Hervías,ESP,MF,Valladolid,La Liga,25,1993,1.8,1,0,0,1,0,0,1,0.0,1,0,0,0,2,3,0,0,0,2018-2019,90.0,100.0,50.0
1057,Pablo Hervías,ESP,MF,Eibar,La Liga,25,1993,2.0,1,1,0,1,0,0,4,0.0,4,2,0,2,0,1,0,0,0,2018-2019,90.0,0.0,45.0
1058,Përparim Hetemaj,FIN,MF,Chievo,Serie A,31,1986,24.0,53,27,27,23,3,20,68,29.4,48,25,1,24,30,83,24,2,0,2018-2019,90.0,112.5,198.75
1059,Son Heung-min,KOR,"FW,MF",Tottenham,Premier League,26,1992,22.7,23,12,7,12,4,10,34,29.4,24,26,2,24,8,31,4,1,0,2018-2019,89.99999999999999,31.71806167400881,91.18942731277532
1060,Gonzalo Higuaín,ARG,FW,Chelsea,Premier League,30,1987,12.1,10,7,2,4,4,2,11,18.2,9,4,0,4,1,11,5,0,0,2018-2019,90.0,7.43801652892562,74.3801652892562
1061,Gonzalo Higuaín,ARG,FW,Milan,Serie A,30,1987,14.2,8,6,1,5,2,5,13,38.5,8,3,0,3,0,8,11,1,0,2018-2019,90.0,0.0,50.70422535211268
1062,Oscar Hiljemark,SWE,MF,Genoa,Serie A,26,1992,13.3,16,9,8,7,1,5,16,31.3,11,13,3,10,13,29,14,0,0,2018-2019,90.0,87.96992481203007,108.27067669172932
1063,Vitorino Hilton,BRA,DF,Montpellier,Ligue 1,40,1977,35.9,33,13,28,5,0,12,30,40.0,18,31,15,16,66,99,198,2,0,2018-2019,90.0,165.45961002785518,82.72980501392759
1064,Martin Hinteregger,AUT,DF,Augsburg,Bundesliga,25,1992,17.5,48,35,31,16,1,24,35,68.6,11,24,13,11,22,70,68,0,0,2018-2019,90.0,113.14285714285714,246.85714285714286
1065,Martin Hinteregger,AUT,DF,Eint Frankfurt,Bundesliga,25,1992,12.7,34,26,19,12,3,13,28,46.4,15,20,7,13,13,47,51,0,0,2018-2019,90.0,92.1259842519685,240.9448818897638
1066,Marwin Hitz,SUI,GK,Dortmund,Bundesliga,30,1987,2.0,0,0,0,0,0,0,0,0.0,0,0,0,0,0,0,0,1,0,2018-2019,90.0,0.0,0.0
1067,Andrew Hjulsager,DEN,"MF,FW",Celta Vigo,La Liga,23,1995,4.0,16,10,11,2,3,2,18,11.1,16,4,0,4,2,18,1,0,0,2018-2019,90.0,45.0,360.0
1068,Wesley Hoedt,NED,DF,Southampton,Premier League,24,1994,13.0,28,12,23,5,0,17,26,65.4,9,20,13,7,23,51,79,2,0,2018-2019,90.00000000000001,159.23076923076925,193.84615384615387
1069,Wesley Hoedt,NED,DF,Celta Vigo,La Liga,24,1994,9.9,17,11,15,2,0,12,17,70.6,5,17,11,6,11,28,58,3,0,2018-2019,90.0,100.0,154.54545454545453
1070,André Hoffmann,GER,"DF,MF",Düsseldorf,Bundesliga,25,1993,11.7,22,14,12,10,0,9,25,36.0,16,17,12,5,21,43,44,0,0,2018-2019,89.99999999999999,161.53846153846152,169.23076923076923
1071,Nicolas Höfler,GER,MF,Freiburg,Bundesliga,28,1990,17.9,45,22,19,22,4,14,36,38.9,22,21,4,17,32,77,41,0,0,2018-2019,90.0,160.89385474860336,226.2569832402235
1072,Jonas Hofmann,GER,MF,Gladbach,Bundesliga,26,1992,21.2,37,18,11,19,7,9,37,24.3,28,33,2,31,16,53,14,1,0,2018-2019,90.0,67.9245283018868,157.0754716981132
1073,Jonathan Hogg,ENG,MF,Huddersfield,Premier League,29,1988,26.3,78,41,18,51,9,27,69,39.1,42,46,7,39,73,151,19,1,0,2018-2019,90.0,249.80988593155894,266.92015209125475
1074,Junior Hoilett,CAN,"MF,FW",Cardiff City,Premier League,28,1990,23.8,40,27,26,11,3,15,53,28.3,38,34,0,34,32,72,30,0,0,2018-2019,90.00000000000001,121.00840336134455,151.26050420168067
1075,Rob Holding,ENG,DF,Arsenal,Premier League,22,1995,9.0,11,7,9,2,0,2,8,25.0,6,9,7,2,12,23,40,0,0,2018-2019,90.0,120.0,110.0
Rk,Player,Nation,Pos,Squad,Comp,0,0,90.0,0,0,3,3,3,Tkl,0,0.0,0,0,0,0,0,0,0,0,0,2018-2019,90.0,0.0,0.0
1076,José Holebas,GRE,DF,Watford,Premier League,34,1984,26.6,68,40,44,20,4,28,53,52.8,25,27,8,19,21,89,97,0,0,2018-2019,90.0,71.05263157894737,230.0751879699248
1077,Lucas Höler,GER,FW,Freiburg,Bundesliga,24,1994,11.2,18,13,6,9,3,4,18,22.2,14,10,1,9,3,21,15,2,0,2018-2019,90.0,24.107142857142858,144.64285714285714
1078,Mason Holgate,ENG,DF,Everton,Premier League,21,1996,4.5,5,4,4,1,0,1,1,100.0,0,3,2,1,3,8,32,0,0,2018-2019,90.0,60.0,100.0
1079,Gerrit Holtmann,PHI,"FW,MF",Mainz 05,Bundesliga,23,1995,1.6,2,0,1,0,1,1,2,50.0,1,3,2,1,4,6,1,0,0,2018-2019,90.0,225.0,112.5
1080,Justin Hoogma,NED,"DF,MF",Hoffenheim,Bundesliga,20,1998,1.2,4,2,2,1,1,2,2,100.0,0,3,1,2,2,6,1,0,0,2018-2019,90.0,150.0,300.0
1081,Lukáš Hrádecký,FIN,GK,Leverkusen,Bundesliga,28,1989,32.0,0,0,0,0,0,0,1,0.0,1,0,0,0,1,1,9,1,0,2018-2019,90.0,2.8125,0.0
1082,Branimir Hrgota,SWE,FW,Eint Frankfurt,Bundesliga,25,1993,0.1,0,0,0,0,0,0,0,0.0,0,0,0,0,0,0,0,0,0,2018-2019,90.0,0.0,0.0
1083,Benjamin Hübner,GER,DF,Hoffenheim,Bundesliga,29,1989,9.0,29,18,18,9,2,14,18,77.8,4,16,7,9,21,50,35,0,0,2018-2019,90.0,210.0,290.0
1084,Tomáš Hubočan,SVK,DF,Marseille,Ligue 1,32,1985,0.8,3,2,3,0,0,3,4,75.0,1,0,0,0,2,5,5,0,0,2018-2019,90.0,225.0,337.5
1085,Callum Hudson-Odoi,ENG,FW,Chelsea,Premier League,17,2000,4.4,8,6,8,0,0,2,4,50.0,2,1,0,1,3,11,0,0,0,2018-2019,90.0,61.36363636363636,163.63636363636363
1086,Will Hughes,ENG,MF,Watford,Premier League,23,1995,26.9,74,43,27,35,12,25,59,42.4,34,55,6,49,25,99,30,0,0,2018-2019,90.0,83.64312267657994,247.5836431226766
1087,Vitor Hugo,BRA,DF,Fiorentina,Serie A,27,1991,27.4,64,42,38,25,1,17,27,63.0,10,28,13,15,74,138,141,2,0,2018-2019,90.0,243.06569343065698,210.2189781021898
1088,Mats Hummels,GER,DF,Bayern Munich,Bundesliga,29,1988,19.7,26,17,19,6,1,9,24,37.5,15,20,8,12,34,60,50,1,0,2018-2019,90.0,155.32994923857868,118.78172588832487
1089,Adrien Hunou,FRA,"FW,MF",Rennes,Ligue 1,24,1994,13.8,11,7,3,5,3,2,9,22.2,7,14,0,14,5,16,8,0,0,2018-2019,90.0,32.60869565217391,71.7391304347826
1090,Emerson Hyndman,USA,MF,Bournemouth,Premier League,22,1996,0.4,6,2,6,0,0,2,3,66.7,1,0,0,0,1,7,0,0,0,2018-2019,90.0,225.0,1350.0
1091,Elseid Hysaj,ALB,DF,Napoli,Serie A,24,1994,23.4,40,28,22,15,3,25,49,51.0,24,11,3,8,24,64,51,0,0,2018-2019,89.99999999999999,92.3076923076923,153.84615384615384
1092,Suk Hyun-jun,KOR,FW,Reims,Ligue 1,27,1991,8.8,11,8,1,6,4,0,8,0.0,8,2,1,1,2,13,4,1,0,2018-2019,90.0,20.454545454545453,112.5
1093,Pierre Højbjerg,DEN,MF,Southampton,Premier League,22,1995,30.7,71,49,20,44,7,24,73,32.9,49,51,8,43,60,131,30,1,0,2018-2019,90.0,175.89576547231272,208.14332247557005
1094,Simone Iacoponi,ITA,DF,Parma,Serie A,31,1987,37.2,62,43,50,11,1,27,47,57.4,20,40,26,14,37,99,178,3,0,2018-2019,90.0,89.51612903225805,149.99999999999997
1095,Robert Ibáñez,ESP,MF,Getafe,La Liga,25,1993,0.8,2,2,1,1,0,0,1,0.0,1,3,0,3,0,2,0,0,0,2018-2019,90.0,0.0,225.0
1096,Roger Ibanez,BRA,"DF,FW",Atalanta,Serie A,19,1998,0.0,0,0,0,0,0,0,0,0.0,0,0,0,0,0,0,1,0,0,2018-2019,,,
1097,Jordon Ibe,ENG,"MF,DF",Bournemouth,Premier League,22,1995,8.9,6,5,0,5,1,2,7,28.6,5,2,0,2,4,10,4,0,0,2018-2019,90.0,40.449438202247194,60.67415730337079
1098,Vedad Ibišević,BIH,FW,Hertha BSC,Bundesliga,33,1984,20.1,12,8,2,5,5,0,10,0.0,10,10,4,6,3,15,20,0,0,2018-2019,90.0,13.432835820895521,53.731343283582085
1099,Vicente Iborra,ESP,MF,Leicester City,Premier League,30,1988,2.5,4,1,1,3,0,0,7,0.0,7,1,0,1,8,12,4,1,0,2018-2019,90.0,288.0,144.0
1100,Vicente Iborra,ESP,MF,Villarreal,La Liga,30,1988,18.5,31,18,22,5,4,14,37,37.8,23,25,7,18,22,53,41,1,0,2018-2019,90.0,107.02702702702703,150.8108108108108
Rk,Player,Nation,Pos,Squad,Comp,0,0,90.0,0,0,3,3,3,Tkl,0,0.0,0,0,0,0,0,0,0,0,0,2018-2019,90.0,0.0,0.0
1101,Didier Ibrahim Ndong,GAB,MF,Guingamp,Ligue 1,24,1994,8.3,16,11,3,13,0,5,13,38.5,8,15,3,12,15,31,6,1,0,2018-2019,90.0,162.65060240963854,173.49397590361443
1102,Mauro Icardi,ARG,FW,Inter,Serie A,25,1993,25.2,9,8,2,2,5,1,6,16.7,5,4,1,3,3,12,20,1,0,2018-2019,90.0,10.714285714285715,32.142857142857146
1103,Salvador Ichazo,URU,GK,Torino,Serie A,26,1992,2.8,0,0,0,0,0,0,0,0.0,0,0,0,0,0,0,0,0,0,2018-2019,90.0,0.0,0.0
1104,Edgar Ié,GNB,DF,Lille,Ligue 1,24,1994,2.7,5,4,3,2,0,3,5,60.0,2,2,1,1,7,12,17,0,0,2018-2019,90.0,233.33333333333331,166.66666666666666
1105,Edgar Ié,GNB,DF,Nantes,Ligue 1,24,1994,8.6,20,13,12,6,2,9,16,56.3,7,10,3,7,8,28,23,0,0,2018-2019,90.0,83.72093023255815,209.30232558139537
1106,Borja Iglesias,ESP,FW,Espanyol,La Liga,25,1993,34.2,23,14,7,8,8,5,24,20.8,19,14,6,8,7,30,41,0,0,2018-2019,90.0,18.42105263157895,60.526315789473685
1107,Kelechi Iheanacho,NGA,"FW,MF",Leicester City,Premier League,21,1996,10.5,6,5,4,1,1,1,5,20.0,4,5,0,5,2,8,3,0,0,2018-2019,90.0,17.142857142857142,51.42857142857143
1108,Jordan Ikoko,COD,DF,Guingamp,Ligue 1,24,1994,19.0,37,24,22,14,1,16,28,57.1,12,18,5,13,24,61,30,0,0,2018-2019,90.0,113.6842105263158,175.26315789473685
1109,Jonathan Ikone,FRA,"MF,FW",Lille,Ligue 1,20,1998,31.1,25,14,7,12,6,8,30,26.7,22,24,2,22,6,31,4,0,0,2018-2019,90.0,17.363344051446944,72.34726688102894
1110,Ivo Iličević,CRO,MF,Nürnberg,Bundesliga,31,1986,0.4,1,0,0,1,0,1,2,50.0,1,1,0,1,0,1,0,0,0,2018-2019,90.0,0.0,225.0
1111,Josip Iličić,SVN,"FW,MF",Atalanta,Serie A,30,1988,23.8,15,7,2,7,6,5,20,25.0,15,20,1,19,5,20,2,0,0,2018-2019,90.00000000000001,18.907563025210084,56.72268907563026
1112,Asier Illarramendi,ESP,MF,Real Sociedad,La Liga,28,1990,20.2,39,24,22,14,3,21,51,41.2,30,36,9,27,31,70,46,1,0,2018-2019,90.0,138.11881188118812,173.76237623762376
1113,Stefan Ilsanker,AUT,"DF,MF",RB Leipzig,Bundesliga,29,1989,10.4,26,17,15,10,1,14,23,60.9,9,9,2,7,18,44,43,1,0,2018-2019,90.0,155.76923076923075,224.99999999999997
1114,Giannelli Imbula,COD,MF,Rayo Vallecano,La Liga,25,1992,19.2,14,7,6,7,1,5,12,41.7,7,12,3,9,8,22,6,0,0,2018-2019,90.0,37.5,65.625
1115,Ciro Immobile,ITA,FW,Lazio,Serie A,28,1990,31.8,12,6,4,3,5,4,9,44.4,5,18,1,17,1,13,8,0,0,2018-2019,90.0,2.830188679245283,33.9622641509434
1116,Emmanuel Imorou,BEN,DF,Caen,Ligue 1,29,1988,12.4,18,13,10,7,1,11,17,64.7,6,14,4,10,28,46,49,1,0,2018-2019,90.0,203.2258064516129,130.6451612903226
1117,Svante Ingelsson,SWE,"DF,MF",Udinese,Serie A,20,1998,1.1,1,1,1,0,0,0,0,0.0,0,2,0,2,0,1,4,0,0,2018-2019,90.0,0.0,81.81818181818181
1118,Roberto Inglese,ITA,FW,Parma,Serie A,26,1991,21.8,20,14,7,7,6,1,13,7.7,12,26,2,24,6,26,27,0,0,2018-2019,90.0,24.77064220183486,82.56880733944953
1119,Danny Ings,ENG,FW,Southampton,Premier League,26,1992,18.3,30,14,5,19,6,11,28,39.3,17,30,2,28,5,35,9,0,0,2018-2019,90.0,24.59016393442623,147.54098360655738
1120,Lorenzo Insigne,ITA,"FW,MF",Napoli,Serie A,27,1991,23.0,14,4,5,6,3,6,18,33.3,12,7,0,7,8,22,3,0,0,2018-2019,90.0,31.30434782608696,54.78260869565218
1121,Emiliano Insúa,ARG,DF,Stuttgart,Bundesliga,29,1989,23.5,51,33,26,18,7,25,42,59.5,17,29,2,27,31,82,55,1,0,2018-2019,90.0,118.72340425531914,195.3191489361702
1122,Pablo Insua,ESP,DF,Huesca,La Liga,24,1993,8.6,23,10,14,9,0,8,15,53.3,7,2,0,2,12,35,40,0,0,2018-2019,90.0,125.58139534883722,240.69767441860466
1123,Takashi Inui,JPN,"MF,FW",Alavés,La Liga,30,1988,9.2,9,5,6,2,1,5,18,27.8,13,5,0,5,4,13,3,0,0,2018-2019,90.0,39.130434782608695,88.04347826086958
1124,Takashi Inui,JPN,MF,Betis,La Liga,30,1988,4.2,4,3,0,4,0,3,7,42.9,4,3,0,3,1,5,1,0,0,2018-2019,90.0,21.428571428571427,85.71428571428571
1125,Artur Ioniță,MDA,MF,Cagliari,Serie A,27,1990,33.0,67,38,23,31,13,16,57,28.1,41,40,5,35,27,94,30,0,0,2018-2019,90.0,73.63636363636364,182.72727272727275
Rk,Player,Nation,Pos,Squad,Comp,0,0,90.0,0,0,3,3,3,Tkl,0,0.0,0,0,0,0,0,0,0,0,0,2018-2019,90.0,0.0,0.0
1126,Gorka Iraizoz,ESP,GK,Girona,La Liga,37,1981,6.2,1,0,1,0,0,1,1,100.0,0,0,0,0,1,2,7,0,0,2018-2019,90.0,14.516129032258064,14.516129032258064
1127,Carlos Isaac,ESP,DF,Atlético Madrid,La Liga,20,1998,1.0,0,0,0,0,0,0,2,0.0,2,2,0,2,1,1,2,0,0,2018-2019,90.0,90.0,0.0
1128,Isco,ESP,"MF,FW",Real Madrid,La Liga,26,1992,13.2,29,14,14,8,7,14,34,41.2,20,9,1,8,6,35,3,0,0,2018-2019,90.0,40.90909090909091,197.72727272727272
1129,Mikael Ishak,SWE,FW,Nürnberg,Bundesliga,25,1993,21.3,9,6,3,6,0,3,16,18.8,13,8,3,5,3,12,10,0,0,2018-2019,90.0,12.67605633802817,38.028169014084504
1130,Wilson Isidor,FRA,FW,Monaco,Ligue 1,17,2000,0.5,0,0,0,0,0,0,0,0.0,0,1,1,0,0,0,1,0,0,2018-2019,90.0,0.0,0.0
1131,Abass Issah,GHA,FW,Mainz 05,Bundesliga,19,1998,0.1,0,0,0,0,0,0,0,0.0,0,0,0,0,0,0,0,0,0,2018-2019,90.0,0.0,0.0
1132,Gian-Luca Itter,GER,DF,Wolfsburg,Bundesliga,19,1999,1.0,4,3,3,1,0,1,2,50.0,1,2,0,2,1,5,2,0,0,2018-2019,90.0,90.0,360.0
1133,Manuel Iturra,CHI,MF,Villarreal,La Liga,34,1984,0.8,2,0,0,2,0,0,0,0.0,0,1,0,1,2,4,2,0,0,2018-2019,90.0,225.0,225.0
1134,Ander Iturraspe,ESP,MF,Athletic Club,La Liga,29,1989,1.1,2,2,1,1,0,1,1,100.0,0,0,0,0,6,8,2,0,0,2018-2019,90.0,490.9090909090909,163.63636363636363
1135,Ivi,ESP,"MF,FW",Valladolid,La Liga,24,1994,0.2,0,0,0,0,0,0,0,0.0,0,0,0,0,0,0,0,0,0,2018-2019,90.0,0.0,0.0
1136,Alex Iwobi,NGA,"FW,MF",Arsenal,Premier League,22,1996,21.9,28,14,10,16,2,6,25,24.0,19,21,1,20,12,40,13,1,0,2018-2019,90.0,49.31506849315069,115.06849315068494
1137,José Izquierdo,COL,"MF,FW",Brighton,Premier League,26,1992,8.8,15,9,9,4,2,10,20,50.0,10,7,1,6,5,20,7,0,0,2018-2019,90.0,51.13636363636363,153.4090909090909
1138,Armando Izzo,ITA,DF,Torino,Serie A,26,1992,36.3,76,50,35,35,6,33,53,62.3,20,52,24,28,88,164,149,2,0,2018-2019,90.0,218.1818181818182,188.4297520661157
1139,Koo Ja-cheol,KOR,MF,Augsburg,Bundesliga,29,1989,18.2,36,23,10,20,6,12,30,40.0,18,28,5,23,27,63,21,0,0,2018-2019,90.0,133.5164835164835,178.02197802197801
1140,Lukas Jäger,AUT,"FW,MF",Nürnberg,Bundesliga,24,1994,0.3,0,0,0,0,0,0,2,0.0,2,0,0,0,0,0,0,0,0,2018-2019,90.0,0.0,0.0
1141,Phil Jagielka,ENG,DF,Everton,Premier League,35,1982,3.7,7,5,3,4,0,1,4,25.0,3,1,0,1,2,9,14,0,0,2018-2019,90.0,48.648648648648646,170.27027027027026
1142,Alireza Jahanbakhsh,IRN,"FW,MF",Brighton,Premier League,24,1993,11.3,32,18,17,11,4,11,30,36.7,19,16,0,16,11,43,4,0,0,2018-2019,90.0,87.61061946902655,254.86725663716814
1143,Christophe Jallet,FRA,DF,Nice,Ligue 1,34,1983,9.8,29,21,12,13,4,16,27,59.3,11,21,5,16,14,43,32,0,0,2018-2019,90.0,128.57142857142856,266.3265306122449
1144,Jandrei,BRA,GK,Genoa,Serie A,25,1993,1.0,0,0,0,0,0,0,1,0.0,1,0,0,0,0,0,0,0,0,2018-2019,90.0,0.0,0.0
1145,Christoph Janker,GER,"MF,FW",Augsburg,Bundesliga,33,1985,0.8,2,1,2,0,0,0,0,0.0,0,1,0,1,0,2,1,0,0,2018-2019,90.0,0.0,225.0
1146,Marko Janković,MNE,"DF,MF",SPAL,Serie A,23,1995,0.6,3,1,2,1,0,0,2,0.0,2,0,0,0,0,3,0,0,0,2018-2019,90.0,0.0,450.00000000000006
1147,Jakub Jankto,CZE,MF,Sampdoria,Serie A,22,1996,10.7,7,4,5,2,0,4,15,26.7,11,18,2,16,9,16,16,0,0,2018-2019,90.0,75.70093457943926,58.8785046728972
1148,Daryl Janmaat,NED,DF,Watford,Premier League,29,1989,16.9,36,24,23,11,2,20,29,69.0,9,16,6,10,33,69,71,0,0,2018-2019,90.0,175.73964497041422,191.71597633136096
1149,Vincent Janssen,NED,FW,Tottenham,Premier League,24,1994,0.4,2,1,0,2,0,0,0,0.0,0,0,0,0,0,2,1,0,0,2018-2019,90.0,0.0,450.0
1150,Tony Jantschke,GER,DF,Gladbach,Bundesliga,28,1990,10.4,15,10,9,5,1,6,8,75.0,2,10,7,3,27,42,51,1,0,2018-2019,90.0,233.65384615384613,129.8076923076923
Rk,Player,Nation,Pos,Squad,Comp,0,0,90.0,0,0,3,3,3,Tkl,0,0.0,0,0,0,0,0,0,0,0,0,2018-2019,90.0,0.0,0.0
1151,Adnan Januzaj,BEL,"FW,MF",Real Sociedad,La Liga,23,1995,13.9,11,8,5,2,4,3,13,23.1,10,7,0,7,6,17,6,0,0,2018-2019,90.0,38.84892086330935,71.22302158273382
1152,Nicolas Janvier,FRA,MF,Rennes,Ligue 1,19,1998,0.0,0,0,0,0,0,0,0,0.0,0,0,0,0,0,0,0,0,0,2018-2019,,,
1153,Paweł Jaroszyński,POL,DF,Chievo,Serie A,23,1994,15.0,29,18,17,8,4,16,32,50.0,16,15,4,11,24,53,41,1,0,2018-2019,90.0,144.0,174.0
1154,Rune Jarstein,NOR,GK,Hertha BSC,Bundesliga,33,1984,30.5,0,0,0,0,0,0,0,0.0,0,0,0,0,1,1,8,1,0,2018-2019,90.0,2.9508196721311473,0.0
1155,Jason,ESP,"DF,FW",Levante,La Liga,24,1994,25.9,44,25,22,11,11,20,71,28.2,51,25,4,21,46,90,27,0,0,2018-2019,90.0,159.84555984555988,152.8957528957529
1156,Dennis Jastrzembski,POL,"FW,DF",Hertha BSC,Bundesliga,18,2000,0.7,0,0,0,0,0,0,3,0.0,3,0,0,0,1,1,0,0,0,2018-2019,90.0,128.57142857142858,0.0
1157,Assil Jaziri,TUN,FW,Nice,Ligue 1,18,1999,0.4,2,2,0,2,0,1,2,50.0,1,1,0,1,1,3,0,0,0,2018-2019,90.0,225.0,450.0
1158,Corentin Jean,FRA,"FW,MF",Toulouse,Ligue 1,23,1995,7.0,9,6,3,6,0,2,8,25.0,6,8,0,8,2,11,5,0,0,2018-2019,90.0,25.714285714285715,115.71428571428571
1159,Benjamin Jeannot,FRA,"FW,MF",Dijon,Ligue 1,26,1992,16.0,17,12,5,7,5,6,19,31.6,13,15,3,12,12,29,14,0,0,2018-2019,90.0,67.5,95.625
1160,Tin Jedvaj,CRO,DF,Leverkusen,Bundesliga,22,1995,12.5,23,15,9,8,6,10,19,52.6,9,28,2,26,22,45,52,0,0,2018-2019,90.0,158.4,165.6
1161,Jemerson,BRA,"DF,MF",Monaco,Ligue 1,25,1992,24.7,54,38,34,19,1,29,46,63.0,17,29,17,12,25,79,121,1,0,2018-2019,90.0,91.09311740890689,196.76113360323887
1162,Carl Jenkinson,ENG,DF,Arsenal,Premier League,26,1992,1.8,3,2,2,0,1,2,3,66.7,1,4,3,1,0,3,2,0,0,2018-2019,90.0,0.0,150.0
1163,Fredrik Jensen,FIN,"FW,MF",Augsburg,Bundesliga,20,1997,2.3,5,4,3,1,1,2,4,50.0,2,6,0,6,2,7,3,0,0,2018-2019,90.0,78.26086956521739,195.6521739130435
1164,Mathias Jensen,DEN,"MF,FW",Celta Vigo,La Liga,22,1996,2.6,4,2,2,2,0,2,9,22.2,7,2,0,2,4,8,1,0,0,2018-2019,90.0,138.46153846153845,138.46153846153845
1165,Jesé,ESP,"FW,MF",Betis,La Liga,25,1993,8.7,7,4,3,3,1,2,8,25.0,6,8,0,8,1,8,1,0,0,2018-2019,90.0,10.344827586206897,72.41379310344827
1166,Gabriel Jesus,BRA,FW,Manchester City,Premier League,21,1997,11.5,10,3,5,2,3,0,5,0.0,5,16,2,14,3,13,4,0,0,2018-2019,90.0,23.47826086956522,78.26086956521739
1167,Juan Jesus,BRA,DF,Roma,Serie A,27,1991,15.6,37,29,30,5,2,17,30,56.7,13,20,12,8,16,53,41,0,0,2018-2019,90.0,92.3076923076923,213.46153846153845
1168,Raúl Jiménez,MEX,FW,Wolves,Premier League,27,1991,34.6,30,18,5,17,8,6,23,26.1,17,25,3,22,26,56,40,0,0,2018-2019,90.0,67.6300578034682,78.03468208092485
1169,Joaquín,ESP,"FW,MF",Betis,La Liga,37,1981,18.8,10,4,4,2,4,3,7,42.9,4,13,2,11,14,24,31,1,0,2018-2019,90.0,67.02127659574468,47.87234042553191
1170,Joelinton,BRA,"FW,MF",Hoffenheim,Bundesliga,21,1996,23.7,35,22,9,20,6,10,30,33.3,20,36,3,33,14,49,8,0,0,2018-2019,90.0,53.16455696202532,132.9113924050633
1171,Aron Jóhannsson,USA,MF,Werder Bremen,Bundesliga,27,1990,0.0,0,0,0,0,0,0,0,0.0,0,0,0,0,0,0,0,0,0,2018-2019,,,
1172,Stefan Johansen,NOR,MF,Fulham,Premier League,27,1991,4.6,11,3,4,7,0,5,8,62.5,3,5,0,5,3,14,6,0,0,2018-2019,90.0,58.69565217391305,215.21739130434784
1173,Jakob Johansson,SWE,MF,Rennes,Ligue 1,28,1990,7.9,17,9,5,12,0,10,20,50.0,10,7,3,4,3,20,17,1,0,2018-2019,90.0,34.177215189873415,193.67088607594934
1174,Ben Johnson,ENG,DF,West Ham,Premier League,18,2000,0.7,1,0,1,0,0,0,1,0.0,1,0,0,0,1,2,5,0,0,2018-2019,90.0,128.57142857142858,128.57142857142858
1175,Fabian Johnson,USA,"DF,FW",Gladbach,Bundesliga,30,1987,11.2,13,5,2,8,3,6,8,75.0,2,8,3,5,10,23,16,0,0,2018-2019,90.0,80.35714285714286,104.46428571428572
Rk,Player,Nation,Pos,Squad,Comp,0,0,90.0,0,0,3,3,3,Tkl,0,0.0,0,0,0,0,0,0,0,0,0,2018-2019,90.0,0.0,0.0
1176,Tyreke Johnson,ENG,MF,Southampton,Premier League,19,1998,0.0,0,0,0,0,0,0,0,0.0,0,0,0,0,0,0,0,0,0,2018-2019,,,
1177,Karl-Johan Johnsson,SWE,GK,Guingamp,Ligue 1,28,1990,17.0,0,0,0,0,0,0,1,0.0,1,0,0,0,0,0,4,1,0,2018-2019,90.0,0.0,0.0
1178,Jonathas,BRA,FW,Hannover 96,Bundesliga,29,1989,6.7,7,4,3,4,0,3,10,30.0,7,9,1,8,3,10,4,0,0,2018-2019,90.0,40.298507462686565,94.02985074626865
1179,Phil Jones,ENG,DF,Manchester Utd,Premier League,26,1992,14.0,19,13,12,7,0,8,13,61.5,5,16,11,5,23,42,67,3,0,2018-2019,90.0,147.85714285714286,122.14285714285714
1180,Jony,ESP,"MF,FW",Alavés,La Liga,27,1991,33.0,20,14,6,7,7,7,37,18.9,30,18,0,18,22,42,12,2,0,2018-2019,90.0,60.00000000000001,54.54545454545455
1181,Joan Jordán,ESP,MF,Eibar,La Liga,24,1994,31.9,63,40,16,38,9,28,80,35.0,52,38,4,34,32,95,18,1,0,2018-2019,90.0,90.28213166144201,177.74294670846393
1182,Bruno Jordão,POR,"MF,DF",Lazio,Serie A,19,1998,1.0,4,3,2,1,1,1,3,33.3,2,1,0,1,0,4,2,0,0,2018-2019,90.0,0.0,360.0
1183,Jorginho,ITA,MF,Chelsea,Premier League,26,1991,35.1,76,38,27,41,8,45,96,46.9,51,46,7,39,64,140,38,1,0,2018-2019,90.0,164.1025641025641,194.87179487179486
1184,Willian José,BRA,FW,Real Sociedad,La Liga,26,1991,26.3,5,3,1,3,1,2,7,28.6,5,11,5,6,1,6,27,0,0,2018-2019,90.0,3.4220532319391634,17.11026615969582
1185,Joselu,ESP,FW,Newcastle Utd,Premier League,28,1990,6.6,14,8,4,5,5,4,9,44.4,5,5,0,5,3,17,15,0,0,2018-2019,90.0,40.90909090909091,190.9090909090909
1186,Evens Joseph,FRA,"MF,FW",Caen,Ligue 1,19,1999,3.8,5,2,1,2,2,1,3,33.3,2,3,0,3,2,7,1,0,0,2018-2019,90.0,47.368421052631575,118.42105263157895
1187,Diogo Jota,POR,"FW,MF",Wolves,Premier League,21,1996,26.2,28,16,11,11,6,10,38,26.3,28,20,1,19,13,41,11,0,0,2018-2019,90.0,44.656488549618324,96.18320610687023
1188,Aleksandar Jovanović,SRB,GK,Huesca,La Liga,25,1992,12.0,0,0,0,0,0,0,0,0.0,0,0,0,0,1,1,3,0,0,2018-2019,90.0,7.5,0.0
1189,Vukašin Jovanović,SRB,DF,Bordeaux,Ligue 1,22,1996,15.3,26,21,21,5,0,13,19,68.4,6,23,12,11,36,62,105,0,0,2018-2019,90.0,211.76470588235293,152.94117647058823
1190,Stevan Jovetić,MNE,"MF,FW",Monaco,Ligue 1,28,1989,4.4,2,1,1,1,0,1,3,33.3,2,1,0,1,1,3,3,0,0,2018-2019,90.0,20.454545454545453,40.90909090909091
1191,Luka Jović,SRB,"FW,MF",Eint Frankfurt,Bundesliga,20,1997,24.9,10,5,1,8,1,1,12,8.3,11,8,0,8,3,13,30,0,0,2018-2019,90.0,10.843373493975903,36.144578313253014
1192,Jozabed,ESP,MF,Celta Vigo,La Liga,27,1991,12.8,19,10,8,8,3,8,24,33.3,16,8,2,6,9,28,13,2,0,2018-2019,90.0,63.28125,133.59375
1193,Miguel Juan Llambrich,ESP,"DF,FW",Villarreal,La Liga,22,1996,6.0,21,14,11,9,1,6,14,42.9,8,9,2,7,12,33,17,0,0,2018-2019,90.0,180.0,315.0
1194,Juanfran,ESP,"DF,FW",Leganés,La Liga,29,1988,16.2,20,12,13,5,2,9,16,56.3,7,9,4,5,19,39,37,0,0,2018-2019,90.0,105.55555555555556,111.11111111111111
1195,Juanfran,ESP,DF,Atlético Madrid,La Liga,33,1985,17.9,35,22,27,5,3,24,38,63.2,14,13,5,8,19,54,36,1,0,2018-2019,90.0,95.53072625698326,175.97765363128494
1196,Juanmi,ESP,"FW,MF",Real Sociedad,La Liga,25,1993,16.9,21,12,7,11,3,8,22,36.4,14,12,0,12,16,37,13,0,0,2018-2019,90.0,85.20710059171599,111.83431952662723
1197,Juanpe,ESP,DF,Girona,La Liga,27,1991,30.7,48,25,32,15,1,24,45,53.3,21,31,15,16,57,105,138,0,0,2018-2019,90.0,167.10097719869708,140.71661237785017
1198,Juanpi,VEN,"MF,FW",Huesca,La Liga,24,1994,7.4,16,6,9,5,2,4,12,33.3,8,15,0,15,6,22,3,0,0,2018-2019,90.0,72.97297297297297,194.59459459459458
1199,Nathaël Julan,FRA,"FW,MF",Guingamp,Ligue 1,22,1996,4.8,1,0,0,0,1,0,3,0.0,3,6,1,5,0,1,2,0,0,2018-2019,90.0,0.0,18.75
1200,Christopher Jullien,FRA,DF,Toulouse,Ligue 1,25,1993,33.5,35,24,23,10,2,12,32,37.5,20,39,27,12,41,76,203,4,0,2018-2019,90.0,110.14925373134328,94.02985074626865
Rk,Player,Nation,Pos,Squad,Comp,0,0,90.0,0,0,3,3,3,Tkl,0,0.0,0,0,0,0,0,0,0,0,0,2018-2019,90.0,0.0,0.0
1201,David Juncà,ESP,DF,Celta Vigo,La Liga,24,1993,19.5,55,30,40,13,2,28,46,60.9,18,27,6,21,35,90,63,1,0,2018-2019,90.0,161.53846153846152,253.84615384615384
1202,Sebastian Jung,GER,DF,Wolfsburg,Bundesliga,28,1990,0.6,1,0,0,1,0,1,1,100.0,0,0,0,0,0,1,1,0,0,2018-2019,90.0,0.0,150.0
1203,Hamed Junior Traorè,CIV,MF,Empoli,Serie A,18,2000,25.1,67,38,26,32,9,27,72,37.5,45,29,4,25,30,97,17,0,0,2018-2019,90.0,107.56972111553785,240.23904382470118
1204,Vinicius Júnior,BRA,"FW,MF",Real Madrid,La Liga,18,2000,9.7,10,6,3,6,1,3,16,18.8,13,6,1,5,7,17,1,0,0,2018-2019,90.0,64.94845360824743,92.78350515463919
1205,Musa Juwara,GAM,FW,Chievo,Serie A,16,2001,0.1,0,0,0,0,0,0,0,0.0,0,0,0,0,1,1,0,0,0,2018-2019,90.0,900.0,0.0
1206,Mathias Jørgensen,DEN,DF,Huddersfield,Premier League,28,1990,23.9,49,31,27,21,1,27,46,58.7,19,29,14,15,69,118,83,0,0,2018-2019,90.0,259.83263598326363,184.51882845188285
1207,Sory Kaba,GUI,"FW,MF",Dijon,Ligue 1,23,1995,2.6,1,1,1,0,0,1,3,33.3,2,2,0,2,0,1,1,0,0,2018-2019,90.0,0.0,34.61538461538461
1208,Ozan Kabak,TUR,DF,Stuttgart,Bundesliga,18,2000,15.0,33,19,22,9,2,9,19,47.4,10,15,8,7,23,56,58,1,0,2018-2019,90.0,138.0,198.0
1209,Christian Kabasele,BEL,DF,Watford,Premier League,27,1991,17.6,25,14,20,5,0,10,23,43.5,13,21,16,5,38,63,111,0,0,2018-2019,90.0,194.3181818181818,127.84090909090908
1210,Elias Kachunga,COD,"FW,MF",Huddersfield,Premier League,26,1992,13.1,22,9,8,12,2,9,25,36.0,16,16,1,15,4,26,10,0,0,2018-2019,90.0,27.480916030534353,151.14503816793894
1211,Pavel Kadeřábek,CZE,DF,Hoffenheim,Bundesliga,26,1992,27.9,30,19,12,13,5,11,24,45.8,13,37,10,27,34,64,71,1,0,2018-2019,90.0,109.6774193548387,96.7741935483871
1212,Shinji Kagawa,JPN,MF,Dortmund,Bundesliga,29,1989,1.1,0,0,0,0,0,0,0,0.0,0,0,0,0,0,0,0,0,0,2018-2019,90.0,0.0,0.0
1213,Florian Kainz,AUT,FW,Werder Bremen,Bundesliga,25,1992,4.1,6,5,5,1,0,3,6,50.0,3,4,1,3,3,9,5,0,0,2018-2019,90.0,65.85365853658537,131.70731707317074
1214,Gaël Kakuta,COD,"MF,FW",Rayo Vallecano,La Liga,27,1991,8.0,12,7,5,5,2,2,10,20.0,8,4,1,3,9,21,9,0,0,2018-2019,90.0,101.25,135.0
1215,Nikola Kalinić,CRO,FW,Atlético Madrid,La Liga,30,1988,7.1,6,4,2,4,0,1,3,33.3,2,1,0,1,2,8,2,0,0,2018-2019,90.0,25.35211267605634,76.05633802816902
1216,Salomon Kalou,CIV,"FW,MF",Hertha BSC,Bundesliga,32,1985,25.7,21,12,5,11,5,6,24,25.0,18,23,1,22,6,27,25,0,0,2018-2019,90.0,21.011673151750973,73.5408560311284
1217,Samuel Kalu,NGA,FW,Bordeaux,Ligue 1,20,1997,14.2,27,18,15,7,5,4,11,36.4,7,11,3,8,8,35,4,1,0,2018-2019,90.0,50.70422535211268,171.1267605633803
1218,François Kamano,GUI,"FW,MF",Bordeaux,Ligue 1,22,1996,28.5,29,18,6,17,6,11,30,36.7,19,27,0,27,17,46,6,1,0,2018-2019,90.0,53.684210526315795,91.57894736842105
1219,Aboubakar Kamara,MTN,FW,Fulham,Premier League,23,1995,7.7,8,4,1,5,2,3,7,42.9,4,6,0,6,1,9,6,0,0,2018-2019,90.0,11.688311688311689,93.50649350649351
1220,Boubacar Kamara,FRA,DF,Marseille,Ligue 1,18,1999,26.8,67,39,38,24,5,32,49,65.3,17,24,13,11,45,112,95,2,0,2018-2019,90.0,151.1194029850746,224.99999999999997
1221,Hassane Kamara,CIV,"DF,FW",Reims,Ligue 1,24,1994,10.3,29,21,22,5,2,16,19,84.2,3,6,1,5,14,43,41,0,0,2018-2019,90.0,122.33009708737863,253.39805825242718
1222,Marcin Kamiński,POL,DF,Düsseldorf,Bundesliga,26,1992,27.0,18,13,14,3,1,7,11,63.6,4,21,11,10,39,57,103,2,0,2018-2019,90.0,130.0,60.0
1223,Patrick Kammerbauer,GER,FW,Freiburg,Bundesliga,21,1997,0.0,0,0,0,0,0,0,0,0.0,0,0,0,0,1,1,1,0,0,2018-2019,,inf,
1224,Kevin Kampl,SVN,MF,RB Leipzig,Bundesliga,27,1990,23.5,41,24,16,21,4,8,28,28.6,20,32,2,30,33,74,22,0,0,2018-2019,90.0,126.38297872340425,157.02127659574467
1225,Harry Kane,ENG,FW,Tottenham,Premier League,25,1993,26.9,10,6,2,8,0,1,14,7.1,13,16,6,10,1,11,14,0,0,2018-2019,90.0,3.345724907063197,33.457249070631974
Rk,Player,Nation,Pos,Squad,Comp,0,0,90.0,0,0,3,3,3,Tkl,0,0.0,0,0,0,0,0,0,0,0,0,2018-2019,90.0,0.0,0.0
1226,Lee Kang-in,KOR,"MF,FW",Valencia,La Liga,17,2001,0.3,2,0,1,1,0,1,3,33.3,2,0,0,0,1,3,0,0,0,2018-2019,90.0,300.0,600.0
1227,Wilfried Kanga,CIV,FW,Angers,Ligue 1,20,1998,5.5,0,0,0,0,0,0,1,0.0,1,3,0,3,0,0,4,0,0,2018-2019,90.0,0.0,0.0
1228,N'Golo Kanté,FRA,MF,Chelsea,Premier League,27,1991,34.4,75,41,21,41,13,23,67,34.3,44,63,6,57,44,119,32,1,0,2018-2019,90.0,115.11627906976746,196.22093023255815
1229,Stefanos Kapino,GRE,GK,Werder Bremen,Bundesliga,24,1994,0.5,0,0,0,0,0,0,0,0.0,0,0,0,0,0,0,0,0,0,2018-2019,90.0,0.0,0.0
1230,Wilfrid Kaptoum,CMR,MF,Betis,La Liga,22,1996,8.6,15,6,4,10,1,5,11,45.5,6,9,1,8,10,25,6,2,0,2018-2019,90.0,104.65116279069768,156.97674418604652
1231,Kenan Karaman,TUR,"FW,MF",Düsseldorf,Bundesliga,24,1994,10.2,13,9,3,10,0,7,12,58.3,5,5,1,4,2,15,8,0,0,2018-2019,90.0,17.647058823529413,114.70588235294119
1232,Yann Karamoh,FRA,"FW,MF",Inter,Serie A,20,1998,0.1,0,0,0,0,0,0,0,0.0,0,0,0,0,0,0,0,0,0,2018-2019,90.0,0.0,0.0
1233,Yann Karamoh,FRA,FW,Bordeaux,Ligue 1,20,1998,13.6,7,3,1,4,2,1,13,7.7,12,9,0,9,6,13,3,0,0,2018-2019,90.0,39.705882352941174,46.3235294117647
1234,Ibrahim Karamoko,FRA,MF,Chievo,Serie A,17,2001,0.7,0,0,0,0,0,0,0,0.0,0,1,0,1,0,0,1,0,0,2018-2019,90.0,0.0,0.0
1235,Orestis Karnezis,GRE,GK,Napoli,Serie A,33,1985,9.0,0,0,0,0,0,0,0,0.0,0,0,0,0,0,0,3,0,0,2018-2019,90.0,0.0,0.0
1236,Rick Karsdorp,NED,DF,Roma,Serie A,23,1995,6.6,9,6,3,5,1,5,11,45.5,6,4,2,2,12,21,12,1,0,2018-2019,90.0,163.63636363636363,122.72727272727273
1237,Grigoris Kastanos,CYP,MF,Juventus,Serie A,20,1998,0.7,3,1,3,0,0,0,0,0.0,0,3,1,2,0,3,0,0,0,2018-2019,90.0,0.0,385.7142857142857
1238,Eiji Kawashima,JPN,GK,Strasbourg,Ligue 1,35,1983,1.0,0,0,0,0,0,0,0,0.0,0,0,0,0,0,0,0,0,0,2018-2019,90.0,0.0,0.0
1239,Beram Kayal,ISR,MF,Brighton,Premier League,30,1988,10.4,28,17,16,11,1,5,21,23.8,16,17,10,7,15,43,25,0,0,2018-2019,90.0,129.8076923076923,242.3076923076923
1240,Moise Kean,ITA,FW,Juventus,Serie A,18,2000,6.0,0,0,0,0,0,0,1,0.0,1,1,0,1,2,2,1,0,0,2018-2019,90.0,30.0,0.0
1241,Michael Keane,ENG,DF,Everton,Premier League,25,1993,33.0,41,25,22,16,3,19,32,59.4,13,30,22,8,43,84,185,4,0,2018-2019,90.0,117.27272727272728,111.81818181818183
1242,Neeskens Kebano,COD,"FW,MF",Fulham,Premier League,26,1992,1.2,3,1,2,1,0,1,1,100.0,0,3,0,3,0,3,3,0,0,2018-2019,90.0,0.0,225.00000000000003
1243,Thilo Kehrer,GER,DF,Paris S-G,Ligue 1,21,1996,21.1,64,43,27,31,6,31,55,56.4,24,32,17,15,31,95,69,1,0,2018-2019,90.0,132.22748815165878,272.98578199052133
1244,Jules Keita,GUI,"FW,MF",Dijon,Ligue 1,20,1998,5.1,10,4,0,3,7,5,12,41.7,7,2,0,2,2,12,1,0,0,2018-2019,90.0,35.294117647058826,176.47058823529412
1245,Naby Keïta,GUI,"MF,FW",Liverpool,Premier League,23,1995,15.4,37,15,13,19,5,14,42,33.3,28,29,4,25,12,49,16,1,0,2018-2019,90.0,70.12987012987013,216.23376623376623
1246,Keko,ESP,"MF,FW",Valladolid,La Liga,26,1991,17.0,42,18,21,15,6,18,50,36.0,32,20,1,19,14,56,17,0,0,2018-2019,90.0,74.11764705882354,222.35294117647058
1247,Martin Kelly,ENG,DF,Crystal Palace,Premier League,28,1990,12.3,21,13,18,2,1,14,19,73.7,5,18,12,6,11,32,88,1,0,2018-2019,89.99999999999999,80.48780487804876,153.65853658536582
1248,Marc-Oliver Kempf,GER,DF,Stuttgart,Bundesliga,23,1995,22.5,33,18,26,7,0,12,24,50.0,12,35,21,14,46,79,141,1,0,2018-2019,90.0,184.0,132.0
1249,Kenedy,BRA,"MF,DF",Newcastle Utd,Premier League,22,1996,15.0,30,22,11,16,3,12,29,41.4,17,10,0,10,32,62,24,1,0,2018-2019,90.0,192.0,180.0
1250,Jonjoe Kenny,ENG,DF,Everton,Premier League,21,1997,8.8,21,16,16,4,1,10,18,55.6,8,13,2,11,17,38,36,1,0,2018-2019,90.0,173.86363636363635,214.77272727272725
Rk,Player,Nation,Pos,Squad,Comp,0,0,90.0,0,0,3,3,3,Tkl,0,0.0,0,0,0,0,0,0,0,0,0,2018-2019,90.0,0.0,0.0
1251,Christophe Kerbrat,FRA,DF,Guingamp,Ligue 1,31,1986,23.3,40,24,28,12,0,24,38,63.2,14,19,10,9,50,90,140,5,0,2018-2019,90.0,193.13304721030042,154.50643776824035
1252,Sebastian Kerk,GER,"MF,FW",Nürnberg,Bundesliga,24,1994,13.1,16,9,8,5,3,7,23,30.4,16,14,5,9,3,19,22,1,0,2018-2019,90.0,20.610687022900763,109.92366412213741
1253,Franck Kessié,CIV,MF,Milan,Serie A,21,1996,33.5,42,27,16,20,6,18,38,47.4,20,35,10,25,27,69,53,2,0,2018-2019,90.0,72.53731343283582,112.83582089552239
1254,Saîf-Eddine Khaoui,TUN,"MF,FW",Caen,Ligue 1,23,1995,15.0,20,14,5,11,4,8,27,29.6,19,9,1,8,20,40,4,0,0,2018-2019,90.0,120.0,120.0
1255,Wahbi Khazri,TUN,"FW,MF",Saint-Étienne,Ligue 1,27,1991,31.3,41,26,8,14,19,17,49,34.7,32,27,2,25,11,52,5,0,0,2018-2019,90.0,31.629392971246006,117.89137380191693
1256,Rani Khedira,GER,"DF,MF",Augsburg,Bundesliga,24,1994,29.2,56,39,22,28,6,18,36,50.0,18,44,22,22,80,136,95,1,0,2018-2019,90.0,246.57534246575344,172.6027397260274
1257,Sami Khedira,GER,MF,Juventus,Serie A,31,1987,7.8,10,9,6,2,2,5,9,55.6,4,8,3,5,5,15,6,0,0,2018-2019,90.0,57.69230769230769,115.38461538461539
1258,Isaac Kiese Thelin,SWE,"FW,MF",Leverkusen,Bundesliga,26,1992,2.0,2,1,0,2,0,1,2,50.0,1,1,0,1,0,2,4,0,0,2018-2019,90.0,0.0,90.0
1259,Kiké,ESP,FW,Eibar,La Liga,28,1989,14.4,7,4,1,2,4,1,5,20.0,4,18,0,18,4,11,6,0,0,2018-2019,90.0,25.0,43.75
1260,Max Kilman,ENG,DF,Wolves,Premier League,21,1997,0.0,0,0,0,0,0,0,0,0.0,0,0,0,0,0,0,0,0,0,2018-2019,,,
1261,Joshua Kimmich,GER,"DF,MF",Bayern Munich,Bundesliga,23,1995,34.0,46,26,17,22,7,25,54,46.3,29,35,9,26,34,80,41,3,0,2018-2019,90.0,90.0,121.76470588235294
1262,Presnel Kimpembe,FRA,DF,Paris S-G,Ligue 1,22,1995,22.3,55,34,26,25,4,24,40,60.0,16,17,10,7,30,85,48,5,0,2018-2019,90.0,121.0762331838565,221.97309417040358
1263,Joshua King,NOR,"FW,MF",Bournemouth,Premier League,26,1992,32.9,30,19,7,19,4,8,29,27.6,21,28,4,24,7,37,14,0,0,2018-2019,90.0,19.148936170212767,82.06686930091186
1264,Sofian Kiyine,MAR,"MF,DF",Chievo,Serie A,20,1997,9.1,28,13,11,14,3,9,18,50.0,9,10,0,10,10,38,4,0,0,2018-2019,90.0,98.9010989010989,276.9230769230769
1265,Simon Kjær,DEN,DF,Sevilla,La Liga,29,1989,22.3,29,19,25,3,1,9,16,56.3,7,41,34,7,27,56,136,0,0,2018-2019,90.0,108.96860986547085,117.04035874439461
1266,Davy Klaassen,NED,MF,Werder Bremen,Bundesliga,25,1993,31.3,64,47,24,33,7,14,49,28.6,35,44,9,35,47,111,47,0,0,2018-2019,90.0,135.14376996805112,184.0255591054313
1267,Felix Klaus,GER,"FW,MF",Wolfsburg,Bundesliga,25,1992,4.9,10,7,4,5,1,2,7,28.6,5,5,0,5,4,14,0,0,0,2018-2019,90.0,73.46938775510203,183.6734693877551
1268,Ragnar Klavan,EST,DF,Cagliari,Serie A,32,1985,13.7,9,8,5,3,1,5,11,45.5,6,19,13,6,10,19,68,1,0,2018-2019,90.0,65.69343065693431,59.12408759124089
1269,Tim Kleindienst,GER,FW,Freiburg,Bundesliga,22,1995,2.2,4,3,1,2,1,1,3,33.3,2,3,0,3,0,4,7,0,0,2018-2019,90.0,0.0,163.63636363636363
1270,Lukas Klostermann,GER,DF,RB Leipzig,Bundesliga,22,1996,22.3,50,29,33,12,5,29,45,64.4,16,37,5,32,29,79,74,0,0,2018-2019,90.0,117.04035874439461,201.79372197309416
1271,Justin Kluivert,NED,FW,Roma,Serie A,19,1999,14.9,28,27,12,9,7,10,23,43.5,13,17,0,17,7,35,12,0,0,2018-2019,90.0,42.28187919463087,169.12751677852347
1272,Lukas Klünter,GER,DF,Hertha BSC,Bundesliga,22,1996,6.6,11,8,6,5,0,4,5,80.0,1,6,2,4,12,23,20,0,0,2018-2019,90.0,163.63636363636363,150.0
1273,Robin Knoche,GER,DF,Wolfsburg,Bundesliga,26,1992,31.0,26,20,19,6,1,16,29,55.2,13,46,29,17,44,70,138,2,0,2018-2019,90.0,127.74193548387098,75.48387096774194
1274,Anthony Knockaert,FRA,"MF,FW",Brighton,Premier League,26,1991,20.4,33,21,12,15,6,13,30,43.3,17,13,0,13,29,62,11,0,0,2018-2019,90.0,127.94117647058825,145.58823529411765
1275,Törles Knöll,GER,"FW,MF",Nürnberg,Bundesliga,20,1997,4.1,3,2,1,1,1,0,4,0.0,4,5,1,4,0,3,2,0,0,2018-2019,90.0,0.0,65.85365853658537
Rk,Player,Nation,Pos,Squad,Comp,0,0,90.0,0,0,3,3,3,Tkl,0,0.0,0,0,0,0,0,0,0,0,0,2018-2019,90.0,0.0,0.0
1276,Gregor Kobel,SUI,GK,Hoffenheim,Bundesliga,20,1997,1.0,0,0,0,0,0,0,0,0.0,0,0,0,0,0,0,0,0,0,2018-2019,90.0,0.0,0.0
1277,Gregor Kobel,SUI,GK,Augsburg,Bundesliga,20,1997,15.4,1,1,1,0,0,1,1,100.0,0,0,0,0,2,3,5,3,0,2018-2019,90.0,11.688311688311689,5.8441558441558445
1278,Robin Koch,GER,"MF,DF",Freiburg,Bundesliga,22,1996,21.1,25,14,17,7,1,7,24,29.2,17,31,18,13,32,57,77,4,0,2018-2019,90.0,136.49289099526067,106.63507109004739
1279,Kenan Kodro,BIH,"FW,MF",Athletic Club,La Liga,24,1993,1.8,3,1,1,1,1,1,3,33.3,2,1,0,1,0,3,0,0,0,2018-2019,90.0,0.0,150.0
1280,Dominik Kohr,GER,MF,Leverkusen,Bundesliga,24,1994,10.8,42,29,21,21,0,14,35,40.0,21,25,12,13,15,57,17,1,0,2018-2019,90.0,124.99999999999999,350.0
1281,Djégui Koita,FRA,DF,Guingamp,Ligue 1,18,1999,1.9,8,6,8,0,0,3,4,75.0,1,5,3,2,0,8,9,0,0,2018-2019,90.0,0.0,378.9473684210526
1282,Koke,ESP,MF,Atlético Madrid,La Liga,26,1992,28.7,84,46,41,32,11,34,86,39.5,52,25,5,20,31,115,37,1,0,2018-2019,90.0,97.21254355400697,263.4146341463415
1283,Aleksandar Kolarov,SRB,DF,Roma,Serie A,32,1985,32.3,38,26,22,10,6,21,34,61.8,13,23,15,8,41,79,82,2,0,2018-2019,90.0,114.24148606811146,105.88235294117648
1284,Sead Kolašinac,BIH,"DF,MF",Arsenal,Premier League,25,1993,21.0,34,21,21,7,6,20,34,58.8,14,12,3,9,20,54,28,3,0,2018-2019,90.0,85.71428571428571,145.71428571428572
1285,Randal Kolo Muani,FRA,FW,Nantes,Ligue 1,19,1998,1.4,2,0,1,1,0,0,1,0.0,1,2,0,2,0,2,2,0,0,2018-2019,90.0,0.0,128.57142857142858
1286,Timothée Kolodziejczak,FRA,DF,Saint-Étienne,Ligue 1,26,1991,35.4,34,22,21,10,3,20,45,44.4,25,25,11,14,53,87,118,2,0,2018-2019,90.0,134.74576271186442,86.4406779661017
1287,Vincent Kompany,BEL,DF,Manchester City,Premier League,32,1986,13.6,16,10,11,3,2,8,9,88.9,1,11,8,3,16,32,55,0,0,2018-2019,90.0,105.88235294117646,105.88235294117646
1288,Ghislain Konan,CIV,DF,Reims,Ligue 1,22,1995,20.0,45,28,31,10,4,24,40,60.0,16,18,4,14,40,85,55,1,0,2018-2019,90.0,180.0,202.5
1289,Ibrahima Konaté,FRA,DF,RB Leipzig,Bundesliga,19,1999,27.0,44,32,30,14,0,17,27,63.0,10,29,18,11,58,102,126,0,0,2018-2019,90.0,193.33333333333334,146.66666666666669
1290,Moussa Konaté,SEN,FW,Amiens,Ligue 1,25,1993,20.8,10,8,3,3,4,2,12,16.7,10,14,3,11,5,15,15,0,0,2018-2019,90.0,21.634615384615383,43.26923076923077
1291,Geoffrey Kondogbia,CTA,MF,Valencia,La Liga,25,1993,13.8,47,33,18,23,6,12,27,44.4,15,20,7,13,27,74,22,2,0,2018-2019,90.0,176.08695652173913,306.52173913043475
1292,Lamine Koné,CIV,DF,Strasbourg,Ligue 1,29,1989,23.9,21,16,9,9,3,6,9,66.7,3,18,13,5,33,54,66,3,0,2018-2019,90.0,124.26778242677825,79.0794979079498
1293,Manu Koné,FRA,MF,Toulouse,Ligue 1,17,2001,0.8,4,2,0,4,0,2,4,50.0,2,0,0,0,0,4,0,0,0,2018-2019,90.0,0.0,450.0
1294,Youssouf Koné,MLI,DF,Lille,Ligue 1,23,1995,19.0,67,38,45,19,3,41,65,63.1,24,31,3,28,39,106,52,1,0,2018-2019,90.0,184.73684210526315,317.36842105263156
1295,Terence Kongolo,NED,DF,Huddersfield,Premier League,24,1994,30.2,74,46,44,26,4,27,47,57.4,20,42,16,26,65,139,106,1,0,2018-2019,90.0,193.7086092715232,220.52980132450332
1296,Yevhen Konoplyanka,UKR,"FW,MF",Schalke 04,Bundesliga,28,1989,7.3,2,0,0,0,2,2,4,50.0,2,6,0,6,3,5,3,0,0,2018-2019,90.0,36.986301369863014,24.657534246575345
1297,Pascal Köpke,GER,"FW,MF",Hertha BSC,Bundesliga,22,1995,0.8,1,0,1,0,0,1,2,50.0,1,0,0,0,0,1,0,0,0,2018-2019,90.0,0.0,112.5
1298,Julian Korb,GER,DF,Hannover 96,Bundesliga,26,1992,11.2,26,17,16,9,1,10,29,34.5,19,27,4,23,23,49,34,1,0,2018-2019,90.0,184.82142857142858,208.92857142857144
1299,Laurent Koscielny,FRA,DF,Arsenal,Premier League,32,1985,14.8,19,11,9,9,1,10,16,62.5,6,20,15,5,30,49,72,0,0,2018-2019,90.0,182.43243243243242,115.54054054054053
1300,Filip Kostić,SRB,"DF,FW",Eint Frankfurt,Bundesliga,25,1992,32.8,64,42,35,22,7,23,65,35.4,42,80,6,74,23,87,50,0,0,2018-2019,90.0,63.10975609756098,175.609756097561
Rk,Player,Nation,Pos,Squad,Comp,0,0,90.0,0,0,3,3,3,Tkl,0,0.0,0,0,0,0,0,0,0,0,0,2018-2019,90.0,0.0,0.0
1301,Christian Kouamé,CIV,FW,Genoa,Serie A,20,1997,34.1,31,22,8,16,7,2,13,15.4,11,23,3,20,25,56,28,0,0,2018-2019,90.0,65.98240469208211,81.81818181818181
1302,Tomáš Koubek,CZE,GK,Rennes,Ligue 1,25,1992,32.5,0,0,0,0,0,0,1,0.0,1,0,0,0,0,0,26,4,0,2018-2019,90.0,0.0,0.0
1303,Kalidou Koulibaly,SEN,DF,Napoli,Serie A,27,1991,34.8,61,40,37,22,2,19,36,52.8,17,55,33,22,40,101,144,0,0,2018-2019,90.0,103.44827586206897,157.75862068965517
1304,Jules Koundé,FRA,DF,Bordeaux,Ligue 1,19,1998,37.0,48,31,37,11,0,27,41,65.9,14,44,23,21,50,98,193,7,0,2018-2019,90.0,121.62162162162163,116.75675675675676
1305,Cheikhou Kouyaté,SEN,MF,Crystal Palace,Premier League,28,1989,21.1,59,33,23,31,5,9,33,27.3,24,29,11,18,16,75,33,0,0,2018-2019,90.0,68.24644549763033,251.65876777251182
1306,Mateo Kovačić,CRO,MF,Chelsea,Premier League,24,1994,19.3,45,29,23,19,3,20,46,43.5,26,19,2,17,8,53,18,1,0,2018-2019,90.0,37.30569948186528,209.84455958549222
1307,Dawid Kownacki,POL,FW,Sampdoria,Serie A,21,1997,1.9,2,1,0,1,1,1,4,25.0,3,0,0,0,0,2,0,0,0,2018-2019,90.0,0.0,94.73684210526315
1308,Dawid Kownacki,POL,"MF,FW",Düsseldorf,Bundesliga,21,1997,6.4,13,6,9,3,1,7,16,43.8,9,8,0,8,2,15,8,0,0,2018-2019,90.0,28.125,182.8125
1309,Thomas Kraft,GER,GK,Hertha BSC,Bundesliga,30,1988,3.5,0,0,0,0,0,0,0,0.0,0,0,0,0,0,0,1,1,0,2018-2019,90.0,0.0,0.0
1310,Emil Krafth,SWE,DF,Amiens,Ligue 1,23,1994,33.0,55,35,34,14,7,32,65,49.2,33,27,12,15,23,78,94,4,0,2018-2019,90.0,62.727272727272734,150.0
1311,Luka Krajnc,SVN,DF,Frosinone,Serie A,23,1994,8.8,10,8,6,3,1,5,6,83.3,1,11,3,8,11,21,42,0,0,2018-2019,90.0,112.5,102.27272727272727
1312,Andrej Kramarić,CRO,"MF,FW",Hoffenheim,Bundesliga,27,1991,26.6,9,4,1,5,3,4,26,15.4,22,15,3,12,8,17,13,0,0,2018-2019,90.0,27.06766917293233,30.45112781954887
1313,Christoph Kramer,GER,MF,Gladbach,Bundesliga,27,1991,12.6,41,22,17,23,1,15,40,37.5,25,19,4,15,21,62,23,0,0,2018-2019,90.0,150.00000000000003,292.8571428571429
1314,Vasyl Kravets,UKR,"DF,FW",Leganés,La Liga,20,1997,5.3,16,11,8,6,2,6,13,46.2,7,5,1,4,4,20,10,1,0,2018-2019,90.0,67.9245283018868,271.6981132075472
1315,Ladislav Krejčí,CZE,"DF,MF",Bologna,Serie A,26,1992,11.8,16,12,6,9,1,7,12,58.3,5,8,2,6,6,22,18,0,0,2018-2019,90.0,45.762711864406775,122.03389830508473
1316,Rene Krhin,SVN,MF,Nantes,Ligue 1,28,1990,11.7,22,14,7,12,3,11,19,57.9,8,7,4,3,21,43,32,0,0,2018-2019,89.99999999999999,161.53846153846152,169.23076923076923
1317,Toni Kroos,GER,MF,Real Madrid,La Liga,28,1990,24.7,51,35,18,24,9,14,57,24.6,43,25,4,21,14,65,13,1,0,2018-2019,90.0,51.012145748987855,185.82995951417004
1318,Rade Krunić,BIH,MF,Empoli,Serie A,24,1993,30.8,38,23,21,14,3,14,41,34.1,27,35,12,23,24,62,32,0,0,2018-2019,90.0,70.12987012987013,111.03896103896105
1319,Max Kruse,GER,"FW,MF",Werder Bremen,Bundesliga,30,1988,31.5,17,5,2,13,2,6,38,15.8,32,16,1,15,8,25,6,2,0,2018-2019,90.0,22.857142857142858,48.57142857142858
1320,Lukas Kübler,GER,"DF,MF",Freiburg,Bundesliga,25,1992,13.2,35,22,23,12,0,16,26,61.5,10,15,5,10,30,65,50,1,0,2018-2019,90.0,204.54545454545453,238.63636363636363
1321,Yuya Kubo,JPN,"FW,MF",Nürnberg,Bundesliga,24,1993,15.1,21,11,6,10,5,12,33,36.4,21,11,0,11,10,31,6,0,0,2018-2019,90.0,59.60264900662252,125.16556291390728
1322,Juraj Kucka,SVK,MF,Parma,Serie A,31,1987,17.1,51,32,17,29,5,19,53,35.8,34,27,7,20,17,68,37,1,0,2018-2019,90.0,89.47368421052632,268.42105263157896
1323,Dejan Kulusevski,SWE,MF,Atalanta,Serie A,18,2000,1.2,3,3,0,2,1,1,3,33.3,2,1,0,1,0,3,0,0,0,2018-2019,90.0,0.0,225.00000000000003
1324,Pierre Kunde,CMR,MF,Mainz 05,Bundesliga,23,1995,21.2,48,29,20,26,2,16,27,59.3,11,34,14,20,24,72,49,1,0,2018-2019,90.0,101.88679245283019,203.77358490566039
1325,Jasmin Kurtić,SVN,MF,SPAL,Serie A,29,1989,28.4,35,20,19,13,3,13,41,31.7,28,30,3,27,20,55,52,0,0,2018-2019,90.0,63.38028169014085,110.91549295774648
Rk,Player,Nation,Pos,Squad,Comp,0,0,90.0,0,0,3,3,3,Tkl,0,0.0,0,0,0,0,0,0,0,0,0,2018-2019,90.0,0.0,0.0
1326,Layvin Kurzawa,FRA,"DF,MF",Paris S-G,Ligue 1,25,1992,11.2,19,11,6,5,8,6,16,37.5,10,10,2,8,10,29,16,0,0,2018-2019,90.0,80.35714285714286,152.67857142857144
1327,Rafał Kurzawa,POL,FW,Amiens,Ligue 1,25,1993,2.7,8,3,6,2,0,2,6,33.3,4,1,0,1,3,11,3,0,0,2018-2019,90.0,99.99999999999999,266.66666666666663
1328,Ahmed Kutucu,TUR,"FW,MF",Schalke 04,Bundesliga,18,2000,4.7,8,3,3,4,1,1,3,33.3,2,2,1,1,0,8,0,0,0,2018-2019,90.0,0.0,153.1914893617021
1329,Enock Kwateng,FRA,DF,Nantes,Ligue 1,21,1997,22.7,65,41,34,27,4,33,70,47.1,37,28,4,24,78,143,56,0,0,2018-2019,89.99999999999999,309.2511013215859,257.70925110132157
1330,Grejohn Kyei,FRA,FW,Reims,Ligue 1,22,1995,0.0,0,0,0,0,0,0,1,0.0,1,0,0,0,0,0,0,0,0,2018-2019,,,
1331,Antonino La Gumina,ITA,"FW,MF",Empoli,Serie A,22,1996,12.1,5,4,1,2,2,2,6,33.3,4,8,2,6,6,11,5,0,0,2018-2019,90.0,44.628099173553714,37.1900826446281
1332,Rajiv van La Parra,NED,"FW,MF",Huddersfield,Premier League,27,1991,4.5,8,5,1,7,0,1,6,16.7,5,0,0,0,4,12,3,1,0,2018-2019,90.0,80.0,160.0
1333,Gaëtan Laborde,FRA,FW,Bordeaux,Ligue 1,24,1994,1.0,4,3,0,1,3,2,4,50.0,2,0,0,0,0,4,0,0,0,2018-2019,90.0,0.0,360.0
1334,Gaëtan Laborde,FRA,"FW,MF",Montpellier,Ligue 1,24,1994,32.2,36,15,6,15,15,11,27,40.7,16,18,2,16,6,42,27,0,0,2018-2019,90.0,16.770186335403725,100.62111801242236
1335,Alexandre Lacazette,FRA,FW,Arsenal,Premier League,27,1991,27.8,35,16,6,19,10,5,28,17.9,23,27,1,26,15,50,31,0,0,2018-2019,90.0,48.56115107913669,113.30935251798562
1336,Alban Lafont,FRA,GK,Fiorentina,Serie A,19,1999,33.5,0,0,0,0,0,0,0,0.0,0,0,0,0,1,1,16,4,0,2018-2019,90.0,2.6865671641791042,0.0
1337,Víctor Laguardia,ESP,DF,Alavés,La Liga,28,1989,36.0,47,34,37,10,0,24,33,72.7,9,42,19,23,53,100,232,0,0,2018-2019,90.0,132.5,117.5
1338,Abdou Lahat Diakhate,SEN,MF,Parma,Serie A,19,1998,0.0,0,0,0,0,0,0,0,0.0,0,0,0,0,0,0,0,0,0,2018-2019,,,
1339,Konrad Laimer,AUT,"MF,DF",RB Leipzig,Bundesliga,21,1997,20.8,72,38,21,34,17,20,71,28.2,51,67,2,65,32,104,23,0,0,2018-2019,90.0,138.46153846153845,311.5384615384615
1340,Diego Lainez,MEX,"FW,MF",Betis,La Liga,18,2000,3.9,4,4,0,3,1,1,1,100.0,0,2,0,2,1,5,2,0,0,2018-2019,90.0,23.076923076923077,92.3076923076923
1341,Kenny Lala,MAD,"DF,FW",Strasbourg,Ligue 1,26,1991,34.0,78,45,48,23,7,30,53,56.6,23,26,9,17,28,106,62,2,0,2018-2019,90.0,74.11764705882354,206.47058823529412
1342,Adam Lallana,ENG,"MF,FW",Liverpool,Premier League,30,1988,5.2,16,9,6,7,3,5,12,41.7,7,10,1,9,5,21,4,0,0,2018-2019,90.0,86.53846153846153,276.9230769230769
1343,Érik Lamela,ARG,"MF,FW",Tottenham,Premier League,26,1992,10.8,17,13,6,7,4,5,14,35.7,9,14,0,14,7,24,1,0,0,2018-2019,90.0,58.33333333333333,141.66666666666666
1344,Mohamed Lamine Diaby,FRA,FW,Nice,Ligue 1,17,2001,1.8,1,1,0,1,0,1,1,100.0,0,2,0,2,2,3,0,0,0,2018-2019,90.0,100.0,50.0
1345,Loïck Landre,FRA,DF,Nîmes,Ligue 1,26,1992,17.7,31,21,23,8,0,14,22,63.6,8,16,11,5,38,69,83,1,0,2018-2019,90.0,193.22033898305085,157.6271186440678
1346,Michael Lang,SUI,DF,Gladbach,Bundesliga,27,1991,13.9,14,9,7,6,1,6,16,37.5,10,14,3,11,16,30,42,1,0,2018-2019,90.0,103.59712230215828,90.64748201438849
1347,Sebastian Langkamp,GER,DF,Werder Bremen,Bundesliga,30,1988,15.7,24,15,18,6,0,7,14,50.0,7,17,11,6,20,44,79,1,0,2018-2019,90.0,114.64968152866243,137.57961783439492
1348,Manuel Lanzini,ARG,MF,West Ham,Premier League,25,1993,7.6,12,7,5,6,1,5,18,27.8,13,3,1,2,9,21,7,1,0,2018-2019,90.0,106.57894736842105,142.10526315789474
1349,Gianluca Lapadula,PER,FW,Genoa,Serie A,28,1990,4.5,2,1,2,0,0,1,5,20.0,4,2,0,2,1,3,2,0,0,2018-2019,90.0,20.0,40.0
1350,Aymeric Laporte,ESP,DF,Manchester City,Premier League,24,1994,34.0,42,20,27,14,1,22,34,64.7,12,16,9,7,39,81,98,2,0,2018-2019,90.0,103.23529411764706,111.17647058823529
Rk,Player,Nation,Pos,Squad,Comp,0,0,90.0,0,0,3,3,3,Tkl,0,0.0,0,0,0,0,0,0,0,0,0,2018-2019,90.0,0.0,0.0
1351,Danilo Larangeira,BRA,DF,Bologna,Serie A,34,1984,34.2,40,26,29,11,0,20,30,66.7,10,52,39,13,37,77,182,3,0,2018-2019,90.0,97.36842105263158,105.26315789473684
1352,Johan Larsson,SWE,DF,Guingamp,Ligue 1,28,1990,1.0,1,1,0,1,0,1,2,50.0,1,0,0,0,1,2,1,1,0,2018-2019,90.0,90.0,90.0
1353,Kevin Lasagna,ITA,FW,Udinese,Serie A,25,1992,27.3,6,1,0,3,3,2,12,16.7,10,20,2,18,8,14,35,0,0,2018-2019,90.0,26.373626373626372,19.78021978021978
1354,Jamaal Lascelles,ENG,DF,Newcastle Utd,Premier League,24,1993,30.5,32,21,25,5,2,11,14,78.6,3,43,28,15,39,71,218,3,0,2018-2019,90.0,115.08196721311475,94.42622950819671
1355,Paul Lasne,FRA,"MF,DF",Montpellier,Ligue 1,29,1989,19.9,53,33,32,16,5,24,43,55.8,19,22,2,20,22,75,23,1,0,2018-2019,90.0,99.49748743718594,239.69849246231158
1356,Toni Lato,ESP,DF,Valencia,La Liga,20,1997,3.0,6,4,4,1,1,1,5,20.0,4,9,3,6,6,12,13,0,0,2018-2019,90.0,180.0,180.0
1357,Danny Latza,GER,MF,Mainz 05,Bundesliga,28,1989,20.7,41,22,16,23,2,20,61,32.8,41,49,10,39,20,61,31,0,0,2018-2019,90.0,86.95652173913044,178.2608695652174
1358,Alexandre Lauray,FRA,DF,Bordeaux,Ligue 1,21,1997,2.9,11,6,9,2,0,6,8,75.0,2,2,0,2,4,15,10,0,0,2018-2019,90.0,124.13793103448276,341.3793103448276
1359,Armand Lauriente,FRA,MF,Rennes,Ligue 1,19,1998,0.0,0,0,0,0,0,0,0,0.0,0,0,0,0,0,0,0,0,0,2018-2019,,,
1360,Vincent Laurini,FRA,DF,Fiorentina,Serie A,29,1989,10.2,13,5,6,5,2,6,10,60.0,4,11,5,6,13,26,30,0,0,2018-2019,90.0,114.70588235294119,114.70588235294119
1361,Wesley Lautoa,NCL,"DF,MF",Dijon,Ligue 1,30,1987,33.6,81,55,46,31,4,34,75,45.3,41,37,14,23,87,168,110,1,0,2018-2019,90.0,233.03571428571428,216.9642857142857
1362,Diego Laxalt,URU,"DF,MF",Milan,Serie A,25,1993,7.2,26,13,14,7,5,13,22,59.1,9,23,3,20,8,34,12,0,0,2018-2019,90.0,100.0,325.0
1363,Miguel Layún,MEX,"MF,DF",Villarreal,La Liga,30,1988,5.6,8,2,0,7,1,2,6,33.3,4,8,2,6,1,9,10,0,0,2018-2019,90.0,16.071428571428573,128.57142857142858
1364,Valentino Lazaro,AUT,"DF,FW",Hertha BSC,Bundesliga,22,1996,30.5,46,31,23,17,6,21,53,39.6,32,52,12,40,44,90,65,0,0,2018-2019,90.0,129.8360655737705,135.7377049180328
1365,Darko Lazović,SRB,"DF,FW",Genoa,Serie A,27,1990,28.2,28,17,13,8,7,14,31,45.2,17,21,6,15,20,48,33,0,0,2018-2019,89.99999999999999,63.82978723404255,89.36170212765957
1366,Manuel Lazzari,ITA,DF,SPAL,Serie A,24,1993,31.5,29,17,16,10,3,13,24,54.2,11,26,5,21,20,49,51,1,0,2018-2019,90.0,57.142857142857146,82.85714285714286
1367,Mickaël Le Bihan,FRA,FW,Nice,Ligue 1,28,1990,2.3,1,1,0,1,0,1,2,50.0,1,1,0,1,1,2,1,0,0,2018-2019,90.0,39.130434782608695,39.130434782608695
1368,Maxime Le Marchand,FRA,DF,Fulham,Premier League,28,1989,25.0,56,36,45,11,0,23,47,48.9,24,30,16,14,54,110,129,2,0,2018-2019,90.0,194.39999999999998,201.6
1369,Robin Le Normand,ESP,DF,Real Sociedad,La Liga,21,1996,3.2,5,2,2,3,0,1,3,33.3,2,3,0,3,4,9,13,1,0,2018-2019,90.0,112.5,140.625
1370,Damien Le Tallec,FRA,MF,Montpellier,Ligue 1,28,1990,31.2,95,58,42,43,10,33,89,37.1,56,35,8,27,59,154,50,0,0,2018-2019,90.0,170.19230769230768,274.03846153846155
1371,James Lea Siliki,CMR,"MF,FW",Rennes,Ligue 1,22,1996,13.6,26,17,13,10,3,12,35,34.3,23,14,1,13,10,36,7,1,0,2018-2019,90.0,66.17647058823529,172.05882352941177
1372,Rafael Leão,POR,FW,Lille,Ligue 1,19,1999,14.3,5,2,0,4,1,2,15,13.3,13,13,4,9,4,9,12,0,0,2018-2019,90.0,25.174825174825177,31.46853146853147
1373,Mathew Leckie,AUS,"FW,MF",Hertha BSC,Bundesliga,27,1991,10.5,20,13,5,10,5,7,16,43.8,9,10,1,9,13,33,16,0,0,2018-2019,90.0,111.42857142857143,171.42857142857142
1374,Benjamin Lecomte,FRA,GK,Montpellier,Ligue 1,27,1991,37.0,1,0,1,0,0,1,3,33.3,2,0,0,0,5,6,24,3,0,2018-2019,90.0,12.162162162162163,2.4324324324324325
1375,Pierre Lees-Melou,FRA,MF,Nice,Ligue 1,25,1993,26.6,74,46,31,36,7,25,62,40.3,37,44,8,36,36,110,37,0,0,2018-2019,90.0,121.80451127819548,250.37593984962405
Rk,Player,Nation,Pos,Squad,Comp,0,0,90.0,0,0,3,3,3,Tkl,0,0.0,0,0,0,0,0,0,0,0,0,2018-2019,90.0,0.0,0.0
1376,Jordan Lefort,FRA,DF,Amiens,Ligue 1,24,1993,20.0,33,18,23,6,4,16,25,64.0,9,11,8,3,46,79,107,0,0,2018-2019,90.0,207.0,148.5
1377,Wu Lei,CHN,"FW,MF",Espanyol,La Liga,26,1991,11.8,13,6,5,6,2,5,16,31.3,11,9,0,9,7,20,7,0,0,2018-2019,90.0,53.389830508474574,99.15254237288134
1378,Tim Leibold,GER,DF,Nürnberg,Bundesliga,24,1993,30.7,62,42,45,16,1,33,71,46.5,38,23,3,20,38,100,57,0,0,2018-2019,90.0,111.40065146579805,181.75895765472313
1379,Lucas Leiva,BRA,MF,Lazio,Serie A,31,1987,22.1,91,54,40,46,5,38,79,48.1,41,27,11,16,52,143,43,3,0,2018-2019,90.0,211.76470588235293,370.5882352941176
1380,Florian Lejeune,FRA,DF,Newcastle Utd,Premier League,27,1991,11.7,25,15,17,7,1,11,24,45.8,13,16,5,11,21,46,49,0,0,2018-2019,89.99999999999999,161.53846153846152,192.3076923076923
1381,Iñigo Lekue,ESP,DF,Athletic Club,La Liga,25,1993,2.3,5,2,3,2,0,2,7,28.6,5,4,0,4,4,9,11,0,0,2018-2019,90.0,156.52173913043478,195.6521739130435
1382,Thomas Lemar,FRA,MF,Atlético Madrid,La Liga,22,1995,20.2,38,21,23,11,4,19,42,45.2,23,26,1,25,22,60,7,1,0,2018-2019,90.0,98.01980198019803,169.30693069306932
1383,Mario Lemina,GAB,MF,Southampton,Premier League,24,1993,17.9,49,32,23,23,3,15,34,44.1,19,27,3,24,43,92,31,1,0,2018-2019,90.0,216.2011173184358,246.36871508379892
1384,Mauricio Lemos,URU,DF,Sassuolo,Serie A,22,1995,2.0,2,1,2,0,0,1,2,50.0,1,2,1,1,3,5,10,1,0,2018-2019,90.0,135.0,90.0
1385,Clément Lenglet,FRA,DF,Barcelona,La Liga,23,1995,21.5,47,29,26,19,2,22,36,61.1,14,30,20,10,21,68,70,0,0,2018-2019,90.0,87.90697674418604,196.74418604651163
1386,Aaron Lennon,ENG,MF,Burnley,Premier League,31,1987,13.5,26,16,11,12,3,6,14,42.9,8,24,0,24,10,36,18,0,0,2018-2019,90.0,66.66666666666667,173.33333333333334
1387,Bernd Leno,GER,GK,Arsenal,Premier League,26,1992,31.5,0,0,0,0,0,0,3,0.0,3,0,0,0,4,4,16,6,0,2018-2019,90.0,11.428571428571429,0.0
1388,Pedro León,ESP,"MF,FW",Eibar,La Liga,31,1986,4.7,7,4,2,2,3,4,7,57.1,3,10,0,10,4,11,2,0,0,2018-2019,90.0,76.59574468085106,134.04255319148936
1389,Sergio León,ESP,"FW,MF",Betis,La Liga,29,1989,7.1,4,2,2,1,1,2,8,25.0,6,4,0,4,2,6,6,0,0,2018-2019,90.0,25.35211267605634,50.70422535211268
1390,Lukas Lerager,DEN,MF,Genoa,Serie A,25,1993,12.5,34,18,12,20,2,13,42,31.0,29,11,1,10,18,52,12,0,0,2018-2019,90.0,129.6,244.79999999999998
1391,Lukas Lerager,DEN,MF,Bordeaux,Ligue 1,25,1993,14.4,38,21,14,23,1,18,43,41.9,25,22,10,12,32,70,26,1,0,2018-2019,90.0,200.0,237.5
1392,Mehdi Léris,ALG,"MF,DF",Chievo,Serie A,20,1998,17.9,53,33,19,24,10,24,54,44.4,30,34,1,33,28,81,24,1,0,2018-2019,90.0,140.78212290502796,266.4804469273743
1393,Jefferson Lerma,COL,MF,Bournemouth,Premier League,23,1994,27.8,45,31,20,20,5,14,54,25.9,40,35,19,16,54,99,88,1,0,2018-2019,90.0,174.8201438848921,145.68345323741008
1394,Robert Lewandowski,POL,FW,Bayern Munich,Bundesliga,29,1988,32.9,12,9,0,8,4,3,11,27.3,8,11,1,10,7,19,15,0,0,2018-2019,90.0,19.148936170212767,32.82674772036474
1395,Igor Lewczuk,POL,DF,Bordeaux,Ligue 1,33,1985,5.0,12,7,8,2,2,1,4,25.0,3,2,2,0,4,16,27,0,0,2018-2019,90.0,72.0,216.0
1396,Aaron Leya Iseka,BEL,FW,Toulouse,Ligue 1,20,1997,16.0,6,4,1,4,1,1,4,25.0,3,5,3,2,1,7,10,0,0,2018-2019,90.0,5.625,33.75
1397,Stephan Lichtsteiner,SUI,DF,Arsenal,Premier League,34,1984,10.4,15,9,5,4,6,9,16,56.3,7,11,4,7,9,24,25,1,0,2018-2019,90.0,77.88461538461537,129.8076923076923
1398,Dimitri Liénard,FRA,"MF,DF",Strasbourg,Ligue 1,30,1988,14.3,33,18,20,9,4,21,45,46.7,24,11,2,9,18,51,22,0,0,2018-2019,90.0,113.2867132867133,207.6923076923077
1399,Philipp Lienhart,AUT,DF,Freiburg,Bundesliga,22,1996,6.8,6,6,4,2,0,3,6,50.0,3,9,7,2,11,17,42,0,0,2018-2019,90.0,145.58823529411765,79.41176470588235
1400,Lucas Lima,BRA,"DF,FW",Nantes,Ligue 1,26,1991,27.7,49,28,26,15,8,20,53,37.7,33,39,3,36,29,78,62,1,0,2018-2019,90.0,94.22382671480145,159.20577617328522
Rk,Player,Nation,Pos,Squad,Comp,0,0,90.0,0,0,3,3,3,Tkl,0,0.0,0,0,0,0,0,0,0,0,0,2018-2019,90.0,0.0,0.0
1401,Anthony Limbombe,BEL,FW,Nantes,Ligue 1,24,1994,13.7,12,10,4,6,2,7,16,43.8,9,5,0,5,8,20,10,0,0,2018-2019,90.0,52.55474452554745,78.83211678832117
1402,Victor Lindelöf,SWE,DF,Manchester Utd,Premier League,24,1994,28.9,40,27,28,12,0,13,23,56.5,10,21,12,9,24,64,121,3,0,2018-2019,90.00000000000001,74.74048442906576,124.56747404844292
1403,Karol Linetty,POL,MF,Sampdoria,Serie A,23,1995,27.9,72,48,26,32,14,15,69,21.7,54,39,4,35,25,97,17,0,0,2018-2019,90.0,80.64516129032258,232.25806451612902
1404,Jesse Lingard,ENG,"FW,MF",Manchester Utd,Premier League,25,1992,18.5,29,18,8,11,10,7,28,25.0,21,18,2,16,10,39,9,1,0,2018-2019,90.0,48.64864864864865,141.0810810810811
1405,Pol Lirola,ESP,"DF,MF",Sassuolo,Serie A,20,1997,33.1,35,22,19,11,5,21,34,61.8,13,25,5,20,32,67,89,0,0,2018-2019,90.0,87.00906344410875,95.16616314199395
1406,Adem Ljajić,SRB,MF,Torino,Serie A,26,1991,0.3,0,0,0,0,0,0,1,0.0,1,0,0,0,0,0,0,0,0,2018-2019,90.0,0.0,0.0
1407,Diego Llorente,ESP,DF,Real Sociedad,La Liga,24,1993,19.5,26,15,16,8,2,17,29,58.6,12,27,15,12,26,52,83,2,0,2018-2019,90.0,120.0,120.0
1408,Fernando Llorente,ESP,FW,Tottenham,Premier League,33,1985,7.7,4,2,3,0,1,2,3,66.7,1,7,2,5,1,5,10,0,0,2018-2019,90.0,11.688311688311689,46.753246753246756
1409,Marcos Llorente,ESP,MF,Real Madrid,La Liga,23,1995,6.0,16,12,7,7,2,8,18,44.4,10,8,0,8,7,23,12,0,0,2018-2019,90.0,105.0,240.0
1410,Hugo Lloris,FRA,GK,Tottenham,Premier League,31,1986,33.0,1,0,1,0,0,0,2,0.0,2,0,0,0,0,1,13,5,0,2018-2019,90.0,0.0,2.7272727272727275
1411,Giovani Lo Celso,ARG,"MF,FW",Betis,La Liga,22,1996,26.6,52,31,16,28,8,9,35,25.7,26,24,1,23,17,69,8,0,0,2018-2019,90.0,57.5187969924812,175.93984962406014
1412,Giovani Lo Celso,ARG,MF,Paris S-G,Ligue 1,22,1996,0.1,1,1,0,0,1,0,1,0.0,1,0,0,0,0,1,0,0,0,2018-2019,90.0,0.0,900.0
1413,Stanislav Lobotka,SVK,MF,Celta Vigo,La Liga,23,1994,27.7,30,19,10,17,3,9,32,28.1,23,15,1,14,26,56,18,1,0,2018-2019,90.0,84.47653429602889,97.47292418772564
1414,Jürgen Locadia,CUW,"FW,MF",Brighton,Premier League,24,1993,13.7,15,10,5,8,2,3,7,42.9,4,8,0,8,9,24,13,0,0,2018-2019,90.0,59.12408759124089,98.54014598540147
1415,Manuel Locatelli,ITA,MF,Sassuolo,Serie A,20,1998,20.5,44,28,19,15,10,13,29,44.8,16,21,3,18,27,71,33,1,0,2018-2019,90.0,118.53658536585365,193.1707317073171
1416,Ruben Loftus-Cheek,ENG,"MF,FW",Chelsea,Premier League,22,1996,11.1,18,12,7,7,4,3,12,25.0,9,10,4,6,11,29,5,0,0,2018-2019,90.0,89.1891891891892,145.94594594594597
1417,Enzo Loiodice,FRA,MF,Dijon,Ligue 1,17,2000,9.4,25,14,8,15,2,10,21,47.6,11,7,0,7,11,36,7,0,0,2018-2019,90.0,105.31914893617021,239.36170212765956
1418,Kevin Long,IRL,DF,Burnley,Premier League,27,1990,5.7,18,10,13,5,0,7,17,41.2,10,7,5,2,7,25,35,1,0,2018-2019,90.0,110.52631578947367,284.2105263157894
1419,Shane Long,IRL,"FW,MF",Southampton,Premier League,31,1987,14.1,15,8,4,5,6,3,16,18.8,13,10,1,9,7,22,18,0,0,2018-2019,89.99999999999999,44.680851063829785,95.74468085106382
1420,Samuele Longo,ITA,FW,Huesca,La Liga,26,1992,6.2,4,3,2,2,0,0,6,0.0,6,4,0,4,1,5,7,0,0,2018-2019,90.0,14.516129032258064,58.064516129032256
1421,Sean Longstaff,ENG,MF,Newcastle Utd,Premier League,20,1997,7.6,17,13,6,11,0,9,24,37.5,15,19,4,15,10,27,7,0,0,2018-2019,90.0,118.42105263157895,201.3157894736842
1422,Ademola Lookman,NGA,"FW,MF",Everton,Premier League,20,1997,6.9,15,7,7,5,3,4,6,66.7,2,10,0,10,7,22,2,0,0,2018-2019,90.0,91.30434782608695,195.65217391304347
1423,Anthony Lopes,POR,GK,Lyon,Ligue 1,27,1990,34.0,1,0,1,0,0,1,3,33.3,2,3,0,3,2,3,16,3,0,2018-2019,90.0,5.294117647058823,2.6470588235294117
1424,Rony Lopes,POR,"FW,MF",Monaco,Ligue 1,22,1995,20.5,33,22,10,17,6,9,22,40.9,13,17,1,16,8,41,10,0,0,2018-2019,90.0,35.1219512195122,144.8780487804878
1425,Álex López,ESP,MF,Espanyol,La Liga,21,1997,1.2,3,1,1,2,0,2,3,66.7,1,0,0,0,3,6,1,0,0,2018-2019,90.0,225.00000000000003,225.00000000000003
Rk,Player,Nation,Pos,Squad,Comp,0,0,90.0,0,0,3,3,3,Tkl,0,0.0,0,0,0,0,0,0,0,0,0,2018-2019,90.0,0.0,0.0
1426,Cristian López,ESP,FW,Angers,Ligue 1,29,1989,4.1,6,3,1,2,3,1,8,12.5,7,4,0,4,1,7,2,0,0,2018-2019,90.0,21.951219512195124,131.70731707317074
1427,David López,ESP,DF,Espanyol,La Liga,28,1989,20.2,27,18,15,10,2,10,22,45.5,12,18,12,6,28,55,65,2,0,2018-2019,90.0,124.75247524752476,120.29702970297029
1428,Diego López,ESP,GK,Espanyol,La Liga,36,1981,38.0,0,0,0,0,0,0,0,0.0,0,0,0,0,2,2,9,3,0,2018-2019,90.0,4.7368421052631575,0.0
1429,Javi López,ESP,DF,Espanyol,La Liga,32,1986,21.6,63,40,37,22,4,28,60,46.7,32,27,5,22,40,103,90,0,0,2018-2019,90.0,166.66666666666666,262.5
1430,Lluis López,ESP,DF,Espanyol,La Liga,21,1997,5.8,5,3,4,1,0,3,6,50.0,3,6,2,4,7,12,21,0,0,2018-2019,90.0,108.62068965517241,77.58620689655173
1431,Maxime Lopez,FRA,MF,Marseille,Ligue 1,20,1997,24.2,46,24,17,23,6,19,53,35.8,34,10,2,8,20,66,8,0,0,2018-2019,90.0,74.3801652892562,171.07438016528926
1432,Pedro López Muñoz,ESP,DF,Levante,La Liga,34,1983,5.2,5,3,5,0,0,3,7,42.9,4,8,3,5,8,13,7,0,0,2018-2019,90.0,138.46153846153845,86.53846153846153
1433,Pau López,ESP,GK,Betis,La Liga,23,1994,33.0,0,0,0,0,0,0,2,0.0,2,1,0,1,2,2,17,2,0,2018-2019,90.0,5.454545454545455,0.0
1434,Roberto López,ESP,MF,Real Sociedad,La Liga,18,2000,0.3,0,0,0,0,0,0,1,0.0,1,1,0,1,1,1,2,0,0,2018-2019,90.0,300.0,0.0
1435,Unai López,ESP,MF,Athletic Club,La Liga,22,1995,3.6,7,5,3,2,2,2,12,16.7,10,10,3,7,1,8,2,0,0,2018-2019,90.0,25.0,175.0
1436,Jonas Lössl,DEN,GK,Huddersfield,Premier League,29,1989,30.9,0,0,0,0,0,0,1,0.0,1,1,0,1,2,2,12,2,0,2018-2019,90.0,5.825242718446602,0.0
1437,Albert Lottin,FRA,"MF,FW",Bordeaux,Ligue 1,16,2001,0.2,1,1,0,1,0,0,1,0.0,1,1,0,1,0,1,0,0,0,2018-2019,90.0,0.0,450.0
1438,Imran Louza,MAR,MF,Nantes,Ligue 1,19,1999,1.0,2,0,1,1,0,1,1,100.0,0,1,0,1,0,2,1,0,0,2018-2019,90.0,0.0,180.0
1439,Davor Lovren,CRO,MF,Düsseldorf,Bundesliga,19,1998,0.5,1,1,0,0,1,0,0,0.0,0,1,0,1,0,1,0,0,0,2018-2019,90.0,0.0,180.0
1440,Dejan Lovren,CRO,DF,Liverpool,Premier League,29,1989,11.0,15,9,10,5,0,7,15,46.7,8,11,7,4,11,26,51,2,0,2018-2019,90.0,90.0,122.72727272727273
1441,Chris Löwe,GER,"DF,MF",Huddersfield,Premier League,29,1989,22.9,34,18,17,15,2,12,33,36.4,21,21,3,18,23,57,56,0,0,2018-2019,90.0,90.39301310043669,133.62445414847164
1442,Eduard Löwen,GER,"MF,FW",Nürnberg,Bundesliga,21,1997,18.0,30,22,14,13,3,11,34,32.4,23,15,2,13,8,38,23,0,0,2018-2019,90.0,40.0,150.0
1443,Matthew Lowton,ENG,DF,Burnley,Premier League,29,1989,19.4,56,35,21,31,4,32,60,53.3,28,29,7,22,30,86,80,1,0,2018-2019,90.0,139.1752577319588,259.79381443298973
1444,Anthony Lozano,HON,"FW,MF",Girona,La Liga,25,1993,8.1,6,5,3,3,0,0,6,0.0,6,7,1,6,0,6,6,0,0,2018-2019,90.0,0.0,66.66666666666667
1445,Derrick Luckassen,NED,DF,Hertha BSC,Bundesliga,23,1995,2.8,4,2,4,0,0,1,3,33.3,2,1,0,1,0,4,13,0,0,2018-2019,90.0,0.0,128.57142857142858
1446,Filipe Luís,BRA,DF,Atlético Madrid,La Liga,32,1985,22.6,66,36,33,25,8,32,58,55.2,26,18,3,15,44,110,47,0,0,2018-2019,90.0,175.2212389380531,262.83185840707966
1447,José Luis Gayà,ESP,DF,Valencia,La Liga,23,1995,34.9,83,59,56,20,7,46,80,57.5,34,48,6,42,43,126,105,1,0,2018-2019,90.0,110.88825214899714,214.04011461318052
1448,José Luis Morales,ESP,"FW,MF",Levante,La Liga,31,1987,35.5,21,15,6,10,5,8,49,16.3,41,22,1,21,12,33,17,0,0,2018-2019,90.0,30.422535211267608,53.23943661971831
1449,José Luis Palomino,ARG,DF,Atalanta,Serie A,28,1990,25.1,49,31,31,15,3,23,38,60.5,15,34,17,17,68,117,79,0,0,2018-2019,90.0,243.82470119521912,175.69721115537848
1450,Luisinho,POR,DF,Huesca,La Liga,33,1985,5.6,14,10,9,5,0,10,17,58.8,7,6,1,5,16,30,17,0,0,2018-2019,90.0,257.14285714285717,225.0
Rk,Player,Nation,Pos,Squad,Comp,0,0,90.0,0,0,3,3,3,Tkl,0,0.0,0,0,0,0,0,0,0,0,0,2018-2019,90.0,0.0,0.0
1451,David Luiz,BRA,DF,Chelsea,Premier League,31,1987,36.0,41,31,27,13,1,21,28,75.0,7,33,18,15,35,76,149,1,0,2018-2019,90.0,87.5,102.5
1452,Douglas Luiz,BRA,MF,Girona,La Liga,20,1998,16.6,34,19,13,20,1,9,38,23.7,29,19,7,12,21,55,26,0,0,2018-2019,90.0,113.85542168674698,184.33734939759034
1453,Everton Luiz,BRA,MF,SPAL,Serie A,30,1988,3.5,11,6,5,5,1,4,7,57.1,3,9,1,8,3,14,7,2,0,2018-2019,90.0,77.14285714285714,282.85714285714283
1454,Jordan Lukaku,BEL,"DF,MF",Lazio,Serie A,24,1994,1.9,4,3,2,1,1,3,5,60.0,2,3,0,3,5,9,2,0,0,2018-2019,90.0,236.8421052631579,189.4736842105263
1455,Romelu Lukaku,BEL,FW,Manchester Utd,Premier League,25,1993,23.7,8,4,0,6,2,2,10,20.0,8,12,1,11,2,10,19,0,0,2018-2019,90.0,7.59493670886076,30.37974683544304
1456,Dodi Lukebakio,BEL,"FW,MF",Düsseldorf,Bundesliga,20,1997,21.9,25,17,11,6,8,8,15,53.3,7,13,0,13,9,34,19,0,0,2018-2019,90.0,36.986301369863014,102.73972602739727
1457,Saša Lukić,SRB,MF,Torino,Serie A,21,1996,11.0,21,11,5,11,5,5,16,31.3,11,13,4,9,12,33,11,0,0,2018-2019,90.0,98.18181818181819,171.8181818181818
1458,Senad Lulić,BIH,"DF,FW",Lazio,Serie A,32,1986,32.5,71,43,37,27,7,32,76,42.1,44,27,3,24,49,120,58,1,0,2018-2019,90.0,135.6923076923077,196.6153846153846
1459,Antonio Luna,ESP,"DF,FW",Levante,La Liga,27,1991,14.0,14,10,6,7,1,6,23,26.1,17,22,7,15,15,29,48,1,0,2018-2019,90.0,96.42857142857143,90.0
1460,Andriy Lunin,UKR,GK,Leganés,La Liga,19,1999,4.1,0,0,0,0,0,0,0,0.0,0,0,0,0,0,0,0,0,0,2018-2019,90.0,0.0,0.0
1461,Sebastiano Luperto,ITA,DF,Napoli,Serie A,21,1996,8.1,8,6,5,2,1,2,5,40.0,3,7,3,4,13,21,30,0,0,2018-2019,90.0,144.44444444444446,88.88888888888889
1462,Fabian Lustenberger,SUI,"DF,MF",Hertha BSC,Bundesliga,30,1988,24.1,45,30,23,21,1,15,33,45.5,18,39,18,21,39,84,108,2,0,2018-2019,90.0,145.64315352697096,168.04979253112032
1463,Andreas Luthe,GER,GK,Augsburg,Bundesliga,31,1987,14.6,0,0,0,0,0,0,0,0.0,0,0,0,0,0,0,4,0,0,2018-2019,90.0,0.0,0.0
1464,Lyanco,BRA,DF,Torino,Serie A,21,1997,1.0,1,1,1,0,0,0,0,0.0,0,1,1,0,4,5,5,0,0,2018-2019,90.0,360.0,90.0
1465,Lyanco,BRA,DF,Bologna,Serie A,21,1997,12.4,29,18,19,10,0,13,18,72.2,5,24,16,8,22,51,64,0,0,2018-2019,90.0,159.67741935483872,210.48387096774195
1466,Hervé Lybohy,NIG,DF,Nîmes,Ligue 1,35,1983,16.4,22,13,13,9,0,11,16,68.8,5,17,11,6,14,36,70,0,0,2018-2019,90.0,76.82926829268294,120.73170731707319
1467,Charalambos Lykogiannis,GRE,DF,Cagliari,Serie A,24,1993,9.2,14,8,8,3,3,6,11,54.5,5,18,3,15,19,33,33,0,0,2018-2019,90.0,185.8695652173913,136.95652173913044
1468,Yann M'Vila,FRA,MF,Saint-Étienne,Ligue 1,28,1990,36.2,72,40,22,48,2,29,72,40.3,43,42,12,30,74,146,86,5,0,2018-2019,90.0,183.97790055248618,179.00552486187843
1469,Darwin Machís,VEN,"FW,MF",Udinese,Serie A,25,1993,5.1,7,6,4,3,0,0,4,0.0,4,6,0,6,2,9,8,0,0,2018-2019,90.0,35.294117647058826,123.52941176470588
1470,James Maddison,ENG,"MF,FW",Leicester City,Premier League,21,1996,31.5,48,32,20,25,3,14,58,24.1,44,20,4,16,12,60,10,1,0,2018-2019,90.0,34.285714285714285,137.14285714285714
1471,Gary Madine,ENG,"FW,MF",Cardiff City,Premier League,27,1990,0.4,1,1,0,1,0,0,0,0.0,0,0,0,0,0,1,0,0,0,2018-2019,90.0,0.0,225.0
1472,Pablo Maffeo,ESP,"DF,MF",Stuttgart,Bundesliga,21,1997,6.6,15,13,10,5,0,6,13,46.2,7,8,4,4,13,28,17,0,0,2018-2019,90.0,177.27272727272728,204.54545454545453
1473,Gabriel Magalhães,BRA,DF,Lille,Ligue 1,20,1997,11.8,18,11,13,4,1,4,7,57.1,3,14,6,8,19,37,60,2,0,2018-2019,90.0,144.9152542372881,137.28813559322032
1474,Francesco Magnanelli,ITA,MF,Sassuolo,Serie A,33,1984,20.7,52,33,29,22,1,22,49,44.9,27,18,5,13,24,76,38,2,0,2018-2019,90.0,104.34782608695653,226.08695652173915
1475,Giangiacomo Magnani,ITA,DF,Sassuolo,Serie A,22,1995,16.8,11,9,9,2,0,6,15,40.0,9,17,13,4,16,27,99,1,0,2018-2019,90.0,85.71428571428571,58.92857142857142
Rk,Player,Nation,Pos,Squad,Comp,0,0,90.0,0,0,3,3,3,Tkl,0,0.0,0,0,0,0,0,0,0,0,0,2018-2019,90.0,0.0,0.0
1476,Harry Maguire,ENG,DF,Leicester City,Premier League,25,1993,28.8,31,17,21,9,1,11,17,64.7,6,32,18,14,36,67,155,4,0,2018-2019,90.0,112.5,96.875
1477,Riyad Mahrez,ALG,"FW,MF",Manchester City,Premier League,27,1991,14.9,14,7,3,7,4,6,18,33.3,12,18,1,17,9,23,3,1,0,2018-2019,90.0,54.36241610738254,84.56375838926174
1478,Thiago Maia,BRA,MF,Lille,Ligue 1,21,1997,11.3,32,19,17,13,2,13,33,39.4,20,14,5,9,23,55,23,0,0,2018-2019,90.0,183.1858407079646,254.86725663716814
1479,Raffaele Maiello,ITA,MF,Frosinone,Serie A,27,1991,22.7,42,27,30,8,4,16,27,59.3,11,23,10,13,30,72,41,0,0,2018-2019,89.99999999999999,118.94273127753303,166.51982378854623
1480,Arne Maier,GER,MF,Hertha BSC,Bundesliga,19,1999,22.9,31,16,12,19,0,6,25,24.0,19,32,9,23,28,59,35,0,0,2018-2019,90.0,110.04366812227076,121.83406113537119
1481,Domenico Maietta,ITA,DF,Empoli,Serie A,35,1982,19.0,33,15,22,10,1,16,36,44.4,20,19,14,5,24,57,78,2,0,2018-2019,90.0,113.6842105263158,156.31578947368422
1482,Mike Maignan,FRA,GK,Lille,Ligue 1,23,1995,38.0,0,0,0,0,0,0,0,0.0,0,1,0,1,0,0,12,1,0,2018-2019,90.0,0.0,0.0
1483,Linton Maina,GER,"FW,MF",Hannover 96,Bundesliga,19,1999,15.7,28,14,13,10,5,12,23,52.2,11,20,0,20,14,42,4,0,0,2018-2019,90.0,80.2547770700637,160.5095541401274
1484,Ainsley Maitland-Niles,ENG,DF,Arsenal,Premier League,20,1997,11.0,33,22,19,12,2,14,28,50.0,14,22,4,18,19,52,15,2,0,2018-2019,90.0,155.45454545454547,270.0
1485,Josh Maja,NGA,FW,Bordeaux,Ligue 1,19,1998,2.2,2,1,1,1,0,0,1,0.0,1,1,0,1,0,2,0,0,0,2018-2019,90.0,0.0,81.81818181818181
1486,Abdul Majeed Waris,GHA,"FW,MF",Nantes,Ligue 1,26,1991,25.0,22,13,6,13,3,7,28,25.0,21,9,0,9,7,29,7,0,0,2018-2019,90.0,25.2,79.2
1487,Jean-Victor Makengo,FRA,"MF,FW",Nice,Ligue 1,20,1998,11.4,10,8,3,6,1,1,5,20.0,4,5,1,4,9,19,5,0,0,2018-2019,90.0,71.05263157894736,78.94736842105263
1488,Nemanja Maksimović,SRB,MF,Getafe,La Liga,23,1995,35.7,77,45,21,51,5,21,61,34.4,40,60,15,45,71,148,33,0,0,2018-2019,90.0,178.99159663865544,194.1176470588235
1489,Nikola Maksimović,SRB,DF,Napoli,Serie A,26,1991,15.3,20,13,14,6,0,6,12,50.0,6,16,10,6,28,48,56,1,0,2018-2019,90.0,164.70588235294116,117.6470588235294
1490,Malcom,BRA,"FW,MF",Barcelona,La Liga,21,1997,6.8,3,2,0,1,2,2,3,66.7,1,7,0,7,1,4,1,0,0,2018-2019,90.0,13.235294117647058,39.705882352941174
1491,Kévin Malcuit,MAR,DF,Napoli,Serie A,27,1991,20.1,43,31,23,14,6,23,36,63.9,13,18,4,14,44,87,67,0,0,2018-2019,90.0,197.0149253731343,192.5373134328358
1492,Yunus Mallı,TUR,"MF,FW",Wolfsburg,Bundesliga,26,1992,7.8,15,7,8,6,1,2,11,18.2,9,2,0,2,4,19,1,0,0,2018-2019,90.0,46.15384615384615,173.07692307692307
1493,Hugo Mallo,ESP,DF,Celta Vigo,La Liga,27,1991,34.4,73,41,41,27,5,27,52,51.9,25,44,13,31,50,123,135,1,0,2018-2019,90.0,130.8139534883721,190.9883720930233
1494,Antonio Mance,CRO,FW,Nantes,Ligue 1,22,1995,0.6,1,1,0,0,1,1,2,50.0,1,0,0,0,0,1,0,0,0,2018-2019,90.0,0.0,150.0
1495,Vincent Manceau,FRA,DF,Angers,Ligue 1,29,1989,31.0,98,65,64,23,11,33,62,53.2,29,41,10,31,44,142,87,0,0,2018-2019,90.0,127.74193548387098,284.51612903225805
1496,Gianluca Mancini,ITA,DF,Atalanta,Serie A,22,1996,25.0,40,30,22,17,1,16,29,55.2,13,19,4,15,48,88,77,1,0,2018-2019,90.0,172.79999999999998,144.0
1497,Steve Mandanda,FRA,GK,Marseille,Ligue 1,33,1985,30.4,0,0,0,0,0,0,3,0.0,3,0,0,0,1,1,7,4,0,2018-2019,90.0,2.9605263157894735,0.0
1498,Reinildo Mandava,MOZ,DF,Lille,Ligue 1,24,1994,1.1,3,2,1,2,0,2,3,66.7,1,1,0,1,1,4,0,0,0,2018-2019,90.0,81.81818181818181,245.45454545454544
1499,Aïssa Mandi,ALG,DF,Betis,La Liga,26,1991,34.0,52,34,27,20,5,12,29,41.4,17,39,23,16,41,93,71,2,0,2018-2019,90.0,108.52941176470588,137.64705882352942
1500,Rolando Mandragora,ITA,MF,Udinese,Serie A,21,1997,32.4,66,35,25,34,7,24,69,34.8,45,49,9,40,43,109,59,0,0,2018-2019,90.0,119.44444444444444,183.33333333333334
Rk,Player,Nation,Pos,Squad,Comp,0,0,90.0,0,0,3,3,3,Tkl,0,0.0,0,0,0,0,0,0,0,0,0,2018-2019,90.0,0.0,0.0
1501,Mario Mandžukić,CRO,FW,Juventus,Serie A,32,1986,22.4,34,25,13,15,6,9,18,50.0,9,17,5,12,13,47,22,0,0,2018-2019,90.0,52.23214285714286,136.60714285714286
1502,Sadio Mané,SEN,FW,Liverpool,Premier League,26,1992,34.2,35,29,12,17,6,14,43,32.6,29,28,4,24,15,50,10,1,0,2018-2019,90.0,39.473684210526315,92.10526315789474
1503,Thomas Mangani,FRA,MF,Angers,Ligue 1,31,1987,17.8,42,27,13,26,3,19,62,30.6,43,13,2,11,23,65,24,0,0,2018-2019,90.0,116.29213483146067,212.35955056179776
1504,Kostas Manolas,GRE,DF,Roma,Serie A,27,1991,25.8,32,24,23,8,1,17,26,65.4,9,34,25,9,50,82,117,2,0,2018-2019,90.0,174.41860465116278,111.62790697674419
1505,Javier Manquillo,ESP,DF,Newcastle Utd,Premier League,24,1994,12.2,27,19,14,11,2,9,14,64.3,5,9,1,8,17,44,58,0,0,2018-2019,90.0,125.40983606557378,199.1803278688525
1506,Martín Mantovani,ARG,DF,Huesca,La Liga,34,1984,7.8,15,9,12,3,0,6,11,54.5,5,4,3,1,22,37,48,0,0,2018-2019,90.0,253.84615384615384,173.07692307692307
1507,Juan Manuel Valencia,COL,FW,Bologna,Serie A,20,1998,0.3,0,0,0,0,0,0,0,0.0,0,0,0,0,1,1,0,0,0,2018-2019,90.0,300.0,0.0
1508,Harrison Manzala,COD,"MF,FW",Angers,Ligue 1,24,1994,0.8,2,2,1,0,1,0,0,0.0,0,0,0,0,0,2,1,0,0,2018-2019,90.0,0.0,225.0
1509,Fran Manzanara,ESP,"DF,MF",Levante,La Liga,21,1996,1.7,7,5,3,3,1,4,4,100.0,0,3,2,1,1,8,7,0,0,2018-2019,90.0,52.94117647058823,370.5882352941176
1510,Myziane Maolida,COM,FW,Nice,Ligue 1,19,1999,10.6,12,8,5,5,2,2,4,50.0,2,5,0,5,1,13,5,0,0,2018-2019,90.0,8.49056603773585,101.88679245283019
1511,Faitout Maouassa,FRA,DF,Nîmes,Ligue 1,20,1998,23.7,55,30,35,15,5,23,39,59.0,16,24,5,19,23,78,81,1,0,2018-2019,90.0,87.34177215189874,208.8607594936709
1512,Fernando Marçal,BRA,DF,Lyon,Ligue 1,29,1989,9.8,25,16,17,7,1,12,15,80.0,3,9,3,6,30,55,42,0,0,2018-2019,90.0,275.51020408163265,229.59183673469386
1513,Iván Marcano,ESP,DF,Roma,Serie A,31,1987,9.0,8,4,4,4,0,5,8,62.5,3,13,6,7,24,32,45,0,0,2018-2019,90.0,240.0,80.0
1514,Marcelo,BRA,DF,Real Madrid,La Liga,30,1988,20.6,34,19,17,12,5,15,39,38.5,24,19,2,17,17,51,21,0,0,2018-2019,90.0,74.27184466019418,148.54368932038835
1515,Marcelo,BRA,DF,Lyon,Ligue 1,31,1987,32.0,48,33,29,17,2,19,24,79.2,5,30,22,8,62,110,152,2,0,2018-2019,90.0,174.375,135.0
1516,Solly March,ENG,"FW,MF",Brighton,Premier League,24,1994,27.4,56,24,27,16,13,19,45,42.2,26,34,4,30,27,83,44,0,0,2018-2019,90.0,88.68613138686132,183.94160583941607
1517,Federico Marchetti,ITA,GK,Genoa,Serie A,35,1983,4.0,0,0,0,0,0,0,0,0.0,0,0,0,0,0,0,1,0,0,2018-2019,90.0,0.0,0.0
1518,Gian Marco Ferrari,ITA,DF,Sassuolo,Serie A,26,1992,31.0,41,23,27,12,2,12,16,75.0,4,36,20,16,36,77,97,1,0,2018-2019,90.0,104.51612903225806,119.03225806451613
1519,Óscar de Marcos,ESP,"DF,FW",Athletic Club,La Liga,29,1989,26.9,60,32,34,17,9,29,62,46.8,33,29,4,25,27,87,62,0,0,2018-2019,90.0,90.33457249070632,200.74349442379184
1520,Georg Margreitter,AUT,DF,Nürnberg,Bundesliga,29,1988,22.9,39,24,28,8,3,31,38,81.6,7,29,26,3,26,65,141,0,0,2018-2019,90.0,102.18340611353713,153.27510917030568
1521,Miguel Marí,ESP,MF,Eibar,La Liga,21,1997,0.8,0,0,0,0,0,0,2,0.0,2,0,0,0,1,1,2,0,0,2018-2019,90.0,112.5,0.0
1522,José María Giménez,URU,DF,Atlético Madrid,La Liga,23,1995,19.7,26,15,20,6,0,13,26,50.0,13,27,14,13,44,70,128,2,0,2018-2019,90.0,201.01522842639594,118.78172588832487
1523,Mariano,DOM,FW,Real Madrid,La Liga,24,1993,5.0,2,1,1,1,0,0,3,0.0,3,2,0,2,0,2,2,0,0,2018-2019,90.0,0.0,36.0
1524,Mariano,DOM,FW,Lyon,Ligue 1,24,1993,1.6,0,0,0,0,0,0,0,0.0,0,0,0,0,1,1,0,0,0,2018-2019,90.0,56.25,0.0
1525,Adrian Mariappa,JAM,DF,Watford,Premier League,31,1986,21.4,35,22,29,6,0,16,32,50.0,16,23,15,8,26,61,120,2,0,2018-2019,90.0,109.34579439252337,147.196261682243
Rk,Player,Nation,Pos,Squad,Comp,0,0,90.0,0,0,3,3,3,Tkl,0,0.0,0,0,0,0,0,0,0,0,0,2018-2019,90.0,0.0,0.0
1526,Jordan Marié,FRA,MF,Dijon,Ligue 1,26,1991,20.0,52,28,15,31,6,21,58,36.2,37,28,5,23,40,92,32,0,0,2018-2019,90.0,180.0,234.0
1527,Adrián Marín,ESP,"DF,MF",Alavés,La Liga,21,1997,3.2,13,8,8,5,0,4,7,57.1,3,1,0,1,7,20,13,0,0,2018-2019,90.0,196.875,365.625
1528,João Mário,POR,"MF,FW",Inter,Serie A,25,1993,12.0,28,16,9,15,4,9,31,29.0,22,14,0,14,6,34,4,1,0,2018-2019,90.0,45.0,210.0
1529,Guillermo Maripán,CHI,DF,Alavés,La Liga,24,1994,22.3,46,26,34,12,0,26,38,68.4,12,35,19,16,40,86,133,2,0,2018-2019,90.0,161.43497757847533,185.65022421524662
1530,Lazar Marković,SRB,MF,Fulham,Premier League,24,1994,0.5,0,0,0,0,0,0,0,0.0,0,0,0,0,0,0,2,0,0,2018-2019,90.0,0.0,0.0
1531,Marlon,BRA,DF,Sassuolo,Serie A,22,1995,16.8,29,18,25,3,1,15,21,71.4,6,22,12,10,24,53,39,0,0,2018-2019,90.0,128.57142857142856,155.35714285714286
1532,Marquinhos,BRA,"DF,MF",Paris S-G,Ligue 1,24,1994,29.9,65,41,34,28,3,31,52,59.6,21,30,13,17,44,109,84,1,0,2018-2019,90.0,132.44147157190636,195.6521739130435
1533,Roger Martí,ESP,FW,Levante,La Liga,27,1991,21.0,8,6,1,4,3,1,19,5.3,18,14,1,13,4,12,9,0,0,2018-2019,90.0,17.142857142857142,34.285714285714285
1534,Anthony Martial,FRA,FW,Manchester Utd,Premier League,22,1995,18.0,9,7,2,5,2,1,11,9.1,10,12,0,12,3,12,8,0,0,2018-2019,90.0,15.0,45.0
1535,Aarón Martín,ESP,DF,Mainz 05,Bundesliga,21,1997,32.0,55,30,29,21,5,20,38,52.6,18,38,11,27,38,93,75,1,0,2018-2019,90.0,106.875,154.6875
1536,Jonas Martin,FRA,MF,Strasbourg,Ligue 1,28,1990,22.9,46,28,23,18,5,17,33,51.5,16,30,12,18,30,76,42,0,0,2018-2019,90.0,117.90393013100437,180.78602620087338
1537,Marvin Martin,FRA,MF,Reims,Ligue 1,30,1988,6.9,2,1,0,2,0,0,6,0.0,6,2,1,1,2,4,1,0,0,2018-2019,90.0,26.08695652173913,26.08695652173913
1538,Iñigo Martínez,ESP,DF,Athletic Club,La Liga,27,1991,32.2,53,26,36,16,1,23,37,62.2,14,24,14,10,69,122,144,0,0,2018-2019,90.0,192.85714285714283,148.1366459627329
1539,Javi Martínez,ESP,MF,Bayern Munich,Bundesliga,29,1988,14.5,26,15,7,17,2,5,16,31.3,11,17,5,12,31,57,13,0,0,2018-2019,90.0,192.41379310344826,161.3793103448276
1540,Lautaro Martínez,ARG,"FW,MF",Inter,Serie A,20,1997,14.9,6,5,0,2,4,2,6,33.3,4,16,0,16,3,9,7,0,0,2018-2019,90.0,18.120805369127517,36.241610738255034
1541,Pablo Martinez,FRA,DF,Strasbourg,Ligue 1,29,1989,31.3,51,34,34,17,0,30,49,61.2,19,37,23,14,52,103,132,1,0,2018-2019,90.0,149.52076677316293,146.64536741214056
1542,Gelson Martins,POR,"FW,MF",Atlético Madrid,La Liga,23,1995,2.5,5,3,3,1,1,3,4,75.0,1,1,0,1,1,6,1,0,0,2018-2019,90.0,36.0,180.0
1543,Gelson Martins,POR,"FW,MF",Monaco,Ligue 1,23,1995,15.4,20,12,8,7,5,13,32,40.6,19,9,1,8,8,28,7,0,0,2018-2019,90.0,46.753246753246756,116.88311688311688
1544,Adam Marušić,MNE,DF,Lazio,Serie A,25,1992,23.5,32,15,14,14,4,16,25,64.0,9,25,4,21,24,56,36,0,0,2018-2019,90.0,91.91489361702128,122.5531914893617
1545,Omar Mascarell,EQG,MF,Schalke 04,Bundesliga,25,1993,11.0,20,10,9,9,2,10,24,41.7,14,21,7,14,23,43,8,0,0,2018-2019,90.0,188.1818181818182,163.63636363636365
1546,Andrea Masiello,ITA,DF,Atalanta,Serie A,32,1986,20.4,28,14,13,15,0,17,29,58.6,12,21,6,15,44,72,49,0,0,2018-2019,90.0,194.11764705882354,123.52941176470588
1547,Adam Masina,MAR,DF,Watford,Premier League,24,1994,11.2,30,17,16,13,1,13,25,52.0,12,19,4,15,17,47,40,0,0,2018-2019,90.0,136.60714285714286,241.07142857142858
1548,Jordi Masip,ESP,GK,Valladolid,La Liga,29,1989,35.0,1,1,1,0,0,0,0,0.0,0,1,0,1,1,2,3,3,0,2018-2019,90.0,2.571428571428571,2.571428571428571
1549,Han-Noah Massengo,FRA,MF,Monaco,Ligue 1,17,2001,0.7,2,2,2,0,0,2,5,40.0,3,0,0,0,2,4,1,0,0,2018-2019,90.0,257.14285714285717,257.14285714285717
1550,Arthur Masuaku,COD,DF,West Ham,Premier League,24,1993,19.5,57,25,38,13,6,31,56,55.4,25,27,6,21,36,93,72,0,0,2018-2019,90.0,166.15384615384616,263.0769230769231
Rk,Player,Nation,Pos,Squad,Comp,0,0,90.0,0,0,3,3,3,Tkl,0,0.0,0,0,0,0,0,0,0,0,0,2018-2019,90.0,0.0,0.0
1551,Jaime Mata,ESP,"FW,MF",Getafe,La Liga,29,1988,27.0,30,21,8,14,8,7,26,26.9,19,14,0,14,17,47,27,0,0,2018-2019,90.0,56.66666666666667,100.0
1552,Juan Mata,ESP,"FW,MF",Manchester Utd,Premier League,30,1988,14.3,9,4,7,1,1,6,21,28.6,15,8,1,7,6,15,6,0,0,2018-2019,90.0,37.76223776223776,56.64335664335665
1553,Luca Matarese,ITA,FW,Frosinone,Serie A,20,1998,0.2,0,0,0,0,0,0,0,0.0,0,0,0,0,0,0,0,0,0,2018-2019,90.0,0.0,0.0
1554,Jean-Philippe Mateta,FRA,FW,Mainz 05,Bundesliga,21,1997,27.6,13,9,4,4,5,1,10,10.0,9,15,2,13,3,16,22,0,0,2018-2019,90.0,9.782608695652172,42.391304347826086
1555,Christian Mathenia,GER,GK,Nürnberg,Bundesliga,26,1992,21.5,0,0,0,0,0,0,0,0.0,0,1,0,1,1,1,18,2,0,2018-2019,90.0,4.186046511627906,0.0
1556,Nemanja Matić,SRB,MF,Manchester Utd,Premier League,29,1988,27.1,50,30,27,19,4,30,59,50.8,29,39,18,21,31,81,53,4,0,2018-2019,90.0,102.9520295202952,166.05166051660518
1557,Joël Matip,CMR,DF,Liverpool,Premier League,26,1991,17.1,39,26,23,12,4,13,24,54.2,11,12,7,5,32,71,78,0,0,2018-2019,90.0,168.42105263157896,205.26315789473685
1558,Rabbi Matondo,WAL,"FW,MF",Schalke 04,Bundesliga,17,2000,2.1,4,1,4,0,0,1,5,20.0,4,2,0,2,0,4,1,0,0,2018-2019,90.0,0.0,171.42857142857142
1559,Alessandro Matri,ITA,FW,Sassuolo,Serie A,33,1984,6.7,2,1,0,0,2,0,3,0.0,3,4,2,2,4,6,7,0,0,2018-2019,90.0,53.731343283582085,26.865671641791042
1560,Federico Mattiello,ITA,"DF,FW",Bologna,Serie A,23,1995,14.8,33,20,19,9,5,15,23,65.2,8,9,3,6,20,53,43,0,0,2018-2019,90.0,121.62162162162161,200.67567567567568
1561,Blaise Matuidi,FRA,MF,Juventus,Serie A,31,1987,26.9,59,33,25,21,13,20,36,55.6,16,33,8,25,26,85,21,1,0,2018-2019,90.0,86.98884758364312,197.39776951672863
1562,José Mauri,ITA,MF,Milan,Serie A,22,1996,2.3,8,4,2,6,0,2,6,33.3,4,0,0,0,5,13,0,0,0,2018-2019,90.0,195.6521739130435,313.04347826086956
1563,Stephy Mavididi,ENG,FW,Juventus,Serie A,20,1998,0.2,0,0,0,0,0,0,0,0.0,0,1,0,1,0,0,0,0,0,2018-2019,90.0,0.0,0.0
1564,Konstantinos Mavropanos,GRE,DF,Arsenal,Premier League,20,1997,1.6,1,0,0,1,0,1,1,100.0,0,1,1,0,7,8,5,0,0,2018-2019,90.0,393.75,56.25
1565,Alfie Mawson,ENG,DF,Fulham,Premier League,24,1994,12.6,11,7,7,4,0,6,10,60.0,4,20,17,3,19,30,64,1,0,2018-2019,90.0,135.71428571428572,78.57142857142858
1566,Philipp Max,GER,"DF,MF",Augsburg,Bundesliga,24,1993,28.5,35,24,17,15,3,21,39,53.8,18,16,3,13,22,57,46,1,0,2018-2019,90.0,69.47368421052632,110.52631578947368
1567,Alexandru Maxim,ROU,"MF,FW",Mainz 05,Bundesliga,28,1990,6.4,16,10,6,9,1,10,19,52.6,9,12,0,12,5,21,7,0,0,2018-2019,90.0,70.3125,225.0
1568,Eric Maxim Choupo-Moting,CMR,FW,Paris S-G,Ligue 1,29,1989,8.9,9,4,3,2,4,2,9,22.2,7,7,0,7,3,12,4,0,0,2018-2019,90.0,30.337078651685395,91.01123595505618
1569,Borja Mayoral,ESP,FW,Levante,La Liga,21,1997,18.0,9,4,1,6,2,5,16,31.3,11,10,1,9,5,14,5,0,0,2018-2019,90.0,25.0,45.0
1570,Róbert Mazáň,SVK,DF,Celta Vigo,La Liga,24,1994,1.0,3,3,3,0,0,2,2,100.0,0,2,0,2,3,6,0,0,0,2018-2019,90.0,270.0,270.0
1571,Luca Mazzitelli,ITA,MF,Genoa,Serie A,22,1995,3.6,5,2,3,1,1,2,3,66.7,1,4,1,3,6,11,7,0,0,2018-2019,90.0,150.0,125.0
1572,Kylian Mbappé,FRA,FW,Paris S-G,Ligue 1,19,1998,26.0,8,4,2,1,5,1,6,16.7,5,2,0,2,5,13,2,0,0,2018-2019,90.00000000000001,17.30769230769231,27.692307692307693
1573,Ibrahima Mbaye,SEN,DF,Bologna,Serie A,23,1994,22.3,48,32,30,16,2,19,32,59.4,13,21,12,9,19,67,66,1,0,2018-2019,90.0,76.68161434977578,193.72197309417038
1574,Loïc Mbe Soh,FRA,DF,Paris S-G,Ligue 1,17,2001,2.0,0,0,0,0,0,0,3,0.0,3,2,2,0,3,3,5,0,0,2018-2019,90.0,135.0,0.0
1575,Nolan Mbemba,CGO,"MF,DF",Reims,Ligue 1,23,1995,4.0,14,8,10,4,0,6,9,66.7,3,4,1,3,10,24,4,2,0,2018-2019,90.0,225.0,315.0
Rk,Player,Nation,Pos,Squad,Comp,0,0,90.0,0,0,3,3,3,Tkl,0,0.0,0,0,0,0,0,0,0,0,0,2018-2019,90.0,0.0,0.0
1576,Adama Mbengue,SEN,DF,Caen,Ligue 1,24,1993,8.2,48,32,34,12,2,19,26,73.1,7,15,4,11,7,55,22,0,0,2018-2019,90.0,76.82926829268294,526.829268292683
1577,Isaac Mbenza,BEL,"FW,MF",Huddersfield,Premier League,22,1996,11.0,10,9,5,5,0,2,4,50.0,2,4,0,4,5,15,4,0,0,2018-2019,90.0,40.909090909090914,81.81818181818183
1578,Stéphane Mbia,CMR,"DF,MF",Toulouse,Ligue 1,32,1986,5.0,1,0,1,0,0,1,2,50.0,1,9,4,5,7,8,25,1,0,2018-2019,90.0,126.0,18.0
1579,Kara Mbodji,SEN,DF,Nantes,Ligue 1,28,1989,5.6,12,10,10,1,1,6,8,75.0,2,4,1,3,6,18,25,0,0,2018-2019,90.0,96.42857142857143,192.85714285714286
1580,Jordi Mboula,ESP,"FW,MF",Monaco,Ligue 1,19,1999,3.1,3,0,0,1,2,3,6,50.0,3,1,0,1,1,4,5,0,0,2018-2019,90.0,29.032258064516128,87.09677419354838
1581,James McArthur,SCO,MF,Crystal Palace,Premier League,30,1987,34.0,84,51,38,32,14,30,78,38.5,48,64,22,42,39,123,55,0,0,2018-2019,90.0,103.23529411764706,222.35294117647058
1582,Alex McCarthy,ENG,GK,Southampton,Premier League,28,1989,25.0,0,0,0,0,0,0,0,0.0,0,0,0,0,0,0,6,2,0,2018-2019,90.0,0.0,0.0
1583,James McCarthy,IRL,MF,Everton,Premier League,27,1990,0.2,2,1,1,1,0,0,0,0.0,0,0,0,0,1,3,0,0,0,2018-2019,90.0,450.0,900.0
1584,Kevin McDonald,SCO,MF,Fulham,Premier League,29,1988,9.3,15,11,6,8,1,5,13,38.5,8,8,2,6,9,24,22,0,0,2018-2019,90.0,87.09677419354837,145.16129032258064
1585,Levan Mchedlidze,GEO,FW,Empoli,Serie A,28,1990,2.3,1,1,0,0,1,0,1,0.0,1,2,0,2,0,1,5,0,0,2018-2019,90.0,0.0,39.130434782608695
1586,Weston McKennie,USA,"MF,FW",Schalke 04,Bundesliga,19,1998,19.4,28,14,5,17,6,11,35,31.4,24,28,9,19,36,64,46,1,0,2018-2019,90.0,167.01030927835055,129.89690721649487
1587,Dwight McNeil,ENG,MF,Burnley,Premier League,18,1999,17.7,36,22,16,17,3,13,44,29.5,31,30,3,27,13,49,35,0,0,2018-2019,90.0,66.10169491525424,183.05084745762713
1588,Scott McTominay,SCO,"MF,DF",Manchester Utd,Premier League,21,1996,9.6,10,9,3,6,1,4,10,40.0,6,9,4,5,15,25,16,0,0,2018-2019,90.0,140.625,93.75
1589,Iuri Medeiros,POR,"MF,FW",Genoa,Serie A,24,1994,1.2,2,2,0,1,1,1,2,50.0,1,2,0,2,0,2,1,0,0,2018-2019,90.0,0.0,150.0
1590,Nicky Medja,SUI,"FW,MF",Fiorentina,Serie A,18,2000,0.5,1,0,0,0,1,1,2,50.0,1,0,0,0,0,1,0,0,0,2018-2019,90.0,0.0,180.0
1591,Álvaro Medrán,ESP,MF,Rayo Vallecano,La Liga,24,1994,12.8,15,8,5,6,4,6,21,28.6,15,10,1,9,17,32,9,0,0,2018-2019,90.0,119.53125,105.46875
1592,Ben Mee,ENG,DF,Burnley,Premier League,28,1989,38.0,55,24,38,17,0,35,44,79.5,9,59,50,9,48,103,235,4,0,2018-2019,90.0,113.6842105263158,130.26315789473685
1593,Riccardo Meggiorini,ITA,FW,Chievo,Serie A,32,1985,17.2,17,13,5,9,3,1,10,10.0,9,20,2,18,8,25,26,0,0,2018-2019,90.0,41.86046511627907,88.95348837209303
1594,Admir Mehmedi,SUI,"FW,MF",Wolfsburg,Bundesliga,27,1991,18.8,46,28,19,19,8,18,44,40.9,26,25,0,25,12,58,9,0,0,2018-2019,90.0,57.44680851063829,220.2127659574468
1595,Soualiho Meïté,FRA,MF,Torino,Serie A,24,1994,29.5,46,21,13,22,11,23,46,50.0,23,46,6,40,29,75,26,0,0,2018-2019,90.0,88.47457627118644,140.33898305084745
1596,Farid El Melali,ALG,"MF,FW",Angers,Ligue 1,21,1997,3.6,8,4,3,4,1,3,12,25.0,9,2,0,2,5,13,1,0,0,2018-2019,90.0,125.0,200.0
1597,Óscar Melendo,ESP,"MF,FW",Espanyol,La Liga,20,1997,22.2,17,8,7,6,4,10,26,38.5,16,17,1,16,13,30,9,0,0,2018-2019,90.0,52.70270270270271,68.91891891891892
1598,Gonzalo Melero,ESP,MF,Huesca,La Liga,24,1994,14.9,26,23,5,19,2,11,48,22.9,37,14,4,10,2,28,23,0,0,2018-2019,90.0,12.080536912751677,157.0469798657718
1599,Arthur Melo,BRA,MF,Barcelona,La Liga,21,1996,15.9,15,10,5,6,4,6,13,46.2,7,8,0,8,9,24,9,1,0,2018-2019,90.0,50.943396226415096,84.90566037735849
1600,Memphis,NED,"FW,MF",Lyon,Ligue 1,24,1994,30.4,12,9,0,7,5,5,21,23.8,16,16,2,14,9,21,1,0,0,2018-2019,90.0,26.644736842105264,35.526315789473685
Rk,Player,Nation,Pos,Squad,Comp,0,0,90.0,0,0,3,3,3,Tkl,0,0.0,0,0,0,0,0,0,0,0,0,2018-2019,90.0,0.0,0.0
1601,Pedro Mendes,POR,DF,Montpellier,Ligue 1,27,1990,29.6,71,42,56,13,2,31,47,66.0,16,42,22,20,48,119,73,1,0,2018-2019,90.0,145.94594594594594,215.8783783783784
1602,Thiago Mendes,BRA,MF,Lille,Ligue 1,26,1992,34.2,85,47,42,41,2,39,71,54.9,32,44,11,33,68,153,49,0,0,2018-2019,90.0,178.94736842105263,223.68421052631578
1603,Brais Méndez,ESP,"MF,FW",Celta Vigo,La Liga,21,1997,26.1,61,31,23,29,9,14,53,26.4,39,32,3,29,24,85,24,0,0,2018-2019,90.0,82.75862068965516,210.34482758620686
1604,Nathaniel Mendez-Laing,GUA,"MF,FW",Cardiff City,Premier League,26,1992,10.9,34,25,18,12,4,12,26,46.2,14,17,1,16,13,47,20,0,0,2018-2019,90.0,107.3394495412844,280.73394495412845
1605,Stiven Mendoza,COL,"FW,MF",Amiens,Ligue 1,26,1992,20.9,29,18,10,12,7,14,38,36.8,24,18,0,18,17,46,12,0,0,2018-2019,90.0,73.20574162679426,124.88038277511961
1606,Alexandre Mendy,GNB,FW,Guingamp,Ligue 1,24,1994,8.5,5,3,0,4,1,3,8,37.5,5,3,0,3,1,6,6,0,0,2018-2019,90.0,10.588235294117647,52.94117647058824
1607,Benjamin Mendy,FRA,DF,Manchester City,Premier League,24,1994,10.0,16,10,10,5,1,9,17,52.9,8,13,4,9,10,26,18,0,0,2018-2019,90.0,90.0,144.0
1608,Edouard Mendy,SEN,GK,Reims,Ligue 1,26,1992,38.0,0,0,0,0,0,0,1,0.0,1,1,0,1,2,2,16,3,0,2018-2019,90.0,4.7368421052631575,0.0
1609,Ferland Mendy,FRA,DF,Lyon,Ligue 1,23,1995,28.1,44,28,25,14,5,14,17,82.4,3,22,5,17,34,78,53,2,0,2018-2019,90.0,108.8967971530249,140.92526690391458
1610,Nampalys Mendy,SEN,MF,Leicester City,Premier League,26,1992,23.2,33,18,16,16,1,6,22,27.3,16,24,8,16,26,59,26,2,0,2018-2019,90.0,100.86206896551724,128.01724137931035
1611,Hamza Mendyl,MAR,DF,Schalke 04,Bundesliga,20,1997,6.0,17,15,6,8,3,8,18,44.4,10,11,2,9,8,25,8,0,0,2018-2019,90.0,120.0,255.0
1612,Chris Mepham,WAL,DF,Bournemouth,Premier League,20,1997,9.4,9,3,9,0,0,7,11,63.6,4,12,5,7,14,23,57,2,0,2018-2019,90.0,134.04255319148936,86.17021276595744
1613,Gabriel Mercado,ARG,DF,Sevilla,La Liga,31,1987,19.3,35,23,21,12,2,18,36,50.0,18,24,12,12,26,61,75,1,0,2018-2019,90.0,121.24352331606217,163.21243523316062
1614,Alex Meret,ITA,GK,Napoli,Serie A,21,1997,12.8,0,0,0,0,0,0,0,0.0,0,0,0,0,0,0,3,1,0,2018-2019,90.0,0.0,0.0
1615,Mehdi Merghem,FRA,"FW,MF",Guingamp,Ligue 1,21,1997,8.0,25,18,15,7,3,11,21,52.4,10,14,1,13,9,34,6,0,0,2018-2019,90.0,101.25,281.25
1616,Mikel Merino,ESP,MF,Real Sociedad,La Liga,22,1996,22.8,50,28,19,25,6,14,52,26.9,38,37,2,35,29,79,37,1,0,2018-2019,90.0,114.4736842105263,197.36842105263156
1617,Sabin Merino,ESP,"FW,MF",Leganés,La Liga,26,1992,3.3,1,1,0,0,1,1,1,100.0,0,1,0,1,0,1,4,0,0,2018-2019,90.0,0.0,27.272727272727273
1618,Martín Merquelanz,ESP,MF,Real Sociedad,La Liga,23,1995,0.1,0,0,0,0,0,0,0,0.0,0,0,0,0,0,0,0,0,0,2018-2019,90.0,0.0,0.0
1619,Dries Mertens,BEL,FW,Napoli,Serie A,31,1987,25.0,19,11,2,7,10,1,21,4.8,20,7,0,7,13,32,3,0,0,2018-2019,90.0,46.8,68.39999999999999
1620,Roque Mesa,ESP,MF,Sevilla,La Liga,29,1989,19.4,46,27,16,22,8,15,38,39.5,23,16,0,16,14,60,12,4,0,2018-2019,90.0,64.94845360824743,213.40206185567013
1621,Lionel Messi,ARG,FW,Barcelona,La Liga,31,1987,30.1,12,7,5,3,4,1,17,5.9,16,10,0,10,3,15,1,0,0,2018-2019,90.00000000000001,8.970099667774086,35.880398671096344
1622,Romain Métanire,MAD,DF,Reims,Ligue 1,28,1990,3.5,12,9,10,1,1,5,7,71.4,2,4,3,1,6,18,13,0,0,2018-2019,90.0,154.28571428571428,308.57142857142856
1623,Thomas Meunier,BEL,DF,Paris S-G,Ligue 1,26,1991,17.9,44,33,25,15,4,21,35,60.0,14,13,2,11,19,63,29,0,0,2018-2019,90.0,95.53072625698326,221.22905027932964
1624,Mexer,MOZ,DF,Rennes,Ligue 1,29,1988,27.4,23,12,18,5,0,12,18,66.7,6,26,18,8,30,53,125,0,0,2018-2019,90.0,98.54014598540147,75.54744525547446
1625,Max Meyer,GER,MF,Crystal Palace,Premier League,22,1995,15.7,33,18,14,18,1,11,20,55.0,9,6,0,6,15,48,19,0,0,2018-2019,90.0,85.98726114649682,189.171974522293
Rk,Player,Nation,Pos,Squad,Comp,0,0,90.0,0,0,3,3,3,Tkl,0,0.0,0,0,0,0,0,0,0,0,0,2018-2019,90.0,0.0,0.0
1626,Matt Miazga,USA,DF,Nantes,Ligue 1,23,1995,8.0,12,11,11,1,0,7,9,77.8,2,11,7,4,12,24,41,1,0,2018-2019,90.0,135.0,135.0
1627,Míchel,ESP,MF,Valladolid,La Liga,30,1988,28.4,60,38,25,31,4,18,73,24.7,55,40,4,36,43,103,30,1,0,2018-2019,90.0,136.26760563380282,190.14084507042256
1628,Clément Michelin,FRA,DF,Toulouse,Ligue 1,21,1997,1.0,3,2,2,1,0,2,3,66.7,1,0,0,0,3,6,7,0,0,2018-2019,90.0,270.0,270.0
1629,Petar Mićin,SRB,MF,Udinese,Serie A,19,1998,0.0,0,0,0,0,0,0,0,0.0,0,0,0,0,0,0,0,0,0,2018-2019,,,
1630,Miguel,ESP,FW,Valladolid,La Liga,18,1999,0.1,0,0,0,0,0,0,1,0.0,1,0,0,0,1,1,0,0,0,2018-2019,90.0,900.0,0.0
1631,Florian Miguel,FRA,DF,Nîmes,Ligue 1,21,1996,12.4,19,16,13,6,0,7,11,63.6,4,15,7,8,21,40,47,0,0,2018-2019,90.0,152.41935483870967,137.90322580645162
1632,Nikola Milenković,SRB,DF,Fiorentina,Serie A,20,1997,33.4,59,40,36,21,2,17,33,51.5,16,39,21,18,48,107,143,0,0,2018-2019,90.0,129.34131736526945,158.98203592814372
1633,Arkadiusz Milik,POL,FW,Napoli,Serie A,24,1994,26.6,19,9,1,8,10,1,20,5.0,19,7,2,5,3,22,15,0,0,2018-2019,90.0,10.150375939849624,64.28571428571428
1634,Sergej Milinković-Savić,SRB,MF,Lazio,Serie A,23,1995,26.6,44,28,17,21,6,23,60,38.3,37,28,4,24,27,71,48,0,0,2018-2019,90.0,91.35338345864662,148.8721804511278
1635,Vanja Milinković-Savić,SRB,GK,SPAL,Serie A,21,1997,1.8,0,0,0,0,0,0,0,0.0,0,0,0,0,0,0,1,0,0,2018-2019,90.0,0.0,0.0
1636,Luka Milivojević,SRB,MF,Crystal Palace,Premier League,27,1991,38.0,90,69,36,47,7,39,91,42.9,52,47,15,32,72,162,68,3,0,2018-2019,90.0,170.52631578947367,213.1578947368421
1637,Pere Milla,ESP,"MF,FW",Eibar,La Liga,25,1992,3.8,7,6,1,5,1,0,5,0.0,5,4,1,3,2,9,1,0,0,2018-2019,90.0,47.368421052631575,165.78947368421052
1638,Vincenzo Millico,ITA,MF,Torino,Serie A,17,2000,0.0,0,0,0,0,0,0,0,0.0,0,0,0,0,0,0,0,0,0,2018-2019,,,
1639,James Milner,ENG,"MF,DF",Liverpool,Premier League,32,1986,19.9,43,23,14,24,5,15,41,36.6,26,40,5,35,18,61,30,0,0,2018-2019,90.0,81.4070351758794,194.47236180904525
1640,Santi Mina,ESP,FW,Valencia,La Liga,22,1995,20.6,17,10,1,15,1,3,25,12.0,22,19,2,17,4,21,20,0,0,2018-2019,90.0,17.475728155339805,74.27184466019418
1641,Yerry Mina,COL,DF,Everton,Premier League,23,1994,9.9,14,7,8,6,0,6,9,66.7,3,11,5,6,8,22,54,3,0,2018-2019,90.0,72.72727272727273,127.27272727272727
1642,Tyrone Mings,ENG,DF,Bournemouth,Premier League,25,1993,1.6,4,3,3,1,0,2,3,66.7,1,5,2,3,6,10,8,0,0,2018-2019,90.0,337.5,225.0
1643,Ignasi Miquel,ESP,DF,Getafe,La Liga,25,1992,3.5,1,0,0,1,0,1,2,50.0,1,4,4,0,5,6,25,0,0,2018-2019,90.0,128.57142857142856,25.714285714285715
1644,Kevin Mirallas,BEL,"FW,MF",Fiorentina,Serie A,30,1987,14.4,17,7,8,4,5,6,15,40.0,9,17,0,17,4,21,10,0,0,2018-2019,90.0,25.0,106.25
1645,Jorge Miramón,ESP,DF,Huesca,La Liga,29,1989,27.7,73,55,49,17,7,34,53,64.2,19,34,11,23,44,117,65,1,0,2018-2019,90.0,142.96028880866427,237.18411552346572
1646,Miranda,BRA,DF,Inter,Serie A,33,1984,12.9,11,7,7,4,0,4,8,50.0,4,11,7,4,14,25,48,2,0,2018-2019,90.0,97.67441860465115,76.74418604651163
1647,Antonio Mirante,ITA,GK,Roma,Serie A,35,1983,11.0,0,0,0,0,0,0,0,0.0,0,0,0,0,0,0,6,1,0,2018-2019,90.0,0.0,0.0
1648,Virgil Misidjan,SUR,"MF,FW",Nürnberg,Bundesliga,25,1993,17.1,21,13,10,5,6,4,25,16.0,21,17,0,17,9,30,5,0,0,2018-2019,90.0,47.368421052631575,110.52631578947368
1649,Simone Missiroli,ITA,MF,SPAL,Serie A,32,1986,30.5,58,43,31,22,5,25,49,51.0,24,44,11,33,46,104,46,0,0,2018-2019,90.0,135.7377049180328,171.14754098360655
1650,Kostas Mitroglou,GRE,FW,Marseille,Ligue 1,30,1988,6.4,0,0,0,0,0,0,3,0.0,3,0,0,0,0,0,5,0,0,2018-2019,90.0,0.0,0.0
Rk,Player,Nation,Pos,Squad,Comp,0,0,90.0,0,0,3,3,3,Tkl,0,0.0,0,0,0,0,0,0,0,0,0,2018-2019,90.0,0.0,0.0
1651,Aleksandar Mitrović,SRB,FW,Fulham,Premier League,23,1994,36.4,19,9,3,13,3,5,15,33.3,10,22,8,14,6,25,53,0,0,2018-2019,90.0,14.835164835164836,46.97802197802198
1652,Stefan Mitrović,SRB,DF,Strasbourg,Ligue 1,28,1990,33.6,23,16,20,3,0,12,24,50.0,12,41,31,10,46,69,146,2,0,2018-2019,90.0,123.21428571428571,61.607142857142854
1653,Maximilian Mittelstädt,GER,"DF,MF",Hertha BSC,Bundesliga,21,1997,20.0,61,37,33,23,5,23,49,46.9,26,32,4,28,46,107,64,0,0,2018-2019,90.0,207.0,274.5
1654,Henrikh Mkhitaryan,ARM,"FW,MF",Arsenal,Premier League,29,1989,18.2,28,22,8,17,3,6,22,27.3,16,34,2,32,16,44,13,0,0,2018-2019,90.0,79.12087912087912,138.46153846153845
1655,Luka Modrić,CRO,MF,Real Madrid,La Liga,32,1985,29.0,49,30,11,25,13,14,48,29.2,34,20,3,17,31,80,7,1,0,2018-2019,90.0,96.20689655172413,152.06896551724137
1656,Kevin Möhwald,GER,MF,Werder Bremen,Bundesliga,25,1993,9.7,16,10,3,11,2,3,20,15.0,17,14,0,14,17,33,14,0,0,2018-2019,90.0,157.73195876288662,148.4536082474227
1657,Niklas Moisander,FIN,DF,Werder Bremen,Bundesliga,32,1985,29.3,34,23,26,8,0,22,51,43.1,29,42,19,23,39,73,140,2,0,2018-2019,90.0,119.79522184300342,104.43686006825939
1658,Johan Mojica,COL,"FW,MF",Girona,La Liga,25,1992,0.2,1,1,1,0,0,0,0,0.0,0,0,0,0,0,1,0,0,0,2018-2019,90.0,0.0,450.0
1659,Hakim El Mokeddem,,"FW,MF",Toulouse,Ligue 1,19,1999,0.3,1,1,1,0,0,0,1,0.0,1,0,0,0,0,1,1,0,0,2018-2019,90.0,0.0,300.0
1660,Jorge Molina,ESP,FW,Getafe,La Liga,36,1982,29.4,12,9,1,4,7,2,15,13.3,13,22,0,22,7,19,26,1,0,2018-2019,90.0,21.42857142857143,36.734693877551024
1661,Cristian Molinaro,ITA,"DF,MF",Frosinone,Serie A,35,1983,12.9,15,10,7,7,1,3,9,33.3,6,11,4,7,15,30,43,0,0,2018-2019,90.0,104.65116279069767,104.65116279069767
1662,Victor Mollejo,ESP,"FW,DF",Atlético Madrid,La Liga,17,2001,0.7,0,0,0,0,0,0,2,0.0,2,0,0,0,0,0,0,0,0,2018-2019,90.0,0.0,0.0
1663,Florent Mollet,FRA,MF,Montpellier,Ligue 1,26,1991,28.5,36,20,8,20,8,13,51,25.5,38,32,1,31,23,59,7,0,0,2018-2019,90.0,72.63157894736842,113.6842105263158
1664,Gabriele Moncini,ITA,MF,SPAL,Serie A,22,1996,0.1,1,1,1,0,0,0,0,0.0,0,0,0,0,0,1,0,0,0,2018-2019,90.0,0.0,900.0
1665,Thomas Monconduit,FRA,MF,Amiens,Ligue 1,27,1991,31.3,76,47,38,33,5,26,63,41.3,37,46,17,29,36,112,77,1,0,2018-2019,90.0,103.51437699680511,218.53035143769966
1666,Kévin Monnet-Paquet,FRA,"DF,MF",Saint-Étienne,Ligue 1,29,1988,16.5,46,25,23,16,7,20,36,55.6,16,22,4,18,14,60,28,0,0,2018-2019,90.0,76.36363636363637,250.90909090909093
1667,Nacho Monreal,ESP,DF,Arsenal,Premier League,32,1986,20.7,35,17,21,9,5,15,25,60.0,10,28,10,18,31,66,62,0,0,2018-2019,90.0,134.7826086956522,152.17391304347828
1668,Francisco Montero,ESP,DF,Atlético Madrid,La Liga,19,1999,4.5,8,4,5,3,0,5,6,83.3,1,10,4,6,5,13,18,1,0,2018-2019,90.0,100.0,160.0
1669,Cristóbal Montiel,ESP,FW,Fiorentina,Serie A,18,2000,0.1,0,0,0,0,0,0,0,0.0,0,0,0,0,0,0,0,0,0,2018-2019,90.0,0.0,0.0
1670,Martín Montoya,ESP,DF,Brighton,Premier League,27,1991,24.1,58,35,29,21,8,32,55,58.2,23,30,10,20,48,106,76,1,0,2018-2019,90.0,179.253112033195,216.59751037344398
1671,Aaron Mooy,AUS,"MF,FW",Huddersfield,Premier League,27,1990,25.9,62,42,19,27,16,21,52,40.4,31,43,7,36,14,76,22,0,0,2018-2019,90.0,48.64864864864865,215.44401544401546
1672,Emre Mor,TUR,"FW,MF",Celta Vigo,La Liga,21,1997,4.1,7,4,1,3,3,2,7,28.6,5,5,0,5,3,10,1,0,0,2018-2019,90.0,65.85365853658537,153.65853658536588
1673,Alfredo Morales,USA,MF,Düsseldorf,Bundesliga,28,1990,17.0,32,18,16,15,1,6,24,25.0,18,18,9,9,24,56,31,0,0,2018-2019,90.0,127.05882352941177,169.41176470588235
1674,Álvaro Morata,ESP,FW,Chelsea,Premier League,25,1992,10.5,8,5,0,5,3,1,7,14.3,6,6,1,5,0,8,6,0,0,2018-2019,90.0,0.0,68.57142857142857
1675,Álvaro Morata,ESP,FW,Atlético Madrid,La Liga,25,1992,12.0,20,14,2,7,11,3,10,30.0,7,7,0,7,5,25,13,0,0,2018-2019,90.0,37.5,150.0
Rk,Player,Nation,Pos,Squad,Comp,0,0,90.0,0,0,3,3,3,Tkl,0,0.0,0,0,0,0,0,0,0,0,0,2018-2019,90.0,0.0,0.0
1676,Jan Morávek,CZE,MF,Augsburg,Bundesliga,28,1989,8.4,38,21,17,16,5,19,42,45.2,23,21,1,20,9,47,13,0,0,2018-2019,90.0,96.42857142857143,407.1428571428571
1677,Steven Moreira,CPV,"DF,MF",Toulouse,Ligue 1,23,1994,9.6,19,8,13,5,1,10,17,58.8,7,14,0,14,10,29,19,1,0,2018-2019,90.0,93.75,178.125
1678,Jérémy Morel,MAD,DF,Lyon,Ligue 1,34,1984,11.8,16,10,11,5,0,9,13,69.2,4,18,14,4,18,34,45,1,0,2018-2019,90.0,137.28813559322032,122.03389830508473
1679,Alberto Moreno,ESP,DF,Liverpool,Premier League,26,1992,1.7,3,2,1,2,0,1,3,33.3,2,1,0,1,2,5,0,0,0,2018-2019,90.0,105.88235294117646,158.8235294117647
1680,Álex Moreno,ESP,DF,Rayo Vallecano,La Liga,25,1993,34.8,63,40,41,18,4,29,53,54.7,24,35,9,26,41,104,97,0,0,2018-2019,90.0,106.0344827586207,162.93103448275863
1681,Gerard Moreno,ESP,FW,Villarreal,La Liga,26,1992,25.7,22,12,2,15,5,8,27,29.6,19,23,9,14,9,31,39,0,0,2018-2019,90.0,31.517509727626457,77.04280155642023
1682,Héctor Moreno,MEX,DF,Real Sociedad,La Liga,30,1988,21.5,16,9,12,4,0,9,17,52.9,8,34,19,15,31,47,73,0,0,2018-2019,90.0,129.7674418604651,66.9767441860465
1683,Sergio Moreno,ESP,FW,Rayo Vallecano,La Liga,19,1999,0.2,0,0,0,0,0,0,0,0.0,0,0,0,0,0,0,0,0,0,2018-2019,90.0,0.0,0.0
1684,Emiliano Moretti,ITA,DF,Torino,Serie A,37,1981,22.3,30,21,21,9,0,13,20,65.0,7,14,6,8,24,54,65,1,0,2018-2019,90.0,96.86098654708519,121.0762331838565
1685,Wes Morgan,JAM,DF,Leicester City,Premier League,34,1984,21.4,27,15,14,12,1,6,7,85.7,1,24,10,14,32,59,109,1,0,2018-2019,90.0,134.57943925233647,113.5514018691589
1686,Manu Morlanes,ESP,MF,Villarreal,La Liga,19,1999,6.8,21,11,9,9,3,7,19,36.8,12,7,3,4,5,26,9,0,0,2018-2019,90.0,66.17647058823529,277.94117647058823
1687,Loren Morón,ESP,FW,Betis,La Liga,24,1993,21.7,18,12,4,11,3,6,27,22.2,21,24,1,23,6,24,18,0,0,2018-2019,90.0,24.88479262672811,74.65437788018433
1688,Sean Morrison,ENG,DF,Cardiff City,Premier League,27,1991,33.8,35,17,29,4,2,15,28,53.6,13,47,30,17,52,87,204,5,0,2018-2019,90.0,138.46153846153848,93.19526627218936
1689,Victor Moses,NGA,FW,Chelsea,Premier League,27,1990,0.3,0,0,0,0,0,0,0,0.0,0,1,0,1,0,0,0,0,0,2018-2019,90.0,0.0,0.0
1690,Lebo Mothiba,RSA,FW,Strasbourg,Ligue 1,22,1996,19.7,10,9,2,7,1,0,8,0.0,8,5,1,4,0,10,6,0,0,2018-2019,90.0,0.0,45.68527918781726
1691,Lebo Mothiba,RSA,FW,Lille,Ligue 1,22,1996,2.8,1,1,0,1,0,0,0,0.0,0,0,0,0,0,1,8,0,0,2018-2019,90.0,0.0,32.142857142857146
1692,François Moubandje,SUI,DF,Toulouse,Ligue 1,28,1990,21.5,38,22,22,10,6,17,22,77.3,5,18,4,14,27,65,74,0,0,2018-2019,90.0,113.02325581395348,159.06976744186045
1693,Jessy Moulin,FRA,GK,Saint-Étienne,Ligue 1,32,1986,1.0,1,0,1,0,0,1,1,100.0,0,0,0,0,0,1,2,0,0,2018-2019,90.0,0.0,90.0
1694,Steve Mounié,BEN,FW,Huddersfield,Premier League,23,1994,19.8,9,6,3,4,2,2,12,16.7,10,10,1,9,5,14,15,0,0,2018-2019,90.0,22.727272727272727,40.90909090909091
1695,Lucas Moura,BRA,"FW,MF",Tottenham,Premier League,25,1992,23.6,35,18,8,20,7,9,27,33.3,18,15,1,14,24,59,24,0,0,2018-2019,90.0,91.52542372881355,133.47457627118644
1696,Herman Moussaki,FRA,"MF,FW",Caen,Ligue 1,19,1999,2.3,3,3,2,1,0,1,4,25.0,3,2,1,1,0,3,3,0,0,2018-2019,90.0,0.0,117.3913043478261
1697,Lys Mousset,FRA,FW,Bournemouth,Premier League,22,1996,4.1,3,1,1,1,1,1,4,25.0,3,3,0,3,1,4,3,0,0,2018-2019,90.0,21.951219512195124,65.85365853658537
1698,João Moutinho,POR,MF,Wolves,Premier League,31,1986,33.7,113,58,50,56,7,44,126,34.9,82,56,11,45,40,153,50,0,0,2018-2019,90.0,106.82492581602374,301.78041543026706
1699,Samuel Moutoussamy,COD,"MF,FW",Nantes,Ligue 1,21,1996,18.3,35,20,16,11,8,12,34,35.3,22,17,2,15,9,44,17,0,0,2018-2019,90.0,44.26229508196721,172.1311475409836
1700,Toni Moya,ESP,DF,Atlético Madrid,La Liga,20,1998,1.0,2,2,2,0,0,0,1,0.0,1,0,0,0,0,2,3,0,0,2018-2019,90.0,0.0,180.0
Rk,Player,Nation,Pos,Squad,Comp,0,0,90.0,0,0,3,3,3,Tkl,0,0.0,0,0,0,0,0,0,0,0,0,2018-2019,90.0,0.0,0.0
1701,Javi Moyano,ESP,DF,Valladolid,La Liga,32,1986,23.3,25,17,17,6,2,15,30,50.0,15,20,9,11,25,50,88,2,0,2018-2019,90.0,96.56652360515021,96.56652360515021
1702,Samuel Mráz,SVK,FW,Empoli,Serie A,21,1997,1.9,0,0,0,0,0,0,0,0.0,0,2,0,2,0,0,2,0,0,2018-2019,90.0,0.0,0.0
1703,Ndombe Mubele,COD,FW,Toulouse,Ligue 1,24,1994,5.2,9,4,5,2,2,4,9,44.4,5,4,0,4,2,11,2,0,0,2018-2019,90.0,34.61538461538461,155.76923076923075
1704,Lukas Mühl,GER,DF,Nürnberg,Bundesliga,21,1997,31.0,57,34,49,6,2,32,51,62.7,19,53,18,35,48,105,139,2,0,2018-2019,90.0,139.3548387096774,165.48387096774195
1705,Nordi Mukiele,FRA,DF,RB Leipzig,Bundesliga,20,1997,13.6,38,21,23,12,3,19,22,86.4,3,17,3,14,24,62,35,0,0,2018-2019,90.0,158.8235294117647,251.47058823529412
1706,Florian Müller,GER,GK,Mainz 05,Bundesliga,20,1997,24.0,1,1,1,0,0,1,2,50.0,1,0,0,0,3,4,8,5,0,2018-2019,90.0,11.25,3.75
1707,Nicolai Müller,GER,"MF,FW",Hannover 96,Bundesliga,30,1987,10.0,18,9,7,7,4,8,27,29.6,19,9,1,8,1,19,7,0,0,2018-2019,90.0,9.0,162.0
1708,Nicolai Müller,GER,"FW,MF",Eint Frankfurt,Bundesliga,30,1987,2.4,4,2,3,1,0,1,2,50.0,1,4,1,3,0,4,0,0,0,2018-2019,90.0,0.0,150.0
1709,Thomas Müller,GER,"MF,FW",Bayern Munich,Bundesliga,28,1989,26.4,42,23,13,15,14,10,38,26.3,28,46,6,40,9,51,12,0,0,2018-2019,90.0,30.681818181818183,143.1818181818182
1710,Gianni Munari,ITA,MF,Parma,Serie A,35,1983,0.0,0,0,0,0,0,0,0,0.0,0,0,0,0,0,0,0,0,0,2018-2019,,,
1711,Iker Muniain,ESP,"MF,FW",Athletic Club,La Liga,25,1992,26.5,29,20,10,14,5,6,29,20.7,23,17,3,14,12,41,6,0,0,2018-2019,90.0,40.75471698113208,98.49056603773585
1712,Marc Muniesa,ESP,"DF,MF",Girona,La Liga,26,1992,15.6,49,34,27,17,5,15,28,53.6,13,18,6,12,37,86,49,1,0,2018-2019,90.0,213.46153846153845,282.6923076923077
1713,Aihen Muñoz,ESP,DF,Real Sociedad,La Liga,20,1997,10.6,13,8,11,2,0,10,19,52.6,9,19,9,10,7,20,26,0,0,2018-2019,90.0,59.43396226415095,110.37735849056604
1714,Ezequiel Muñoz,ARG,DF,Leganés,La Liga,27,1990,2.3,3,2,1,2,0,0,0,0.0,0,3,1,2,1,4,10,0,0,2018-2019,90.0,39.130434782608695,117.3913043478261
1715,Joaquín Muñoz,ESP,FW,Atlético Madrid,La Liga,19,1999,0.0,0,0,0,0,0,0,0,0.0,0,0,0,0,0,0,0,0,0,2018-2019,,,
1716,Alessandro Murgia,ITA,MF,SPAL,Serie A,21,1996,11.9,22,15,9,12,1,7,32,21.9,25,14,2,12,19,41,12,1,0,2018-2019,90.00000000000001,143.69747899159665,166.38655462184875
1717,Alessandro Murgia,ITA,MF,Lazio,Serie A,21,1996,0.1,0,0,0,0,0,0,0,0.0,0,0,0,0,0,0,0,0,0,2018-2019,90.0,0.0,0.0
1718,Luis Muriel,COL,FW,Fiorentina,Serie A,27,1991,16.0,19,11,4,13,2,6,18,33.3,12,10,0,10,3,22,1,0,0,2018-2019,90.0,16.875,106.875
1719,Luis Muriel,COL,"MF,FW",Sevilla,La Liga,27,1991,1.4,0,0,0,0,0,0,6,0.0,6,3,0,3,0,0,1,0,0,2018-2019,90.0,0.0,0.0
1720,Jeison Murillo,COL,DF,Valencia,La Liga,26,1992,1.0,2,1,1,1,0,1,2,50.0,1,1,0,1,2,4,6,0,0,2018-2019,90.0,180.0,180.0
1721,Jeison Murillo,COL,DF,Barcelona,La Liga,26,1992,1.3,2,2,1,1,0,0,3,0.0,3,0,0,0,0,2,5,1,0,2018-2019,90.0,0.0,138.46153846153845
1722,Jacob Murphy,ENG,"MF,DF",Newcastle Utd,Premier League,23,1995,3.4,6,2,4,2,0,2,4,50.0,2,5,2,3,1,7,7,0,0,2018-2019,90.0,26.470588235294116,158.8235294117647
1723,Josh Murphy,ENG,"MF,FW",Cardiff City,Premier League,23,1995,20.2,26,17,15,7,4,9,29,31.0,20,30,0,30,11,37,17,0,0,2018-2019,90.0,49.00990099009901,115.84158415841584
1724,Glenn Murray,ENG,FW,Brighton,Premier League,34,1983,27.9,17,7,4,7,6,4,20,20.0,16,20,3,17,2,19,17,1,0,2018-2019,90.0,6.451612903225807,54.83870967741935
1725,Nicola Murru,ITA,DF,Sampdoria,Serie A,23,1994,32.6,83,59,42,25,16,41,54,75.9,13,50,22,28,41,124,99,0,0,2018-2019,90.0,113.19018404907976,229.14110429447854
Rk,Player,Nation,Pos,Squad,Comp,0,0,90.0,0,0,3,3,3,Tkl,0,0.0,0,0,0,0,0,0,0,0,0,2018-2019,90.0,0.0,0.0
1726,Mateo Musacchio,ARG,DF,Milan,Serie A,27,1990,29.0,41,22,30,8,3,19,27,70.4,8,26,19,7,29,70,114,0,0,2018-2019,90.0,90.0,127.24137931034483
1727,Florent Muslija,KVX,"MF,FW",Hannover 96,Bundesliga,20,1998,7.5,16,10,8,6,2,8,12,66.7,4,4,0,4,3,19,4,0,0,2018-2019,90.0,36.0,192.0
1728,Juan Musso,ARG,GK,Udinese,Serie A,24,1994,29.0,0,0,0,0,0,0,1,0.0,1,0,0,0,0,0,10,4,0,2018-2019,90.0,0.0,0.0
1729,Shkodran Mustafi,GER,DF,Arsenal,Premier League,26,1992,29.0,62,45,42,17,3,31,40,77.5,9,34,17,17,58,120,168,1,0,2018-2019,90.0,180.0,192.41379310344826
1730,Damián Musto,ARG,"MF,DF",Huesca,La Liga,31,1987,18.7,52,34,22,27,3,16,33,48.5,17,30,11,19,34,86,54,1,0,2018-2019,90.0,163.63636363636363,250.26737967914437
1731,Yoshinori Mutō,JPN,"FW,MF",Newcastle Utd,Premier League,26,1992,5.8,8,4,3,5,0,2,7,28.6,5,9,0,9,5,13,3,1,0,2018-2019,90.0,77.58620689655173,124.13793103448276
1732,Yvon Mvogo,SUI,GK,RB Leipzig,Bundesliga,24,1994,1.5,0,0,0,0,0,0,0,0.0,0,0,0,0,0,0,1,0,0,2018-2019,90.0,0.0,0.0
1733,Phillipp Mwene,AUT,"DF,MF",Mainz 05,Bundesliga,24,1994,3.0,7,2,3,4,0,5,6,83.3,1,6,0,6,6,13,10,0,0,2018-2019,90.0,180.0,210.0
1734,Obite N'Dicka,CIV,DF,Eint Frankfurt,Bundesliga,18,1999,25.6,43,28,31,10,2,31,52,59.6,21,29,11,18,29,72,123,0,0,2018-2019,90.0,101.953125,151.171875
1735,Kévin N'Doram,FRA,"DF,MF",Monaco,Ligue 1,22,1996,2.2,5,4,1,4,0,3,5,60.0,2,1,1,0,5,10,8,1,0,2018-2019,90.0,204.54545454545453,204.54545454545453
1736,Abdallah N'dour,SEN,DF,Strasbourg,Ligue 1,24,1993,3.2,6,4,3,3,0,4,9,44.4,5,4,2,2,5,11,8,0,0,2018-2019,90.0,140.625,168.75
1737,Cheikh N'Doye,SEN,MF,Angers,Ligue 1,32,1986,25.9,25,15,14,11,0,10,32,31.3,22,33,8,25,25,50,61,0,0,2018-2019,90.0,86.87258687258688,86.87258687258688
1738,Nathan N'Goumou,FRA,FW,Toulouse,Ligue 1,18,2000,0.8,1,1,0,1,0,0,1,0.0,1,1,0,1,0,1,3,0,0,2018-2019,90.0,0.0,112.5
1739,Clinton N'Jie,CMR,FW,Marseille,Ligue 1,24,1993,4.0,7,4,2,3,2,3,3,100.0,0,2,0,2,2,9,0,0,0,2018-2019,90.0,45.0,157.5
1740,Georges-Kévin N'Koudou,CMR,FW,Tottenham,Premier League,23,1995,0.1,0,0,0,0,0,0,0,0.0,0,0,0,0,0,0,0,0,0,2018-2019,90.0,0.0,0.0
1741,Georges-Kévin N'Koudou,CMR,FW,Monaco,Ligue 1,23,1995,0.3,2,1,0,0,2,1,1,100.0,0,2,0,2,0,2,0,0,0,2018-2019,90.0,0.0,600.0
1742,Stanley N'Soki,FRA,DF,Paris S-G,Ligue 1,19,1999,7.8,20,14,8,10,2,6,13,46.2,7,10,1,9,18,38,20,1,0,2018-2019,90.0,207.69230769230768,230.76923076923077
1743,Nacho,ESP,DF,Valladolid,La Liga,29,1989,35.0,110,66,73,30,7,67,100,67.0,33,43,10,33,45,155,113,2,0,2018-2019,90.0,115.71428571428571,282.85714285714283
1744,Nacho,ESP,DF,Real Madrid,La Liga,28,1990,18.9,26,19,14,7,5,11,22,50.0,11,19,7,12,32,58,65,1,0,2018-2019,90.0,152.38095238095238,123.80952380952381
1745,Ádám Nagy,HUN,MF,Bologna,Serie A,23,1995,10.8,29,21,15,13,1,11,21,52.4,10,13,5,8,25,54,12,2,0,2018-2019,90.0,208.33333333333331,241.66666666666666
1746,Radja Nainggolan,BEL,MF,Inter,Serie A,30,1988,21.9,35,26,7,20,8,10,24,41.7,14,17,2,15,8,43,5,0,0,2018-2019,90.0,32.87671232876713,143.83561643835617
1747,Naldo,BRA,DF,Espanyol,La Liga,29,1988,15.1,18,10,9,5,4,6,10,60.0,4,19,13,6,26,44,112,1,0,2018-2019,90.0,154.96688741721854,107.28476821192054
1748,Naldo,BRA,DF,Monaco,Ligue 1,35,1982,3.3,5,3,4,1,0,2,4,50.0,2,5,2,3,5,10,23,0,0,2018-2019,90.0,136.36363636363637,136.36363636363637
1749,Naldo,BRA,DF,Schalke 04,Bundesliga,35,1982,7.0,10,7,8,2,0,5,8,62.5,3,8,3,5,14,24,25,0,0,2018-2019,90.0,180.0,128.57142857142856
1750,Samir Nasri,FRA,MF,West Ham,Premier League,31,1987,2.7,0,0,0,0,0,0,0,0.0,0,1,0,1,1,1,1,0,0,2018-2019,90.0,33.33333333333333,0.0
Rk,Player,Nation,Pos,Squad,Comp,0,0,90.0,0,0,3,3,3,Tkl,0,0.0,0,0,0,0,0,0,0,0,0,2018-2019,90.0,0.0,0.0
1751,Matija Nastasić,SRB,DF,Schalke 04,Bundesliga,25,1993,27.2,35,23,22,13,0,20,29,69.0,9,32,20,12,38,73,114,1,0,2018-2019,90.0,125.73529411764706,115.80882352941177
1752,Marc Navarro,ESP,DF,Watford,Premier League,23,1995,0.9,4,2,3,1,0,3,4,75.0,1,0,0,0,0,4,4,0,0,2018-2019,90.0,0.0,400.0
1753,Ximo Navarro,ESP,DF,Alavés,La Liga,28,1990,28.1,57,35,44,12,1,32,45,71.1,13,25,11,14,47,104,143,1,0,2018-2019,90.0,150.53380782918148,182.56227758007117
1754,Jesús Navas,ESP,"DF,FW",Sevilla,La Liga,32,1985,30.1,28,21,15,11,2,16,24,66.7,8,23,5,18,29,57,62,0,0,2018-2019,90.00000000000001,86.71096345514951,83.72093023255815
1755,Keylor Navas,CRC,GK,Real Madrid,La Liga,31,1986,10.0,0,0,0,0,0,0,0,0.0,0,0,0,0,1,1,5,0,0,2018-2019,90.0,9.0,0.0
1756,Raúl Navas,ESP,DF,Real Sociedad,La Liga,30,1988,14.6,23,14,20,3,0,13,21,61.9,8,20,9,11,20,43,60,1,0,2018-2019,90.0,123.28767123287672,141.78082191780823
1757,Wilfred Ndidi,NGA,MF,Leicester City,Premier League,21,1996,36.6,142,98,66,67,9,46,95,48.4,49,64,9,55,83,225,85,2,0,2018-2019,90.0,204.0983606557377,349.18032786885243
1758,Aly Ndom,FRA,MF,Caen,Ligue 1,22,1996,0.5,0,0,0,0,0,0,0,0.0,0,0,0,0,1,1,1,0,0,2018-2019,90.0,180.0,0.0
1759,Aly Ndom,FRA,MF,Reims,Ligue 1,22,1996,4.0,11,9,5,5,1,3,7,42.9,4,6,2,4,3,14,9,1,0,2018-2019,90.0,67.5,247.5
1760,Tanguy Ndombele,FRA,MF,Lyon,Ligue 1,21,1996,29.9,66,43,21,35,10,22,54,40.7,32,29,9,20,30,96,13,3,0,2018-2019,90.0,90.30100334448161,198.66220735785956
1761,Angelo Ndrecka,ALB,DF,Chievo,Serie A,16,2001,1.0,1,1,1,0,0,1,2,50.0,1,3,2,1,0,1,1,0,0,2018-2019,90.0,0.0,90.0
1762,Reiss Nelson,ENG,"MF,FW",Hoffenheim,Bundesliga,18,1999,7.1,17,10,8,4,5,2,13,15.4,11,12,1,11,5,22,2,0,0,2018-2019,90.0,63.38028169014085,215.49295774647888
1763,Neto,BRA,GK,Valencia,La Liga,29,1989,34.0,2,0,2,0,0,2,3,66.7,1,0,0,0,1,3,9,3,0,2018-2019,90.0,2.6470588235294117,5.294117647058823
1764,Pedro Neto,POR,"FW,DF",Lazio,Serie A,18,2000,0.5,0,0,0,0,0,0,0,0.0,0,1,0,1,0,0,0,0,0,2018-2019,90.0,0.0,0.0
1765,Manuel Neuer,GER,GK,Bayern Munich,Bundesliga,32,1986,25.6,1,1,1,0,0,0,1,0.0,1,1,0,1,0,1,8,3,0,2018-2019,90.0,0.0,3.515625
1766,Florian Neuhaus,GER,MF,Gladbach,Bundesliga,21,1997,22.9,22,15,9,9,4,10,36,27.8,26,20,1,19,10,32,23,0,0,2018-2019,90.0,39.301310043668124,86.46288209606988
1767,Rúben Neves,POR,MF,Wolves,Premier League,21,1997,33.4,75,32,33,36,6,27,83,32.5,56,57,18,39,73,148,46,3,0,2018-2019,90.0,196.7065868263473,202.09580838323353
1768,Neymar,BRA,"MF,FW",Paris S-G,Ligue 1,26,1992,16.0,14,9,3,10,1,4,21,19.0,17,8,0,8,5,19,1,1,0,2018-2019,90.0,28.125,78.75
1769,Yeni Ngbakoto,COD,"MF,FW",Guingamp,Ligue 1,26,1992,6.3,9,4,4,3,2,4,8,50.0,4,7,0,7,4,13,2,0,0,2018-2019,90.0,57.142857142857146,128.57142857142858
1770,Moussa Niakhate,SEN,DF,Mainz 05,Bundesliga,22,1996,31.0,49,30,35,12,2,20,33,60.6,13,42,24,18,44,93,143,1,0,2018-2019,90.0,127.74193548387098,142.25806451612902
1771,M'Baye Niang,SEN,"FW,MF",Rennes,Ligue 1,23,1994,19.9,16,10,3,8,5,2,11,18.2,9,19,3,16,8,24,14,0,0,2018-2019,90.0,36.18090452261307,72.36180904522614
1772,Oumar Niasse,SEN,FW,Cardiff City,Premier League,28,1990,10.3,12,3,1,5,6,4,8,50.0,4,7,0,7,2,14,7,0,0,2018-2019,90.0,17.475728155339805,104.85436893203884
1773,Oumar Niasse,SEN,FW,Everton,Premier League,28,1990,0.7,0,0,0,0,0,0,1,0.0,1,0,0,0,0,0,0,0,0,2018-2019,90.0,0.0,0.0
1774,Hans Nicolussi Caviglia,ITA,MF,Juventus,Serie A,18,2000,0.6,2,1,0,2,0,0,2,0.0,2,2,1,1,0,2,0,0,0,2018-2019,90.0,0.0,300.0
1775,Florian Niederlechner,GER,"FW,MF",Freiburg,Bundesliga,27,1990,10.8,7,5,1,4,2,0,5,0.0,5,12,4,8,6,13,10,0,0,2018-2019,90.0,49.99999999999999,58.33333333333333
Rk,Player,Nation,Pos,Squad,Comp,0,0,90.0,0,0,3,3,3,Tkl,0,0.0,0,0,0,0,0,0,0,0,0,2018-2019,90.0,0.0,0.0
1776,Saúl Ñíguez,ESP,"MF,DF",Atlético Madrid,La Liga,23,1994,32.5,83,56,35,41,7,32,81,39.5,49,57,10,47,42,125,86,1,0,2018-2019,90.0,116.3076923076923,229.84615384615384
1777,Dimitris Nikolaou,GRE,DF,Empoli,Serie A,19,1998,3.9,5,3,3,2,0,1,2,50.0,1,2,2,0,2,7,14,0,0,2018-2019,90.0,46.15384615384615,115.38461538461539
1778,Casimir Ninga,CHA,"FW,MF",Caen,Ligue 1,25,1993,27.4,53,30,23,21,9,20,49,40.8,29,22,1,21,22,75,12,0,0,2018-2019,90.0,72.26277372262774,174.08759124087592
1779,Eddie Nketiah,ENG,"MF,FW",Arsenal,Premier League,19,1999,0.7,1,1,0,1,0,0,0,0.0,0,0,0,0,0,1,1,0,0,2018-2019,90.0,0.0,128.57142857142858
1780,Nicolas Nkoulou,CMR,DF,Torino,Serie A,28,1990,35.7,45,29,34,10,1,15,25,60.0,10,42,28,14,70,115,174,2,0,2018-2019,90.0,176.4705882352941,113.44537815126048
1781,Christopher Nkunku,FRA,"MF,FW",Paris S-G,Ligue 1,20,1997,12.8,21,16,8,10,3,7,16,43.8,9,12,2,10,9,30,7,1,0,2018-2019,90.0,63.28125,147.65625
1782,Mark Noble,ENG,MF,West Ham,Premier League,31,1987,25.5,47,26,19,24,4,17,52,32.7,35,17,2,15,21,68,13,0,0,2018-2019,90.0,74.11764705882354,165.88235294117646
1783,Peru Nolaskoain,ESP,DF,Athletic Club,La Liga,19,1998,5.2,11,8,7,4,0,5,9,55.6,4,11,6,5,10,21,18,0,0,2018-2019,90.0,173.07692307692307,190.38461538461536
1784,Nolito,ESP,"FW,DF",Sevilla,La Liga,31,1986,0.8,3,2,1,1,1,1,2,50.0,1,2,0,2,0,3,1,0,0,2018-2019,90.0,0.0,337.5
1785,Arnaud Nordin,FRA,"FW,MF",Saint-Étienne,Ligue 1,20,1998,11.7,14,12,4,4,6,4,11,36.4,7,13,2,11,5,19,9,0,0,2018-2019,89.99999999999999,38.46153846153846,107.6923076923077
1786,Håvard Nordtveit,NOR,DF,Fulham,Premier League,28,1990,4.0,9,4,8,1,0,4,5,80.0,1,3,3,0,8,17,15,1,0,2018-2019,90.0,180.0,202.5
1787,Håvard Nordtveit,NOR,"MF,DF",Hoffenheim,Bundesliga,28,1990,5.2,8,5,2,4,2,3,7,42.9,4,8,5,3,4,12,14,0,0,2018-2019,90.0,69.23076923076923,138.46153846153845
1788,Will Norris,ENG,GK,Wolves,Premier League,24,1993,0.0,0,0,0,0,0,0,0,0.0,0,0,0,0,0,0,0,0,0,2018-2019,,,
1789,Alexander Nübel,GER,GK,Schalke 04,Bundesliga,21,1996,17.6,0,0,0,0,0,0,1,0.0,1,0,0,0,1,1,4,1,0,2018-2019,90.0,5.113636363636363,0.0
1790,Kasim Nuhu,GHA,DF,Hoffenheim,Bundesliga,23,1995,10.0,19,11,14,3,2,10,23,43.5,13,11,5,6,23,42,44,0,0,2018-2019,90.0,207.0,171.0
1791,Unai Núñez,ESP,DF,Athletic Club,La Liga,21,1997,11.8,15,11,11,4,0,7,11,63.6,4,20,12,8,28,43,60,2,0,2018-2019,90.0,213.5593220338983,114.40677966101694
1792,Hans Nunoo Sarpei,GHA,"FW,MF",Stuttgart,Bundesliga,19,1998,0.5,1,1,0,1,0,0,0,0.0,0,0,0,0,0,1,0,0,0,2018-2019,90.0,0.0,180.0
1793,Bram Nuytinck,NED,DF,Udinese,Serie A,28,1990,23.6,50,35,34,13,3,25,33,75.8,8,44,27,17,29,79,126,0,0,2018-2019,90.0,110.59322033898304,190.6779661016949
1794,Gerzino Nyamsi,FRA,DF,Rennes,Ligue 1,21,1997,6.0,6,3,5,1,0,4,9,44.4,5,8,4,4,4,10,17,0,0,2018-2019,90.0,60.0,90.0
1795,Allan Nyom,CMR,"DF,FW",Leganés,La Liga,30,1988,19.0,32,24,20,10,2,12,17,70.6,5,7,2,5,20,52,35,0,0,2018-2019,90.0,94.73684210526316,151.57894736842104
1796,Steven Nzonzi,FRA,MF,Roma,Serie A,29,1988,29.1,66,45,24,36,6,21,34,61.8,13,40,24,16,27,93,55,2,0,2018-2019,90.0,83.50515463917525,204.12371134020617
1797,Christian Nørgaard,DEN,MF,Fiorentina,Serie A,24,1994,3.6,4,2,1,2,1,2,5,40.0,3,2,0,2,10,14,16,0,0,2018-2019,90.0,250.0,100.0
1798,Michael Obafemi,IRL,FW,Southampton,Premier League,18,2000,1.5,1,1,0,0,1,0,0,0.0,0,1,1,0,1,2,0,0,0,2018-2019,90.0,60.0,60.0
1799,Dimitri Oberlin,SUI,FW,Empoli,Serie A,20,1997,1.5,1,1,0,0,1,0,3,0.0,3,1,0,1,0,1,1,0,0,2018-2019,90.0,0.0,60.0
1800,Joel Obi,NGA,MF,Chievo,Serie A,27,1991,7.3,22,15,9,11,2,7,17,41.2,10,12,1,11,14,36,15,0,0,2018-2019,90.0,172.6027397260274,271.2328767123288
Rk,Player,Nation,Pos,Squad,Comp,0,0,90.0,0,0,3,3,3,Tkl,0,0.0,0,0,0,0,0,0,0,0,0,2018-2019,90.0,0.0,0.0
1801,Pedro Obiang,EQG,MF,West Ham,Premier League,26,1992,12.5,41,23,23,16,2,18,43,41.9,25,27,9,18,12,53,18,0,0,2018-2019,90.0,86.39999999999999,295.2
1802,Jan Oblak,SVN,GK,Atlético Madrid,La Liga,25,1993,37.0,1,0,1,0,0,1,1,100.0,0,0,0,0,1,2,13,1,0,2018-2019,90.0,2.4324324324324325,2.4324324324324325
1803,Lucas Ocampos,ARG,"FW,MF",Marseille,Ligue 1,24,1994,30.1,80,54,37,33,10,34,80,42.5,46,40,5,35,29,109,30,0,0,2018-2019,90.00000000000001,86.71096345514951,239.20265780730898
1804,Bastian Oczipka,GER,"DF,FW",Schalke 04,Bundesliga,29,1989,20.8,41,27,20,19,2,21,26,80.8,5,23,5,18,24,65,24,2,0,2018-2019,90.0,103.84615384615384,177.40384615384613
1805,Jens Odgaard,DEN,FW,Sassuolo,Serie A,19,1999,0.2,0,0,0,0,0,0,0,0.0,0,1,0,1,0,0,1,0,0,2018-2019,90.0,0.0,0.0
1806,Denis Odoi,GHA,DF,Fulham,Premier League,30,1988,28.8,48,34,29,16,3,21,33,63.6,12,45,24,21,42,90,153,0,0,2018-2019,90.0,131.25,150.0
1807,Álvaro Odriozola,ESP,DF,Real Madrid,La Liga,22,1995,13.1,28,25,13,11,4,14,18,77.8,4,11,1,10,11,39,17,1,0,2018-2019,90.0,75.57251908396947,192.36641221374046
1808,Angelo Ogbonna,ITA,DF,West Ham,Premier League,30,1988,20.8,31,13,23,6,2,14,23,60.9,9,29,19,10,35,66,101,0,0,2018-2019,90.0,151.44230769230768,134.1346153846154
1809,Dani Ojeda,ESP,"MF,DF",Leganés,La Liga,23,1994,2.1,3,2,2,0,1,1,3,33.3,2,2,0,2,2,5,2,0,0,2018-2019,90.0,85.71428571428571,128.57142857142856
1810,Sheyi Ojo,ENG,"FW,MF",Reims,Ligue 1,21,1997,5.2,8,6,2,4,2,2,8,25.0,6,1,0,1,3,11,2,0,0,2018-2019,90.0,51.92307692307692,138.46153846153845
1811,Stefano Okaka,ITA,"FW,MF",Watford,Premier League,28,1989,0.3,0,0,0,0,0,0,0,0.0,0,1,0,1,0,0,0,0,0,2018-2019,90.0,0.0,0.0
1812,Stefano Okaka,ITA,FW,Udinese,Serie A,28,1989,10.8,13,7,4,5,4,2,8,25.0,6,6,1,5,0,13,16,1,0,2018-2019,90.0,0.0,108.33333333333333
1813,Shinji Okazaki,JPN,"MF,FW",Leicester City,Premier League,32,1986,3.2,5,5,2,3,0,0,1,0.0,1,7,1,6,2,7,1,0,0,2018-2019,90.0,56.25,140.625
1814,Chima Okoroji,NGA,"DF,MF",Freiburg,Bundesliga,21,1997,1.2,3,0,1,1,1,1,1,100.0,0,0,0,0,1,4,1,0,0,2018-2019,90.0,75.0,225.00000000000003
1815,Orji Okwonkwo,NGA,FW,Bologna,Serie A,20,1998,2.9,4,3,1,2,1,2,2,100.0,0,0,0,0,1,5,0,0,0,2018-2019,90.0,31.03448275862069,124.13793103448276
1816,Lucas Olaza,URU,DF,Celta Vigo,La Liga,24,1994,10.0,29,18,19,8,2,14,18,77.8,4,13,6,7,8,37,18,0,0,2018-2019,90.0,72.0,261.0
1817,Oier Olazábal,ESP,GK,Levante,La Liga,28,1989,21.0,1,1,1,0,0,1,2,50.0,1,1,0,1,1,2,15,2,0,2018-2019,90.0,4.285714285714286,4.285714285714286
1818,Kiko Olivas,ESP,DF,Valladolid,La Liga,29,1988,34.4,51,38,35,15,1,22,48,45.8,26,31,18,13,46,97,173,2,0,2018-2019,90.0,120.34883720930233,133.43023255813955
1819,Paulo Oliveira,POR,DF,Eibar,La Liga,26,1992,24.9,49,39,33,16,0,28,44,63.6,16,25,10,15,36,85,116,0,0,2018-2019,90.0,130.12048192771084,177.10843373493975
1820,Mathías Olivera,URU,"DF,MF",Getafe,La Liga,20,1997,11.2,24,17,11,8,5,10,18,55.6,8,25,2,23,10,34,22,0,0,2018-2019,90.0,80.35714285714286,192.85714285714286
1821,Alexandre Olliero,FRA,GK,Nantes,Ligue 1,22,1996,1.0,0,0,0,0,0,0,0,0.0,0,0,0,0,0,0,0,0,0,2018-2019,90.0,0.0,0.0
1822,Robin Olsen,SWE,GK,Roma,Serie A,28,1990,27.0,0,0,0,0,0,0,1,0.0,1,1,0,1,0,0,10,4,0,2018-2019,90.0,0.0,0.0
1823,Stephane Omeonga,BEL,MF,Genoa,Serie A,22,1996,0.6,1,1,1,0,0,0,1,0.0,1,1,0,1,0,1,2,0,0,2018-2019,90.0,0.0,150.0
1824,Kenneth Omeruo,NGA,DF,Leganés,La Liga,24,1993,27.0,49,27,41,8,0,20,29,69.0,9,23,11,12,37,86,159,3,0,2018-2019,90.0,123.33333333333334,163.33333333333334
1825,Prince Oniangué,CGO,MF,Caen,Ligue 1,29,1988,26.0,59,33,22,34,3,24,57,42.1,33,30,10,20,29,88,42,0,0,2018-2019,90.00000000000001,100.3846153846154,204.23076923076925
Rk,Player,Nation,Pos,Squad,Comp,0,0,90.0,0,0,3,3,3,Tkl,0,0.0,0,0,0,0,0,0,0,0,0,2018-2019,90.0,0.0,0.0
1826,Karim Onisiwo,AUT,"FW,MF",Mainz 05,Bundesliga,26,1992,12.9,23,15,6,12,5,4,12,33.3,8,14,3,11,9,32,13,0,0,2018-2019,90.0,62.7906976744186,160.46511627906975
1827,Nicholas Opoku,GHA,DF,Udinese,Serie A,20,1997,10.1,16,9,15,1,0,10,17,58.8,7,8,5,3,18,34,29,0,0,2018-2019,90.0,160.3960396039604,142.5742574257426
1828,Willi Orban,HUN,DF,RB Leipzig,Bundesliga,25,1992,22.8,49,26,31,15,3,24,38,63.2,14,33,15,18,36,85,140,0,0,2018-2019,90.0,142.1052631578947,193.42105263157893
1829,Fabián Orellana,CHI,"MF,FW",Eibar,La Liga,32,1986,30.4,44,21,14,16,14,9,42,21.4,33,17,0,17,19,63,4,0,0,2018-2019,90.0,56.25,130.26315789473685
1830,Divock Origi,BEL,FW,Liverpool,Premier League,23,1995,4.1,6,1,2,3,1,1,4,25.0,3,2,0,2,0,6,2,0,0,2018-2019,90.0,0.0,131.70731707317074
1831,Riccardo Orsolini,ITA,"FW,MF",Bologna,Serie A,21,1997,21.8,40,24,16,18,6,9,39,23.1,30,23,2,21,14,54,25,1,0,2018-2019,90.0,57.798165137614674,165.13761467889907
1832,Yuya Osako,JPN,"FW,MF",Werder Bremen,Bundesliga,28,1990,15.0,23,11,6,12,5,7,22,31.8,15,15,3,12,7,30,8,0,0,2018-2019,90.0,42.0,138.0
1833,David Ospina,COL,GK,Napoli,Serie A,29,1988,16.2,1,0,1,0,0,1,1,100.0,0,0,0,0,0,1,7,1,0,2018-2019,90.0,0.0,5.555555555555555
1834,Matthias Ostrzolek,GER,DF,Hannover 96,Bundesliga,28,1990,16.3,32,18,24,8,0,20,33,60.6,13,20,5,15,26,58,44,2,0,2018-2019,90.0,143.55828220858896,176.68711656441718
1835,Nicolás Otamendi,ARG,DF,Manchester City,Premier League,30,1988,13.7,24,14,17,6,1,5,9,55.6,4,6,4,2,29,53,56,1,0,2018-2019,90.0,190.5109489051095,157.66423357664235
1836,Otávio,BRA,MF,Bordeaux,Ligue 1,24,1994,31.9,127,74,59,64,4,49,109,45.0,60,45,11,34,43,170,54,1,0,2018-2019,90.0,121.31661442006269,358.30721003134795
1837,David Otto,GER,"MF,FW",Hoffenheim,Bundesliga,19,1999,0.3,2,1,1,1,0,0,1,0.0,1,0,0,0,0,2,0,0,0,2018-2019,90.0,0.0,600.0
1838,Remi Oudin,FRA,"FW,MF",Reims,Ligue 1,21,1996,29.0,51,32,25,18,8,20,45,44.4,25,29,5,24,42,93,34,0,0,2018-2019,90.0,130.3448275862069,158.2758620689655
1839,Adam Ounas,ALG,"MF,FW",Napoli,Serie A,21,1996,6.0,5,2,0,3,2,2,11,18.2,9,6,0,6,2,7,0,1,0,2018-2019,90.0,30.0,75.0
1840,Reece Oxford,ENG,DF,Augsburg,Bundesliga,19,1998,5.6,12,9,9,3,0,4,6,66.7,2,10,9,1,11,23,39,0,0,2018-2019,90.0,176.78571428571428,192.85714285714286
1841,Alex Oxlade-Chamberlain,ENG,MF,Liverpool,Premier League,24,1993,0.2,1,1,0,1,0,1,1,100.0,0,0,0,0,1,2,0,0,0,2018-2019,90.0,450.0,450.0
1842,Mikel Oyarzabal,ESP,"FW,MF",Real Sociedad,La Liga,21,1997,35.0,36,20,15,15,6,12,49,24.5,37,54,3,51,14,50,26,0,0,2018-2019,90.0,36.0,92.57142857142857
1843,Ambroise Oyongo,CMR,DF,Montpellier,Ligue 1,27,1991,23.7,44,21,23,16,5,20,38,52.6,18,26,6,20,38,82,60,0,0,2018-2019,90.0,144.30379746835445,167.08860759493672
1844,Berkay Özcan,TUR,"MF,DF",Stuttgart,Bundesliga,20,1998,0.6,0,0,0,0,0,0,0,0.0,0,1,0,1,0,0,0,0,0,2018-2019,90.0,0.0,0.0
1845,Ramazan Özcan,AUT,GK,Leverkusen,Bundesliga,34,1984,2.0,0,0,0,0,0,0,0,0.0,0,0,0,0,1,1,2,0,0,2018-2019,90.0,45.0,0.0
1846,Mesut Özil,GER,"MF,FW",Arsenal,Premier League,29,1988,19.3,12,5,6,3,3,3,21,14.3,18,10,2,8,4,16,5,0,0,2018-2019,90.0,18.65284974093264,55.95854922279792
1847,Levin Öztunalı,GER,"MF,FW",Mainz 05,Bundesliga,22,1996,10.2,17,7,5,9,3,4,18,22.2,14,14,2,12,7,24,10,0,0,2018-2019,90.0,61.76470588235294,150.0
1848,Pablo,BRA,DF,Bordeaux,Ligue 1,27,1991,21.5,26,15,22,3,1,13,23,56.5,10,28,22,6,32,58,173,2,0,2018-2019,90.0,133.953488372093,108.83720930232558
1849,Fernando Pacheco,ESP,GK,Alavés,La Liga,26,1992,35.0,0,0,0,0,0,0,1,0.0,1,0,0,0,1,1,23,0,0,2018-2019,90.0,2.571428571428571,0.0
1850,Gonçalo Paciência,POR,FW,Eint Frankfurt,Bundesliga,23,1994,4.3,3,2,0,2,1,1,2,50.0,1,8,1,7,0,3,1,0,0,2018-2019,90.0,0.0,62.79069767441861
Rk,Player,Nation,Pos,Squad,Comp,0,0,90.0,0,0,3,3,3,Tkl,0,0.0,0,0,0,0,0,0,0,0,0,2018-2019,90.0,0.0,0.0
1851,Simone Padoin,ITA,"DF,MF",Cagliari,Serie A,34,1984,21.3,34,25,12,18,4,14,33,42.4,19,18,5,13,14,48,54,0,0,2018-2019,90.0,59.15492957746479,143.66197183098592
1852,Luca Paganini,ITA,"DF,MF",Frosinone,Serie A,25,1993,12.5,25,13,8,13,4,8,23,34.8,15,19,4,15,19,44,17,1,0,2018-2019,90.0,136.79999999999998,180.0
1853,Marko Pajač,CRO,"FW,DF",Empoli,Serie A,25,1993,8.2,7,7,2,3,2,5,11,45.5,6,3,0,3,7,14,18,0,0,2018-2019,90.0,76.82926829268294,76.82926829268294
1854,Marko Pajač,CRO,DF,Cagliari,Serie A,25,1993,1.1,1,1,0,0,1,0,0,0.0,0,1,1,0,1,2,3,0,0,2018-2019,90.0,81.81818181818181,81.81818181818181
1855,Vincent Pajot,FRA,MF,Angers,Ligue 1,27,1990,7.9,18,14,6,8,4,4,14,28.6,10,9,0,9,8,26,6,0,0,2018-2019,90.0,91.1392405063291,205.06329113924048
1856,Rodrigo Palacio,ARG,FW,Bologna,Serie A,36,1982,25.9,24,13,8,12,4,4,34,11.8,30,35,0,35,5,29,13,0,0,2018-2019,90.0,17.374517374517378,83.39768339768341
1857,Federico Palacios Martínez,GER,"MF,FW",Nürnberg,Bundesliga,23,1995,10.5,21,10,11,8,2,10,20,50.0,10,10,0,10,9,30,4,0,0,2018-2019,90.0,77.14285714285714,180.0
1858,Sergi Palencia,ESP,DF,Bordeaux,Ligue 1,22,1996,22.1,74,50,46,20,8,27,55,49.1,28,22,3,19,17,91,70,1,0,2018-2019,90.0,69.23076923076923,301.3574660633484
1859,Nicolas Pallois,FRA,DF,Nantes,Ligue 1,30,1987,24.0,77,48,60,17,0,40,69,58.0,29,30,14,16,34,111,114,0,0,2018-2019,90.0,127.5,288.75
1860,Emerson Palmieri,ITA,DF,Chelsea,Premier League,23,1994,7.4,14,9,6,5,3,6,10,60.0,4,11,1,10,8,22,14,0,0,2018-2019,90.0,97.29729729729729,170.27027027027026
1861,Alberto Paloschi,ITA,FW,SPAL,Serie A,28,1990,9.6,13,9,3,5,5,1,2,50.0,1,2,0,2,1,14,0,0,0,2018-2019,90.0,9.375,121.87500000000001
1862,Goran Pandev,MKD,"FW,MF",Genoa,Serie A,35,1983,12.5,14,10,0,10,4,2,8,25.0,6,7,0,7,1,15,3,0,0,2018-2019,90.0,7.199999999999999,100.8
1863,Mickaël Panos,FRA,DF,Saint-Étienne,Ligue 1,21,1997,0.3,1,0,0,1,0,1,2,50.0,1,2,0,2,1,2,0,0,0,2018-2019,90.0,300.0,300.0
1864,Sokratis Papastathopoulos,GRE,DF,Arsenal,Premier League,30,1988,24.4,42,25,30,11,1,15,28,53.6,13,34,17,17,26,68,112,1,0,2018-2019,90.0,95.9016393442623,154.91803278688528
1865,Elhadji Pape Diaw,SEN,DF,Angers,Ligue 1,23,1994,0.2,0,0,0,0,0,0,0,0.0,0,0,0,0,1,1,0,0,0,2018-2019,90.0,450.0,0.0
1866,Lucas Paquetá,BRA,MF,Milan,Serie A,20,1997,9.4,18,9,9,8,1,7,24,29.2,17,12,0,12,4,22,11,2,0,2018-2019,90.0,38.29787234042553,172.3404255319149
1867,Gaëtan Paquiez,FRA,DF,Nîmes,Ligue 1,24,1994,14.8,43,29,30,10,3,23,48,47.9,25,24,6,18,22,65,50,0,0,2018-2019,90.0,133.78378378378378,261.48648648648646
1868,Rubén Pardo,ESP,"MF,FW",Real Sociedad,La Liga,25,1992,15.2,11,7,2,9,0,4,17,23.5,13,14,6,8,21,32,9,0,0,2018-2019,90.0,124.34210526315789,65.13157894736842
1869,Leandro Paredes,ARG,MF,Paris S-G,Ligue 1,24,1994,13.9,34,19,16,15,3,13,30,43.3,17,17,5,12,14,48,20,2,0,2018-2019,90.0,90.64748201438849,220.14388489208633
1870,Daniel Parejo,ESP,MF,Valencia,La Liga,29,1989,34.0,73,42,41,24,8,31,90,34.4,59,41,7,34,46,119,26,2,0,2018-2019,90.0,121.76470588235294,193.23529411764707
1871,Vittorio Parigini,ITA,"MF,DF",Torino,Serie A,22,1996,4.2,11,10,3,6,2,6,9,66.7,3,3,0,3,1,12,5,0,0,2018-2019,90.0,21.428571428571427,235.7142857142857
1872,Marco Parolo,ITA,MF,Lazio,Serie A,33,1985,28.5,68,45,24,37,7,18,56,32.1,38,48,11,37,28,96,56,0,0,2018-2019,90.0,88.42105263157895,214.73684210526318
1873,Thomas Partey,GHA,MF,Atlético Madrid,La Liga,25,1993,23.0,66,42,32,25,9,21,49,42.9,28,26,5,21,49,115,22,2,0,2018-2019,90.0,191.73913043478262,258.26086956521743
1874,Mario Pašalić,CRO,MF,Atalanta,Serie A,23,1995,18.0,32,19,9,13,10,7,29,24.1,22,19,4,15,12,44,14,1,0,2018-2019,90.0,60.0,160.0
1875,Manuel Pasqual,ITA,DF,Empoli,Serie A,36,1982,14.9,26,19,12,11,3,17,45,37.8,28,7,0,7,11,37,31,0,0,2018-2019,90.0,66.44295302013423,157.0469798657718
Rk,Player,Nation,Pos,Squad,Comp,0,0,90.0,0,0,3,3,3,Tkl,0,0.0,0,0,0,0,0,0,0,0,0,2018-2019,90.0,0.0,0.0
1876,Javier Pastore,ARG,"MF,FW",Roma,Serie A,29,1989,6.6,10,4,4,3,3,4,16,25.0,12,7,0,7,3,13,5,0,0,2018-2019,90.0,40.90909090909091,136.36363636363637
1877,Callum Paterson,SCO,"FW,MF",Cardiff City,Premier League,23,1994,22.2,21,14,7,7,7,5,26,19.2,21,23,2,21,8,29,29,0,0,2018-2019,90.0,32.432432432432435,85.13513513513514
1878,Patric,ESP,DF,Lazio,Serie A,25,1993,12.1,19,11,8,8,3,8,15,53.3,7,14,7,7,12,31,29,1,0,2018-2019,90.0,89.25619834710743,141.32231404958677
1879,Rui Patrício,POR,GK,Wolves,Premier League,30,1988,37.0,2,0,2,0,0,2,3,66.7,1,0,0,0,1,3,7,4,0,2018-2019,90.0,2.4324324324324325,4.864864864864865
1880,Paulinho,BRA,"FW,MF",Leverkusen,Bundesliga,18,2000,2.0,4,4,2,2,0,1,2,50.0,1,3,0,3,2,6,0,1,0,2018-2019,90.0,90.0,180.0
1881,Gabriel Paulista,BRA,DF,Valencia,La Liga,27,1990,29.1,29,16,20,6,3,14,28,50.0,14,37,21,16,70,99,162,1,0,2018-2019,90.0,216.4948453608247,89.69072164948453
1882,Benjamin Pavard,FRA,DF,Stuttgart,Bundesliga,22,1996,29.0,28,20,21,6,1,12,19,63.2,7,27,19,8,48,76,189,2,0,2018-2019,90.0,148.9655172413793,86.89655172413792
1883,Jiří Pavlenka,CZE,GK,Werder Bremen,Bundesliga,26,1992,33.1,3,0,3,0,0,3,6,50.0,3,1,0,1,3,6,14,1,0,2018-2019,90.0,8.157099697885196,8.157099697885196
1884,Mateo Pavlović,BIH,DF,Angers,Ligue 1,28,1990,27.7,26,18,24,2,0,12,24,50.0,12,37,29,8,20,46,164,2,0,2018-2019,90.0,64.98194945848375,84.47653429602889
1885,Leonardo Pavoletti,ITA,FW,Cagliari,Serie A,29,1988,30.4,32,21,6,17,9,6,16,37.5,10,12,3,9,7,39,26,0,0,2018-2019,90.0,20.723684210526315,94.73684210526315
1886,Dimitri Payet,FRA,"MF,FW",Marseille,Ligue 1,31,1987,21.2,11,9,2,8,1,5,22,22.7,17,14,0,14,8,19,8,0,0,2018-2019,90.0,33.9622641509434,46.69811320754717
1887,Nehuén Paz,ARG,DF,Bologna,Serie A,25,1993,1.3,2,1,2,0,0,1,2,50.0,1,3,1,2,0,2,2,0,0,2018-2019,90.0,0.0,138.46153846153845
1888,Alfonso Pedraza,ESP,"DF,FW",Villarreal,La Liga,22,1996,23.3,59,44,34,19,6,22,62,35.5,40,33,7,26,29,88,55,0,0,2018-2019,90.0,112.01716738197425,227.8969957081545
1889,Pedro,ESP,FW,Chelsea,Premier League,31,1987,19.8,27,14,11,10,6,9,35,25.7,26,13,2,11,18,45,8,1,0,2018-2019,90.0,81.81818181818181,122.72727272727273
1890,João Pedro,ITA,"FW,MF",Cagliari,Serie A,26,1992,28.4,17,12,4,8,5,4,11,36.4,7,14,5,9,6,23,14,0,0,2018-2019,90.0,19.014084507042256,53.87323943661972
1891,Adrià Pedrosa,ESP,DF,Espanyol,La Liga,20,1998,8.5,14,9,11,2,1,7,14,50.0,7,10,4,6,8,22,27,0,0,2018-2019,90.0,84.70588235294117,148.23529411764707
1892,Stef Peeters,BEL,MF,Caen,Ligue 1,26,1992,4.5,15,8,8,4,3,4,11,36.4,7,1,0,1,6,21,1,0,0,2018-2019,90.0,120.0,300.0
1893,Jordan Pefok,USA,FW,Rennes,Ligue 1,22,1996,6.8,6,2,0,3,3,2,4,50.0,2,7,2,5,4,10,5,0,0,2018-2019,90.0,52.94117647058823,79.41176470588235
1894,Gianluca Pegolo,ITA,GK,Sassuolo,Serie A,37,1981,2.3,0,0,0,0,0,0,0,0.0,0,0,0,0,0,0,0,0,0,2018-2019,90.0,0.0,0.0
1895,Peter Pekarík,SVK,DF,Hertha BSC,Bundesliga,31,1986,2.4,2,1,1,1,0,1,3,33.3,2,2,1,1,1,3,5,0,0,2018-2019,90.0,37.5,75.0
1896,Pelé,GNB,MF,Monaco,Ligue 1,26,1991,5.2,8,7,3,5,0,2,6,33.3,4,2,1,1,3,11,10,0,0,2018-2019,90.0,51.92307692307692,138.46153846153845
1897,Yohann Pelé,FRA,GK,Marseille,Ligue 1,35,1982,7.6,0,0,0,0,0,0,2,0.0,2,0,0,0,0,0,1,1,0,2018-2019,90.0,0.0,0.0
1898,Maxime Pélican,FRA,"FW,MF",Nice,Ligue 1,20,1998,1.0,1,1,0,1,0,0,0,0.0,0,1,0,1,0,1,0,0,0,2018-2019,90.0,0.0,90.0
1899,Pietro Pellegri,ITA,"FW,MF",Monaco,Ligue 1,17,2001,0.9,1,1,0,0,1,0,0,0.0,0,0,0,0,0,1,0,0,0,2018-2019,90.0,0.0,100.0
1900,Lorenzo Pellegrini,ITA,MF,Roma,Serie A,22,1996,20.2,39,23,16,18,5,10,30,33.3,20,20,2,18,12,51,21,0,0,2018-2019,90.0,53.46534653465346,173.76237623762376
Rk,Player,Nation,Pos,Squad,Comp,0,0,90.0,0,0,3,3,3,Tkl,0,0.0,0,0,0,0,0,0,0,0,0,2018-2019,90.0,0.0,0.0
1901,Luca Pellegrini,ITA,DF,Cagliari,Serie A,19,1999,10.4,28,19,16,11,1,14,25,56.0,11,13,3,10,18,46,22,0,0,2018-2019,90.0,155.76923076923075,242.3076923076923
1902,Luca Pellegrini,ITA,DF,Roma,Serie A,19,1999,1.8,1,1,1,0,0,1,2,50.0,1,2,1,1,3,4,2,0,0,2018-2019,90.0,150.0,50.0
1903,Théo Pellenard,FRA,DF,Angers,Ligue 1,24,1994,5.5,11,6,7,2,2,5,8,62.5,3,6,2,4,5,16,16,0,0,2018-2019,90.0,81.81818181818183,180.0
1904,Sergio Pellissier,ITA,FW,Chievo,Serie A,39,1979,10.6,4,3,1,1,2,3,4,75.0,1,8,1,7,2,6,8,0,0,2018-2019,90.0,16.9811320754717,33.9622641509434
1905,Andy Pelmard,FRA,DF,Nice,Ligue 1,18,2000,3.1,5,5,3,2,0,1,4,25.0,3,0,0,0,3,8,3,0,0,2018-2019,90.0,87.09677419354838,145.16129032258064
1906,Lee Peltier,ENG,DF,Cardiff City,Premier League,31,1986,17.2,39,25,27,11,1,15,27,55.6,12,18,12,6,18,57,60,0,0,2018-2019,90.0,94.18604651162792,204.06976744186048
1907,Federico Peluso,ITA,DF,Sassuolo,Serie A,34,1984,15.1,23,14,15,5,3,13,16,81.3,3,8,3,5,23,46,70,0,0,2018-2019,90.0,137.08609271523179,137.08609271523179
1908,Rubén Peña,ESP,DF,Eibar,La Liga,27,1991,29.7,63,46,24,27,12,24,53,45.3,29,37,9,28,35,98,57,0,0,2018-2019,90.0,106.06060606060606,190.9090909090909
1909,Nicolas Pépé,CIV,"FW,MF",Lille,Ligue 1,23,1995,36.9,27,10,6,15,6,8,35,22.9,27,33,0,33,13,40,11,1,0,2018-2019,90.0,31.707317073170735,65.85365853658537
1910,Pepín,EQG,MF,Parma,Serie A,21,1996,0.9,4,2,3,1,0,1,4,25.0,3,0,0,0,3,7,0,0,0,2018-2019,90.0,300.0,400.0
1911,Andreas Pereira,BRA,MF,Manchester Utd,Premier League,22,1996,6.7,8,6,5,2,1,4,15,26.7,11,9,2,7,11,19,8,1,0,2018-2019,90.0,147.76119402985074,107.46268656716417
1912,Matheus Pereira,POR,"MF,FW",Nürnberg,Bundesliga,22,1996,13.7,16,11,4,8,4,2,13,15.4,11,15,2,13,14,30,7,0,0,2018-2019,90.0,91.97080291970804,105.1094890510949
1913,Pedro Pereira,POR,"DF,FW",Genoa,Serie A,20,1998,15.4,20,14,15,2,3,11,19,57.9,8,10,5,5,14,34,55,1,0,2018-2019,90.0,81.81818181818183,116.88311688311688
1914,Ricardo Pereira,POR,"DF,FW",Leicester City,Premier League,24,1993,34.7,118,66,66,40,12,54,112,48.2,58,60,6,54,60,178,130,1,0,2018-2019,90.0,155.61959654178673,306.0518731988472
1915,Roberto Pereyra,ARG,MF,Watford,Premier League,27,1991,31.3,21,12,10,10,1,7,24,29.2,17,26,0,26,24,45,27,2,0,2018-2019,90.0,69.00958466453673,60.383386581469644
1916,Ayoze Pérez,ESP,"MF,FW",Newcastle Utd,Premier League,25,1993,32.4,59,22,24,28,7,17,63,27.0,46,55,4,51,42,101,33,1,0,2018-2019,90.0,116.66666666666667,163.88888888888889
1917,Carles Pérez,ESP,FW,Barcelona,La Liga,20,1998,0.2,0,0,0,0,0,0,0,0.0,0,1,0,1,0,0,0,0,0,2018-2019,90.0,0.0,0.0
1918,Hernán Pérez,PAR,"FW,MF",Espanyol,La Liga,29,1989,8.8,13,10,8,3,2,6,27,22.2,21,14,3,11,5,18,13,0,0,2018-2019,90.0,51.13636363636363,132.95454545454544
1919,Lucas Pérez,ESP,"FW,MF",West Ham,Premier League,29,1988,5.3,6,4,3,2,1,1,3,33.3,2,2,1,1,2,8,2,0,0,2018-2019,90.0,33.9622641509434,101.88679245283019
1920,Rubén Pérez,ESP,MF,Leganés,La Liga,29,1989,27.5,71,42,27,40,4,32,80,40.0,48,35,8,27,40,111,34,1,0,2018-2019,89.99999999999999,130.9090909090909,232.36363636363635
1921,Stipe Perica,CRO,FW,Frosinone,Serie A,23,1995,5.3,5,3,2,2,1,1,3,33.3,2,3,1,2,0,5,4,0,0,2018-2019,90.0,0.0,84.9056603773585
1922,Mattia Perin,ITA,GK,Juventus,Serie A,25,1992,9.0,0,0,0,0,0,0,0,0.0,0,0,0,0,0,0,3,2,0,2018-2019,90.0,0.0,0.0
1923,Ivan Perišić,CRO,FW,Inter,Serie A,29,1989,30.0,34,26,7,20,7,16,51,31.4,35,40,4,36,23,57,55,0,0,2018-2019,90.0,69.0,102.0
1924,Diego Perotti,ARG,"FW,MF",Roma,Serie A,30,1988,7.4,14,12,5,5,4,6,19,31.6,13,4,0,4,4,18,2,0,0,2018-2019,90.0,48.648648648648646,170.27027027027026
1925,Loïc Perrin,FRA,DF,Saint-Étienne,Ligue 1,32,1985,30.0,53,36,34,17,2,20,33,60.6,13,37,24,13,44,97,118,2,0,2018-2019,90.0,132.0,159.0
Rk,Player,Nation,Pos,Squad,Comp,0,0,90.0,0,0,3,3,3,Tkl,0,0.0,0,0,0,0,0,0,0,0,0,2018-2019,90.0,0.0,0.0
1926,Pavao Pervan,AUT,GK,Wolfsburg,Bundesliga,30,1987,8.5,0,0,0,0,0,0,0,0.0,0,0,0,0,0,0,3,1,0,2018-2019,90.0,0.0,0.0
1927,Matteo Pessina,ITA,"MF,FW",Atalanta,Serie A,21,1997,2.6,4,2,0,4,0,2,3,66.7,1,2,1,1,0,4,4,0,0,2018-2019,90.0,0.0,138.46153846153845
1928,Andrea Petagna,ITA,FW,SPAL,Serie A,23,1995,33.7,15,6,5,5,5,2,9,22.2,7,23,8,15,4,19,15,0,0,2018-2019,90.0,10.682492581602373,40.0593471810089
1929,Nils Petersen,GER,FW,Freiburg,Bundesliga,29,1988,21.4,29,21,10,16,3,4,24,16.7,20,28,2,26,13,42,34,0,0,2018-2019,90.0,54.67289719626169,121.96261682242992
1930,Ondřej Petrák,CZE,MF,Nürnberg,Bundesliga,26,1992,18.0,36,24,17,18,1,14,25,56.0,11,18,4,14,40,76,22,0,0,2018-2019,90.0,200.0,180.0
1931,Germán Pezzella,ARG,DF,Fiorentina,Serie A,27,1991,31.7,56,36,42,13,1,31,51,60.8,20,42,30,12,60,116,159,1,0,2018-2019,90.0,170.34700315457414,158.99053627760253
1932,Giuseppe Pezzella,ITA,DF,Udinese,Serie A,20,1997,2.0,5,4,4,1,0,2,8,25.0,6,2,1,1,1,6,9,0,0,2018-2019,90.0,45.0,225.0
1933,Giuseppe Pezzella,ITA,"DF,MF",Genoa,Serie A,20,1997,1.2,2,1,1,1,0,0,0,0.0,0,1,0,1,1,3,4,0,0,2018-2019,90.0,75.0,150.0
1934,Matthias Phaeton,GLP,"FW,MF",Guingamp,Ligue 1,18,2000,0.6,1,1,0,1,0,0,0,0.0,0,0,0,0,0,1,0,0,0,2018-2019,90.0,0.0,150.0
1935,Maximilian Philipp,GER,"FW,MF",Dortmund,Bundesliga,24,1994,8.4,7,5,3,4,0,2,9,22.2,7,10,0,10,3,10,6,0,0,2018-2019,90.0,32.14285714285714,75.0
1936,Lebogang Phiri,RSA,MF,Guingamp,Ligue 1,23,1994,21.4,60,38,16,41,3,24,43,55.8,19,26,3,23,29,89,19,0,0,2018-2019,90.0,121.96261682242992,252.33644859813086
1937,Krzysztof Piątek,POL,FW,Genoa,Serie A,23,1995,17.7,9,4,2,5,2,1,15,6.7,14,18,3,15,3,12,19,0,0,2018-2019,90.0,15.254237288135593,45.76271186440678
1938,Krzysztof Piątek,POL,FW,Milan,Serie A,23,1995,15.3,8,6,2,1,5,3,10,30.0,7,7,2,5,1,9,15,0,0,2018-2019,90.0,5.88235294117647,47.05882352941176
1939,Pablo Piatti,ARG,"FW,MF",Espanyol,La Liga,29,1989,8.3,21,15,8,10,3,8,16,50.0,8,15,0,15,2,23,8,0,0,2018-2019,90.0,21.686746987951803,227.71084337349396
1940,Lucas Piazon,BRA,"MF,FW",Chievo,Serie A,24,1994,0.9,2,0,1,1,0,0,2,0.0,2,1,0,1,1,3,0,0,0,2018-2019,90.0,100.0,200.0
1941,Cristiano Piccini,ITA,DF,Valencia,La Liga,25,1992,20.8,32,23,25,7,0,13,26,50.0,13,27,7,20,27,59,64,1,0,2018-2019,90.0,116.82692307692307,138.46153846153845
1942,Roberto Piccoli,ITA,"FW,MF",Atalanta,Serie A,17,2001,0.5,2,2,0,1,1,1,1,100.0,0,1,0,1,0,2,0,0,0,2018-2019,90.0,0.0,360.0
1943,Jordan Pickford,ENG,GK,Everton,Premier League,24,1994,38.0,0,0,0,0,0,0,0,0.0,0,0,0,0,0,0,20,8,0,2018-2019,90.0,0.0,0.0
1944,Jérémy Pied,FRA,DF,Lille,Ligue 1,29,1989,5.2,12,8,5,6,1,3,9,33.3,6,8,1,7,5,17,13,0,0,2018-2019,90.0,86.53846153846153,207.69230769230768
1945,Ronaël Pierre-Gabriel,FRA,DF,Monaco,Ligue 1,20,1998,3.9,13,8,10,2,1,9,10,90.0,1,3,1,2,3,16,18,0,0,2018-2019,90.0,69.23076923076923,300.0
1946,Erik Pieters,NED,DF,Amiens,Ligue 1,29,1988,14.0,49,28,28,18,3,25,33,75.8,8,21,13,8,17,66,56,0,0,2018-2019,90.0,109.28571428571428,315.0
1947,Tomás Pina Isla,ESP,MF,Alavés,La Liga,30,1987,26.0,64,41,23,36,5,18,46,39.1,28,15,4,11,41,105,43,1,0,2018-2019,90.00000000000001,141.92307692307693,221.53846153846155
1948,Andrea Pinamonti,ITA,FW,Frosinone,Serie A,19,1999,18.1,14,6,6,5,3,4,20,20.0,16,16,3,13,5,19,17,0,0,2018-2019,90.0,24.86187845303867,69.61325966850828
1949,Carlo Pinsoglio,ITA,GK,Juventus,Serie A,28,1990,1.0,0,0,0,0,0,0,0,0.0,0,0,0,0,0,0,0,0,0,2018-2019,90.0,0.0,0.0
1950,Virgile Pinson,FRA,MF,Reims,Ligue 1,22,1996,0.1,0,0,0,0,0,0,0,0.0,0,0,0,0,0,0,0,0,0,2018-2019,90.0,0.0,0.0
Rk,Player,Nation,Pos,Squad,Comp,0,0,90.0,0,0,3,3,3,Tkl,0,0.0,0,0,0,0,0,0,0,0,0,2018-2019,90.0,0.0,0.0
1951,Lenny Pintor,FRA,FW,Lyon,Ligue 1,17,2000,0.0,0,0,0,0,0,0,0,0.0,0,0,0,0,0,0,0,0,0,2018-2019,,,
1952,Gerard Piqué,ESP,DF,Barcelona,La Liga,31,1987,35.0,42,27,25,17,0,24,37,64.9,13,41,27,14,36,78,154,5,0,2018-2019,90.0,92.57142857142857,108.0
1953,Facundo Píriz,URU,"MF,FW",Montpellier,Ligue 1,28,1990,1.3,9,6,3,4,2,4,9,44.4,5,2,1,1,0,9,2,0,0,2018-2019,90.0,0.0,623.076923076923
1954,Fabio Pisacane,ITA,DF,Cagliari,Serie A,32,1986,25.2,33,17,22,8,3,18,31,58.1,13,36,23,13,23,56,108,0,0,2018-2019,90.0,82.14285714285715,117.85714285714288
1955,Łukasz Piszczek,POL,DF,Dortmund,Bundesliga,33,1985,19.5,57,36,34,15,8,18,33,54.5,15,26,3,23,39,96,69,0,0,2018-2019,90.0,180.0,263.0769230769231
1956,Claudio Pizarro,PER,FW,Werder Bremen,Bundesliga,39,1978,7.7,10,6,4,2,4,4,7,57.1,3,14,1,13,1,11,7,0,0,2018-2019,90.0,11.688311688311689,116.88311688311688
1957,Marko Pjaca,CRO,"FW,MF",Fiorentina,Serie A,23,1995,8.3,9,4,3,4,2,2,6,33.3,4,2,0,2,7,16,6,0,0,2018-2019,90.0,75.90361445783131,97.59036144578312
1958,Miralem Pjanić,BIH,MF,Juventus,Serie A,28,1990,25.3,41,20,15,18,8,16,59,27.1,43,34,6,28,36,77,19,2,0,2018-2019,89.99999999999999,128.06324110671935,145.84980237154147
1959,Carles Planas,ESP,DF,Girona,La Liga,27,1991,4.7,12,6,7,5,0,4,11,36.4,7,2,0,2,4,16,15,0,0,2018-2019,90.0,76.59574468085106,229.78723404255317
1960,Óscar Plano,ESP,"MF,FW",Valladolid,La Liga,27,1991,29.9,63,45,23,28,12,14,48,29.2,34,19,3,16,22,85,28,1,0,2018-2019,90.0,66.22073578595318,189.63210702341138
1961,Jaroslav Plašil,CZE,MF,Bordeaux,Ligue 1,36,1982,16.0,34,26,11,20,3,18,44,40.9,26,21,5,16,19,53,28,1,0,2018-2019,90.0,106.875,191.25
1962,Marvin Plattenhardt,GER,DF,Hertha BSC,Bundesliga,26,1992,21.4,27,21,12,10,5,14,21,66.7,7,18,3,15,7,34,56,0,0,2018-2019,90.0,29.4392523364486,113.5514018691589
1963,Stiven Plaza,ECU,"FW,MF",Valladolid,La Liga,19,1999,0.4,0,0,0,0,0,0,0,0.0,0,0,0,0,0,0,0,0,0,2018-2019,90.0,0.0,0.0
1964,Alassane Pléa,FRA,FW,Gladbach,Bundesliga,25,1993,27.8,14,10,7,4,3,5,22,22.7,17,17,2,15,3,17,15,2,0,2018-2019,90.0,9.712230215827338,45.32374100719424
1965,Luca Plogmann,GER,GK,Werder Bremen,Bundesliga,18,2000,0.4,0,0,0,0,0,0,0,0.0,0,0,0,0,0,0,0,0,0,2018-2019,90.0,0.0,0.0
1966,Morgan Poaty,CGO,MF,Montpellier,Ligue 1,21,1997,1.0,1,1,1,0,0,0,0,0.0,0,1,0,1,0,1,2,0,0,2018-2019,90.0,0.0,90.0
1967,Paul Pogba,FRA,MF,Manchester Utd,Premier League,25,1993,33.4,47,30,21,21,5,17,43,39.5,26,30,9,21,18,65,39,0,0,2018-2019,90.0,48.50299401197605,126.64670658682634
1968,Denis-Will Poha,FRA,MF,Rennes,Ligue 1,21,1997,0.3,0,0,0,0,0,0,1,0.0,1,0,0,0,1,1,1,0,0,2018-2019,90.0,300.0,0.0
1969,Andrea Poli,ITA,MF,Bologna,Serie A,28,1989,21.5,65,47,30,28,7,24,67,35.8,43,36,5,31,35,100,13,2,0,2018-2019,90.0,146.51162790697674,272.09302325581393
1970,Matteo Politano,ITA,FW,Inter,Serie A,24,1993,28.3,18,7,9,4,5,8,30,26.7,22,18,0,18,14,32,10,1,0,2018-2019,90.0,44.522968197879855,57.243816254416956
1971,Pierre-Yves Polomat,FRA,DF,Saint-Étienne,Ligue 1,24,1993,10.6,18,13,11,6,1,10,18,55.6,8,4,2,2,21,39,27,0,0,2018-2019,90.0,178.30188679245285,152.83018867924528
1972,Giacomo Poluzzi,ITA,GK,SPAL,Serie A,30,1988,0.1,0,0,0,0,0,0,0,0.0,0,0,0,0,0,0,0,0,0,2018-2019,90.0,0.0,0.0
1973,Pere Pons,ESP,MF,Girona,La Liga,25,1993,31.0,83,46,34,38,11,30,82,36.6,52,48,12,36,35,118,39,0,0,2018-2019,90.0,101.61290322580645,240.96774193548387
1974,Pedro Porro,ESP,DF,Girona,La Liga,18,1999,24.6,51,31,28,16,7,32,80,40.0,48,36,2,34,39,90,60,1,0,2018-2019,89.99999999999999,142.68292682926827,186.58536585365852
1975,Manolo Portanova,ITA,MF,Juventus,Serie A,18,2000,0.4,1,1,0,1,0,0,1,0.0,1,2,0,2,1,2,2,0,0,2018-2019,90.0,225.0,225.0
Rk,Player,Nation,Pos,Squad,Comp,0,0,90.0,0,0,3,3,3,Tkl,0,0.0,0,0,0,0,0,0,0,0,0,2018-2019,90.0,0.0,0.0
1976,Francisco Portillo,ESP,MF,Getafe,La Liga,28,1990,22.2,26,16,6,15,5,9,29,31.0,20,14,0,14,17,43,9,0,0,2018-2019,90.0,68.91891891891892,105.40540540540542
1977,Portu,ESP,"FW,MF",Girona,La Liga,26,1992,31.3,33,24,8,15,10,12,43,27.9,31,16,1,15,8,41,5,0,0,2018-2019,90.0,23.003194888178914,94.88817891373802
1978,Stefan Posch,AUT,DF,Hoffenheim,Bundesliga,21,1997,15.6,45,32,28,15,2,17,28,60.7,11,26,11,15,21,66,58,0,0,2018-2019,90.0,121.15384615384615,259.6153846153846
1979,Sergio Postigo,ESP,DF,Levante,La Liga,29,1988,16.1,25,15,22,3,0,15,19,78.9,4,21,12,9,20,45,77,0,0,2018-2019,90.0,111.80124223602483,139.75155279503105
1980,Yussuf Poulsen,DEN,FW,RB Leipzig,Bundesliga,24,1994,27.2,20,10,5,10,5,3,25,12.0,22,33,2,31,7,27,28,0,0,2018-2019,90.0,23.16176470588235,66.17647058823529
1981,Maxime Poundjé,FRA,DF,Bordeaux,Ligue 1,25,1992,28.2,48,35,34,12,2,31,62,50.0,31,24,5,19,29,77,79,0,0,2018-2019,89.99999999999999,92.5531914893617,153.1914893617021
1982,Gaëtan Poussin,FRA,GK,Bordeaux,Ligue 1,19,1999,1.0,0,0,0,0,0,0,0,0.0,0,0,0,0,0,0,0,0,0,2018-2019,90.0,0.0,0.0
1983,José Pozo,ESP,MF,Rayo Vallecano,La Liga,22,1996,18.0,13,10,4,5,4,4,25,16.0,21,7,1,6,4,17,6,0,0,2018-2019,90.0,20.0,65.0
1984,Dennis Praet,BEL,MF,Sampdoria,Serie A,24,1994,32.1,62,44,30,25,7,27,51,52.9,24,33,4,29,36,98,31,0,0,2018-2019,90.0,100.93457943925233,173.83177570093457
1985,Sanjin Prcić,BIH,MF,Levante,La Liga,24,1993,5.9,18,13,7,9,2,5,11,45.5,6,11,7,4,11,29,11,1,0,2018-2019,90.0,167.79661016949152,274.57627118644064
1986,Sanjin Prcić,BIH,MF,Strasbourg,Ligue 1,24,1993,11.7,19,14,11,7,1,8,18,44.4,10,22,8,14,18,37,7,1,0,2018-2019,89.99999999999999,138.46153846153845,146.15384615384616
1987,Nicolas de Préville,FRA,"FW,MF",Bordeaux,Ligue 1,27,1991,14.1,28,19,10,15,3,8,29,27.6,21,23,1,22,10,38,21,1,0,2018-2019,89.99999999999999,63.82978723404255,178.72340425531914
1988,Edgar Prib,GER,MF,Hannover 96,Bundesliga,28,1989,2.2,10,9,3,5,2,2,4,50.0,2,4,0,4,2,12,1,0,0,2018-2019,90.0,81.81818181818181,409.09090909090907
1989,Alex Pritchard,ENG,"MF,FW",Huddersfield,Premier League,25,1993,23.1,36,24,10,18,8,10,35,28.6,25,26,2,24,17,53,9,0,0,2018-2019,89.99999999999999,66.23376623376622,140.25974025974023
1990,Sebastian Prödl,AUT,DF,Watford,Premier League,31,1987,0.1,0,0,0,0,0,0,0,0.0,0,0,0,0,0,0,0,0,0,2018-2019,90.0,0.0,0.0
1991,Quincy Promes,NED,"FW,DF",Sevilla,La Liga,26,1992,17.6,35,25,23,9,3,15,22,68.2,7,19,3,16,25,60,22,1,0,2018-2019,90.0,127.84090909090908,178.97727272727272
1992,Davy Pröpper,NED,MF,Brighton,Premier League,26,1991,28.3,50,28,23,21,6,16,52,30.8,36,21,6,15,53,103,37,0,0,2018-2019,90.0,168.55123674911658,159.01060070671377
1993,Silvio Proto,BEL,GK,Lazio,Serie A,35,1983,2.0,0,0,0,0,0,0,1,0.0,1,0,0,0,0,0,1,0,0,2018-2019,90.0,0.0,0.0
1994,Ivan Provedel,ITA,GK,Empoli,Serie A,24,1994,16.0,0,0,0,0,0,0,1,0.0,1,0,0,0,0,0,4,0,0,2018-2019,90.0,0.0,0.0
1995,Javi Puado,ESP,"FW,MF",Espanyol,La Liga,20,1998,4.0,2,1,0,2,0,0,7,0.0,7,5,1,4,6,8,4,0,0,2018-2019,90.0,135.0,45.0
1996,Manuel Pucciarelli,ITA,FW,Chievo,Serie A,27,1991,3.4,4,2,2,1,1,2,5,40.0,3,5,0,5,3,7,4,0,0,2018-2019,90.0,79.41176470588235,105.88235294117646
1997,Riqui Puig,ESP,MF,Barcelona,La Liga,18,1999,1.7,3,3,0,2,1,2,3,66.7,1,0,0,0,0,3,1,0,0,2018-2019,90.0,0.0,158.8235294117647
1998,Erick Pulgar,CHI,MF,Bologna,Serie A,24,1994,26.2,65,36,35,23,7,22,73,30.1,51,35,5,30,50,115,54,1,0,2018-2019,90.0,171.7557251908397,223.28244274809163
1999,Jorge Pulido,ESP,DF,Huesca,La Liga,27,1991,30.9,63,42,40,19,4,32,51,62.7,19,39,18,21,50,113,158,0,0,2018-2019,90.0,145.63106796116506,183.49514563106797
2000,Christian Pulisic,USA,FW,Dortmund,Bundesliga,19,1998,10.4,10,6,2,6,2,2,6,33.3,4,12,2,10,6,16,10,0,0,2018-2019,90.0,51.92307692307692,86.53846153846153
Rk,Player,Nation,Pos,Squad,Comp,0,0,90.0,0,0,3,3,3,Tkl,0,0.0,0,0,0,0,0,0,0,0,0,2018-2019,90.0,0.0,0.0
2001,Jason Puncheon,ENG,MF,Crystal Palace,Premier League,32,1986,0.1,1,1,1,0,0,0,0,0.0,0,0,0,0,0,1,0,0,0,2018-2019,90.0,0.0,900.0
2002,Jason Puncheon,ENG,MF,Huddersfield,Premier League,32,1986,4.2,7,4,1,5,1,1,7,14.3,6,3,1,2,3,10,8,0,0,2018-2019,90.0,64.28571428571428,150.0
2003,Ignacio Pussetto,ARG,"FW,MF",Udinese,Serie A,22,1995,24.2,65,40,25,30,10,15,43,34.9,28,28,3,25,29,94,34,0,0,2018-2019,90.0,107.85123966942149,241.73553719008262
2004,Fabio Quagliarella,ITA,FW,Sampdoria,Serie A,35,1983,35.5,14,8,6,4,4,2,15,13.3,13,32,1,31,8,22,17,0,0,2018-2019,90.0,20.281690140845072,35.49295774647887
2005,Robin Quaison,SWE,"FW,MF",Mainz 05,Bundesliga,24,1993,24.4,19,12,3,10,6,5,12,41.7,7,9,1,8,7,26,4,0,0,2018-2019,90.0,25.819672131147545,70.08196721311477
2006,Collin Quaner,GER,FW,Huddersfield,Premier League,27,1991,0.4,0,0,0,0,0,0,1,0.0,1,0,0,0,0,0,0,0,0,2018-2019,90.0,0.0,0.0
2007,Domingos Quina,POR,MF,Watford,Premier League,18,1999,3.8,9,7,3,5,1,3,11,27.3,8,6,0,6,3,12,1,0,0,2018-2019,90.0,71.05263157894737,213.1578947368421
2008,Xavi Quintillà,ESP,DF,Villarreal,La Liga,21,1996,7.0,10,4,5,4,1,6,12,50.0,6,5,2,3,8,18,17,0,0,2018-2019,90.0,102.85714285714286,128.57142857142856
2009,Dani Raba,ESP,"MF,FW",Villarreal,La Liga,22,1995,2.1,6,5,1,2,3,1,5,20.0,4,1,0,1,1,7,0,0,0,2018-2019,90.0,42.857142857142854,257.1428571428571
2010,Adrien Rabiot,FRA,MF,Paris S-G,Ligue 1,23,1995,11.8,35,20,13,17,5,9,12,75.0,3,9,2,7,10,45,20,0,0,2018-2019,90.0,76.27118644067797,266.9491525423729
2011,Nemanja Radonjić,SRB,"FW,MF",Marseille,Ligue 1,22,1996,7.6,8,5,1,5,2,5,16,31.3,11,3,0,3,5,13,4,0,0,2018-2019,90.0,59.21052631578947,94.73684210526315
2012,Ivan Radovanović,SRB,MF,Genoa,Serie A,29,1988,14.2,20,12,11,8,1,8,17,47.1,9,12,4,8,13,33,20,1,0,2018-2019,90.0,82.3943661971831,126.7605633802817
2013,Ivan Radovanović,SRB,MF,Chievo,Serie A,29,1988,19.0,27,22,20,7,0,11,31,35.5,20,19,7,12,26,53,36,0,0,2018-2019,90.0,123.15789473684211,127.89473684210526
2014,Ionuț Radu,ROU,GK,Genoa,Serie A,21,1997,33.0,0,0,0,0,0,0,1,0.0,1,0,0,0,1,1,11,4,0,2018-2019,90.0,2.7272727272727275,0.0
2015,Ștefan Radu,ROU,DF,Lazio,Serie A,31,1986,24.9,43,27,24,15,4,25,38,65.8,13,20,14,6,42,85,85,1,0,2018-2019,90.0,151.80722891566265,155.42168674698794
2016,Rafael,BRA,DF,Lyon,Ligue 1,28,1990,11.4,31,19,14,12,5,17,24,70.8,7,19,2,17,15,46,30,2,0,2018-2019,90.0,118.42105263157893,244.73684210526315
2017,Raffael,BRA,FW,Gladbach,Bundesliga,33,1985,6.0,8,4,2,4,2,2,7,28.6,5,5,0,5,1,9,0,0,0,2018-2019,90.0,15.0,120.0
2018,Rafinha,BRA,"FW,MF",Barcelona,La Liga,25,1993,2.5,8,6,2,3,3,2,2,100.0,0,5,1,4,1,9,2,0,0,2018-2019,90.0,36.0,288.0
2019,Rafinha,BRA,DF,Bayern Munich,Bundesliga,32,1985,10.0,15,7,6,6,3,6,14,42.9,8,8,3,5,19,34,11,0,0,2018-2019,90.0,171.0,135.0
2020,Andrea Raggi,ITA,DF,Monaco,Ligue 1,34,1984,5.5,7,5,7,0,0,6,6,100.0,0,1,0,1,7,14,21,0,0,2018-2019,90.0,114.54545454545455,114.54545454545455
2021,Baba Rahman,GHA,DF,Reims,Ligue 1,24,1994,10.7,26,20,17,8,1,18,21,85.7,3,21,3,18,16,42,37,2,0,2018-2019,90.0,134.57943925233647,218.69158878504675
2022,Baba Rahman,GHA,DF,Schalke 04,Bundesliga,24,1994,1.8,3,1,1,1,1,1,1,100.0,0,3,0,3,2,5,2,0,0,2018-2019,90.0,100.0,150.0
2023,Ivan Rakitić,CRO,MF,Barcelona,La Liga,30,1988,29.4,30,24,10,14,6,12,37,32.4,25,32,8,24,51,81,33,0,0,2018-2019,90.0,156.12244897959184,91.83673469387756
2024,Joe Ralls,ENG,MF,Cardiff City,Premier League,24,1993,21.8,45,23,21,21,3,10,33,30.3,23,21,6,15,29,74,30,0,0,2018-2019,90.0,119.72477064220183,185.77981651376146
2025,Jonás Ramalho,ESP,DF,Girona,La Liga,25,1993,18.0,13,6,12,1,0,8,14,57.1,6,24,11,13,16,29,80,1,0,2018-2019,90.0,80.0,65.0
Rk,Player,Nation,Pos,Squad,Comp,0,0,90.0,0,0,3,3,3,Tkl,0,0.0,0,0,0,0,0,0,0,0,0,2018-2019,90.0,0.0,0.0
2026,Benito Raman,BEL,"MF,FW",Düsseldorf,Bundesliga,23,1994,18.7,35,20,14,16,5,11,53,20.8,42,30,2,28,15,50,8,0,0,2018-2019,90.0,72.19251336898395,168.44919786096256
2027,Adil Rami,FRA,DF,Marseille,Ligue 1,32,1985,15.7,14,9,12,2,0,8,12,66.7,4,14,14,0,18,32,52,3,0,2018-2019,90.0,103.18471337579619,80.2547770700637
2028,Gastón Ramírez,URU,MF,Sampdoria,Serie A,27,1990,17.5,38,22,12,18,8,11,31,35.5,20,28,4,24,8,46,27,0,0,2018-2019,90.0,41.14285714285714,195.42857142857142
2029,Sandro Ramírez,ESP,"FW,MF",Real Sociedad,La Liga,23,1995,11.7,19,10,7,10,2,4,11,36.4,7,12,1,11,9,28,3,0,0,2018-2019,89.99999999999999,69.23076923076923,146.15384615384616
2030,Iván Ramis,ESP,DF,Eibar,La Liga,33,1984,18.6,23,13,10,11,2,17,23,73.9,6,10,5,5,18,41,65,2,0,2018-2019,90.0,87.09677419354837,111.29032258064515
2031,Chris Ramos,ESP,FW,Valladolid,La Liga,21,1997,0.7,1,1,0,0,1,1,1,100.0,0,0,0,0,0,1,1,0,0,2018-2019,90.0,0.0,128.57142857142858
2032,Sergio Ramos,ESP,DF,Real Madrid,La Liga,32,1986,27.5,41,32,25,12,4,22,39,56.4,17,29,15,14,37,78,90,2,0,2018-2019,89.99999999999999,121.09090909090908,134.18181818181816
2033,Aaron Ramsey,WAL,MF,Arsenal,Premier League,27,1990,14.8,34,18,11,15,8,7,25,28.0,18,7,1,6,9,43,3,0,0,2018-2019,90.0,54.729729729729726,206.75675675675674
2034,Kayne Ramsey,ENG,DF,Southampton,Premier League,17,2000,1.0,0,0,0,0,0,0,0,0.0,0,0,0,0,0,0,7,0,0,2018-2019,90.0,0.0,0.0
2035,Andrea Ranocchia,ITA,"DF,FW",Inter,Serie A,30,1988,0.7,2,2,1,1,0,0,1,0.0,1,1,0,1,0,2,3,0,0,2018-2019,90.0,0.0,257.14285714285717
2036,Marcus Rashford,ENG,FW,Manchester Utd,Premier League,20,1997,25.9,24,12,4,12,8,7,29,24.1,22,27,0,27,3,27,24,0,0,2018-2019,90.0,10.424710424710426,83.39768339768341
2037,Milot Rashica,KVX,"FW,MF",Werder Bremen,Bundesliga,22,1996,17.2,24,16,8,11,5,9,24,37.5,15,16,2,14,6,30,6,1,0,2018-2019,90.0,31.395348837209305,125.58139534883722
2038,Jacob Rasmussen,DEN,"DF,MF",Empoli,Serie A,21,1997,11.3,18,12,10,6,2,5,14,35.7,9,18,13,5,12,30,55,1,0,2018-2019,90.0,95.57522123893806,143.36283185840708
2039,Giacomo Raspadori,ITA,DF,Sassuolo,Serie A,18,2000,0.0,0,0,0,0,0,0,0,0.0,0,0,0,0,0,0,0,0,0,2018-2019,,,
2040,Yoric Ravet,FRA,"FW,MF",Freiburg,Bundesliga,28,1989,0.8,2,1,1,0,1,1,2,50.0,1,2,1,1,0,2,1,0,0,2018-2019,90.0,0.0,225.0
2041,Tim Ream,USA,DF,Fulham,Premier League,30,1987,22.7,23,14,16,7,0,14,28,50.0,14,19,10,9,25,48,80,2,0,2018-2019,89.99999999999999,99.11894273127753,91.18942731277532
2042,Ante Rebić,CRO,"FW,MF",Eint Frankfurt,Bundesliga,24,1993,22.0,22,9,5,12,5,5,12,41.7,7,18,1,17,8,30,3,0,0,2018-2019,90.0,32.72727272727273,90.0
2043,Pedro Rebocho,POR,DF,Guingamp,Ligue 1,23,1995,36.0,61,35,31,22,8,29,54,53.7,25,48,13,35,40,101,92,1,0,2018-2019,90.0,100.0,152.5
2044,Arkadiusz Reca,POL,DF,Atalanta,Serie A,23,1995,0.5,2,0,1,0,1,0,1,0.0,1,0,0,0,3,5,0,0,0,2018-2019,90.0,540.0,360.0
2045,Recio,ESP,MF,Leganés,La Liga,27,1991,14.3,30,21,14,13,3,6,24,25.0,18,14,2,12,14,44,14,0,0,2018-2019,90.0,88.11188811188812,188.81118881118883
2046,Nathan Redmond,ENG,"MF,FW",Southampton,Premier League,24,1994,36.3,45,22,14,19,12,14,41,34.1,27,54,2,52,20,65,23,1,0,2018-2019,90.0,49.586776859504134,111.5702479338843
2047,Vasco Regini,ITA,"DF,FW",SPAL,Serie A,27,1990,0.9,1,0,0,1,0,1,3,33.3,2,2,1,1,0,1,4,0,0,2018-2019,90.0,0.0,100.0
2048,Sergio Reguilón,ESP,DF,Real Madrid,La Liga,21,1996,12.4,25,14,15,9,1,10,21,47.6,11,13,3,10,20,45,41,1,0,2018-2019,90.0,145.16129032258064,181.4516129032258
2049,Bobby Reid,JAM,"FW,MF",Cardiff City,Premier League,25,1993,15.8,16,9,6,7,3,3,8,37.5,5,13,0,13,3,19,12,0,0,2018-2019,90.0,17.088607594936708,91.1392405063291
2050,Pepe Reina,ESP,GK,Milan,Serie A,35,1982,3.7,0,0,0,0,0,0,0,0.0,0,0,0,0,0,0,1,0,0,2018-2019,90.0,0.0,0.0
Rk,Player,Nation,Pos,Squad,Comp,0,0,90.0,0,0,3,3,3,Tkl,0,0.0,0,0,0,0,0,0,0,0,0,2018-2019,90.0,0.0,0.0
2051,Jeff Reine-Adélaïde,FRA,"FW,MF",Angers,Ligue 1,20,1998,28.4,40,22,18,19,3,16,39,41.0,23,20,0,20,19,59,10,0,0,2018-2019,90.0,60.21126760563381,126.7605633802817
2052,Karim Rekik,NED,DF,Hertha BSC,Bundesliga,23,1994,23.0,36,22,23,12,1,12,18,66.7,6,24,16,8,34,70,88,0,0,2018-2019,90.0,133.04347826086956,140.8695652173913
2053,Loïc Rémy,FRA,FW,Lille,Ligue 1,31,1987,13.4,2,1,0,2,0,0,3,0.0,3,3,1,2,2,4,17,1,0,2018-2019,90.0,13.432835820895521,13.432835820895521
2054,Michael Rensing,GER,GK,Düsseldorf,Bundesliga,34,1984,32.0,2,1,2,0,0,1,5,20.0,4,1,0,1,2,4,13,2,0,2018-2019,90.0,5.625,5.625
2055,Marco Reus,GER,"MF,FW",Dortmund,Bundesliga,29,1989,25.7,33,22,11,16,6,6,31,19.4,25,28,1,27,8,41,32,0,0,2018-2019,90.0,28.01556420233463,115.56420233463035
2056,Elvis Rexhbeçaj,GER,MF,Wolfsburg,Bundesliga,20,1997,12.7,28,18,11,12,5,12,24,50.0,12,18,2,16,14,42,21,0,0,2018-2019,90.0,99.21259842519686,198.42519685039372
2057,Diego Reyes,MEX,DF,Leganés,La Liga,25,1992,3.6,7,4,4,3,0,3,4,75.0,1,4,4,0,7,14,17,1,0,2018-2019,90.0,175.0,175.0
2058,Baptiste Reynet,FRA,GK,Toulouse,Ligue 1,27,1990,30.0,0,0,0,0,0,0,3,0.0,3,0,0,0,1,1,14,2,0,2018-2019,90.0,3.0,0.0
2059,Simon Rhein,GER,MF,Nürnberg,Bundesliga,20,1998,5.5,7,4,7,0,0,2,7,28.6,5,6,1,5,7,14,6,0,0,2018-2019,90.0,114.54545454545455,114.54545454545455
2060,Franck Ribéry,FRA,"MF,FW",Bayern Munich,Bundesliga,35,1983,13.0,15,7,7,6,2,4,10,40.0,6,9,0,9,7,22,1,0,0,2018-2019,90.00000000000001,48.46153846153847,103.84615384615385
2061,Declan Rice,ENG,MF,West Ham,Premier League,19,1999,33.4,98,60,35,58,5,38,88,43.2,50,51,12,39,52,150,56,0,0,2018-2019,90.0,140.11976047904193,264.07185628742513
2062,Jazz Richards,WAL,"DF,MF",Cardiff City,Premier League,27,1991,1.5,0,0,0,0,0,0,1,0.0,1,2,1,1,2,2,5,0,0,2018-2019,90.0,120.0,0.0
2063,Richarlison,BRA,"FW,MF",Everton,Premier League,21,1997,29.6,49,34,19,20,10,8,24,33.3,16,30,2,28,16,65,39,0,0,2018-2019,90.0,48.648648648648646,148.98648648648648
2064,Marco Richter,GER,"MF,FW",Augsburg,Bundesliga,20,1997,15.8,13,8,4,5,4,7,20,35.0,13,16,1,15,13,26,9,1,0,2018-2019,90.0,74.0506329113924,74.0506329113924
2065,Diego Rico,ESP,"DF,MF",Bournemouth,Premier League,25,1993,6.8,14,9,8,2,4,4,12,33.3,8,13,2,11,14,28,20,0,0,2018-2019,90.0,185.2941176470588,185.2941176470588
2066,Mikel Rico,ESP,MF,Athletic Club,La Liga,33,1984,2.7,5,2,1,4,0,2,7,28.6,5,3,2,1,2,7,3,0,0,2018-2019,90.0,66.66666666666666,166.66666666666666
2067,Sergio Rico,ESP,GK,Fulham,Premier League,24,1993,29.0,1,1,1,0,0,1,1,100.0,0,0,0,0,1,2,13,5,0,2018-2019,90.0,3.103448275862069,3.103448275862069
2068,Asier Riesgo,ESP,GK,Eibar,La Liga,34,1983,14.0,1,1,1,0,0,1,3,33.3,2,0,0,0,0,1,8,1,0,2018-2019,90.0,0.0,6.428571428571429
2069,Sascha Riether,GER,FW,Schalke 04,Bundesliga,35,1983,0.0,0,0,0,0,0,0,0,0.0,0,0,0,0,0,0,0,0,0,2018-2019,,,
2070,Emiliano Rigoni,ARG,"FW,MF",Atalanta,Serie A,25,1993,5.8,6,1,2,2,2,2,6,33.3,4,3,0,3,3,9,3,0,0,2018-2019,90.0,46.55172413793103,93.10344827586206
2071,Luca Rigoni,ITA,MF,Parma,Serie A,33,1984,19.6,42,25,25,15,2,9,26,34.6,17,19,2,17,18,60,39,0,0,2018-2019,90.0,82.65306122448979,192.85714285714283
2072,Nicola Rigoni,ITA,MF,Chievo,Serie A,27,1990,21.7,43,25,22,15,6,22,51,43.1,29,20,5,15,23,66,45,1,0,2018-2019,90.0,95.39170506912443,178.34101382488478
2073,Kévin Rimane,GUF,MF,Paris S-G,Ligue 1,27,1991,0.1,0,0,0,0,0,0,0,0.0,0,0,0,0,0,0,0,0,0,2018-2019,90.0,0.0,0.0
2074,Tomás Rincón,VEN,MF,Torino,Serie A,30,1988,31.1,75,44,25,41,9,31,68,45.6,37,35,5,30,42,117,71,1,0,2018-2019,90.0,121.54340836012861,217.04180064308682
2075,Renaud Ripart,FRA,"FW,DF",Nîmes,Ligue 1,25,1993,33.4,76,49,41,22,13,32,76,42.1,44,43,7,36,27,103,79,0,0,2018-2019,90.0,72.75449101796407,204.79041916167665
Rk,Player,Nation,Pos,Squad,Comp,0,0,90.0,0,0,3,3,3,Tkl,0,0.0,0,0,0,0,0,0,0,0,0,2018-2019,90.0,0.0,0.0
2076,Mihailo Ristić,SRB,"DF,MF",Montpellier,Ligue 1,22,1995,3.6,14,9,8,5,1,6,10,60.0,4,11,3,8,9,23,6,0,0,2018-2019,90.0,225.0,350.0
2077,Matt Ritchie,SCO,"DF,MF",Newcastle Utd,Premier League,28,1989,32.5,70,44,35,27,8,19,47,40.4,28,34,11,23,51,121,76,1,0,2018-2019,90.0,141.23076923076923,193.84615384615384
2078,Cristian Rivera,ESP,MF,Huesca,La Liga,21,1997,18.8,38,25,18,19,1,11,25,44.0,14,21,4,17,31,69,31,0,0,2018-2019,90.0,148.40425531914892,181.91489361702128
2079,Arjen Robben,NED,"FW,MF",Bayern Munich,Bundesliga,34,1984,6.3,3,1,0,3,0,0,1,0.0,1,6,1,5,3,6,0,0,0,2018-2019,90.0,42.85714285714286,42.85714285714286
2080,Rober,ESP,DF,Levante,La Liga,23,1995,31.7,41,29,33,6,2,24,48,50.0,24,52,36,16,51,92,129,2,0,2018-2019,90.0,144.79495268138803,116.40378548895899
2081,Sergi Roberto,ESP,"DF,MF",Barcelona,La Liga,26,1992,23.2,28,20,15,9,4,16,24,66.7,8,18,3,15,43,71,31,0,0,2018-2019,90.0,166.81034482758622,108.62068965517241
2082,Patrick Roberts,ENG,"MF,FW",Girona,La Liga,21,1997,6.7,7,6,5,2,0,3,15,20.0,12,5,0,5,3,10,2,1,0,2018-2019,90.0,40.298507462686565,94.02985074626865
2083,Andrew Robertson,SCO,DF,Liverpool,Premier League,24,1994,35.7,80,49,41,31,8,39,70,55.7,31,33,6,27,29,109,57,3,0,2018-2019,90.0,73.10924369747899,201.68067226890753
2084,Joel Robles,ESP,GK,Betis,La Liga,28,1990,5.0,1,0,1,0,0,1,1,100.0,0,0,0,0,0,1,5,1,0,2018-2019,90.0,0.0,18.0
2085,Marc Roca,ESP,MF,Espanyol,La Liga,21,1996,34.6,71,45,36,26,9,28,70,40.0,42,43,21,22,36,107,60,3,0,2018-2019,90.0,93.64161849710982,184.68208092485548
2086,Christopher Rocchia,FRA,DF,Marseille,Ligue 1,20,1998,0.0,0,0,0,0,0,0,0,0.0,0,0,0,0,0,0,1,0,0,2018-2019,,,
2087,Kenny Rocha Santos,CPV,MF,Saint-Étienne,Ligue 1,18,2000,0.0,0,0,0,0,0,0,0,0.0,0,0,0,0,0,0,0,0,0,2018-2019,,,
2088,Rubén Rochina,ESP,MF,Levante,La Liga,27,1991,20.0,51,33,26,16,9,23,81,28.4,58,29,0,29,21,72,19,1,0,2018-2019,90.0,94.5,229.5
2089,Sebastian Rode,GER,MF,Eint Frankfurt,Bundesliga,27,1990,10.3,31,19,17,9,5,16,35,45.7,19,17,0,17,19,50,14,0,0,2018-2019,90.0,166.01941747572815,270.873786407767
2090,Ronny Rodelin,FRA,"MF,FW",Guingamp,Ligue 1,28,1989,8.8,13,5,2,7,4,3,8,37.5,5,8,1,7,8,21,13,0,0,2018-2019,90.0,81.81818181818181,132.95454545454544
2091,Rodri,ESP,MF,Atlético Madrid,La Liga,22,1996,30.4,103,70,45,50,8,39,75,52.0,36,35,11,24,41,144,68,0,0,2018-2019,90.0,121.38157894736841,304.9342105263158
2092,Rodrigo,ESP,FW,Valencia,La Liga,27,1991,28.1,21,10,6,9,6,3,17,17.6,14,17,1,16,3,24,18,0,0,2018-2019,90.0,9.608540925266903,67.25978647686833
2093,Kévin Rodrigues,POR,DF,Real Sociedad,La Liga,24,1994,5.4,21,11,14,6,1,9,17,52.9,8,13,3,10,8,29,15,0,0,2018-2019,90.0,133.33333333333331,350.0
2094,Alejandro Rodríguez,ESP,MF,Empoli,Serie A,27,1991,0.3,0,0,0,0,0,0,0,0.0,0,0,0,0,0,0,1,0,0,2018-2019,90.0,0.0,0.0
2095,Ángel Rodríguez,ESP,FW,Getafe,La Liga,31,1987,20.2,16,7,1,6,9,6,26,23.1,20,15,1,14,8,24,8,0,0,2018-2019,90.0,35.64356435643565,71.2871287128713
2096,Óscar Rodríguez Arnaiz,ESP,MF,Leganés,La Liga,20,1998,27.8,46,25,26,15,5,16,58,27.6,42,12,2,10,16,62,16,0,0,2018-2019,90.0,51.79856115107914,148.9208633093525
2097,James Rodríguez,COL,MF,Bayern Munich,Bundesliga,27,1991,12.6,12,8,3,4,5,5,19,26.3,14,9,0,9,4,16,1,0,0,2018-2019,90.0,28.571428571428573,85.71428571428572
2098,Ricardo Rodríguez,SUI,DF,Milan,Serie A,25,1992,33.9,57,32,34,21,2,32,39,82.1,7,25,5,20,38,95,98,0,0,2018-2019,90.0,100.88495575221239,151.3274336283186
2099,Marko Rog,CRO,MF,Napoli,Serie A,23,1995,3.7,12,9,3,7,2,5,11,45.5,6,8,2,6,5,17,1,0,0,2018-2019,90.0,121.62162162162161,291.8918918918919
2100,Marko Rog,CRO,MF,Sevilla,La Liga,23,1995,4.0,12,11,4,8,0,5,9,55.6,4,4,0,4,8,20,1,0,0,2018-2019,90.0,180.0,270.0
Rk,Player,Nation,Pos,Squad,Comp,0,0,90.0,0,0,3,3,3,Tkl,0,0.0,0,0,0,0,0,0,0,0,0,2018-2019,90.0,0.0,0.0
2101,Rogério,BRA,"DF,MF",Sassuolo,Serie A,20,1998,29.7,55,38,35,13,7,30,55,54.5,25,32,7,25,37,92,109,1,0,2018-2019,90.0,112.12121212121211,166.66666666666666
2102,Marcos Rojo,ARG,DF,Manchester Utd,Premier League,28,1990,2.4,5,3,3,2,0,1,6,16.7,5,3,2,1,6,11,9,1,0,2018-2019,90.0,225.00000000000003,187.5
2103,Diego Rolán,URU,"MF,FW",Leganés,La Liga,25,1993,2.4,6,4,3,3,0,2,9,22.2,7,2,0,2,3,9,3,0,0,2018-2019,90.0,112.50000000000001,225.00000000000003
2104,Diego Rolán,URU,"MF,FW",Alavés,La Liga,25,1993,3.3,7,4,3,1,3,0,2,0.0,2,1,0,1,1,8,4,0,0,2018-2019,90.0,27.272727272727273,190.9090909090909
2105,Rolando,POR,DF,Marseille,Ligue 1,32,1985,8.9,18,7,15,3,0,8,10,80.0,2,8,6,2,11,29,25,0,0,2018-2019,90.0,111.23595505617978,182.02247191011236
2106,Esteban Rolón,ARG,MF,Genoa,Serie A,23,1995,11.6,46,29,14,20,12,20,44,45.5,24,18,2,16,16,62,12,0,0,2018-2019,90.0,124.13793103448276,356.89655172413796
2107,Filippo Romagna,ITA,DF,Cagliari,Serie A,21,1997,16.4,14,9,10,4,0,4,8,50.0,4,20,12,8,19,33,68,0,0,2018-2019,90.0,104.26829268292684,76.82926829268294
2108,Alessio Romagnoli,ITA,DF,Milan,Serie A,23,1995,31.6,34,19,26,6,2,16,19,84.2,3,48,32,16,37,71,173,1,0,2018-2019,90.0,105.37974683544303,96.83544303797467
2109,Alaixys Romao,TOG,MF,Reims,Ligue 1,34,1984,35.1,118,71,61,50,7,43,102,42.2,59,44,16,28,58,176,65,1,0,2018-2019,90.0,148.7179487179487,302.56410256410254
2110,Cristian Romero,ARG,DF,Genoa,Serie A,20,1998,26.0,61,35,38,18,5,27,40,67.5,13,49,27,22,37,98,128,1,0,2018-2019,90.00000000000001,128.0769230769231,211.15384615384616
2111,Oriol Romeu,ESP,MF,Southampton,Premier League,26,1991,23.7,81,46,39,38,4,32,77,41.6,45,43,17,26,52,133,44,1,0,2018-2019,90.0,197.46835443037978,307.5949367088608
2112,Rômulo,ITA,"MF,FW",Genoa,Serie A,31,1987,15.0,26,18,9,10,7,7,17,41.2,10,16,3,13,18,44,20,0,0,2018-2019,90.0,108.0,156.0
2113,Rômulo,ITA,DF,Lazio,Serie A,31,1987,8.6,10,5,8,2,0,5,7,71.4,2,10,2,8,5,15,13,0,0,2018-2019,90.0,52.32558139534884,104.65116279069768
2114,Cristiano Ronaldo,POR,FW,Juventus,Serie A,33,1985,29.9,10,7,5,4,1,1,11,9.1,10,7,2,5,6,16,32,0,0,2018-2019,90.0,18.06020066889632,30.100334448160538
2115,Facundo Roncaglia,ARG,DF,Valencia,La Liga,31,1987,6.7,13,10,8,5,0,4,6,66.7,2,4,2,2,10,23,22,0,0,2018-2019,90.0,134.32835820895522,174.62686567164178
2116,Facundo Roncaglia,ARG,DF,Celta Vigo,La Liga,31,1987,11.9,34,22,26,8,0,17,24,70.8,7,12,5,7,20,54,51,2,0,2018-2019,90.00000000000001,151.26050420168067,257.14285714285717
2117,Salomón Rondón,VEN,FW,Newcastle Utd,Premier League,28,1989,28.9,8,3,2,4,2,4,24,16.7,20,14,3,11,5,13,39,0,0,2018-2019,90.00000000000001,15.570934256055365,24.913494809688583
2118,Valentin Rongier,FRA,MF,Nantes,Ligue 1,23,1994,35.8,86,54,24,46,16,26,65,40.0,39,46,6,40,33,119,19,0,0,2018-2019,90.0,82.96089385474862,216.2011173184358
2119,Marten de Roon,NED,MF,Atalanta,Serie A,27,1991,33.1,102,57,32,61,9,34,94,36.2,60,48,9,39,53,155,49,1,0,2018-2019,90.0,144.1087613293051,277.34138972809666
2120,Roberto Rosales,VEN,DF,Espanyol,La Liga,29,1988,19.4,48,31,22,16,10,21,44,47.7,23,19,7,12,22,70,68,0,0,2018-2019,90.0,102.0618556701031,222.68041237113405
2121,Danny Rose,ENG,DF,Tottenham,Premier League,28,1990,20.0,49,31,26,16,7,20,32,62.5,12,24,4,20,24,73,28,3,0,2018-2019,90.0,108.0,220.5
2122,Valentin Rosier,FRA,"DF,MF",Dijon,Ligue 1,21,1996,16.2,44,25,22,19,3,16,31,51.6,15,25,4,21,32,76,45,1,0,2018-2019,90.0,177.77777777777777,244.44444444444446
2123,Luca Rossettini,ITA,DF,Chievo,Serie A,33,1985,20.3,26,17,18,8,0,15,20,75.0,5,23,15,8,35,61,114,0,0,2018-2019,90.0,155.17241379310343,115.27093596059113
2124,Francesco Rossi,ITA,GK,Atalanta,Serie A,27,1991,0.0,0,0,0,0,0,0,0,0.0,0,0,0,0,0,0,0,0,0,2018-2019,,,
2125,Jérôme Roussillon,FRA,DF,Wolfsburg,Bundesliga,25,1993,27.3,42,29,25,15,2,20,30,66.7,10,50,7,43,31,73,54,0,0,2018-2019,90.0,102.19780219780219,138.46153846153845
Rk,Player,Nation,Pos,Squad,Comp,0,0,90.0,0,0,3,3,3,Tkl,0,0.0,0,0,0,0,0,0,0,0,0,2018-2019,90.0,0.0,0.0
2126,Nolan Roux,FRA,FW,Guingamp,Ligue 1,30,1988,17.1,11,9,0,6,5,4,14,28.6,10,6,2,4,4,15,21,0,0,2018-2019,90.0,21.05263157894737,57.89473684210526
2127,Aaron Rowe,ENG,FW,Huddersfield,Premier League,17,2000,0.8,1,0,1,0,0,0,0,0.0,0,0,0,0,1,2,1,0,0,2018-2019,90.0,112.5,112.5
2128,Waldo Rubio,ESP,MF,Valladolid,La Liga,22,1995,5.5,4,2,3,1,0,1,6,16.7,5,2,0,2,1,5,8,1,0,2018-2019,90.0,16.363636363636363,65.45454545454545
2129,John Ruddy,ENG,GK,Wolves,Premier League,31,1986,1.0,0,0,0,0,0,0,0,0.0,0,0,0,0,0,0,0,0,0,2018-2019,90.0,0.0,0.0
2130,Antonio Rüdiger,GER,DF,Chelsea,Premier League,25,1993,31.9,34,16,27,6,1,15,27,55.6,12,15,8,7,32,66,96,1,0,2018-2019,90.0,90.28213166144201,95.92476489028213
2131,Sebastian Rudy,GER,MF,Schalke 04,Bundesliga,28,1990,15.1,44,24,11,27,6,11,41,26.8,30,23,2,21,15,59,15,0,0,2018-2019,90.0,89.40397350993378,262.25165562913907
2132,Stéphane Ruffier,FRA,GK,Saint-Étienne,Ligue 1,31,1986,37.0,2,2,2,0,0,2,4,50.0,2,0,0,0,0,2,18,3,0,2018-2019,90.0,0.0,4.864864864864865
2133,Daniele Rugani,ITA,DF,Juventus,Serie A,24,1994,15.0,8,5,5,3,0,2,5,40.0,3,19,14,5,16,24,51,1,0,2018-2019,90.0,96.0,48.0
2134,Mário Rui,POR,DF,Napoli,Serie A,27,1991,15.7,24,18,9,12,3,14,25,56.0,11,15,3,12,21,45,38,0,0,2018-2019,90.0,120.38216560509555,137.57961783439492
2135,Abel Ruiz,ESP,FW,Barcelona,La Liga,18,2000,0.2,1,1,1,0,0,1,1,100.0,0,0,0,0,0,1,0,0,0,2018-2019,90.0,0.0,450.0
2136,Fabián Ruiz Peña,ESP,MF,Napoli,Serie A,22,1996,22.1,54,33,22,25,7,20,46,43.5,26,23,4,19,21,75,29,2,0,2018-2019,90.0,85.52036199095022,219.90950226244343
2137,Víctor Ruiz,ESP,DF,Villarreal,La Liga,29,1989,21.9,28,19,20,6,2,13,18,72.2,5,28,16,12,38,66,67,1,0,2018-2019,90.0,156.16438356164386,115.06849315068494
2138,Gerónimo Rulli,ARG,GK,Real Sociedad,La Liga,26,1992,27.0,2,1,2,0,0,1,3,33.3,2,1,0,1,1,3,12,6,0,2018-2019,90.0,3.3333333333333335,6.666666666666667
2139,Lukas Rupp,GER,"MF,DF",Hoffenheim,Bundesliga,27,1991,0.3,1,1,0,0,1,0,0,0.0,0,0,0,0,0,1,0,0,0,2018-2019,90.0,0.0,300.0
2140,Marco Russ,GER,DF,Eint Frankfurt,Bundesliga,32,1985,4.2,7,2,5,2,0,4,6,66.7,2,2,2,0,7,14,8,0,0,2018-2019,90.0,150.0,150.0
2141,Mathew Ryan,AUS,GK,Brighton,Premier League,26,1992,34.0,1,0,1,0,0,1,2,50.0,1,0,0,0,0,1,13,1,0,2018-2019,90.0,0.0,2.6470588235294117
2142,Frederik Rønnow,DEN,GK,Eint Frankfurt,Bundesliga,25,1992,1.4,0,0,0,0,0,0,0,0.0,0,0,0,0,0,0,1,0,0,2018-2019,90.0,0.0,0.0
2143,Idriss Saadi,ALG,"FW,MF",Strasbourg,Ligue 1,26,1992,0.1,0,0,0,0,0,0,0,0.0,0,0,0,0,0,0,0,0,0,2018-2019,90.0,0.0,0.0
2144,Youssouf Sabaly,SEN,DF,Bordeaux,Ligue 1,25,1993,21.2,46,32,32,12,2,25,46,54.3,21,19,2,17,26,72,42,0,0,2018-2019,90.0,110.37735849056604,195.28301886792454
2145,Abdelhamid Sabiri,MAR,FW,Huddersfield,Premier League,21,1996,0.5,2,1,1,1,0,0,0,0.0,0,1,0,1,1,3,0,0,0,2018-2019,90.0,180.0,360.0
2146,Marcel Sabitzer,AUT,MF,RB Leipzig,Bundesliga,24,1994,26.1,45,28,17,21,7,18,46,39.1,28,21,2,19,33,78,31,0,0,2018-2019,90.0,113.79310344827584,155.17241379310343
2147,Ihsan Sacko,FRA,FW,Nice,Ligue 1,21,1997,4.9,7,2,2,5,0,2,5,40.0,3,5,0,5,2,9,2,0,0,2018-2019,90.0,36.73469387755102,128.57142857142856
2148,Nuri Şahin,TUR,MF,Werder Bremen,Bundesliga,29,1988,16.4,60,33,22,33,5,23,59,39.0,36,30,3,27,37,97,39,1,0,2018-2019,90.0,203.0487804878049,329.26829268292687
2149,Samuel Şahin-Radlinger,AUT,GK,Hannover 96,Bundesliga,25,1992,1.0,0,0,0,0,0,0,0,0.0,0,1,0,1,0,0,2,0,0,2018-2019,90.0,0.0,0.0
2150,Wesley Saïd,FRA,"FW,MF",Dijon,Ligue 1,23,1995,25.0,25,18,6,11,8,5,20,25.0,15,9,0,9,9,34,9,0,0,2018-2019,90.0,32.4,90.0
Rk,Player,Nation,Pos,Squad,Comp,0,0,90.0,0,0,3,3,3,Tkl,0,0.0,0,0,0,0,0,0,0,0,0,2018-2019,90.0,0.0,0.0
2151,Allan Saint-Maximin,FRA,FW,Nice,Ligue 1,21,1997,32.2,12,6,1,7,4,2,14,14.3,12,11,0,11,4,16,3,0,0,2018-2019,90.0,11.180124223602483,33.54037267080745
2152,Théo Sainte-Luce,FRA,MF,Nîmes,Ligue 1,19,1998,0.0,0,0,0,0,0,0,0,0.0,0,0,0,0,0,0,0,0,0,2018-2019,,,
2153,Romain Saïss,MAR,"MF,DF",Wolves,Premier League,28,1990,12.8,39,26,23,14,2,20,37,54.1,17,25,12,13,26,65,61,0,0,2018-2019,90.0,182.8125,274.21875
2154,Samuel Sáiz,ESP,MF,Getafe,La Liga,27,1991,3.4,4,3,0,3,1,2,5,40.0,3,1,0,1,0,4,2,0,0,2018-2019,90.0,0.0,105.88235294117646
2155,Bukayo Saka,ENG,FW,Arsenal,Premier League,16,2001,0.1,0,0,0,0,0,0,0,0.0,0,0,0,0,0,0,0,0,0,2018-2019,90.0,0.0,0.0
2156,Hiroki Sakai,JPN,DF,Marseille,Ligue 1,28,1990,26.4,59,41,30,23,6,29,54,53.7,25,25,10,15,37,96,77,0,0,2018-2019,90.0,126.13636363636364,201.13636363636363
2157,Diafra Sakho,SEN,FW,Rennes,Ligue 1,28,1989,1.6,2,1,0,0,2,0,0,0.0,0,0,0,0,0,2,0,0,0,2018-2019,90.0,0.0,112.5
2158,Mamadou Sakho,FRA,DF,Crystal Palace,Premier League,28,1990,26.8,25,16,22,3,0,11,18,61.1,7,26,16,10,41,66,136,2,0,2018-2019,90.0,137.68656716417908,83.955223880597
2159,Bakary Sako,MLI,FW,Crystal Palace,Premier League,30,1988,0.3,2,1,2,0,0,1,1,100.0,0,0,0,0,0,2,0,0,0,2018-2019,90.0,0.0,600.0
2160,Emiliano Sala,ARG,FW,Nantes,Ligue 1,27,1990,15.2,7,5,0,2,5,1,8,12.5,7,8,1,7,2,9,20,0,0,2018-2019,90.0,11.842105263157894,41.44736842105263
2161,Jacopo Sala,ITA,DF,Sampdoria,Serie A,26,1991,16.9,38,23,20,14,4,23,41,56.1,18,11,3,8,20,58,47,2,0,2018-2019,90.0,106.50887573964498,202.36686390532546
2162,Mohamed Salah,EGY,FW,Liverpool,Premier League,26,1992,36.1,21,9,3,11,7,5,16,31.3,11,9,0,9,5,26,6,0,0,2018-2019,90.0,12.465373961218836,52.35457063711911
2163,Bartosz Salamon,POL,DF,Frosinone,Serie A,27,1991,19.2,17,10,12,5,0,6,14,42.9,8,27,19,8,27,44,143,1,0,2018-2019,90.0,126.56250000000001,79.6875
2164,Carlos Salcedo,MEX,DF,Eint Frankfurt,Bundesliga,24,1993,5.1,7,3,4,3,0,4,7,57.1,3,7,3,4,9,16,22,0,0,2018-2019,90.0,158.82352941176472,123.52941176470588
2165,William Saliba,FRA,DF,Saint-Étienne,Ligue 1,17,2001,14.2,32,20,28,4,0,16,24,66.7,8,11,10,1,28,60,44,2,0,2018-2019,90.0,177.46478873239437,202.81690140845072
2166,Yannis Salibur,FRA,"FW,MF",Saint-Étienne,Ligue 1,27,1991,9.8,9,5,1,7,1,1,7,14.3,6,6,0,6,8,17,4,0,0,2018-2019,90.0,73.46938775510203,82.65306122448979
2167,Yannis Salibur,FRA,MF,Guingamp,Ligue 1,27,1991,0.2,0,0,0,0,0,0,0,0.0,0,0,0,0,0,0,0,0,0,2018-2019,90.0,0.0,0.0
2168,Roland Sallai,HUN,MF,Freiburg,Bundesliga,21,1997,5.9,12,7,5,5,2,5,13,38.5,8,3,0,3,3,15,8,0,0,2018-2019,90.0,45.762711864406775,183.0508474576271
2169,Edgar Salli,CMR,"FW,MF",Nürnberg,Bundesliga,25,1992,1.3,2,1,1,1,0,0,1,0.0,1,0,0,0,1,3,1,0,0,2018-2019,90.0,69.23076923076923,138.46153846153845
2170,Brice Samba,FRA,GK,Caen,Ligue 1,24,1994,38.0,1,0,1,0,0,0,1,0.0,1,0,0,0,1,2,12,4,0,2018-2019,90.0,2.3684210526315788,2.3684210526315788
2171,Junior Sambia,FRA,"MF,FW",Montpellier,Ligue 1,21,1996,10.3,15,7,7,7,1,6,15,40.0,9,14,2,12,5,20,3,0,0,2018-2019,90.0,43.689320388349515,131.06796116504853
2172,Paolo Sammarco,ITA,MF,Frosinone,Serie A,35,1983,6.1,16,7,7,6,3,6,9,66.7,3,5,0,5,3,19,1,2,0,2018-2019,90.0,44.26229508196722,236.06557377049182
2173,Frédéric Sammaritano,FRA,"FW,MF",Dijon,Ligue 1,32,1986,6.0,11,5,5,5,1,5,13,38.5,8,8,1,7,8,19,2,1,0,2018-2019,90.0,120.0,165.0
2174,Mikel San José,ESP,MF,Athletic Club,La Liga,29,1989,19.3,43,25,19,19,5,15,48,31.3,33,27,6,21,21,64,35,0,0,2018-2019,90.0,97.92746113989637,200.5181347150259
2175,Antonio Sanabria,PAR,FW,Genoa,Serie A,22,1996,8.5,6,3,1,1,4,0,1,0.0,1,8,0,8,4,10,3,0,0,2018-2019,90.0,42.35294117647059,63.529411764705884
Rk,Player,Nation,Pos,Squad,Comp,0,0,90.0,0,0,3,3,3,Tkl,0,0.0,0,0,0,0,0,0,0,0,0,2018-2019,90.0,0.0,0.0
2176,Antonio Sanabria,PAR,FW,Betis,La Liga,22,1996,9.0,8,6,0,5,3,1,6,16.7,5,8,2,6,3,11,4,0,0,2018-2019,90.0,30.0,80.0
2177,Renato Sanches,POR,MF,Bayern Munich,Bundesliga,20,1997,6.4,5,5,2,1,2,3,10,30.0,7,7,0,7,4,9,2,0,0,2018-2019,90.0,56.25,70.3125
2178,Alexis Sánchez,CHI,"FW,MF",Manchester Utd,Premier League,29,1988,9.8,17,10,5,9,3,5,13,38.5,8,7,0,7,9,26,2,0,0,2018-2019,90.0,82.65306122448979,156.12244897959184
2179,Carlos Sánchez,COL,MF,West Ham,Premier League,32,1986,2.7,4,3,4,0,0,3,8,37.5,5,1,0,1,1,5,5,2,0,2018-2019,90.0,33.33333333333333,133.33333333333331
2180,Davinson Sánchez,COL,DF,Tottenham,Premier League,22,1996,21.6,37,20,28,9,0,20,37,54.1,17,17,9,8,30,67,103,2,0,2018-2019,90.0,124.99999999999999,154.16666666666666
2181,Javi Sánchez,ESP,DF,Real Madrid,La Liga,21,1997,0.5,1,0,1,0,0,0,0,0.0,0,0,0,0,0,1,4,0,0,2018-2019,90.0,0.0,180.0
2182,Víctor Sánchez,ESP,MF,Espanyol,La Liga,30,1987,14.1,45,30,21,17,7,14,67,20.9,53,17,2,15,25,70,25,0,0,2018-2019,89.99999999999999,159.57446808510636,287.23404255319144
2183,Jadon Sancho,ENG,"FW,MF",Dortmund,Bundesliga,18,2000,27.3,19,10,7,6,6,10,31,32.3,21,21,1,20,14,33,12,1,0,2018-2019,90.0,46.15384615384615,62.637362637362635
2184,Sandro,BRA,MF,Udinese,Serie A,29,1989,6.6,18,10,10,8,0,7,13,53.8,6,14,5,9,11,29,16,0,0,2018-2019,90.0,150.0,245.45454545454547
2185,Sandro,BRA,MF,Genoa,Serie A,29,1989,7.9,27,17,12,11,4,9,17,52.9,8,9,4,5,20,47,25,0,0,2018-2019,90.0,227.84810126582275,307.5949367088607
2186,Alex Sandro,BRA,DF,Juventus,Serie A,27,1991,26.5,68,45,28,33,7,21,36,58.3,15,32,8,24,38,106,71,0,0,2018-2019,90.0,129.0566037735849,230.94339622641508
2187,Leroy Sané,GER,FW,Manchester City,Premier League,22,1996,20.7,24,15,8,7,9,2,23,8.7,21,21,2,19,8,32,2,0,0,2018-2019,90.0,34.78260869565218,104.34782608695653
2188,Salif Sané,SEN,DF,Schalke 04,Bundesliga,27,1990,29.0,54,37,34,19,1,27,46,58.7,19,44,29,15,68,122,146,3,0,2018-2019,90.0,211.03448275862067,167.58620689655172
2189,Luca Sangalli,ESP,"MF,FW",Real Sociedad,La Liga,23,1995,11.1,19,13,6,11,2,5,22,22.7,17,9,1,8,5,24,5,0,0,2018-2019,90.0,40.54054054054055,154.05405405405406
2190,Ibrahim Sangaré,CIV,MF,Toulouse,Ligue 1,20,1997,27.4,102,66,50,44,8,32,63,50.8,31,52,20,32,29,131,49,2,0,2018-2019,90.0,95.25547445255475,335.036496350365
2191,Younousse Sankharé,SEN,MF,Bordeaux,Ligue 1,28,1989,16.4,25,12,2,19,4,6,19,31.6,13,14,0,14,9,34,4,0,0,2018-2019,90.0,49.39024390243903,137.19512195121953
2192,Baissama Sankoh,GUI,"MF,FW",Caen,Ligue 1,26,1992,7.2,4,1,4,0,0,1,4,25.0,3,8,1,7,5,9,16,0,0,2018-2019,90.0,62.5,50.0
2193,Yaya Sanogo,FRA,FW,Toulouse,Ligue 1,25,1993,13.8,4,2,0,2,2,2,4,50.0,2,3,0,3,3,7,15,0,0,2018-2019,90.0,19.565217391304344,26.08695652173913
2194,Morgan Sanson,FRA,MF,Marseille,Ligue 1,23,1994,26.7,70,47,27,35,8,21,77,27.3,56,40,1,39,42,112,8,1,0,2018-2019,90.00000000000001,141.5730337078652,235.9550561797753
2195,Nicola Sansone,ITA,FW,Bologna,Serie A,26,1991,12.7,29,17,9,14,6,9,27,33.3,18,13,1,12,9,38,4,0,0,2018-2019,90.0,63.77952755905512,205.51181102362204
2196,Nicola Sansone,ITA,"FW,MF",Villarreal,La Liga,26,1991,0.4,0,0,0,0,0,0,0,0.0,0,0,0,0,0,0,0,0,0,2018-2019,90.0,0.0,0.0
2197,Baptiste Santamaria,FRA,MF,Angers,Ligue 1,23,1995,36.1,118,60,48,63,7,51,106,48.1,55,41,4,37,57,175,57,2,0,2018-2019,90.0,142.10526315789474,294.1828254847645
2198,Roberto Santamaría,ESP,GK,Huesca,La Liga,33,1985,20.0,0,0,0,0,0,0,0,0.0,0,0,0,0,1,1,12,1,0,2018-2019,90.0,4.5,0.0
2199,Federico Santander,PAR,FW,Bologna,Serie A,27,1991,22.9,18,10,6,8,4,2,23,8.7,21,20,2,18,9,27,30,0,0,2018-2019,90.0,35.37117903930131,70.74235807860262
2200,Davide Santon,ITA,DF,Roma,Serie A,27,1991,11.2,14,6,8,6,0,8,12,66.7,4,11,7,4,15,29,27,0,0,2018-2019,90.0,120.53571428571429,112.5
Rk,Player,Nation,Pos,Squad,Comp,0,0,90.0,0,0,3,3,3,Tkl,0,0.0,0,0,0,0,0,0,0,0,0,2018-2019,90.0,0.0,0.0
2201,Michael Santos,URU,"FW,MF",Leganés,La Liga,25,1993,6.2,12,5,1,7,4,2,7,28.6,5,7,1,6,1,13,1,0,0,2018-2019,90.0,14.516129032258064,174.19354838709677
2202,Samir Santos,BRA,DF,Udinese,Serie A,23,1994,20.0,47,33,27,18,2,19,25,76.0,6,18,9,9,34,81,96,0,0,2018-2019,90.0,153.0,211.5
2203,Riccardo Saponara,ITA,MF,Sampdoria,Serie A,26,1991,10.1,12,6,2,6,4,3,12,25.0,9,5,1,4,4,16,10,0,0,2018-2019,90.0,35.64356435643565,106.93069306930693
2204,Pablo Sarabia,ESP,"MF,FW",Sevilla,La Liga,26,1992,30.3,30,15,6,15,9,6,47,12.8,41,30,3,27,22,52,20,0,0,2018-2019,90.0,65.34653465346534,89.10891089108911
2205,Marcelo Saracchi,URU,DF,RB Leipzig,Bundesliga,20,1998,7.3,17,11,12,4,1,8,13,61.5,5,12,1,11,11,28,14,0,0,2018-2019,90.0,135.6164383561644,209.58904109589042
2206,Josh Sargent,USA,FW,Werder Bremen,Bundesliga,18,2000,2.4,2,1,1,0,1,2,2,100.0,0,2,0,2,0,2,3,0,0,2018-2019,90.0,0.0,75.0
2207,Bouna Sarr,SEN,"DF,MF",Marseille,Ligue 1,26,1992,24.9,67,48,27,27,13,26,42,61.9,16,28,3,25,39,106,56,1,0,2018-2019,90.0,140.96385542168673,242.16867469879517
2208,Ismaila Sarr,SEN,"FW,MF",Rennes,Ligue 1,20,1998,31.0,35,24,16,15,4,17,34,50.0,17,17,2,15,14,49,4,0,0,2018-2019,90.0,40.645161290322584,101.61290322580645
2209,Malang Sarr,FRA,DF,Nice,Ligue 1,19,1999,33.3,59,36,38,17,4,31,57,54.4,26,29,12,17,68,127,107,2,0,2018-2019,90.0,183.78378378378378,159.45945945945945
2210,Lluís Sastre,ESP,MF,Huesca,La Liga,32,1986,1.3,5,3,0,5,0,0,1,0.0,1,0,0,0,1,6,0,0,0,2018-2019,90.0,69.23076923076923,346.15384615384613
2211,Marco Sau,ITA,"MF,FW",Sampdoria,Serie A,30,1987,0.6,0,0,0,0,0,0,0,0.0,0,1,0,1,0,0,0,0,0,2018-2019,90.0,0.0,0.0
2212,Marco Sau,ITA,"FW,MF",Cagliari,Serie A,30,1987,6.2,4,2,0,2,2,0,3,0.0,3,5,0,5,1,5,4,0,0,2018-2019,90.0,14.516129032258064,58.064516129032256
2213,Téji Savanier,FRA,MF,Nîmes,Ligue 1,26,1991,31.8,95,58,35,52,8,43,116,37.1,73,32,15,17,64,159,53,2,0,2018-2019,90.0,181.1320754716981,268.8679245283019
2214,Stefan Savić,MNE,DF,Atlético Madrid,La Liga,27,1991,15.5,11,10,9,2,0,7,12,58.3,5,13,9,4,22,33,67,0,0,2018-2019,90.0,127.74193548387098,63.87096774193549
2215,Fabian Schär,SUI,DF,Newcastle Utd,Premier League,26,1991,22.2,60,39,37,19,4,24,50,48.0,26,40,16,24,67,127,145,2,0,2018-2019,90.0,271.62162162162167,243.24324324324326
2216,Ezequiel Schelotto,ITA,DF,Chievo,Serie A,29,1989,1.6,3,0,3,0,0,2,3,66.7,1,1,0,1,2,5,8,0,0,2018-2019,90.0,112.5,168.75
2217,Nicolás Schiappacasse,URU,"FW,MF",Parma,Serie A,19,1999,0.9,0,0,0,0,0,0,0,0.0,0,2,0,2,0,0,0,0,0,2018-2019,90.0,0.0,0.0
2218,Pasquale Schiattarella,ITA,MF,SPAL,Serie A,31,1987,20.5,43,27,18,21,4,13,38,34.2,25,17,5,12,22,65,25,1,0,2018-2019,90.0,96.58536585365854,188.78048780487805
2219,Patrik Schick,CZE,"FW,MF",Roma,Serie A,22,1996,14.6,11,5,3,5,3,1,19,5.3,18,19,2,17,3,14,15,1,0,2018-2019,90.0,18.493150684931507,67.8082191780822
2220,Julian Schieber,GER,FW,Augsburg,Bundesliga,29,1989,2.9,3,2,1,2,0,0,1,0.0,1,1,0,1,1,4,3,0,0,2018-2019,90.0,31.03448275862069,93.10344827586206
2221,Christopher Schindler,GER,DF,Huddersfield,Premier League,28,1990,36.2,61,36,46,14,1,27,47,57.4,20,69,34,35,70,131,138,4,0,2018-2019,90.0,174.0331491712707,151.6574585635359
2222,Keven Schlotterbeck,GER,DF,Freiburg,Bundesliga,21,1997,8.6,22,16,19,2,1,8,12,66.7,4,17,11,6,13,35,26,0,0,2018-2019,90.0,136.046511627907,230.23255813953492
2223,Nico Schlotterbeck,GER,DF,Freiburg,Bundesliga,18,1999,2.5,6,6,6,0,0,2,2,100.0,0,3,1,2,5,11,10,0,0,2018-2019,90.0,180.0,216.0
2224,Jeffrey Schlupp,GHA,"MF,FW",Crystal Palace,Premier League,25,1992,18.6,41,20,18,18,5,10,27,37.0,17,30,8,22,19,60,27,1,0,2018-2019,90.0,91.93548387096773,198.3870967741935
2225,Kasper Schmeichel,DEN,GK,Leicester City,Premier League,31,1986,38.0,1,1,1,0,0,1,1,100.0,0,0,0,0,3,4,14,3,0,2018-2019,90.0,7.105263157894737,2.3684210526315788
Rk,Player,Nation,Pos,Squad,Comp,0,0,90.0,0,0,3,3,3,Tkl,0,0.0,0,0,0,0,0,0,0,0,0,2018-2019,90.0,0.0,0.0
2226,Marcel Schmelzer,GER,DF,Dortmund,Bundesliga,30,1988,6.3,10,5,7,2,1,5,9,55.6,4,7,1,6,9,19,14,0,0,2018-2019,90.0,128.57142857142858,142.85714285714286
2227,Jonathan Schmid,FRA,DF,Augsburg,Bundesliga,28,1990,28.0,44,22,23,19,2,16,28,57.1,12,22,8,14,43,87,70,2,0,2018-2019,90.0,138.21428571428572,141.42857142857142
2228,Morgan Schneiderlin,FRA,MF,Everton,Premier League,28,1989,9.3,24,16,11,11,2,6,14,42.9,8,16,3,13,15,39,16,0,0,2018-2019,90.0,145.16129032258064,232.258064516129
2229,Alessandro Schöpf,AUT,"MF,DF",Schalke 04,Bundesliga,24,1994,11.2,26,16,12,13,1,12,29,41.4,17,14,0,14,9,35,12,0,0,2018-2019,90.0,72.32142857142857,208.92857142857144
2230,Nico Schulz,GER,DF,Hoffenheim,Bundesliga,25,1993,28.2,34,20,19,12,3,15,36,41.7,21,32,4,28,24,58,36,0,0,2018-2019,89.99999999999999,76.59574468085106,108.51063829787233
2231,André Schürrle,GER,"FW,MF",Fulham,Premier League,27,1990,18.2,30,19,14,10,6,12,42,28.6,30,16,1,15,8,38,17,1,0,2018-2019,90.0,39.56043956043956,148.35164835164835
2232,Pirmin Schwegler,SUI,MF,Hannover 96,Bundesliga,31,1987,23.1,63,34,30,29,4,34,60,56.7,26,21,5,16,41,104,54,0,0,2018-2019,89.99999999999999,159.74025974025972,245.4545454545454
2233,Alexander Schwolow,GER,GK,Freiburg,Bundesliga,26,1992,33.0,0,0,0,0,0,0,1,0.0,1,0,0,0,0,0,13,2,0,2018-2019,90.0,0.0,0.0
2234,Matteo Scozzarella,ITA,MF,Parma,Serie A,30,1988,16.2,18,13,9,8,1,9,33,27.3,24,22,10,12,23,41,33,0,0,2018-2019,90.0,127.77777777777779,100.0
2235,Simone Scuffet,ITA,GK,Udinese,Serie A,22,1996,9.0,0,0,0,0,0,0,1,0.0,1,0,0,0,0,0,4,2,0,2018-2019,90.0,0.0,0.0
2236,Andrea Seculin,ITA,GK,Chievo,Serie A,28,1990,1.0,0,0,0,0,0,0,0,0.0,0,0,0,0,0,0,1,0,0,2018-2019,90.0,0.0,0.0
2237,Stanley Segarel,SMN,FW,Amiens,Ligue 1,24,1994,0.2,0,0,0,0,0,0,0,0.0,0,0,0,0,0,0,0,0,0,2018-2019,90.0,0.0,0.0
2238,Davie Selke,GER,FW,Hertha BSC,Bundesliga,23,1995,19.3,5,2,1,4,0,2,9,22.2,7,11,0,11,1,6,7,0,0,2018-2019,90.0,4.66321243523316,23.3160621761658
2239,Ole Selnæs,NOR,MF,Saint-Étienne,Ligue 1,24,1994,18.5,44,26,12,23,9,13,35,37.1,22,24,7,17,19,63,29,0,0,2018-2019,90.0,92.43243243243244,214.05405405405406
2240,Matz Sels,BEL,GK,Strasbourg,Ligue 1,26,1992,37.0,0,0,0,0,0,0,1,0.0,1,0,0,0,1,1,24,1,0,2018-2019,90.0,2.4324324324324325,0.0
2241,Ken Sema,SWE,"MF,FW",Watford,Premier League,24,1993,8.4,15,7,7,5,3,9,21,42.9,12,7,0,7,8,23,5,0,0,2018-2019,90.0,85.71428571428571,160.7142857142857
2242,Alfa Semedo,GNB,MF,Espanyol,La Liga,20,1997,0.5,0,0,0,0,0,0,3,0.0,3,1,1,0,2,2,0,0,0,2018-2019,90.0,360.0,0.0
2243,Nélson Semedo,POR,DF,Barcelona,La Liga,24,1993,17.8,38,27,23,12,3,12,18,66.7,6,23,7,16,22,60,26,0,0,2018-2019,90.0,111.23595505617978,192.13483146067415
2244,Rúben Semedo,POR,DF,Huesca,La Liga,24,1994,9.4,20,16,14,6,0,12,16,75.0,4,15,9,6,16,36,35,2,0,2018-2019,90.0,153.1914893617021,191.48936170212764
2245,Adrian Šemper,CRO,GK,Chievo,Serie A,20,1998,6.0,0,0,0,0,0,0,0,0.0,0,0,0,0,1,1,3,0,0,2018-2019,90.0,15.0,0.0
2246,Stefano Sensi,ITA,MF,Sassuolo,Serie A,22,1995,21.9,36,20,15,18,3,6,30,20.0,24,36,7,29,33,69,17,0,0,2018-2019,90.0,135.6164383561644,147.94520547945206
2247,Luigi Sepe,ITA,GK,Parma,Serie A,27,1991,37.0,1,1,1,0,0,1,2,50.0,1,0,0,0,3,4,21,3,0,2018-2019,90.0,7.297297297297297,2.4324324324324325
2248,Suat Serdar,GER,MF,Schalke 04,Bundesliga,21,1997,19.2,51,32,20,26,5,14,49,28.6,35,37,6,31,23,74,5,1,0,2018-2019,90.0,107.81250000000001,239.06250000000003
2249,Jean Seri,CIV,MF,Fulham,Premier League,27,1991,24.9,41,28,20,20,1,13,45,28.9,32,40,9,31,32,73,17,4,0,2018-2019,90.0,115.66265060240964,148.19277108433735
2250,Leonardo Sernicola,ITA,FW,Sassuolo,Serie A,21,1997,0.1,0,0,0,0,0,0,0,0.0,0,0,0,0,0,0,0,0,0,2018-2019,90.0,0.0,0.0
Rk,Player,Nation,Pos,Squad,Comp,0,0,90.0,0,0,3,3,3,Tkl,0,0.0,0,0,0,0,0,0,0,0,0,2018-2019,90.0,0.0,0.0
2251,Julien Serrano,FRA,"MF,DF",Monaco,Ligue 1,20,1998,1.3,5,4,3,2,0,3,6,50.0,3,1,0,1,3,8,3,0,0,2018-2019,90.0,207.69230769230768,346.15384615384613
2252,Grégory Sertic,FRA,MF,Marseille,Ligue 1,28,1989,1.2,2,0,1,1,0,0,1,0.0,1,2,1,1,1,3,2,0,0,2018-2019,90.0,75.0,150.0
2253,Ryan Sessegnon,ENG,"FW,DF",Fulham,Premier League,18,2000,25.6,22,14,8,8,6,6,22,27.3,16,25,2,23,19,41,49,1,0,2018-2019,90.0,66.796875,77.34375
2254,Paik Seung-ho,KOR,"FW,MF",Girona,La Liga,21,1997,0.7,0,0,0,0,0,0,1,0.0,1,1,0,1,3,3,1,0,0,2018-2019,90.0,385.7142857142857,0.0
2255,Stephan El Shaarawy,ITA,"FW,MF",Roma,Serie A,25,1992,23.4,27,14,14,8,5,9,24,37.5,15,11,2,9,20,47,9,0,0,2018-2019,89.99999999999999,76.92307692307692,103.84615384615384
2256,Meritan Shabani,ALB,MF,Bayern Munich,Bundesliga,19,1999,0.0,0,0,0,0,0,0,0,0.0,0,0,0,0,0,0,0,0,0,2018-2019,,,
2257,Xherdan Shaqiri,SUI,"FW,MF",Liverpool,Premier League,26,1991,11.8,14,4,3,9,2,9,19,47.4,10,6,1,5,6,20,6,0,0,2018-2019,90.0,45.762711864406775,106.77966101694915
2258,Luke Shaw,ENG,DF,Manchester Utd,Premier League,23,1995,28.8,55,29,17,31,7,28,47,59.6,19,42,12,30,21,76,93,2,0,2018-2019,90.0,65.625,171.875
2259,Jonjo Shelvey,ENG,MF,Newcastle Utd,Premier League,26,1992,10.5,22,12,10,9,3,8,17,47.1,9,10,3,7,7,29,15,0,0,2018-2019,90.0,60.0,188.57142857142856
2260,Gaku Shibasaki,JPN,"MF,FW",Getafe,La Liga,26,1992,4.3,7,3,2,4,1,3,6,50.0,3,2,0,2,3,10,4,0,0,2018-2019,90.0,62.79069767441861,146.51162790697677
2261,Gen Shoji,JPN,DF,Toulouse,Ligue 1,25,1992,18.0,24,13,16,8,0,11,24,45.8,13,22,14,8,21,45,56,0,0,2018-2019,90.0,105.0,120.0
2262,Djibril Sidibé,FRA,"DF,MF",Monaco,Ligue 1,26,1992,23.1,50,34,27,12,11,26,48,54.2,22,25,9,16,30,80,51,0,0,2018-2019,89.99999999999999,116.88311688311687,194.80519480519476
2263,Kalidou Sidibé,FRA,MF,Toulouse,Ligue 1,19,1999,14.0,24,12,11,12,1,7,15,46.7,8,16,3,13,17,41,26,1,0,2018-2019,90.0,109.28571428571428,154.28571428571428
2264,Sidnei,BRA,DF,Betis,La Liga,28,1989,19.4,48,29,33,12,3,18,34,52.9,16,21,8,13,41,89,57,0,0,2018-2019,90.0,190.20618556701032,222.68041237113405
2265,Francisco Sierralta,CHI,DF,Parma,Serie A,21,1997,3.0,11,8,8,3,0,4,6,66.7,2,1,1,0,4,15,27,0,0,2018-2019,90.0,120.0,330.0
2266,Gylfi Sigurðsson,ISL,MF,Everton,Premier League,28,1989,34.6,56,36,20,25,11,16,47,34.0,31,38,4,34,28,84,24,0,0,2018-2019,90.0,72.83236994219652,145.66473988439304
2267,Luca Siligardi,ITA,FW,Parma,Serie A,30,1988,18.2,30,20,10,13,7,8,23,34.8,15,19,3,16,15,45,11,0,0,2018-2019,90.0,74.17582417582418,148.35164835164835
2268,Adrien Silva,POR,MF,Leicester City,Premier League,29,1989,1.0,2,2,0,1,1,0,2,0.0,2,1,0,1,1,3,1,0,0,2018-2019,90.0,90.0,180.0
2269,Adrien Silva,POR,MF,Monaco,Ligue 1,29,1989,13.2,50,31,19,26,5,30,62,48.4,32,15,2,13,16,66,23,0,0,2018-2019,90.0,109.0909090909091,340.90909090909093
2270,André Silva,POR,FW,Sevilla,La Liga,22,1995,24.0,8,5,1,4,3,1,11,9.1,10,17,1,16,3,11,32,0,0,2018-2019,90.0,11.25,30.0
2271,Bernardo Silva,POR,"MF,FW",Manchester City,Premier League,23,1994,31.7,52,39,18,21,13,16,67,23.9,51,47,3,44,25,77,26,1,0,2018-2019,90.0,70.97791798107255,147.63406940063092
2272,David Silva,ESP,MF,Manchester City,Premier League,32,1986,26.7,30,18,12,11,7,1,20,5.0,19,18,1,17,22,52,15,0,0,2018-2019,90.00000000000001,74.15730337078652,101.12359550561798
2273,Gabriel Silva,BRA,DF,Saint-Étienne,Ligue 1,27,1991,15.9,19,10,13,6,0,6,17,35.3,11,15,3,12,14,33,60,1,0,2018-2019,90.0,79.24528301886792,107.54716981132076
2274,Jonathan Silva,ARG,"DF,FW",Leganés,La Liga,24,1994,30.0,51,38,30,17,4,23,52,44.2,29,23,2,21,29,80,86,0,0,2018-2019,90.0,87.0,153.0
2275,Matheus Pereira da Silva,BRA,MF,Juventus,Serie A,20,1998,1.0,3,2,0,2,1,2,4,50.0,2,1,0,1,0,3,1,0,0,2018-2019,90.0,0.0,270.0
Rk,Player,Nation,Pos,Squad,Comp,0,0,90.0,0,0,3,3,3,Tkl,0,0.0,0,0,0,0,0,0,0,0,0,2018-2019,90.0,0.0,0.0
2276,Thiago Silva,BRA,DF,Paris S-G,Ligue 1,33,1984,23.1,16,13,7,8,1,6,11,54.5,5,28,20,8,32,48,99,1,0,2018-2019,89.99999999999999,124.67532467532466,62.33766233766233
2277,Xande Silva,POR,FW,West Ham,Premier League,21,1997,0.2,0,0,0,0,0,0,0,0.0,0,1,0,1,0,0,0,0,0,2018-2019,90.0,0.0,0.0
2278,Matías Silvestre,ARG,DF,Empoli,Serie A,33,1984,34.0,31,17,22,5,4,17,26,65.4,9,29,24,5,21,52,165,0,0,2018-2019,90.0,55.588235294117645,82.05882352941177
2279,Giovanni Simeone,ARG,FW,Fiorentina,Serie A,23,1995,27.3,43,27,10,23,10,7,29,24.1,22,26,2,24,4,47,14,0,0,2018-2019,90.0,13.186813186813186,141.75824175824175
2280,Lorenco Šimić,CRO,DF,SPAL,Serie A,22,1996,2.6,6,3,5,1,0,2,4,50.0,2,2,1,1,12,18,19,1,0,2018-2019,90.0,415.38461538461536,207.69230769230768
2281,Moses Simon,NGA,"DF,MF",Levante,La Liga,23,1995,8.7,14,8,10,2,2,5,9,55.6,4,10,1,9,12,26,14,0,0,2018-2019,90.0,124.13793103448276,144.82758620689654
2282,Unai Simón,ESP,GK,Athletic Club,La Liga,21,1997,7.0,0,0,0,0,0,0,1,0.0,1,0,0,0,1,1,1,1,0,2018-2019,90.0,12.857142857142858,0.0
2283,Danny Simpson,ENG,DF,Leicester City,Premier League,31,1987,3.2,11,3,8,3,0,3,5,60.0,2,7,3,4,6,17,20,0,0,2018-2019,90.0,168.75,309.375
2284,Jack Simpson,ENG,DF,Bournemouth,Premier League,21,1996,4.5,9,5,8,1,0,6,9,66.7,3,5,4,1,9,18,25,2,0,2018-2019,90.0,180.0,180.0
2285,Josh Sims,ENG,MF,Southampton,Premier League,21,1997,2.4,1,0,1,0,0,1,3,33.3,2,2,0,2,1,2,1,0,0,2018-2019,90.0,37.5,37.5
2286,Giovanni Sio,CIV,FW,Montpellier,Ligue 1,29,1989,0.7,0,0,0,0,0,0,0,0.0,0,0,0,0,0,0,0,0,0,2018-2019,90.0,0.0,0.0
2287,Dimitris Siovas,GRE,DF,Leganés,La Liga,29,1988,32.9,57,32,38,18,1,27,47,57.4,20,32,15,17,65,122,155,1,0,2018-2019,90.0,177.8115501519757,155.92705167173253
2288,Salvatore Sirigu,ITA,GK,Torino,Serie A,31,1987,35.2,0,0,0,0,0,0,2,0.0,2,0,0,0,2,2,21,1,0,2018-2019,90.0,5.113636363636363,0.0
2289,Ibrahima Sissoko,MLI,MF,Strasbourg,Ligue 1,20,1997,29.6,60,41,23,34,3,23,55,41.8,32,37,3,34,34,94,39,1,0,2018-2019,90.0,103.37837837837837,182.43243243243242
2290,Moussa Sissoko,FRA,"MF,FW",Tottenham,Premier League,28,1989,25.9,36,25,18,14,4,15,29,51.7,14,31,4,27,16,52,25,2,0,2018-2019,90.0,55.59845559845561,125.09652509652511
2291,Pione Sisto,DEN,"FW,MF",Celta Vigo,La Liga,23,1995,9.4,4,3,4,0,0,0,9,0.0,9,5,0,5,3,7,3,0,0,2018-2019,90.0,28.723404255319146,38.29787234042553
2292,Antonio Sivera,ESP,GK,Alavés,La Liga,21,1996,3.0,0,0,0,0,0,0,0,0.0,0,0,0,0,0,0,4,1,0,2018-2019,90.0,0.0,0.0
2293,Ellyes Skhiri,TUN,MF,Montpellier,Ligue 1,23,1995,34.3,105,58,31,64,10,43,91,47.3,48,60,7,53,60,165,41,0,0,2018-2019,90.0,157.43440233236154,275.5102040816327
2294,Oliver Skipp,ENG,MF,Tottenham,Premier League,17,2000,2.4,7,3,4,3,0,4,6,66.7,2,2,1,1,1,8,7,0,0,2018-2019,90.0,37.5,262.5
2295,Łukasz Skorupski,POL,GK,Bologna,Serie A,27,1991,38.0,0,0,0,0,0,0,0,0.0,0,0,0,0,3,3,12,4,0,2018-2019,90.0,7.105263157894737,0.0
2296,Milan Škriniar,SVK,DF,Inter,Serie A,23,1995,35.0,64,37,46,17,1,38,60,63.3,22,48,29,19,27,91,138,0,0,2018-2019,90.0,69.42857142857143,164.57142857142856
2297,Steven Skrzybski,GER,"FW,MF",Schalke 04,Bundesliga,25,1992,7.4,9,3,0,6,3,3,11,27.3,8,8,1,7,3,12,2,0,0,2018-2019,90.0,36.486486486486484,109.45945945945945
2298,Petar Škuletić,SRB,FW,Montpellier,Ligue 1,28,1990,6.7,9,5,4,2,3,1,15,6.7,14,7,1,6,3,12,14,1,0,2018-2019,90.0,40.298507462686565,120.89552238805969
2299,Callum Slattery,ENG,MF,Southampton,Premier League,19,1999,1.2,4,3,0,4,0,3,7,42.9,4,1,1,0,2,6,1,0,0,2018-2019,90.0,150.0,300.0
2300,Naïm Sliti,TUN,"MF,FW",Dijon,Ligue 1,26,1992,25.4,56,33,24,19,13,15,46,32.6,31,18,0,18,11,67,9,0,0,2018-2019,90.0,38.97637795275591,198.42519685039372
Rk,Player,Nation,Pos,Squad,Comp,0,0,90.0,0,0,3,3,3,Tkl,0,0.0,0,0,0,0,0,0,0,0,0,2018-2019,90.0,0.0,0.0
2301,Chris Smalling,ENG,DF,Manchester Utd,Premier League,28,1989,23.6,30,17,21,9,0,11,17,64.7,6,37,25,12,26,56,109,1,0,2018-2019,90.0,99.15254237288134,114.40677966101694
2302,Adam Smith,ENG,"DF,MF",Bournemouth,Premier League,27,1991,23.0,46,32,26,14,6,19,41,46.3,22,26,7,19,31,77,68,1,0,2018-2019,90.0,121.30434782608697,180.0
2303,Emile Smith Rowe,ENG,MF,RB Leipzig,Bundesliga,18,2000,0.3,1,0,0,1,0,1,1,100.0,0,0,0,0,1,2,0,0,0,2018-2019,90.0,300.0,300.0
2304,Tommy Smith,ENG,DF,Huddersfield,Premier League,26,1992,12.7,26,13,14,11,1,10,25,40.0,15,12,4,8,18,44,25,0,0,2018-2019,90.0,127.55905511811024,184.251968503937
2305,Robert Snodgrass,SCO,MF,West Ham,Premier League,30,1987,24.7,44,27,18,24,2,13,46,28.3,33,24,4,20,11,55,23,0,0,2018-2019,90.0,40.08097165991903,160.32388663967612
2306,Cédric Soares,POR,DF,Southampton,Premier League,26,1991,16.6,22,16,15,6,1,9,15,60.0,6,21,5,16,22,44,60,2,0,2018-2019,90.0,119.27710843373492,119.27710843373492
2307,Cédric Soares,POR,DF,Inter,Serie A,26,1991,2.9,8,6,2,4,2,4,7,57.1,3,4,1,3,2,10,3,0,0,2018-2019,90.0,62.06896551724138,248.27586206896552
2308,Ramadan Sobhi,EGY,"FW,MF",Huddersfield,Premier League,21,1997,0.9,1,1,0,1,0,0,0,0.0,0,2,0,2,1,2,0,0,0,2018-2019,90.0,100.0,100.0
2309,Marcel Sobottka,GER,MF,Düsseldorf,Bundesliga,24,1994,10.5,30,20,12,18,0,10,19,52.6,9,13,5,8,24,54,17,0,0,2018-2019,90.0,205.71428571428572,257.1428571428571
2310,Rubén Sobrino,ESP,"FW,MF",Alavés,La Liga,26,1992,10.7,16,11,7,6,3,5,13,38.5,8,16,1,15,2,18,13,0,0,2018-2019,90.0,16.82242990654206,134.57943925233647
2311,Rubén Sobrino,ESP,"FW,MF",Valencia,La Liga,26,1992,2.1,6,3,1,4,1,1,1,100.0,0,1,1,0,1,7,1,0,0,2018-2019,90.0,42.857142857142854,257.1428571428571
2312,Danilo Soddimo,ITA,"MF,FW",Frosinone,Serie A,30,1987,2.8,11,9,3,6,2,3,6,50.0,3,2,1,1,7,18,3,0,0,2018-2019,90.0,225.0,353.57142857142856
2313,Alex Sola,ESP,DF,Real Sociedad,La Liga,19,1999,1.0,4,3,0,3,1,3,4,75.0,1,0,0,0,1,5,2,0,0,2018-2019,90.0,90.0,360.0
2314,Dominic Solanke,ENG,"FW,MF",Bournemouth,Premier League,20,1997,3.9,8,3,1,4,3,1,8,12.5,7,4,1,3,2,10,9,0,0,2018-2019,90.0,46.15384615384615,184.6153846153846
2315,Andrés Solano,COL,DF,Atlético Madrid,La Liga,20,1998,0.5,4,3,2,2,0,2,2,100.0,0,1,0,1,0,4,1,0,0,2018-2019,90.0,0.0,720.0
2316,Carlos Soler,ESP,MF,Valencia,La Liga,21,1997,27.3,41,28,15,23,3,16,65,24.6,49,46,6,40,19,60,37,0,0,2018-2019,90.0,62.637362637362635,135.16483516483515
2317,Oumar Solet,FRA,DF,Lyon,Ligue 1,18,2000,0.7,1,0,1,0,0,1,1,100.0,0,1,0,1,0,1,0,0,0,2018-2019,90.0,0.0,128.57142857142858
2318,Yann Sommer,SUI,GK,Gladbach,Bundesliga,29,1988,34.0,2,2,2,0,0,2,2,100.0,0,1,0,1,1,3,12,5,0,2018-2019,90.0,2.6470588235294117,5.294117647058823
2319,Kévin Soni,CMR,"FW,DF",Girona,La Liga,20,1998,0.9,3,2,0,2,1,2,4,50.0,2,3,0,3,1,4,0,0,0,2018-2019,90.0,100.0,300.0
2320,Jérémy Sorbon,FRA,DF,Guingamp,Ligue 1,34,1983,29.4,33,20,23,10,0,14,22,63.6,8,33,23,10,34,67,105,2,0,2018-2019,90.0,104.08163265306122,101.0204081632653
2321,Oliver Sorg,GER,DF,Hannover 96,Bundesliga,28,1990,17.6,42,28,26,16,0,20,43,46.5,23,16,9,7,46,88,47,0,0,2018-2019,90.0,235.22727272727272,214.77272727272725
2322,David Soria,ESP,GK,Getafe,La Liga,25,1993,37.0,1,0,1,0,0,1,2,50.0,1,2,0,2,1,2,15,6,0,2018-2019,90.0,2.4324324324324325,2.4324324324324325
2323,Juan Soriano,ESP,GK,Sevilla,La Liga,20,1997,4.0,0,0,0,0,0,0,0,0.0,0,0,0,0,1,1,1,0,0,2018-2019,90.0,22.5,0.0
2324,Roberto Soriano,ITA,MF,Torino,Serie A,27,1991,5.2,9,5,0,5,4,1,8,12.5,7,9,0,9,6,15,1,0,0,2018-2019,90.0,103.84615384615384,155.76923076923075
2325,Roberto Soriano,ITA,MF,Bologna,Serie A,27,1991,16.5,27,18,14,10,3,8,24,33.3,16,21,2,19,3,30,11,0,0,2018-2019,90.0,16.363636363636363,147.27272727272728
Rk,Player,Nation,Pos,Squad,Comp,0,0,90.0,0,0,3,3,3,Tkl,0,0.0,0,0,0,0,0,0,0,0,0,2018-2019,90.0,0.0,0.0
2326,Stefano Sorrentino,ITA,GK,Chievo,Serie A,39,1979,31.0,1,1,1,0,0,1,2,50.0,1,0,0,0,3,4,10,1,0,2018-2019,90.0,8.709677419354838,2.903225806451613
2327,Borna Sosa,CRO,"DF,MF",Stuttgart,Bundesliga,20,1998,6.8,13,7,8,4,1,4,9,44.4,5,5,1,4,6,19,34,0,0,2018-2019,90.0,79.41176470588235,172.05882352941177
2328,Sebastian Soto,USA,"MF,FW",Hannover 96,Bundesliga,18,2000,0.3,0,0,0,0,0,0,0,0.0,0,0,0,0,0,0,0,0,0,2018-2019,90.0,0.0,0.0
2329,Riccardo Sottil,ITA,"FW,MF",Fiorentina,Serie A,19,1999,0.2,1,1,0,1,0,1,1,100.0,0,0,0,0,0,1,0,0,0,2018-2019,90.0,0.0,450.0
2330,Pape Souaré,SEN,DF,Crystal Palace,Premier League,28,1990,0.0,0,0,0,0,0,0,0,0.0,0,0,0,0,1,1,0,0,0,2018-2019,,inf,
2331,Adama Soumaoro,FRA,DF,Lille,Ligue 1,26,1992,19.1,14,11,12,2,0,4,6,66.7,2,21,18,3,21,35,92,1,0,2018-2019,90.0,98.95287958115183,65.96858638743456
2332,Boubakary Soumaré,FRA,MF,Lille,Ligue 1,19,1999,6.3,20,15,9,11,0,10,18,55.6,8,9,3,6,7,27,5,0,0,2018-2019,90.0,100.00000000000001,285.7142857142857
2333,Çağlar Söyüncü,TUR,DF,Leicester City,Premier League,22,1996,4.1,5,2,4,1,0,3,6,50.0,3,8,5,3,7,12,22,3,0,2018-2019,90.0,153.65853658536588,109.75609756097562
2334,Julián Speroni,ARG,GK,Crystal Palace,Premier League,39,1979,1.0,0,0,0,0,0,0,0,0.0,0,0,0,0,0,0,1,2,0,2018-2019,90.0,0.0,0.0
2335,Leonardo Spinazzola,ITA,DF,Juventus,Serie A,25,1993,6.7,9,4,4,2,3,4,8,50.0,4,5,0,5,3,12,7,0,0,2018-2019,90.0,40.298507462686565,120.89552238805969
2336,Nicolás Spolli,ARG,DF,Genoa,Serie A,35,1983,6.0,7,6,3,4,0,0,2,0.0,2,8,6,2,7,14,39,1,0,2018-2019,90.0,105.0,105.0
2337,Marco Sportiello,ITA,GK,Frosinone,Serie A,26,1992,35.0,1,0,1,0,0,1,1,100.0,0,1,0,1,0,1,8,2,0,2018-2019,90.0,0.0,2.571428571428571
2338,Mattia Sprocati,ITA,"FW,MF",Parma,Serie A,25,1993,7.2,10,4,5,5,0,5,11,45.5,6,6,0,6,7,17,6,0,0,2018-2019,90.0,87.5,125.0
2339,Bassem Srarfi,TUN,"FW,MF",Nice,Ligue 1,21,1997,9.1,20,11,8,8,4,6,17,35.3,11,8,0,8,5,25,5,0,0,2018-2019,90.0,49.45054945054945,197.8021978021978
2340,Darijo Srna,CRO,DF,Cagliari,Serie A,36,1982,23.2,24,16,6,13,5,9,14,64.3,5,24,5,19,18,42,66,0,0,2018-2019,90.0,69.82758620689656,93.10344827586206
2341,Kostas Stafylidis,GRE,DF,Augsburg,Bundesliga,24,1993,10.2,22,14,17,4,1,10,19,52.6,9,13,2,11,15,37,31,0,0,2018-2019,90.0,132.3529411764706,194.11764705882354
2342,Benjamin Stambouli,FRA,"DF,MF",Schalke 04,Bundesliga,27,1990,19.6,51,31,24,24,3,25,46,54.3,21,41,9,32,32,83,65,2,0,2018-2019,90.0,146.93877551020407,234.18367346938774
2343,Jozo Stanić,CRO,MF,Augsburg,Bundesliga,19,1999,0.0,0,0,0,0,0,0,0,0.0,0,0,0,0,0,0,0,0,0,2018-2019,,,
2344,Junior Stanislas,ENG,"MF,FW",Bournemouth,Premier League,28,1989,11.5,12,6,5,4,3,3,7,42.9,4,8,1,7,2,14,15,0,0,2018-2019,90.0,15.65217391304348,93.91304347826087
2345,Niklas Stark,GER,DF,Hertha BSC,Bundesliga,23,1995,20.8,34,19,23,11,0,9,24,37.5,15,45,26,19,37,71,141,1,0,2018-2019,90.0,160.09615384615384,147.1153846153846
2346,Timo Stavitski,FIN,"MF,FW",Caen,Ligue 1,19,1999,0.2,0,0,0,0,0,0,1,0.0,1,0,0,0,0,0,0,0,0,2018-2019,90.0,0.0,0.0
2347,Renato Steffen,SUI,"FW,MF",Wolfsburg,Bundesliga,26,1991,16.7,26,17,5,17,4,7,17,41.2,10,13,2,11,16,42,14,0,0,2018-2019,90.0,86.22754491017965,140.11976047904193
2348,Marc Stendera,GER,MF,Eint Frankfurt,Bundesliga,22,1995,1.2,6,1,2,4,0,2,4,50.0,2,4,1,3,0,6,0,0,0,2018-2019,90.0,0.0,450.00000000000006
2349,Pascal Stenzel,GER,"DF,MF",Freiburg,Bundesliga,22,1996,16.1,42,26,26,14,2,24,43,55.8,19,16,3,13,30,72,48,1,0,2018-2019,90.0,167.70186335403724,234.78260869565216
2350,Dale Stephens,ENG,MF,Brighton,Premier League,29,1989,27.6,83,57,37,41,5,28,74,37.8,46,33,13,20,46,129,47,0,0,2018-2019,90.0,149.99999999999997,270.65217391304344
Rk,Player,Nation,Pos,Squad,Comp,0,0,90.0,0,0,3,3,3,Tkl,0,0.0,0,0,0,0,0,0,0,0,0,2018-2019,90.0,0.0,0.0
2351,Jack Stephens,ENG,DF,Southampton,Premier League,24,1994,18.9,25,13,17,7,1,16,28,57.1,12,25,13,12,37,62,96,2,0,2018-2019,90.0,176.1904761904762,119.04761904761905
2352,Mariusz Stępiński,POL,FW,Chievo,Serie A,23,1995,27.5,18,13,1,11,6,1,17,5.9,16,10,2,8,5,23,20,0,0,2018-2019,89.99999999999999,16.363636363636363,58.90909090909091
2353,Raheem Sterling,ENG,FW,Manchester City,Premier League,23,1994,30.8,32,16,11,12,9,9,25,36.0,16,28,3,25,17,49,4,0,0,2018-2019,90.0,49.675324675324674,93.50649350649351
2354,Lars Stindl,GER,"FW,MF",Gladbach,Bundesliga,29,1988,16.8,21,14,8,11,2,3,15,20.0,12,22,2,20,14,35,13,0,0,2018-2019,90.0,75.0,112.5
2355,Kevin Stöger,AUT,MF,Düsseldorf,Bundesliga,24,1993,23.5,63,35,28,27,8,30,67,44.8,37,32,5,27,31,94,19,1,0,2018-2019,90.0,118.72340425531914,241.27659574468083
2356,John Stones,ENG,DF,Manchester City,Premier League,24,1994,19.6,16,11,9,5,2,4,9,44.4,5,15,9,6,14,30,64,1,0,2018-2019,90.0,64.28571428571428,73.46938775510203
2357,Thomas Strakosha,ALB,GK,Lazio,Serie A,23,1995,35.0,1,1,1,0,0,1,1,100.0,0,0,0,0,1,2,8,1,0,2018-2019,90.0,2.571428571428571,2.571428571428571
2358,Tobias Strobl,GER,"MF,DF",Gladbach,Bundesliga,28,1990,25.5,31,17,17,13,1,9,29,31.0,20,36,14,22,29,60,35,1,0,2018-2019,90.0,102.3529411764706,109.41176470588236
2359,Kevin Strootman,NED,MF,Roma,Serie A,28,1990,1.0,2,2,1,0,1,0,1,0.0,1,5,0,5,2,4,2,0,0,2018-2019,90.0,180.0,180.0
2360,Kevin Strootman,NED,MF,Marseille,Ligue 1,28,1990,21.6,76,40,21,47,8,20,52,38.5,32,24,6,18,24,100,26,0,0,2018-2019,90.0,99.99999999999999,316.66666666666663
2361,Jens Stryger Larsen,DEN,DF,Udinese,Serie A,27,1991,35.9,42,20,24,14,4,22,44,50.0,22,27,8,19,26,68,98,1,0,2018-2019,90.0,65.18105849582173,105.2924791086351
2362,Cristhian Stuani,URU,FW,Girona,La Liga,31,1986,30.3,23,13,7,13,3,5,20,25.0,15,13,1,12,4,27,39,0,0,2018-2019,90.0,11.881188118811881,68.31683168316832
2363,Leo Štulac,SVN,MF,Parma,Serie A,23,1994,16.1,21,13,10,10,1,4,17,23.5,13,29,13,16,34,55,31,1,0,2018-2019,90.0,190.06211180124222,117.39130434782608
2364,Stefano Sturaro,ITA,"MF,FW",Genoa,Serie A,25,1993,2.4,4,3,0,3,1,2,9,22.2,7,3,1,2,3,7,2,0,0,2018-2019,90.0,112.50000000000001,150.0
2365,Daniel Sturridge,ENG,"FW,MF",Liverpool,Premier League,28,1989,5.7,3,3,1,1,1,2,3,66.7,1,4,0,4,1,4,0,0,0,2018-2019,90.0,15.789473684210526,47.368421052631575
2366,Damián Suárez,URU,DF,Getafe,La Liga,30,1988,36.0,96,62,43,41,12,53,120,44.2,67,47,6,41,46,142,57,2,0,2018-2019,90.0,115.0,240.0
2367,Denis Suárez,ESP,"MF,FW",Arsenal,Premier League,24,1994,0.8,1,1,0,1,0,0,5,0.0,5,0,0,0,1,2,0,0,0,2018-2019,90.0,112.5,112.5
2368,Denis Suárez,ESP,"MF,DF",Barcelona,La Liga,24,1994,0.2,0,0,0,0,0,0,0,0.0,0,1,0,1,0,0,0,0,0,2018-2019,90.0,0.0,0.0
2369,Leonardo Suárez,ARG,"FW,MF",Valladolid,La Liga,22,1996,5.7,3,3,2,0,1,2,4,50.0,2,7,1,6,1,4,4,0,0,2018-2019,90.0,15.789473684210526,47.368421052631575
2370,Luis Suárez,URU,FW,Barcelona,La Liga,31,1987,31.4,18,11,1,6,11,4,10,40.0,6,12,4,8,8,26,24,0,0,2018-2019,90.0,22.929936305732486,51.592356687898096
2371,Mario Suárez,ESP,MF,Rayo Vallecano,La Liga,31,1987,11.4,37,23,17,17,3,15,28,53.6,13,10,3,7,14,51,17,2,0,2018-2019,90.0,110.52631578947367,292.10526315789474
2372,Mathías Suárez,URU,DF,Montpellier,Ligue 1,22,1996,6.1,20,11,7,10,3,10,23,43.5,13,11,0,11,9,29,18,0,0,2018-2019,90.0,132.78688524590166,295.0819672131148
2373,Danijel Subašić,CRO,GK,Monaco,Ligue 1,33,1984,12.6,0,0,0,0,0,0,1,0.0,1,0,0,0,0,0,6,2,0,2018-2019,90.0,0.0,0.0
2374,Neven Subotić,SRB,DF,Saint-Étienne,Ligue 1,29,1988,23.9,44,23,36,7,1,20,39,51.3,19,14,6,8,38,82,107,3,0,2018-2019,90.0,143.09623430962344,165.69037656903765
2375,Isaac Success,NGA,"FW,MF",Watford,Premier League,22,1996,11.7,15,12,4,8,3,2,5,40.0,3,6,0,6,2,17,11,0,0,2018-2019,89.99999999999999,15.384615384615383,115.38461538461539
Rk,Player,Nation,Pos,Squad,Comp,0,0,90.0,0,0,3,3,3,Tkl,0,0.0,0,0,0,0,0,0,0,0,0,2018-2019,90.0,0.0,0.0
2376,Niklas Süle,GER,DF,Bayern Munich,Bundesliga,22,1995,29.5,28,23,17,10,1,18,25,72.0,7,23,13,10,40,68,83,0,0,2018-2019,90.0,122.03389830508475,85.42372881355932
2377,Ki Sung-yueng,KOR,MF,Newcastle Utd,Premier League,29,1989,14.5,14,10,5,8,1,3,12,25.0,9,11,1,10,19,33,20,0,0,2018-2019,90.0,117.93103448275862,86.89655172413792
2378,Andrew Surman,ENG,MF,Bournemouth,Premier League,31,1986,16.0,11,6,6,5,0,3,13,23.1,10,20,7,13,10,21,34,1,0,2018-2019,90.0,56.25,61.875
2379,Sam Surridge,ENG,"MF,FW",Bournemouth,Premier League,20,1998,0.1,1,0,0,0,1,0,0,0.0,0,0,0,0,0,1,0,0,0,2018-2019,90.0,0.0,900.0
2380,Markel Susaeta,ESP,"FW,MF",Athletic Club,La Liga,30,1987,15.3,17,10,4,6,7,3,23,13.0,20,10,1,9,12,29,5,0,0,2018-2019,90.0,70.58823529411764,99.99999999999999
2381,Suso,ESP,"FW,MF",Milan,Serie A,24,1993,33.5,28,18,10,14,4,10,41,24.4,31,26,1,25,16,44,3,0,0,2018-2019,90.0,42.98507462686567,75.22388059701493
2382,Markus Suttner,AUT,"DF,MF",Düsseldorf,Bundesliga,31,1987,5.4,10,7,5,4,1,4,8,50.0,4,8,3,5,8,18,10,0,0,2018-2019,90.0,133.33333333333331,166.66666666666666
2383,Mattias Svanberg,SWE,MF,Bologna,Serie A,19,1999,13.1,22,11,14,7,1,11,25,44.0,14,25,6,19,11,33,16,2,0,2018-2019,90.0,75.57251908396947,151.14503816793894
2384,Sanasi Sy,FRA,MF,Amiens,Ligue 1,19,1999,0.0,0,0,0,0,0,0,0,0.0,0,0,0,0,0,0,0,0,0,2018-2019,,,
2385,Seydou Sy,SEN,GK,Monaco,Ligue 1,22,1995,2.5,0,0,0,0,0,0,0,0.0,0,0,0,0,0,0,0,1,0,2018-2019,90.0,0.0,0.0
2386,Issiaga Sylla,GUI,"DF,MF",Toulouse,Ligue 1,24,1994,22.2,54,36,30,24,0,28,53,52.8,25,36,10,26,39,93,77,0,0,2018-2019,90.0,158.10810810810813,218.91891891891893
2387,Moussa Sylla,MLI,"FW,MF",Monaco,Ligue 1,18,1999,8.5,6,4,4,1,1,2,6,33.3,4,5,2,3,2,8,5,0,0,2018-2019,90.0,21.176470588235293,63.529411764705884
2388,Eddy Sylvestre,FRA,"FW,MF",Nice,Ligue 1,18,1999,3.0,3,2,0,3,0,3,9,33.3,6,1,0,1,0,3,0,0,0,2018-2019,90.0,0.0,90.0
2389,Ádám Szalai,HUN,FW,Hoffenheim,Bundesliga,30,1987,18.1,19,13,3,12,4,4,11,36.4,7,8,1,7,4,23,8,0,0,2018-2019,90.0,19.889502762430936,94.47513812154695
2390,Wojciech Szczęsny,POL,GK,Juventus,Serie A,28,1990,28.0,2,1,2,0,0,1,1,100.0,0,0,0,0,1,3,8,2,0,2018-2019,90.0,3.2142857142857144,6.428571428571429
2391,Alexander Sørloth,NOR,FW,Crystal Palace,Premier League,22,1995,2.1,2,1,0,0,2,1,2,50.0,1,0,0,0,0,2,3,0,0,2018-2019,90.0,0.0,85.71428571428571
2392,Franck Tabanou,FRA,DF,Guingamp,Ligue 1,29,1989,2.0,4,3,4,0,0,1,2,50.0,1,0,0,0,6,10,15,0,0,2018-2019,90.0,270.0,180.0
2393,Jonathan Tah,GER,DF,Leverkusen,Bundesliga,22,1996,32.6,44,30,30,10,4,17,32,53.1,15,39,26,13,45,89,142,1,0,2018-2019,90.0,124.23312883435582,121.47239263803681
2394,Flavien Tait,FRA,"MF,FW",Angers,Ligue 1,25,1993,33.2,58,35,33,16,9,23,59,39.0,36,29,2,27,28,86,15,0,0,2018-2019,90.0,75.90361445783131,157.2289156626506
2395,Adrien Tameze,CMR,MF,Nice,Ligue 1,24,1994,32.7,74,44,32,31,11,39,92,42.4,53,53,12,41,56,130,59,1,0,2018-2019,90.0,154.12844036697248,203.6697247706422
2396,Strahinja Tanasijević,SRB,"DF,MF",Chievo,Serie A,21,1997,0.2,0,0,0,0,0,0,0,0.0,0,0,0,0,0,0,0,0,0,2018-2019,90.0,0.0,0.0
2397,Matt Targett,ENG,DF,Southampton,Premier League,22,1995,13.2,27,19,15,7,5,12,26,46.2,14,19,3,16,27,54,42,0,0,2018-2019,90.0,184.0909090909091,184.0909090909091
2398,Rodrigo Tarín,ESP,DF,Leganés,La Liga,22,1996,15.9,22,14,15,5,2,7,10,70.0,3,11,5,6,31,53,79,0,0,2018-2019,90.0,175.47169811320754,124.52830188679245
2399,James Tarkowski,ENG,DF,Burnley,Premier League,25,1992,34.3,71,36,52,18,1,29,50,58.0,21,72,56,16,42,113,240,2,0,2018-2019,90.0,110.20408163265307,186.29737609329447
2400,Ciprian Tătărușanu,ROU,GK,Nantes,Ligue 1,32,1986,26.6,0,0,0,0,0,0,0,0.0,0,0,0,0,2,2,20,0,0,2018-2019,90.0,6.7669172932330826,0.0
Rk,Player,Nation,Pos,Squad,Comp,0,0,90.0,0,0,3,3,3,Tkl,0,0.0,0,0,0,0,0,0,0,0,0,2018-2019,90.0,0.0,0.0
2401,Júlio Tavares,CPV,FW,Dijon,Ligue 1,29,1988,31.2,15,9,1,7,7,3,9,33.3,6,17,3,14,13,28,51,0,0,2018-2019,90.0,37.5,43.26923076923077
2402,Júnior Tavares,BRA,DF,Sampdoria,Serie A,21,1996,2.0,2,1,1,1,0,2,4,50.0,2,0,0,0,2,4,1,0,0,2018-2019,90.0,90.0,90.0
2403,Taleb Tawatha,ISR,"FW,DF",Eint Frankfurt,Bundesliga,26,1992,1.4,1,1,1,0,0,1,2,50.0,1,0,0,0,0,1,1,0,0,2018-2019,90.0,0.0,64.28571428571429
2404,Charlie Taylor,ENG,DF,Burnley,Premier League,24,1993,36.0,55,26,37,15,3,24,50,48.0,26,74,35,39,40,95,120,0,0,2018-2019,90.0,100.0,137.5
2405,Malik Tchokounté,FRA,"FW,MF",Caen,Ligue 1,29,1988,16.4,21,13,6,12,3,5,10,50.0,5,11,0,11,6,27,26,0,0,2018-2019,90.0,32.926829268292686,115.24390243902441
2406,Aurélien Tchouaméni,FRA,MF,Bordeaux,Ligue 1,18,2000,7.8,24,12,10,14,0,7,18,38.9,11,11,5,6,21,45,14,0,0,2018-2019,90.0,242.3076923076923,276.9230769230769
2407,Georg Teigl,AUT,"MF,FW",Augsburg,Bundesliga,27,1991,3.3,5,3,4,0,1,2,2,100.0,0,1,0,1,7,12,5,1,0,2018-2019,90.0,190.9090909090909,136.36363636363637
2408,Cristian Tello,ESP,"DF,FW",Betis,La Liga,26,1991,17.5,32,20,18,9,5,17,35,48.6,18,19,0,19,16,48,17,1,0,2018-2019,90.0,82.28571428571428,164.57142857142856
2409,Łukasz Teodorczyk,POL,FW,Udinese,Serie A,27,1991,4.4,4,2,2,2,0,2,8,25.0,6,8,2,6,1,5,4,0,0,2018-2019,90.0,20.454545454545453,81.81818181818181
2410,Hidde ter Avest,NED,"DF,FW",Udinese,Serie A,21,1997,10.8,26,14,17,6,3,14,20,70.0,6,14,3,11,10,36,39,1,0,2018-2019,90.0,83.33333333333333,216.66666666666666
2411,Marc-André ter Stegen,GER,GK,Barcelona,La Liga,26,1992,35.0,0,0,0,0,0,0,3,0.0,3,0,0,0,2,2,5,2,0,2018-2019,90.0,5.142857142857142,0.0
2412,Pietro Terracciano,ITA,GK,Fiorentina,Serie A,28,1990,2.0,0,0,0,0,0,0,0,0.0,0,0,0,0,0,0,1,1,0,2018-2019,90.0,0.0,0.0
2413,Pietro Terracciano,ITA,GK,Empoli,Serie A,28,1990,8.0,0,0,0,0,0,0,0,0.0,0,0,0,0,1,1,4,0,0,2018-2019,90.0,11.25,0.0
2414,Marco Terrazzino,GER,"MF,FW",Freiburg,Bundesliga,27,1991,5.7,6,3,4,2,0,1,7,14.3,6,5,2,3,3,9,2,0,0,2018-2019,90.0,47.368421052631575,94.73684210526315
2415,Martin Terrier,FRA,FW,Lyon,Ligue 1,21,1997,16.5,23,13,5,13,5,9,23,39.1,14,17,2,15,6,29,14,0,0,2018-2019,90.0,32.72727272727273,125.45454545454547
2416,Kenny Tete,NED,DF,Lyon,Ligue 1,22,1995,11.6,30,23,11,16,3,13,19,68.4,6,13,5,8,18,48,29,0,0,2018-2019,90.0,139.6551724137931,232.75862068965517
2417,Cedric Teuchert,GER,"FW,MF",Schalke 04,Bundesliga,21,1997,1.8,0,0,0,0,0,0,0,0.0,0,2,0,2,1,1,0,0,0,2018-2019,90.0,50.0,0.0
2418,Florian Thauvin,FRA,"FW,MF",Marseille,Ligue 1,25,1993,29.0,42,23,10,21,11,16,35,45.7,19,19,1,18,8,50,4,0,0,2018-2019,90.0,24.82758620689655,130.3448275862069
2419,Cyril Théréau,FRA,"FW,MF",Fiorentina,Serie A,35,1983,0.3,0,0,0,0,0,0,0,0.0,0,0,0,0,0,0,1,0,0,2018-2019,90.0,0.0,0.0
2420,Cyril Théréau,FRA,FW,Cagliari,Serie A,35,1983,1.5,1,1,0,1,0,1,1,100.0,0,0,0,0,0,1,2,0,0,2018-2019,90.0,0.0,60.0
2421,Sada Thioub,SEN,"MF,FW",Nîmes,Ligue 1,23,1995,27.5,30,19,13,10,7,20,45,44.4,25,29,1,28,16,46,11,0,0,2018-2019,89.99999999999999,52.36363636363636,98.18181818181817
2422,Romain Thomas,FRA,DF,Angers,Ligue 1,30,1988,26.6,35,26,25,10,0,14,19,73.7,5,31,24,7,29,64,133,1,0,2018-2019,90.0,98.1203007518797,118.42105263157895
2423,Adrien Thomasson,FRA,"MF,FW",Strasbourg,Ligue 1,24,1993,27.5,54,27,18,23,13,21,66,31.8,45,29,5,24,18,72,12,1,0,2018-2019,89.99999999999999,58.90909090909091,176.72727272727272
2424,Erik Thommy,GER,"MF,FW",Stuttgart,Bundesliga,23,1994,8.8,5,3,3,1,1,1,7,14.3,6,16,1,15,14,19,4,0,0,2018-2019,90.0,143.1818181818182,51.13636363636363
2425,Marcus Thuram,FRA,"FW,MF",Guingamp,Ligue 1,20,1997,28.6,45,28,23,15,7,20,43,46.5,23,24,1,23,10,55,14,0,0,2018-2019,90.0,31.46853146853147,141.6083916083916
Rk,Player,Nation,Pos,Squad,Comp,0,0,90.0,0,0,3,3,3,Tkl,0,0.0,0,0,0,0,0,0,0,0,0,2018-2019,90.0,0.0,0.0
2426,Youri Tielemans,BEL,MF,Leicester City,Premier League,21,1997,12.1,17,8,5,9,3,5,17,29.4,12,13,2,11,5,22,13,1,0,2018-2019,90.0,37.1900826446281,126.44628099173553
2427,Youri Tielemans,BEL,MF,Monaco,Ligue 1,21,1997,18.7,45,24,17,23,5,24,47,51.1,23,20,3,17,18,63,22,0,0,2018-2019,90.0,86.63101604278074,216.57754010695186
2428,Timmy Tillman,GER,"FW,MF",Nürnberg,Bundesliga,19,1999,2.3,0,0,0,0,0,0,4,0.0,4,3,0,3,3,3,0,2,0,2018-2019,90.0,117.3913043478261,0.0
2429,Cheick Timite,CIV,"FW,MF",Amiens,Ligue 1,20,1997,16.2,18,13,5,7,6,3,16,18.8,13,14,2,12,12,30,13,0,0,2018-2019,90.0,66.66666666666667,100.0
2430,David Timor,ESP,MF,Girona,La Liga,28,1989,1.8,2,2,1,1,0,0,1,0.0,1,1,1,0,3,5,3,0,0,2018-2019,90.0,150.0,100.0
2431,George Timotheou,AUS,DF,Schalke 04,Bundesliga,21,1997,1.0,3,3,3,0,0,0,0,0.0,0,1,1,0,1,4,4,0,0,2018-2019,90.0,90.0,270.0
2432,Marcel Tisserand,COD,DF,Wolfsburg,Bundesliga,25,1993,9.8,14,9,9,5,0,10,13,76.9,3,12,5,7,20,34,42,1,0,2018-2019,90.0,183.6734693877551,128.57142857142856
2433,Tito,ESP,DF,Rayo Vallecano,La Liga,33,1985,12.2,14,9,12,2,0,7,22,31.8,15,22,2,20,17,31,41,0,0,2018-2019,90.0,125.40983606557378,103.27868852459018
2434,Jean-Clair Todibo,FRA,DF,Barcelona,La Liga,18,1999,1.7,7,2,4,3,0,5,6,83.3,1,1,0,1,3,10,8,0,0,2018-2019,90.0,158.8235294117647,370.5882352941176
2435,Jean-Clair Todibo,FRA,DF,Toulouse,Ligue 1,18,1999,9.3,21,18,19,2,0,11,13,84.6,2,14,5,9,14,35,62,2,0,2018-2019,90.0,135.48387096774192,203.22580645161287
2436,Karl Toko Ekambi,CMR,"FW,MF",Villarreal,La Liga,25,1992,23.8,11,8,1,6,4,2,14,14.3,12,8,0,8,11,22,9,1,0,2018-2019,90.00000000000001,41.596638655462186,41.596638655462186
2437,Corentin Tolisso,FRA,MF,Bayern Munich,Bundesliga,23,1994,0.6,0,0,0,0,0,0,2,0.0,2,1,1,0,0,0,0,0,0,2018-2019,90.0,0.0,0.0
2438,Rafael Tolói,ITA,DF,Atalanta,Serie A,27,1990,19.4,27,17,15,9,3,16,24,66.7,8,28,10,18,33,60,54,1,0,2018-2019,90.0,153.09278350515467,125.2577319587629
2439,Raúl de Tomás,ESP,FW,Rayo Vallecano,La Liga,23,1994,31.3,8,3,0,7,1,0,12,0.0,12,18,4,14,9,17,45,0,0,2018-2019,90.0,25.878594249201278,23.003194888178914
2440,James Tomkins,ENG,DF,Crystal Palace,Premier League,29,1989,28.4,34,20,27,7,0,15,28,53.6,13,23,10,13,34,68,184,3,0,2018-2019,90.0,107.74647887323944,107.74647887323944
2441,Nenad Tomović,SRB,DF,Chievo,Serie A,30,1987,8.2,9,7,5,4,0,7,10,70.0,3,5,1,4,13,22,34,0,0,2018-2019,90.0,142.6829268292683,98.78048780487806
2442,Lorenzo Tonelli,ITA,DF,Sampdoria,Serie A,28,1990,18.4,31,22,19,9,3,15,19,78.9,4,27,21,6,24,55,92,0,0,2018-2019,90.0,117.3913043478261,151.63043478260872
2443,Toño,ESP,"DF,FW",Levante,La Liga,28,1989,19.6,17,13,12,3,2,10,21,47.6,11,20,5,15,14,31,42,0,0,2018-2019,90.0,64.28571428571428,78.06122448979592
2444,Ömer Toprak,TUR,DF,Dortmund,Bundesliga,29,1989,2.6,1,1,0,1,0,0,1,0.0,1,1,1,0,0,1,7,0,0,2018-2019,90.0,0.0,34.61538461538461
2445,Lucas Torreira,URU,MF,Arsenal,Premier League,22,1996,26.5,65,39,24,32,9,25,57,43.9,32,34,7,27,41,106,33,2,0,2018-2019,90.0,139.24528301886792,220.75471698113208
2446,Daniel Torres,COL,MF,Alavés,La Liga,28,1989,0.8,2,1,2,0,0,0,3,0.0,3,0,0,0,2,4,0,0,0,2018-2019,90.0,225.0,225.0
2447,Ferrán Torres,ESP,MF,Valencia,La Liga,18,2000,9.4,15,8,4,8,3,5,11,45.5,6,10,1,9,10,25,9,0,0,2018-2019,90.0,95.74468085106382,143.61702127659572
2448,Lucas Torró,ESP,MF,Eint Frankfurt,Bundesliga,24,1994,6.2,14,7,5,7,2,5,11,45.5,6,12,1,11,14,28,13,0,0,2018-2019,90.0,203.2258064516129,203.2258064516129
2449,Jordan Torunarigha,GER,DF,Hertha BSC,Bundesliga,20,1997,12.9,34,30,23,10,1,18,28,64.3,10,19,7,12,29,63,55,0,0,2018-2019,90.0,202.32558139534882,237.20930232558138
2450,Cenk Tosun,TUR,FW,Everton,Premier League,27,1991,11.8,13,9,3,6,4,4,13,30.8,9,12,0,12,5,18,3,0,0,2018-2019,90.0,38.13559322033898,99.15254237288134
Rk,Player,Nation,Pos,Squad,Comp,0,0,90.0,0,0,3,3,3,Tkl,0,0.0,0,0,0,0,0,0,0,0,0,2018-2019,90.0,0.0,0.0
2451,Abdoulaye Touré,GUI,MF,Nantes,Ligue 1,24,1994,30.5,48,31,14,28,6,19,56,33.9,37,25,10,15,47,95,29,1,0,2018-2019,90.0,138.68852459016392,141.63934426229508
2452,Almamy Touré,MLI,DF,Monaco,Ligue 1,22,1996,3.8,13,6,6,7,0,3,10,30.0,7,3,1,2,11,24,12,0,0,2018-2019,90.0,260.5263157894737,307.89473684210526
2453,Almamy Touré,MLI,"DF,MF",Eint Frankfurt,Bundesliga,22,1996,5.8,18,11,7,11,0,5,8,62.5,3,4,1,3,9,27,25,0,0,2018-2019,90.0,139.6551724137931,279.3103448275862
2454,Lucas Tousart,FRA,MF,Lyon,Ligue 1,21,1997,19.2,74,38,33,34,7,25,59,42.4,34,30,13,17,26,100,27,0,0,2018-2019,90.0,121.87500000000001,346.875
2455,Andros Townsend,ENG,"FW,MF",Crystal Palace,Premier League,27,1991,33.4,62,35,38,16,8,35,89,39.3,54,48,5,43,38,100,28,0,0,2018-2019,90.0,102.39520958083833,167.06586826347305
2456,Adama Traoré,ESP,"FW,MF",Wolves,Premier League,22,1996,10.0,16,13,11,3,2,4,9,44.4,5,11,0,11,6,22,7,0,0,2018-2019,90.0,54.0,144.0
2457,Adama Traoré,MLI,MF,Monaco,Ligue 1,23,1995,2.7,2,1,1,0,1,1,4,25.0,3,4,0,4,3,5,1,0,0,2018-2019,90.0,99.99999999999999,66.66666666666666
2458,Bertrand Traoré,BFA,FW,Lyon,Ligue 1,22,1995,23.5,36,22,19,13,4,12,26,46.2,14,23,5,18,15,51,18,0,0,2018-2019,90.0,57.44680851063829,137.87234042553192
2459,Charles Traore,MLI,"DF,FW",Nantes,Ligue 1,26,1992,12.9,40,20,22,16,2,23,34,67.6,11,16,3,13,19,59,46,0,0,2018-2019,90.0,132.5581395348837,279.06976744186045
2460,Cheick Traoré,MLI,DF,Guingamp,Ligue 1,23,1995,16.8,37,21,23,11,3,15,25,60.0,10,13,3,10,23,60,46,1,0,2018-2019,90.0,123.21428571428571,198.2142857142857
2461,Gaoussou Traoré,MLI,MF,Amiens,Ligue 1,18,1999,1.2,10,5,6,4,0,4,8,50.0,4,1,0,1,0,10,0,0,0,2018-2019,90.0,0.0,750.0
2462,Hamari Traoré,MLI,DF,Rennes,Ligue 1,26,1992,33.0,61,33,32,27,2,36,71,50.7,35,39,11,28,44,105,82,0,0,2018-2019,90.0,120.00000000000001,166.36363636363637
2463,Ibrahima Traoré,GUI,"FW,MF",Gladbach,Bundesliga,30,1988,6.1,12,6,8,2,2,3,11,27.3,8,3,1,2,3,15,1,0,0,2018-2019,90.0,44.26229508196722,177.04918032786887
2464,Ismaël Traoré,CIV,DF,Angers,Ligue 1,31,1986,29.3,27,11,19,8,0,9,24,37.5,15,27,16,11,42,69,120,2,0,2018-2019,90.0,129.01023890784984,82.93515358361775
2465,Kevin Trapp,GER,GK,Eint Frankfurt,Bundesliga,28,1990,32.6,0,0,0,0,0,0,2,0.0,2,0,0,0,0,0,17,1,0,2018-2019,90.0,0.0,0.0
2466,Mark Travers,IRL,GK,Bournemouth,Premier League,19,1999,2.0,0,0,0,0,0,0,0,0.0,0,0,0,0,0,0,2,0,0,2018-2019,90.0,0.0,0.0
2467,Óscar Trejo,ARG,"MF,FW",Rayo Vallecano,La Liga,30,1988,19.6,57,41,21,25,11,8,33,24.2,25,24,2,22,18,75,15,0,0,2018-2019,90.0,82.65306122448979,261.734693877551
2468,Driss Trichard,FRA,DF,Bordeaux,Ligue 1,23,1995,1.0,2,2,2,0,0,1,1,100.0,0,1,0,1,1,3,4,0,0,2018-2019,90.0,90.0,180.0
2469,Manu Trigueros,ESP,MF,Villarreal,La Liga,26,1991,17.2,46,35,18,23,5,20,57,35.1,37,17,6,11,16,62,17,0,0,2018-2019,90.0,83.72093023255815,240.69767441860466
2470,Kieran Trippier,ENG,DF,Tottenham,Premier League,27,1990,25.3,67,37,43,16,8,37,62,59.7,25,38,5,33,23,90,77,2,0,2018-2019,89.99999999999999,81.81818181818181,238.33992094861657
2471,William Troost-Ekong,NGA,DF,Udinese,Serie A,24,1993,34.0,31,15,21,9,1,13,24,54.2,11,53,41,12,40,71,200,2,0,2018-2019,90.0,105.88235294117648,82.05882352941177
2472,Marcello Trotta,ITA,FW,Frosinone,Serie A,25,1992,4.4,7,6,2,4,1,1,3,33.3,2,2,1,1,3,10,3,0,0,2018-2019,90.0,61.36363636363636,143.1818181818182
2473,Marcello Trotta,ITA,MF,Sassuolo,Serie A,25,1992,0.1,0,0,0,0,0,0,1,0.0,1,0,0,0,0,0,0,0,0,2018-2019,90.0,0.0,0.0
2474,Philipp Tschauner,GER,GK,Hannover 96,Bundesliga,32,1985,1.0,0,0,0,0,0,0,0,0.0,0,0,0,0,0,0,0,0,0,2018-2019,90.0,0.0,0.0
2475,Marco Tumminello,ITA,"FW,DF",Atalanta,Serie A,19,1998,0.1,0,0,0,0,0,0,0,0.0,0,0,0,0,0,0,0,0,0,2018-2019,90.0,0.0,0.0
Rk,Player,Nation,Pos,Squad,Comp,0,0,90.0,0,0,3,3,3,Tkl,0,0.0,0,0,0,0,0,0,0,0,0,2018-2019,90.0,0.0,0.0
2476,Patrick Twumasi,GHA,"MF,FW",Alavés,La Liga,24,1994,1.9,3,3,2,0,1,0,4,0.0,4,2,0,2,1,4,1,0,0,2018-2019,90.0,47.368421052631575,142.10526315789474
2477,Salih Uçan,TUR,MF,Empoli,Serie A,24,1994,2.9,10,4,3,5,2,3,10,30.0,7,4,0,4,6,16,2,0,0,2018-2019,90.0,186.20689655172413,310.3448275862069
2478,Anthony Ujah,NGA,FW,Mainz 05,Bundesliga,27,1990,8.2,2,0,0,1,1,1,2,50.0,1,7,2,5,1,3,10,0,0,2018-2019,90.0,10.975609756097562,21.951219512195124
2479,Sven Ulreich,GER,GK,Bayern Munich,Bundesliga,29,1988,8.4,0,0,0,0,0,0,0,0.0,0,0,0,0,0,0,2,1,0,2018-2019,90.0,0.0,0.0
2480,Samuel Umtiti,FRA,DF,Barcelona,La Liga,24,1993,13.2,8,5,3,4,1,4,6,66.7,2,10,8,2,18,26,28,2,0,2018-2019,90.0,122.72727272727273,54.54545454545455
2481,Enes Ünal,TUR,FW,Valladolid,La Liga,21,1997,23.9,17,10,3,4,10,4,24,16.7,20,17,4,13,2,19,18,0,0,2018-2019,90.0,7.531380753138076,64.01673640167364
2482,Cengiz Ünder,TUR,FW,Roma,Serie A,21,1997,15.3,6,3,3,3,0,2,11,18.2,9,7,0,7,13,19,5,0,0,2018-2019,90.0,76.47058823529412,35.29411764705882
2483,Joel Untersee,SUI,DF,Empoli,Serie A,24,1994,1.4,3,2,1,2,0,2,3,66.7,1,2,1,1,1,4,5,1,0,2018-2019,90.0,64.28571428571429,192.85714285714286
2484,Dayot Upamecano,FRA,DF,RB Leipzig,Bundesliga,19,1998,14.4,22,16,14,8,0,15,18,83.3,3,19,5,14,33,55,47,0,0,2018-2019,90.0,206.25,137.5
2485,Takashi Usami,JPN,"MF,FW",Düsseldorf,Bundesliga,26,1992,9.8,18,12,7,11,0,9,26,34.6,17,15,2,13,8,26,13,1,0,2018-2019,90.0,73.46938775510203,165.30612244897958
2486,Mark Uth,GER,"FW,MF",Schalke 04,Bundesliga,26,1991,15.6,20,11,8,8,4,4,23,17.4,19,19,2,17,8,28,12,0,0,2018-2019,90.0,46.15384615384615,115.38461538461539
2487,Tomáš Vaclík,CZE,GK,Sevilla,La Liga,29,1989,33.0,0,0,0,0,0,0,1,0.0,1,0,0,0,0,0,9,6,0,2018-2019,90.0,0.0,0.0
2488,Valentín Vada,ARG,MF,Bordeaux,Ligue 1,22,1996,0.4,2,1,0,2,0,1,1,100.0,0,0,0,0,0,2,0,0,0,2018-2019,90.0,0.0,450.0
2489,Valentín Vada,ARG,MF,Saint-Étienne,Ligue 1,22,1996,4.5,7,4,4,3,0,3,12,25.0,9,4,1,3,7,14,4,0,0,2018-2019,90.0,140.0,140.0
2490,William Vainqueur,FRA,MF,Monaco,Ligue 1,29,1988,0.9,6,3,4,2,0,1,1,100.0,0,1,0,1,0,6,0,0,0,2018-2019,90.0,0.0,600.0
2491,Mirko Valdifiori,ITA,MF,SPAL,Serie A,32,1986,7.4,20,15,12,7,1,8,14,57.1,6,4,2,2,5,25,9,0,0,2018-2019,90.0,60.81081081081081,243.24324324324323
2492,Pierrick Valdivia,FRA,MF,Nîmes,Ligue 1,30,1988,0.3,1,1,0,1,0,1,2,50.0,1,1,0,1,1,2,0,0,0,2018-2019,90.0,300.0,300.0
2493,Antonio Valencia,ECU,DF,Manchester Utd,Premier League,32,1985,5.2,8,6,2,4,2,3,4,75.0,1,9,0,9,5,13,10,0,0,2018-2019,90.0,86.53846153846153,138.46153846153845
2494,Enrico Valentini,ITA,DF,Nürnberg,Bundesliga,29,1989,14.4,44,27,31,10,3,22,40,55.0,18,17,3,14,13,57,58,0,0,2018-2019,90.0,81.25,275.0
2495,Borja Valero,ESP,MF,Inter,Serie A,33,1985,13.7,22,19,9,10,3,8,30,26.7,22,11,1,10,16,38,27,2,0,2018-2019,90.0,105.1094890510949,144.52554744525548
2496,Yan Valery,TUN,DF,Southampton,Premier League,19,1999,19.0,42,36,26,10,6,16,29,55.2,13,24,3,21,22,64,72,1,0,2018-2019,90.0,104.21052631578948,198.94736842105263
2497,Jesús Vallejo,ESP,DF,Real Madrid,La Liga,21,1997,3.5,6,5,4,2,0,5,6,83.3,1,4,4,0,7,13,12,0,0,2018-2019,90.0,180.0,154.28571428571428
2498,Theo Valls,FRA,MF,Nîmes,Ligue 1,22,1995,19.7,37,21,16,19,2,15,43,34.9,28,17,4,13,22,59,15,0,0,2018-2019,90.0,100.50761421319797,169.03553299492387
2499,Mattia Valoti,ITA,MF,SPAL,Serie A,24,1993,13.6,33,19,13,14,6,13,29,44.8,16,23,0,23,19,52,17,1,0,2018-2019,90.0,125.73529411764706,218.38235294117646
2500,Federico Valverde,URU,MF,Real Madrid,La Liga,20,1998,7.3,12,8,3,7,2,5,11,45.5,6,10,2,8,21,33,10,0,0,2018-2019,90.0,258.9041095890411,147.94520547945206
Rk,Player,Nation,Pos,Squad,Comp,0,0,90.0,0,0,3,3,3,Tkl,0,0.0,0,0,0,0,0,0,0,0,0,2018-2019,90.0,0.0,0.0
2501,Luca Valzania,ITA,MF,Frosinone,Serie A,22,1996,10.0,21,12,7,10,4,13,33,39.4,20,18,0,18,16,37,8,1,0,2018-2019,90.0,144.0,189.0
2502,Luca Valzania,ITA,MF,Atalanta,Serie A,22,1996,0.8,5,4,2,3,0,3,5,60.0,2,0,0,0,1,6,0,0,0,2018-2019,90.0,112.5,562.5
2503,Virgil van Dijk,NED,DF,Liverpool,Premier League,27,1991,37.6,38,28,26,11,1,14,14,100.0,0,29,18,11,40,78,201,1,0,2018-2019,90.0,95.74468085106382,90.95744680851064
2504,Raphaël Varane,FRA,DF,Real Madrid,La Liga,25,1993,30.6,33,18,25,7,1,15,19,78.9,4,21,9,12,32,65,141,1,0,2018-2019,90.0,94.11764705882352,97.05882352941175
2505,Jamie Vardy,ENG,FW,Leicester City,Premier League,31,1987,30.3,14,8,3,6,5,4,17,23.5,13,16,1,15,6,20,28,0,0,2018-2019,90.0,17.821782178217823,41.584158415841586
2506,Franco Vázquez,ARG,MF,Sevilla,La Liga,29,1989,25.3,51,37,21,21,9,23,66,34.8,43,25,2,23,23,74,27,1,0,2018-2019,89.99999999999999,81.81818181818181,181.42292490118575
2507,Kevin Vázquez,ESP,DF,Celta Vigo,La Liga,25,1993,2.4,6,5,5,0,1,4,7,57.1,3,8,3,5,2,8,9,0,0,2018-2019,90.0,75.0,225.00000000000003
2508,Lucas Vázquez,ESP,"FW,MF",Real Madrid,La Liga,27,1991,16.8,43,26,11,21,11,15,41,36.6,26,16,1,15,12,55,11,0,0,2018-2019,90.0,64.28571428571428,230.35714285714283
2509,Matías Vecino,URU,MF,Inter,Serie A,26,1991,22.4,50,39,18,23,9,26,53,49.1,27,38,9,29,17,67,22,0,0,2018-2019,90.0,68.30357142857143,200.89285714285714
2510,Koke Vegas,ESP,GK,Levante,La Liga,22,1995,1.0,0,0,0,0,0,0,0,0.0,0,0,0,0,0,0,0,0,0,2018-2019,90.0,0.0,0.0
2511,Emiliano Velázquez,URU,DF,Rayo Vallecano,La Liga,24,1994,14.2,49,32,38,9,2,20,34,58.8,14,29,7,22,47,96,106,1,0,2018-2019,90.0,297.887323943662,310.5633802816902
2512,Miloš Veljković,SRB,DF,Werder Bremen,Bundesliga,22,1995,20.9,36,24,29,6,1,22,37,59.5,15,27,13,14,27,63,111,0,0,2018-2019,90.0,116.26794258373207,155.02392344497608
2513,Miguel Veloso,POR,MF,Genoa,Serie A,32,1986,14.0,31,20,14,13,4,9,26,34.6,17,12,1,11,13,44,21,0,0,2018-2019,90.0,83.57142857142857,199.28571428571428
2514,Daniele Verde,ITA,"MF,FW",Valladolid,La Liga,22,1996,7.3,6,3,2,2,2,1,6,16.7,5,3,0,3,7,13,3,1,0,2018-2019,90.0,86.3013698630137,73.97260273972603
2515,Francesco Verde,ITA,FW,Cagliari,Serie A,19,1999,0.1,1,0,0,1,0,0,0,0.0,0,0,0,0,0,1,0,0,0,2018-2019,90.0,0.0,900.0
2516,Simone Verdi,ITA,"MF,FW",Napoli,Serie A,26,1992,7.8,16,11,5,9,2,8,16,50.0,8,6,0,6,4,20,3,0,0,2018-2019,90.0,46.15384615384615,184.6153846153846
2517,Jordan Veretout,FRA,MF,Fiorentina,Serie A,25,1993,32.7,64,40,22,31,11,21,52,40.4,31,33,7,26,46,110,54,2,0,2018-2019,90.0,126.60550458715596,176.14678899082568
2518,Paul Verhaegh,NED,DF,Wolfsburg,Bundesliga,34,1983,2.0,1,0,0,0,1,1,2,50.0,1,5,0,5,1,2,7,1,0,2018-2019,90.0,45.0,45.0
2519,Thomas Vermaelen,BEL,DF,Barcelona,La Liga,32,1985,6.5,6,4,3,3,0,3,7,42.9,4,4,2,2,6,12,21,0,0,2018-2019,90.00000000000001,83.07692307692308,83.07692307692308
2520,Marco Verratti,ITA,MF,Paris S-G,Ligue 1,25,1992,20.9,72,42,25,39,8,36,81,44.4,45,26,1,25,18,90,8,2,0,2018-2019,90.0,77.51196172248804,310.04784688995215
2521,Jan Vertonghen,BEL,DF,Tottenham,Premier League,31,1987,21.2,39,24,17,20,2,14,24,58.3,10,18,11,7,32,71,81,0,0,2018-2019,90.0,135.8490566037736,165.56603773584905
2522,Freddie Veseli,ALB,DF,Empoli,Serie A,25,1992,28.2,34,21,16,15,3,19,27,70.4,8,28,17,11,30,64,99,1,0,2018-2019,89.99999999999999,95.74468085106382,108.51063829787233
2523,Mikel Vesga,ESP,MF,Leganés,La Liga,25,1993,23.0,50,32,27,15,8,20,82,24.4,62,42,4,38,39,89,26,0,0,2018-2019,90.0,152.60869565217394,195.6521739130435
2524,Jannik Vestergaard,DEN,DF,Southampton,Premier League,25,1992,22.5,53,33,37,13,3,28,45,62.2,17,35,20,15,35,88,174,1,0,2018-2019,90.0,140.0,212.0
2525,Rúben Vezo,POR,DF,Levante,La Liga,24,1994,14.9,26,17,17,8,1,14,22,63.6,8,23,20,3,19,45,88,0,0,2018-2019,90.0,114.76510067114093,157.0469798657718
Rk,Player,Nation,Pos,Squad,Comp,0,0,90.0,0,0,3,3,3,Tkl,0,0.0,0,0,0,0,0,0,0,0,0,2018-2019,90.0,0.0,0.0
2526,Rúben Vezo,POR,DF,Valencia,La Liga,24,1994,2.2,2,1,2,0,0,2,4,50.0,2,2,1,1,2,4,10,0,0,2018-2019,90.0,81.81818181818181,81.81818181818181
2527,Francesco Vicari,ITA,DF,SPAL,Serie A,23,1994,25.9,28,24,21,7,0,18,28,64.3,10,31,24,7,34,62,139,1,0,2018-2019,90.0,118.14671814671816,97.2972972972973
2528,Aleix Vidal,ESP,"DF,MF",Sevilla,La Liga,28,1989,5.9,13,11,5,5,3,5,14,35.7,9,5,0,5,4,17,12,0,0,2018-2019,90.0,61.01694915254237,198.30508474576268
2529,Arturo Vidal,CHI,MF,Barcelona,La Liga,31,1987,21.4,78,44,32,37,9,30,69,43.5,39,46,5,41,29,107,23,1,0,2018-2019,90.0,121.96261682242992,328.0373831775701
2530,Ronaldo Vieira,ENG,MF,Sampdoria,Serie A,20,1998,6.7,19,10,3,14,2,5,9,55.6,4,10,2,8,8,27,24,1,0,2018-2019,90.0,107.46268656716417,255.2238805970149
2531,Luciano Vietto,ARG,"FW,MF",Fulham,Premier League,24,1993,11.0,15,11,5,5,5,4,19,21.1,15,9,0,9,6,21,5,0,0,2018-2019,90.0,49.09090909090909,122.72727272727273
2532,Carlos Vigaray,ESP,DF,Alavés,La Liga,23,1994,7.2,15,8,10,4,1,9,15,60.0,6,6,1,5,6,21,24,1,0,2018-2019,90.0,75.0,187.5
2533,Emanuel Vignato,ITA,"MF,FW",Chievo,Serie A,17,2000,7.3,8,4,4,3,1,0,6,0.0,6,4,0,4,10,18,0,0,0,2018-2019,90.0,123.28767123287672,98.63013698630138
2534,Dídac Vilà,ESP,DF,Espanyol,La Liga,29,1989,26.2,67,31,33,26,8,31,58,53.4,27,41,12,29,53,120,94,1,0,2018-2019,90.0,182.06106870229007,230.1526717557252
2535,Toni Villa,ESP,"MF,FW",Valladolid,La Liga,23,1995,19.6,51,32,24,18,9,20,47,42.6,27,15,0,15,12,63,10,0,0,2018-2019,90.0,55.10204081632653,234.18367346938774
2536,Rúben Vinagre,POR,"DF,MF",Wolves,Premier League,19,1999,7.9,14,9,7,7,0,2,5,40.0,3,10,2,8,14,28,16,1,0,2018-2019,90.0,159.49367088607593,159.49367088607593
2537,Carlos Vinícius,BRA,"FW,MF",Monaco,Ligue 1,23,1995,5.8,4,1,1,2,1,0,1,0.0,1,7,0,7,1,5,2,0,0,2018-2019,90.0,15.517241379310345,62.06896551724138
2538,Vitolo,ESP,"MF,FW",Atlético Madrid,La Liga,28,1989,8.4,17,13,8,6,3,6,19,31.6,13,8,1,7,10,27,6,0,0,2018-2019,90.0,107.14285714285714,182.14285714285714
2539,Federico Viviani,ITA,MF,Frosinone,Serie A,26,1992,3.7,6,5,2,3,1,3,8,37.5,5,6,3,3,8,14,2,0,0,2018-2019,90.0,194.59459459459458,145.94594594594594
2540,Emiliano Viviano,ITA,GK,SPAL,Serie A,32,1985,16.9,0,0,0,0,0,0,0,0.0,0,0,0,0,0,0,5,2,0,2018-2019,90.0,0.0,0.0
2541,Felipe Vizeu,BRA,"FW,DF",Udinese,Serie A,21,1997,0.4,0,0,0,0,0,0,0,0.0,0,0,0,0,0,0,0,0,0,2018-2019,90.0,0.0,0.0
2542,Dušan Vlahović,SRB,FW,Fiorentina,Serie A,18,2000,1.8,0,0,0,0,0,0,0,0.0,0,2,0,2,0,0,4,0,0,2018-2019,90.0,0.0,0.0
2543,Rai Vloet,NED,MF,Frosinone,Serie A,23,1995,1.4,4,2,1,2,1,0,3,0.0,3,4,0,4,0,4,1,0,0,2018-2019,90.0,0.0,257.14285714285717
2544,Kevin Vogt,GER,DF,Hoffenheim,Bundesliga,26,1991,26.6,24,15,20,4,0,12,32,37.5,20,28,11,17,33,57,103,3,0,2018-2019,90.0,111.65413533834585,81.203007518797
2545,Sam Vokes,WAL,FW,Burnley,Premier League,28,1989,10.2,4,2,1,2,1,0,0,0.0,0,2,1,1,0,4,17,0,0,2018-2019,90.0,0.0,35.294117647058826
2546,Kevin Volland,GER,FW,Leverkusen,Bundesliga,26,1992,31.3,33,20,7,14,12,13,27,48.1,14,17,1,16,6,39,33,0,0,2018-2019,90.0,17.252396166134183,94.88817891373802
2547,Michel Vorm,NED,GK,Tottenham,Premier League,34,1983,2.0,0,0,0,0,0,0,0,0.0,0,0,0,0,0,0,1,0,0,2018-2019,90.0,0.0,0.0
2548,Stefan de Vrij,NED,DF,Inter,Serie A,26,1992,28.0,25,16,14,10,1,8,15,53.3,7,32,23,9,25,50,95,1,0,2018-2019,90.0,80.35714285714286,80.35714285714286
2549,Šime Vrsaljko,CRO,DF,Inter,Serie A,26,1992,8.1,20,14,8,6,6,9,14,64.3,5,5,1,4,11,31,27,1,0,2018-2019,90.0,122.22222222222223,222.22222222222223
2550,Nikola Vukčević,MNE,MF,Levante,La Liga,26,1991,7.4,25,18,12,9,4,9,24,37.5,15,15,5,10,10,35,17,0,0,2018-2019,90.0,121.62162162162161,304.05405405405406
Rk,Player,Nation,Pos,Squad,Comp,0,0,90.0,0,0,3,3,3,Tkl,0,0.0,0,0,0,0,0,0,0,0,0,2018-2019,90.0,0.0,0.0
2551,Matěj Vydra,CZE,FW,Burnley,Premier League,26,1992,3.5,2,1,0,1,1,0,3,0.0,3,4,1,3,1,3,6,0,0,2018-2019,90.0,25.714285714285715,51.42857142857143
2552,Paul Wade,FRA,MF,Nice,Ligue 1,18,2000,0.1,0,0,0,0,0,0,3,0.0,3,0,0,0,0,0,1,0,0,2018-2019,90.0,0.0,0.0
2553,Sandro Wagner,GER,FW,Bayern Munich,Bundesliga,30,1987,1.6,3,2,0,2,1,0,1,0.0,1,0,0,0,0,3,2,0,0,2018-2019,90.0,0.0,168.75
2554,Molla Wagué,MLI,DF,Udinese,Serie A,27,1991,1.1,1,1,1,0,0,0,1,0.0,1,1,0,1,4,5,5,0,0,2018-2019,90.0,327.27272727272725,81.81818181818181
2555,Moussa Wagué,SEN,"DF,FW",Barcelona,La Liga,19,1998,2.5,6,5,1,4,1,3,7,42.9,4,1,0,1,4,10,3,0,0,2018-2019,90.0,144.0,216.0
2556,Wakaso,GHA,MF,Alavés,La Liga,28,1990,18.5,46,30,23,19,4,12,36,33.3,24,37,9,28,16,62,19,2,0,2018-2019,90.0,77.83783783783784,223.7837837837838
2557,Walace,BRA,MF,Hannover 96,Bundesliga,23,1995,22.2,52,22,17,28,7,27,61,44.3,34,30,4,26,45,97,36,1,0,2018-2019,90.0,182.43243243243245,210.81081081081084
2558,Theo Walcott,ENG,"FW,MF",Everton,Premier League,29,1989,23.5,27,17,11,9,7,10,22,45.5,12,17,1,16,22,49,8,0,0,2018-2019,90.0,84.25531914893617,103.40425531914893
2559,Luca Waldschmidt,GER,"FW,MF",Freiburg,Bundesliga,22,1996,19.1,20,13,7,10,3,2,20,10.0,18,20,3,17,13,33,8,1,0,2018-2019,90.0,61.2565445026178,94.24083769633508
2560,Kyle Walker,ENG,DF,Manchester City,Premier League,28,1990,30.9,40,26,20,20,0,24,38,63.2,14,19,5,14,36,76,58,2,0,2018-2019,90.0,104.85436893203884,116.50485436893204
2561,Kyle Walker-Peters,ENG,DF,Tottenham,Premier League,21,1997,4.2,7,4,4,2,1,3,4,75.0,1,5,1,4,4,11,6,0,0,2018-2019,90.0,85.71428571428571,150.0
2562,Wallace,BRA,DF,Lazio,Serie A,23,1994,13.7,17,13,11,6,0,8,17,47.1,9,13,7,6,30,47,60,2,0,2018-2019,90.0,197.08029197080293,111.67883211678833
2563,Anthony Walongwa,,DF,Nantes,Ligue 1,24,1993,1.0,0,0,0,0,0,0,0,0.0,0,3,2,1,1,1,2,0,0,2018-2019,90.0,90.0,0.0
2564,Rémi Walter,FRA,MF,Nice,Ligue 1,23,1995,9.3,20,12,7,10,3,5,15,33.3,10,9,1,8,6,26,11,0,0,2018-2019,90.0,58.06451612903225,193.54838709677418
2565,Aaron Wan-Bissaka,ENG,DF,Crystal Palace,Premier League,20,1997,34.8,129,90,90,33,6,55,65,84.6,10,49,16,33,84,213,161,0,0,2018-2019,90.0,217.24137931034483,333.62068965517244
2566,Victor Wanyama,KEN,MF,Tottenham,Premier League,27,1991,5.7,13,13,8,5,0,6,12,50.0,6,9,3,6,7,20,11,0,0,2018-2019,90.0,110.52631578947367,205.26315789473682
2567,Danny Ward,ENG,FW,Cardiff City,Premier League,26,1991,4.9,2,1,0,1,1,0,3,0.0,3,3,1,2,0,2,9,0,0,2018-2019,90.0,0.0,36.73469387755102
2568,Joel Ward,ENG,DF,Crystal Palace,Premier League,28,1989,6.1,12,7,7,4,1,3,10,30.0,7,2,0,2,10,22,35,0,0,2018-2019,90.0,147.5409836065574,177.04918032786887
2569,Stephen Ward,IRL,DF,Burnley,Premier League,32,1985,2.5,4,2,1,2,1,1,4,25.0,3,3,1,2,4,8,14,0,0,2018-2019,90.0,144.0,144.0
2570,James Ward-Prowse,ENG,"MF,DF",Southampton,Premier League,23,1994,21.6,36,17,19,13,4,14,43,32.6,29,30,6,24,27,63,59,0,0,2018-2019,90.0,112.49999999999999,150.0
2571,Daniel Wass,DEN,"DF,MF",Valencia,La Liga,29,1989,26.2,35,25,9,19,7,20,42,47.6,22,23,4,19,34,69,49,0,0,2018-2019,90.0,116.79389312977099,120.2290076335878
2572,Timothy Weah,USA,FW,Paris S-G,Ligue 1,18,2000,0.6,0,0,0,0,0,0,0,0.0,0,0,0,0,0,0,0,0,0,2018-2019,90.0,0.0,0.0
2573,Wout Weghorst,NED,FW,Wolfsburg,Bundesliga,25,1992,32.5,30,23,10,12,8,7,35,20.0,28,27,3,24,9,39,33,0,0,2018-2019,90.0,24.923076923076923,83.07692307692308
2574,Julian Weigl,GER,"DF,MF",Dortmund,Bundesliga,22,1995,16.2,32,18,19,12,1,24,41,58.5,17,18,10,8,16,48,56,2,0,2018-2019,90.0,88.88888888888889,177.77777777777777
2575,Mitchell Weiser,GER,DF,Leverkusen,Bundesliga,24,1994,23.5,63,37,34,22,7,26,50,52.0,24,31,3,28,27,90,48,0,0,2018-2019,90.0,103.40425531914893,241.27659574468083
Rk,Player,Nation,Pos,Squad,Comp,0,0,90.0,0,0,3,3,3,Tkl,0,0.0,0,0,0,0,0,0,0,0,0,2018-2019,90.0,0.0,0.0
2576,Danny Welbeck,ENG,"FW,MF",Arsenal,Premier League,27,1990,1.7,3,2,0,2,1,0,0,0.0,0,2,0,2,1,4,2,0,0,2018-2019,90.0,52.94117647058823,158.8235294117647
2577,Wendell,BRA,DF,Leverkusen,Bundesliga,25,1993,25.3,75,48,47,24,4,34,57,59.6,23,49,13,36,29,104,66,0,0,2018-2019,89.99999999999999,103.16205533596836,266.798418972332
2578,Oscar Wendt,SWE,DF,Gladbach,Bundesliga,32,1985,30.3,45,34,34,8,3,31,53,58.5,22,37,11,26,19,64,90,0,0,2018-2019,90.0,56.43564356435643,133.66336633663366
2579,Axel Werner,ARG,GK,Huesca,La Liga,22,1996,6.0,0,0,0,0,0,0,0,0.0,0,0,0,0,0,0,2,0,0,2018-2019,90.0,0.0,0.0
2580,Timo Werner,GER,FW,RB Leipzig,Bundesliga,22,1996,27.9,18,12,6,8,4,3,16,18.8,13,18,2,16,3,21,7,0,0,2018-2019,90.0,9.67741935483871,58.064516129032256
2581,Ashley Westwood,ENG,MF,Burnley,Premier League,28,1990,31.4,58,30,24,27,7,14,39,35.9,25,38,9,29,47,105,42,2,0,2018-2019,90.0,134.71337579617835,166.24203821656053
2582,Hendrik Weydandt,GER,FW,Hannover 96,Bundesliga,23,1995,19.1,18,12,7,8,3,3,24,12.5,21,14,4,10,5,23,44,0,0,2018-2019,90.0,23.56020942408377,84.81675392670157
2583,Connor Wickham,ENG,"FW,MF",Crystal Palace,Premier League,25,1993,0.7,0,0,0,0,0,0,0,0.0,0,0,0,0,0,0,2,0,0,2018-2019,90.0,0.0,0.0
2584,Georginio Wijnaldum,NED,MF,Liverpool,Premier League,27,1990,30.3,41,28,14,20,7,14,27,51.9,13,21,7,14,21,62,24,0,0,2018-2019,90.0,62.37623762376238,121.78217821782178
2585,Jetro Willems,NED,"MF,DF",Eint Frankfurt,Bundesliga,24,1994,8.1,20,15,10,8,2,9,15,60.0,6,10,4,6,10,30,14,0,0,2018-2019,90.0,111.11111111111111,222.22222222222223
2586,William,BRA,DF,Wolfsburg,Bundesliga,23,1995,29.7,82,57,52,21,9,35,75,46.7,40,41,2,39,85,167,127,3,0,2018-2019,90.0,257.57575757575756,248.48484848484847
2587,Danny Williams,USA,MF,Huddersfield,Premier League,29,1989,1.1,0,0,0,0,0,0,0,0.0,0,4,1,3,1,1,2,0,0,2018-2019,90.0,81.81818181818181,0.0
2588,Iñaki Williams,GHA,FW,Athletic Club,La Liga,24,1994,33.6,27,18,9,7,11,5,22,22.7,17,22,1,21,7,34,33,0,0,2018-2019,90.0,18.75,72.32142857142857
2589,Willian,BRA,FW,Chelsea,Premier League,29,1988,23.3,35,21,11,15,9,9,25,36.0,16,16,1,15,14,49,12,2,0,2018-2019,90.0,54.07725321888412,135.1931330472103
2590,Joe Willock,ENG,"MF,FW",Arsenal,Premier League,18,1999,0.7,1,0,0,1,0,0,0,0.0,0,1,0,1,1,2,0,0,0,2018-2019,90.0,128.57142857142858,128.57142857142858
2591,Ben Wilmot,ENG,"MF,DF",Watford,Premier League,18,1999,0.3,0,0,0,0,0,0,1,0.0,1,2,1,1,0,0,1,0,0,2018-2019,90.0,0.0,0.0
2592,Ben Wilmot,ENG,"DF,MF",Udinese,Serie A,18,1999,2.2,0,0,0,0,0,0,2,0.0,2,2,2,0,2,2,11,0,0,2018-2019,90.0,81.81818181818181,0.0
2593,Jack Wilshere,ENG,MF,West Ham,Premier League,26,1992,4.4,7,4,1,4,2,2,6,33.3,4,3,1,2,7,14,0,0,0,2018-2019,90.0,143.1818181818182,143.1818181818182
2594,Callum Wilson,ENG,FW,Bournemouth,Premier League,26,1992,28.1,9,7,4,3,2,0,8,0.0,8,14,4,10,4,13,16,0,0,2018-2019,90.0,12.811387900355871,28.82562277580071
2595,Kevin Wimmer,AUT,DF,Hannover 96,Bundesliga,25,1992,18.7,25,17,17,6,2,15,27,55.6,12,30,23,7,41,66,63,0,0,2018-2019,90.0,197.32620320855614,120.32085561497325
2596,Harry Winks,ENG,MF,Tottenham,Premier League,22,1996,17.7,22,13,12,9,1,5,30,16.7,25,19,3,16,21,43,19,0,0,2018-2019,90.0,106.77966101694916,111.86440677966102
2597,Axel Witsel,BEL,MF,Dortmund,Bundesliga,29,1989,31.9,47,33,19,24,4,17,28,60.7,11,33,6,27,47,94,49,0,0,2018-2019,90.0,132.60188087774296,132.60188087774296
2598,Maximilian Wöber,AUT,DF,Sevilla,La Liga,20,1998,6.0,12,9,8,2,2,3,6,50.0,3,6,0,6,7,19,16,0,0,2018-2019,90.0,105.0,180.0
2599,Marius Wolf,GER,"DF,FW",Dortmund,Bundesliga,23,1995,9.2,14,10,11,3,0,5,13,38.5,8,6,0,6,13,27,12,0,0,2018-2019,90.0,127.17391304347827,136.95652173913044
2600,Jeong Woo-yeong,KOR,FW,Bayern Munich,Bundesliga,18,1999,0.1,0,0,0,0,0,0,1,0.0,1,0,0,0,0,0,0,0,0,2018-2019,90.0,0.0,0.0
Rk,Player,Nation,Pos,Squad,Comp,0,0,90.0,0,0,3,3,3,Tkl,0,0.0,0,0,0,0,0,0,0,0,0,2018-2019,90.0,0.0,0.0
2601,Bobby Wood,USA,"FW,MF",Hannover 96,Bundesliga,25,1992,13.1,13,10,2,10,1,5,8,62.5,3,2,0,2,4,17,6,0,0,2018-2019,90.0,27.480916030534353,89.31297709923665
2602,Chris Wood,NZL,FW,Burnley,Premier League,26,1991,28.8,12,8,0,7,5,5,17,29.4,12,17,4,13,3,15,26,0,0,2018-2019,90.0,9.375,37.5
2603,Haji Wright,USA,FW,Schalke 04,Bundesliga,20,1998,2.2,3,2,1,1,1,0,1,0.0,1,1,0,1,0,3,1,0,0,2018-2019,90.0,0.0,122.72727272727272
2604,Xeka,POR,MF,Lille,Ligue 1,23,1994,25.1,59,31,25,27,7,18,57,31.6,39,20,2,18,21,80,30,4,0,2018-2019,90.0,75.2988047808765,211.55378486055776
2605,Granit Xhaka,SUI,"MF,DF",Arsenal,Premier League,25,1992,27.8,52,29,29,20,3,24,59,40.7,35,35,9,26,36,88,56,3,0,2018-2019,90.0,116.54676258992806,168.3453237410072
2606,Cédric Yamberé,CTA,DF,Dijon,Ligue 1,27,1990,31.2,47,31,36,11,0,21,39,53.8,18,45,32,13,52,99,136,4,0,2018-2019,90.0,150.0,135.57692307692307
2607,Andriy Yarmolenko,UKR,"MF,FW",West Ham,Premier League,28,1989,5.1,4,1,2,1,1,4,6,66.7,2,4,1,3,2,6,4,2,0,2018-2019,90.0,35.294117647058826,70.58823529411765
2608,John Yeboah,ECU,"MF,FW",Wolfsburg,Bundesliga,18,2000,0.6,0,0,0,0,0,0,3,0.0,3,1,0,1,1,1,0,0,0,2018-2019,90.0,150.0,0.0
2609,DeAndre Yedlin,USA,DF,Newcastle Utd,Premier League,25,1993,27.5,54,32,36,14,4,19,41,46.3,22,36,10,26,28,82,88,0,0,2018-2019,89.99999999999999,91.63636363636363,176.72727272727272
2610,Yoel,ESP,GK,Valladolid,La Liga,29,1988,3.0,0,0,0,0,0,0,0,0.0,0,0,0,0,0,0,0,1,0,2018-2019,90.0,0.0,0.0
2611,Okay Yokuşlu,TUR,MF,Celta Vigo,La Liga,24,1994,24.4,61,39,31,28,2,28,45,62.2,17,32,11,21,37,98,53,2,0,2018-2019,90.0,136.47540983606558,225.00000000000003
2612,Maya Yoshida,JPN,DF,Southampton,Premier League,29,1988,16.9,16,12,5,10,1,4,13,30.8,9,24,20,4,42,58,103,1,0,2018-2019,90.0,223.66863905325445,85.20710059171599
2613,Elie Youan,FRA,FW,Nantes,Ligue 1,19,1999,0.2,1,0,0,1,0,0,0,0.0,0,0,0,0,0,1,0,0,0,2018-2019,90.0,0.0,450.0
2614,Amin Younes,GER,"MF,FW",Napoli,Serie A,24,1993,5.5,11,6,3,6,2,3,6,50.0,3,7,0,7,2,13,0,0,0,2018-2019,90.0,32.72727272727273,180.0
2615,Ashley Young,ENG,DF,Manchester Utd,Premier League,33,1985,28.5,52,32,34,16,2,20,39,51.3,19,36,10,26,55,107,74,0,0,2018-2019,90.0,173.6842105263158,164.21052631578948
2616,Zaydou Youssouf,FRA,"MF,FW",Bordeaux,Ligue 1,19,1999,4.7,7,5,3,4,0,3,7,42.9,4,5,1,4,5,12,0,0,0,2018-2019,90.0,95.74468085106382,134.04255319148936
2617,Pablo Zabaleta,ARG,DF,West Ham,Premier League,33,1985,23.2,47,24,26,15,6,17,44,38.6,27,39,15,24,48,95,96,3,0,2018-2019,90.0,186.20689655172413,182.32758620689657
2618,Dan-Axel Zagadou,FRA,DF,Dortmund,Bundesliga,19,1999,14.1,13,10,10,2,1,4,6,66.7,2,17,11,6,25,38,70,2,0,2018-2019,89.99999999999999,159.57446808510636,82.97872340425532
2619,Wilfried Zaha,CIV,FW,Crystal Palace,Premier League,25,1992,33.7,39,20,11,23,5,12,34,35.3,22,19,0,19,10,49,4,0,0,2018-2019,90.0,26.706231454005934,104.15430267062314
2620,Younn Zahary,COM,DF,Caen,Ligue 1,19,1998,8.2,16,9,7,6,3,8,14,57.1,6,13,8,5,16,32,35,0,0,2018-2019,90.0,175.609756097561,175.609756097561
2621,Miha Zajc,SVN,"MF,FW",Empoli,Serie A,24,1994,13.0,6,4,1,1,4,2,11,18.2,9,15,4,11,5,11,8,0,0,2018-2019,90.00000000000001,34.61538461538462,41.53846153846154
2622,Denis Zakaria,SUI,MF,Gladbach,Bundesliga,21,1996,21.8,40,21,15,24,1,12,30,40.0,18,38,9,29,26,66,20,0,0,2018-2019,90.0,107.3394495412844,165.13761467889907
2623,Joseba Zaldúa,ESP,DF,Real Sociedad,La Liga,26,1992,23.8,36,27,23,10,3,15,32,46.9,17,19,3,16,38,74,72,0,0,2018-2019,90.00000000000001,143.69747899159665,136.1344537815126
2624,Andre-Frank Zambo Anguissa,CMR,MF,Fulham,Premier League,22,1995,16.9,48,29,23,20,5,18,52,34.6,34,25,6,19,34,82,32,0,0,2018-2019,90.0,181.06508875739647,255.62130177514794
2625,Francesco Zampano,ITA,"DF,MF",Frosinone,Serie A,24,1993,23.4,35,25,23,9,3,15,31,48.4,16,24,4,20,13,48,48,0,0,2018-2019,89.99999999999999,50.0,134.6153846153846
Rk,Player,Nation,Pos,Squad,Comp,0,0,90.0,0,0,3,3,3,Tkl,0,0.0,0,0,0,0,0,0,0,0,0,2018-2019,90.0,0.0,0.0
2626,Nicolò Zaniolo,ITA,"MF,FW",Roma,Serie A,19,1999,19.6,35,21,7,18,10,7,37,18.9,30,14,0,14,13,48,8,0,0,2018-2019,90.0,59.69387755102041,160.7142857142857
2627,Cristián Zapata,COL,DF,Milan,Serie A,31,1986,11.4,23,16,15,7,1,9,10,90.0,1,18,15,3,8,31,59,0,0,2018-2019,90.0,63.1578947368421,181.57894736842104
2628,Duván Zapata,COL,FW,Atalanta,Serie A,27,1991,32.2,9,5,3,2,4,1,9,11.1,8,26,6,20,4,13,25,0,0,2018-2019,90.0,11.180124223602483,25.15527950310559
2629,Davide Zappacosta,ITA,DF,Chelsea,Premier League,26,1992,1.4,0,0,0,0,0,0,1,0.0,1,0,0,0,3,3,5,0,0,2018-2019,90.0,192.85714285714286,0.0
2630,Simone Zaza,ITA,"FW,MF",Torino,Serie A,27,1991,16.0,20,9,3,12,5,1,8,12.5,7,12,1,11,4,24,9,0,0,2018-2019,90.0,22.5,112.5
2631,Marvin Zeegelaar,NED,DF,Udinese,Serie A,27,1990,10.6,30,23,21,6,3,16,24,66.7,8,11,2,9,17,47,38,0,0,2018-2019,90.0,144.33962264150944,254.7169811320755
2632,Mehdi Zeffane,ALG,"DF,MF",Rennes,Ligue 1,26,1992,13.5,19,13,12,7,0,10,26,38.5,16,14,5,9,18,37,35,1,0,2018-2019,90.0,120.0,126.66666666666667
2633,Arton Zekaj,KVX,FW,Lille,Ligue 1,18,2000,0.0,0,0,0,0,0,0,0,0.0,0,0,0,0,0,0,0,0,0,2018-2019,,,
2634,Mootaz Zemzemi,TUN,"FW,MF",Strasbourg,Ligue 1,18,1999,0.0,1,0,0,0,1,0,0,0.0,0,0,0,0,0,1,0,0,0,2018-2019,,,inf
2635,Arber Zeneli,KVX,FW,Reims,Ligue 1,23,1995,9.0,8,6,3,2,3,0,10,0.0,10,3,0,3,2,10,3,1,0,2018-2019,90.0,20.0,80.0
2636,Robin Zentner,GER,GK,Mainz 05,Bundesliga,23,1994,10.0,0,0,0,0,0,0,1,0.0,1,0,0,0,1,1,3,0,0,2018-2019,90.0,9.0,0.0
2637,Nabil El Zhar,MAR,"MF,FW",Leganés,La Liga,31,1986,10.7,8,4,2,4,2,0,5,0.0,5,4,0,4,4,12,1,0,0,2018-2019,90.0,33.64485981308412,67.28971962616824
2638,Luca Zidane,FRA,GK,Real Madrid,La Liga,20,1998,1.0,0,0,0,0,0,0,0,0.0,0,0,0,0,0,0,0,0,0,2018-2019,90.0,0.0,0.0
2639,Ron-Robert Zieler,GER,GK,Stuttgart,Bundesliga,29,1989,34.0,2,1,2,0,0,1,4,25.0,3,1,0,1,1,3,19,3,0,2018-2019,90.0,2.6470588235294117,5.294117647058823
2640,Piotr Zieliński,POL,MF,Napoli,Serie A,24,1994,31.9,41,25,11,20,10,13,34,38.2,21,30,4,26,20,61,18,0,0,2018-2019,90.0,56.426332288401255,115.67398119122257
2641,Jean Zimmer,GER,"DF,FW",Düsseldorf,Bundesliga,24,1993,15.9,17,11,11,5,1,6,16,37.5,10,13,2,11,11,28,32,1,0,2018-2019,90.0,62.264150943396224,96.22641509433963
2642,Matthias Zimmermann,GER,"DF,MF",Düsseldorf,Bundesliga,26,1992,33.9,97,64,69,24,4,45,90,50.0,45,51,18,33,67,164,90,2,0,2018-2019,90.0,177.87610619469027,257.5221238938053
2643,Oleksandr Zinchenko,UKR,DF,Manchester City,Premier League,21,1996,12.8,34,20,13,15,6,14,33,42.4,19,14,3,11,20,54,19,1,0,2018-2019,90.0,140.625,239.0625
2644,Kévin Zohi,MLI,"FW,MF",Strasbourg,Ligue 1,21,1996,7.0,14,10,6,6,2,5,9,55.6,4,8,0,8,7,21,5,0,0,2018-2019,90.0,90.0,180.0
2645,Kenneth Zohore,DEN,FW,Cardiff City,Premier League,24,1994,8.4,3,2,0,3,0,1,3,33.3,2,4,2,2,2,5,5,0,0,2018-2019,90.0,21.428571428571427,32.14285714285714
2646,Kurt Zouma,FRA,DF,Everton,Premier League,23,1994,29.0,32,21,16,14,2,4,11,36.4,7,27,12,15,54,86,126,2,0,2018-2019,90.0,167.58620689655172,99.3103448275862
2647,Adam Zreľák,SVK,FW,Nürnberg,Bundesliga,24,1994,10.5,14,9,2,11,1,5,9,55.6,4,14,2,12,2,16,13,0,0,2018-2019,90.0,17.142857142857142,120.0
2648,Igor Zubeldia,ESP,MF,Real Sociedad,La Liga,21,1997,28.3,61,35,32,24,5,22,54,40.7,32,30,6,24,45,106,60,0,0,2018-2019,90.0,143.1095406360424,193.9929328621908
2649,Steven Zuber,SUI,"MF,FW",Hoffenheim,Bundesliga,26,1991,6.3,12,9,5,6,1,6,13,46.2,7,5,1,4,5,17,4,0,0,2018-2019,90.0,71.42857142857143,171.42857142857144
2650,Steven Zuber,SUI,"MF,FW",Stuttgart,Bundesliga,26,1991,11.7,6,3,2,2,2,1,13,7.7,12,14,2,12,6,12,6,0,0,2018-2019,89.99999999999999,46.15384615384615,46.15384615384615
Rk,Player,Nation,Pos,Squad,Comp,0,0,90.0,0,0,3,3,3,Tkl,0,0.0,0,0,0,0,0,0,0,0,0,2018-2019,90.0,0.0,0.0
2651,Martín Zubimendi,ESP,MF,Real Sociedad,La Liga,19,1999,0.1,1,0,0,1,0,0,1,0.0,1,0,0,0,0,1,0,0,0,2018-2019,90.0,0.0,900.0
2652,Ervin Zukanović,BIH,DF,Genoa,Serie A,31,1987,21.8,28,16,20,7,1,17,30,56.7,13,17,9,8,19,47,96,0,0,2018-2019,90.0,78.44036697247707,115.59633027522935
2653,Bongani Zungu,RSA,MF,Amiens,Ligue 1,25,1992,2.6,3,2,0,1,2,2,8,25.0,6,0,0,0,2,5,5,0,0,2018-2019,90.0,69.23076923076923,103.84615384615384
2654,David Zurutuza,ESP,MF,Real Sociedad,La Liga,32,1986,13.6,27,16,9,15,3,8,22,36.4,14,19,4,15,24,51,26,1,0,2018-2019,90.0,158.8235294117647,178.6764705882353
2655,Filip Đorđević,SRB,FW,Chievo,Serie A,30,1987,7.0,11,6,3,6,2,3,12,25.0,9,7,1,6,2,13,8,1,0,2018-2019,90.0,25.714285714285715,141.42857142857142
2656,Filip Đuričić,SRB,"FW,MF",Sassuolo,Serie A,26,1992,13.9,17,13,2,11,4,5,22,22.7,17,20,1,19,8,25,8,1,0,2018-2019,90.0,51.79856115107914,110.07194244604317
1,Patrick van Aanholt,NED,DF,Crystal Palace,Premier League,28,1990,27.9,43,23,31,10,2,23,50,46.0,27,31,9,22,45,88,52,1,0,2019-2020,90.0,145.16129032258064,138.70967741935485
2,Max Aarons,ENG,DF,Norwich City,Premier League,19,2000,36.0,48,30,33,9,6,18,36,50.0,18,46,29,17,37,85,97,1,0,2019-2020,90.0,92.5,120.0
3,Yunis Abdelhamid,MAR,DF,Reims,Ligue 1,31,1987,28.0,46,33,29,15,2,17,30,56.7,13,26,14,12,47,93,99,1,0,2019-2020,90.0,151.07142857142856,147.85714285714286
4,Suleiman Abdullahi,NGA,"FW,MF",Union Berlin,Bundesliga,22,1996,1.7,0,0,0,0,0,0,3,0.0,3,2,1,1,1,1,1,0,0,2019-2020,90.0,52.94117647058823,0.0
5,Mehdi Abeid,ALG,MF,Nantes,Ligue 1,26,1992,20.2,55,29,18,32,5,20,53,37.7,33,16,3,13,23,78,8,1,0,2019-2020,90.0,102.47524752475248,245.04950495049505
6,Charles Abi,FRA,FW,Saint-Étienne,Ligue 1,19,2000,6.9,9,9,2,5,2,2,7,28.6,5,2,0,2,4,13,4,0,0,2019-2020,90.0,52.17391304347826,117.39130434782608
7,David Abraham,ARG,DF,Eint Frankfurt,Bundesliga,33,1986,18.8,21,14,16,4,1,15,32,46.9,17,27,11,16,25,46,61,1,0,2019-2020,90.0,119.68085106382978,100.53191489361701
8,Tammy Abraham,ENG,FW,Chelsea,Premier League,21,1997,24.6,8,4,2,5,1,3,14,21.4,11,20,2,18,6,14,27,0,0,2019-2020,89.99999999999999,21.95121951219512,29.268292682926827
9,Amir Abrashi,ALB,MF,Freiburg,Bundesliga,29,1990,7.4,16,8,7,8,1,10,19,52.6,9,18,3,15,7,23,16,2,0,2019-2020,90.0,85.13513513513513,194.59459459459458
10,Francesco Acerbi,ITA,DF,Lazio,Serie A,31,1988,35.1,59,29,42,12,5,14,20,70.0,6,40,27,13,42,101,109,1,0,2019-2020,90.0,107.6923076923077,151.28205128205127
11,Che Adams,SCO,FW,Southampton,Premier League,23,1996,12.3,6,4,1,5,0,1,4,25.0,3,9,1,8,2,8,10,0,0,2019-2020,89.99999999999999,14.634146341463413,43.90243902439024
12,Tyler Adams,USA,"MF,DF",RB Leipzig,Bundesliga,20,1999,10.6,22,15,13,8,1,12,25,48.0,13,16,1,15,14,36,14,0,0,2019-2020,90.0,118.8679245283019,186.7924528301887
13,Sargis Adamyan,ARM,"FW,MF",Hoffenheim,Bundesliga,26,1993,8.3,11,7,3,6,2,3,21,14.3,18,8,1,7,2,13,4,0,0,2019-2020,90.0,21.686746987951803,119.27710843373492
14,Antonio Adán,ESP,GK,Atlético Madrid,La Liga,32,1987,0.3,0,0,0,0,0,0,0,0.0,0,0,0,0,0,0,0,0,0,2019-2020,90.0,0.0,0.0
15,Bobby Adekanye,NED,FW,Lazio,Serie A,20,1999,2.1,3,2,0,3,0,0,5,0.0,5,0,0,0,2,5,1,0,0,2019-2020,90.0,85.71428571428571,128.57142857142856
16,Claud Adjapong,ITA,DF,Hellas Verona,Serie A,21,1998,2.6,5,3,4,1,0,2,3,66.7,1,4,3,1,3,8,7,0,0,2019-2020,90.0,103.84615384615384,173.07692307692307
17,Amine Adli,MAR,"MF,FW",Toulouse,Ligue 1,19,2000,0.5,0,0,0,0,0,0,1,0.0,1,0,0,0,1,1,0,0,0,2019-2020,90.0,180.0,0.0
18,Yacine Adli,FRA,MF,Bordeaux,Ligue 1,19,2000,11.3,22,14,4,15,3,11,34,32.4,23,10,0,10,8,30,3,0,0,2019-2020,90.0,63.716814159292035,175.2212389380531
19,Adrián,ESP,GK,Liverpool,Premier League,32,1987,9.7,1,1,1,0,0,1,1,100.0,0,0,0,0,0,1,8,3,0,2019-2020,90.0,0.0,9.278350515463918
20,Aritz Aduriz,ESP,"FW,MF",Athletic Club,La Liga,38,1981,2.3,3,2,0,3,0,0,0,0.0,0,0,0,0,0,3,2,0,0,2019-2020,90.0,0.0,117.3913043478261
21,Lumor Agbenyenu,GHA,DF,Mallorca,La Liga,22,1996,20.1,31,21,19,9,3,16,35,45.7,19,13,2,11,21,52,66,1,0,2019-2020,90.0,94.02985074626865,138.8059701492537
22,Martin Agirregabiria,ESP,DF,Alavés,La Liga,23,1996,23.3,55,30,32,18,5,30,54,55.6,24,19,7,12,18,73,48,0,0,2019-2020,90.0,69.52789699570815,212.44635193133047
23,Lucien Agoume,FRA,MF,Inter,Serie A,17,2002,0.8,3,2,0,2,1,0,0,0.0,0,3,1,2,0,3,0,0,0,2019-2020,90.0,0.0,337.5
24,Kevin Agudelo,COL,"MF,FW",Fiorentina,Serie A,20,1998,0.7,2,1,0,1,1,0,1,0.0,1,1,0,1,1,3,0,0,0,2019-2020,90.0,128.57142857142858,257.14285714285717
25,Kevin Agudelo,COL,"MF,FW",Genoa,Serie A,20,1998,7.4,23,14,9,12,2,10,20,50.0,10,12,1,11,6,29,2,0,0,2019-2020,90.0,72.97297297297297,279.72972972972974
Rk,Player,Nation,Pos,Squad,Comp,0,0,90.0,0,0,3,3,3,Tkl,0,0.0,0,0,0,0,0,0,0,0,0,2019-2020,90.0,0.0,0.0
26,Nayef Aguerd,MAR,DF,Dijon,Ligue 1,23,1996,10.6,13,9,7,5,1,8,12,66.7,4,11,11,0,18,31,54,0,0,2019-2020,90.0,152.83018867924528,110.37735849056604
27,Sergio Agüero,ARG,FW,Manchester City,Premier League,31,1988,16.1,7,4,0,4,3,1,8,12.5,7,9,1,8,3,10,2,0,0,2019-2020,90.0,16.770186335403725,39.130434782608695
28,Ruben Aguilar,FRA,DF,Monaco,Ligue 1,26,1993,11.9,36,22,19,15,2,19,28,67.9,9,6,2,4,11,47,21,0,0,2019-2020,90.00000000000001,83.19327731092437,272.2689075630252
29,Emmanuel Agyemang-Badu,GHA,MF,Hellas Verona,Serie A,28,1990,2.6,1,1,0,1,0,1,2,50.0,1,2,2,0,1,2,6,0,0,2019-2020,90.0,34.61538461538461,34.61538461538461
30,Jean-Eudes Aholou,CIV,MF,Saint-Étienne,Ligue 1,25,1994,7.0,16,12,2,11,3,3,9,33.3,6,6,1,5,15,31,10,0,0,2019-2020,90.0,192.85714285714286,205.71428571428572
31,Joseph Aidoo,GHA,DF,Celta Vigo,La Liga,23,1995,27.8,43,27,30,11,2,13,27,48.1,14,31,14,17,45,88,124,3,0,2019-2020,90.0,145.68345323741008,139.20863309352518
32,Ola Aina,NGA,DF,Torino,Serie A,22,1996,23.1,45,24,23,18,4,17,37,45.9,20,24,6,18,41,86,61,0,0,2019-2020,89.99999999999999,159.74025974025972,175.3246753246753
33,Youssef Aït Bennasser,MAR,MF,Bordeaux,Ligue 1,23,1996,6.0,11,8,6,4,1,4,24,16.7,20,6,1,5,4,15,10,1,0,2019-2020,90.0,60.0,165.0
34,Rayan Aït-Nouri,ALG,DF,Angers,Ligue 1,18,2001,14.2,29,22,14,8,7,10,21,47.6,11,14,1,13,18,47,33,0,0,2019-2020,90.0,114.08450704225353,183.80281690140848
35,Albian Ajeti,SUI,FW,West Ham,Premier League,22,1997,1.5,1,0,0,0,1,0,0,0.0,0,0,0,0,0,1,0,0,0,2019-2020,90.0,0.0,60.0
36,Ludovic Ajorque,FRA,FW,Strasbourg,Ligue 1,25,1994,22.9,15,10,2,10,3,2,13,15.4,11,11,0,11,2,17,20,0,0,2019-2020,90.0,7.860262008733625,58.951965065502186
37,Manuel Akanji,SUI,DF,Dortmund,Bundesliga,24,1995,25.7,38,21,23,14,1,12,20,60.0,8,20,11,9,30,68,61,2,0,2019-2020,90.0,105.05836575875486,133.0739299610895
38,Marley Aké,FRA,"FW,MF",Marseille,Ligue 1,18,2001,1.1,2,2,1,1,0,1,3,33.3,2,0,0,0,1,3,1,0,0,2019-2020,90.0,81.81818181818181,163.63636363636363
39,Nathan Aké,NED,DF,Bournemouth,Premier League,24,1995,27.8,31,21,23,8,0,14,23,60.9,9,40,29,11,36,67,152,0,0,2019-2020,90.0,116.54676258992806,100.35971223021583
40,Chadrac Akolo,COD,"FW,MF",Amiens,Ligue 1,24,1995,6.0,16,8,8,6,2,5,12,41.7,7,6,1,5,5,21,5,0,0,2019-2020,90.0,75.0,240.0
41,Kevin Akpoguma,NGA,DF,Hoffenheim,Bundesliga,24,1995,12.7,24,16,20,4,0,13,24,54.2,11,21,11,10,13,37,48,0,0,2019-2020,90.0,92.1259842519685,170.07874015748033
42,David Alaba,AUT,DF,Bayern Munich,Bundesliga,27,1992,27.8,30,17,14,15,1,16,25,64.0,9,19,10,9,29,59,40,0,0,2019-2020,90.0,93.88489208633094,97.12230215827338
43,Sofiane Alakouch,MAR,DF,Nîmes,Ligue 1,21,1998,15.6,45,26,25,13,7,25,48,52.1,23,13,2,11,23,68,39,3,0,2019-2020,90.0,132.69230769230768,259.6153846153846
44,Lucas Alario,ARG,FW,Leverkusen,Bundesliga,26,1992,13.0,6,3,0,4,2,1,8,12.5,7,12,2,10,1,7,9,0,0,2019-2020,90.00000000000001,6.923076923076923,41.53846153846154
45,Jordi Alba,ESP,DF,Barcelona,La Liga,30,1989,24.3,20,13,9,7,4,6,27,22.2,21,12,3,9,37,57,40,0,0,2019-2020,90.0,137.03703703703704,74.07407407407408
46,Luis Alberto,ESP,MF,Lazio,Serie A,26,1992,34.6,50,30,21,19,10,27,82,32.9,55,32,1,31,21,71,9,1,0,2019-2020,90.0,54.62427745664739,130.05780346820808
47,Raúl Albiol,ESP,DF,Villarreal,La Liga,33,1985,36.0,43,23,27,16,0,18,27,66.7,9,29,21,8,42,85,175,2,0,2019-2020,90.0,105.0,107.5
48,Marc Albrighton,ENG,"MF,DF",Leicester City,Premier League,29,1989,9.6,24,17,10,13,1,9,30,30.0,21,19,2,17,10,34,8,0,0,2019-2020,90.0,93.75,225.00000000000003
49,Paco Alcácer,ESP,FW,Villarreal,La Liga,25,1993,10.3,3,3,2,1,0,1,7,14.3,6,4,1,3,2,5,10,0,0,2019-2020,90.0,17.475728155339805,26.21359223300971
50,Paco Alcácer,ESP,FW,Dortmund,Bundesliga,25,1993,5.9,2,2,0,2,0,1,5,20.0,4,4,1,3,2,4,3,0,0,2019-2020,90.0,30.508474576271183,30.508474576271183
Rk,Player,Nation,Pos,Squad,Comp,0,0,90.0,0,0,3,3,3,Tkl,0,0.0,0,0,0,0,0,0,0,0,0,2019-2020,90.0,0.0,0.0
51,Thiago Alcántara,ESP,MF,Bayern Munich,Bundesliga,28,1991,19.7,45,26,17,23,5,12,33,36.4,21,12,3,9,45,90,13,1,0,2019-2020,90.0,205.58375634517768,205.58375634517768
52,Rubén Alcaraz,ESP,MF,Valladolid,La Liga,28,1991,21.4,61,30,37,20,4,30,63,47.6,33,46,15,31,15,76,41,0,0,2019-2020,90.0,63.084112149532714,256.5420560747664
53,Toby Alderweireld,BEL,DF,Tottenham,Premier League,30,1989,32.9,40,29,24,13,3,11,24,45.8,13,48,32,16,31,71,172,2,0,2019-2020,90.0,84.80243161094225,109.42249240121582
54,Haitam Aleesami,NOR,DF,Amiens,Ligue 1,28,1991,21.3,36,16,25,9,2,18,43,41.9,25,33,10,23,34,70,59,1,0,2019-2020,90.0,143.66197183098592,152.11267605633802
55,Álex Alegría,ESP,FW,Mallorca,La Liga,26,1992,1.2,1,0,1,0,0,0,0,0.0,0,2,0,2,0,1,0,0,0,2019-2020,90.0,0.0,75.0
56,Carles Aleñá,ESP,MF,Barcelona,La Liga,21,1998,1.9,2,1,1,1,0,1,4,25.0,3,1,0,1,0,2,0,0,0,2019-2020,90.0,0.0,94.73684210526315
57,Carles Aleñá,ESP,"MF,FW",Betis,La Liga,21,1998,8.2,14,9,5,7,2,3,17,17.6,14,4,1,3,1,15,3,0,0,2019-2020,90.0,10.975609756097562,153.65853658536588
58,Rúnar Alex Rúnarsson,ISL,GK,Dijon,Ligue 1,24,1995,10.0,0,0,0,0,0,0,2,0.0,2,0,0,0,0,0,3,3,0,2019-2020,90.0,0.0,0.0
59,Trent Alexander-Arnold,ENG,DF,Liverpool,Premier League,20,1998,35.3,55,34,35,17,3,36,78,46.2,42,27,9,18,45,100,84,3,0,2019-2020,90.0,114.73087818696885,140.22662889518415
60,Enrico Alfonso,ITA,GK,Brescia,Serie A,31,1988,3.1,0,0,0,0,0,0,0,0.0,0,0,0,0,0,0,2,0,0,2019-2020,90.0,0.0,0.0
61,Rachid Alioui,MAR,FW,Angers,Ligue 1,27,1992,17.4,8,5,0,7,1,2,13,15.4,11,3,0,3,2,10,9,0,0,2019-2020,90.0,10.344827586206897,41.37931034482759
62,Alisson,BRA,GK,Liverpool,Premier League,26,1992,28.3,0,0,0,0,0,0,2,0.0,2,0,0,0,1,1,13,3,0,2019-2020,90.0,3.1802120141342756,0.0
63,Allan,BRA,MF,Napoli,Serie A,28,1991,14.2,50,27,20,21,9,18,54,33.3,36,19,3,16,16,66,11,1,0,2019-2020,90.0,101.40845070422536,316.90140845070425
64,Dele Alli,ENG,"MF,FW",Tottenham,Premier League,23,1996,20.5,34,16,11,20,3,13,37,35.1,24,35,3,32,17,51,17,2,0,2019-2020,90.0,74.63414634146342,149.26829268292684
65,Miguel Almirón,PAR,"MF,FW",Newcastle Utd,Premier League,25,1994,33.6,60,39,32,20,8,19,52,36.5,33,25,1,24,31,91,25,0,0,2019-2020,90.0,83.03571428571428,160.7142857142857
66,Marcos Alonso,ESP,DF,Chelsea,Premier League,28,1990,15.9,28,16,20,6,2,14,33,42.4,19,18,2,16,20,48,32,0,0,2019-2020,90.0,113.20754716981132,158.49056603773585
67,Mickaël Alphonse,GLP,DF,Dijon,Ligue 1,30,1989,15.3,39,25,26,12,1,23,37,62.2,14,19,3,16,17,56,64,0,0,2019-2020,90.0,99.99999999999999,229.41176470588235
68,Sergio Álvarez,ESP,"MF,DF",Eibar,La Liga,27,1992,12.7,37,22,11,24,2,8,24,33.3,16,16,2,14,17,54,26,1,0,2019-2020,90.0,120.4724409448819,262.20472440944883
69,Sergio Álvarez,ESP,GK,Celta Vigo,La Liga,32,1986,2.0,0,0,0,0,0,0,0,0.0,0,0,0,0,0,0,1,0,0,2019-2020,90.0,0.0,0.0
70,Yeray Álvarez,ESP,DF,Athletic Club,La Liga,24,1995,31.2,36,19,28,7,1,17,30,56.7,13,33,22,11,62,98,138,2,0,2019-2020,90.0,178.84615384615384,103.84615384615384
71,Bruno Alves,POR,DF,Parma,Serie A,37,1981,29.7,17,11,12,5,0,8,13,61.5,5,30,21,9,25,42,150,2,0,2019-2020,90.0,75.75757575757575,51.515151515151516
72,Steven Alzate,COL,"MF,DF",Brighton,Premier League,20,1998,13.2,33,19,20,11,2,17,27,63.0,10,18,3,15,14,47,13,0,0,2019-2020,90.0,95.45454545454545,225.0
73,Ibrahim Amadou,FRA,"DF,MF",Norwich City,Premier League,26,1993,8.4,18,11,9,8,1,3,11,27.3,8,8,5,3,16,34,55,1,0,2019-2020,90.0,171.42857142857142,192.85714285714286
74,Ibrahim Amadou,FRA,MF,Leganés,La Liga,26,1993,8.6,16,9,5,9,2,4,11,36.4,7,5,0,5,12,28,6,0,0,2019-2020,90.0,125.58139534883722,167.4418604651163
75,Romain Amalfitano,FRA,MF,Dijon,Ligue 1,29,1989,18.8,43,27,18,21,4,21,61,34.4,40,23,9,14,36,79,14,2,0,2019-2020,90.0,172.3404255319149,205.85106382978722
Rk,Player,Nation,Pos,Squad,Comp,0,0,90.0,0,0,3,3,3,Tkl,0,0.0,0,0,0,0,0,0,0,0,0,2019-2020,90.0,0.0,0.0
76,Amath,SEN,MF,Getafe,La Liga,23,1996,0.7,2,1,1,1,0,0,5,0.0,5,2,0,2,0,2,0,0,0,2019-2020,90.0,0.0,257.14285714285717
77,Jordan Amavi,FRA,DF,Marseille,Ligue 1,25,1994,24.0,55,29,31,19,5,31,64,48.4,33,27,6,21,56,111,97,0,0,2019-2020,90.0,210.0,206.25
78,Thierry Ambrose,GLP,FW,Metz,Ligue 1,22,1997,6.1,7,5,2,2,3,2,7,28.6,5,3,0,3,3,10,3,0,0,2019-2020,90.0,44.26229508196722,103.27868852459018
79,Kelvin Amian,FRA,DF,Toulouse,Ligue 1,21,1998,18.1,27,21,21,5,1,14,25,56.0,11,14,7,7,18,45,56,0,0,2019-2020,90.0,89.50276243093921,134.25414364640883
80,Nadiem Amiri,GER,"MF,FW",Leverkusen,Bundesliga,22,1996,20.6,26,16,7,15,4,16,34,47.1,18,12,2,10,14,40,8,1,0,2019-2020,90.0,61.165048543689316,113.59223300970874
81,Ethan Ampadu,WAL,DF,RB Leipzig,Bundesliga,18,2000,0.9,5,4,3,2,0,1,1,100.0,0,3,1,2,1,6,3,0,0,2019-2020,90.0,100.0,500.0
82,Opoku Ampomah,GHA,"FW,MF",Düsseldorf,Bundesliga,23,1996,5.6,9,4,3,4,2,3,12,25.0,9,3,0,3,4,13,5,0,0,2019-2020,90.0,64.28571428571429,144.64285714285714
83,Sofyan Amrabat,MAR,MF,Hellas Verona,Serie A,22,1996,32.4,58,36,26,21,11,26,55,47.3,29,29,10,19,31,89,15,1,0,2019-2020,90.0,86.11111111111111,161.11111111111111
84,Joachim Andersen,DEN,DF,Lyon,Ligue 1,23,1996,17.0,17,9,15,2,0,7,19,36.8,12,16,12,4,10,27,74,2,0,2019-2020,90.0,52.94117647058824,90.0
85,Djavan Anderson,NED,"FW,DF",Lazio,Serie A,24,1995,1.9,0,0,0,0,0,0,0,0.0,0,1,0,1,3,3,3,0,0,2019-2020,90.0,142.10526315789474,0.0
86,Felipe Anderson,BRA,"MF,FW",West Ham,Premier League,26,1993,16.6,46,32,20,21,5,11,47,23.4,36,19,1,18,22,68,11,0,0,2019-2020,90.0,119.27710843373492,249.39759036144576
87,Sebastian Andersson,SWE,FW,Union Berlin,Bundesliga,28,1991,29.8,20,10,0,12,8,4,19,21.1,15,19,3,16,5,25,36,0,0,2019-2020,90.0,15.100671140939596,60.402684563758385
88,Florin Andone,ROU,FW,Brighton,Premier League,26,1993,0.8,1,1,0,1,0,1,1,100.0,0,1,1,0,0,1,1,0,0,2019-2020,90.0,0.0,112.5
89,Benjamin André,FRA,MF,Lille,Ligue 1,28,1990,22.8,72,44,31,35,6,29,74,39.2,45,32,9,23,59,131,40,1,0,2019-2020,90.0,232.89473684210523,284.2105263157894
90,Lorenzo Andrenacci,ITA,GK,Brescia,Serie A,24,1995,5.9,1,0,1,0,0,1,3,33.3,2,0,0,0,0,1,0,0,0,2019-2020,90.0,0.0,15.254237288135592
91,Robert Andrich,GER,MF,Union Berlin,Bundesliga,24,1994,28.6,52,27,28,18,6,19,60,31.7,41,27,7,20,47,99,36,0,0,2019-2020,90.0,147.9020979020979,163.63636363636365
92,Victorien Angban,CIV,MF,Metz,Ligue 1,22,1996,11.4,23,18,11,11,1,11,24,45.8,13,9,2,7,8,31,5,0,0,2019-2020,90.0,63.1578947368421,181.57894736842104
93,Miguel Ángel Guerrero,ESP,FW,Leganés,La Liga,29,1990,8.8,1,0,0,1,0,1,10,10.0,9,4,0,4,2,3,4,0,0,2019-2020,90.0,20.454545454545453,10.227272727272727
94,José Ángel,ESP,DF,Eibar,La Liga,29,1989,26.2,54,31,26,25,3,26,43,60.5,17,23,7,16,33,87,61,1,0,2019-2020,90.0,113.3587786259542,185.49618320610688
95,Miguel Ángel Moyá,ESP,GK,Real Sociedad,La Liga,35,1984,13.0,0,0,0,0,0,0,1,0.0,1,0,0,0,1,1,6,2,0,2019-2020,90.00000000000001,6.923076923076923,0.0
96,Angeliño,ESP,DF,Manchester City,Premier League,22,1997,4.7,5,2,3,1,1,5,7,71.4,2,1,0,1,9,14,15,0,0,2019-2020,90.0,172.3404255319149,95.74468085106382
97,Angeliño,ESP,"DF,FW",RB Leipzig,Bundesliga,22,1997,12.2,15,9,7,5,3,5,15,33.3,10,14,1,13,19,34,24,0,0,2019-2020,90.0,140.16393442622953,110.65573770491804
98,Faustino Anjorin,ENG,FW,Chelsea,Premier League,17,2001,0.2,0,0,0,0,0,0,0,0.0,0,1,0,1,0,0,0,0,0,2019-2020,90.0,0.0,0.0
99,Peter Ankersen,DEN,DF,Genoa,Serie A,28,1990,11.8,16,4,7,7,2,4,13,30.8,9,19,5,14,9,25,25,1,0,2019-2020,90.0,68.64406779661016,122.03389830508473
100,Cristian Ansaldi,ARG,"DF,MF",Torino,Serie A,32,1986,19.6,37,25,24,7,6,19,34,55.9,15,23,3,20,14,51,20,4,0,2019-2020,90.0,64.28571428571428,169.89795918367346
Rk,Player,Nation,Pos,Squad,Comp,0,0,90.0,0,0,3,3,3,Tkl,0,0.0,0,0,0,0,0,0,0,0,0,2019-2020,90.0,0.0,0.0
101,Janis Antiste,FRA,MF,Toulouse,Ligue 1,16,2002,0.1,0,0,0,0,0,0,0,0.0,0,0,0,0,0,0,0,0,0,2019-2020,90.0,0.0,0.0
102,Michail Antonio,JAM,FW,West Ham,Premier League,29,1990,19.6,13,9,5,4,4,4,14,28.6,10,17,2,15,9,22,5,0,0,2019-2020,90.0,41.326530612244895,59.69387755102041
103,Antoñito,ESP,"DF,MF",Valladolid,La Liga,31,1987,11.4,26,18,19,7,0,12,20,60.0,8,9,0,9,15,41,20,1,0,2019-2020,90.0,118.42105263157893,205.26315789473682
104,Mirko Antonucci,ITA,"FW,MF",Roma,Serie A,20,1999,0.9,4,3,1,0,3,3,3,100.0,0,2,0,2,2,6,1,0,0,2019-2020,90.0,200.0,400.0
105,Vitorino Antunes,POR,MF,Getafe,La Liga,32,1987,0.1,0,0,0,0,0,0,0,0.0,0,0,0,0,0,0,1,0,0,2019-2020,90.0,0.0,0.0
106,Christopher Antwi-Adjei,GHA,"MF,FW",Paderborn 07,Bundesliga,25,1994,27.4,25,16,13,9,3,9,33,27.3,24,29,2,27,15,40,14,0,0,2019-2020,90.0,49.27007299270073,82.11678832116789
107,Anuar,MAR,"MF,FW",Valladolid,La Liga,24,1995,2.1,4,2,1,2,1,2,6,33.3,4,7,3,4,5,9,0,0,0,2019-2020,90.0,214.28571428571428,171.42857142857142
108,Houssem Aouar,ALG,"MF,FW",Lyon,Ligue 1,21,1998,21.7,28,12,6,18,4,10,35,28.6,25,15,1,14,13,41,11,0,0,2019-2020,90.0,53.91705069124424,116.12903225806451
109,Adil Aouchiche,FRA,MF,Paris S-G,Ligue 1,17,2002,0.7,3,2,1,2,0,2,4,50.0,2,3,0,3,0,3,0,0,0,2019-2020,90.0,0.0,385.7142857142857
110,Dennis Appiah,FRA,DF,Nantes,Ligue 1,27,1992,17.8,58,35,32,20,6,28,52,53.8,24,9,3,6,23,81,34,0,0,2019-2020,90.0,116.29213483146067,293.2584269662921
111,Mauro Arambarri,URU,MF,Getafe,La Liga,23,1995,34.1,72,33,24,40,8,31,69,44.9,38,52,5,47,43,115,40,2,0,2019-2020,90.0,113.48973607038123,190.02932551319648
112,Guilherme Arana,BRA,DF,Atalanta,Serie A,22,1997,0.9,4,4,1,3,0,3,5,60.0,2,0,0,0,2,6,0,0,0,2019-2020,90.0,200.0,400.0
113,Charles Aránguiz,CHI,MF,Leverkusen,Bundesliga,30,1989,23.5,56,37,19,29,8,27,74,36.5,47,27,6,21,22,78,21,1,0,2019-2020,90.0,84.25531914893617,214.46808510638297
114,Luiz Araújo,BRA,"FW,MF",Lille,Ligue 1,23,1996,9.2,20,11,3,8,9,5,31,16.1,26,14,0,14,4,24,6,0,0,2019-2020,90.0,39.130434782608695,195.6521739130435
115,Néstor Araujo,MEX,DF,Celta Vigo,La Liga,27,1991,32.1,44,27,35,8,1,22,36,61.1,14,26,18,8,52,96,142,0,0,2019-2020,90.0,145.79439252336448,123.3644859813084
116,Ronald Araújo,URU,DF,Barcelona,La Liga,20,1999,2.6,3,2,2,1,0,1,1,100.0,0,6,2,4,0,3,9,0,0,2019-2020,90.0,0.0,103.84615384615384
117,Anaitz Arbilla,ESP,DF,Eibar,La Liga,32,1987,22.3,33,20,23,8,2,16,34,47.1,18,20,4,16,29,62,82,0,0,2019-2020,90.0,117.04035874439461,133.18385650224215
118,Alphonse Areola,FRA,GK,Real Madrid,La Liga,26,1993,4.0,0,0,0,0,0,0,0,0.0,0,0,0,0,0,0,0,0,0,2019-2020,90.0,0.0,0.0
119,Alphonse Areola,FRA,GK,Paris S-G,Ligue 1,26,1993,3.0,0,0,0,0,0,0,0,0.0,0,0,0,0,0,0,1,1,0,2019-2020,90.0,0.0,0.0
120,Santiago Arias,COL,DF,Atlético Madrid,La Liga,27,1992,12.0,36,24,20,12,4,10,18,55.6,8,12,7,5,19,55,20,1,0,2019-2020,90.0,142.5,270.0
121,Nicolò Armini,ITA,DF,Lazio,Serie A,18,2001,0.0,1,1,1,0,0,1,1,100.0,0,0,0,0,0,1,1,0,0,2019-2020,,,inf
122,Stuart Armstrong,SCO,MF,Southampton,Premier League,27,1992,19.1,32,19,19,11,2,9,38,23.7,29,22,4,18,11,43,23,1,0,2019-2020,90.0,51.832460732984295,150.7853403141361
123,José Arnaiz,ESP,"FW,MF",Osasuna,La Liga,24,1995,8.8,3,2,0,2,1,0,12,0.0,12,7,0,7,5,8,5,0,0,2019-2020,90.0,51.13636363636363,30.68181818181818
124,José Arnaiz,ESP,MF,Leganés,La Liga,24,1995,3.7,3,0,1,2,0,2,5,40.0,3,4,0,4,2,5,1,0,0,2019-2020,90.0,48.648648648648646,72.97297297297297
125,Maximilian Arnold,GER,MF,Wolfsburg,Bundesliga,25,1994,31.3,42,24,15,23,4,16,62,25.8,46,25,6,19,25,67,35,0,0,2019-2020,90.0,71.8849840255591,120.76677316293929
Rk,Player,Nation,Pos,Squad,Comp,0,0,90.0,0,0,3,3,3,Tkl,0,0.0,0,0,0,0,0,0,0,0,0,2019-2020,90.0,0.0,0.0
126,Kepa Arrizabalaga,ESP,GK,Chelsea,Premier League,24,1994,33.0,1,1,1,0,0,1,2,50.0,1,0,0,0,1,2,7,2,0,2019-2020,90.0,2.7272727272727275,2.7272727272727275
127,Kwadwo Asamoah,GHA,"DF,FW",Inter,Serie A,30,1988,7.1,10,8,4,5,1,6,14,42.9,8,8,1,7,9,19,13,0,0,2019-2020,90.0,114.08450704225353,126.7605633802817
128,Santiago Ascacíbar,ARG,MF,Hertha BSC,Bundesliga,22,1997,7.0,26,13,15,11,0,11,28,39.3,17,13,2,11,16,42,13,0,0,2019-2020,90.0,205.71428571428572,334.2857142857143
129,Sergio Asenjo,ESP,GK,Villarreal,La Liga,30,1989,34.0,0,0,0,0,0,0,2,0.0,2,0,0,0,1,1,15,1,0,2019-2020,90.0,2.6470588235294117,0.0
130,Marco Asensio,ESP,FW,Real Madrid,La Liga,23,1996,3.7,4,3,3,1,0,1,4,25.0,3,2,0,2,1,5,4,0,0,2019-2020,90.0,24.324324324324323,97.29729729729729
131,Kristoffer Askildsen,NOR,MF,Sampdoria,Serie A,18,2001,0.8,1,1,1,0,0,0,0,0.0,0,1,0,1,1,2,0,0,0,2019-2020,90.0,112.5,112.5
132,Iago Aspas,ESP,FW,Celta Vigo,La Liga,31,1987,36.2,29,19,7,9,13,12,45,26.7,33,16,1,15,22,51,7,0,0,2019-2020,90.0,54.696132596685075,72.09944751381215
133,Roger Assalé,CIV,"FW,MF",Leganés,La Liga,25,1993,5.9,3,2,1,0,2,1,9,11.1,8,8,0,8,0,3,1,0,0,2019-2020,90.0,0.0,45.762711864406775
134,Youcef Atal,ALG,"FW,DF",Nice,Ligue 1,23,1996,11.1,24,11,15,6,3,13,31,41.9,18,12,1,11,24,48,11,1,0,2019-2020,90.0,194.5945945945946,194.5945945945946
135,Miguel Atienza,ESP,MF,Eibar,La Liga,20,1999,0.3,1,1,0,1,0,1,2,50.0,1,1,1,0,2,3,1,0,0,2019-2020,90.0,600.0,300.0
136,Christian Atsu,GHA,"MF,FW",Newcastle Utd,Premier League,27,1992,8.3,10,8,5,5,0,5,14,35.7,9,19,0,19,5,15,9,0,0,2019-2020,90.0,54.21686746987951,108.43373493975902
137,Pierre-Emerick Aubameyang,GAB,FW,Arsenal,Premier League,30,1989,34.8,31,19,10,12,9,12,51,23.5,39,39,1,38,14,45,16,0,0,2019-2020,90.0,36.206896551724135,80.17241379310344
138,Emil Audero,ITA,GK,Sampdoria,Serie A,22,1997,36.0,1,1,1,0,0,1,3,33.3,2,0,0,0,0,1,21,1,0,2019-2020,90.0,0.0,2.5
139,Tommaso Augello,ITA,DF,Sampdoria,Serie A,24,1994,12.6,14,9,6,3,5,5,7,71.4,2,8,0,8,15,29,21,1,0,2019-2020,90.0,107.14285714285715,100.00000000000001
140,Jean-Kévin Augustin,FRA,FW,Monaco,Ligue 1,22,1997,3.0,3,0,1,2,0,1,6,16.7,5,2,0,2,3,6,0,0,0,2019-2020,90.0,90.0,90.0
141,Ludwig Augustinsson,SWE,"DF,MF",Werder Bremen,Bundesliga,25,1994,10.3,29,12,15,9,5,12,23,52.2,11,19,5,14,10,39,29,0,0,2019-2020,90.0,87.37864077669903,253.39805825242718
142,Serge Aurier,CIV,DF,Tottenham,Premier League,26,1992,30.0,93,69,58,27,8,39,69,56.5,30,38,6,32,47,140,98,2,0,2019-2020,90.0,141.0,279.0
143,Mathias Autret,FRA,"MF,FW",Brest,Ligue 1,28,1991,13.6,23,17,5,11,7,8,25,32.0,17,14,1,13,10,33,3,0,0,2019-2020,90.0,66.17647058823529,152.2058823529412
144,Ezequiel Ávila,ARG,FW,Osasuna,La Liga,25,1994,17.7,17,12,6,7,4,6,18,33.3,12,12,0,12,3,20,5,0,0,2019-2020,90.0,15.254237288135593,86.4406779661017
145,Javier Avilés,ESP,"MF,FW",Leganés,La Liga,21,1997,2.0,9,7,2,7,0,2,4,50.0,2,3,0,3,3,12,1,0,0,2019-2020,90.0,135.0,405.0
146,Chidozie Awaziem,NGA,DF,Leganés,La Liga,22,1997,22.2,34,22,29,5,0,16,27,59.3,11,26,15,11,28,62,73,1,0,2019-2020,90.0,113.51351351351353,137.83783783783784
147,Taiwo Awoniyi,NGA,"FW,MF",Mainz 05,Bundesliga,21,1997,5.4,2,0,0,2,0,0,4,0.0,4,4,2,2,2,4,3,0,0,2019-2020,90.0,33.33333333333333,33.33333333333333
148,Florian Ayé,FRA,"FW,MF",Brescia,Serie A,22,1997,15.3,17,9,9,5,3,6,13,46.2,7,17,2,15,4,21,18,1,0,2019-2020,90.0,23.52941176470588,99.99999999999999
149,Jordan Ayew,GHA,FW,Crystal Palace,Premier League,27,1991,35.0,48,30,10,22,16,17,49,34.7,32,29,4,25,15,63,21,0,0,2019-2020,90.0,38.57142857142857,123.42857142857143
150,Kaan Ayhan,TUR,DF,Düsseldorf,Bundesliga,24,1994,30.3,38,25,26,11,1,20,37,54.1,17,28,15,13,45,83,72,1,0,2019-2020,90.0,133.66336633663366,112.87128712871286
Rk,Player,Nation,Pos,Squad,Comp,0,0,90.0,0,0,3,3,3,Tkl,0,0.0,0,0,0,0,0,0,0,0,0,2019-2020,90.0,0.0,0.0
151,Ramon Azeez,NGA,MF,Granada,La Liga,26,1992,15.1,11,8,2,8,1,7,19,36.8,12,8,2,6,19,30,11,1,0,2019-2020,90.0,113.24503311258279,65.56291390728477
152,César Azpilicueta,ESP,DF,Chelsea,Premier League,29,1989,35.9,86,56,40,32,14,35,69,50.7,34,56,21,35,67,153,94,0,0,2019-2020,90.0,167.966573816156,215.5988857938719
153,Ludovic Baal,GUF,DF,Brest,Ligue 1,33,1986,9.2,27,15,13,12,2,10,22,45.5,12,9,3,6,17,44,20,0,0,2019-2020,90.0,166.30434782608697,264.1304347826087
154,Iddrisu Baba,GHA,MF,Mallorca,La Liga,23,1996,32.3,59,37,26,29,4,20,70,28.6,50,31,8,23,39,98,42,0,0,2019-2020,90.0,108.6687306501548,164.39628482972137
155,Khouma Babacar,SEN,FW,Lecce,Serie A,26,1993,15.8,12,8,2,6,4,1,7,14.3,6,12,3,9,3,15,34,0,0,2019-2020,90.0,17.088607594936708,68.35443037974683
156,Carlos Bacca,COL,FW,Villarreal,La Liga,32,1986,7.6,5,1,1,2,2,2,6,33.3,4,4,0,4,0,5,7,0,0,2019-2020,90.0,0.0,59.21052631578947
157,Milan Badelj,CRO,MF,Fiorentina,Serie A,30,1989,17.6,29,17,10,16,3,15,50,30.0,35,21,3,18,45,74,34,1,0,2019-2020,90.0,230.11363636363635,148.29545454545453
158,Matthias Bader,GER,DF,Köln,Bundesliga,22,1997,0.1,1,1,1,0,0,1,2,50.0,1,0,0,0,0,1,1,0,0,2019-2020,90.0,0.0,900.0
159,Benoît Badiashile,FRA,DF,Monaco,Ligue 1,18,2001,15.7,18,12,12,5,1,6,12,50.0,6,20,11,9,27,45,57,1,0,2019-2020,90.0,154.77707006369428,103.18471337579619
160,Bastian Badu,FRA,FW,Montpellier,Ligue 1,19,2000,0.1,0,0,0,0,0,0,0,0.0,0,0,0,0,0,0,0,0,0,2019-2020,90.0,0.0,0.0
161,Alex Baena,ESP,MF,Villarreal,La Liga,18,2001,0.2,0,0,0,0,0,0,0,0.0,0,1,0,1,0,0,0,0,0,2019-2020,90.0,0.0,0.0
162,Stéphane Bahoken,CMR,FW,Angers,Ligue 1,27,1992,10.1,7,4,1,2,4,1,7,14.3,6,4,1,3,2,9,2,0,0,2019-2020,90.0,17.821782178217823,62.37623762376238
163,Daniel Baier,GER,MF,Augsburg,Bundesliga,35,1984,21.6,33,17,14,14,5,15,43,34.9,28,19,7,12,58,91,27,0,0,2019-2020,90.0,241.66666666666666,137.5
164,Leon Bailey,JAM,"FW,MF",Leverkusen,Bundesliga,21,1997,12.1,6,3,1,5,0,6,16,37.5,10,9,0,9,8,14,3,0,0,2019-2020,90.0,59.50413223140496,44.628099173553714
165,Eric Bailly,CIV,DF,Manchester Utd,Premier League,25,1994,1.7,0,0,0,0,0,0,1,0.0,1,3,3,0,4,4,7,1,0,2019-2020,90.0,211.76470588235293,0.0
166,Dénys Bain,FRA,DF,Brest,Ligue 1,26,1993,14.1,21,14,15,6,0,9,9,100.0,0,13,10,3,28,49,66,0,0,2019-2020,89.99999999999999,178.72340425531914,134.04255319148936
167,Leighton Baines,ENG,DF,Everton,Premier League,34,1984,4.5,10,6,6,2,2,8,10,80.0,2,5,2,3,5,15,14,0,0,2019-2020,90.0,100.0,200.0
168,Stefan Bajic,FRA,GK,Saint-Étienne,Ligue 1,17,2001,1.0,0,0,0,0,0,0,0,0.0,0,1,0,1,0,0,2,0,0,2019-2020,90.0,0.0,0.0
169,Tiemoué Bakayoko,FRA,MF,Monaco,Ligue 1,24,1994,19.1,48,24,16,27,5,29,54,53.7,25,12,4,8,29,77,17,0,0,2019-2020,90.0,136.64921465968587,226.17801047120417
170,Lewis Baker,ENG,MF,Düsseldorf,Bundesliga,24,1995,6.1,8,5,6,2,0,2,10,20.0,8,5,2,3,2,10,5,0,0,2019-2020,90.0,29.508196721311478,118.03278688524591
171,Mitchel Bakker,NED,DF,Paris S-G,Ligue 1,19,2000,1.0,2,2,1,1,0,1,1,100.0,0,0,0,0,0,2,2,0,0,2019-2020,90.0,0.0,180.0
172,Ridle Baku,GER,"DF,MF",Mainz 05,Bundesliga,21,1998,26.1,54,31,25,22,7,26,53,49.1,27,45,7,38,42,96,57,0,0,2019-2020,90.0,144.82758620689654,186.20689655172413
173,Fabián Balbuena,PAR,DF,West Ham,Premier League,27,1991,13.1,17,12,13,3,1,9,25,36.0,16,15,5,10,26,43,75,3,0,2019-2020,90.0,178.6259541984733,116.79389312977099
174,Keita Baldé,SEN,"FW,MF",Monaco,Ligue 1,24,1995,9.5,6,5,1,1,4,3,9,33.3,6,4,1,3,2,8,7,1,0,2019-2020,90.0,18.94736842105263,56.8421052631579
175,George Baldock,GRE,DF,Sheffield Utd,Premier League,26,1993,38.0,62,43,35,17,10,27,47,57.4,20,26,3,23,34,96,83,3,0,2019-2020,90.0,80.52631578947368,146.8421052631579
Rk,Player,Nation,Pos,Squad,Comp,0,0,90.0,0,0,3,3,3,Tkl,0,0.0,0,0,0,0,0,0,0,0,0,2019-2020,90.0,0.0,0.0
176,Gareth Bale,WAL,"FW,MF",Real Madrid,La Liga,30,1989,12.1,9,5,5,2,2,3,14,21.4,11,8,2,6,6,15,9,0,0,2019-2020,90.0,44.628099173553714,66.94214876033058
177,Mikel Balenziaga,ESP,DF,Athletic Club,La Liga,31,1988,6.3,15,10,4,10,1,9,11,81.8,2,4,1,3,2,17,20,0,0,2019-2020,90.0,28.571428571428573,214.2857142857143
178,Leonardo Balerdi,ARG,"DF,MF",Dortmund,Bundesliga,20,1999,1.5,2,1,1,1,0,2,2,100.0,0,0,0,0,4,6,3,0,0,2019-2020,90.0,240.0,120.0
179,Marco Ballarini,ITA,MF,Udinese,Serie A,18,2001,0.0,0,0,0,0,0,0,0,0.0,0,0,0,0,0,0,0,0,0,2019-2020,,,
180,Fodé Ballo-Touré,SEN,DF,Monaco,Ligue 1,22,1997,18.7,36,25,21,11,4,17,32,53.1,15,10,1,9,24,60,45,0,0,2019-2020,90.0,115.50802139037432,173.2620320855615
181,Florent Balmont,FRA,MF,Dijon,Ligue 1,39,1980,4.5,12,6,5,7,0,7,12,58.3,5,6,0,6,1,13,3,0,0,2019-2020,90.0,20.0,240.0
182,Mario Balotelli,ITA,FW,Brescia,Serie A,28,1990,15.6,2,2,0,2,0,0,2,0.0,2,1,1,0,8,10,22,0,0,2019-2020,90.0,46.15384615384615,11.538461538461538
183,Abdoulaye Bamba,CIV,DF,Angers,Ligue 1,29,1990,6.2,10,7,7,1,2,8,15,53.3,7,4,1,3,4,14,18,0,0,2019-2020,90.0,58.064516129032256,145.16129032258064
184,Jonathan Bamba,CIV,"FW,MF",Lille,Ligue 1,23,1996,21.5,12,6,5,5,2,7,29,24.1,22,19,3,16,16,28,8,2,0,2019-2020,90.0,66.9767441860465,50.23255813953488
185,Éver Banega,ARG,MF,Sevilla,La Liga,31,1988,27.5,43,28,16,18,9,21,70,30.0,49,19,1,18,15,58,5,0,0,2019-2020,89.99999999999999,49.090909090909086,140.72727272727272
186,Mattia Bani,ITA,DF,Bologna,Serie A,25,1993,24.5,47,28,27,19,1,25,36,69.4,11,29,15,14,52,99,92,2,0,2019-2020,90.00000000000001,191.02040816326533,172.65306122448982
187,Antonín Barák,CZE,"MF,FW",Udinese,Serie A,24,1994,2.2,5,4,3,0,2,1,5,20.0,4,6,1,5,0,5,4,0,0,2019-2020,90.0,0.0,204.54545454545453
188,Antonín Barák,CZE,MF,Lecce,Serie A,24,1994,15.2,19,10,9,10,0,6,24,25.0,18,18,1,17,9,28,20,2,0,2019-2020,90.0,53.28947368421053,112.5
189,Federico Barba,ITA,DF,Valladolid,La Liga,25,1993,5.0,12,6,10,2,0,7,9,77.8,2,5,2,3,8,20,12,0,0,2019-2020,90.0,144.0,216.0
190,Danilo Barbosa,BRA,"DF,MF",Nice,Ligue 1,23,1996,12.5,28,21,17,9,2,13,29,44.8,16,21,6,15,20,48,38,0,0,2019-2020,90.0,144.0,201.6
191,Melvin Bard,FRA,DF,Lyon,Ligue 1,18,2000,0.5,0,0,0,0,0,0,0,0.0,0,0,0,0,1,1,0,0,0,2019-2020,90.0,180.0,0.0
192,Enis Bardhi,MKD,MF,Levante,La Liga,24,1995,23.5,24,11,7,15,2,8,35,22.9,27,15,4,11,15,39,19,0,0,2019-2020,90.0,57.44680851063829,91.91489361702128
193,Phil Bardsley,SCO,DF,Burnley,Premier League,34,1985,21.0,49,36,16,24,9,24,37,64.9,13,24,11,13,30,79,73,0,0,2019-2020,90.0,128.57142857142856,210.0
194,Nicolò Barella,ITA,MF,Inter,Serie A,22,1997,22.4,36,21,14,15,7,8,37,21.6,29,20,5,15,14,50,14,0,0,2019-2020,90.0,56.25,144.64285714285714
195,Philipp Bargfrede,GER,MF,Werder Bremen,Bundesliga,30,1989,6.5,15,12,8,5,2,6,23,26.1,17,8,2,6,16,31,15,0,0,2019-2020,90.00000000000001,221.53846153846155,207.6923076923077
196,Antonino Barillà,ITA,MF,Parma,Serie A,31,1988,18.8,43,31,22,19,2,16,45,35.6,29,26,8,18,17,60,32,0,0,2019-2020,90.0,81.38297872340425,205.85106382978722
197,Kike Barja,ESP,"MF,FW",Osasuna,La Liga,22,1997,3.5,1,1,1,0,0,1,1,100.0,0,3,1,2,0,1,2,0,0,2019-2020,90.0,0.0,25.714285714285715
198,Ross Barkley,ENG,MF,Chelsea,Premier League,25,1993,12.3,16,9,6,6,4,5,18,27.8,13,7,2,5,7,23,7,0,0,2019-2020,89.99999999999999,51.21951219512194,117.07317073170731
199,Aymen Barkok,MAR,"FW,MF",Düsseldorf,Bundesliga,21,1998,0.9,1,1,0,0,1,0,2,0.0,2,2,0,2,3,4,1,0,0,2019-2020,90.0,300.0,100.0
200,Ashley Barnes,ENG,FW,Burnley,Premier League,29,1989,15.0,10,5,3,5,2,3,9,33.3,6,7,2,5,6,16,9,0,0,2019-2020,90.0,36.0,60.0
Rk,Player,Nation,Pos,Squad,Comp,0,0,90.0,0,0,3,3,3,Tkl,0,0.0,0,0,0,0,0,0,0,0,0,2019-2020,90.0,0.0,0.0
201,Harvey Barnes,ENG,"MF,FW",Leicester City,Premier League,21,1997,23.1,16,11,7,7,2,5,23,21.7,18,13,3,10,8,24,6,1,0,2019-2020,89.99999999999999,31.168831168831165,62.33766233766233
202,Antonio Barragán,ESP,DF,Betis,La Liga,32,1987,7.1,7,5,4,2,1,3,6,50.0,3,2,2,0,8,15,22,0,0,2019-2020,90.0,101.40845070422536,88.73239436619718
203,Antonio Barreca,ITA,"DF,FW",Genoa,Serie A,24,1995,12.2,10,7,5,3,2,4,5,80.0,1,12,7,5,1,11,22,0,0,2019-2020,90.0,7.3770491803278695,73.7704918032787
204,Leandro Barreiro Martins,LUX,MF,Mainz 05,Bundesliga,19,2000,10.4,38,21,16,19,3,14,29,48.3,15,18,3,15,9,47,18,1,0,2019-2020,90.0,77.88461538461537,328.8461538461538
205,Ander Barrenetxea,ESP,"FW,MF",Real Sociedad,La Liga,17,2001,4.9,12,9,5,5,2,4,10,40.0,6,3,0,3,3,15,4,0,0,2019-2020,90.0,55.10204081632653,220.40816326530611
206,Édgar Barreto,PAR,MF,Sampdoria,Serie A,35,1984,1.0,4,3,0,1,3,2,3,66.7,1,1,0,1,0,4,0,0,0,2019-2020,90.0,0.0,360.0
207,Musa Barrow,GAM,"FW,MF",Bologna,Serie A,20,1998,15.0,20,13,11,7,2,6,20,30.0,14,15,0,15,5,25,11,0,0,2019-2020,90.0,30.0,120.0
208,Musa Barrow,GAM,"FW,MF",Atalanta,Serie A,20,1998,2.1,1,1,0,0,1,1,4,25.0,3,4,0,4,0,1,1,0,0,2019-2020,90.0,0.0,42.857142857142854
209,Fin Bartels,GER,"MF,FW",Werder Bremen,Bundesliga,32,1987,3.8,9,5,4,4,1,3,12,25.0,9,3,1,2,1,10,1,0,0,2019-2020,90.0,23.684210526315788,213.1578947368421
210,Marc Bartra,ESP,"DF,MF",Betis,La Liga,28,1991,28.0,62,34,39,23,0,27,54,50.0,27,45,24,21,35,97,127,0,0,2019-2020,90.0,112.5,199.28571428571428
211,Daniele Baselli,ITA,MF,Torino,Serie A,27,1992,14.2,43,23,17,19,7,13,40,32.5,27,20,4,16,25,68,25,0,0,2019-2020,90.0,158.45070422535213,272.53521126760563
212,Chris Basham,ENG,DF,Sheffield Utd,Premier League,31,1988,36.0,85,48,58,20,7,48,81,59.3,33,38,15,23,77,162,173,1,0,2019-2020,90.0,192.5,212.5
213,Toma Bašić,CRO,MF,Bordeaux,Ligue 1,22,1996,11.0,26,22,9,16,1,12,27,44.4,15,14,2,12,9,35,12,1,0,2019-2020,90.0,73.63636363636364,212.72727272727275
214,Thomas Basila,FRA,DF,Nantes,Ligue 1,20,1999,4.6,6,3,2,4,0,4,4,100.0,0,0,0,0,4,10,14,0,0,2019-2020,90.0,78.26086956521739,117.3913043478261
215,Gil Bastião Dias,POR,"MF,DF",Granada,La Liga,22,1996,4.0,19,14,10,6,3,7,17,41.2,10,4,1,3,3,22,7,0,0,2019-2020,90.0,67.5,427.5
216,Gil Bastião Dias,POR,"DF,MF",Monaco,Ligue 1,22,1996,11.7,53,33,30,21,2,29,58,50.0,29,15,1,14,13,66,22,1,0,2019-2020,89.99999999999999,100.0,407.6923076923077
217,Borja Bastón,ESP,"MF,FW",Aston Villa,Premier League,26,1992,0.2,1,0,0,1,0,0,2,0.0,2,1,0,1,0,1,0,1,0,2019-2020,90.0,0.0,450.0
218,Alessandro Bastoni,ITA,DF,Inter,Serie A,20,1999,21.3,32,17,14,11,7,15,24,62.5,9,18,9,9,26,58,54,0,0,2019-2020,90.0,109.85915492957747,135.2112676056338
219,Bastos,ANG,DF,Lazio,Serie A,28,1991,8.5,9,5,6,3,0,4,11,36.4,7,13,8,5,13,22,26,0,0,2019-2020,90.0,137.64705882352942,95.29411764705883
220,Oliver Batista-Meier,GER,MF,Bayern Munich,Bundesliga,18,2001,0.1,0,0,0,0,0,0,2,0.0,2,0,0,0,0,0,0,0,0,2019-2020,90.0,0.0,0.0
221,Michy Batshuayi,BEL,FW,Chelsea,Premier League,25,1993,2.7,4,1,2,2,0,0,5,0.0,5,1,1,0,0,4,1,0,0,2019-2020,90.0,0.0,133.33333333333331
222,Cristian Battocchio,ITA,MF,Brest,Ligue 1,27,1992,15.5,31,24,13,13,5,14,36,38.9,22,13,4,9,19,50,21,0,0,2019-2020,90.0,110.3225806451613,180.0
223,Oliver Baumann,GER,GK,Hoffenheim,Bundesliga,29,1990,30.0,0,0,0,0,0,0,0,0.0,0,1,0,1,3,3,15,0,0,2019-2020,90.0,9.0,0.0
224,Julian Baumgartlinger,AUT,MF,Leverkusen,Bundesliga,31,1988,19.9,42,21,15,21,6,18,42,42.9,24,37,4,33,20,62,16,1,0,2019-2020,90.0,90.45226130653268,189.9497487437186
225,Christoph Baumgartner,AUT,"MF,FW",Hoffenheim,Bundesliga,19,1999,16.6,32,17,15,16,1,10,37,27.0,27,25,1,24,8,40,13,0,0,2019-2020,90.0,43.37349397590361,173.49397590361443
Rk,Player,Nation,Pos,Squad,Comp,0,0,90.0,0,0,3,3,3,Tkl,0,0.0,0,0,0,0,0,0,0,0,0,2019-2020,90.0,0.0,0.0
226,Noah Joel Sarenren Bazee,NGA,FW,Augsburg,Bundesliga,22,1996,4.2,4,3,0,4,0,1,4,25.0,3,2,1,1,5,9,4,0,0,2019-2020,90.0,107.14285714285714,85.71428571428571
227,Ihlas Bebou,TOG,"FW,MF",Hoffenheim,Bundesliga,25,1994,23.4,27,15,9,13,5,8,23,34.8,15,25,4,21,11,38,25,0,0,2019-2020,89.99999999999999,42.30769230769231,103.84615384615384
228,Rodrigo Becão,BRA,DF,Udinese,Serie A,23,1996,24.6,56,25,34,19,3,26,46,56.5,20,40,20,20,45,101,77,0,0,2019-2020,89.99999999999999,164.63414634146338,204.87804878048777
229,Sheraldo Becker,SUR,"MF,FW",Union Berlin,Bundesliga,24,1995,6.0,2,1,2,0,0,1,3,33.3,2,1,0,1,0,2,1,0,0,2019-2020,90.0,0.0,30.0
230,Timo Becker,GER,"DF,MF",Schalke 04,Bundesliga,22,1997,3.7,10,9,3,6,1,5,9,55.6,4,6,1,5,3,13,8,0,0,2019-2020,90.0,72.97297297297297,243.24324324324323
231,Jan Bednarek,POL,DF,Southampton,Premier League,23,1996,34.0,65,38,41,18,6,31,61,50.8,30,44,23,21,77,142,198,4,0,2019-2020,90.0,203.82352941176472,172.05882352941177
232,Asmir Begović,BIH,GK,Milan,Serie A,32,1987,1.4,0,0,0,0,0,0,0,0.0,0,0,0,0,0,0,0,0,0,2019-2020,90.0,0.0,0.0
233,Valon Behrami,SUI,MF,Genoa,Serie A,34,1985,12.3,34,26,13,17,4,8,32,25.0,24,25,10,15,9,43,16,0,0,2019-2020,89.99999999999999,65.85365853658536,248.78048780487802
234,Maximilian Beier,GER,FW,Hoffenheim,Bundesliga,16,2002,1.2,5,2,0,1,4,1,2,50.0,1,2,0,2,0,5,0,0,0,2019-2020,90.0,0.0,375.0
235,Gaëtan Belaud,FRA,DF,Brest,Ligue 1,32,1986,6.4,13,7,10,2,1,4,8,50.0,4,8,3,5,15,28,15,0,0,2019-2020,90.0,210.9375,182.8125
236,Ishak Belfodil,ALG,"FW,MF",Hoffenheim,Bundesliga,27,1992,3.0,0,0,0,0,0,0,1,0.0,1,0,0,0,0,0,2,0,0,2019-2020,90.0,0.0,0.0
237,Haris Belkebla,ALG,MF,Brest,Ligue 1,25,1994,20.2,44,24,17,17,10,10,28,35.7,18,25,5,20,53,97,21,2,0,2019-2020,90.0,236.13861386138615,196.03960396039605
238,Raoul Bellanova,ITA,DF,Atalanta,Serie A,19,2000,0.2,0,0,0,0,0,0,0,0.0,0,0,0,0,0,0,0,0,0,2019-2020,90.0,0.0,0.0
239,Raoul Bellanova,ITA,DF,Bordeaux,Ligue 1,19,2000,0.7,1,1,1,0,0,0,1,0.0,1,0,0,0,0,1,0,0,0,2019-2020,90.0,0.0,128.57142857142858
240,Karim Bellarabi,GER,"FW,DF",Leverkusen,Bundesliga,29,1990,15.8,19,11,9,7,3,9,28,32.1,19,16,0,16,10,29,4,0,0,2019-2020,90.0,56.96202531645569,108.2278481012658
241,Jean-Ricner Bellegarde,FRA,MF,Strasbourg,Ligue 1,21,1998,16.6,40,27,18,19,3,13,21,61.9,8,16,3,13,22,62,6,0,0,2019-2020,90.0,119.27710843373492,216.86746987951804
242,Héctor Bellerín,ESP,"DF,MF",Arsenal,Premier League,24,1995,12.9,20,13,7,11,2,11,29,37.9,18,20,4,16,19,39,27,1,0,2019-2020,90.0,132.5581395348837,139.53488372093022
243,Andrea Belotti,ITA,FW,Torino,Serie A,25,1993,33.4,29,16,7,17,5,5,31,16.1,26,23,5,18,5,34,20,1,0,2019-2020,90.0,13.47305389221557,78.1437125748503
244,Fran Beltrán,ESP,MF,Celta Vigo,La Liga,20,1999,20.3,31,19,15,12,4,11,35,31.4,24,14,1,13,14,45,17,0,0,2019-2020,90.0,62.068965517241374,137.4384236453202
245,Sami Ben Amar,MAR,FW,Nîmes,Ligue 1,21,1998,0.2,1,1,0,0,1,1,1,100.0,0,1,0,1,1,2,0,0,0,2019-2020,90.0,450.0,450.0
246,Hatem Ben Arfa,FRA,"MF,FW",Valladolid,La Liga,32,1987,1.8,0,0,0,0,0,0,4,0.0,4,1,0,1,0,0,0,0,0,2019-2020,90.0,0.0,0.0
247,Wissam Ben Yedder,FRA,FW,Monaco,Ligue 1,28,1990,24.0,22,16,2,12,8,8,19,42.1,11,12,0,12,4,26,1,0,0,2019-2020,90.0,15.0,82.5
248,Marco Benassi,ITA,MF,Fiorentina,Serie A,24,1994,10.9,18,12,9,5,4,10,24,41.7,14,11,1,10,4,22,9,0,0,2019-2020,90.0,33.027522935779814,148.62385321100916
249,Cristian Benavente,PER,"MF,FW",Nantes,Ligue 1,25,1994,3.9,8,5,2,5,1,2,8,25.0,6,1,0,1,3,11,0,0,0,2019-2020,90.0,69.23076923076923,184.6153846153846
250,Lars Bender,GER,"DF,MF",Leverkusen,Bundesliga,30,1989,15.3,42,26,17,20,5,19,38,50.0,19,32,6,26,24,66,30,0,0,2019-2020,90.0,141.17647058823528,247.05882352941174
Rk,Player,Nation,Pos,Squad,Comp,0,0,90.0,0,0,3,3,3,Tkl,0,0.0,0,0,0,0,0,0,0,0,0,2019-2020,90.0,0.0,0.0
251,Sven Bender,GER,DF,Leverkusen,Bundesliga,30,1989,30.3,53,34,29,17,7,23,48,47.9,25,42,13,29,67,120,88,2,0,2019-2020,90.0,199.009900990099,157.4257425742574
252,Darío Benedetto,ARG,FW,Marseille,Ligue 1,29,1990,23.3,12,9,0,9,3,3,18,16.7,15,15,2,13,3,15,23,1,0,2019-2020,90.0,11.587982832618026,46.351931330472105
253,László Bénes,SVK,MF,Gladbach,Bundesliga,21,1997,10.0,15,8,3,5,7,6,19,31.6,13,6,2,4,8,23,3,1,0,2019-2020,90.0,72.0,135.0
254,Walter Benítez,ARG,GK,Nice,Ligue 1,26,1993,26.0,1,1,1,0,0,1,3,33.3,2,0,0,0,0,1,8,0,0,2019-2020,90.00000000000001,0.0,3.4615384615384617
255,Loris Benito,SUI,DF,Bordeaux,Ligue 1,27,1992,21.1,40,25,23,11,6,16,43,37.2,27,14,5,9,29,69,58,1,0,2019-2020,90.0,123.69668246445497,170.61611374407582
256,Bilal Benkhedim,FRA,"MF,FW",Saint-Étienne,Ligue 1,18,2001,1.5,3,3,1,1,1,1,4,25.0,3,1,0,1,1,4,0,0,0,2019-2020,90.0,60.0,180.0
257,Ismaël Bennacer,ALG,MF,Milan,Serie A,21,1997,27.6,67,47,21,34,12,29,73,39.7,44,25,7,18,54,121,15,2,0,2019-2020,90.0,176.08695652173913,218.4782608695652
258,Ryan Bennett,ENG,DF,Wolves,Premier League,29,1990,6.7,4,2,4,0,0,2,6,33.3,4,14,8,6,9,13,29,0,0,2019-2020,90.0,120.89552238805969,53.731343283582085
259,Ryan Bennett,ENG,DF,Leicester City,Premier League,29,1990,3.7,5,4,3,2,0,4,6,66.7,2,3,1,2,7,12,8,0,0,2019-2020,90.0,170.27027027027026,121.62162162162161
260,Keanan Bennetts,ENG,MF,Gladbach,Bundesliga,20,1999,0.0,0,0,0,0,0,0,1,0.0,1,0,0,0,0,0,0,0,0,2019-2020,,,
261,Yassine Benrahou,FRA,"FW,MF",Bordeaux,Ligue 1,20,1999,1.9,3,0,1,1,1,2,5,40.0,3,1,0,1,2,5,1,0,0,2019-2020,90.0,94.73684210526315,142.10526315789474
262,Yassine Benrahou,FRA,"MF,FW",Nîmes,Ligue 1,20,1999,8.5,13,8,3,3,7,5,16,31.3,11,1,0,1,2,15,0,0,0,2019-2020,90.0,21.176470588235293,137.64705882352942
263,Ramy Bensebaini,ALG,DF,Gladbach,Bundesliga,24,1995,16.1,33,17,17,12,4,18,31,58.1,13,24,4,20,38,71,49,0,0,2019-2020,90.0,212.42236024844718,184.47204968944098
264,Nabil Bentaleb,ALG,MF,Newcastle Utd,Premier League,24,1994,8.3,23,13,14,9,0,7,25,28.0,18,9,2,7,19,42,9,1,0,2019-2020,90.0,206.02409638554215,249.39759036144576
265,Rodrigo Bentancur,URU,MF,Juventus,Serie A,22,1997,24.4,58,32,27,18,13,31,66,47.0,35,44,9,35,32,90,34,1,0,2019-2020,90.0,118.03278688524591,213.93442622950823
266,Christian Benteke,BEL,FW,Crystal Palace,Premier League,28,1990,14.0,9,5,1,6,2,0,10,0.0,10,11,4,7,4,13,28,1,0,2019-2020,90.0,25.714285714285715,57.857142857142854
267,Romario Benzar,ROU,DF,Lecce,Serie A,27,1992,1.1,2,2,1,1,0,2,3,66.7,1,1,0,1,0,2,2,0,0,2019-2020,90.0,0.0,163.63636363636363
268,Karim Benzema,FRA,FW,Real Madrid,La Liga,31,1987,34.9,18,8,3,11,4,2,16,12.5,14,16,4,12,7,25,30,1,0,2019-2020,90.0,18.05157593123209,46.41833810888252
269,Yassine Benzia,ALG,MF,Dijon,Ligue 1,24,1994,1.9,3,2,2,1,0,1,6,16.7,5,4,2,2,3,6,1,0,0,2019-2020,90.0,142.10526315789474,142.10526315789474
270,Domenico Berardi,ITA,FW,Sassuolo,Serie A,24,1994,27.7,32,16,19,8,5,13,59,22.0,46,31,3,28,33,65,27,0,0,2019-2020,90.0,107.2202166064982,103.971119133574
271,Yuri Berchiche,ESP,DF,Athletic Club,La Liga,29,1990,31.7,48,35,32,15,1,21,40,52.5,19,26,4,22,30,78,73,1,0,2019-2020,90.0,85.17350157728707,136.2776025236593
272,Álex Berenguer,ESP,"MF,DF",Torino,Serie A,24,1995,20.3,20,6,6,13,1,8,33,24.2,25,17,1,16,18,38,17,0,0,2019-2020,90.0,79.80295566502463,88.66995073891626
273,Bartosz Bereszyński,POL,DF,Sampdoria,Serie A,27,1992,26.7,53,35,25,23,5,26,52,50.0,26,38,16,22,35,88,88,1,0,2019-2020,90.00000000000001,117.97752808988766,178.65168539325845
274,Jóhann Berg Guðmundsson,ISL,MF,Burnley,Premier League,28,1990,6.9,4,2,2,2,0,1,8,12.5,7,8,1,7,7,11,9,0,0,2019-2020,90.0,91.30434782608695,52.17391304347826
275,Markel Bergara,ESP,MF,Getafe,La Liga,33,1986,0.8,0,0,0,0,0,0,0,0.0,0,0,0,0,0,0,2,0,0,2019-2020,90.0,0.0,0.0
Rk,Player,Nation,Pos,Squad,Comp,0,0,90.0,0,0,3,3,3,Tkl,0,0.0,0,0,0,0,0,0,0,0,0,2019-2020,90.0,0.0,0.0
276,Sander Berge,NOR,MF,Sheffield Utd,Premier League,21,1998,10.5,22,15,3,14,5,5,10,50.0,5,15,1,14,10,32,16,0,0,2019-2020,90.0,85.71428571428571,188.57142857142856
277,Steven Bergwijn,NED,"FW,MF",Tottenham,Premier League,21,1997,7.8,10,6,3,6,1,4,12,33.3,8,12,0,12,1,11,5,0,0,2019-2020,90.0,11.538461538461538,115.38461538461539
278,Robert Berić,SVN,FW,Saint-Étienne,Ligue 1,28,1991,4.6,3,2,0,2,1,0,5,0.0,5,2,0,2,4,7,2,0,0,2019-2020,90.0,78.26086956521739,58.69565217391305
279,Etrit Berisha,ALB,GK,SPAL,Serie A,30,1989,26.0,3,2,3,0,0,2,3,66.7,1,0,0,0,1,4,9,0,0,2019-2020,90.00000000000001,3.4615384615384617,10.384615384615385
280,Valon Berisha,KVX,MF,Lazio,Serie A,26,1993,0.4,1,1,0,1,0,1,2,50.0,1,0,0,0,0,1,1,0,0,2019-2020,90.0,0.0,225.0
281,Valon Berisha,KVX,MF,Düsseldorf,Bundesliga,26,1993,10.5,14,9,3,8,3,6,21,28.6,15,4,1,3,9,23,8,0,0,2019-2020,90.0,77.14285714285714,120.0
282,Sergio Bermejo,ESP,"MF,FW",Celta Vigo,La Liga,21,1997,0.1,0,0,0,0,0,0,0,0.0,0,0,0,0,0,0,0,0,0,2019-2020,90.0,0.0,0.0
283,Bernard,BRA,"MF,FW",Everton,Premier League,26,1992,14.2,32,22,12,14,6,13,44,29.5,31,22,2,20,16,48,7,0,0,2019-2020,90.0,101.40845070422536,202.81690140845072
284,Federico Bernardeschi,ITA,"MF,FW",Juventus,Serie A,25,1994,17.5,13,5,4,5,4,5,25,20.0,20,11,0,11,13,26,12,1,0,2019-2020,90.0,66.85714285714286,66.85714285714286
285,Bernardo,BRA,"DF,MF",Brighton,Premier League,24,1995,7.5,27,16,12,9,6,13,17,76.5,4,7,3,4,6,33,24,0,0,2019-2020,90.0,72.0,324.0
286,Paul Bernardoni,FRA,GK,Nîmes,Ligue 1,22,1997,24.5,0,0,0,0,0,0,1,0.0,1,0,0,0,0,0,11,1,0,2019-2020,90.00000000000001,0.0,0.0
287,Juan Bernat,ESP,"DF,MF",Paris S-G,Ligue 1,26,1993,15.4,42,27,19,16,7,20,51,39.2,31,13,1,12,10,52,26,0,0,2019-2020,90.0,58.44155844155844,245.45454545454547
288,Dimitry Bertaud,COD,GK,Montpellier,Ligue 1,21,1998,2.2,0,0,0,0,0,0,0,0.0,0,0,0,0,0,0,0,0,0,2019-2020,90.0,0.0,0.0
289,Andrea Bertolacci,ITA,MF,Sampdoria,Serie A,28,1991,5.9,7,4,2,3,2,1,8,12.5,7,4,1,3,2,9,13,0,0,2019-2020,90.0,30.508474576271183,106.77966101694915
290,Ryan Bertrand,ENG,DF,Southampton,Premier League,29,1989,30.5,47,29,22,15,10,26,58,44.8,32,27,12,15,37,84,31,1,0,2019-2020,90.0,109.18032786885246,138.68852459016392
291,Muhamed Bešić,BIH,MF,Sheffield Utd,Premier League,26,1992,2.8,8,6,4,4,0,2,5,40.0,3,4,0,4,1,9,6,0,0,2019-2020,90.0,32.142857142857146,257.14285714285717
292,Jordan Beyer,GER,DF,Gladbach,Bundesliga,19,2000,1.2,3,1,3,0,0,0,1,0.0,1,4,2,2,1,4,4,0,0,2019-2020,90.0,75.0,225.00000000000003
293,Ermin Bičakčić,BIH,DF,Hoffenheim,Bundesliga,29,1990,13.1,7,3,5,2,0,4,11,36.4,7,14,8,6,25,32,64,2,0,2019-2020,90.0,171.7557251908397,48.091603053435115
294,Pedro Bigas,ESP,DF,Eibar,La Liga,28,1990,19.7,18,9,11,7,0,9,19,47.4,10,16,10,6,36,54,82,0,0,2019-2020,90.0,164.46700507614213,82.23350253807106
295,Lucas Biglia,ARG,MF,Milan,Serie A,33,1986,7.6,13,7,7,6,0,4,15,26.7,11,12,4,8,7,20,10,1,0,2019-2020,90.0,82.89473684210526,153.94736842105263
296,El Bilal Touré,MLI,FW,Reims,Ligue 1,17,2001,5.0,3,3,1,0,2,0,0,0.0,0,6,0,6,1,4,1,0,0,2019-2020,90.0,18.0,54.0
297,Philip Billing,DEN,MF,Bournemouth,Premier League,23,1996,28.1,72,46,30,37,5,17,65,26.2,48,59,16,43,66,138,97,1,0,2019-2020,90.0,211.3879003558719,230.60498220640568
298,Cristiano Biraghi,ITA,DF,Inter,Serie A,26,1992,17.5,22,6,10,8,4,10,24,41.7,14,21,7,14,13,35,41,0,0,2019-2020,90.0,66.85714285714286,113.14285714285714
299,Davide Biraschi,ITA,DF,Genoa,Serie A,25,1994,21.9,32,17,17,13,2,15,26,57.7,11,22,12,10,34,66,69,0,0,2019-2020,90.0,139.72602739726028,131.5068493150685
300,Valter Birsa,SVN,"MF,FW",Cagliari,Serie A,32,1986,4.8,10,6,3,6,1,7,21,33.3,14,6,1,5,4,14,3,0,0,2019-2020,90.0,75.0,187.5
Rk,Player,Nation,Pos,Squad,Comp,0,0,90.0,0,0,3,3,3,Tkl,0,0.0,0,0,0,0,0,0,0,0,0,2019-2020,90.0,0.0,0.0
301,Dimitri Bisoli,ITA,MF,Brescia,Serie A,25,1994,23.9,64,35,34,20,10,30,49,61.2,19,41,7,34,25,89,49,0,0,2019-2020,90.0,94.14225941422595,241.00418410041843
302,Yves Bissouma,MLI,MF,Brighton,Premier League,22,1996,14.0,49,38,24,22,3,17,40,42.5,23,18,2,16,21,70,23,0,0,2019-2020,90.0,135.0,315.0
303,Leonardo Bittencourt,GER,MF,Hoffenheim,Bundesliga,25,1993,0.0,1,1,0,0,1,0,0,0.0,0,0,0,0,0,1,0,0,0,2019-2020,,,inf
304,Leonardo Bittencourt,GER,"FW,MF",Werder Bremen,Bundesliga,25,1993,21.0,52,28,23,18,11,9,51,17.6,42,20,3,17,12,64,14,0,0,2019-2020,90.0,51.42857142857143,222.85714285714286
305,Birkir Bjarnason,ISL,"MF,FW",Brescia,Serie A,31,1988,8.9,5,3,1,3,1,2,13,15.4,11,9,4,5,5,10,4,0,0,2019-2020,90.0,50.56179775280899,50.56179775280899
306,Rubén Blanco,ESP,GK,Celta Vigo,La Liga,24,1995,32.9,1,1,1,0,0,1,1,100.0,0,0,0,0,0,1,14,1,0,2019-2020,90.0,0.0,2.7355623100303954
307,Ludovic Blas,FRA,"FW,MF",Nantes,Ligue 1,21,1997,20.5,26,18,7,15,4,5,26,19.2,21,17,1,16,14,40,11,0,0,2019-2020,90.0,61.46341463414634,114.14634146341464
308,Pablo de Blasis,ARG,"DF,MF",Eibar,La Liga,31,1988,17.8,41,32,22,13,6,30,63,47.6,33,13,0,13,24,65,21,0,0,2019-2020,90.0,121.34831460674158,207.30337078651687
309,Alejandro Blesa,ESP,MF,Levante,La Liga,17,2002,0.0,0,0,0,0,0,0,1,0.0,1,0,0,0,0,0,0,0,0,2019-2020,,,
310,Alexis Blin,FRA,MF,Amiens,Ligue 1,22,1996,20.5,39,25,18,15,6,20,61,32.8,41,25,6,19,16,55,49,0,0,2019-2020,90.0,70.2439024390244,171.21951219512195
311,Jérôme Boateng,GER,DF,Bayern Munich,Bundesliga,30,1988,20.0,21,14,9,12,0,11,22,50.0,11,15,11,4,33,54,58,1,0,2019-2020,90.0,148.5,94.5
312,Kevin-Prince Boateng,GHA,FW,Fiorentina,Serie A,32,1987,6.7,3,1,0,2,1,2,8,25.0,6,3,0,3,1,4,7,0,0,2019-2020,90.0,13.432835820895521,40.298507462686565
313,Antonin Bobichon,FRA,MF,Nîmes,Ligue 1,23,1995,2.0,4,3,1,3,0,3,3,100.0,0,1,0,1,1,5,0,0,0,2019-2020,90.0,45.0,180.0
314,Antonin Bobichon,FRA,MF,Angers,Ligue 1,23,1995,7.2,9,4,4,5,0,2,19,10.5,17,7,0,7,7,16,4,0,0,2019-2020,90.0,87.5,112.5
315,Salvatore Bocchetti,ITA,DF,Hellas Verona,Serie A,32,1986,3.4,5,3,3,2,0,2,3,66.7,1,2,2,0,17,22,23,0,0,2019-2020,90.0,450.0,132.35294117647058
316,Mathieu Bodmer,FRA,"MF,FW",Amiens,Ligue 1,36,1982,1.0,0,0,0,0,0,0,1,0.0,1,1,1,0,1,1,1,0,0,2019-2020,90.0,90.0,0.0
317,Adam Bodzek,GER,MF,Düsseldorf,Bundesliga,33,1985,22.4,42,26,21,20,1,14,46,30.4,32,34,11,23,25,67,39,0,0,2019-2020,90.0,100.44642857142857,168.75
318,Jean-Paul Boëtius,NED,MF,Mainz 05,Bundesliga,25,1994,25.2,63,33,21,31,11,20,57,35.1,37,38,1,37,26,89,6,0,0,2019-2020,90.0,92.85714285714286,225.00000000000003
319,Sacha Boey,FRA,DF,Rennes,Ligue 1,18,2000,1.9,6,4,3,1,2,4,8,50.0,4,0,0,0,2,8,5,0,0,2019-2020,90.0,94.73684210526315,284.2105263157895
320,Jeremie Boga,CIV,FW,Sassuolo,Serie A,22,1997,27.9,12,7,3,8,1,6,20,30.0,14,24,0,24,3,15,4,0,0,2019-2020,90.0,9.67741935483871,38.70967741935484
321,Melayro Bogarde,NED,DF,Hoffenheim,Bundesliga,17,2002,0.6,2,1,2,0,0,2,2,100.0,0,0,0,0,0,2,3,0,0,2019-2020,90.0,0.0,300.0
322,Quentin Boisgard,FRA,"MF,FW",Toulouse,Ligue 1,22,1997,12.7,31,19,10,14,7,14,35,40.0,21,11,0,11,12,43,4,1,0,2019-2020,90.0,85.03937007874016,219.68503937007875
323,Willy Boly,CIV,DF,Wolves,Premier League,28,1991,22.0,57,33,36,21,0,25,43,58.1,18,28,11,17,39,96,108,3,0,2019-2020,90.0,159.54545454545456,233.1818181818182
324,Giacomo Bonaventura,ITA,"MF,FW",Milan,Serie A,29,1989,14.9,16,9,5,6,5,5,17,29.4,12,8,3,5,7,23,10,0,0,2019-2020,90.0,42.28187919463087,96.64429530201342
325,Federico Bonazzoli,ITA,FW,Sampdoria,Serie A,22,1997,8.3,7,5,1,4,2,0,7,0.0,7,3,0,3,5,12,2,0,0,2019-2020,90.0,54.21686746987951,75.90361445783131
Rk,Player,Nation,Pos,Squad,Comp,0,0,90.0,0,0,3,3,3,Tkl,0,0.0,0,0,0,0,0,0,0,0,0,2019-2020,90.0,0.0,0.0
326,Gaëtan Bong,CMR,"DF,MF",Brighton,Premier League,31,1988,0.7,1,0,0,0,1,0,0,0.0,0,1,1,0,0,1,0,0,0,2019-2020,90.0,0.0,128.57142857142858
327,Kevin Bonifazi,ITA,DF,Torino,Serie A,23,1996,2.7,9,8,6,3,0,5,6,83.3,1,3,2,1,5,14,10,0,0,2019-2020,90.0,166.66666666666666,300.0
328,Kevin Bonifazi,ITA,DF,SPAL,Serie A,23,1996,13.2,16,9,15,1,0,9,18,50.0,9,20,12,8,35,51,50,2,0,2019-2020,90.0,238.63636363636363,109.0909090909091
329,Federico Bonini,ITA,DF,Bologna,Serie A,17,2001,0.1,0,0,0,0,0,0,0,0.0,0,0,0,0,0,0,0,0,0,2019-2020,90.0,0.0,0.0
330,Leonardo Bonucci,ITA,DF,Juventus,Serie A,32,1987,34.2,28,17,18,8,2,12,17,70.6,5,32,29,3,31,59,94,2,0,2019-2020,90.0,81.57894736842105,73.6842105263158
331,Fabio Borini,ITA,"MF,FW",Hellas Verona,Serie A,28,1991,9.0,2,1,2,0,0,0,4,0.0,4,3,0,3,13,15,6,0,0,2019-2020,90.0,130.0,20.0
332,Fabio Borini,ITA,MF,Milan,Serie A,28,1991,0.8,2,2,0,0,2,0,2,0.0,2,1,0,1,0,2,3,0,0,2019-2020,90.0,0.0,225.0
333,Dennis Borkowski,GER,FW,RB Leipzig,Bundesliga,17,2002,0.1,0,0,0,0,0,0,0,0.0,0,0,0,0,0,0,0,0,0,2019-2020,90.0,0.0,0.0
334,Robin Bormuth,GER,DF,Düsseldorf,Bundesliga,23,1995,2.0,2,1,2,0,0,2,3,66.7,1,6,5,1,0,2,12,0,0,2019-2020,90.0,0.0,90.0
335,Sebastiaan Bornauw,BEL,DF,Köln,Bundesliga,20,1999,27.2,37,24,24,12,1,20,39,51.3,19,32,12,20,42,79,99,0,0,2019-2020,90.0,138.97058823529412,122.42647058823529
336,Brandon Borrello,AUS,"MF,FW",Freiburg,Bundesliga,24,1995,3.3,10,4,6,4,0,4,10,40.0,6,7,1,6,1,11,1,0,0,2019-2020,90.0,27.272727272727273,272.72727272727275
337,Gabriel Boschilia,BRA,"MF,FW",Monaco,Ligue 1,23,1996,1.4,3,1,0,3,0,1,5,20.0,4,1,1,0,2,5,2,0,0,2019-2020,90.0,128.57142857142858,192.85714285714286
338,Denis Bouanga,GAB,"FW,MF",Saint-Étienne,Ligue 1,24,1994,22.7,45,34,10,25,10,20,55,36.4,35,30,0,30,10,55,15,0,0,2019-2020,89.99999999999999,39.647577092511014,178.41409691629954
339,Hicham Boudaoui,ALG,"MF,FW",Nice,Ligue 1,19,1999,5.4,20,10,6,11,3,9,23,39.1,14,10,3,7,13,33,7,0,0,2019-2020,90.0,216.66666666666666,333.3333333333333
340,Ryad Boudebouz,ALG,"MF,FW",Saint-Étienne,Ligue 1,29,1990,17.7,25,16,9,14,2,8,25,32.0,17,14,1,13,7,32,5,0,0,2019-2020,90.0,35.59322033898305,127.11864406779662
341,Sofiane Boufal,MAR,"MF,FW",Southampton,Premier League,25,1993,8.5,16,8,6,5,5,6,15,40.0,9,17,0,17,4,20,1,0,0,2019-2020,90.0,42.35294117647059,169.41176470588235
342,Nassim Boujellab,MAR,"MF,FW",Schalke 04,Bundesliga,20,1999,4.7,12,10,5,4,3,5,14,35.7,9,8,1,7,7,19,5,0,0,2019-2020,90.0,134.04255319148936,229.78723404255317
343,Farid Boulaya,ALG,FW,Metz,Ligue 1,26,1993,9.1,14,10,7,4,3,7,19,36.8,12,5,0,5,6,20,3,0,0,2019-2020,90.0,59.34065934065934,138.46153846153845
344,Yassine Bounou,MAR,GK,Sevilla,La Liga,28,1991,5.5,0,0,0,0,0,0,0,0.0,0,0,0,0,0,0,0,0,0,2019-2020,90.0,0.0,0.0
345,Mehdi Bourabia,MAR,MF,Sassuolo,Serie A,27,1991,10.3,19,9,8,10,1,9,22,40.9,13,12,2,10,22,41,23,0,0,2019-2020,90.0,192.23300970873785,166.01941747572815
346,Benjamin Bourigeaud,FRA,MF,Rennes,Ligue 1,25,1994,21.1,40,12,18,20,2,17,68,25.0,51,38,7,31,20,60,25,0,0,2019-2020,90.0,85.30805687203791,170.61611374407582
347,Bilal Boutobba,FRA,MF,Montpellier,Ligue 1,20,1998,0.1,0,0,0,0,0,0,1,0.0,1,0,0,0,0,0,0,0,0,2019-2020,90.0,0.0,0.0
348,Jarrod Bowen,ENG,"FW,MF",West Ham,Premier League,22,1996,10.2,19,15,7,9,3,4,17,23.5,13,6,0,6,16,35,8,0,0,2019-2020,90.0,141.1764705882353,167.64705882352942
349,Dedryck Boyata,BEL,DF,Hertha BSC,Bundesliga,28,1990,27.1,24,18,17,5,2,4,12,33.3,8,39,32,7,62,86,158,1,0,2019-2020,90.0,205.9040590405904,79.70479704797049
350,John Boye,GHA,DF,Metz,Ligue 1,32,1987,23.5,30,19,25,5,0,19,32,59.4,13,31,18,13,31,61,116,0,0,2019-2020,90.0,118.72340425531914,114.89361702127658
Rk,Player,Nation,Pos,Squad,Comp,0,0,90.0,0,0,3,3,3,Tkl,0,0.0,0,0,0,0,0,0,0,0,0,2019-2020,90.0,0.0,0.0
351,Can Bozdogan,GER,MF,Schalke 04,Bundesliga,18,2001,2.6,8,6,5,3,0,3,12,25.0,9,2,0,2,2,10,2,0,0,2019-2020,90.0,69.23076923076923,276.9230769230769
352,Domagoj Bradarić,CRO,DF,Lille,Ligue 1,19,1999,15.8,28,11,9,17,2,12,27,44.4,15,16,3,13,22,50,28,0,0,2019-2020,90.0,125.31645569620251,159.49367088607593
353,Filip Bradarić,CRO,MF,Celta Vigo,La Liga,27,1992,7.8,12,9,5,5,2,3,8,37.5,5,12,3,9,17,29,19,0,0,2019-2020,90.0,196.15384615384616,138.46153846153845
354,Robbie Brady,IRL,MF,Burnley,Premier League,27,1992,5.0,11,9,5,4,2,3,10,30.0,7,10,2,8,5,16,8,0,0,2019-2020,90.0,90.0,198.0
355,Martin Braithwaite,DEN,"FW,MF",Barcelona,La Liga,28,1991,4.5,2,2,2,0,0,0,8,0.0,8,3,0,3,1,3,1,0,0,2019-2020,90.0,20.0,40.0
356,Martin Braithwaite,DEN,"FW,MF",Leganés,La Liga,28,1991,21.5,13,7,4,5,4,4,12,33.3,8,10,2,8,4,17,9,0,0,2019-2020,90.0,16.744186046511626,54.41860465116279
357,Federico Brancolini,ITA,GK,Fiorentina,Serie A,18,2001,0.1,0,0,0,0,0,0,0,0.0,0,0,0,0,0,0,0,0,0,2019-2020,90.0,0.0,0.0
358,Brandon,ESP,FW,Osasuna,La Liga,24,1995,4.5,5,3,1,3,1,0,5,0.0,5,4,0,4,0,5,1,0,0,2019-2020,90.0,0.0,100.0
359,Julian Brandt,GER,"MF,FW",Dortmund,Bundesliga,23,1996,24.5,48,33,15,21,12,25,55,45.5,30,35,2,33,16,64,10,1,0,2019-2020,90.00000000000001,58.77551020408164,176.3265306122449
360,Jarrad Branthwaite,ENG,DF,Everton,Premier League,17,2002,3.3,8,7,5,3,0,3,5,60.0,2,6,3,3,2,10,12,0,0,2019-2020,90.0,54.54545454545455,218.1818181818182
361,Darko Brašanac,SRB,MF,Osasuna,La Liga,27,1992,24.9,45,25,14,26,5,15,41,36.6,26,19,4,15,20,65,21,0,0,2019-2020,90.0,72.28915662650603,162.65060240963854
362,Claudio Bravo,CHI,GK,Manchester City,Premier League,36,1983,3.9,0,0,0,0,0,0,0,0.0,0,0,0,0,0,0,1,1,0,2019-2020,90.0,0.0,0.0
363,Josip Brekalo,CRO,"MF,FW",Wolfsburg,Bundesliga,21,1998,18.6,18,8,5,6,7,5,23,21.7,18,26,0,26,16,34,4,0,0,2019-2020,90.0,77.41935483870967,87.09677419354837
364,Gleison Bremer,BRA,DF,Torino,Serie A,22,1997,25.2,63,36,37,20,6,20,34,58.8,14,48,22,26,74,137,118,1,0,2019-2020,90.0,264.28571428571433,225.00000000000003
365,Marco Brescianini,ITA,MF,Milan,Serie A,19,2000,0.3,1,1,1,0,0,0,0,0.0,0,0,0,0,2,3,0,0,0,2019-2020,90.0,600.0,300.0
366,Anthony Briançon,FRA,DF,Nîmes,Ligue 1,24,1994,19.3,29,19,20,9,0,17,34,50.0,17,22,16,6,39,68,80,0,0,2019-2020,90.0,181.86528497409324,135.23316062176164
367,Jimmy Briand,FRA,FW,Bordeaux,Ligue 1,33,1985,16.9,12,8,5,4,3,3,13,23.1,10,8,4,4,6,18,12,0,0,2019-2020,90.0,31.952662721893493,63.905325443786985
368,Yan Brice Eteki,CMR,MF,Granada,La Liga,21,1997,16.7,37,21,14,18,5,15,31,48.4,16,17,4,13,24,61,20,1,0,2019-2020,90.0,129.34131736526945,199.4011976047904
369,Armando Broja,ALB,FW,Chelsea,Premier League,17,2001,0.1,0,0,0,0,0,0,0,0.0,0,0,0,0,0,0,0,0,0,2019-2020,90.0,0.0,0.0
370,Dylan Bronn,TUN,DF,Metz,Ligue 1,24,1995,9.0,7,5,6,1,0,4,7,57.1,3,11,9,2,6,13,42,0,0,2019-2020,90.0,60.0,70.0
371,David Brooks,WAL,"MF,FW",Bournemouth,Premier League,22,1997,5.6,5,5,1,2,2,2,14,14.3,12,5,1,4,2,7,1,0,0,2019-2020,90.0,32.142857142857146,80.35714285714286
372,John Brooks,USA,DF,Wolfsburg,Bundesliga,26,1993,24.7,38,27,27,9,2,24,49,49.0,25,31,12,19,41,79,93,0,0,2019-2020,90.0,149.39271255060729,138.46153846153845
373,Daniel Brosinski,GER,DF,Mainz 05,Bundesliga,31,1988,19.0,40,27,13,23,4,15,34,44.1,19,16,2,14,14,54,58,0,0,2019-2020,90.0,66.3157894736842,189.47368421052633
374,Josh Brownhill,ENG,MF,Burnley,Premier League,23,1995,8.9,14,8,5,7,2,5,13,38.5,8,9,4,5,14,28,18,0,0,2019-2020,90.0,141.57303370786516,141.57303370786516
375,Marcelo Brozović,CRO,MF,Inter,Serie A,26,1992,30.0,67,35,26,31,10,19,71,26.8,52,26,9,17,46,113,46,2,0,2019-2020,90.0,138.0,201.0
Rk,Player,Nation,Pos,Squad,Comp,0,0,90.0,0,0,3,3,3,Tkl,0,0.0,0,0,0,0,0,0,0,0,0,2019-2020,90.0,0.0,0.0
376,Gastón Brugman,URU,MF,Parma,Serie A,26,1992,16.2,47,24,25,15,7,19,46,41.3,27,33,15,18,27,74,19,2,0,2019-2020,90.0,150.0,261.11111111111114
377,Jeffrey Bruma,NED,DF,Wolfsburg,Bundesliga,27,1991,9.0,9,5,4,5,0,7,13,53.8,6,6,3,3,13,22,51,1,0,2019-2020,90.0,130.0,90.0
378,Jeffrey Bruma,NED,DF,Mainz 05,Bundesliga,27,1991,7.5,12,8,8,4,0,4,6,66.7,2,11,5,6,6,18,34,1,0,2019-2020,90.0,72.0,144.0
379,Jacob Bruun Larsen,DEN,"FW,MF",Hoffenheim,Bundesliga,20,1998,4.3,3,2,3,0,0,3,8,37.5,5,3,0,3,3,6,1,0,0,2019-2020,90.0,62.79069767441861,62.79069767441861
380,Jacob Bruun Larsen,DEN,FW,Dortmund,Bundesliga,20,1998,0.8,0,0,0,0,0,0,0,0.0,0,0,0,0,0,0,0,0,0,2019-2020,90.0,0.0,0.0
381,Lucas Buadés,FRA,"MF,FW",Nîmes,Ligue 1,21,1997,1.3,4,4,3,1,0,1,5,20.0,4,0,0,0,1,5,3,0,0,2019-2020,90.0,69.23076923076923,276.9230769230769
382,Ante Budimir,CRO,FW,Mallorca,La Liga,28,1991,30.7,31,15,4,22,5,7,29,24.1,22,21,4,17,8,39,29,0,0,2019-2020,90.0,23.452768729641697,90.87947882736157
383,Emi Buendía,ARG,"FW,MF",Norwich City,Premier League,22,1996,27.4,82,39,57,21,4,38,118,32.2,80,58,5,53,23,105,32,2,0,2019-2020,90.0,75.54744525547446,269.3430656934307
384,Gianluigi Buffon,ITA,GK,Juventus,Serie A,41,1978,9.0,0,0,0,0,0,0,0,0.0,0,0,0,0,0,0,3,1,0,2019-2020,90.0,0.0,0.0
385,Marius Bülter,GER,"MF,FW",Union Berlin,Bundesliga,26,1993,25.8,38,22,19,13,6,17,54,31.5,37,37,3,34,11,49,20,1,0,2019-2020,90.0,38.372093023255815,132.5581395348837
386,Esteban Burgos,ARG,DF,Eibar,La Liga,27,1992,12.4,11,9,9,2,0,5,9,55.6,4,11,6,5,17,28,66,2,0,2019-2020,90.0,123.38709677419355,79.83870967741936
387,Guido Burgstaller,AUT,FW,Schalke 04,Bundesliga,30,1989,13.7,7,3,0,5,2,4,15,26.7,11,12,3,9,4,11,10,0,0,2019-2020,90.0,26.277372262773724,45.98540145985402
388,Burgui,ESP,MF,Alavés,La Liga,25,1993,0.2,0,0,0,0,0,0,0,0.0,0,0,0,0,0,0,0,0,0,2019-2020,90.0,0.0,0.0
389,Jonathan Burkardt,GER,"FW,MF",Mainz 05,Bundesliga,19,2000,2.8,9,4,2,5,2,3,8,37.5,5,6,1,5,0,9,1,0,0,2019-2020,90.0,0.0,289.2857142857143
390,Oliver Burke,SCO,"MF,FW",Alavés,La Liga,22,1997,15.9,19,14,8,9,2,10,23,43.5,13,24,0,24,8,27,16,0,0,2019-2020,90.0,45.283018867924525,107.54716981132076
391,Roman Bürki,SUI,GK,Dortmund,Bundesliga,28,1990,30.8,2,2,2,0,0,2,3,66.7,1,1,0,1,2,4,13,1,0,2019-2020,90.0,5.8441558441558445,5.8441558441558445
392,Dan Burn,ENG,DF,Brighton,Premier League,27,1992,32.0,67,42,35,27,5,25,53,47.2,28,44,20,24,42,109,130,0,0,2019-2020,90.0,118.125,188.4375
393,Patrick Burner,MTQ,DF,Nice,Ligue 1,23,1996,15.9,35,25,15,17,3,14,25,56.0,11,11,2,9,30,65,37,0,0,2019-2020,90.0,169.81132075471697,198.11320754716982
394,Sergio Busquets,ESP,MF,Barcelona,La Liga,31,1988,27.6,80,44,23,43,14,41,71,57.7,30,36,5,31,44,124,24,2,0,2019-2020,90.0,143.4782608695652,260.86956521739125
395,Unai Bustinza,ESP,DF,Leganés,La Liga,27,1992,29.8,66,40,40,19,7,32,53,60.4,21,30,9,21,65,131,77,0,0,2019-2020,90.0,196.30872483221475,199.32885906040266
396,Ludovic Butelle,FRA,GK,Angers,Ligue 1,36,1983,26.0,1,1,1,0,0,1,2,50.0,1,1,0,1,0,1,10,4,0,2019-2020,90.00000000000001,0.0,3.4615384615384617
397,Marcin Bułka,POL,GK,Paris S-G,Ligue 1,19,1999,1.0,0,0,0,0,0,0,0,0.0,0,0,0,0,0,0,0,0,0,2019-2020,90.0,0.0,0.0
398,Sam Byram,ENG,DF,Norwich City,Premier League,25,1993,14.4,40,22,24,11,5,18,37,48.6,19,16,8,8,26,66,73,0,0,2019-2020,90.0,162.5,250.0
399,Erick Cabaco,URU,DF,Getafe,La Liga,24,1995,3.0,3,2,1,2,0,0,3,0.0,3,1,1,0,3,6,11,0,0,2019-2020,90.0,90.0,90.0
400,Erick Cabaco,URU,DF,Levante,La Liga,24,1995,9.0,12,9,9,3,0,4,6,66.7,2,12,7,5,12,24,50,1,0,2019-2020,90.0,120.0,120.0
Rk,Player,Nation,Pos,Squad,Comp,0,0,90.0,0,0,3,3,3,Tkl,0,0.0,0,0,0,0,0,0,0,0,0,2019-2020,90.0,0.0,0.0
401,Willy Caballero,ARG,GK,Chelsea,Premier League,37,1981,5.0,0,0,0,0,0,0,0,0.0,0,0,0,0,0,0,3,0,0,2019-2020,90.0,0.0,0.0
402,Yohan Cabaye,FRA,MF,Saint-Étienne,Ligue 1,33,1986,9.5,29,18,11,14,4,14,25,56.0,11,10,0,10,22,51,7,1,0,2019-2020,90.0,208.42105263157896,274.7368421052632
403,Manuel Cabit,MTQ,DF,Metz,Ligue 1,26,1993,3.0,3,1,1,2,0,2,10,20.0,8,5,0,5,4,7,5,0,0,2019-2020,90.0,120.0,90.0
404,Ariday Cabrera,ESP,MF,Mallorca,La Liga,30,1988,0.4,1,1,1,0,0,0,1,0.0,1,2,0,2,0,1,0,0,0,2019-2020,90.0,0.0,225.0
405,Leandro Cabrera,URU,DF,Getafe,La Liga,28,1991,17.0,10,6,5,5,0,5,12,41.7,7,10,4,6,21,31,66,0,0,2019-2020,90.0,111.17647058823529,52.94117647058824
406,Leandro Cabrera,URU,DF,Espanyol,La Liga,28,1991,17.0,27,11,17,9,1,17,28,60.7,11,19,12,7,21,48,78,1,0,2019-2020,90.0,111.17647058823529,142.94117647058823
407,Fabrizio Cacciatore,ITA,DF,Cagliari,Serie A,32,1986,12.8,14,4,9,4,1,6,9,66.7,3,10,6,4,16,30,44,0,0,2019-2020,90.0,112.5,98.4375
408,Martín Cáceres,URU,DF,Fiorentina,Serie A,32,1987,26.2,47,31,34,11,2,16,34,47.1,18,29,13,16,31,78,74,2,0,2019-2020,90.0,106.48854961832062,161.45038167938932
409,Anthony Caci,FRA,DF,Strasbourg,Ligue 1,22,1997,7.7,29,17,19,9,1,8,17,47.1,9,15,5,10,19,48,15,1,0,2019-2020,90.0,222.0779220779221,338.961038961039
410,Jhonder Cádiz,VEN,"FW,MF",Dijon,Ligue 1,24,1995,8.9,16,8,6,7,3,3,7,42.9,4,4,2,2,1,17,9,0,0,2019-2020,90.0,10.112359550561798,161.79775280898878
411,Mathieu Cafaro,FRA,"FW,MF",Reims,Ligue 1,22,1997,10.3,12,6,5,5,2,6,17,35.3,11,13,0,13,2,14,0,0,0,2019-2020,90.0,17.475728155339805,104.85436893203884
412,Jonathan Cafu,BRA,DF,Bordeaux,Ligue 1,28,1991,2.2,7,3,4,3,0,4,7,57.1,3,1,0,1,1,8,3,0,0,2019-2020,90.0,40.90909090909091,286.3636363636364
413,Gary Cahill,ENG,DF,Crystal Palace,Premier League,33,1985,24.1,15,8,11,4,0,7,15,46.7,8,34,25,9,18,33,114,1,0,2019-2020,90.0,67.21991701244814,56.016597510373444
414,Felipe Caicedo,ECU,FW,Lazio,Serie A,30,1988,15.6,17,10,4,7,6,2,11,18.2,9,9,1,8,4,21,2,0,0,2019-2020,90.0,23.076923076923077,98.07692307692308
415,Arturo Calabresi,ITA,DF,Amiens,Ligue 1,23,1996,20.9,53,33,29,20,4,33,75,44.0,42,24,11,13,29,82,60,0,0,2019-2020,90.0,124.88038277511961,228.22966507177034
416,Davide Calabria,ITA,DF,Milan,Serie A,22,1996,18.0,52,33,28,22,2,17,41,41.5,24,23,5,18,21,73,47,1,0,2019-2020,90.0,105.0,260.0
417,Riccardo Calafiori,ITA,DF,Roma,Serie A,17,2002,0.7,0,0,0,0,0,0,1,0.0,1,0,0,0,2,2,0,0,0,2019-2020,90.0,257.14285714285717,0.0
418,Mattia Caldara,ITA,DF,Atalanta,Serie A,25,1994,10.7,21,11,12,8,1,5,11,45.5,6,9,5,4,30,51,22,1,0,2019-2020,90.0,252.33644859813086,176.6355140186916
419,Marco Calderoni,ITA,DF,Lecce,Serie A,30,1989,22.9,38,25,22,13,3,20,39,51.3,19,27,10,17,37,75,54,1,0,2019-2020,90.0,145.41484716157206,149.34497816593887
420,Fernando Calero,ESP,DF,Espanyol,La Liga,23,1995,11.6,14,9,10,4,0,7,15,46.7,8,13,5,8,8,22,42,1,0,2019-2020,90.0,62.06896551724138,108.62068965517241
421,Duje Ćaleta-Car,CRO,DF,Marseille,Ligue 1,22,1996,21.0,29,15,17,11,1,18,26,69.2,8,17,6,11,26,55,98,0,0,2019-2020,90.0,111.42857142857143,124.28571428571428
422,Hakan Çalhanoğlu,TUR,"MF,FW",Milan,Serie A,25,1994,30.0,42,21,15,21,6,12,35,34.3,23,26,2,24,26,68,26,1,0,2019-2020,90.0,78.0,126.0
423,Daniel Caligiuri,ITA,"MF,FW",Schalke 04,Bundesliga,31,1988,25.5,58,37,18,25,15,27,74,36.5,47,67,6,61,25,83,39,0,0,2019-2020,90.0,88.23529411764706,204.7058823529412
424,José Callejón,ESP,"FW,MF",Napoli,Serie A,32,1987,24.1,13,9,3,7,3,9,25,36.0,16,15,3,12,10,23,14,1,0,2019-2020,90.0,37.344398340248965,48.54771784232365
425,Jonathan Calleri,ARG,FW,Espanyol,La Liga,25,1993,20.1,12,8,6,4,2,3,24,12.5,21,11,3,8,7,19,22,0,0,2019-2020,90.0,31.343283582089548,53.731343283582085
Rk,Player,Nation,Pos,Squad,Comp,0,0,90.0,0,0,3,3,3,Tkl,0,0.0,0,0,0,0,0,0,0,0,0,2019-2020,90.0,0.0,0.0
426,Dominic Calvert-Lewin,ENG,FW,Everton,Premier League,22,1997,29.2,7,5,1,4,2,1,10,10.0,9,15,2,13,6,13,36,0,0,2019-2020,90.0,18.493150684931507,21.575342465753426
427,Mahdi Camara,FRA,MF,Saint-Étienne,Ligue 1,21,1998,10.0,33,20,12,16,5,18,32,56.3,14,20,2,18,18,51,5,0,0,2019-2020,90.0,162.0,297.0
428,Souleymane Camara,SEN,FW,Montpellier,Ligue 1,36,1982,1.8,0,0,0,0,0,0,2,0.0,2,0,0,0,0,0,1,0,0,2019-2020,90.0,0.0,0.0
429,Víctor Camarasa,ESP,FW,Crystal Palace,Premier League,25,1994,0.1,0,0,0,0,0,0,0,0.0,0,0,0,0,0,0,0,0,0,2019-2020,90.0,0.0,0.0
430,Víctor Camarasa,ESP,MF,Alavés,La Liga,25,1994,14.4,18,10,5,10,3,7,18,38.9,11,8,3,5,15,33,12,0,0,2019-2020,90.0,93.75,112.5
431,Eduardo Camavinga,FRA,MF,Rennes,Ligue 1,16,2002,23.4,105,64,45,56,4,48,96,50.0,48,26,8,18,34,139,35,0,0,2019-2020,89.99999999999999,130.76923076923077,403.8461538461538
432,Sergio Camello,ESP,FW,Atlético Madrid,La Liga,18,2001,0.3,0,0,0,0,0,0,0,0.0,0,0,0,0,0,0,0,0,0,2019-2020,90.0,0.0,0.0
433,José Campaña,ESP,MF,Levante,La Liga,26,1993,35.1,38,25,15,13,10,13,53,24.5,40,30,5,25,44,82,42,2,0,2019-2020,90.0,112.82051282051282,97.43589743589743
434,Xisco Campos,ESP,DF,Mallorca,La Liga,37,1982,5.3,7,4,5,2,0,5,9,55.6,4,8,5,3,11,18,23,0,0,2019-2020,90.0,186.7924528301887,118.8679245283019
435,Víctor Campuzano,ESP,FW,Espanyol,La Liga,22,1997,9.7,12,9,1,6,5,3,19,15.8,16,8,0,8,2,14,4,0,0,2019-2020,90.0,18.556701030927837,111.34020618556703
436,Emre Can,GER,MF,Juventus,Serie A,25,1994,3.2,10,7,5,3,2,3,10,30.0,7,4,0,4,2,12,3,0,0,2019-2020,90.0,56.25,281.25
437,Emre Can,GER,"MF,DF",Dortmund,Bundesliga,25,1994,10.6,19,12,11,7,1,5,12,41.7,7,14,6,8,19,38,15,0,0,2019-2020,90.0,161.32075471698113,161.32075471698113
438,Sergio Canales,ESP,"MF,FW",Betis,La Liga,28,1991,35.1,25,16,14,6,5,7,28,25.0,21,30,1,29,13,38,16,0,0,2019-2020,90.0,33.333333333333336,64.1025641025641
439,João Cancelo,POR,DF,Manchester City,Premier League,25,1994,13.4,40,24,21,12,7,24,40,60.0,16,9,2,7,21,61,18,0,0,2019-2020,90.0,141.04477611940297,268.65671641791045
440,Antonio Candreva,ITA,DF,Inter,Serie A,32,1987,22.1,11,6,9,1,1,7,29,24.1,22,26,10,16,14,25,33,1,0,2019-2020,90.0,57.01357466063348,44.796380090497735
441,Gianmarco Cangiano,ITA,"FW,MF",Bologna,Serie A,17,2001,0.2,1,1,0,1,0,0,0,0.0,0,0,0,0,1,2,0,0,0,2019-2020,90.0,450.0,450.0
442,Todd Cantwell,ENG,"FW,MF",Norwich City,Premier League,21,1998,27.7,51,31,19,27,5,26,73,35.6,47,38,2,36,18,69,35,1,0,2019-2020,90.0,58.48375451263538,165.70397111913357
443,Ander Capa,ESP,DF,Athletic Club,La Liga,27,1992,31.9,64,36,37,21,6,24,59,40.7,35,26,7,19,28,92,63,0,0,2019-2020,90.0,78.99686520376176,180.56426332288402
444,Pierrick Capelle,FRA,"MF,DF",Angers,Ligue 1,32,1987,19.4,42,32,18,16,8,16,48,33.3,32,17,3,14,21,63,28,0,0,2019-2020,90.0,97.42268041237115,194.8453608247423
445,Étienne Capoue,FRA,MF,Watford,Premier League,31,1988,29.2,75,40,38,30,7,37,85,43.5,48,30,11,19,68,143,61,0,0,2019-2020,90.0,209.58904109589042,231.16438356164386
446,Gianluca Caprari,ITA,"FW,MF",Sampdoria,Serie A,26,1993,7.4,9,7,1,6,2,4,13,30.8,9,5,0,5,7,16,1,0,0,2019-2020,90.0,85.13513513513513,109.45945945945945
447,Gianluca Caprari,ITA,"FW,MF",Parma,Serie A,26,1993,6.5,1,1,0,1,0,0,5,0.0,5,7,2,5,4,5,2,0,0,2019-2020,90.00000000000001,55.38461538461539,13.846153846153847
448,Francesco Caputo,ITA,FW,Sassuolo,Serie A,31,1987,32.6,7,4,3,2,2,3,11,27.3,8,15,0,15,1,8,8,0,0,2019-2020,90.0,2.7607361963190185,19.32515337423313
449,Maxence Caqueret,FRA,MF,Lyon,Ligue 1,19,2000,6.3,24,15,10,13,1,11,25,44.0,14,14,2,12,9,33,6,1,0,2019-2020,90.0,128.57142857142858,342.8571428571429
450,Andrea Carboni,ITA,DF,Cagliari,Serie A,18,2001,4.1,8,4,3,5,0,3,4,75.0,1,6,6,0,7,15,20,0,0,2019-2020,90.0,153.65853658536588,175.609756097561
Rk,Player,Nation,Pos,Squad,Comp,0,0,90.0,0,0,3,3,3,Tkl,0,0.0,0,0,0,0,0,0,0,0,0,2019-2020,90.0,0.0,0.0
451,Irvin Cardona,FRA,"FW,MF",Brest,Ligue 1,21,1997,16.1,13,8,5,6,2,9,32,28.1,23,8,0,8,1,14,7,0,0,2019-2020,90.0,5.590062111801242,72.67080745341615
452,Marc Cardona,ESP,FW,Osasuna,La Liga,24,1995,7.8,1,0,0,1,0,0,8,0.0,8,3,1,2,2,3,2,0,0,2019-2020,90.0,23.076923076923077,11.538461538461538
453,Diego Carlos,BRA,DF,Sevilla,La Liga,26,1993,34.8,35,23,25,9,1,15,25,60.0,10,33,24,9,37,72,176,1,0,2019-2020,90.0,95.6896551724138,90.51724137931035
454,Lionel Carole,FRA,DF,Strasbourg,Ligue 1,28,1991,14.1,23,8,15,6,2,13,17,76.5,4,2,1,1,19,42,22,0,0,2019-2020,89.99999999999999,121.27659574468085,146.80851063829786
455,Yannick Carrasco,BEL,"MF,FW",Atlético Madrid,La Liga,25,1993,7.0,11,7,4,4,3,7,21,33.3,14,9,0,9,5,16,2,0,0,2019-2020,90.0,64.28571428571428,141.42857142857142
456,Daniel Carriço,POR,DF,Sevilla,La Liga,30,1988,9.4,8,2,4,3,1,1,6,16.7,5,4,3,1,8,16,23,0,0,2019-2020,90.0,76.59574468085106,76.59574468085106
457,Guido Carrillo,ARG,FW,Leganés,La Liga,28,1991,13.5,13,10,3,6,4,2,14,14.3,12,9,1,8,3,16,22,0,0,2019-2020,90.0,20.0,86.66666666666667
458,Andy Carroll,ENG,FW,Newcastle Utd,Premier League,30,1989,7.0,5,3,3,2,0,2,8,25.0,6,2,1,1,2,7,24,1,0,2019-2020,90.0,25.714285714285715,64.28571428571428
459,Dani Carvajal,ESP,DF,Real Madrid,La Liga,27,1992,30.4,65,46,33,25,7,23,42,54.8,19,43,14,29,36,101,53,0,0,2019-2020,90.0,106.57894736842105,192.43421052631578
460,Matis Carvalho,POR,GK,Montpellier,Ligue 1,20,1999,0.8,0,0,0,0,0,0,1,0.0,1,0,0,0,0,0,1,0,0,2019-2020,90.0,0.0,0.0
461,William Carvalho,POR,MF,Betis,La Liga,27,1992,9.9,7,4,4,2,1,4,14,28.6,10,7,5,2,4,11,8,1,0,2019-2020,90.0,36.36363636363637,63.63636363636363
462,Casemiro,BRA,MF,Real Madrid,La Liga,27,1992,34.3,96,60,43,45,8,39,99,39.4,60,53,10,43,68,164,72,0,0,2019-2020,90.0,178.4256559766764,251.89504373177846
463,Moreto Cassamã,GNB,MF,Reims,Ligue 1,21,1998,6.6,17,11,2,13,2,5,7,71.4,2,7,2,5,5,22,6,0,0,2019-2020,90.0,68.18181818181819,231.8181818181818
464,Francesco Cassata,ITA,MF,Genoa,Serie A,22,1997,16.2,20,10,12,5,3,9,30,30.0,21,12,2,10,11,31,11,0,0,2019-2020,90.0,61.111111111111114,111.11111111111111
465,Timothy Castagne,BEL,DF,Atalanta,Serie A,23,1995,19.7,31,20,9,16,6,13,25,52.0,12,34,5,29,17,48,23,0,0,2019-2020,90.0,77.66497461928934,141.62436548223351
466,Koen Casteels,BEL,GK,Wolfsburg,Bundesliga,27,1992,26.0,0,0,0,0,0,0,0,0.0,0,0,0,0,0,0,9,1,0,2019-2020,90.00000000000001,0.0,0.0
467,Jean-Charles Castelletto,CMR,DF,Brest,Ligue 1,24,1995,20.4,18,9,13,5,0,9,18,50.0,9,20,16,4,33,51,87,1,0,2019-2020,90.0,145.58823529411765,79.41176470588236
468,Samu Castillejo,ESP,"FW,MF",Milan,Serie A,24,1995,13.4,24,15,10,11,3,9,42,21.4,33,17,2,15,24,48,5,0,0,2019-2020,90.0,161.19402985074626,161.19402985074626
469,Jonny Castro,ESP,"MF,DF",Wolves,Premier League,25,1994,32.1,91,55,54,26,11,29,82,35.4,53,45,10,35,53,144,45,2,0,2019-2020,90.0,148.59813084112147,255.14018691588782
470,Lucas Castro,ARG,MF,SPAL,Serie A,30,1989,4.7,13,5,5,5,3,2,4,50.0,2,4,0,4,2,15,3,0,0,2019-2020,90.0,38.29787234042553,248.93617021276594
471,Lucas Castro,ARG,MF,Cagliari,Serie A,30,1989,6.7,7,3,3,4,0,1,12,8.3,11,6,1,5,8,15,14,0,0,2019-2020,90.0,107.46268656716417,94.02985074626865
472,Gaetano Castrovilli,ITA,MF,Fiorentina,Serie A,22,1997,29.7,59,31,25,23,11,18,53,34.0,35,29,2,27,15,74,31,1,0,2019-2020,90.0,45.45454545454545,178.78787878787878
473,Danilo Cataldi,ITA,MF,Lazio,Serie A,24,1994,6.6,17,11,10,5,2,10,20,50.0,10,7,1,6,13,30,10,0,0,2019-2020,90.0,177.27272727272728,231.8181818181818
474,Craig Cathcart,NIR,DF,Watford,Premier League,30,1989,27.6,41,26,25,15,1,10,24,41.7,14,19,16,3,25,66,136,1,0,2019-2020,90.0,81.52173913043477,133.69565217391303
475,Edinson Cavani,URU,FW,Paris S-G,Ligue 1,32,1987,6.7,5,1,0,2,3,0,3,0.0,3,7,0,7,1,6,2,0,0,2019-2020,90.0,13.432835820895521,67.16417910447761
Rk,Player,Nation,Pos,Squad,Comp,0,0,90.0,0,0,3,3,3,Tkl,0,0.0,0,0,0,0,0,0,0,0,0,2019-2020,90.0,0.0,0.0
476,Santi Cazorla,ESP,MF,Villarreal,La Liga,34,1984,27.2,48,25,14,21,13,20,57,35.1,37,23,1,22,19,67,16,2,0,2019-2020,90.0,62.86764705882353,158.8235294117647
477,Dani Ceballos,ESP,MF,Arsenal,Premier League,22,1996,18.8,45,23,26,14,5,18,61,29.5,43,14,3,11,32,77,16,1,0,2019-2020,90.0,153.1914893617021,215.4255319148936
478,Federico Ceccherini,ITA,DF,Fiorentina,Serie A,27,1992,9.3,14,8,11,3,0,10,10,100.0,0,9,5,4,13,27,37,1,0,2019-2020,90.0,125.8064516129032,135.48387096774192
479,Christian Celesia,ITA,DF,Torino,Serie A,17,2002,0.0,0,0,0,0,0,0,0,0.0,0,0,0,0,0,0,0,0,0,2019-2020,,,
480,Zeki Çelik,TUR,DF,Lille,Ligue 1,22,1997,23.0,53,28,18,28,7,27,60,45.0,33,24,4,20,26,79,39,0,0,2019-2020,90.0,101.73913043478262,207.3913043478261
481,Fabien Centonze,FRA,DF,Metz,Ligue 1,23,1996,28.0,76,49,53,22,1,34,57,59.6,23,30,11,19,59,135,98,0,0,2019-2020,90.0,189.64285714285714,244.28571428571428
482,Luca Ceppitelli,ITA,DF,Cagliari,Serie A,29,1989,13.8,22,15,16,6,0,6,11,54.5,5,23,17,6,23,45,66,2,0,2019-2020,90.0,149.99999999999997,143.4782608695652
483,Alberto Cerri,ITA,FW,SPAL,Serie A,23,1996,4.7,2,1,0,2,0,1,3,33.3,2,1,0,1,0,2,3,0,0,2019-2020,90.0,0.0,38.29787234042553
484,Alberto Cerri,ITA,FW,Cagliari,Serie A,23,1996,2.7,3,1,1,0,2,2,6,33.3,4,1,0,1,2,5,4,0,0,2019-2020,90.0,66.66666666666666,99.99999999999999
485,Julian Chabot,GER,DF,Sampdoria,Serie A,21,1998,6.3,11,7,6,5,0,6,11,54.5,5,3,2,1,15,26,26,0,0,2019-2020,90.0,214.2857142857143,157.14285714285717
486,Florian Chabrolle,FRA,MF,Marseille,Ligue 1,21,1998,0.2,0,0,0,0,0,0,0,0.0,0,0,0,0,0,0,0,0,0,2019-2020,90.0,0.0,0.0
487,Fouad Chafik,MAR,DF,Dijon,Ligue 1,32,1986,17.0,32,21,22,7,3,17,36,47.2,19,12,5,7,26,58,36,0,0,2019-2020,90.0,137.64705882352942,169.41176470588235
488,Sofian Chakla,MAR,DF,Villarreal,La Liga,25,1993,2.0,0,0,0,0,0,0,1,0.0,1,2,1,1,3,3,7,1,0,2019-2020,90.0,135.0,0.0
489,Nathaniel Chalobah,ENG,MF,Watford,Premier League,24,1994,10.3,30,11,13,13,4,12,27,44.4,15,10,4,6,18,48,20,0,0,2019-2020,90.0,157.28155339805826,262.13592233009706
490,Calum Chambers,ENG,DF,Arsenal,Premier League,24,1995,12.2,26,10,12,8,6,11,16,68.8,5,13,7,6,16,42,43,1,0,2019-2020,90.0,118.03278688524591,191.8032786885246
491,Jhon Chancellor,VEN,DF,Brescia,Serie A,27,1992,24.9,30,14,22,8,0,11,22,50.0,11,34,29,5,34,64,145,3,0,2019-2020,90.0,122.89156626506023,108.43373493975903
492,Timothy Chandler,USA,"DF,MF",Eint Frankfurt,Bundesliga,29,1990,13.6,22,10,9,8,5,9,16,56.3,7,9,4,5,13,35,21,0,0,2019-2020,90.0,86.02941176470588,145.58823529411765
493,Kwon Chang-hoon,KOR,"MF,FW",Freiburg,Bundesliga,25,1994,7.5,7,4,2,3,2,1,10,10.0,9,5,1,4,7,14,14,0,0,2019-2020,90.0,84.0,84.0
494,Gaëtan Charbonnier,FRA,"FW,MF",Brest,Ligue 1,30,1988,22.9,36,16,11,11,14,10,35,28.6,25,19,6,13,7,43,33,1,0,2019-2020,90.0,27.51091703056769,141.48471615720524
495,Brendan Chardonnet,FRA,DF,Brest,Ligue 1,24,1994,9.1,12,6,10,2,0,7,12,58.3,5,8,5,3,15,27,50,0,0,2019-2020,90.0,148.35164835164835,118.68131868131869
496,Charles,BRA,FW,Eibar,La Liga,35,1984,14.5,10,5,0,6,4,4,22,18.2,18,7,2,5,7,17,6,0,0,2019-2020,90.0,43.44827586206896,62.068965517241374
497,Xavier Chavalerin,FRA,MF,Reims,Ligue 1,28,1991,23.9,71,52,29,33,9,19,49,38.8,30,23,8,15,36,107,36,0,0,2019-2020,90.0,135.56485355648536,267.3640167364017
498,Pablo Chavarría,ARG,"FW,MF",Mallorca,La Liga,31,1988,2.3,1,1,0,1,0,0,4,0.0,4,1,1,0,1,2,2,0,0,2019-2020,90.0,39.130434782608695,39.130434782608695
499,Aurélien Chedjou,CMR,DF,Amiens,Ligue 1,34,1985,21.9,27,19,18,9,0,10,22,45.5,12,15,11,4,40,67,120,3,0,2019-2020,90.0,164.38356164383563,110.95890410958904
500,Pape Cheikh Diop,SEN,MF,Celta Vigo,La Liga,21,1997,6.7,10,4,6,3,1,2,12,16.7,10,4,2,2,5,15,3,0,0,2019-2020,90.0,67.16417910447761,134.32835820895522
Rk,Player,Nation,Pos,Squad,Comp,0,0,90.0,0,0,3,3,3,Tkl,0,0.0,0,0,0,0,0,0,0,0,0,2019-2020,90.0,0.0,0.0
501,Chema,ESP,DF,Getafe,La Liga,27,1992,3.4,4,3,1,3,0,1,2,50.0,1,1,0,1,5,9,12,0,0,2019-2020,90.0,132.35294117647058,105.88235294117646
502,Rayan Cherki,FRA,"MF,FW",Lyon,Ligue 1,15,2003,1.6,3,2,0,1,2,3,4,75.0,1,3,0,3,0,3,0,0,0,2019-2020,90.0,0.0,168.75
503,Denis Cheryshev,RUS,"MF,FW",Valencia,La Liga,28,1990,10.3,16,9,5,4,7,3,17,17.6,14,15,1,14,7,23,10,0,0,2019-2020,90.0,61.165048543689316,139.80582524271844
504,Giorgio Chiellini,ITA,DF,Juventus,Serie A,34,1984,2.2,3,0,3,0,0,1,1,100.0,0,2,2,0,1,4,9,0,0,2019-2020,90.0,40.90909090909091,122.72727272727272
505,Federico Chiesa,ITA,"FW,DF",Fiorentina,Serie A,21,1997,29.3,38,22,13,15,10,10,52,19.2,42,19,0,19,6,44,6,0,0,2019-2020,90.0,18.430034129692835,116.72354948805462
506,Ben Chilwell,ENG,DF,Leicester City,Premier League,22,1996,26.4,43,26,28,13,2,23,52,44.2,29,30,6,24,28,71,68,2,0,2019-2020,90.0,95.45454545454545,146.5909090909091
507,Vlad Chiricheș,ROU,DF,Sassuolo,Serie A,29,1989,7.9,14,9,12,2,0,7,10,70.0,3,13,8,5,11,25,28,2,0,2019-2020,90.0,125.31645569620251,159.49367088607593
508,Tahith Chong,NED,"FW,DF",Manchester Utd,Premier League,19,1999,0.4,0,0,0,0,0,0,0,0.0,0,0,0,0,0,0,0,0,0,2019-2020,90.0,0.0,0.0
509,Joris Chotard,FRA,MF,Montpellier,Ligue 1,17,2001,13.9,30,18,13,17,0,15,35,42.9,20,12,5,7,20,50,12,1,0,2019-2020,90.0,129.49640287769785,194.24460431654677
510,Hamza Choudhury,ENG,MF,Leicester City,Premier League,21,1997,9.9,17,8,7,8,2,3,25,12.0,22,15,6,9,24,41,13,0,0,2019-2020,90.0,218.1818181818182,154.54545454545453
511,Mounir Chouiar,FRA,"MF,FW",Dijon,Ligue 1,20,1999,16.7,36,23,13,18,5,12,42,28.6,30,8,0,8,13,49,13,0,0,2019-2020,90.0,70.05988023952096,194.0119760479042
512,Andreas Christensen,DEN,DF,Chelsea,Premier League,23,1996,19.5,38,21,25,12,1,15,21,71.4,6,12,8,4,29,67,56,0,0,2019-2020,90.0,133.84615384615384,175.3846153846154
513,Samuel Chukwueze,NGA,"FW,MF",Villarreal,La Liga,20,1999,22.8,23,14,12,6,5,13,30,43.3,17,15,1,14,10,33,14,1,0,2019-2020,90.0,39.473684210526315,90.78947368421052
514,Darko Churlinov,MKD,MF,Köln,Bundesliga,19,2000,0.2,1,1,1,0,0,1,2,50.0,1,0,0,0,1,2,0,0,0,2019-2020,90.0,450.0,450.0
515,Churripi,ESP,GK,Valladolid,La Liga,25,1994,2.7,1,1,1,0,0,1,1,100.0,0,0,0,0,0,1,2,0,0,2019-2020,90.0,0.0,33.33333333333333
516,Luca Cigarini,ITA,MF,Cagliari,Serie A,33,1986,17.8,37,20,23,13,1,16,40,40.0,24,28,10,18,20,57,29,0,0,2019-2020,90.0,101.12359550561798,187.07865168539325
517,Per Ciljan Skjelbred,NOR,MF,Hertha BSC,Bundesliga,32,1987,18.1,50,30,18,29,3,17,41,41.5,24,14,3,11,23,73,17,0,0,2019-2020,90.0,114.36464088397788,248.6187845303867
518,Jasper Cillessen,NED,GK,Valencia,La Liga,30,1989,23.3,0,0,0,0,0,0,1,0.0,1,0,0,0,3,3,3,1,0,2019-2020,90.0,11.587982832618026,0.0
519,Thiago Cionek,POL,DF,SPAL,Serie A,33,1986,24.1,53,32,36,12,5,22,53,41.5,31,30,11,19,46,99,91,2,0,2019-2020,90.0,171.78423236514521,197.9253112033195
520,Ibrahim Cissé,CIV,DF,Nice,Ligue 1,20,1999,0.6,1,1,1,0,0,0,0,0.0,0,0,0,0,0,1,6,0,0,2019-2020,90.0,0.0,150.0
521,Ibrahim Cissé,SEN,DF,Angers,Ligue 1,23,1996,0.7,2,1,0,2,0,0,0,0.0,0,0,0,0,0,2,2,0,0,2019-2020,90.0,0.0,257.14285714285717
522,Andrea Cistana,ITA,DF,Brescia,Serie A,22,1997,20.4,20,8,13,7,0,6,17,35.3,11,38,34,4,33,53,96,1,0,2019-2020,90.0,145.58823529411765,88.23529411764706
523,Ciaran Clark,IRL,DF,Newcastle Utd,Premier League,29,1989,13.2,20,12,18,2,0,9,15,60.0,6,18,14,4,11,31,82,0,0,2019-2020,90.0,75.0,136.36363636363637
524,Leon Clarke,ENG,"FW,MF",Sheffield Utd,Premier League,34,1985,0.4,0,0,0,0,0,0,0,0.0,0,0,0,0,0,0,2,0,0,2019-2020,90.0,0.0,0.0
525,Alexis Claude-Maurice,FRA,"FW,MF",Nice,Ligue 1,21,1998,18.1,26,16,8,11,7,13,35,37.1,22,20,4,16,11,37,4,0,0,2019-2020,90.0,54.696132596685075,129.2817679558011
Rk,Player,Nation,Pos,Squad,Comp,0,0,90.0,0,0,3,3,3,Tkl,0,0.0,0,0,0,0,0,0,0,0,0,2019-2020,90.0,0.0,0.0
526,Christian Clemens,GER,FW,Köln,Bundesliga,27,1991,0.2,0,0,0,0,0,0,0,0.0,0,1,1,0,0,0,0,0,0,2019-2020,90.0,0.0,0.0
527,Óscar Clemente,ESP,MF,Atlético Madrid,La Liga,20,1999,0.0,0,0,0,0,0,0,0,0.0,0,1,0,1,0,0,0,0,0,2019-2020,,,
528,Yannis Clementia,MTQ,GK,Nice,Ligue 1,22,1997,2.0,0,0,0,0,0,0,0,0.0,0,0,0,0,0,0,0,0,0,2019-2020,90.0,0.0,0.0
529,Denilho Cleonise,NED,FW,Genoa,Serie A,17,2001,0.5,1,0,1,0,0,0,0,0.0,0,0,0,0,1,2,0,0,0,2019-2020,90.0,180.0,180.0
530,Carlos Clerc,ESP,DF,Levante,La Liga,27,1992,20.5,28,16,14,13,1,12,20,60.0,8,22,9,13,22,50,61,0,0,2019-2020,90.0,96.58536585365854,122.92682926829268
531,Tom Cleverley,ENG,MF,Watford,Premier League,29,1989,10.8,28,15,8,14,6,9,36,25.0,27,13,1,12,10,38,15,0,0,2019-2020,90.0,83.33333333333333,233.33333333333331
532,Conor Coady,ENG,DF,Wolves,Premier League,26,1993,38.0,36,23,30,6,0,15,30,50.0,15,22,15,7,28,64,119,2,0,2019-2020,90.0,66.3157894736842,85.26315789473684
533,Marcus Coco,FRA,FW,Nantes,Ligue 1,23,1996,0.2,1,0,1,0,0,1,1,100.0,0,0,0,0,0,1,0,0,0,2019-2020,90.0,0.0,450.0
534,Renaud Cohade,FRA,MF,Metz,Ligue 1,34,1984,8.5,28,20,11,12,5,12,28,42.9,16,14,3,11,8,36,6,0,0,2019-2020,90.0,84.70588235294117,296.47058823529414
535,Coke,ESP,DF,Levante,La Liga,32,1987,11.0,25,18,14,8,3,14,30,46.7,16,9,2,7,13,38,19,0,0,2019-2020,90.0,106.36363636363637,204.54545454545456
536,Séamus Coleman,IRL,DF,Everton,Premier League,30,1988,20.4,42,31,24,14,4,19,25,76.0,6,21,9,12,24,66,43,1,0,2019-2020,90.0,105.88235294117648,185.29411764705884
537,Álex Collado,ESP,FW,Barcelona,La Liga,20,1999,0.1,0,0,0,0,0,0,0,0.0,0,0,0,0,0,0,0,0,0,2019-2020,90.0,0.0,0.0
538,Ebrima Colley,GAM,FW,Atalanta,Serie A,19,2000,0.9,2,1,1,0,1,1,2,50.0,1,1,0,1,1,3,0,0,0,2019-2020,90.0,100.0,200.0
539,Omar Colley,GAM,DF,Sampdoria,Serie A,26,1992,30.8,42,26,27,14,1,12,24,50.0,12,33,22,11,59,101,155,1,0,2019-2020,90.0,172.40259740259742,122.72727272727273
540,Jamilu Collins,NGA,DF,Paderborn 07,Bundesliga,24,1994,29.6,69,43,44,21,4,37,62,59.7,25,53,19,34,70,139,91,1,0,2019-2020,90.0,212.83783783783784,209.7972972972973
541,Simone Colombi,ITA,GK,Parma,Serie A,28,1991,4.0,0,0,0,0,0,0,0,0.0,0,0,0,0,0,0,1,0,0,2019-2020,90.0,0.0,0.0
542,Lorenzo Colombo,ITA,FW,Milan,Serie A,17,2002,0.1,0,0,0,0,0,0,0,0.0,0,0,0,0,0,0,0,0,0,2019-2020,90.0,0.0,0.0
543,Racine Coly,SEN,"DF,FW",Nice,Ligue 1,23,1995,7.2,21,13,15,5,1,9,17,52.9,8,5,0,5,12,33,23,0,0,2019-2020,90.0,150.0,262.5
544,Kingsley Coman,FRA,"FW,MF",Bayern Munich,Bundesliga,23,1996,16.7,19,11,6,7,6,12,27,44.4,15,9,0,9,4,23,3,0,0,2019-2020,90.0,21.55688622754491,102.39520958083833
545,Daniel Congré,FRA,DF,Montpellier,Ligue 1,34,1985,21.6,37,27,20,16,1,18,38,47.4,20,8,7,1,47,84,66,1,0,2019-2020,90.0,195.83333333333331,154.16666666666666
546,Aaron Connolly,IRL,FW,Brighton,Premier League,19,2000,14.0,7,6,1,4,2,3,10,30.0,7,11,0,11,0,7,3,0,0,2019-2020,90.0,0.0,45.0
547,Andrea Consigli,ITA,GK,Sassuolo,Serie A,32,1987,31.0,0,0,0,0,0,0,1,0.0,1,0,0,0,4,4,19,2,0,2019-2020,90.0,11.612903225806452,0.0
548,Andrea Conti,ITA,DF,Milan,Serie A,25,1994,19.2,41,25,23,15,3,21,49,42.9,28,21,8,13,43,84,42,1,0,2019-2020,90.0,201.5625,192.1875
549,Lewis Cook,ENG,"MF,FW",Bournemouth,Premier League,22,1997,15.0,27,14,15,9,3,10,47,21.3,37,17,5,12,17,44,17,1,0,2019-2020,90.0,102.0,162.0
550,Steve Cook,ENG,DF,Bournemouth,Premier League,28,1991,27.0,22,11,18,4,0,8,20,40.0,12,32,23,9,44,66,153,1,0,2019-2020,90.0,146.66666666666669,73.33333333333334
Rk,Player,Nation,Pos,Squad,Comp,0,0,90.0,0,0,3,3,3,Tkl,0,0.0,0,0,0,0,0,0,0,0,0,2019-2020,90.0,0.0,0.0
551,Francis Coquelin,FRA,MF,Valencia,La Liga,28,1991,21.2,37,21,25,11,1,16,38,42.1,22,19,9,10,38,75,25,0,0,2019-2020,90.0,161.32075471698113,157.0754716981132
552,Gabriele Corbo,ITA,DF,Bologna,Serie A,19,2000,1.4,1,1,1,0,0,0,3,0.0,3,2,2,0,4,5,5,0,0,2019-2020,90.0,257.14285714285717,64.28571428571429
553,Sébastien Corchia,FRA,DF,Espanyol,La Liga,28,1990,3.0,2,1,2,0,0,2,4,50.0,2,5,2,3,5,7,8,0,0,2019-2020,90.0,150.0,60.0
554,Iñigo Córdoba,ESP,FW,Athletic Club,La Liga,22,1997,16.0,33,20,16,12,5,14,52,26.9,38,30,2,28,16,49,13,0,0,2019-2020,90.0,90.0,185.625
555,Jhon Córdoba,COL,FW,Köln,Bundesliga,26,1993,22.2,9,6,1,5,3,3,13,23.1,10,19,1,18,5,14,17,0,0,2019-2020,90.0,20.270270270270274,36.48648648648649
556,Sergio Córdova,VEN,FW,Augsburg,Bundesliga,21,1997,4.1,3,0,0,2,1,1,10,10.0,9,0,0,0,0,3,3,0,0,2019-2020,90.0,0.0,65.85365853658537
557,Benjamin Corgnet,FRA,"MF,FW",Strasbourg,Ligue 1,32,1987,2.9,1,1,1,0,0,1,3,33.3,2,2,0,2,2,3,3,0,0,2019-2020,90.0,62.06896551724138,31.03448275862069
558,Jack Cork,ENG,MF,Burnley,Premier League,30,1989,29.0,35,24,10,20,5,12,62,19.4,50,34,12,22,28,63,49,0,0,2019-2020,90.0,86.89655172413792,108.62068965517241
559,Andreas Cornelius,DEN,FW,Parma,Serie A,26,1993,16.6,9,4,2,5,2,4,11,36.4,7,7,0,7,2,11,26,0,0,2019-2020,90.0,10.843373493975902,48.79518072289156
560,Maxwel Cornet,CIV,"FW,DF",Lyon,Ligue 1,22,1996,14.8,30,19,18,8,4,13,23,56.5,10,16,1,15,21,51,19,1,0,2019-2020,90.0,127.7027027027027,182.43243243243242
561,Quentin Cornette,FRA,"FW,MF",Amiens,Ligue 1,25,1994,3.9,8,3,3,2,3,3,9,33.3,6,7,1,6,6,14,5,0,0,2019-2020,90.0,138.46153846153845,184.6153846153846
562,Ángel Correa,ARG,"MF,FW",Atlético Madrid,La Liga,24,1995,22.9,25,9,7,9,9,9,36,25.0,27,23,5,18,14,39,21,0,0,2019-2020,90.0,55.02183406113538,98.25327510917032
563,Joaquín Correa,ARG,FW,Lazio,Serie A,24,1994,22.2,13,7,3,7,3,5,24,20.8,19,5,1,4,7,20,10,0,0,2019-2020,90.0,28.378378378378383,52.70270270270271
564,Rober Correa,ESP,DF,Eibar,La Liga,26,1992,10.3,13,6,8,3,2,6,10,60.0,4,6,4,2,16,29,31,0,0,2019-2020,90.0,139.80582524271844,113.59223300970874
565,Edmilson Correia,GNB,"FW,DF",Saint-Étienne,Ligue 1,19,2000,0.5,0,0,0,0,0,0,1,0.0,1,1,0,1,1,1,0,0,0,2019-2020,90.0,180.0,0.0
566,Thierry Correia,POR,DF,Valencia,La Liga,20,1999,2.9,8,3,5,3,0,1,2,50.0,1,5,0,5,2,10,10,0,0,2019-2020,90.0,62.06896551724138,248.27586206896552
567,Antonio Cortés,ESP,"FW,MF",Granada,La Liga,19,2000,2.0,1,1,0,1,0,0,1,0.0,1,0,0,0,0,1,2,0,0,2019-2020,90.0,0.0,45.0
568,Danny da Costa,GER,"DF,FW",Eint Frankfurt,Bundesliga,26,1993,15.4,26,17,14,8,4,6,16,37.5,10,16,1,15,15,41,26,0,0,2019-2020,90.0,87.66233766233766,151.94805194805195
569,Diego Costa,ESP,FW,Atlético Madrid,La Liga,30,1988,15.0,9,5,1,4,4,1,10,10.0,9,4,2,2,3,12,10,0,0,2019-2020,90.0,18.0,54.0
570,Douglas Costa,BRA,"FW,MF",Juventus,Serie A,28,1990,8.9,2,1,1,1,0,1,12,8.3,11,7,0,7,5,7,5,0,0,2019-2020,90.0,50.56179775280899,20.224719101123597
571,Jaume Costa,ESP,DF,Valencia,La Liga,31,1988,15.4,27,23,17,8,2,14,28,50.0,14,11,6,5,24,51,52,1,0,2019-2020,90.0,140.25974025974025,157.7922077922078
572,Angelo da Costa Júnior,BRA,GK,Bologna,Serie A,35,1983,1.0,0,0,0,0,0,0,0,0.0,0,0,0,0,0,0,0,0,0,2019-2020,90.0,0.0,0.0
573,Nuno da Costa,CPV,FW,Strasbourg,Ligue 1,28,1991,5.9,15,10,3,8,4,4,10,40.0,6,7,0,7,4,19,3,0,0,2019-2020,90.0,61.01694915254237,228.81355932203388
574,David Costas,ESP,DF,Celta Vigo,La Liga,24,1995,3.8,4,3,3,1,0,2,4,50.0,2,3,3,0,8,12,12,0,0,2019-2020,90.0,189.4736842105263,94.73684210526315
575,Benoît Costil,FRA,GK,Bordeaux,Ligue 1,32,1987,28.0,0,0,0,0,0,0,3,0.0,3,0,0,0,2,2,9,0,0,2019-2020,90.0,6.428571428571429,0.0
Rk,Player,Nation,Pos,Squad,Comp,0,0,90.0,0,0,3,3,3,Tkl,0,0.0,0,0,0,0,0,0,0,0,0,2019-2020,90.0,0.0,0.0
576,Kalifa Coulibaly,MLI,FW,Nantes,Ligue 1,27,1991,18.0,11,7,0,5,6,3,5,60.0,2,3,1,2,6,17,32,0,0,2019-2020,90.0,30.0,55.0
577,Senou Coulibaly,MLI,DF,Dijon,Ligue 1,24,1994,7.4,14,7,11,3,0,2,4,50.0,2,11,10,1,10,24,44,1,0,2019-2020,90.0,121.62162162162161,170.27027027027026
578,Yoann Court,FRA,"FW,MF",Brest,Ligue 1,29,1990,16.3,48,26,28,17,3,20,64,31.3,44,21,0,21,15,63,14,0,0,2019-2020,90.0,82.82208588957056,265.03067484662574
579,Thibaut Courtois,BEL,GK,Real Madrid,La Liga,27,1992,34.0,0,0,0,0,0,0,2,0.0,2,0,0,0,2,2,18,2,0,2019-2020,90.0,5.294117647058823,0.0
580,Philippe Coutinho,BRA,"MF,FW",Bayern Munich,Bundesliga,27,1992,15.7,21,15,1,13,7,2,13,15.4,11,9,2,7,6,27,0,0,0,2019-2020,90.0,34.39490445859873,120.38216560509555
581,Nicolas Cozza,FRA,DF,Montpellier,Ligue 1,20,1999,6.2,5,5,3,2,0,2,3,66.7,1,8,6,2,9,14,18,0,0,2019-2020,90.0,130.6451612903226,72.58064516129032
582,Alessio Cragno,ITA,GK,Cagliari,Serie A,25,1994,16.0,0,0,0,0,0,0,0,0.0,0,0,0,0,0,0,10,0,0,2019-2020,90.0,0.0,0.0
583,Aaron Cresswell,ENG,DF,West Ham,Premier League,29,1989,30.3,43,26,21,18,4,23,46,50.0,23,33,10,23,35,78,75,2,0,2019-2020,90.0,103.96039603960396,127.72277227722772
584,Domenico Criscito,ITA,DF,Genoa,Serie A,32,1986,22.8,53,33,34,12,7,24,56,42.9,32,25,13,12,53,106,81,1,0,2019-2020,90.0,209.21052631578945,209.21052631578945
585,Bryan Cristante,ITA,MF,Roma,Serie A,24,1995,18.0,25,15,6,14,5,8,27,29.6,19,13,4,9,22,47,23,0,0,2019-2020,90.0,110.0,125.0
586,Sebastián Cristóforo,URU,MF,Fiorentina,Serie A,25,1993,1.0,5,5,2,2,1,1,5,20.0,4,2,1,1,1,6,0,0,0,2019-2020,90.0,90.0,450.0
587,Sebastián Cristóforo,URU,MF,Eibar,La Liga,25,1993,9.7,35,19,11,14,10,13,32,40.6,19,25,3,22,8,43,2,0,0,2019-2020,90.0,74.22680412371135,324.74226804123714
588,Juan Cuadrado,COL,"DF,FW",Juventus,Serie A,31,1988,29.5,67,43,32,28,7,35,62,56.5,27,22,8,14,35,102,47,0,0,2019-2020,90.0,106.77966101694915,204.40677966101694
589,Cucho,COL,"FW,MF",Mallorca,La Liga,20,1999,16.5,15,8,6,8,1,6,21,28.6,15,14,1,13,10,25,15,0,0,2019-2020,90.0,54.54545454545455,81.81818181818183
590,Marc Cucurella,ESP,"MF,DF",Getafe,La Liga,21,1998,36.0,74,51,23,38,13,24,76,31.6,52,58,8,50,36,110,28,1,0,2019-2020,90.0,90.0,185.0
591,Iván Cuéllar,ESP,GK,Leganés,La Liga,35,1984,27.0,0,0,0,0,0,0,2,0.0,2,0,0,0,0,0,28,2,0,2019-2020,90.0,0.0,0.0
592,Jaume Cuéllar,BOL,"MF,FW",SPAL,Serie A,17,2001,0.8,1,0,0,0,1,0,1,0.0,1,0,0,0,0,1,0,0,0,2019-2020,90.0,0.0,112.5
593,Mickaël Cuisance,FRA,"MF,FW",Bayern Munich,Bundesliga,19,1999,3.4,2,1,0,2,0,1,9,11.1,8,1,1,0,3,5,0,0,0,2019-2020,90.0,79.41176470588235,52.94117647058823
594,Matheus Cunha,BRA,"FW,MF",Hertha BSC,Bundesliga,20,1999,8.3,10,5,6,4,0,4,11,36.4,7,11,1,10,10,20,1,0,0,2019-2020,90.0,108.43373493975902,108.43373493975902
595,Matheus Cunha,BRA,"FW,MF",RB Leipzig,Bundesliga,20,1999,3.1,6,2,0,1,5,0,2,0.0,2,5,1,4,1,7,0,0,0,2019-2020,90.0,29.032258064516128,174.19354838709677
596,Felipe Curcio,BRA,DF,Brescia,Serie A,25,1993,0.1,0,0,0,0,0,0,0,0.0,0,0,0,0,0,0,0,0,0,2019-2020,90.0,0.0,0.0
597,Patrick Cutrone,ITA,FW,Wolves,Premier League,21,1998,3.3,4,2,2,1,1,1,5,20.0,4,1,1,0,2,6,1,0,0,2019-2020,90.0,54.54545454545455,109.0909090909091
598,Patrick Cutrone,ITA,FW,Fiorentina,Serie A,21,1998,9.3,4,2,2,1,1,1,15,6.7,14,6,1,5,2,6,6,0,0,2019-2020,90.0,19.354838709677416,38.70967741935483
599,Wylan Cyprien,FRA,MF,Nice,Ligue 1,24,1995,19.7,17,11,5,12,0,7,27,25.9,20,8,2,6,19,36,16,3,0,2019-2020,90.0,86.80203045685279,77.66497461928934
600,Rafael Czichos,GER,DF,Köln,Bundesliga,29,1990,24.5,43,34,26,16,1,22,45,48.9,23,24,13,11,35,78,110,1,0,2019-2020,90.00000000000001,128.57142857142858,157.9591836734694
Rk,Player,Nation,Pos,Squad,Comp,0,0,90.0,0,0,3,3,3,Tkl,0,0.0,0,0,0,0,0,0,0,0,0,2019-2020,90.0,0.0,0.0
601,Lennart-Marten Czyborra,GER,DF,Atalanta,Serie A,20,1999,0.2,0,0,0,0,0,0,0,0.0,0,2,0,2,0,0,0,0,0,2019-2020,90.0,0.0,0.0
602,Marco D'Alessandro,ITA,"MF,DF",SPAL,Serie A,28,1991,8.7,11,8,5,3,3,5,8,62.5,3,11,0,11,5,16,6,0,0,2019-2020,90.0,51.724137931034484,113.79310344827586
603,Danilo D'Ambrosio,ITA,DF,Inter,Serie A,30,1988,15.6,30,16,16,12,2,16,33,48.5,17,15,4,11,14,44,25,0,0,2019-2020,90.0,80.76923076923076,173.07692307692307
604,Felice D'Amico,ITA,MF,Sampdoria,Serie A,18,2000,0.0,1,1,0,0,1,0,0,0.0,0,0,0,0,0,1,0,0,0,2019-2020,,,inf
605,Lucas Da Cunha,FRA,MF,Rennes,Ligue 1,18,2001,0.8,1,0,1,0,0,1,1,100.0,0,0,0,0,0,1,0,0,0,2019-2020,90.0,0.0,112.5
606,Jacopo Da Riva,ITA,MF,Atalanta,Serie A,18,2000,0.0,0,0,0,0,0,0,0,0.0,0,0,0,0,0,0,0,0,0,2019-2020,,,
607,Damien Da Silva,FRA,DF,Rennes,Ligue 1,31,1988,24.9,27,14,20,5,2,10,19,52.6,9,21,13,8,26,53,143,1,0,2019-2020,90.0,93.97590361445783,97.59036144578313
608,Moanes Dabbur,ISR,FW,Sevilla,La Liga,27,1992,0.3,1,1,0,0,1,0,0,0.0,0,1,0,1,0,1,0,0,0,2019-2020,90.0,0.0,300.0
609,Moanes Dabbur,ISR,FW,Hoffenheim,Bundesliga,27,1992,8.5,8,5,1,3,4,3,10,30.0,7,6,2,4,4,12,1,0,0,2019-2020,90.0,42.35294117647059,84.70588235294117
610,Bryan Dabo,BFA,MF,SPAL,Serie A,27,1992,12.5,18,10,13,4,1,5,15,33.3,10,13,2,11,9,27,14,0,0,2019-2020,90.0,64.8,129.6
611,Colin Dagba,FRA,DF,Paris S-G,Ligue 1,20,1998,7.4,10,4,2,4,4,5,9,55.6,4,6,1,5,6,16,9,0,0,2019-2020,90.0,72.97297297297297,121.62162162162161
612,Mahmoud Dahoud,GER,MF,Dortmund,Bundesliga,23,1996,6.2,10,6,4,4,2,6,18,33.3,12,8,2,6,8,18,4,0,0,2019-2020,90.0,116.12903225806451,145.16129032258064
613,Leon Dajaku,GER,"DF,MF",Bayern Munich,Bundesliga,18,2001,0.1,0,0,0,0,0,0,1,0.0,1,0,0,0,0,0,0,0,0,2019-2020,90.0,0.0,0.0
614,Felipe dal Belo,BRA,DF,SPAL,Serie A,35,1984,11.1,13,6,9,4,0,9,15,60.0,6,14,12,2,9,22,30,0,0,2019-2020,90.0,72.97297297297298,105.40540540540542
615,Christian Dalle Mura,ITA,FW,Fiorentina,Serie A,17,2002,0.0,0,0,0,0,0,0,0,0.0,0,0,0,0,0,0,0,0,0,2019-2020,,,
616,Diogo Dalot,POR,"DF,MF",Manchester Utd,Premier League,20,1999,0.7,3,2,3,0,0,3,4,75.0,1,1,0,1,2,5,1,0,0,2019-2020,90.0,257.14285714285717,385.7142857142857
617,Charlie Daniels,ENG,DF,Bournemouth,Premier League,32,1986,1.4,1,1,0,1,0,0,1,0.0,1,2,0,2,1,2,5,1,0,2019-2020,90.0,64.28571428571429,64.28571428571429
618,Danilo,BRA,DF,Juventus,Serie A,28,1991,16.0,30,20,16,12,2,18,30,60.0,12,12,3,9,26,56,44,0,0,2019-2020,90.0,146.25,168.75
619,Arnaut Danjuma,NED,MF,Bournemouth,Premier League,22,1997,7.0,4,2,3,1,0,1,4,25.0,3,2,0,2,8,12,4,1,0,2019-2020,90.0,102.85714285714286,51.42857142857143
620,Scott Dann,ENG,DF,Crystal Palace,Premier League,32,1987,14.1,8,4,7,1,0,8,14,57.1,6,9,7,2,14,22,67,0,0,2019-2020,89.99999999999999,89.36170212765957,51.06382978723404
621,Kevin Danso,AUT,DF,Southampton,Premier League,20,1998,3.1,6,4,3,3,0,4,7,57.1,3,7,3,4,2,8,7,0,0,2019-2020,90.0,58.064516129032256,174.19354838709677
622,Dante,BRA,DF,Nice,Ligue 1,35,1983,21.0,34,21,24,10,0,17,25,68.0,8,27,16,11,26,60,79,0,0,2019-2020,90.0,111.42857142857143,145.71428571428572
623,Andrea Danzi,ITA,MF,Hellas Verona,Serie A,20,1999,0.0,0,0,0,0,0,0,0,0.0,0,0,0,0,0,0,0,0,0,2019-2020,,,
624,Sergi Darder,ESP,MF,Espanyol,La Liga,25,1993,29.5,47,23,11,26,10,17,58,29.3,41,30,1,29,24,71,23,1,0,2019-2020,90.0,73.22033898305085,143.38983050847457
625,Vladimír Darida,CZE,MF,Hertha BSC,Bundesliga,28,1990,25.1,50,27,14,31,5,11,48,22.9,37,44,7,37,27,77,19,2,0,2019-2020,90.0,96.81274900398405,179.2828685258964
Rk,Player,Nation,Pos,Squad,Comp,0,0,90.0,0,0,3,3,3,Tkl,0,0.0,0,0,0,0,0,0,0,0,0,2019-2020,90.0,0.0,0.0
626,Matteo Darmian,ITA,DF,Parma,Serie A,29,1989,29.8,81,42,48,30,3,40,83,48.2,43,38,16,22,25,106,78,1,0,2019-2020,90.0,75.50335570469798,244.63087248322145
627,Alphonso Davies,CAN,DF,Bayern Munich,Bundesliga,18,2000,24.8,70,43,35,24,11,38,58,65.5,20,35,6,29,31,101,51,0,0,2019-2020,90.0,112.5,254.03225806451613
628,Ben Davies,WAL,DF,Tottenham,Premier League,26,1993,15.9,28,15,13,11,4,7,21,33.3,14,28,12,16,22,50,47,0,0,2019-2020,90.0,124.52830188679245,158.49056603773585
629,Tom Davies,ENG,MF,Everton,Premier League,21,1998,22.5,38,17,12,22,4,17,55,30.9,38,12,4,8,35,73,28,0,0,2019-2020,90.0,140.0,152.0
630,Keinan Davis,ENG,FW,Aston Villa,Premier League,21,1998,6.1,1,1,0,1,0,0,3,0.0,3,4,0,4,0,1,3,0,0,2019-2020,90.0,0.0,14.754098360655739
631,Paweł Dawidowicz,POL,DF,Hellas Verona,Serie A,24,1995,7.7,15,12,11,4,0,5,11,45.5,6,6,5,1,12,27,26,0,0,2019-2020,90.0,140.25974025974025,175.32467532467533
632,Craig Dawson,ENG,DF,Watford,Premier League,29,1990,26.2,29,18,16,13,0,17,31,54.8,14,41,32,9,34,63,116,0,0,2019-2020,90.0,116.79389312977099,99.61832061068702
633,Kevin De Bruyne,BEL,MF,Manchester City,Premier League,28,1991,31.0,45,24,8,20,17,18,66,27.3,48,26,4,22,18,63,24,2,0,2019-2020,90.0,52.25806451612903,130.6451612903226
634,Sebastien De Maio,FRA,DF,Udinese,Serie A,32,1987,16.7,18,11,11,7,0,7,11,63.6,4,28,20,8,32,50,86,2,0,2019-2020,90.0,172.4550898203593,97.0059880239521
635,Rodrigo De Paul,ARG,MF,Udinese,Serie A,25,1994,31.4,61,31,31,26,4,27,65,41.5,38,38,3,35,29,90,8,1,0,2019-2020,90.0,83.12101910828027,174.8407643312102
636,Mattia De Sciglio,ITA,DF,Juventus,Serie A,26,1992,5.2,10,8,6,4,0,6,14,42.9,8,5,2,3,8,18,18,1,0,2019-2020,90.0,138.46153846153845,173.07692307692307
637,Lorenzo De Silvestri,ITA,DF,Torino,Serie A,31,1988,24.9,15,8,4,7,4,11,27,40.7,16,20,7,13,19,34,72,0,0,2019-2020,90.0,68.67469879518072,54.21686746987952
638,Lucas Deaux,FRA,MF,Nîmes,Ligue 1,30,1988,14.8,49,26,16,29,4,16,45,35.6,29,20,4,16,15,64,19,0,0,2019-2020,90.0,91.21621621621621,297.97297297297297
639,Mathieu Debuchy,FRA,DF,Saint-Étienne,Ligue 1,34,1985,19.7,44,26,22,15,7,24,47,51.1,23,21,11,10,43,87,59,0,0,2019-2020,90.0,196.44670050761422,201.01522842639594
640,Troy Deeney,ENG,FW,Watford,Premier League,31,1988,24.7,19,12,6,10,3,6,29,20.7,23,13,1,12,11,30,27,0,0,2019-2020,90.0,40.08097165991903,69.23076923076923
641,Grégoire Defrel,MTQ,"FW,MF",Sassuolo,Serie A,28,1991,10.9,12,8,4,6,2,4,15,26.7,11,9,0,9,3,15,5,0,0,2019-2020,90.0,24.77064220183486,99.08256880733944
642,Alessandro Deiola,ITA,MF,Cagliari,Serie A,23,1995,0.0,0,0,0,0,0,0,0,0.0,0,0,0,0,1,1,0,0,0,2019-2020,,inf,
643,Alessandro Deiola,ITA,MF,Lecce,Serie A,23,1995,8.0,16,9,9,7,0,9,24,37.5,15,12,4,8,8,24,14,1,0,2019-2020,90.0,90.0,180.0
644,Romain Del Castillo,FRA,"FW,MF",Rennes,Ligue 1,23,1996,13.8,20,14,5,11,4,6,27,22.2,21,12,2,10,7,27,7,0,0,2019-2020,90.0,45.65217391304348,130.43478260869563
645,Thomas Delaine,FRA,DF,Metz,Ligue 1,27,1992,13.9,25,16,18,6,1,12,21,57.1,9,17,1,16,15,40,28,0,0,2019-2020,90.0,97.12230215827338,161.8705035971223
646,Thomas Delaney,DEN,MF,Dortmund,Bundesliga,27,1991,9.2,22,10,10,11,1,9,15,60.0,6,16,7,9,26,48,26,0,0,2019-2020,90.0,254.34782608695653,215.21739130434784
647,Paul Delecroix,FRA,GK,Metz,Ligue 1,30,1988,1.5,0,0,0,0,0,0,0,0.0,0,0,0,0,0,0,0,0,0,2019-2020,90.0,0.0,0.0
648,Cristian Dell'Orco,ITA,DF,Lecce,Serie A,25,1994,11.2,22,12,14,7,1,8,14,57.1,6,11,7,4,16,38,33,0,0,2019-2020,90.0,128.57142857142858,176.78571428571428
649,Andy Delort,ALG,FW,Montpellier,Ligue 1,27,1991,25.3,28,18,11,9,8,7,27,25.9,20,21,6,15,3,31,10,0,0,2019-2020,89.99999999999999,10.67193675889328,99.60474308300394
650,Fabian Delph,ENG,MF,Everton,Premier League,29,1989,13.2,26,12,10,13,3,9,22,40.9,13,12,3,9,15,41,19,1,0,2019-2020,90.0,102.27272727272727,177.27272727272728
Rk,Player,Nation,Pos,Squad,Comp,0,0,90.0,0,0,3,3,3,Tkl,0,0.0,0,0,0,0,0,0,0,0,0,2019-2020,90.0,0.0,0.0
651,Moussa Dembélé,FRA,FW,Lyon,Ligue 1,23,1996,24.3,12,7,2,5,5,4,14,28.6,10,14,3,11,5,17,31,0,0,2019-2020,90.0,18.51851851851852,44.44444444444444
652,Ousmane Dembélé,FRA,FW,Barcelona,La Liga,22,1997,4.0,2,2,1,1,0,2,5,40.0,3,4,0,4,0,2,0,1,0,2019-2020,90.0,0.0,45.0
653,Merih Demiral,TUR,DF,Juventus,Serie A,21,1998,4.6,8,7,5,3,0,1,3,33.3,2,4,3,1,4,12,16,1,0,2019-2020,90.0,78.26086956521739,156.52173913043478
654,Kerem Demirbay,GER,MF,Leverkusen,Bundesliga,26,1993,17.5,35,19,10,21,4,12,31,38.7,19,19,5,14,22,57,7,1,0,2019-2020,90.0,113.14285714285714,180.0
655,Diego Demme,GER,MF,Napoli,Serie A,27,1991,10.0,18,8,14,3,1,8,23,34.8,15,9,1,8,8,26,9,0,0,2019-2020,90.0,72.0,162.0
656,Diego Demme,GER,MF,RB Leipzig,Bundesliga,27,1991,13.5,41,18,17,19,5,17,42,40.5,25,14,2,12,15,56,14,0,0,2019-2020,90.0,100.0,273.33333333333337
657,Jason Denayer,BEL,DF,Lyon,Ligue 1,24,1995,23.7,17,13,12,5,0,10,14,71.4,4,32,29,3,20,37,83,0,0,2019-2020,90.0,75.9493670886076,64.55696202531647
658,Leander Dendoncker,BEL,"MF,DF",Wolves,Premier League,24,1995,31.1,68,31,41,19,8,28,67,41.8,39,39,12,27,38,106,64,2,0,2019-2020,90.0,109.96784565916398,196.78456591639872
659,Kévin Denkey,TOG,FW,Nîmes,Ligue 1,18,2000,6.7,10,5,1,8,1,6,10,60.0,4,7,0,7,2,12,1,1,0,2019-2020,90.0,26.865671641791042,134.32835820895522
660,Stefano Denswil,SUR,DF,Bologna,Serie A,26,1993,24.9,49,28,29,19,1,26,44,59.1,18,23,8,15,31,80,68,0,0,2019-2020,90.0,112.04819277108433,177.10843373493975
661,Fabio Depaoli,ITA,"MF,DF",Sampdoria,Serie A,22,1997,20.6,41,28,26,10,5,17,31,54.8,14,29,3,26,16,57,39,0,0,2019-2020,90.0,69.90291262135922,179.126213592233
662,Kastriot Dermaku,ALB,DF,Parma,Serie A,27,1992,11.4,13,5,10,3,0,3,5,60.0,2,20,16,4,12,25,61,1,0,2019-2020,90.0,94.73684210526315,102.63157894736841
663,Daniele Dessena,ITA,MF,Brescia,Serie A,32,1987,20.8,21,11,5,14,2,6,25,24.0,19,11,1,10,11,32,21,0,0,2019-2020,90.0,47.59615384615384,90.86538461538461
664,Mattia Destro,ITA,FW,Bologna,Serie A,28,1991,2.1,3,2,1,2,0,1,3,33.3,2,1,0,1,0,3,0,0,0,2019-2020,90.0,0.0,128.57142857142856
665,Mattia Destro,ITA,"FW,MF",Genoa,Serie A,28,1991,1.7,0,0,0,0,0,0,0,0.0,0,0,0,0,0,0,1,0,0,2019-2020,90.0,0.0,0.0
666,Gerard Deulofeu,ESP,FW,Watford,Premier League,25,1994,23.3,33,16,18,9,6,12,59,20.3,47,10,0,10,25,58,6,0,0,2019-2020,90.0,96.56652360515021,127.46781115879828
667,Deyverson,BRA,FW,Getafe,La Liga,28,1991,2.3,0,0,0,0,0,0,1,0.0,1,2,1,1,0,0,5,0,0,2019-2020,90.0,0.0,0.0
668,Samuel Di Carmine,ITA,"FW,MF",Hellas Verona,Serie A,30,1988,14.4,2,1,0,0,2,0,8,0.0,8,3,0,3,1,3,10,0,0,2019-2020,90.0,6.25,12.5
669,Federico Di Francesco,ITA,FW,SPAL,Serie A,25,1994,12.0,11,5,2,6,3,3,15,20.0,12,9,1,8,3,14,2,1,0,2019-2020,90.0,22.5,82.5
670,Giovanni Di Lorenzo,ITA,DF,Napoli,Serie A,25,1993,33.0,59,35,27,19,13,32,61,52.5,29,27,11,16,28,87,54,0,0,2019-2020,90.0,76.36363636363637,160.9090909090909
671,Ángel Di María,ARG,"FW,MF",Paris S-G,Ligue 1,31,1988,22.2,17,12,2,8,7,4,34,11.8,30,14,3,11,11,28,1,3,0,2019-2020,90.0,44.5945945945946,68.91891891891892
672,Boulaye Dia,SEN,FW,Reims,Ligue 1,22,1996,20.1,15,9,7,6,2,3,10,30.0,7,9,2,7,7,22,16,0,0,2019-2020,90.0,31.343283582089548,67.16417910447761
673,Fousseni Diabaté,MLI,"FW,MF",Amiens,Ligue 1,23,1995,13.2,16,10,6,6,4,5,16,31.3,11,11,0,11,8,24,3,1,0,2019-2020,90.0,54.54545454545455,109.0909090909091
674,Moussa Diaby,FRA,"FW,MF",Leverkusen,Bundesliga,20,1999,19.7,10,8,3,7,0,5,15,33.3,10,6,0,6,9,19,4,0,0,2019-2020,90.0,41.11675126903553,45.68527918781726
675,Mouctar Diakhaby,GUI,DF,Valencia,La Liga,22,1996,16.0,11,8,7,3,1,5,8,62.5,3,17,15,2,11,22,73,0,0,2019-2020,90.0,61.875,61.875
Rk,Player,Nation,Pos,Squad,Comp,0,0,90.0,0,0,3,3,3,Tkl,0,0.0,0,0,0,0,0,0,0,0,0,2019-2020,90.0,0.0,0.0
676,Bafodé Diakité,FRA,DF,Toulouse,Ligue 1,18,2001,15.2,23,19,15,8,0,7,13,53.8,6,18,9,9,20,43,75,0,0,2019-2020,90.0,118.42105263157895,136.18421052631578
677,Abdou Diallo,SEN,DF,Paris S-G,Ligue 1,23,1996,13.3,20,11,9,10,1,8,14,57.1,6,9,5,4,10,30,32,0,0,2019-2020,90.0,67.66917293233082,135.33834586466165
678,Amad Diallo,CIV,FW,Atalanta,Serie A,17,2002,0.3,1,1,0,1,0,0,0,0.0,0,0,0,0,0,1,0,0,0,2019-2020,90.0,0.0,300.0
679,Habib Diallo,SEN,FW,Metz,Ligue 1,24,1995,24.4,2,1,0,2,0,0,6,0.0,6,6,5,1,4,6,43,0,0,2019-2020,90.0,14.754098360655739,7.3770491803278695
680,Ibrahima Diallo,FRA,MF,Brest,Ligue 1,20,1999,17.3,38,24,15,22,1,12,29,41.4,17,9,2,7,23,61,16,3,0,2019-2020,90.0,119.65317919075143,197.6878612716763
681,Moussa Diarra,MLI,DF,Toulouse,Ligue 1,18,2000,1.0,3,3,2,1,0,1,1,100.0,0,0,0,0,3,6,2,0,0,2019-2020,90.0,270.0,270.0
682,Lucas Dias,FRA,GK,Nîmes,Ligue 1,20,1999,3.5,1,1,1,0,0,1,1,100.0,0,0,0,0,0,1,2,0,0,2019-2020,90.0,0.0,25.714285714285715
683,Amadou Diawara,GUI,MF,Roma,Serie A,22,1997,16.9,40,25,14,20,6,8,30,26.7,22,10,1,9,33,73,16,2,0,2019-2020,90.0,175.73964497041422,213.01775147928996
684,Brahim Díaz,MAR,FW,Real Madrid,La Liga,19,1999,0.7,1,0,0,1,0,0,2,0.0,2,2,0,2,0,1,0,0,0,2019-2020,90.0,0.0,128.57142857142858
685,Víctor Díaz,ESP,DF,Granada,La Liga,31,1988,32.0,74,43,38,31,5,31,60,51.7,29,53,23,30,48,122,94,1,0,2019-2020,90.0,135.0,208.125
686,Bakaye Dibassy,MLI,DF,Amiens,Ligue 1,29,1989,20.8,26,14,17,8,1,15,20,75.0,5,29,18,11,37,63,78,2,0,2019-2020,90.0,160.09615384615384,112.49999999999999
687,Eric Dier,ENG,"DF,MF",Tottenham,Premier League,25,1994,14.9,21,12,10,10,1,10,20,50.0,10,14,9,5,21,42,65,0,0,2019-2020,90.0,126.84563758389261,126.84563758389261
688,Lucas Digne,FRA,DF,Everton,Premier League,26,1993,33.7,73,49,49,19,5,33,68,48.5,35,39,10,29,42,115,108,0,0,2019-2020,90.0,112.16617210682492,194.9554896142433
689,Mitchell Dijks,NED,DF,Bologna,Serie A,26,1993,11.2,13,10,6,5,2,8,12,66.7,4,5,1,4,10,23,23,0,0,2019-2020,90.0,80.35714285714286,104.46428571428572
690,Javairô Dilrosun,NED,"MF,FW",Hertha BSC,Bundesliga,21,1998,14.5,15,8,11,1,3,5,13,38.5,8,20,0,20,18,33,10,0,0,2019-2020,90.0,111.72413793103448,93.10344827586206
691,Federico Dimarco,ITA,DF,Hellas Verona,Serie A,21,1997,5.8,11,5,4,4,3,6,10,60.0,4,3,2,1,4,15,11,0,0,2019-2020,90.0,62.06896551724138,170.6896551724138
692,Federico Dimarco,ITA,DF,Inter,Serie A,21,1997,0.3,1,0,0,1,0,0,0,0.0,0,0,0,0,1,2,1,0,0,2019-2020,90.0,300.0,300.0
693,Tristan Dingomé,CMR,MF,Reims,Ligue 1,28,1991,9.9,10,4,3,6,1,2,12,16.7,10,6,0,6,6,16,1,0,0,2019-2020,90.0,54.54545454545455,90.9090909090909
694,Lois Diony,FRA,FW,Saint-Étienne,Ligue 1,26,1992,7.4,15,5,0,11,4,5,9,55.6,4,3,0,3,1,16,0,0,0,2019-2020,90.0,12.162162162162161,182.43243243243242
695,Issa Diop,FRA,DF,West Ham,Premier League,22,1997,30.7,27,15,18,9,0,16,25,64.0,9,37,21,16,47,74,166,2,0,2019-2020,90.0,137.78501628664495,79.15309446254072
696,Papakouli Diop,SEN,MF,Eibar,La Liga,33,1986,25.0,39,26,13,22,4,18,42,42.9,24,24,7,17,34,73,38,0,0,2019-2020,90.0,122.39999999999999,140.4
697,Assane Dioussé,SEN,MF,Saint-Étienne,Ligue 1,21,1997,1.3,1,1,0,1,0,0,3,0.0,3,0,0,0,0,1,2,0,0,2019-2020,90.0,0.0,69.23076923076923
698,Axel Disasi,FRA,DF,Reims,Ligue 1,21,1998,27.0,32,21,18,13,1,17,27,63.0,10,29,24,5,26,58,97,0,0,2019-2020,90.0,86.66666666666667,106.66666666666667
699,Tiago Djaló,POR,DF,Lille,Ligue 1,19,2000,7.3,9,4,5,3,1,2,7,28.6,5,3,2,1,11,20,28,0,0,2019-2020,90.0,135.6164383561644,110.95890410958904
700,Djené,TOG,DF,Getafe,La Liga,27,1991,34.0,42,32,27,15,0,17,30,56.7,13,20,7,13,34,76,105,1,0,2019-2020,90.0,90.0,111.17647058823529
Rk,Player,Nation,Pos,Squad,Comp,0,0,90.0,0,0,3,3,3,Tkl,0,0.0,0,0,0,0,0,0,0,0,0,2019-2020,90.0,0.0,0.0
701,Moussa Djenepo,MLI,"MF,DF",Southampton,Premier League,21,1998,10.3,27,21,13,9,5,11,21,52.4,10,15,1,14,9,36,9,0,0,2019-2020,90.0,78.64077669902913,235.92233009708738
702,Koffi Djidji,CIV,DF,Torino,Serie A,26,1992,9.5,27,12,19,8,0,8,18,44.4,10,28,23,5,15,42,53,1,0,2019-2020,90.0,142.10526315789474,255.78947368421052
703,Alexander Djiku,GHA,"DF,MF",Strasbourg,Ligue 1,24,1994,22.9,46,32,27,19,0,21,29,72.4,8,14,8,6,55,101,82,4,0,2019-2020,90.0,216.1572052401747,180.78602620087338
704,Berat Djimsiti,ALB,DF,Atalanta,Serie A,26,1993,30.9,42,23,17,23,2,22,39,56.4,17,21,14,7,49,91,92,0,0,2019-2020,90.0,142.71844660194176,122.33009708737865
705,Naïs Djouahra,FRA,FW,Real Sociedad,La Liga,19,1999,0.3,0,0,0,0,0,0,0,0.0,0,0,0,0,0,0,0,0,0,2019-2020,90.0,0.0,0.0
706,Marko Dmitrović,SRB,GK,Eibar,La Liga,27,1992,35.0,3,2,3,0,0,3,5,60.0,2,1,0,1,3,6,24,0,0,2019-2020,90.0,7.714285714285714,7.714285714285714
707,Matt Doherty,IRL,"MF,DF",Wolves,Premier League,27,1992,31.5,55,29,34,17,4,27,41,65.9,14,34,4,30,40,95,52,1,0,2019-2020,90.0,114.28571428571429,157.14285714285714
708,Kasper Dolberg,DEN,FW,Nice,Ligue 1,21,1997,21.0,10,6,0,3,7,4,17,23.5,13,18,2,16,10,20,24,0,0,2019-2020,90.0,42.857142857142854,42.857142857142854
709,Keagan Dolly,RSA,MF,Montpellier,Ligue 1,26,1993,1.6,6,3,1,3,2,2,5,40.0,3,1,0,1,1,7,0,0,0,2019-2020,90.0,56.25,337.5
710,Jaume Doménech,ESP,GK,Valencia,La Liga,28,1990,14.7,0,0,0,0,0,0,1,0.0,1,0,0,0,1,1,3,1,0,2019-2020,90.0,6.122448979591836,0.0
711,Nicolás Domínguez,ARG,MF,Bologna,Serie A,21,1998,7.8,21,14,15,5,1,7,18,38.9,11,12,2,10,12,33,7,0,0,2019-2020,90.0,138.46153846153845,242.3076923076923
712,Giulio Donati,ITA,DF,Lecce,Serie A,29,1990,19.6,32,21,22,8,2,15,28,53.6,13,19,10,9,25,57,42,0,0,2019-2020,90.0,114.79591836734693,146.93877551020407
713,Ji Dong-won,KOR,"FW,MF",Mainz 05,Bundesliga,28,1991,1.1,0,0,0,0,0,0,1,0.0,1,1,0,1,0,0,0,0,0,2019-2020,90.0,0.0,0.0
714,Anastasios Donis,GRE,FW,Reims,Ligue 1,22,1996,6.8,3,2,2,1,0,1,9,11.1,8,2,0,2,1,4,3,0,0,2019-2020,90.0,13.235294117647058,39.705882352941174
715,Alfredo Donnarumma,ITA,FW,Brescia,Serie A,28,1990,18.7,17,9,3,9,5,6,18,33.3,12,7,0,7,5,22,1,0,0,2019-2020,90.0,24.06417112299465,81.81818181818181
716,Gianluigi Donnarumma,ITA,GK,Milan,Serie A,20,1999,35.6,1,0,1,0,0,1,2,50.0,1,0,0,0,3,4,25,7,0,2019-2020,90.0,7.584269662921349,2.5280898876404496
717,Mathieu Dossevi,TOG,"MF,FW",Toulouse,Ligue 1,31,1988,19.5,32,20,7,17,8,15,30,50.0,15,17,0,17,14,46,7,0,0,2019-2020,90.0,64.61538461538461,147.69230769230768
718,Bas Dost,NED,FW,Eint Frankfurt,Bundesliga,30,1989,16.4,11,7,1,7,3,3,7,42.9,4,6,2,4,5,16,22,0,0,2019-2020,90.0,27.439024390243905,60.365853658536594
719,Abdoulaye Doucouré,MLI,MF,Watford,Premier League,26,1993,35.1,64,30,29,29,6,16,57,28.1,41,46,8,38,31,95,32,0,0,2019-2020,90.0,79.48717948717949,164.1025641025641
720,Mamadou Doucouré,FRA,MF,Gladbach,Bundesliga,21,1998,0.0,0,0,0,0,0,0,0,0.0,0,0,0,0,0,0,0,0,0,2019-2020,,,
721,Moussa Doumbia,MLI,"FW,MF",Reims,Ligue 1,24,1994,19.1,16,8,5,6,5,7,24,29.2,17,14,1,13,9,25,5,0,0,2019-2020,90.0,42.40837696335078,75.39267015706805
722,Souleyman Doumbia,CIV,DF,Angers,Ligue 1,22,1996,5.0,10,4,7,2,1,5,6,83.3,1,5,0,5,6,16,18,0,0,2019-2020,90.0,108.0,180.0
723,Souleyman Doumbia,CIV,DF,Rennes,Ligue 1,22,1996,1.0,1,1,1,0,0,1,1,100.0,0,2,2,0,0,1,3,0,0,2019-2020,90.0,0.0,90.0
724,Tommy Doyle,ENG,MF,Manchester City,Premier League,17,2001,0.2,0,0,0,0,0,0,1,0.0,1,0,0,0,0,0,0,0,0,2019-2020,90.0,0.0,0.0
725,Mohamed Dräger,TUN,DF,Paderborn 07,Bundesliga,23,1996,16.2,32,21,22,8,2,14,33,42.4,19,17,5,12,18,50,39,0,0,2019-2020,90.0,100.0,177.77777777777777
Rk,Player,Nation,Pos,Squad,Comp,0,0,90.0,0,0,3,3,3,Tkl,0,0.0,0,0,0,0,0,0,0,0,0,2019-2020,90.0,0.0,0.0
726,Aleksandar Dragović,AUT,DF,Leverkusen,Bundesliga,28,1991,11.4,18,11,11,6,1,10,21,47.6,11,9,3,6,15,33,39,0,0,2019-2020,90.0,118.42105263157893,142.1052631578947
727,Bartłomiej Drągowski,POL,GK,Fiorentina,Serie A,21,1997,31.0,0,0,0,0,0,0,1,0.0,1,0,0,0,3,3,8,1,0,2019-2020,90.0,8.709677419354838,0.0
728,Julian Draxler,GER,MF,Paris S-G,Ligue 1,25,1993,7.6,13,10,2,9,2,7,15,46.7,8,7,1,6,10,23,1,0,0,2019-2020,90.0,118.42105263157895,153.94736842105263
729,Dominick Drexler,GER,"MF,FW",Köln,Bundesliga,29,1990,17.6,34,25,12,19,3,8,32,25.0,24,11,5,6,26,60,11,0,0,2019-2020,90.0,132.95454545454544,173.86363636363635
730,Danny Drinkwater,ENG,MF,Aston Villa,Premier League,29,1990,2.9,5,3,3,2,0,2,18,11.1,16,5,0,5,5,10,5,1,0,2019-2020,90.0,155.17241379310346,155.17241379310346
731,Danny Drinkwater,ENG,MF,Burnley,Premier League,29,1990,0.6,2,1,1,1,0,0,1,0.0,1,0,0,0,1,3,0,0,0,2019-2020,90.0,150.0,300.0
732,Josip Drmić,SUI,FW,Norwich City,Premier League,26,1992,7.2,3,2,1,2,0,0,8,0.0,8,6,0,6,1,4,5,1,0,2019-2020,90.0,12.5,37.5
733,Domingos Duarte,POR,DF,Granada,La Liga,24,1995,34.3,30,19,24,5,1,11,20,55.0,9,34,24,10,34,64,153,1,0,2019-2020,90.0,89.2128279883382,78.71720116618077
734,Léo Duarte,BRA,DF,Milan,Serie A,23,1996,4.5,4,3,0,3,1,1,4,25.0,3,9,6,3,3,7,9,0,0,2019-2020,90.0,60.0,80.0
735,Óscar Duarte,CRC,DF,Levante,La Liga,30,1989,5.4,12,3,11,1,0,3,4,75.0,1,7,6,1,6,18,29,0,0,2019-2020,90.0,99.99999999999999,199.99999999999997
736,Rubén Duarte,ESP,DF,Alavés,La Liga,23,1995,29.6,61,32,30,28,3,34,60,56.7,26,30,8,22,47,108,71,0,0,2019-2020,90.0,142.9054054054054,185.47297297297297
737,Edgaras Dubickas,LTU,DF,Lecce,Serie A,21,1998,0.0,0,0,0,0,0,0,0,0.0,0,0,0,0,0,0,0,0,0,2019-2020,,,
738,Leo Dubois,FRA,DF,Lyon,Ligue 1,24,1994,15.0,32,23,20,9,3,13,22,59.1,9,12,4,8,18,50,34,1,0,2019-2020,90.0,108.0,192.0
739,Martin Dúbravka,SVK,GK,Newcastle Utd,Premier League,30,1989,38.0,1,1,1,0,0,1,2,50.0,1,2,0,2,1,2,17,5,0,2019-2020,90.0,2.3684210526315788,2.3684210526315788
740,Ondrej Duda,SVK,MF,Norwich City,Premier League,24,1994,8.0,18,11,9,6,3,7,16,43.8,9,10,2,8,6,24,8,0,0,2019-2020,90.0,67.5,202.5
741,Ondrej Duda,SVK,MF,Hertha BSC,Bundesliga,24,1994,5.0,6,4,1,2,3,1,10,10.0,9,3,1,2,5,11,5,0,0,2019-2020,90.0,90.0,108.0
742,Shane Duffy,IRL,DF,Brighton,Premier League,27,1992,13.8,18,9,14,4,0,6,17,35.3,11,13,7,6,21,39,72,0,0,2019-2020,90.0,136.9565217391304,117.39130434782608
743,Haris Duljević,BIH,"FW,MF",Nîmes,Ligue 1,25,1993,5.8,11,6,3,7,1,4,12,33.3,8,5,0,5,2,13,1,0,0,2019-2020,90.0,31.03448275862069,170.6896551724138
744,Paul Dummett,WAL,DF,Newcastle Utd,Premier League,27,1991,13.6,27,17,19,7,1,21,27,77.8,6,23,9,14,23,50,69,0,0,2019-2020,90.0,152.2058823529412,178.6764705882353
745,Alfred Duncan,GHA,MF,Fiorentina,Serie A,26,1993,9.9,12,9,11,1,0,2,19,10.5,17,4,0,4,5,17,12,0,0,2019-2020,90.0,45.45454545454545,109.0909090909091
746,Alfred Duncan,GHA,MF,Sassuolo,Serie A,26,1993,9.4,19,12,8,7,4,6,16,37.5,10,7,0,7,9,28,13,0,0,2019-2020,90.0,86.17021276595744,181.91489361702128
747,Lewis Dunk,ENG,DF,Brighton,Premier League,27,1991,35.9,40,24,23,17,0,15,34,44.1,19,55,33,22,55,95,125,2,0,2019-2020,90.0,137.883008356546,100.27855153203343
748,Erik Durm,GER,"DF,FW",Eint Frankfurt,Bundesliga,27,1992,5.7,13,6,9,2,2,9,17,52.9,8,11,2,9,3,16,11,0,0,2019-2020,90.0,47.368421052631575,205.26315789473682
749,Riza Durmisi,DEN,"DF,MF",Nice,Ligue 1,25,1994,1.8,1,1,1,0,0,0,0,0.0,0,2,1,1,1,2,3,0,0,2019-2020,90.0,50.0,50.0
750,Hugo Duro,ESP,"FW,MF",Getafe,La Liga,19,1999,4.2,6,5,2,2,2,4,8,50.0,4,3,0,3,1,7,3,0,0,2019-2020,90.0,21.428571428571427,128.57142857142856
Rk,Player,Nation,Pos,Squad,Comp,0,0,90.0,0,0,3,3,3,Tkl,0,0.0,0,0,0,0,0,0,0,0,0,2019-2020,90.0,0.0,0.0
751,Jean-Kevin Duverne,HAI,DF,Brest,Ligue 1,22,1997,13.1,12,8,5,6,1,2,6,33.3,4,23,8,15,20,32,50,0,0,2019-2020,90.0,137.40458015267177,82.44274809160305
752,Paulo Dybala,ARG,"FW,MF",Juventus,Serie A,25,1993,23.9,19,10,6,9,4,9,39,23.1,30,15,0,15,13,32,3,0,0,2019-2020,90.0,48.953974895397494,71.54811715481172
753,Edin Džeko,BIH,FW,Roma,Serie A,33,1986,31.7,16,11,2,7,7,2,13,15.4,11,11,4,7,6,22,33,0,0,2019-2020,90.0,17.034700315457414,45.42586750788644
754,Blerim Džemaili,SUI,MF,Bologna,Serie A,33,1986,7.8,19,12,3,13,3,4,22,18.2,18,9,3,6,7,26,6,0,0,2019-2020,90.0,80.76923076923076,219.23076923076923
755,Bruno Ecuele Manga,GAB,DF,Dijon,Ligue 1,31,1988,28.0,22,15,17,5,0,9,20,45.0,11,34,23,11,37,59,112,2,0,2019-2020,90.0,118.92857142857143,70.71428571428571
756,Simone Edera,ITA,"MF,FW",Torino,Serie A,22,1997,4.4,13,5,3,7,3,2,12,16.7,10,1,0,1,1,14,3,0,0,2019-2020,90.0,20.454545454545453,265.9090909090909
757,Ederson,BRA,GK,Manchester City,Premier League,25,1993,34.1,2,2,2,0,0,2,5,40.0,3,0,0,0,3,5,16,6,0,2019-2020,90.0,7.9178885630498534,5.278592375366569
758,John Egan,IRL,DF,Sheffield Utd,Premier League,26,1992,35.4,44,27,34,10,0,25,45,55.6,20,39,27,12,58,102,171,4,0,2019-2020,90.0,147.45762711864407,111.86440677966102
759,Johannes Eggestein,GER,"MF,FW",Werder Bremen,Bundesliga,21,1998,5.7,8,6,2,2,4,3,12,25.0,9,6,0,6,2,10,4,0,0,2019-2020,90.0,31.57894736842105,126.3157894736842
760,Maximilian Eggestein,GER,MF,Werder Bremen,Bundesliga,22,1996,31.7,40,28,20,18,2,15,43,34.9,28,37,8,29,36,76,57,0,0,2019-2020,90.0,102.20820189274448,113.56466876971609
761,Kingsley Ehizibue,NED,DF,Köln,Bundesliga,24,1995,25.9,79,53,44,30,5,33,53,62.3,20,28,8,20,39,118,79,1,0,2019-2020,90.0,135.52123552123552,274.51737451737455
762,Albin Ekdal,SWE,MF,Sampdoria,Serie A,30,1989,26.5,51,25,18,31,2,24,68,35.3,44,35,14,21,33,84,46,1,0,2019-2020,90.0,112.0754716981132,173.2075471698113
763,Harvey Elliott,ENG,DF,Liverpool,Premier League,16,2003,0.1,0,0,0,0,0,0,0,0.0,0,0,0,0,0,0,0,0,0,2019-2020,90.0,0.0,0.0
764,Elif Elmas,MKD,MF,Napoli,Serie A,19,1999,12.6,16,7,5,6,5,5,20,25.0,15,11,1,10,11,27,4,0,0,2019-2020,90.0,78.57142857142858,114.28571428571429
765,Ilay Elmkies,ISR,MF,Hoffenheim,Bundesliga,19,2000,0.0,1,1,1,0,0,0,0,0.0,0,0,0,0,0,1,0,0,0,2019-2020,,,inf
766,Ahmed Elmohamady,EGY,DF,Aston Villa,Premier League,31,1987,11.5,19,9,10,7,2,10,21,47.6,11,11,5,6,13,32,25,1,0,2019-2020,90.0,101.73913043478262,148.69565217391306
767,Aritz Elustondo,ESP,DF,Real Sociedad,La Liga,25,1994,16.8,28,17,19,8,1,13,23,56.5,10,21,8,13,15,43,67,0,0,2019-2020,90.0,80.35714285714285,150.0
768,Nico Elvedi,SUI,DF,Gladbach,Bundesliga,22,1996,29.1,45,27,37,8,0,19,38,50.0,19,32,15,17,62,107,112,0,0,2019-2020,90.0,191.7525773195876,139.17525773195874
769,Rodrigo Ely,BRA,DF,Alavés,La Liga,25,1993,23.6,22,13,15,7,0,13,29,44.8,16,23,19,4,32,54,116,0,0,2019-2020,90.0,122.03389830508473,83.89830508474576
770,Adri Embarba,ESP,"MF,FW",Espanyol,La Liga,27,1992,15.2,37,22,16,16,5,16,33,48.5,17,28,4,24,16,53,11,0,0,2019-2020,90.0,94.73684210526315,219.07894736842104
771,Breel Embolo,SUI,"FW,MF",Gladbach,Bundesliga,22,1997,17.2,22,11,2,15,5,4,15,26.7,11,12,1,11,8,30,5,0,0,2019-2020,90.0,41.86046511627907,115.11627906976746
772,Emerson,BRA,DF,Betis,La Liga,20,1999,31.5,74,46,49,19,6,36,79,45.6,43,30,9,21,31,105,57,1,0,2019-2020,90.0,88.57142857142858,211.42857142857144
773,Renaud Emond,BEL,FW,Nantes,Ligue 1,27,1991,3.2,3,1,0,2,1,1,5,20.0,4,0,0,0,0,3,7,0,0,2019-2020,90.0,0.0,84.375
774,Alan Empereur,BRA,DF,Hellas Verona,Serie A,25,1994,9.5,16,8,11,4,1,6,10,60.0,4,19,12,7,22,38,36,0,0,2019-2020,90.0,208.42105263157896,151.57894736842104
775,Youssef En-Nesyri,MAR,FW,Leganés,La Liga,22,1997,15.4,9,7,1,2,6,3,17,17.6,14,15,2,13,5,14,22,0,0,2019-2020,90.0,29.22077922077922,52.5974025974026
Rk,Player,Nation,Pos,Squad,Comp,0,0,90.0,0,0,3,3,3,Tkl,0,0.0,0,0,0,0,0,0,0,0,0,2019-2020,90.0,0.0,0.0
776,Youssef En-Nesyri,MAR,FW,Sevilla,La Liga,22,1997,8.8,7,5,1,6,0,3,10,30.0,7,9,3,6,5,12,7,0,0,2019-2020,90.0,51.13636363636363,71.5909090909091
777,Björn Engels,BEL,DF,Aston Villa,Premier League,24,1994,16.1,11,6,8,2,1,8,13,61.5,5,18,17,1,28,39,86,3,0,2019-2020,90.0,156.52173913043478,61.49068322981366
778,Sergi Enrich,ESP,FW,Eibar,La Liga,29,1990,20.7,17,6,4,8,5,4,21,19.0,17,16,2,14,9,26,12,0,0,2019-2020,90.0,39.130434782608695,73.91304347826087
779,Javier Eraso,ESP,MF,Leganés,La Liga,29,1990,9.1,11,5,4,5,2,5,15,33.3,10,5,0,5,7,18,5,0,0,2019-2020,90.0,69.23076923076923,108.79120879120879
780,Christian Eriksen,DEN,"MF,FW",Tottenham,Premier League,27,1992,12.2,19,9,10,8,1,7,24,29.2,17,10,1,9,12,31,16,0,0,2019-2020,90.0,88.52459016393443,140.16393442622953
781,Christian Eriksen,DEN,MF,Inter,Serie A,27,1992,7.8,11,6,2,8,1,5,20,25.0,15,3,0,3,0,11,0,0,0,2019-2020,90.0,0.0,126.92307692307692
782,Gonzalo Escalante,ARG,MF,Eibar,La Liga,26,1993,18.6,41,22,15,17,9,24,41,58.5,17,22,4,18,29,70,14,0,0,2019-2020,90.0,140.32258064516128,198.3870967741935
783,Aarón Escandell,ESP,GK,Granada,La Liga,23,1995,3.0,1,1,1,0,0,1,1,100.0,0,0,0,0,0,1,0,0,0,2019-2020,90.0,0.0,30.0
784,Sergio Escudero,ESP,DF,Sevilla,La Liga,29,1989,8.6,29,16,17,10,2,19,28,67.9,9,11,1,10,13,42,35,0,0,2019-2020,90.0,136.046511627907,303.48837209302326
785,Bernardo Espinosa,COL,DF,Espanyol,La Liga,30,1989,25.1,24,16,18,4,2,16,28,57.1,12,19,11,8,24,48,108,2,0,2019-2020,90.0,86.05577689243027,86.05577689243027
786,Sebastiano Esposito,ITA,FW,Inter,Serie A,17,2002,2.2,3,2,0,2,1,0,5,0.0,5,3,0,3,3,6,1,0,0,2019-2020,90.0,122.72727272727272,122.72727272727272
787,Vicente Esquerdo,ESP,"MF,FW",Valencia,La Liga,20,1999,0.2,1,0,1,0,0,0,0,0.0,0,1,0,1,0,1,1,0,0,2019-2020,90.0,0.0,450.0
788,Alexander Esswein,GER,"FW,MF",Hertha BSC,Bundesliga,29,1990,2.4,6,4,4,2,0,3,8,37.5,5,8,1,7,7,13,7,1,0,2019-2020,90.0,262.5,225.00000000000003
789,Pervis Estupiñán,ECU,DF,Osasuna,La Liga,21,1998,33.1,84,45,53,27,4,42,77,54.5,35,30,7,23,58,142,61,6,0,2019-2020,90.0,157.70392749244712,228.39879154078548
790,Oghenekaro Etebo,NGA,MF,Getafe,La Liga,23,1995,6.4,12,4,5,7,0,7,12,58.3,5,10,1,9,11,23,4,1,0,2019-2020,90.0,154.6875,168.75
791,Beñat Etxebarria,ESP,MF,Athletic Club,La Liga,32,1987,4.4,6,1,2,3,1,2,13,15.4,11,6,1,5,4,10,6,0,0,2019-2020,90.0,81.81818181818181,122.72727272727272
792,Xabier Etxeita,ESP,DF,Getafe,La Liga,31,1987,16.1,20,11,11,9,0,12,23,52.2,11,9,5,4,17,37,68,0,0,2019-2020,90.0,95.03105590062111,111.80124223602483
793,Antony Evans,ENG,"MF,DF",Paderborn 07,Bundesliga,20,1998,1.7,5,4,1,3,1,1,5,20.0,4,1,1,0,2,7,4,0,0,2019-2020,90.0,105.88235294117646,264.70588235294116
794,Jonny Evans,NIR,DF,Leicester City,Premier League,31,1988,37.6,48,34,33,14,1,28,39,71.8,11,33,18,15,57,105,174,4,0,2019-2020,90.0,136.43617021276594,114.89361702127658
795,Edu Expósito,ESP,MF,Eibar,La Liga,22,1996,25.7,52,28,12,31,9,18,49,36.7,31,20,6,14,31,83,18,1,0,2019-2020,90.0,108.56031128404669,182.1011673151751
796,Valentin Eysseric,FRA,"MF,FW",Hellas Verona,Serie A,27,1992,3.9,4,4,1,2,1,0,4,0.0,4,3,0,3,1,5,2,0,0,2019-2020,90.0,23.076923076923077,92.3076923076923
797,Valentin Eysseric,FRA,"FW,MF",Fiorentina,Serie A,27,1992,0.5,0,0,0,0,0,0,0,0.0,0,1,0,1,0,0,0,0,0,2019-2020,90.0,0.0,0.0
798,Łukasz Fabiański,POL,GK,West Ham,Premier League,34,1985,23.5,2,2,2,0,0,2,4,50.0,2,0,0,0,1,3,5,3,0,2019-2020,90.0,3.829787234042553,7.659574468085106
799,Fabinho,BRA,MF,Liverpool,Premier League,25,1993,23.1,62,35,20,35,7,26,67,38.8,41,25,2,23,34,96,19,1,0,2019-2020,89.99999999999999,132.46753246753244,241.55844155844153
800,Fábio,BRA,DF,Nantes,Ligue 1,29,1990,9.3,38,22,18,20,0,25,35,71.4,10,10,5,5,18,56,19,0,0,2019-2020,90.0,174.19354838709674,367.7419354838709
Rk,Player,Nation,Pos,Squad,Comp,0,0,90.0,0,0,3,3,3,Tkl,0,0.0,0,0,0,0,0,0,0,0,0,2019-2020,90.0,0.0,0.0
801,Cesc Fàbregas,ESP,MF,Monaco,Ligue 1,32,1987,10.3,11,4,6,3,2,6,29,20.7,23,8,1,7,7,18,3,0,0,2019-2020,90.0,61.165048543689316,96.11650485436893
802,Fabricio,ESP,GK,Mallorca,La Liga,31,1987,1.0,0,0,0,0,0,0,0,0.0,0,0,0,0,0,0,0,1,0,2019-2020,90.0,0.0,0.0
803,Ralf Fährmann,GER,GK,Norwich City,Premier League,30,1988,0.2,0,0,0,0,0,0,0,0.0,0,0,0,0,0,0,0,0,0,2019-2020,90.0,0.0,0.0
804,Fayçal Fajr,MAR,MF,Getafe,La Liga,30,1988,4.5,1,1,0,1,0,0,3,0.0,3,4,0,4,4,5,1,0,0,2019-2020,90.0,80.0,20.0
805,Luca Falbo,ITA,DF,Lazio,Serie A,19,2000,0.0,0,0,0,0,0,0,0,0.0,0,0,0,0,0,0,0,0,0,2019-2020,,,
806,Filippo Falco,ITA,"FW,MF",Lecce,Serie A,27,1992,22.4,13,7,4,5,4,5,18,27.8,13,11,1,10,2,15,1,0,0,2019-2020,90.0,8.035714285714286,52.23214285714286
807,Eliseo Falcon,ESP,DF,Levante,La Liga,22,1997,0.8,0,0,0,0,0,0,0,0.0,0,0,0,0,0,0,2,0,0,2019-2020,90.0,0.0,0.0
808,Wladimiro Falcone,ITA,GK,Sampdoria,Serie A,24,1995,2.0,0,0,0,0,0,0,0,0.0,0,0,0,0,0,0,0,0,0,2019-2020,90.0,0.0,0.0
809,Simon Falette,GUI,DF,Eint Frankfurt,Bundesliga,27,1992,1.0,0,0,0,0,0,0,1,0.0,1,3,3,0,3,3,5,0,0,2019-2020,90.0,270.0,0.0
810,Iago Falque,ESP,"FW,MF",Torino,Serie A,29,1990,1.1,0,0,0,0,0,0,1,0.0,1,1,0,1,0,0,0,0,0,2019-2020,90.0,0.0,0.0
811,Iago Falque,ESP,MF,Genoa,Serie A,29,1990,5.8,7,3,1,4,2,4,8,50.0,4,7,0,7,1,8,4,0,0,2019-2020,90.0,15.517241379310345,108.62068965517241
812,Akin Famewo,ENG,MF,Norwich City,Premier League,20,1998,0.0,0,0,0,0,0,0,0,0.0,0,0,0,0,0,0,0,0,0,2019-2020,,,
813,Andri Fannar Baldursson,ISL,MF,Bologna,Serie A,17,2002,1.6,1,0,0,1,0,0,1,0.0,1,2,0,2,1,2,3,0,0,2019-2020,90.0,56.25,56.25
814,Paolo Faragò,ITA,"DF,MF",Cagliari,Serie A,26,1993,14.9,41,28,21,15,5,23,46,50.0,23,18,9,9,10,51,58,0,0,2019-2020,90.0,60.402684563758385,247.65100671140937
815,Davide Faraoni,ITA,DF,Hellas Verona,Serie A,27,1991,35.9,67,37,43,19,5,30,67,44.8,37,50,15,35,36,103,115,0,0,2019-2020,90.0,90.2506963788301,167.966573816156
816,Mohamed Fares,ALG,"DF,MF",SPAL,Serie A,23,1996,4.7,6,4,3,2,1,2,10,20.0,8,5,3,2,5,11,8,0,0,2019-2020,90.0,95.74468085106382,114.89361702127658
817,Diego Farias,BRA,"MF,FW",Lecce,Serie A,29,1990,9.2,9,6,3,5,1,5,18,27.8,13,7,0,7,4,13,4,0,0,2019-2020,90.0,39.130434782608695,88.04347826086958
818,Ansu Fati,ESP,FW,Barcelona,La Liga,16,2002,11.4,16,8,4,7,5,5,15,33.3,10,14,1,13,8,24,3,0,0,2019-2020,90.0,63.1578947368421,126.3157894736842
819,Julien Faussurier,FRA,DF,Brest,Ligue 1,32,1987,22.0,36,22,23,13,0,21,53,39.6,32,22,7,15,33,69,46,1,0,2019-2020,90.0,135.0,147.27272727272728
820,Andrea Favilli,ITA,FW,Genoa,Serie A,22,1997,7.3,8,7,2,3,3,4,11,36.4,7,5,1,4,0,8,7,0,0,2019-2020,90.0,0.0,98.63013698630138
821,Federico Fazio,ARG,DF,Roma,Serie A,32,1987,13.5,19,11,12,6,1,6,11,54.5,5,8,6,2,19,38,52,0,0,2019-2020,90.0,126.66666666666667,126.66666666666667
822,Aleix Febas,ESP,"MF,FW",Mallorca,La Liga,23,1996,18.8,36,24,13,19,4,12,36,33.3,24,15,0,15,17,53,6,0,0,2019-2020,90.0,81.38297872340425,172.3404255319149
823,Zouhair Feddal,MAR,DF,Betis,La Liga,30,1989,15.9,20,13,14,5,1,10,14,71.4,4,15,9,6,23,43,74,0,0,2019-2020,90.0,130.18867924528303,113.20754716981132
824,Ljubomir Fejsa,SRB,MF,Alavés,La Liga,30,1988,8.7,19,13,8,10,1,6,23,26.1,17,8,1,7,6,25,13,0,0,2019-2020,90.0,62.06896551724138,196.55172413793105
825,Nabil Fekir,FRA,"MF,FW",Betis,La Liga,26,1993,29.3,41,26,14,19,8,12,37,32.4,25,27,3,24,10,51,3,0,0,2019-2020,90.0,30.716723549488055,125.93856655290102
Rk,Player,Nation,Pos,Squad,Comp,0,0,90.0,0,0,3,3,3,Tkl,0,0.0,0,0,0,0,0,0,0,0,0,2019-2020,90.0,0.0,0.0
826,Felipe,BRA,DF,Atlético Madrid,La Liga,30,1989,23.4,27,19,21,6,0,14,24,58.3,10,18,13,5,40,67,130,0,0,2019-2020,89.99999999999999,153.84615384615384,103.84615384615384
827,Luiz Felipe,ITA,DF,Lazio,Serie A,22,1997,22.5,42,24,24,15,3,19,32,59.4,13,39,30,9,41,83,69,2,0,2019-2020,90.0,164.0,168.0
828,Lucas Felippe,BRA,"MF,DF",Hellas Verona,Serie A,19,2000,0.3,1,1,1,0,0,1,1,100.0,0,0,0,0,0,1,0,0,0,2019-2020,90.0,0.0,300.0
829,João Félix,POR,"FW,MF",Atlético Madrid,La Liga,19,1999,19.4,9,3,3,3,3,4,14,28.6,10,4,0,4,10,19,4,1,0,2019-2020,90.0,46.39175257731959,41.75257731958764
830,Ohis Felix Uduokhai,GER,DF,Augsburg,Bundesliga,21,1997,21.8,43,26,30,12,1,19,29,65.5,10,40,30,10,36,79,125,2,0,2019-2020,90.0,148.62385321100916,177.52293577981652
831,Kiko Femenía,ESP,DF,Watford,Premier League,28,1991,24.9,68,38,49,17,2,43,80,53.8,37,16,2,14,36,104,49,0,0,2019-2020,90.0,130.12048192771084,245.78313253012047
832,Zinedine Ferhat,ALG,"FW,MF",Nîmes,Ligue 1,26,1993,25.0,26,16,5,16,5,15,46,32.6,31,15,3,12,16,42,18,0,0,2019-2020,90.0,57.599999999999994,93.6
833,Bruno Fernandes,POR,MF,Manchester Utd,Premier League,24,1994,13.2,22,12,9,9,4,5,38,13.2,33,6,0,6,11,33,16,0,0,2019-2020,90.0,75.0,150.0
834,Edimilson Fernandes,SUI,"MF,DF",Mainz 05,Bundesliga,23,1996,16.5,33,20,12,15,6,15,33,45.5,18,17,9,8,32,65,47,1,0,2019-2020,90.0,174.54545454545456,180.0
835,Gedson Fernandes,POR,"MF,DF",Tottenham,Premier League,20,1999,0.8,2,0,2,0,0,0,2,0.0,2,2,0,2,1,3,0,0,0,2019-2020,90.0,112.5,225.0
836,Gelson Fernandes,SUI,MF,Eint Frankfurt,Bundesliga,32,1986,8.6,30,18,13,17,0,7,21,33.3,14,11,3,8,16,46,9,2,0,2019-2020,90.0,167.4418604651163,313.95348837209303
837,Matheus Fernandes,BRA,"MF,FW",Valladolid,La Liga,21,1998,1.8,6,2,2,2,2,3,5,60.0,2,4,0,4,2,8,2,0,0,2019-2020,90.0,100.0,300.0
838,Aitor Fernández,ESP,GK,Levante,La Liga,28,1991,36.0,1,1,1,0,0,1,1,100.0,0,0,0,0,2,3,18,3,0,2019-2020,90.0,5.0,2.5
839,Andrés Fernández,ESP,GK,Villarreal,La Liga,32,1986,4.0,0,0,0,0,0,0,0,0.0,0,0,0,0,0,0,2,0,0,2019-2020,90.0,0.0,0.0
840,Carlos Fernández,ESP,"FW,MF",Granada,La Liga,23,1996,24.5,24,15,7,11,6,3,32,9.4,29,25,2,23,11,35,30,0,0,2019-2020,90.00000000000001,40.40816326530613,88.16326530612245
841,Federico Fernández,ARG,DF,Newcastle Utd,Premier League,30,1989,29.1,42,25,30,10,2,23,46,50.0,23,41,28,13,24,66,190,2,0,2019-2020,90.0,74.22680412371133,129.89690721649484
842,Gabriel Fernández,URU,"FW,MF",Celta Vigo,La Liga,25,1994,6.2,1,0,0,1,0,1,3,33.3,2,5,1,4,2,3,2,0,0,2019-2020,90.0,29.032258064516128,14.516129032258064
843,Joaquín Fernández,ESP,"MF,DF",Valladolid,La Liga,23,1996,18.4,30,24,17,10,3,9,30,30.0,21,14,10,4,32,62,57,0,0,2019-2020,90.0,156.52173913043478,146.73913043478262
844,Fernandinho,BRA,DF,Manchester City,Premier League,34,1985,26.6,50,35,32,16,2,29,48,60.4,19,28,16,12,25,75,82,0,0,2019-2020,90.0,84.58646616541353,169.17293233082705
845,Fernando,BRA,MF,Sevilla,La Liga,32,1987,29.5,62,33,37,24,1,34,58,58.6,24,38,15,23,67,129,73,1,0,2019-2020,90.0,204.40677966101694,189.15254237288136
846,Juan Ferney Otero,COL,"FW,MF",Amiens,Ligue 1,24,1995,13.4,17,10,6,9,2,8,24,33.3,16,12,1,11,19,36,10,0,0,2019-2020,90.0,127.61194029850745,114.17910447761193
847,Alex Ferrari,ITA,DF,Sampdoria,Serie A,25,1994,11.2,18,13,13,5,0,7,12,58.3,5,13,8,5,12,30,31,0,0,2019-2020,90.0,96.42857142857143,144.64285714285714
848,Facundo Ferreyra,ARG,"FW,MF",Espanyol,La Liga,28,1991,6.4,9,4,4,5,0,3,10,30.0,7,4,0,4,2,11,5,0,0,2019-2020,90.0,28.125,126.5625
849,Jordan Ferri,FRA,MF,Montpellier,Ligue 1,27,1992,12.8,22,13,7,12,3,13,44,29.5,31,9,0,9,10,32,10,0,0,2019-2020,90.0,70.3125,154.6875
850,Oliver Fink,GER,"MF,FW",Düsseldorf,Bundesliga,37,1982,7.5,21,12,7,11,3,5,16,31.3,11,12,1,11,15,36,7,0,0,2019-2020,90.0,180.0,252.0
Rk,Player,Nation,Pos,Squad,Comp,0,0,90.0,0,0,3,3,3,Tkl,0,0.0,0,0,0,0,0,0,0,0,0,2019-2020,90.0,0.0,0.0
851,Alfreð Finnbogason,ISL,FW,Augsburg,Bundesliga,30,1989,10.7,11,6,1,9,1,2,7,28.6,5,8,2,6,3,14,8,0,0,2019-2020,90.0,25.233644859813086,92.52336448598132
852,Roberto Firmino,BRA,FW,Liverpool,Premier League,27,1991,33.2,37,19,8,14,15,10,43,23.3,33,34,3,31,7,44,11,1,0,2019-2020,90.0,18.975903614457827,100.3012048192771
853,Junior Firpo,DOM,DF,Barcelona,La Liga,22,1996,11.3,23,15,12,8,3,11,17,64.7,6,15,3,12,17,40,12,1,0,2019-2020,90.0,135.39823008849558,183.1858407079646
854,John Fleck,SCO,MF,Sheffield Utd,Premier League,27,1991,28.0,36,25,13,14,9,22,64,34.4,42,25,3,22,24,60,26,0,0,2019-2020,90.0,77.14285714285714,115.71428571428571
855,Mark Flekken,NED,GK,Freiburg,Bundesliga,26,1993,10.0,0,0,0,0,0,0,1,0.0,1,0,0,0,0,0,2,2,0,2019-2020,90.0,0.0,0.0
856,Sergio Floccari,ITA,FW,SPAL,Serie A,37,1981,10.5,8,3,3,1,4,0,13,0.0,13,9,1,8,5,13,1,0,0,2019-2020,90.0,42.857142857142854,68.57142857142857
857,Alessandro Florenzi,ITA,"DF,FW",Roma,Serie A,28,1991,11.1,14,11,8,4,2,7,20,35.0,13,9,3,6,16,30,19,0,0,2019-2020,90.0,129.72972972972974,113.51351351351353
858,Alessandro Florenzi,ITA,DF,Valencia,La Liga,28,1991,8.4,13,9,9,4,0,8,18,44.4,10,11,1,10,14,27,21,0,0,2019-2020,90.0,150.0,139.28571428571428
859,Phil Foden,ENG,"FW,MF",Manchester City,Premier League,19,2000,10.0,14,10,4,6,4,6,19,31.6,13,5,0,5,6,20,2,0,0,2019-2020,90.0,54.0,126.0
860,Mamadou Fofana,MLI,"DF,MF",Metz,Ligue 1,21,1998,17.6,57,35,38,15,4,21,41,51.2,20,22,10,12,22,79,61,1,0,2019-2020,90.0,112.5,291.4772727272727
861,Seko Fofana,CIV,MF,Udinese,Serie A,24,1995,25.0,17,12,8,8,1,9,35,25.7,26,20,1,19,17,34,19,0,0,2019-2020,90.0,61.199999999999996,61.199999999999996
862,Wesley Fofana,FRA,DF,Saint-Étienne,Ligue 1,18,2000,13.5,25,15,16,9,0,12,18,66.7,6,10,5,5,36,61,55,4,0,2019-2020,90.0,240.0,166.66666666666669
863,Youssouf Fofana,FRA,MF,Strasbourg,Ligue 1,20,1999,11.2,25,17,10,12,3,13,30,43.3,17,11,0,11,14,39,7,0,0,2019-2020,90.0,112.5,200.89285714285714
864,Youssouf Fofana,FRA,MF,Monaco,Ligue 1,20,1999,6.8,16,9,6,10,0,8,15,53.3,7,12,2,10,8,24,9,0,0,2019-2020,90.0,105.88235294117646,211.76470588235293
865,Thomas Foket,BEL,DF,Reims,Ligue 1,24,1994,27.0,61,36,31,23,7,30,48,62.5,18,15,4,11,39,100,59,1,0,2019-2020,90.0,130.0,203.33333333333334
866,Lamine Fomba,FRA,MF,Nîmes,Ligue 1,21,1998,15.3,65,31,20,37,8,21,43,48.8,22,29,4,25,25,90,11,1,0,2019-2020,90.0,147.05882352941177,382.35294117647055
867,José Fonte,POR,DF,Lille,Ligue 1,35,1983,24.5,19,11,11,7,1,11,22,50.0,11,19,11,8,28,47,90,1,0,2019-2020,90.00000000000001,102.85714285714286,69.79591836734694
868,Pablo Fornals,ESP,"MF,FW",West Ham,Premier League,23,1996,24.1,46,28,21,18,7,19,64,29.7,45,35,1,34,25,71,15,0,0,2019-2020,90.0,93.3609958506224,171.78423236514521
869,Emil Forsberg,SWE,MF,RB Leipzig,Bundesliga,27,1991,12.7,16,10,5,8,3,6,26,23.1,20,15,0,15,5,21,3,0,0,2019-2020,90.0,35.43307086614173,113.38582677165356
870,Hernâni Fortes,POR,"MF,FW",Levante,La Liga,27,1991,7.3,5,2,4,0,1,1,3,33.3,2,3,0,3,4,9,9,0,0,2019-2020,90.0,49.31506849315069,61.64383561643836
871,Ben Foster,ENG,GK,Watford,Premier League,36,1983,38.0,1,0,1,0,0,1,3,33.3,2,1,0,1,0,1,16,2,0,2019-2020,90.0,0.0,2.3684210526315788
872,Lyle Foster,RSA,FW,Monaco,Ligue 1,18,2000,0.7,0,0,0,0,0,0,1,0.0,1,0,0,0,0,0,1,0,0,2019-2020,90.0,0.0,0.0
873,Timothy Fosu-Mensah,NED,DF,Manchester Utd,Premier League,21,1998,1.5,1,1,0,1,0,1,4,25.0,3,0,0,0,4,5,1,0,0,2019-2020,90.0,240.0,60.0
874,Dimitri Foulquier,FRA,"DF,MF",Watford,Premier League,26,1993,0.7,1,0,1,0,0,0,0,0.0,0,1,0,1,2,3,2,0,0,2019-2020,90.0,257.14285714285717,128.57142857142858
875,Dimitri Foulquier,FRA,"DF,MF",Granada,La Liga,26,1993,12.4,25,11,13,9,3,11,20,55.0,9,8,3,5,16,41,32,0,0,2019-2020,90.0,116.12903225806451,181.4516129032258
Rk,Player,Nation,Pos,Squad,Comp,0,0,90.0,0,0,3,3,3,Tkl,0,0.0,0,0,0,0,0,0,0,0,0,2019-2020,90.0,0.0,0.0
876,Juan Foyth,ARG,DF,Tottenham,Premier League,21,1998,0.8,7,3,5,2,0,3,4,75.0,1,1,0,1,1,8,3,1,0,2019-2020,90.0,112.5,787.5
877,Gianluca Frabotta,ITA,DF,Juventus,Serie A,20,1999,1.0,3,1,0,2,1,2,2,100.0,0,2,0,2,1,4,2,0,0,2019-2020,90.0,90.0,270.0
878,Raphael Framberger,GER,DF,Augsburg,Bundesliga,23,1995,13.1,43,25,23,16,4,21,29,72.4,8,23,9,14,20,63,26,0,0,2019-2020,90.0,137.40458015267177,295.4198473282443
879,Simon Francis,ENG,DF,Bournemouth,Premier League,34,1985,10.8,13,9,11,2,0,11,21,52.4,10,17,12,5,20,33,71,0,0,2019-2020,90.0,166.66666666666666,108.33333333333333
880,Mike Frantz,GER,MF,Freiburg,Bundesliga,32,1986,3.9,4,2,1,3,0,2,9,22.2,7,5,3,2,1,5,4,0,0,2019-2020,90.0,23.076923076923077,92.3076923076923
881,Ryan Fraser,SCO,"MF,FW",Bournemouth,Premier League,25,1994,23.0,12,6,5,5,2,7,22,31.8,15,15,3,12,15,27,24,0,0,2019-2020,90.0,58.69565217391305,46.95652173913044
882,Fred,BRA,MF,Manchester Utd,Premier League,26,1993,24.0,60,32,33,22,5,25,100,25.0,75,44,8,36,38,98,32,0,0,2019-2020,90.0,142.5,225.0
883,Ryan Fredericks,ENG,DF,West Ham,Premier League,26,1992,24.9,82,56,59,18,5,41,64,64.1,23,20,10,10,24,106,73,1,0,2019-2020,90.0,86.74698795180723,296.3855421686747
884,Kieron Freeman,WAL,FW,Sheffield Utd,Premier League,27,1992,0.1,0,0,0,0,0,0,0,0.0,0,0,0,0,0,0,0,0,0,2019-2020,90.0,0.0,0.0
885,Luke Freeman,ENG,MF,Sheffield Utd,Premier League,27,1992,4.1,6,4,2,2,2,2,8,25.0,6,1,0,1,10,16,6,0,0,2019-2020,90.0,219.51219512195124,131.70731707317074
886,Remo Freuler,SUI,MF,Atalanta,Serie A,27,1992,26.0,51,30,18,25,8,22,63,34.9,41,41,6,35,28,79,26,0,0,2019-2020,90.00000000000001,96.92307692307693,176.53846153846155
887,Marco Friedl,AUT,"DF,MF",Werder Bremen,Bundesliga,21,1998,24.3,61,39,42,15,4,29,54,53.7,25,29,9,20,34,95,78,0,0,2019-2020,90.0,125.92592592592592,225.92592592592592
888,Marvin Friedrich,GER,DF,Union Berlin,Bundesliga,23,1995,31.0,45,31,30,14,1,12,37,32.4,25,46,24,22,42,87,110,0,0,2019-2020,90.0,121.93548387096774,130.6451612903226
889,Samúel Friðjónsson,ISL,MF,Paderborn 07,Bundesliga,23,1996,2.1,4,1,3,1,0,1,3,33.3,2,4,1,3,4,8,4,0,0,2019-2020,90.0,171.42857142857142,171.42857142857142
890,Jorge de Frutos,ESP,"MF,DF",Valladolid,La Liga,22,1997,0.7,2,2,2,0,0,1,2,50.0,1,0,0,0,0,2,1,0,0,2019-2020,90.0,0.0,257.14285714285717
891,Christian Fuchs,AUT,DF,Leicester City,Premier League,33,1986,8.6,14,9,8,6,0,8,19,42.1,11,8,3,5,17,31,33,1,0,2019-2020,90.0,177.90697674418607,146.51162790697677
892,Angelo Fulgini,FRA,MF,Angers,Ligue 1,22,1996,17.5,28,18,8,15,5,12,23,52.2,11,6,1,5,19,47,10,0,0,2019-2020,90.0,97.71428571428571,144.0
893,Niclas Füllkrug,GER,FW,Werder Bremen,Bundesliga,26,1993,4.5,2,2,1,1,0,1,3,33.3,2,3,0,3,3,5,6,0,0,2019-2020,90.0,60.0,40.0
894,Ramiro Funes Mori,ARG,DF,Villarreal,La Liga,28,1991,5.0,5,2,2,3,0,0,2,0.0,2,8,2,6,3,8,9,1,0,2019-2020,90.0,54.0,90.0
895,Daniel Fuzato,BRA,GK,Roma,Serie A,22,1997,1.0,0,0,0,0,0,0,0,0.0,0,0,0,0,0,0,0,0,0,2019-2020,90.0,0.0,0.0
896,Matteo Gabbia,ITA,DF,Milan,Serie A,19,1999,7.6,7,5,5,2,0,5,8,62.5,3,6,6,0,9,16,21,0,0,2019-2020,90.0,106.57894736842105,82.89473684210526
897,Manolo Gabbiadini,ITA,FW,Sampdoria,Serie A,27,1991,22.6,9,7,2,3,4,1,7,14.3,6,12,0,12,10,19,11,0,0,2019-2020,90.0,39.823008849557525,35.84070796460177
898,Gabriel,BRA,GK,Lecce,Serie A,26,1992,33.3,2,1,2,0,0,2,3,66.7,1,0,0,0,0,2,11,10,0,2019-2020,90.0,0.0,5.405405405405405
899,Ruben Gabrielsen,NOR,DF,Toulouse,Ligue 1,27,1992,7.3,3,2,3,0,0,2,4,50.0,2,5,3,2,8,11,41,0,0,2019-2020,90.0,98.63013698630138,36.986301369863014
900,Mijat Gaćinović,SRB,"MF,FW",Eint Frankfurt,Bundesliga,24,1995,11.6,19,11,7,8,4,6,25,24.0,19,26,2,24,15,34,6,0,0,2019-2020,90.0,116.37931034482759,147.41379310344828
Rk,Player,Nation,Pos,Squad,Comp,0,0,90.0,0,0,3,3,3,Tkl,0,0.0,0,0,0,0,0,0,0,0,0,2019-2020,90.0,0.0,0.0
901,Luca Gagliano,ITA,FW,Cagliari,Serie A,19,2000,0.6,0,0,0,0,0,0,0,0.0,0,0,0,0,1,1,0,0,0,2019-2020,90.0,150.0,0.0
902,Roberto Gagliardini,ITA,MF,Inter,Serie A,25,1994,20.0,38,19,12,18,8,14,41,34.1,27,28,8,20,30,68,20,1,0,2019-2020,90.0,135.0,171.0
903,Riccardo Gagliolo,SWE,DF,Parma,Serie A,29,1990,28.9,57,32,37,12,8,30,60,50.0,30,35,18,17,53,110,100,0,0,2019-2020,90.00000000000001,165.05190311418687,177.50865051903116
904,Nicolás Gaitán,ARG,"MF,FW",Lille,Ligue 1,31,1988,0.6,1,0,0,1,0,1,1,100.0,0,1,0,1,0,1,1,0,0,2019-2020,90.0,0.0,150.0
905,Marvin Gakpa,FRA,"MF,FW",Metz,Ligue 1,25,1993,5.2,10,6,3,4,3,4,8,50.0,4,3,0,3,5,15,1,0,0,2019-2020,90.0,86.53846153846153,173.07692307692307
906,Enric Gallego,ESP,FW,Osasuna,La Liga,32,1986,9.8,9,5,1,5,3,0,4,0.0,4,10,2,8,4,13,8,0,0,2019-2020,90.0,36.73469387755102,82.65306122448979
907,Enric Gallego,ESP,FW,Getafe,La Liga,32,1986,1.8,3,1,1,1,1,2,4,50.0,2,2,0,2,2,5,1,0,0,2019-2020,90.0,100.0,150.0
908,Kévin Gameiro,FRA,FW,Valencia,La Liga,32,1987,17.6,17,9,7,6,4,5,21,23.8,16,10,1,9,5,22,5,0,0,2019-2020,90.0,25.568181818181817,86.93181818181817
909,Fran Gámez,ESP,DF,Mallorca,La Liga,28,1991,19.6,64,42,32,27,5,33,74,44.6,41,31,11,20,29,93,41,0,0,2019-2020,90.0,133.16326530612244,293.87755102040813
910,Idrissa Gana Gueye,SEN,MF,Paris S-G,Ligue 1,29,1989,18.4,65,34,30,25,10,18,43,41.9,25,29,4,25,33,98,15,0,0,2019-2020,90.0,161.41304347826087,317.9347826086957
911,Ignatius Ganago,CMR,"FW,MF",Nice,Ligue 1,20,1999,13.8,10,6,4,3,3,3,18,16.7,15,8,1,7,4,14,13,0,0,2019-2020,90.0,26.08695652173913,65.21739130434781
912,Ezequiel Garay,ARG,DF,Valencia,La Liga,32,1986,16.0,12,8,9,2,1,7,11,63.6,4,19,17,2,14,26,71,0,0,2019-2020,90.0,78.75,67.5
913,Dani García,ESP,MF,Athletic Club,La Liga,29,1990,33.7,59,30,30,27,2,30,86,34.9,56,25,7,18,52,111,56,1,0,2019-2020,90.0,138.87240356083086,157.566765578635
914,David García,ESP,DF,Osasuna,La Liga,25,1994,31.0,28,16,15,12,1,14,31,45.2,17,20,16,4,48,76,123,2,0,2019-2020,90.0,139.3548387096774,81.29032258064517
915,Eric García,ESP,DF,Manchester City,Premier League,18,2001,8.8,6,1,4,2,0,5,9,55.6,4,2,0,2,18,24,33,0,0,2019-2020,90.0,184.0909090909091,61.36363636363636
916,Javi García,ESP,MF,Betis,La Liga,32,1987,4.2,2,2,2,0,0,2,3,66.7,1,1,0,1,4,6,15,0,0,2019-2020,90.0,85.71428571428571,42.857142857142854
917,Manu García,ESP,MF,Alavés,La Liga,33,1986,21.9,46,23,11,31,4,17,72,23.6,55,28,12,16,28,74,32,1,0,2019-2020,90.0,115.06849315068494,189.04109589041096
918,Raúl García,ESP,"DF,MF",Valladolid,La Liga,30,1989,11.2,20,12,11,7,2,9,22,40.9,13,12,2,10,8,28,30,0,0,2019-2020,90.0,64.28571428571429,160.71428571428572
919,Raúl García,ESP,"MF,FW",Athletic Club,La Liga,33,1986,31.9,57,37,19,26,12,16,76,21.1,60,46,6,40,24,81,44,0,0,2019-2020,90.0,67.7115987460815,160.81504702194357
920,Raúl García,ESP,DF,Getafe,La Liga,30,1989,2.7,5,3,2,3,0,3,6,50.0,3,3,1,2,4,9,10,0,0,2019-2020,90.0,133.33333333333331,166.66666666666666
921,Rubén García,ESP,"MF,FW",Osasuna,La Liga,26,1993,24.3,55,30,22,26,7,18,46,39.1,28,34,5,29,11,66,23,1,0,2019-2020,90.0,40.74074074074074,203.7037037037037
922,Unai García,ESP,DF,Osasuna,La Liga,27,1992,6.0,9,6,4,4,1,5,9,55.6,4,13,9,4,8,17,31,0,0,2019-2020,90.0,120.0,135.0
923,Víctor García,ESP,"FW,MF",Valladolid,La Liga,21,1997,1.0,0,0,0,0,0,0,1,0.0,1,1,0,1,0,0,1,0,0,2019-2020,90.0,0.0,0.0
924,James Garner,ENG,MF,Manchester Utd,Premier League,18,2001,0.1,0,0,0,0,0,0,1,0.0,1,0,0,0,0,0,1,0,0,2019-2020,90.0,0.0,0.0
925,Manuel Garrido,ESP,FW,Leganés,La Liga,18,2000,1.3,0,0,0,0,0,0,6,0.0,6,3,1,2,1,1,0,0,0,2019-2020,90.0,69.23076923076923,0.0
Rk,Player,Nation,Pos,Squad,Comp,0,0,90.0,0,0,3,3,3,Tkl,0,0.0,0,0,0,0,0,0,0,0,0,2019-2020,90.0,0.0,0.0
926,Mario Gaspar,ESP,DF,Villarreal,La Liga,28,1990,21.8,35,20,16,16,3,15,31,48.4,16,25,10,15,26,61,69,0,0,2019-2020,90.0,107.3394495412844,144.4954128440367
927,Daniele Gastaldello,ITA,DF,Brescia,Serie A,36,1983,4.3,8,5,5,3,0,2,3,66.7,1,6,3,3,5,13,29,1,0,2019-2020,90.0,104.65116279069768,167.4418604651163
928,Dwight Gayle,ENG,FW,Newcastle Utd,Premier League,28,1990,9.4,12,10,4,6,2,4,8,50.0,4,5,0,5,2,14,9,0,0,2019-2020,90.0,19.148936170212764,114.89361702127658
929,Paulo Gazzaniga,ARG,GK,Tottenham,Premier League,27,1992,17.9,0,0,0,0,0,0,0,0.0,0,0,0,0,1,1,4,1,0,2019-2020,90.0,5.027932960893855,0.0
930,Jean-Philippe Gbamin,CIV,MF,Everton,Premier League,23,1995,1.5,4,3,1,1,2,1,2,50.0,1,1,0,1,1,5,4,0,0,2019-2020,90.0,60.0,240.0
931,Yann Gboho,FRA,FW,Rennes,Ligue 1,18,2001,2.5,2,2,1,0,1,0,2,0.0,2,1,0,1,1,3,0,0,0,2019-2020,90.0,36.0,72.0
932,David de Gea,ESP,GK,Manchester Utd,Premier League,28,1990,38.0,0,0,0,0,0,0,0,0.0,0,0,0,0,0,0,7,4,0,2019-2020,90.0,0.0,0.0
933,Theodor Gebre Selassie,CZE,"DF,MF",Werder Bremen,Bundesliga,32,1986,27.0,36,27,23,10,3,17,35,48.6,18,26,9,17,63,99,81,0,0,2019-2020,90.0,210.0,120.0
934,Dennis Geiger,GER,MF,Hoffenheim,Bundesliga,21,1998,12.6,12,5,4,6,2,2,16,12.5,14,9,2,7,6,18,4,0,0,2019-2020,90.0,42.85714285714286,85.71428571428572
935,Jérémy Gélin,FRA,"DF,MF",Rennes,Ligue 1,22,1997,10.3,14,5,10,2,2,8,13,61.5,5,14,7,7,15,29,33,1,0,2019-2020,90.0,131.06796116504853,122.33009708737863
936,Christian Gentner,GER,MF,Union Berlin,Bundesliga,33,1985,27.1,53,28,16,32,5,22,73,30.1,51,46,8,38,54,107,50,0,0,2019-2020,90.0,179.33579335793357,176.01476014760146
937,Yannick Gerhardt,GER,MF,Wolfsburg,Bundesliga,25,1994,9.2,28,18,7,15,6,8,21,38.1,13,11,3,8,12,40,9,0,0,2019-2020,90.0,117.3913043478261,273.9130434782609
938,Valère Germain,FRA,FW,Marseille,Ligue 1,29,1990,15.0,22,12,6,11,5,6,31,19.4,25,16,3,13,8,30,26,0,0,2019-2020,90.0,48.0,132.0
939,Gervinho,CIV,FW,Parma,Serie A,32,1987,25.2,12,6,5,6,1,6,17,35.3,11,4,0,4,5,17,3,0,0,2019-2020,90.0,17.857142857142858,42.85714285714286
940,Anwar El Ghazi,NED,"FW,MF",Aston Villa,Premier League,24,1995,22.8,20,11,12,5,3,8,26,30.8,18,10,1,9,13,33,16,1,0,2019-2020,90.0,51.315789473684205,78.94736842105263
941,Rachid Ghezzal,ALG,"MF,FW",Fiorentina,Serie A,27,1992,9.2,27,15,14,10,3,10,33,30.3,23,6,0,6,11,38,9,0,0,2019-2020,90.0,107.60869565217392,264.1304347826087
942,Andrea Ghezzi,ITA,"FW,MF",Brescia,Serie A,18,2001,0.4,2,0,0,1,1,1,1,100.0,0,0,0,0,0,2,0,0,0,2019-2020,90.0,0.0,450.0
943,Paolo Ghiglione,ITA,"DF,FW",Genoa,Serie A,22,1997,19.1,31,16,15,13,3,18,35,51.4,17,17,2,15,9,40,42,1,0,2019-2020,90.0,42.40837696335078,146.07329842931938
944,Andrea Ghion,ITA,"FW,MF",Sassuolo,Serie A,19,2000,0.5,3,1,1,2,0,1,1,100.0,0,0,0,0,0,3,0,0,0,2019-2020,90.0,0.0,540.0
945,Saman Ghoddos,IRN,FW,Amiens,Ligue 1,25,1993,2.6,2,2,0,1,1,1,2,50.0,1,5,0,5,2,4,3,0,0,2019-2020,90.0,69.23076923076923,69.23076923076923
946,Faouzi Ghoulam,ALG,DF,Napoli,Serie A,28,1991,4.2,6,4,1,4,1,2,5,40.0,3,3,2,1,4,10,8,0,0,2019-2020,90.0,85.71428571428571,128.57142857142856
947,Morgan Gibbs-White,ENG,"MF,FW",Wolves,Premier League,19,2000,1.4,0,0,0,0,0,0,0,0.0,0,0,0,0,2,2,0,0,0,2019-2020,90.0,128.57142857142858,0.0
948,Niko Gießelmann,GER,DF,Düsseldorf,Bundesliga,27,1991,22.9,46,31,31,11,4,22,45,48.9,23,23,6,17,27,73,55,1,0,2019-2020,90.0,106.11353711790395,180.78602620087338
949,Rafał Gikiewicz,POL,GK,Union Berlin,Bundesliga,31,1987,33.0,1,0,1,0,0,1,4,25.0,3,0,0,0,2,3,26,4,0,2019-2020,90.0,5.454545454545455,2.7272727272727275
950,Bryan Gil,ESP,"MF,FW",Leganés,La Liga,18,2001,6.2,8,4,3,4,1,1,8,12.5,7,6,0,6,3,11,1,0,0,2019-2020,90.0,43.54838709677419,116.12903225806451
Rk,Player,Nation,Pos,Squad,Comp,0,0,90.0,0,0,3,3,3,Tkl,0,0.0,0,0,0,0,0,0,0,0,0,2019-2020,90.0,0.0,0.0
951,Bryan Gil,ESP,FW,Sevilla,La Liga,18,2001,0.7,1,1,0,1,0,0,1,0.0,1,0,0,0,0,1,0,0,0,2019-2020,90.0,0.0,128.57142857142858
952,Billy Gilmour,SCO,MF,Chelsea,Premier League,18,2001,2.2,5,2,3,2,0,2,4,50.0,2,2,0,2,3,8,3,1,0,2019-2020,90.0,122.72727272727272,204.54545454545453
953,Daniel Ginczek,GER,FW,Wolfsburg,Bundesliga,28,1991,8.5,4,3,3,1,0,1,11,9.1,10,3,1,2,1,5,3,0,0,2019-2020,90.0,10.588235294117647,42.35294117647059
954,Matthias Ginter,GER,DF,Gladbach,Bundesliga,25,1994,30.9,34,20,19,14,1,17,31,54.8,14,27,22,5,34,68,125,3,0,2019-2020,90.0,99.02912621359224,99.02912621359224
955,Andrei Girotto,BRA,DF,Nantes,Ligue 1,27,1992,24.2,76,53,45,29,2,39,71,54.9,32,32,17,15,34,110,111,1,0,2019-2020,90.0,126.44628099173553,282.64462809917353
956,Olivier Giroud,FRA,FW,Chelsea,Premier League,32,1986,11.0,8,3,2,5,1,1,11,9.1,10,14,1,13,2,10,13,0,0,2019-2020,90.0,16.363636363636363,65.45454545454545
957,Klaus Gjasula,ALB,MF,Paderborn 07,Bundesliga,29,1989,25.3,69,39,30,35,4,30,61,49.2,31,33,6,27,32,101,50,2,0,2019-2020,89.99999999999999,113.83399209486164,245.45454545454544
958,Kamil Glik,POL,DF,Monaco,Ligue 1,31,1988,23.0,26,14,15,11,0,13,21,61.9,8,23,17,6,27,53,118,0,0,2019-2020,90.0,105.65217391304348,101.73913043478262
959,Serge Gnabry,GER,"FW,MF",Bayern Munich,Bundesliga,24,1995,24.4,36,16,4,19,13,9,29,31.0,20,17,0,17,16,52,2,1,0,2019-2020,90.0,59.016393442622956,132.78688524590166
960,Joris Gnagnon,FRA,DF,Rennes,Ligue 1,22,1997,14.2,16,13,14,2,0,10,11,90.9,1,21,17,4,18,34,61,0,0,2019-2020,90.0,114.08450704225353,101.40845070422536
961,Eddy Gnahoré,FRA,MF,Amiens,Ligue 1,25,1993,12.6,24,12,7,15,2,8,28,28.6,20,25,4,21,9,33,25,0,0,2019-2020,90.0,64.28571428571429,171.42857142857144
962,Ben Godfrey,ENG,DF,Norwich City,Premier League,21,1998,29.4,22,14,18,3,1,10,18,55.6,8,41,37,4,25,47,152,3,0,2019-2020,90.0,76.53061224489797,67.34693877551021
963,Diego Godín,URU,DF,Inter,Serie A,33,1986,18.1,38,29,19,16,3,18,32,56.3,14,17,7,10,45,83,60,1,0,2019-2020,90.0,223.75690607734805,188.9502762430939
964,Akaki Gogia,GER,"MF,FW",Union Berlin,Bundesliga,27,1992,1.3,2,1,0,0,2,0,2,0.0,2,2,2,0,0,2,0,0,0,2019-2020,90.0,0.0,138.46153846153845
965,Mauro Goicoechea,URU,GK,Toulouse,Ligue 1,31,1988,2.0,0,0,0,0,0,0,0,0.0,0,0,0,0,0,0,1,2,0,2019-2020,90.0,0.0,0.0
966,Edoardo Goldaniga,ITA,DF,Genoa,Serie A,25,1993,8.7,4,3,3,1,0,2,5,40.0,3,11,6,5,18,22,25,1,0,2019-2020,90.0,186.20689655172413,41.37931034482759
967,Benjamin Goller,GER,"FW,MF",Werder Bremen,Bundesliga,20,1999,3.2,8,3,3,4,1,3,10,30.0,7,3,0,3,1,9,1,0,0,2019-2020,90.0,28.125,225.0
968,Pierluigi Gollini,ITA,GK,Atalanta,Serie A,24,1995,32.0,0,0,0,0,0,0,2,0.0,2,0,0,0,0,0,13,2,0,2019-2020,90.0,0.0,0.0
969,Aleksandr Golovin,RUS,MF,Monaco,Ligue 1,23,1996,22.9,49,27,17,26,6,14,69,20.3,55,28,0,28,31,80,22,0,0,2019-2020,90.0,121.83406113537119,192.57641921397382
970,André Gomes,POR,MF,Everton,Premier League,26,1993,16.2,22,15,7,11,4,8,62,12.9,54,20,3,17,7,29,7,0,0,2019-2020,90.0,38.88888888888889,122.22222222222223
971,Angel Gomes,ENG,MF,Manchester Utd,Premier League,18,2000,0.2,0,0,0,0,0,0,0,0.0,0,1,0,1,0,0,0,0,0,2019-2020,90.0,0.0,0.0
972,Ibai Gómez,ESP,FW,Athletic Club,La Liga,29,1989,7.7,5,3,2,2,1,3,8,37.5,5,4,0,4,3,8,6,0,0,2019-2020,90.0,35.064935064935064,58.44155844155844
973,Joe Gomez,ENG,DF,Liverpool,Premier League,22,1997,22.3,23,16,17,6,0,9,20,45.0,11,15,8,7,38,61,64,2,0,2019-2020,90.0,153.36322869955157,92.82511210762331
974,Maxi Gómez,URU,FW,Valencia,La Liga,22,1996,23.8,9,7,1,6,2,4,8,50.0,4,8,1,7,5,14,14,0,0,2019-2020,90.00000000000001,18.907563025210084,34.03361344537815
975,Moi Gómez,ESP,"FW,MF",Villarreal,La Liga,25,1994,25.8,30,22,9,14,7,11,33,33.3,22,22,2,20,25,55,23,0,0,2019-2020,90.0,87.20930232558139,104.65116279069767
Rk,Player,Nation,Pos,Squad,Comp,0,0,90.0,0,0,3,3,3,Tkl,0,0.0,0,0,0,0,0,0,0,0,0,2019-2020,90.0,0.0,0.0
976,Papu Gómez,ARG,"MF,FW",Atalanta,Serie A,31,1988,31.6,27,13,5,13,9,13,45,28.9,32,24,0,24,17,44,6,1,0,2019-2020,90.0,48.417721518987335,76.89873417721518
977,Sergi Gómez,ESP,DF,Sevilla,La Liga,27,1992,8.0,9,7,7,2,0,4,4,100.0,0,6,6,0,7,16,30,0,0,2019-2020,90.0,78.75,101.25
978,Victor Gomez,ESP,"DF,FW",Espanyol,La Liga,19,2000,14.1,13,5,8,4,1,7,20,35.0,13,10,0,10,21,34,31,0,0,2019-2020,89.99999999999999,134.04255319148936,82.97872340425532
979,Alfred Gomis,SEN,GK,Dijon,Ligue 1,25,1993,18.0,1,0,1,0,0,1,2,50.0,1,2,0,2,0,1,14,2,0,2019-2020,90.0,0.0,5.0
980,Maxime Gonalons,FRA,MF,Granada,La Liga,30,1989,16.7,62,38,25,35,2,22,54,40.7,32,27,3,24,20,82,20,1,0,2019-2020,90.0,107.78443113772455,334.1317365269461
981,Mathieu Goncalves,FRA,DF,Toulouse,Ligue 1,18,2001,3.5,5,3,5,0,0,2,8,25.0,6,4,3,1,4,9,10,0,0,2019-2020,90.0,102.85714285714286,128.57142857142856
982,Jérôme Gondorf,GER,MF,Freiburg,Bundesliga,31,1988,1.3,9,6,7,1,1,3,6,50.0,3,3,2,1,0,9,2,0,0,2019-2020,90.0,0.0,623.076923076923
983,Álvaro González,ESP,DF,Marseille,Ligue 1,29,1990,18.1,19,13,14,4,1,9,13,69.2,4,7,4,3,18,37,65,0,0,2019-2020,90.0,89.50276243093921,94.47513812154695
984,Bruno González,ESP,DF,Getafe,La Liga,29,1990,2.0,3,2,3,0,0,1,1,100.0,0,2,0,2,0,3,3,0,0,2019-2020,90.0,0.0,135.0
985,Bruno González,ESP,DF,Levante,La Liga,29,1990,5.1,10,8,7,2,1,2,4,50.0,2,7,4,3,2,12,32,0,0,2019-2020,90.0,35.294117647058826,176.47058823529412
986,Édgar González,ESP,MF,Betis,La Liga,22,1997,7.6,8,3,3,5,0,2,14,14.3,12,4,2,2,10,18,16,0,0,2019-2020,90.0,118.42105263157895,94.73684210526315
987,Gonzalo,ESP,DF,Levante,La Liga,22,1997,0.1,1,0,0,1,0,0,0,0.0,0,0,0,0,0,1,0,0,0,2019-2020,90.0,0.0,900.0
988,Anthony Gordon,ENG,"MF,FW",Everton,Premier League,18,2001,4.9,11,7,5,6,0,5,15,33.3,10,6,2,4,8,19,4,0,0,2019-2020,90.0,146.93877551020407,202.0408163265306
989,Leon Goretzka,GER,MF,Bayern Munich,Bundesliga,24,1995,16.8,28,15,7,18,3,10,32,31.3,22,18,2,16,24,52,8,0,0,2019-2020,90.0,128.57142857142856,150.0
990,Andoni Gorosabel,ESP,DF,Real Sociedad,La Liga,22,1996,7.9,14,8,9,3,2,10,20,50.0,10,13,1,12,13,27,21,0,0,2019-2020,90.0,148.1012658227848,159.49367088607593
991,Robin Gosens,GER,DF,Atalanta,Serie A,25,1994,29.1,53,27,19,26,8,23,51,45.1,28,38,10,28,39,92,40,0,0,2019-2020,90.0,120.61855670103091,163.91752577319585
992,Dan Gosling,ENG,MF,Bournemouth,Premier League,29,1990,14.0,26,10,14,9,3,6,27,22.2,21,31,11,20,20,46,26,0,0,2019-2020,90.0,128.57142857142856,167.14285714285714
993,Mario Götze,GER,FW,Dortmund,Bundesliga,27,1992,5.8,10,7,0,6,4,3,12,25.0,9,3,0,3,2,12,1,0,0,2019-2020,90.0,31.03448275862069,155.17241379310346
994,Prince-Désir Gouano,FRA,DF,Amiens,Ligue 1,25,1993,3.0,3,1,0,3,0,0,0,0.0,0,6,3,3,2,5,15,0,0,2019-2020,90.0,60.0,90.0
995,Amine Gouiri,ALG,FW,Lyon,Ligue 1,19,2000,0.0,0,0,0,0,0,0,0,0.0,0,0,0,0,0,0,0,0,0,2019-2020,,,
996,Jeffrey Gouweleeuw,NED,DF,Augsburg,Bundesliga,28,1991,18.3,28,16,22,5,1,12,21,57.1,9,15,8,7,37,65,97,0,0,2019-2020,90.0,181.9672131147541,137.70491803278688
997,Max Gradel,CIV,"MF,FW",Toulouse,Ligue 1,31,1987,18.2,36,20,17,14,5,12,47,25.5,35,11,1,10,11,47,23,0,0,2019-2020,90.0,54.395604395604394,178.02197802197801
998,Samuel Grandsir,FRA,"FW,MF",Brest,Ligue 1,22,1996,16.6,34,22,13,16,5,11,30,36.7,19,9,0,9,14,48,5,0,0,2019-2020,90.0,75.90361445783131,184.33734939759034
999,Esteban Granero,ESP,MF,Espanyol,La Liga,32,1987,5.3,10,4,5,3,2,5,11,45.5,6,3,2,1,2,12,5,0,0,2019-2020,90.0,33.9622641509434,169.811320754717
1000,Alberto Grassi,ITA,MF,Parma,Serie A,24,1995,7.1,10,4,7,3,0,5,13,38.5,8,5,2,3,19,29,9,1,0,2019-2020,90.0,240.84507042253523,126.7605633802817
Rk,Player,Nation,Pos,Squad,Comp,0,0,90.0,0,0,3,3,3,Tkl,0,0.0,0,0,0,0,0,0,0,0,0,2019-2020,90.0,0.0,0.0
1001,Andre Gray,JAM,FW,Watford,Premier League,28,1991,8.4,4,3,0,2,2,1,3,33.3,2,4,1,3,1,5,2,0,0,2019-2020,90.0,10.714285714285714,42.857142857142854
1002,Demarai Gray,JAM,"MF,FW",Leicester City,Premier League,23,1996,6.9,12,6,6,6,0,6,12,50.0,6,7,0,7,5,17,4,0,0,2019-2020,90.0,65.21739130434781,156.52173913043475
1003,Jack Grealish,ENG,"FW,MF",Aston Villa,Premier League,23,1995,35.9,29,19,12,12,5,13,34,38.2,21,33,12,21,22,51,22,1,0,2019-2020,90.0,55.15320334261839,72.70194986072424
1004,Mason Greenwood,ENG,FW,Manchester Utd,Premier League,17,2001,14.7,17,11,5,6,6,5,20,25.0,15,9,0,9,6,23,6,1,0,2019-2020,90.0,36.734693877551024,104.08163265306122
1005,Michael Gregoritsch,AUT,"MF,FW",Augsburg,Bundesliga,25,1994,3.4,2,2,0,2,0,0,4,0.0,4,4,1,3,3,5,7,0,0,2019-2020,90.0,79.41176470588235,52.94117647058823
1006,Michael Gregoritsch,AUT,FW,Schalke 04,Bundesliga,25,1994,9.2,8,5,0,6,2,0,9,0.0,9,9,1,8,2,10,10,0,0,2019-2020,90.0,19.565217391304348,78.26086956521739
1007,Clément Grenier,FRA,MF,Rennes,Ligue 1,28,1991,9.3,21,12,6,15,0,11,40,27.5,29,7,2,5,7,28,16,0,0,2019-2020,90.0,67.74193548387096,203.22580645161287
1008,Antoine Griezmann,FRA,FW,Barcelona,La Liga,28,1991,28.3,33,18,12,11,10,9,34,26.5,25,22,3,19,12,45,20,1,0,2019-2020,90.0,38.1625441696113,104.94699646643109
1009,Vincenzo Grifo,ITA,MF,Hoffenheim,Bundesliga,26,1993,0.2,0,0,0,0,0,0,0,0.0,0,0,0,0,0,0,0,0,0,2019-2020,90.0,0.0,0.0
1010,Vincenzo Grifo,ITA,"MF,FW",Freiburg,Bundesliga,26,1993,18.0,15,10,9,3,3,6,25,24.0,19,13,1,12,14,29,18,1,0,2019-2020,90.0,70.0,75.0
1011,Florian Grillitsch,AUT,"MF,DF",Hoffenheim,Bundesliga,23,1995,26.8,59,29,34,24,1,29,61,47.5,32,33,6,27,49,108,41,1,0,2019-2020,90.0,164.55223880597012,198.13432835820893
1012,Jérémy Grimm,FRA,MF,Strasbourg,Ligue 1,32,1987,0.0,0,0,0,0,0,0,0,0.0,0,0,0,0,0,0,0,0,0,2019-2020,,,
1013,Christian Groß,GER,"DF,MF",Werder Bremen,Bundesliga,30,1989,9.7,23,17,16,5,2,9,16,56.3,7,13,7,6,14,37,50,1,0,2019-2020,90.0,129.89690721649487,213.40206185567013
1014,Pascal Groß,GER,"MF,FW",Brighton,Premier League,28,1991,20.0,36,13,8,21,7,14,39,35.9,25,25,3,22,9,45,7,0,0,2019-2020,90.0,40.5,162.0
1015,Carlos Gruezo,ECU,MF,Augsburg,Bundesliga,24,1995,9.8,28,12,12,15,1,5,24,20.8,19,5,0,5,6,34,5,0,0,2019-2020,90.0,55.10204081632653,257.1428571428571
1016,Marko Grujić,SRB,MF,Hertha BSC,Bundesliga,23,1996,26.8,56,34,21,30,5,19,63,30.2,44,43,9,34,22,78,69,0,0,2019-2020,90.0,73.88059701492537,188.0597014925373
1017,Vicente Guaita,ESP,GK,Crystal Palace,Premier League,32,1987,35.0,1,1,1,0,0,1,2,50.0,1,0,0,0,0,1,18,3,0,2019-2020,90.0,0.0,2.571428571428571
1018,Andrés Guardado,MEX,MF,Betis,La Liga,32,1986,22.7,30,14,15,11,4,15,41,36.6,26,15,4,11,18,48,22,1,0,2019-2020,89.99999999999999,71.36563876651982,118.94273127753303
1019,Sergi Guardiola,ESP,FW,Valladolid,La Liga,28,1991,29.5,14,6,3,7,4,4,24,16.7,20,23,0,23,6,20,18,1,0,2019-2020,90.0,18.305084745762713,42.71186440677966
1020,Nemanja Gudelj,SRB,"MF,DF",Sevilla,La Liga,27,1991,13.5,20,14,11,8,1,6,19,31.6,13,17,8,9,12,32,35,1,0,2019-2020,90.0,80.0,133.33333333333334
1021,Gonçalo Guedes,POR,"MF,FW",Valencia,La Liga,22,1996,14.1,19,11,11,7,1,9,32,28.1,23,10,1,9,7,26,1,0,0,2019-2020,89.99999999999999,44.680851063829785,121.27659574468085
1022,Mattéo Guendouzi,FRA,MF,Arsenal,Premier League,20,1999,19.4,31,16,14,13,4,14,43,32.6,29,21,7,14,29,60,38,2,0,2019-2020,90.0,134.53608247422682,143.81443298969074
1023,Raphaël Guerreiro,POR,"DF,MF",Dortmund,Bundesliga,25,1993,25.9,44,24,18,21,5,20,32,62.5,12,27,3,24,42,86,26,0,0,2019-2020,90.0,145.94594594594597,152.8957528957529
1024,Adrián Guerrero,ESP,DF,Valencia,La Liga,21,1998,1.4,2,2,1,1,0,2,3,66.7,1,0,0,0,2,4,1,0,0,2019-2020,90.0,128.57142857142858,128.57142857142858
1025,Ander Guevara,ESP,MF,Real Sociedad,La Liga,22,1997,10.4,27,11,9,17,1,12,30,40.0,18,13,3,10,8,35,15,1,0,2019-2020,90.0,69.23076923076923,233.65384615384613
Rk,Player,Nation,Pos,Squad,Comp,0,0,90.0,0,0,3,3,3,Tkl,0,0.0,0,0,0,0,0,0,0,0,0,2019-2020,90.0,0.0,0.0
1026,Babacar Guèye,SEN,FW,Paderborn 07,Bundesliga,24,1994,1.2,2,0,0,0,2,0,1,0.0,1,1,1,0,0,2,3,0,0,2019-2020,90.0,0.0,150.0
1027,John Guidetti,SWE,"FW,MF",Alavés,La Liga,27,1992,1.1,2,1,0,1,1,0,0,0.0,0,1,0,1,0,2,0,0,0,2019-2020,90.0,0.0,163.63636363636363
1028,Josuha Guilavogui,FRA,"MF,DF",Wolfsburg,Bundesliga,28,1990,22.9,41,26,17,23,1,10,30,33.3,20,35,9,26,45,86,64,2,0,2019-2020,90.0,176.85589519650657,161.1353711790393
1029,Frederic Guilbert,FRA,"DF,MF",Aston Villa,Premier League,24,1994,22.7,74,43,48,20,6,36,67,53.7,31,33,10,23,49,123,74,2,0,2019-2020,89.99999999999999,194.27312775330395,293.3920704845815
1030,Hugo Guillamón,ESP,DF,Valencia,La Liga,19,2000,5.5,8,3,5,2,1,5,10,50.0,5,3,2,1,5,13,29,0,0,2019-2020,90.0,81.81818181818183,130.9090909090909
1031,Bruno Guimarães,BRA,MF,Lyon,Ligue 1,21,1997,3.0,12,7,5,6,1,5,10,50.0,5,1,0,1,4,16,1,0,0,2019-2020,90.0,120.0,360.0
1032,Serhou Guirassy,GUI,FW,Amiens,Ligue 1,23,1996,21.3,7,3,1,4,2,2,7,28.6,5,13,6,7,4,11,21,0,0,2019-2020,90.0,16.901408450704224,29.577464788732396
1033,Rafik Guitane,FRA,MF,Rennes,Ligue 1,20,1999,0.2,0,0,0,0,0,0,0,0.0,0,0,0,0,0,0,0,0,0,2019-2020,90.0,0.0,0.0
1034,Péter Gulácsi,HUN,GK,RB Leipzig,Bundesliga,29,1990,32.0,0,0,0,0,0,0,0,0.0,0,0,0,0,1,1,18,6,0,2019-2020,90.0,2.8125,0.0
1035,Manuel Gulde,GER,DF,Freiburg,Bundesliga,28,1991,15.2,28,16,17,9,2,15,24,62.5,9,23,13,10,22,50,80,1,0,2019-2020,90.0,130.26315789473685,165.78947368421052
1036,Sinan Gümüş,,"FW,MF",Genoa,Serie A,25,1994,1.1,0,0,0,0,0,0,4,0.0,4,0,0,0,0,0,1,0,0,2019-2020,90.0,0.0,0.0
1037,İlkay Gündoğan,GER,MF,Manchester City,Premier League,28,1990,22.4,27,16,9,11,7,9,41,22.0,32,17,5,12,31,58,13,0,0,2019-2020,90.0,124.55357142857143,108.48214285714286
1038,Angus Gunn,SCO,GK,Southampton,Premier League,23,1996,10.0,1,1,1,0,0,1,3,33.3,2,0,0,0,0,1,1,0,0,2019-2020,90.0,0.0,9.0
1039,Christian Günter,GER,DF,Freiburg,Bundesliga,26,1993,33.7,25,11,17,7,1,12,35,34.3,23,29,13,16,14,39,40,0,0,2019-2020,90.0,37.388724035608305,66.76557863501483
1040,Koray Günter,GER,DF,Hellas Verona,Serie A,24,1994,30.4,39,25,22,15,2,19,29,65.5,10,45,39,6,55,94,131,1,0,2019-2020,90.0,162.82894736842104,115.46052631578947
1041,Régis Gurtner,FRA,GK,Amiens,Ligue 1,32,1986,28.0,1,1,1,0,0,1,2,50.0,1,0,0,0,0,1,10,4,0,2019-2020,90.0,0.0,3.2142857142857144
1042,Luiz Gustavo,BRA,MF,Marseille,Ligue 1,32,1987,2.1,6,3,3,3,0,3,5,60.0,2,5,2,3,5,11,6,0,0,2019-2020,90.0,214.28571428571428,257.1428571428571
1043,Jonathan de Guzmán,NED,MF,Eint Frankfurt,Bundesliga,31,1987,1.0,1,1,0,1,0,1,7,14.3,6,2,0,2,1,2,0,0,0,2019-2020,90.0,90.0,90.0
1044,Erling Haaland,NOR,FW,Dortmund,Bundesliga,19,2000,11.8,4,2,1,0,3,0,4,0.0,4,7,4,3,4,8,4,0,0,2019-2020,90.0,30.508474576271183,30.508474576271183
1045,Janik Haberer,GER,"MF,FW",Freiburg,Bundesliga,25,1994,19.1,26,18,8,14,4,12,45,26.7,33,25,4,21,25,51,23,0,0,2019-2020,90.0,117.80104712041884,122.5130890052356
1046,Alexander Hack,GER,DF,Mainz 05,Bundesliga,25,1993,8.9,26,10,19,6,1,16,27,59.3,11,20,9,11,23,49,60,1,0,2019-2020,90.0,232.58426966292134,262.92134831460675
1047,Munir El Haddadi,MAR,FW,Sevilla,La Liga,23,1995,13.9,19,17,6,11,2,4,21,19.0,17,8,0,8,7,26,8,0,0,2019-2020,90.0,45.32374100719424,123.02158273381295
1048,André Hahn,GER,"FW,MF",Augsburg,Bundesliga,28,1990,7.8,15,9,7,5,3,5,21,23.8,16,23,5,18,13,28,14,0,0,2019-2020,90.0,150.0,173.07692307692307
1049,Amadou Haidara,MLI,MF,RB Leipzig,Bundesliga,21,1998,8.4,26,16,7,17,2,10,24,41.7,14,14,2,12,8,34,10,1,0,2019-2020,90.0,85.71428571428571,278.57142857142856
1050,Achraf Hakimi,MAR,"DF,MF",Dortmund,Bundesliga,20,1998,30.2,60,41,38,14,8,27,64,42.2,37,26,2,24,30,90,27,2,0,2019-2020,90.0,89.40397350993378,178.80794701986756
Rk,Player,Nation,Pos,Squad,Comp,0,0,90.0,0,0,3,3,3,Tkl,0,0.0,0,0,0,0,0,0,0,0,0,2019-2020,90.0,0.0,0.0
1051,Sébastien Haller,CIV,FW,West Ham,Premier League,25,1994,25.2,22,15,8,10,4,3,30,10.0,27,19,5,14,8,30,27,0,0,2019-2020,90.0,28.571428571428573,78.57142857142858
1052,Marcel Halstenberg,GER,DF,RB Leipzig,Bundesliga,27,1991,28.0,46,31,27,17,2,28,58,48.3,30,37,11,26,46,92,72,2,0,2019-2020,90.0,147.85714285714286,147.85714285714286
1053,Romain Hamouma,FRA,"FW,MF",Saint-Étienne,Ligue 1,32,1987,9.6,12,9,1,5,6,2,12,16.7,10,12,0,12,0,12,4,0,0,2019-2020,90.0,0.0,112.50000000000001
1054,Samir Handanović,SVN,GK,Inter,Serie A,35,1984,35.0,1,1,1,0,0,0,1,0.0,1,0,0,0,0,1,8,3,0,2019-2020,90.0,0.0,2.571428571428571
1055,Grant Hanley,SCO,DF,Norwich City,Premier League,27,1991,14.0,24,15,17,7,0,8,14,57.1,6,25,18,7,31,55,77,1,0,2019-2020,90.0,199.28571428571428,154.28571428571428
1056,Lukáš Haraslín,SVK,FW,Sassuolo,Serie A,23,1996,4.3,5,2,1,3,1,2,9,22.2,7,5,0,5,4,9,1,0,0,2019-2020,90.0,83.72093023255815,104.65116279069768
1057,Amine Harit,MAR,"MF,FW",Schalke 04,Bundesliga,22,1997,23.4,16,7,8,5,3,6,25,24.0,19,13,0,13,7,23,2,1,0,2019-2020,89.99999999999999,26.923076923076923,61.53846153846153
1058,Martin Harnik,AUT,"MF,FW",Werder Bremen,Bundesliga,32,1987,0.1,0,0,0,0,0,0,0,0.0,0,0,0,0,0,0,0,0,0,2019-2020,90.0,0.0,0.0
1059,Makoto Hasebe,JPN,"DF,MF",Eint Frankfurt,Bundesliga,35,1984,21.9,28,20,16,9,3,18,39,46.2,21,38,10,28,26,54,38,0,0,2019-2020,90.0,106.84931506849315,115.06849315068494
1060,Hans Hateboer,NED,DF,Atalanta,Serie A,25,1994,26.2,36,23,20,9,7,18,38,47.4,20,22,7,15,10,46,32,1,0,2019-2020,90.0,34.35114503816794,123.66412213740459
1061,Kortney Hause,ENG,DF,Aston Villa,Premier League,24,1995,17.2,21,9,15,5,1,8,15,53.3,7,27,19,8,20,41,98,4,0,2019-2020,90.0,104.65116279069768,109.88372093023257
1062,Kai Havertz,GER,"MF,FW",Leverkusen,Bundesliga,20,1999,27.3,21,15,5,10,6,6,39,15.4,33,22,0,22,2,23,22,0,0,2019-2020,90.0,6.593406593406593,69.23076923076923
1063,Isaac Hayden,ENG,MF,Newcastle Utd,Premier League,24,1995,24.7,55,27,33,17,5,20,50,40.0,30,24,7,17,38,93,38,0,0,2019-2020,90.0,138.46153846153845,200.40485829959516
1064,Eden Hazard,BEL,"FW,MF",Real Madrid,La Liga,28,1991,12.0,7,3,2,3,2,3,15,20.0,12,5,0,5,6,13,0,0,0,2019-2020,90.0,45.0,52.5
1065,Thorgan Hazard,BEL,"FW,MF",Dortmund,Bundesliga,26,1993,26.4,40,27,17,14,9,12,50,24.0,38,29,0,29,13,53,2,1,0,2019-2020,90.0,44.31818181818182,136.36363636363637
1066,Tom Heaton,ENG,GK,Aston Villa,Premier League,33,1986,19.9,3,2,3,0,0,3,4,75.0,1,0,0,0,0,3,6,0,0,2019-2020,90.0,0.0,13.5678391959799
1067,Jonas Hector,GER,"MF,DF",Köln,Bundesliga,29,1990,27.0,76,49,37,34,5,24,75,32.0,51,44,10,34,46,122,38,1,0,2019-2020,90.0,153.33333333333334,253.33333333333334
1068,Dominique Heintz,GER,DF,Freiburg,Bundesliga,25,1993,27.0,47,30,40,6,1,17,43,39.5,26,38,25,13,41,88,131,1,0,2019-2020,90.0,136.66666666666669,156.66666666666669
1069,Dean Henderson,ENG,GK,Sheffield Utd,Premier League,22,1997,36.0,0,0,0,0,0,0,0,0.0,0,0,0,0,1,1,13,1,0,2019-2020,90.0,2.5,0.0
1070,Jordan Henderson,ENG,MF,Liverpool,Premier League,29,1990,24.9,63,41,18,33,12,22,55,40.0,33,22,4,18,30,93,21,2,0,2019-2020,90.0,108.43373493975903,227.71084337349396
1071,Liam Henderson,SCO,MF,Hellas Verona,Serie A,23,1996,2.2,3,2,0,3,0,2,3,66.7,1,1,0,1,0,3,4,0,0,2019-2020,90.0,0.0,122.72727272727272
1072,Jeff Hendrick,IRL,MF,Burnley,Premier League,27,1992,21.5,18,10,7,8,3,7,27,25.9,20,21,8,13,20,38,20,0,0,2019-2020,90.0,83.72093023255813,75.34883720930232
1073,Wayne Hennessey,WAL,GK,Crystal Palace,Premier League,32,1987,3.0,0,0,0,0,0,0,0,0.0,0,0,0,0,1,1,3,1,0,2019-2020,90.0,30.0,0.0
1074,Rouwen Hennings,GER,FW,Düsseldorf,Bundesliga,31,1987,27.3,11,5,2,7,2,3,18,16.7,15,12,0,12,2,13,33,0,0,2019-2020,90.0,6.593406593406593,36.26373626373626
1075,Benjamin Henrichs,GER,"DF,MF",Monaco,Ligue 1,22,1997,9.9,26,20,16,9,1,14,33,42.4,19,19,4,15,14,40,18,0,0,2019-2020,90.0,127.27272727272727,236.36363636363637
Rk,Player,Nation,Pos,Squad,Comp,0,0,90.0,0,0,3,3,3,Tkl,0,0.0,0,0,0,0,0,0,0,0,0,2019-2020,90.0,0.0,0.0
1076,Dalbert Henrique,BRA,"DF,MF",Fiorentina,Serie A,25,1993,27.6,52,25,35,12,5,18,51,35.3,33,34,4,30,19,71,65,0,0,2019-2020,90.0,61.95652173913043,169.56521739130434
1077,Christophe Hérelle,MTQ,DF,Nice,Ligue 1,26,1992,12.3,14,11,10,4,0,3,7,42.9,4,14,8,6,17,31,26,1,0,2019-2020,89.99999999999999,124.39024390243901,102.43902439024389
1078,Mario Hermoso,ESP,DF,Atlético Madrid,La Liga,24,1995,13.5,15,8,12,2,1,11,20,55.0,9,11,5,6,12,27,61,0,0,2019-2020,90.0,80.0,100.0
1079,Aridane Hernández,ESP,DF,Osasuna,La Liga,30,1989,29.0,35,23,22,13,0,15,19,78.9,4,24,15,9,34,69,137,2,0,2019-2020,90.0,105.51724137931033,108.62068965517241
1080,Javier Hernández,MEX,FW,West Ham,Premier League,31,1988,1.2,0,0,0,0,0,0,1,0.0,1,0,0,0,1,1,0,0,0,2019-2020,90.0,75.0,0.0
1081,Javier Hernández,MEX,FW,Sevilla,La Liga,31,1988,5.0,6,4,0,4,2,1,6,16.7,5,5,0,5,5,11,1,0,0,2019-2020,90.0,90.0,108.0
1082,Juan Hernández,ESP,"FW,MF",Celta Vigo,La Liga,24,1994,1.0,0,0,0,0,0,0,0,0.0,0,0,0,0,1,1,0,0,0,2019-2020,90.0,90.0,0.0
1083,Lucas Hernández,FRA,DF,Bayern Munich,Bundesliga,23,1996,10.2,18,9,13,3,2,9,15,60.0,6,6,1,5,15,33,17,0,0,2019-2020,90.0,132.3529411764706,158.82352941176472
1084,Onel Hernández,CUB,"FW,MF",Norwich City,Premier League,26,1993,15.4,27,19,13,11,3,9,31,29.0,22,12,1,11,19,46,10,0,0,2019-2020,90.0,111.03896103896105,157.7922077922078
1085,Theo Hernández,FRA,DF,Milan,Serie A,21,1997,31.3,56,39,32,18,6,33,53,62.3,20,34,6,28,43,99,62,2,0,2019-2020,90.0,123.64217252396165,161.02236421725237
1086,Hernani,BRA,MF,Parma,Serie A,25,1994,26.9,61,31,25,31,5,30,112,26.8,82,53,11,42,50,111,51,1,0,2019-2020,90.0,167.28624535315987,204.08921933085503
1087,Ander Herrera,ESP,"MF,DF",Paris S-G,Ligue 1,29,1989,6.1,19,11,9,9,1,5,14,35.7,9,10,2,8,6,25,4,0,0,2019-2020,90.0,88.52459016393443,280.32786885245906
1088,Héctor Herrera,MEX,MF,Atlético Madrid,La Liga,29,1990,12.5,31,21,9,18,4,13,32,40.6,19,16,7,9,17,48,13,2,0,2019-2020,90.0,122.39999999999999,223.2
1089,Sergio Herrera,ESP,GK,Osasuna,La Liga,26,1993,18.4,1,1,1,0,0,1,4,25.0,3,0,0,0,1,2,13,3,0,2019-2020,90.0,4.891304347826087,4.891304347826087
1090,Yangel Herrera,VEN,MF,Granada,La Liga,21,1998,26.3,88,49,25,53,10,36,80,45.0,44,38,9,29,34,122,28,0,0,2019-2020,90.0,116.34980988593156,301.1406844106464
1091,Iago Herrerín,ESP,GK,Athletic Club,La Liga,31,1988,4.7,0,0,0,0,0,0,0,0.0,0,0,0,0,0,0,0,0,0,2019-2020,90.0,0.0,0.0
1092,Patrick Herrmann,GER,"FW,MF",Gladbach,Bundesliga,28,1991,16.1,24,11,8,10,6,5,16,31.3,11,21,4,17,11,35,8,0,0,2019-2020,90.0,61.49068322981366,134.1614906832298
1093,Pablo Hervías,ESP,"MF,FW",Valladolid,La Liga,26,1993,11.3,24,20,8,14,2,12,22,54.5,10,8,0,8,5,29,0,0,0,2019-2020,90.0,39.823008849557525,191.1504424778761
1094,Son Heung-min,KOR,FW,Tottenham,Premier League,27,1992,27.5,23,15,10,11,2,9,57,15.8,48,23,0,23,19,42,18,1,0,2019-2020,89.99999999999999,62.18181818181818,75.27272727272727
1095,Gonzalo Higuaín,ARG,FW,Juventus,Serie A,31,1987,20.7,13,7,2,6,5,4,31,12.9,27,12,0,12,6,19,14,0,0,2019-2020,90.0,26.086956521739133,56.52173913043479
1096,Vitorino Hilton,BRA,DF,Montpellier,Ligue 1,41,1977,27.9,27,17,20,7,0,13,28,46.4,15,22,18,4,49,76,121,1,0,2019-2020,90.0,158.06451612903226,87.09677419354838
1097,Martin Hinteregger,AUT,DF,Eint Frankfurt,Bundesliga,26,1992,30.2,66,51,33,30,3,28,57,49.1,29,41,21,20,36,102,96,0,0,2019-2020,90.0,107.28476821192054,196.6887417218543
1098,George Hirst,ENG,"MF,DF",Leicester City,Premier League,20,1999,0.1,0,0,0,0,0,0,0,0.0,0,0,0,0,0,0,0,0,0,2019-2020,90.0,0.0,0.0
1099,Marwin Hitz,SUI,GK,Dortmund,Bundesliga,31,1987,3.2,0,0,0,0,0,0,0,0.0,0,0,0,0,0,0,0,0,0,2019-2020,90.0,0.0,0.0
1100,André Hoffmann,GER,DF,Düsseldorf,Bundesliga,26,1993,27.0,48,22,30,18,0,16,50,32.0,34,22,9,13,56,104,90,0,0,2019-2020,90.0,186.66666666666669,160.0
Rk,Player,Nation,Pos,Squad,Comp,0,0,90.0,0,0,3,3,3,Tkl,0,0.0,0,0,0,0,0,0,0,0,0,2019-2020,90.0,0.0,0.0
1101,Nicolas Höfler,GER,MF,Freiburg,Bundesliga,29,1990,30.9,65,40,31,28,6,22,64,34.4,42,58,18,40,71,136,59,3,0,2019-2020,90.0,206.79611650485438,189.32038834951456
1102,Jonas Hofmann,GER,"MF,FW",Gladbach,Bundesliga,27,1992,18.1,43,27,22,12,9,22,76,28.9,54,28,3,25,18,61,14,0,0,2019-2020,90.0,89.50276243093921,213.81215469613258
1103,Jonas Hofmann,GER,MF,Schalke 04,Bundesliga,22,1997,0.0,0,0,0,0,0,0,0,0.0,0,0,0,0,0,0,2,0,0,2019-2020,,,
1104,Marco Höger,GER,MF,Köln,Bundesliga,29,1989,7.5,10,6,4,5,1,6,16,37.5,10,14,4,10,6,16,15,0,0,2019-2020,90.0,72.0,120.0
1105,Rob Holding,ENG,DF,Arsenal,Premier League,23,1995,6.5,4,2,3,1,0,1,3,33.3,2,10,6,4,5,9,45,1,0,2019-2020,90.00000000000001,69.23076923076924,55.38461538461539
1106,José Holebas,GRE,DF,Watford,Premier League,35,1984,11.4,26,15,19,7,0,9,28,32.1,19,11,4,7,3,29,33,0,0,2019-2020,90.0,23.684210526315788,205.26315789473682
1107,Lucas Höler,GER,"FW,MF",Freiburg,Bundesliga,25,1994,27.6,35,15,11,16,8,11,46,23.9,35,30,9,21,12,47,38,0,0,2019-2020,90.0,39.13043478260869,114.13043478260869
1108,Mason Holgate,ENG,DF,Everton,Premier League,22,1996,22.8,44,26,30,13,1,21,31,67.7,10,26,13,13,34,78,97,0,0,2019-2020,90.0,134.21052631578945,173.68421052631578
1109,Nathan Holland,ENG,MF,West Ham,Premier League,21,1998,0.4,3,1,2,1,0,0,0,0.0,0,1,0,1,0,3,0,0,0,2019-2020,90.0,0.0,675.0
1110,Gerrit Holtmann,PHI,"MF,DF",Paderborn 07,Bundesliga,24,1995,11.8,24,14,14,6,4,15,37,40.5,22,21,1,20,6,30,8,0,0,2019-2020,90.0,45.762711864406775,183.0508474576271
1111,Josué Homawoo,FRA,DF,Nantes,Ligue 1,21,1997,0.5,6,2,3,3,0,2,2,100.0,0,3,2,1,2,8,2,0,0,2019-2020,90.0,360.0,1080.0
1112,Franck Honorat,FRA,"FW,DF",Saint-Étienne,Ligue 1,22,1996,9.4,16,11,7,8,1,8,23,34.8,15,12,1,11,5,21,13,1,0,2019-2020,90.0,47.87234042553191,153.1914893617021
1113,Luca Horn,GER,DF,Wolfsburg,Bundesliga,20,1998,0.1,0,0,0,0,0,0,0,0.0,0,0,0,0,0,0,0,0,0,2019-2020,90.0,0.0,0.0
1114,Timo Horn,GER,GK,Köln,Bundesliga,26,1993,34.0,0,0,0,0,0,0,5,0.0,5,0,0,0,2,2,15,1,0,2019-2020,90.0,5.294117647058823,0.0
1115,Krisztofer Horváth,HUN,"FW,DF",SPAL,Serie A,17,2002,0.5,1,1,0,1,0,0,0,0.0,0,0,0,0,0,1,0,0,0,2019-2020,90.0,0.0,180.0
1116,Conor Hourihane,IRL,MF,Aston Villa,Premier League,28,1991,17.0,16,10,4,8,4,10,25,40.0,15,19,4,15,9,25,31,0,0,2019-2020,90.0,47.64705882352941,84.70588235294117
1117,Lukáš Hrádecký,FIN,GK,Leverkusen,Bundesliga,29,1989,34.0,0,0,0,0,0,0,1,0.0,1,0,0,0,2,2,19,2,0,2019-2020,90.0,5.294117647058823,0.0
1118,Benjamin Hübner,GER,DF,Hoffenheim,Bundesliga,30,1989,23.0,42,26,33,9,0,23,45,51.1,22,18,13,5,30,72,98,2,0,2019-2020,90.0,117.3913043478261,164.34782608695653
1119,Florian Hübner,GER,DF,Union Berlin,Bundesliga,28,1991,9.4,16,14,12,4,0,7,17,41.2,10,11,7,4,16,32,39,0,0,2019-2020,90.0,153.1914893617021,153.1914893617021
1120,Callum Hudson-Odoi,ENG,"FW,MF",Chelsea,Premier League,18,2000,9.6,10,4,4,5,1,1,7,14.3,6,9,0,9,5,15,4,1,0,2019-2020,90.0,46.875,93.75
1121,Will Hughes,ENG,MF,Watford,Premier League,24,1995,25.0,75,47,24,41,10,25,67,37.3,42,48,8,40,37,112,28,0,0,2019-2020,90.0,133.2,270.0
1122,Mats Hummels,GER,DF,Dortmund,Bundesliga,30,1988,28.7,57,30,30,26,1,20,38,52.6,18,41,18,23,59,116,110,1,0,2019-2020,90.0,185.01742160278746,178.74564459930315
1123,Uwe Hünemeier,GER,DF,Paderborn 07,Bundesliga,33,1986,13.4,20,15,9,11,0,10,20,50.0,10,22,12,10,24,44,63,0,0,2019-2020,90.0,161.19402985074626,134.32835820895522
1124,Adrien Hunou,FRA,"FW,MF",Rennes,Ligue 1,25,1994,13.4,21,18,5,11,5,4,21,19.0,17,16,1,15,5,26,5,0,0,2019-2020,90.0,33.582089552238806,141.04477611940297
1125,Jannik Huth,GER,GK,Paderborn 07,Bundesliga,25,1994,6.0,0,0,0,0,0,0,1,0.0,1,0,0,0,0,0,2,0,0,2019-2020,90.0,0.0,0.0
Rk,Player,Nation,Pos,Squad,Comp,0,0,90.0,0,0,3,3,3,Tkl,0,0.0,0,0,0,0,0,0,0,0,0,2019-2020,90.0,0.0,0.0
1126,Elseid Hysaj,ALB,DF,Napoli,Serie A,25,1994,16.5,18,9,13,4,1,12,26,46.2,14,16,3,13,24,42,26,0,0,2019-2020,90.0,130.9090909090909,98.18181818181819
1127,Suk Hyun-jun,KOR,"FW,MF",Reims,Ligue 1,28,1991,2.9,3,3,1,1,1,1,2,50.0,1,1,0,1,1,4,2,0,0,2019-2020,90.0,31.03448275862069,93.10344827586206
1128,Pierre Højbjerg,DEN,MF,Southampton,Premier League,23,1995,30.6,80,49,34,38,8,39,91,42.9,52,44,5,39,46,126,54,2,0,2019-2020,90.0,135.2941176470588,235.2941176470588
1129,Simone Iacoponi,ITA,DF,Parma,Serie A,32,1987,33.9,49,25,36,12,1,26,42,61.9,16,37,29,8,35,84,140,2,0,2019-2020,90.0,92.9203539823009,130.08849557522123
1130,Iago,BRA,"DF,MF",Augsburg,Bundesliga,22,1997,7.5,19,12,12,7,0,9,18,50.0,9,6,2,4,14,33,27,0,0,2019-2020,90.0,168.0,228.0
1131,Robert Ibáñez,ESP,"MF,FW",Osasuna,La Liga,26,1993,6.0,13,8,4,5,4,7,20,35.0,13,7,0,7,5,18,5,0,0,2019-2020,90.0,75.0,195.0
1132,Roger Ibanez,BRA,DF,Roma,Serie A,20,1998,6.8,11,8,6,3,2,5,7,71.4,2,9,6,3,18,29,21,1,0,2019-2020,90.0,238.23529411764704,145.58823529411765
1133,Jordon Ibe,ENG,DF,Bournemouth,Premier League,23,1995,0.6,2,2,2,0,0,1,1,100.0,0,0,0,0,0,2,1,0,0,2019-2020,90.0,0.0,300.0
1134,Vedad Ibišević,BIH,FW,Hertha BSC,Bundesliga,34,1984,14.0,4,3,0,1,3,0,3,0.0,3,4,0,4,1,5,15,0,0,2019-2020,90.0,6.428571428571429,25.714285714285715
1135,Vicente Iborra,ESP,MF,Villarreal,La Liga,31,1988,29.4,61,42,31,25,5,30,67,44.8,37,35,16,19,40,101,63,1,0,2019-2020,90.0,122.44897959183673,186.73469387755102
1136,Didier Ibrahim Ndong,GAB,MF,Dijon,Ligue 1,25,1994,26.5,62,35,30,31,1,30,59,50.8,29,27,6,21,49,111,31,0,0,2019-2020,90.0,166.41509433962264,210.56603773584905
1137,Zlatan Ibrahimović,SWE,FW,Milan,Serie A,37,1981,15.1,5,1,0,2,3,1,13,7.7,12,4,3,1,5,10,21,0,0,2019-2020,90.0,29.80132450331126,29.80132450331126
1138,Mauro Icardi,ARG,FW,Paris S-G,Ligue 1,26,1993,14.1,4,2,1,3,0,1,10,10.0,9,7,1,6,2,6,11,0,0,2019-2020,89.99999999999999,12.76595744680851,25.53191489361702
1139,Adam Idah,IRL,"FW,MF",Norwich City,Premier League,18,2001,2.5,2,2,1,0,1,2,3,66.7,1,4,0,4,0,2,1,0,0,2019-2020,90.0,0.0,72.0
1140,Odion Ighalo,NGA,FW,Manchester Utd,Premier League,30,1989,1.1,2,2,0,2,0,1,3,33.3,2,1,1,0,0,2,0,0,0,2019-2020,90.0,0.0,163.63636363636363
1141,Borja Iglesias,ESP,FW,Betis,La Liga,26,1993,21.4,7,5,1,4,2,0,9,0.0,9,7,4,3,5,12,18,0,0,2019-2020,90.0,21.028037383177573,29.4392523364486
1142,Igor,BRA,DF,SPAL,Serie A,21,1998,14.9,24,16,13,10,1,14,20,70.0,6,17,9,8,24,48,37,1,0,2019-2020,90.0,144.96644295302013,144.96644295302013
1143,Igor,BRA,DF,Fiorentina,Serie A,21,1998,6.8,12,10,8,2,2,6,7,85.7,1,10,4,6,7,19,16,0,0,2019-2020,90.0,92.6470588235294,158.8235294117647
1144,Kelechi Iheanacho,NGA,FW,Leicester City,Premier League,22,1996,10.7,3,1,1,2,0,1,9,11.1,8,8,1,7,3,6,8,0,0,2019-2020,90.0,25.233644859813086,25.233644859813086
1145,Luc Ihorst,GER,FW,Werder Bremen,Bundesliga,19,2000,0.1,1,1,0,0,1,0,0,0.0,0,1,0,1,0,1,0,0,0,2019-2020,90.0,0.0,900.0
1146,Jonathan Ikone,FRA,"MF,FW",Lille,Ligue 1,21,1998,22.9,15,7,3,7,5,6,24,25.0,18,26,2,24,5,20,3,0,0,2019-2020,90.0,19.650655021834062,58.951965065502186
1147,Yun Il-lok,KOR,"MF,FW",Montpellier,Ligue 1,27,1992,1.3,1,1,0,1,0,0,4,0.0,4,0,0,0,0,1,0,0,0,2019-2020,90.0,0.0,69.23076923076923
1148,Josip Iličić,SVN,"FW,MF",Atalanta,Serie A,31,1988,18.5,26,19,7,10,9,7,28,25.0,21,9,0,9,9,35,4,0,0,2019-2020,90.0,43.78378378378378,126.4864864864865
1149,Asier Illarramendi,ESP,MF,Real Sociedad,La Liga,29,1990,2.4,2,2,1,0,1,2,6,33.3,4,2,1,1,5,7,6,0,0,2019-2020,90.0,187.5,75.0
1150,Stefan Ilsanker,AUT,DF,RB Leipzig,Bundesliga,30,1989,4.6,3,1,3,0,0,3,6,50.0,3,6,3,3,7,10,21,0,0,2019-2020,90.0,136.95652173913044,58.69565217391305
Rk,Player,Nation,Pos,Squad,Comp,0,0,90.0,0,0,3,3,3,Tkl,0,0.0,0,0,0,0,0,0,0,0,0,2019-2020,90.0,0.0,0.0
1151,Stefan Ilsanker,AUT,"DF,MF",Eint Frankfurt,Bundesliga,30,1989,9.3,23,15,16,7,0,10,23,43.5,13,8,1,7,19,42,26,0,0,2019-2020,90.0,183.87096774193546,222.5806451612903
1152,Giannelli Imbula,COD,MF,Lecce,Serie A,26,1992,1.4,2,0,2,0,0,0,1,0.0,1,4,1,3,2,4,0,0,0,2019-2020,90.0,128.57142857142858,128.57142857142858
1153,Ciro Immobile,ITA,FW,Lazio,Serie A,29,1990,35.2,8,6,2,4,2,0,24,0.0,24,10,2,8,11,19,7,0,0,2019-2020,90.0,28.125,20.454545454545453
1154,Roberto Inglese,ITA,FW,Parma,Serie A,27,1991,8.5,9,6,2,2,5,2,10,20.0,8,8,2,6,2,11,1,0,0,2019-2020,90.0,21.176470588235293,95.29411764705883
1155,Danny Ings,ENG,FW,Southampton,Premier League,27,1992,31.2,42,25,16,16,10,13,67,19.4,54,62,4,58,9,51,30,1,0,2019-2020,90.0,25.96153846153846,121.15384615384615
1156,Marcus Ingvartsen,DEN,"MF,FW",Union Berlin,Bundesliga,23,1996,19.1,20,14,5,7,8,9,28,32.1,19,16,1,15,16,36,16,0,0,2019-2020,90.0,75.39267015706805,94.24083769633508
1157,Lorenzo Insigne,ITA,"FW,MF",Napoli,Serie A,28,1991,31.2,21,15,6,8,7,6,35,17.1,29,13,0,13,30,51,4,1,0,2019-2020,90.0,86.53846153846153,60.57692307692307
1158,Takashi Inui,JPN,"MF,FW",Eibar,La Liga,31,1988,21.8,20,10,7,8,5,11,34,32.4,23,23,4,19,18,38,12,0,0,2019-2020,90.0,74.31192660550458,82.56880733944953
1159,Artur Ioniță,MDA,MF,Cagliari,Serie A,28,1990,21.1,38,23,12,22,4,12,37,32.4,25,32,10,22,18,56,24,2,0,2019-2020,90.0,76.77725118483411,162.08530805687204
1160,Alexander Isak,SWE,FW,Real Sociedad,La Liga,19,1999,16.7,7,2,0,3,4,1,8,12.5,7,8,0,8,3,10,6,0,0,2019-2020,90.0,16.16766467065868,37.724550898203596
1161,Isco,ESP,"FW,MF",Real Madrid,La Liga,27,1992,13.1,13,9,2,10,1,5,14,35.7,9,9,0,9,7,20,4,1,0,2019-2020,90.0,48.091603053435115,89.31297709923665
1162,Nicolas Isimat-Mirin,FRA,DF,Toulouse,Ligue 1,27,1991,14.0,14,8,8,6,0,5,11,45.5,6,18,12,6,22,36,71,0,0,2019-2020,90.0,141.42857142857142,90.0
1163,Jakub Iskra,POL,DF,SPAL,Serie A,16,2002,0.9,0,0,0,0,0,0,0,0.0,0,0,0,0,1,1,2,0,0,2019-2020,90.0,100.0,0.0
1164,Ismael,ESP,MF,Betis,La Liga,18,2000,0.9,2,1,1,1,0,1,2,50.0,1,2,1,1,2,4,2,0,0,2019-2020,90.0,200.0,200.0
1165,Gian-Luca Itter,GER,"DF,MF",Freiburg,Bundesliga,20,1999,0.4,1,1,1,0,0,1,1,100.0,0,0,0,0,1,2,4,0,0,2019-2020,90.0,225.0,225.0
1166,Ander Iturraspe,ESP,MF,Espanyol,La Liga,30,1989,2.7,2,0,1,1,0,2,5,40.0,3,0,0,0,1,3,7,0,0,2019-2020,90.0,33.33333333333333,66.66666666666666
1167,Alex Iwobi,NGA,"MF,FW",Everton,Premier League,23,1996,17.7,25,17,8,15,2,12,33,36.4,21,18,2,16,14,39,10,1,0,2019-2020,90.0,71.1864406779661,127.11864406779662
1168,Armando Izzo,ITA,DF,Torino,Serie A,27,1992,29.8,42,24,24,14,4,17,35,48.6,18,44,29,15,71,113,121,1,0,2019-2020,90.0,214.42953020134226,126.84563758389261
1169,Jacobo,ESP,"DF,MF",Celta Vigo,La Liga,22,1997,0.9,3,3,2,1,0,1,1,100.0,0,0,0,0,0,3,2,0,0,2019-2020,90.0,0.0,300.0
1170,Phil Jagielka,ENG,DF,Sheffield Utd,Premier League,36,1982,2.7,5,4,3,2,0,1,3,33.3,2,5,5,0,4,9,19,0,0,2019-2020,90.0,133.33333333333331,166.66666666666666
1171,Filip Jagiełło,POL,MF,Genoa,Serie A,21,1997,6.1,7,2,0,3,4,3,7,42.9,4,4,0,4,5,12,4,0,0,2019-2020,90.0,73.7704918032787,103.27868852459018
1172,Alireza Jahanbakhsh,IRN,"FW,MF",Brighton,Premier League,25,1993,3.5,8,4,3,2,3,0,2,0.0,2,5,0,5,3,11,2,0,0,2019-2020,90.0,77.14285714285714,205.71428571428572
1173,Mato Jajalo,BIH,MF,Udinese,Serie A,31,1988,18.3,44,19,19,22,3,14,38,36.8,24,20,7,13,19,63,19,2,0,2019-2020,90.0,93.44262295081967,216.3934426229508
1174,Ismail Jakobs,SEN,"FW,DF",Köln,Bundesliga,19,1999,18.6,34,23,18,9,7,10,23,43.5,13,25,3,22,24,58,30,0,0,2019-2020,90.0,116.1290322580645,164.51612903225805
1175,Christophe Jallet,FRA,DF,Amiens,Ligue 1,35,1983,9.5,24,16,14,8,2,14,37,37.8,23,8,2,6,18,42,29,0,0,2019-2020,90.0,170.52631578947367,227.3684210526316
Rk,Player,Nation,Pos,Squad,Comp,0,0,90.0,0,0,3,3,3,Tkl,0,0.0,0,0,0,0,0,0,0,0,0,2019-2020,90.0,0.0,0.0
1176,Daniel James,WAL,FW,Manchester Utd,Premier League,21,1997,25.4,20,10,5,10,5,7,45,15.6,38,23,4,19,7,27,12,0,0,2019-2020,90.0,24.803149606299215,70.86614173228347
1177,Matty James,ENG,MF,Leicester City,Premier League,28,1991,0.1,0,0,0,0,0,0,0,0.0,0,0,0,0,0,0,0,0,0,2019-2020,90.0,0.0,0.0
1178,Reece James,ENG,DF,Chelsea,Premier League,19,1999,16.8,36,23,18,14,4,11,29,37.9,18,19,8,11,22,58,28,0,0,2019-2020,90.0,117.85714285714285,192.85714285714286
1179,Marko Janković,MNE,"FW,DF",SPAL,Serie A,24,1995,1.3,2,1,0,0,2,1,2,50.0,1,2,1,1,0,2,0,0,0,2019-2020,90.0,0.0,138.46153846153845
1180,Jakub Jankto,CZE,"MF,FW",Sampdoria,Serie A,23,1996,23.3,27,13,14,10,3,10,42,23.8,32,30,3,27,22,49,22,0,0,2019-2020,90.0,84.97854077253218,104.29184549356223
1181,Daryl Janmaat,NED,DF,Watford,Premier League,30,1989,6.7,14,10,8,6,0,6,13,46.2,7,7,2,5,7,21,23,0,0,2019-2020,90.0,94.02985074626865,188.0597014925373
1182,Laurent Jans,LUX,DF,Paderborn 07,Bundesliga,26,1992,17.5,42,25,30,8,4,22,48,45.8,26,25,10,15,19,61,49,1,0,2019-2020,90.0,97.71428571428571,216.0
1183,Tony Jantschke,GER,DF,Gladbach,Bundesliga,29,1990,11.2,33,21,23,10,0,15,24,62.5,9,20,11,9,27,60,48,0,0,2019-2020,90.0,216.96428571428572,265.17857142857144
1184,Adnan Januzaj,BEL,"FW,MF",Real Sociedad,La Liga,24,1995,13.0,8,7,3,2,3,3,16,18.8,13,9,1,8,7,15,2,0,0,2019-2020,90.00000000000001,48.46153846153847,55.38461538461539
1185,Rune Jarstein,NOR,GK,Hertha BSC,Bundesliga,34,1984,28.3,4,1,4,0,0,2,3,66.7,1,0,0,0,1,5,11,3,0,2019-2020,90.0,3.1802120141342756,12.720848056537102
1186,Jason,ESP,MF,Getafe,La Liga,25,1994,13.1,29,20,8,16,5,15,33,45.5,18,18,3,15,18,47,9,0,0,2019-2020,90.0,123.66412213740459,199.23664122137404
1187,Dennis Jastrzembski,POL,"MF,FW",Paderborn 07,Bundesliga,19,2000,2.0,2,0,1,1,0,0,1,0.0,1,3,0,3,3,5,0,0,0,2019-2020,90.0,135.0,90.0
1188,Corentin Jean,FRA,DF,Toulouse,Ligue 1,24,1995,0.1,0,0,0,0,0,0,0,0.0,0,0,0,0,0,0,1,0,0,2019-2020,90.0,0.0,0.0
1189,Benjamin Jeannot,FRA,"MF,FW",Dijon,Ligue 1,27,1992,1.9,2,1,0,1,1,0,4,0.0,4,2,0,2,2,4,4,0,0,2019-2020,90.0,94.73684210526315,94.73684210526315
1190,Tin Jedvaj,CRO,DF,Augsburg,Bundesliga,23,1995,29.3,44,26,25,19,0,23,47,48.9,24,36,18,18,60,104,123,1,0,2019-2020,90.0,184.30034129692834,135.15358361774744
1191,Jemerson,BRA,"DF,MF",Monaco,Ligue 1,26,1992,11.7,28,17,13,14,1,10,21,47.6,11,8,3,5,16,44,24,0,0,2019-2020,89.99999999999999,123.07692307692307,215.3846153846154
1192,Fredrik Jensen,FIN,"MF,FW",Augsburg,Bundesliga,21,1997,5.1,3,1,2,1,0,2,7,28.6,5,7,1,6,1,4,3,0,0,2019-2020,90.0,17.647058823529413,52.94117647058824
1193,Jesé,ESP,FW,Paris S-G,Ligue 1,26,1993,0.0,0,0,0,0,0,0,0,0.0,0,0,0,0,0,0,0,0,0,2019-2020,,,
1194,Gabriel Jesus,BRA,FW,Manchester City,Premier League,22,1997,22.6,17,10,4,5,8,7,25,28.0,18,26,1,25,11,28,6,0,0,2019-2020,90.0,43.80530973451327,67.69911504424779
1195,Juan Jesus,BRA,DF,Roma,Serie A,28,1991,1.5,2,1,2,0,0,0,3,0.0,3,1,0,1,1,3,7,0,0,2019-2020,90.0,60.0,120.0
1196,Raúl Jiménez,MEX,FW,Wolves,Premier League,28,1991,36.0,20,12,6,10,4,3,31,9.7,28,26,0,26,16,36,34,1,0,2019-2020,90.0,40.0,50.0
1197,João Pedro,BRA,"FW,MF",Watford,Premier League,17,2001,0.3,0,0,0,0,0,0,0,0.0,0,0,0,0,0,0,0,0,0,2019-2020,90.0,0.0,0.0
1198,Joaquín,ESP,"MF,FW",Betis,La Liga,38,1981,22.9,14,7,4,8,2,4,11,36.4,7,10,2,8,15,29,22,1,0,2019-2020,90.0,58.951965065502186,55.02183406113538
1199,Joelinton,BRA,FW,Newcastle Utd,Premier League,22,1996,29.8,34,20,7,22,5,9,32,28.1,23,32,6,26,11,45,30,0,0,2019-2020,90.0,33.22147651006711,102.68456375838926
1200,Ben Johnson,ENG,DF,West Ham,Premier League,19,2000,3.0,8,4,7,1,0,7,10,70.0,3,5,2,3,3,11,11,0,0,2019-2020,90.0,90.0,240.0
Rk,Player,Nation,Pos,Squad,Comp,0,0,90.0,0,0,3,3,3,Tkl,0,0.0,0,0,0,0,0,0,0,0,0,2019-2020,90.0,0.0,0.0
1201,Fabian Johnson,USA,"MF,DF",Gladbach,Bundesliga,31,1987,3.0,5,3,2,2,1,2,4,50.0,2,4,1,3,2,7,3,0,0,2019-2020,90.0,60.0,150.0
1202,Curtis Jones,ENG,MF,Liverpool,Premier League,18,2001,1.4,4,4,0,1,3,3,4,75.0,1,2,0,2,2,6,1,0,0,2019-2020,90.0,128.57142857142858,257.14285714285717
1203,Phil Jones,ENG,DF,Manchester Utd,Premier League,27,1992,1.5,2,2,1,1,0,1,1,100.0,0,2,0,2,2,4,9,1,0,2019-2020,90.0,120.0,120.0
1204,Frenkie de Jong,NED,MF,Barcelona,La Liga,22,1997,23.5,26,19,7,12,7,7,22,31.8,15,17,7,10,21,47,9,0,0,2019-2020,90.0,80.42553191489361,99.57446808510637
1205,Luuk de Jong,NED,FW,Sevilla,La Liga,28,1990,22.9,21,10,4,8,9,6,17,35.3,11,12,1,11,7,28,22,0,0,2019-2020,90.0,27.51091703056769,82.53275109170306
1206,Jony,ESP,"DF,FW",Lazio,Serie A,28,1991,13.1,13,9,7,4,2,5,23,21.7,18,11,2,9,14,27,17,0,0,2019-2020,90.0,96.18320610687023,89.31297709923665
1207,Joan Jordán,ESP,MF,Sevilla,La Liga,25,1994,25.0,64,34,27,31,6,21,76,27.6,55,25,5,20,26,90,20,4,0,2019-2020,90.0,93.6,230.39999999999998
1208,Bruno Jordão,POR,FW,Wolves,Premier League,20,1998,0.1,0,0,0,0,0,0,0,0.0,0,1,0,1,0,0,0,0,0,2019-2020,90.0,0.0,0.0
1209,Jorginho,ITA,MF,Chelsea,Premier League,27,1991,26.4,66,40,24,34,8,35,91,38.5,56,30,5,25,64,130,27,2,0,2019-2020,90.0,218.1818181818182,225.0
1210,Jesse Joronen,FIN,GK,Brescia,Serie A,26,1993,29.0,3,1,3,0,0,3,3,100.0,0,0,0,0,6,9,22,0,0,2019-2020,90.0,18.620689655172413,9.310344827586206
1211,Willian José,BRA,FW,Real Sociedad,La Liga,27,1991,22.3,5,2,0,4,1,2,8,25.0,6,10,4,6,1,6,16,0,0,2019-2020,90.0,4.0358744394618835,20.179372197309416
1212,Joselu,ESP,FW,Alavés,La Liga,29,1990,30.9,26,17,4,12,10,4,32,12.5,28,36,5,31,13,39,46,0,0,2019-2020,90.0,37.86407766990291,75.72815533980582
1213,Jota,ESP,"FW,MF",Aston Villa,Premier League,28,1991,3.7,3,1,2,0,1,2,5,40.0,3,1,0,1,3,6,6,0,0,2019-2020,90.0,72.97297297297297,72.97297297297297
1214,Diogo Jota,POR,FW,Wolves,Premier League,22,1996,25.4,28,15,16,10,2,12,48,25.0,36,17,0,17,9,37,10,2,0,2019-2020,90.0,31.88976377952756,99.21259842519686
1215,Vukašin Jovanović,SRB,DF,Bordeaux,Ligue 1,23,1996,6.4,18,11,12,6,0,14,21,66.7,7,5,3,2,15,33,15,0,0,2019-2020,90.0,210.9375,253.125
1216,Dejan Joveljić,SRB,FW,Eint Frankfurt,Bundesliga,19,1999,1.7,2,2,1,1,0,0,1,0.0,1,0,0,0,0,2,1,0,0,2019-2020,90.0,0.0,105.88235294117646
1217,Stevan Jovetić,MNE,"FW,MF",Monaco,Ligue 1,29,1989,5.3,2,1,0,1,1,1,5,20.0,4,1,0,1,1,3,5,0,0,2019-2020,90.0,16.9811320754717,33.9622641509434
1218,Luka Jović,SRB,FW,Real Madrid,La Liga,21,1997,4.8,2,1,0,0,2,1,2,50.0,1,1,0,1,2,4,0,0,0,2019-2020,90.0,37.5,37.5
1219,Juanmi,ESP,"FW,MF",Betis,La Liga,26,1993,2.9,4,1,1,2,1,1,4,25.0,3,1,0,1,0,4,0,0,0,2019-2020,90.0,0.0,124.13793103448276
1220,David Juncà,ESP,DF,Celta Vigo,La Liga,25,1993,2.9,6,5,4,1,1,2,3,66.7,1,4,1,3,2,8,3,0,0,2019-2020,90.0,62.06896551724138,186.20689655172413
1221,Lago Junior,CIV,"MF,FW",Mallorca,La Liga,28,1990,24.3,32,19,12,11,9,12,29,41.4,17,23,5,18,14,46,25,0,0,2019-2020,90.0,51.85185185185185,118.5185185185185
1222,Hamed Junior Traorè,CIV,"MF,FW",Sassuolo,Serie A,19,2000,17.4,31,15,10,15,6,14,39,35.9,25,22,1,21,11,42,7,0,0,2019-2020,90.0,56.89655172413793,160.3448275862069
1223,Vinicius Júnior,BRA,"FW,MF",Real Madrid,La Liga,19,2000,15.2,26,16,13,8,5,8,32,25.0,24,14,0,14,3,29,2,0,0,2019-2020,90.0,17.763157894736842,153.94736842105263
1224,James Justin,ENG,"DF,MF",Leicester City,Premier League,21,1998,11.2,36,17,22,14,0,15,25,60.0,10,15,7,8,11,47,30,0,0,2019-2020,90.0,88.39285714285714,289.2857142857143
1225,Musa Juwara,GAM,"FW,MF",Bologna,Serie A,17,2001,1.7,4,2,1,1,2,1,5,20.0,4,2,1,1,0,4,1,0,0,2019-2020,90.0,0.0,211.76470588235293
Rk,Player,Nation,Pos,Squad,Comp,0,0,90.0,0,0,3,3,3,Tkl,0,0.0,0,0,0,0,0,0,0,0,0,2019-2020,90.0,0.0,0.0
1226,Mathias Jørgensen,DEN,DF,Düsseldorf,Bundesliga,29,1990,5.5,4,3,3,1,0,2,4,50.0,2,7,3,4,13,17,33,0,0,2019-2020,90.0,212.72727272727275,65.45454545454545
1227,Ozan Kabak,TUR,DF,Schalke 04,Bundesliga,19,2000,19.7,37,23,28,9,0,14,21,66.7,7,33,19,14,37,74,97,0,0,2019-2020,90.0,169.03553299492387,169.03553299492387
1228,Christian Kabasele,BEL,DF,Watford,Premier League,28,1991,25.0,37,24,26,11,0,17,32,53.1,15,31,23,8,36,73,127,0,0,2019-2020,90.0,129.6,133.2
1229,Abdoul Kader Bamba,FRA,"FW,MF",Nantes,Ligue 1,25,1994,16.3,19,15,5,9,5,9,30,30.0,21,8,2,6,16,35,8,0,0,2019-2020,90.0,88.34355828220859,104.9079754601227
1230,Pavel Kadeřábek,CZE,"DF,FW",Hoffenheim,Bundesliga,27,1992,27.5,32,22,17,13,2,13,30,43.3,17,29,7,22,27,59,55,1,0,2019-2020,89.99999999999999,88.36363636363636,104.72727272727272
1231,Florian Kainz,AUT,"FW,MF",Köln,Bundesliga,26,1992,17.3,21,13,12,6,3,15,33,45.5,18,26,2,24,13,34,11,0,0,2019-2020,90.0,67.6300578034682,109.24855491329478
1232,Gaël Kakuta,COD,"MF,FW",Amiens,Ligue 1,28,1991,22.2,46,27,13,27,6,17,48,35.4,31,15,1,14,16,62,8,2,0,2019-2020,90.0,64.86486486486487,186.4864864864865
1233,Lovre Kalinić,CRO,GK,Toulouse,Ligue 1,29,1990,3.4,0,0,0,0,0,0,1,0.0,1,0,0,0,0,0,0,0,0,2019-2020,90.0,0.0,0.0
1234,Nikola Kalinić,CRO,FW,Roma,Serie A,31,1988,6.3,2,1,0,2,0,0,0,0.0,0,2,0,2,1,3,1,0,0,2019-2020,90.0,14.285714285714286,28.571428571428573
1235,Salomon Kalou,CIV,"FW,MF",Hertha BSC,Bundesliga,33,1985,1.6,1,0,1,0,0,0,2,0.0,2,2,0,2,0,1,1,0,0,2019-2020,90.0,0.0,56.25
1236,Samuel Kalu,NGA,"DF,FW",Bordeaux,Ligue 1,21,1997,15.1,33,17,19,12,2,16,36,44.4,20,13,1,12,24,57,10,0,0,2019-2020,90.0,143.04635761589404,196.6887417218543
1237,Daichi Kamada,JPN,"MF,FW",Eint Frankfurt,Bundesliga,22,1996,21.9,29,20,7,17,5,8,42,19.0,34,16,1,15,10,39,6,0,0,2019-2020,90.0,41.09589041095891,119.17808219178083
1238,François Kamano,GUI,"DF,MF",Bordeaux,Ligue 1,23,1996,7.2,12,6,5,4,3,8,15,53.3,7,5,0,5,3,15,2,0,0,2019-2020,90.0,37.5,150.0
1239,Boubacar Kamara,FRA,"DF,MF",Marseille,Ligue 1,19,1999,23.8,67,34,37,27,3,27,57,47.4,30,27,14,13,34,101,53,1,0,2019-2020,90.00000000000001,128.57142857142858,253.36134453781514
1240,Hassane Kamara,CIV,"DF,FW",Reims,Ligue 1,25,1994,19.0,58,47,40,14,4,24,35,68.6,11,17,2,15,58,116,58,0,0,2019-2020,90.0,274.7368421052632,274.7368421052632
1241,Kevin Kampl,SVN,MF,RB Leipzig,Bundesliga,28,1990,7.5,17,11,7,10,0,7,23,30.4,16,7,2,5,16,33,6,0,0,2019-2020,90.0,192.0,204.0
1242,Harry Kane,ENG,FW,Tottenham,Premier League,26,1993,28.7,18,12,3,12,3,4,17,23.5,13,17,7,10,6,24,30,0,0,2019-2020,90.0,18.81533101045296,56.44599303135889
1243,Lee Kang-in,KOR,"MF,FW",Valencia,La Liga,18,2001,5.0,3,1,0,2,1,3,6,50.0,3,5,0,5,3,6,0,0,0,2019-2020,90.0,54.0,54.0
1244,Wilfried Kanga,CIV,FW,Angers,Ligue 1,21,1998,0.8,0,0,0,0,0,0,1,0.0,1,0,0,0,0,0,0,0,0,2019-2020,90.0,0.0,0.0
1245,N'Golo Kanté,FRA,MF,Chelsea,Premier League,28,1991,19.2,44,20,22,14,8,17,36,47.2,19,29,5,24,44,88,32,2,0,2019-2020,90.0,206.25,206.25
1246,Stefanos Kapino,GRE,GK,Werder Bremen,Bundesliga,25,1994,1.0,0,0,0,0,0,0,0,0.0,0,0,0,0,1,1,0,0,0,2019-2020,90.0,90.0,0.0
1247,Wilfrid Kaptoum,CMR,MF,Betis,La Liga,23,1996,2.2,5,2,3,2,0,3,3,100.0,0,4,1,3,1,6,3,0,0,2019-2020,90.0,40.90909090909091,204.54545454545453
1248,Kenan Karaman,TUR,"FW,MF",Düsseldorf,Bundesliga,25,1994,15.0,11,5,2,5,4,4,9,44.4,5,9,4,5,2,13,7,0,0,2019-2020,90.0,12.0,66.0
1249,Yann Karamoh,FRA,"FW,MF",Parma,Serie A,21,1998,6.4,10,7,5,4,1,3,9,33.3,6,5,0,5,2,12,3,0,0,2019-2020,90.0,28.125,140.625
1250,Mamoudou Karamoko,FRA,MF,Wolfsburg,Bundesliga,19,1999,0.1,0,0,0,0,0,0,0,0.0,0,0,0,0,0,0,0,0,0,2019-2020,90.0,0.0,0.0
Rk,Player,Nation,Pos,Squad,Comp,0,0,90.0,0,0,3,3,3,Tkl,0,0.0,0,0,0,0,0,0,0,0,0,2019-2020,90.0,0.0,0.0
1251,Florian Kastenmeier,GER,GK,Düsseldorf,Bundesliga,22,1997,17.0,1,1,1,0,0,0,0,0.0,0,0,0,0,2,3,3,1,0,2019-2020,90.0,10.588235294117647,5.294117647058823
1252,Noah Katterbach,GER,DF,Köln,Bundesliga,18,2001,14.6,29,23,21,8,0,11,28,39.3,17,12,1,11,29,58,26,0,0,2019-2020,90.0,178.76712328767124,178.76712328767124
1253,Moise Kean,ITA,FW,Everton,Premier League,19,2000,9.5,6,6,5,1,0,0,0,0.0,0,4,0,4,5,11,1,1,0,2019-2020,90.0,47.36842105263158,56.8421052631579
1254,Michael Keane,ENG,DF,Everton,Premier League,26,1993,28.4,31,16,18,12,1,14,24,58.3,10,35,28,7,44,75,152,0,0,2019-2020,90.0,139.43661971830986,98.23943661971832
1255,Thilo Kehrer,GER,DF,Paris S-G,Ligue 1,22,1996,5.3,10,7,4,5,1,5,10,50.0,5,2,0,2,1,11,2,1,0,2019-2020,90.0,16.9811320754717,169.811320754717
1256,Jules Keita,GUI,"MF,FW",Dijon,Ligue 1,21,1998,1.8,4,3,2,1,1,1,6,16.7,5,1,0,1,3,7,0,0,0,2019-2020,90.0,150.0,200.0
1257,Naby Keïta,GUI,MF,Liverpool,Premier League,24,1995,9.1,30,14,8,16,6,11,26,42.3,15,18,0,18,10,40,4,0,0,2019-2020,90.0,98.9010989010989,296.7032967032967
1258,Yannik Keitel,GER,MF,Freiburg,Bundesliga,19,2000,1.9,2,1,1,1,0,0,6,0.0,6,3,1,2,4,6,4,0,0,2019-2020,90.0,189.4736842105263,94.73684210526315
1259,Lloyd Kelly,ENG,DF,Bournemouth,Premier League,20,1998,7.1,7,3,3,4,0,6,7,85.7,1,9,5,4,6,13,15,1,0,2019-2020,90.0,76.05633802816902,88.73239436619718
1260,Martin Kelly,ENG,DF,Crystal Palace,Premier League,29,1990,17.2,23,18,19,4,0,14,31,45.2,17,18,10,8,16,39,86,1,0,2019-2020,90.0,83.72093023255815,120.34883720930233
1261,Kenedy,BRA,MF,Getafe,La Liga,23,1996,6.5,9,5,3,3,3,2,5,40.0,3,10,0,10,11,20,4,0,0,2019-2020,90.00000000000001,152.30769230769232,124.61538461538463
1262,Jonjoe Kenny,ENG,DF,Schalke 04,Bundesliga,22,1997,30.2,49,29,24,19,6,26,51,51.0,25,45,10,35,26,75,79,0,0,2019-2020,90.0,77.48344370860927,146.02649006622516
1263,Franck Kessié,CIV,MF,Milan,Serie A,22,1996,32.3,54,29,28,18,8,16,52,30.8,36,34,5,29,34,88,32,2,0,2019-2020,90.0,94.73684210526316,150.46439628482972
1264,Saîf-Eddine Khaoui,TUN,"MF,FW",Marseille,Ligue 1,24,1995,1.2,3,1,0,3,0,2,5,40.0,3,2,0,2,1,4,4,0,0,2019-2020,90.0,75.0,225.00000000000003
1265,Wahbi Khazri,TUN,"FW,MF",Saint-Étienne,Ligue 1,28,1991,12.8,17,9,5,7,5,9,27,33.3,18,11,0,11,4,21,0,0,0,2019-2020,90.0,28.125,119.53125
1266,Rani Khedira,GER,MF,Augsburg,Bundesliga,25,1994,29.4,60,36,21,35,4,18,45,40.0,27,47,12,35,48,108,62,0,0,2019-2020,90.0,146.9387755102041,183.67346938775512
1267,Sami Khedira,GER,MF,Juventus,Serie A,32,1987,7.6,14,7,3,8,3,4,19,21.1,15,12,1,11,3,17,13,0,0,2019-2020,90.0,35.526315789473685,165.78947368421052
1268,Kiké,ESP,FW,Eibar,La Liga,29,1989,19.6,13,7,0,5,8,4,12,33.3,8,15,1,14,1,14,9,0,0,2019-2020,90.0,4.591836734693877,59.69387755102041
1269,Luca Kilian,GER,DF,Paderborn 07,Bundesliga,19,1999,14.0,33,24,27,6,0,22,41,53.7,19,20,9,11,12,45,67,0,0,2019-2020,90.0,77.14285714285714,212.14285714285714
1270,Max Kilman,ENG,DF,Wolves,Premier League,22,1997,2.1,4,2,1,3,0,2,2,100.0,0,1,1,0,4,8,7,0,0,2019-2020,90.0,171.42857142857142,171.42857142857142
1271,Joshua Kimmich,GER,"MF,DF",Bayern Munich,Bundesliga,24,1995,31.3,52,29,21,20,11,22,55,40.0,33,38,9,29,29,81,29,0,0,2019-2020,90.0,83.38658146964856,149.52076677316293
1272,Presnel Kimpembe,FRA,DF,Paris S-G,Ligue 1,23,1995,13.6,33,25,25,8,0,14,20,70.0,6,7,3,4,21,54,33,1,0,2019-2020,90.0,138.97058823529412,218.38235294117646
1273,Joshua King,NOR,"FW,MF",Bournemouth,Premier League,27,1992,22.3,16,6,4,8,4,4,16,25.0,12,20,3,17,8,24,9,0,0,2019-2020,90.0,32.28699551569507,64.57399103139014
1274,Simon Kjær,DEN,DF,Atalanta,Serie A,30,1989,3.2,9,6,1,8,0,3,4,75.0,1,5,4,1,7,16,10,1,0,2019-2020,90.0,196.875,253.125
1275,Simon Kjær,DEN,DF,Milan,Serie A,30,1989,13.8,22,13,17,5,0,10,18,55.6,8,20,16,4,15,37,52,0,0,2019-2020,90.0,97.82608695652173,143.4782608695652
Rk,Player,Nation,Pos,Squad,Comp,0,0,90.0,0,0,3,3,3,Tkl,0,0.0,0,0,0,0,0,0,0,0,0,2019-2020,90.0,0.0,0.0
1276,Davy Klaassen,NED,MF,Werder Bremen,Bundesliga,26,1993,32.6,55,43,19,23,13,19,57,33.3,38,46,18,28,38,93,45,2,0,2019-2020,90.0,104.9079754601227,151.840490797546
1277,Felix Klaus,GER,"MF,FW",Wolfsburg,Bundesliga,26,1992,7.4,24,16,4,13,7,7,19,36.8,12,10,2,8,3,27,5,0,0,2019-2020,90.0,36.486486486486484,291.8918918918919
1278,Ragnar Klavan,EST,DF,Cagliari,Serie A,33,1985,26.2,29,16,20,9,0,14,28,50.0,14,29,19,10,25,54,118,1,0,2019-2020,90.0,85.87786259541986,99.61832061068702
1279,Timm Klose,SUI,DF,Norwich City,Premier League,31,1988,6.5,8,2,5,2,1,7,11,63.6,4,6,6,0,7,15,29,0,0,2019-2020,90.00000000000001,96.92307692307693,110.76923076923077
1280,Lukas Klostermann,GER,DF,RB Leipzig,Bundesliga,23,1996,29.4,45,26,24,16,5,18,31,58.1,13,34,16,18,26,71,101,2,0,2019-2020,90.0,79.59183673469389,137.75510204081633
1281,Justin Kluivert,NED,FW,Roma,Serie A,20,1999,16.8,17,11,4,8,5,7,16,43.8,9,15,0,15,6,23,7,0,0,2019-2020,90.0,32.14285714285714,91.07142857142857
1282,Lukas Klünter,GER,DF,Hertha BSC,Bundesliga,23,1996,20.9,44,31,26,16,2,20,30,66.7,10,16,4,12,27,71,61,1,0,2019-2020,90.0,116.26794258373207,189.47368421052633
1283,Robin Knoche,GER,DF,Wolfsburg,Bundesliga,27,1992,17.7,29,14,24,5,0,17,30,56.7,13,19,11,8,27,56,77,1,0,2019-2020,90.0,137.28813559322035,147.45762711864407
1284,Robin Koch,GER,"DF,MF",Freiburg,Bundesliga,23,1996,30.1,34,20,20,13,1,11,26,42.3,15,30,22,8,45,79,94,4,0,2019-2020,90.00000000000001,134.5514950166113,101.66112956810632
1285,Giorgi Kochorashvili,GEO,MF,Levante,La Liga,20,1999,0.0,0,0,0,0,0,0,0,0.0,0,0,0,0,0,0,0,0,0,2019-2020,,,
1286,Jonathan Kodjia,CIV,FW,Aston Villa,Premier League,29,1989,1.3,0,0,0,0,0,0,1,0.0,1,0,0,0,0,0,1,0,0,2019-2020,90.0,0.0,0.0
1287,Kenan Kodro,BIH,"FW,MF",Athletic Club,La Liga,25,1993,4.0,1,0,0,0,1,0,2,0.0,2,1,0,1,0,1,4,0,0,2019-2020,90.0,0.0,22.5
1288,Dominik Kohr,GER,MF,Eint Frankfurt,Bundesliga,25,1994,16.1,44,35,15,25,4,18,53,34.0,35,31,11,20,30,74,16,0,0,2019-2020,90.0,167.70186335403724,245.96273291925465
1289,Koke,ESP,MF,Atlético Madrid,La Liga,27,1992,30.0,70,42,27,30,13,29,89,32.6,60,33,8,25,29,99,28,2,0,2019-2020,90.0,87.0,210.0
1290,Aleksandar Kolarov,SRB,DF,Roma,Serie A,33,1985,30.4,37,28,16,16,5,20,37,54.1,17,20,9,11,31,68,57,0,0,2019-2020,90.0,91.77631578947368,109.53947368421052
1291,Sead Kolašinac,BIH,DF,Arsenal,Premier League,26,1993,18.9,29,16,18,6,5,12,23,52.2,11,14,4,10,25,54,34,1,0,2019-2020,90.0,119.04761904761905,138.0952380952381
1292,Timothée Kolodziejczak,FRA,DF,Saint-Étienne,Ligue 1,27,1991,14.5,17,10,13,4,0,9,21,42.9,12,8,3,5,30,47,44,2,0,2019-2020,90.0,186.20689655172413,105.51724137931033
1293,Ghislain Konan,CIV,DF,Reims,Ligue 1,23,1995,14.8,43,26,28,14,1,19,28,67.9,9,13,3,10,24,67,34,0,0,2019-2020,90.0,145.94594594594594,261.48648648648646
1294,Ibrahima Konaté,FRA,DF,RB Leipzig,Bundesliga,20,1999,6.3,11,6,10,1,0,2,7,28.6,5,9,4,5,5,16,35,1,0,2019-2020,90.0,71.42857142857143,157.14285714285717
1295,Moussa Konaté,SEN,FW,Amiens,Ligue 1,26,1993,6.8,3,0,0,3,0,0,2,0.0,2,2,0,2,1,4,1,0,0,2019-2020,90.0,13.235294117647058,39.705882352941174
1296,Geoffrey Kondogbia,CTA,MF,Valencia,La Liga,26,1993,20.1,63,40,40,18,5,19,51,37.3,32,25,6,19,57,120,36,2,0,2019-2020,90.0,255.2238805970149,282.08955223880594
1297,Lamine Koné,CIV,DF,Strasbourg,Ligue 1,30,1989,16.4,31,21,20,10,1,12,17,70.6,5,8,5,3,25,56,47,1,0,2019-2020,90.0,137.19512195121953,170.12195121951223
1298,Manu Koné,FRA,MF,Toulouse,Ligue 1,18,2001,9.7,35,20,17,14,4,13,30,43.3,17,15,1,14,19,54,10,1,0,2019-2020,90.0,176.28865979381445,324.74226804123714
1299,Moussa Koné,SEN,"FW,MF",Nîmes,Ligue 1,22,1996,1.6,2,0,1,1,0,1,3,33.3,2,1,0,1,1,3,0,0,0,2019-2020,90.0,56.25,112.5
1300,Youssouf Koné,MLI,DF,Lyon,Ligue 1,24,1995,9.1,22,14,17,3,2,12,20,60.0,8,2,1,1,8,30,15,0,0,2019-2020,90.0,79.12087912087912,217.58241758241758
Rk,Player,Nation,Pos,Squad,Comp,0,0,90.0,0,0,3,3,3,Tkl,0,0.0,0,0,0,0,0,0,0,0,0,2019-2020,90.0,0.0,0.0
1301,Ezri Konsa,ENG,DF,Aston Villa,Premier League,21,1997,22.7,18,9,12,6,0,7,16,43.8,9,34,24,10,25,43,70,2,0,2019-2020,89.99999999999999,99.11894273127753,71.36563876651982
1302,Pascal Köpke,GER,FW,Hertha BSC,Bundesliga,23,1995,1.3,0,0,0,0,0,0,0,0.0,0,0,0,0,0,0,0,0,0,2019-2020,90.0,0.0,0.0
1303,Laurent Koscielny,FRA,DF,Bordeaux,Ligue 1,33,1985,24.3,28,13,24,4,0,10,20,50.0,10,23,19,4,26,54,104,0,0,2019-2020,90.0,96.29629629629629,103.7037037037037
1304,Filip Kostić,SRB,"DF,FW",Eint Frankfurt,Bundesliga,26,1992,32.9,59,38,30,20,9,22,59,37.3,37,45,2,43,23,82,16,0,0,2019-2020,90.0,62.91793313069909,161.39817629179333
1305,Christian Kouamé,CIV,"FW,MF",Fiorentina,Serie A,21,1997,3.3,3,2,0,3,0,0,1,0.0,1,5,1,4,1,4,1,0,0,2019-2020,90.0,27.272727272727273,81.81818181818181
1306,Christian Kouamé,CIV,FW,Genoa,Serie A,21,1997,10.2,2,1,0,1,1,0,8,0.0,8,8,2,6,1,3,13,0,0,2019-2020,90.0,8.823529411764707,17.647058823529413
1307,Tomáš Koubek,CZE,GK,Augsburg,Bundesliga,26,1992,24.0,3,2,3,0,0,3,11,27.3,8,1,0,1,1,4,23,3,0,2019-2020,90.0,3.75,11.25
1308,Kalidou Koulibaly,SEN,DF,Napoli,Serie A,28,1991,23.4,51,33,30,17,4,17,28,60.7,11,28,16,12,31,82,61,1,0,2019-2020,89.99999999999999,119.23076923076923,196.15384615384616
1309,Efthimis Koulouris,GRE,FW,Toulouse,Ligue 1,23,1996,17.1,13,8,5,5,3,3,13,23.1,10,8,4,4,3,16,16,0,0,2019-2020,90.0,15.789473684210526,68.42105263157895
1310,Jules Koundé,FRA,DF,Sevilla,La Liga,20,1998,25.7,23,12,14,5,4,10,18,55.6,8,16,12,4,23,46,91,2,0,2019-2020,90.0,80.54474708171206,80.54474708171206
1311,Leonardo Koutris,GRE,DF,Mallorca,La Liga,24,1995,1.0,1,1,0,0,1,1,2,50.0,1,1,1,0,1,2,6,0,0,2019-2020,90.0,90.0,90.0
1312,Cheikhou Kouyaté,SEN,"MF,DF",Crystal Palace,Premier League,29,1989,28.1,67,32,43,20,4,26,48,54.2,22,35,11,24,43,110,58,1,0,2019-2020,90.0,137.72241992882562,214.59074733096085
1313,Mateo Kovačić,CRO,MF,Chelsea,Premier League,25,1994,23.0,63,38,29,32,2,26,65,40.0,39,15,1,14,22,85,16,1,0,2019-2020,90.0,86.08695652173914,246.5217391304348
1314,Dawid Kownacki,POL,"FW,MF",Düsseldorf,Bundesliga,22,1997,12.1,13,8,5,7,1,9,20,45.0,11,13,2,11,6,19,8,0,0,2019-2020,90.0,44.628099173553714,96.69421487603306
1315,İsmail Köybaşı,TUR,"DF,FW",Granada,La Liga,30,1989,2.6,4,4,3,1,0,0,2,0.0,2,4,0,4,5,9,2,0,0,2019-2020,90.0,173.07692307692307,138.46153846153845
1316,Thomas Kraft,GER,GK,Hertha BSC,Bundesliga,31,1988,4.0,0,0,0,0,0,0,0,0.0,0,0,0,0,1,1,0,0,0,2019-2020,90.0,22.5,0.0
1317,Emil Krafth,SWE,DF,Newcastle Utd,Premier League,24,1994,11.3,18,12,15,2,1,9,20,45.0,11,11,8,3,8,26,45,0,0,2019-2020,90.0,63.716814159292035,143.36283185840708
1318,Andrej Kramarić,CRO,"FW,MF",Hoffenheim,Bundesliga,28,1991,15.8,2,1,1,0,1,1,7,14.3,6,6,0,6,3,5,4,0,0,2019-2020,90.0,17.088607594936708,11.392405063291138
1319,Christoph Kramer,GER,MF,Gladbach,Bundesliga,28,1991,16.3,45,29,19,21,5,19,49,38.8,30,22,3,19,14,59,19,0,0,2019-2020,90.0,77.30061349693251,248.46625766871165
1320,Tom Krauß,GER,MF,RB Leipzig,Bundesliga,18,2001,0.0,1,1,0,1,0,1,2,50.0,1,0,0,0,0,1,0,0,0,2019-2020,,,inf
1321,Ladislav Krejčí,CZE,DF,Bologna,Serie A,27,1992,11.7,15,10,6,7,2,9,19,47.4,10,7,4,3,10,25,23,0,0,2019-2020,89.99999999999999,76.92307692307692,115.38461538461539
1322,Rene Krhin,SVN,"DF,MF",Nantes,Ligue 1,29,1990,3.6,4,3,1,3,0,2,2,100.0,0,1,0,1,6,10,17,0,0,2019-2020,90.0,150.0,100.0
1323,Felix Kroos,GER,"MF,DF",Union Berlin,Bundesliga,28,1991,4.2,17,9,9,6,2,8,15,53.3,7,6,3,3,3,20,13,1,0,2019-2020,90.0,64.28571428571428,364.2857142857143
1324,Toni Kroos,GER,MF,Real Madrid,La Liga,29,1990,29.5,56,28,18,29,9,18,70,25.7,52,27,0,27,23,79,15,0,0,2019-2020,90.0,70.16949152542372,170.84745762711864
1325,Tim Krul,NED,GK,Norwich City,Premier League,31,1988,36.0,0,0,0,0,0,0,1,0.0,1,2,0,2,1,1,13,1,0,2019-2020,90.0,2.5,0.0
Rk,Player,Nation,Pos,Squad,Comp,0,0,90.0,0,0,3,3,3,Tkl,0,0.0,0,0,0,0,0,0,0,0,0,2019-2020,90.0,0.0,0.0
1326,Rade Krunić,BIH,"MF,FW",Milan,Serie A,25,1993,6.0,16,8,8,5,3,9,16,56.3,7,5,0,5,9,25,5,0,0,2019-2020,90.0,135.0,240.0
1327,Lukas Kübler,GER,DF,Freiburg,Bundesliga,26,1992,2.3,1,1,0,1,0,1,5,20.0,4,2,0,2,1,2,6,0,0,2019-2020,90.0,39.130434782608695,39.130434782608695
1328,Takefusa Kubo,JPN,"MF,FW",Mallorca,La Liga,18,2001,25.7,34,22,16,12,6,15,44,34.1,29,19,1,18,23,57,10,0,0,2019-2020,90.0,80.54474708171206,119.06614785992218
1329,Juraj Kucka,SVK,"MF,FW",Parma,Serie A,32,1987,21.5,43,22,21,16,6,14,61,23.0,47,21,4,17,29,72,36,0,0,2019-2020,90.0,121.3953488372093,180.0
1330,Dejan Kulusevski,SWE,"FW,MF",Parma,Serie A,19,2000,32.6,41,21,10,24,7,19,64,29.7,45,25,1,24,23,64,17,0,0,2019-2020,90.0,63.49693251533742,113.19018404907976
1331,Marash Kumbulla,ALB,DF,Hellas Verona,Serie A,19,2000,21.7,40,24,21,17,2,19,36,52.8,17,33,24,9,50,90,86,3,0,2019-2020,90.0,207.3732718894009,165.89861751152074
1332,Pierre Kunde,CMR,MF,Mainz 05,Bundesliga,24,1995,20.7,34,17,15,18,1,12,30,40.0,18,16,4,12,26,60,55,0,0,2019-2020,90.0,113.04347826086958,147.82608695652175
1333,Jasmin Kurtić,SVN,MF,SPAL,Serie A,30,1989,15.7,20,7,8,8,4,6,27,22.2,21,14,2,12,10,30,20,1,0,2019-2020,90.0,57.32484076433121,114.64968152866243
1334,Jasmin Kurtić,SVN,"MF,FW",Parma,Serie A,30,1989,18.5,32,23,19,10,3,13,35,37.1,22,19,5,14,15,47,27,2,0,2019-2020,90.0,72.97297297297298,155.67567567567568
1335,Layvin Kurzawa,FRA,DF,Paris S-G,Ligue 1,26,1992,9.5,23,16,5,14,4,11,23,47.8,12,12,1,11,18,41,24,1,0,2019-2020,90.0,170.52631578947367,217.89473684210526
1336,Dereck Kutesa,SUI,"FW,MF",Reims,Ligue 1,21,1997,5.9,6,5,3,2,1,3,9,33.3,6,5,0,5,1,7,1,0,0,2019-2020,90.0,15.254237288135592,91.52542372881355
1337,Ahmed Kutucu,TUR,"FW,MF",Schalke 04,Bundesliga,19,2000,7.5,11,7,3,6,2,4,15,26.7,11,5,0,5,2,13,5,0,0,2019-2020,90.0,24.0,132.0
1338,Enock Kwateng,FRA,DF,Bordeaux,Ligue 1,22,1997,10.9,36,22,17,17,2,22,47,46.8,25,16,6,10,22,58,41,0,0,2019-2020,90.0,181.65137614678898,297.2477064220183
1339,Giorgos Kyriakopoulos,GRE,DF,Sassuolo,Serie A,23,1996,18.3,35,18,22,7,6,18,32,56.3,14,19,6,13,18,53,41,0,0,2019-2020,90.0,88.52459016393442,172.1311475409836
1340,Antonino La Gumina,ITA,FW,Sampdoria,Serie A,23,1996,2.1,0,0,0,0,0,0,0,0.0,0,0,0,0,0,0,1,0,0,2019-2020,90.0,0.0,0.0
1341,Andrea La Mantia,ITA,FW,Lecce,Serie A,28,1991,6.1,1,0,1,0,0,1,5,20.0,4,3,0,3,7,8,11,0,0,2019-2020,90.0,103.27868852459018,14.754098360655739
1342,Gaëtan Laborde,FRA,FW,Montpellier,Ligue 1,25,1994,24.9,21,12,4,10,7,9,38,23.7,29,21,0,21,7,28,32,1,0,2019-2020,90.0,25.301204819277107,75.90361445783132
1343,Alexandre Lacazette,FRA,FW,Arsenal,Premier League,28,1991,20.8,31,16,8,21,2,9,24,37.5,15,14,0,14,7,38,15,0,0,2019-2020,90.0,30.288461538461537,134.1346153846154
1344,Riccardo Ladinetti,ITA,MF,Cagliari,Serie A,18,2000,1.4,2,2,0,2,0,1,1,100.0,0,0,0,0,4,6,0,1,0,2019-2020,90.0,257.14285714285717,128.57142857142858
1345,Alban Lafont,FRA,GK,Nantes,Ligue 1,20,1999,27.0,1,1,1,0,0,1,1,100.0,0,0,0,0,0,1,12,0,0,2019-2020,90.0,0.0,3.3333333333333335
1346,Víctor Laguardia,ESP,DF,Alavés,La Liga,29,1989,29.5,21,15,15,6,0,16,30,53.3,14,24,18,6,37,58,131,1,0,2019-2020,90.0,112.88135593220339,64.0677966101695
1347,Jack Lahne,SWE,FW,Amiens,Ligue 1,17,2001,0.1,1,1,0,0,1,0,0,0.0,0,0,0,0,0,1,0,0,0,2019-2020,90.0,0.0,900.0
1348,Konrad Laimer,AUT,MF,RB Leipzig,Bundesliga,22,1997,23.5,91,45,30,46,15,43,102,42.2,59,51,8,43,34,125,14,0,0,2019-2020,90.0,130.2127659574468,348.51063829787233
1349,Stefan Lainer,AUT,DF,Gladbach,Bundesliga,26,1992,30.1,51,30,25,19,7,24,54,44.4,30,38,7,31,29,80,71,0,0,2019-2020,90.00000000000001,86.71096345514951,152.49169435215947
1350,Diego Lainez,MEX,"MF,FW",Betis,La Liga,19,2000,3.9,6,5,2,4,0,5,8,62.5,3,6,0,6,1,7,1,0,0,2019-2020,90.0,23.076923076923077,138.46153846153845
Rk,Player,Nation,Pos,Squad,Comp,0,0,90.0,0,0,3,3,3,Tkl,0,0.0,0,0,0,0,0,0,0,0,0,2019-2020,90.0,0.0,0.0
1351,Kenny Lala,MAD,"DF,MF",Strasbourg,Ligue 1,27,1991,22.7,29,16,17,11,1,11,27,40.7,16,14,5,9,20,49,40,1,0,2019-2020,89.99999999999999,79.29515418502203,114.97797356828193
1352,Adam Lallana,ENG,"MF,FW",Liverpool,Premier League,31,1988,4.2,19,9,7,9,3,6,21,28.6,15,7,0,7,5,24,3,0,0,2019-2020,90.0,107.14285714285714,407.1428571428571
1353,Érik Lamela,ARG,"MF,FW",Tottenham,Premier League,27,1992,13.5,24,20,9,13,2,2,21,9.5,19,12,3,9,8,32,10,0,0,2019-2020,90.0,53.333333333333336,160.0
1354,Tariq Lamptey,GHA,DF,Chelsea,Premier League,18,2000,0.4,2,2,1,1,0,2,2,100.0,0,0,0,0,0,2,0,0,0,2019-2020,90.0,0.0,450.0
1355,Tariq Lamptey,GHA,DF,Brighton,Premier League,18,2000,6.5,7,6,6,1,0,2,9,22.2,7,6,0,6,16,23,17,0,0,2019-2020,90.00000000000001,221.53846153846155,96.92307692307693
1356,Loïck Landre,FRA,DF,Nîmes,Ligue 1,27,1992,10.3,16,9,12,3,1,7,11,63.6,4,12,9,3,17,33,34,0,0,2019-2020,90.0,148.54368932038835,139.80582524271844
1357,Michael Lang,SUI,"DF,FW",Werder Bremen,Bundesliga,28,1991,6.0,8,5,3,5,0,6,12,50.0,6,5,1,4,7,15,22,0,0,2019-2020,90.0,105.0,120.0
1358,Sebastian Langkamp,GER,DF,Werder Bremen,Bundesliga,31,1988,3.5,3,2,3,0,0,2,4,50.0,2,5,3,2,3,6,11,1,0,2019-2020,90.0,77.14285714285714,77.14285714285714
1359,Henri Lansbury,ENG,MF,Aston Villa,Premier League,28,1990,2.2,6,2,3,1,2,2,8,25.0,6,4,0,4,0,6,3,0,0,2019-2020,90.0,0.0,245.45454545454544
1360,Manuel Lanzini,ARG,"MF,FW",West Ham,Premier League,26,1993,15.3,14,9,6,6,2,7,39,17.9,32,9,1,8,10,24,3,0,0,2019-2020,90.0,58.8235294117647,82.35294117647058
1361,Gianluca Lapadula,PER,FW,Lecce,Serie A,29,1990,19.8,15,8,6,8,1,5,16,31.3,11,2,0,2,1,16,14,0,0,2019-2020,90.0,4.545454545454546,68.18181818181819
1362,Aymeric Laporte,ESP,DF,Manchester City,Premier League,25,1994,12.2,13,6,6,7,0,4,9,44.4,5,6,5,1,20,33,26,1,0,2019-2020,90.0,147.5409836065574,95.9016393442623
1363,Danilo Larangeira,BRA,DF,Bologna,Serie A,35,1984,29.3,34,17,19,15,0,16,28,57.1,12,54,39,15,30,64,99,0,0,2019-2020,90.0,92.15017064846417,104.43686006825939
1364,Larra,ESP,"FW,MF",Athletic Club,La Liga,21,1997,2.8,2,2,0,1,1,0,0,0.0,0,1,0,1,0,2,0,0,0,2019-2020,90.0,0.0,64.28571428571429
1365,Gautier Larsonneur,FRA,GK,Brest,Ligue 1,22,1997,26.6,2,1,2,0,0,2,4,50.0,2,1,0,1,4,6,14,3,0,2019-2020,90.0,13.533834586466165,6.7669172932330826
1366,Kevin Lasagna,ITA,FW,Udinese,Serie A,26,1992,28.5,27,14,7,13,7,6,31,19.4,25,23,1,22,10,37,18,1,0,2019-2020,90.0,31.578947368421055,85.26315789473685
1367,Jamaal Lascelles,ENG,DF,Newcastle Utd,Premier League,25,1993,23.1,14,3,10,4,0,4,9,44.4,5,23,20,3,28,42,116,1,0,2019-2020,89.99999999999999,109.09090909090908,54.54545454545454
1368,Paul Lasne,FRA,"MF,FW",Brest,Ligue 1,30,1989,13.6,25,13,13,11,1,6,20,30.0,14,7,2,5,7,32,5,0,0,2019-2020,90.0,46.3235294117647,165.44117647058823
1369,Toni Lato,ESP,"DF,MF",Osasuna,La Liga,21,1997,5.2,22,15,11,8,3,9,10,90.0,1,9,1,8,8,30,13,1,0,2019-2020,90.0,138.46153846153845,380.7692307692307
1370,Danny Latza,GER,MF,Mainz 05,Bundesliga,29,1989,15.3,33,19,15,17,1,16,49,32.7,33,22,5,17,17,50,24,0,0,2019-2020,90.0,99.99999999999999,194.1176470588235
1371,Vincent Laurini,FRA,DF,Parma,Serie A,30,1989,9.8,26,22,11,11,4,14,18,77.8,4,10,3,7,11,37,29,0,0,2019-2020,90.0,101.0204081632653,238.77551020408163
1372,Wesley Lautoa,NCL,"MF,DF",Dijon,Ligue 1,31,1987,20.8,54,29,24,28,2,28,63,44.4,35,31,16,15,42,96,48,2,0,2019-2020,90.0,181.73076923076923,233.65384615384613
1373,Diego Laxalt,URU,"DF,MF",Torino,Serie A,26,1993,6.6,19,10,10,6,3,6,20,30.0,14,12,4,8,6,25,20,0,0,2019-2020,90.0,81.81818181818181,259.09090909090907
1374,Diego Laxalt,URU,DF,Milan,Serie A,26,1993,1.9,3,3,3,0,0,1,3,33.3,2,4,0,4,0,3,3,0,0,2019-2020,90.0,0.0,142.10526315789474
1375,Valentino Lazaro,AUT,"DF,MF",Newcastle Utd,Premier League,23,1996,5.3,13,9,11,2,0,11,18,61.1,7,2,0,2,3,16,4,0,0,2019-2020,90.0,50.943396226415096,220.75471698113208
Rk,Player,Nation,Pos,Squad,Comp,0,0,90.0,0,0,3,3,3,Tkl,0,0.0,0,0,0,0,0,0,0,0,0,2019-2020,90.0,0.0,0.0
1376,Valentino Lazaro,AUT,DF,Inter,Serie A,23,1996,3.6,6,5,3,2,1,4,8,50.0,4,5,0,5,1,7,8,1,0,2019-2020,90.0,25.0,150.0
1377,Darko Lazović,SRB,DF,Hellas Verona,Serie A,28,1990,36.0,26,16,14,8,4,14,27,51.9,13,15,4,11,23,49,53,0,0,2019-2020,90.0,57.5,65.0
1378,Manuel Lazzari,ITA,DF,Lazio,Serie A,25,1993,28.3,20,11,10,7,3,10,31,32.3,21,11,1,10,8,28,34,0,0,2019-2020,90.0,25.441696113074205,63.60424028268551
1379,Mickaël Le Bihan,FRA,"FW,DF",Nice,Ligue 1,29,1990,1.1,0,0,0,0,0,0,2,0.0,2,0,0,0,0,0,2,0,0,2019-2020,90.0,0.0,0.0
1380,Robin Le Normand,ESP,DF,Real Sociedad,La Liga,22,1996,26.6,48,27,33,15,0,26,35,74.3,9,20,7,13,20,68,99,0,0,2019-2020,90.0,67.66917293233082,162.406015037594
1381,Damien Le Tallec,FRA,"MF,DF",Montpellier,Ligue 1,29,1990,27.3,52,27,20,28,4,24,69,34.8,45,38,18,20,38,90,59,0,0,2019-2020,90.0,125.27472527472527,171.42857142857142
1382,James Lea Siliki,CMR,MF,Rennes,Ligue 1,23,1996,12.0,28,16,19,9,0,16,29,55.2,13,15,4,11,12,40,12,0,0,2019-2020,90.0,90.0,210.0
1383,Rafael Leão,POR,FW,Milan,Serie A,20,1999,15.6,7,4,2,5,0,3,9,33.3,6,4,0,4,0,7,5,0,0,2019-2020,90.0,0.0,40.38461538461538
1384,Adrien Lebeau,FRA,"MF,FW",Strasbourg,Ligue 1,20,1999,0.1,1,1,1,0,0,0,1,0.0,1,1,0,1,0,1,0,0,0,2019-2020,90.0,0.0,900.0
1385,Mathew Leckie,AUS,"DF,FW",Hertha BSC,Bundesliga,28,1991,2.2,3,1,1,2,0,2,3,66.7,1,6,0,6,2,5,2,1,0,2019-2020,90.0,81.81818181818181,122.72727272727272
1386,Benjamin Lecomte,FRA,GK,Monaco,Ligue 1,28,1991,28.0,0,0,0,0,0,0,1,0.0,1,1,0,1,0,0,10,5,0,2019-2020,90.0,0.0,0.0
1387,Pierre Lees-Melou,FRA,MF,Nice,Ligue 1,26,1993,25.0,63,27,34,21,8,31,88,35.2,57,38,12,26,32,95,43,0,0,2019-2020,90.0,115.19999999999999,226.79999999999998
1388,Jordan Lefort,FRA,DF,Amiens,Ligue 1,25,1993,9.4,3,2,2,1,0,3,5,60.0,2,4,1,3,9,12,29,0,0,2019-2020,90.0,86.17021276595744,28.723404255319146
1389,Wu Lei,CHN,"FW,MF",Espanyol,La Liga,27,1991,19.1,13,8,5,6,2,4,38,10.5,34,32,1,31,15,28,19,1,0,2019-2020,90.0,70.68062827225131,61.2565445026178
1390,Toni Leistner,GER,DF,Köln,Bundesliga,28,1990,11.2,19,12,10,9,0,5,13,38.5,8,16,7,9,32,51,57,0,0,2019-2020,90.0,257.14285714285717,152.67857142857144
1391,Moritz Leitner,GER,MF,Norwich City,Premier League,26,1992,7.6,16,9,8,7,1,9,25,36.0,16,14,4,10,9,25,10,1,0,2019-2020,90.0,106.57894736842105,189.4736842105263
1392,Lucas Leiva,BRA,MF,Lazio,Serie A,32,1987,20.1,60,35,25,31,4,28,72,38.9,44,29,6,23,47,107,34,1,0,2019-2020,90.0,210.44776119402982,268.65671641791045
1393,Florian Lejeune,FRA,DF,Newcastle Utd,Premier League,28,1991,4.9,8,2,6,2,0,4,7,57.1,3,6,2,4,10,18,15,2,0,2019-2020,90.0,183.6734693877551,146.93877551020407
1394,Iñigo Lekue,ESP,"FW,DF",Athletic Club,La Liga,26,1993,6.9,22,12,14,6,2,11,14,78.6,3,7,0,7,3,25,11,0,0,2019-2020,90.0,39.13043478260869,286.9565217391304
1395,Nicolas Lemaître,FRA,GK,Reims,Ligue 1,22,1997,1.0,0,0,0,0,0,0,1,0.0,1,0,0,0,1,1,1,1,0,2019-2020,90.0,90.0,0.0
1396,Thomas Lemar,FRA,MF,Atlético Madrid,La Liga,23,1995,10.3,12,8,4,5,3,2,11,18.2,9,14,1,13,6,18,6,0,0,2019-2020,90.0,52.42718446601942,104.85436893203884
1397,Tim Lemperle,GER,MF,Köln,Bundesliga,17,2002,0.2,0,0,0,0,0,0,0,0.0,0,0,0,0,0,0,0,0,0,2019-2020,90.0,0.0,0.0
1398,Clément Lenglet,FRA,DF,Barcelona,La Liga,24,1995,26.9,44,31,29,15,0,16,32,50.0,16,29,15,14,35,79,79,1,0,2019-2020,90.0,117.10037174721191,147.21189591078067
1399,Aaron Lennon,ENG,MF,Burnley,Premier League,32,1987,5.5,14,8,7,4,3,7,10,70.0,3,6,1,5,8,22,3,0,0,2019-2020,90.0,130.9090909090909,229.0909090909091
1400,Bernd Leno,GER,GK,Arsenal,Premier League,27,1992,29.4,0,0,0,0,0,0,2,0.0,2,0,0,0,0,0,9,2,0,2019-2020,90.0,0.0,0.0
Rk,Player,Nation,Pos,Squad,Comp,0,0,90.0,0,0,3,3,3,Tkl,0,0.0,0,0,0,0,0,0,0,0,0,2019-2020,90.0,0.0,0.0
1401,Christopher Lenz,GER,"DF,MF",Union Berlin,Bundesliga,24,1994,25.2,63,37,37,20,6,26,49,53.1,23,46,11,35,43,106,65,0,0,2019-2020,90.0,153.57142857142858,225.00000000000003
1402,Donovan Léon,GUF,GK,Brest,Ligue 1,26,1992,1.4,0,0,0,0,0,0,0,0.0,0,1,0,1,0,0,0,0,0,2019-2020,90.0,0.0,0.0
1403,Pedro León,ESP,"MF,FW",Eibar,La Liga,32,1986,21.1,28,20,8,9,11,12,25,48.0,13,18,1,17,19,47,7,0,0,2019-2020,90.0,81.04265402843602,119.43127962085308
1404,Sergio León,ESP,FW,Levante,La Liga,30,1989,7.5,3,3,0,3,0,2,4,50.0,2,3,0,3,1,4,2,0,0,2019-2020,90.0,12.0,36.0
1405,Lukas Lerager,DEN,MF,Genoa,Serie A,26,1993,15.4,29,19,13,12,4,10,34,29.4,24,20,5,15,8,37,15,1,0,2019-2020,90.0,46.753246753246756,169.4805194805195
1406,Mehdi Léris,ALG,"MF,FW",Sampdoria,Serie A,21,1998,5.7,13,11,4,2,7,7,19,36.8,12,12,4,8,6,19,6,0,0,2019-2020,90.0,94.73684210526315,205.26315789473682
1407,Jefferson Lerma,COL,MF,Bournemouth,Premier League,24,1994,30.0,54,32,17,31,6,22,48,45.8,26,28,12,16,57,111,54,1,0,2019-2020,90.0,171.0,162.0
1408,Karlo Letica,CRO,GK,SPAL,Serie A,22,1997,10.0,0,0,0,0,0,0,2,0.0,2,0,0,0,0,0,4,3,0,2019-2020,90.0,0.0,0.0
1409,Robert Lewandowski,POL,FW,Bayern Munich,Bundesliga,30,1988,30.7,18,9,3,9,6,3,15,20.0,12,13,1,12,7,25,13,0,0,2019-2020,90.0,20.521172638436482,52.76872964169382
1410,Jamal Lewis,NIR,DF,Norwich City,Premier League,21,1998,25.6,51,35,42,6,3,22,36,61.1,14,27,12,15,25,76,68,0,0,2019-2020,90.0,87.890625,179.296875
1411,Aaron Leya Iseka,BEL,FW,Toulouse,Ligue 1,21,1997,8.6,2,0,0,2,0,0,3,0.0,3,5,0,5,1,3,7,0,0,2019-2020,90.0,10.465116279069768,20.930232558139537
1412,Stephan Lichtsteiner,SUI,DF,Augsburg,Bundesliga,35,1984,14.9,23,14,16,5,2,10,22,45.5,12,15,7,8,16,39,35,0,0,2019-2020,90.0,96.64429530201342,138.92617449664428
1413,Dimitri Liénard,FRA,MF,Strasbourg,Ligue 1,31,1988,16.5,37,24,10,22,5,18,39,46.2,21,18,4,14,17,54,25,0,0,2019-2020,90.0,92.72727272727273,201.81818181818184
1414,Philipp Lienhart,AUT,DF,Freiburg,Bundesliga,23,1996,20.2,11,4,10,1,0,6,13,46.2,7,24,17,7,28,39,86,0,0,2019-2020,90.0,124.75247524752476,49.00990099009901
1415,Matthijs de Ligt,NED,DF,Juventus,Serie A,19,1999,27.2,25,15,14,10,1,13,23,56.5,10,30,23,7,25,50,101,2,0,2019-2020,90.0,82.72058823529412,82.72058823529412
1416,Isaac Lihadji,FRA,MF,Marseille,Ligue 1,17,2002,0.3,0,0,0,0,0,0,0,0.0,0,0,0,0,0,0,0,0,0,2019-2020,90.0,0.0,0.0
1417,Lillo,ESP,DF,Osasuna,La Liga,30,1989,2.2,4,2,2,2,0,1,1,100.0,0,2,1,1,2,6,8,0,0,2019-2020,90.0,81.81818181818181,163.63636363636363
1418,Anderson Lima,BRA,"MF,DF",Lazio,Serie A,19,1999,0.7,4,0,3,1,0,1,1,100.0,0,4,0,4,0,4,0,0,0,2019-2020,90.0,0.0,514.2857142857143
1419,Lucas Lima,BRA,"FW,DF",Nantes,Ligue 1,27,1991,3.0,7,2,4,3,0,2,5,40.0,3,2,0,2,1,8,3,0,0,2019-2020,90.0,30.0,210.0
1420,Anthony Limbombe,BEL,"FW,MF",Nantes,Ligue 1,25,1994,1.7,3,2,1,2,0,1,1,100.0,0,1,0,1,0,3,3,0,0,2019-2020,90.0,0.0,158.8235294117647
1421,Victor Lindelöf,SWE,DF,Manchester Utd,Premier League,25,1994,34.4,29,15,16,12,1,17,20,85.0,3,25,16,9,26,55,129,0,0,2019-2020,90.0,68.0232558139535,75.87209302325581
1422,Karol Linetty,POL,MF,Sampdoria,Serie A,24,1995,22.4,61,32,24,25,12,21,65,32.3,44,26,3,23,26,87,17,0,0,2019-2020,90.0,104.46428571428572,245.08928571428572
1423,Jesse Lingard,ENG,"MF,FW",Manchester Utd,Premier League,26,1992,10.4,15,8,6,4,5,5,18,27.8,13,5,0,5,3,18,0,0,0,2019-2020,90.0,25.96153846153846,129.8076923076923
1424,Pol Lirola,ESP,DF,Fiorentina,Serie A,21,1997,29.4,34,20,18,10,6,21,38,55.3,17,16,4,12,26,60,52,0,0,2019-2020,90.0,79.59183673469389,104.08163265306122
1425,Diego Llorente,ESP,DF,Real Sociedad,La Liga,25,1993,25.9,30,14,20,9,1,16,28,57.1,12,14,7,7,28,58,101,5,0,2019-2020,90.0,97.2972972972973,104.24710424710426
Rk,Player,Nation,Pos,Squad,Comp,0,0,90.0,0,0,3,3,3,Tkl,0,0.0,0,0,0,0,0,0,0,0,0,2019-2020,90.0,0.0,0.0
1426,Fernando Llorente,ESP,FW,Napoli,Serie A,34,1985,5.6,0,0,0,0,0,0,1,0.0,1,4,0,4,1,1,3,0,0,2019-2020,90.0,16.071428571428573,0.0
1427,Marcos Llorente,ESP,"MF,FW",Atlético Madrid,La Liga,24,1995,15.2,29,15,7,16,6,7,21,33.3,14,24,4,20,14,43,9,0,0,2019-2020,90.0,82.89473684210526,171.71052631578948
1428,Gautier Lloris,FRA,DF,Nice,Ligue 1,24,1995,3.0,5,3,5,0,0,4,5,80.0,1,3,3,0,2,7,11,0,0,2019-2020,90.0,60.0,150.0
1429,Hugo Lloris,FRA,GK,Tottenham,Premier League,32,1986,20.1,0,0,0,0,0,0,0,0.0,0,0,0,0,1,1,3,2,0,2019-2020,90.0,4.477611940298507,0.0
1430,Giovani Lo Celso,ARG,"MF,FW",Tottenham,Premier League,23,1996,16.6,51,29,12,33,6,12,59,20.3,47,20,4,16,9,60,19,0,0,2019-2020,90.0,48.79518072289156,276.5060240963855
1431,Stanislav Lobotka,SVK,MF,Napoli,Serie A,24,1994,8.4,11,9,3,5,3,5,12,41.7,7,3,1,2,9,20,2,0,0,2019-2020,90.0,96.42857142857143,117.85714285714285
1432,Stanislav Lobotka,SVK,MF,Celta Vigo,La Liga,24,1994,15.4,19,11,13,5,1,4,19,21.1,15,8,2,6,8,27,7,0,0,2019-2020,90.0,46.753246753246756,111.03896103896105
1433,Jürgen Locadia,CUW,"FW,MF",Brighton,Premier League,25,1993,1.0,0,0,0,0,0,0,0,0.0,0,0,0,0,0,0,0,0,0,2019-2020,90.0,0.0,0.0
1434,Jürgen Locadia,CUW,FW,Hoffenheim,Bundesliga,25,1993,5.9,5,4,0,4,1,1,4,25.0,3,1,0,1,0,5,3,0,0,2019-2020,90.0,0.0,76.27118644067797
1435,Manuel Locatelli,ITA,MF,Sassuolo,Serie A,21,1998,28.7,76,50,35,37,4,33,69,47.8,36,42,14,28,33,109,36,0,0,2019-2020,90.0,103.48432055749129,238.3275261324042
1436,Renan Lodi,BRA,DF,Atlético Madrid,La Liga,21,1998,26.6,73,46,28,35,10,40,65,61.5,25,28,7,21,38,111,56,0,0,2019-2020,90.0,128.57142857142856,246.99248120300751
1437,Ruben Loftus-Cheek,ENG,"MF,FW",Chelsea,Premier League,23,1996,2.3,0,0,0,0,0,0,2,0.0,2,1,1,0,2,2,2,0,0,2019-2020,90.0,78.26086956521739,0.0
1438,Enzo Loiodice,FRA,MF,Dijon,Ligue 1,18,2000,2.1,6,4,1,4,1,1,3,33.3,2,2,0,2,2,8,1,0,0,2019-2020,90.0,85.71428571428571,257.1428571428571
1439,Kevin Long,IRL,DF,Burnley,Premier League,28,1990,6.3,7,5,6,1,0,4,9,44.4,5,9,7,2,4,11,31,0,0,2019-2020,90.0,57.142857142857146,100.00000000000001
1440,Shane Long,IRL,FW,Southampton,Premier League,32,1987,15.5,19,10,5,8,6,7,19,36.8,12,12,0,12,4,23,16,0,0,2019-2020,90.0,23.225806451612904,110.3225806451613
1441,Matthew Longstaff,ENG,MF,Newcastle Utd,Premier League,19,2000,6.4,3,1,2,1,0,3,14,21.4,11,4,1,3,5,8,3,0,0,2019-2020,90.0,70.3125,42.1875
1442,Sean Longstaff,ENG,MF,Newcastle Utd,Premier League,21,1997,15.3,35,19,17,16,2,20,50,40.0,30,23,5,18,19,54,20,2,0,2019-2020,90.0,111.76470588235293,205.88235294117646
1443,Ademola Lookman,NGA,"FW,MF",RB Leipzig,Bundesliga,21,1997,3.4,6,4,3,1,2,1,1,100.0,0,3,0,3,1,7,0,1,0,2019-2020,90.0,26.470588235294116,158.8235294117647
1444,Anthony Lopes,POR,GK,Lyon,Ligue 1,28,1990,26.0,0,0,0,0,0,0,0,0.0,0,0,0,0,1,1,11,0,0,2019-2020,90.00000000000001,3.4615384615384617,0.0
1445,Rony Lopes,POR,FW,Sevilla,La Liga,23,1995,1.5,0,0,0,0,0,0,0,0.0,0,0,0,0,2,2,0,0,0,2019-2020,90.0,120.0,0.0
1446,Rony Lopes,POR,FW,Monaco,Ligue 1,23,1995,0.9,1,0,0,1,0,0,0,0.0,0,0,0,0,0,1,0,0,0,2019-2020,90.0,0.0,100.0
1447,Adrián López,ESP,FW,Osasuna,La Liga,31,1988,16.0,7,5,1,5,1,2,19,10.5,17,6,2,4,4,11,8,0,0,2019-2020,90.0,22.5,39.375
1448,David López,ESP,"DF,MF",Espanyol,La Liga,29,1989,27.3,38,20,15,20,3,13,41,31.7,28,28,13,15,35,73,63,3,0,2019-2020,90.0,115.38461538461539,125.27472527472527
1449,Diego López,ESP,GK,Espanyol,La Liga,37,1981,35.9,2,2,2,0,0,1,2,50.0,1,0,0,0,2,4,8,1,0,2019-2020,90.0,5.013927576601672,5.013927576601672
1450,Javi López,ESP,DF,Alavés,La Liga,17,2002,1.0,6,5,4,2,0,4,5,80.0,1,1,1,0,1,7,5,0,0,2019-2020,90.0,90.0,540.0
Rk,Player,Nation,Pos,Squad,Comp,0,0,90.0,0,0,3,3,3,Tkl,0,0.0,0,0,0,0,0,0,0,0,0,2019-2020,90.0,0.0,0.0
1451,Javi López,ESP,DF,Espanyol,La Liga,33,1986,15.4,47,34,23,18,6,19,40,47.5,21,12,6,6,21,68,38,2,0,2019-2020,90.0,122.72727272727273,274.6753246753247
1452,Lluis López,ESP,DF,Espanyol,La Liga,22,1997,3.3,4,2,3,1,0,2,2,100.0,0,4,0,4,1,5,6,1,0,2019-2020,90.0,27.272727272727273,109.0909090909091
1453,Maxime Lopez,FRA,"MF,FW",Marseille,Ligue 1,21,1997,12.3,16,10,5,8,3,4,26,15.4,22,8,2,6,8,24,1,0,0,2019-2020,89.99999999999999,58.536585365853654,117.07317073170731
1454,Pau López,ESP,GK,Roma,Serie A,24,1994,32.0,1,0,1,0,0,1,5,20.0,4,0,0,0,1,2,10,3,0,2019-2020,90.0,2.8125,2.8125
1455,Roberto López,ESP,"FW,MF",Real Sociedad,La Liga,19,2000,0.6,4,2,1,1,2,2,2,100.0,0,0,0,0,0,4,0,0,0,2019-2020,90.0,0.0,600.0
1456,Unai López,ESP,MF,Athletic Club,La Liga,23,1995,19.9,30,22,8,18,4,10,41,24.4,31,13,2,11,18,48,12,1,0,2019-2020,90.0,81.4070351758794,135.678391959799
1457,Iker Losada,ESP,"MF,FW",Celta Vigo,La Liga,17,2001,0.1,0,0,0,0,0,0,0,0.0,0,0,0,0,0,0,0,0,0,2019-2020,90.0,0.0,0.0
1458,Albert Lottin,FRA,MF,Bordeaux,Ligue 1,17,2001,0.5,2,0,2,0,0,1,4,25.0,3,0,0,0,2,4,2,0,0,2019-2020,90.0,360.0,360.0
1459,Imran Louza,MAR,"MF,FW",Nantes,Ligue 1,20,1999,22.3,53,27,18,27,8,19,46,41.3,27,18,2,16,17,70,7,0,0,2019-2020,90.0,68.60986547085201,213.9013452914798
1460,Matteo Lovato,ITA,DF,Hellas Verona,Serie A,19,2000,0.1,0,0,0,0,0,0,0,0.0,0,0,0,0,0,0,1,0,0,2019-2020,90.0,0.0,0.0
1461,Dejan Lovren,CRO,DF,Liverpool,Premier League,30,1989,8.6,13,8,10,3,0,7,12,58.3,5,9,6,3,10,23,42,0,0,2019-2020,90.0,104.65116279069768,136.046511627907
1462,Eduard Löwen,GER,MF,Augsburg,Bundesliga,22,1997,7.5,10,8,6,2,2,6,18,33.3,12,11,2,9,5,15,7,0,0,2019-2020,90.0,60.0,120.0
1463,Eduard Löwen,GER,MF,Hertha BSC,Bundesliga,22,1997,3.5,9,6,3,6,0,5,11,45.5,6,2,1,1,7,16,2,0,0,2019-2020,90.0,180.0,231.42857142857142
1464,Matthew Lowton,ENG,DF,Burnley,Premier League,30,1989,17.0,41,22,20,18,3,22,33,66.7,11,20,6,14,27,68,57,1,0,2019-2020,90.0,142.94117647058823,217.05882352941177
1465,Hirving Lozano,MEX,"FW,MF",Napoli,Serie A,24,1995,11.4,6,4,1,5,0,2,15,13.3,13,13,0,13,5,11,5,0,0,2019-2020,90.0,39.473684210526315,47.368421052631575
1466,Pol Lozano,ESP,MF,Espanyol,La Liga,19,1999,1.9,5,3,3,2,0,3,7,42.9,4,3,0,3,1,6,2,0,0,2019-2020,90.0,47.368421052631575,236.8421052631579
1467,Jan Luca Rumpf,GER,DF,Paderborn 07,Bundesliga,20,1999,1.0,0,0,0,0,0,0,0,0.0,0,0,0,0,0,0,2,0,0,2019-2020,90.0,0.0,0.0
1468,Jean Lucas,BRA,MF,Lyon,Ligue 1,21,1998,2.2,16,7,8,5,3,2,9,22.2,7,2,2,0,2,18,0,0,0,2019-2020,90.0,81.81818181818181,654.5454545454545
1469,Fabio Lucioni,ITA,DF,Lecce,Serie A,31,1987,34.8,29,13,20,9,0,14,32,43.8,18,48,38,10,36,65,169,5,0,2019-2020,90.0,93.10344827586206,75.0
1470,José Luis Gayà,ESP,DF,Valencia,La Liga,24,1995,22.1,44,30,29,12,3,28,41,68.3,13,22,9,13,18,62,48,1,0,2019-2020,90.0,73.30316742081448,179.18552036199094
1471,José Luis Morales,ESP,"FW,MF",Levante,La Liga,32,1987,28.0,17,8,5,9,3,6,34,17.6,28,14,1,13,6,23,5,1,0,2019-2020,90.0,19.285714285714285,54.64285714285714
1472,José Luis Palomino,ARG,DF,Atalanta,Serie A,29,1990,27.6,81,44,46,33,2,28,54,51.9,26,39,14,25,61,142,74,2,0,2019-2020,90.0,198.91304347826085,264.1304347826087
1473,José Luis Rodríguez,PAN,FW,Alavés,La Liga,21,1998,0.2,0,0,0,0,0,0,2,0.0,2,0,0,0,0,0,0,0,0,2019-2020,90.0,0.0,0.0
1474,David Luiz,BRA,DF,Arsenal,Premier League,32,1987,31.2,28,16,14,14,0,13,24,54.2,11,42,37,5,32,60,133,2,0,2019-2020,90.0,92.3076923076923,80.76923076923076
1475,Douglas Luiz,BRA,MF,Aston Villa,Premier League,21,1998,29.0,46,24,25,17,4,19,65,29.2,46,42,15,27,36,82,54,1,0,2019-2020,90.0,111.72413793103448,142.75862068965517
Rk,Player,Nation,Pos,Squad,Comp,0,0,90.0,0,0,3,3,3,Tkl,0,0.0,0,0,0,0,0,0,0,0,0,2019-2020,90.0,0.0,0.0
1476,Jordan Lukaku,BEL,DF,Lazio,Serie A,25,1994,4.4,4,2,1,1,2,2,4,50.0,2,2,1,1,0,4,9,0,0,2019-2020,90.0,0.0,81.81818181818181
1477,Romelu Lukaku,BEL,FW,Inter,Serie A,26,1993,33.1,13,7,4,7,2,3,10,30.0,7,14,6,8,1,14,28,0,0,2019-2020,90.0,2.7190332326283984,35.34743202416918
1478,Dodi Lukebakio,BEL,"FW,MF",Hertha BSC,Bundesliga,21,1997,22.6,25,18,13,8,4,10,28,35.7,18,22,4,18,10,35,14,0,0,2019-2020,90.0,39.823008849557525,99.5575221238938
1479,Saša Lukić,SRB,MF,Torino,Serie A,22,1996,20.7,29,17,8,19,2,10,35,28.6,25,21,7,14,29,58,15,0,0,2019-2020,90.0,126.08695652173914,126.08695652173914
1480,Senad Lulić,BIH,DF,Lazio,Serie A,33,1986,17.5,21,13,10,7,4,11,41,26.8,30,20,4,16,21,42,28,1,0,2019-2020,90.0,108.0,108.0
1481,John Lundstram,ENG,MF,Sheffield Utd,Premier League,25,1994,27.3,46,30,18,21,7,21,65,32.3,44,18,4,14,33,79,46,1,0,2019-2020,90.0,108.79120879120879,151.64835164835165
1482,Sebastiano Luperto,ITA,DF,Napoli,Serie A,22,1996,5.9,12,9,7,3,2,6,9,66.7,3,5,3,2,6,18,16,0,0,2019-2020,90.0,91.52542372881355,183.0508474576271
1483,Arnaud Lusamba,COD,"MF,FW",Nice,Ligue 1,22,1997,10.9,20,11,8,10,2,7,23,30.4,16,9,0,9,5,25,6,1,0,2019-2020,90.0,41.28440366972477,165.13761467889907
1484,Andreas Luthe,GER,GK,Augsburg,Bundesliga,32,1987,10.0,1,0,1,0,0,1,2,50.0,1,0,0,0,0,1,5,1,0,2019-2020,90.0,0.0,9.0
1485,Lyanco,BRA,DF,Torino,Serie A,22,1997,13.1,23,13,9,12,2,7,13,53.8,6,29,19,10,23,46,54,2,0,2019-2020,90.0,158.01526717557252,158.01526717557252
1486,Charalambos Lykogiannis,GRE,DF,Cagliari,Serie A,25,1993,14.9,14,9,9,3,2,7,18,38.9,11,25,9,16,23,37,71,0,0,2019-2020,90.0,138.92617449664428,84.56375838926174
1487,Yann M'Vila,FRA,"MF,DF",Saint-Étienne,Ligue 1,29,1990,21.6,29,14,12,16,1,12,43,27.9,31,14,4,10,40,69,47,1,0,2019-2020,90.0,166.66666666666666,120.83333333333333
1488,Alexis Mac Allister,ARG,"MF,FW",Brighton,Premier League,20,1998,3.9,9,5,4,3,2,5,9,55.6,4,12,0,12,1,10,2,0,0,2019-2020,90.0,23.076923076923077,207.69230769230768
1489,Darwin Machís,VEN,"FW,MF",Granada,La Liga,26,1993,23.7,23,13,11,8,4,8,23,34.8,15,22,4,18,31,54,9,0,0,2019-2020,90.0,117.72151898734178,87.34177215189874
1490,Yvann Macon,FRA,DF,Saint-Étienne,Ligue 1,20,1998,1.1,0,0,0,0,0,0,1,0.0,1,2,0,2,3,3,4,0,0,2019-2020,90.0,245.45454545454544,0.0
1491,James Maddison,ENG,MF,Leicester City,Premier League,22,1996,29.2,59,30,13,31,15,23,68,33.8,45,16,0,16,9,68,7,1,0,2019-2020,90.0,27.73972602739726,181.84931506849315
1492,Gabriel Magalhães,BRA,DF,Lille,Ligue 1,21,1997,23.2,41,29,27,11,3,15,22,68.2,7,27,18,9,22,63,86,2,0,2019-2020,90.0,85.3448275862069,159.05172413793105
1493,Lisandro Magallán,ARG,DF,Alavés,La Liga,25,1993,13.3,22,15,10,12,0,8,14,57.1,6,17,6,11,16,38,43,1,0,2019-2020,90.0,108.27067669172932,148.8721804511278
1494,Francesco Magnanelli,ITA,MF,Sassuolo,Serie A,34,1984,15.5,25,13,9,12,4,11,35,31.4,24,12,6,6,19,44,23,1,0,2019-2020,90.0,110.3225806451613,145.16129032258064
1495,Giangiacomo Magnani,ITA,DF,Brescia,Serie A,23,1995,1.3,0,0,0,0,0,0,1,0.0,1,2,2,0,2,2,6,0,0,2019-2020,90.0,138.46153846153845,0.0
1496,Giangiacomo Magnani,ITA,DF,Sassuolo,Serie A,23,1995,1.6,0,0,0,0,0,0,0,0.0,0,2,1,1,2,2,7,0,0,2019-2020,90.0,112.5,0.0
1497,Hugo Magnetti,FRA,MF,Brest,Ligue 1,21,1998,2.6,16,10,7,7,2,5,9,55.6,4,4,0,4,7,23,4,0,0,2019-2020,90.0,242.3076923076923,553.8461538461538
1498,Harry Maguire,ENG,DF,Manchester Utd,Premier League,26,1993,38.0,37,23,23,14,0,18,34,52.9,16,31,22,9,72,109,159,0,0,2019-2020,90.0,170.52631578947367,87.63157894736842
1499,Abdallahi Mahmoud,MTN,MF,Alavés,La Liga,19,2000,1.7,4,4,2,1,1,1,6,16.7,5,0,0,0,5,9,2,0,0,2019-2020,90.0,264.70588235294116,211.76470588235293
1500,Riyad Mahrez,ALG,"FW,MF",Manchester City,Premier League,28,1991,21.6,28,14,11,9,8,11,38,28.9,27,31,1,30,18,46,8,2,0,2019-2020,90.0,75.0,116.66666666666666
Rk,Player,Nation,Pos,Squad,Comp,0,0,90.0,0,0,3,3,3,Tkl,0,0.0,0,0,0,0,0,0,0,0,0,2019-2020,90.0,0.0,0.0
1501,Thiago Maia,BRA,MF,Lille,Ligue 1,22,1997,0.5,4,4,1,3,0,0,1,0.0,1,0,0,0,1,5,1,0,0,2019-2020,90.0,180.0,720.0
1502,Arne Maier,GER,MF,Hertha BSC,Bundesliga,20,1999,5.9,9,7,6,1,2,1,10,10.0,9,5,0,5,7,16,2,1,0,2019-2020,90.0,106.77966101694915,137.28813559322032
1503,Habib Maïga,CIV,MF,Metz,Ligue 1,23,1996,25.2,84,50,36,38,10,24,64,37.5,40,39,4,35,34,118,39,2,0,2019-2020,90.0,121.42857142857144,300.00000000000006
1504,Mike Maignan,FRA,GK,Lille,Ligue 1,24,1995,28.0,0,0,0,0,0,0,0,0.0,0,0,0,0,2,2,5,0,0,2019-2020,90.0,6.428571428571429,0.0
1505,Ainsley Maitland-Niles,ENG,DF,Arsenal,Premier League,21,1997,15.4,41,23,34,5,2,22,43,51.2,21,12,3,9,28,69,38,0,0,2019-2020,90.0,163.63636363636365,239.61038961038963
1506,Josh Maja,NGA,FW,Bordeaux,Ligue 1,20,1998,8.2,5,2,0,2,3,1,10,10.0,9,8,4,4,1,6,3,0,0,2019-2020,90.0,10.975609756097562,54.87804878048781
1507,Abdul Majeed Waris,GHA,FW,Strasbourg,Ligue 1,27,1991,4.1,6,4,4,2,0,3,8,37.5,5,2,0,2,4,10,0,0,0,2019-2020,90.0,87.8048780487805,131.70731707317074
1508,Žan Majer,SVN,MF,Lecce,Serie A,27,1992,18.5,39,18,19,12,8,17,56,30.4,39,27,6,21,26,65,18,1,0,2019-2020,90.0,126.4864864864865,189.72972972972974
1509,Jean-Victor Makengo,FRA,MF,Toulouse,Ligue 1,21,1998,11.0,14,11,3,10,1,4,13,30.8,9,7,1,6,3,17,5,1,0,2019-2020,90.0,24.545454545454547,114.54545454545455
1510,Nemanja Maksimović,SRB,MF,Getafe,La Liga,24,1995,32.2,49,28,12,31,6,10,44,22.7,34,37,7,30,56,105,30,1,0,2019-2020,90.0,156.52173913043478,136.95652173913044
1511,Nikola Maksimović,SRB,DF,Napoli,Serie A,27,1991,20.0,35,24,21,14,0,10,21,47.6,11,19,11,8,30,65,64,1,0,2019-2020,90.0,135.0,157.5
1512,Kévin Malcuit,MAR,DF,Napoli,Serie A,28,1991,2.8,8,6,4,3,1,5,6,83.3,1,4,1,3,3,11,2,0,0,2019-2020,90.0,96.42857142857143,257.14285714285717
1513,Daniel Maldini,ITA,"FW,MF",Milan,Serie A,17,2001,0.3,0,0,0,0,0,0,2,0.0,2,1,0,1,1,1,0,0,0,2019-2020,90.0,300.0,0.0
1514,Ruslan Malinovskyi,UKR,"MF,FW",Atalanta,Serie A,26,1993,17.1,22,14,2,17,3,9,31,29.0,22,13,2,11,5,27,5,0,0,2019-2020,90.0,26.31578947368421,115.78947368421052
1515,Yunus Mallı,TUR,"MF,FW",Union Berlin,Bundesliga,27,1992,7.5,8,3,1,5,2,5,10,50.0,5,2,0,2,7,15,7,0,0,2019-2020,90.0,84.0,96.0
1516,Hugo Mallo,ESP,DF,Celta Vigo,La Liga,28,1991,21.8,62,42,44,16,2,27,48,56.3,21,24,8,16,22,84,97,1,0,2019-2020,90.0,90.82568807339449,255.96330275229357
1517,Streli Mamba,GER,FW,Paderborn 07,Bundesliga,25,1994,16.9,15,9,0,9,6,1,13,7.7,12,12,2,10,6,21,2,0,0,2019-2020,90.0,31.952662721893493,79.88165680473374
1518,Hianga Mananga Mbock,FRA,MF,Brest,Ligue 1,19,1999,1.6,1,1,1,0,0,0,0,0.0,0,0,0,0,4,5,0,0,0,2019-2020,90.0,225.0,56.25
1519,Vincent Manceau,FRA,DF,Angers,Ligue 1,30,1989,22.0,34,22,18,13,3,16,36,44.4,20,16,3,13,22,56,51,0,0,2019-2020,90.0,90.0,139.0909090909091
1520,Gianluca Mancini,ITA,"DF,MF",Roma,Serie A,23,1996,30.4,49,26,26,18,5,22,44,50.0,22,32,15,17,60,109,98,1,0,2019-2020,90.0,177.6315789473684,145.06578947368422
1521,Marco Mancosu,ITA,"MF,FW",Lecce,Serie A,30,1988,27.1,32,18,11,16,5,10,46,21.7,36,34,9,25,16,48,15,1,0,2019-2020,90.0,53.13653136531365,106.2730627306273
1522,Steve Mandanda,FRA,GK,Marseille,Ligue 1,34,1985,26.3,3,1,3,0,0,3,4,75.0,1,0,0,0,1,4,2,4,0,2019-2020,90.0,3.4220532319391634,10.26615969581749
1523,Reinildo Mandava,MOZ,"DF,MF",Lille,Ligue 1,25,1994,12.3,37,21,23,11,3,25,41,61.0,16,16,1,15,19,56,20,0,0,2019-2020,89.99999999999999,139.02439024390242,270.73170731707313
1524,Aïssa Mandi,ALG,DF,Betis,La Liga,27,1991,28.6,33,15,22,8,3,18,28,64.3,10,29,15,14,38,71,93,0,0,2019-2020,90.0,119.58041958041959,103.84615384615385
1525,Rolando Mandragora,ITA,MF,Udinese,Serie A,22,1997,22.8,47,24,15,25,7,15,55,27.3,40,30,5,25,26,73,25,0,0,2019-2020,90.0,102.63157894736841,185.52631578947367
Rk,Player,Nation,Pos,Squad,Comp,0,0,90.0,0,0,3,3,3,Tkl,0,0.0,0,0,0,0,0,0,0,0,0,2019-2020,90.0,0.0,0.0
1526,Sadio Mané,SEN,FW,Liverpool,Premier League,27,1992,30.5,44,32,9,20,15,13,40,32.5,27,19,0,19,13,57,11,2,0,2019-2020,90.0,38.36065573770492,129.8360655737705
1527,Eliaquim Mangala,FRA,DF,Valencia,La Liga,28,1991,7.5,4,4,3,1,0,1,2,50.0,1,7,6,1,7,11,40,0,0,2019-2020,90.0,84.0,48.0
1528,Thomas Mangani,FRA,MF,Angers,Ligue 1,32,1987,20.8,33,23,15,16,2,14,47,29.8,33,17,2,15,12,45,20,1,0,2019-2020,90.0,51.92307692307692,142.78846153846152
1529,Massimiliano Mangraviti,ITA,DF,Brescia,Serie A,21,1998,10.8,8,6,1,6,1,3,6,50.0,3,11,6,5,8,16,43,0,0,2019-2020,90.0,66.66666666666666,66.66666666666666
1530,Kostas Manolas,GRE,DF,Napoli,Serie A,28,1991,24.2,23,15,13,10,0,10,17,58.8,7,19,14,5,25,48,76,1,0,2019-2020,90.0,92.97520661157024,85.53719008264463
1531,Javier Manquillo,ESP,DF,Newcastle Utd,Premier League,25,1994,17.8,39,26,27,8,4,24,38,63.2,14,14,2,12,18,57,56,0,0,2019-2020,90.0,91.01123595505618,197.19101123595505
1532,Giacomo Manzari,ITA,"FW,MF",Sassuolo,Serie A,18,2000,0.2,0,0,0,0,0,0,0,0.0,0,0,0,0,0,0,0,0,0,2019-2020,90.0,0.0,0.0
1533,Myziane Maolida,COM,"FW,MF",Nice,Ligue 1,20,1999,7.5,14,10,5,6,3,5,12,41.7,7,8,0,8,3,17,3,0,0,2019-2020,90.0,36.0,168.0
1534,Faitout Maouassa,FRA,DF,Rennes,Ligue 1,21,1998,20.0,51,33,27,20,4,14,26,53.8,12,13,5,8,23,74,59,0,0,2019-2020,90.0,103.5,229.5
1535,Fernando Marçal,BRA,DF,Lyon,Ligue 1,30,1989,9.2,28,18,18,7,3,13,26,50.0,13,7,3,4,26,54,32,0,0,2019-2020,90.0,254.34782608695653,273.9130434782609
1536,Marcelo,BRA,DF,Real Madrid,La Liga,31,1988,14.4,19,11,8,8,3,9,28,32.1,19,19,2,17,18,37,21,0,0,2019-2020,90.0,112.5,118.75
1537,Marcelo,BRA,DF,Lyon,Ligue 1,32,1987,16.7,27,18,18,8,1,16,23,69.6,7,12,11,1,22,49,77,0,0,2019-2020,90.0,118.562874251497,145.50898203592814
1538,Solly March,ENG,"FW,MF",Brighton,Premier League,25,1994,12.7,25,12,16,6,3,9,19,47.4,10,16,4,12,20,45,14,2,0,2019-2020,90.0,141.73228346456693,177.16535433070868
1539,Gian Marco Ferrari,ITA,DF,Sassuolo,Serie A,27,1992,21.1,9,5,6,3,0,4,8,50.0,4,25,22,3,26,35,41,1,0,2019-2020,90.0,110.90047393364928,38.38862559241706
1540,Óscar de Marcos,ESP,"DF,FW",Athletic Club,La Liga,30,1989,6.0,5,3,2,1,2,3,6,50.0,3,6,0,6,8,13,8,0,0,2019-2020,90.0,120.0,75.0
1541,Dario Maresic,AUT,DF,Reims,Ligue 1,19,1999,1.0,0,0,0,0,0,0,0,0.0,0,1,1,0,1,1,6,0,0,2019-2020,90.0,90.0,0.0
1542,Miguel Marí,ESP,MF,Eibar,La Liga,22,1997,0.1,0,0,0,0,0,0,0,0.0,0,0,0,0,0,0,0,0,0,2019-2020,90.0,0.0,0.0
1543,Pablo Marí,ESP,DF,Arsenal,Premier League,25,1993,1.3,2,1,2,0,0,0,0,0.0,0,0,0,0,1,3,10,0,0,2019-2020,90.0,69.23076923076923,138.46153846153845
1544,José María Giménez,URU,DF,Atlético Madrid,La Liga,24,1995,19.5,20,16,18,1,1,7,11,63.6,4,14,7,7,23,43,75,1,0,2019-2020,90.0,106.15384615384615,92.3076923076923
1545,Mariano,DOM,"FW,MF",Real Madrid,La Liga,25,1993,0.5,0,0,0,0,0,0,1,0.0,1,0,0,0,0,0,0,0,0,2019-2020,90.0,0.0,0.0
1546,Adrian Mariappa,JAM,DF,Watford,Premier League,32,1986,16.8,20,14,15,4,1,11,30,36.7,19,22,7,15,11,31,73,0,0,2019-2020,90.0,58.92857142857142,107.14285714285714
1547,Jordan Marié,FRA,"MF,FW",Dijon,Ligue 1,27,1991,2.2,7,5,4,3,0,4,9,44.4,5,3,1,2,4,11,2,0,0,2019-2020,90.0,163.63636363636363,286.3636363636364
1548,Federico Marigosu,ITA,MF,Cagliari,Serie A,18,2001,0.3,0,0,0,0,0,0,0,0.0,0,0,0,0,0,0,1,0,0,2019-2020,90.0,0.0,0.0
1549,Adrián Marín,ESP,DF,Alavés,La Liga,22,1997,9.5,22,15,14,6,2,13,15,86.7,2,13,4,9,13,35,32,0,0,2019-2020,90.0,123.15789473684211,208.42105263157896
1550,Guillermo Maripán,CHI,DF,Alavés,La Liga,25,1994,1.0,1,1,1,0,0,1,2,50.0,1,0,0,0,2,3,10,0,0,2019-2020,90.0,180.0,90.0
Rk,Player,Nation,Pos,Squad,Comp,0,0,90.0,0,0,3,3,3,Tkl,0,0.0,0,0,0,0,0,0,0,0,0,2019-2020,90.0,0.0,0.0
1551,Guillermo Maripán,CHI,DF,Monaco,Ligue 1,25,1994,19.5,42,26,28,13,1,24,41,58.5,17,30,13,17,25,67,69,2,0,2019-2020,90.0,115.38461538461539,193.84615384615384
1552,Marlon,BRA,DF,Sassuolo,Serie A,23,1995,20.2,40,23,24,15,1,17,27,63.0,10,20,13,7,35,75,69,0,0,2019-2020,90.0,155.94059405940595,178.21782178217822
1553,Omar Marmoush,EGY,"MF,FW",Wolfsburg,Bundesliga,20,1999,0.9,1,1,1,0,0,0,0,0.0,0,1,0,1,1,2,0,0,0,2019-2020,90.0,100.0,100.0
1554,Gonzalo Maroni,ARG,"MF,FW",Sampdoria,Serie A,20,1999,2.0,3,1,1,1,1,3,7,42.9,4,1,0,1,3,6,0,0,0,2019-2020,90.0,135.0,135.0
1555,Marquinhos,BRA,"MF,DF",Paris S-G,Ligue 1,25,1994,16.4,39,20,17,18,4,11,26,42.3,15,25,8,17,25,64,31,1,0,2019-2020,90.0,137.19512195121953,214.02439024390247
1556,Bruno Martella,ITA,DF,Brescia,Serie A,26,1992,14.1,18,9,14,3,1,9,16,56.3,7,13,7,6,17,35,48,1,0,2019-2020,89.99999999999999,108.51063829787233,114.89361702127658
1557,Roger Martí,ESP,FW,Levante,La Liga,28,1991,25.2,18,11,8,7,3,7,29,24.1,22,14,0,14,6,24,17,0,0,2019-2020,90.0,21.42857142857143,64.28571428571429
1558,Anthony Martial,FRA,FW,Manchester Utd,Premier League,23,1995,29.2,15,12,1,4,10,1,16,6.3,15,18,1,17,5,20,17,0,0,2019-2020,90.0,15.41095890410959,46.23287671232877
1559,Aarón Martín,ESP,DF,Mainz 05,Bundesliga,22,1997,19.9,29,15,17,8,4,9,22,40.9,13,11,5,6,30,59,36,0,0,2019-2020,90.0,135.678391959799,131.15577889447238
1560,Daniel Martín,ESP,GK,Betis,La Liga,21,1998,5.9,0,0,0,0,0,0,0,0.0,0,0,0,0,0,0,3,0,0,2019-2020,90.0,0.0,0.0
1561,David Martin,ENG,GK,West Ham,Premier League,33,1986,4.8,0,0,0,0,0,0,0,0.0,0,0,0,0,0,0,1,1,0,2019-2020,90.0,0.0,0.0
1562,Jonas Martin,FRA,MF,Rennes,Ligue 1,29,1990,1.3,6,2,4,0,2,1,1,100.0,0,2,2,0,0,6,0,0,0,2019-2020,90.0,0.0,415.38461538461536
1563,Jonas Martin,FRA,MF,Strasbourg,Ligue 1,29,1990,2.7,5,3,4,0,1,1,3,33.3,2,3,0,3,1,6,3,0,0,2019-2020,90.0,33.33333333333333,166.66666666666666
1564,Josh Martin,ENG,"FW,MF",Norwich City,Premier League,17,2001,0.4,1,0,0,0,1,0,0,0.0,0,1,0,1,1,2,0,0,0,2019-2020,90.0,225.0,225.0
1565,Gabriel Martinelli,BRA,FW,Arsenal,Premier League,18,2001,7.4,20,15,10,6,4,7,20,35.0,13,15,1,14,3,23,8,0,0,2019-2020,90.0,36.486486486486484,243.24324324324323
1566,Álex Martínez,ESP,DF,Granada,La Liga,28,1990,0.2,0,0,0,0,0,0,0,0.0,0,0,0,0,0,0,0,0,0,2019-2020,90.0,0.0,0.0
1567,Emiliano Martínez,ARG,GK,Arsenal,Premier League,26,1992,8.6,0,0,0,0,0,0,0,0.0,0,0,0,0,0,0,1,0,0,2019-2020,90.0,0.0,0.0
1568,Iñigo Martínez,ESP,DF,Athletic Club,La Liga,28,1991,33.0,48,30,33,13,2,27,47,57.4,20,28,13,15,39,87,140,0,0,2019-2020,90.0,106.36363636363637,130.9090909090909
1569,Javi Martínez,ESP,MF,Osasuna,La Liga,19,1999,0.1,0,0,0,0,0,0,0,0.0,0,0,0,0,0,0,1,0,0,2019-2020,90.0,0.0,0.0
1570,Javi Martínez,ESP,"DF,MF",Bayern Munich,Bundesliga,30,1988,7.5,16,12,9,7,0,9,11,81.8,2,9,8,1,18,34,30,0,0,2019-2020,90.0,216.0,192.0
1571,José Martínez,ESP,DF,Granada,La Liga,26,1993,13.2,21,16,12,8,1,14,25,56.0,11,6,4,2,18,39,46,0,0,2019-2020,90.0,122.72727272727273,143.1818181818182
1572,Lautaro Martínez,ARG,FW,Inter,Serie A,21,1997,27.2,22,7,2,8,12,4,34,11.8,30,30,2,28,15,37,11,0,0,2019-2020,90.0,49.63235294117647,72.79411764705883
1573,Pablo Martínez,ESP,MF,Levante,La Liga,21,1998,0.4,2,0,1,1,0,0,1,0.0,1,0,0,0,0,2,2,0,0,2019-2020,90.0,0.0,450.0
1574,Pablo Martinez,FRA,DF,Nîmes,Ligue 1,30,1989,26.0,42,21,26,15,1,21,40,52.5,19,34,22,12,58,100,97,0,0,2019-2020,90.00000000000001,200.7692307692308,145.3846153846154
1575,Gelson Martins,POR,"DF,FW",Monaco,Ligue 1,24,1995,18.6,30,22,11,15,4,17,42,40.5,25,9,2,7,19,49,10,1,0,2019-2020,90.0,91.93548387096773,145.16129032258064
Rk,Player,Nation,Pos,Squad,Comp,0,0,90.0,0,0,3,3,3,Tkl,0,0.0,0,0,0,0,0,0,0,0,0,2019-2020,90.0,0.0,0.0
1576,Adam Marušić,MNE,DF,Lazio,Serie A,26,1992,10.5,11,6,7,4,0,4,11,36.4,7,14,2,12,14,25,16,0,0,2019-2020,90.0,120.0,94.28571428571428
1577,Omar Mascarell,EQG,MF,Schalke 04,Bundesliga,26,1993,22.5,42,23,17,22,3,21,57,36.8,36,46,14,32,62,104,40,0,0,2019-2020,90.0,248.0,168.0
1578,Andrea Masiello,ITA,DF,Genoa,Serie A,33,1986,14.7,26,15,17,8,1,16,32,50.0,16,8,2,6,26,52,55,2,0,2019-2020,90.0,159.18367346938777,159.18367346938777
1579,Andrea Masiello,ITA,DF,Atalanta,Serie A,33,1986,6.0,11,4,6,4,1,7,14,50.0,7,6,4,2,10,21,13,0,0,2019-2020,90.0,150.0,165.0
1580,Adam Masina,MAR,DF,Watford,Premier League,25,1994,20.2,38,22,24,11,3,14,37,37.8,23,26,12,14,28,66,66,0,0,2019-2020,90.0,124.75247524752476,169.30693069306932
1581,Jordi Masip,ESP,GK,Valladolid,La Liga,30,1989,35.0,1,1,1,0,0,0,2,0.0,2,0,0,0,1,2,7,3,0,2019-2020,90.0,2.571428571428571,2.571428571428571
1582,Arthur Masuaku,COD,DF,West Ham,Premier League,25,1993,10.4,41,23,24,13,4,23,39,59.0,16,19,5,14,14,55,23,0,0,2019-2020,90.0,121.15384615384615,354.80769230769226
1583,Jaime Mata,ESP,FW,Getafe,La Liga,30,1988,30.5,21,13,3,11,7,3,20,15.0,17,16,1,15,7,28,15,0,0,2019-2020,90.0,20.65573770491803,61.967213114754095
1584,Juan Mata,ESP,"MF,FW",Manchester Utd,Premier League,31,1988,8.4,7,3,1,5,1,2,7,28.6,5,5,1,4,0,7,2,0,0,2019-2020,90.0,0.0,75.0
1585,Aleš Matějů,CZE,DF,Brescia,Serie A,23,1996,28.3,48,27,33,9,6,23,45,51.1,22,41,24,17,37,85,109,3,0,2019-2020,90.0,117.66784452296818,152.6501766784452
1586,Jean-Philippe Mateta,FRA,FW,Mainz 05,Bundesliga,22,1997,11.7,2,2,0,2,0,0,6,0.0,6,3,2,1,1,3,11,0,0,2019-2020,89.99999999999999,7.692307692307692,15.384615384615383
1587,Nemanja Matić,SRB,MF,Manchester Utd,Premier League,30,1988,17.6,46,24,23,19,4,20,43,46.5,23,21,8,13,22,68,28,1,0,2019-2020,90.0,112.5,235.22727272727272
1588,Joël Matip,CMR,DF,Liverpool,Premier League,27,1991,7.8,13,9,4,7,2,4,11,36.4,7,8,4,4,12,25,38,0,0,2019-2020,90.0,138.46153846153845,150.0
1589,Rabbi Matondo,WAL,"FW,MF",Schalke 04,Bundesliga,18,2000,12.9,10,3,3,2,5,3,13,23.1,10,4,0,4,5,15,1,0,0,2019-2020,90.0,34.883720930232556,69.76744186046511
1590,Alessandro Matri,ITA,"FW,MF",Brescia,Serie A,34,1984,1.0,1,0,0,0,1,0,0,0.0,0,1,0,1,0,1,1,0,0,2019-2020,90.0,0.0,90.0
1591,Federico Mattiello,ITA,DF,Cagliari,Serie A,24,1995,10.3,30,21,19,7,4,11,27,40.7,16,20,7,13,18,48,22,0,0,2019-2020,90.0,157.28155339805826,262.13592233009706
1592,Blaise Matuidi,FRA,MF,Juventus,Serie A,32,1987,24.9,48,27,13,27,8,13,34,38.2,21,35,6,29,22,70,16,0,0,2019-2020,90.0,79.51807228915662,173.49397590361446
1593,Neal Maupay,FRA,FW,Brighton,Premier League,22,1996,30.7,20,12,1,13,6,9,29,31.0,20,24,0,24,4,24,10,0,0,2019-2020,90.0,11.726384364820849,58.63192182410424
1594,Stephy Mavididi,ENG,"FW,MF",Dijon,Ligue 1,21,1998,15.5,18,11,7,8,3,10,26,38.5,16,11,0,11,7,25,5,0,0,2019-2020,90.0,40.645161290322584,104.51612903225806
1595,Philipp Max,GER,DF,Augsburg,Bundesliga,25,1993,30.1,42,29,22,16,4,20,45,44.4,25,19,4,15,26,68,50,0,0,2019-2020,90.00000000000001,77.74086378737542,125.58139534883722
1596,Alexandru Maxim,ROU,"MF,DF",Mainz 05,Bundesliga,29,1990,1.3,4,2,1,2,1,1,3,33.3,2,0,0,0,1,5,1,0,0,2019-2020,90.0,69.23076923076923,276.9230769230769
1597,Eric Maxim Choupo-Moting,CMR,"FW,MF",Paris S-G,Ligue 1,30,1989,5.0,12,9,3,4,5,4,8,50.0,4,3,0,3,1,13,3,0,0,2019-2020,90.0,18.0,216.0
1598,Kévin Mayi,GAB,"FW,MF",Brest,Ligue 1,26,1993,0.0,0,0,0,0,0,0,0,0.0,0,0,0,0,0,0,0,0,0,2019-2020,,,
1599,Borja Mayoral,ESP,FW,Levante,La Liga,22,1997,23.8,12,3,4,6,2,2,13,15.4,11,11,0,11,4,16,6,0,0,2019-2020,90.00000000000001,15.126050420168069,45.378151260504204
1600,Luca Mazzitelli,ITA,MF,Sassuolo,Serie A,23,1995,0.1,1,1,0,1,0,1,1,100.0,0,0,0,0,0,1,0,0,0,2019-2020,90.0,0.0,900.0
Rk,Player,Nation,Pos,Squad,Comp,0,0,90.0,0,0,3,3,3,Tkl,0,0.0,0,0,0,0,0,0,0,0,0,2019-2020,90.0,0.0,0.0
1601,Kevin Mbabu,SUI,DF,Wolfsburg,Bundesliga,24,1995,18.8,69,48,39,24,6,35,54,64.8,19,33,10,23,23,92,53,0,0,2019-2020,90.0,110.1063829787234,330.31914893617017
1602,Kylian Mbappé,FRA,FW,Paris S-G,Ligue 1,20,1998,16.8,7,2,1,5,1,3,10,30.0,7,4,0,4,3,10,0,0,0,2019-2020,90.0,16.07142857142857,37.5
1603,Ibrahima Mbaye,SEN,DF,Bologna,Serie A,24,1994,16.7,19,10,13,4,2,7,17,41.2,10,22,11,11,15,34,42,0,0,2019-2020,90.0,80.83832335329342,102.39520958083833
1604,Loïc Mbe Soh,FRA,DF,Paris S-G,Ligue 1,18,2001,0.6,2,2,2,0,0,2,2,100.0,0,0,0,0,1,3,0,0,0,2019-2020,90.0,150.0,300.0
1605,Isaac Mbenza,BEL,FW,Amiens,Ligue 1,23,1996,0.9,0,0,0,0,0,0,1,0.0,1,0,0,0,0,0,0,0,0,2019-2020,90.0,0.0,0.0
1606,Nathanael Mbuku,FRA,"FW,MF",Reims,Ligue 1,17,2002,4.4,4,2,2,2,0,0,3,0.0,3,0,0,0,2,6,1,0,0,2019-2020,90.0,40.90909090909091,81.81818181818181
1607,James McArthur,SCO,MF,Crystal Palace,Premier League,31,1987,34.3,88,51,43,34,11,37,106,34.9,69,69,19,50,60,148,56,0,0,2019-2020,90.0,157.43440233236154,230.9037900874636
1608,Oliver McBurnie,SCO,FW,Sheffield Utd,Premier League,23,1996,23.5,37,22,6,27,4,11,40,27.5,29,25,3,22,15,52,43,0,0,2019-2020,90.0,57.44680851063829,141.70212765957447
1609,Alex McCarthy,ENG,GK,Southampton,Premier League,29,1989,28.0,1,1,1,0,0,1,1,100.0,0,1,0,1,0,1,11,3,0,2019-2020,90.0,0.0,3.2142857142857144
1610,James McCarthy,IRL,MF,Crystal Palace,Premier League,28,1990,18.7,82,47,36,36,10,40,76,52.6,36,24,5,19,24,106,11,0,0,2019-2020,90.0,115.50802139037432,394.6524064171123
1611,John McGinn,SCO,MF,Aston Villa,Premier League,24,1994,25.7,53,35,19,23,11,18,62,29.0,44,25,1,24,25,78,18,0,0,2019-2020,90.0,87.54863813229572,185.60311284046693
1612,David McGoldrick,IRL,FW,Sheffield Utd,Premier League,31,1987,20.2,41,26,9,24,8,5,20,25.0,15,14,2,12,3,44,23,0,0,2019-2020,90.0,13.366336633663366,182.67326732673268
1613,Michael McGovern,NIR,GK,Norwich City,Premier League,35,1984,1.8,0,0,0,0,0,0,0,0.0,0,0,0,0,0,0,1,1,0,2019-2020,90.0,0.0,0.0
1614,Weston McKennie,USA,"MF,DF",Schalke 04,Bundesliga,20,1998,23.0,38,20,17,16,5,13,40,32.5,27,38,12,26,46,84,39,0,0,2019-2020,90.0,180.0,148.69565217391306
1615,Kenny McLean,SCO,MF,Norwich City,Premier League,27,1992,33.0,44,29,20,18,6,14,42,33.3,28,32,7,25,38,82,67,2,0,2019-2020,90.0,103.63636363636364,120.00000000000001
1616,Dwight McNeil,ENG,MF,Burnley,Premier League,19,1999,37.1,47,33,18,22,7,23,71,32.4,48,60,8,52,30,77,34,0,0,2019-2020,90.0,72.77628032345014,114.01617250673854
1617,Scott McTominay,SCO,MF,Manchester Utd,Premier League,22,1996,19.7,43,22,14,25,4,17,32,53.1,15,25,5,20,31,74,34,2,0,2019-2020,90.0,141.62436548223351,196.44670050761422
1618,Biagio Meccariello,ITA,DF,Lecce,Serie A,28,1991,8.5,23,13,15,6,2,12,29,41.4,17,14,2,12,10,33,25,0,0,2019-2020,90.0,105.88235294117648,243.52941176470588
1619,Gary Medel,CHI,MF,Bologna,Serie A,31,1987,19.8,43,22,15,24,4,16,43,37.2,27,24,8,16,34,77,31,2,0,2019-2020,90.0,154.54545454545453,195.45454545454547
1620,Ben Mee,ENG,DF,Burnley,Premier League,29,1989,32.0,41,22,25,16,0,17,29,58.6,12,42,31,11,42,83,165,2,0,2019-2020,90.0,118.125,115.3125
1621,Joshua Mees,GER,"MF,FW",Union Berlin,Bundesliga,23,1996,3.6,8,5,3,4,1,4,12,33.3,8,3,0,3,2,10,4,0,0,2019-2020,90.0,50.0,200.0
1622,Admir Mehmedi,SUI,"MF,FW",Wolfsburg,Bundesliga,28,1991,13.3,14,6,2,9,3,4,15,26.7,11,10,0,10,5,19,4,0,0,2019-2020,90.0,33.83458646616541,94.73684210526315
1623,Soualiho Meïté,FRA,MF,Torino,Serie A,25,1994,24.5,32,18,14,13,5,12,35,34.3,23,31,6,25,24,56,36,0,0,2019-2020,90.00000000000001,88.16326530612245,117.55102040816328
1624,Farid El Melali,ALG,"MF,FW",Angers,Ligue 1,22,1997,3.4,7,5,2,2,3,4,14,28.6,10,5,0,5,2,9,4,0,0,2019-2020,90.0,52.94117647058823,185.2941176470588
1625,Óscar Melendo,ESP,"MF,FW",Espanyol,La Liga,21,1997,12.4,10,4,4,4,2,4,12,33.3,8,7,2,5,2,12,3,0,0,2019-2020,90.0,14.516129032258064,72.58064516129032
Rk,Player,Nation,Pos,Squad,Comp,0,0,90.0,0,0,3,3,3,Tkl,0,0.0,0,0,0,0,0,0,0,0,0,2019-2020,90.0,0.0,0.0
1626,Gonzalo Melero,ESP,MF,Levante,La Liga,25,1994,13.7,20,13,9,9,2,7,27,25.9,20,12,3,9,9,29,15,1,0,2019-2020,90.0,59.12408759124089,131.38686131386862
1627,Arthur Melo,BRA,MF,Barcelona,La Liga,22,1996,13.1,15,10,4,7,4,4,12,33.3,8,9,0,9,4,19,5,2,0,2019-2020,90.0,27.480916030534353,103.05343511450383
1628,Memphis,NED,"FW,MF",Lyon,Ligue 1,25,1994,11.3,4,3,2,0,2,0,5,0.0,5,0,0,0,2,6,2,0,0,2019-2020,90.0,15.929203539823009,31.858407079646017
1629,Pedro Mendes,POR,DF,Montpellier,Ligue 1,28,1990,15.3,28,17,15,13,0,15,24,62.5,9,19,12,7,28,56,42,1,0,2019-2020,90.0,164.70588235294116,164.70588235294116
1630,Thiago Mendes,BRA,MF,Lyon,Ligue 1,27,1992,20.1,43,29,20,19,4,21,45,46.7,24,21,7,14,46,89,36,0,0,2019-2020,90.0,205.97014925373134,192.5373134328358
1631,Brais Méndez,ESP,"MF,FW",Celta Vigo,La Liga,22,1997,16.4,26,11,14,9,3,12,39,30.8,27,20,0,20,12,38,23,1,0,2019-2020,90.0,65.85365853658537,142.6829268292683
1632,Édgar Méndez,ESP,"MF,FW",Alavés,La Liga,29,1990,9.6,11,7,4,6,1,5,13,38.5,8,10,2,8,5,16,7,0,0,2019-2020,90.0,46.875,103.125
1633,Stiven Mendoza,COL,"FW,MF",Amiens,Ligue 1,27,1992,12.2,12,7,4,5,3,4,22,18.2,18,13,2,11,9,21,3,1,0,2019-2020,90.0,66.39344262295083,88.52459016393443
1634,Alexandre Mendy,GNB,FW,Brest,Ligue 1,25,1994,10.0,5,1,1,0,4,1,4,25.0,3,4,1,3,0,5,10,0,0,2019-2020,90.0,0.0,45.0
1635,Benjamin Mendy,FRA,DF,Manchester City,Premier League,25,1994,16.6,18,15,7,7,4,9,27,33.3,18,10,2,8,16,34,21,3,0,2019-2020,90.0,86.74698795180721,97.59036144578312
1636,Edouard Mendy,SEN,GK,Rennes,Ligue 1,27,1992,24.0,0,0,0,0,0,0,0,0.0,0,0,0,0,0,0,5,1,0,2019-2020,90.0,0.0,0.0
1637,Ferland Mendy,FRA,DF,Real Madrid,La Liga,24,1995,20.1,32,26,20,9,3,14,18,77.8,4,19,5,14,22,54,30,1,0,2019-2020,90.0,98.50746268656715,143.28358208955223
1638,Nampalys Mendy,SEN,MF,Leicester City,Premier League,27,1992,3.2,7,5,4,1,2,4,5,80.0,1,4,1,3,6,13,6,0,0,2019-2020,90.0,168.75,196.875
1639,Hamza Mendyl,MAR,DF,Dijon,Ligue 1,21,1997,16.0,49,32,31,14,4,29,46,63.0,17,16,4,12,23,72,47,0,0,2019-2020,90.0,129.375,275.625
1640,Chris Mepham,WAL,DF,Bournemouth,Premier League,21,1997,10.1,20,9,13,7,0,11,14,78.6,3,17,11,6,17,37,62,1,0,2019-2020,90.0,151.4851485148515,178.21782178217822
1641,Levent Mercan,GER,"MF,FW",Schalke 04,Bundesliga,18,2000,0.8,0,0,0,0,0,0,0,0.0,0,0,0,0,0,0,2,1,0,2019-2020,90.0,0.0,0.0
1642,Jorge Meré,ESP,DF,Köln,Bundesliga,22,1997,6.9,6,5,2,4,0,1,2,50.0,1,13,11,2,14,20,30,0,0,2019-2020,90.0,182.6086956521739,78.26086956521738
1643,Alex Meret,ITA,GK,Napoli,Serie A,22,1997,21.7,0,0,0,0,0,0,2,0.0,2,1,0,1,1,1,7,2,0,2019-2020,90.0,4.147465437788019,0.0
1644,Fran Mérida,ESP,MF,Osasuna,La Liga,29,1990,12.9,27,15,11,10,6,9,27,33.3,18,15,4,11,25,52,10,0,0,2019-2020,90.0,174.41860465116278,188.37209302325581
1645,Mikel Merino,ESP,MF,Real Sociedad,La Liga,23,1996,34.9,79,52,20,44,15,28,86,32.6,58,46,8,38,51,130,52,0,0,2019-2020,90.0,131.5186246418338,203.72492836676219
1646,Sabin Merino,ESP,FW,Leganés,La Liga,27,1992,0.9,0,0,0,0,0,0,0,0.0,0,0,0,0,0,0,0,0,0,2019-2020,90.0,0.0,0.0
1647,Yıldırım Mert Çetin,TUR,DF,Roma,Serie A,22,1997,2.9,5,1,4,1,0,3,5,60.0,2,4,3,1,4,9,8,1,0,2019-2020,90.0,124.13793103448276,155.17241379310346
1648,Dries Mertens,BEL,FW,Napoli,Serie A,32,1987,18.8,13,9,1,8,4,2,27,7.4,25,10,1,9,7,20,4,0,0,2019-2020,90.0,33.51063829787234,62.234042553191486
1649,Roque Mesa,ESP,MF,Leganés,La Liga,30,1989,22.4,40,21,17,18,5,13,44,29.5,31,13,4,9,11,51,8,0,0,2019-2020,90.0,44.19642857142857,160.71428571428572
1650,Lionel Messi,ARG,FW,Barcelona,La Liga,32,1987,32.0,21,10,4,7,10,3,21,14.3,18,9,0,9,7,28,1,0,0,2019-2020,90.0,19.6875,59.0625
Rk,Player,Nation,Pos,Squad,Comp,0,0,90.0,0,0,3,3,3,Tkl,0,0.0,0,0,0,0,0,0,0,0,0,2019-2020,90.0,0.0,0.0
1651,Thomas Meunier,BEL,DF,Paris S-G,Ligue 1,27,1991,13.8,27,21,9,12,6,16,26,61.5,10,17,5,12,18,45,19,1,0,2019-2020,90.0,117.39130434782608,176.08695652173913
1652,Mexer,MOZ,DF,Bordeaux,Ligue 1,30,1988,16.5,16,11,14,1,1,10,30,33.3,20,14,13,1,15,31,47,0,0,2019-2020,90.0,81.81818181818183,87.27272727272728
1653,Max Meyer,GER,"MF,FW",Crystal Palace,Premier League,23,1995,7.3,19,11,10,9,0,8,18,44.4,10,6,1,5,7,26,4,0,0,2019-2020,90.0,86.3013698630137,234.24657534246577
1654,Kingsley Michael,NGA,MF,Bologna,Serie A,19,1999,0.8,2,1,0,2,0,0,0,0.0,0,0,0,0,1,3,1,0,0,2019-2020,90.0,112.5,225.0
1655,Míchel,ESP,MF,Valladolid,La Liga,31,1988,24.2,50,28,26,19,5,22,75,29.3,53,22,4,18,33,83,41,1,0,2019-2020,90.0,122.72727272727272,185.9504132231405
1656,Sven Michel,GER,FW,Paderborn 07,Bundesliga,29,1990,15.3,14,12,3,5,6,3,20,15.0,17,13,2,11,7,21,7,0,0,2019-2020,90.0,41.17647058823529,82.35294117647058
1657,Miguel,ESP,FW,Valladolid,La Liga,19,1999,2.6,2,1,1,0,1,1,2,50.0,1,3,1,2,0,2,1,0,0,2019-2020,90.0,0.0,69.23076923076923
1658,Florian Miguel,FRA,DF,Nîmes,Ligue 1,22,1996,22.8,51,25,27,20,4,31,52,59.6,21,19,4,15,33,84,32,0,0,2019-2020,90.0,130.26315789473682,201.3157894736842
1659,Georges Mikautadze,GEO,FW,Metz,Ligue 1,18,2000,0.1,1,0,0,0,1,0,0,0.0,0,0,0,0,0,1,0,0,0,2019-2020,90.0,0.0,900.0
1660,Nikola Milenković,SRB,DF,Fiorentina,Serie A,21,1997,36.2,46,25,30,16,0,11,31,35.5,20,39,21,18,29,75,129,1,0,2019-2020,90.0,72.09944751381215,114.36464088397788
1661,Arkadiusz Milik,POL,FW,Napoli,Serie A,25,1994,19.4,12,5,4,1,7,3,11,27.3,8,11,1,10,2,14,12,0,0,2019-2020,90.0,9.278350515463918,55.67010309278351
1662,Sergej Milinković-Savić,SRB,MF,Lazio,Serie A,24,1995,33.7,60,35,25,24,11,15,79,19.0,64,67,16,51,37,97,60,1,0,2019-2020,90.0,98.81305637982196,160.2373887240356
1663,Éder Militão,BRA,DF,Real Madrid,La Liga,21,1998,11.4,25,15,15,9,1,10,17,58.8,7,12,6,6,20,45,42,0,0,2019-2020,90.0,157.89473684210526,197.36842105263156
1664,Luka Milivojević,SRB,MF,Crystal Palace,Premier League,28,1991,27.9,61,32,32,25,4,35,84,41.7,49,30,7,23,42,103,39,4,0,2019-2020,90.0,135.48387096774195,196.7741935483871
1665,Vincenzo Millico,ITA,"MF,FW",Torino,Serie A,18,2000,2.4,1,0,1,0,0,1,3,33.3,2,2,0,2,0,1,1,0,0,2019-2020,90.0,0.0,37.5
1666,James Milner,ENG,"MF,DF",Liverpool,Premier League,33,1986,10.4,16,10,3,10,3,6,26,23.1,20,12,3,9,7,23,17,1,0,2019-2020,90.0,60.57692307692307,138.46153846153845
1667,Santi Mina,ESP,"FW,MF",Celta Vigo,La Liga,23,1995,21.6,13,8,8,5,0,5,38,13.2,33,19,2,17,10,23,27,0,0,2019-2020,90.0,41.666666666666664,54.166666666666664
1668,Yerry Mina,COL,DF,Everton,Premier League,24,1994,25.4,39,22,25,12,2,18,24,75.0,6,20,14,6,28,67,102,1,0,2019-2020,90.0,99.21259842519686,138.18897637795277
1669,Takumi Minamino,JPN,"FW,MF",Liverpool,Premier League,24,1995,2.8,3,3,0,2,1,2,10,20.0,8,3,0,3,0,3,3,0,0,2019-2020,90.0,0.0,96.42857142857143
1670,Tyrone Mings,ENG,DF,Aston Villa,Premier League,26,1993,32.2,15,11,11,3,1,10,13,76.9,3,56,48,8,30,45,190,4,0,2019-2020,90.0,83.85093167701862,41.92546583850931
1671,Jorge Miramón,ESP,DF,Levante,La Liga,30,1989,27.0,52,27,35,13,4,26,45,57.8,19,30,8,22,46,98,61,1,0,2019-2020,90.0,153.33333333333334,173.33333333333334
1672,Juan Miranda,ESP,DF,Schalke 04,Bundesliga,19,2000,8.7,14,10,8,6,0,6,18,33.3,12,12,4,8,10,24,27,1,0,2019-2020,90.0,103.44827586206897,144.82758620689654
1673,Antonio Mirante,ITA,GK,Roma,Serie A,36,1983,5.0,0,0,0,0,0,0,1,0.0,1,0,0,0,0,0,2,1,0,2019-2020,90.0,0.0,0.0
1674,Simone Missiroli,ITA,MF,SPAL,Serie A,33,1986,31.1,42,27,18,20,4,13,43,30.2,30,42,27,15,54,96,62,1,0,2019-2020,90.0,156.2700964630225,121.54340836012861
1675,Tyrick Mitchell,ENG,DF,Crystal Palace,Premier League,19,1999,2.2,5,2,2,2,1,1,7,14.3,6,2,0,2,2,7,3,0,0,2019-2020,90.0,81.81818181818181,204.54545454545453
Rk,Player,Nation,Pos,Squad,Comp,0,0,90.0,0,0,3,3,3,Tkl,0,0.0,0,0,0,0,0,0,0,0,0,2019-2020,90.0,0.0,0.0
1676,Stefan Mitrović,SRB,DF,Strasbourg,Ligue 1,29,1990,22.8,15,9,10,5,0,6,14,42.9,8,14,9,5,23,38,90,3,0,2019-2020,90.0,90.78947368421052,59.210526315789465
1677,Maximilian Mittelstädt,GER,"DF,FW",Hertha BSC,Bundesliga,22,1997,21.0,61,38,31,25,5,26,54,48.1,28,38,6,32,53,114,64,0,0,2019-2020,90.0,227.14285714285714,261.42857142857144
1678,Henrikh Mkhitaryan,ARM,FW,Arsenal,Premier League,30,1989,1.2,0,0,0,0,0,0,2,0.0,2,3,0,3,0,0,1,0,0,2019-2020,90.0,0.0,0.0
1679,Henrikh Mkhitaryan,ARM,"MF,FW",Roma,Serie A,30,1989,17.0,32,22,10,17,5,19,45,42.2,26,27,3,24,11,43,6,0,0,2019-2020,90.0,58.23529411764706,169.41176470588235
1680,Anthony Modeste,FRA,FW,Köln,Bundesliga,31,1988,12.6,10,5,1,5,4,1,10,10.0,9,5,3,2,0,10,19,0,0,2019-2020,90.0,0.0,71.42857142857143
1681,Luka Modrić,CRO,MF,Real Madrid,La Liga,33,1985,22.2,37,18,9,15,13,16,41,39.0,25,10,2,8,22,59,12,0,0,2019-2020,90.0,89.1891891891892,150.0
1682,Kevin Möhwald,GER,MF,Werder Bremen,Bundesliga,26,1993,0.8,2,1,1,1,0,1,2,50.0,1,0,0,0,0,2,1,0,0,2019-2020,90.0,0.0,225.0
1683,Niklas Moisander,FIN,DF,Werder Bremen,Bundesliga,33,1985,22.0,27,15,19,6,2,11,26,42.3,15,37,19,18,49,76,85,0,0,2019-2020,90.0,200.45454545454547,110.45454545454545
1684,Jorge Molina,ESP,FW,Getafe,La Liga,37,1982,21.0,8,2,0,4,4,0,12,0.0,12,13,2,11,4,12,18,0,0,2019-2020,90.0,17.142857142857142,34.285714285714285
1685,Florent Mollet,FRA,"MF,FW",Montpellier,Ligue 1,27,1991,18.7,13,11,3,8,2,7,28,25.0,21,9,1,8,9,22,2,0,0,2019-2020,90.0,43.31550802139037,62.56684491978609
1686,Jon Moncayola,ESP,"MF,DF",Osasuna,La Liga,21,1998,16.6,52,30,26,22,4,27,54,50.0,27,29,5,24,16,68,23,1,0,2019-2020,90.0,86.74698795180721,281.92771084337346
1687,Gabriele Moncini,ITA,"FW,MF",SPAL,Serie A,23,1996,1.7,1,0,0,1,0,0,0,0.0,0,2,1,1,1,2,0,0,0,2019-2020,90.0,52.94117647058823,52.94117647058823
1688,Thomas Monconduit,FRA,MF,Amiens,Ligue 1,28,1991,15.2,26,12,6,18,2,9,26,34.6,17,11,4,7,10,36,25,3,0,2019-2020,90.0,59.21052631578947,153.94736842105263
1689,Nacho Monreal,ESP,DF,Arsenal,Premier League,33,1986,3.0,1,1,1,0,0,1,3,33.3,2,3,1,2,3,4,10,0,0,2019-2020,90.0,90.0,30.0
1690,Nacho Monreal,ESP,DF,Real Sociedad,La Liga,33,1986,26.6,38,16,26,9,3,22,42,52.4,20,20,4,16,43,81,66,0,0,2019-2020,90.0,145.48872180451127,128.57142857142856
1691,Joan Monterde,ESP,MF,Levante,La Liga,21,1997,0.1,0,0,0,0,0,0,0,0.0,0,0,0,0,0,0,0,0,0,2019-2020,90.0,0.0,0.0
1692,Ilario Monterisi,ITA,DF,Lecce,Serie A,17,2001,0.0,0,0,0,0,0,0,0,0.0,0,0,0,0,0,0,0,0,0,2019-2020,,,
1693,Ángel Montoro,ESP,MF,Granada,La Liga,31,1988,10.8,19,8,8,9,2,3,13,23.1,10,10,1,9,13,32,15,0,0,2019-2020,90.0,108.33333333333333,158.33333333333331
1694,Martín Montoya,ESP,"DF,MF",Brighton,Premier League,28,1991,21.1,57,29,31,20,6,30,56,53.6,26,19,5,14,24,81,40,0,0,2019-2020,90.0,102.3696682464455,243.12796208530804
1695,Simon Moore,ENG,GK,Sheffield Utd,Premier League,29,1990,2.0,1,0,1,0,0,1,1,100.0,0,0,0,0,0,1,0,1,0,2019-2020,90.0,0.0,45.0
1696,Aaron Mooy,AUS,"MF,FW",Brighton,Premier League,28,1990,23.2,37,24,9,18,10,6,40,15.0,34,36,7,29,23,60,32,1,0,2019-2020,90.0,89.22413793103449,143.5344827586207
1697,Wesley Moraes,BRA,FW,Aston Villa,Premier League,22,1996,19.8,15,8,3,8,4,0,5,0.0,5,10,2,8,4,19,23,0,0,2019-2020,90.0,18.181818181818183,68.18181818181819
1698,Alfredo Morales,USA,MF,Düsseldorf,Bundesliga,29,1990,19.2,31,15,11,16,4,11,35,31.4,24,17,6,11,18,49,37,0,0,2019-2020,90.0,84.375,145.3125
1699,Álvaro Morata,ESP,FW,Atlético Madrid,La Liga,26,1992,23.3,17,8,4,9,4,1,13,7.7,12,12,2,10,5,22,23,0,0,2019-2020,90.0,19.313304721030043,65.66523605150215
1700,Jan Morávek,CZE,MF,Augsburg,Bundesliga,29,1989,5.3,23,12,9,14,0,11,24,45.8,13,4,1,3,8,31,11,0,0,2019-2020,90.0,135.8490566037736,390.5660377358491
Rk,Player,Nation,Pos,Squad,Comp,0,0,90.0,0,0,3,3,3,Tkl,0,0.0,0,0,0,0,0,0,0,0,0,2019-2020,90.0,0.0,0.0
1701,Steven Moreira,CPV,DF,Toulouse,Ligue 1,24,1994,15.4,37,25,21,15,1,19,31,61.3,12,16,3,13,16,53,29,0,0,2019-2020,90.0,93.50649350649351,216.23376623376623
1702,Jérémy Morel,MAD,DF,Rennes,Ligue 1,35,1984,20.1,15,9,13,1,1,9,20,45.0,11,21,17,4,17,32,59,1,0,2019-2020,90.0,76.11940298507461,67.16417910447761
1703,Alberto Moreno,ESP,DF,Villarreal,La Liga,27,1992,16.3,27,16,15,11,1,9,25,36.0,16,15,3,12,25,52,36,0,0,2019-2020,90.0,138.03680981595093,149.079754601227
1704,Álex Moreno,ESP,DF,Betis,La Liga,26,1993,25.2,37,20,27,8,2,12,32,37.5,20,21,8,13,23,60,47,1,0,2019-2020,90.0,82.14285714285715,132.14285714285717
1705,Gerard Moreno,ESP,"FW,MF",Villarreal,La Liga,27,1992,30.5,19,8,4,10,5,5,46,10.9,41,19,3,16,10,29,51,0,0,2019-2020,90.0,29.508196721311474,56.0655737704918
1706,Mateu Morey,ESP,"DF,MF",Dortmund,Bundesliga,19,2000,2.2,7,3,2,4,1,4,10,40.0,6,4,0,4,5,12,3,0,0,2019-2020,90.0,204.54545454545453,286.3636363636364
1707,Wes Morgan,JAM,DF,Leicester City,Premier League,35,1984,4.8,4,1,3,1,0,0,3,0.0,3,5,3,2,7,11,19,0,0,2019-2020,90.0,131.25,75.0
1708,Manu Morlanes,ESP,MF,Villarreal,La Liga,20,1999,2.8,7,3,3,4,0,2,9,22.2,7,1,1,0,2,9,2,0,0,2019-2020,90.0,64.28571428571429,225.0
1709,Raúl Moro,ESP,FW,Lazio,Serie A,16,2002,0.0,0,0,0,0,0,0,0,0.0,0,0,0,0,0,0,0,0,0,2019-2020,,,
1710,Loren Morón,ESP,FW,Betis,La Liga,25,1993,22.6,18,12,6,7,5,9,23,39.1,14,25,6,19,9,27,13,0,0,2019-2020,90.0,35.84070796460177,71.68141592920354
1711,Leonardo Morosini,ITA,"FW,DF",Brescia,Serie A,23,1995,0.3,1,1,1,0,0,0,0,0.0,0,1,0,1,1,2,1,0,0,2019-2020,90.0,300.0,300.0
1712,Ravel Morrison,JAM,MF,Sheffield Utd,Premier League,26,1993,0.1,0,0,0,0,0,0,0,0.0,0,0,0,0,0,0,0,0,0,2019-2020,90.0,0.0,0.0
1713,Victor Moses,NGA,DF,Inter,Serie A,28,1990,4.7,4,3,1,2,1,2,8,25.0,6,4,0,4,0,4,4,0,0,2019-2020,90.0,0.0,76.59574468085106
1714,Lebo Mothiba,RSA,FW,Strasbourg,Ligue 1,23,1996,11.6,4,3,1,1,2,1,6,16.7,5,5,0,5,3,7,1,0,0,2019-2020,90.0,23.275862068965516,31.03448275862069
1715,Harold Moukoudi,CMR,DF,Saint-Étienne,Ligue 1,21,1997,11.0,28,19,20,7,1,11,14,78.6,3,16,10,6,16,44,42,2,0,2019-2020,90.0,130.9090909090909,229.0909090909091
1716,Jessy Moulin,FRA,GK,Saint-Étienne,Ligue 1,33,1986,5.0,0,0,0,0,0,0,0,0.0,0,0,0,0,1,1,2,0,0,2019-2020,90.0,18.0,0.0
1717,Mason Mount,ENG,"MF,FW",Chelsea,Premier League,20,1999,31.9,37,17,8,19,10,9,42,21.4,33,25,3,22,16,53,18,0,0,2019-2020,90.0,45.141065830721004,104.38871473354232
1718,Lucas Moura,BRA,"FW,MF",Tottenham,Premier League,26,1992,24.9,57,33,25,22,10,16,58,27.6,42,29,2,27,15,72,27,0,0,2019-2020,90.0,54.21686746987952,206.02409638554215
1719,Lys Mousset,FRA,FW,Sheffield Utd,Premier League,23,1996,13.8,9,5,0,5,4,3,7,42.9,4,3,0,3,4,13,2,0,0,2019-2020,90.0,26.08695652173913,58.69565217391304
1720,Wesley Moustache,FRA,DF,Nantes,Ligue 1,20,1999,0.5,0,0,0,0,0,0,0,0.0,0,1,0,1,0,0,2,0,0,2019-2020,90.0,0.0,0.0
1721,João Moutinho,POR,MF,Wolves,Premier League,32,1986,34.5,93,50,43,41,9,46,139,33.1,93,43,13,30,50,143,18,1,0,2019-2020,90.0,130.43478260869566,242.6086956521739
1722,Samuel Moutoussamy,COD,"DF,MF",Nantes,Ligue 1,22,1996,5.8,4,1,2,1,1,2,7,28.6,5,2,0,2,4,8,7,0,0,2019-2020,90.0,62.06896551724138,62.06896551724138
1723,Toni Moya,ESP,MF,Atlético Madrid,La Liga,21,1998,0.0,0,0,0,0,0,0,0,0.0,0,0,0,0,0,0,0,0,0,2019-2020,,,
1724,Javi Moyano,ESP,DF,Valladolid,La Liga,33,1986,24.7,19,8,11,8,0,8,20,40.0,12,18,5,13,27,46,63,0,0,2019-2020,90.0,98.38056680161944,69.23076923076923
1725,Nordi Mukiele,FRA,"DF,FW",RB Leipzig,Bundesliga,21,1997,19.8,61,39,39,12,10,25,38,65.8,13,26,4,22,47,108,57,0,0,2019-2020,90.0,213.63636363636363,277.27272727272725
Rk,Player,Nation,Pos,Squad,Comp,0,0,90.0,0,0,3,3,3,Tkl,0,0.0,0,0,0,0,0,0,0,0,0,2019-2020,90.0,0.0,0.0
1726,Mert Müldür,TUR,DF,Sassuolo,Serie A,20,1999,14.1,47,27,33,8,6,27,42,64.3,15,10,0,10,22,69,42,0,0,2019-2020,89.99999999999999,140.4255319148936,300.0
1727,Florian Müller,GER,GK,Mainz 05,Bundesliga,21,1997,12.5,0,0,0,0,0,0,0,0.0,0,0,0,0,2,2,3,1,0,2019-2020,90.0,14.399999999999999,0.0
1728,Thomas Müller,GER,"MF,FW",Bayern Munich,Bundesliga,29,1989,25.1,45,27,7,26,12,22,69,31.9,47,27,3,24,12,57,8,0,0,2019-2020,90.0,43.02788844621514,161.35458167330677
1729,Marshall Munetsi,ZIM,MF,Reims,Ligue 1,23,1996,9.3,27,19,12,12,3,6,12,50.0,6,13,7,6,12,39,20,1,0,2019-2020,90.0,116.1290322580645,261.2903225806451
1730,Iker Muniain,ESP,"FW,MF",Athletic Club,La Liga,26,1992,26.5,26,19,11,10,5,4,24,16.7,20,9,0,9,12,38,7,0,0,2019-2020,90.0,40.75471698113208,88.30188679245283
1731,Aihen Muñoz,ESP,DF,Real Sociedad,La Liga,21,1997,10.9,28,18,13,12,3,18,27,66.7,9,13,2,11,2,30,19,0,0,2019-2020,90.0,16.513761467889907,231.1926605504587
1732,Javier Muñoz,ESP,"FW,MF",Alavés,La Liga,24,1995,0.6,0,0,0,0,0,0,0,0.0,0,1,1,0,0,0,0,0,0,2019-2020,90.0,0.0,0.0
1733,Simone Muratore,ITA,MF,Juventus,Serie A,21,1998,1.8,2,0,0,1,1,1,3,33.3,2,1,0,1,3,5,0,0,0,2019-2020,90.0,150.0,100.0
1734,Alessandro Murgia,ITA,MF,SPAL,Serie A,22,1996,19.4,27,17,16,8,3,14,34,41.2,20,10,3,7,18,45,15,0,0,2019-2020,90.0,83.50515463917527,125.2577319587629
1735,Luis Muriel,COL,FW,Atalanta,Serie A,28,1991,14.0,15,9,3,8,4,3,14,21.4,11,12,0,12,4,19,0,0,0,2019-2020,90.0,25.714285714285715,96.42857142857143
1736,Jeison Murillo,COL,DF,Sampdoria,Serie A,27,1992,7.4,18,6,14,4,0,10,19,52.6,9,8,4,4,10,28,28,0,0,2019-2020,90.0,121.62162162162161,218.9189189189189
1737,Jeison Murillo,COL,DF,Celta Vigo,La Liga,27,1992,17.0,37,20,30,6,1,18,27,66.7,9,13,9,4,20,57,74,2,0,2019-2020,90.0,105.88235294117648,195.88235294117646
1738,Glenn Murray,ENG,FW,Brighton,Premier League,35,1983,8.9,5,2,0,3,2,2,9,22.2,7,6,2,4,1,6,12,0,0,2019-2020,90.0,10.112359550561798,50.56179775280899
1739,Nicola Murru,ITA,DF,Sampdoria,Serie A,24,1994,25.1,40,22,24,8,8,21,41,51.2,20,22,4,18,27,67,58,0,0,2019-2020,90.0,96.81274900398405,143.42629482071712
1740,Mateo Musacchio,ARG,DF,Milan,Serie A,28,1990,16.3,15,8,11,4,0,7,20,35.0,13,10,7,3,22,37,50,0,0,2019-2020,90.0,121.47239263803681,82.82208588957056
1741,Torben Müsel,GER,FW,Gladbach,Bundesliga,20,1999,0.0,0,0,0,0,0,0,0,0.0,0,0,0,0,1,1,0,0,0,2019-2020,,inf,
1742,Jamal Musiala,GER,MF,Bayern Munich,Bundesliga,16,2003,0.0,0,0,0,0,0,0,0,0.0,0,0,0,0,0,0,0,0,0,2019-2020,,,
1743,Juan Musso,ARG,GK,Udinese,Serie A,25,1994,38.0,0,0,0,0,0,0,1,0.0,1,0,0,0,1,1,18,2,0,2019-2020,90.0,2.3684210526315788,0.0
1744,Shkodran Mustafi,GER,DF,Arsenal,Premier League,27,1992,13.4,17,10,11,5,1,6,12,50.0,6,10,6,4,18,35,72,0,0,2019-2020,90.0,120.89552238805969,114.17910447761193
1745,Yoshinori Mutō,JPN,"MF,FW",Newcastle Utd,Premier League,27,1992,2.4,3,2,1,2,0,1,2,50.0,1,0,0,0,0,3,0,0,0,2019-2020,90.0,0.0,112.50000000000001
1746,Yvon Mvogo,SUI,GK,RB Leipzig,Bundesliga,25,1994,2.0,0,0,0,0,0,0,0,0.0,0,0,0,0,0,0,0,1,0,2019-2020,90.0,0.0,0.0
1747,Phillipp Mwene,AUT,DF,Mainz 05,Bundesliga,25,1994,3.5,11,5,9,2,0,7,12,58.3,5,10,1,9,3,14,11,0,0,2019-2020,90.0,77.14285714285714,282.85714285714283
1748,Obite N'Dicka,CIV,DF,Eint Frankfurt,Bundesliga,19,1999,19.1,27,13,13,11,3,15,28,53.6,13,28,6,22,29,56,57,0,0,2019-2020,90.0,136.64921465968587,127.22513089005236
1749,Kévin N'Doram,FRA,MF,Metz,Ligue 1,23,1996,18.3,43,28,19,21,3,17,40,42.5,23,20,8,12,26,69,23,0,0,2019-2020,90.0,127.8688524590164,211.47540983606558
1750,Abdallah N'dour,SEN,DF,Strasbourg,Ligue 1,25,1993,4.1,5,4,2,3,0,5,10,50.0,5,4,1,3,4,9,5,1,0,2019-2020,90.0,87.8048780487805,109.75609756097562
Rk,Player,Nation,Pos,Squad,Comp,0,0,90.0,0,0,3,3,3,Tkl,0,0.0,0,0,0,0,0,0,0,0,0,2019-2020,90.0,0.0,0.0
1751,Ferris N'Goma,FRA,"MF,FW",Brest,Ligue 1,26,1993,0.3,0,0,0,0,0,0,0,0.0,0,1,0,1,0,0,0,0,0,2019-2020,90.0,0.0,0.0
1752,Nathan N'Goumou,FRA,FW,Toulouse,Ligue 1,19,2000,0.1,0,0,0,0,0,0,0,0.0,0,0,0,0,0,0,1,0,0,2019-2020,90.0,0.0,0.0
1753,Georges-Kévin N'Koudou,CMR,FW,Tottenham,Premier League,24,1995,0.0,0,0,0,0,0,0,1,0.0,1,0,0,0,0,0,0,0,0,2019-2020,,,
1754,Stanley N'Soki,FRA,DF,Nice,Ligue 1,20,1999,14.1,40,29,24,16,0,23,42,54.8,19,14,6,8,32,72,37,0,0,2019-2020,89.99999999999999,204.25531914893617,255.3191489361702
1755,Nacho,ESP,DF,Valladolid,La Liga,30,1989,21.0,43,22,24,15,4,17,48,35.4,31,36,8,28,25,68,61,0,0,2019-2020,90.0,107.14285714285714,184.28571428571428
1756,Nacho,ESP,DF,Real Madrid,La Liga,29,1990,4.9,11,6,6,3,2,6,10,60.0,4,5,3,2,12,23,18,1,0,2019-2020,90.0,220.40816326530611,202.0408163265306
1757,Radja Nainggolan,BEL,MF,Cagliari,Serie A,31,1988,23.0,30,18,9,12,9,9,29,31.0,20,25,6,19,13,43,30,0,0,2019-2020,90.0,50.86956521739131,117.3913043478261
1758,Marvelous Nakamba,ZIM,MF,Aston Villa,Premier League,25,1994,20.4,55,28,28,20,7,24,67,35.8,43,50,11,39,39,94,38,3,0,2019-2020,90.0,172.05882352941177,242.64705882352942
1759,Naldo,BRA,DF,Espanyol,La Liga,30,1988,14.8,24,13,15,9,0,7,15,46.7,8,11,7,4,21,45,50,1,0,2019-2020,90.0,127.7027027027027,145.94594594594594
1760,Nahitan Nández,URU,"MF,DF",Cagliari,Serie A,23,1995,32.2,58,38,37,17,4,25,69,36.2,44,30,1,29,25,83,26,0,0,2019-2020,90.0,69.87577639751552,162.111801242236
1761,Matija Nastasić,SRB,DF,Schalke 04,Bundesliga,26,1993,15.2,26,16,17,9,0,14,17,82.4,3,28,16,12,22,48,79,0,0,2019-2020,90.0,130.26315789473685,153.94736842105263
1762,Marc Navarro,ESP,"FW,DF",Leganés,La Liga,24,1995,2.4,3,3,2,1,0,1,1,100.0,0,2,1,1,0,3,3,0,0,2019-2020,90.0,0.0,112.50000000000001
1763,Ximo Navarro,ESP,DF,Alavés,La Liga,29,1990,21.1,34,19,17,15,2,16,28,57.1,12,20,7,13,52,86,76,2,0,2019-2020,90.0,221.80094786729856,145.02369668246445
1764,Jesús Navas,ESP,DF,Sevilla,La Liga,33,1985,37.4,27,15,16,7,4,15,32,46.9,17,20,7,13,31,58,70,0,0,2019-2020,90.0,74.59893048128342,64.97326203208556
1765,Keylor Navas,CRC,GK,Paris S-G,Ligue 1,32,1986,21.0,0,0,0,0,0,0,0,0.0,0,1,0,1,0,0,4,2,0,2019-2020,90.0,0.0,0.0
1766,Raúl Navas,ESP,DF,Osasuna,La Liga,31,1988,7.9,10,5,4,6,0,4,13,30.8,9,10,4,6,18,28,30,0,0,2019-2020,90.0,205.06329113924048,113.92405063291137
1767,Michel Ndary Adopo,FRA,"DF,MF",Torino,Serie A,19,2000,0.0,0,0,0,0,0,0,0,0.0,0,1,1,0,0,0,0,0,0,2019-2020,,,
1768,Papa Ndiaga Yade,MTN,FW,Metz,Ligue 1,19,2000,0.0,0,0,0,0,0,0,0,0.0,0,0,0,0,0,0,0,0,0,2019-2020,,,
1769,Wilfred Ndidi,NGA,MF,Leicester City,Premier League,22,1996,29.7,128,67,56,61,11,45,91,49.5,46,52,6,46,80,208,69,3,0,2019-2020,90.0,242.4242424242424,387.8787878787879
1770,Emanuele Ndoj,ALB,MF,Brescia,Serie A,22,1996,6.2,9,6,2,6,1,3,13,23.1,10,7,0,7,5,14,5,0,0,2019-2020,90.0,72.58064516129032,130.6451612903226
1771,Tanguy Ndombele,FRA,MF,Tottenham,Premier League,22,1996,11.2,24,16,10,13,1,9,22,40.9,13,20,3,17,14,38,7,0,0,2019-2020,90.0,112.5,192.85714285714286
1772,Reiss Nelson,ENG,FW,Arsenal,Premier League,19,1999,7.0,11,8,5,4,2,7,17,41.2,10,13,2,11,3,14,3,0,0,2019-2020,90.0,38.57142857142857,141.42857142857142
1773,Ilija Nestorovski,MKD,FW,Udinese,Serie A,29,1990,13.9,10,7,5,5,0,6,21,28.6,15,13,2,11,4,14,12,0,0,2019-2020,90.0,25.89928057553957,64.74820143884892
1774,Neto,BRA,GK,Barcelona,La Liga,30,1989,2.0,0,0,0,0,0,0,0,0.0,0,0,0,0,0,0,1,0,0,2019-2020,90.0,0.0,0.0
1775,Pedro Neto,POR,"FW,MF",Wolves,Premier League,19,2000,10.4,9,4,3,6,0,4,15,26.7,11,2,0,2,6,15,4,0,0,2019-2020,90.0,51.92307692307692,77.88461538461537
Rk,Player,Nation,Pos,Squad,Comp,0,0,90.0,0,0,3,3,3,Tkl,0,0.0,0,0,0,0,0,0,0,0,0,2019-2020,90.0,0.0,0.0
1776,Manuel Neuer,GER,GK,Bayern Munich,Bundesliga,33,1986,33.0,2,1,1,0,1,2,4,50.0,2,0,0,0,0,2,15,4,0,2019-2020,90.0,0.0,5.454545454545455
1777,Florian Neuhaus,GER,MF,Gladbach,Bundesliga,22,1997,26.2,42,23,13,22,7,12,54,22.2,42,24,4,20,27,69,8,0,0,2019-2020,90.0,92.74809160305344,144.27480916030535
1778,Carlos Neva,ESP,DF,Granada,La Liga,23,1996,24.5,16,11,12,3,1,9,21,42.9,12,15,2,13,28,44,60,0,0,2019-2020,90.00000000000001,102.85714285714286,58.77551020408164
1779,Rúben Neves,POR,MF,Wolves,Premier League,22,1997,34.0,62,33,27,32,3,34,86,39.5,52,38,9,29,56,118,34,1,0,2019-2020,90.0,148.23529411764707,164.11764705882354
1780,Neymar,BRA,"MF,FW",Paris S-G,Ligue 1,27,1992,14.6,12,7,1,9,2,3,21,14.3,18,10,0,10,4,16,1,0,0,2019-2020,90.0,24.657534246575345,73.97260273972603
1781,Jeremy Ngakia,ENG,DF,West Ham,Premier League,18,2000,4.9,15,7,10,5,0,9,21,42.9,12,6,1,5,7,22,16,0,0,2019-2020,90.0,128.57142857142856,275.51020408163265
1782,Jessic Ngankam,GER,"FW,MF",Hertha BSC,Bundesliga,19,2000,0.9,2,2,1,1,0,2,2,100.0,0,2,0,2,0,2,1,0,0,2019-2020,90.0,0.0,200.0
1783,Muzinga Ngonda,COD,DF,Dijon,Ligue 1,24,1994,6.0,15,6,10,3,2,7,10,70.0,3,5,4,1,11,26,23,0,0,2019-2020,90.0,165.0,225.0
1784,Ahmad Ngouyamsa,CMR,DF,Dijon,Ligue 1,18,2000,0.6,1,0,1,0,0,0,3,0.0,3,1,1,0,1,2,5,0,0,2019-2020,90.0,150.0,150.0
1785,Opa Nguette,SEN,FW,Metz,Ligue 1,25,1994,20.3,44,28,23,15,6,11,39,28.2,28,17,3,14,12,56,12,0,0,2019-2020,90.0,53.20197044334975,195.07389162561574
1786,Moussa Niakhate,SEN,DF,Mainz 05,Bundesliga,23,1996,33.0,35,22,29,6,0,16,29,55.2,13,40,26,14,40,75,124,4,0,2019-2020,90.0,109.0909090909091,95.45454545454547
1787,Ibrahima Niane,SEN,FW,Metz,Ligue 1,20,1999,10.6,8,7,2,5,1,5,16,31.3,11,5,1,4,10,18,11,1,0,2019-2020,90.0,84.9056603773585,67.9245283018868
1788,M'Baye Niang,SEN,FW,Rennes,Ligue 1,24,1994,23.6,17,10,3,11,3,6,21,28.6,15,10,1,9,5,22,20,0,0,2019-2020,90.0,19.06779661016949,64.83050847457626
1789,Tanguy Nianzou,FRA,"DF,MF",Paris S-G,Ligue 1,17,2002,5.0,2,1,0,1,1,1,3,33.3,2,4,2,2,3,5,6,0,0,2019-2020,90.0,54.0,36.0
1790,Cheikh Niasse,SEN,MF,Lille,Ligue 1,19,2000,0.2,0,0,0,0,0,0,0,0.0,0,0,0,0,0,0,0,0,0,2019-2020,90.0,0.0,0.0
1791,Oumar Niasse,SEN,FW,Everton,Premier League,29,1990,0.2,4,0,0,2,2,0,0,0.0,0,0,0,0,1,5,0,0,0,2019-2020,90.0,450.0,1800.0
1792,Moritz Nicolas,GER,GK,Union Berlin,Bundesliga,21,1997,1.0,0,0,0,0,0,0,0,0.0,0,0,0,0,0,0,0,0,0,2019-2020,90.0,0.0,0.0
1793,Florian Niederlechner,GER,"FW,MF",Augsburg,Bundesliga,28,1990,30.2,21,13,7,9,5,4,21,19.0,17,21,5,16,8,29,38,0,0,2019-2020,90.0,23.841059602649008,62.58278145695364
1794,Saúl Ñíguez,ESP,"MF,DF",Atlético Madrid,La Liga,24,1994,34.1,95,59,44,42,9,39,88,44.3,49,58,13,45,55,150,68,1,0,2019-2020,90.0,145.16129032258064,250.73313782991204
1795,Casimir Ninga,CHA,"MF,FW",Angers,Ligue 1,26,1993,7.6,5,5,4,0,1,1,5,20.0,4,5,0,5,3,8,2,0,0,2019-2020,90.0,35.526315789473685,59.21052631578947
1796,Fernando Niño,ESP,FW,Villarreal,La Liga,18,2000,0.9,1,0,0,1,0,1,2,50.0,1,0,0,0,0,1,2,0,0,2019-2020,90.0,0.0,100.0
1797,Timothée Nkada,FRA,FW,Reims,Ligue 1,20,1999,1.6,1,0,1,0,0,0,1,0.0,1,0,0,0,0,1,1,0,0,2019-2020,90.0,0.0,56.25
1798,Eddie Nketiah,ENG,FW,Arsenal,Premier League,20,1999,7.0,7,5,3,4,0,2,6,33.3,4,9,0,9,2,9,5,0,0,2019-2020,90.0,25.714285714285715,90.0
1799,Nicolas Nkoulou,CMR,DF,Torino,Serie A,29,1990,29.9,34,24,21,11,2,16,22,72.7,6,40,18,22,70,104,138,2,0,2019-2020,90.0,210.70234113712377,102.34113712374582
1800,Christopher Nkunku,FRA,"MF,FW",RB Leipzig,Bundesliga,21,1997,21.4,21,13,4,11,6,9,33,27.3,24,25,2,23,20,41,8,0,0,2019-2020,90.0,84.11214953271029,88.3177570093458
Rk,Player,Nation,Pos,Squad,Comp,0,0,90.0,0,0,3,3,3,Tkl,0,0.0,0,0,0,0,0,0,0,0,0,2019-2020,90.0,0.0,0.0
1801,Lukas Nmecha,GER,"MF,FW",Wolfsburg,Bundesliga,20,1998,1.5,0,0,0,0,0,0,0,0.0,0,0,0,0,0,0,0,0,0,2019-2020,90.0,0.0,0.0
1802,Mark Noble,ENG,MF,West Ham,Premier League,32,1987,29.7,52,30,19,28,5,22,64,34.4,42,20,6,14,20,72,10,1,0,2019-2020,90.0,60.6060606060606,157.57575757575756
1803,Nolito,ESP,FW,Sevilla,La Liga,32,1986,10.0,21,12,5,11,5,7,20,35.0,13,7,0,7,1,22,1,0,0,2019-2020,90.0,9.0,189.0
1804,Nolito,ESP,"MF,FW",Celta Vigo,La Liga,32,1986,3.6,7,5,5,2,0,3,8,37.5,5,4,1,3,1,8,4,0,0,2019-2020,90.0,25.0,175.0
1805,Arnaud Nordin,FRA,"FW,MF",Saint-Étienne,Ligue 1,21,1998,10.1,7,3,3,3,1,4,13,30.8,9,11,1,10,4,11,6,0,0,2019-2020,90.0,35.64356435643565,62.37623762376238
1806,Håvard Nordtveit,NOR,DF,Hoffenheim,Bundesliga,29,1990,7.8,4,1,3,1,0,3,7,42.9,4,17,12,5,13,17,45,0,0,2019-2020,90.0,150.0,46.15384615384615
1807,Oliver Norwood,NIR,MF,Sheffield Utd,Premier League,28,1991,34.3,66,37,35,24,7,28,97,28.9,69,34,12,22,47,113,40,1,0,2019-2020,90.0,123.32361516034987,173.1778425655977
1808,Alexander Nübel,GER,GK,Schalke 04,Bundesliga,22,1996,25.7,0,0,0,0,0,0,0,0.0,0,0,0,0,2,2,9,6,0,2019-2020,90.0,7.003891050583658,0.0
1809,Kasim Nuhu,GHA,DF,Düsseldorf,Bundesliga,24,1995,11.1,14,7,12,1,1,9,19,47.4,10,16,12,4,25,39,54,0,0,2019-2020,90.0,202.7027027027027,113.51351351351353
1810,Unai Núñez,ESP,DF,Athletic Club,La Liga,22,1997,17.5,13,10,10,2,1,6,16,37.5,10,25,17,8,23,36,71,0,0,2019-2020,90.0,118.28571428571428,66.85714285714286
1811,Bram Nuytinck,NED,DF,Udinese,Serie A,29,1990,24.7,46,32,30,13,3,17,27,63.0,10,50,32,18,27,73,96,1,0,2019-2020,90.0,98.38056680161944,167.61133603238866
1812,Gerzino Nyamsi,FRA,DF,Rennes,Ligue 1,22,1997,1.3,1,0,1,0,0,0,0,0.0,0,1,0,1,1,2,5,0,0,2019-2020,90.0,69.23076923076923,69.23076923076923
1813,Ørjan Nyland,NOR,GK,Aston Villa,Premier League,28,1990,6.0,0,0,0,0,0,0,0,0.0,0,0,0,0,0,0,1,1,0,2019-2020,90.0,0.0,0.0
1814,Allan Nyom,CMR,"DF,MF",Getafe,La Liga,31,1988,26.9,45,25,26,15,4,20,37,54.1,17,24,5,19,14,59,50,1,0,2019-2020,90.0,46.84014869888476,150.55762081784388
1815,Steven Nzonzi,FRA,MF,Rennes,Ligue 1,30,1988,4.3,5,4,3,1,1,1,2,50.0,1,2,2,0,4,9,18,0,0,2019-2020,90.0,83.72093023255815,104.65116279069768
1816,Jack O'Connell,ENG,DF,Sheffield Utd,Premier League,25,1994,32.4,23,14,15,6,2,10,20,50.0,10,38,17,21,42,65,154,1,0,2019-2020,90.0,116.66666666666667,63.88888888888889
1817,Michael Obafemi,IRL,FW,Southampton,Premier League,19,2000,7.4,7,3,1,3,3,2,14,14.3,12,3,0,3,6,13,0,0,0,2019-2020,90.0,72.97297297297297,85.13513513513513
1818,Pedro Obiang,EQG,MF,Sassuolo,Serie A,27,1992,18.6,46,31,21,19,6,19,40,47.5,21,24,10,14,21,67,31,1,0,2019-2020,90.0,101.61290322580643,222.5806451612903
1819,Jan Oblak,SVN,GK,Atlético Madrid,La Liga,26,1993,37.7,0,0,0,0,0,0,0,0.0,0,0,0,0,1,1,4,2,0,2019-2020,90.0,2.3872679045092835,0.0
1820,Rafel Obrador,ESP,DF,Mallorca,La Liga,15,2004,0.0,0,0,0,0,0,0,1,0.0,1,0,0,0,0,0,1,0,0,2019-2020,,,
1821,Lucas Ocampos,ARG,"FW,MF",Sevilla,La Liga,25,1994,30.5,54,31,30,19,5,30,72,41.7,42,33,2,31,22,76,27,0,0,2019-2020,90.0,64.91803278688525,159.34426229508196
1822,Bastian Oczipka,GER,DF,Schalke 04,Bundesliga,30,1989,33.5,72,50,42,21,9,36,62,58.1,26,35,6,29,37,109,68,0,0,2019-2020,90.0,99.40298507462687,193.43283582089552
1823,Álvaro Odriozola,ESP,DF,Real Madrid,La Liga,23,1995,3.8,5,2,4,0,1,5,8,62.5,3,4,0,4,2,7,8,0,0,2019-2020,90.0,47.368421052631575,118.42105263157895
1824,Álvaro Odriozola,ESP,DF,Bayern Munich,Bundesliga,23,1995,1.7,2,2,1,0,1,2,3,66.7,1,1,0,1,1,3,2,0,0,2019-2020,90.0,52.94117647058823,105.88235294117646
1825,Kelvin Ofori,GHA,MF,Düsseldorf,Bundesliga,18,2001,0.4,0,0,0,0,0,0,0,0.0,0,0,0,0,0,0,0,0,0,2019-2020,90.0,0.0,0.0
Rk,Player,Nation,Pos,Squad,Comp,0,0,90.0,0,0,3,3,3,Tkl,0,0.0,0,0,0,0,0,0,0,0,0,2019-2020,90.0,0.0,0.0
1826,Angelo Ogbonna,ITA,DF,West Ham,Premier League,31,1988,31.0,38,24,20,14,4,18,32,56.3,14,50,32,18,27,65,134,1,0,2019-2020,90.0,78.38709677419355,110.3225806451613
1827,Stefano Okaka,ITA,FW,Udinese,Serie A,29,1989,26.8,19,11,6,8,5,7,27,25.9,20,23,2,21,8,27,28,0,0,2019-2020,90.0,26.865671641791042,63.805970149253724
1828,Kwasi Okyere Wriedt,GHA,FW,Bayern Munich,Bundesliga,25,1994,0.2,0,0,0,0,0,0,0,0.0,0,0,0,0,0,0,0,0,0,2019-2020,90.0,0.0,0.0
1829,Lucas Olaza,URU,DF,Celta Vigo,La Liga,25,1994,34.9,56,39,36,17,3,39,59,66.1,20,37,10,27,31,87,60,1,0,2019-2020,90.0,79.94269340974212,144.41260744985672
1830,Oier Olazábal,ESP,GK,Espanyol,La Liga,29,1989,2.0,0,0,0,0,0,0,0,0.0,0,1,0,1,0,0,0,0,0,2019-2020,90.0,0.0,0.0
1831,Christian Oliva,URU,MF,Cagliari,Serie A,23,1996,5.2,13,7,9,4,0,5,15,33.3,10,5,0,5,7,20,14,0,0,2019-2020,90.0,121.15384615384615,224.99999999999997
1832,Kiko Olivas,ESP,DF,Valladolid,La Liga,30,1988,32.7,33,16,25,7,1,13,35,37.1,22,30,16,14,61,94,112,2,0,2019-2020,90.0,167.88990825688074,90.82568807339449
1833,Paulo Oliveira,POR,DF,Eibar,La Liga,27,1992,23.2,31,19,22,8,1,18,30,60.0,12,23,13,10,42,73,107,1,0,2019-2020,90.0,162.93103448275863,120.25862068965517
1834,Cauly Oliveira Souza,BRA,"MF,FW",Paderborn 07,Bundesliga,23,1995,8.0,11,7,5,5,1,3,11,27.3,8,9,0,9,6,17,1,0,0,2019-2020,90.0,67.5,123.75
1835,Mathías Olivera,URU,DF,Getafe,La Liga,21,1997,20.8,64,40,34,16,14,27,45,60.0,18,32,3,29,23,87,44,0,0,2019-2020,90.0,99.51923076923076,276.9230769230769
1836,Maximiliano Olivera,URU,MF,Fiorentina,Serie A,27,1992,0.1,1,0,1,0,0,0,0,0.0,0,0,0,0,0,1,0,0,0,2019-2020,90.0,0.0,900.0
1837,Marco Olivieri,ITA,FW,Juventus,Serie A,20,1999,0.3,1,1,1,0,0,1,2,50.0,1,0,0,0,0,1,0,0,0,2019-2020,90.0,0.0,300.0
1838,Dani Olmo,ESP,"MF,FW",RB Leipzig,Bundesliga,21,1998,8.3,20,14,5,10,5,1,13,7.7,12,7,1,6,4,24,6,0,0,2019-2020,90.0,43.37349397590361,216.86746987951804
1839,Robin Olsen,SWE,GK,Cagliari,Serie A,29,1990,16.9,0,0,0,0,0,0,1,0.0,1,0,0,0,0,0,8,0,0,2019-2020,90.0,0.0,0.0
1840,Kenneth Omeruo,NGA,DF,Leganés,La Liga,25,1993,20.8,28,17,25,3,0,11,18,61.1,7,21,12,9,36,64,112,2,0,2019-2020,90.0,155.76923076923075,121.15384615384615
1841,Jean Onana,CMR,MF,Lille,Ligue 1,19,2000,0.9,0,0,0,0,0,0,2,0.0,2,1,0,1,1,1,0,0,0,2019-2020,90.0,100.0,0.0
1842,Karim Onisiwo,AUT,FW,Mainz 05,Bundesliga,27,1992,19.2,27,19,6,10,11,5,13,38.5,8,20,3,17,7,34,11,0,0,2019-2020,90.0,32.8125,126.56250000000001
1843,Javier Ontiveros,ESP,"FW,MF",Villarreal,La Liga,21,1997,9.9,29,14,13,14,2,8,35,22.9,27,13,1,12,5,34,7,0,0,2019-2020,90.0,45.45454545454545,263.6363636363636
1844,Henry Onyekuru,NGA,"MF,FW",Monaco,Ligue 1,22,1997,1.8,1,1,1,0,0,0,0,0.0,0,1,0,1,1,2,0,0,0,2019-2020,90.0,50.0,50.0
1845,Nicholas Opoku,GHA,DF,Udinese,Serie A,21,1997,5.3,13,8,8,3,2,6,11,54.5,5,6,4,2,4,17,19,0,0,2019-2020,90.0,67.9245283018868,220.75471698113208
1846,Nicholas Opoku,GHA,DF,Amiens,Ligue 1,21,1997,7.0,7,5,6,1,0,7,14,50.0,7,6,2,4,7,14,32,0,0,2019-2020,90.0,90.0,90.0
1847,Willi Orban,HUN,DF,RB Leipzig,Bundesliga,26,1992,9.5,20,12,13,7,0,12,20,60.0,8,14,3,11,16,36,52,1,0,2019-2020,90.0,151.57894736842104,189.47368421052633
1848,Fabián Orellana,CHI,"MF,FW",Eibar,La Liga,33,1986,26.6,29,18,10,6,13,14,52,26.9,38,9,0,9,20,49,2,0,0,2019-2020,90.0,67.66917293233082,98.1203007518797
1849,Divock Origi,BEL,FW,Liverpool,Premier League,24,1995,8.0,12,9,2,5,5,4,9,44.4,5,2,0,2,4,16,5,0,0,2019-2020,90.0,45.0,135.0
1850,Aimar Oroz,ESP,FW,Osasuna,La Liga,17,2001,0.1,0,0,0,0,0,0,0,0.0,0,1,0,1,0,0,0,0,0,2019-2020,90.0,0.0,0.0
Rk,Player,Nation,Pos,Squad,Comp,0,0,90.0,0,0,3,3,3,Tkl,0,0.0,0,0,0,0,0,0,0,0,0,2019-2020,90.0,0.0,0.0
1851,Riccardo Orsolini,ITA,"FW,MF",Bologna,Serie A,22,1997,29.8,36,22,21,10,5,12,47,25.5,35,23,1,22,16,52,20,0,0,2019-2020,90.0,48.32214765100671,108.72483221476509
1852,Yuya Osako,JPN,"FW,MF",Werder Bremen,Bundesliga,29,1990,20.5,29,16,5,19,5,3,29,10.3,26,10,1,9,6,35,13,1,0,2019-2020,90.0,26.34146341463415,127.3170731707317
1853,Ben Osborn,ENG,"MF,DF",Sheffield Utd,Premier League,24,1994,6.6,15,10,11,3,1,3,16,18.8,13,6,1,5,6,21,7,0,0,2019-2020,90.0,81.81818181818181,204.54545454545453
1854,Victor Osimhen,NGA,FW,Lille,Ligue 1,20,1998,25.4,8,4,1,0,7,1,11,9.1,10,8,0,8,11,19,32,0,0,2019-2020,90.0,38.97637795275591,28.34645669291339
1855,David Ospina,COL,GK,Napoli,Serie A,30,1988,16.3,0,0,0,0,0,0,0,0.0,0,0,0,0,0,0,2,1,0,2019-2020,90.0,0.0,0.0
1856,Nicolás Otamendi,ARG,DF,Manchester City,Premier League,31,1988,19.1,28,14,21,6,1,16,33,48.5,17,15,9,6,21,49,76,2,0,2019-2020,90.0,98.95287958115183,131.9371727748691
1857,Otávio,BRA,MF,Bordeaux,Ligue 1,25,1994,24.6,80,45,23,52,5,35,82,42.7,47,26,9,17,41,121,40,6,0,2019-2020,89.99999999999999,149.99999999999997,292.68292682926824
1858,Paulo Otávio,BRA,DF,Wolfsburg,Bundesliga,24,1994,4.2,21,16,11,9,1,10,13,76.9,3,12,2,10,9,30,11,0,0,2019-2020,90.0,192.85714285714286,450.0
1859,Abou Ouattara,BFA,FW,Lille,Ligue 1,19,1999,0.1,0,0,0,0,0,0,0,0.0,0,0,0,0,0,0,1,0,0,2019-2020,90.0,0.0,0.0
1860,Remi Oudin,FRA,"FW,MF",Bordeaux,Ligue 1,22,1996,6.2,9,6,4,4,1,4,14,28.6,10,7,1,6,9,18,5,0,0,2019-2020,90.0,130.6451612903226,130.6451612903226
1861,Remi Oudin,FRA,"FW,MF",Reims,Ligue 1,22,1996,15.5,15,7,8,5,2,6,19,31.6,13,16,1,15,18,33,18,1,0,2019-2020,90.0,104.51612903225806,87.09677419354838
1862,Alexandre Oukidja,ALG,GK,Metz,Ligue 1,31,1988,26.5,0,0,0,0,0,0,1,0.0,1,1,0,1,0,0,15,1,0,2019-2020,90.0,0.0,0.0
1863,Zinédine Ould Khaled,FRA,MF,Angers,Ligue 1,19,2000,0.7,2,1,0,2,0,2,4,50.0,2,0,0,0,4,6,0,0,0,2019-2020,90.0,514.2857142857143,257.14285714285717
1864,Adam Ounas,ALG,"FW,MF",Nice,Ligue 1,22,1996,12.5,10,5,2,6,2,5,13,38.5,8,9,1,8,11,21,8,1,0,2019-2020,90.0,79.2,72.0
1865,Reece Oxford,ENG,MF,Augsburg,Bundesliga,20,1998,4.2,7,4,2,4,1,2,8,25.0,6,8,5,3,5,12,10,1,0,2019-2020,90.0,107.14285714285714,150.0
1866,Alex Oxlade-Chamberlain,ENG,"MF,FW",Liverpool,Premier League,25,1993,16.5,18,9,4,6,8,5,21,23.8,16,26,1,25,22,40,10,0,0,2019-2020,90.0,120.00000000000001,98.18181818181819
1867,Mikel Oyarzabal,ESP,"FW,MF",Real Sociedad,La Liga,22,1997,33.9,36,15,13,15,8,16,46,34.8,30,32,2,30,13,49,19,1,0,2019-2020,90.0,34.51327433628319,95.57522123893806
1868,Ambroise Oyongo,CMR,"DF,FW",Montpellier,Ligue 1,28,1991,20.2,25,10,16,6,3,16,28,57.1,12,8,0,8,17,42,35,0,0,2019-2020,90.0,75.74257425742574,111.38613861386139
1869,Mesut Özil,GER,MF,Arsenal,Premier League,30,1988,16.0,17,8,9,7,1,4,23,17.4,19,4,0,4,5,22,1,0,0,2019-2020,90.0,28.125,95.625
1870,Levin Öztunalı,GER,"MF,FW",Mainz 05,Bundesliga,23,1996,19.8,28,19,13,12,3,12,35,34.3,23,27,1,26,9,37,14,2,0,2019-2020,90.0,40.90909090909091,127.27272727272727
1871,Pablo,BRA,DF,Bordeaux,Ligue 1,28,1991,24.1,27,15,22,5,0,16,31,51.6,15,25,14,11,40,67,130,2,0,2019-2020,90.0,149.37759336099586,100.8298755186722
1872,Fernando Pacheco,ESP,GK,Alavés,La Liga,27,1992,26.2,1,0,1,0,0,1,3,33.3,2,0,0,0,0,1,10,0,0,2019-2020,90.0,0.0,3.435114503816794
1873,Jon Pacheco,ESP,DF,Real Sociedad,La Liga,18,2001,0.9,0,0,0,0,0,0,0,0.0,0,1,0,1,0,0,2,0,0,2019-2020,90.0,0.0,0.0
1874,Gonçalo Paciência,POR,FW,Eint Frankfurt,Bundesliga,24,1994,14.3,9,5,1,4,4,3,13,23.1,10,9,1,8,1,10,11,0,0,2019-2020,90.0,6.293706293706294,56.64335664335665
1875,Daniele Padelli,ITA,GK,Inter,Serie A,33,1985,3.0,0,0,0,0,0,0,0,0.0,0,0,0,0,0,0,1,1,0,2019-2020,90.0,0.0,0.0
Rk,Player,Nation,Pos,Squad,Comp,0,0,90.0,0,0,3,3,3,Tkl,0,0.0,0,0,0,0,0,0,0,0,0,2019-2020,90.0,0.0,0.0
1876,Marko Pajač,CRO,"DF,FW",Genoa,Serie A,26,1993,8.4,8,4,4,3,1,7,16,43.8,9,6,0,6,8,16,9,0,0,2019-2020,90.0,85.71428571428571,85.71428571428571
1877,Vincent Pajot,FRA,MF,Angers,Ligue 1,28,1990,1.3,2,2,1,1,0,1,1,100.0,0,3,0,3,5,7,0,0,0,2019-2020,90.0,346.15384615384613,138.46153846153845
1878,Vincent Pajot,FRA,MF,Metz,Ligue 1,28,1990,5.8,16,11,8,7,1,2,4,50.0,2,5,1,4,9,25,13,0,0,2019-2020,90.0,139.6551724137931,248.27586206896552
1879,Rodrigo Palacio,ARG,FW,Bologna,Serie A,37,1982,28.0,19,11,0,9,10,4,27,14.8,23,17,3,14,5,24,38,2,0,2019-2020,90.0,16.07142857142857,61.07142857142857
1880,Exequiel Palacios,ARG,MF,Leverkusen,Bundesliga,20,1998,2.0,8,7,4,4,0,2,5,40.0,3,2,0,2,1,9,0,0,0,2019-2020,90.0,45.0,360.0
1881,Sergi Palencia,ESP,DF,Saint-Étienne,Ligue 1,23,1996,5.2,16,10,6,10,0,5,7,71.4,2,6,1,5,8,24,4,0,0,2019-2020,90.0,138.46153846153845,276.9230769230769
1882,Nicolas Pallois,FRA,DF,Nantes,Ligue 1,31,1987,21.0,47,36,28,17,2,31,55,56.4,24,18,13,5,40,87,77,1,0,2019-2020,90.0,171.42857142857142,201.42857142857142
1883,Emerson Palmieri,ITA,DF,Chelsea,Premier League,24,1994,11.4,23,12,8,11,4,10,15,66.7,5,13,1,12,18,41,19,0,0,2019-2020,90.0,142.1052631578947,181.57894736842104
1884,Alberto Paloschi,ITA,FW,SPAL,Serie A,29,1990,4.9,3,0,3,0,0,2,8,25.0,6,3,0,3,0,3,2,0,0,2019-2020,90.0,0.0,55.10204081632653
1885,Alberto Paloschi,ITA,"FW,MF",Cagliari,Serie A,29,1990,2.3,0,0,0,0,0,0,1,0.0,1,1,0,1,1,1,3,0,0,2019-2020,90.0,39.130434782608695,0.0
1886,Martin Palumbo,NOR,MF,Udinese,Serie A,17,2002,0.0,0,0,0,0,0,0,0,0.0,0,0,0,0,0,0,0,0,0,2019-2020,,,
1887,Goran Pandev,MKD,"FW,MF",Genoa,Serie A,36,1983,18.7,12,8,2,7,3,3,25,12.0,22,4,1,3,0,12,5,1,0,2019-2020,90.0,0.0,57.75401069518716
1888,Jonathan Panzo,ENG,DF,Monaco,Ligue 1,18,2000,1.2,2,2,2,0,0,1,1,100.0,0,3,1,2,3,5,7,0,0,2019-2020,90.0,225.00000000000003,150.0
1889,Sokratis Papastathopoulos,GRE,DF,Arsenal,Premier League,31,1988,18.8,25,16,17,7,1,10,21,47.6,11,30,24,6,17,42,68,1,0,2019-2020,90.0,81.38297872340425,119.68085106382978
1890,Andrea Papetti,ITA,DF,Brescia,Serie A,17,2002,10.2,9,7,8,1,0,4,14,28.6,10,15,11,4,15,24,39,0,0,2019-2020,90.0,132.3529411764706,79.41176470588236
1891,Lucas Paquetá,BRA,"MF,FW",Milan,Serie A,21,1997,12.3,33,19,12,17,4,14,37,37.8,23,17,2,15,8,41,9,0,0,2019-2020,89.99999999999999,58.536585365853654,241.46341463414632
1892,Gaëtan Paquiez,FRA,DF,Nîmes,Ligue 1,25,1994,17.0,36,25,14,13,9,17,47,36.2,30,18,5,13,33,69,43,0,0,2019-2020,90.0,174.7058823529412,190.58823529411765
1893,Rubén Pardo,ESP,MF,Bordeaux,Ligue 1,26,1992,2.1,3,2,2,1,0,2,3,66.7,1,0,0,0,1,4,2,1,0,2019-2020,90.0,42.857142857142854,128.57142857142856
1894,Leandro Paredes,ARG,MF,Paris S-G,Ligue 1,25,1994,9.0,22,14,7,14,1,13,29,44.8,16,7,1,6,15,37,7,0,0,2019-2020,90.0,150.0,220.0
1895,Daniel Parejo,ESP,MF,Valencia,La Liga,30,1989,33.6,67,41,29,32,6,32,101,31.7,69,38,11,27,22,89,20,2,0,2019-2020,90.0,58.92857142857142,179.4642857142857
1896,Michael Parensen,GER,DF,Union Berlin,Bundesliga,33,1986,7.0,11,6,5,6,0,5,10,50.0,5,14,8,6,12,23,17,0,0,2019-2020,90.0,154.28571428571428,141.42857142857142
1897,Miquel Parera,ESP,GK,Mallorca,La Liga,23,1996,1.0,0,0,0,0,0,0,0,0.0,0,0,0,0,0,0,0,0,0,2019-2020,90.0,0.0,0.0
1898,Marco Parolo,ITA,MF,Lazio,Serie A,34,1985,18.9,54,26,19,27,8,18,46,39.1,28,44,15,29,26,80,49,0,0,2019-2020,90.0,123.80952380952381,257.14285714285717
1899,Troy Parrott,IRL,FW,Tottenham,Premier League,17,2002,0.1,0,0,0,0,0,0,0,0.0,0,0,0,0,0,0,0,0,0,2019-2020,90.0,0.0,0.0
1900,Thomas Partey,GHA,MF,Atlético Madrid,La Liga,26,1993,28.3,70,41,34,30,6,26,58,44.8,32,32,8,24,48,118,41,7,0,2019-2020,90.0,152.6501766784452,222.61484098939928
Rk,Player,Nation,Pos,Squad,Comp,0,0,90.0,0,0,3,3,3,Tkl,0,0.0,0,0,0,0,0,0,0,0,0,2019-2020,90.0,0.0,0.0
1901,Mario Pašalić,CRO,MF,Atalanta,Serie A,24,1995,26.9,47,21,17,18,12,16,52,30.8,36,27,7,20,27,74,22,2,0,2019-2020,90.0,90.33457249070632,157.24907063197028
1902,Javier Pastore,ARG,MF,Roma,Serie A,30,1989,5.7,14,10,3,5,6,5,12,41.7,7,4,0,4,5,19,5,0,0,2019-2020,90.0,78.94736842105263,221.05263157894734
1903,Patric,ESP,DF,Lazio,Serie A,26,1993,18.6,34,20,24,7,3,18,25,72.0,7,19,9,10,15,49,45,0,0,2019-2020,90.0,72.58064516129032,164.51612903225805
1904,Rui Patrício,POR,GK,Wolves,Premier League,31,1988,38.0,0,0,0,0,0,0,2,0.0,2,2,0,2,2,2,5,2,0,2019-2020,90.0,4.7368421052631575,0.0
1905,Paulinho,BRA,"MF,FW",Leverkusen,Bundesliga,19,2000,3.4,4,3,3,1,0,1,2,50.0,1,5,1,4,1,5,0,0,0,2019-2020,90.0,26.470588235294116,105.88235294117646
1906,Paulino,ESP,"FW,MF",Alavés,La Liga,22,1997,0.8,0,0,0,0,0,0,1,0.0,1,1,0,1,1,1,0,0,0,2019-2020,90.0,112.5,0.0
1907,Gabriel Paulista,BRA,DF,Valencia,La Liga,28,1990,31.1,22,14,17,2,3,15,25,60.0,10,36,29,7,48,70,151,3,0,2019-2020,90.0,138.90675241157555,63.665594855305464
1908,Benjamin Pavard,FRA,DF,Bayern Munich,Bundesliga,23,1996,31.0,34,22,15,10,9,16,28,57.1,12,28,10,18,52,86,60,0,0,2019-2020,90.0,150.96774193548387,98.70967741935483
1909,Jiří Pavlenka,CZE,GK,Werder Bremen,Bundesliga,27,1992,33.0,1,0,1,0,0,1,2,50.0,1,1,0,1,5,6,11,3,0,2019-2020,90.0,13.636363636363637,2.7272727272727275
1910,Mateo Pavlović,BIH,DF,Angers,Ligue 1,29,1990,9.0,8,2,6,2,0,5,7,71.4,2,4,2,2,5,13,38,1,0,2019-2020,90.0,50.0,80.0
1911,Leonardo Pavoletti,ITA,FW,Cagliari,Serie A,30,1988,0.5,0,0,0,0,0,0,0,0.0,0,0,0,0,1,1,3,0,0,2019-2020,90.0,180.0,0.0
1912,Dimitri Payet,FRA,"FW,MF",Marseille,Ligue 1,32,1987,21.4,22,12,8,8,6,10,26,38.5,16,8,1,7,8,30,12,0,0,2019-2020,90.0,33.64485981308412,92.52336448598132
1913,Nehuén Paz,ARG,DF,Bologna,Serie A,26,1993,1.3,1,1,0,1,0,0,2,0.0,2,3,3,0,5,6,12,0,0,2019-2020,90.0,346.15384615384613,69.23076923076923
1914,Nehuén Paz,ARG,DF,Lecce,Serie A,26,1993,9.4,14,5,11,3,0,10,12,83.3,2,12,6,6,20,34,38,1,0,2019-2020,90.0,191.48936170212764,134.04255319148936
1915,Giampaolo Pazzini,ITA,"FW,MF",Hellas Verona,Serie A,34,1984,3.4,1,0,0,1,0,0,4,0.0,4,2,0,2,1,2,4,0,0,2019-2020,90.0,26.470588235294116,26.470588235294116
1916,Mads Pedersen,DEN,DF,Augsburg,Bundesliga,22,1996,1.1,4,2,3,0,1,2,6,33.3,4,3,1,2,2,6,0,0,0,2019-2020,90.0,163.63636363636363,327.27272727272725
1917,Alfonso Pedraza,ESP,DF,Betis,La Liga,23,1996,15.0,30,19,16,11,3,19,33,57.6,14,18,6,12,16,46,26,1,0,2019-2020,90.0,96.0,180.0
1918,Marc Pedraza,ESP,MF,Mallorca,La Liga,32,1987,1.4,1,1,1,0,0,1,5,20.0,4,0,0,0,4,5,1,0,0,2019-2020,90.0,257.14285714285717,64.28571428571429
1919,Pedro,ESP,"FW,MF",Chelsea,Premier League,32,1987,7.3,15,7,5,9,1,3,15,20.0,12,9,0,9,9,24,1,0,0,2019-2020,90.0,110.95890410958904,184.93150684931507
1920,Pedro,BRA,FW,Fiorentina,Serie A,22,1997,0.7,1,1,0,0,1,0,0,0.0,0,1,0,1,0,1,0,0,0,2019-2020,90.0,0.0,128.57142857142858
1921,João Pedro,ITA,"FW,MF",Cagliari,Serie A,27,1992,35.0,17,11,5,7,5,4,24,16.7,20,35,8,27,9,26,39,0,0,2019-2020,90.0,23.142857142857142,43.714285714285715
1922,Adrià Pedrosa,ESP,"DF,MF",Espanyol,La Liga,21,1998,12.1,19,13,8,9,2,7,25,28.0,18,12,1,11,11,30,32,0,0,2019-2020,90.0,81.81818181818181,141.32231404958677
1923,Daouda Peeters,BEL,MF,Juventus,Serie A,20,1999,0.2,1,0,0,1,0,1,1,100.0,0,0,0,0,0,1,0,0,0,2019-2020,90.0,0.0,450.0
1924,Jordan Pefok,USA,FW,Rennes,Ligue 1,23,1996,4.9,7,6,1,4,2,0,2,0.0,2,3,0,3,1,8,2,0,0,2019-2020,90.0,18.36734693877551,128.57142857142856
1925,Gianluca Pegolo,ITA,GK,Sassuolo,Serie A,38,1981,5.0,0,0,0,0,0,0,0,0.0,0,0,0,0,0,0,4,0,0,2019-2020,90.0,0.0,0.0
Rk,Player,Nation,Pos,Squad,Comp,0,0,90.0,0,0,3,3,3,Tkl,0,0.0,0,0,0,0,0,0,0,0,0,2019-2020,90.0,0.0,0.0
1926,Peter Pekarík,SVK,"DF,FW",Hertha BSC,Bundesliga,32,1986,8.5,14,7,7,3,4,8,20,40.0,12,11,4,7,7,21,31,0,0,2019-2020,90.0,74.11764705882354,148.23529411764707
1927,Yohann Pelé,FRA,GK,Marseille,Ligue 1,36,1982,1.7,0,0,0,0,0,0,0,0.0,0,0,0,0,0,0,0,0,0,2019-2020,90.0,0.0,0.0
1928,Lorenzo Pellegrini,ITA,MF,Roma,Serie A,23,1996,23.3,30,13,9,13,8,12,33,36.4,21,28,0,28,15,45,18,0,0,2019-2020,90.0,57.93991416309013,115.87982832618026
1929,Luca Pellegrini,ITA,DF,Cagliari,Serie A,20,1999,21.2,31,15,20,7,4,15,38,39.5,23,19,2,17,21,52,45,2,0,2019-2020,90.0,89.15094339622642,131.60377358490567
1930,Théo Pellenard,FRA,DF,Angers,Ligue 1,25,1994,5.1,11,8,6,3,2,6,13,46.2,7,4,0,4,5,16,8,0,0,2019-2020,90.0,88.23529411764706,194.11764705882354
1931,Andy Pelmard,FRA,DF,Nice,Ligue 1,19,2000,8.5,22,14,13,9,0,9,11,81.8,2,12,4,8,15,37,28,1,0,2019-2020,90.0,158.8235294117647,232.94117647058823
1932,Federico Peluso,ITA,DF,Sassuolo,Serie A,35,1984,16.8,19,16,8,8,3,8,9,88.9,1,14,9,5,22,41,58,1,0,2019-2020,90.0,117.85714285714285,101.78571428571428
1933,Rubén Peña,ESP,DF,Villarreal,La Liga,28,1991,21.2,42,24,23,19,0,17,50,34.0,33,25,8,17,35,77,58,2,0,2019-2020,90.0,148.58490566037736,178.30188679245285
1934,Philipp Pentke,GER,GK,Hoffenheim,Bundesliga,34,1985,4.0,0,0,0,0,0,0,0,0.0,0,0,0,0,0,0,2,0,0,2019-2020,90.0,0.0,0.0
1935,Nicolas Pépé,CIV,FW,Arsenal,Premier League,24,1995,22.3,32,17,15,13,4,8,16,50.0,8,15,2,13,8,40,5,0,0,2019-2020,90.0,32.28699551569507,129.14798206278027
1936,Luis Perea,ESP,FW,Osasuna,La Liga,21,1997,0.2,0,0,0,0,0,0,0,0.0,0,0,0,0,0,0,1,0,0,2019-2020,90.0,0.0,0.0
1937,Andreas Pereira,BRA,"MF,FW",Manchester Utd,Premier League,23,1996,16.5,24,13,8,9,7,10,39,25.6,29,13,0,13,7,31,7,0,0,2019-2020,90.0,38.18181818181819,130.9090909090909
1938,Mathias Pereira Lage,POR,MF,Angers,Ligue 1,22,1996,17.1,30,18,16,13,1,12,37,32.4,25,19,0,19,17,47,9,0,0,2019-2020,90.0,89.47368421052632,157.89473684210526
1939,Ricardo Pereira,POR,DF,Leicester City,Premier League,25,1993,28.0,119,68,65,36,18,53,106,50.0,53,38,6,32,49,168,86,0,0,2019-2020,90.0,157.5,382.5
1940,Gastón Pereiro,URU,"MF,FW",Cagliari,Serie A,24,1995,3.9,2,2,2,0,0,1,4,25.0,3,1,0,1,0,2,1,1,0,2019-2020,90.0,0.0,46.15384615384615
1941,Bruno Peres,BRA,DF,Roma,Serie A,29,1990,11.7,14,10,10,3,1,8,21,38.1,13,12,3,9,15,29,19,2,0,2019-2020,89.99999999999999,115.38461538461539,107.6923076923077
1942,Roberto Pereyra,ARG,"FW,MF",Watford,Premier League,28,1991,18.3,20,8,11,7,2,9,28,32.1,19,21,0,21,14,34,12,1,0,2019-2020,90.0,68.85245901639344,98.36065573770492
1943,Ayoze Pérez,ESP,"MF,FW",Leicester City,Premier League,26,1993,22.3,45,28,14,26,5,8,54,14.8,46,33,1,32,14,59,9,1,0,2019-2020,90.0,56.502242152466366,181.61434977578475
1944,Carles Pérez,ESP,"FW,MF",Roma,Serie A,21,1998,6.3,12,8,4,6,2,3,10,30.0,7,6,1,5,3,15,1,0,0,2019-2020,90.0,42.85714285714286,171.42857142857144
1945,Carles Pérez,ESP,FW,Barcelona,La Liga,21,1998,5.3,7,4,2,2,3,3,15,20.0,12,5,2,3,1,8,1,0,0,2019-2020,90.0,16.9811320754717,118.8679245283019
1946,Iñigo Pérez,ESP,MF,Osasuna,La Liga,31,1988,12.0,15,11,3,7,5,8,22,36.4,14,7,1,6,12,27,6,0,0,2019-2020,90.0,90.0,112.5
1947,Juan Pérez,ESP,GK,Osasuna,La Liga,23,1996,2.0,1,1,1,0,0,1,2,50.0,1,0,0,0,0,1,0,0,0,2019-2020,90.0,0.0,45.0
1948,Kike Pérez,ESP,"MF,FW",Valladolid,La Liga,22,1997,2.4,6,1,1,3,2,3,7,42.9,4,1,0,1,10,16,4,0,0,2019-2020,90.0,375.0,225.00000000000003
1949,Lucas Pérez,ESP,FW,Alavés,La Liga,30,1988,27.7,12,6,2,8,2,3,13,23.1,10,13,2,11,2,14,0,0,0,2019-2020,90.0,6.498194945848375,38.98916967509025
1950,Rubén Pérez,ESP,MF,Leganés,La Liga,30,1989,24.4,50,27,21,23,6,16,47,34.0,31,21,4,17,38,88,33,0,0,2019-2020,90.0,140.16393442622953,184.42622950819674
Rk,Player,Nation,Pos,Squad,Comp,0,0,90.0,0,0,3,3,3,Tkl,0,0.0,0,0,0,0,0,0,0,0,0,2019-2020,90.0,0.0,0.0
1951,Samu Pérez,ESP,GK,Valladolid,La Liga,22,1997,0.3,0,0,0,0,0,0,0,0.0,0,0,0,0,0,0,0,0,0,2019-2020,90.0,0.0,0.0
1952,Mattia Perin,ITA,GK,Genoa,Serie A,26,1992,21.0,1,1,1,0,0,1,1,100.0,0,1,0,1,0,1,5,1,0,2019-2020,90.0,0.0,4.285714285714286
1953,Ivan Perišić,CRO,"FW,MF",Bayern Munich,Bundesliga,30,1989,13.4,16,12,5,6,5,8,33,24.2,25,14,3,11,4,20,8,0,0,2019-2020,90.0,26.865671641791042,107.46268656716417
1954,Diego Perotti,ARG,"FW,MF",Roma,Serie A,31,1988,9.7,16,13,5,8,3,5,20,25.0,15,14,0,14,3,19,6,0,0,2019-2020,90.0,27.835051546391757,148.4536082474227
1955,Romain Perraud,FRA,DF,Brest,Ligue 1,21,1997,18.6,29,14,18,9,2,14,28,50.0,14,24,9,15,27,56,50,0,0,2019-2020,90.0,130.64516129032256,140.32258064516128
1956,Loïc Perrin,FRA,DF,Saint-Étienne,Ligue 1,33,1985,19.0,27,20,16,11,0,11,14,78.6,3,23,17,6,39,66,59,0,0,2019-2020,90.0,184.73684210526315,127.89473684210526
1957,Lucas Perrin,FRA,DF,Marseille,Ligue 1,20,1998,4.0,5,2,3,2,0,2,7,28.6,5,3,2,1,10,15,17,0,0,2019-2020,90.0,225.0,112.5
1958,Pavao Pervan,AUT,GK,Wolfsburg,Bundesliga,31,1987,8.0,0,0,0,0,0,0,1,0.0,1,0,0,0,0,0,4,0,0,2019-2020,90.0,0.0,0.0
1959,Matteo Pessina,ITA,MF,Hellas Verona,Serie A,22,1997,27.7,35,21,9,20,6,12,33,36.4,21,28,8,20,25,60,40,2,0,2019-2020,90.0,81.2274368231047,113.71841155234658
1960,Andrea Petagna,ITA,FW,SPAL,Serie A,24,1995,33.7,9,4,2,7,0,3,17,17.6,14,11,5,6,1,10,27,0,0,2019-2020,90.0,2.6706231454005933,24.03560830860534
1961,Nils Petersen,GER,"FW,MF",Freiburg,Bundesliga,30,1988,27.1,19,14,7,9,3,10,28,35.7,18,32,6,26,10,29,67,0,0,2019-2020,90.0,33.210332103321036,63.09963099630996
1962,Danijel Petković,MNE,GK,Angers,Ligue 1,26,1993,2.0,0,0,0,0,0,0,0,0.0,0,0,0,0,0,0,2,0,0,2019-2020,90.0,0.0,0.0
1963,Denis Petrić,SRB,GK,Nantes,Ligue 1,31,1988,1.0,1,1,1,0,0,1,1,100.0,0,0,0,0,0,1,0,0,0,2019-2020,90.0,0.0,90.0
1964,Jacopo Petriccione,ITA,MF,Lecce,Serie A,24,1995,23.8,38,20,29,9,0,15,57,26.3,42,20,7,13,28,66,25,2,0,2019-2020,90.00000000000001,105.88235294117648,143.69747899159665
1965,Germán Pezzella,ARG,DF,Fiorentina,Serie A,28,1991,31.4,36,18,26,9,1,14,32,43.8,18,31,20,11,55,91,134,1,0,2019-2020,90.0,157.64331210191085,103.18471337579619
1966,Giuseppe Pezzella,ITA,DF,Udinese,Serie A,21,1997,0.9,0,0,0,0,0,0,0,0.0,0,0,0,0,1,1,4,0,0,2019-2020,90.0,100.0,0.0
1967,Giuseppe Pezzella,ITA,DF,Parma,Serie A,21,1997,10.5,20,12,17,3,0,11,19,57.9,8,13,9,4,6,26,30,0,0,2019-2020,90.0,51.42857142857143,171.42857142857142
1968,Rayan Philippe,FRA,FW,Dijon,Ligue 1,18,2000,0.3,0,0,0,0,0,0,1,0.0,1,0,0,0,1,1,1,1,0,2019-2020,90.0,300.0,0.0
1969,Romain Philippoteaux,FRA,"FW,MF",Nîmes,Ligue 1,31,1988,22.2,23,12,11,11,1,9,43,20.9,34,22,1,21,13,36,10,0,0,2019-2020,90.0,52.70270270270271,93.24324324324326
1970,Krzysztof Piątek,POL,FW,Milan,Serie A,24,1995,13.1,9,4,0,7,2,3,11,27.3,8,5,2,3,3,12,10,0,0,2019-2020,90.0,20.610687022900763,61.832061068702295
1971,Krzysztof Piątek,POL,FW,Hertha BSC,Bundesliga,24,1995,10.1,5,4,1,1,3,0,11,0.0,11,7,0,7,5,10,3,0,0,2019-2020,90.0,44.554455445544555,44.554455445544555
1972,Pablo Piatti,ARG,"DF,MF",Espanyol,La Liga,30,1989,0.6,2,2,1,1,0,1,2,50.0,1,1,0,1,0,2,1,0,0,2019-2020,90.0,0.0,300.0
1973,Cristiano Piccini,ITA,DF,Valencia,La Liga,26,1992,0.8,5,4,1,0,4,4,4,100.0,0,0,0,0,2,7,1,0,0,2019-2020,90.0,225.0,562.5
1974,Stefano Piccinini,ITA,DF,Sassuolo,Serie A,16,2002,0.1,0,0,0,0,0,0,0,0.0,0,0,0,0,0,0,0,0,0,2019-2020,90.0,0.0,0.0
1975,Roberto Piccoli,ITA,FW,Atalanta,Serie A,18,2001,0.2,0,0,0,0,0,0,0,0.0,0,1,0,1,0,0,0,0,0,2019-2020,90.0,0.0,0.0
Rk,Player,Nation,Pos,Squad,Comp,0,0,90.0,0,0,3,3,3,Tkl,0,0.0,0,0,0,0,0,0,0,0,0,2019-2020,90.0,0.0,0.0
1976,Jordan Pickford,ENG,GK,Everton,Premier League,25,1994,38.0,0,0,0,0,0,0,4,0.0,4,0,0,0,3,3,12,6,0,2019-2020,90.0,7.105263157894737,0.0
1977,Jérémy Pied,FRA,DF,Lille,Ligue 1,30,1989,5.0,18,10,6,11,1,11,16,68.8,5,8,0,8,7,25,10,0,0,2019-2020,90.0,126.0,324.0
1978,Ronaël Pierre-Gabriel,FRA,DF,Mainz 05,Bundesliga,21,1998,6.4,16,10,9,6,1,7,13,53.8,6,7,0,7,8,24,31,1,0,2019-2020,90.0,112.5,225.0
1979,Brandon Pierrick,ENG,"MF,FW",Crystal Palace,Premier League,17,2001,0.2,0,0,0,0,0,0,0,0.0,0,0,0,0,0,0,1,0,0,2019-2020,90.0,0.0,0.0
1980,Erik Pieters,NED,"DF,MF",Burnley,Premier League,30,1988,20.9,54,32,18,29,7,28,69,40.6,41,30,4,26,28,82,60,1,0,2019-2020,90.0,120.57416267942584,232.53588516746413
1981,Tomás Pina Isla,ESP,MF,Alavés,La Liga,31,1987,14.9,37,22,13,21,3,12,24,50.0,12,15,5,10,16,53,31,0,0,2019-2020,90.0,96.64429530201342,223.48993288590603
1982,Andrea Pinamonti,ITA,FW,Genoa,Serie A,20,1999,24.8,19,12,1,7,11,5,25,20.0,20,19,2,17,9,28,25,0,0,2019-2020,90.0,32.66129032258065,68.95161290322581
1983,Simone Pinna,ITA,DF,Cagliari,Serie A,21,1997,1.0,1,1,0,1,0,0,0,0.0,0,3,1,2,5,6,4,1,0,2019-2020,90.0,450.0,90.0
1984,Carlo Pinsoglio,ITA,GK,Juventus,Serie A,29,1990,0.2,0,0,0,0,0,0,0,0.0,0,0,0,0,0,0,0,0,0,2019-2020,90.0,0.0,0.0
1985,Pipa,ESP,"DF,FW",Espanyol,La Liga,21,1998,5.3,9,8,5,4,0,4,6,66.7,2,8,0,8,6,15,17,0,0,2019-2020,90.0,101.88679245283019,152.83018867924528
1986,Gerard Piqué,ESP,DF,Barcelona,La Liga,32,1987,34.4,32,23,20,11,1,16,26,61.5,10,39,24,15,36,68,157,0,0,2019-2020,90.0,94.18604651162792,83.72093023255815
1987,Lorenzo Pirola,ITA,DF,Inter,Serie A,17,2002,0.1,0,0,0,0,0,0,0,0.0,0,0,0,0,1,1,0,0,0,2019-2020,90.0,900.0,0.0
1988,Fabio Pisacane,ITA,DF,Cagliari,Serie A,33,1986,27.1,32,21,22,10,0,21,37,56.8,16,36,28,8,27,59,110,2,0,2019-2020,90.0,89.66789667896678,106.2730627306273
1989,Łukasz Piszczek,POL,DF,Dortmund,Bundesliga,34,1985,23.4,45,32,27,16,2,28,50,56.0,22,27,11,16,26,71,47,1,0,2019-2020,89.99999999999999,100.0,173.07692307692307
1990,Claudio Pizarro,PER,"FW,MF",Werder Bremen,Bundesliga,40,1978,2.6,2,1,0,1,1,0,1,0.0,1,2,0,2,2,4,2,0,0,2019-2020,90.0,69.23076923076923,69.23076923076923
1991,Miralem Pjanić,BIH,MF,Juventus,Serie A,29,1990,25.3,46,21,16,23,7,21,63,33.3,42,29,12,17,32,78,30,0,0,2019-2020,89.99999999999999,113.83399209486164,163.63636363636363
1992,Óscar Plano,ESP,MF,Valladolid,La Liga,28,1991,27.8,48,30,25,19,4,20,61,32.8,41,36,3,33,35,83,29,0,0,2019-2020,90.0,113.30935251798562,155.3956834532374
1993,Marvin Plattenhardt,GER,DF,Hertha BSC,Bundesliga,27,1992,15.5,18,12,13,4,1,12,17,70.6,5,18,7,11,11,29,47,0,0,2019-2020,90.0,63.87096774193549,104.51612903225806
1994,Alassane Pléa,FRA,FW,Gladbach,Bundesliga,26,1993,23.8,16,7,5,6,5,8,28,28.6,20,21,2,19,9,25,7,0,0,2019-2020,90.00000000000001,34.03361344537815,60.504201680672274
1995,Thomas Pledl,GER,"MF,FW",Düsseldorf,Bundesliga,25,1994,1.0,4,2,2,2,0,0,1,0.0,1,0,0,0,0,4,1,0,0,2019-2020,90.0,0.0,360.0
1996,Daniel Podence,POR,"FW,MF",Wolves,Premier League,23,1995,3.2,3,3,2,0,1,0,2,0.0,2,4,1,3,2,5,1,0,0,2019-2020,90.0,56.25,84.375
1997,Paul Pogba,FRA,MF,Manchester Utd,Premier League,26,1993,13.4,20,9,8,8,4,8,16,50.0,8,12,4,8,7,27,10,2,0,2019-2020,90.0,47.014925373134325,134.32835820895522
1998,Joel Pohjanpalo,FIN,MF,Leverkusen,Bundesliga,24,1994,0.0,0,0,0,0,0,0,0,0.0,0,0,0,0,0,0,0,0,0,2019-2020,,,
1999,Andrea Poli,ITA,MF,Bologna,Serie A,29,1989,21.3,44,24,19,21,4,16,52,30.8,36,19,3,16,40,84,11,0,0,2019-2020,90.0,169.01408450704224,185.9154929577465
2000,Matteo Politano,ITA,FW,Napoli,Serie A,25,1993,8.3,12,6,8,2,2,5,14,35.7,9,6,0,6,5,17,3,0,0,2019-2020,90.0,54.21686746987951,130.12048192771084
Rk,Player,Nation,Pos,Squad,Comp,0,0,90.0,0,0,3,3,3,Tkl,0,0.0,0,0,0,0,0,0,0,0,0,2019-2020,90.0,0.0,0.0
2001,Matteo Politano,ITA,"FW,MF",Inter,Serie A,25,1993,2.9,0,0,0,0,0,0,2,0.0,2,1,0,1,0,0,1,0,0,2019-2020,90.0,0.0,0.0
2002,Sebastian Polter,GER,FW,Union Berlin,Bundesliga,28,1991,3.7,2,2,0,1,1,1,3,33.3,2,2,0,2,1,3,1,0,0,2019-2020,90.0,24.324324324324323,48.648648648648646
2003,Marin Pongračić,CRO,DF,Wolfsburg,Bundesliga,21,1997,10.3,14,9,11,2,1,9,10,90.0,1,11,7,4,19,33,21,1,0,2019-2020,90.0,166.01941747572815,122.33009708737863
2004,Pere Pons,ESP,MF,Alavés,La Liga,26,1993,12.1,28,16,14,12,2,12,26,46.2,14,16,3,13,12,40,8,1,0,2019-2020,90.0,89.25619834710743,208.26446280991735
2005,Nick Pope,ENG,GK,Burnley,Premier League,27,1992,38.0,1,1,1,0,0,1,2,50.0,1,0,0,0,3,4,15,3,0,2019-2020,90.0,7.105263157894737,2.3684210526315788
2006,Pedro Porro,ESP,"DF,MF",Valladolid,La Liga,19,1999,8.2,18,10,11,7,0,10,18,55.6,8,3,0,3,7,25,19,1,0,2019-2020,90.0,76.82926829268294,197.56097560975613
2007,Francisco Portillo,ESP,MF,Getafe,La Liga,29,1990,4.2,11,6,3,6,2,4,12,33.3,8,2,0,2,2,13,3,0,0,2019-2020,90.0,42.857142857142854,235.7142857142857
2008,Portu,ESP,"FW,MF",Real Sociedad,La Liga,27,1992,26.6,32,21,10,15,7,13,33,39.4,20,28,3,25,13,45,5,0,0,2019-2020,90.0,43.984962406015036,108.27067669172932
2009,Stefan Posch,AUT,DF,Hoffenheim,Bundesliga,22,1997,25.6,63,34,35,27,1,35,63,55.6,28,57,25,32,40,103,101,1,0,2019-2020,90.0,140.625,221.484375
2010,Sergio Postigo,ESP,DF,Levante,La Liga,30,1988,26.4,32,15,23,7,2,11,18,61.1,7,24,15,9,34,66,132,1,0,2019-2020,90.0,115.9090909090909,109.0909090909091
2011,Florent Poulolo,MTQ,DF,Getafe,La Liga,22,1997,0.0,0,0,0,0,0,0,0,0.0,0,0,0,0,0,0,1,0,0,2019-2020,,,
2012,Yussuf Poulsen,DEN,FW,RB Leipzig,Bundesliga,25,1994,13.6,14,10,2,10,2,4,21,19.0,17,12,0,12,4,18,15,0,0,2019-2020,90.0,26.470588235294116,92.6470588235294
2013,Maxime Poundjé,FRA,DF,Bordeaux,Ligue 1,26,1992,0.0,0,0,0,0,0,0,0,0.0,0,0,0,0,0,0,0,0,0,2019-2020,,,
2014,Darío Poveda,ESP,MF,Atlético Madrid,La Liga,22,1997,0.1,1,0,0,1,0,0,0,0.0,0,0,0,0,0,1,0,0,0,2019-2020,90.0,0.0,900.0
2015,Alejandro Pozo Pozo,ESP,DF,Mallorca,La Liga,20,1999,16.6,38,24,30,6,2,19,38,50.0,19,23,2,21,23,61,29,1,0,2019-2020,90.0,124.69879518072288,206.02409638554215
2016,Alejandro Pozo Pozo,ESP,"MF,FW",Sevilla,La Liga,20,1999,0.4,1,1,1,0,0,1,1,100.0,0,0,0,0,0,1,1,0,0,2019-2020,90.0,0.0,225.0
2017,Percy Prado,PER,DF,Nantes,Ligue 1,23,1996,2.1,6,5,3,2,1,5,9,55.6,4,1,0,1,1,7,5,0,0,2019-2020,90.0,42.857142857142854,257.1428571428571
2018,Dennis Praet,BEL,MF,Leicester City,Premier League,25,1994,12.6,33,18,8,21,4,9,29,31.0,20,19,1,18,17,50,12,0,0,2019-2020,90.0,121.42857142857144,235.71428571428575
2019,Abdón Prats,ESP,FW,Mallorca,La Liga,26,1992,3.1,1,1,0,0,1,0,1,0.0,1,1,0,1,0,1,1,0,0,2019-2020,90.0,0.0,29.032258064516128
2020,Sanjin Prcić,BIH,"MF,FW",Strasbourg,Ligue 1,25,1993,0.9,1,0,0,0,1,1,2,50.0,1,1,1,0,1,2,0,0,0,2019-2020,90.0,100.0,100.0
2021,Nicolas de Préville,FRA,"MF,FW",Bordeaux,Ligue 1,28,1991,22.2,35,21,9,22,4,18,56,32.1,38,15,3,12,6,41,19,0,0,2019-2020,90.0,24.324324324324326,141.8918918918919
2022,Sebastian Prödl,AUT,DF,Watford,Premier League,32,1987,0.6,0,0,0,0,0,0,0,0.0,0,0,0,0,0,0,4,0,0,2019-2020,90.0,0.0,0.0
2023,Kai Pröger,GER,"MF,FW",Paderborn 07,Bundesliga,27,1992,23.1,43,22,21,17,5,17,58,29.3,41,34,6,28,14,57,20,1,0,2019-2020,89.99999999999999,54.54545454545454,167.5324675324675
2024,Grischa Prömel,GER,MF,Union Berlin,Bundesliga,24,1995,10.3,14,11,6,6,2,7,19,36.8,12,10,2,8,14,28,9,0,0,2019-2020,90.0,122.33009708737863,122.33009708737863
2025,Davy Pröpper,NED,MF,Brighton,Premier League,27,1991,31.4,64,35,28,28,8,23,74,31.1,51,27,8,19,38,102,36,4,0,2019-2020,90.0,108.9171974522293,183.4394904458599
Rk,Player,Nation,Pos,Squad,Comp,0,0,90.0,0,0,3,3,3,Tkl,0,0.0,0,0,0,0,0,0,0,0,0,2019-2020,90.0,0.0,0.0
2026,Antonio Puertas,ESP,"FW,MF",Granada,La Liga,27,1992,28.5,37,24,8,18,11,16,53,30.2,37,21,3,18,12,49,21,0,0,2019-2020,90.0,37.89473684210527,116.8421052631579
2027,Riqui Puig,ESP,MF,Barcelona,La Liga,19,1999,5.7,11,7,1,9,1,5,17,29.4,12,2,0,2,5,16,1,0,0,2019-2020,90.0,78.94736842105263,173.68421052631578
2028,Teemu Pukki,FIN,FW,Norwich City,Premier League,29,1990,32.1,12,6,3,5,4,1,23,4.3,22,13,0,13,6,18,7,0,0,2019-2020,90.0,16.822429906542055,33.64485981308411
2029,Erick Pulgar,CHI,MF,Fiorentina,Serie A,25,1994,32.8,73,46,25,41,7,22,96,22.9,74,45,15,30,49,122,53,1,0,2019-2020,90.0,134.45121951219514,200.30487804878052
2030,Christian Pulisic,USA,FW,Chelsea,Premier League,20,1998,19.1,23,11,13,4,6,7,24,29.2,17,15,0,15,6,29,11,0,0,2019-2020,90.0,28.272251308900522,108.37696335078533
2031,Ignacio Pussetto,ARG,"FW,MF",Watford,Premier League,23,1995,0.8,7,4,4,2,1,3,8,37.5,5,2,1,1,3,10,4,0,0,2019-2020,90.0,337.5,787.5
2032,Ignacio Pussetto,ARG,"FW,MF",Udinese,Serie A,23,1995,3.8,8,4,4,3,1,1,4,25.0,3,3,0,3,4,12,7,0,0,2019-2020,90.0,94.73684210526315,189.4736842105263
2033,Fabio Quagliarella,ITA,FW,Sampdoria,Serie A,36,1983,25.3,9,5,0,6,3,2,30,6.7,28,13,0,13,8,17,15,0,0,2019-2020,89.99999999999999,28.45849802371541,32.01581027667984
2034,Robin Quaison,SWE,"FW,MF",Mainz 05,Bundesliga,25,1993,28.9,25,17,15,7,3,11,32,34.4,21,27,5,22,11,36,8,0,0,2019-2020,90.00000000000001,34.256055363321806,77.85467128027683
2035,Domingos Quina,POR,"MF,FW",Watford,Premier League,19,1999,0.2,2,0,1,1,0,1,2,50.0,1,3,0,3,0,2,0,0,0,2019-2020,90.0,0.0,900.0
2036,Quini,ESP,DF,Granada,La Liga,29,1989,8.0,25,14,16,7,2,13,22,59.1,9,5,1,4,10,35,14,0,0,2019-2020,90.0,112.5,281.25
2037,Xavi Quintillà,ESP,DF,Villarreal,La Liga,22,1996,17.5,22,12,14,4,4,10,20,50.0,10,11,4,7,12,34,35,0,0,2019-2020,90.0,61.714285714285715,113.14285714285714
2038,Quique,ESP,"FW,MF",Eibar,La Liga,29,1990,5.4,2,1,1,0,1,0,0,0.0,0,3,0,3,0,2,3,0,0,2019-2020,90.0,0.0,33.33333333333333
2039,Adrien Rabiot,FRA,MF,Juventus,Serie A,24,1995,21.2,47,31,16,19,12,15,41,36.6,26,36,6,30,32,79,19,0,0,2019-2020,90.0,135.8490566037736,199.52830188679246
2040,Nemanja Radoja,SRB,MF,Levante,La Liga,26,1993,22.1,43,19,27,16,0,15,46,32.6,31,21,4,17,23,66,24,0,0,2019-2020,90.0,93.66515837104072,175.1131221719457
2041,Nemanja Radonjić,SRB,"FW,MF",Marseille,Ligue 1,23,1996,9.8,10,3,4,3,3,6,17,35.3,11,7,0,7,2,12,7,0,0,2019-2020,90.0,18.36734693877551,91.83673469387755
2042,Ivan Radovanović,SRB,MF,Genoa,Serie A,30,1988,14.6,27,14,18,9,0,10,26,38.5,16,17,3,14,8,35,39,0,0,2019-2020,90.0,49.31506849315069,166.43835616438358
2043,Ionuț Radu,ROU,GK,Genoa,Serie A,22,1997,17.0,0,0,0,0,0,0,2,0.0,2,0,0,0,1,1,7,1,0,2019-2020,90.0,5.294117647058823,0.0
2044,Ștefan Radu,ROU,DF,Lazio,Serie A,32,1986,25.6,43,25,24,15,4,28,43,65.1,15,19,9,10,34,77,85,0,0,2019-2020,90.0,119.53125,151.171875
2045,Boris Radunović,SRB,GK,Hellas Verona,Serie A,23,1996,3.0,0,0,0,0,0,0,0,0.0,0,0,0,0,0,0,1,0,0,2019-2020,90.0,0.0,0.0
2046,Rafael,BRA,GK,Cagliari,Serie A,37,1982,5.0,0,0,0,0,0,0,0,0.0,0,0,0,0,0,0,3,0,0,2019-2020,90.0,0.0,0.0
2047,Rafael,BRA,DF,Lyon,Ligue 1,29,1990,7.8,24,16,12,8,4,10,18,55.6,8,6,3,3,10,34,14,0,0,2019-2020,90.0,115.38461538461539,276.9230769230769
2048,Raffael,BRA,"MF,FW",Gladbach,Bundesliga,34,1985,0.7,0,0,0,0,0,0,2,0.0,2,2,0,2,0,0,0,0,0,2019-2020,90.0,0.0,0.0
2049,Rafinha,BRA,"FW,MF",Barcelona,La Liga,26,1993,2.1,3,2,1,1,1,1,2,50.0,1,0,0,0,1,4,0,0,0,2019-2020,90.0,42.857142857142854,128.57142857142856
2050,Rafinha,BRA,MF,Celta Vigo,La Liga,26,1993,23.5,71,37,29,37,5,20,62,32.3,42,37,4,33,33,104,25,0,0,2019-2020,90.0,126.38297872340425,271.9148936170213
Rk,Player,Nation,Pos,Squad,Comp,0,0,90.0,0,0,3,3,3,Tkl,0,0.0,0,0,0,0,0,0,0,0,0,2019-2020,90.0,0.0,0.0
2051,Daniele Ragatzu,ITA,"MF,FW",Cagliari,Serie A,27,1991,3.5,3,2,0,2,1,1,3,33.3,2,1,0,1,1,4,5,0,0,2019-2020,90.0,25.714285714285715,77.14285714285714
2052,Baba Rahman,GHA,DF,Mallorca,La Liga,25,1994,1.2,3,2,2,0,1,0,0,0.0,0,2,1,1,1,4,2,0,0,2019-2020,90.0,75.0,225.00000000000003
2053,Antonio Raillo,ESP,DF,Mallorca,La Liga,27,1991,30.8,31,21,24,7,0,13,19,68.4,6,31,26,5,22,53,112,1,0,2019-2020,90.0,64.28571428571429,90.5844155844156
2054,Predrag Rajković,SRB,GK,Reims,Ligue 1,23,1995,27.0,1,1,1,0,0,1,1,100.0,0,0,0,0,1,2,9,0,0,2019-2020,90.0,3.3333333333333335,3.3333333333333335
2055,Ivan Rakitić,CRO,MF,Barcelona,La Liga,31,1988,17.7,27,14,8,15,4,10,28,35.7,18,19,6,13,15,42,18,1,0,2019-2020,90.0,76.27118644067797,137.28813559322035
2056,Benito Raman,BEL,FW,Schalke 04,Bundesliga,24,1994,17.8,18,9,4,9,5,7,24,29.2,17,11,1,10,7,25,1,0,0,2019-2020,90.0,35.39325842696629,91.01123595505618
2057,Gastón Ramírez,URU,"MF,FW",Sampdoria,Serie A,28,1990,15.5,32,21,7,16,9,8,30,26.7,22,28,2,26,11,43,10,0,0,2019-2020,90.0,63.87096774193549,185.80645161290323
2058,Sandro Ramírez,ESP,"FW,MF",Valladolid,La Liga,24,1995,14.5,12,10,2,6,4,2,20,10.0,18,11,1,10,7,19,2,0,0,2019-2020,90.0,43.44827586206896,74.48275862068965
2059,Iván Ramis,ESP,DF,Eibar,La Liga,34,1984,5.1,3,2,2,1,0,1,4,25.0,3,2,0,2,4,7,23,2,0,2019-2020,90.0,70.58823529411765,52.94117647058824
2060,Adrián Ramos,COL,"FW,MF",Granada,La Liga,33,1986,2.5,6,2,0,2,4,2,3,66.7,1,2,0,2,1,7,1,0,0,2019-2020,90.0,36.0,216.0
2061,Sergio Ramos,ESP,DF,Real Madrid,La Liga,33,1986,33.5,46,31,26,17,3,20,42,47.6,22,22,9,13,49,95,102,4,0,2019-2020,90.0,131.6417910447761,123.5820895522388
2062,Aaron Ramsdale,ENG,GK,Bournemouth,Premier League,21,1998,37.0,4,3,4,0,0,3,3,100.0,0,0,0,0,0,4,25,1,0,2019-2020,90.0,0.0,9.72972972972973
2063,Aaron Ramsey,WAL,MF,Juventus,Serie A,28,1990,11.7,20,15,6,8,6,6,24,25.0,18,18,3,15,11,31,12,0,0,2019-2020,89.99999999999999,84.61538461538461,153.84615384615384
2064,Darren Randolph,IRL,GK,West Ham,Premier League,32,1987,2.0,0,0,0,0,0,0,0,0.0,0,0,0,0,0,0,2,0,0,2019-2020,90.0,0.0,0.0
2065,Luca Ranieri,ITA,DF,Fiorentina,Serie A,20,1999,2.6,2,2,2,0,0,2,3,66.7,1,1,0,1,2,4,7,0,0,2019-2020,90.0,69.23076923076923,69.23076923076923
2066,Andrea Ranocchia,ITA,DF,Inter,Serie A,31,1988,5.8,17,10,10,7,0,5,8,62.5,3,11,6,5,8,25,18,0,0,2019-2020,90.0,124.13793103448276,263.7931034482759
2067,Raphinha,BRA,"MF,FW",Rennes,Ligue 1,22,1996,18.8,22,18,5,12,5,10,32,31.3,22,23,1,22,17,39,14,1,0,2019-2020,90.0,81.38297872340425,105.31914893617021
2068,Tobias Raschl,GER,MF,Dortmund,Bundesliga,19,2000,0.3,0,0,0,0,0,0,1,0.0,1,1,0,1,0,0,0,0,0,2019-2020,90.0,0.0,0.0
2069,Marcus Rashford,ENG,FW,Manchester Utd,Premier League,21,1997,29.4,13,9,1,6,6,9,23,39.1,14,23,0,23,10,23,19,0,0,2019-2020,90.0,30.612244897959183,39.79591836734694
2070,Milot Rashica,KVX,FW,Werder Bremen,Bundesliga,23,1996,25.2,21,14,13,6,2,9,33,27.3,24,15,2,13,6,27,16,1,0,2019-2020,90.0,21.42857142857143,75.00000000000001
2071,Giacomo Raspadori,ITA,"MF,FW",Sassuolo,Serie A,19,2000,2.9,8,6,5,2,1,3,4,75.0,1,5,0,5,1,9,0,0,0,2019-2020,90.0,31.03448275862069,248.27586206896552
2072,Raúl,ESP,"FW,MF",Betis,La Liga,18,2000,0.2,0,0,0,0,0,0,2,0.0,2,0,0,0,0,0,0,0,0,2019-2020,90.0,0.0,0.0
2073,Ante Rebić,CRO,"FW,MF",Milan,Serie A,25,1993,15.5,16,11,4,9,3,7,34,20.6,27,14,1,13,3,19,12,0,0,2019-2020,90.0,17.419354838709676,92.90322580645162
2074,Ante Rebić,CRO,"FW,MF",Eint Frankfurt,Bundesliga,25,1993,1.0,1,0,0,1,0,0,0,0.0,0,0,0,0,0,1,1,0,0,2019-2020,90.0,0.0,90.0
2075,Arkadiusz Reca,POL,DF,SPAL,Serie A,24,1995,21.4,38,23,22,10,6,13,39,33.3,26,15,2,13,32,70,48,1,0,2019-2020,90.0,134.57943925233647,159.81308411214954
Rk,Player,Nation,Pos,Squad,Comp,0,0,90.0,0,0,3,3,3,Tkl,0,0.0,0,0,0,0,0,0,0,0,0,2019-2020,90.0,0.0,0.0
2076,Recio,ESP,MF,Leganés,La Liga,28,1991,17.4,30,19,13,12,5,10,40,25.0,30,14,3,11,22,52,9,0,0,2019-2020,90.0,113.79310344827586,155.17241379310346
2077,Daishawn Redan,NED,MF,Hertha BSC,Bundesliga,18,2001,0.2,0,0,0,0,0,0,1,0.0,1,0,0,0,0,0,0,0,0,2019-2020,90.0,0.0,0.0
2078,Nathan Redmond,ENG,"MF,FW",Southampton,Premier League,25,1994,30.7,49,29,17,23,9,21,57,36.8,36,39,2,37,16,65,16,0,0,2019-2020,90.0,46.905537459283394,143.6482084690554
2079,Fabian Reese,GER,FW,Schalke 04,Bundesliga,21,1997,1.0,1,1,1,0,0,0,0,0.0,0,1,1,0,0,1,1,0,0,2019-2020,90.0,0.0,90.0
2080,Vasco Regini,ITA,DF,Sampdoria,Serie A,28,1990,1.9,4,2,3,1,0,0,0,0.0,0,4,2,2,1,5,6,0,0,2019-2020,90.0,47.368421052631575,189.4736842105263
2081,Vasco Regini,ITA,DF,Parma,Serie A,28,1990,0.6,0,0,0,0,0,0,0,0.0,0,0,0,0,0,0,3,0,0,2019-2020,90.0,0.0,0.0
2082,Sergio Reguilón,ESP,DF,Sevilla,La Liga,22,1996,27.9,57,30,28,25,4,27,64,42.2,37,25,5,20,33,90,53,0,0,2019-2020,90.0,106.45161290322581,183.8709677419355
2083,Ken Reichel,GER,DF,Union Berlin,Bundesliga,32,1986,5.9,6,3,2,3,1,3,13,23.1,10,8,1,7,9,15,12,0,0,2019-2020,90.0,137.28813559322032,91.52542372881355
2084,Manolo Reina,ESP,GK,Mallorca,La Liga,34,1985,36.0,0,0,0,0,0,0,1,0.0,1,2,0,2,5,5,9,1,0,2019-2020,90.0,12.5,0.0
2085,Pepe Reina,ESP,GK,Aston Villa,Premier League,36,1982,12.0,0,0,0,0,0,0,2,0.0,2,0,0,0,0,0,9,1,0,2019-2020,90.0,0.0,0.0
2086,Pepe Reina,ESP,GK,Milan,Serie A,36,1982,1.0,0,0,0,0,0,0,0,0.0,0,0,0,0,0,0,0,1,0,2019-2020,90.0,0.0,0.0
2087,Jeff Reine-Adélaïde,FRA,MF,Angers,Ligue 1,21,1998,0.9,3,1,1,2,0,1,1,100.0,0,1,0,1,0,3,1,0,0,2019-2020,90.0,0.0,300.0
2088,Jeff Reine-Adélaïde,FRA,"MF,FW",Lyon,Ligue 1,21,1998,8.7,10,8,3,3,4,5,13,38.5,8,3,1,2,7,17,4,0,0,2019-2020,90.0,72.41379310344827,103.44827586206897
2089,Karim Rekik,NED,DF,Hertha BSC,Bundesliga,24,1994,14.0,16,10,10,6,0,3,6,50.0,3,23,15,8,18,34,44,0,0,2019-2020,90.0,115.71428571428571,102.85714285714286
2090,Álex Remiro,ESP,GK,Real Sociedad,La Liga,24,1995,25.0,0,0,0,0,0,0,1,0.0,1,0,0,0,0,0,25,1,0,2019-2020,90.0,0.0,0.0
2091,Loïc Rémy,FRA,FW,Lille,Ligue 1,32,1987,10.7,4,1,0,3,1,0,4,0.0,4,1,1,0,0,4,7,0,0,2019-2020,90.0,0.0,33.64485981308412
2092,Panagiotis Retsos,GRE,DF,Leverkusen,Bundesliga,20,1998,1.3,6,3,4,2,0,1,4,25.0,3,2,0,2,2,8,2,0,0,2019-2020,90.0,138.46153846153845,415.38461538461536
2093,Marco Reus,GER,"MF,FW",Dortmund,Bundesliga,30,1989,16.6,26,16,5,11,10,3,19,15.8,16,17,2,15,9,35,11,0,0,2019-2020,90.0,48.79518072289156,140.96385542168673
2094,Elvis Rexhbeçaj,GER,MF,Köln,Bundesliga,21,1997,6.9,16,12,9,5,2,5,13,38.5,8,7,0,7,3,19,4,0,0,2019-2020,90.0,39.13043478260869,208.69565217391303
2095,Gio Reyna,USA,"MF,FW",Dortmund,Bundesliga,16,2002,3.9,6,2,1,5,0,1,4,25.0,3,3,0,3,0,6,2,0,0,2019-2020,90.0,0.0,138.46153846153845
2096,Baptiste Reynet,FRA,GK,Toulouse,Ligue 1,28,1990,22.6,1,1,1,0,0,1,3,33.3,2,0,0,0,0,1,12,0,0,2019-2020,90.0,0.0,3.982300884955752
2097,Nico Ribaudo,ESP,"FW,MF",Espanyol,La Liga,18,2001,2.0,3,1,1,0,2,2,6,33.3,4,1,0,1,1,4,0,0,0,2019-2020,90.0,45.0,135.0
2098,Lucas Ribeiro,BRA,MF,Hoffenheim,Bundesliga,20,1999,0.7,1,0,1,0,0,0,3,0.0,3,1,0,1,1,2,1,0,0,2019-2020,90.0,128.57142857142858,128.57142857142858
2099,Franck Ribéry,FRA,FW,Fiorentina,Serie A,36,1983,15.7,20,14,7,10,3,4,20,20.0,16,9,0,9,3,23,3,0,0,2019-2020,90.0,17.197452229299365,114.64968152866243
2100,Davide Riccardi,ITA,DF,Lecce,Serie A,23,1996,0.2,0,0,0,0,0,0,1,0.0,1,0,0,0,0,0,1,0,0,2019-2020,90.0,0.0,0.0
Rk,Player,Nation,Pos,Squad,Comp,0,0,90.0,0,0,3,3,3,Tkl,0,0.0,0,0,0,0,0,0,0,0,0,2019-2020,90.0,0.0,0.0
2101,Declan Rice,ENG,MF,West Ham,Premier League,20,1999,38.0,116,60,64,48,4,47,98,48.0,51,41,9,32,77,193,55,0,0,2019-2020,90.0,182.3684210526316,274.7368421052632
2102,Chris Richards,USA,DF,Bayern Munich,Bundesliga,19,2000,0.1,0,0,0,0,0,0,0,0.0,0,0,0,0,0,0,1,0,0,2019-2020,90.0,0.0,0.0
2103,Richarlison,BRA,"FW,MF",Everton,Premier League,22,1997,34.1,70,47,28,28,14,27,56,48.2,29,34,4,30,12,82,42,0,0,2019-2020,90.0,31.671554252199414,184.7507331378299
2104,Marco Richter,GER,"MF,FW",Augsburg,Bundesliga,21,1997,25.3,21,16,7,9,5,14,51,27.5,37,15,0,15,24,45,17,0,0,2019-2020,89.99999999999999,85.37549407114624,74.70355731225295
2105,Diego Rico,ESP,DF,Bournemouth,Premier League,26,1993,25.9,61,39,32,24,5,29,59,49.2,30,31,7,24,84,145,91,0,0,2019-2020,90.0,291.89189189189193,211.969111969112
2106,Sergio Rico,ESP,GK,Paris S-G,Ligue 1,25,1993,2.0,0,0,0,0,0,0,0,0.0,0,0,0,0,0,0,1,2,0,2019-2020,90.0,0.0,0.0
2107,Jaïro Riedewald,NED,"DF,MF",Crystal Palace,Premier League,22,1996,8.5,14,10,4,10,0,7,11,63.6,4,7,2,5,17,31,23,1,0,2019-2020,90.0,180.0,148.23529411764707
2108,Emiliano Rigoni,ARG,"MF,FW",Sampdoria,Serie A,26,1993,4.8,5,4,2,1,2,3,10,30.0,7,5,1,4,3,8,1,0,0,2019-2020,90.0,56.25000000000001,93.75
2109,Tomás Rincón,VEN,MF,Torino,Serie A,31,1988,30.0,56,25,23,25,8,23,65,35.4,42,20,3,17,36,92,62,0,0,2019-2020,90.0,108.0,168.0
2110,Luis Rioja,ESP,MF,Alavés,La Liga,25,1993,18.2,18,12,11,6,1,8,25,32.0,17,21,0,21,16,34,6,0,0,2019-2020,90.0,79.12087912087912,89.01098901098901
2111,Renaud Ripart,FRA,"FW,DF",Nîmes,Ligue 1,26,1993,22.5,39,23,17,20,2,18,46,39.1,28,17,2,15,12,51,37,0,0,2019-2020,90.0,48.0,156.0
2112,Rodrigo Riquelme,ESP,"FW,MF",Atlético Madrid,La Liga,19,2000,0.1,0,0,0,0,0,0,0,0.0,0,0,0,0,0,0,0,0,0,2019-2020,90.0,0.0,0.0
2113,Andrea Rispoli,ITA,DF,Lecce,Serie A,30,1988,21.2,24,18,14,9,1,15,30,50.0,15,28,7,21,32,56,62,1,0,2019-2020,90.0,135.8490566037736,101.88679245283019
2114,Marcel Risse,GER,"MF,FW",Köln,Bundesliga,29,1989,1.5,3,2,3,0,0,1,1,100.0,0,1,0,1,1,4,1,0,0,2019-2020,90.0,60.0,180.0
2115,Mihailo Ristić,SRB,"DF,MF",Montpellier,Ligue 1,23,1995,9.0,18,14,7,11,0,9,20,45.0,11,7,2,5,7,25,18,0,0,2019-2020,90.0,70.0,180.0
2116,Matt Ritchie,SCO,"DF,MF",Newcastle Utd,Premier League,29,1989,14.6,22,15,9,10,3,3,15,20.0,12,20,5,15,14,36,31,1,0,2019-2020,90.0,86.3013698630137,135.6164383561644
2117,Marlon Ritter,GER,MF,Paderborn 07,Bundesliga,24,1994,4.8,7,5,5,2,0,4,9,44.4,5,7,0,7,8,15,3,0,0,2019-2020,90.0,150.0,131.25
2118,Cristian Rivera,ESP,MF,Leganés,La Liga,22,1997,3.5,6,4,3,2,1,2,4,50.0,2,4,3,1,4,10,7,0,0,2019-2020,90.0,102.85714285714286,154.28571428571428
2119,Maxence Rivera,FRA,"MF,FW",Saint-Étienne,Ligue 1,17,2002,0.3,0,0,0,0,0,0,1,0.0,1,1,0,1,0,0,0,0,0,2019-2020,90.0,0.0,0.0
2120,Rober,ESP,DF,Levante,La Liga,24,1995,2.1,3,1,2,0,1,2,2,100.0,0,0,0,0,3,6,2,0,0,2019-2020,90.0,128.57142857142856,128.57142857142856
2121,Roberto,ESP,GK,West Ham,Premier League,33,1986,7.6,0,0,0,0,0,0,0,0.0,0,0,0,0,0,0,2,2,0,2019-2020,90.0,0.0,0.0
2122,Roberto,ESP,GK,Alavés,La Liga,33,1986,8.8,1,1,1,0,0,1,1,100.0,0,0,0,0,0,1,2,0,0,2019-2020,90.0,0.0,10.227272727272727
2123,Sergi Roberto,ESP,"DF,MF",Barcelona,La Liga,27,1992,26.0,35,22,16,11,8,15,25,60.0,10,12,3,9,33,68,36,0,0,2019-2020,90.00000000000001,114.23076923076924,121.15384615384616
2124,Patrick Roberts,ENG,"FW,MF",Norwich City,Premier League,22,1997,0.3,0,0,0,0,0,0,0,0.0,0,0,0,0,0,0,0,0,0,2019-2020,90.0,0.0,0.0
2125,Andrew Robertson,SCO,DF,Liverpool,Premier League,25,1994,34.6,54,31,17,25,12,27,61,44.3,34,29,7,22,38,92,72,1,0,2019-2020,90.0,98.84393063583815,140.46242774566474
Rk,Player,Nation,Pos,Squad,Comp,0,0,90.0,0,0,3,3,3,Tkl,0,0.0,0,0,0,0,0,0,0,0,0,2019-2020,90.0,0.0,0.0
2126,Callum Robinson,IRL,"FW,MF",Sheffield Utd,Premier League,24,1995,7.5,6,3,2,2,2,2,7,28.6,5,3,0,3,7,13,3,0,0,2019-2020,90.0,84.0,72.0
2127,Jack Robinson,ENG,DF,Sheffield Utd,Premier League,25,1993,5.6,10,5,5,5,0,1,6,16.7,5,12,5,7,8,18,24,0,0,2019-2020,90.0,128.57142857142858,160.71428571428572
2128,Joel Robles,ESP,GK,Betis,La Liga,29,1990,32.1,0,0,0,0,0,0,2,0.0,2,0,0,0,0,0,13,2,0,2019-2020,90.0,0.0,0.0
2129,Marc Roca,ESP,MF,Espanyol,La Liga,22,1996,33.4,82,52,29,44,9,29,82,35.4,53,28,10,18,31,113,53,2,0,2019-2020,90.0,83.53293413173652,220.95808383233532
2130,Rubén Rochina,ESP,MF,Levante,La Liga,28,1991,20.8,41,26,22,9,10,19,52,36.5,33,16,0,16,12,53,19,1,0,2019-2020,90.0,51.92307692307692,177.40384615384613
2131,Sebastian Rode,GER,MF,Eint Frankfurt,Bundesliga,28,1990,21.5,58,33,27,27,4,17,59,28.8,42,32,5,27,34,92,13,0,0,2019-2020,90.0,142.32558139534882,242.7906976744186
2132,Rodri,ESP,MF,Manchester City,Premier League,23,1996,27.6,50,30,17,25,8,23,63,36.5,40,19,5,14,26,76,35,0,0,2019-2020,90.0,84.78260869565217,163.04347826086953
2133,Rodrigo,ESP,FW,Valencia,La Liga,28,1991,20.9,10,6,4,5,1,2,23,8.7,21,9,1,8,9,19,13,0,0,2019-2020,90.0,38.75598086124402,43.0622009569378
2134,Kévin Rodrigues,POR,"DF,MF",Leganés,La Liga,25,1994,21.5,56,31,31,17,8,25,46,54.3,21,30,3,27,31,87,26,1,0,2019-2020,90.0,129.7674418604651,234.41860465116278
2135,Kévin Rodrigues,POR,DF,Real Sociedad,La Liga,25,1994,0.1,1,0,1,0,0,1,1,100.0,0,0,0,0,0,1,0,0,0,2019-2020,90.0,0.0,900.0
2136,Ángel Rodríguez,ESP,FW,Getafe,La Liga,32,1987,15.6,14,8,2,8,4,2,18,11.1,16,10,1,9,3,17,10,0,0,2019-2020,90.0,17.307692307692307,80.76923076923076
2137,Óscar Rodríguez Arnaiz,ESP,"MF,FW",Leganés,La Liga,21,1998,21.3,23,10,11,7,5,13,41,31.7,28,19,0,19,14,37,13,0,0,2019-2020,90.0,59.15492957746479,97.1830985915493
2138,Dani Rodríguez,ESP,"MF,FW",Mallorca,La Liga,31,1988,33.8,59,32,24,28,7,18,61,29.5,43,35,3,32,38,97,27,1,0,2019-2020,90.0,101.18343195266273,157.10059171597635
2139,Guido Rodríguez,ARG,MF,Betis,La Liga,25,1994,10.4,24,16,11,11,2,15,25,60.0,10,13,4,9,10,34,21,0,0,2019-2020,90.0,86.53846153846153,207.69230769230768
2140,James Rodríguez,COL,"MF,FW",Real Madrid,La Liga,28,1991,4.7,17,13,6,8,3,6,12,50.0,6,3,0,3,3,20,1,0,0,2019-2020,90.0,57.44680851063829,325.531914893617
2141,Jay Rodriguez,ENG,FW,Burnley,Premier League,30,1989,22.4,29,19,4,13,12,8,33,24.2,25,33,6,27,5,34,12,0,0,2019-2020,90.0,20.089285714285715,116.51785714285715
2142,Mario Rodriguez,ESP,MF,Granada,La Liga,22,1997,0.0,0,0,0,0,0,0,0,0.0,0,0,0,0,0,0,0,0,0,2019-2020,,,
2143,Ricardo Rodríguez,SUI,DF,Milan,Serie A,26,1992,4.3,6,1,2,2,2,2,6,33.3,4,3,2,1,5,11,17,0,0,2019-2020,90.0,104.65116279069768,125.58139534883722
2144,Rodrygo,BRA,FW,Real Madrid,La Liga,18,2001,11.3,6,1,2,3,1,2,21,9.5,19,13,0,13,10,16,5,0,0,2019-2020,90.0,79.64601769911505,47.78761061946903
2145,Jack Rodwell,ENG,MF,Sheffield Utd,Premier League,28,1991,0.2,0,0,0,0,0,0,0,0.0,0,0,0,0,0,0,1,0,0,2019-2020,90.0,0.0,0.0
2146,Marko Rog,CRO,MF,Cagliari,Serie A,24,1995,25.7,69,47,31,29,9,22,84,26.2,62,40,12,28,22,91,23,0,0,2019-2020,90.0,77.04280155642023,241.63424124513617
2147,Agustín Rogel,URU,DF,Toulouse,Ligue 1,21,1997,9.5,15,8,12,3,0,7,13,53.8,6,13,10,3,11,26,35,2,0,2019-2020,90.0,104.21052631578948,142.10526315789474
2148,Rogério,BRA,DF,Sassuolo,Serie A,21,1998,11.3,22,14,12,8,2,16,23,69.6,7,13,3,10,9,31,34,0,0,2019-2020,90.0,71.68141592920354,175.2212389380531
2149,Marcos Rojo,ARG,DF,Manchester Utd,Premier League,29,1990,1.4,3,1,2,1,0,1,2,50.0,1,2,1,1,0,3,6,0,0,2019-2020,90.0,0.0,192.85714285714286
2150,Filippo Romagna,ITA,DF,Sassuolo,Serie A,22,1997,16.4,7,6,2,5,0,5,6,83.3,1,24,17,7,10,17,69,0,0,2019-2020,90.0,54.87804878048781,38.41463414634147
Rk,Player,Nation,Pos,Squad,Comp,0,0,90.0,0,0,3,3,3,Tkl,0,0.0,0,0,0,0,0,0,0,0,0,2019-2020,90.0,0.0,0.0
2151,Alessio Romagnoli,ITA,DF,Milan,Serie A,24,1995,34.3,46,25,28,15,3,16,27,59.3,11,32,18,14,56,102,157,1,0,2019-2020,90.0,146.9387755102041,120.6997084548105
2152,Alaixys Romao,TOG,MF,Reims,Ligue 1,35,1984,19.8,46,29,31,14,1,17,57,29.8,40,12,3,9,26,72,38,3,0,2019-2020,90.0,118.18181818181819,209.0909090909091
2153,Cristian Romero,ARG,DF,Genoa,Serie A,21,1998,28.6,52,35,36,12,4,12,41,29.3,29,59,33,26,75,127,116,2,0,2019-2020,90.0,236.01398601398603,163.63636363636365
2154,Luka Romero,ARG,FW,Mallorca,La Liga,14,2004,0.1,0,0,0,0,0,0,0,0.0,0,0,0,0,0,0,0,0,0,2019-2020,90.0,0.0,0.0
2155,Oriol Romeu,ESP,MF,Southampton,Premier League,27,1991,20.7,55,35,23,30,2,27,75,36.0,48,35,13,22,34,89,32,0,0,2019-2020,90.0,147.82608695652175,239.13043478260872
2156,Rômulo,ITA,MF,Brescia,Serie A,32,1987,19.1,30,19,12,14,4,12,34,35.3,22,18,1,17,8,38,12,1,0,2019-2020,90.0,37.69633507853403,141.36125654450262
2157,Rômulo,ITA,DF,Genoa,Serie A,32,1987,0.2,2,1,1,1,0,0,0,0.0,0,0,0,0,0,2,1,0,0,2019-2020,90.0,0.0,900.0
2158,Cristiano Ronaldo,POR,FW,Juventus,Serie A,34,1985,32.4,14,10,3,3,8,4,20,20.0,16,10,3,7,6,20,21,1,0,2019-2020,90.0,16.666666666666668,38.88888888888889
2159,Facundo Roncaglia,ARG,DF,Osasuna,La Liga,32,1987,14.2,24,20,12,10,2,11,20,55.0,9,18,3,15,22,46,46,0,0,2019-2020,90.0,139.43661971830986,152.11267605633805
2160,Valentin Rongier,FRA,MF,Marseille,Ligue 1,24,1994,19.9,76,51,25,41,10,22,63,34.9,41,30,4,26,36,112,16,2,0,2019-2020,90.0,162.8140703517588,343.71859296482415
2161,Valentin Rongier,FRA,MF,Nantes,Ligue 1,24,1994,3.0,5,4,0,2,3,3,5,60.0,2,4,0,4,2,7,0,0,0,2019-2020,90.0,60.0,150.0
2162,Marten de Roon,NED,"MF,DF",Atalanta,Serie A,28,1991,30.2,77,43,36,29,12,34,75,45.3,41,32,8,24,46,123,45,0,0,2019-2020,90.0,137.08609271523179,229.4701986754967
2163,Roberto Rosales,VEN,DF,Leganés,La Liga,30,1988,20.8,42,23,23,17,2,19,43,44.2,24,17,4,13,30,72,48,0,0,2019-2020,90.0,129.8076923076923,181.73076923076923
2164,Antonio Rosati,ITA,GK,Torino,Serie A,36,1983,1.0,0,0,0,0,0,0,0,0.0,0,0,0,0,0,0,0,1,0,2019-2020,90.0,0.0,0.0
2165,Danny Rose,ENG,DF,Tottenham,Premier League,29,1990,9.9,18,11,6,10,2,9,20,45.0,11,14,6,8,8,26,34,2,0,2019-2020,90.0,72.72727272727273,163.63636363636363
2166,Danny Rose,ENG,DF,Newcastle Utd,Premier League,29,1990,9.6,21,12,11,8,2,12,21,57.1,9,11,4,7,10,31,14,1,0,2019-2020,90.0,93.75,196.875
2167,Luca Rossettini,ITA,DF,Lecce,Serie A,34,1985,25.1,25,14,18,7,0,17,34,50.0,17,31,22,9,35,60,126,1,0,2019-2020,90.0,125.49800796812748,89.6414342629482
2168,Francesco Rossi,ITA,GK,Atalanta,Serie A,28,1991,0.1,0,0,0,0,0,0,0,0.0,0,0,0,0,0,0,0,0,0,2019-2020,90.0,0.0,0.0
2169,Jérôme Roussillon,FRA,DF,Wolfsburg,Bundesliga,26,1993,26.3,48,29,26,18,4,15,29,51.7,14,33,5,28,30,78,58,0,0,2019-2020,90.0,102.66159695817491,164.25855513307985
2170,Nolan Roux,FRA,FW,Nîmes,Ligue 1,31,1988,6.5,5,2,1,3,1,1,3,33.3,2,2,0,2,4,9,5,0,0,2019-2020,90.00000000000001,55.38461538461539,69.23076923076924
2171,Nicolò Rovella,ITA,MF,Genoa,Serie A,17,2001,1.2,0,0,0,0,0,0,1,0.0,1,0,0,0,4,4,0,0,0,2019-2020,90.0,300.0,0.0
2172,Amir Rrahmani,KVX,DF,Hellas Verona,Serie A,25,1994,35.9,50,31,26,19,5,26,46,56.5,20,50,31,19,30,80,151,1,0,2019-2020,90.0,75.20891364902508,125.3481894150418
2173,Rubén,ESP,GK,Osasuna,La Liga,35,1984,17.6,1,1,1,0,0,1,1,100.0,0,0,0,0,0,1,9,1,0,2019-2020,90.0,0.0,5.113636363636363
2174,Waldo Rubio,ESP,"MF,FW",Valladolid,La Liga,23,1995,9.8,13,8,10,3,0,5,31,16.1,26,12,0,12,7,20,7,0,0,2019-2020,90.0,64.28571428571428,119.38775510204081
2175,Antonio Rüdiger,GER,DF,Chelsea,Premier League,26,1993,19.0,28,18,19,7,2,16,25,64.0,9,15,9,6,16,44,59,1,0,2019-2020,90.0,75.78947368421052,132.6315789473684
Rk,Player,Nation,Pos,Squad,Comp,0,0,90.0,0,0,3,3,3,Tkl,0,0.0,0,0,0,0,0,0,0,0,0,2019-2020,90.0,0.0,0.0
2176,Sebastian Rudy,GER,"MF,DF",Hoffenheim,Bundesliga,29,1990,30.4,73,49,31,29,13,28,75,37.3,47,26,5,21,27,100,38,0,0,2019-2020,90.0,79.93421052631578,216.11842105263156
2177,Stéphane Ruffier,FRA,GK,Saint-Étienne,Ligue 1,32,1986,22.0,0,0,0,0,0,0,0,0.0,0,0,0,0,0,0,5,3,0,2019-2020,90.0,0.0,0.0
2178,Dion Ruffo Luci,ITA,MF,Bologna,Serie A,18,2001,0.0,0,0,0,0,0,0,0,0.0,0,0,0,0,0,0,0,0,0,2019-2020,,,
2179,Daniele Rugani,ITA,DF,Juventus,Serie A,25,1994,7.7,8,6,4,4,0,4,5,80.0,1,4,4,0,11,19,18,0,0,2019-2020,90.0,128.57142857142858,93.50649350649351
2180,Mário Rui,POR,DF,Napoli,Serie A,28,1991,21.8,31,17,12,12,7,11,29,37.9,18,24,5,19,21,52,43,0,0,2019-2020,90.0,86.69724770642202,127.98165137614679
2181,Aitor Ruibal,ESP,"DF,MF",Leganés,La Liga,23,1996,13.6,27,17,14,11,2,16,39,41.0,23,18,1,17,8,35,11,0,0,2019-2020,90.0,52.94117647058823,178.6764705882353
2182,Fabián Ruiz Peña,ESP,MF,Napoli,Serie A,23,1996,29.8,43,26,19,18,6,24,65,36.9,41,32,4,28,32,75,18,2,0,2019-2020,90.0,96.64429530201342,129.86577181208054
2183,Gerónimo Rulli,ARG,GK,Montpellier,Ligue 1,27,1992,25.0,3,1,3,0,0,3,4,75.0,1,1,0,1,2,5,9,1,0,2019-2020,90.0,7.199999999999999,10.799999999999999
2184,Lukas Rupp,GER,"FW,MF",Norwich City,Premier League,28,1991,7.7,15,9,7,5,3,5,17,29.4,12,11,0,11,15,30,4,0,0,2019-2020,90.0,175.32467532467533,175.32467532467533
2185,Lukas Rupp,GER,MF,Hoffenheim,Bundesliga,28,1991,3.8,9,4,3,5,1,3,6,50.0,3,5,0,5,5,14,3,0,0,2019-2020,90.0,118.42105263157895,213.1578947368421
2186,Mathew Ryan,AUS,GK,Brighton,Premier League,27,1992,38.0,1,1,1,0,0,1,4,25.0,3,0,0,0,2,3,13,2,0,2019-2020,90.0,4.7368421052631575,2.3684210526315788
2187,Julian Ryerson,NOR,"DF,MF",Union Berlin,Bundesliga,21,1997,4.1,7,5,2,1,4,3,6,50.0,3,5,3,2,5,12,9,0,0,2019-2020,90.0,109.75609756097562,153.65853658536588
2188,Frederik Rønnow,DEN,GK,Eint Frankfurt,Bundesliga,26,1992,9.0,0,0,0,0,0,0,1,0.0,1,0,0,0,0,0,1,0,0,2019-2020,90.0,0.0,0.0
2189,João Victor Santos Sá,BRA,"MF,FW",Wolfsburg,Bundesliga,25,1994,18.1,35,22,12,17,6,10,38,26.3,28,31,1,30,9,44,9,0,0,2019-2020,90.0,44.75138121546961,174.0331491712707
2190,Roli Pereira de Sa,FRA,MF,Nantes,Ligue 1,22,1996,0.1,0,0,0,0,0,0,0,0.0,0,0,0,0,0,0,0,0,0,2019-2020,90.0,0.0,0.0
2191,Youssouf Sabaly,SEN,DF,Bordeaux,Ligue 1,26,1993,10.1,18,11,9,4,5,6,22,27.3,16,8,1,7,18,36,23,0,0,2019-2020,90.0,160.3960396039604,160.3960396039604
2192,Stefano Sabelli,ITA,DF,Brescia,Serie A,26,1993,35.2,83,44,51,28,4,50,106,47.2,56,40,13,27,58,141,107,0,0,2019-2020,90.0,148.29545454545453,212.2159090909091
2193,Abdelhamid Sabiri,MAR,MF,Paderborn 07,Bundesliga,22,1996,11.6,20,16,6,11,3,9,27,33.3,18,9,2,7,8,28,18,1,0,2019-2020,90.0,62.06896551724138,155.17241379310346
2194,Marcel Sabitzer,AUT,"MF,FW",RB Leipzig,Bundesliga,25,1994,27.8,39,25,15,18,6,19,56,33.9,37,27,4,23,23,62,25,0,0,2019-2020,90.0,74.46043165467626,126.2589928057554
2195,Ihsan Sacko,FRA,FW,Nice,Ligue 1,22,1997,1.6,1,1,1,0,0,0,1,0.0,1,0,0,0,0,1,0,0,0,2019-2020,90.0,0.0,56.25
2196,Alexis Saelemaekers,BEL,"FW,DF",Milan,Serie A,20,1999,7.6,14,8,5,7,2,6,20,30.0,14,13,1,12,8,22,1,0,0,2019-2020,90.0,94.73684210526315,165.78947368421052
2197,Jorge Sáenz,ESP,DF,Celta Vigo,La Liga,22,1996,4.1,6,1,4,2,0,3,5,60.0,2,5,2,3,10,16,15,0,0,2019-2020,90.0,219.51219512195124,131.70731707317074
2198,Nuri Şahin,TUR,MF,Werder Bremen,Bundesliga,30,1988,13.9,27,16,10,14,3,11,35,31.4,24,15,7,8,37,64,38,0,0,2019-2020,90.0,239.56834532374103,174.8201438848921
2199,Wesley Saïd,FRA,"MF,FW",Toulouse,Ligue 1,24,1995,12.9,20,9,8,10,2,2,13,15.4,11,6,0,6,9,29,8,0,0,2019-2020,90.0,62.7906976744186,139.53488372093022
2200,Allan Saint-Maximin,FRA,"MF,FW",Newcastle Utd,Premier League,22,1997,20.7,13,8,7,4,2,4,18,22.2,14,5,2,3,9,22,6,0,0,2019-2020,90.0,39.130434782608695,56.52173913043479
Rk,Player,Nation,Pos,Squad,Comp,0,0,90.0,0,0,3,3,3,Tkl,0,0.0,0,0,0,0,0,0,0,0,0,2019-2020,90.0,0.0,0.0
2201,Théo Sainte-Luce,FRA,"MF,DF",Nîmes,Ligue 1,20,1998,0.2,0,0,0,0,0,0,0,0.0,0,0,0,0,0,0,0,0,0,2019-2020,90.0,0.0,0.0
2202,Borja Sainz,ESP,"MF,FW",Alavés,La Liga,18,2001,6.4,16,9,4,9,3,8,26,30.8,18,14,0,14,3,19,0,0,0,2019-2020,90.0,42.1875,225.0
2203,Romain Saïss,MAR,DF,Wolves,Premier League,29,1990,30.1,55,38,37,15,3,32,46,69.6,14,31,16,15,55,110,127,3,0,2019-2020,90.00000000000001,164.45182724252493,164.45182724252493
2204,Bukayo Saka,ENG,"DF,FW",Arsenal,Premier League,17,2001,19.5,36,21,21,8,7,19,37,51.4,18,12,3,9,12,48,19,0,0,2019-2020,90.0,55.38461538461538,166.15384615384616
2205,Hiroki Sakai,JPN,DF,Marseille,Ligue 1,29,1990,18.0,57,36,26,24,7,25,40,62.5,15,20,5,15,23,80,34,1,0,2019-2020,90.0,115.0,285.0
2206,Mamadou Sakho,FRA,DF,Crystal Palace,Premier League,29,1990,10.3,7,5,5,1,1,2,5,40.0,3,12,5,7,20,27,46,2,0,2019-2020,90.0,174.75728155339806,61.165048543689316
2207,Jacopo Sala,ITA,DF,SPAL,Serie A,27,1991,9.5,29,24,17,11,1,17,31,54.8,14,4,0,4,13,42,15,1,0,2019-2020,90.0,123.15789473684211,274.7368421052632
2208,Mohamed Salah,EGY,FW,Liverpool,Premier League,27,1992,32.0,16,6,1,4,11,5,22,22.7,17,3,1,2,8,24,2,1,0,2019-2020,90.0,22.5,45.0
2209,Bartosz Salamon,POL,DF,SPAL,Serie A,28,1991,3.8,2,1,2,0,0,1,2,50.0,1,4,4,0,6,8,14,0,0,2019-2020,90.0,142.10526315789474,47.368421052631575
2210,Eddie Salcedo,ITA,"FW,MF",Hellas Verona,Serie A,17,2001,7.6,3,1,2,0,1,0,5,0.0,5,4,0,4,1,4,2,0,0,2019-2020,90.0,11.842105263157894,35.526315789473685
2211,William Saliba,FRA,DF,Saint-Étienne,Ligue 1,18,2001,11.0,19,9,15,3,1,5,10,50.0,5,13,4,9,21,40,36,1,0,2019-2020,90.0,171.8181818181818,155.45454545454547
2212,Yannis Salibur,FRA,"MF,FW",Mallorca,La Liga,28,1991,0.9,0,0,0,0,0,0,4,0.0,4,0,0,0,1,1,1,0,0,2019-2020,90.0,100.0,0.0
2213,Romain Salin,FRA,GK,Rennes,Ligue 1,35,1984,4.0,0,0,0,0,0,0,1,0.0,1,0,0,0,0,0,3,0,0,2019-2020,90.0,0.0,0.0
2214,Mohammed Salisu,GHA,DF,Valladolid,La Liga,20,1999,30.3,41,24,28,13,0,21,34,61.8,13,32,26,6,35,76,158,3,0,2019-2020,90.0,103.96039603960396,121.78217821782178
2215,Roland Sallai,HUN,"MF,FW",Freiburg,Bundesliga,22,1997,12.9,17,10,4,9,4,7,20,35.0,13,12,2,10,7,24,4,0,0,2019-2020,90.0,48.837209302325576,118.60465116279069
2216,Lazar Samardzic,SRB,"MF,FW",Hertha BSC,Bundesliga,17,2002,0.4,4,4,2,2,0,1,4,25.0,3,2,1,1,0,4,0,0,0,2019-2020,90.0,0.0,900.0
2217,Diadie Samassékou,MLI,MF,Hoffenheim,Bundesliga,23,1996,14.6,37,18,14,17,6,12,34,35.3,22,25,8,17,40,77,27,1,0,2019-2020,90.0,246.57534246575344,228.08219178082194
2218,Mbwana Samatta,TAN,FW,Aston Villa,Premier League,26,1992,10.5,6,4,0,3,3,1,8,12.5,7,7,0,7,1,7,6,0,0,2019-2020,90.0,8.571428571428571,51.42857142857143
2219,Mama Samba Baldé,GNB,"FW,MF",Dijon,Ligue 1,23,1995,18.6,24,13,9,8,7,7,30,23.3,23,17,0,17,7,31,24,0,0,2019-2020,90.0,33.87096774193548,116.1290322580645
2220,Junior Sambia,FRA,"DF,MF",Montpellier,Ligue 1,22,1996,6.5,8,6,4,2,2,3,13,23.1,10,4,0,4,8,16,6,0,0,2019-2020,90.00000000000001,110.76923076923077,110.76923076923077
2221,Frédéric Sammaritano,FRA,"MF,FW",Dijon,Ligue 1,33,1986,5.8,9,7,4,4,1,4,11,36.4,7,6,1,5,2,11,3,1,0,2019-2020,90.0,31.03448275862069,139.6551724137931
2222,Fede San Emeterio,ESP,MF,Valladolid,La Liga,22,1997,19.5,26,13,18,6,2,7,29,24.1,22,20,8,12,28,54,13,1,0,2019-2020,90.0,129.23076923076923,120.0
2223,Mikel San José,ESP,MF,Athletic Club,La Liga,30,1989,4.0,9,4,2,4,3,2,10,20.0,8,3,1,2,9,18,12,0,0,2019-2020,90.0,202.5,202.5
2224,Antonio Sanabria,PAR,FW,Genoa,Serie A,23,1996,15.4,14,11,2,7,5,3,14,21.4,11,13,1,12,5,19,12,1,0,2019-2020,90.0,29.22077922077922,81.81818181818183
2225,Oihan Sancet,ESP,"MF,FW",Athletic Club,La Liga,19,2000,8.2,11,7,5,4,2,4,11,36.4,7,6,0,6,2,13,2,0,0,2019-2020,90.0,21.951219512195124,120.73170731707319
Rk,Player,Nation,Pos,Squad,Comp,0,0,90.0,0,0,3,3,3,Tkl,0,0.0,0,0,0,0,0,0,0,0,0,2019-2020,90.0,0.0,0.0
2226,Renato Sanches,POR,"MF,FW",Lille,Ligue 1,21,1997,16.5,28,15,9,15,4,8,33,24.2,25,19,1,18,15,43,10,1,0,2019-2020,90.0,81.81818181818183,152.72727272727275
2227,Renato Sanches,POR,MF,Bayern Munich,Bundesliga,21,1997,0.1,0,0,0,0,0,0,0,0.0,0,0,0,0,0,0,0,0,0,2019-2020,90.0,0.0,0.0
2228,Alexis Sánchez,CHI,FW,Inter,Serie A,30,1988,10.3,9,7,1,4,4,5,13,38.5,8,7,0,7,3,12,1,0,0,2019-2020,90.0,26.21359223300971,78.64077669902913
2229,Carlos Sánchez,COL,MF,West Ham,Premier League,33,1986,1.3,1,0,0,1,0,1,1,100.0,0,1,0,1,2,3,1,0,0,2019-2020,90.0,138.46153846153845,69.23076923076923
2230,Davinson Sánchez,COL,DF,Tottenham,Premier League,23,1996,27.0,44,27,32,12,0,22,44,50.0,22,40,28,12,34,78,128,5,0,2019-2020,90.0,113.33333333333334,146.66666666666669
2231,Germán Sánchez,ESP,DF,Granada,La Liga,32,1986,25.5,16,10,12,4,0,6,16,37.5,10,29,23,6,33,49,115,2,0,2019-2020,90.0,116.47058823529412,56.470588235294116
2232,Javi Sánchez,ESP,DF,Valladolid,La Liga,22,1997,5.5,5,4,3,2,0,1,3,33.3,2,4,2,2,4,9,24,0,0,2019-2020,90.0,65.45454545454545,81.81818181818183
2233,Manu Sánchez,ESP,DF,Atlético Madrid,La Liga,18,2000,3.6,13,7,2,7,4,8,15,53.3,7,3,0,3,7,20,1,0,0,2019-2020,90.0,175.0,325.0
2234,Víctor Sánchez,ESP,MF,Espanyol,La Liga,31,1987,18.8,66,36,36,23,7,30,71,42.3,41,31,8,23,27,93,23,1,0,2019-2020,90.0,129.25531914893617,315.9574468085106
2235,Jadon Sancho,ENG,"FW,MF",Dortmund,Bundesliga,19,2000,25.4,14,11,6,6,2,8,24,33.3,16,8,0,8,14,28,6,0,0,2019-2020,90.0,49.60629921259843,49.60629921259843
2236,Alex Sandro,BRA,DF,Juventus,Serie A,28,1991,26.5,44,26,23,14,7,12,33,36.4,21,26,6,20,47,91,46,3,0,2019-2020,90.0,159.62264150943395,149.43396226415095
2237,Leroy Sané,GER,FW,Manchester City,Premier League,23,1996,0.1,0,0,0,0,0,0,0,0.0,0,0,0,0,0,0,0,0,0,2019-2020,90.0,0.0,0.0
2238,Salif Sané,SEN,DF,Schalke 04,Bundesliga,28,1990,12.5,16,9,12,4,0,11,19,57.9,8,19,7,12,21,37,50,0,0,2019-2020,90.0,151.2,115.19999999999999
2239,Luca Sangalli,ESP,MF,Real Sociedad,La Liga,24,1995,4.1,1,0,0,1,0,1,8,12.5,7,3,0,3,1,2,0,0,0,2019-2020,90.0,21.951219512195124,21.951219512195124
2240,Ibrahim Sangaré,CIV,MF,Toulouse,Ligue 1,21,1997,24.2,84,54,37,42,5,33,74,44.6,41,28,10,18,39,123,49,4,0,2019-2020,90.0,145.04132231404958,312.396694214876
2241,Oier Sanjurjo,ESP,MF,Osasuna,La Liga,33,1986,25.8,65,34,21,34,10,28,64,43.8,36,33,8,25,35,100,39,1,0,2019-2020,90.0,122.09302325581395,226.74418604651163
2242,Yaya Sanogo,FRA,FW,Toulouse,Ligue 1,26,1993,10.1,6,3,2,3,1,1,2,50.0,1,4,1,3,7,13,14,0,0,2019-2020,90.0,62.37623762376238,53.46534653465346
2243,Morgan Sanson,FRA,MF,Marseille,Ligue 1,24,1994,24.1,60,28,20,29,11,13,52,25.0,39,39,5,34,23,83,9,0,0,2019-2020,90.0,85.89211618257261,224.06639004149378
2244,Nicola Sansone,ITA,"FW,MF",Bologna,Serie A,27,1991,25.2,34,20,12,18,4,15,59,25.4,44,21,0,21,11,45,9,0,0,2019-2020,90.0,39.28571428571429,121.42857142857144
2245,Baptiste Santamaria,FRA,MF,Angers,Ligue 1,24,1995,27.8,91,53,39,43,9,35,79,44.3,44,27,5,22,43,134,36,0,0,2019-2020,90.0,139.20863309352518,294.6043165467626
2246,Federico Santander,PAR,FW,Bologna,Serie A,28,1991,8.6,13,8,3,0,10,1,4,25.0,3,3,0,3,7,20,12,0,0,2019-2020,90.0,73.25581395348838,136.046511627907
2247,Davide Santon,ITA,DF,Roma,Serie A,28,1991,6.9,11,6,6,5,0,6,17,35.3,11,2,1,1,11,22,13,0,0,2019-2020,90.0,143.4782608695652,143.4782608695652
2248,Samir Santos,BRA,DF,Udinese,Serie A,24,1994,17.2,35,27,24,8,3,12,23,52.2,11,16,6,10,33,68,64,1,0,2019-2020,90.0,172.67441860465118,183.13953488372096
2249,Riccardo Saponara,ITA,"MF,FW",Genoa,Serie A,27,1991,1.9,4,3,2,2,0,0,2,0.0,2,2,1,1,0,4,2,0,0,2019-2020,90.0,0.0,189.4736842105263
2250,Riccardo Saponara,ITA,"MF,FW",Lecce,Serie A,27,1991,10.5,12,8,4,8,0,6,13,46.2,7,2,0,2,5,17,7,0,0,2019-2020,90.0,42.857142857142854,102.85714285714286
Rk,Player,Nation,Pos,Squad,Comp,0,0,90.0,0,0,3,3,3,Tkl,0,0.0,0,0,0,0,0,0,0,0,0,2019-2020,90.0,0.0,0.0
2251,Ivan Šaponjić,SRB,"DF,FW",Atlético Madrid,La Liga,21,1997,0.1,0,0,0,0,0,0,0,0.0,0,0,0,0,0,0,0,0,0,2019-2020,90.0,0.0,0.0
2252,Pablo Sarabia,ESP,"FW,MF",Paris S-G,Ligue 1,27,1992,12.9,12,7,3,6,3,4,25,16.0,21,19,1,18,10,22,5,0,0,2019-2020,90.0,69.76744186046511,83.72093023255813
2253,Marcelo Saracchi,URU,DF,RB Leipzig,Bundesliga,21,1998,2.0,8,6,2,5,1,5,6,83.3,1,3,1,2,1,9,5,0,0,2019-2020,90.0,45.0,360.0
2254,Josh Sargent,USA,FW,Werder Bremen,Bundesliga,19,2000,15.7,11,6,5,4,2,2,12,16.7,10,17,1,16,14,25,21,0,0,2019-2020,90.0,80.2547770700637,63.05732484076434
2255,Bouna Sarr,SEN,"DF,FW",Marseille,Ligue 1,27,1992,24.0,60,37,30,19,11,30,53,56.6,23,17,1,16,32,92,38,0,0,2019-2020,90.0,120.0,225.0
2256,Ismaila Sarr,SEN,"FW,MF",Watford,Premier League,21,1998,22.5,11,10,5,2,4,5,23,21.7,18,9,1,8,18,29,10,0,0,2019-2020,90.0,72.0,44.0
2257,Malang Sarr,FRA,DF,Nice,Ligue 1,20,1999,16.2,19,11,13,6,0,9,22,40.9,13,10,4,6,38,57,31,4,0,2019-2020,90.0,211.11111111111111,105.55555555555556
2258,Sidy Sarr,SEN,MF,Nîmes,Ligue 1,23,1996,12.9,35,18,15,16,4,11,34,32.4,23,13,3,10,15,50,18,0,0,2019-2020,90.0,104.65116279069767,244.1860465116279
2259,Joan Sastre Vanrell,ESP,DF,Mallorca,La Liga,22,1997,15.1,30,17,26,3,1,17,39,43.6,22,8,2,6,23,53,27,1,0,2019-2020,90.0,137.08609271523179,178.80794701986756
2260,Téji Savanier,FRA,MF,Montpellier,Ligue 1,27,1991,16.9,52,39,16,30,6,25,77,32.5,52,10,0,10,35,87,21,1,0,2019-2020,90.0,186.39053254437871,276.92307692307696
2261,Stefan Savić,MNE,DF,Atlético Madrid,La Liga,28,1991,22.0,22,17,11,10,1,11,18,61.1,7,16,9,7,24,46,91,1,0,2019-2020,90.0,98.18181818181819,90.0
2262,Fabian Schär,SUI,"DF,MF",Newcastle Utd,Premier League,27,1991,18.6,39,21,25,14,0,19,40,47.5,21,35,18,17,47,86,74,2,0,2019-2020,90.0,227.41935483870964,188.70967741935482
2263,Louis Schaub,AUT,MF,Köln,Bundesliga,24,1994,6.9,15,12,2,9,4,5,14,35.7,9,10,1,9,3,18,2,0,0,2019-2020,90.0,39.13043478260869,195.65217391304347
2264,Ezequiel Schelotto,ITA,DF,Brighton,Premier League,30,1989,4.0,4,3,1,2,1,2,8,25.0,6,3,0,3,7,11,14,0,0,2019-2020,90.0,157.5,90.0
2265,Patrik Schick,CZE,FW,RB Leipzig,Bundesliga,23,1996,14.4,7,3,1,3,3,2,9,22.2,7,8,2,6,2,9,17,0,0,2019-2020,90.0,12.5,43.75
2266,Julian Schieber,GER,FW,Augsburg,Bundesliga,30,1989,0.5,1,1,0,1,0,0,0,0.0,0,0,0,0,0,1,0,0,0,2019-2020,90.0,0.0,180.0
2267,Kingsley Schindler,GHA,"FW,MF",Köln,Bundesliga,26,1993,9.4,8,5,3,5,0,4,12,33.3,8,6,1,5,6,14,17,0,0,2019-2020,90.0,57.44680851063829,76.59574468085106
2268,Xaver Schlager,AUT,MF,Wolfsburg,Bundesliga,21,1997,19.1,47,29,13,30,4,14,44,31.8,30,16,2,14,17,64,12,0,0,2019-2020,90.0,80.10471204188481,221.46596858638742
2269,Keven Schlotterbeck,GER,DF,Union Berlin,Bundesliga,22,1997,21.5,52,27,36,15,1,17,29,58.6,12,40,21,19,40,92,113,1,0,2019-2020,90.0,167.44186046511626,217.67441860465115
2270,Nico Schlotterbeck,GER,DF,Freiburg,Bundesliga,19,1999,4.1,6,3,4,2,0,2,5,40.0,3,7,5,2,3,9,20,1,0,2019-2020,90.0,65.85365853658537,131.70731707317074
2271,Jeffrey Schlupp,GHA,"FW,MF",Crystal Palace,Premier League,26,1992,11.5,18,9,10,7,1,6,16,37.5,10,11,3,8,13,31,15,0,0,2019-2020,90.0,101.73913043478262,140.8695652173913
2272,Kasper Schmeichel,DEN,GK,Leicester City,Premier League,32,1986,38.0,1,1,1,0,0,1,2,50.0,1,0,0,0,1,2,4,2,0,2019-2020,90.0,2.3684210526315788,2.3684210526315788
2273,Marcel Schmelzer,GER,DF,Dortmund,Bundesliga,31,1988,0.7,2,1,1,1,0,1,1,100.0,0,0,0,0,1,3,2,0,0,2019-2020,90.0,128.57142857142858,257.14285714285717
2274,Jonathan Schmid,FRA,DF,Freiburg,Bundesliga,29,1990,31.5,42,27,19,19,4,19,37,51.4,18,23,8,15,35,77,84,0,0,2019-2020,90.0,100.0,120.00000000000001
2275,Manuel Schmiedebach,GER,MF,Union Berlin,Bundesliga,30,1988,2.0,4,1,0,3,1,1,7,14.3,6,1,1,0,3,7,3,0,0,2019-2020,90.0,135.0,180.0
Rk,Player,Nation,Pos,Squad,Comp,0,0,90.0,0,0,3,3,3,Tkl,0,0.0,0,0,0,0,0,0,0,0,0,2019-2020,90.0,0.0,0.0
2276,Benno Schmitz,GER,DF,Köln,Bundesliga,24,1994,12.9,28,17,13,11,4,16,36,44.4,20,11,1,10,16,44,27,0,0,2019-2020,90.0,111.62790697674419,195.3488372093023
2277,Morgan Schneiderlin,FRA,MF,Everton,Premier League,29,1989,11.1,31,22,13,16,2,8,24,33.3,16,13,3,10,21,52,20,1,0,2019-2020,90.0,170.2702702702703,251.35135135135138
2278,Lasse Schöne,DEN,MF,Genoa,Serie A,33,1986,27.0,42,26,16,22,4,15,48,31.3,33,22,6,16,37,79,25,2,0,2019-2020,90.0,123.33333333333334,140.0
2279,Sebastian Schonlau,GER,DF,Paderborn 07,Bundesliga,24,1994,23.0,64,43,50,14,0,41,66,62.1,25,36,15,21,40,104,138,1,0,2019-2020,90.0,156.52173913043478,250.43478260869568
2280,Alessandro Schöpf,AUT,MF,Schalke 04,Bundesliga,25,1994,15.9,29,16,11,10,8,12,33,36.4,21,17,1,16,26,55,8,0,0,2019-2020,90.0,147.16981132075472,164.1509433962264
2281,Jerdy Schouten,NED,MF,Bologna,Serie A,22,1997,12.0,26,16,13,11,2,10,26,38.5,16,19,7,12,26,52,22,0,0,2019-2020,90.0,195.0,195.0
2282,Markus Schubert,GER,GK,Schalke 04,Bundesliga,21,1998,8.2,0,0,0,0,0,0,1,0.0,1,0,0,0,0,0,9,4,0,2019-2020,90.0,0.0,0.0
2283,Nico Schulz,GER,"DF,MF",Dortmund,Bundesliga,26,1993,6.6,11,7,3,6,2,8,13,61.5,5,14,4,10,9,20,9,0,0,2019-2020,90.0,122.72727272727273,150.0
2284,Alexander Schwolow,GER,GK,Freiburg,Bundesliga,27,1992,23.2,0,0,0,0,0,0,0,0.0,0,2,0,2,1,1,8,3,0,2019-2020,90.0,3.8793103448275863,0.0
2285,Matteo Scozzarella,ITA,MF,Parma,Serie A,31,1988,10.2,23,15,8,13,2,14,29,48.3,15,19,14,5,27,50,28,0,0,2019-2020,90.0,238.23529411764707,202.94117647058823
2286,Aleksandar Sedlar,SRB,DF,Mallorca,La Liga,27,1991,9.0,13,6,10,2,1,7,11,63.6,4,17,11,6,16,29,31,0,0,2019-2020,90.0,160.0,130.0
2287,Davie Selke,GER,FW,Hertha BSC,Bundesliga,24,1995,10.7,6,3,2,2,2,4,7,57.1,3,7,1,6,1,7,11,0,0,2019-2020,90.0,8.41121495327103,50.46728971962617
2288,Davie Selke,GER,FW,Werder Bremen,Bundesliga,24,1995,5.1,2,0,1,1,0,0,2,0.0,2,1,0,1,0,2,2,0,0,2019-2020,90.0,0.0,35.294117647058826
2289,Matz Sels,BEL,GK,Strasbourg,Ligue 1,27,1992,27.0,0,0,0,0,0,0,1,0.0,1,0,0,0,1,1,6,0,0,2019-2020,90.0,3.3333333333333335,0.0
2290,Ken Sema,SWE,"DF,MF",Udinese,Serie A,25,1993,27.3,59,41,43,15,1,36,68,52.9,32,26,6,20,17,76,41,1,0,2019-2020,90.0,56.043956043956044,194.5054945054945
2291,Nélson Semedo,POR,DF,Barcelona,La Liga,25,1993,23.3,51,30,27,18,6,21,36,58.3,15,18,3,15,22,73,30,0,0,2019-2020,90.0,84.97854077253218,196.99570815450645
2292,Alessandro Semprini,ITA,DF,Brescia,Serie A,21,1998,7.0,10,4,7,3,0,7,9,77.8,2,10,3,7,9,19,16,0,0,2019-2020,90.0,115.71428571428571,128.57142857142856
2293,Josep Señé,ESP,MF,Mallorca,La Liga,27,1991,1.7,2,1,2,0,0,2,5,40.0,3,2,1,1,0,2,2,0,0,2019-2020,90.0,0.0,105.88235294117646
2294,Stefano Sensi,ITA,MF,Inter,Serie A,23,1995,8.0,18,10,10,7,1,6,22,27.3,16,15,1,14,9,27,4,0,0,2019-2020,90.0,101.25,202.5
2295,Luigi Sepe,ITA,GK,Parma,Serie A,28,1991,34.0,1,0,1,0,0,1,2,50.0,1,0,0,0,0,1,6,2,0,2019-2020,90.0,0.0,2.6470588235294117
2296,Suat Serdar,GER,MF,Schalke 04,Bundesliga,22,1997,17.8,56,37,16,33,7,18,61,29.5,43,39,7,32,24,80,7,0,0,2019-2020,90.0,121.34831460674158,283.14606741573033
2297,Ryan Sessegnon,ENG,"DF,FW",Tottenham,Premier League,19,2000,3.8,6,4,2,4,0,3,6,50.0,3,0,0,0,3,9,12,0,0,2019-2020,90.0,71.05263157894737,142.10526315789474
2298,Salva Sevilla,ESP,MF,Mallorca,La Liga,35,1984,28.5,27,21,11,16,0,9,30,30.0,21,17,5,12,29,56,17,1,0,2019-2020,90.0,91.57894736842105,85.26315789473685
2299,Yevhen Shakhov,UKR,"MF,FW",Lecce,Serie A,28,1990,12.1,28,16,12,13,3,8,27,29.6,19,11,3,8,14,42,9,1,0,2019-2020,90.0,104.13223140495867,208.26446280991735
2300,Xherdan Shaqiri,SUI,"FW,MF",Liverpool,Premier League,27,1991,2.1,1,0,0,1,0,0,1,0.0,1,0,0,0,0,1,0,0,0,2019-2020,90.0,0.0,42.857142857142854
Rk,Player,Nation,Pos,Squad,Comp,0,0,90.0,0,0,3,3,3,Tkl,0,0.0,0,0,0,0,0,0,0,0,0,2019-2020,90.0,0.0,0.0
2301,Billy Sharp,ENG,FW,Sheffield Utd,Premier League,33,1986,11.7,6,5,2,1,3,1,6,16.7,5,2,0,2,1,7,2,0,0,2019-2020,89.99999999999999,7.692307692307692,46.15384615384615
2302,Luke Shaw,ENG,DF,Manchester Utd,Premier League,24,1995,19.3,34,18,19,11,4,19,33,57.6,14,26,6,20,24,58,56,1,0,2019-2020,90.0,111.91709844559584,158.54922279792746
2303,Khiry Shelton,USA,FW,Paderborn 07,Bundesliga,26,1993,0.4,1,1,1,0,0,0,0,0.0,0,0,0,0,0,1,0,0,0,2019-2020,90.0,0.0,225.0
2304,Jonjo Shelvey,ENG,MF,Newcastle Utd,Premier League,27,1992,23.5,29,19,17,12,0,11,42,26.2,31,14,5,9,23,52,38,0,0,2019-2020,90.0,88.08510638297872,111.06382978723404
2305,Gen Shoji,JPN,DF,Toulouse,Ligue 1,26,1992,0.5,2,2,2,0,0,1,1,100.0,0,0,0,0,0,2,2,0,0,2019-2020,90.0,0.0,360.0
2306,Djibril Sidibé,FRA,"DF,MF",Everton,Premier League,27,1992,20.3,83,44,48,25,10,43,72,59.7,29,19,3,16,40,123,41,0,0,2019-2020,90.0,177.3399014778325,367.98029556650243
2307,Kalidou Sidibé,FRA,MF,Toulouse,Ligue 1,20,1999,1.0,3,3,0,3,0,2,5,40.0,3,0,0,0,1,4,0,0,0,2019-2020,90.0,90.0,270.0
2308,Sidnei,BRA,DF,Betis,La Liga,29,1989,13.1,23,19,17,6,0,9,14,64.3,5,15,12,3,21,44,57,0,0,2019-2020,90.0,144.27480916030535,158.01526717557252
2309,Kaj Sierhuis,NED,FW,Reims,Ligue 1,21,1998,0.1,0,0,0,0,0,0,0,0.0,0,0,0,0,0,0,0,0,0,2019-2020,90.0,0.0,0.0
2310,Gylfi Sigurðsson,ISL,MF,Everton,Premier League,29,1989,28.4,50,26,15,24,11,19,70,27.1,51,30,4,26,37,87,17,1,0,2019-2020,90.0,117.25352112676057,158.45070422535213
2311,Luca Siligardi,ITA,"MF,FW",Parma,Serie A,31,1988,3.7,6,2,3,2,1,4,8,50.0,4,3,0,3,3,9,5,0,0,2019-2020,90.0,72.97297297297297,145.94594594594594
2312,Adrien Silva,POR,MF,Monaco,Ligue 1,30,1989,13.6,37,22,14,19,4,10,37,27.0,27,19,6,13,12,49,14,2,0,2019-2020,90.0,79.41176470588235,244.85294117647058
2313,André Silva,POR,FW,Milan,Serie A,23,1995,0.7,2,1,0,0,2,0,1,0.0,1,0,0,0,0,2,0,0,0,2019-2020,90.0,0.0,257.14285714285717
2314,André Silva,POR,FW,Eint Frankfurt,Bundesliga,23,1995,17.5,7,2,0,5,2,2,14,14.3,12,9,0,9,8,15,4,0,0,2019-2020,90.0,41.14285714285714,36.0
2315,Bernardo Silva,POR,"FW,MF",Manchester City,Premier League,24,1994,22.6,36,18,8,21,7,13,44,29.5,31,25,1,24,24,60,13,0,0,2019-2020,90.0,95.57522123893806,143.36283185840708
2316,David Silva,ESP,MF,Manchester City,Premier League,33,1986,20.3,26,14,3,15,8,10,28,35.7,18,18,3,15,13,39,5,0,0,2019-2020,90.0,57.635467980295566,115.27093596059113
2317,Gabriel Silva,BRA,DF,Saint-Étienne,Ligue 1,28,1991,2.6,4,1,1,2,1,2,3,66.7,1,2,0,2,4,8,8,0,0,2019-2020,90.0,138.46153846153845,138.46153846153845
2318,Jonathan Silva,ARG,DF,Leganés,La Liga,25,1994,30.9,60,34,32,22,6,27,52,51.9,25,12,4,8,34,94,46,0,0,2019-2020,90.0,99.02912621359224,174.75728155339806
2319,Matheus Pereira da Silva,BRA,"MF,FW",Dijon,Ligue 1,21,1998,5.2,10,6,1,6,3,4,10,40.0,6,11,0,11,6,16,5,0,0,2019-2020,90.0,103.84615384615384,173.07692307692307
2320,Rui Silva,POR,GK,Granada,La Liga,25,1994,35.0,2,1,2,0,0,2,2,100.0,0,0,0,0,2,4,22,3,0,2019-2020,90.0,5.142857142857142,5.142857142857142
2321,Thiago Silva,BRA,DF,Paris S-G,Ligue 1,34,1984,17.5,28,16,15,13,0,13,16,81.3,3,18,15,3,26,54,54,0,0,2019-2020,90.0,133.71428571428572,144.0
2322,Marco Silvestri,ITA,GK,Hellas Verona,Serie A,28,1991,35.0,1,0,1,0,0,1,2,50.0,1,0,0,0,4,5,11,1,0,2019-2020,90.0,10.285714285714285,2.571428571428571
2323,Mohamed Simakan,FRA,DF,Strasbourg,Ligue 1,19,2000,16.7,54,32,35,16,3,22,34,64.7,12,14,3,11,31,85,25,0,0,2019-2020,90.0,167.06586826347305,291.0179640718563
2324,Giovanni Simeone,ARG,FW,Cagliari,Serie A,24,1995,32.5,24,13,9,10,5,5,32,15.6,27,24,7,17,11,35,16,1,0,2019-2020,90.0,30.461538461538463,66.46153846153847
2325,Moses Simon,NGA,"FW,MF",Nantes,Ligue 1,24,1995,24.2,15,7,5,4,6,6,21,28.6,15,6,0,6,8,23,6,0,0,2019-2020,90.0,29.75206611570248,55.785123966942145
Rk,Player,Nation,Pos,Squad,Comp,0,0,90.0,0,0,3,3,3,Tkl,0,0.0,0,0,0,0,0,0,0,0,0,2019-2020,90.0,0.0,0.0
2326,Unai Simón,ESP,GK,Athletic Club,La Liga,22,1997,33.2,0,0,0,0,0,0,1,0.0,1,1,0,1,1,1,10,1,0,2019-2020,90.0,2.7108433734939754,0.0
2327,Jack Simpson,ENG,DF,Bournemouth,Premier League,22,1996,2.7,5,2,4,1,0,2,8,25.0,6,1,0,1,2,7,12,1,0,2019-2020,90.0,66.66666666666666,166.66666666666666
2328,Sarpreet Singh,NZL,"FW,MF",Bayern Munich,Bundesliga,20,1999,0.8,1,0,0,1,0,0,1,0.0,1,0,0,0,0,1,0,0,0,2019-2020,90.0,0.0,112.5
2329,Wilfried Singo,CIV,DF,Torino,Serie A,18,2000,1.5,1,0,0,1,0,0,0,0.0,0,0,0,0,1,2,2,0,0,2019-2020,90.0,60.0,60.0
2330,Daley Sinkgraven,NED,"DF,MF",Leverkusen,Bundesliga,24,1995,10.1,20,16,11,6,3,8,24,33.3,16,12,3,9,10,30,16,0,0,2019-2020,90.0,89.10891089108911,178.21782178217822
2331,Dimitris Siovas,GRE,DF,Leganés,La Liga,30,1988,21.3,42,31,24,15,3,19,28,67.9,9,14,1,13,46,88,69,0,0,2019-2020,90.0,194.3661971830986,177.46478873239437
2332,Salvatore Sirigu,ITA,GK,Torino,Serie A,32,1987,36.0,0,0,0,0,0,0,0,0.0,0,0,0,0,2,2,12,0,0,2019-2020,90.0,5.0,0.0
2333,Ibrahima Sissoko,MLI,MF,Strasbourg,Ligue 1,21,1997,17.8,46,27,21,21,4,16,48,33.3,32,14,5,9,20,66,25,0,0,2019-2020,90.0,101.12359550561798,232.58426966292134
2334,Moussa Sissoko,FRA,MF,Tottenham,Premier League,29,1989,27.2,39,25,25,12,2,20,48,41.7,28,19,4,15,27,66,43,2,0,2019-2020,90.0,89.33823529411765,129.0441176470588
2335,Sambou Sissoko,FRA,"MF,FW",Reims,Ligue 1,20,1999,0.4,0,0,0,0,0,0,0,0.0,0,0,0,0,1,1,2,0,0,2019-2020,90.0,225.0,0.0
2336,Pione Sisto,DEN,"FW,MF",Celta Vigo,La Liga,24,1995,9.9,17,8,5,6,6,4,19,21.1,15,18,0,18,6,23,4,1,0,2019-2020,90.0,54.54545454545455,154.54545454545453
2337,Antonio Sivera,ESP,GK,Alavés,La Liga,22,1996,3.0,0,0,0,0,0,0,0,0.0,0,0,0,0,0,0,2,0,0,2019-2020,90.0,0.0,0.0
2338,Ellyes Skhiri,TUN,MF,Köln,Bundesliga,24,1995,29.7,74,52,30,37,7,29,77,37.7,48,47,9,38,67,141,33,0,0,2019-2020,90.0,203.03030303030303,224.24242424242422
2339,Oliver Skipp,ENG,MF,Tottenham,Premier League,18,2000,0.9,2,2,0,2,0,1,4,25.0,3,3,2,1,0,2,0,0,0,2019-2020,90.0,0.0,200.0
2340,Łukasz Skorupski,POL,GK,Bologna,Serie A,28,1991,37.0,1,0,1,0,0,0,1,0.0,1,0,0,0,2,3,15,5,0,2019-2020,90.0,4.864864864864865,2.4324324324324325
2341,Andreas Skov Olsen,DEN,"FW,MF",Bologna,Serie A,19,1999,8.4,11,8,5,5,1,4,12,33.3,8,10,1,9,8,19,5,0,0,2019-2020,90.0,85.71428571428571,117.85714285714285
2342,Robert Skov,DEN,"DF,FW",Hoffenheim,Bundesliga,23,1996,29.0,41,28,30,9,2,26,50,52.0,24,26,6,20,20,61,40,0,0,2019-2020,90.0,62.068965517241374,127.24137931034483
2343,Simon Skrabb,FIN,"FW,MF",Brescia,Serie A,24,1995,2.9,7,6,2,4,1,6,12,50.0,6,4,1,3,0,7,3,0,0,2019-2020,90.0,0.0,217.24137931034483
2344,Milan Škriniar,SVK,DF,Inter,Serie A,24,1995,29.2,39,20,24,14,1,14,33,42.4,19,19,11,8,28,67,85,1,0,2019-2020,90.0,86.3013698630137,120.2054794520548
2345,Steven Skrzybski,GER,"FW,MF",Düsseldorf,Bundesliga,26,1992,5.9,4,4,2,1,1,0,16,0.0,16,10,0,10,10,14,4,0,0,2019-2020,90.0,152.54237288135593,61.01694915254237
2346,Petar Škuletić,SRB,"FW,MF",Montpellier,Ligue 1,29,1990,1.2,6,4,2,2,2,2,4,50.0,2,0,0,0,0,6,1,0,0,2019-2020,90.0,0.0,450.00000000000006
2347,Islam Slimani,ALG,FW,Monaco,Ligue 1,31,1988,14.3,8,4,0,2,6,4,15,26.7,11,5,0,5,1,9,11,1,0,2019-2020,90.0,6.293706293706294,50.349650349650354
2348,William Smallbone,IRL,MF,Southampton,Premier League,19,2000,4.4,10,5,2,8,0,5,10,50.0,5,7,1,6,1,11,2,0,0,2019-2020,90.0,20.454545454545453,204.54545454545453
2349,Chris Smalling,ENG,DF,Roma,Serie A,29,1989,28.5,25,16,15,9,1,10,13,76.9,3,44,35,9,56,81,126,2,0,2019-2020,90.0,176.8421052631579,78.94736842105263
2350,Dennis Smarsch,GER,GK,Hertha BSC,Bundesliga,20,1999,1.7,0,0,0,0,0,0,0,0.0,0,0,0,0,0,0,1,0,0,2019-2020,90.0,0.0,0.0
Rk,Player,Nation,Pos,Squad,Comp,0,0,90.0,0,0,3,3,3,Tkl,0,0.0,0,0,0,0,0,0,0,0,0,2019-2020,90.0,0.0,0.0
2351,Adam Smith,ENG,DF,Bournemouth,Premier League,28,1991,22.8,47,32,29,16,2,23,50,46.0,27,27,6,21,25,72,64,1,0,2019-2020,90.0,98.68421052631578,185.52631578947367
2352,Emile Smith Rowe,ENG,MF,Arsenal,Premier League,19,2000,1.1,1,1,1,0,0,1,3,33.3,2,0,0,0,1,2,2,0,0,2019-2020,90.0,81.81818181818181,81.81818181818181
2353,Fyodor Smolov,RUS,FW,Celta Vigo,La Liga,29,1990,8.3,2,1,0,2,0,1,9,11.1,8,6,0,6,7,9,9,0,0,2019-2020,90.0,75.90361445783131,21.686746987951803
2354,Robert Snodgrass,SCO,"MF,FW",West Ham,Premier League,31,1987,16.8,29,16,17,10,2,13,44,29.5,31,12,1,11,4,33,11,0,0,2019-2020,90.0,21.428571428571427,155.35714285714286
2355,Cédric Soares,POR,"MF,DF",Arsenal,Premier League,27,1991,2.8,8,6,2,6,0,1,3,33.3,2,3,0,3,3,11,4,0,0,2019-2020,90.0,96.42857142857143,257.14285714285717
2356,Cédric Soares,POR,DF,Southampton,Premier League,27,1991,14.5,45,26,19,24,2,25,41,61.0,16,18,4,14,19,64,51,0,0,2019-2020,90.0,117.93103448275862,279.31034482758616
2357,Rafa Soares,POR,DF,Eibar,La Liga,24,1995,4.8,6,5,5,0,1,5,11,45.5,6,1,0,1,2,8,6,0,0,2019-2020,90.0,37.5,112.50000000000001
2358,Lasse Sobiech,GER,DF,Köln,Bundesliga,28,1991,1.0,1,0,0,0,1,0,0,0.0,0,0,0,0,4,5,6,0,0,2019-2020,90.0,360.0,90.0
2359,Marcel Sobottka,GER,MF,Düsseldorf,Bundesliga,25,1994,7.8,15,10,6,8,1,4,13,30.8,9,9,1,8,9,24,12,0,0,2019-2020,90.0,103.84615384615384,173.07692307692307
2360,Rubén Sobrino,ESP,"FW,MF",Valencia,La Liga,27,1992,1.9,7,5,3,2,2,2,3,66.7,1,1,0,1,0,7,1,0,0,2019-2020,90.0,0.0,331.57894736842104
2361,Dominic Solanke,ENG,FW,Bournemouth,Premier League,21,1997,18.3,8,4,2,5,1,5,33,15.2,28,9,1,8,8,16,18,1,0,2019-2020,90.0,39.34426229508197,39.34426229508197
2362,Roberto Soldado,ESP,FW,Granada,La Liga,34,1985,26.1,16,9,2,7,7,7,24,29.2,17,16,4,12,4,20,16,0,0,2019-2020,90.0,13.793103448275861,55.172413793103445
2363,Carlos Soler,ESP,MF,Valencia,La Liga,22,1997,23.0,21,10,10,10,1,9,39,23.1,30,16,6,10,9,30,14,0,0,2019-2020,90.0,35.21739130434783,82.17391304347827
2364,Oumar Solet,FRA,DF,Lyon,Ligue 1,19,2000,0.1,0,0,0,0,0,0,0,0.0,0,1,1,0,0,0,1,0,0,2019-2020,90.0,0.0,0.0
2365,Yann Sommer,SUI,GK,Gladbach,Bundesliga,30,1988,34.0,0,0,0,0,0,0,1,0.0,1,0,0,0,1,1,11,6,0,2019-2020,90.0,2.6470588235294117,0.0
2366,Kévin Soni,CMR,FW,Espanyol,La Liga,21,1998,0.0,0,0,0,0,0,0,0,0.0,0,0,0,0,0,0,0,0,0,2019-2020,,,
2367,David Soria,ESP,GK,Getafe,La Liga,26,1993,38.0,2,1,2,0,0,2,4,50.0,2,0,0,0,3,5,17,5,0,2019-2020,90.0,7.105263157894737,4.7368421052631575
2368,Bruno Soriano,ESP,"MF,FW",Villarreal,La Liga,35,1984,2.9,4,0,1,2,1,1,1,100.0,0,4,0,4,1,5,7,0,0,2019-2020,90.0,31.03448275862069,124.13793103448276
2369,Juan Soriano,ESP,GK,Leganés,La Liga,21,1997,11.0,0,0,0,0,0,0,0,0.0,0,0,0,0,0,0,1,1,0,2019-2020,90.0,0.0,0.0
2370,Roberto Soriano,ITA,MF,Bologna,Serie A,28,1991,27.4,43,25,15,21,7,10,46,21.7,36,19,0,19,17,60,23,1,0,2019-2020,90.0,55.839416058394164,141.24087591240877
2371,Riccardo Sottil,ITA,"FW,DF",Fiorentina,Serie A,20,1999,5.7,6,4,4,2,0,3,10,30.0,7,4,0,4,0,6,0,0,0,2019-2020,90.0,0.0,94.73684210526315
2372,Tomáš Souček,CZE,MF,West Ham,Premier League,24,1995,11.6,29,15,13,15,1,10,23,43.5,13,7,1,6,22,51,35,0,0,2019-2020,90.0,170.6896551724138,225.0
2373,Adama Soumaoro,FRA,DF,Genoa,Serie A,27,1992,7.1,3,2,3,0,0,1,3,33.3,2,12,12,0,11,14,32,0,0,2019-2020,90.0,139.43661971830986,38.02816901408451
2374,Adama Soumaoro,FRA,DF,Lille,Ligue 1,27,1992,4.6,1,1,0,1,0,0,0,0.0,0,6,5,1,4,5,17,0,0,2019-2020,90.0,78.26086956521739,19.565217391304348
2375,Boubakary Soumaré,FRA,MF,Lille,Ligue 1,20,1999,13.5,19,12,6,13,0,9,19,47.4,10,6,0,6,16,35,9,0,0,2019-2020,90.0,106.66666666666667,126.66666666666667
Rk,Player,Nation,Pos,Squad,Comp,0,0,90.0,0,0,3,3,3,Tkl,0,0.0,0,0,0,0,0,0,0,0,0,2019-2020,90.0,0.0,0.0
2376,Bryan Soumaré,FRA,"MF,FW",Dijon,Ligue 1,20,1999,4.3,12,1,6,5,1,6,9,66.7,3,1,0,1,2,14,1,0,0,2019-2020,90.0,41.86046511627907,251.16279069767444
2377,Arnaud Souquet,FRA,"DF,FW",Montpellier,Ligue 1,27,1992,22.4,62,40,45,13,4,30,67,44.8,37,20,6,14,17,79,44,0,0,2019-2020,90.0,68.30357142857143,249.10714285714286
2378,Djibril Sow,SUI,MF,Eint Frankfurt,Bundesliga,22,1997,19.4,56,33,26,17,13,16,47,34.0,31,15,3,12,30,86,9,0,0,2019-2020,90.0,139.1752577319588,259.79381443298973
2379,Çağlar Söyüncü,TUR,DF,Leicester City,Premier League,23,1996,33.7,60,40,41,18,1,27,46,58.7,19,35,19,16,43,103,156,1,0,2019-2020,90.0,114.83679525222551,160.2373887240356
2380,Nikolas Špalek,SVK,"MF,FW",Brescia,Serie A,22,1997,17.5,24,10,6,11,7,7,31,22.6,24,15,1,14,6,30,10,0,0,2019-2020,90.0,30.857142857142858,123.42857142857143
2381,Leonardo Spinazzola,ITA,DF,Roma,Serie A,26,1993,17.2,24,12,11,8,5,12,21,57.1,9,13,5,8,20,44,41,0,0,2019-2020,90.0,104.65116279069768,125.58139534883722
2382,Marco Sportiello,ITA,GK,Atalanta,Serie A,27,1992,5.8,0,0,0,0,0,0,0,0.0,0,0,0,0,0,0,3,0,0,2019-2020,90.0,0.0,0.0
2383,Mattia Sprocati,ITA,"FW,MF",Parma,Serie A,26,1993,6.6,4,2,3,1,0,0,1,0.0,1,5,1,4,2,6,2,0,0,2019-2020,90.0,27.272727272727273,54.54545454545455
2384,Bassem Srarfi,TUN,"FW,MF",Nice,Ligue 1,22,1997,1.5,0,0,0,0,0,0,2,0.0,2,0,0,0,2,2,0,0,0,2019-2020,90.0,120.0,0.0
2385,Dennis Srbeny,GER,"MF,FW",Norwich City,Premier League,25,1994,0.5,5,5,3,2,0,1,3,33.3,2,1,0,1,0,5,1,0,0,2019-2020,90.0,0.0,900.0
2386,Dennis Srbeny,GER,"FW,MF",Paderborn 07,Bundesliga,25,1994,12.4,11,6,4,4,3,5,18,27.8,13,11,1,10,3,14,9,0,0,2019-2020,90.0,21.774193548387096,79.83870967741936
2387,Jerry St. Juste,NED,DF,Mainz 05,Bundesliga,22,1996,23.5,46,25,34,10,2,14,34,41.2,20,35,19,16,52,98,86,1,0,2019-2020,90.0,199.14893617021275,176.17021276595744
2388,Jack Stacey,ENG,DF,Bournemouth,Premier League,23,1996,17.2,21,11,9,11,1,8,22,36.4,14,27,11,16,18,39,64,1,0,2019-2020,90.0,94.18604651162792,109.88372093023257
2389,Kostas Stafylidis,GRE,DF,Hoffenheim,Bundesliga,25,1993,4.4,10,3,7,2,1,4,10,40.0,6,10,3,7,2,12,17,0,0,2019-2020,90.0,40.90909090909091,204.54545454545453
2390,Benjamin Stambouli,FRA,DF,Schalke 04,Bundesliga,28,1990,9.0,31,19,14,15,2,11,21,52.4,10,16,6,10,12,43,28,1,0,2019-2020,90.0,120.0,310.0
2391,Junior Stanislas,ENG,"MF,FW",Bournemouth,Premier League,29,1989,7.9,10,7,2,3,5,3,8,37.5,5,6,0,6,4,14,6,0,0,2019-2020,90.0,45.56962025316455,113.92405063291137
2392,Niklas Stark,GER,DF,Hertha BSC,Bundesliga,24,1995,19.2,36,20,24,10,2,9,21,42.9,12,27,12,15,21,57,97,2,0,2019-2020,90.0,98.4375,168.75
2393,Jed Steer,ENG,GK,Aston Villa,Premier League,26,1992,0.1,0,0,0,0,0,0,0,0.0,0,0,0,0,0,0,0,0,0,2019-2020,90.0,0.0,0.0
2394,Renato Steffen,SUI,"MF,FW",Wolfsburg,Bundesliga,27,1991,17.6,25,18,4,14,7,14,39,35.9,25,25,2,23,23,48,10,0,0,2019-2020,90.0,117.61363636363636,127.84090909090908
2395,Zack Steffen,USA,GK,Düsseldorf,Bundesliga,24,1995,17.0,0,0,0,0,0,0,0,0.0,0,0,0,0,0,0,5,4,0,2019-2020,90.0,0.0,0.0
2396,Dale Stephens,ENG,MF,Brighton,Premier League,30,1989,28.1,73,44,30,37,6,25,75,33.3,50,31,11,20,58,131,42,2,0,2019-2020,90.0,185.76512455516013,233.80782918149464
2397,Jack Stephens,ENG,DF,Southampton,Premier League,25,1994,27.2,44,27,30,13,1,24,46,52.2,22,38,22,16,31,75,120,2,0,2019-2020,90.0,102.57352941176471,145.58823529411765
2398,Mariusz Stępiński,POL,"FW,MF",Hellas Verona,Serie A,24,1995,7.8,5,3,2,1,2,1,2,50.0,1,3,1,2,1,6,7,0,0,2019-2020,90.0,11.538461538461538,57.69230769230769
2399,Raheem Sterling,ENG,FW,Manchester City,Premier League,24,1994,29.5,27,15,8,10,9,6,28,21.4,22,16,2,14,15,42,4,0,0,2019-2020,90.0,45.76271186440678,82.37288135593221
2400,Enda Stevens,IRL,DF,Sheffield Utd,Premier League,29,1990,37.2,81,46,48,26,7,42,96,43.8,54,27,8,19,35,116,71,3,0,2019-2020,90.0,84.6774193548387,195.96774193548384
Rk,Player,Nation,Pos,Squad,Comp,0,0,90.0,0,0,3,3,3,Tkl,0,0.0,0,0,0,0,0,0,0,0,0,2019-2020,90.0,0.0,0.0
2401,Marco Stiepermann,GER,MF,Norwich City,Premier League,28,1991,13.1,20,8,8,9,3,5,21,23.8,16,11,3,8,5,25,16,0,0,2019-2020,90.0,34.35114503816794,137.40458015267177
2402,Lars Stindl,GER,"MF,FW",Gladbach,Bundesliga,30,1988,15.9,27,16,4,15,8,10,28,35.7,18,18,2,16,10,37,7,0,0,2019-2020,90.0,56.60377358490566,152.83018867924528
2403,Kevin Stöger,AUT,MF,Düsseldorf,Bundesliga,25,1993,14.1,21,15,10,7,4,6,24,25.0,18,24,2,22,26,47,7,1,0,2019-2020,89.99999999999999,165.95744680851064,134.04255319148936
2404,Vlatko Stojanovski,MKD,FW,Nîmes,Ligue 1,22,1997,1.4,3,3,0,3,0,1,1,100.0,0,0,0,0,0,3,1,0,0,2019-2020,90.0,0.0,192.85714285714286
2405,John Stones,ENG,DF,Manchester City,Premier League,25,1994,12.5,16,10,8,7,1,3,5,60.0,2,5,3,2,9,25,32,2,0,2019-2020,90.0,64.8,115.19999999999999
2406,Thomas Strakosha,ALB,GK,Lazio,Serie A,24,1995,38.0,0,0,0,0,0,0,1,0.0,1,0,0,0,0,0,7,2,0,2019-2020,90.0,0.0,0.0
2407,Gabriel Strefezza,BRA,"DF,MF",SPAL,Serie A,22,1997,23.4,64,40,28,26,10,22,54,40.7,32,29,3,26,21,85,17,0,0,2019-2020,89.99999999999999,80.76923076923076,246.15384615384613
2408,Tobias Strobl,GER,"MF,DF",Gladbach,Bundesliga,29,1990,6.8,9,6,5,4,0,3,8,37.5,5,8,4,4,11,20,5,0,0,2019-2020,90.0,145.58823529411765,119.11764705882352
2409,Christian Strohdiek,GER,DF,Paderborn 07,Bundesliga,31,1988,15.1,26,22,21,5,0,20,42,47.6,22,16,10,6,25,51,92,0,0,2019-2020,90.0,149.0066225165563,154.96688741721854
2410,Kevin Strootman,NED,MF,Marseille,Ligue 1,29,1990,15.7,39,27,13,23,3,20,49,40.8,29,16,1,15,17,56,24,0,0,2019-2020,90.0,97.45222929936307,223.56687898089174
2411,Jens Stryger Larsen,DEN,DF,Udinese,Serie A,28,1991,31.0,27,19,15,9,3,17,30,56.7,13,20,5,15,20,47,52,0,0,2019-2020,90.0,58.064516129032256,78.38709677419355
2412,Stefano Sturaro,ITA,MF,Genoa,Serie A,26,1993,13.9,38,22,14,19,5,15,39,38.5,24,16,4,12,10,48,26,1,0,2019-2020,90.0,64.74820143884892,246.0431654676259
2413,Damián Suárez,URU,DF,Getafe,La Liga,31,1988,28.8,62,32,32,21,9,38,72,52.8,34,25,2,23,27,89,41,0,0,2019-2020,90.0,84.375,193.75
2414,Denis Suárez,ESP,"MF,FW",Celta Vigo,La Liga,25,1994,18.1,22,15,14,7,1,10,37,27.0,27,9,1,8,14,36,12,1,0,2019-2020,90.0,69.61325966850828,109.39226519337015
2415,Luis Suárez,URU,FW,Barcelona,La Liga,32,1987,22.2,4,0,0,1,3,2,12,16.7,10,6,1,5,1,5,11,0,0,2019-2020,90.0,4.054054054054054,16.216216216216218
2416,Mathías Suárez,URU,DF,Montpellier,Ligue 1,23,1996,0.7,2,2,2,0,0,2,3,66.7,1,0,0,0,1,3,3,0,0,2019-2020,90.0,128.57142857142858,257.14285714285717
2417,Neven Subotić,SRB,DF,Union Berlin,Bundesliga,30,1988,21.8,30,18,12,16,2,8,32,25.0,24,21,8,13,34,64,89,0,0,2019-2020,90.0,140.36697247706422,123.8532110091743
2418,Isaac Success,NGA,"FW,MF",Watford,Premier League,23,1996,0.8,0,0,0,0,0,0,0,0.0,0,0,0,0,1,1,0,0,0,2019-2020,90.0,112.5,0.0
2419,Marek Suchý,CZE,DF,Augsburg,Bundesliga,31,1988,4.4,7,5,7,0,0,4,6,66.7,2,4,1,3,6,13,15,0,0,2019-2020,90.0,122.72727272727272,143.1818181818182
2420,Niklas Süle,GER,DF,Bayern Munich,Bundesliga,23,1995,7.1,10,6,8,2,0,4,5,80.0,1,8,6,2,8,18,22,1,0,2019-2020,90.0,101.40845070422536,126.7605633802817
2421,Ki Sung-yueng,KOR,MF,Newcastle Utd,Premier League,30,1989,1.5,1,1,0,1,0,1,3,33.3,2,1,0,1,3,4,2,0,0,2019-2020,90.0,180.0,60.0
2422,Ki Sung-yueng,KOR,MF,Mallorca,La Liga,30,1989,0.1,0,0,0,0,0,0,1,0.0,1,0,0,0,0,0,0,0,0,2019-2020,90.0,0.0,0.0
2423,Stoppila Sunzu,ZAM,DF,Metz,Ligue 1,30,1989,15.0,16,8,12,4,0,10,15,66.7,5,22,15,7,24,40,63,0,0,2019-2020,90.0,144.0,96.0
2424,Andrew Surman,ENG,MF,Bournemouth,Premier League,32,1986,2.6,4,2,2,2,0,1,3,33.3,2,1,0,1,1,5,5,1,0,2019-2020,90.0,34.61538461538461,138.46153846153845
2425,Sam Surridge,ENG,"FW,MF",Bournemouth,Premier League,21,1998,0.3,0,0,0,0,0,0,0,0.0,0,1,0,1,1,1,0,0,0,2019-2020,90.0,300.0,0.0
Rk,Player,Nation,Pos,Squad,Comp,0,0,90.0,0,0,3,3,3,Tkl,0,0.0,0,0,0,0,0,0,0,0,0,2019-2020,90.0,0.0,0.0
2426,Suso,ESP,"FW,MF",Milan,Serie A,25,1993,15.1,7,3,2,3,2,2,10,20.0,8,5,0,5,8,15,3,0,0,2019-2020,90.0,47.682119205298015,41.72185430463576
2427,Suso,ESP,"FW,MF",Sevilla,La Liga,25,1993,8.7,9,4,4,4,1,7,16,43.8,9,6,0,6,2,11,0,0,0,2019-2020,90.0,20.689655172413794,93.10344827586206
2428,Bosko Sutalo,CRO,DF,Atalanta,Serie A,19,2000,3.1,3,2,2,1,0,0,2,0.0,2,4,0,4,6,9,6,1,0,2019-2020,90.0,174.19354838709677,87.09677419354838
2429,Markus Suttner,AUT,DF,Düsseldorf,Bundesliga,32,1987,14.9,21,16,11,9,1,11,24,45.8,13,22,7,15,13,34,33,0,0,2019-2020,90.0,78.5234899328859,126.84563758389261
2430,Mattias Svanberg,SWE,MF,Bologna,Serie A,20,1999,11.7,13,8,9,4,0,6,31,19.4,25,15,4,11,13,26,10,0,0,2019-2020,89.99999999999999,100.0,100.0
2431,Issiaga Sylla,GUI,DF,Toulouse,Ligue 1,25,1994,28.0,73,49,44,21,8,40,69,58.0,29,31,7,24,67,140,90,2,0,2019-2020,90.0,215.35714285714286,234.64285714285714
2432,Moussa Sylla,MLI,FW,Monaco,Ligue 1,19,1999,0.1,0,0,0,0,0,0,0,0.0,0,0,0,0,0,0,0,0,0,2019-2020,90.0,0.0,0.0
2433,Eddy Sylvestre,FRA,MF,Nice,Ligue 1,19,1999,0.4,0,0,0,0,0,0,1,0.0,1,0,0,0,0,0,0,0,0,2019-2020,90.0,0.0,0.0
2434,Ádám Szalai,HUN,FW,Mainz 05,Bundesliga,31,1987,12.7,8,4,0,6,2,1,11,9.1,10,9,0,9,2,10,14,0,0,2019-2020,90.0,14.173228346456694,56.69291338582678
2435,Wojciech Szczęsny,POL,GK,Juventus,Serie A,29,1990,28.8,0,0,0,0,0,0,0,0.0,0,0,0,0,1,1,10,1,0,2019-2020,90.0,3.125,0.0
2436,Andrea Tabanelli,ITA,MF,Lecce,Serie A,29,1990,10.7,22,13,10,9,3,8,28,28.6,20,13,2,11,11,33,19,0,0,2019-2020,90.0,92.52336448598132,185.04672897196264
2437,Tachi,ESP,DF,Alavés,La Liga,21,1997,2.6,2,1,2,0,0,1,4,25.0,3,5,4,1,4,6,12,0,0,2019-2020,90.0,138.46153846153845,69.23076923076923
2438,Panagiotis Tachtsidis,GRE,MF,Lecce,Serie A,28,1991,22.3,52,27,26,20,6,20,56,35.7,36,27,11,16,35,87,32,2,0,2019-2020,90.0,141.2556053811659,209.86547085201792
2439,Jonathan Tah,GER,DF,Leverkusen,Bundesliga,23,1996,23.2,36,26,23,11,2,18,29,62.1,11,25,13,12,27,63,98,2,0,2019-2020,90.0,104.74137931034483,139.6551724137931
2440,Flavien Tait,FRA,"MF,FW",Rennes,Ligue 1,26,1993,9.8,20,13,12,6,2,9,28,32.1,19,7,0,7,9,29,5,1,0,2019-2020,90.0,82.65306122448979,183.6734693877551
2441,Madih Talal,FRA,FW,Amiens,Ligue 1,21,1997,0.2,0,0,0,0,0,0,1,0.0,1,1,0,1,0,0,2,0,0,2019-2020,90.0,0.0,0.0
2442,Adrien Tameze,CMR,MF,Atalanta,Serie A,25,1994,2.3,4,3,1,1,2,1,2,50.0,1,3,1,2,3,7,4,1,0,2019-2020,90.0,117.3913043478261,156.52173913043478
2443,Adrien Tameze,CMR,MF,Nice,Ligue 1,25,1994,5.8,6,2,2,3,1,4,16,25.0,12,7,2,5,7,13,1,1,0,2019-2020,90.0,108.62068965517241,93.10344827586206
2444,Japhet Tanganga,ENG,DF,Tottenham,Premier League,20,1999,5.8,17,9,10,6,1,10,17,58.8,7,7,6,1,11,28,31,2,0,2019-2020,90.0,170.6896551724138,263.7931034482759
2445,Adil Taoui,FRA,MF,Toulouse,Ligue 1,17,2001,0.3,2,2,0,2,0,0,2,0.0,2,0,0,0,2,4,0,0,0,2019-2020,90.0,600.0,600.0
2446,Edmond Tapsoba,BFA,DF,Leverkusen,Bundesliga,20,1999,11.8,24,15,17,5,2,15,25,60.0,10,9,5,4,9,33,44,0,0,2019-2020,90.0,68.64406779661016,183.0508474576271
2447,Matt Targett,ENG,"DF,MF",Aston Villa,Premier League,23,1995,25.5,52,29,37,11,4,22,53,41.5,31,28,8,20,56,108,82,0,0,2019-2020,90.0,197.64705882352942,183.52941176470588
2448,Rodrigo Tarín,ESP,DF,Leganés,La Liga,23,1996,10.6,10,7,8,2,0,9,14,64.3,5,7,3,4,9,19,51,0,0,2019-2020,90.0,76.41509433962264,84.9056603773585
2449,James Tarkowski,ENG,DF,Burnley,Premier League,26,1992,38.0,66,43,47,19,0,31,54,57.4,23,63,47,16,63,129,204,4,0,2019-2020,90.0,149.21052631578948,156.31578947368422
2450,Ciprian Tătărușanu,ROU,GK,Lyon,Ligue 1,33,1986,2.0,0,0,0,0,0,0,0,0.0,0,0,0,0,0,0,0,1,0,2019-2020,90.0,0.0,0.0
Rk,Player,Nation,Pos,Squad,Comp,0,0,90.0,0,0,3,3,3,Tkl,0,0.0,0,0,0,0,0,0,0,0,0,2019-2020,90.0,0.0,0.0
2451,Júlio Tavares,CPV,FW,Dijon,Ligue 1,30,1988,22.2,12,8,1,6,5,4,17,23.5,13,9,2,7,8,20,29,0,0,2019-2020,90.0,32.432432432432435,48.64864864864865
2452,Charlie Taylor,ENG,DF,Burnley,Premier League,25,1993,21.6,39,24,26,9,4,19,39,48.7,20,29,9,20,29,68,78,1,0,2019-2020,90.0,120.83333333333333,162.5
2453,Neil Taylor,WAL,DF,Aston Villa,Premier League,30,1989,12.1,16,11,12,4,0,11,20,55.0,9,15,5,10,20,36,43,0,0,2019-2020,90.0,148.7603305785124,119.00826446280992
2454,Aurélien Tchouaméni,FRA,MF,Bordeaux,Ligue 1,19,2000,12.3,30,14,15,13,2,11,27,40.7,16,11,3,8,13,43,19,1,0,2019-2020,89.99999999999999,95.12195121951218,219.51219512195118
2455,Aurélien Tchouaméni,FRA,MF,Monaco,Ligue 1,19,2000,0.7,0,0,0,0,0,0,2,0.0,2,0,0,0,0,0,2,1,0,2019-2020,90.0,0.0,0.0
2456,Georg Teigl,AUT,"DF,MF",Augsburg,Bundesliga,28,1991,1.2,3,1,1,2,0,2,4,50.0,2,0,0,0,3,6,1,0,0,2019-2020,90.0,225.00000000000003,225.00000000000003
2457,Álvaro Tejero,ESP,DF,Eibar,La Liga,23,1996,16.1,30,18,17,10,3,14,23,60.9,9,17,4,13,28,58,38,0,0,2019-2020,90.0,156.52173913043478,167.70186335403724
2458,Bernard Tekpetey,GHA,"FW,MF",Düsseldorf,Bundesliga,21,1997,5.0,4,4,1,2,1,0,2,0.0,2,5,0,5,2,6,0,0,0,2019-2020,90.0,36.0,72.0
2459,Nathan Tella,NGA,FW,Southampton,Premier League,20,1999,0.0,0,0,0,0,0,0,0,0.0,0,0,0,0,0,0,0,0,0,2019-2020,,,
2460,Cristian Tello,ESP,"MF,FW",Betis,La Liga,27,1991,8.7,8,5,2,2,4,4,8,50.0,4,5,0,5,4,12,0,0,0,2019-2020,90.0,41.37931034482759,82.75862068965517
2461,Lino Tempelmann,GER,MF,Freiburg,Bundesliga,20,1999,0.4,1,0,1,0,0,1,1,100.0,0,1,1,0,0,1,0,0,0,2019-2020,90.0,0.0,225.0
2462,Łukasz Teodorczyk,POL,FW,Udinese,Serie A,28,1991,2.5,7,5,1,5,1,3,7,42.9,4,2,0,2,0,7,1,0,0,2019-2020,90.0,0.0,252.0
2463,Hidde ter Avest,NED,DF,Udinese,Serie A,22,1997,7.6,18,9,13,3,2,14,17,82.4,3,6,1,5,9,27,27,0,0,2019-2020,90.0,106.57894736842105,213.1578947368421
2464,Marc-André ter Stegen,GER,GK,Barcelona,La Liga,27,1992,36.0,2,2,2,0,0,2,3,66.7,1,0,0,0,2,4,17,6,0,2019-2020,90.0,5.0,5.0
2465,Simon Terodde,GER,FW,Köln,Bundesliga,31,1988,9.0,8,5,4,3,1,3,13,23.1,10,14,3,11,2,10,14,0,0,2019-2020,90.0,20.0,80.0
2466,Pietro Terracciano,ITA,GK,Fiorentina,Serie A,29,1990,6.9,0,0,0,0,0,0,0,0.0,0,0,0,0,0,0,4,0,0,2019-2020,90.0,0.0,0.0
2467,Martin Terrier,FRA,"FW,MF",Lyon,Ligue 1,22,1997,13.3,20,15,7,10,3,3,14,21.4,11,14,1,13,10,30,11,0,0,2019-2020,90.0,67.66917293233082,135.33834586466165
2468,Aleksa Terzić,SRB,MF,Fiorentina,Serie A,19,1999,0.1,0,0,0,0,0,0,0,0.0,0,0,0,0,0,0,0,0,0,2019-2020,90.0,0.0,0.0
2469,Kenny Tete,NED,DF,Lyon,Ligue 1,23,1995,11.9,33,21,12,16,5,15,23,65.2,8,12,3,9,19,52,34,0,0,2019-2020,90.00000000000001,143.69747899159665,249.57983193277312
2470,Alexander Tettey,NOR,"MF,DF",Norwich City,Premier League,33,1986,26.0,23,18,7,16,0,11,39,28.2,28,20,9,11,43,66,72,1,0,2019-2020,90.00000000000001,148.84615384615387,79.61538461538463
2471,Florian Thauvin,FRA,FW,Marseille,Ligue 1,26,1993,0.2,1,0,0,1,0,0,1,0.0,1,0,0,0,0,1,0,0,0,2019-2020,90.0,0.0,450.0
2472,Demba Thiam,SEN,GK,SPAL,Serie A,21,1998,2.0,0,0,0,0,0,0,0,0.0,0,0,0,0,1,1,0,0,0,2019-2020,90.0,45.0,0.0
2473,Malick Thiaw,GER,DF,Schalke 04,Bundesliga,17,2001,0.8,2,0,1,1,0,1,2,50.0,1,2,2,0,2,4,4,1,0,2019-2020,90.0,225.0,225.0
2474,Niclas Thiede,GER,GK,Freiburg,Bundesliga,20,1999,0.8,0,0,0,0,0,0,0,0.0,0,0,0,0,0,0,1,0,0,2019-2020,90.0,0.0,0.0
2475,Jan Thielmann,GER,"FW,MF",Köln,Bundesliga,17,2002,6.2,9,6,2,6,1,5,12,41.7,7,8,0,8,8,17,6,0,0,2019-2020,90.0,116.12903225806451,130.6451612903226
Rk,Player,Nation,Pos,Squad,Comp,0,0,90.0,0,0,3,3,3,Tkl,0,0.0,0,0,0,0,0,0,0,0,0,2019-2020,90.0,0.0,0.0
2476,Sada Thioub,SEN,"MF,FW",Angers,Ligue 1,24,1995,16.8,20,12,8,9,3,5,18,27.8,13,9,1,8,4,24,5,0,0,2019-2020,90.0,21.428571428571427,107.14285714285714
2477,Jordan Thomas,ENG,FW,Norwich City,Premier League,18,2001,0.0,0,0,0,0,0,0,0,0.0,0,0,0,0,0,0,0,0,0,2019-2020,,,
2478,Luke Thomas,ENG,"MF,DF",Leicester City,Premier League,18,2001,3.0,1,0,0,1,0,0,3,0.0,3,2,0,2,3,4,7,0,0,2019-2020,90.0,90.0,30.0
2479,Romain Thomas,FRA,DF,Angers,Ligue 1,31,1988,26.0,24,17,16,7,1,8,18,44.4,10,35,18,17,39,63,118,1,0,2019-2020,90.00000000000001,135.0,83.07692307692308
2480,Adrien Thomasson,FRA,"MF,FW",Strasbourg,Ligue 1,25,1993,23.0,36,21,11,16,9,15,47,31.9,32,21,1,20,9,45,9,0,0,2019-2020,90.0,35.21739130434783,140.8695652173913
2481,Erik Thommy,GER,"MF,FW",Düsseldorf,Bundesliga,24,1994,25.1,40,23,16,16,8,15,39,38.5,24,23,2,21,16,56,20,1,0,2019-2020,90.0,57.37051792828685,143.42629482071712
2482,Max Thompson,ENG,FW,Burnley,Premier League,17,2002,0.0,0,0,0,0,0,0,0,0.0,0,0,0,0,0,0,0,0,0,2019-2020,,,
2483,Morten Thorsby,NOR,"MF,DF",Sampdoria,Serie A,23,1996,20.7,53,34,17,23,13,27,52,51.9,25,24,6,18,17,70,34,0,0,2019-2020,90.0,73.91304347826087,230.43478260869566
2484,Khéphren Thuram,FRA,MF,Nice,Ligue 1,18,2001,6.6,22,7,14,8,0,6,17,35.3,11,12,2,10,7,29,13,0,0,2019-2020,90.0,95.45454545454545,300.0
2485,Marcus Thuram,FRA,FW,Gladbach,Bundesliga,21,1997,24.5,26,18,7,8,11,11,29,37.9,18,20,1,19,12,38,18,0,0,2019-2020,90.00000000000001,44.08163265306123,95.51020408163266
2486,Youri Tielemans,BEL,MF,Leicester City,Premier League,22,1997,31.4,52,29,17,30,5,24,74,32.4,50,43,4,39,22,74,18,0,0,2019-2020,90.0,63.05732484076434,149.04458598726117
2487,Kieran Tierney,SCO,"DF,MF",Arsenal,Premier League,22,1997,11.0,20,16,13,6,1,11,15,73.3,4,10,4,6,9,29,37,1,0,2019-2020,90.0,73.63636363636364,163.63636363636365
2488,Cheick Timite,CIV,"MF,FW",Amiens,Ligue 1,21,1997,1.3,1,0,0,1,0,0,1,0.0,1,0,0,0,2,3,1,0,0,2019-2020,90.0,138.46153846153845,69.23076923076923
2489,David Timor,ESP,"MF,DF",Getafe,La Liga,29,1989,10.5,9,6,4,5,0,5,16,31.3,11,8,3,5,18,27,23,0,0,2019-2020,90.0,154.28571428571428,77.14285714285714
2490,Marcel Tisserand,COD,DF,Wolfsburg,Bundesliga,26,1993,13.4,21,10,14,5,2,7,12,58.3,5,13,4,9,32,53,49,2,0,2019-2020,90.0,214.92537313432834,141.04477611940297
2491,Jean-Clair Todibo,FRA,DF,Barcelona,La Liga,19,1999,0.9,1,0,1,0,0,0,1,0.0,1,0,0,0,0,1,6,0,0,2019-2020,90.0,0.0,100.0
2492,Jean-Clair Todibo,FRA,DF,Schalke 04,Bundesliga,19,1999,4.1,15,10,10,5,0,8,9,88.9,1,2,0,2,15,30,24,0,0,2019-2020,90.0,329.26829268292687,329.26829268292687
2493,Karl Toko Ekambi,CMR,FW,Villarreal,La Liga,26,1992,11.0,5,3,0,3,2,1,4,25.0,3,2,0,2,3,8,2,0,0,2019-2020,90.0,24.545454545454547,40.909090909090914
2494,Karl Toko Ekambi,CMR,"FW,MF",Lyon,Ligue 1,26,1992,6.0,5,2,0,1,4,3,5,60.0,2,2,0,2,5,10,1,0,0,2019-2020,90.0,75.0,75.0
2495,Corentin Tolisso,FRA,MF,Bayern Munich,Bundesliga,24,1994,7.1,9,4,4,3,2,1,9,11.1,8,9,3,6,4,13,2,1,0,2019-2020,90.0,50.70422535211268,114.08450704225353
2496,Jeremy Toljan,GER,DF,Sassuolo,Serie A,24,1994,24.3,37,21,24,10,3,18,35,51.4,17,23,12,11,18,55,58,1,0,2019-2020,90.0,66.66666666666666,137.03703703703704
2497,Rafael Tolói,ITA,DF,Atalanta,Serie A,28,1990,29.0,56,29,28,23,5,33,76,43.4,43,31,17,14,45,101,80,0,0,2019-2020,90.0,139.65517241379308,173.79310344827584
2498,Raúl de Tomás,ESP,FW,Espanyol,La Liga,24,1994,11.9,9,7,3,4,2,4,13,30.8,9,8,1,7,10,19,4,0,0,2019-2020,90.00000000000001,75.63025210084034,68.0672268907563
2499,Takehiro Tomiyasu,JPN,DF,Bologna,Serie A,20,1998,28.1,42,24,25,13,4,22,41,53.7,19,34,9,25,49,91,78,1,0,2019-2020,90.0,156.93950177935943,134.51957295373666
2500,James Tomkins,ENG,DF,Crystal Palace,Premier League,30,1989,17.6,29,17,21,8,0,18,25,72.0,7,17,15,2,21,50,103,0,0,2019-2020,90.0,107.38636363636363,148.29545454545453
Rk,Player,Nation,Pos,Squad,Comp,0,0,90.0,0,0,3,3,3,Tkl,0,0.0,0,0,0,0,0,0,0,0,0,2019-2020,90.0,0.0,0.0
2501,Fikayo Tomori,ENG,DF,Chelsea,Premier League,21,1997,14.3,29,16,21,8,0,10,15,66.7,5,13,7,6,22,51,48,2,0,2019-2020,90.0,138.46153846153845,182.51748251748253
2502,Nenad Tomović,SRB,DF,SPAL,Serie A,31,1987,19.5,26,19,18,6,2,10,21,47.6,11,32,23,9,30,56,65,1,0,2019-2020,90.0,138.46153846153845,120.0
2503,Sandro Tonali,ITA,MF,Brescia,Serie A,19,2000,33.5,39,25,16,20,3,16,55,29.1,39,36,14,22,41,80,42,0,0,2019-2020,90.0,110.14925373134328,104.77611940298507
2504,Lorenzo Tonelli,ITA,DF,Sampdoria,Serie A,29,1990,7.8,13,9,13,0,0,4,10,40.0,6,10,7,3,4,17,23,0,0,2019-2020,90.0,46.15384615384615,150.0
2505,Toño,ESP,DF,Levante,La Liga,29,1989,17.7,26,19,18,7,1,15,28,53.6,13,11,3,8,13,39,34,1,0,2019-2020,90.0,66.10169491525424,132.20338983050848
2506,Ömer Toprak,TUR,DF,Werder Bremen,Bundesliga,30,1989,7.9,7,2,4,2,1,3,6,50.0,3,6,4,2,12,19,41,0,0,2019-2020,90.0,136.70886075949366,79.74683544303797
2507,Ernesto Torregrossa,VEN,FW,Brescia,Serie A,27,1992,20.5,17,7,5,10,2,6,22,27.3,16,10,2,8,5,22,22,0,0,2019-2020,90.0,21.951219512195124,74.63414634146342
2508,Lucas Torreira,URU,MF,Arsenal,Premier League,23,1996,16.8,31,16,11,15,5,16,39,41.0,23,24,8,16,34,65,24,0,0,2019-2020,90.0,182.14285714285714,166.07142857142856
2509,Ferrán Torres,ESP,"MF,FW",Valencia,La Liga,19,2000,25.0,23,15,6,16,1,8,30,26.7,22,20,3,17,14,37,12,0,0,2019-2020,90.0,50.4,82.8
2510,Óliver Torres,ESP,"MF,FW",Sevilla,La Liga,24,1994,17.7,45,27,12,26,7,23,60,38.3,37,23,1,22,13,58,9,1,0,2019-2020,90.0,66.10169491525424,228.8135593220339
2511,Pau Torres,ESP,DF,Villarreal,La Liga,22,1997,33.0,34,21,24,10,0,16,24,66.7,8,39,23,16,27,61,153,1,0,2019-2020,90.0,73.63636363636364,92.72727272727273
2512,Roberto Torres,ESP,"MF,FW",Osasuna,La Liga,30,1989,30.2,33,16,12,18,3,21,49,42.9,28,41,2,39,31,64,37,0,0,2019-2020,90.0,92.3841059602649,98.34437086092716
2513,Lucas Torró,ESP,MF,Eint Frankfurt,Bundesliga,25,1994,3.7,12,7,6,6,0,8,16,50.0,8,2,1,1,8,20,3,0,0,2019-2020,90.0,194.59459459459458,291.8918918918919
2514,Jordan Torunarigha,GER,DF,Hertha BSC,Bundesliga,21,1997,16.2,32,19,21,11,0,18,27,66.7,9,33,18,15,31,63,75,0,0,2019-2020,90.0,172.22222222222223,177.77777777777777
2515,Cenk Tosun,TUR,FW,Crystal Palace,Premier League,28,1991,2.0,2,2,2,0,0,0,2,0.0,2,0,0,0,0,2,1,0,0,2019-2020,90.0,0.0,90.0
2516,Cenk Tosun,TUR,FW,Everton,Premier League,28,1991,3.2,2,0,0,0,2,0,1,0.0,1,1,0,1,0,2,1,0,0,2019-2020,90.0,0.0,56.25
2517,Abdoulaye Touré,GUI,MF,Nantes,Ligue 1,25,1994,24.7,32,21,10,21,1,10,30,33.3,20,31,11,20,29,61,18,1,0,2019-2020,90.0,105.66801619433198,116.59919028340082
2518,Almamy Touré,MLI,DF,Eint Frankfurt,Bundesliga,23,1996,16.6,32,19,18,11,3,11,22,50.0,11,18,7,11,23,55,54,1,0,2019-2020,90.0,124.69879518072288,173.49397590361443
2519,Lucas Tousart,FRA,MF,Lyon,Ligue 1,22,1997,19.6,58,32,19,34,5,17,56,30.4,39,19,7,12,31,89,27,1,0,2019-2020,90.0,142.34693877551018,266.3265306122449
2520,Andros Townsend,ENG,"FW,MF",Crystal Palace,Premier League,28,1991,14.4,34,21,12,17,5,15,37,40.5,22,18,0,18,15,49,10,1,0,2019-2020,90.0,93.75,212.5
2521,Aleksandar Trajkovski,MKD,"MF,FW",Mallorca,La Liga,26,1992,3.7,2,0,1,1,0,1,7,14.3,6,2,0,2,3,5,1,0,0,2019-2020,90.0,72.97297297297297,48.648648648648646
2522,Adama Traoré,ESP,"FW,DF",Wolves,Premier League,23,1996,28.9,33,21,6,14,13,8,23,34.8,15,19,3,16,13,46,14,2,0,2019-2020,90.00000000000001,40.48442906574395,102.7681660899654
2523,Adama Traoré,MLI,"FW,MF",Metz,Ligue 1,24,1995,11.2,3,1,1,2,0,3,12,25.0,9,7,2,5,3,6,5,0,0,2019-2020,90.0,24.107142857142858,24.107142857142858
2524,Adama Traoré,MLI,MF,Monaco,Ligue 1,24,1995,0.3,0,0,0,0,0,0,0,0.0,0,0,0,0,1,1,0,0,0,2019-2020,90.0,300.0,0.0
2525,Bertrand Traoré,BFA,"FW,MF",Lyon,Ligue 1,23,1995,13.9,27,14,8,12,7,8,19,42.1,11,17,2,15,21,48,16,0,0,2019-2020,90.0,135.97122302158274,174.8201438848921
Rk,Player,Nation,Pos,Squad,Comp,0,0,90.0,0,0,3,3,3,Tkl,0,0.0,0,0,0,0,0,0,0,0,0,2019-2020,90.0,0.0,0.0
2526,Charles Traore,MLI,DF,Nantes,Ligue 1,27,1992,19.3,48,35,27,19,2,36,61,59.0,25,21,4,17,39,87,64,0,0,2019-2020,90.0,181.86528497409324,223.83419689119168
2527,Hamari Traoré,MLI,DF,Rennes,Ligue 1,27,1992,26.8,55,26,34,18,3,32,64,50.0,32,22,5,17,48,103,59,1,0,2019-2020,90.0,161.19402985074626,184.7014925373134
2528,Ibrahima Traoré,GUI,"FW,MF",Gladbach,Bundesliga,31,1988,1.7,4,3,1,1,2,1,7,14.3,6,1,0,1,1,5,3,0,0,2019-2020,90.0,52.94117647058823,211.76470588235293
2529,Ismaël Traoré,CIV,DF,Angers,Ligue 1,32,1986,22.8,23,12,14,7,2,10,17,58.8,7,23,13,10,27,50,85,1,0,2019-2020,90.0,106.57894736842104,90.78947368421052
2530,Kevin Trapp,GER,GK,Eint Frankfurt,Bundesliga,29,1990,22.0,0,0,0,0,0,0,1,0.0,1,0,0,0,3,3,5,0,0,2019-2020,90.0,12.272727272727273,0.0
2531,Miguel Trauco,PER,DF,Saint-Étienne,Ligue 1,26,1992,16.4,32,20,16,12,4,19,44,43.2,25,8,1,7,23,55,25,0,0,2019-2020,90.0,126.21951219512196,175.609756097561
2532,Mark Travers,IRL,GK,Bournemouth,Premier League,20,1999,1.0,0,0,0,0,0,0,0,0.0,0,0,0,0,0,0,1,1,0,2019-2020,90.0,0.0,0.0
2533,Luca Tremolada,ITA,MF,Brescia,Serie A,27,1991,0.2,0,0,0,0,0,0,0,0.0,0,0,0,0,0,0,0,0,0,2019-2020,90.0,0.0,0.0
2534,Trézéguet,EGY,"FW,MF",Aston Villa,Premier League,24,1994,21.7,38,16,18,15,5,9,44,20.5,35,23,2,21,25,63,18,0,0,2019-2020,90.0,103.68663594470046,157.6036866359447
2535,Manu Trigueros,ESP,MF,Villarreal,La Liga,27,1991,17.2,34,21,10,17,7,12,45,26.7,33,23,12,11,4,38,21,0,0,2019-2020,90.0,20.930232558139537,177.90697674418607
2536,Christopher Trimmel,AUT,"DF,MF",Union Berlin,Bundesliga,32,1987,31.8,71,41,35,32,4,32,54,59.3,22,31,10,21,51,122,88,1,0,2019-2020,90.0,144.33962264150944,200.9433962264151
2537,Alessandro Tripaldelli,ITA,DF,Sassuolo,Serie A,20,1999,1.5,4,4,1,3,0,1,3,33.3,2,1,0,1,3,7,3,0,0,2019-2020,90.0,180.0,240.0
2538,Kieran Trippier,ENG,DF,Atlético Madrid,La Liga,28,1990,22.0,52,34,24,21,7,34,53,64.2,19,33,7,26,24,76,46,0,0,2019-2020,90.0,98.18181818181819,212.72727272727275
2539,William Troost-Ekong,NGA,DF,Udinese,Serie A,25,1993,28.6,37,19,25,12,0,10,18,55.6,8,41,29,12,31,68,135,2,0,2019-2020,90.0,97.55244755244756,116.43356643356644
2540,Leandro Trossard,BEL,"FW,MF",Brighton,Premier League,24,1994,22.3,22,17,7,12,3,6,38,15.8,32,16,1,15,9,31,8,0,0,2019-2020,90.0,36.322869955156946,88.78923766816143
2541,Tom Trybull,GER,MF,Norwich City,Premier League,26,1993,12.6,39,25,15,18,6,16,60,26.7,44,20,5,15,16,55,35,0,0,2019-2020,90.0,114.28571428571429,278.5714285714286
2542,Axel Tuanzebe,COD,DF,Manchester Utd,Premier League,21,1997,2.1,2,2,0,2,0,1,2,50.0,1,1,0,1,5,7,5,1,0,2019-2020,90.0,214.28571428571428,85.71428571428571
2543,Georgi Tunjov,EST,MF,SPAL,Serie A,18,2001,3.2,4,4,3,1,0,1,11,9.1,10,3,1,2,1,5,0,0,0,2019-2020,90.0,28.125,112.5
2544,Stefano Turati,ITA,GK,Sassuolo,Serie A,17,2001,2.0,0,0,0,0,0,0,0,0.0,0,0,0,0,0,0,1,0,0,2019-2020,90.0,0.0,0.0
2545,Gennaro Tutino,ITA,"FW,MF",Hellas Verona,Serie A,22,1996,2.5,0,0,0,0,0,0,0,0.0,0,0,0,0,2,2,1,0,0,2019-2020,90.0,72.0,0.0
2546,Matthieu Udol,FRA,DF,Metz,Ligue 1,23,1996,12.2,29,19,19,8,2,13,24,54.2,11,21,4,17,23,52,43,0,0,2019-2020,90.0,169.672131147541,213.93442622950823
2547,Hwang Ui-jo,KOR,"FW,MF",Bordeaux,Ligue 1,26,1992,18.1,9,7,2,5,2,4,20,20.0,16,7,0,7,5,14,5,0,0,2019-2020,90.0,24.86187845303867,44.75138121546961
2548,Anthony Ujah,NGA,"FW,MF",Union Berlin,Bundesliga,28,1990,10.5,8,6,4,2,2,1,6,16.7,5,0,0,0,3,11,10,0,0,2019-2020,90.0,25.714285714285715,68.57142857142857
2549,Samir Ujkani,KVX,GK,Torino,Serie A,31,1988,1.0,0,0,0,0,0,0,0,0.0,0,0,0,0,0,0,1,0,0,2019-2020,90.0,0.0,0.0
2550,Sven Ulreich,GER,GK,Bayern Munich,Bundesliga,30,1988,1.0,0,0,0,0,0,0,0,0.0,0,0,0,0,0,0,0,0,0,2019-2020,90.0,0.0,0.0
Rk,Player,Nation,Pos,Squad,Comp,0,0,90.0,0,0,3,3,3,Tkl,0,0.0,0,0,0,0,0,0,0,0,0,2019-2020,90.0,0.0,0.0
2551,Samuel Umtiti,FRA,DF,Barcelona,La Liga,25,1993,10.5,11,5,5,5,1,5,8,62.5,3,4,2,2,22,33,32,0,0,2019-2020,90.0,188.57142857142856,94.28571428571428
2552,Enes Ünal,TUR,FW,Valladolid,La Liga,22,1997,26.0,20,12,6,11,3,6,28,21.4,22,17,5,12,6,26,13,0,0,2019-2020,90.00000000000001,20.76923076923077,69.23076923076924
2553,Cengiz Ünder,TUR,FW,Roma,Serie A,22,1997,9.7,10,6,4,4,2,2,9,22.2,7,7,2,5,8,18,7,0,0,2019-2020,90.0,74.22680412371135,92.78350515463919
2554,Dayot Upamecano,FRA,DF,RB Leipzig,Bundesliga,20,1998,26.2,52,31,37,15,0,23,43,53.5,20,31,17,14,43,95,88,1,0,2019-2020,90.0,147.70992366412216,178.6259541984733
2555,Mark Uth,GER,"MF,FW",Köln,Bundesliga,27,1991,12.9,19,12,4,10,5,9,32,28.1,23,15,0,15,7,26,3,0,0,2019-2020,90.0,48.837209302325576,132.5581395348837
2556,Mark Uth,GER,"FW,MF",Schalke 04,Bundesliga,27,1991,3.9,3,2,1,1,1,0,3,0.0,3,4,0,4,1,4,0,0,0,2019-2020,90.0,23.076923076923077,69.23076923076923
2557,Tomáš Vaclík,CZE,GK,Sevilla,La Liga,30,1989,32.5,0,0,0,0,0,0,1,0.0,1,0,0,0,0,0,7,0,0,2019-2020,90.0,0.0,0.0
2558,Álvaro Vadillo,ESP,"FW,MF",Granada,La Liga,24,1994,13.5,16,11,6,8,2,9,16,56.3,7,12,0,12,7,23,2,0,0,2019-2020,90.0,46.66666666666667,106.66666666666667
2559,William Vainqueur,FRA,MF,Toulouse,Ligue 1,30,1988,19.1,68,36,30,32,6,22,60,36.7,38,21,5,16,29,97,23,0,0,2019-2020,90.0,136.64921465968587,320.41884816753924
2560,Mirko Valdifiori,ITA,MF,SPAL,Serie A,33,1986,15.6,31,15,14,17,0,16,33,48.5,17,8,3,5,4,35,25,0,0,2019-2020,90.0,23.076923076923077,178.84615384615384
2561,Pierrick Valdivia,FRA,MF,Nîmes,Ligue 1,31,1988,0.8,1,1,0,0,1,0,1,0.0,1,0,0,0,0,1,0,0,0,2019-2020,90.0,0.0,112.5
2562,Germán Valera,ESP,FW,Atlético Madrid,La Liga,17,2002,0.0,0,0,0,0,0,0,0,0.0,0,1,0,1,0,0,0,0,0,2019-2020,,,
2563,Antoine Valerio,FRA,MF,Nîmes,Ligue 1,19,1999,1.0,1,1,0,1,0,0,2,0.0,2,2,0,2,3,4,1,0,0,2019-2020,90.0,270.0,90.0
2564,Borja Valero,ESP,MF,Inter,Serie A,34,1985,10.3,18,7,9,3,6,6,24,25.0,18,12,3,9,8,26,9,0,0,2019-2020,90.0,69.90291262135922,157.28155339805826
2565,Yan Valery,TUN,DF,Southampton,Premier League,20,1999,8.7,20,7,9,7,4,11,19,57.9,8,9,1,8,13,33,32,2,0,2019-2020,90.0,134.48275862068965,206.89655172413794
2566,Martin Valjent,SVK,DF,Mallorca,La Liga,23,1995,35.4,25,17,14,10,1,13,25,52.0,12,39,27,12,37,62,146,1,0,2019-2020,90.0,94.0677966101695,63.55932203389831
2567,Jesús Vallejo,ESP,DF,Wolves,Premier League,22,1997,1.8,1,1,1,0,0,1,2,50.0,1,4,3,1,2,3,8,1,0,2019-2020,90.0,100.0,50.0
2568,Jesús Vallejo,ESP,DF,Granada,La Liga,22,1997,7.0,6,5,4,2,0,3,4,75.0,1,7,4,3,5,11,28,0,0,2019-2020,90.0,64.28571428571428,77.14285714285714
2569,Manu Vallejo,ESP,"MF,FW",Valencia,La Liga,22,1997,4.6,7,3,0,3,4,5,9,55.6,4,4,0,4,2,9,2,0,0,2019-2020,90.0,39.130434782608695,136.95652173913044
2570,Luca Valls,FRA,MF,Nîmes,Ligue 1,20,1998,0.1,1,0,1,0,0,1,1,100.0,0,1,0,1,0,1,0,0,0,2019-2020,90.0,0.0,900.0
2571,Theo Valls,FRA,MF,Nîmes,Ligue 1,23,1995,18.1,39,16,12,26,1,16,50,32.0,34,17,0,17,13,52,6,0,0,2019-2020,90.0,64.64088397790054,193.92265193370164
2572,Mattia Valoti,ITA,"MF,FW",SPAL,Serie A,25,1993,17.0,48,30,21,25,2,16,43,37.2,27,27,6,21,16,64,18,0,0,2019-2020,90.0,84.70588235294117,254.11764705882354
2573,Federico Valverde,URU,MF,Real Madrid,La Liga,21,1998,21.2,38,19,9,19,10,12,36,33.3,24,38,4,34,21,59,12,2,0,2019-2020,90.0,89.15094339622642,161.32075471698113
2574,Virgil van Dijk,NED,DF,Liverpool,Premier League,28,1991,38.0,23,12,18,5,0,6,13,46.2,7,20,15,5,40,63,166,2,0,2019-2020,90.0,94.73684210526316,54.473684210526315
2575,Raphaël Varane,FRA,DF,Real Madrid,La Liga,26,1993,31.4,30,17,15,14,1,12,23,52.2,11,32,16,16,31,61,124,0,0,2019-2020,90.0,88.85350318471339,85.98726114649682
Rk,Player,Nation,Pos,Squad,Comp,0,0,90.0,0,0,3,3,3,Tkl,0,0.0,0,0,0,0,0,0,0,0,0,2019-2020,90.0,0.0,0.0
2576,Jamie Vardy,ENG,FW,Leicester City,Premier League,32,1987,33.7,15,12,0,9,6,2,4,50.0,2,22,4,18,2,17,22,0,0,2019-2020,90.0,5.341246290801187,40.0593471810089
2577,Matías Vargas,ARG,"FW,MF",Espanyol,La Liga,22,1997,11.4,13,5,7,3,3,4,23,17.4,19,12,2,10,3,16,5,0,0,2019-2020,90.0,23.684210526315788,102.63157894736841
2578,Ruben Vargas,SUI,"FW,MF",Augsburg,Bundesliga,20,1998,28.1,32,16,18,7,7,8,36,22.2,28,26,1,25,26,58,35,0,0,2019-2020,90.0,83.27402135231317,102.49110320284697
2579,Thibaut Vargas,FRA,"DF,MF",Montpellier,Ligue 1,19,2000,1.7,3,1,3,0,0,2,5,40.0,3,1,1,0,0,3,3,0,0,2019-2020,90.0,0.0,158.8235294117647
2580,Sebastian Vasiliadis,GRE,MF,Paderborn 07,Bundesliga,21,1997,31.2,73,45,34,31,8,28,81,34.6,53,47,6,41,34,107,50,0,0,2019-2020,90.0,98.07692307692308,210.57692307692307
2581,Indiana Vassilev,USA,"FW,MF",Aston Villa,Premier League,18,2001,0.6,0,0,0,0,0,0,0,0.0,0,0,0,0,0,0,0,0,0,2019-2020,90.0,0.0,0.0
2582,Denis Vavro,SVK,DF,Lazio,Serie A,23,1996,3.6,3,3,2,1,0,1,3,33.3,2,8,6,2,5,8,10,0,0,2019-2020,90.0,125.0,75.0
2583,Franco Vázquez,ARG,"MF,FW",Sevilla,La Liga,30,1989,12.2,25,17,9,14,2,6,36,16.7,30,13,0,13,10,35,10,0,0,2019-2020,90.0,73.7704918032787,184.42622950819674
2584,Kevin Vázquez,ESP,DF,Celta Vigo,La Liga,26,1993,14.7,26,15,16,6,4,15,28,53.6,13,18,1,17,26,52,28,0,0,2019-2020,90.0,159.18367346938777,159.18367346938777
2585,Lucas Vázquez,ESP,"MF,FW",Real Madrid,La Liga,28,1991,9.4,23,17,10,13,0,11,26,42.3,15,10,0,10,10,33,8,1,0,2019-2020,90.0,95.74468085106382,220.2127659574468
2586,Matías Vecino,URU,MF,Inter,Serie A,27,1991,14.2,31,20,14,11,6,9,36,25.0,27,20,3,17,15,46,26,0,0,2019-2020,90.0,95.07042253521128,196.47887323943664
2587,Koke Vegas,ESP,GK,Levante,La Liga,23,1995,2.0,0,0,0,0,0,0,1,0.0,1,0,0,0,0,0,3,0,0,2019-2020,90.0,0.0,0.0
2588,Miloš Veljković,SRB,DF,Werder Bremen,Bundesliga,23,1995,22.8,55,33,36,18,1,33,53,62.3,20,25,11,14,26,81,92,1,0,2019-2020,90.0,102.63157894736841,217.1052631578947
2589,Miguel Veloso,POR,MF,Hellas Verona,Serie A,33,1986,31.2,52,29,20,28,4,18,60,30.0,42,36,12,24,32,84,46,1,0,2019-2020,90.0,92.3076923076923,150.0
2590,Unai Vencedor Paris,ESP,MF,Athletic Club,La Liga,18,2000,0.8,0,0,0,0,0,0,0,0.0,0,0,0,0,0,0,0,0,0,2019-2020,90.0,0.0,0.0
2591,Lorenzo Venuti,ITA,"DF,MF",Fiorentina,Serie A,24,1995,9.5,20,10,12,6,2,13,19,68.4,6,5,1,4,11,31,15,0,0,2019-2020,90.0,104.21052631578948,189.47368421052633
2592,Brayan Vera,COL,"DF,FW",Lecce,Serie A,20,1999,1.7,4,1,2,1,1,3,7,42.9,4,1,0,1,1,5,4,0,0,2019-2020,90.0,52.94117647058823,211.76470588235293
2593,Simone Verdi,ITA,"MF,FW",Torino,Serie A,27,1992,23.0,19,10,4,12,3,9,38,23.7,29,14,0,14,7,26,1,0,0,2019-2020,90.0,27.39130434782609,74.34782608695653
2594,Jordan Veretout,FRA,MF,Roma,Serie A,26,1993,29.2,36,18,13,16,7,14,43,32.6,29,35,5,30,18,54,31,1,0,2019-2020,90.0,55.47945205479452,110.95890410958904
2595,Marco Verratti,ITA,MF,Paris S-G,Ligue 1,26,1992,16.5,54,32,22,22,10,20,56,35.7,36,23,3,20,19,73,9,0,0,2019-2020,90.0,103.63636363636364,294.54545454545456
2596,Valerio Verre,ITA,"MF,FW",Hellas Verona,Serie A,25,1994,19.7,25,15,4,11,10,9,23,39.1,14,5,0,5,13,38,9,0,0,2019-2020,90.0,59.390862944162436,114.21319796954315
2597,Birger Verstraete,BEL,MF,Köln,Bundesliga,25,1994,7.4,20,11,9,10,1,11,21,52.4,10,8,1,7,4,24,10,1,0,2019-2020,90.0,48.648648648648646,243.24324324324323
2598,Jan Vertonghen,BEL,DF,Tottenham,Premier League,32,1987,18.3,40,24,25,14,1,20,31,64.5,11,18,10,8,33,73,68,0,0,2019-2020,90.0,162.29508196721312,196.72131147540983
2599,Mikel Vesga,ESP,MF,Athletic Club,La Liga,26,1993,14.1,25,17,7,12,6,9,45,20.0,36,18,7,11,31,56,24,1,0,2019-2020,89.99999999999999,197.87234042553192,159.57446808510636
2600,Jannik Vestergaard,DEN,DF,Southampton,Premier League,26,1992,16.6,19,12,14,5,0,11,28,39.3,17,15,9,6,26,45,99,2,0,2019-2020,90.0,140.96385542168673,103.01204819277108
Rk,Player,Nation,Pos,Squad,Comp,0,0,90.0,0,0,3,3,3,Tkl,0,0.0,0,0,0,0,0,0,0,0,0,2019-2020,90.0,0.0,0.0
2601,Rúben Vezo,POR,DF,Levante,La Liga,25,1994,29.0,41,24,28,13,0,19,35,54.3,16,37,29,8,42,83,144,2,0,2019-2020,90.0,130.3448275862069,127.24137931034483
2602,Francesco Vicari,ITA,DF,SPAL,Serie A,24,1994,32.2,27,13,20,6,1,12,25,48.0,13,48,37,11,38,65,145,1,0,2019-2020,90.0,106.21118012422359,75.46583850931677
2603,Fede Vico,ESP,"MF,FW",Granada,La Liga,25,1994,9.7,5,1,2,3,0,2,11,18.2,9,12,1,11,5,10,2,0,0,2019-2020,90.0,46.39175257731959,46.39175257731959
2604,Aleix Vidal,ESP,MF,Alavés,La Liga,29,1989,24.1,21,14,8,11,2,8,37,21.6,29,14,1,13,23,44,18,0,0,2019-2020,90.0,85.89211618257261,78.42323651452283
2605,Arturo Vidal,CHI,MF,Barcelona,La Liga,32,1987,18.6,63,38,22,30,11,24,58,41.4,34,31,7,24,17,80,16,1,0,2019-2020,90.0,82.25806451612902,304.83870967741933
2606,Clément Vidal,FRA,DF,Montpellier,Ligue 1,19,2000,1.0,0,0,0,0,0,0,2,0.0,2,1,1,0,0,0,6,0,0,2019-2020,90.0,0.0,0.0
2607,Nacho Vidal,ESP,DF,Osasuna,La Liga,24,1995,25.9,45,29,26,13,6,21,38,55.3,17,24,6,18,44,89,70,1,0,2019-2020,90.0,152.8957528957529,156.37065637065638
2608,Ronaldo Vieira,ENG,MF,Sampdoria,Serie A,21,1998,20.2,33,19,13,17,3,6,28,21.4,22,14,2,12,21,54,31,0,0,2019-2020,90.0,93.56435643564356,147.02970297029702
2609,Mauro Vigorito,ITA,GK,Lecce,Serie A,29,1990,4.7,0,0,0,0,0,0,0,0.0,0,0,0,0,0,0,3,1,0,2019-2020,90.0,0.0,0.0
2610,Dídac Vilà,ESP,DF,Espanyol,La Liga,30,1989,27.7,73,42,44,23,6,25,61,41.0,36,31,5,26,40,113,63,0,0,2019-2020,90.0,129.9638989169675,237.18411552346572
2611,Toni Villa,ESP,MF,Valladolid,La Liga,24,1995,15.0,31,16,13,14,4,13,50,26.0,37,16,1,15,8,39,11,0,0,2019-2020,90.0,48.0,186.0
2612,Asier Villalibre,ESP,FW,Athletic Club,La Liga,21,1997,5.9,0,0,0,0,0,0,3,0.0,3,3,0,3,1,1,4,0,0,2019-2020,90.0,15.254237288135592,0.0
2613,Gonzalo Villar,ESP,MF,Roma,Serie A,21,1998,3.3,5,3,4,0,1,2,4,50.0,2,2,0,2,2,7,3,0,0,2019-2020,90.0,54.54545454545455,136.36363636363637
2614,Iván Villar,ESP,GK,Celta Vigo,La Liga,22,1997,3.1,0,0,0,0,0,0,0,0.0,0,0,0,0,0,0,5,0,0,2019-2020,90.0,0.0,0.0
2615,Juan Villar,ESP,FW,Osasuna,La Liga,31,1988,2.7,1,0,0,1,0,0,2,0.0,2,4,1,3,1,2,0,0,0,2019-2020,90.0,33.33333333333333,33.33333333333333
2616,Rúben Vinagre,POR,"MF,DF",Wolves,Premier League,20,1999,7.2,23,13,15,6,2,12,15,80.0,3,7,2,5,11,34,22,0,0,2019-2020,90.0,137.5,287.5
2617,Luigi Vitale,ITA,DF,Hellas Verona,Serie A,31,1987,0.5,1,0,0,1,0,0,0,0.0,0,1,0,1,0,1,0,0,0,2019-2020,90.0,0.0,180.0
2618,Vitolo,ESP,"FW,MF",Atlético Madrid,La Liga,29,1989,13.6,15,12,7,7,1,5,17,29.4,12,9,0,9,10,25,9,0,0,2019-2020,90.0,66.17647058823529,99.26470588235294
2619,Mattia Viviani,ITA,MF,Brescia,Serie A,18,2000,3.8,3,1,0,3,0,1,8,12.5,7,3,3,0,9,12,2,1,0,2019-2020,90.0,213.1578947368421,71.05263157894737
2620,Dušan Vlahović,SRB,FW,Fiorentina,Serie A,19,2000,16.7,6,2,1,4,1,4,13,30.8,9,5,2,3,7,13,6,0,0,2019-2020,90.0,37.724550898203596,32.33532934131736
2621,Kevin Vogt,GER,DF,Hoffenheim,Bundesliga,27,1991,10.7,7,5,4,3,0,3,9,33.3,6,12,6,6,8,15,52,1,0,2019-2020,90.0,67.28971962616824,58.8785046728972
2622,Kevin Vogt,GER,"DF,MF",Werder Bremen,Bundesliga,27,1991,12.3,14,10,8,6,0,8,16,50.0,8,15,12,3,25,39,37,1,0,2019-2020,89.99999999999999,182.92682926829266,102.43902439024389
2623,Jake Vokins,ENG,DF,Southampton,Premier League,19,2000,1.0,2,2,0,0,2,1,1,100.0,0,0,0,0,0,2,1,0,0,2019-2020,90.0,0.0,180.0
2624,Kevin Volland,GER,FW,Leverkusen,Bundesliga,27,1992,22.7,16,6,5,6,5,5,16,31.3,11,14,2,12,5,21,7,0,0,2019-2020,89.99999999999999,19.823788546255507,63.43612334801762
2625,Mario Vrančić,BIH,MF,Norwich City,Premier League,30,1989,7.1,27,16,14,11,2,16,27,59.3,11,9,0,9,10,37,4,2,0,2019-2020,90.0,126.7605633802817,342.2535211267606
Rk,Player,Nation,Pos,Squad,Comp,0,0,90.0,0,0,3,3,3,Tkl,0,0.0,0,0,0,0,0,0,0,0,0,2019-2020,90.0,0.0,0.0
2626,Stefan de Vrij,NED,DF,Inter,Serie A,27,1992,31.4,33,18,20,12,1,14,27,51.9,13,34,24,10,52,85,121,1,0,2019-2020,90.0,149.04458598726117,94.5859872611465
2627,Giacomo Vrioni,ALB,FW,Juventus,Serie A,20,1998,0.1,0,0,0,0,0,0,0,0.0,0,0,0,0,0,0,0,0,0,2019-2020,90.0,0.0,0.0
2628,Šime Vrsaljko,CRO,DF,Atlético Madrid,La Liga,27,1992,4.0,6,5,6,0,0,5,6,83.3,1,5,3,2,8,14,11,0,0,2019-2020,90.0,180.0,135.0
2629,Nikola Vukčević,MNE,MF,Levante,La Liga,27,1991,17.4,41,26,17,17,7,15,40,37.5,25,19,7,12,12,53,16,0,0,2019-2020,90.0,62.06896551724138,212.0689655172414
2630,Matěj Vydra,CZE,FW,Burnley,Premier League,27,1992,9.1,4,3,0,3,1,3,6,50.0,3,7,3,4,1,5,6,0,0,2019-2020,90.0,9.89010989010989,39.56043956043956
2631,Molla Wagué,MLI,DF,Nantes,Ligue 1,28,1991,7.6,15,12,11,4,0,7,7,100.0,0,10,8,2,15,30,42,0,0,2019-2020,90.0,177.6315789473684,177.6315789473684
2632,Moussa Wagué,SEN,DF,Barcelona,La Liga,20,1998,1.0,2,1,1,0,1,1,1,100.0,0,0,0,0,1,3,0,0,0,2019-2020,90.0,90.0,180.0
2633,Moussa Wagué,SEN,"DF,MF",Nice,Ligue 1,20,1998,2.2,6,4,3,3,0,2,3,66.7,1,2,1,1,2,8,2,0,0,2019-2020,90.0,81.81818181818181,245.45454545454544
2634,Wakaso,GHA,MF,Alavés,La Liga,29,1990,14.3,54,31,25,24,5,16,33,48.5,17,23,5,18,17,71,17,1,0,2019-2020,90.0,106.993006993007,339.8601398601399
2635,Walace,BRA,MF,Udinese,Serie A,24,1995,12.7,28,9,19,6,3,13,42,31.0,29,14,6,8,33,61,19,0,0,2019-2020,90.0,233.85826771653544,198.42519685039372
2636,Theo Walcott,ENG,"MF,FW",Everton,Premier League,30,1989,14.3,13,8,6,5,2,3,15,20.0,12,13,0,13,8,21,1,0,0,2019-2020,90.0,50.349650349650354,81.81818181818183
2637,Luca Waldschmidt,GER,"FW,MF",Freiburg,Bundesliga,23,1996,14.1,10,7,3,5,2,2,18,11.1,16,11,2,9,4,14,4,0,0,2019-2020,89.99999999999999,25.53191489361702,63.82978723404255
2638,Kyle Walker,ENG,DF,Manchester City,Premier League,29,1990,26.6,28,18,12,15,1,12,29,41.4,17,15,6,9,28,56,42,1,0,2019-2020,90.0,94.73684210526315,94.73684210526315
2639,Kyle Walker-Peters,ENG,DF,Southampton,Premier League,22,1997,7.8,13,8,5,6,2,6,16,37.5,10,10,3,7,14,27,21,1,0,2019-2020,90.0,161.53846153846152,150.0
2640,Kyle Walker-Peters,ENG,DF,Tottenham,Premier League,22,1997,2.7,8,5,8,0,0,5,9,55.6,4,4,2,2,3,11,5,1,0,2019-2020,90.0,99.99999999999999,266.66666666666663
2641,Rémi Walter,FRA,MF,Nice,Ligue 1,24,1995,0.6,1,1,0,1,0,1,1,100.0,0,0,0,0,0,1,0,0,0,2019-2020,90.0,0.0,150.0
2642,Sebastian Walukiewicz,POL,DF,Cagliari,Serie A,19,2000,12.9,25,11,17,8,0,14,22,63.6,8,21,14,7,14,39,41,0,0,2019-2020,90.0,97.67441860465115,174.41860465116278
2643,Aaron Wan-Bissaka,ENG,DF,Manchester Utd,Premier League,21,1997,34.1,129,80,71,50,8,64,86,74.4,22,46,13,33,66,195,83,0,0,2019-2020,90.0,174.19354838709677,340.4692082111437
2644,Victor Wanyama,KEN,MF,Tottenham,Premier League,28,1991,0.3,0,0,0,0,0,0,0,0.0,0,0,0,0,0,0,0,0,0,2019-2020,90.0,0.0,0.0
2645,Joel Ward,ENG,DF,Crystal Palace,Premier League,29,1989,26.5,69,42,48,16,5,39,56,69.6,17,13,6,7,48,117,93,1,0,2019-2020,90.0,163.0188679245283,234.33962264150944
2646,James Ward-Prowse,ENG,"MF,DF",Southampton,Premier League,24,1994,38.0,92,48,39,39,14,39,94,41.5,55,48,14,34,60,152,75,1,0,2019-2020,90.0,142.10526315789474,217.89473684210526
2647,Daniel Wass,DEN,"DF,MF",Valencia,La Liga,30,1989,30.4,44,25,25,13,6,25,57,43.9,32,22,5,17,31,75,91,1,0,2019-2020,90.0,91.77631578947368,130.26315789473685
2648,Kelland Watts,ENG,DF,Newcastle Utd,Premier League,19,1999,0.2,1,0,1,0,0,1,1,100.0,0,0,0,0,0,1,0,0,0,2019-2020,90.0,0.0,450.0
2649,Timothy Weah,USA,"MF,FW",Lille,Ligue 1,19,2000,0.9,0,0,0,0,0,0,1,0.0,1,0,0,0,0,0,1,0,0,2019-2020,90.0,0.0,0.0
2650,Adam Webster,ENG,DF,Brighton,Premier League,24,1995,29.6,30,17,21,8,1,14,32,43.8,18,43,26,17,45,75,110,2,0,2019-2020,90.0,136.82432432432432,91.21621621621621
Rk,Player,Nation,Pos,Squad,Comp,0,0,90.0,0,0,3,3,3,Tkl,0,0.0,0,0,0,0,0,0,0,0,0,2019-2020,90.0,0.0,0.0
2651,Wout Weghorst,NED,FW,Wolfsburg,Bundesliga,26,1992,30.4,15,8,4,5,6,1,17,5.9,16,17,4,13,2,17,30,0,0,2019-2020,90.0,5.921052631578947,44.4078947368421
2652,Julian Weigl,GER,"MF,DF",Dortmund,Bundesliga,23,1995,11.3,16,9,12,3,1,9,16,56.3,7,10,0,10,8,24,21,0,0,2019-2020,90.0,63.716814159292035,127.43362831858407
2653,Mitchell Weiser,GER,"DF,MF",Leverkusen,Bundesliga,25,1994,13.0,41,29,20,17,4,18,30,60.0,12,19,2,17,24,65,22,1,0,2019-2020,90.00000000000001,166.15384615384616,283.84615384615387
2654,Danny Welbeck,ENG,"FW,MF",Watford,Premier League,28,1990,9.1,14,6,6,5,3,3,11,27.3,8,12,1,11,5,19,7,0,0,2019-2020,90.0,49.45054945054945,138.46153846153845
2655,Wendell,BRA,"DF,MF",Leverkusen,Bundesliga,26,1993,21.1,64,42,26,26,12,41,66,62.1,25,30,4,26,36,100,36,0,0,2019-2020,90.0,153.55450236966823,272.98578199052133
2656,Oscar Wendt,SWE,DF,Gladbach,Bundesliga,33,1985,18.7,26,14,16,8,2,12,31,38.7,19,27,6,21,20,46,45,0,0,2019-2020,90.0,96.2566844919786,125.13368983957218
2657,Timo Werner,GER,FW,RB Leipzig,Bundesliga,23,1996,31.1,20,9,6,7,7,3,16,18.8,13,16,0,16,5,25,2,0,0,2019-2020,90.0,14.469453376205788,57.87781350482315
2658,Ashley Westwood,ENG,MF,Burnley,Premier League,29,1990,35.0,54,33,15,32,7,17,48,35.4,31,23,11,12,32,86,32,3,0,2019-2020,90.0,82.28571428571428,138.85714285714286
2659,Connor Wickham,ENG,"FW,MF",Crystal Palace,Premier League,26,1993,1.1,1,1,1,0,0,0,0,0.0,0,1,0,1,1,2,0,0,0,2019-2020,90.0,81.81818181818181,81.81818181818181
2660,Felix Wiedwald,GER,GK,Eint Frankfurt,Bundesliga,29,1990,3.0,0,0,0,0,0,0,0,0.0,0,0,0,0,0,0,2,1,0,2019-2020,90.0,0.0,0.0
2661,Georginio Wijnaldum,NED,MF,Liverpool,Premier League,28,1990,32.6,38,20,12,21,5,10,40,25.0,30,18,4,14,17,55,34,3,0,2019-2020,90.0,46.93251533742331,104.9079754601227
2662,Jetro Willems,NED,DF,Newcastle Utd,Premier League,25,1994,16.6,37,19,29,6,2,18,39,46.2,21,20,5,15,17,54,42,1,0,2019-2020,90.0,92.16867469879517,200.6024096385542
2663,William,BRA,DF,Wolfsburg,Bundesliga,24,1995,15.2,55,26,34,14,7,27,59,45.8,32,10,3,7,24,79,38,1,0,2019-2020,90.0,142.10526315789474,325.6578947368421
2664,Brandon Williams,ENG,DF,Manchester Utd,Premier League,18,2000,11.2,21,15,11,6,4,9,29,31.0,20,9,4,5,16,37,27,0,0,2019-2020,90.0,128.57142857142858,168.75
2665,Iñaki Williams,GHA,FW,Athletic Club,La Liga,25,1994,32.7,15,5,0,7,8,5,18,27.8,13,18,2,16,5,20,29,0,0,2019-2020,90.0,13.761467889908257,41.28440366972477
2666,Neco Williams,WAL,DF,Liverpool,Premier League,18,2001,2.6,5,3,1,3,1,4,5,80.0,1,3,1,2,9,14,6,0,0,2019-2020,90.0,311.5384615384615,173.07692307692307
2667,Willian,BRA,"FW,MF",Chelsea,Premier League,30,1988,28.9,45,27,14,24,7,14,43,32.6,29,15,0,15,20,65,7,0,0,2019-2020,90.00000000000001,62.28373702422146,140.13840830449828
2668,Joe Willock,ENG,"MF,FW",Arsenal,Premier League,19,1999,9.5,25,16,9,12,4,8,21,38.1,13,16,2,14,4,29,11,2,0,2019-2020,90.0,37.89473684210526,236.8421052631579
2669,Jack Wilshere,ENG,MF,West Ham,Premier League,27,1992,2.4,1,0,1,0,0,0,4,0.0,4,3,0,3,1,2,0,0,0,2019-2020,90.0,37.5,37.5
2670,Callum Wilson,ENG,FW,Bournemouth,Premier League,27,1992,32.3,12,9,3,6,3,2,17,11.8,15,16,2,14,4,16,16,0,0,2019-2020,90.0,11.145510835913313,33.43653250773994
2671,Harry Wilson,WAL,"MF,FW",Bournemouth,Premier League,22,1997,18.3,23,13,8,10,5,11,34,32.4,23,26,2,24,11,34,15,1,0,2019-2020,90.0,54.0983606557377,113.11475409836065
2672,Harry Winks,ENG,MF,Tottenham,Premier League,23,1996,24.7,40,24,18,20,2,17,54,31.5,37,27,8,19,36,76,32,1,0,2019-2020,90.0,131.1740890688259,145.74898785425103
2673,Florian Wirtz,GER,FW,Leverkusen,Bundesliga,16,2003,4.1,4,2,0,4,0,2,4,50.0,2,4,0,4,2,6,1,0,0,2019-2020,90.0,43.90243902439025,87.8048780487805
2674,Axel Witsel,BEL,MF,Dortmund,Bundesliga,30,1989,24.9,28,20,10,17,1,14,33,42.4,19,26,7,19,31,59,19,1,0,2019-2020,90.0,112.04819277108433,101.20481927710843
2675,Hannes Wolf,AUT,"FW,MF",RB Leipzig,Bundesliga,20,1999,0.6,3,0,0,1,2,1,4,25.0,3,0,0,0,0,3,0,0,0,2019-2020,90.0,0.0,450.00000000000006
Rk,Player,Nation,Pos,Squad,Comp,0,0,90.0,0,0,3,3,3,Tkl,0,0.0,0,0,0,0,0,0,0,0,0,2019-2020,90.0,0.0,0.0
2676,Marius Wolf,GER,"FW,MF",Hertha BSC,Bundesliga,24,1995,15.7,19,11,9,7,3,10,27,37.0,17,14,1,13,17,36,13,0,0,2019-2020,90.0,97.45222929936307,108.9171974522293
2677,Nick Woltemade,GER,"FW,MF",Werder Bremen,Bundesliga,17,2002,1.0,2,1,0,2,0,0,1,0.0,1,1,0,1,0,2,2,0,0,2019-2020,90.0,0.0,180.0
2678,Chris Wood,NZL,FW,Burnley,Premier League,27,1991,27.1,7,4,2,4,1,5,15,33.3,10,15,2,13,4,11,18,0,0,2019-2020,90.0,13.284132841328413,23.247232472324722
2679,Xeka,POR,MF,Lille,Ligue 1,24,1994,7.9,18,10,3,13,2,9,29,31.0,20,11,1,10,4,22,7,1,0,2019-2020,90.0,45.56962025316455,205.06329113924048
2680,Granit Xhaka,SUI,MF,Arsenal,Premier League,26,1992,28.7,45,25,20,19,6,25,55,45.5,30,32,16,16,21,66,59,3,0,2019-2020,90.0,65.85365853658537,141.11498257839722
2681,Jawad El Yamiq,MAR,DF,Genoa,Serie A,27,1992,2.2,3,2,3,0,0,1,4,25.0,3,3,2,1,1,4,3,0,0,2019-2020,90.0,40.90909090909091,122.72727272727272
2682,Andriy Yarmolenko,UKR,"MF,FW",West Ham,Premier League,29,1989,11.0,13,8,5,6,2,5,20,25.0,15,3,1,2,6,19,4,0,0,2019-2020,90.0,49.09090909090909,106.36363636363637
2683,Yusuf Yazıcı,TUR,"MF,FW",Lille,Ligue 1,22,1997,9.4,17,8,2,11,4,5,13,38.5,8,6,1,5,5,22,1,1,0,2019-2020,90.0,47.87234042553191,162.7659574468085
2684,DeAndre Yedlin,USA,DF,Newcastle Utd,Premier League,26,1993,10.4,18,13,10,6,2,8,16,50.0,8,13,7,6,10,28,20,0,0,2019-2020,90.0,86.53846153846153,155.76923076923075
2685,Yoel,ESP,GK,Eibar,La Liga,30,1988,3.0,0,0,0,0,0,0,0,0.0,0,0,0,0,1,1,1,0,0,2019-2020,90.0,30.0,0.0
2686,Okay Yokuşlu,TUR,MF,Celta Vigo,La Liga,25,1994,21.9,41,27,18,21,2,20,42,47.6,22,12,5,7,28,69,71,1,0,2019-2020,90.0,115.06849315068494,168.49315068493152
2687,Maya Yoshida,JPN,DF,Southampton,Premier League,30,1988,6.2,8,5,4,1,3,3,7,42.9,4,6,2,4,4,12,27,1,0,2019-2020,90.0,58.064516129032256,116.12903225806451
2688,Maya Yoshida,JPN,DF,Sampdoria,Serie A,30,1988,13.2,4,3,2,2,0,2,6,33.3,4,15,12,3,27,31,72,0,0,2019-2020,90.0,184.0909090909091,27.272727272727273
2689,Elie Youan,FRA,"FW,MF",Nantes,Ligue 1,20,1999,1.8,0,0,0,0,0,0,7,0.0,7,2,0,2,0,0,3,0,0,2019-2020,90.0,0.0,0.0
2690,Amin Younes,GER,"FW,MF",Napoli,Serie A,25,1993,2.0,3,2,1,2,0,2,4,50.0,2,2,0,2,0,3,1,0,0,2019-2020,90.0,0.0,135.0
2691,Ashley Young,ENG,DF,Manchester Utd,Premier League,34,1985,10.6,14,7,7,4,3,5,17,29.4,12,8,2,6,11,25,29,0,0,2019-2020,90.0,93.39622641509435,118.8679245283019
2692,Ashley Young,ENG,DF,Inter,Serie A,34,1985,13.2,11,5,3,5,3,6,19,31.6,13,11,3,8,14,25,24,0,0,2019-2020,90.0,95.45454545454545,75.0
2693,Zaydou Youssouf,FRA,MF,Saint-Étienne,Ligue 1,20,1999,12.0,40,22,12,26,2,15,35,42.9,20,7,1,6,16,56,13,0,0,2019-2020,90.0,120.0,300.0
2694,Pablo Zabaleta,ARG,DF,West Ham,Premier League,34,1985,6.6,18,10,12,5,1,6,13,46.2,7,5,3,2,14,32,21,0,0,2019-2020,90.0,190.9090909090909,245.45454545454547
2695,Mattia Zaccagni,ITA,"MF,FW",Hellas Verona,Serie A,24,1995,23.5,20,11,10,5,5,3,15,20.0,12,14,3,11,20,40,21,0,0,2019-2020,90.0,76.59574468085106,76.59574468085106
2696,Dan-Axel Zagadou,FRA,DF,Dortmund,Bundesliga,20,1999,10.9,16,10,12,4,0,6,8,75.0,2,12,8,4,15,31,38,0,0,2019-2020,90.0,123.8532110091743,132.11009174311926
2697,Arthur Zagre,FRA,MF,Paris S-G,Ligue 1,17,2001,0.3,1,0,1,0,0,0,0,0.0,0,1,0,1,1,2,0,0,0,2019-2020,90.0,300.0,300.0
2698,Wilfried Zaha,CIV,"FW,MF",Crystal Palace,Premier League,26,1992,36.4,43,19,18,12,13,12,49,24.5,37,22,2,20,18,61,4,0,0,2019-2020,90.0,44.505494505494504,106.31868131868131
2699,Denis Zakaria,SUI,"MF,DF",Gladbach,Bundesliga,22,1996,21.6,49,30,23,23,3,20,39,51.3,19,39,12,27,37,86,31,1,0,2019-2020,90.0,154.16666666666666,204.16666666666666
2700,Joseba Zaldúa,ESP,DF,Real Sociedad,La Liga,27,1992,28.3,62,43,39,18,5,31,59,52.5,28,31,7,24,37,99,71,0,0,2019-2020,90.0,117.66784452296818,197.17314487632507
Rk,Player,Nation,Pos,Squad,Comp,0,0,90.0,0,0,3,3,3,Tkl,0,0.0,0,0,0,0,0,0,0,0,0,2019-2020,90.0,0.0,0.0
2701,Andre-Frank Zambo Anguissa,CMR,MF,Villarreal,La Liga,23,1995,28.7,76,49,29,40,7,26,78,33.3,52,42,6,36,44,120,30,0,0,2019-2020,90.0,137.97909407665506,238.3275261324042
2702,Luca Zanimacchia,ITA,"FW,MF",Juventus,Serie A,21,1998,1.3,5,1,1,2,2,1,2,50.0,1,1,0,1,0,5,0,0,0,2019-2020,90.0,0.0,346.15384615384613
2703,Nicolò Zaniolo,ITA,"FW,MF",Roma,Serie A,20,1999,16.7,15,11,4,7,4,3,24,12.5,21,14,0,14,5,20,5,0,0,2019-2020,90.0,26.94610778443114,80.83832335329342
2704,Cristián Zapata,COL,DF,Genoa,Serie A,32,1986,19.1,23,17,16,7,0,8,16,50.0,8,29,17,12,24,47,75,0,0,2019-2020,90.0,113.08900523560209,108.37696335078533
2705,Duván Zapata,COL,FW,Atalanta,Serie A,28,1991,22.5,7,3,1,2,4,1,6,16.7,5,18,7,11,2,9,11,0,0,2019-2020,90.0,8.0,28.0
2706,Davide Zappacosta,ITA,DF,Roma,Serie A,27,1992,5.0,7,3,2,3,2,4,8,50.0,4,3,1,2,6,13,8,1,0,2019-2020,90.0,108.0,126.0
2707,Simone Zaza,ITA,FW,Torino,Serie A,28,1991,18.2,15,10,6,4,5,3,10,30.0,7,11,0,11,9,24,13,1,0,2019-2020,90.0,44.505494505494504,74.17582417582418
2708,Marvin Zeegelaar,NED,DF,Udinese,Serie A,28,1990,6.6,15,9,8,4,3,6,11,54.5,5,9,2,7,5,20,10,0,0,2019-2020,90.0,68.18181818181819,204.54545454545453
2709,Mootaz Zemzemi,TUN,MF,Strasbourg,Ligue 1,19,1999,0.3,0,0,0,0,0,0,0,0.0,0,0,0,0,1,1,0,0,0,2019-2020,90.0,300.0,0.0
2710,Arber Zeneli,KVX,MF,Reims,Ligue 1,24,1995,0.1,0,0,0,0,0,0,0,0.0,0,0,0,0,0,0,0,0,0,2019-2020,90.0,0.0,0.0
2711,Robin Zentner,GER,GK,Mainz 05,Bundesliga,24,1994,21.5,1,1,1,0,0,1,1,100.0,0,0,0,0,0,1,11,0,0,2019-2020,90.0,0.0,4.186046511627906
2712,Piotr Zieliński,POL,MF,Napoli,Serie A,25,1994,32.5,26,16,10,11,5,12,30,40.0,18,28,5,23,21,47,15,0,0,2019-2020,90.0,58.15384615384615,72.0
2713,Jean Zimmer,GER,"DF,FW",Düsseldorf,Bundesliga,25,1993,8.0,11,6,5,5,1,5,10,50.0,5,3,1,2,3,14,0,0,0,2019-2020,90.0,33.75,123.75
2714,Christoph Zimmermann,GER,DF,Norwich City,Premier League,26,1993,15.9,32,21,26,6,0,21,30,70.0,9,22,18,4,19,51,87,2,0,2019-2020,90.0,107.54716981132076,181.1320754716981
2715,Matthias Zimmermann,GER,"DF,MF",Düsseldorf,Bundesliga,27,1992,32.5,62,47,26,27,9,31,64,48.4,33,41,15,26,43,105,59,0,0,2019-2020,90.0,119.07692307692308,171.6923076923077
2716,Oleksandr Zinchenko,UKR,DF,Manchester City,Premier League,22,1996,14.2,31,19,16,11,4,17,32,53.1,15,9,0,9,17,48,21,1,0,2019-2020,90.0,107.74647887323944,196.47887323943664
2717,Leopold Zingerle,GER,GK,Paderborn 07,Bundesliga,25,1994,28.0,3,1,3,0,0,2,4,50.0,2,0,0,0,0,3,7,2,0,2019-2020,90.0,0.0,9.642857142857142
2718,Joshua Zirkzee,NED,FW,Bayern Munich,Bundesliga,18,2001,3.3,5,2,0,2,3,2,4,50.0,2,2,0,2,1,6,0,0,0,2019-2020,90.0,27.272727272727273,136.36363636363637
2719,Richairo Živković,CUW,FW,Sheffield Utd,Premier League,22,1996,1.2,2,2,0,2,0,1,2,50.0,1,1,0,1,0,2,0,0,0,2019-2020,90.0,0.0,150.0
2720,Jaromír Zmrhal,CZE,MF,Brescia,Serie A,25,1993,12.5,10,4,2,5,3,5,18,27.8,13,8,1,7,4,14,11,0,0,2019-2020,90.0,28.799999999999997,72.0
2721,Kévin Zohi,MLI,"FW,MF",Strasbourg,Ligue 1,22,1996,5.9,8,6,3,3,2,3,6,50.0,3,1,0,1,4,12,2,0,0,2019-2020,90.0,61.01694915254237,122.03389830508473
2722,Ben Zolinski,GER,"FW,MF",Paderborn 07,Bundesliga,27,1992,13.4,17,9,7,9,1,7,27,25.9,20,12,0,12,8,25,4,0,0,2019-2020,90.0,53.731343283582085,114.17910447761193
2723,Kurt Zouma,FRA,DF,Chelsea,Premier League,24,1994,26.0,23,14,17,6,0,9,16,56.3,7,22,14,8,58,81,116,2,0,2019-2020,90.00000000000001,200.7692307692308,79.61538461538463
2724,Igor Zubeldia,ESP,"MF,DF",Real Sociedad,La Liga,22,1997,29.3,42,21,18,19,5,17,35,48.6,18,38,21,17,26,68,82,2,0,2019-2020,90.0,79.86348122866895,129.01023890784984
2725,Steven Zuber,SUI,"DF,FW",Hoffenheim,Bundesliga,27,1991,8.3,11,10,7,2,2,9,19,47.4,10,4,1,3,9,20,12,0,0,2019-2020,90.0,97.59036144578312,119.27710843373492
Rk,Player,Nation,Pos,Squad,Comp,0,0,90.0,0,0,3,3,3,Tkl,0,0.0,0,0,0,0,0,0,0,0,0,2019-2020,90.0,0.0,0.0
2726,Martín Zubimendi,ESP,MF,Real Sociedad,La Liga,20,1999,5.8,16,12,9,7,0,6,12,50.0,6,7,0,7,9,25,2,0,0,2019-2020,90.0,139.6551724137931,248.27586206896552
2727,Ervin Zukanović,BIH,DF,SPAL,Serie A,32,1987,2.3,1,0,0,0,1,1,1,100.0,0,3,1,2,3,4,15,0,0,2019-2020,90.0,117.3913043478261,39.130434782608695
2728,Bongani Zungu,RSA,MF,Amiens,Ligue 1,26,1992,11.0,27,11,10,13,4,18,31,58.1,13,8,2,6,16,43,21,0,0,2019-2020,90.0,130.9090909090909,220.9090909090909
2729,Szymon Żurkowski,POL,MF,Fiorentina,Serie A,21,1997,0.1,1,0,0,0,1,0,2,0.0,2,0,0,0,0,1,1,0,0,2019-2020,90.0,0.0,900.0
2730,David Zurutuza,ESP,MF,Real Sociedad,La Liga,33,1986,1.7,4,3,0,3,1,1,2,50.0,1,1,0,1,4,8,3,0,0,2019-2020,90.0,211.76470588235293,211.76470588235293
2731,Martin Ødegaard,NOR,MF,Real Sociedad,La Liga,20,1998,28.1,27,19,5,14,8,7,34,20.6,27,13,0,13,17,44,5,0,0,2019-2020,90.0,54.44839857651245,86.47686832740213
2732,Filip Đuričić,SRB,"MF,FW",Sassuolo,Serie A,27,1992,18.1,23,14,2,10,11,3,19,15.8,16,20,3,17,8,31,14,0,0,2019-2020,90.0,39.77900552486187,114.36464088397788
1,Ismael Aaneba,FRA,DF,Strasbourg,Ligue 1,21,1999,0.1,0,0,0,0,0,0,0,0.0,0,0,0,0,1,1,1,0,0,2020-2021,90.0,900.0,0.0
2,Patrick van Aanholt,NED,DF,Crystal Palace,Premier League,29,1990,19.7,35,22,18,17,0,19,43,44.2,24,18,6,12,30,65,40,2,0,2020-2021,90.0,137.05583756345177,159.89847715736042
3,Yunis Abdelhamid,MAR,DF,Reims,Ligue 1,32,1987,32.1,59,37,36,23,0,26,42,61.9,16,34,15,19,61,120,132,0,0,2020-2021,90.0,171.02803738317755,165.42056074766353
4,Sabit Abdulai,GHA,MF,Getafe,La Liga,21,1999,0.7,2,0,1,1,0,1,3,33.3,2,0,0,0,0,2,0,0,0,2020-2021,90.0,0.0,257.14285714285717
5,Mehdi Abeid,ALG,MF,Nantes,Ligue 1,27,1992,14.7,34,19,16,14,4,15,30,50.0,15,9,2,7,20,54,10,0,0,2020-2021,90.0,122.44897959183673,208.16326530612244
6,Laurent Abergel,FRA,MF,Lorient,Ligue 1,27,1993,32.9,145,84,64,69,12,54,162,33.3,108,64,6,58,46,191,12,0,0,2020-2021,90.0,125.83586626139818,396.65653495440733
7,Charles Abi,FRA,"FW,MF",Saint-Étienne,Ligue 1,20,2000,10.1,8,2,5,0,3,3,12,25.0,9,6,2,4,4,12,5,0,0,2020-2021,90.0,35.64356435643565,71.2871287128713
8,Matthis Abline,FRA,FW,Rennes,Ligue 1,17,2003,0.0,0,0,0,0,0,0,0,0.0,0,0,0,0,0,0,0,0,0,2020-2021,,,
9,Pape Abou Cissé,SEN,DF,Saint-Étienne,Ligue 1,24,1995,14.0,15,13,10,5,0,6,10,60.0,4,7,4,3,27,42,87,0,0,2020-2021,90.0,173.57142857142856,96.42857142857143
10,David Abraham,ARG,DF,Eint Frankfurt,Bundesliga,34,1986,13.6,18,12,13,3,2,11,17,64.7,6,13,4,9,17,35,34,0,0,2020-2021,90.0,112.5,119.11764705882352
11,Tammy Abraham,ENG,FW,Chelsea,Premier League,22,1997,11.6,7,5,3,3,1,1,7,14.3,6,6,0,6,5,12,17,0,0,2020-2021,90.0,38.793103448275865,54.310344827586206
12,Amir Abrashi,ALB,"MF,DF",Freiburg,Bundesliga,30,1990,0.7,1,1,1,0,0,0,0,0.0,0,1,1,0,2,3,1,0,0,2020-2021,90.0,257.14285714285717,128.57142857142858
13,Gennaro Acampora,ITA,"MF,FW",Spezia,Serie A,26,1994,4.9,6,4,1,4,1,2,7,28.6,5,4,1,3,4,10,4,0,0,2020-2021,90.0,73.46938775510203,110.20408163265306
14,Francesco Acerbi,ITA,DF,Lazio,Serie A,32,1988,31.3,51,32,34,13,4,18,40,45.0,22,24,15,9,76,127,121,2,0,2020-2021,90.0,218.53035143769966,146.64536741214056
15,Ragnar Ache,GER,"FW,DF",Eint Frankfurt,Bundesliga,22,1998,1.1,2,0,0,1,1,0,0,0.0,0,1,0,1,1,3,1,0,0,2020-2021,90.0,81.81818181818181,163.63636363636363
16,Marcos Acuña,ARG,DF,Sevilla,La Liga,28,1991,25.9,62,42,34,20,8,23,41,56.1,18,23,2,21,23,85,30,1,0,2020-2021,90.0,79.92277992277994,215.44401544401546
17,Che Adams,SCO,FW,Southampton,Premier League,24,1996,29.6,25,16,4,15,6,6,17,35.3,11,20,2,18,4,29,19,1,0,2020-2021,90.0,12.162162162162161,76.01351351351352
18,Tyler Adams,USA,"MF,DF",RB Leipzig,Bundesliga,21,1999,20.6,35,24,12,15,8,17,31,54.8,14,22,5,17,29,64,30,0,0,2020-2021,90.0,126.69902912621359,152.9126213592233
19,Sargis Adamyan,ARM,"FW,MF",Hoffenheim,Bundesliga,27,1993,5.3,9,4,4,3,2,7,14,50.0,7,2,0,2,6,15,1,0,0,2020-2021,90.0,101.88679245283019,152.83018867924528
20,Tosin Adarabioyo,ENG,DF,Fulham,Premier League,22,1997,32.8,37,19,30,6,1,19,40,47.5,21,26,20,6,42,79,197,2,0,2020-2021,90.0,115.24390243902441,101.52439024390245
21,Bobby Adekanye,NED,"FW,MF",Cádiz,La Liga,21,1999,0.4,0,0,0,0,0,0,1,0.0,1,0,0,0,0,0,1,0,0,2020-2021,90.0,0.0,0.0
22,Yacine Adli,FRA,MF,Bordeaux,Ligue 1,20,2000,26.9,74,37,30,33,11,35,92,38.0,57,27,2,25,39,113,17,2,0,2020-2021,90.0,130.48327137546468,247.5836431226766
23,Andrea Adorante,ITA,FW,Parma,Serie A,20,2000,0.1,0,0,0,0,0,0,0,0.0,0,0,0,0,0,0,0,0,0,2020-2021,90.0,0.0,0.0
24,Adrián,ESP,GK,Liverpool,Premier League,33,1987,3.0,0,0,0,0,0,0,0,0.0,0,0,0,0,0,0,3,1,0,2020-2021,90.0,0.0,0.0
25,Martin Agirregabiria,ESP,"DF,MF",Alavés,La Liga,24,1996,17.3,32,18,17,12,3,17,33,51.5,16,9,3,6,27,59,36,0,0,2020-2021,90.0,140.46242774566474,166.47398843930634
Rk,Player,Nation,Pos,Squad,Comp,0,0,90.0,0,0,3,3,3,Tkl,0,0.0,0,0,0,0,0,0,0,0,0,2020-2021,90.0,0.0,0.0
26,Lucien Agoume,FRA,MF,Spezia,Serie A,18,2002,8.9,18,10,11,7,0,6,19,31.6,13,10,5,5,15,33,10,0,0,2020-2021,90.0,151.68539325842696,182.02247191011236
27,Felix Agu,GER,DF,Werder Bremen,Bundesliga,20,1999,7.8,20,9,10,9,1,10,18,55.6,8,14,3,11,12,32,18,0,0,2020-2021,90.0,138.46153846153845,230.76923076923077
28,Kevin Agudelo,COL,FW,Spezia,Serie A,21,1998,15.1,39,28,9,15,15,12,34,35.3,22,30,0,30,10,49,2,0,0,2020-2021,90.0,59.60264900662252,232.45033112582783
29,Nayef Aguerd,MAR,DF,Rennes,Ligue 1,24,1996,35.0,37,30,28,9,0,21,33,63.6,12,34,22,12,47,84,102,0,0,2020-2021,90.0,120.85714285714286,95.14285714285714
30,Sergio Agüero,ARG,FW,Manchester City,Premier League,32,1988,6.2,4,1,0,2,2,2,11,18.2,9,2,0,2,2,6,0,0,0,2020-2021,90.0,29.032258064516128,58.064516129032256
31,Ruben Aguilar,FRA,"DF,MF",Monaco,Ligue 1,27,1993,24.7,63,37,32,21,10,32,52,61.5,20,30,3,27,47,110,43,1,0,2020-2021,90.0,171.25506072874495,229.55465587044534
32,Naouirou Ahamada,FRA,MF,Stuttgart,Bundesliga,18,2002,2.8,4,1,3,1,0,1,1,100.0,0,2,0,2,1,5,1,0,0,2020-2021,90.0,32.142857142857146,128.57142857142858
33,Matteo Ahlinvi,BEN,MF,Nîmes,Ligue 1,21,1999,10.0,26,20,10,14,2,11,39,28.2,28,6,0,6,2,28,8,0,0,2020-2021,90.0,18.0,234.0
34,Jean-Eudes Aholou,CIV,MF,Strasbourg,Ligue 1,26,1994,23.8,46,25,18,25,3,19,48,39.6,29,17,5,12,53,99,32,0,0,2020-2021,90.00000000000001,200.4201680672269,173.9495798319328
35,Jean-Eudes Aholou,CIV,MF,Monaco,Ligue 1,26,1994,0.4,1,0,0,1,0,1,3,33.3,2,0,0,0,1,2,1,0,0,2020-2021,90.0,225.0,225.0
36,Joseph Aidoo,GHA,DF,Celta Vigo,La Liga,24,1995,14.3,26,17,17,9,0,12,21,57.1,9,7,4,3,25,51,88,1,0,2020-2021,90.0,157.34265734265733,163.63636363636365
37,Ola Aina,NGA,DF,Fulham,Premier League,23,1996,29.6,37,20,22,7,8,21,43,48.8,22,22,6,16,45,82,94,2,0,2020-2021,90.0,136.82432432432432,112.5
38,Rayan Aït-Nouri,ALG,DF,Wolves,Premier League,19,2001,15.6,29,16,18,10,1,13,27,48.1,14,14,1,13,15,44,25,0,0,2020-2021,90.0,86.53846153846153,167.3076923076923
39,Rayan Aït-Nouri,ALG,DF,Angers,Ligue 1,19,2001,2.1,3,2,1,2,0,3,5,60.0,2,2,1,1,4,7,1,0,0,2020-2021,90.0,171.42857142857142,128.57142857142856
40,Semi Ajayi,NGA,DF,West Brom,Premier League,26,1993,30.9,40,14,34,6,0,23,41,56.1,18,51,32,19,42,82,122,2,0,2020-2021,90.0,122.33009708737865,116.50485436893204
41,Ludovic Ajorque,FRA,FW,Strasbourg,Ligue 1,26,1994,33.0,30,18,6,18,6,7,31,22.6,24,14,5,9,11,41,54,0,0,2020-2021,90.0,30.000000000000004,81.81818181818183
42,Manuel Akanji,SUI,DF,Dortmund,Bundesliga,25,1995,26.1,41,22,23,12,6,19,31,61.3,12,23,10,13,49,90,70,1,0,2020-2021,90.0,168.9655172413793,141.37931034482756
43,Carlos Akapo,EQG,DF,Cádiz,La Liga,27,1993,9.6,18,14,14,4,0,10,18,55.6,8,16,3,13,19,37,33,0,0,2020-2021,90.0,178.125,168.75
44,Marley Aké,FRA,FW,Marseille,Ligue 1,19,2001,1.6,3,3,1,0,2,0,1,0.0,1,2,0,2,0,3,1,0,0,2020-2021,90.0,0.0,168.75
45,Nathan Aké,NED,DF,Manchester City,Premier League,25,1995,8.9,10,5,3,6,1,3,4,75.0,1,2,1,1,9,19,23,0,0,2020-2021,90.0,91.01123595505618,101.12359550561798
46,Paul Akouokou,CIV,MF,Betis,La Liga,22,1997,4.2,11,8,2,8,1,5,8,62.5,3,3,1,2,6,17,7,0,0,2020-2021,90.0,128.57142857142856,235.7142857142857
47,Jean-Daniel Akpa-Akpro,CIV,MF,Lazio,Serie A,27,1992,11.7,38,25,13,22,3,8,27,29.6,19,24,6,18,18,56,13,0,0,2020-2021,89.99999999999999,138.46153846153845,292.3076923076923
48,Kevin Akpoguma,NGA,DF,Hoffenheim,Bundesliga,25,1995,13.2,18,12,11,6,1,8,14,57.1,6,28,15,13,13,31,32,2,0,2020-2021,90.0,88.63636363636364,122.72727272727273
49,David Alaba,AUT,"DF,MF",Bayern Munich,Bundesliga,28,1992,29.7,37,21,14,19,4,17,32,53.1,15,29,13,16,43,80,60,0,0,2020-2021,90.0,130.30303030303028,112.12121212121211
50,Sofiane Alakouch,MAR,DF,Nîmes,Ligue 1,22,1998,16.7,53,33,30,16,7,29,45,64.4,16,17,2,15,21,74,38,0,0,2020-2021,90.0,113.17365269461078,285.62874251497004
Rk,Player,Nation,Pos,Squad,Comp,0,0,90.0,0,0,3,3,3,Tkl,0,0.0,0,0,0,0,0,0,0,0,0,2020-2021,90.0,0.0,0.0
51,Jony Álamo,ESP,MF,Elche,La Liga,18,2001,0.8,2,1,1,0,1,0,1,0.0,1,0,0,0,1,3,0,0,0,2020-2021,90.0,112.5,225.0
52,Lucas Alario,ARG,FW,Leverkusen,Bundesliga,27,1992,13.8,8,2,2,5,1,2,4,50.0,2,9,1,8,2,10,10,0,0,2020-2021,90.0,13.043478260869565,52.17391304347826
53,Jordi Alba,ESP,"DF,FW",Barcelona,La Liga,31,1989,33.6,45,30,22,16,7,24,52,46.2,28,21,2,19,49,94,48,0,0,2020-2021,90.0,131.25,120.53571428571428
54,Luis Alberto,ESP,MF,Lazio,Serie A,27,1992,29.1,43,24,15,19,9,15,73,20.5,58,41,2,39,13,56,11,1,0,2020-2021,90.0,40.20618556701031,132.98969072164948
55,Raúl Albiol,ESP,DF,Villarreal,La Liga,34,1985,34.6,22,15,19,3,0,13,18,72.2,5,32,22,10,22,44,146,2,0,2020-2021,90.0,57.22543352601156,57.22543352601156
56,Marc Albrighton,ENG,"DF,FW",Leicester City,Premier League,30,1989,19.4,33,19,14,15,4,16,45,35.6,29,29,3,26,17,50,27,1,0,2020-2021,90.0,78.86597938144331,153.09278350515467
57,Paco Alcácer,ESP,FW,Villarreal,La Liga,26,1993,17.2,6,3,1,2,3,3,7,42.9,4,8,0,8,9,15,6,0,0,2020-2021,90.0,47.09302325581396,31.395348837209305
58,Pedro Alcalá,ESP,DF,Cádiz,La Liga,31,1989,10.1,8,4,6,2,0,3,5,60.0,2,19,13,6,16,24,50,0,0,2020-2021,90.0,142.5742574257426,71.2871287128713
59,Thiago Alcántara,ESP,MF,Liverpool,Premier League,29,1991,20.6,61,36,20,30,11,17,49,34.7,32,26,0,26,30,91,14,0,0,2020-2021,90.0,131.06796116504853,266.50485436893206
60,Rubén Alcaraz,ESP,MF,Valladolid,La Liga,29,1991,24.1,54,29,32,21,1,30,80,37.5,50,35,8,27,31,85,28,0,0,2020-2021,90.0,115.76763485477179,201.6597510373444
61,Omar Alderete,PAR,DF,Hertha BSC,Bundesliga,23,1996,14.4,16,10,11,5,0,7,16,43.8,9,14,10,4,21,37,61,1,0,2020-2021,90.0,131.25,100.0
62,Toby Alderweireld,BEL,DF,Tottenham,Premier League,31,1989,24.9,35,22,22,11,2,18,30,60.0,12,40,28,12,10,45,121,0,0,2020-2021,90.0,36.144578313253014,126.50602409638554
63,Iván Alejo,ESP,"MF,FW",Cádiz,La Liga,25,1995,9.2,14,10,8,4,2,4,23,17.4,19,14,1,13,3,17,10,0,0,2020-2021,90.0,29.347826086956523,136.95652173913044
64,Carles Aleñá,ESP,MF,Barcelona,La Liga,22,1998,0.5,1,0,1,0,0,0,0,0.0,0,0,0,0,0,1,0,0,0,2020-2021,90.0,0.0,180.0
65,Carles Aleñá,ESP,"MF,FW",Getafe,La Liga,22,1998,15.2,15,10,3,9,3,7,25,28.0,18,14,1,13,2,17,2,0,0,2020-2021,90.0,11.842105263157894,88.8157894736842
66,Rúnar Alex Rúnarsson,ISL,GK,Arsenal,Premier League,25,1995,0.2,0,0,0,0,0,0,0,0.0,0,0,0,0,0,0,0,0,0,2020-2021,90.0,0.0,0.0
67,Trent Alexander-Arnold,ENG,DF,Liverpool,Premier League,21,1998,33.7,56,33,31,18,7,36,56,64.3,20,24,3,21,49,105,50,3,0,2020-2021,90.0,130.86053412462908,149.55489614243322
68,Alfon,ESP,MF,Celta Vigo,La Liga,21,1999,0.4,0,0,0,0,0,0,0,0.0,0,0,0,0,0,0,0,0,0,2020-2021,90.0,0.0,0.0
69,Mohamed Ali Cho,FRA,"FW,MF",Angers,Ligue 1,16,2004,3.9,9,7,2,6,1,4,9,44.4,5,4,0,4,3,12,0,0,0,2020-2021,90.0,69.23076923076923,207.69230769230768
70,Ezgjan Alioski,MKD,"DF,MF",Leeds United,Premier League,28,1992,27.3,74,31,38,28,8,32,74,43.2,42,17,2,15,23,97,50,2,0,2020-2021,90.0,75.82417582417582,243.95604395604394
71,Rachid Alioui,MAR,FW,Angers,Ligue 1,28,1992,0.2,0,0,0,0,0,0,1,0.0,1,0,0,0,0,0,0,0,0,2020-2021,90.0,0.0,0.0
72,Alisson,BRA,GK,Liverpool,Premier League,27,1992,33.0,3,2,3,0,0,3,4,75.0,1,0,0,0,2,5,26,7,0,2020-2021,90.0,5.454545454545455,8.181818181818182
73,Saturnin Allagbé,BEN,GK,Dijon,Ligue 1,26,1993,12.0,0,0,0,0,0,0,1,0.0,1,0,0,0,0,0,9,3,0,2020-2021,90.0,0.0,0.0
74,Allan,BRA,MF,Everton,Premier League,29,1991,22.8,80,45,39,37,4,28,95,29.5,67,31,12,19,19,99,25,1,0,2020-2021,90.0,75.0,315.7894736842105
75,Dele Alli,ENG,MF,Tottenham,Premier League,24,1996,6.9,18,11,8,6,4,7,19,36.8,12,9,0,9,7,25,3,0,0,2020-2021,90.0,91.30434782608695,234.78260869565216
Rk,Player,Nation,Pos,Squad,Comp,0,0,90.0,0,0,3,3,3,Tkl,0,0.0,0,0,0,0,0,0,0,0,0,2020-2021,90.0,0.0,0.0
76,Miguel Almirón,PAR,"MF,FW",Newcastle Utd,Premier League,26,1994,27.0,49,29,21,25,3,14,56,25.0,42,23,4,19,25,74,20,1,0,2020-2021,90.0,83.33333333333334,163.33333333333334
77,Marcos Alonso,ESP,DF,Chelsea,Premier League,29,1990,10.7,13,3,6,4,3,7,14,50.0,7,12,1,11,12,25,30,0,0,2020-2021,90.0,100.93457943925235,109.34579439252337
78,Sergio Álvarez,ESP,"MF,DF",Eibar,La Liga,28,1992,17.4,42,25,13,26,3,8,22,36.4,14,22,5,17,22,64,24,2,0,2020-2021,90.0,113.79310344827586,217.24137931034483
79,Yeray Álvarez,ESP,DF,Athletic Club,La Liga,25,1995,21.6,19,12,11,8,0,9,21,42.9,12,12,5,7,53,72,73,0,0,2020-2021,90.0,220.83333333333331,79.16666666666666
80,Bruno Alves,POR,DF,Parma,Serie A,38,1981,18.1,13,10,10,3,0,7,9,77.8,2,17,12,5,26,39,81,0,0,2020-2021,90.0,129.2817679558011,64.64088397790054
81,Steven Alzate,COL,MF,Brighton,Premier League,21,1998,10.0,17,8,10,4,3,6,15,40.0,9,8,1,7,8,25,10,0,0,2020-2021,90.0,72.0,153.0
82,Ibrahim Amadou,FRA,MF,Angers,Ligue 1,27,1993,16.7,39,26,18,19,2,15,38,39.5,23,14,4,10,23,62,25,0,0,2020-2021,90.0,123.95209580838323,210.17964071856287
83,Romain Amalfitano,FRA,"FW,DF",Dijon,Ligue 1,30,1989,1.3,4,2,3,1,0,1,3,33.3,2,2,1,1,1,5,1,0,0,2020-2021,90.0,69.23076923076923,276.9230769230769
84,Emmanuel Amankwaa Akurugu,GHA,DF,Getafe,La Liga,18,2001,0.5,0,0,0,0,0,0,1,0.0,1,1,0,1,2,2,1,0,0,2020-2021,90.0,360.0,0.0
85,Daniel Amartey,GHA,DF,Leicester City,Premier League,25,1994,8.0,11,7,6,4,1,8,12,66.7,4,8,4,4,12,23,26,0,0,2020-2021,90.0,135.0,123.75
86,Jordan Amavi,FRA,DF,Marseille,Ligue 1,26,1994,9.0,11,9,9,1,1,9,12,75.0,3,12,2,10,27,38,33,1,0,2020-2021,90.0,270.0,110.0
87,Thierry Ambrose,GLP,FW,Metz,Ligue 1,23,1997,8.4,7,4,1,1,5,2,12,16.7,10,2,0,2,2,9,4,0,0,2020-2021,90.0,21.428571428571427,75.0
88,Wisdom Amey,ITA,DF,Bologna,Serie A,14,2005,0.0,0,0,0,0,0,0,0,0.0,0,0,0,0,0,0,0,0,0,2020-2021,,,
89,Nadiem Amiri,GER,MF,Leverkusen,Bundesliga,23,1996,21.0,12,7,4,8,0,7,33,21.2,26,18,3,15,12,24,7,0,0,2020-2021,90.0,51.42857142857143,51.42857142857143
90,Ethan Ampadu,WAL,"DF,MF",Sheffield Utd,Premier League,19,2000,23.2,57,36,31,24,2,20,46,43.5,26,40,19,21,49,106,87,3,0,2020-2021,90.0,190.08620689655172,221.1206896551724
91,Sofyan Amrabat,MAR,MF,Fiorentina,Serie A,23,1996,27.1,39,22,11,24,4,18,48,37.5,30,30,5,25,23,62,12,0,0,2020-2021,90.0,76.38376383763838,129.52029520295204
92,Jon Ander Garrido,ESP,MF,Cádiz,La Liga,30,1989,8.9,18,10,8,7,3,10,26,38.5,16,12,4,8,14,32,13,0,0,2020-2021,90.0,141.57303370786516,182.02247191011236
93,Joachim Andersen,DEN,DF,Fulham,Premier League,24,1996,30.3,33,19,18,11,4,15,28,53.6,13,24,13,11,44,77,151,1,0,2020-2021,90.0,130.69306930693068,98.01980198019803
94,Joachim Andersen,DEN,DF,Lyon,Ligue 1,24,1996,2.1,2,1,1,1,0,2,2,100.0,0,1,1,0,2,4,6,0,0,2020-2021,90.0,85.71428571428571,85.71428571428571
95,Djavan Anderson,NED,DF,Lazio,Serie A,25,1995,0.8,0,0,0,0,0,0,1,0.0,1,1,0,1,1,1,0,0,0,2020-2021,90.0,112.5,0.0
96,Elliot Anderson,SCO,MF,Newcastle Utd,Premier League,17,2002,0.0,0,0,0,0,0,0,0,0.0,0,0,0,0,0,0,0,0,0,2020-2021,,,
97,Felipe Anderson,BRA,"FW,MF",West Ham,Premier League,27,1993,0.0,1,1,0,1,0,0,0,0.0,0,0,0,0,0,1,0,0,0,2020-2021,,,inf
98,Sebastian Andersson,SWE,FW,Köln,Bundesliga,29,1991,12.5,3,2,0,3,0,1,8,12.5,7,10,3,7,2,5,9,0,0,2020-2021,90.0,14.399999999999999,21.599999999999998
99,Nícolas Andrade,BRA,GK,Udinese,Serie A,32,1988,2.0,0,0,0,0,0,0,0,0.0,0,0,0,0,0,0,0,0,0,2020-2021,90.0,0.0,0.0
100,Benjamin André,FRA,MF,Lille,Ligue 1,29,1990,32.1,114,68,47,61,6,53,122,43.4,69,39,10,29,76,190,49,0,0,2020-2021,90.0,213.0841121495327,319.626168224299
Rk,Player,Nation,Pos,Squad,Comp,0,0,90.0,0,0,3,3,3,Tkl,0,0.0,0,0,0,0,0,0,0,0,0,2020-2021,90.0,0.0,0.0
101,Marcos André,BRA,FW,Valladolid,La Liga,23,1996,13.1,8,2,2,2,4,0,8,0.0,8,15,2,13,2,10,9,0,0,2020-2021,90.0,13.740458015267176,54.961832061068705
102,Robert Andrich,GER,MF,Union Berlin,Bundesliga,25,1994,28.1,51,24,22,27,2,24,53,45.3,29,40,6,34,51,102,31,2,0,2020-2021,90.0,163.34519572953735,163.34519572953735
103,Victorien Angban,CIV,MF,Metz,Ligue 1,23,1996,18.6,36,24,17,15,4,17,42,40.5,25,17,4,13,19,55,9,1,0,2020-2021,90.0,91.93548387096773,174.19354838709674
104,Ángel,ESP,GK,Granada,La Liga,18,2002,1.0,0,0,0,0,0,0,0,0.0,0,0,0,0,0,0,1,0,0,2020-2021,90.0,0.0,0.0
105,José Ángel,ESP,DF,Eibar,La Liga,30,1989,10.0,15,8,9,4,2,8,12,66.7,4,7,0,7,13,28,17,1,0,2020-2021,90.0,117.0,135.0
106,Miguel Ángel Rubio,ESP,DF,Valladolid,La Liga,22,1998,1.5,0,0,0,0,0,0,0,0.0,0,2,2,0,3,3,11,0,0,2020-2021,90.0,180.0,0.0
107,Angeliño,ESP,"DF,FW",RB Leipzig,Bundesliga,23,1997,24.0,31,19,10,18,3,13,24,54.2,11,22,1,21,30,61,40,0,0,2020-2021,90.0,112.5,116.25
108,Davide Angelo Ghislandi,ITA,DF,Atalanta,Serie A,19,2001,0.1,0,0,0,0,0,0,0,0.0,0,0,0,0,0,0,1,0,0,2020-2021,90.0,0.0,0.0
109,Philip Ankhrah,GHA,MF,Hellas Verona,Serie A,17,2002,0.1,0,0,0,0,0,0,0,0.0,0,1,0,1,0,0,0,0,0,2020-2021,90.0,0.0,0.0
110,Cristian Ansaldi,ARG,"DF,FW",Torino,Serie A,33,1986,21.6,48,33,25,14,9,24,38,63.2,14,21,7,14,16,64,38,0,0,2020-2021,90.0,66.66666666666666,199.99999999999997
111,Waldemar Anton,GER,DF,Stuttgart,Bundesliga,24,1996,30.1,31,20,17,14,0,12,31,38.7,19,28,18,10,47,78,114,0,0,2020-2021,90.00000000000001,140.531561461794,92.69102990033223
112,Michail Antonio,JAM,FW,West Ham,Premier League,30,1990,21.9,7,4,1,5,1,1,7,14.3,6,20,3,17,7,14,7,0,0,2020-2021,90.0,28.767123287671236,28.767123287671236
113,José Antonio Miranda,EQG,"MF,DF",Getafe,La Liga,22,1998,0.3,0,0,0,0,0,0,1,0.0,1,1,0,1,0,0,0,0,0,2020-2021,90.0,0.0,0.0
114,Valentin Antov,BUL,DF,Bologna,Serie A,19,2000,2.6,4,2,3,1,0,3,10,30.0,7,6,5,1,4,8,13,0,0,2020-2021,90.0,138.46153846153845,138.46153846153845
115,Houssem Aouar,ALG,"MF,FW",Lyon,Ligue 1,22,1998,19.8,17,12,0,13,4,8,25,32.0,17,17,1,16,17,34,4,0,0,2020-2021,90.0,77.27272727272727,77.27272727272727
116,Adil Aouchiche,FRA,"MF,FW",Saint-Étienne,Ligue 1,18,2002,19.2,38,20,12,17,9,13,49,26.5,36,15,1,14,10,48,6,0,0,2020-2021,90.0,46.875,178.125
117,Dennis Appiah,FRA,DF,Nantes,Ligue 1,28,1992,17.3,55,34,33,15,7,32,59,54.2,27,23,6,17,25,80,43,0,0,2020-2021,90.0,130.05780346820808,286.1271676300578
118,Aritz Arambarri,ESP,DF,Real Sociedad,La Liga,22,1998,0.3,1,1,0,1,0,1,2,50.0,1,0,0,0,0,1,0,0,0,2020-2021,90.0,0.0,300.0
119,Mauro Arambarri,URU,MF,Getafe,La Liga,24,1995,33.1,64,39,22,35,7,23,80,28.8,57,40,5,35,42,106,28,0,0,2020-2021,90.0,114.19939577039274,174.0181268882175
120,Charles Aránguiz,CHI,MF,Leverkusen,Bundesliga,31,1989,18.5,41,23,16,21,4,17,43,39.5,26,32,4,28,33,74,17,0,0,2020-2021,90.0,160.54054054054055,199.45945945945948
121,Luiz Araújo,BRA,MF,Lille,Ligue 1,24,1996,16.6,38,25,12,18,8,8,28,28.6,20,23,1,22,11,49,3,0,0,2020-2021,90.0,59.63855421686746,206.02409638554215
122,Néstor Araujo,MEX,DF,Celta Vigo,La Liga,28,1991,27.0,24,16,14,9,1,7,15,46.7,8,23,18,5,43,67,89,2,0,2020-2021,90.0,143.33333333333334,80.0
123,Ronald Araújo,URU,DF,Barcelona,La Liga,21,1999,16.8,22,11,12,8,2,9,9,100.0,0,24,15,9,20,42,47,1,0,2020-2021,90.0,107.14285714285714,117.85714285714285
124,Anaitz Arbilla,ESP,DF,Eibar,La Liga,33,1987,31.2,45,26,31,11,3,27,54,50.0,27,36,11,25,69,114,73,1,0,2020-2021,90.0,199.03846153846152,129.8076923076923
125,Alphonse Areola,FRA,GK,Fulham,Premier League,27,1993,36.0,1,0,1,0,0,1,5,20.0,4,0,0,0,1,2,13,3,0,2020-2021,90.0,2.5,2.5
Rk,Player,Nation,Pos,Squad,Comp,0,0,90.0,0,0,3,3,3,Tkl,0,0.0,0,0,0,0,0,0,0,0,0,2020-2021,90.0,0.0,0.0
126,Santiago Arias,COL,DF,Leverkusen,Bundesliga,28,1992,1.0,2,1,0,1,1,1,1,100.0,0,0,0,0,1,3,4,0,0,2020-2021,90.0,90.0,180.0
127,Karim Aribi,ALG,FW,Nîmes,Ligue 1,26,1994,3.3,2,2,0,1,1,0,5,0.0,5,1,0,1,0,2,3,0,0,2020-2021,90.0,0.0,54.54545454545455
128,Unai Arietaleanizbeaskoa,ESP,"FW,MF",Eibar,La Liga,21,1999,0.5,1,0,0,0,1,0,0,0.0,0,0,0,0,0,1,0,0,0,2020-2021,90.0,0.0,180.0
129,Nicolò Armini,ITA,DF,Lazio,Serie A,19,2001,0.1,0,0,0,0,0,0,0,0.0,0,0,0,0,0,0,0,0,0,2020-2021,90.0,0.0,0.0
130,Stuart Armstrong,SCO,MF,Southampton,Premier League,28,1992,30.7,60,41,19,32,9,27,75,36.0,48,26,1,25,24,84,19,0,0,2020-2021,90.0,70.35830618892508,175.89576547231272
131,Maximilian Arnold,GER,MF,Wolfsburg,Bundesliga,26,1994,28.7,47,32,20,26,1,18,49,36.7,31,24,3,21,49,96,57,0,0,2020-2021,90.0,153.65853658536585,147.38675958188153
132,Tolu Arokodare,NGA,"FW,MF",Köln,Bundesliga,19,2000,1.2,1,1,0,0,1,0,0,0.0,0,1,0,1,1,2,0,0,0,2020-2021,90.0,75.0,75.0
133,Sergio Arribas,ESP,"MF,FW",Real Madrid,La Liga,18,2001,1.5,3,1,2,1,0,1,3,33.3,2,2,0,2,4,7,2,0,0,2020-2021,90.0,240.0,180.0
134,Kepa Arrizabalaga,ESP,GK,Chelsea,Premier League,25,1994,6.5,0,0,0,0,0,0,1,0.0,1,0,0,0,0,0,0,3,0,2020-2021,90.00000000000001,0.0,0.0
135,Tolgay Arslan,GER,MF,Udinese,Serie A,29,1990,20.2,52,32,24,24,4,25,54,46.3,29,22,2,20,22,74,15,1,0,2020-2021,90.0,98.01980198019803,231.68316831683168
136,Kwadwo Asamoah,GHA,"DF,MF",Cagliari,Serie A,31,1988,2.5,4,3,2,2,0,2,3,66.7,1,5,1,4,4,8,2,1,0,2020-2021,90.0,144.0,144.0
137,Santiago Ascacíbar,ARG,MF,Hertha BSC,Bundesliga,23,1997,8.5,30,15,15,14,1,15,28,53.6,13,23,2,21,13,43,14,0,0,2020-2021,90.0,137.64705882352942,317.6470588235294
138,Sergio Asenjo,ESP,GK,Villarreal,La Liga,31,1989,36.0,0,0,0,0,0,0,1,0.0,1,0,0,0,0,0,13,2,0,2020-2021,90.0,0.0,0.0
139,Marco Asensio,ESP,"FW,MF",Real Madrid,La Liga,24,1996,20.8,12,6,7,4,1,3,24,12.5,21,15,0,15,11,23,10,0,0,2020-2021,90.0,47.59615384615384,51.92307692307692
140,Kristoffer Askildsen,NOR,MF,Sampdoria,Serie A,19,2001,1.1,0,0,0,0,0,0,0,0.0,0,2,0,2,3,3,3,0,0,2020-2021,90.0,245.45454545454544,0.0
141,Iago Aspas,ESP,FW,Celta Vigo,La Liga,32,1987,31.8,11,3,2,7,2,2,23,8.7,21,25,2,23,16,27,21,0,0,2020-2021,90.0,45.283018867924525,31.132075471698112
142,Roger Assalé,CIV,"FW,MF",Dijon,Ligue 1,26,1993,9.2,10,8,3,5,2,4,12,33.3,8,7,3,4,2,12,2,0,0,2020-2021,90.0,19.565217391304348,97.82608695652175
143,Youcef Atal,ALG,"DF,FW",Nice,Ligue 1,24,1996,10.6,25,12,11,14,0,13,26,50.0,13,10,2,8,26,51,12,0,0,2020-2021,90.0,220.75471698113208,212.26415094339623
144,Miguel Atienza,ESP,MF,Eibar,La Liga,21,1999,9.3,20,9,5,15,0,8,23,34.8,15,14,1,13,9,29,12,0,0,2020-2021,90.0,87.09677419354837,193.54838709677418
145,Pierre-Emerick Aubameyang,GAB,FW,Arsenal,Premier League,31,1989,25.9,12,8,7,4,1,3,20,15.0,17,18,0,18,7,19,17,0,0,2020-2021,90.0,24.324324324324326,41.698841698841704
146,Emil Audero,ITA,GK,Sampdoria,Serie A,23,1997,37.0,1,1,1,0,0,1,2,50.0,1,0,0,0,1,2,16,0,0,2020-2021,90.0,2.4324324324324325,2.4324324324324325
147,Tommaso Augello,ITA,DF,Sampdoria,Serie A,25,1994,35.7,42,30,27,10,5,23,39,59.0,16,22,2,20,32,74,76,1,0,2020-2021,90.0,80.67226890756301,105.88235294117645
148,Jean-Kévin Augustin,FRA,FW,Nantes,Ligue 1,23,1997,0.4,2,0,0,2,0,2,2,100.0,0,0,0,0,0,2,0,0,0,2020-2021,90.0,0.0,450.0
149,Ludwig Augustinsson,SWE,"DF,FW",Werder Bremen,Bundesliga,26,1994,21.7,37,20,19,14,4,17,29,58.6,12,21,7,14,20,57,62,0,0,2020-2021,90.0,82.94930875576037,153.45622119815667
150,Serge Aurier,CIV,DF,Tottenham,Premier League,27,1992,17.8,55,33,33,17,5,15,40,37.5,25,28,5,23,19,74,44,3,0,2020-2021,90.0,96.06741573033707,278.08988764044943
Rk,Player,Nation,Pos,Squad,Comp,0,0,90.0,0,0,3,3,3,Tkl,0,0.0,0,0,0,0,0,0,0,0,0,2020-2021,90.0,0.0,0.0
151,Charlie Austin,ENG,"FW,MF",West Brom,Premier League,31,1989,1.5,4,2,1,2,1,1,3,33.3,2,0,0,0,3,7,4,0,0,2020-2021,90.0,180.0,240.0
152,Ezequiel Ávila,ARG,"FW,MF",Osasuna,La Liga,26,1994,2.2,6,2,3,1,2,2,4,50.0,2,1,0,1,1,7,0,0,0,2020-2021,90.0,40.90909090909091,245.45454545454544
153,Taiwo Awoniyi,NGA,FW,Union Berlin,Bundesliga,22,1997,15.1,5,3,2,3,0,1,14,7.1,13,9,0,9,3,8,4,0,0,2020-2021,90.0,17.880794701986755,29.80132450331126
154,Mehmet Aydin,GER,DF,Schalke 04,Bundesliga,18,2002,5.6,15,7,9,6,0,4,10,40.0,6,6,1,5,6,21,16,0,0,2020-2021,90.0,96.42857142857143,241.07142857142858
155,Jordan Ayew,GHA,"FW,MF",Crystal Palace,Premier League,28,1991,23.3,38,26,8,16,14,16,44,36.4,28,28,2,26,16,54,12,0,0,2020-2021,90.0,61.802575107296136,146.78111587982832
156,Kaan Ayhan,TUR,DF,Sassuolo,Serie A,25,1994,8.8,15,9,8,5,2,8,13,61.5,5,9,5,4,16,31,33,0,0,2020-2021,90.0,163.63636363636363,153.4090909090909
157,Luke Ayling,ENG,DF,Leeds United,Premier League,28,1991,37.8,108,61,69,30,9,49,87,56.3,38,53,36,17,36,144,96,5,0,2020-2021,90.0,85.71428571428572,257.14285714285717
158,Ramon Azeez,NGA,MF,Granada,La Liga,27,1992,1.1,1,1,0,1,0,0,0,0.0,0,0,0,0,1,2,1,0,0,2020-2021,90.0,81.81818181818181,81.81818181818181
159,César Azpilicueta,ESP,DF,Chelsea,Premier League,30,1989,24.3,53,28,22,24,7,19,37,51.4,18,30,5,25,28,81,62,2,0,2020-2021,90.0,103.7037037037037,196.29629629629628
160,Ludovic Baal,GUF,"DF,MF",Brest,Ligue 1,34,1986,3.3,6,5,4,1,1,2,5,40.0,3,4,1,3,5,11,5,0,0,2020-2021,90.0,136.36363636363637,163.63636363636363
161,Carlos Bacca,COL,FW,Villarreal,La Liga,33,1986,8.7,9,5,5,3,1,3,5,60.0,2,5,0,5,3,12,2,0,0,2020-2021,90.0,31.03448275862069,93.10344827586206
162,Loïc Bade,FRA,DF,Lens,Ligue 1,20,2000,29.0,57,34,47,10,0,30,55,54.5,25,43,17,26,74,131,135,2,0,2020-2021,90.0,229.65517241379308,176.8965517241379
163,Milan Badelj,CRO,MF,Genoa,Serie A,31,1989,26.8,56,27,27,22,7,26,84,31.0,58,51,10,41,87,143,45,1,0,2020-2021,90.0,292.16417910447757,188.0597014925373
164,Édgar Badía,ESP,GK,Elche,La Liga,28,1992,30.0,1,0,1,0,0,1,3,33.3,2,0,0,0,0,1,17,3,0,2020-2021,90.0,0.0,3.0
165,Benoît Badiashile,FRA,DF,Monaco,Ligue 1,19,2001,31.9,24,17,15,9,0,13,28,46.4,15,21,12,9,58,82,102,4,0,2020-2021,90.0,163.63636363636363,67.7115987460815
166,Alex Baena,ESP,MF,Villarreal,La Liga,19,2001,1.5,4,3,1,2,1,1,3,33.3,2,1,1,0,1,5,1,0,0,2020-2021,90.0,60.0,240.0
167,Miguel Baeza,ESP,"MF,FW",Celta Vigo,La Liga,20,2000,6.0,7,6,5,2,0,5,13,38.5,8,3,0,3,3,10,2,0,0,2020-2021,90.0,45.0,105.0
168,Stéphane Bahoken,CMR,FW,Angers,Ligue 1,28,1992,18.0,9,6,1,7,1,4,12,33.3,8,9,0,9,9,18,9,0,0,2020-2021,90.0,45.0,45.0
169,Leon Bailey,JAM,"FW,MF",Leverkusen,Bundesliga,22,1997,23.8,14,8,3,7,4,4,15,26.7,11,13,0,13,9,23,3,0,0,2020-2021,90.00000000000001,34.03361344537815,52.94117647058824
170,Eric Bailly,CIV,DF,Manchester Utd,Premier League,26,1994,10.2,5,5,3,1,1,0,1,0.0,1,13,11,2,13,18,36,2,0,2020-2021,90.0,114.70588235294119,44.11764705882353
171,Stefan Bajic,FRA,GK,Saint-Étienne,Ligue 1,18,2001,1.0,0,0,0,0,0,0,0,0.0,0,0,0,0,0,0,1,0,0,2020-2021,90.0,0.0,0.0
172,Tiemoué Bakayoko,FRA,MF,Napoli,Serie A,25,1994,21.8,69,41,21,41,7,23,40,57.5,17,24,2,22,36,105,13,2,0,2020-2021,90.0,148.62385321100916,284.86238532110093
173,Mitchel Bakker,NED,DF,Paris S-G,Ligue 1,20,2000,18.8,38,30,15,14,9,17,26,65.4,9,22,2,20,22,60,20,0,0,2020-2021,90.0,105.31914893617021,181.91489361702128
174,Ridle Baku,GER,"FW,DF",Wolfsburg,Bundesliga,22,1998,29.8,50,31,20,20,10,22,53,41.5,31,54,4,50,40,90,33,1,0,2020-2021,90.0,120.80536912751677,151.00671140939596
175,Ridle Baku,GER,DF,Mainz 05,Bundesliga,22,1998,2.0,4,2,3,1,0,2,6,33.3,4,3,1,2,3,7,6,0,0,2020-2021,90.0,135.0,180.0
Rk,Player,Nation,Pos,Squad,Comp,0,0,90.0,0,0,3,3,3,Tkl,0,0.0,0,0,0,0,0,0,0,0,0,2020-2021,90.0,0.0,0.0
176,Dilane Bakwa,FRA,"FW,MF",Bordeaux,Ligue 1,17,2002,0.6,2,2,1,1,0,0,1,0.0,1,2,0,2,1,3,0,0,0,2020-2021,90.0,150.0,300.0
177,Fabián Balbuena,PAR,DF,West Ham,Premier League,28,1991,13.3,24,12,23,1,0,14,23,60.9,9,23,6,17,25,49,63,0,0,2020-2021,90.0,169.17293233082705,162.406015037594
178,Keita Baldé,SEN,FW,Sampdoria,Serie A,25,1995,13.3,9,6,2,6,1,4,10,40.0,6,10,1,9,0,9,3,0,0,2020-2021,90.0,0.0,60.90225563909774
179,George Baldock,GRE,DF,Sheffield Utd,Premier League,27,1993,31.0,47,34,28,14,5,21,50,42.0,29,26,7,19,25,72,70,1,0,2020-2021,90.0,72.58064516129032,136.4516129032258
180,Gareth Bale,WAL,FW,Tottenham,Premier League,31,1989,10.2,17,10,4,9,4,7,14,50.0,7,13,2,11,8,25,16,0,0,2020-2021,90.0,70.58823529411765,150.0
181,Mikel Balenziaga,ESP,DF,Athletic Club,La Liga,32,1988,18.8,26,15,11,12,3,9,18,50.0,9,22,7,15,7,33,46,0,0,2020-2021,90.0,33.51063829787234,124.46808510638297
182,Leonardo Balerdi,ARG,DF,Marseille,Ligue 1,21,1999,18.2,29,18,19,7,3,14,31,45.2,17,17,9,8,28,57,65,3,0,2020-2021,90.0,138.46153846153845,143.4065934065934
183,Fodé Ballo-Touré,SEN,DF,Monaco,Ligue 1,23,1997,7.4,21,17,9,11,1,6,13,46.2,7,7,0,7,6,27,11,1,0,2020-2021,90.0,72.97297297297297,255.4054054054054
184,Botond Balogh,HUN,DF,Parma,Serie A,18,2002,1.8,9,7,9,0,0,2,5,40.0,3,4,3,1,2,11,8,0,0,2020-2021,90.0,100.0,450.0
185,Abdoulaye Bamba,CIV,DF,Angers,Ligue 1,30,1990,15.0,27,17,19,7,1,19,28,67.9,9,7,1,6,19,46,34,0,0,2020-2021,90.0,114.0,162.0
186,Jonathan Bamba,CIV,MF,Lille,Ligue 1,24,1996,33.2,45,23,15,19,11,24,84,28.6,60,24,2,22,24,69,15,0,0,2020-2021,90.0,65.06024096385542,121.9879518072289
187,Robson Bambu,BRA,DF,Nice,Ligue 1,22,1997,11.6,16,11,14,2,0,11,14,78.6,3,8,7,1,10,26,57,0,0,2020-2021,90.0,77.58620689655173,124.13793103448276
188,Patrick Bamford,ENG,FW,Leeds United,Premier League,26,1993,33.9,21,9,2,11,8,8,27,29.6,19,14,4,10,10,31,37,0,0,2020-2021,90.0,26.548672566371682,55.75221238938053
189,Mattia Bani,ITA,DF,Genoa,Serie A,26,1993,10.2,10,5,5,5,0,5,12,41.7,7,16,11,5,27,37,44,0,0,2020-2021,90.0,238.23529411764707,88.23529411764706
190,Mattia Bani,ITA,DF,Parma,Serie A,26,1993,12.7,20,11,15,4,1,4,8,50.0,4,10,6,4,33,53,50,0,0,2020-2021,90.0,233.85826771653544,141.73228346456693
191,Simon Banza,COD,FW,Lens,Ligue 1,23,1996,15.2,13,6,0,4,9,1,14,7.1,13,16,1,15,7,20,15,0,0,2020-2021,90.0,41.44736842105263,76.97368421052632
192,Antonín Barák,CZE,MF,Hellas Verona,Serie A,25,1994,30.7,30,19,8,16,6,14,47,29.8,33,26,7,19,12,42,38,1,0,2020-2021,90.0,35.17915309446254,87.94788273615636
193,Federico Barba,ITA,DF,Benevento,Serie A,26,1993,29.5,31,16,22,8,1,21,35,60.0,14,39,18,21,48,79,94,4,0,2020-2021,90.0,146.4406779661017,94.57627118644068
194,Danilo Barbosa,BRA,DF,Nice,Ligue 1,24,1996,2.8,6,3,5,1,0,4,6,66.7,2,2,1,1,2,8,11,2,0,2020-2021,90.0,64.28571428571429,192.85714285714286
195,Barcia,ESP,DF,Granada,La Liga,19,2000,1.0,1,1,1,0,0,0,0,0.0,0,1,1,0,3,4,9,0,0,2020-2021,90.0,270.0,90.0
196,Melvin Bard,FRA,DF,Lyon,Ligue 1,19,2000,4.8,12,8,7,4,1,6,11,54.5,5,10,2,8,6,18,14,0,0,2020-2021,90.0,112.50000000000001,225.00000000000003
197,Enis Bardhi,MKD,MF,Levante,La Liga,25,1995,18.7,28,12,8,16,4,10,36,27.8,26,8,2,6,21,49,14,0,0,2020-2021,90.0,101.06951871657753,134.75935828877004
198,Phil Bardsley,SCO,DF,Burnley,Premier League,35,1985,3.0,6,5,4,2,0,3,6,50.0,3,3,1,2,6,12,12,0,0,2020-2021,90.0,180.0,180.0
199,Nicolò Barella,ITA,MF,Inter,Serie A,23,1997,32.2,58,31,23,29,6,23,72,31.9,49,29,4,25,26,84,14,0,0,2020-2021,90.0,72.67080745341615,162.111801242236
200,Philipp Bargfrede,GER,MF,Werder Bremen,Bundesliga,31,1989,0.3,0,0,0,0,0,0,0,0.0,0,0,0,0,0,0,3,0,0,2020-2021,90.0,0.0,0.0
Rk,Player,Nation,Pos,Squad,Comp,0,0,90.0,0,0,3,3,3,Tkl,0,0.0,0,0,0,0,0,0,0,0,0,2020-2021,90.0,0.0,0.0
201,Kike Barja,ESP,"MF,FW",Osasuna,La Liga,23,1997,15.9,10,5,6,1,3,5,24,20.8,19,10,1,9,16,26,8,0,0,2020-2021,90.0,90.56603773584905,56.60377358490566
202,Ross Barkley,ENG,MF,Aston Villa,Premier League,26,1993,17.0,6,2,2,4,0,3,15,20.0,12,9,1,8,5,11,6,1,0,2020-2021,90.0,26.47058823529412,31.764705882352942
203,Ross Barkley,ENG,"FW,MF",Chelsea,Premier League,26,1993,0.5,0,0,0,0,0,0,0,0.0,0,0,0,0,0,0,0,0,0,2020-2021,90.0,0.0,0.0
204,Aymen Barkok,MAR,"MF,DF",Eint Frankfurt,Bundesliga,22,1998,10.9,29,15,11,9,9,10,31,32.3,21,15,1,14,10,39,9,1,0,2020-2021,90.0,82.56880733944953,239.44954128440367
205,Ashley Barnes,ENG,FW,Burnley,Premier League,30,1989,14.8,12,6,2,6,4,3,13,23.1,10,14,2,12,5,17,11,0,0,2020-2021,90.0,30.405405405405403,72.97297297297297
206,Harvey Barnes,ENG,"FW,MF",Leicester City,Premier League,22,1997,21.6,19,9,11,3,5,5,22,22.7,17,16,3,13,8,27,11,0,0,2020-2021,90.0,33.33333333333333,79.16666666666666
207,Marc Baró,ESP,DF,Cádiz,La Liga,20,1999,1.0,2,1,2,0,0,0,2,0.0,2,1,0,1,2,4,2,1,0,2020-2021,90.0,180.0,180.0
208,Antonio Barragán,ESP,DF,Elche,La Liga,33,1987,24.8,28,14,21,5,2,12,21,57.1,9,22,8,14,33,61,67,1,0,2020-2021,90.0,119.75806451612904,101.61290322580645
209,Antonio Barreca,ITA,DF,Fiorentina,Serie A,25,1995,0.9,1,0,0,1,0,1,1,100.0,0,0,0,0,0,1,1,0,0,2020-2021,90.0,0.0,100.0
210,Leandro Barreiro Martins,LUX,MF,Mainz 05,Bundesliga,20,2000,25.6,58,32,19,26,13,20,50,40.0,30,34,9,25,57,115,55,0,0,2020-2021,90.0,200.390625,203.90625
211,Ander Barrenetxea,ESP,"MF,FW",Real Sociedad,La Liga,18,2001,14.5,29,19,5,18,6,9,24,37.5,15,20,0,20,6,35,8,0,0,2020-2021,90.0,37.241379310344826,180.0
212,Jacob Barrett Laursen,DEN,DF,Arminia,Bundesliga,25,1994,12.3,23,12,13,8,2,10,16,62.5,6,14,4,10,24,47,37,0,0,2020-2021,89.99999999999999,175.60975609756096,168.29268292682926
213,Musa Barrow,GAM,"FW,MF",Bologna,Serie A,21,1998,32.5,26,10,8,10,8,10,25,40.0,15,37,2,35,11,37,15,0,0,2020-2021,90.0,30.461538461538463,72.0
214,Kyle Bartley,ENG,DF,West Brom,Premier League,29,1991,28.7,27,16,14,10,3,11,23,47.8,12,50,35,15,38,65,159,1,0,2020-2021,90.0,119.1637630662021,84.66898954703832
215,Paolo Bartolomei,ITA,MF,Spezia,Serie A,30,1989,3.6,6,2,3,1,2,4,7,57.1,3,1,0,1,1,7,2,0,0,2020-2021,90.0,25.0,150.0
216,Marc Bartra,ESP,DF,Betis,La Liga,29,1991,18.8,27,16,18,8,1,12,22,54.5,10,19,5,14,40,67,74,3,0,2020-2021,90.0,191.48936170212764,129.25531914893617
217,Daniele Baselli,ITA,MF,Torino,Serie A,28,1992,4.4,12,7,3,6,3,6,10,60.0,4,2,0,2,9,21,5,0,0,2020-2021,90.0,184.0909090909091,245.45454545454544
218,Chris Basham,ENG,"DF,MF",Sheffield Utd,Premier League,32,1988,28.6,69,42,41,23,5,41,67,61.2,26,36,15,21,49,118,105,1,0,2020-2021,90.0,154.1958041958042,217.13286713286715
219,Toma Bašić,CRO,MF,Bordeaux,Ligue 1,23,1996,28.9,33,22,15,16,2,16,58,27.6,42,21,5,16,32,65,42,1,0,2020-2021,90.00000000000001,99.65397923875433,102.7681660899654
220,Álvaro Bastida,ESP,MF,Cádiz,La Liga,16,2004,0.4,0,0,0,0,0,0,0,0.0,0,0,0,0,0,0,0,0,0,2020-2021,90.0,0.0,0.0
221,Alessandro Bastoni,ITA,DF,Inter,Serie A,21,1999,32.5,36,22,13,21,2,17,27,63.0,10,34,16,18,40,76,75,0,0,2020-2021,90.0,110.76923076923077,99.6923076923077
222,Simone Bastoni,ITA,DF,Spezia,Serie A,23,1996,16.9,50,29,26,22,2,27,52,51.9,25,19,1,18,16,66,31,0,0,2020-2021,90.0,85.20710059171599,266.27218934911247
223,Bastos,ANG,DF,Lazio,Serie A,29,1991,0.7,3,1,2,0,1,3,5,60.0,2,1,0,1,0,3,3,0,0,2020-2021,90.0,0.0,385.7142857142857
224,Michy Batshuayi,BEL,FW,Crystal Palace,Premier League,26,1993,8.1,5,3,1,2,2,1,9,11.1,8,5,1,4,4,9,5,0,0,2020-2021,90.0,44.44444444444444,55.55555555555556
225,Rodrigo Battaglia,ARG,MF,Alavés,La Liga,29,1991,27.7,38,16,21,14,3,16,50,32.0,34,30,14,16,29,67,40,1,0,2020-2021,90.0,94.22382671480145,123.46570397111914
Rk,Player,Nation,Pos,Squad,Comp,0,0,90.0,0,0,3,3,3,Tkl,0,0.0,0,0,0,0,0,0,0,0,0,2020-2021,90.0,0.0,0.0
226,Cristian Battocchio,ITA,MF,Brest,Ligue 1,28,1992,3.9,5,2,1,4,0,2,9,22.2,7,0,0,0,4,9,5,0,0,2020-2021,90.0,92.3076923076923,115.38461538461539
227,Oliver Baumann,GER,GK,Hoffenheim,Bundesliga,30,1990,31.0,0,0,0,0,0,0,1,0.0,1,0,0,0,2,2,14,0,0,2020-2021,90.0,5.806451612903226,0.0
228,Julian Baumgartlinger,AUT,MF,Leverkusen,Bundesliga,32,1988,11.9,43,20,14,26,3,16,31,51.6,15,12,0,12,12,55,10,1,0,2020-2021,90.00000000000001,90.75630252100841,325.21008403361344
229,Christoph Baumgartner,AUT,"MF,FW",Hoffenheim,Bundesliga,20,1999,26.3,44,31,13,24,7,14,51,27.5,37,40,8,32,24,68,24,0,0,2020-2021,90.0,82.12927756653993,150.5703422053232
230,Jon Bautista,ESP,FW,Real Sociedad,La Liga,25,1995,4.1,5,3,0,2,3,0,3,0.0,3,3,1,2,2,7,4,0,0,2020-2021,90.0,43.90243902439025,109.75609756097562
231,Paul Baysse,FRA,DF,Bordeaux,Ligue 1,32,1988,29.0,35,18,21,13,1,16,21,76.2,5,33,24,9,52,87,123,1,0,2020-2021,90.0,161.3793103448276,108.62068965517241
232,Noah Joel Sarenren Bazee,NGA,"FW,MF",Augsburg,Bundesliga,23,1996,0.4,0,0,0,0,0,0,1,0.0,1,0,0,0,1,1,0,0,0,2020-2021,90.0,225.0,0.0
233,Ihlas Bebou,TOG,"FW,MF",Hoffenheim,Bundesliga,26,1994,24.4,24,9,5,10,9,8,14,57.1,6,18,4,14,17,41,16,0,0,2020-2021,90.0,62.70491803278689,88.52459016393443
234,Rodrigo Becão,BRA,DF,Udinese,Serie A,24,1996,30.9,59,33,36,20,3,27,49,55.1,22,48,27,21,68,127,94,2,0,2020-2021,90.0,198.05825242718447,171.84466019417476
235,Sheraldo Becker,SUR,"FW,MF",Union Berlin,Bundesliga,25,1995,12.3,5,4,2,2,1,3,5,60.0,2,4,0,4,6,11,7,0,0,2020-2021,89.99999999999999,43.90243902439024,36.58536585365853
236,Timo Becker,GER,DF,Schalke 04,Bundesliga,23,1997,18.2,34,23,28,6,0,16,25,64.0,9,18,4,14,22,56,58,0,0,2020-2021,90.0,108.79120879120879,168.13186813186815
237,Jan Bednarek,POL,DF,Southampton,Premier League,24,1996,34.4,37,19,25,11,1,25,49,51.0,24,44,27,17,84,121,132,0,0,2020-2021,90.0,219.76744186046514,96.80232558139535
238,Donny van de Beek,NED,"MF,FW",Manchester Utd,Premier League,23,1997,5.8,15,10,2,11,2,7,15,46.7,8,10,1,9,6,21,7,0,0,2020-2021,90.0,93.10344827586206,232.75862068965517
239,Valon Behrami,SUI,MF,Genoa,Serie A,35,1985,9.9,21,9,9,10,2,9,26,34.6,17,13,5,8,9,30,13,0,0,2020-2021,90.0,81.81818181818181,190.9090909090909
240,Brian Behrendt,GER,DF,Arminia,Bundesliga,28,1991,0.9,0,0,0,0,0,0,1,0.0,1,0,0,0,0,0,1,0,0,2020-2021,90.0,0.0,0.0
241,Maximilian Beier,GER,"FW,DF",Hoffenheim,Bundesliga,17,2002,0.1,0,0,0,0,0,0,1,0.0,1,0,0,0,0,0,0,0,0,2020-2021,90.0,0.0,0.0
242,Ishak Belfodil,ALG,"FW,MF",Hoffenheim,Bundesliga,28,1992,6.6,3,2,0,0,3,0,2,0.0,2,1,0,1,1,4,3,0,0,2020-2021,90.0,13.636363636363637,40.90909090909091
243,Erwan Belhadji,FRA,MF,Dijon,Ligue 1,19,2001,0.3,3,0,3,0,0,3,5,60.0,2,1,0,1,0,3,0,0,0,2020-2021,90.0,0.0,900.0000000000001
244,Haris Belkebla,ALG,MF,Brest,Ligue 1,26,1994,30.3,69,39,32,28,9,31,66,47.0,35,26,5,21,57,126,34,0,0,2020-2021,90.0,169.30693069306932,204.95049504950495
245,Stefan Bell,GER,DF,Mainz 05,Bundesliga,28,1991,14.1,24,18,15,9,0,14,23,60.9,9,19,11,8,27,51,76,1,0,2020-2021,89.99999999999999,172.3404255319149,153.1914893617021
246,Karim Bellarabi,GER,"FW,MF",Leverkusen,Bundesliga,30,1990,8.9,12,10,3,4,5,4,17,23.5,13,12,0,12,12,24,4,0,0,2020-2021,90.0,121.34831460674158,121.34831460674158
247,Jean-Ricner Bellegarde,FRA,"MF,FW",Strasbourg,Ligue 1,22,1998,23.2,56,39,22,25,9,14,23,60.9,9,20,2,18,19,75,16,0,0,2020-2021,90.0,73.70689655172414,217.24137931034483
248,Héctor Bellerín,ESP,"DF,MF",Arsenal,Premier League,25,1995,23.2,29,19,14,12,3,12,41,29.3,29,26,8,18,33,62,33,0,0,2020-2021,90.0,128.01724137931035,112.5
249,Jude Bellingham,ENG,MF,Dortmund,Bundesliga,17,2003,18.9,49,31,11,29,9,19,46,41.3,27,37,5,32,24,73,13,0,0,2020-2021,90.0,114.28571428571429,233.33333333333334
250,Andrea Belotti,ITA,FW,Torino,Serie A,26,1993,32.1,30,18,4,16,10,11,35,31.4,24,27,4,23,12,42,21,0,0,2020-2021,90.0,33.64485981308411,84.11214953271028
Rk,Player,Nation,Pos,Squad,Comp,0,0,90.0,0,0,3,3,3,Tkl,0,0.0,0,0,0,0,0,0,0,0,0,2020-2021,90.0,0.0,0.0
251,Fran Beltrán,ESP,"MF,FW",Celta Vigo,La Liga,21,1999,15.5,30,22,15,12,3,8,24,33.3,16,14,1,13,16,46,24,0,0,2020-2021,90.0,92.90322580645162,174.19354838709677
252,Sami Ben Amar,MAR,MF,Nîmes,Ligue 1,22,1998,0.1,0,0,0,0,0,0,0,0.0,0,1,0,1,0,0,0,0,0,2020-2021,90.0,0.0,0.0
253,Hatem Ben Arfa,FRA,"MF,FW",Bordeaux,Ligue 1,33,1987,18.9,11,7,1,7,3,2,9,22.2,7,3,0,3,2,13,0,0,0,2020-2021,90.0,9.523809523809524,52.38095238095238
254,Salim Ben Seghir,FRA,DF,Nice,Ligue 1,17,2003,0.1,0,0,0,0,0,0,0,0.0,0,0,0,0,0,0,0,0,0,2020-2021,90.0,0.0,0.0
255,Wissam Ben Yedder,FRA,FW,Monaco,Ligue 1,29,1990,29.0,18,9,2,10,6,3,13,23.1,10,16,0,16,13,31,3,0,0,2020-2021,90.0,40.3448275862069,55.86206896551724
256,Ahmad Benali,LBY,MF,Crotone,Serie A,28,1992,13.5,19,11,10,9,0,11,38,28.9,27,15,2,13,6,25,15,0,0,2020-2021,90.0,40.0,126.66666666666667
257,Samy Benchamma,FRA,"DF,MF",Montpellier,Ligue 1,20,2000,0.5,1,1,1,0,0,0,0,0.0,0,0,0,0,0,1,1,0,0,2020-2021,90.0,0.0,180.0
258,Lars Bender,GER,DF,Leverkusen,Bundesliga,31,1989,10.4,19,13,12,6,1,9,21,42.9,12,19,5,14,16,35,19,0,0,2020-2021,90.0,138.46153846153845,164.4230769230769
259,Sven Bender,GER,DF,Leverkusen,Bundesliga,31,1989,13.0,17,9,8,8,1,7,20,35.0,13,20,9,11,21,38,41,1,0,2020-2021,90.00000000000001,145.3846153846154,117.69230769230771
260,Darío Benedetto,ARG,FW,Marseille,Ligue 1,30,1990,17.5,6,4,1,4,1,5,13,38.5,8,9,2,7,3,9,17,0,0,2020-2021,90.0,15.428571428571429,30.857142857142858
261,László Bénes,SVK,MF,Augsburg,Bundesliga,22,1997,7.3,8,6,4,4,0,2,8,25.0,6,6,2,4,7,15,1,1,0,2020-2021,90.0,86.3013698630137,98.63013698630138
262,László Bénes,SVK,MF,Gladbach,Bundesliga,22,1997,1.7,6,2,5,1,0,2,4,50.0,2,0,0,0,2,8,1,0,0,2020-2021,90.0,105.88235294117646,317.6470588235294
263,Walter Benítez,ARG,GK,Nice,Ligue 1,27,1993,38.0,1,1,1,0,0,1,3,33.3,2,1,0,1,1,2,7,2,0,2020-2021,90.0,2.3684210526315788,2.3684210526315788
264,Loris Benito,SUI,DF,Bordeaux,Ligue 1,28,1992,29.5,42,26,27,12,3,22,48,45.8,26,33,10,23,42,84,70,0,0,2020-2021,90.0,128.135593220339,128.135593220339
265,Sergio Benito,ESP,FW,Valladolid,La Liga,21,1999,0.0,0,0,0,0,0,0,0,0.0,0,0,0,0,0,0,0,0,0,2020-2021,,,
266,Bilal Benkhedim,FRA,FW,Saint-Étienne,Ligue 1,19,2001,0.8,0,0,0,0,0,0,1,0.0,1,1,0,1,0,0,0,0,0,2020-2021,90.0,0.0,0.0
267,Djamel Benlamri,ALG,DF,Lyon,Ligue 1,30,1989,1.7,5,3,5,0,0,3,6,50.0,3,3,2,1,6,11,11,0,0,2020-2021,90.0,317.6470588235294,264.70588235294116
268,Ismaël Bennacer,ALG,MF,Milan,Serie A,22,1997,14.7,39,18,17,21,1,15,32,46.9,17,10,1,9,20,59,12,0,0,2020-2021,90.0,122.44897959183673,238.77551020408163
269,Saïd Benrahma,ALG,"FW,MF",West Ham,Premier League,24,1995,15.5,24,15,8,11,5,8,28,28.6,20,10,0,10,8,32,8,0,0,2020-2021,90.0,46.45161290322581,139.3548387096774
270,Yassine Benrahou,FRA,MF,Nîmes,Ligue 1,21,1999,13.8,16,9,8,6,2,7,25,28.0,18,9,0,9,4,20,5,1,0,2020-2021,90.0,26.08695652173913,104.34782608695652
271,Ramy Bensebaini,ALG,DF,Gladbach,Bundesliga,25,1995,20.1,43,24,27,13,3,26,42,61.9,16,39,7,32,47,90,66,0,0,2020-2021,90.0,210.44776119402982,192.5373134328358
272,Josh Benson,ENG,MF,Burnley,Premier League,20,1999,2.9,5,1,3,0,2,1,6,16.7,5,3,0,3,3,8,2,0,0,2020-2021,90.0,93.10344827586206,155.17241379310346
273,Nabil Bentaleb,ALG,MF,Schalke 04,Bundesliga,25,1994,6.1,14,8,7,6,1,4,15,26.7,11,5,2,3,6,20,8,0,0,2020-2021,90.0,88.52459016393443,206.55737704918036
274,Rodrigo Bentancur,URU,MF,Juventus,Serie A,23,1997,25.8,63,33,21,37,5,20,59,33.9,39,35,12,23,47,110,46,1,0,2020-2021,90.0,163.953488372093,219.7674418604651
275,Christian Benteke,BEL,FW,Crystal Palace,Premier League,29,1990,20.2,15,7,1,7,7,2,9,22.2,7,17,6,11,4,19,39,0,0,2020-2021,90.0,17.821782178217823,66.83168316831683
Rk,Player,Nation,Pos,Squad,Comp,0,0,90.0,0,0,3,3,3,Tkl,0,0.0,0,0,0,0,0,0,0,0,0,2020-2021,90.0,0.0,0.0
276,Karim Benzema,FRA,FW,Real Madrid,La Liga,32,1987,32.2,8,6,4,2,2,5,15,33.3,10,9,2,7,8,16,24,0,0,2020-2021,90.0,22.360248447204967,22.360248447204967
277,Yassine Benzia,ALG,"MF,FW",Dijon,Ligue 1,25,1994,4.5,10,5,5,3,2,2,10,20.0,8,3,0,3,6,16,2,0,0,2020-2021,90.0,120.0,200.0
278,Alessandro Berardi,ITA,GK,Hellas Verona,Serie A,29,1991,0.3,0,0,0,0,0,0,0,0.0,0,0,0,0,0,0,0,0,0,2020-2021,90.0,0.0,0.0
279,Domenico Berardi,ITA,FW,Sassuolo,Serie A,25,1994,27.5,42,22,17,11,14,21,62,33.9,41,23,1,22,26,68,34,0,0,2020-2021,89.99999999999999,85.09090909090908,137.45454545454544
280,Gaetano Berardi,SUI,DF,Leeds United,Premier League,31,1988,1.3,2,2,1,0,1,0,0,0.0,0,2,1,1,1,3,2,0,0,2020-2021,90.0,69.23076923076923,138.46153846153845
281,Yuri Berchiche,ESP,DF,Athletic Club,La Liga,30,1990,18.7,24,19,14,5,5,10,24,41.7,14,14,0,14,11,35,29,0,0,2020-2021,90.0,52.94117647058823,115.50802139037432
282,Álex Berenguer,ESP,MF,Torino,Serie A,25,1995,1.5,2,0,0,0,2,2,5,40.0,3,2,0,2,0,2,1,0,0,2020-2021,90.0,0.0,120.0
283,Álex Berenguer,ESP,"MF,FW",Athletic Club,La Liga,25,1995,25.3,47,31,21,20,6,9,51,17.6,42,48,3,45,18,65,27,0,0,2020-2021,89.99999999999999,64.03162055335967,167.19367588932803
284,Bartosz Bereszyński,POL,DF,Sampdoria,Serie A,28,1992,29.0,66,44,37,22,7,41,73,56.2,32,40,20,20,42,108,88,0,0,2020-2021,90.0,130.3448275862069,204.82758620689654
285,Jóhann Berg Guðmundsson,ISL,MF,Burnley,Premier League,29,1990,15.1,19,11,6,9,4,11,23,47.8,12,11,2,9,17,36,19,0,0,2020-2021,90.0,101.32450331125828,113.24503311258279
286,Sander Berge,NOR,MF,Sheffield Utd,Premier League,22,1998,12.4,16,7,8,5,3,7,15,46.7,8,11,2,9,4,20,18,0,0,2020-2021,90.0,29.032258064516128,116.12903225806451
287,Steven Bergwijn,NED,"FW,MF",Tottenham,Premier League,22,1997,13.4,15,7,8,3,4,7,20,35.0,13,7,1,6,5,20,9,0,0,2020-2021,90.0,33.582089552238806,100.74626865671641
288,Valon Berisha,KVX,MF,Reims,Ligue 1,27,1993,18.3,40,23,19,17,4,11,47,23.4,36,14,2,12,25,65,21,1,0,2020-2021,90.0,122.95081967213115,196.72131147540983
289,Bernard,BRA,"MF,FW",Everton,Premier League,27,1992,5.1,8,3,3,3,2,7,15,46.7,8,5,0,5,8,16,6,0,0,2020-2021,90.0,141.1764705882353,141.1764705882353
290,Federico Bernardeschi,ITA,"MF,DF",Juventus,Serie A,26,1994,10.8,9,4,3,5,1,4,20,20.0,16,6,2,4,14,23,7,1,0,2020-2021,90.0,116.66666666666666,75.0
291,Bernardo,BRA,"DF,MF",Brighton,Premier League,25,1995,2.3,10,8,8,1,1,4,6,66.7,2,2,0,2,1,11,1,0,0,2020-2021,90.0,39.130434782608695,391.304347826087
292,Paul Bernardoni,FRA,GK,Angers,Ligue 1,23,1997,38.0,1,1,1,0,0,1,2,50.0,1,0,0,0,2,3,23,1,0,2020-2021,90.0,4.7368421052631575,2.3684210526315788
293,Juan Bernat,ESP,DF,Paris S-G,Ligue 1,27,1993,2.2,5,3,0,4,1,3,5,60.0,2,4,0,4,1,6,6,0,0,2020-2021,90.0,40.90909090909091,204.54545454545453
294,Dimitry Bertaud,COD,GK,Montpellier,Ligue 1,22,1998,8.3,0,0,0,0,0,0,0,0.0,0,0,0,0,1,1,2,0,0,2020-2021,90.0,10.843373493975902,0.0
295,Marco Bertini,ITA,MF,Lazio,Serie A,17,2002,0.1,1,0,1,0,0,0,0,0.0,0,0,0,0,0,1,0,0,0,2020-2021,90.0,0.0,900.0
296,Ryan Bertrand,ENG,DF,Southampton,Premier League,30,1989,28.9,60,32,26,27,7,30,48,62.5,18,19,1,18,30,90,41,1,0,2020-2021,90.00000000000001,93.4256055363322,186.8512110726644
297,Daniel Bessa,ITA,MF,Hellas Verona,Serie A,27,1993,6.8,15,8,3,11,1,6,14,42.9,8,5,1,4,2,17,0,0,0,2020-2021,90.0,26.470588235294116,198.52941176470588
298,Loïc Bessile,TOG,DF,Bordeaux,Ligue 1,21,1999,1.0,0,0,0,0,0,0,0,0.0,0,2,1,1,1,1,3,0,0,2020-2021,90.0,90.0,0.0
299,Jordan Beyer,GER,DF,Gladbach,Bundesliga,20,2000,2.1,2,1,2,0,0,1,2,50.0,1,5,4,1,5,7,5,0,0,2020-2021,90.0,214.28571428571428,85.71428571428571
300,Giulian Biancone,FRA,"DF,MF",Monaco,Ligue 1,20,2000,1.0,3,3,1,1,1,2,3,66.7,1,1,0,1,1,4,4,0,0,2020-2021,90.0,90.0,270.0
Rk,Player,Nation,Pos,Squad,Comp,0,0,90.0,0,0,3,3,3,Tkl,0,0.0,0,0,0,0,0,0,0,0,0,2020-2021,90.0,0.0,0.0
301,Bartosz Białek,POL,"FW,MF",Wolfsburg,Bundesliga,18,2001,3.0,6,5,1,4,1,4,4,100.0,0,5,1,4,3,9,4,0,0,2020-2021,90.0,90.0,180.0
302,Ermin Bičakčić,BIH,DF,Hoffenheim,Bundesliga,30,1990,1.4,1,1,0,1,0,1,1,100.0,0,1,1,0,3,4,9,0,0,2020-2021,90.0,192.85714285714286,64.28571428571429
303,Pedro Bigas,ESP,DF,Eibar,La Liga,29,1990,17.0,11,9,7,4,0,7,14,50.0,7,12,6,6,23,34,54,0,0,2020-2021,90.0,121.76470588235294,58.23529411764706
304,El Bilal Touré,MLI,FW,Reims,Ligue 1,18,2001,13.8,22,12,3,16,3,8,18,44.4,10,8,3,5,6,28,10,1,0,2020-2021,90.0,39.13043478260869,143.4782608695652
305,Cristiano Biraghi,ITA,DF,Fiorentina,Serie A,27,1992,31.1,42,23,19,15,8,27,45,60.0,18,23,9,14,27,69,56,3,0,2020-2021,90.0,78.13504823151125,121.54340836012861
306,Davide Biraschi,ITA,DF,Genoa,Serie A,26,1994,10.2,17,9,12,5,0,5,10,50.0,5,12,6,6,21,38,26,0,0,2020-2021,90.0,185.29411764705884,150.0
307,Yves Bissouma,MLI,MF,Brighton,Premier League,23,1996,34.6,104,68,50,48,6,33,67,49.3,34,42,6,36,64,168,67,0,0,2020-2021,90.0,166.47398843930634,270.5202312138728
308,Leonardo Bittencourt,GER,"MF,FW",Werder Bremen,Bundesliga,26,1993,16.8,58,32,24,28,6,16,51,31.4,35,29,2,27,13,71,10,0,0,2020-2021,90.0,69.64285714285714,310.7142857142857
309,Alejandro Blanco,ESP,MF,Valencia,La Liga,21,1998,6.4,8,4,4,4,0,3,18,16.7,15,5,0,5,8,16,9,0,0,2020-2021,90.0,112.5,112.5
310,Antonio Blanco,ESP,"MF,FW",Real Madrid,La Liga,20,2000,2.4,7,2,4,2,1,3,7,42.9,4,6,2,4,3,10,5,0,0,2020-2021,90.0,112.50000000000001,262.5
311,Rubén Blanco,ESP,GK,Celta Vigo,La Liga,25,1995,18.2,0,0,0,0,0,0,0,0.0,0,0,0,0,0,0,7,3,0,2020-2021,90.0,0.0,0.0
312,Ludovic Blas,FRA,"MF,FW",Nantes,Ligue 1,22,1997,31.0,58,30,18,37,3,23,54,42.6,31,33,4,29,21,79,19,0,0,2020-2021,90.0,60.96774193548387,168.38709677419354
313,Alejandro Blesa,ESP,MF,Levante,La Liga,18,2002,0.1,0,0,0,0,0,0,0,0.0,0,0,0,0,0,0,0,0,0,2020-2021,90.0,0.0,0.0
314,Jérôme Boateng,GER,DF,Bayern Munich,Bundesliga,31,1988,26.3,26,16,17,8,1,14,32,43.8,18,24,17,7,40,66,63,1,0,2020-2021,90.0,136.88212927756655,88.97338403041826
315,Antonin Bobichon,FRA,"MF,FW",Angers,Ligue 1,24,1995,10.1,23,14,10,8,5,9,15,60.0,6,4,1,3,2,25,1,0,0,2020-2021,90.0,17.821782178217823,204.95049504950495
316,Yann Bodiger,FRA,MF,Cádiz,La Liga,25,1995,2.8,2,2,1,1,0,1,6,16.7,5,7,3,4,8,10,4,0,0,2020-2021,90.0,257.14285714285717,64.28571428571429
317,Jean-Paul Boëtius,NED,"MF,FW",Mainz 05,Bundesliga,26,1994,22.9,42,28,13,15,14,17,47,36.2,30,37,3,34,33,75,14,0,0,2020-2021,90.0,129.69432314410483,165.06550218340612
318,Sacha Boey,FRA,DF,Dijon,Ligue 1,19,2000,20.7,54,40,30,23,1,27,55,49.1,28,25,5,20,41,95,62,0,0,2020-2021,90.0,178.2608695652174,234.7826086956522
319,Sacha Boey,FRA,DF,Rennes,Ligue 1,19,2000,1.4,3,3,2,1,0,3,4,75.0,1,0,0,0,2,5,2,0,0,2020-2021,90.0,128.57142857142858,192.85714285714286
320,Jeremie Boga,CIV,"FW,MF",Sassuolo,Serie A,23,1997,19.8,11,9,5,0,6,3,11,27.3,8,10,0,10,8,19,7,0,0,2020-2021,90.0,36.36363636363637,50.0
321,Melayro Bogarde,NED,"DF,MF",Hoffenheim,Bundesliga,18,2002,3.1,7,3,3,3,1,5,9,55.6,4,0,0,0,5,12,1,0,0,2020-2021,90.0,145.16129032258064,203.2258064516129
322,Jayden Bogle,ENG,"DF,MF",Sheffield Utd,Premier League,20,2000,12.3,33,23,21,10,2,20,39,51.3,19,14,4,10,14,47,22,0,0,2020-2021,89.99999999999999,102.43902439024389,241.46341463414632
323,Quentin Boisgard,FRA,"MF,FW",Lorient,Ligue 1,23,1997,14.6,24,17,3,15,6,11,24,45.8,13,17,2,15,15,39,1,0,0,2020-2021,90.0,92.46575342465754,147.94520547945206
324,Willy Boly,CIV,DF,Wolves,Premier League,29,1991,20.9,33,20,26,7,0,13,24,54.2,11,18,12,6,32,65,84,1,0,2020-2021,90.0,137.79904306220095,142.10526315789474
325,Giacomo Bonaventura,ITA,MF,Fiorentina,Serie A,30,1989,25.1,34,19,16,13,5,16,53,30.2,37,26,2,24,39,73,12,0,0,2020-2021,90.0,139.84063745019918,121.91235059760956
Rk,Player,Nation,Pos,Squad,Comp,0,0,90.0,0,0,3,3,3,Tkl,0,0.0,0,0,0,0,0,0,0,0,0,2020-2021,90.0,0.0,0.0
326,Federico Bonazzoli,ITA,FW,Torino,Serie A,23,1997,6.3,6,4,0,4,2,2,13,15.4,11,3,0,3,2,8,3,0,0,2020-2021,90.0,28.571428571428573,85.71428571428572
327,Federico Bonazzoli,ITA,FW,Sampdoria,Serie A,23,1997,1.5,0,0,0,0,0,0,0,0.0,0,1,0,1,0,0,0,0,0,2020-2021,90.0,0.0,0.0
328,Kevin Bonifazi,ITA,DF,Udinese,Serie A,24,1996,27.4,32,21,24,6,2,8,23,34.8,15,33,20,13,50,82,85,1,0,2020-2021,90.0,164.23357664233578,105.1094890510949
329,Leonardo Bonucci,ITA,DF,Juventus,Serie A,33,1987,22.5,19,14,10,8,1,6,14,42.9,8,24,13,11,33,52,67,0,0,2020-2021,90.0,132.0,76.0
330,Elias Bördner,GER,GK,Eint Frankfurt,Bundesliga,18,2002,1.0,1,0,1,0,0,1,1,100.0,0,0,0,0,2,3,1,0,0,2020-2021,90.0,180.0,90.0
331,Dennis Borkowski,GER,"MF,FW",RB Leipzig,Bundesliga,18,2002,0.1,0,0,0,0,0,0,0,0.0,0,1,0,1,0,0,0,0,0,2020-2021,90.0,0.0,0.0
332,Sebastiaan Bornauw,BEL,DF,Köln,Bundesliga,21,1999,23.1,29,20,25,4,0,14,25,56.0,11,33,26,7,40,69,104,0,0,2020-2021,89.99999999999999,155.8441558441558,112.98701298701297
333,Sven Botman,NED,DF,Lille,Ligue 1,20,2000,36.8,31,21,18,12,1,14,26,53.8,12,31,21,10,57,88,126,2,0,2020-2021,90.0,139.4021739130435,75.81521739130436
334,Denis Bouanga,GAB,"MF,FW",Saint-Étienne,Ligue 1,25,1994,30.2,52,28,22,24,6,16,58,27.6,42,32,3,29,20,72,36,0,0,2020-2021,90.0,59.60264900662252,154.96688741721854
335,Hicham Boudaoui,ALG,MF,Nice,Ligue 1,20,1999,19.3,52,35,20,24,8,26,68,38.2,42,14,4,10,23,75,26,1,0,2020-2021,90.0,107.25388601036268,242.48704663212433
336,Ryad Boudebouz,ALG,"MF,FW",Saint-Étienne,Ligue 1,30,1990,7.2,9,4,1,7,1,4,8,50.0,4,3,0,3,5,14,5,0,0,2020-2021,90.0,62.5,112.5
337,Sofiane Boufal,MAR,"FW,MF",Angers,Ligue 1,26,1993,8.1,17,11,8,6,3,8,28,28.6,20,8,0,8,3,20,1,0,0,2020-2021,90.0,33.333333333333336,188.88888888888889
338,Nassim Boujellab,MAR,"MF,FW",Schalke 04,Bundesliga,21,1999,6.7,13,9,2,10,1,2,12,16.7,10,10,3,7,7,20,9,0,0,2020-2021,90.0,94.02985074626865,174.62686567164178
339,Farid Boulaya,ALG,"MF,FW",Metz,Ligue 1,27,1993,31.3,24,16,4,17,3,13,51,25.5,38,19,3,16,12,36,7,0,0,2020-2021,90.0,34.504792332268366,69.00958466453673
340,Yassine Bounou,MAR,GK,Sevilla,La Liga,29,1991,33.0,1,1,1,0,0,0,2,0.0,2,0,0,0,0,1,12,2,0,2020-2021,90.0,0.0,2.7272727272727275
341,Ismaëlben Boura,COM,DF,Lens,Ligue 1,19,2000,9.1,11,7,8,2,1,3,9,33.3,6,7,2,5,21,32,12,0,0,2020-2021,90.0,207.6923076923077,108.79120879120879
342,Mehdi Bourabia,MAR,MF,Sassuolo,Serie A,28,1991,5.9,6,5,1,4,1,2,7,28.6,5,14,6,8,12,18,8,0,0,2020-2021,90.0,183.0508474576271,91.52542372881355
343,Benjamin Bourigeaud,FRA,"MF,FW",Rennes,Ligue 1,26,1994,28.4,40,23,17,16,7,21,71,29.6,50,37,1,36,19,59,25,0,0,2020-2021,90.0,60.21126760563381,126.7605633802817
344,Edoardo Bove,ITA,MF,Roma,Serie A,18,2002,0.1,0,0,0,0,0,0,1,0.0,1,0,0,0,0,0,0,0,0,2020-2021,90.0,0.0,0.0
345,Jarrod Bowen,ENG,"FW,MF",West Ham,Premier League,23,1996,28.5,26,15,12,7,7,10,29,34.5,19,19,1,18,22,48,10,0,0,2020-2021,90.0,69.47368421052632,82.10526315789474
346,Dedryck Boyata,BEL,DF,Hertha BSC,Bundesliga,29,1990,17.2,14,7,10,3,1,7,15,46.7,8,23,20,3,26,40,68,1,0,2020-2021,90.0,136.046511627907,73.25581395348838
347,John Boye,GHA,DF,Metz,Ligue 1,33,1987,33.8,58,34,43,13,2,31,54,57.4,23,36,20,16,80,138,146,1,0,2020-2021,90.0,213.01775147928996,154.43786982248523
348,Lucas Boyé,ARG,FW,Elche,La Liga,24,1996,29.9,47,31,13,27,7,10,49,20.4,39,37,2,35,19,66,21,0,0,2020-2021,90.0,57.190635451505024,141.4715719063545
349,Can Bozdogan,GER,"MF,FW",Schalke 04,Bundesliga,19,2001,7.2,13,5,6,6,1,4,15,26.7,11,10,2,8,7,20,5,0,0,2020-2021,90.0,87.5,162.5
350,Umut Bozok,TUR,"MF,FW",Lorient,Ligue 1,23,1996,0.7,0,0,0,0,0,0,2,0.0,2,0,0,0,0,0,0,0,0,2020-2021,90.0,0.0,0.0
Rk,Player,Nation,Pos,Squad,Comp,0,0,90.0,0,0,3,3,3,Tkl,0,0.0,0,0,0,0,0,0,0,0,0,2020-2021,90.0,0.0,0.0
351,Jayden Braaf,NED,FW,Udinese,Serie A,17,2002,1.3,0,0,0,0,0,0,1,0.0,1,0,0,0,0,0,0,0,0,2020-2021,90.0,0.0,0.0
352,Domagoj Bradarić,CRO,DF,Lille,Ligue 1,20,1999,14.0,28,18,11,13,4,12,27,44.4,15,14,4,10,26,54,21,0,0,2020-2021,90.0,167.14285714285714,180.0
353,Robbie Brady,IRL,MF,Burnley,Premier League,28,1992,11.7,22,15,12,6,4,12,35,34.3,23,16,0,16,9,31,29,1,0,2020-2021,89.99999999999999,69.23076923076923,169.23076923076923
354,Martin Braithwaite,DEN,FW,Barcelona,La Liga,29,1991,13.1,8,4,2,3,3,1,6,16.7,5,2,0,2,6,14,7,0,0,2020-2021,90.0,41.221374045801525,54.961832061068705
355,Julian Brandt,GER,"FW,MF",Dortmund,Bundesliga,24,1996,16.6,27,14,13,9,5,12,43,27.9,31,25,1,24,17,44,7,1,0,2020-2021,90.0,92.16867469879517,146.38554216867468
356,Darko Brašanac,SRB,MF,Osasuna,La Liga,28,1992,10.1,10,6,6,4,0,5,16,31.3,11,8,1,7,7,17,10,0,0,2020-2021,90.0,62.37623762376238,89.10891089108911
357,Lilian Brassier,FRA,DF,Brest,Ligue 1,20,1999,10.7,19,10,12,4,3,7,11,63.6,4,13,6,7,23,42,38,1,0,2020-2021,90.0,193.45794392523365,159.81308411214954
358,Álvaro Bravo,ESP,MF,Granada,La Liga,22,1998,0.2,1,1,1,0,0,1,2,50.0,1,0,0,0,1,2,0,0,0,2020-2021,90.0,450.0,450.0
359,Claudio Bravo,CHI,GK,Betis,La Liga,37,1983,20.0,0,0,0,0,0,0,1,0.0,1,0,0,0,0,0,11,0,0,2020-2021,90.0,0.0,0.0
360,Fabian Bredlow,GER,GK,Stuttgart,Bundesliga,25,1995,1.0,0,0,0,0,0,0,0,0.0,0,0,0,0,0,0,0,0,0,2020-2021,90.0,0.0,0.0
361,Josip Brekalo,CRO,FW,Wolfsburg,Bundesliga,22,1998,20.2,22,10,10,7,5,8,29,27.6,21,18,0,18,17,39,3,1,0,2020-2021,90.0,75.74257425742574,98.01980198019803
362,Gleison Bremer,BRA,DF,Torino,Serie A,23,1997,32.6,51,34,36,14,1,21,36,58.3,15,54,21,33,70,121,142,1,0,2020-2021,90.0,193.25153374233128,140.79754601226995
363,Joshua Brenet,CUW,DF,Hoffenheim,Bundesliga,26,1994,0.0,0,0,0,0,0,0,0,0.0,0,0,0,0,0,0,0,0,0,2020-2021,,,
364,Rhian Brewster,ENG,"FW,MF",Sheffield Utd,Premier League,20,2000,12.5,8,5,1,4,3,1,13,7.7,12,15,2,13,5,13,5,0,0,2020-2021,90.0,36.0,57.599999999999994
365,Anthony Briançon,FRA,DF,Nîmes,Ligue 1,25,1994,13.6,12,7,9,3,0,9,19,47.4,10,19,12,7,33,45,57,2,0,2020-2021,90.0,218.38235294117646,79.41176470588235
366,Jimmy Briand,FRA,FW,Bordeaux,Ligue 1,34,1985,6.3,7,3,3,2,2,1,1,100.0,0,2,0,2,1,8,3,0,0,2020-2021,90.0,14.285714285714286,100.00000000000001
367,Yan Brice Eteki,CMR,MF,Granada,La Liga,22,1997,14.7,23,15,10,12,1,8,19,42.1,11,13,3,10,13,36,16,1,0,2020-2021,90.0,79.59183673469389,140.81632653061226
368,Nathan Broadhead,WAL,FW,Everton,Premier League,22,1998,0.0,1,1,0,1,0,0,0,0.0,0,0,0,0,0,1,0,0,0,2020-2021,,,inf
369,Dylan Bronn,TUN,DF,Metz,Ligue 1,25,1995,37.9,57,37,38,19,0,24,44,54.5,20,31,14,17,44,101,112,0,0,2020-2021,90.0,104.48548812664907,135.3562005277045
370,John Brooks,USA,DF,Wolfsburg,Bundesliga,27,1993,30.8,47,29,33,14,0,30,54,55.6,24,35,10,25,55,102,134,0,0,2020-2021,90.0,160.71428571428572,137.33766233766235
371,Daniel Brosinski,GER,"DF,FW",Mainz 05,Bundesliga,32,1988,15.9,19,14,10,7,2,12,31,38.7,19,18,1,17,14,33,33,0,0,2020-2021,90.0,79.24528301886792,107.54716981132076
372,Josh Brownhill,ENG,MF,Burnley,Premier League,24,1995,31.3,45,27,9,29,7,15,44,34.1,29,33,11,22,69,114,39,0,0,2020-2021,90.0,198.40255591054313,129.3929712460064
373,Marcelo Brozović,CRO,MF,Inter,Serie A,27,1992,28.7,54,29,23,24,7,20,61,32.8,41,43,17,26,40,94,38,0,0,2020-2021,90.0,125.43554006968641,169.33797909407664
374,Gastón Brugman,URU,MF,Parma,Serie A,27,1992,18.0,35,19,18,15,2,11,44,25.0,33,33,4,29,45,80,34,0,0,2020-2021,90.0,225.0,175.0
375,Juan Brunet,ARG,MF,Granada,La Liga,22,1998,0.3,0,0,0,0,0,0,0,0.0,0,0,0,0,0,0,1,0,0,2020-2021,90.0,0.0,0.0
Rk,Player,Nation,Pos,Squad,Comp,0,0,90.0,0,0,3,3,3,Tkl,0,0.0,0,0,0,0,0,0,0,0,0,2020-2021,90.0,0.0,0.0
376,Juan Brunetta,ARG,"FW,MF",Parma,Serie A,23,1997,5.3,2,2,0,2,0,1,6,16.7,5,5,0,5,1,3,2,0,0,2020-2021,90.0,16.9811320754717,33.9622641509434
377,Cédric Brunner,SUI,DF,Arminia,Bundesliga,26,1994,29.5,42,22,24,15,3,27,40,67.5,13,30,10,20,42,84,96,0,0,2020-2021,90.0,128.135593220339,128.135593220339
378,Jacob Bruun Larsen,DEN,"MF,FW",Hoffenheim,Bundesliga,21,1998,1.0,0,0,0,0,0,0,0,0.0,0,0,0,0,0,0,0,0,0,2020-2021,90.0,0.0,0.0
379,Joe Bryan,ENG,"DF,MF",Fulham,Premier League,26,1993,7.4,15,8,7,5,3,7,12,58.3,5,8,2,6,14,29,16,0,0,2020-2021,90.0,170.27027027027026,182.43243243243242
380,Kean Bryan,ENG,DF,Sheffield Utd,Premier League,23,1996,11.2,20,10,9,11,0,9,19,47.4,10,16,10,6,13,33,39,1,0,2020-2021,90.0,104.46428571428572,160.71428571428572
381,Lucas Buadés,FRA,MF,Nîmes,Ligue 1,22,1997,0.2,1,0,0,1,0,0,0,0.0,0,0,0,0,0,1,0,0,0,2020-2021,90.0,0.0,450.0
382,Ante Budimir,CRO,FW,Osasuna,La Liga,29,1991,18.1,20,12,2,11,7,4,15,26.7,11,17,4,13,2,22,17,1,0,2020-2021,90.0,9.944751381215468,99.44751381215468
383,Gianluigi Buffon,ITA,GK,Juventus,Serie A,42,1978,8.0,0,0,0,0,0,0,0,0.0,0,0,0,0,0,0,3,1,0,2020-2021,90.0,0.0,0.0
384,Marius Bülter,GER,"FW,MF",Union Berlin,Bundesliga,27,1993,10.9,15,8,6,6,3,5,17,29.4,12,17,2,15,12,27,11,0,0,2020-2021,90.0,99.08256880733944,123.8532110091743
385,Alessandro Buongiorno,ITA,DF,Torino,Serie A,21,1999,9.5,12,5,8,4,0,7,12,58.3,5,15,9,6,11,23,44,1,0,2020-2021,90.0,104.21052631578948,113.6842105263158
386,Esteban Burgos,ARG,DF,Eibar,La Liga,28,1992,12.3,7,6,4,3,0,1,5,20.0,4,8,7,1,23,30,54,2,0,2020-2021,89.99999999999999,168.29268292682926,51.21951219512194
387,Burgui,ESP,MF,Alavés,La Liga,26,1993,0.2,3,1,2,1,0,1,1,100.0,0,0,0,0,0,3,0,0,0,2020-2021,90.0,0.0,1350.0
388,Jonathan Burkardt,GER,"FW,MF",Mainz 05,Bundesliga,20,2000,15.3,27,13,15,10,2,11,19,57.9,8,20,3,17,8,35,15,0,0,2020-2021,90.0,47.05882352941176,158.8235294117647
389,Nishan Burkart,SUI,MF,Freiburg,Bundesliga,20,2000,0.2,0,0,0,0,0,0,1,0.0,1,0,0,0,0,0,0,0,0,2020-2021,90.0,0.0,0.0
390,Oliver Burke,SCO,FW,Sheffield Utd,Premier League,23,1997,14.1,16,8,6,9,1,5,24,20.8,19,24,0,24,2,18,6,0,0,2020-2021,89.99999999999999,12.76595744680851,102.12765957446808
391,Roman Bürki,SUI,GK,Dortmund,Bundesliga,29,1990,18.5,0,0,0,0,0,0,0,0.0,0,0,0,0,0,0,5,1,0,2020-2021,90.0,0.0,0.0
392,Dan Burn,ENG,DF,Brighton,Premier League,28,1992,22.9,50,26,33,14,3,27,53,50.9,26,30,7,23,31,81,75,0,0,2020-2021,90.0,121.83406113537119,196.50655021834064
393,Patrick Burner,MTQ,DF,Nice,Ligue 1,24,1996,0.0,0,0,0,0,0,0,0,0.0,0,0,0,0,0,0,0,0,0,2020-2021,,,
394,Patrick Burner,MTQ,DF,Nîmes,Ligue 1,24,1996,14.6,25,11,14,10,1,13,26,50.0,13,10,3,7,24,49,41,1,0,2020-2021,90.0,147.94520547945206,154.1095890410959
395,Maxime Busi,BEL,DF,Parma,Serie A,20,1999,13.3,23,13,19,3,1,11,28,39.3,17,14,1,13,16,39,32,0,0,2020-2021,90.0,108.27067669172932,155.6390977443609
396,Sergio Busquets,ESP,MF,Barcelona,La Liga,32,1988,28.0,63,35,21,29,13,27,76,35.5,49,27,4,23,53,116,18,2,0,2020-2021,90.0,170.35714285714286,202.5
397,Jack Butland,ENG,GK,Crystal Palace,Premier League,27,1993,1.0,0,0,0,0,0,0,0,0.0,0,0,0,0,0,0,0,0,0,2020-2021,90.0,0.0,0.0
398,David Button,ENG,GK,West Brom,Premier League,31,1989,1.0,0,0,0,0,0,0,0,0.0,0,0,0,0,0,0,0,0,0,2020-2021,90.0,0.0,0.0
399,Oskar Buur,DEN,DF,Wolves,Premier League,22,1998,0.2,0,0,0,0,0,0,2,0.0,2,0,0,0,0,0,0,0,0,2020-2021,90.0,0.0,0.0
400,Marcin Bułka,POL,GK,Paris S-G,Ligue 1,20,1999,1.0,0,0,0,0,0,0,0,0.0,0,0,0,0,0,0,0,1,0,2020-2021,90.0,0.0,0.0
Rk,Player,Nation,Pos,Squad,Comp,0,0,90.0,0,0,3,3,3,Tkl,0,0.0,0,0,0,0,0,0,0,0,0,2020-2021,90.0,0.0,0.0
401,Erick Cabaco,URU,DF,Getafe,La Liga,25,1995,14.7,24,14,11,12,1,12,22,54.5,10,8,6,2,13,37,51,1,0,2020-2021,90.0,79.59183673469389,146.9387755102041
402,Willy Caballero,ARG,GK,Chelsea,Premier League,38,1981,1.0,0,0,0,0,0,0,0,0.0,0,0,0,0,0,0,0,0,0,2020-2021,90.0,0.0,0.0
403,Jimmy Cabot,FRA,"FW,MF",Angers,Ligue 1,26,1994,10.5,26,13,8,14,4,11,36,30.6,25,8,0,8,12,38,6,0,0,2020-2021,90.0,102.85714285714286,222.85714285714286
404,Martín Cáceres,URU,DF,Fiorentina,Serie A,33,1987,24.9,28,12,16,11,1,15,35,42.9,20,20,14,6,14,42,52,1,0,2020-2021,90.0,50.602409638554214,101.20481927710843
405,Anthony Caci,FRA,DF,Strasbourg,Ligue 1,23,1997,31.1,80,46,47,27,6,35,69,50.7,34,30,4,26,55,135,65,1,0,2020-2021,90.0,159.16398713826365,231.5112540192926
406,Mathieu Cafaro,FRA,"MF,FW",Reims,Ligue 1,23,1997,23.0,40,17,15,19,6,13,43,30.2,30,11,0,11,17,57,12,0,0,2020-2021,90.0,66.52173913043478,156.52173913043478
407,Gary Cahill,ENG,DF,Crystal Palace,Premier League,34,1985,20.0,13,9,10,3,0,7,11,63.6,4,27,22,5,13,26,88,0,0,2020-2021,90.0,58.5,58.5
408,Yannick Cahuzac,FRA,MF,Lens,Ligue 1,35,1985,25.0,26,12,12,10,4,9,27,33.3,18,18,5,13,33,59,72,0,0,2020-2021,90.0,118.8,93.6
409,Felipe Caicedo,ECU,FW,Lazio,Serie A,31,1988,10.3,10,7,4,4,2,1,8,12.5,7,7,0,7,4,14,2,0,0,2020-2021,90.0,34.95145631067961,87.37864077669903
410,Marc-Aurèle Caillard,FRA,GK,Metz,Ligue 1,26,1994,4.0,0,0,0,0,0,0,0,0.0,0,0,0,0,0,0,2,0,0,2020-2021,90.0,0.0,0.0
411,Tom Cairney,SCO,MF,Fulham,Premier League,29,1991,8.4,9,3,1,4,4,1,4,25.0,3,6,0,6,0,9,3,0,0,2020-2021,90.0,0.0,96.42857142857143
412,Cala,ESP,DF,Cádiz,La Liga,30,1989,25.2,21,12,15,6,0,11,21,52.4,10,18,8,10,35,56,91,0,0,2020-2021,90.0,125.00000000000001,75.00000000000001
413,Arturo Calabresi,ITA,"DF,FW",Bologna,Serie A,24,1996,0.2,0,0,0,0,0,0,0,0.0,0,0,0,0,0,0,2,0,0,2020-2021,90.0,0.0,0.0
414,Arturo Calabresi,ITA,DF,Cagliari,Serie A,24,1996,0.2,0,0,0,0,0,0,1,0.0,1,0,0,0,0,0,0,0,0,2020-2021,90.0,0.0,0.0
415,Davide Calabria,ITA,DF,Milan,Serie A,23,1996,29.4,101,64,61,32,8,54,90,60.0,36,42,9,33,37,138,82,1,0,2020-2021,90.0,113.26530612244898,309.18367346938777
416,Riccardo Calafiori,ITA,DF,Roma,Serie A,18,2002,0.7,1,0,1,0,0,1,4,25.0,3,1,0,1,0,1,0,0,0,2020-2021,90.0,0.0,128.57142857142858
417,Mattia Caldara,ITA,DF,Atalanta,Serie A,26,1994,1.2,1,0,0,1,0,1,1,100.0,0,3,2,1,4,5,3,0,0,2020-2021,90.0,300.0,75.0
418,Luca Caldirola,ITA,DF,Benevento,Serie A,29,1991,17.5,21,13,13,6,2,10,22,45.5,12,20,15,5,20,41,56,0,0,2020-2021,90.0,102.85714285714286,108.0
419,Duje Ćaleta-Car,CRO,DF,Marseille,Ligue 1,23,1996,31.3,29,17,19,9,1,17,30,56.7,13,29,22,7,44,73,130,0,0,2020-2021,90.0,126.51757188498402,83.38658146964856
420,Hakan Çalhanoğlu,TUR,"MF,FW",Milan,Serie A,26,1994,29.0,26,7,3,17,6,7,28,25.0,21,21,6,15,15,41,24,1,0,2020-2021,90.0,46.55172413793103,80.6896551724138
421,Kerim Calhanoglu,GER,DF,Schalke 04,Bundesliga,17,2002,3.3,3,3,1,1,1,0,3,0.0,3,4,0,4,7,10,6,0,0,2020-2021,90.0,190.9090909090909,81.81818181818181
422,Fabrizio Caligara,ITA,"MF,FW",Cagliari,Serie A,20,2000,2.0,6,4,2,2,2,6,9,66.7,3,9,2,7,3,9,3,0,0,2020-2021,90.0,135.0,270.0
423,Daniel Caligiuri,ITA,"MF,FW",Augsburg,Bundesliga,32,1988,29.6,71,46,29,31,11,29,92,31.5,63,45,6,39,38,109,41,0,0,2020-2021,90.0,115.54054054054053,215.8783783783784
424,José Callejón,ESP,"FW,MF",Fiorentina,Serie A,33,1987,7.4,10,7,0,6,4,5,9,55.6,4,4,1,3,4,14,5,0,0,2020-2021,90.0,48.648648648648646,121.62162162162161
425,Jonathan Calleri,ARG,FW,Osasuna,La Liga,26,1993,17.2,15,6,2,4,9,3,17,17.6,14,18,2,16,1,16,10,1,0,2020-2021,90.0,5.232558139534884,78.48837209302326
Rk,Player,Nation,Pos,Squad,Comp,0,0,90.0,0,0,3,3,3,Tkl,0,0.0,0,0,0,0,0,0,0,0,0,2020-2021,90.0,0.0,0.0
426,Dominic Calvert-Lewin,ENG,FW,Everton,Premier League,23,1997,31.9,17,8,1,8,8,6,12,50.0,6,22,6,16,6,23,33,0,0,2020-2021,90.0,16.927899686520377,47.96238244514107
427,Dani Calvo,ESP,DF,Elche,La Liga,26,1994,19.8,20,13,13,7,0,7,10,70.0,3,18,12,6,11,31,71,0,0,2020-2021,90.0,50.0,90.9090909090909
428,Drissa Camara,CIV,MF,Parma,Serie A,18,2002,0.2,0,0,0,0,0,0,0,0.0,0,0,0,0,0,0,0,0,0,2020-2021,90.0,0.0,0.0
429,Mahdi Camara,FRA,"MF,DF",Saint-Étienne,Ligue 1,22,1998,36.6,99,67,43,46,10,33,60,55.0,27,50,12,38,78,177,51,0,0,2020-2021,90.0,191.80327868852459,243.44262295081967
430,Eduardo Camavinga,FRA,MF,Rennes,Ligue 1,17,2002,26.7,98,58,39,48,11,38,77,49.4,39,36,2,34,23,121,15,1,0,2020-2021,90.00000000000001,77.52808988764046,330.33707865168543
431,José Campaña,ESP,MF,Levante,La Liga,27,1993,8.3,14,6,3,6,5,5,14,35.7,9,2,0,2,13,27,4,0,0,2020-2021,90.0,140.96385542168673,151.80722891566262
432,Emre Can,GER,"DF,MF",Dortmund,Bundesliga,26,1994,23.7,43,34,20,20,3,20,37,54.1,17,35,10,25,48,91,52,0,0,2020-2021,90.0,182.27848101265823,163.29113924050634
433,Sergio Canales,ESP,"MF,FW",Betis,La Liga,29,1991,27.8,16,9,9,6,1,3,21,14.3,18,18,0,18,13,29,5,0,0,2020-2021,90.0,42.0863309352518,51.79856115107914
434,João Cancelo,POR,"DF,MF",Manchester City,Premier League,26,1994,25.5,68,41,42,19,7,43,83,51.8,40,23,2,21,41,109,33,2,0,2020-2021,90.0,144.7058823529412,240.0
435,Antonio Candreva,ITA,MF,Sampdoria,Serie A,33,1987,27.8,28,19,17,9,2,21,53,39.6,32,24,3,21,9,37,27,1,0,2020-2021,90.0,29.136690647482016,90.64748201438849
436,Álex Cantero,ESP,FW,Levante,La Liga,20,2000,2.6,2,1,0,2,0,1,2,50.0,1,1,0,1,0,2,3,0,0,2020-2021,90.0,0.0,69.23076923076923
437,Ander Capa,ESP,DF,Athletic Club,La Liga,28,1992,23.7,37,18,22,13,2,18,37,48.6,19,21,8,13,25,62,57,0,0,2020-2021,90.0,94.93670886075951,140.50632911392407
438,Pierrick Capelle,FRA,"MF,DF",Angers,Ligue 1,33,1987,22.8,53,28,24,17,12,31,79,39.2,48,25,1,24,47,100,32,0,0,2020-2021,90.0,185.52631578947367,209.21052631578945
439,Étienne Capoue,FRA,MF,Villarreal,La Liga,32,1988,13.2,20,10,14,6,0,8,18,44.4,10,7,1,6,20,40,23,0,0,2020-2021,90.0,136.36363636363637,136.36363636363637
440,Elio Capradossi,UGA,DF,Spezia,Serie A,24,1996,1.0,2,1,2,0,0,2,2,100.0,0,0,0,0,1,3,5,0,0,2020-2021,90.0,90.0,180.0
441,Gianluca Caprari,ITA,"MF,FW",Benevento,Serie A,27,1993,20.7,16,11,5,5,6,6,31,19.4,25,19,1,18,18,34,8,0,0,2020-2021,90.0,78.26086956521739,69.56521739130436
442,Francesco Caputo,ITA,FW,Sassuolo,Serie A,32,1987,18.9,0,0,0,0,0,0,2,0.0,2,4,0,4,1,1,3,0,0,2020-2021,90.0,4.761904761904762,0.0
443,Maxence Caqueret,FRA,MF,Lyon,Ligue 1,20,2000,19.6,72,45,17,39,16,35,106,33.0,71,35,3,32,23,95,5,2,0,2020-2021,90.0,105.61224489795917,330.61224489795916
444,Andrea Carboni,ITA,DF,Cagliari,Serie A,19,2001,12.1,34,23,23,11,0,15,28,53.6,13,15,4,11,14,48,52,0,0,2020-2021,90.0,104.13223140495867,252.89256198347107
445,Isaac Carcelen,ESP,DF,Cádiz,La Liga,27,1993,28.7,68,43,36,25,7,33,60,55.0,27,37,12,25,49,117,89,0,0,2020-2021,90.0,153.65853658536585,213.2404181184669
446,Cárdenas,ESP,GK,Levante,La Liga,23,1997,8.0,0,0,0,0,0,0,1,0.0,1,0,0,0,3,3,5,1,0,2020-2021,90.0,33.75,0.0
447,Irvin Cardona,FRA,FW,Brest,Ligue 1,22,1997,22.5,10,5,3,6,1,4,22,18.2,18,17,3,14,9,19,23,2,0,2020-2021,90.0,36.0,40.0
448,Marc Cardona,ESP,"FW,DF",Osasuna,La Liga,25,1995,0.6,1,0,1,0,0,1,1,100.0,0,0,0,0,0,1,0,0,0,2020-2021,90.0,0.0,150.0
449,Diego Carlos,BRA,DF,Sevilla,La Liga,27,1993,31.0,22,13,17,4,1,8,16,50.0,8,35,27,8,31,53,114,1,0,2020-2021,90.0,90.0,63.87096774193549
450,Juan Carlos,ESP,"MF,FW",Huesca,La Liga,29,1991,3.2,5,3,4,1,0,2,15,13.3,13,7,0,7,1,6,1,0,0,2020-2021,90.0,28.125,140.625
Rk,Player,Nation,Pos,Squad,Comp,0,0,90.0,0,0,3,3,3,Tkl,0,0.0,0,0,0,0,0,0,0,0,0,2020-2021,90.0,0.0,0.0
451,Lionel Carole,FRA,DF,Strasbourg,Ligue 1,29,1991,14.9,37,25,18,14,5,16,29,55.2,13,3,1,2,38,75,28,0,0,2020-2021,90.0,229.53020134228186,223.48993288590603
452,Yannick Carrasco,BEL,"DF,MF",Atlético Madrid,La Liga,26,1993,24.2,27,15,14,6,7,15,34,44.1,19,24,0,24,17,44,16,1,0,2020-2021,90.0,63.22314049586777,100.41322314049586
453,Sergio Carreira,ESP,DF,Celta Vigo,La Liga,19,2000,2.9,3,0,2,1,0,1,1,100.0,0,2,0,2,1,4,7,0,0,2020-2021,90.0,31.03448275862069,93.10344827586206
454,Guido Carrillo,ARG,FW,Elche,La Liga,29,1991,11.1,9,8,1,7,1,2,8,25.0,6,2,1,1,4,13,14,0,0,2020-2021,90.0,32.432432432432435,72.97297297297298
455,Andy Carroll,ENG,FW,Newcastle Utd,Premier League,31,1989,4.4,3,1,1,1,1,1,8,12.5,7,1,0,1,0,3,14,0,0,2020-2021,90.0,0.0,61.36363636363636
456,Scott Carson,ENG,GK,Manchester City,Premier League,34,1985,1.0,0,0,0,0,0,0,0,0.0,0,0,0,0,0,0,0,0,0,2020-2021,90.0,0.0,0.0
457,Dani Carvajal,ESP,DF,Real Madrid,La Liga,28,1992,10.6,27,20,12,10,5,11,20,55.0,9,19,1,18,13,40,27,0,0,2020-2021,90.0,110.37735849056604,229.24528301886792
458,Fabio Carvalho,POR,"MF,FW",Fulham,Premier League,17,2002,2.8,9,6,4,4,1,5,9,55.6,4,2,0,2,1,10,1,1,0,2020-2021,90.0,32.142857142857146,289.2857142857143
459,William Carvalho,POR,MF,Betis,La Liga,28,1992,13.6,19,12,7,11,1,5,21,23.8,16,11,3,8,11,30,14,1,0,2020-2021,90.0,72.79411764705883,125.73529411764706
460,Casemiro,BRA,MF,Real Madrid,La Liga,28,1992,32.2,84,49,50,30,4,33,73,45.2,40,50,17,33,70,154,62,0,0,2020-2021,90.0,195.65217391304347,234.78260869565216
461,Matty Cash,POL,DF,Aston Villa,Premier League,22,1997,26.4,71,40,43,22,6,41,74,55.4,33,50,11,39,60,131,95,0,0,2020-2021,90.0,204.54545454545453,242.04545454545453
462,Kiko Casilla,ESP,GK,Leeds United,Premier League,33,1986,3.0,0,0,0,0,0,0,0,0.0,0,0,0,0,0,0,0,0,0,2020-2021,90.0,0.0,0.0
463,Giuseppe Caso,ITA,"DF,FW",Genoa,Serie A,21,1998,0.6,0,0,0,0,0,0,0,0.0,0,0,0,0,0,0,0,0,0,2020-2021,90.0,0.0,0.0
464,Moreto Cassamã,GNB,MF,Reims,Ligue 1,22,1998,22.6,49,36,24,23,2,27,49,55.1,22,19,6,13,36,85,33,4,0,2020-2021,90.0,143.36283185840708,195.13274336283186
465,Francesco Cassata,ITA,"DF,FW",Genoa,Serie A,23,1997,2.5,7,6,7,0,0,4,7,57.1,3,0,0,0,3,10,1,0,0,2020-2021,90.0,108.0,252.0
466,Timothy Castagne,BEL,DF,Leicester City,Premier League,24,1995,26.1,52,32,29,18,5,24,44,54.5,20,29,5,24,29,81,62,1,0,2020-2021,90.0,99.99999999999999,179.3103448275862
467,Koen Casteels,BEL,GK,Wolfsburg,Bundesliga,28,1992,32.0,0,0,0,0,0,0,1,0.0,1,1,0,1,2,2,9,2,0,2020-2021,90.0,5.625,0.0
468,Jean-Charles Castelletto,CMR,DF,Nantes,Ligue 1,25,1995,21.6,32,18,20,11,1,18,31,58.1,13,25,19,6,42,74,79,0,0,2020-2021,90.0,175.0,133.33333333333331
469,Samu Castillejo,ESP,FW,Milan,Serie A,25,1995,13.1,24,12,9,14,1,14,40,35.0,26,21,0,21,6,30,9,0,0,2020-2021,90.0,41.221374045801525,164.8854961832061
470,Gonzalo Castro,GER,MF,Stuttgart,Bundesliga,33,1987,19.2,21,7,6,9,6,8,23,34.8,15,16,3,13,8,29,12,0,0,2020-2021,90.0,37.5,98.4375
471,Jonny Castro,ESP,"MF,DF",Wolves,Premier League,26,1994,5.5,11,5,6,4,1,6,13,46.2,7,9,3,6,9,20,7,0,0,2020-2021,90.0,147.27272727272728,180.0
472,Gaetano Castrovilli,ITA,MF,Fiorentina,Serie A,23,1997,25.9,33,19,15,11,7,11,42,26.2,31,25,2,23,34,67,14,0,0,2020-2021,90.0,118.14671814671816,114.67181467181469
473,Danilo Cataldi,ITA,MF,Lazio,Serie A,25,1994,6.3,7,2,1,5,1,4,18,22.2,14,3,1,2,9,16,7,0,0,2020-2021,90.0,128.57142857142858,100.00000000000001
474,Ivan Cavaleiro,POR,FW,Fulham,Premier League,26,1993,27.5,23,14,9,11,3,12,34,35.3,22,25,1,24,19,42,14,0,0,2020-2021,89.99999999999999,62.18181818181818,75.27272727272727
475,Edinson Cavani,URU,FW,Manchester Utd,Premier League,33,1987,15.3,12,8,1,8,3,2,13,15.4,11,2,0,2,6,18,11,0,0,2020-2021,90.0,35.29411764705882,70.58823529411764
Rk,Player,Nation,Pos,Squad,Comp,0,0,90.0,0,0,3,3,3,Tkl,0,0.0,0,0,0,0,0,0,0,0,0,2020-2021,90.0,0.0,0.0
476,Dani Ceballos,ESP,MF,Arsenal,Premier League,23,1996,17.9,37,22,20,11,6,21,51,41.2,30,23,6,17,35,72,14,1,0,2020-2021,90.0,175.97765363128494,186.03351955307264
477,Federico Ceccherini,ITA,DF,Hellas Verona,Serie A,28,1992,19.3,16,12,10,6,0,2,7,28.6,5,15,8,7,40,56,60,0,0,2020-2021,90.0,186.5284974093264,74.61139896373057
478,Federico Ceccherini,ITA,DF,Fiorentina,Serie A,28,1992,3.0,4,1,1,3,0,1,1,100.0,0,6,5,1,7,11,15,0,0,2020-2021,90.0,210.0,120.0
479,Zeki Çelik,TUR,DF,Lille,Ligue 1,23,1997,26.5,72,33,30,30,12,44,81,54.3,37,32,6,26,38,110,52,0,0,2020-2021,90.0,129.0566037735849,244.52830188679243
480,Bersant Celina,KVX,"MF,FW",Dijon,Ligue 1,23,1996,25.5,20,12,8,8,4,7,38,18.4,31,20,2,18,8,28,10,0,0,2020-2021,90.0,28.235294117647058,70.58823529411765
481,Fabien Centonze,FRA,DF,Metz,Ligue 1,24,1996,35.8,104,68,64,30,10,43,73,58.9,30,62,17,45,112,216,119,1,0,2020-2021,90.0,281.5642458100559,261.45251396648047
482,Luca Ceppitelli,ITA,DF,Cagliari,Serie A,30,1989,16.3,25,19,13,10,2,14,26,53.8,12,23,12,11,25,50,58,1,0,2020-2021,90.0,138.03680981595093,138.03680981595093
483,Alberto Cerri,ITA,FW,Cagliari,Serie A,24,1996,4.1,3,2,0,2,1,0,5,0.0,5,4,2,2,2,5,6,0,0,2020-2021,90.0,43.90243902439025,65.85365853658537
484,Sava Cestic,SRB,DF,Köln,Bundesliga,19,2001,10.0,20,9,12,6,2,8,17,47.1,9,13,4,9,18,38,40,0,0,2020-2021,90.0,162.0,180.0
485,Julian Chabot,GER,DF,Spezia,Serie A,22,1998,18.4,48,34,28,16,4,23,37,62.2,14,25,13,12,37,85,43,1,0,2020-2021,90.0,180.97826086956522,234.7826086956522
486,Nassim Chadli,FRA,"FW,MF",Nîmes,Ligue 1,19,2001,0.3,2,1,2,0,0,0,1,0.0,1,1,0,1,0,2,0,0,0,2020-2021,90.0,0.0,600.0
487,Fouad Chafik,MAR,DF,Dijon,Ligue 1,33,1986,18.0,39,24,29,8,2,16,35,45.7,19,19,10,9,21,60,41,0,0,2020-2021,90.0,105.0,195.0
488,Mehdi Chahiri,MAR,"FW,MF",Strasbourg,Ligue 1,24,1996,8.9,18,8,7,5,6,8,20,40.0,12,9,0,9,6,24,5,0,0,2020-2021,90.0,60.67415730337079,182.02247191011236
489,Sofian Chakla,MAR,DF,Villarreal,La Liga,26,1993,0.1,0,0,0,0,0,0,0,0.0,0,0,0,0,0,0,0,0,0,2020-2021,90.0,0.0,0.0
490,Sofian Chakla,MAR,DF,Getafe,La Liga,26,1993,10.0,12,8,10,1,1,5,7,71.4,2,3,2,1,14,26,48,1,0,2020-2021,90.0,126.0,108.0
491,Aníbal Chalá,ECU,DF,Dijon,Ligue 1,24,1996,8.3,10,7,6,3,1,6,12,50.0,6,5,3,2,14,24,15,1,0,2020-2021,90.0,151.80722891566262,108.43373493975902
492,Trevoh Chalobah,ENG,"DF,MF",Lorient,Ligue 1,21,1999,24.9,45,26,32,13,0,24,50,48.0,26,20,7,13,69,114,56,0,0,2020-2021,90.0,249.39759036144576,162.65060240963854
493,Calum Chambers,ENG,DF,Arsenal,Premier League,25,1995,8.4,7,3,3,2,2,3,8,37.5,5,6,2,4,10,17,37,0,0,2020-2021,90.0,107.14285714285714,75.0
494,Timothy Chandler,USA,DF,Eint Frankfurt,Bundesliga,30,1990,4.8,4,0,2,1,1,1,4,25.0,3,5,2,3,3,7,5,0,0,2020-2021,90.0,56.25000000000001,75.0
495,Kwon Chang-hoon,KOR,"MF,FW",Freiburg,Bundesliga,26,1994,2.4,3,1,1,0,2,1,3,33.3,2,3,1,2,7,10,2,1,0,2020-2021,90.0,262.5,112.50000000000001
496,Gaëtan Charbonnier,FRA,"MF,FW",Brest,Ligue 1,31,1988,17.4,24,15,6,11,7,12,32,37.5,20,15,1,14,9,33,19,0,0,2020-2021,90.0,46.55172413793103,124.13793103448276
497,Brendan Chardonnet,FRA,DF,Brest,Ligue 1,25,1994,30.2,51,29,31,19,1,27,41,65.9,14,54,41,13,64,115,151,0,0,2020-2021,90.0,190.72847682119206,151.98675496688742
498,Xavier Chavalerin,FRA,MF,Reims,Ligue 1,29,1991,28.3,92,50,47,38,7,26,74,35.1,48,43,9,34,43,135,29,1,0,2020-2021,90.0,136.74911660777383,292.57950530035333
499,Pape Cheikh Diop,SEN,MF,Dijon,Ligue 1,22,1997,12.1,24,14,15,6,3,13,33,39.4,20,14,2,12,6,30,6,0,0,2020-2021,90.0,44.628099173553714,178.51239669421486
500,Chema,ESP,"DF,MF",Getafe,La Liga,28,1992,6.2,11,5,6,5,0,5,7,71.4,2,1,0,1,10,21,23,0,0,2020-2021,90.0,145.16129032258064,159.67741935483872
Rk,Player,Nation,Pos,Squad,Comp,0,0,90.0,0,0,3,3,3,Tkl,0,0.0,0,0,0,0,0,0,0,0,0,2020-2021,90.0,0.0,0.0
501,Rayan Cherki,FRA,"FW,MF",Lyon,Ligue 1,16,2003,7.8,5,3,0,3,2,1,11,9.1,10,3,0,3,4,9,0,0,0,2020-2021,90.0,46.15384615384615,57.69230769230769
502,Denis Cheryshev,RUS,MF,Valencia,La Liga,29,1990,12.2,19,15,6,7,6,6,26,23.1,20,15,1,14,12,31,15,0,0,2020-2021,90.0,88.52459016393443,140.16393442622953
503,Giorgio Chiellini,ITA,DF,Juventus,Serie A,35,1984,15.4,12,9,9,3,0,5,11,45.5,6,18,13,5,27,39,56,0,0,2020-2021,90.0,157.7922077922078,70.12987012987013
504,Federico Chiesa,ITA,DF,Fiorentina,Serie A,22,1997,2.7,6,2,2,2,2,3,8,37.5,5,3,1,2,1,7,3,0,0,2020-2021,90.0,33.33333333333333,199.99999999999997
505,Federico Chiesa,ITA,"MF,DF",Juventus,Serie A,22,1997,24.6,47,26,21,14,12,19,50,38.0,31,23,1,22,12,59,16,0,0,2020-2021,89.99999999999999,43.90243902439024,171.9512195121951
506,Ben Chilwell,ENG,DF,Chelsea,Premier League,23,1996,25.4,42,22,16,22,4,15,33,45.5,18,28,3,25,24,66,58,0,0,2020-2021,90.0,85.03937007874016,148.8188976377953
507,Vlad Chiricheș,ROU,DF,Sassuolo,Serie A,30,1989,20.4,38,23,34,3,1,21,35,60.0,14,31,21,10,50,88,59,2,0,2020-2021,90.0,220.58823529411765,167.64705882352942
508,Pedro Chirivella,ESP,MF,Nantes,Ligue 1,23,1997,25.3,26,8,7,13,6,14,49,28.6,35,23,4,19,41,67,19,0,0,2020-2021,89.99999999999999,145.84980237154147,92.4901185770751
509,Tahith Chong,NED,"MF,FW",Werder Bremen,Bundesliga,20,1999,4.3,11,6,1,9,1,4,8,50.0,4,4,0,4,5,16,1,0,0,2020-2021,90.0,104.65116279069768,230.23255813953492
510,Joris Chotard,FRA,MF,Montpellier,Ligue 1,18,2001,12.9,12,8,5,6,1,6,31,19.4,25,12,3,9,11,23,15,0,0,2020-2021,90.0,76.74418604651163,83.72093023255813
511,Hamza Choudhury,ENG,MF,Leicester City,Premier League,22,1997,3.5,8,7,3,5,0,4,10,40.0,6,4,1,3,4,12,9,1,0,2020-2021,90.0,102.85714285714286,205.71428571428572
512,Mounir Chouiar,FRA,"FW,MF",Dijon,Ligue 1,21,1999,14.3,22,12,10,9,3,6,18,33.3,12,10,0,10,11,33,8,0,0,2020-2021,90.0,69.23076923076923,138.46153846153845
513,Andreas Christensen,DEN,DF,Chelsea,Premier League,24,1996,15.2,11,6,8,3,0,0,8,0.0,8,19,14,5,20,31,51,1,0,2020-2021,90.0,118.42105263157895,65.13157894736842
514,Carney Chukwuemeka,ENG,"MF,FW",Aston Villa,Premier League,16,2003,0.2,2,2,1,0,1,1,3,33.3,2,0,0,0,0,2,0,0,0,2020-2021,90.0,0.0,900.0
515,Samuel Chukwueze,NGA,"MF,FW",Villarreal,La Liga,21,1999,15.2,12,7,4,4,4,3,17,17.6,14,8,0,8,10,22,3,0,0,2020-2021,90.0,59.21052631578947,71.05263157894737
516,Darko Churlinov,MKD,"DF,MF",Stuttgart,Bundesliga,20,2000,2.4,2,2,2,0,0,1,3,33.3,2,5,1,4,0,2,2,0,0,2020-2021,90.0,0.0,75.0
517,Víctor Chust,ESP,DF,Real Madrid,La Liga,20,2000,1.1,1,1,0,1,0,0,2,0.0,2,2,2,0,1,2,5,0,0,2020-2021,90.0,81.81818181818181,81.81818181818181
518,Sébastien Cibois,FRA,GK,Brest,Ligue 1,22,1998,3.0,0,0,0,0,0,0,0,0.0,0,0,0,0,0,0,0,1,0,2020-2021,90.0,0.0,0.0
519,Cifu,ESP,DF,Elche,La Liga,29,1990,5.0,10,7,7,3,0,7,13,53.8,6,5,1,4,8,18,10,0,0,2020-2021,90.0,144.0,180.0
520,Alberto Cifuentes,ESP,GK,Cádiz,La Liga,41,1979,2.0,0,0,0,0,0,0,0,0.0,0,0,0,0,0,0,0,0,0,2020-2021,90.0,0.0,0.0
521,Luca Cigarini,ITA,MF,Crotone,Serie A,34,1986,10.3,26,14,11,12,3,12,28,42.9,16,10,1,9,12,38,9,0,0,2020-2021,90.0,104.85436893203884,227.18446601941747
522,Jasper Cillessen,NED,GK,Valencia,La Liga,31,1989,10.0,0,0,0,0,0,0,0,0.0,0,0,0,0,0,0,0,0,0,2020-2021,90.0,0.0,0.0
523,Antonio Cioffi,ITA,FW,Napoli,Serie A,17,2002,0.1,0,0,0,0,0,0,0,0.0,0,1,0,1,1,1,0,0,0,2020-2021,90.0,900.0,0.0
524,Tim Civeja,ALB,MF,Augsburg,Bundesliga,18,2002,0.4,0,0,0,0,0,0,1,0.0,1,0,0,0,3,3,0,0,0,2020-2021,90.0,675.0,0.0
525,Ciaran Clark,IRL,DF,Newcastle Utd,Premier League,30,1989,21.0,24,14,15,6,3,6,13,46.2,7,27,20,7,29,53,104,1,0,2020-2021,90.0,124.28571428571428,102.85714285714286
Rk,Player,Nation,Pos,Squad,Comp,0,0,90.0,0,0,3,3,3,Tkl,0,0.0,0,0,0,0,0,0,0,0,0,2020-2021,90.0,0.0,0.0
526,Alexis Claude-Maurice,FRA,"MF,FW",Nice,Ligue 1,22,1998,21.2,40,19,17,14,9,14,48,29.2,34,16,2,14,14,54,3,0,0,2020-2021,90.0,59.43396226415095,169.811320754717
527,Jonathan Clauss,FRA,DF,Lens,Ligue 1,27,1992,28.0,43,20,12,20,11,17,38,44.7,21,24,1,23,45,88,46,0,0,2020-2021,90.0,144.64285714285714,138.21428571428572
528,Carlos Clerc,ESP,DF,Levante,La Liga,28,1992,30.9,56,29,33,16,7,22,39,56.4,17,26,4,22,37,93,55,1,0,2020-2021,90.0,107.76699029126213,163.10679611650485
529,Nathaniel Clyne,ENG,DF,Crystal Palace,Premier League,29,1991,12.7,17,10,8,8,1,9,16,56.3,7,7,2,5,18,35,25,1,0,2020-2021,90.0,127.55905511811024,120.4724409448819
530,Conor Coady,ENG,DF,Wolves,Premier League,27,1993,36.7,35,23,25,10,0,19,35,54.3,16,40,32,8,27,62,134,2,0,2020-2021,90.0,66.2125340599455,85.83106267029973
531,Marcus Coco,FRA,"MF,FW",Nantes,Ligue 1,24,1996,16.4,36,21,17,15,4,16,36,44.4,20,16,3,13,20,56,17,0,0,2020-2021,90.0,109.75609756097562,197.56097560975613
532,Coke,ESP,DF,Levante,La Liga,33,1987,9.3,24,10,14,7,3,14,27,51.9,13,13,1,12,14,38,27,0,0,2020-2021,90.0,135.48387096774192,232.258064516129
533,Séamus Coleman,IRL,"DF,MF",Everton,Premier League,31,1988,17.9,39,26,21,14,4,21,30,70.0,9,22,6,16,13,52,37,2,0,2020-2021,90.0,65.36312849162012,196.08938547486036
534,Ebrima Colley,GAM,"MF,FW",Hellas Verona,Serie A,20,2000,8.2,11,4,2,6,3,3,11,27.3,8,6,0,6,6,17,1,0,0,2020-2021,90.0,65.85365853658537,120.73170731707319
535,Omar Colley,GAM,DF,Sampdoria,Serie A,27,1992,28.8,28,16,19,8,1,13,23,56.5,10,43,29,14,68,96,133,1,0,2020-2021,90.0,212.5,87.5
536,Simone Colombi,ITA,GK,Parma,Serie A,29,1991,2.0,0,0,0,0,0,0,0,0.0,0,0,0,0,0,0,2,0,0,2020-2021,90.0,0.0,0.0
537,Lorenzo Colombo,ITA,FW,Milan,Serie A,18,2002,1.0,2,1,1,1,0,0,3,0.0,3,0,0,0,0,2,3,0,0,2020-2021,90.0,0.0,180.0
538,Racine Coly,SEN,MF,Nice,Ligue 1,24,1995,0.2,0,0,0,0,0,0,0,0.0,0,0,0,0,0,0,0,0,0,2020-2021,90.0,0.0,0.0
539,Kingsley Coman,FRA,"FW,MF",Bayern Munich,Bundesliga,24,1996,19.5,14,8,6,7,1,2,21,9.5,19,22,0,22,4,18,3,0,0,2020-2021,90.0,18.46153846153846,64.61538461538461
540,Daniel Congré,FRA,DF,Montpellier,Ligue 1,35,1985,36.6,59,35,45,12,2,36,70,51.4,34,50,33,17,69,128,144,3,0,2020-2021,90.0,169.67213114754097,145.08196721311475
541,Aaron Connolly,IRL,FW,Brighton,Premier League,20,2000,8.8,6,3,1,3,2,0,2,0.0,2,4,0,4,0,6,2,0,0,2020-2021,90.0,0.0,61.36363636363636
542,Andrea Consigli,ITA,GK,Sassuolo,Serie A,33,1987,37.0,2,2,2,0,0,2,2,100.0,0,0,0,0,0,2,14,4,0,2020-2021,90.0,0.0,4.864864864864865
543,Andrea Conti,ITA,DF,Milan,Serie A,26,1994,0.3,1,1,1,0,0,0,1,0.0,1,0,0,0,1,2,0,0,0,2020-2021,90.0,300.0,300.0
544,Andrea Conti,ITA,DF,Parma,Serie A,26,1994,9.0,21,10,16,4,1,13,26,50.0,13,13,4,9,16,37,23,0,0,2020-2021,90.0,160.0,210.0
545,Liam Cooper,SCO,DF,Leeds United,Premier League,28,1991,24.3,68,45,39,27,2,37,59,62.7,22,39,32,7,61,129,70,1,0,2020-2021,90.0,225.92592592592592,251.85185185185185
546,Francis Coquelin,FRA,MF,Villarreal,La Liga,29,1991,8.2,19,14,4,12,3,8,19,42.1,11,8,2,6,21,40,11,1,0,2020-2021,90.0,230.48780487804882,208.53658536585368
547,Theo Corbeanu,CAN,FW,Wolves,Premier League,18,2002,0.1,2,1,0,2,0,1,1,100.0,0,0,0,0,1,3,0,0,0,2020-2021,90.0,900.0,1800.0
548,Sébastien Corchia,FRA,DF,Nantes,Ligue 1,29,1990,23.0,55,30,29,17,9,33,60,55.0,27,28,10,18,38,93,40,1,0,2020-2021,90.0,148.69565217391306,215.21739130434784
549,Alex Cordaz,ITA,GK,Crotone,Serie A,37,1983,36.0,0,0,0,0,0,0,0,0.0,0,0,0,0,1,1,7,2,0,2020-2021,90.0,2.5,0.0
550,Iñigo Córdoba,ESP,"FW,MF",Athletic Club,La Liga,23,1997,1.1,0,0,0,0,0,0,3,0.0,3,4,0,4,2,2,1,0,0,2020-2021,90.0,163.63636363636363,0.0
Rk,Player,Nation,Pos,Squad,Comp,0,0,90.0,0,0,3,3,3,Tkl,0,0.0,0,0,0,0,0,0,0,0,0,2020-2021,90.0,0.0,0.0
551,Iñigo Córdoba,ESP,MF,Alavés,La Liga,23,1997,2.4,6,4,1,3,2,2,10,20.0,8,7,0,7,3,9,2,0,0,2020-2021,90.0,112.50000000000001,225.00000000000003
552,Jhon Córdoba,COL,FW,Hertha BSC,Bundesliga,27,1993,17.1,9,4,1,5,3,2,4,50.0,2,13,2,11,6,15,4,0,0,2020-2021,90.0,31.57894736842105,47.368421052631575
553,Sergio Córdova,VEN,"FW,MF",Arminia,Bundesliga,22,1997,12.1,16,8,0,10,6,2,15,13.3,13,14,3,11,9,25,9,0,0,2020-2021,90.0,66.94214876033058,119.00826446280992
554,Jack Cork,ENG,MF,Burnley,Premier League,31,1989,15.0,26,10,5,17,4,11,31,35.5,20,15,4,11,16,42,20,0,0,2020-2021,90.0,96.0,156.0
555,Andreas Cornelius,DEN,FW,Parma,Serie A,27,1993,21.1,11,4,1,5,5,2,12,16.7,10,9,2,7,1,12,25,1,0,2020-2021,90.0,4.265402843601896,46.91943127962085
556,Maxwel Cornet,CIV,"DF,FW",Lyon,Ligue 1,23,1996,27.2,70,41,39,24,7,33,58,56.9,25,23,5,18,43,113,47,2,0,2020-2021,90.0,142.27941176470588,231.61764705882354
557,Ángel Correa,ARG,"FW,MF",Atlético Madrid,La Liga,25,1995,26.6,38,21,10,23,5,15,45,33.3,30,18,1,17,22,60,16,0,0,2020-2021,90.0,74.4360902255639,128.57142857142856
558,Joaquín Correa,ARG,FW,Lazio,Serie A,25,1994,21.5,21,12,6,11,4,7,25,28.0,18,14,0,14,7,28,12,0,0,2020-2021,90.0,29.302325581395348,87.90697674418604
559,Rober Correa,ESP,DF,Eibar,La Liga,27,1992,12.6,16,9,8,6,2,8,12,66.7,4,9,1,8,20,36,31,0,0,2020-2021,90.0,142.85714285714286,114.28571428571429
560,Félix Correia,POR,MF,Juventus,Serie A,19,2001,0.1,0,0,0,0,0,0,0,0.0,0,0,0,0,0,0,1,0,0,2020-2021,90.0,0.0,0.0
561,Thierry Correia,POR,DF,Valencia,La Liga,21,1999,23.7,47,27,32,10,5,21,43,48.8,22,24,6,18,42,89,63,1,0,2020-2021,90.0,159.49367088607596,178.48101265822785
562,Danny da Costa,GER,"DF,FW",Mainz 05,Bundesliga,27,1993,13.4,22,16,6,9,7,13,27,48.1,14,17,2,15,17,39,27,0,0,2020-2021,90.0,114.17910447761193,147.76119402985074
563,Danny da Costa,GER,DF,Eint Frankfurt,Bundesliga,27,1993,1.2,0,0,0,0,0,0,1,0.0,1,3,1,2,0,0,4,0,0,2020-2021,90.0,0.0,0.0
564,David Pereira da Costa,POR,"MF,FW",Lens,Ligue 1,19,2001,1.8,4,4,1,2,1,2,3,66.7,1,2,0,2,0,4,4,0,0,2020-2021,90.0,0.0,200.0
565,Diego Costa,ESP,FW,Atlético Madrid,La Liga,31,1988,2.3,1,0,1,0,0,1,3,33.3,2,0,0,0,0,1,2,0,0,2020-2021,90.0,0.0,39.130434782608695
566,Douglas Costa,BRA,"MF,FW",Juventus,Serie A,29,1990,0.5,1,0,1,0,0,1,3,33.3,2,0,0,0,0,1,0,0,0,2020-2021,90.0,0.0,180.0
567,Douglas Costa,BRA,"FW,MF",Bayern Munich,Bundesliga,29,1990,3.6,2,1,1,1,0,1,3,33.3,2,7,0,7,2,4,1,0,0,2020-2021,90.0,50.0,50.0
568,Hélder Costa,ANG,"MF,FW",Leeds United,Premier League,26,1994,12.8,25,11,12,5,8,11,32,34.4,21,11,0,11,3,28,5,1,0,2020-2021,90.0,21.09375,175.78125
569,Jaume Costa,ESP,"DF,MF",Villarreal,La Liga,32,1988,3.9,10,6,4,6,0,7,9,77.8,2,7,1,6,6,16,8,0,0,2020-2021,90.0,138.46153846153845,230.76923076923077
570,Angelo da Costa Júnior,BRA,GK,Bologna,Serie A,36,1983,6.0,0,0,0,0,0,0,0,0.0,0,0,0,0,0,0,2,3,0,2020-2021,90.0,0.0,0.0
571,Charles Costes,FRA,MF,Dijon,Ligue 1,17,2002,0.0,0,0,0,0,0,0,0,0.0,0,0,0,0,0,0,0,0,0,2020-2021,,,
572,Benoît Costil,FRA,GK,Bordeaux,Ligue 1,33,1987,38.0,1,1,1,0,0,1,3,33.3,2,1,0,1,1,2,17,0,0,2020-2021,90.0,2.3684210526315788,2.3684210526315788
573,Vladimír Coufal,CZE,DF,West Ham,Premier League,27,1992,33.9,73,36,50,15,8,52,89,58.4,37,41,7,34,41,114,102,1,0,2020-2021,90.0,108.8495575221239,193.8053097345133
574,Kalifa Coulibaly,MLI,FW,Nantes,Ligue 1,28,1991,10.9,3,1,0,1,2,2,8,25.0,6,3,1,2,2,5,12,0,0,2020-2021,90.0,16.513761467889907,24.77064220183486
575,Lassana Coulibaly,MLI,MF,Angers,Ligue 1,24,1996,18.7,78,41,33,34,11,39,75,52.0,36,29,4,25,33,111,17,0,0,2020-2021,90.0,158.8235294117647,375.40106951871655
Rk,Player,Nation,Pos,Squad,Comp,0,0,90.0,0,0,3,3,3,Tkl,0,0.0,0,0,0,0,0,0,0,0,0,2020-2021,90.0,0.0,0.0
576,Mamadou Coulibaly,SEN,MF,Udinese,Serie A,21,1999,2.0,10,8,5,5,0,0,0,0.0,0,2,0,2,1,11,0,0,0,2020-2021,90.0,45.0,450.0
577,Senou Coulibaly,MLI,DF,Dijon,Ligue 1,25,1994,21.5,33,21,23,10,0,12,24,50.0,12,18,12,6,30,63,89,0,0,2020-2021,90.0,125.5813953488372,138.13953488372093
578,Tanguy Coulibaly,FRA,"DF,FW",Stuttgart,Bundesliga,19,2001,16.7,26,15,10,7,9,11,23,47.8,12,20,0,20,10,36,11,0,0,2020-2021,90.0,53.89221556886228,140.11976047904193
579,Thibaut Courtois,BEL,GK,Real Madrid,La Liga,28,1992,38.0,0,0,0,0,0,0,1,0.0,1,1,0,1,1,1,17,2,0,2020-2021,90.0,2.3684210526315788,0.0
580,Philippe Coutinho,BRA,"MF,FW",Barcelona,La Liga,28,1992,7.3,8,6,2,5,1,3,9,33.3,6,7,0,7,2,10,1,0,0,2020-2021,90.0,24.657534246575345,98.63013698630138
581,Nicolas Cozza,FRA,DF,Montpellier,Ligue 1,21,1999,15.2,39,30,27,11,1,20,40,50.0,20,20,11,9,26,65,62,0,0,2020-2021,90.0,153.94736842105263,230.92105263157893
582,Alessio Cragno,ITA,GK,Cagliari,Serie A,26,1994,34.0,0,0,0,0,0,0,1,0.0,1,0,0,0,1,1,10,0,0,2020-2021,90.0,2.6470588235294117,0.0
583,Gian Crespi,ITA,GK,Crotone,Serie A,19,2001,1.0,0,0,0,0,0,0,0,0.0,0,0,0,0,0,0,0,0,0,2020-2021,90.0,0.0,0.0
584,Aaron Cresswell,ENG,DF,West Ham,Premier League,30,1989,35.2,32,13,15,15,2,18,32,56.3,14,29,14,15,32,64,79,2,0,2020-2021,90.0,81.81818181818181,81.81818181818181
585,Domenico Criscito,ITA,DF,Genoa,Serie A,33,1986,19.2,43,22,29,11,3,22,39,56.4,17,27,14,13,44,87,51,0,0,2020-2021,90.0,206.25,201.5625
586,Bryan Cristante,ITA,"DF,MF",Roma,Serie A,25,1995,23.9,27,20,10,14,3,10,28,35.7,18,21,7,14,40,67,61,1,0,2020-2021,90.0,150.62761506276152,101.67364016736403
587,Giovanni Crociata,ITA,DF,Crotone,Serie A,22,1997,0.3,1,0,0,1,0,0,1,0.0,1,1,0,1,0,1,0,0,0,2020-2021,90.0,0.0,300.0
588,Juan Cruz Armada,ESP,DF,Osasuna,La Liga,28,1992,21.8,36,22,17,16,3,19,35,54.3,16,19,5,14,15,51,50,0,0,2020-2021,90.0,61.92660550458715,148.62385321100916
589,Juan Cuadrado,COL,"DF,MF",Juventus,Serie A,32,1988,24.2,43,25,22,15,6,29,60,48.3,31,16,2,14,43,86,22,2,0,2020-2021,90.0,159.9173553719008,159.9173553719008
590,Andrés Cubas,PAR,MF,Nîmes,Ligue 1,24,1996,24.9,80,47,30,44,6,33,74,44.6,41,37,10,27,50,130,29,3,0,2020-2021,90.0,180.72289156626505,289.1566265060241
591,Sergio Cubero Ezcurra,ESP,MF,Eibar,La Liga,20,1999,0.0,0,0,0,0,0,0,0,0.0,0,0,0,0,0,0,0,0,0,2020-2021,,,
592,Cucho,COL,"FW,MF",Getafe,La Liga,21,1999,16.3,19,10,1,14,4,2,23,8.7,21,18,1,17,6,25,8,0,0,2020-2021,90.0,33.12883435582822,104.9079754601227
593,Marc Cucurella,ESP,MF,Getafe,La Liga,22,1998,36.0,64,51,19,40,5,25,66,37.9,41,45,4,41,40,104,27,0,0,2020-2021,90.0,100.0,160.0
594,Mickaël Cuisance,FRA,MF,Marseille,Ligue 1,20,1999,11.4,24,11,2,15,7,10,33,30.3,23,13,1,12,3,27,4,0,0,2020-2021,90.0,23.684210526315788,189.4736842105263
595,Mickaël Cuisance,FRA,FW,Bayern Munich,Bundesliga,20,1999,0.2,0,0,0,0,0,0,0,0.0,0,1,0,1,0,0,0,0,0,2020-2021,90.0,0.0,0.0
596,Matheus Cunha,BRA,"FW,MF",Hertha BSC,Bundesliga,21,1999,23.9,36,16,10,19,7,13,49,26.5,36,29,2,27,31,67,9,0,0,2020-2021,90.0,116.73640167364017,135.56485355648536
597,Giuseppe Cuomo,ITA,DF,Crotone,Serie A,22,1998,8.9,26,19,17,9,0,9,14,64.3,5,10,2,8,18,44,19,1,0,2020-2021,90.0,182.02247191011236,262.92134831460675
598,Patrick Cutrone,ITA,FW,Wolves,Premier League,22,1998,0.3,0,0,0,0,0,0,0,0.0,0,0,0,0,0,0,0,0,0,2020-2021,90.0,0.0,0.0
599,Patrick Cutrone,ITA,FW,Fiorentina,Serie A,22,1998,2.2,4,3,1,2,1,1,2,50.0,1,1,0,1,1,5,0,0,0,2020-2021,90.0,40.90909090909091,163.63636363636363
600,Patrick Cutrone,ITA,FW,Valencia,La Liga,22,1998,1.2,0,0,0,0,0,0,1,0.0,1,0,0,0,1,1,0,0,0,2020-2021,90.0,75.0,0.0
Rk,Player,Nation,Pos,Squad,Comp,0,0,90.0,0,0,3,3,3,Tkl,0,0.0,0,0,0,0,0,0,0,0,0,2020-2021,90.0,0.0,0.0
601,Wylan Cyprien,FRA,MF,Parma,Serie A,25,1995,4.6,9,4,5,3,1,2,4,50.0,2,13,8,5,5,14,6,1,0,2020-2021,90.0,97.82608695652175,176.08695652173915
602,Rafael Czichos,GER,DF,Köln,Bundesliga,30,1990,25.1,48,24,33,13,2,23,42,54.8,19,25,9,16,53,101,109,0,0,2020-2021,90.0,190.0398406374502,172.11155378486055
603,Lennart-Marten Czyborra,GER,DF,Genoa,Serie A,21,1999,13.0,19,10,7,7,5,11,19,57.9,8,6,1,5,17,36,27,0,0,2020-2021,90.00000000000001,117.69230769230771,131.53846153846155
604,Danilo D'Ambrosio,ITA,DF,Inter,Serie A,31,1988,7.8,15,9,6,7,2,6,15,40.0,9,9,7,2,4,19,15,0,0,2020-2021,90.0,46.15384615384615,173.07692307692307
605,Damien Da Silva,FRA,DF,Rennes,Ligue 1,32,1988,29.6,22,13,13,8,1,12,18,66.7,6,17,13,4,44,66,99,1,0,2020-2021,90.0,133.78378378378378,66.89189189189189
606,Moanes Dabbur,ISR,"FW,MF",Hoffenheim,Bundesliga,28,1992,11.1,6,3,3,1,2,1,13,7.7,12,6,0,6,9,15,7,0,0,2020-2021,90.0,72.97297297297298,48.64864864864865
607,Bryan Dabo,BFA,MF,Benevento,Serie A,28,1992,12.4,11,8,5,3,3,5,16,31.3,11,7,1,6,13,24,16,0,0,2020-2021,90.0,94.35483870967742,79.83870967741936
608,Colin Dagba,FRA,DF,Paris S-G,Ligue 1,21,1998,15.1,23,11,4,17,2,14,19,73.7,5,18,5,13,16,39,18,1,0,2020-2021,90.0,95.36423841059603,137.08609271523179
609,Finn Dahmen,GER,GK,Mainz 05,Bundesliga,22,1998,3.0,0,0,0,0,0,0,1,0.0,1,0,0,0,0,0,1,0,0,2020-2021,90.0,0.0,0.0
610,Mahmoud Dahoud,GER,MF,Dortmund,Bundesliga,24,1996,14.0,30,18,9,20,1,14,38,36.8,24,23,5,18,18,48,11,1,0,2020-2021,90.0,115.71428571428571,192.85714285714286
611,Leon Dajaku,GER,FW,Union Berlin,Bundesliga,19,2001,0.4,0,0,0,0,0,0,0,0.0,0,0,0,0,0,0,0,0,0,2020-2021,90.0,0.0,0.0
612,Stuart Dallas,NIR,"MF,DF",Leeds United,Premier League,29,1991,37.9,74,45,46,22,6,30,88,34.1,58,41,3,38,44,118,52,1,0,2020-2021,90.0,104.48548812664907,175.72559366754618
613,Diogo Dalot,POR,DF,Milan,Serie A,21,1999,12.1,32,17,23,6,3,17,34,50.0,17,18,5,13,25,57,42,0,0,2020-2021,90.0,185.9504132231405,238.01652892561984
614,Mikkel Damsgaard,DEN,"MF,FW",Sampdoria,Serie A,20,2000,19.7,42,21,14,20,8,22,70,31.4,48,40,4,36,24,66,17,0,0,2020-2021,90.0,109.64467005076142,191.87817258883248
615,Flavius Daniliuc,AUT,DF,Nice,Ligue 1,19,2001,16.4,23,15,15,5,3,10,21,47.6,11,17,6,11,14,37,32,0,0,2020-2021,90.0,76.82926829268294,126.21951219512196
616,Danilo,BRA,"DF,MF",Juventus,Serie A,29,1991,32.4,62,31,37,16,9,35,66,53.0,31,32,12,20,66,128,68,2,0,2020-2021,90.0,183.33333333333334,172.22222222222223
617,Scott Dann,ENG,DF,Crystal Palace,Premier League,33,1987,15.0,6,4,5,1,0,4,11,36.4,7,16,14,2,18,24,59,1,0,2020-2021,90.0,108.0,36.0
618,Tiago Dantas,POR,MF,Bayern Munich,Bundesliga,19,2000,0.8,1,1,0,0,1,0,0,0.0,0,0,0,0,0,1,0,0,0,2020-2021,90.0,0.0,112.5
619,Dante,BRA,DF,Nice,Ligue 1,36,1983,8.6,10,5,6,4,0,3,7,42.9,4,6,4,2,10,20,20,0,0,2020-2021,90.0,104.65116279069768,104.65116279069768
620,Andrea Danzi,ITA,DF,Hellas Verona,Serie A,21,1999,1.2,0,0,0,0,0,0,1,0.0,1,0,0,0,3,3,1,0,0,2020-2021,90.0,225.00000000000003,0.0
621,Ebrima Darboe,GAM,MF,Roma,Serie A,19,2001,3.6,5,2,3,1,1,3,10,30.0,7,3,0,3,8,13,0,1,0,2020-2021,90.0,200.0,125.0
622,Márton Dárdai,HUN,"DF,MF",Hertha BSC,Bundesliga,18,2002,9.1,17,10,10,6,1,9,16,56.3,7,7,3,4,16,33,31,0,0,2020-2021,90.0,158.24175824175825,168.13186813186815
623,Vladimír Darida,CZE,MF,Hertha BSC,Bundesliga,29,1990,21.1,34,19,11,19,4,9,31,29.0,22,34,2,32,27,61,18,0,0,2020-2021,90.0,115.16587677725119,145.02369668246445
624,Karl Darlow,ENG,GK,Newcastle Utd,Premier League,29,1990,25.0,0,0,0,0,0,0,0,0.0,0,0,0,0,0,0,17,0,0,2020-2021,90.0,0.0,0.0
625,Matteo Darmian,ITA,DF,Parma,Serie A,30,1989,2.3,6,5,3,3,0,4,7,57.1,3,2,0,2,6,12,7,0,0,2020-2021,90.0,234.7826086956522,234.7826086956522
Rk,Player,Nation,Pos,Squad,Comp,0,0,90.0,0,0,3,3,3,Tkl,0,0.0,0,0,0,0,0,0,0,0,0,2020-2021,90.0,0.0,0.0
626,Matteo Darmian,ITA,DF,Inter,Serie A,30,1989,12.9,30,16,12,7,11,16,28,57.1,12,9,2,7,17,47,35,0,0,2020-2021,90.0,118.60465116279069,209.30232558139534
627,Jonathan David,CAN,FW,Lille,Ligue 1,20,2000,26.2,17,10,5,5,7,9,24,37.5,15,19,1,18,3,20,9,0,0,2020-2021,90.0,10.305343511450381,58.396946564885496
628,Alphonso Davies,CAN,DF,Bayern Munich,Bundesliga,19,2000,19.6,39,27,16,17,6,28,40,70.0,12,21,1,20,28,67,33,1,0,2020-2021,90.0,128.57142857142856,179.0816326530612
629,Ben Davies,WAL,DF,Tottenham,Premier League,27,1993,15.0,27,17,10,11,6,13,30,43.3,17,10,5,5,18,45,49,2,0,2020-2021,90.0,108.0,162.0
630,Tom Davies,ENG,MF,Everton,Premier League,22,1998,15.8,31,18,17,12,2,16,39,41.0,23,15,9,6,34,65,21,2,0,2020-2021,90.0,193.67088607594934,176.58227848101265
631,Keinan Davis,ENG,"FW,MF",Aston Villa,Premier League,22,1998,3.1,2,1,1,0,1,0,1,0.0,1,1,0,1,0,2,2,0,0,2020-2021,90.0,0.0,58.064516129032256
632,Leif Davis,ENG,DF,Leeds United,Premier League,20,2000,0.4,0,0,0,0,0,0,3,0.0,3,1,0,1,1,1,0,0,0,2020-2021,90.0,225.0,0.0
633,Paweł Dawidowicz,POL,DF,Hellas Verona,Serie A,25,1995,20.7,42,28,30,10,2,14,24,58.3,10,28,19,9,27,69,62,1,0,2020-2021,90.0,117.3913043478261,182.60869565217394
634,Craig Dawson,ENG,DF,West Ham,Premier League,30,1990,21.4,11,8,7,4,0,5,12,41.7,7,26,22,4,32,43,88,3,0,2020-2021,90.0,134.57943925233647,46.26168224299066
635,Kevin De Bruyne,BEL,MF,Manchester City,Premier League,29,1991,22.2,34,21,6,18,10,13,48,27.1,35,26,1,25,9,43,10,0,0,2020-2021,90.0,36.48648648648649,137.83783783783784
636,Sebastien De Maio,FRA,DF,Udinese,Serie A,33,1987,9.5,15,10,6,9,0,4,5,80.0,1,16,9,7,18,33,41,0,0,2020-2021,90.0,170.52631578947367,142.10526315789474
637,Rodrigo De Paul,ARG,MF,Udinese,Serie A,26,1994,35.6,41,24,17,22,2,15,60,25.0,45,32,1,31,17,58,20,1,0,2020-2021,90.0,42.97752808988764,103.65168539325843
638,Mattia De Sciglio,ITA,DF,Juventus,Serie A,27,1992,0.3,0,0,0,0,0,0,0,0.0,0,0,0,0,0,0,1,0,0,2020-2021,90.0,0.0,0.0
639,Mattia De Sciglio,ITA,DF,Lyon,Ligue 1,27,1992,16.3,29,17,15,11,3,18,27,66.7,9,13,4,9,27,56,44,0,0,2020-2021,90.0,149.079754601227,160.12269938650306
640,Lorenzo De Silvestri,ITA,DF,Bologna,Serie A,32,1988,23.8,34,24,18,13,3,16,37,43.2,21,37,10,27,30,64,62,3,0,2020-2021,90.00000000000001,113.44537815126051,128.57142857142858
641,Thibault De Smet,BEL,DF,Reims,Ligue 1,22,1998,5.5,11,6,8,3,0,6,15,40.0,9,8,1,7,6,17,16,0,0,2020-2021,90.0,98.18181818181819,180.0
642,Lucas Deaux,FRA,"MF,DF",Nîmes,Ligue 1,31,1988,19.5,47,32,20,22,5,16,49,32.7,33,20,3,17,20,67,30,4,0,2020-2021,90.0,92.3076923076923,216.9230769230769
643,Mathieu Debuchy,FRA,DF,Saint-Étienne,Ligue 1,35,1985,23.4,58,33,37,17,4,40,62,64.5,22,27,9,18,45,103,61,0,0,2020-2021,89.99999999999999,173.07692307692307,223.07692307692307
644,Grégoire Defrel,MTQ,"MF,FW",Sassuolo,Serie A,29,1991,14.8,13,8,5,5,3,5,13,38.5,8,9,0,9,7,20,5,0,0,2020-2021,90.0,42.567567567567565,79.05405405405405
645,Alessandro Deiola,ITA,MF,Spezia,Serie A,24,1995,4.0,6,3,2,3,1,5,13,38.5,8,3,1,2,3,9,1,0,0,2020-2021,90.0,67.5,135.0
646,Alessandro Deiola,ITA,MF,Cagliari,Serie A,24,1995,6.8,13,5,5,4,4,8,23,34.8,15,7,2,5,11,24,11,0,0,2020-2021,90.0,145.58823529411765,172.05882352941177
647,Romain Del Castillo,FRA,"MF,FW",Rennes,Ligue 1,24,1996,7.2,30,11,5,14,11,5,25,20.0,20,6,0,6,3,33,4,1,0,2020-2021,90.0,37.5,375.0
648,Lorenzo Del Pinto,ITA,MF,Benevento,Serie A,30,1990,0.1,0,0,0,0,0,0,2,0.0,2,0,0,0,0,0,0,0,0,2020-2021,90.0,0.0,0.0
649,Thomas Delaine,FRA,"DF,FW",Metz,Ligue 1,28,1992,19.8,32,18,19,11,2,20,35,57.1,15,22,5,17,24,56,30,1,0,2020-2021,90.0,109.0909090909091,145.45454545454547
650,Thomas Delaney,DEN,MF,Dortmund,Bundesliga,28,1991,14.3,40,30,15,20,5,11,31,35.5,20,28,10,18,22,62,15,1,0,2020-2021,90.0,138.46153846153845,251.74825174825176
Rk,Player,Nation,Pos,Squad,Comp,0,0,90.0,0,0,3,3,3,Tkl,0,0.0,0,0,0,0,0,0,0,0,0,2020-2021,90.0,0.0,0.0
651,Liam Delap,ENG,FW,Manchester City,Premier League,17,2003,0.4,0,0,0,0,0,0,0,0.0,0,0,0,0,0,0,0,0,0,2020-2021,90.0,0.0,0.0
652,Jonathan Delaplace,FRA,DF,Lorient,Ligue 1,34,1986,10.1,8,5,5,1,2,7,13,53.8,6,12,5,7,17,25,19,1,0,2020-2021,90.0,151.4851485148515,71.2871287128713
653,Sacha Delaye,FRA,MF,Montpellier,Ligue 1,18,2002,0.1,0,0,0,0,0,0,1,0.0,1,0,0,0,1,1,1,0,0,2020-2021,90.0,900.0,0.0
654,Cristian Dell'Orco,ITA,DF,Spezia,Serie A,26,1994,2.9,1,0,1,0,0,1,3,33.3,2,8,5,3,7,8,9,1,0,2020-2021,90.0,217.24137931034483,31.03448275862069
655,Andy Delort,ALG,FW,Montpellier,Ligue 1,28,1991,27.6,12,7,1,9,2,8,18,44.4,10,11,1,10,4,16,34,0,0,2020-2021,90.0,13.043478260869565,39.13043478260869
656,Fabian Delph,ENG,"MF,DF",Everton,Premier League,30,1989,3.0,5,2,3,2,0,1,3,33.3,2,2,0,2,4,9,8,1,0,2020-2021,90.0,120.0,150.0
657,Moussa Dembélé,FRA,FW,Atlético Madrid,La Liga,24,1996,1.1,0,0,0,0,0,0,1,0.0,1,0,0,0,1,1,0,0,0,2020-2021,90.0,81.81818181818181,0.0
658,Moussa Dembélé,FRA,FW,Lyon,Ligue 1,24,1996,7.5,2,2,0,1,1,0,4,0.0,4,4,2,2,5,7,9,0,0,2020-2021,90.0,60.0,24.0
659,Ousmane Dembélé,FRA,FW,Barcelona,La Liga,23,1997,19.7,14,9,4,9,1,6,17,35.3,11,10,0,10,9,23,3,1,0,2020-2021,90.0,41.11675126903553,63.95939086294416
660,Merih Demiral,TUR,DF,Juventus,Serie A,22,1998,10.4,12,9,8,4,0,5,13,38.5,8,16,9,7,21,33,40,0,0,2020-2021,90.0,181.73076923076923,103.84615384615384
661,Kerem Demirbay,GER,MF,Leverkusen,Bundesliga,27,1993,19.4,46,31,15,26,5,19,38,50.0,19,21,4,17,8,54,6,1,0,2020-2021,90.0,37.11340206185567,213.40206185567013
662,Ermedin Demirović,BIH,FW,Freiburg,Bundesliga,22,1998,16.6,15,9,4,6,5,2,16,12.5,14,29,5,24,0,15,27,0,0,2020-2021,90.0,0.0,81.32530120481927
663,Diego Demme,GER,MF,Napoli,Serie A,28,1991,17.7,56,32,26,22,8,23,63,36.5,40,14,1,13,11,67,15,1,0,2020-2021,90.0,55.93220338983051,284.7457627118644
664,Jason Denayer,BEL,DF,Lyon,Ligue 1,25,1995,29.0,25,16,16,9,0,6,13,46.2,7,36,25,11,27,52,91,1,0,2020-2021,90.0,83.79310344827586,77.58620689655172
665,Leander Dendoncker,BEL,"MF,DF",Wolves,Premier League,25,1995,27.8,54,29,29,22,3,31,60,51.7,29,38,15,23,27,81,52,2,0,2020-2021,90.0,87.41007194244605,174.8201438848921
666,Kévin Denkey,TOG,FW,Nîmes,Ligue 1,19,2000,5.8,4,2,0,3,1,0,3,0.0,3,2,0,2,1,5,2,0,0,2020-2021,90.0,15.517241379310345,62.06896551724138
667,Emmanuel Dennis,NGA,FW,Köln,Bundesliga,22,1997,5.3,13,7,6,5,2,1,6,16.7,5,6,0,6,0,13,0,1,0,2020-2021,90.0,0.0,220.75471698113208
668,Stefano Denswil,SUR,DF,Bologna,Serie A,27,1993,1.3,2,1,1,1,0,0,1,0.0,1,1,0,1,1,3,1,0,0,2020-2021,90.0,69.23076923076923,138.46153846153845
669,Fabio Depaoli,ITA,DF,Benevento,Serie A,23,1997,12.4,25,13,15,6,4,15,32,46.9,17,16,4,12,12,37,38,0,0,2020-2021,90.0,87.09677419354838,181.4516129032258
670,Fabio Depaoli,ITA,MF,Sampdoria,Serie A,23,1997,0.9,1,0,0,1,0,0,2,0.0,2,0,0,0,1,2,1,0,0,2020-2021,90.0,100.0,100.0
671,Fabio Depaoli,ITA,DF,Atalanta,Serie A,23,1997,2.1,3,2,0,1,2,1,2,50.0,1,4,0,4,3,6,2,0,0,2020-2021,90.0,128.57142857142856,128.57142857142856
672,Clément Depres,FRA,FW,Nîmes,Ligue 1,25,1994,0.2,0,0,0,0,0,0,0,0.0,0,0,0,0,0,0,0,0,0,2020-2021,90.0,0.0,0.0
673,Mike van der Hoorn,NED,DF,Arminia,Bundesliga,27,1992,15.1,8,4,3,5,0,1,3,33.3,2,12,8,4,27,35,73,0,0,2020-2021,90.0,160.9271523178808,47.682119205298015
674,Kastriot Dermaku,ALB,DF,Parma,Serie A,28,1992,1.1,1,1,1,0,0,0,0,0.0,0,2,1,1,2,3,8,0,0,2020-2021,90.0,163.63636363636363,81.81818181818181
675,Kiril Despodov,BUL,FW,Cagliari,Serie A,23,1996,0.1,1,1,0,1,0,1,1,100.0,0,0,0,0,0,1,0,0,0,2020-2021,90.0,0.0,900.0
Rk,Player,Nation,Pos,Squad,Comp,0,0,90.0,0,0,3,3,3,Tkl,0,0.0,0,0,0,0,0,0,0,0,0,2020-2021,90.0,0.0,0.0
676,Sergiño Dest,USA,"DF,FW",Barcelona,La Liga,19,2000,21.2,31,16,23,6,2,18,32,56.3,14,25,4,21,10,41,24,1,0,2020-2021,90.0,42.45283018867925,131.60377358490567
677,Mattia Destro,ITA,FW,Genoa,Serie A,29,1991,17.8,6,3,0,3,3,2,9,22.2,7,11,0,11,4,10,8,0,0,2020-2021,90.0,20.224719101123597,30.337078651685395
678,Gerard Deulofeu,ESP,"FW,MF",Udinese,Serie A,26,1994,6.6,2,2,1,1,0,2,12,16.7,10,2,0,2,3,5,0,0,0,2020-2021,90.0,40.90909090909091,27.272727272727273
679,Deyverson,BRA,FW,Alavés,La Liga,29,1991,9.7,6,4,3,1,2,2,13,15.4,11,9,0,9,9,15,13,0,0,2020-2021,90.0,83.50515463917527,55.67010309278351
680,Jacopo Dezi,ITA,"FW,MF",Parma,Serie A,28,1992,0.9,4,3,0,2,2,3,6,50.0,3,2,0,2,0,4,0,0,0,2020-2021,90.0,0.0,400.0
681,Samuel Di Carmine,ITA,FW,Hellas Verona,Serie A,31,1988,5.6,1,2,0,1,0,0,3,0.0,3,1,0,1,0,1,5,0,0,2020-2021,90.0,0.0,16.071428571428573
682,Samuel Di Carmine,ITA,FW,Crotone,Serie A,31,1988,5.3,2,2,1,0,1,1,3,33.3,2,2,0,2,0,2,5,0,0,2020-2021,90.0,0.0,33.9622641509434
683,Giovanni Di Lorenzo,ITA,DF,Napoli,Serie A,26,1993,36.0,79,50,54,21,4,43,75,57.3,32,37,13,24,35,114,64,1,0,2020-2021,90.0,87.5,197.5
684,Ángel Di María,ARG,"FW,MF",Paris S-G,Ligue 1,32,1988,20.6,26,17,6,8,12,11,45,24.4,34,14,1,13,6,32,7,0,0,2020-2021,90.0,26.21359223300971,113.59223300970874
685,Alessandro Di Pardo,ITA,"FW,DF",Juventus,Serie A,21,1999,0.2,0,0,0,0,0,0,0,0.0,0,1,1,0,0,0,0,0,0,2020-2021,90.0,0.0,0.0
686,Giuseppe Di Serio,ITA,"FW,MF",Benevento,Serie A,19,2001,3.2,2,2,1,1,0,0,4,0.0,4,5,0,5,0,2,4,0,0,2020-2021,90.0,0.0,56.25
687,Boulaye Dia,SEN,"FW,MF",Reims,Ligue 1,23,1996,32.6,23,12,3,11,9,4,22,18.2,18,19,5,14,12,35,37,1,0,2020-2021,90.0,33.12883435582822,63.49693251533742
688,Abdoulay Diaby,MLI,DF,Getafe,La Liga,29,1991,0.2,2,0,0,2,0,0,0,0.0,0,2,0,2,0,2,0,0,0,2020-2021,90.0,0.0,900.0
689,Moussa Diaby,FRA,"FW,MF",Leverkusen,Bundesliga,21,1999,26.5,10,6,4,5,1,6,20,30.0,14,11,0,11,12,22,5,0,0,2020-2021,90.0,40.75471698113208,33.9622641509434
690,Mbaye Diagne,SEN,FW,West Brom,Premier League,28,1991,13.2,4,3,3,0,1,1,4,25.0,3,2,1,1,1,5,16,0,0,2020-2021,90.0,6.818181818181818,27.272727272727273
691,Mouctar Diakhaby,GUI,DF,Valencia,La Liga,23,1996,23.1,16,8,10,6,0,8,12,66.7,4,28,21,7,27,43,102,1,0,2020-2021,89.99999999999999,105.19480519480518,62.33766233766233
692,Abdou Diallo,SEN,DF,Paris S-G,Ligue 1,24,1996,16.6,16,11,9,5,2,8,13,61.5,5,15,8,7,25,41,36,0,0,2020-2021,90.0,135.5421686746988,86.74698795180721
693,Amad Diallo,CIV,FW,Manchester Utd,Premier League,18,2002,1.8,3,3,1,2,0,0,0,0.0,0,2,1,1,0,3,1,0,0,2020-2021,90.0,0.0,150.0
694,Amad Diallo,CIV,MF,Atalanta,Serie A,18,2002,0.2,0,0,0,0,0,0,0,0.0,0,0,0,0,0,0,0,0,0,2020-2021,90.0,0.0,0.0
695,Habib Diallo,SEN,FW,Strasbourg,Ligue 1,25,1995,25.8,11,6,3,6,2,7,18,38.9,11,12,2,10,13,24,12,0,0,2020-2021,90.0,45.348837209302324,38.372093023255815
696,Habib Diallo,SEN,"FW,MF",Metz,Ligue 1,25,1995,1.6,1,1,0,1,0,1,1,100.0,0,0,0,0,0,1,5,0,0,2020-2021,90.0,0.0,56.25
697,Ibrahima Diallo,FRA,MF,Southampton,Premier League,21,1999,11.3,29,16,11,17,1,9,16,56.3,7,10,1,9,10,39,12,2,0,2020-2021,90.0,79.64601769911505,230.97345132743362
698,Ibrahima Diallo,FRA,MF,Brest,Ligue 1,21,1999,4.9,14,9,2,9,3,4,8,50.0,4,4,0,4,3,17,3,0,0,2020-2021,90.0,55.10204081632653,257.1428571428571
699,Amadou Diambo,GHA,FW,Benevento,Serie A,19,2001,0.0,0,0,0,0,0,0,0,0.0,0,0,0,0,0,0,0,0,0,2020-2021,,,
700,Grady Diangana,COD,"MF,FW",West Brom,Premier League,22,1998,13.7,35,19,19,9,7,19,43,44.2,24,16,2,14,16,51,9,0,0,2020-2021,90.0,105.1094890510949,229.9270072992701
Rk,Player,Nation,Pos,Squad,Comp,0,0,90.0,0,0,3,3,3,Tkl,0,0.0,0,0,0,0,0,0,0,0,0,2020-2021,90.0,0.0,0.0
701,Stéphane Diarra,FRA,"MF,FW",Lorient,Ligue 1,21,1998,2.2,0,0,0,0,0,0,7,0.0,7,6,1,5,4,4,1,0,0,2020-2021,90.0,163.63636363636363,0.0
702,Rúben Dias,POR,DF,Manchester City,Premier League,23,1997,31.6,24,13,13,8,3,4,16,25.0,12,31,23,8,35,59,92,0,0,2020-2021,90.0,99.68354430379746,68.35443037974683
703,Krépin Diatta,SEN,"MF,DF",Monaco,Ligue 1,21,1999,4.3,4,3,1,1,2,1,3,33.3,2,5,1,4,4,8,1,0,0,2020-2021,90.0,83.72093023255815,83.72093023255815
704,Amadou Diawara,GUI,MF,Roma,Serie A,23,1997,7.3,10,8,4,6,0,2,8,25.0,6,11,2,9,12,22,4,0,0,2020-2021,90.0,147.94520547945206,123.28767123287672
705,Brahim Díaz,MAR,"MF,FW",Milan,Serie A,20,1999,13.6,18,10,7,7,4,10,23,43.5,13,10,0,10,2,20,2,0,0,2020-2021,90.0,13.235294117647058,119.11764705882352
706,Víctor Díaz,ESP,DF,Granada,La Liga,32,1988,9.2,21,10,13,6,2,10,19,52.6,9,14,8,6,16,37,39,0,0,2020-2021,90.0,156.52173913043478,205.43478260869566
707,Daniel Didavi,GER,"MF,FW",Stuttgart,Bundesliga,30,1990,10.8,16,6,2,9,5,7,12,58.3,5,10,0,10,3,19,8,0,0,2020-2021,90.0,24.999999999999996,133.33333333333331
708,Bamba Dieng,SEN,"FW,DF",Marseille,Ligue 1,20,2000,1.4,5,3,3,2,0,2,4,50.0,2,2,0,2,0,5,0,0,0,2020-2021,90.0,0.0,321.42857142857144
709,Eric Dier,ENG,DF,Tottenham,Premier League,26,1994,28.0,23,14,13,10,0,11,18,61.1,7,37,31,6,23,46,123,3,0,2020-2021,90.0,73.92857142857143,73.92857142857143
710,Daan Dierckx,BEL,DF,Parma,Serie A,17,2003,5.2,5,4,5,0,0,3,5,60.0,2,10,6,4,13,18,21,0,0,2020-2021,90.0,224.99999999999997,86.53846153846153
711,Lucas Digne,FRA,"DF,MF",Everton,Premier League,27,1993,29.8,63,38,40,16,7,29,54,53.7,25,42,4,38,31,94,87,0,0,2020-2021,90.0,93.62416107382549,190.26845637583892
712,Mitchell Dijks,NED,DF,Bologna,Serie A,27,1993,16.5,21,14,15,5,1,12,21,57.1,9,17,2,15,17,38,35,0,0,2020-2021,90.0,92.72727272727273,114.54545454545455
713,Javairô Dilrosun,NED,"FW,MF",Hertha BSC,Bundesliga,22,1998,5.9,5,3,2,2,1,1,6,16.7,5,5,0,5,4,9,3,0,0,2020-2021,90.0,61.01694915254237,76.27118644067797
714,Federico Dimarco,ITA,DF,Hellas Verona,Serie A,22,1997,29.0,32,19,23,7,2,13,28,46.4,15,18,9,9,47,79,50,1,0,2020-2021,90.0,145.86206896551724,99.3103448275862
715,Junior Dina Ebimbe,FRA,"FW,MF",Dijon,Ligue 1,19,2000,23.8,38,25,14,19,5,15,45,33.3,30,17,1,16,14,52,9,0,0,2020-2021,90.00000000000001,52.94117647058824,143.69747899159665
716,Tristan Dingomé,CMR,MF,Reims,Ligue 1,29,1991,0.2,0,0,0,0,0,0,1,0.0,1,0,0,0,0,0,0,0,0,2020-2021,90.0,0.0,0.0
717,Eren Dinkçi,GER,"MF,FW",Werder Bremen,Bundesliga,18,2001,1.2,1,1,1,0,0,0,1,0.0,1,4,0,4,2,3,1,0,0,2020-2021,90.0,150.0,75.0
718,Sinaly Diomande,CIV,DF,Lyon,Ligue 1,19,2001,12.6,10,7,8,1,1,5,14,35.7,9,19,15,4,33,43,53,1,0,2020-2021,90.0,235.71428571428575,71.42857142857143
719,Lois Diony,FRA,FW,Angers,Ligue 1,27,1992,19.4,15,10,3,9,3,4,18,22.2,14,6,3,3,5,20,16,0,0,2020-2021,90.0,23.195876288659797,69.5876288659794
720,Issa Diop,FRA,DF,West Ham,Premier League,23,1997,15.3,20,14,12,8,0,7,18,38.9,11,32,22,10,22,42,59,0,0,2020-2021,90.0,129.41176470588235,117.6470588235294
721,Papakouli Diop,SEN,MF,Eibar,La Liga,34,1986,25.8,43,29,15,22,6,12,41,29.3,29,23,5,18,39,82,34,1,0,2020-2021,90.0,136.04651162790697,150.0
722,Sofiane Diop,FRA,"MF,FW",Monaco,Ligue 1,20,2000,22.5,49,34,17,25,7,18,53,34.0,35,25,1,24,31,80,15,0,0,2020-2021,90.0,124.0,196.0
723,Andy Diouf,FRA,FW,Rennes,Ligue 1,17,2003,0.1,0,0,0,0,0,0,0,0.0,0,0,0,0,0,0,0,0,0,2020-2021,90.0,0.0,0.0
724,Yehvann Diouf,FRA,GK,Reims,Ligue 1,20,1999,1.5,0,0,0,0,0,0,0,0.0,0,0,0,0,0,0,0,0,0,2020-2021,90.0,0.0,0.0
725,Assane Dioussé,SEN,DF,Saint-Étienne,Ligue 1,22,1997,0.0,0,0,0,0,0,0,0,0.0,0,0,0,0,0,0,0,0,0,2020-2021,,,
Rk,Player,Nation,Pos,Squad,Comp,0,0,90.0,0,0,3,3,3,Tkl,0,0.0,0,0,0,0,0,0,0,0,0,2020-2021,90.0,0.0,0.0
726,Jonas Dirkner,GER,MF,Hertha BSC,Bundesliga,18,2002,0.2,0,0,0,0,0,0,0,0.0,0,0,0,0,0,0,0,0,0,2020-2021,90.0,0.0,0.0
727,Axel Disasi,FRA,DF,Monaco,Ligue 1,22,1998,22.3,29,20,17,12,0,20,35,57.1,15,18,11,7,26,55,66,1,0,2020-2021,90.0,104.93273542600896,117.04035874439461
728,Tiago Djaló,POR,DF,Lille,Ligue 1,20,2000,9.7,22,13,14,5,3,15,23,65.2,8,10,4,6,9,31,23,0,0,2020-2021,90.0,83.50515463917527,204.1237113402062
729,Djené,TOG,DF,Getafe,La Liga,28,1991,32.7,61,39,31,26,4,26,34,76.5,8,24,11,13,42,103,96,0,0,2020-2021,90.0,115.59633027522935,167.88990825688074
730,Moussa Djenepo,MLI,MF,Southampton,Premier League,22,1998,13.8,52,27,27,17,8,28,63,44.4,35,24,2,22,10,62,14,0,0,2020-2021,90.0,65.21739130434781,339.1304347826087
731,Koffi Djidji,CIV,DF,Crotone,Serie A,27,1992,16.9,39,28,30,8,1,10,20,50.0,10,35,20,15,28,67,73,0,0,2020-2021,90.0,149.11242603550298,207.6923076923077
732,Alexander Djiku,GHA,"DF,MF",Strasbourg,Ligue 1,25,1994,28.4,60,41,45,13,2,32,52,61.5,20,28,10,18,91,151,104,0,0,2020-2021,90.0,288.38028169014086,190.14084507042256
733,Berat Djimsiti,ALB,DF,Atalanta,Serie A,27,1993,29.2,41,29,27,12,2,17,34,50.0,17,34,20,14,62,103,89,1,0,2020-2021,90.0,191.09589041095893,126.36986301369863
734,Marko Dmitrović,SRB,GK,Eibar,La Liga,28,1992,34.7,4,3,4,0,0,2,4,50.0,2,0,0,0,0,4,16,2,0,2020-2021,90.0,0.0,10.374639769452449
735,Ritsu Doan,JPN,"MF,FW",Arminia,Bundesliga,22,1998,30.8,53,31,22,19,12,19,52,36.5,33,42,1,41,31,84,11,0,0,2020-2021,90.0,90.5844155844156,154.8701298701299
736,Mihai Dobre,ROU,FW,Dijon,Ligue 1,21,1998,5.9,12,5,6,2,4,7,14,50.0,7,5,0,5,10,22,3,0,0,2020-2021,90.0,152.54237288135593,183.0508474576271
737,Matt Doherty,IRL,DF,Tottenham,Premier League,28,1992,13.8,29,15,15,10,4,13,33,39.4,20,20,5,15,23,52,46,0,0,2020-2021,90.0,149.99999999999997,189.1304347826087
738,Jeremy Doku,BEL,"MF,FW",Rennes,Ligue 1,18,2002,25.7,44,25,9,24,11,11,26,42.3,15,18,1,17,11,55,1,0,0,2020-2021,90.0,38.521400778210115,154.08560311284046
739,Kasper Dolberg,DEN,FW,Nice,Ligue 1,22,1997,21.4,6,2,1,3,2,2,11,18.2,9,11,2,9,6,12,19,1,0,2020-2021,90.0,25.233644859813086,25.233644859813086
740,Keagan Dolly,RSA,MF,Montpellier,Ligue 1,27,1993,5.0,7,2,6,0,1,4,8,50.0,4,3,0,3,5,12,2,0,0,2020-2021,90.0,90.0,126.0
741,Jaume Doménech,ESP,GK,Valencia,La Liga,29,1990,28.0,1,1,1,0,0,1,2,50.0,1,1,0,1,0,1,16,2,0,2020-2021,90.0,0.0,3.2142857142857144
742,Carlos Dominguez,ESP,DF,Celta Vigo,La Liga,19,2001,4.0,5,4,4,1,0,3,6,50.0,3,5,3,2,6,11,24,0,0,2020-2021,90.0,135.0,112.5
743,Nicolás Domínguez,ARG,MF,Bologna,Serie A,22,1998,13.9,48,28,26,17,5,15,37,40.5,22,26,7,19,24,72,20,0,0,2020-2021,90.0,155.3956834532374,310.7913669064748
744,John Donald,ESP,"DF,MF",Elche,La Liga,19,2000,0.6,0,0,0,0,0,0,0,0.0,0,0,0,0,0,0,1,0,0,2020-2021,90.0,0.0,0.0
745,Ji Dong-won,KOR,FW,Mainz 05,Bundesliga,29,1991,0.7,1,1,1,0,0,0,0,0.0,0,1,0,1,2,3,0,0,0,2020-2021,90.0,257.14285714285717,128.57142857142858
746,Anastasios Donis,GRE,MF,Reims,Ligue 1,23,1996,1.1,4,1,2,0,2,1,1,100.0,0,0,0,0,0,4,0,0,0,2020-2021,90.0,0.0,327.27272727272725
747,Gianluigi Donnarumma,ITA,GK,Milan,Serie A,21,1999,37.0,0,0,0,0,0,0,1,0.0,1,1,0,1,1,1,23,2,0,2020-2021,90.0,2.4324324324324325,0.0
748,Bas Dost,NED,FW,Eint Frankfurt,Bundesliga,31,1989,9.1,3,2,1,1,1,2,5,40.0,3,5,1,4,2,5,8,0,0,2020-2021,90.0,19.78021978021978,29.67032967032967
749,Abdoulaye Doucouré,MLI,MF,Everton,Premier League,27,1993,27.1,52,32,25,19,8,14,43,32.6,29,24,7,17,39,91,31,1,0,2020-2021,90.0,129.52029520295204,172.6937269372694
750,Cheick Doucouré,MLI,MF,Lens,Ligue 1,20,2000,29.2,87,47,40,42,5,32,65,49.2,33,20,4,16,52,139,26,1,0,2020-2021,90.0,160.27397260273975,268.1506849315069
Rk,Player,Nation,Pos,Squad,Comp,0,0,90.0,0,0,3,3,3,Tkl,0,0.0,0,0,0,0,0,0,0,0,0,2020-2021,90.0,0.0,0.0
751,Fodé Doucouré,MLI,DF,Reims,Ligue 1,19,2001,3.7,11,8,7,4,0,4,9,44.4,5,2,0,2,4,15,11,0,0,2020-2021,90.0,97.29729729729729,267.56756756756755
752,Mahamadou Doucouré,MLI,"FW,MF",Nîmes,Ligue 1,20,2000,0.5,1,1,1,0,0,1,1,100.0,0,0,0,0,0,1,0,0,0,2020-2021,90.0,0.0,180.0
753,Cheick Doukouré,CIV,"MF,FW",Levante,La Liga,27,1992,1.1,5,4,2,1,2,3,4,75.0,1,2,0,2,3,8,0,0,0,2020-2021,90.0,245.45454545454544,409.09090909090907
754,Idrissa Doumbia,CIV,MF,Huesca,La Liga,22,1998,8.7,15,8,6,7,2,5,13,38.5,8,6,3,3,7,22,9,0,0,2020-2021,90.0,72.41379310344827,155.17241379310346
755,Moussa Doumbia,MLI,"MF,FW",Reims,Ligue 1,25,1994,10.0,10,6,4,4,2,4,22,18.2,18,5,1,4,10,20,4,0,0,2020-2021,90.0,90.0,90.0
756,Souleyman Doumbia,CIV,DF,Angers,Ligue 1,23,1996,24.7,48,33,25,19,4,22,36,61.1,14,18,4,14,42,90,50,0,0,2020-2021,90.0,153.03643724696357,174.8987854251012
757,Aleksandar Dragović,AUT,DF,Leverkusen,Bundesliga,29,1991,12.6,11,7,5,5,1,9,13,69.2,4,17,5,12,13,24,33,0,0,2020-2021,90.0,92.85714285714286,78.57142857142858
758,Bartłomiej Drągowski,POL,GK,Fiorentina,Serie A,22,1997,35.0,1,0,1,0,0,1,1,100.0,0,0,0,0,1,2,13,1,0,2020-2021,90.0,2.571428571428571,2.571428571428571
759,Denis Drăguș,ROU,"FW,MF",Crotone,Serie A,21,1999,2.0,3,1,0,0,3,0,4,0.0,4,4,0,4,1,4,0,0,0,2020-2021,90.0,45.0,135.0
760,Radu Drăgușin,ROU,DF,Juventus,Serie A,18,2002,0.0,0,0,0,0,0,0,0,0.0,0,0,0,0,0,0,0,0,0,2020-2021,,,
761,Mouhamadou Drammeh,FRA,MF,Reims,Ligue 1,21,1999,1.9,0,0,0,0,0,0,2,0.0,2,0,0,0,2,2,7,0,0,2020-2021,90.0,94.73684210526315,0.0
762,Julian Draxler,GER,"MF,FW",Paris S-G,Ligue 1,26,1993,11.8,13,6,5,6,2,5,20,25.0,15,4,0,4,14,27,0,0,0,2020-2021,90.0,106.77966101694915,99.15254237288134
763,Dominick Drexler,GER,"MF,FW",Köln,Bundesliga,30,1990,13.7,36,26,15,18,3,12,30,40.0,18,5,1,4,14,50,15,0,0,2020-2021,90.0,91.97080291970804,236.49635036496355
764,Matthieu Dreyer,FRA,GK,Lorient,Ligue 1,31,1989,15.0,0,0,0,0,0,0,0,0.0,0,0,0,0,0,0,4,2,0,2020-2021,90.0,0.0,0.0
765,Domingos Duarte,POR,DF,Granada,La Liga,25,1995,26.3,32,20,18,12,2,14,21,66.7,7,29,20,9,29,61,86,0,0,2020-2021,90.0,99.23954372623574,109.50570342205323
766,Léo Duarte,BRA,DF,Milan,Serie A,24,1996,0.2,1,1,0,1,0,0,0,0.0,0,0,0,0,1,2,0,0,0,2020-2021,90.0,450.0,450.0
767,Óscar Duarte,CRC,DF,Levante,La Liga,31,1989,22.9,22,13,17,5,0,10,18,55.6,8,23,15,8,36,58,97,1,0,2020-2021,90.0,141.48471615720524,86.46288209606988
768,Rubén Duarte,ESP,DF,Alavés,La Liga,24,1995,28.3,55,30,28,21,6,23,52,44.2,29,44,6,38,66,121,72,0,0,2020-2021,90.0,209.89399293286218,174.91166077738515
769,Leo Dubois,FRA,DF,Lyon,Ligue 1,25,1994,32.3,38,26,19,16,3,18,36,50.0,18,27,9,18,31,69,69,2,0,2020-2021,90.0,86.37770897832817,105.88235294117648
770,Martin Dúbravka,SVK,GK,Newcastle Utd,Premier League,31,1989,13.0,0,0,0,0,0,0,0,0.0,0,0,0,0,0,0,3,0,0,2020-2021,90.00000000000001,0.0,0.0
771,Ondrej Duda,SVK,"FW,MF",Köln,Bundesliga,25,1994,28.2,36,14,13,18,5,8,39,20.5,31,28,2,26,19,55,20,0,0,2020-2021,89.99999999999999,60.638297872340424,114.89361702127658
772,Unai Dufur,ESP,DF,Eibar,La Liga,21,1999,0.7,2,2,2,0,0,2,4,50.0,2,0,0,0,1,3,0,0,0,2020-2021,90.0,128.57142857142858,257.14285714285717
773,Haris Duljević,BIH,"MF,FW",Nîmes,Ligue 1,26,1993,8.6,15,9,4,7,4,6,22,27.3,16,3,0,3,8,23,1,0,0,2020-2021,90.0,83.72093023255815,156.97674418604652
774,Paul Dummett,WAL,DF,Newcastle Utd,Premier League,28,1991,13.9,16,7,11,5,0,13,21,61.9,8,12,7,5,16,32,74,0,0,2020-2021,90.0,103.59712230215828,103.59712230215828
775,Alfred Duncan,GHA,MF,Fiorentina,Serie A,27,1993,1.8,3,0,1,1,1,0,2,0.0,2,2,0,2,2,5,0,0,0,2020-2021,90.0,100.0,150.0
Rk,Player,Nation,Pos,Squad,Comp,0,0,90.0,0,0,3,3,3,Tkl,0,0.0,0,0,0,0,0,0,0,0,0,2020-2021,90.0,0.0,0.0
776,Alfred Duncan,GHA,MF,Cagliari,Serie A,27,1993,11.9,18,10,8,9,1,4,21,19.0,17,8,0,8,16,34,8,1,0,2020-2021,90.00000000000001,121.00840336134455,136.1344537815126
777,Lewis Dunk,ENG,DF,Brighton,Premier League,28,1991,32.6,30,15,20,8,2,16,23,69.6,7,29,20,9,32,62,106,0,0,2020-2021,90.0,88.34355828220859,82.82208588957056
778,Jimmy Dunne,IRL,DF,Burnley,Premier League,22,1997,3.0,3,3,2,1,0,1,2,50.0,1,3,2,1,6,9,16,1,0,2020-2021,90.0,180.0,90.0
779,Erik Durm,GER,DF,Eint Frankfurt,Bundesliga,28,1992,16.4,17,13,7,9,1,8,21,38.1,13,19,5,14,29,46,26,0,0,2020-2021,90.0,159.14634146341464,93.29268292682927
780,Hugo Duro,ESP,FW,Real Madrid,La Liga,20,1999,0.6,0,0,0,0,0,0,0,0.0,0,1,0,1,0,0,0,0,0,2020-2021,90.0,0.0,0.0
781,Jean-Kevin Duverne,HAI,DF,Brest,Ligue 1,23,1997,22.5,38,21,24,14,0,15,32,46.9,17,24,16,8,30,68,70,0,0,2020-2021,90.0,120.0,152.0
782,Paulo Dybala,ARG,FW,Juventus,Serie A,26,1993,12.6,14,8,3,4,7,2,14,14.3,12,15,0,15,1,15,1,0,0,2020-2021,90.0,7.142857142857143,100.00000000000001
783,Edin Džeko,BIH,FW,Roma,Serie A,34,1986,20.3,8,6,2,3,3,3,9,33.3,6,9,4,5,1,9,11,0,0,2020-2021,90.0,4.433497536945812,35.4679802955665
784,Steeve-Mike Ebongue,FRA,MF,Genoa,Serie A,19,2001,0.6,2,1,1,0,1,0,3,0.0,3,1,0,1,0,2,0,0,0,2020-2021,90.0,0.0,300.0
785,Enzo Ebosse,CMR,DF,Angers,Ligue 1,21,1999,2.9,5,3,5,0,0,3,4,75.0,1,1,1,0,2,7,13,0,0,2020-2021,90.0,62.06896551724138,155.17241379310346
786,Bruno Ecuele Manga,GAB,DF,Dijon,Ligue 1,32,1988,38.0,52,38,46,6,0,29,40,72.5,11,50,33,17,57,109,165,3,0,2020-2021,90.0,135.0,123.15789473684211
787,Simone Edera,ITA,"DF,MF",Torino,Serie A,23,1997,0.6,3,1,2,1,0,3,4,75.0,1,0,0,0,1,4,1,0,0,2020-2021,90.0,150.0,450.00000000000006
788,Ederson,BRA,GK,Manchester City,Premier League,26,1993,36.0,3,1,3,0,0,3,4,75.0,1,0,0,0,0,3,11,4,0,2020-2021,90.0,0.0,7.5
789,Kyle Edwards,ENG,"MF,FW",West Brom,Premier League,22,1998,1.3,3,2,1,1,1,0,0,0.0,0,2,0,2,1,4,0,0,0,2020-2021,90.0,69.23076923076923,207.69230769230768
790,John Egan,IRL,DF,Sheffield Utd,Premier League,27,1992,29.2,41,21,29,12,0,22,39,56.4,17,43,31,12,41,82,131,0,0,2020-2021,90.0,126.36986301369863,126.36986301369863
791,Johannes Eggestein,GER,"FW,MF",Werder Bremen,Bundesliga,22,1998,0.4,0,0,0,0,0,0,1,0.0,1,0,0,0,1,1,2,0,0,2020-2021,90.0,225.0,0.0
792,Maximilian Eggestein,GER,MF,Werder Bremen,Bundesliga,23,1996,32.7,57,42,22,29,6,21,46,45.7,25,30,5,25,43,100,36,0,0,2020-2021,90.0,118.34862385321101,156.88073394495413
793,Lilian Egloff,GER,MF,Stuttgart,Bundesliga,17,2002,0.2,0,0,0,0,0,0,0,0.0,0,0,0,0,0,0,0,0,0,2020-2021,90.0,0.0,0.0
794,Kingsley Ehizibue,NED,DF,Köln,Bundesliga,25,1995,12.6,32,19,22,9,1,10,17,58.8,7,19,5,14,18,50,42,0,0,2020-2021,90.0,128.57142857142858,228.57142857142858
795,Albin Ekdal,SWE,MF,Sampdoria,Serie A,31,1989,25.5,56,29,21,32,3,23,65,35.4,42,31,12,19,49,105,35,0,0,2020-2021,90.0,172.94117647058823,197.64705882352942
796,Hugo Ekitike,FRA,"FW,MF",Reims,Ligue 1,18,2002,1.0,1,1,0,0,1,0,1,0.0,1,0,0,0,0,1,0,0,0,2020-2021,90.0,0.0,90.0
797,Anthony Elanga,SWE,FW,Manchester Utd,Premier League,18,2002,1.7,4,2,3,1,0,4,5,80.0,1,1,1,0,1,5,1,0,0,2020-2021,90.0,52.94117647058823,211.76470588235293
798,Niclas Eliasson,SWE,"MF,FW",Nîmes,Ligue 1,24,1995,20.0,28,14,9,12,7,11,24,45.8,13,20,1,19,23,51,16,0,0,2020-2021,90.0,103.5,126.0
799,Elif Elmas,MKD,"MF,FW",Napoli,Serie A,20,1999,8.2,15,4,3,6,6,7,12,58.3,5,11,1,10,2,17,10,0,0,2020-2021,90.0,21.951219512195124,164.63414634146343
800,Ahmed Elmohamady,EGY,DF,Aston Villa,Premier League,32,1987,9.3,17,13,12,4,1,9,14,64.3,5,6,3,3,17,34,26,0,0,2020-2021,90.0,164.51612903225805,164.51612903225805
Rk,Player,Nation,Pos,Squad,Comp,0,0,90.0,0,0,3,3,3,Tkl,0,0.0,0,0,0,0,0,0,0,0,0,2020-2021,90.0,0.0,0.0
801,Mohamed Elneny,EGY,MF,Arsenal,Premier League,28,1992,17.2,14,6,7,7,0,7,28,25.0,21,11,4,7,24,38,20,2,0,2020-2021,90.0,125.58139534883722,73.25581395348838
802,Aritz Elustondo,ESP,DF,Real Sociedad,La Liga,26,1994,20.9,30,16,21,7,2,18,22,81.8,4,12,5,7,15,45,63,0,0,2020-2021,90.0,64.5933014354067,129.1866028708134
803,Nico Elvedi,SUI,DF,Gladbach,Bundesliga,23,1996,28.2,49,35,36,12,1,25,37,67.6,12,38,22,16,65,114,123,0,0,2020-2021,89.99999999999999,207.44680851063828,156.38297872340425
804,Rodrigo Ely,BRA,DF,Alavés,La Liga,26,1993,5.2,5,2,3,2,0,3,4,75.0,1,2,1,1,7,12,23,1,0,2020-2021,90.0,121.15384615384615,86.53846153846153
805,Breel Embolo,SUI,"FW,MF",Gladbach,Bundesliga,23,1997,16.0,15,10,1,13,1,0,6,0.0,6,16,1,15,8,23,8,0,0,2020-2021,90.0,45.0,84.375
806,Emerson,BRA,DF,Betis,La Liga,21,1999,33.2,91,52,62,25,4,43,78,55.1,35,33,6,27,61,152,102,2,0,2020-2021,90.0,165.36144578313252,246.68674698795178
807,Renaud Emond,BEL,"FW,MF",Nantes,Ligue 1,28,1991,3.9,0,0,0,0,0,0,1,0.0,1,2,0,2,0,0,1,0,0,2020-2021,90.0,0.0,0.0
808,Alan Empereur,BRA,DF,Hellas Verona,Serie A,26,1994,2.4,0,0,0,0,0,0,0,0.0,0,1,1,0,6,6,7,1,0,2020-2021,90.0,225.00000000000003,0.0
809,Youssef En-Nesyri,MAR,FW,Sevilla,La Liga,23,1997,25.7,17,11,2,9,6,4,21,19.0,17,15,0,15,8,25,23,0,0,2020-2021,90.0,28.01556420233463,59.53307392996109
810,Keita Endo,JPN,"MF,FW",Union Berlin,Bundesliga,22,1997,5.1,8,3,1,5,2,3,9,33.3,6,5,2,3,6,14,4,0,0,2020-2021,90.0,105.88235294117648,141.1764705882353
811,Wataru Endo,JPN,MF,Stuttgart,Bundesliga,27,1993,32.8,65,44,25,34,6,29,71,40.8,42,53,14,39,51,116,59,0,0,2020-2021,90.0,139.93902439024393,178.35365853658539
812,Sergi Enrich,ESP,FW,Eibar,La Liga,30,1990,15.6,21,15,6,7,8,9,22,40.9,13,11,0,11,6,27,5,0,0,2020-2021,90.0,34.61538461538461,121.15384615384615
813,Christian Eriksen,DEN,MF,Inter,Serie A,28,1992,15.4,12,6,6,4,2,7,20,35.0,13,16,1,15,9,21,13,1,0,2020-2021,90.0,52.5974025974026,70.12987012987013
814,Martin Erlic,CRO,DF,Spezia,Serie A,22,1998,20.0,23,14,16,6,1,11,20,55.0,9,22,16,6,41,64,71,2,0,2020-2021,90.0,184.5,103.5
815,Patrick Erras,GER,"FW,MF",Werder Bremen,Bundesliga,25,1995,0.3,0,0,0,0,0,0,1,0.0,1,0,0,0,0,0,0,0,0,2020-2021,90.0,0.0,0.0
816,Gonzalo Escalante,ARG,MF,Lazio,Serie A,27,1993,8.1,26,13,11,14,1,8,28,28.6,20,10,3,7,19,45,13,0,0,2020-2021,90.0,211.11111111111111,288.8888888888889
817,Aarón Escandell,ESP,GK,Granada,La Liga,24,1995,5.0,1,1,1,0,0,1,1,100.0,0,0,0,0,0,1,6,0,0,2020-2021,90.0,0.0,18.0
818,Dani Escriche,ESP,"FW,MF",Huesca,La Liga,22,1998,9.5,9,7,5,2,2,3,10,30.0,7,11,0,11,8,17,5,0,0,2020-2021,90.0,75.78947368421052,85.26315789473684
819,Sergio Escudero,ESP,DF,Sevilla,La Liga,30,1989,6.3,12,8,6,5,1,6,12,50.0,6,5,2,3,9,21,7,0,0,2020-2021,90.0,128.57142857142858,171.42857142857144
820,Alfonso Espino,URU,DF,Cádiz,La Liga,28,1992,28.9,92,48,63,28,1,43,85,50.6,42,30,5,25,41,133,74,0,0,2020-2021,90.00000000000001,127.68166089965399,286.50519031141874
821,Vicente Esquerdo,ESP,MF,Valencia,La Liga,21,1999,2.6,7,4,5,2,0,4,6,66.7,2,4,2,2,8,15,1,0,0,2020-2021,90.0,276.9230769230769,242.3076923076923
822,Nahuel Estévez,ARG,MF,Spezia,Serie A,24,1995,19.6,13,5,4,6,3,5,32,15.6,27,23,5,18,20,33,22,1,0,2020-2021,90.0,91.83673469387755,59.69387755102041
823,Pervis Estupiñán,ECU,DF,Villarreal,La Liga,22,1998,13.0,37,17,23,12,2,14,23,60.9,9,10,2,8,35,72,14,2,0,2020-2021,90.00000000000001,242.30769230769232,256.1538461538462
824,Yoann Etienne,FRA,DF,Lorient,Ligue 1,23,1997,1.0,2,0,1,1,0,1,1,100.0,0,1,0,1,1,3,2,0,0,2020-2021,90.0,90.0,180.0
825,Xabier Etxeita,ESP,DF,Getafe,La Liga,32,1987,9.8,8,4,5,3,0,7,14,50.0,7,6,3,3,13,21,38,0,0,2020-2021,90.0,119.38775510204081,73.46938775510203
Rk,Player,Nation,Pos,Squad,Comp,0,0,90.0,0,0,3,3,3,Tkl,0,0.0,0,0,0,0,0,0,0,0,0,2020-2021,90.0,0.0,0.0
826,Jonny Evans,NIR,DF,Leicester City,Premier League,32,1988,27.5,25,12,22,2,1,14,20,70.0,6,8,3,5,46,71,98,1,0,2020-2021,89.99999999999999,150.54545454545453,81.81818181818181
827,Edu Expósito,ESP,MF,Eibar,La Liga,23,1996,27.3,51,30,16,31,4,20,66,30.3,46,25,4,21,22,73,17,0,0,2020-2021,90.0,72.52747252747253,168.13186813186812
828,Valentin Eysseric,FRA,"MF,FW",Fiorentina,Serie A,28,1992,8.1,14,8,6,7,1,5,11,45.5,6,11,0,11,7,21,8,0,0,2020-2021,90.0,77.77777777777779,155.55555555555557
829,Eberechi Eze,ENG,MF,Crystal Palace,Premier League,22,1998,28.4,27,14,11,13,3,16,35,45.7,19,19,3,16,24,51,9,1,0,2020-2021,90.0,76.05633802816902,85.56338028169014
830,Jokin Ezkieta,ESP,GK,Athletic Club,La Liga,23,1996,1.0,0,0,0,0,0,0,0,0.0,0,0,0,0,0,0,0,0,0,2020-2021,90.0,0.0,0.0
831,Łukasz Fabiański,POL,GK,West Ham,Premier League,35,1985,35.0,1,0,1,0,0,1,1,100.0,0,1,0,1,1,2,12,3,0,2020-2021,90.0,2.571428571428571,2.571428571428571
832,Fabinho,BRA,"DF,MF",Liverpool,Premier League,26,1993,28.5,58,31,21,29,8,27,54,50.0,27,28,10,18,44,102,66,1,0,2020-2021,90.0,138.94736842105263,183.1578947368421
833,Fábio,BRA,DF,Nantes,Ligue 1,30,1990,16.7,62,37,37,23,2,35,61,57.4,26,29,8,21,37,99,49,0,0,2020-2021,90.0,199.4011976047904,334.1317365269461
834,Cesc Fàbregas,ESP,"MF,FW",Monaco,Ligue 1,33,1987,9.7,20,12,6,9,5,9,22,40.9,13,11,1,10,13,33,3,0,0,2020-2021,90.0,120.61855670103094,185.56701030927837
835,Bandiougou Fadiga,FRA,"FW,MF",Paris S-G,Ligue 1,19,2001,0.7,1,0,1,0,0,0,0,0.0,0,0,0,0,0,1,0,0,0,2020-2021,90.0,0.0,128.57142857142858
836,Bandiougou Fadiga,FRA,"MF,FW",Brest,Ligue 1,19,2001,0.5,0,0,0,0,0,0,2,0.0,2,0,0,0,0,0,0,0,0,2020-2021,90.0,0.0,0.0
837,Wout Faes,BEL,DF,Reims,Ligue 1,22,1998,32.2,35,22,26,9,0,20,39,51.3,19,40,31,9,68,103,144,1,0,2020-2021,90.0,190.06211180124222,97.82608695652173
838,Nicolò Fagioli,ITA,MF,Juventus,Serie A,19,2001,0.2,0,0,0,0,0,0,0,0.0,0,0,0,0,0,0,1,0,0,2020-2021,90.0,0.0,0.0
839,Ralf Fährmann,GER,GK,Schalke 04,Bundesliga,31,1988,20.8,2,1,2,0,0,1,2,50.0,1,0,0,0,1,3,9,3,0,2020-2021,90.0,4.326923076923077,8.653846153846153
840,Romain Faivre,FRA,"MF,FW",Brest,Ligue 1,22,1998,32.1,54,27,26,23,5,21,54,38.9,33,30,0,30,30,84,18,0,0,2020-2021,90.0,84.11214953271028,151.4018691588785
841,Fali,ESP,"DF,MF",Cádiz,La Liga,26,1993,29.3,42,25,24,15,3,16,37,43.2,21,28,15,13,32,74,119,0,0,2020-2021,90.0,98.29351535836177,129.01023890784984
842,Iago Falque,ESP,"MF,FW",Benevento,Serie A,30,1990,4.0,4,2,2,2,0,1,6,16.7,5,4,1,3,0,4,1,0,0,2020-2021,90.0,0.0,90.0
843,Andri Fannar Baldursson,ISL,MF,Bologna,Serie A,18,2002,2.4,6,6,1,2,3,1,3,33.3,2,3,1,2,3,9,7,0,0,2020-2021,90.0,112.50000000000001,225.00000000000003
844,Paolo Faragò,ITA,DF,Bologna,Serie A,27,1993,0.3,1,1,1,0,0,1,2,50.0,1,1,0,1,0,1,0,0,0,2020-2021,90.0,0.0,300.0
845,Paolo Faragò,ITA,DF,Cagliari,Serie A,27,1993,4.1,13,9,10,3,0,9,20,45.0,11,3,2,1,6,19,15,0,0,2020-2021,90.0,131.70731707317074,285.3658536585366
846,Davide Faraoni,ITA,DF,Hellas Verona,Serie A,28,1991,32.1,62,33,36,19,7,28,51,54.9,23,48,17,31,49,111,83,1,0,2020-2021,90.0,137.38317757009344,173.83177570093457
847,Mohamed Fares,ALG,DF,Lazio,Serie A,24,1996,12.7,20,15,9,7,4,11,19,57.9,8,14,1,13,16,36,21,0,0,2020-2021,90.0,113.38582677165356,141.73228346456693
848,Diego Farias,BRA,FW,Spezia,Serie A,30,1990,16.8,9,5,4,1,4,4,21,19.0,17,12,0,12,13,22,3,0,0,2020-2021,90.0,69.64285714285714,48.214285714285715
849,Wuilker Faríñez,VEN,GK,Lens,Ligue 1,22,1998,1.2,0,0,0,0,0,0,0,0.0,0,0,0,0,0,0,1,0,0,2020-2021,90.0,0.0,0.0
850,Noah Fatar,FRA,"FW,MF",Angers,Ligue 1,18,2002,0.2,1,0,0,0,1,0,0,0.0,0,0,0,0,0,1,0,0,0,2020-2021,90.0,0.0,450.0
Rk,Player,Nation,Pos,Squad,Comp,0,0,90.0,0,0,3,3,3,Tkl,0,0.0,0,0,0,0,0,0,0,0,0,2020-2021,90.0,0.0,0.0
851,Ansu Fati,ESP,FW,Barcelona,La Liga,17,2002,4.8,9,4,2,4,3,2,10,20.0,8,4,0,4,3,12,1,0,0,2020-2021,90.0,56.25000000000001,168.75
852,Julien Faussurier,FRA,DF,Brest,Ligue 1,33,1987,10.6,16,11,6,8,2,11,25,44.0,14,12,4,8,9,25,10,0,0,2020-2021,90.0,76.41509433962264,135.8490566037736
853,Andrea Favilli,ITA,FW,Hellas Verona,Serie A,23,1997,3.8,3,1,0,1,2,2,3,66.7,1,2,0,2,0,3,2,0,0,2020-2021,90.0,0.0,71.05263157894737
854,Federico Fazio,ARG,DF,Roma,Serie A,33,1987,4.5,3,2,3,0,0,3,4,75.0,1,3,3,0,7,10,18,1,0,2020-2021,90.0,140.0,60.0
855,Nabil Fekir,FRA,"MF,FW",Betis,La Liga,27,1993,29.1,45,23,9,22,14,7,43,16.3,36,31,2,29,8,53,2,0,0,2020-2021,90.0,24.74226804123711,139.17525773195874
856,Felipe,BRA,DF,Atlético Madrid,La Liga,31,1989,22.9,29,17,19,10,0,18,23,78.3,5,30,15,15,36,65,128,2,0,2020-2021,90.0,141.48471615720524,113.97379912663757
857,Luiz Felipe,ITA,DF,Lazio,Serie A,23,1997,10.1,32,20,19,11,2,16,24,66.7,8,20,9,11,21,53,29,1,0,2020-2021,90.0,187.12871287128712,285.1485148514852
858,João Félix,POR,"FW,MF",Atlético Madrid,La Liga,20,1999,17.5,8,4,1,6,1,4,17,23.5,13,3,0,3,5,13,2,0,0,2020-2021,90.0,25.714285714285715,41.14285714285714
859,Ohis Felix Uduokhai,GER,DF,Augsburg,Bundesliga,22,1997,29.0,33,24,19,10,4,18,27,66.7,9,48,25,23,54,87,164,2,0,2020-2021,90.0,167.58620689655172,102.41379310344827
860,Zinedine Ferhat,ALG,"FW,MF",Nîmes,Ligue 1,27,1993,32.9,36,21,18,9,9,18,39,46.2,21,22,0,22,32,68,38,0,0,2020-2021,90.0,87.53799392097265,98.48024316109424
861,Bruno Fernandes,POR,MF,Manchester Utd,Premier League,25,1994,34.4,57,30,16,29,12,26,100,26.0,74,38,0,38,26,83,29,0,0,2020-2021,90.0,68.0232558139535,149.1279069767442
862,Edimilson Fernandes,SUI,"MF,FW",Mainz 05,Bundesliga,24,1996,9.3,8,4,4,4,0,4,7,57.1,3,12,4,8,29,37,25,0,0,2020-2021,90.0,280.64516129032256,77.41935483870967
863,Aitor Fernández,ESP,GK,Levante,La Liga,29,1991,29.0,0,0,0,0,0,0,0,0.0,0,0,0,0,2,2,17,1,0,2020-2021,90.0,6.206896551724138,0.0
864,Álex Fernández,ESP,MF,Cádiz,La Liga,27,1992,21.6,19,9,8,8,3,8,30,26.7,22,14,1,13,22,41,15,0,0,2020-2021,90.0,91.66666666666666,79.16666666666666
865,Álvaro Fernández,ESP,GK,Huesca,La Liga,22,1998,22.0,1,1,0,1,0,1,3,33.3,2,0,0,0,2,3,7,0,0,2020-2021,90.0,8.181818181818182,4.090909090909091
866,Andrés Fernández,ESP,GK,Huesca,La Liga,33,1986,16.0,0,0,0,0,0,0,0,0.0,0,0,0,0,0,0,3,2,0,2020-2021,90.0,0.0,0.0
867,Augusto Fernández,ARG,MF,Cádiz,La Liga,34,1986,4.1,11,3,5,6,0,2,13,15.4,11,5,1,4,9,20,5,0,0,2020-2021,90.0,197.56097560975613,241.46341463414637
868,Carlos Fernández,ESP,FW,Sevilla,La Liga,24,1996,1.6,1,0,1,0,0,0,2,0.0,2,3,1,2,1,2,0,0,0,2020-2021,90.0,56.25,56.25
869,Carlos Fernández,ESP,"FW,MF",Real Sociedad,La Liga,24,1996,4.3,3,2,0,2,1,1,8,12.5,7,6,1,5,0,3,6,0,0,2020-2021,90.0,0.0,62.79069767441861
870,Federico Fernández,ARG,DF,Newcastle Utd,Premier League,31,1989,23.1,29,22,23,5,1,17,21,81.0,4,41,31,10,17,46,147,0,0,2020-2021,89.99999999999999,66.23376623376622,112.98701298701297
871,Joaquín Fernández,ESP,DF,Valladolid,La Liga,24,1996,23.0,30,16,21,8,1,12,21,57.1,9,24,15,9,43,73,113,0,0,2020-2021,90.0,168.2608695652174,117.3913043478261
872,Fernandinho,BRA,MF,Manchester City,Premier League,35,1985,13.2,31,17,8,14,9,20,43,46.5,23,11,2,9,23,54,17,0,0,2020-2021,90.0,156.8181818181818,211.36363636363637
873,Fernando,BRA,MF,Sevilla,La Liga,33,1987,28.3,54,28,24,25,5,23,43,53.5,20,25,11,14,41,95,70,0,0,2020-2021,90.0,130.3886925795053,171.73144876325088
874,Alex Ferrari,ITA,DF,Sampdoria,Serie A,26,1994,9.8,27,15,16,9,2,15,24,62.5,9,18,6,12,23,50,26,0,0,2020-2021,90.0,211.22448979591834,247.95918367346937
875,David Ferreiro,ESP,"MF,FW",Huesca,La Liga,32,1988,28.1,25,12,12,8,5,8,49,16.3,41,21,1,20,25,50,15,0,0,2020-2021,90.0,80.0711743772242,80.0711743772242
Rk,Player,Nation,Pos,Squad,Comp,0,0,90.0,0,0,3,3,3,Tkl,0,0.0,0,0,0,0,0,0,0,0,0,2020-2021,90.0,0.0,0.0
876,Salvador Ferrer,ESP,DF,Spezia,Serie A,22,1998,13.2,20,10,10,8,2,8,22,36.4,14,13,4,9,24,44,37,1,0,2020-2021,90.0,163.63636363636363,136.36363636363637
877,Facundo Ferreyra,ARG,FW,Celta Vigo,La Liga,29,1991,3.3,4,3,1,2,1,0,2,0.0,2,5,0,5,2,6,2,0,0,2020-2021,90.0,54.54545454545455,109.0909090909091
878,Jordan Ferri,FRA,MF,Montpellier,Ligue 1,28,1992,28.6,58,40,34,22,2,31,103,30.1,72,30,5,25,8,66,18,1,0,2020-2021,90.0,25.174825174825177,182.51748251748253
879,Marco Festa,ITA,GK,Crotone,Serie A,28,1992,1.0,0,0,0,0,0,0,0,0.0,0,0,0,0,0,0,0,0,0,2020-2021,90.0,0.0,0.0
880,Fidel,ESP,"MF,DF",Elche,La Liga,30,1989,26.6,46,30,28,15,3,25,64,39.1,39,22,2,20,16,62,14,0,0,2020-2021,90.0,54.13533834586466,155.6390977443609
881,Sam Field,ENG,MF,West Brom,Premier League,22,1998,0.7,5,5,3,2,0,0,0,0.0,0,4,1,3,2,7,4,0,0,2020-2021,90.0,257.14285714285717,642.8571428571429
882,Alfreð Finnbogason,ISL,FW,Augsburg,Bundesliga,31,1989,6.0,2,1,0,1,1,0,1,0.0,1,7,1,6,1,3,4,0,0,2020-2021,90.0,15.0,30.0
883,Roberto Firmino,BRA,FW,Liverpool,Premier League,28,1991,31.5,33,15,3,17,13,6,32,18.8,26,42,5,37,11,44,12,0,0,2020-2021,90.0,31.42857142857143,94.28571428571429
884,Junior Firpo,DOM,"DF,MF",Barcelona,La Liga,23,1996,3.2,1,1,1,0,0,0,1,0.0,1,5,3,2,4,5,7,0,0,2020-2021,90.0,112.5,28.125
885,Will Fish,ENG,FW,Manchester Utd,Premier League,17,2003,0.0,0,0,0,0,0,0,0,0.0,0,0,0,0,0,0,0,0,0,2020-2021,,,
886,John Fleck,SCO,MF,Sheffield Utd,Premier League,28,1991,28.6,51,33,28,18,5,26,83,31.3,57,26,4,22,28,79,12,1,0,2020-2021,90.0,88.11188811188812,160.48951048951048
887,Mark Flekken,NED,GK,Freiburg,Bundesliga,27,1993,3.0,0,0,0,0,0,0,0,0.0,0,0,0,0,0,0,1,0,0,2020-2021,90.0,0.0,0.0
888,Florian Flick,GER,MF,Schalke 04,Bundesliga,20,2000,4.0,10,7,4,6,0,7,16,43.8,9,4,3,1,7,17,5,1,0,2020-2021,90.0,157.5,225.0
889,Alexis Flips,FRA,"MF,FW",Reims,Ligue 1,20,2000,0.5,0,0,0,0,0,0,2,0.0,2,0,0,0,0,0,1,0,0,2020-2021,90.0,0.0,0.0
890,Alessandro Florenzi,ITA,DF,Paris S-G,Ligue 1,29,1991,17.1,24,16,9,9,6,12,29,41.4,17,7,1,6,17,41,25,0,0,2020-2021,90.0,89.47368421052632,126.3157894736842
891,Kingsley Fobi,GHA,DF,Granada,La Liga,21,1998,0.5,0,0,0,0,0,0,0,0.0,0,0,0,0,1,1,1,0,0,2020-2021,90.0,180.0,0.0
892,Phil Foden,ENG,"FW,MF",Manchester City,Premier League,20,2000,18.0,22,11,12,8,2,9,23,39.1,14,9,0,9,11,33,11,0,0,2020-2021,90.0,55.0,110.0
893,Mamadou Fofana,MLI,"MF,DF",Metz,Ligue 1,22,1998,11.9,25,11,17,8,0,7,31,22.6,24,14,2,12,18,43,36,0,0,2020-2021,90.00000000000001,136.1344537815126,189.07563025210086
894,Seko Fofana,CIV,MF,Lens,Ligue 1,25,1995,25.7,16,8,3,10,3,4,26,15.4,22,16,5,11,34,50,23,1,0,2020-2021,90.0,119.06614785992218,56.03112840466926
895,Wesley Fofana,FRA,DF,Leicester City,Premier League,19,2000,25.1,51,37,27,22,2,31,46,67.4,15,28,16,12,61,112,94,0,0,2020-2021,90.0,218.7250996015936,182.86852589641433
896,Wesley Fofana,FRA,DF,Saint-Étienne,Ligue 1,19,2000,3.5,6,4,6,0,0,3,4,75.0,1,3,3,0,8,14,14,1,0,2020-2021,90.0,205.71428571428572,154.28571428571428
897,Youssouf Fofana,FRA,MF,Monaco,Ligue 1,21,1999,31.9,90,51,31,51,8,42,82,51.2,40,43,7,36,34,124,14,2,0,2020-2021,90.0,95.92476489028213,253.91849529780563
898,Thomas Foket,BEL,DF,Reims,Ligue 1,25,1994,36.9,77,43,50,20,7,40,69,58.0,29,28,7,21,69,146,92,2,0,2020-2021,90.0,168.2926829268293,187.8048780487805
899,Ramón Folch,ESP,MF,Elche,La Liga,30,1989,0.0,0,0,0,0,0,0,0,0.0,0,0,0,0,0,0,0,0,0,2020-2021,,,
900,Lamine Fomba,FRA,MF,Nîmes,Ligue 1,22,1998,24.2,66,36,30,25,11,30,65,46.2,35,48,19,29,59,125,39,2,0,2020-2021,90.0,219.42148760330576,245.45454545454544
Rk,Player,Nation,Pos,Squad,Comp,0,0,90.0,0,0,3,3,3,Tkl,0,0.0,0,0,0,0,0,0,0,0,0,2020-2021,90.0,0.0,0.0
901,Thomas Fontaine,MAD,DF,Lorient,Ligue 1,29,1991,3.6,5,2,5,0,0,2,2,100.0,0,3,2,1,5,10,14,0,0,2020-2021,90.0,125.0,125.0
902,José Fontán,ESP,DF,Celta Vigo,La Liga,20,2000,7.2,12,9,8,4,0,5,11,45.5,6,4,3,1,13,25,27,0,0,2020-2021,90.0,162.5,150.0
903,José Fonte,POR,DF,Lille,Ligue 1,36,1983,35.4,40,29,28,10,2,27,33,81.8,6,36,23,13,36,76,137,1,0,2020-2021,90.0,91.52542372881356,101.69491525423729
904,Fernando Forestieri,ITA,"FW,MF",Udinese,Serie A,30,1990,6.1,9,7,4,4,1,3,7,42.9,4,7,0,7,2,11,0,0,0,2020-2021,90.0,29.508196721311478,132.78688524590166
905,Pablo Fornals,ESP,"FW,MF",West Ham,Premier League,24,1996,28.6,44,26,14,24,6,11,73,15.1,62,43,1,42,36,80,9,0,0,2020-2021,90.0,113.2867132867133,138.46153846153845
906,Emil Forsberg,SWE,"FW,MF",RB Leipzig,Bundesliga,28,1991,17.1,11,6,1,6,4,5,27,18.5,22,10,1,9,11,22,4,0,0,2020-2021,90.0,57.89473684210526,57.89473684210526
907,Fraser Forster,ENG,GK,Southampton,Premier League,32,1988,8.0,1,0,1,0,0,1,2,50.0,1,0,0,0,0,1,9,0,0,2020-2021,90.0,0.0,11.25
908,Philipp Förster,GER,MF,Stuttgart,Bundesliga,25,1995,16.8,22,13,7,12,3,6,25,24.0,19,18,1,17,15,37,2,0,0,2020-2021,90.0,80.35714285714285,117.85714285714285
909,Steven Fortes,CPV,DF,Lens,Ligue 1,28,1992,15.9,33,20,20,10,3,16,22,72.7,6,25,10,15,27,60,52,0,0,2020-2021,90.0,152.83018867924528,186.7924528301887
910,Yassin Fortune,FRA,FW,Angers,Ligue 1,21,1999,0.2,0,0,0,0,0,0,0,0.0,0,0,0,0,0,0,0,0,0,2020-2021,90.0,0.0,0.0
911,Timothy Fosu-Mensah,NED,DF,Manchester Utd,Premier League,22,1998,0.9,2,0,1,1,0,1,1,100.0,0,0,0,0,3,5,1,0,0,2020-2021,90.0,300.0,200.0
912,Timothy Fosu-Mensah,NED,DF,Leverkusen,Bundesliga,22,1998,4.5,4,2,1,2,1,2,4,50.0,2,7,3,4,7,11,4,0,0,2020-2021,90.0,140.0,80.0
913,Daam Foulon,BEL,DF,Benevento,Serie A,21,1999,11.3,26,15,21,5,0,16,28,57.1,12,12,3,9,14,40,34,0,0,2020-2021,90.0,111.50442477876106,207.0796460176991
914,Dimitri Foulquier,FRA,DF,Granada,La Liga,27,1993,29.6,35,21,20,12,3,15,26,57.7,11,24,7,17,26,61,60,0,0,2020-2021,90.0,79.05405405405405,106.41891891891892
915,Juan Foyth,ARG,"DF,MF",Villarreal,La Liga,22,1998,13.0,40,22,22,14,4,12,29,41.4,17,21,6,15,19,59,24,1,0,2020-2021,90.00000000000001,131.53846153846155,276.92307692307696
916,Gianluca Frabotta,ITA,"DF,MF",Juventus,Serie A,21,1999,7.7,7,4,5,0,2,5,12,41.7,7,9,1,8,14,21,15,0,0,2020-2021,90.0,163.63636363636365,81.81818181818183
917,Raphael Framberger,GER,DF,Augsburg,Bundesliga,24,1995,17.1,42,23,26,11,5,19,25,76.0,6,24,2,22,36,78,62,1,0,2020-2021,90.0,189.4736842105263,221.05263157894737
918,Tyrese Francois,AUS,DF,Fulham,Premier League,20,2000,0.2,0,0,0,0,0,0,0,0.0,0,0,0,0,0,0,0,0,0,2020-2021,90.0,0.0,0.0
919,Ryan Fraser,SCO,"FW,MF",Newcastle Utd,Premier League,26,1994,10.3,4,1,3,1,0,2,5,40.0,3,1,0,1,6,10,7,0,0,2020-2021,90.0,52.42718446601942,34.95145631067961
920,Fred,BRA,MF,Manchester Utd,Premier League,27,1993,26.6,81,39,39,38,4,29,89,32.6,60,49,9,40,45,126,26,1,0,2020-2021,90.0,152.25563909774436,274.0601503759398
921,Ryan Fredericks,ENG,"DF,FW",West Ham,Premier League,27,1992,6.3,9,5,5,4,0,3,7,42.9,4,6,2,4,11,20,20,0,0,2020-2021,90.0,157.14285714285717,128.57142857142858
922,Remo Freuler,SUI,MF,Atalanta,Serie A,28,1992,30.1,63,39,17,38,8,32,76,42.1,44,52,4,48,39,102,27,2,0,2020-2021,90.00000000000001,116.61129568106313,188.37209302325581
923,Marco Friedl,AUT,DF,Werder Bremen,Bundesliga,22,1998,30.9,50,34,31,17,2,30,62,48.4,32,38,17,21,55,105,118,1,0,2020-2021,90.0,160.19417475728156,145.63106796116506
924,Marvin Friedrich,GER,DF,Union Berlin,Bundesliga,24,1995,34.0,47,29,35,11,1,18,32,56.3,14,38,18,20,52,99,109,0,0,2020-2021,90.0,137.64705882352942,124.41176470588236
925,Jeremie Frimpong,NED,"DF,FW",Leverkusen,Bundesliga,19,2000,4.8,7,4,4,3,0,4,8,50.0,4,4,0,4,1,8,7,0,0,2020-2021,90.0,18.75,131.25
Rk,Player,Nation,Pos,Squad,Comp,0,0,90.0,0,0,3,3,3,Tkl,0,0.0,0,0,0,0,0,0,0,0,0,2020-2021,90.0,0.0,0.0
926,Jorge de Frutos,ESP,MF,Levante,La Liga,23,1997,24.3,48,24,21,21,6,11,41,26.8,30,25,2,23,16,64,18,0,0,2020-2021,90.0,59.25925925925925,177.77777777777777
927,Christian Fuchs,AUT,DF,Leicester City,Premier League,34,1986,7.8,18,7,15,2,1,8,15,53.3,7,6,4,2,16,34,34,1,0,2020-2021,90.0,184.6153846153846,207.69230769230768
928,Angelo Fulgini,FRA,MF,Angers,Ligue 1,23,1996,30.3,22,13,4,12,6,12,34,35.3,22,17,0,17,15,37,9,0,0,2020-2021,90.0,44.554455445544555,65.34653465346534
929,Niclas Füllkrug,GER,FW,Werder Bremen,Bundesliga,27,1993,9.7,7,3,2,4,1,1,13,7.7,12,10,4,6,3,10,13,0,0,2020-2021,90.0,27.835051546391757,64.94845360824743
930,Ramiro Funes Mori,ARG,DF,Villarreal,La Liga,29,1991,8.1,12,8,7,5,0,7,11,63.6,4,7,5,2,8,20,42,1,0,2020-2021,90.0,88.88888888888889,133.33333333333334
931,Darnell Furlong,ENG,DF,West Brom,Premier League,24,1995,32.6,45,27,27,12,6,21,44,47.7,23,39,16,23,49,94,90,0,0,2020-2021,90.0,135.2760736196319,124.23312883435582
932,Daniel Fuzato,BRA,GK,Roma,Serie A,23,1997,5.0,0,0,0,0,0,0,0,0.0,0,1,0,1,0,0,1,1,0,2020-2021,90.0,0.0,0.0
933,Baptiste Gabard,FRA,MF,Saint-Étienne,Ligue 1,20,2000,1.5,4,3,1,3,0,1,5,20.0,4,4,0,4,1,5,0,0,0,2020-2021,90.0,60.0,240.0
934,Matteo Gabbia,ITA,DF,Milan,Serie A,20,1999,6.2,9,5,3,6,0,2,2,100.0,0,8,6,2,3,12,21,0,0,2020-2021,90.0,43.54838709677419,130.6451612903226
935,Manolo Gabbiadini,ITA,FW,Sampdoria,Serie A,28,1991,9.7,2,2,0,2,0,0,1,0.0,1,3,1,2,3,5,5,0,0,2020-2021,90.0,27.835051546391757,18.556701030927837
936,Mijat Gaćinović,SRB,"DF,MF",Hoffenheim,Bundesliga,25,1995,9.1,18,10,6,11,1,9,24,37.5,15,13,0,13,18,36,15,0,0,2020-2021,90.0,178.02197802197801,178.02197802197801
937,Roberto Gagliardini,ITA,MF,Inter,Serie A,26,1994,13.7,30,17,17,8,5,5,28,17.9,23,15,3,12,19,49,16,0,0,2020-2021,90.0,124.8175182481752,197.08029197080293
938,Riccardo Gagliolo,SWE,DF,Parma,Serie A,30,1990,21.7,45,18,35,8,2,28,45,62.2,17,34,7,27,36,81,64,1,0,2020-2021,90.0,149.30875576036865,186.63594470046084
939,Adolfo Gaich,ARG,FW,Benevento,Serie A,21,1999,8.5,9,4,1,7,1,1,13,7.7,12,4,0,4,2,11,4,0,0,2020-2021,90.0,21.176470588235293,95.29411764705883
940,Andrey Galabinov,BUL,FW,Spezia,Serie A,31,1988,4.8,2,1,1,1,0,1,3,33.3,2,2,0,2,0,2,5,0,0,2020-2021,90.0,0.0,37.5
941,Javi Galán,ESP,DF,Huesca,La Liga,25,1994,34.1,88,54,47,35,6,46,72,63.9,26,30,4,26,39,127,61,0,0,2020-2021,90.0,102.9325513196481,232.25806451612902
942,Conor Gallagher,ENG,MF,West Brom,Premier League,20,2000,28.1,81,41,30,39,12,29,97,29.9,68,47,8,39,27,108,31,0,0,2020-2021,90.0,86.47686832740213,259.4306049822064
943,Enric Gallego,ESP,FW,Osasuna,La Liga,33,1986,9.0,6,3,2,2,2,2,14,14.3,12,5,1,4,1,7,9,0,0,2020-2021,90.0,10.0,60.0
944,Kévin Gameiro,FRA,FW,Valencia,La Liga,33,1987,12.0,7,4,3,2,2,3,11,27.3,8,10,0,10,0,7,3,0,0,2020-2021,90.0,0.0,52.5
945,Idrissa Gana Gueye,SEN,MF,Paris S-G,Ligue 1,30,1989,17.6,63,35,20,34,9,26,50,52.0,24,26,7,19,20,83,9,3,0,2020-2021,90.0,102.27272727272727,322.1590909090909
946,Ignatius Ganago,CMR,FW,Lens,Ligue 1,21,1999,14.5,4,3,0,2,2,3,12,25.0,9,7,1,6,6,10,3,0,0,2020-2021,90.0,37.241379310344826,24.82758620689655
947,Aleix García,ESP,MF,Eibar,La Liga,23,1997,4.9,5,4,2,2,1,1,10,10.0,9,5,0,5,8,13,2,0,0,2020-2021,90.0,146.93877551020407,91.83673469387755
948,Borja García,ESP,"MF,FW",Huesca,La Liga,29,1990,12.4,13,7,4,6,3,6,12,50.0,6,12,0,12,10,23,4,1,0,2020-2021,90.0,72.58064516129032,94.35483870967742
949,Dani García,ESP,MF,Athletic Club,La Liga,30,1990,21.3,39,19,10,23,6,15,46,32.6,31,20,7,13,33,72,34,0,0,2020-2021,90.0,139.43661971830986,164.7887323943662
950,David García,ESP,DF,Osasuna,La Liga,26,1994,35.0,26,17,13,13,0,13,24,54.2,11,36,19,17,59,85,171,0,0,2020-2021,90.0,151.71428571428572,66.85714285714286
Rk,Player,Nation,Pos,Squad,Comp,0,0,90.0,0,0,3,3,3,Tkl,0,0.0,0,0,0,0,0,0,0,0,0,2020-2021,90.0,0.0,0.0
951,Eric García,ESP,DF,Manchester City,Premier League,19,2001,4.3,8,7,5,3,0,5,7,71.4,2,4,1,3,4,12,10,0,0,2020-2021,90.0,83.72093023255815,167.4418604651163
952,Manu García,ESP,MF,Alavés,La Liga,34,1986,12.5,24,13,10,13,1,8,35,22.9,27,16,1,15,12,36,21,0,0,2020-2021,90.0,86.39999999999999,172.79999999999998
953,Raúl García,ESP,"DF,MF",Valladolid,La Liga,31,1989,5.6,10,8,5,5,0,6,20,30.0,14,5,1,4,9,19,10,0,0,2020-2021,90.0,144.64285714285714,160.71428571428572
954,Raúl García,ESP,"FW,MF",Athletic Club,La Liga,34,1986,19.4,34,19,9,19,6,7,22,31.8,15,30,1,29,15,49,20,0,0,2020-2021,90.0,69.5876288659794,157.73195876288662
955,Rubén García,ESP,"MF,FW",Osasuna,La Liga,27,1993,30.2,50,29,21,22,7,14,45,31.1,31,28,2,26,29,79,20,0,0,2020-2021,90.0,86.42384105960265,149.0066225165563
956,Sergi García,ESP,MF,Alavés,La Liga,21,1999,0.2,1,1,0,1,0,0,1,0.0,1,0,0,0,0,1,0,0,0,2020-2021,90.0,0.0,450.0
957,Unai García,ESP,DF,Osasuna,La Liga,28,1992,13.8,19,9,14,4,1,9,15,60.0,6,16,8,8,14,33,40,0,0,2020-2021,90.0,91.30434782608695,123.91304347826086
958,Mario Gaspar,ESP,DF,Villarreal,La Liga,29,1990,20.6,55,34,22,24,9,21,40,52.5,19,26,4,22,30,85,47,1,0,2020-2021,90.0,131.06796116504853,240.29126213592232
959,Manuel Gasparini,ITA,GK,Udinese,Serie A,18,2002,0.0,0,0,0,0,0,0,0,0.0,0,0,0,0,0,0,0,0,0,2020-2021,,,
960,Dwight Gayle,ENG,"FW,MF",Newcastle Utd,Premier League,29,1990,5.7,2,0,1,1,0,0,7,0.0,7,3,1,2,1,3,2,0,0,2020-2021,90.0,15.789473684210526,31.57894736842105
961,Paulo Gazzaniga,ARG,GK,Elche,La Liga,28,1992,8.0,1,1,1,0,0,0,0,0.0,0,0,0,0,1,2,4,0,0,2020-2021,90.0,11.25,11.25
962,Jean-Philippe Gbamin,CIV,MF,Everton,Premier League,24,1995,0.1,1,0,0,1,0,0,0,0.0,0,1,0,1,0,1,1,0,0,2020-2021,90.0,0.0,900.0
963,Yann Gboho,FRA,"MF,FW",Rennes,Ligue 1,19,2001,3.4,6,3,3,1,2,3,8,37.5,5,1,0,1,1,7,3,1,0,2020-2021,90.0,26.470588235294116,158.8235294117647
964,David de Gea,ESP,GK,Manchester Utd,Premier League,29,1990,25.5,0,0,0,0,0,0,0,0.0,0,0,0,0,0,0,8,3,0,2020-2021,90.0,0.0,0.0
965,Christian Gebauer,AUT,"MF,FW",Arminia,Bundesliga,26,1993,7.6,9,4,2,5,2,4,11,36.4,7,4,1,3,6,15,14,0,0,2020-2021,90.0,71.05263157894737,106.57894736842105
966,Theodor Gebre Selassie,CZE,DF,Werder Bremen,Bundesliga,33,1986,33.7,61,35,39,17,5,28,64,43.8,36,33,11,22,58,119,98,1,0,2020-2021,90.0,154.89614243323442,162.9080118694362
967,Emrehan Gedikli,GER,FW,Leverkusen,Bundesliga,17,2003,0.3,0,0,0,0,0,0,0,0.0,0,0,0,0,0,0,0,0,0,2020-2021,90.0,0.0,0.0
968,Dennis Geiger,GER,MF,Hoffenheim,Bundesliga,22,1998,7.3,13,10,3,8,2,5,8,62.5,3,10,0,10,3,16,0,0,0,2020-2021,90.0,36.986301369863014,160.27397260273975
969,Christian Gentner,GER,MF,Union Berlin,Bundesliga,34,1985,11.5,17,8,9,5,3,5,18,27.8,13,13,1,12,17,34,16,0,0,2020-2021,90.0,133.04347826086956,133.04347826086956
970,Yannick Gerhardt,GER,"MF,FW",Wolfsburg,Bundesliga,26,1994,21.5,52,32,14,32,6,21,52,40.4,31,34,4,30,21,73,30,0,0,2020-2021,90.0,87.90697674418604,217.67441860465115
971,Valère Germain,FRA,"FW,MF",Marseille,Ligue 1,30,1990,9.5,8,6,2,4,2,3,11,27.3,8,7,2,5,11,19,22,0,0,2020-2021,90.0,104.21052631578948,75.78947368421052
972,Gervinho,CIV,FW,Parma,Serie A,33,1987,22.5,5,1,2,2,1,1,14,7.1,13,11,1,10,10,15,3,0,0,2020-2021,90.0,40.0,20.0
973,Willem Geubbels,FRA,"MF,FW",Monaco,Ligue 1,18,2001,3.3,12,8,5,7,0,5,13,38.5,8,9,0,9,3,15,5,0,0,2020-2021,90.0,81.81818181818181,327.27272727272725
974,Hamadi Al Ghaddioui,MAR,FW,Stuttgart,Bundesliga,29,1990,0.5,0,0,0,0,0,0,1,0.0,1,0,0,0,0,0,0,0,0,2020-2021,90.0,0.0,0.0
975,Anwar El Ghazi,NED,FW,Aston Villa,Premier League,25,1995,17.9,16,13,6,7,3,7,23,30.4,16,11,0,11,6,22,11,0,0,2020-2021,90.0,30.167597765363134,80.44692737430168
Rk,Player,Nation,Pos,Squad,Comp,0,0,90.0,0,0,3,3,3,Tkl,0,0.0,0,0,0,0,0,0,0,0,0,2020-2021,90.0,0.0,0.0
976,Paolo Ghiglione,ITA,"DF,MF",Genoa,Serie A,23,1997,15.1,27,15,17,8,2,13,28,46.4,15,14,2,12,13,40,25,0,0,2020-2021,90.0,77.48344370860927,160.9271523178808
977,Faouzi Ghoulam,ALG,"DF,FW",Napoli,Serie A,29,1991,3.2,6,5,3,2,1,0,1,0.0,1,4,2,2,3,9,1,0,0,2020-2021,90.0,84.375,168.75
978,Kieran Gibbs,ENG,DF,West Brom,Premier League,30,1989,9.0,15,11,11,3,1,8,10,80.0,2,8,6,2,16,31,30,1,0,2020-2021,90.0,160.0,150.0
979,Morgan Gibbs-White,ENG,"MF,FW",Wolves,Premier League,20,2000,4.6,9,7,3,4,2,5,12,41.7,7,6,0,6,3,12,1,0,0,2020-2021,90.0,58.69565217391305,176.08695652173915
980,Niko Gießelmann,GER,DF,Union Berlin,Bundesliga,28,1991,4.8,12,9,7,4,1,5,8,62.5,3,9,3,6,8,20,13,1,0,2020-2021,90.0,150.0,225.00000000000003
981,Rafał Gikiewicz,POL,GK,Augsburg,Bundesliga,32,1987,34.0,0,0,0,0,0,0,3,0.0,3,0,0,0,3,3,9,1,0,2020-2021,90.0,7.9411764705882355,0.0
982,Bryan Gil,ESP,FW,Sevilla,La Liga,19,2001,0.1,1,1,0,1,0,0,0,0.0,0,0,0,0,0,1,0,0,0,2020-2021,90.0,0.0,900.0
983,Bryan Gil,ESP,"MF,FW",Eibar,La Liga,19,2001,25.2,28,18,12,11,5,6,23,26.1,17,20,0,20,17,45,6,0,0,2020-2021,90.0,60.71428571428572,100.00000000000001
984,David Gil,ESP,GK,Cádiz,La Liga,26,1994,4.0,0,0,0,0,0,0,1,0.0,1,0,0,0,0,0,2,0,0,2020-2021,90.0,0.0,0.0
985,Billy Gilmour,SCO,MF,Chelsea,Premier League,19,2001,2.9,4,2,1,2,1,2,7,28.6,5,3,2,1,3,7,1,0,0,2020-2021,90.0,93.10344827586206,124.13793103448276
986,Álvaro Giménez,ESP,FW,Cádiz,La Liga,29,1991,4.5,4,2,2,2,0,0,3,0.0,3,2,0,2,2,6,3,0,0,2020-2021,90.0,40.0,80.0
987,Daniel Ginczek,GER,"FW,MF",Wolfsburg,Bundesliga,29,1991,2.4,2,2,1,1,0,2,8,25.0,6,2,0,2,1,3,2,0,0,2020-2021,90.0,37.5,75.0
988,Matthias Ginter,GER,DF,Gladbach,Bundesliga,26,1994,34.0,26,16,15,10,1,14,24,58.3,10,43,32,11,51,77,121,0,0,2020-2021,90.0,135.0,68.82352941176471
989,Andrei Girotto,BRA,"DF,MF",Nantes,Ligue 1,28,1992,29.6,65,41,50,15,0,39,70,55.7,31,34,15,19,59,124,103,0,0,2020-2021,90.0,179.39189189189187,197.63513513513513
990,Olivier Giroud,FRA,FW,Chelsea,Premier League,33,1986,8.3,4,2,0,1,3,1,7,14.3,6,4,1,3,5,9,10,0,0,2020-2021,90.0,54.21686746987951,43.37349397590361
991,Robert Glatzel,GER,FW,Mainz 05,Bundesliga,26,1994,4.0,1,0,1,0,0,0,2,0.0,2,2,0,2,0,1,2,0,0,2020-2021,90.0,0.0,22.5
992,Kamil Glik,POL,DF,Benevento,Serie A,32,1988,35.6,44,24,33,10,1,25,53,47.2,28,37,31,6,62,106,153,0,0,2020-2021,90.0,156.74157303370788,111.23595505617978
993,Serge Gnabry,GER,"FW,MF",Bayern Munich,Bundesliga,25,1995,18.3,39,19,7,19,13,12,32,37.5,20,17,0,17,26,65,3,0,0,2020-2021,90.0,127.8688524590164,191.80327868852459
994,Ben Godfrey,ENG,DF,Everton,Premier League,22,1998,29.8,55,33,37,15,3,27,41,65.9,14,56,37,19,33,88,120,0,0,2020-2021,90.0,99.66442953020133,166.10738255033556
995,Diego Godín,URU,DF,Cagliari,Serie A,34,1986,27.9,60,32,51,9,0,24,39,61.5,15,41,24,17,56,116,117,0,0,2020-2021,90.0,180.6451612903226,193.5483870967742
996,Akaki Gogia,GER,"FW,MF",Union Berlin,Bundesliga,28,1992,1.6,1,0,0,1,0,0,2,0.0,2,0,0,0,1,2,0,0,0,2020-2021,90.0,56.25,56.25
997,Amer Gojak,BIH,"MF,FW",Torino,Serie A,23,1997,5.3,1,0,1,0,0,1,7,14.3,6,5,0,5,3,4,1,0,0,2020-2021,90.0,50.943396226415096,16.9811320754717
998,Edoardo Goldaniga,ITA,DF,Genoa,Serie A,26,1993,20.6,28,18,21,7,0,14,23,60.9,9,17,7,10,38,66,62,1,0,2020-2021,90.0,166.01941747572815,122.33009708737863
999,Vladimir Golemić,SVN,DF,Crotone,Serie A,29,1991,26.0,33,16,17,13,3,14,19,73.7,5,38,26,12,40,73,97,2,0,2020-2021,90.00000000000001,138.46153846153848,114.23076923076924
1000,Pierluigi Gollini,ITA,GK,Atalanta,Serie A,25,1995,24.0,1,0,1,0,0,1,2,50.0,1,1,0,1,1,2,11,0,0,2020-2021,90.0,3.75,3.75
Rk,Player,Nation,Pos,Squad,Comp,0,0,90.0,0,0,3,3,3,Tkl,0,0.0,0,0,0,0,0,0,0,0,0,2020-2021,90.0,0.0,0.0
1001,Aleksandr Golovin,RUS,"MF,FW",Monaco,Ligue 1,24,1996,11.9,28,16,6,18,4,8,39,20.5,31,21,0,21,11,39,3,0,0,2020-2021,90.00000000000001,83.19327731092437,211.76470588235296
1002,Tomislav Gomelt,CRO,MF,Crotone,Serie A,25,1995,0.2,1,1,0,1,0,0,0,0.0,0,0,0,0,1,2,0,0,0,2020-2021,90.0,450.0,450.0
1003,André Gomes,POR,MF,Everton,Premier League,27,1993,17.4,35,23,16,16,3,17,58,29.3,41,19,1,18,10,45,12,1,0,2020-2021,90.0,51.724137931034484,181.0344827586207
1004,Dani Gómez,ESP,FW,Levante,La Liga,22,1998,18.5,4,3,2,1,1,0,11,0.0,11,3,0,3,2,6,4,0,0,2020-2021,90.0,9.72972972972973,19.45945945945946
1005,Ibai Gómez,ESP,MF,Athletic Club,La Liga,30,1989,4.7,6,4,2,3,1,4,7,57.1,3,3,0,3,2,8,4,0,0,2020-2021,90.0,38.29787234042553,114.89361702127658
1006,Joe Gomez,ENG,DF,Liverpool,Premier League,23,1997,6.6,3,2,1,1,1,0,4,0.0,4,3,2,1,4,7,29,0,0,2020-2021,90.0,54.54545454545455,40.90909090909091
1007,Maxi Gómez,URU,FW,Valencia,La Liga,23,1996,29.9,11,9,3,7,1,3,14,21.4,11,13,3,10,2,13,34,0,0,2020-2021,90.0,6.0200668896321075,33.11036789297659
1008,Moi Gómez,ESP,"MF,FW",Villarreal,La Liga,26,1994,28.5,21,12,6,8,7,14,35,40.0,21,20,3,17,11,32,16,0,0,2020-2021,90.0,34.73684210526316,66.31578947368422
1009,Papu Gómez,ARG,"MF,FW",Atalanta,Serie A,32,1988,7.4,3,2,2,1,0,2,8,25.0,6,8,1,7,1,4,1,0,0,2020-2021,90.0,12.162162162162161,36.486486486486484
1010,Papu Gómez,ARG,"MF,FW",Sevilla,La Liga,32,1988,10.2,9,6,2,4,3,2,12,16.7,10,13,2,11,7,16,6,0,0,2020-2021,90.0,61.76470588235294,79.41176470588236
1011,Sergi Gómez,ESP,DF,Sevilla,La Liga,28,1992,8.0,4,3,2,2,0,1,1,100.0,0,5,4,1,6,10,34,0,0,2020-2021,90.0,67.5,45.0
1012,Sergio Gómez,ESP,"MF,FW",Huesca,La Liga,19,2000,8.8,29,10,17,9,3,11,22,50.0,11,15,0,15,14,43,9,0,0,2020-2021,90.0,143.1818181818182,296.59090909090907
1013,Alfred Gomis,SEN,GK,Dijon,Ligue 1,26,1993,5.0,1,0,1,0,0,1,2,50.0,1,0,0,0,1,2,7,0,0,2020-2021,90.0,18.0,18.0
1014,Alfred Gomis,SEN,GK,Rennes,Ligue 1,26,1993,22.0,1,1,1,0,0,1,1,100.0,0,0,0,0,3,4,10,1,0,2020-2021,90.0,12.272727272727273,4.090909090909091
1015,Maxime Gonalons,FRA,MF,Granada,La Liga,31,1989,16.4,53,37,18,33,2,15,37,40.5,22,17,0,17,25,78,21,1,0,2020-2021,90.0,137.19512195121953,290.8536585365854
1016,Vagner Gonçalves,CPV,"FW,MF",Metz,Ligue 1,24,1996,10.7,16,9,5,5,6,2,15,13.3,13,6,0,6,4,20,1,1,0,2020-2021,90.0,33.64485981308412,134.57943925233647
1017,Álvaro González,ESP,DF,Marseille,Ligue 1,30,1990,31.5,26,17,20,6,0,19,31,61.3,12,30,18,12,33,59,119,1,0,2020-2021,90.0,94.28571428571429,74.28571428571429
1018,Bruno González,ESP,DF,Valladolid,La Liga,30,1990,25.1,26,17,18,8,0,17,31,54.8,14,22,14,8,37,63,112,1,0,2020-2021,90.0,132.66932270916334,93.22709163346613
1019,Diego González,ESP,DF,Elche,La Liga,25,1995,14.2,11,7,7,3,1,5,11,45.5,6,16,9,7,20,31,49,1,0,2020-2021,90.0,126.7605633802817,69.71830985915493
1020,Nicolás González,ARG,"FW,MF",Stuttgart,Bundesliga,22,1998,10.4,5,5,1,2,2,0,6,0.0,6,10,3,7,4,9,6,0,0,2020-2021,90.0,34.61538461538461,43.26923076923077
1021,Sergio González,ESP,"MF,DF",Cádiz,La Liga,23,1997,1.0,1,0,0,1,0,1,2,50.0,1,0,0,0,2,3,0,0,0,2020-2021,90.0,180.0,90.0
1022,Urko González,ESP,MF,Real Sociedad,La Liga,19,2001,0.5,0,0,0,0,0,0,1,0.0,1,1,1,0,0,0,1,0,0,2020-2021,90.0,0.0,0.0
1023,Anthony Gordon,ENG,"FW,MF",Everton,Premier League,19,2001,1.0,3,3,3,0,0,0,2,0.0,2,1,0,1,1,4,3,0,0,2020-2021,90.0,90.0,270.0
1024,Leon Goretzka,GER,MF,Bayern Munich,Bundesliga,25,1995,18.9,37,23,12,21,4,16,39,41.0,23,30,2,28,44,81,11,0,0,2020-2021,90.0,209.52380952380952,176.1904761904762
1025,Andoni Gorosabel,ESP,DF,Real Sociedad,La Liga,23,1996,26.5,76,43,45,20,11,27,64,42.2,37,25,4,21,23,99,42,0,0,2020-2021,90.0,78.11320754716981,258.1132075471698
Rk,Player,Nation,Pos,Squad,Comp,0,0,90.0,0,0,3,3,3,Tkl,0,0.0,0,0,0,0,0,0,0,0,0,2020-2021,90.0,0.0,0.0
1026,Robin Gosens,GER,DF,Atalanta,Serie A,26,1994,28.0,46,35,20,15,11,17,41,41.5,24,50,7,43,41,87,34,0,0,2020-2021,90.0,131.78571428571428,147.85714285714286
1027,Amine Gouiri,ALG,"FW,MF",Nice,Ligue 1,20,2000,30.5,31,18,7,16,8,10,41,24.4,31,22,6,16,17,48,23,0,0,2020-2021,90.0,50.1639344262295,91.47540983606557
1028,Lucas Gourna-Douath,FRA,MF,Saint-Étienne,Ligue 1,16,2003,14.7,32,22,18,11,3,15,28,53.6,13,10,0,10,24,56,18,0,0,2020-2021,90.0,146.9387755102041,195.91836734693877
1029,Jeffrey Gouweleeuw,NED,DF,Augsburg,Bundesliga,29,1991,31.5,36,20,24,11,1,16,33,48.5,17,37,18,19,69,105,149,2,0,2020-2021,90.0,197.14285714285717,102.85714285714286
1030,Jonathan Gradit,FRA,DF,Lens,Ligue 1,27,1992,31.4,60,39,26,28,6,22,38,57.9,16,37,19,18,56,116,81,1,0,2020-2021,90.0,160.5095541401274,171.97452229299364
1031,Karlan Grant,ENG,"FW,MF",West Brom,Premier League,22,1997,12.5,5,3,3,2,0,2,4,50.0,2,7,0,7,5,10,17,0,0,2020-2021,90.0,36.0,36.0
1032,Alberto Grassi,ITA,"MF,DF",Parma,Serie A,25,1995,13.1,30,11,14,13,3,8,29,27.6,21,22,9,13,26,56,32,0,0,2020-2021,90.0,178.6259541984733,206.10687022900765
1033,Andrew Gravillon,GLP,DF,Lorient,Ligue 1,22,1998,25.2,26,17,17,9,0,13,28,46.4,15,44,31,13,59,85,118,4,0,2020-2021,90.0,210.71428571428572,92.85714285714286
1034,Demarai Gray,JAM,FW,Leicester City,Premier League,24,1996,0.2,1,1,1,0,0,0,0,0.0,0,0,0,0,0,1,0,0,0,2020-2021,90.0,0.0,450.0
1035,Demarai Gray,JAM,FW,Leverkusen,Bundesliga,24,1996,4.9,3,2,1,2,0,1,1,100.0,0,3,0,3,4,7,3,0,0,2020-2021,90.0,73.46938775510203,55.10204081632653
1036,Adrian Grbić,AUT,FW,Lorient,Ligue 1,23,1996,10.7,6,4,2,2,2,1,7,14.3,6,6,0,6,5,11,7,0,0,2020-2021,90.0,42.056074766355145,50.46728971962617
1037,Jack Grealish,ENG,"FW,MF",Aston Villa,Premier League,24,1995,24.3,31,14,8,16,7,15,24,62.5,9,20,3,17,12,43,5,3,0,2020-2021,90.0,44.44444444444444,114.81481481481481
1038,Etienne Green,ENG,GK,Saint-Étienne,Ligue 1,20,2000,8.0,0,0,0,0,0,0,0,0.0,0,0,0,0,0,0,3,0,0,2020-2021,90.0,0.0,0.0
1039,Mason Greenwood,ENG,FW,Manchester Utd,Premier League,18,2001,20.2,13,10,6,4,3,5,22,22.7,17,9,0,9,5,18,1,0,0,2020-2021,90.0,22.277227722772277,57.92079207920792
1040,Michael Gregoritsch,AUT,"FW,MF",Augsburg,Bundesliga,26,1994,9.3,13,10,6,7,0,3,10,30.0,7,2,0,2,3,16,17,0,0,2020-2021,90.0,29.032258064516125,125.8064516129032
1041,Clément Grenier,FRA,"MF,FW",Rennes,Ligue 1,29,1991,12.0,20,8,9,8,3,7,31,22.6,24,7,0,7,5,25,3,0,0,2020-2021,90.0,37.5,150.0
1042,Sebastian Griesbeck,GER,MF,Union Berlin,Bundesliga,29,1990,9.9,20,9,8,11,1,8,19,42.1,11,13,3,10,5,25,8,0,0,2020-2021,90.0,45.45454545454545,181.8181818181818
1043,Antoine Griezmann,FRA,"FW,MF",Barcelona,La Liga,29,1991,28.9,37,22,10,18,9,12,40,30.0,28,20,1,19,12,49,11,0,0,2020-2021,90.00000000000001,37.37024221453288,115.2249134948097
1044,Vincenzo Grifo,ITA,"MF,FW",Freiburg,Bundesliga,27,1993,25.7,18,7,6,7,5,14,34,41.2,20,13,0,13,27,45,18,1,0,2020-2021,90.0,94.55252918287937,63.035019455252915
1045,Lennart Grill,GER,GK,Leverkusen,Bundesliga,21,1999,4.0,0,0,0,0,0,0,0,0.0,0,0,0,0,0,0,2,0,0,2020-2021,90.0,0.0,0.0
1046,Florian Grillitsch,AUT,"MF,DF",Hoffenheim,Bundesliga,24,1995,20.9,37,21,21,13,3,19,52,36.5,33,38,7,31,51,88,47,1,0,2020-2021,90.0,219.61722488038276,159.33014354066987
1047,Christian Groß,GER,"MF,DF",Werder Bremen,Bundesliga,31,1989,16.3,44,28,17,25,2,15,37,40.5,22,12,2,10,24,68,37,0,0,2020-2021,90.0,132.51533742331287,242.94478527607362
1048,Pascal Groß,GER,"MF,DF",Brighton,Premier League,29,1991,27.6,45,24,24,15,6,24,53,45.3,29,25,4,21,23,68,18,1,0,2020-2021,90.0,74.99999999999999,146.7391304347826
1049,Kamil Grosicki,POL,"MF,FW",West Brom,Premier League,32,1988,1.6,2,1,2,0,0,2,8,25.0,6,1,0,1,2,4,1,0,0,2020-2021,90.0,112.5,112.5
1050,Ilia Gruev,BUL,FW,Werder Bremen,Bundesliga,20,2000,0.0,0,0,0,0,0,0,0,0.0,0,0,0,0,0,0,0,0,0,2020-2021,,,
Rk,Player,Nation,Pos,Squad,Comp,0,0,90.0,0,0,3,3,3,Tkl,0,0.0,0,0,0,0,0,0,0,0,0,2020-2021,90.0,0.0,0.0
1051,Carlos Gruezo,ECU,MF,Augsburg,Bundesliga,25,1995,23.2,57,32,20,32,5,20,52,38.5,32,32,5,27,35,92,29,1,0,2020-2021,90.0,135.77586206896552,221.1206896551724
1052,Vicente Guaita,ESP,GK,Crystal Palace,Premier League,33,1987,37.0,1,1,1,0,0,1,1,100.0,0,0,0,0,1,2,11,1,0,2020-2021,90.0,2.4324324324324325,2.4324324324324325
1053,Andrés Guardado,MEX,MF,Betis,La Liga,33,1986,14.6,25,12,10,11,4,10,25,40.0,15,13,3,10,18,43,19,0,0,2020-2021,90.0,110.95890410958904,154.1095890410959
1054,Sergi Guardiola,ESP,FW,Valladolid,La Liga,29,1991,19.9,11,5,1,5,5,2,27,7.4,25,12,1,11,7,18,16,3,0,2020-2021,90.0,31.658291457286435,49.74874371859297
1055,Nemanja Gudelj,SRB,"MF,DF",Sevilla,La Liga,28,1991,11.6,23,12,16,5,2,4,10,40.0,6,10,6,4,24,47,24,2,0,2020-2021,90.0,186.20689655172413,178.44827586206898
1056,Gonçalo Guedes,POR,"MF,FW",Valencia,La Liga,23,1996,25.4,18,12,8,7,3,10,45,22.2,35,24,1,23,8,26,7,0,0,2020-2021,90.0,28.34645669291339,63.77952755905512
1057,Mattéo Guendouzi,FRA,MF,Hertha BSC,Bundesliga,21,1999,20.2,24,13,10,12,2,9,25,36.0,16,15,4,11,21,45,24,1,0,2020-2021,90.0,93.56435643564356,106.93069306930693
1058,Raphaël Guerreiro,POR,DF,Dortmund,Bundesliga,26,1993,24.6,30,13,14,8,8,16,31,51.6,15,21,4,17,28,58,31,1,0,2020-2021,89.99999999999999,102.43902439024389,109.75609756097559
1059,Evann Guessand,CIV,FW,Nice,Ligue 1,19,2001,0.3,0,0,0,0,0,0,1,0.0,1,1,1,0,1,1,1,0,0,2020-2021,90.0,300.0,0.0
1060,Kelyan Guessoum,FRA,DF,Nîmes,Ligue 1,21,1999,12.5,13,7,11,1,1,11,16,68.8,5,8,6,2,24,37,51,0,0,2020-2021,90.0,172.79999999999998,93.6
1061,Ander Guevara,ESP,MF,Real Sociedad,La Liga,23,1997,23.1,35,23,15,16,4,15,30,50.0,15,19,5,14,25,60,35,1,0,2020-2021,89.99999999999999,97.40259740259738,136.36363636363635
1062,Lamine Gueye,SEN,"FW,MF",Metz,Ligue 1,22,1998,16.2,18,9,4,11,3,7,24,29.2,17,7,2,5,21,39,5,0,0,2020-2021,90.0,116.66666666666667,100.0
1063,Pape Gueye,SEN,MF,Marseille,Ligue 1,21,1999,22.9,49,21,25,19,5,15,45,33.3,30,25,6,19,47,96,34,0,0,2020-2021,90.0,184.7161572052402,192.57641921397382
1064,John Guidetti,SWE,FW,Alavés,La Liga,28,1992,2.3,2,2,0,2,0,0,2,0.0,2,0,0,0,1,3,2,0,0,2020-2021,90.0,39.130434782608695,78.26086956521739
1065,Josuha Guilavogui,FRA,"MF,DF",Wolfsburg,Bundesliga,29,1990,8.3,17,9,9,8,0,5,12,41.7,7,12,5,7,29,46,25,0,0,2020-2021,90.0,314.4578313253012,184.33734939759034
1066,Frederic Guilbert,FRA,DF,Strasbourg,Ligue 1,25,1994,12.4,37,19,23,11,3,21,34,61.8,13,14,1,13,33,70,32,0,0,2020-2021,90.0,239.51612903225808,268.5483870967742
1067,Hugo Guillamón,ESP,DF,Valencia,La Liga,20,2000,22.1,23,13,17,6,0,8,20,40.0,12,19,14,5,27,50,102,3,0,2020-2021,90.0,109.95475113122171,93.66515837104072
1068,Bruno Guimarães,BRA,MF,Lyon,Ligue 1,22,1997,19.5,76,34,26,41,9,30,64,46.9,34,24,4,20,14,90,13,0,0,2020-2021,90.0,64.61538461538461,350.7692307692308
1069,Serhou Guirassy,GUI,FW,Rennes,Ligue 1,24,1996,19.6,4,1,1,3,0,1,3,33.3,2,10,1,9,5,9,17,0,0,2020-2021,90.0,22.959183673469386,18.36734693877551
1070,Péter Gulácsi,HUN,GK,RB Leipzig,Bundesliga,30,1990,33.0,1,0,1,0,0,1,2,50.0,1,0,0,0,2,3,7,0,0,2020-2021,90.0,5.454545454545455,2.7272727272727275
1071,Manuel Gulde,GER,DF,Freiburg,Bundesliga,29,1991,21.7,27,15,12,12,3,5,21,23.8,16,25,15,10,37,64,64,0,0,2020-2021,90.0,153.45622119815667,111.9815668202765
1072,Robert Gumny,POL,DF,Augsburg,Bundesliga,22,1998,15.3,24,15,12,9,3,15,23,65.2,8,12,2,10,18,42,31,0,0,2020-2021,90.0,105.88235294117646,141.17647058823528
1073,İlkay Gündoğan,GER,MF,Manchester City,Premier League,29,1990,22.5,25,15,8,12,5,10,39,25.6,29,13,4,9,20,45,9,0,0,2020-2021,90.0,80.0,100.0
1074,Christian Günter,GER,"DF,MF",Freiburg,Bundesliga,27,1993,34.0,34,19,18,13,3,15,43,34.9,28,38,9,29,29,63,40,0,0,2020-2021,90.0,76.76470588235294,90.0
1075,Koray Günter,GER,DF,Hellas Verona,Serie A,25,1994,19.6,20,10,10,9,1,4,9,44.4,5,27,21,6,70,90,87,0,0,2020-2021,90.0,321.4285714285714,91.83673469387755
Rk,Player,Nation,Pos,Squad,Comp,0,0,90.0,0,0,3,3,3,Tkl,0,0.0,0,0,0,0,0,0,0,0,0,2020-2021,90.0,0.0,0.0
1076,Jon Guridi,ESP,MF,Real Sociedad,La Liga,25,1995,9.2,19,9,10,6,3,8,22,36.4,14,8,1,7,10,29,9,0,0,2020-2021,90.0,97.82608695652175,185.8695652173913
1077,Malo Gusto,FRA,"DF,MF",Lyon,Ligue 1,17,2003,0.0,0,0,0,0,0,0,0,0.0,0,0,0,0,0,0,0,0,0,2020-2021,,,
1078,Raúl Guti,ESP,MF,Elche,La Liga,23,1996,31.8,48,28,21,22,5,16,52,30.8,36,25,3,22,49,97,25,0,0,2020-2021,90.0,138.67924528301887,135.8490566037736
1079,Marcos Mauro López Gutiérrez,ARG,DF,Cádiz,La Liga,29,1991,20.3,23,15,15,8,0,15,24,62.5,9,18,12,6,22,45,78,0,0,2020-2021,90.0,97.53694581280787,101.9704433497537
1080,Miguel Gutiérrez,ESP,DF,Real Madrid,La Liga,19,2001,3.5,4,0,0,3,1,1,7,14.3,6,3,0,3,5,9,5,0,0,2020-2021,90.0,128.57142857142856,102.85714285714286
1081,Manu Gyabuaa,ITA,MF,Atalanta,Serie A,18,2001,0.0,0,0,0,0,0,0,0,0.0,0,0,0,0,0,0,0,0,0,2020-2021,,,
1082,Emmanuel Gyasi,GHA,FW,Spezia,Serie A,26,1994,31.7,30,16,16,10,4,9,31,29.0,22,13,2,11,14,44,8,0,0,2020-2021,90.0,39.74763406940063,85.17350157728707
1083,Erling Haaland,NOR,FW,Dortmund,Bundesliga,20,2000,26.7,7,2,1,3,3,1,4,25.0,3,19,4,15,4,11,16,0,0,2020-2021,90.00000000000001,13.483146067415731,23.59550561797753
1084,Janik Haberer,GER,"MF,FW",Freiburg,Bundesliga,26,1994,5.4,7,4,4,3,0,3,15,20.0,12,4,1,3,7,14,9,0,0,2020-2021,90.0,116.66666666666666,116.66666666666666
1085,Alexander Hack,GER,DF,Mainz 05,Bundesliga,26,1993,15.2,32,21,23,8,1,18,31,58.1,13,26,17,9,41,73,91,2,0,2020-2021,90.0,242.76315789473682,189.4736842105263
1086,Antwoine Hackford,ENG,DF,Sheffield Utd,Premier League,16,2004,0.1,0,0,0,0,0,0,0,0.0,0,0,0,0,0,0,0,0,0,2020-2021,90.0,0.0,0.0
1087,Munir El Haddadi,MAR,FW,Sevilla,La Liga,24,1995,9.4,12,8,5,5,2,2,12,16.7,10,6,0,6,5,17,6,0,0,2020-2021,90.0,47.87234042553191,114.89361702127658
1088,André Hahn,GER,"FW,MF",Augsburg,Bundesliga,29,1990,22.6,31,17,14,13,4,9,44,20.5,35,35,3,32,14,45,24,0,0,2020-2021,90.0,55.75221238938053,123.45132743362832
1089,Amadou Haidara,MLI,"MF,FW",RB Leipzig,Bundesliga,22,1998,21.2,50,28,20,21,9,11,36,30.6,25,33,1,32,30,80,24,0,0,2020-2021,90.0,127.35849056603774,212.26415094339623
1090,Massadio Haïdara,MLI,DF,Lens,Ligue 1,27,1992,23.7,48,32,21,21,6,23,37,62.2,14,29,6,23,35,83,60,0,0,2020-2021,90.0,132.9113924050633,182.27848101265823
1091,Achraf Hakimi,MAR,DF,Inter,Serie A,21,1998,29.6,53,32,23,19,11,23,48,47.9,25,31,1,30,22,75,23,1,0,2020-2021,90.0,66.89189189189189,161.14864864864865
1092,Sébastien Haller,CIV,FW,West Ham,Premier League,26,1994,10.4,14,9,1,6,7,4,20,20.0,16,7,1,6,5,19,7,0,0,2020-2021,90.0,43.26923076923077,121.15384615384615
1093,Marcel Halstenberg,GER,DF,RB Leipzig,Bundesliga,28,1991,18.3,29,18,20,8,1,19,41,46.3,22,15,3,12,16,45,35,0,0,2020-2021,90.0,78.68852459016394,142.62295081967213
1094,Pierre-Yves Hamel,FRA,FW,Lorient,Ligue 1,26,1994,9.4,15,8,3,9,3,1,6,16.7,5,12,1,11,10,25,6,0,0,2020-2021,90.0,95.74468085106382,143.61702127659572
1095,Romain Hamouma,FRA,"FW,MF",Saint-Étienne,Ligue 1,33,1987,19.7,12,7,5,6,1,4,24,16.7,20,17,1,16,7,19,11,0,0,2020-2021,90.0,31.97969543147208,54.82233502538071
1096,Samir Handanović,SVN,GK,Inter,Serie A,36,1984,36.0,1,0,1,0,0,1,1,100.0,0,0,0,0,0,1,6,3,0,2020-2021,90.0,0.0,2.5
1097,Lukáš Haraslín,SVK,"FW,MF",Sassuolo,Serie A,24,1996,3.7,8,4,2,5,1,2,5,40.0,3,1,0,1,0,8,2,0,0,2020-2021,90.0,0.0,194.59459459459458
1098,Amine Harit,MAR,"MF,FW",Schalke 04,Bundesliga,23,1997,23.3,22,13,8,11,3,10,23,43.5,13,9,1,8,17,39,7,1,0,2020-2021,90.0,65.66523605150215,84.97854077253218
1099,Rekeem Harper,ENG,MF,West Brom,Premier League,20,2000,0.4,0,0,0,0,0,0,0,0.0,0,2,0,2,1,1,0,0,0,2020-2021,90.0,225.0,0.0
1100,Jack Harrison,ENG,"MF,FW",Leeds United,Premier League,23,1996,31.6,63,38,20,30,13,26,59,44.1,33,30,2,28,15,78,21,0,0,2020-2021,90.0,42.72151898734177,179.43037974683543
Rk,Player,Nation,Pos,Squad,Comp,0,0,90.0,0,0,3,3,3,Tkl,0,0.0,0,0,0,0,0,0,0,0,0,2020-2021,90.0,0.0,0.0
1101,Marcel Hartel,GER,MF,Arminia,Bundesliga,24,1996,18.7,35,19,15,18,2,20,40,50.0,20,17,4,13,26,61,16,1,0,2020-2021,90.0,125.13368983957218,168.44919786096256
1102,Makoto Hasebe,JPN,"DF,MF",Eint Frankfurt,Bundesliga,36,1984,25.4,43,29,21,20,2,25,51,49.0,26,31,12,19,31,74,68,2,0,2020-2021,90.0,109.84251968503938,152.36220472440945
1103,Hans Hateboer,NED,DF,Atalanta,Serie A,26,1994,19.6,28,17,12,14,2,13,23,56.5,10,8,1,7,17,45,9,0,0,2020-2021,90.0,78.06122448979592,128.57142857142856
1104,Kortney Hause,ENG,DF,Aston Villa,Premier League,25,1995,7.0,4,2,3,1,0,0,3,0.0,3,4,2,2,8,12,53,0,0,2020-2021,90.0,102.85714285714286,51.42857142857143
1105,Kai Havertz,GER,"MF,FW",Chelsea,Premier League,21,1999,16.9,18,9,6,10,2,6,27,22.2,21,25,0,25,4,22,22,1,0,2020-2021,90.0,21.301775147928996,95.85798816568048
1106,Isaac Hayden,ENG,"MF,DF",Newcastle Utd,Premier League,25,1995,21.6,52,29,23,22,7,14,35,40.0,21,32,9,23,43,95,47,0,0,2020-2021,90.0,179.16666666666666,216.66666666666666
1107,Eden Hazard,BEL,"FW,MF",Real Madrid,La Liga,29,1991,5.9,3,2,1,2,0,0,3,0.0,3,3,0,3,3,6,0,0,0,2020-2021,90.0,45.762711864406775,45.762711864406775
1108,Thorgan Hazard,BEL,"MF,FW",Dortmund,Bundesliga,27,1993,7.3,8,2,6,1,1,3,13,23.1,10,4,0,4,10,18,1,0,0,2020-2021,90.0,123.28767123287672,98.63013698630138
1109,Jonas Hector,GER,"MF,FW",Köln,Bundesliga,30,1990,14.3,34,22,8,21,5,15,35,42.9,20,24,5,19,19,53,20,1,0,2020-2021,90.0,119.58041958041959,213.986013986014
1110,Michael Hector,JAM,DF,Fulham,Premier League,28,1992,2.9,3,2,1,2,0,1,6,16.7,5,4,2,2,0,3,6,0,0,2020-2021,90.0,0.0,93.10344827586206
1111,Hwang Hee-chan,KOR,"FW,MF",RB Leipzig,Bundesliga,24,1996,5.1,3,2,1,0,2,1,7,14.3,6,4,0,4,1,4,1,0,0,2020-2021,90.0,17.647058823529413,52.94117647058824
1112,Ahmed Hegazi,EGY,DF,West Brom,Premier League,29,1991,1.0,0,0,0,0,0,0,0,0.0,0,2,0,2,1,1,7,0,0,2020-2021,90.0,90.0,0.0
1113,Dominique Heintz,GER,DF,Freiburg,Bundesliga,26,1993,15.2,22,11,19,3,0,10,19,52.6,9,10,8,2,35,57,49,0,0,2020-2021,90.0,207.23684210526315,130.26315789473685
1114,Dean Henderson,ENG,GK,Manchester Utd,Premier League,23,1997,12.5,1,1,1,0,0,1,2,50.0,1,0,0,0,0,1,3,2,0,2020-2021,90.0,0.0,7.199999999999999
1115,Jordan Henderson,ENG,"MF,DF",Liverpool,Premier League,30,1990,18.9,24,15,12,9,3,10,26,38.5,16,12,1,11,34,58,30,0,0,2020-2021,90.0,161.9047619047619,114.28571428571429
1116,Jeff Hendrick,IRL,MF,Newcastle Utd,Premier League,28,1992,15.8,8,3,5,3,0,1,13,7.7,12,14,9,5,19,27,18,0,0,2020-2021,90.0,108.2278481012658,45.56962025316455
1117,Benjamin Henrichs,GER,"DF,MF",RB Leipzig,Bundesliga,23,1997,6.0,12,7,4,5,3,2,9,22.2,7,9,1,8,8,20,8,0,0,2020-2021,90.0,120.0,180.0
1118,Dalbert Henrique,BRA,DF,Rennes,Ligue 1,26,1993,4.1,7,6,4,2,1,6,8,75.0,2,8,2,6,5,12,8,0,0,2020-2021,90.0,109.75609756097562,153.65853658536588
1119,Eduardo Henrique,BRA,MF,Crotone,Serie A,25,1995,10.3,5,2,1,4,0,3,12,25.0,9,6,1,5,7,12,7,1,0,2020-2021,90.0,61.165048543689316,43.689320388349515
1120,Luis Henrique,BRA,"FW,DF",Marseille,Ligue 1,18,2001,7.5,5,4,3,1,1,4,9,44.4,5,5,1,4,7,12,4,0,0,2020-2021,90.0,84.0,60.0
1121,Christophe Hérelle,MTQ,DF,Brest,Ligue 1,27,1992,15.3,19,13,12,6,1,10,12,83.3,2,13,9,4,31,50,41,2,0,2020-2021,90.0,182.35294117647058,111.76470588235293
1122,Jérôme Hergault,FRA,"DF,MF",Lorient,Ligue 1,34,1986,18.1,38,23,22,10,6,17,31,54.8,14,16,2,14,22,60,34,0,0,2020-2021,90.0,109.39226519337015,188.9502762430939
1123,Mario Hermoso,ESP,DF,Atlético Madrid,La Liga,25,1995,28.6,55,31,40,11,4,37,61,60.7,24,23,10,13,36,91,73,0,0,2020-2021,90.0,113.2867132867133,173.0769230769231
1124,Aridane Hernández,ESP,DF,Osasuna,La Liga,31,1989,22.5,20,11,13,6,1,7,12,58.3,5,22,19,3,34,54,127,1,0,2020-2021,90.0,136.0,80.0
1125,Lucas Hernández,FRA,DF,Bayern Munich,Bundesliga,24,1996,17.7,41,31,16,17,8,17,31,54.8,14,24,6,18,19,60,38,0,0,2020-2021,90.0,96.61016949152543,208.47457627118646
Rk,Player,Nation,Pos,Squad,Comp,0,0,90.0,0,0,3,3,3,Tkl,0,0.0,0,0,0,0,0,0,0,0,0,2020-2021,90.0,0.0,0.0
1126,Pablo Hernández,ESP,MF,Leeds United,Premier League,35,1985,4.7,5,3,2,1,2,5,16,31.3,11,2,0,2,0,5,0,1,0,2020-2021,90.0,0.0,95.74468085106382
1127,Theo Hernández,FRA,DF,Milan,Serie A,22,1997,32.6,48,29,22,21,5,19,38,50.0,19,29,6,23,34,82,64,5,0,2020-2021,90.0,93.86503067484662,132.51533742331287
1128,Hernani,BRA,MF,Parma,Serie A,26,1994,24.3,51,25,21,27,3,29,66,43.9,37,35,4,31,31,82,40,1,0,2020-2021,90.0,114.81481481481481,188.88888888888889
1129,Ander Herrera,ESP,MF,Paris S-G,Ligue 1,30,1989,20.6,53,35,17,26,10,30,77,39.0,47,31,5,26,31,84,22,1,0,2020-2021,90.0,135.4368932038835,231.5533980582524
1130,Héctor Herrera,MEX,MF,Atlético Madrid,La Liga,30,1990,7.6,12,7,5,6,1,7,13,53.8,6,7,2,5,14,26,8,0,0,2020-2021,90.0,165.78947368421052,142.10526315789474
1131,Sergio Herrera,ESP,GK,Osasuna,La Liga,27,1993,32.9,0,0,0,0,0,0,2,0.0,2,0,0,0,3,3,29,3,0,2020-2021,90.0,8.206686930091186,0.0
1132,Yangel Herrera,VEN,MF,Granada,La Liga,22,1998,25.7,59,26,19,32,8,11,41,26.8,30,53,17,36,26,85,32,1,0,2020-2021,90.0,91.05058365758755,206.6147859922179
1133,Patrick Herrmann,GER,"FW,MF",Gladbach,Bundesliga,29,1991,9.7,9,6,4,3,2,2,14,14.3,12,16,0,16,10,19,8,0,0,2020-2021,90.0,92.78350515463919,83.50515463917527
1134,Pablo Hervías,ESP,"DF,MF",Valladolid,La Liga,27,1993,13.4,19,12,7,9,3,9,26,34.6,17,6,0,6,11,30,8,0,0,2020-2021,90.0,73.88059701492537,127.61194029850745
1135,Përparim Hetemaj,FIN,MF,Benevento,Serie A,33,1986,24.6,44,27,21,18,5,26,61,42.6,35,41,5,36,22,66,24,1,0,2020-2021,89.99999999999999,80.48780487804876,160.97560975609753
1136,Son Heung-min,KOR,FW,Tottenham,Premier League,28,1992,34.6,32,18,11,14,7,18,72,25.0,54,28,3,25,14,46,8,0,0,2020-2021,90.0,36.41618497109826,83.23699421965317
1137,Aaron Hickey,SCO,DF,Bologna,Serie A,18,2002,8.4,12,8,10,2,0,7,17,41.2,10,6,1,5,15,27,15,1,0,2020-2021,90.0,160.7142857142857,128.57142857142856
1138,Vitorino Hilton,BRA,DF,Montpellier,Ligue 1,42,1977,23.5,15,10,10,4,1,3,14,21.4,11,34,26,8,38,53,104,3,0,2020-2021,90.0,145.531914893617,57.44680851063829
1139,Martin Hinteregger,AUT,DF,Eint Frankfurt,Bundesliga,27,1992,28.1,77,49,53,22,2,37,63,58.7,26,31,12,19,44,121,92,0,0,2020-2021,90.0,140.92526690391458,246.61921708185054
1140,Marwin Hitz,SUI,GK,Dortmund,Bundesliga,32,1987,15.5,1,1,1,0,0,1,1,100.0,0,0,0,0,0,1,7,1,0,2020-2021,90.0,0.0,5.806451612903226
1141,Wesley Hoedt,NED,DF,Lazio,Serie A,26,1994,10.6,22,16,18,4,0,10,17,58.8,7,9,5,4,17,39,48,1,0,2020-2021,90.0,144.33962264150944,186.7924528301887
1142,Ki-Jana Hoever,NED,"DF,MF",Wolves,Premier League,18,2002,6.4,14,6,11,2,1,10,22,45.5,12,2,0,2,9,23,23,0,0,2020-2021,90.0,126.5625,196.875
1143,Nicolas Höfler,GER,MF,Freiburg,Bundesliga,30,1990,30.3,54,28,16,31,7,23,59,39.0,36,34,10,24,66,120,41,2,0,2020-2021,90.0,196.03960396039605,160.3960396039604
1144,Jonas Hofmann,GER,"FW,MF",Gladbach,Bundesliga,28,1992,20.2,26,20,12,12,2,10,53,18.9,43,27,2,25,27,53,9,0,0,2020-2021,90.0,120.29702970297029,115.84158415841584
1145,Marco Höger,GER,"DF,MF",Köln,Bundesliga,30,1989,0.6,1,0,0,1,0,1,2,50.0,1,2,0,2,2,3,1,0,0,2020-2021,90.0,300.0,150.0
1146,Rob Holding,ENG,DF,Arsenal,Premier League,24,1995,28.4,43,20,28,13,2,17,35,48.6,18,37,27,10,24,67,120,0,0,2020-2021,90.0,76.05633802816902,136.26760563380282
1147,Lucas Höler,GER,"FW,MF",Freiburg,Bundesliga,26,1994,23.2,36,24,13,19,4,12,32,37.5,20,19,2,17,16,52,14,0,0,2020-2021,90.0,62.06896551724138,139.6551724137931
1148,Mason Holgate,ENG,DF,Everton,Premier League,23,1996,25.4,56,36,31,18,7,20,50,40.0,30,37,13,24,35,91,90,3,0,2020-2021,90.0,124.01574803149607,198.42519685039372
1149,Jordan Holsgrove,SCO,MF,Celta Vigo,La Liga,20,1999,1.6,6,4,4,1,1,5,8,62.5,3,2,0,2,2,8,1,0,0,2020-2021,90.0,112.5,337.5
1150,Franck Honorat,FRA,"MF,FW",Brest,Ligue 1,23,1996,27.3,28,13,12,10,6,14,37,37.8,23,15,3,12,11,39,24,0,0,2020-2021,90.0,36.26373626373626,92.3076923076923
Rk,Player,Nation,Pos,Squad,Comp,0,0,90.0,0,0,3,3,3,Tkl,0,0.0,0,0,0,0,0,0,0,0,0,2020-2021,90.0,0.0,0.0
1151,Matthew Hoppe,USA,FW,Schalke 04,Bundesliga,19,2001,14.5,6,6,1,3,2,2,12,16.7,10,8,2,6,4,10,15,0,0,2020-2021,90.0,24.82758620689655,37.241379310344826
1152,Jannes Horn,GER,DF,Köln,Bundesliga,23,1997,19.6,35,19,23,11,1,23,31,74.2,8,19,2,17,10,45,45,0,0,2020-2021,90.0,45.91836734693877,160.7142857142857
1153,Timo Horn,GER,GK,Köln,Bundesliga,27,1993,33.4,1,0,1,0,0,1,4,25.0,3,1,0,1,0,1,11,2,0,2020-2021,90.0,0.0,2.694610778443114
1154,Fraser Hornby,SCO,"FW,MF",Reims,Ligue 1,20,1999,0.4,0,0,0,0,0,0,0,0.0,0,0,0,0,1,1,0,0,0,2020-2021,90.0,225.0,0.0
1155,Conor Hourihane,IRL,MF,Aston Villa,Premier League,29,1991,2.5,0,0,0,0,0,0,2,0.0,2,3,0,3,0,0,2,0,0,2020-2021,90.0,0.0,0.0
1156,Lukáš Hrádecký,FIN,GK,Leverkusen,Bundesliga,30,1989,28.5,0,0,0,0,0,0,1,0.0,1,0,0,0,1,1,11,3,0,2020-2021,90.0,3.1578947368421053,0.0
1157,Ajdin Hrustic,AUS,"MF,DF",Eint Frankfurt,Bundesliga,24,1996,3.0,6,5,2,3,1,3,10,30.0,7,2,0,2,4,10,3,0,0,2020-2021,90.0,120.0,180.0
1158,Florian Hübner,GER,DF,Union Berlin,Bundesliga,29,1991,5.8,10,5,7,3,0,7,15,46.7,8,7,3,4,13,23,21,0,0,2020-2021,90.0,201.72413793103448,155.17241379310346
1159,Callum Hudson-Odoi,ENG,"FW,DF",Chelsea,Premier League,19,2000,11.8,23,15,11,7,5,8,21,38.1,13,15,1,14,6,29,6,0,0,2020-2021,90.0,45.762711864406775,175.4237288135593
1160,Niall Huggins,WAL,DF,Leeds United,Premier League,19,2000,0.4,0,0,0,0,0,0,1,0.0,1,0,0,0,0,0,1,0,0,2020-2021,90.0,0.0,0.0
1161,Mats Hummels,GER,DF,Dortmund,Bundesliga,31,1988,31.3,58,40,34,18,6,26,42,61.9,16,31,22,9,73,131,122,2,0,2020-2021,90.0,209.90415335463257,166.77316293929712
1162,Adrien Hunou,FRA,"FW,MF",Rennes,Ligue 1,26,1994,6.5,6,3,2,2,2,2,8,25.0,6,7,0,7,1,7,2,0,0,2020-2021,90.00000000000001,13.846153846153847,83.07692307692308
1163,Klaas-Jan Huntelaar,NED,FW,Schalke 04,Bundesliga,36,1983,6.5,4,2,0,2,2,0,2,0.0,2,3,1,2,2,6,3,0,0,2020-2021,90.00000000000001,27.692307692307693,55.38461538461539
1164,Elseid Hysaj,ALB,DF,Napoli,Serie A,26,1994,19.6,29,17,16,11,2,17,33,51.5,16,18,4,14,30,59,52,0,0,2020-2021,90.0,137.75510204081633,133.16326530612244
1165,Pierre Højbjerg,DEN,MF,Tottenham,Premier League,24,1995,38.0,98,51,45,42,11,54,129,41.9,75,51,9,42,48,146,66,0,0,2020-2021,90.0,113.6842105263158,232.10526315789474
1166,Simone Iacoponi,ITA,DF,Parma,Serie A,33,1987,13.3,22,12,16,5,1,13,26,50.0,13,9,4,5,11,33,42,1,0,2020-2021,90.0,74.4360902255639,148.8721804511278
1167,Iago,BRA,DF,Augsburg,Bundesliga,23,1997,17.3,37,27,21,13,3,17,29,58.6,12,17,5,12,22,59,55,0,0,2020-2021,90.0,114.45086705202311,192.48554913294797
1168,Roger Ibanez,BRA,DF,Roma,Serie A,21,1998,26.6,59,37,28,25,6,25,45,55.6,20,38,17,21,68,127,78,3,0,2020-2021,90.0,230.0751879699248,199.62406015037593
1169,Vedad Ibišević,BIH,FW,Schalke 04,Bundesliga,35,1984,1.7,0,0,0,0,0,0,0,0.0,0,1,0,1,1,1,1,0,0,2020-2021,90.0,52.94117647058823,0.0
1170,Vicente Iborra,ESP,MF,Villarreal,La Liga,32,1988,10.3,18,8,8,7,3,8,24,33.3,16,14,7,7,14,32,25,1,0,2020-2021,90.0,122.33009708737863,157.28155339805826
1171,Didier Ibrahim Ndong,GAB,MF,Dijon,Ligue 1,26,1994,29.0,53,32,22,30,1,25,70,35.7,45,35,7,28,37,90,40,0,0,2020-2021,90.0,114.82758620689654,164.48275862068965
1172,Zlatan Ibrahimović,SWE,FW,Milan,Serie A,38,1981,16.6,5,4,0,4,1,3,6,50.0,3,5,3,2,6,11,27,1,0,2020-2021,90.0,32.53012048192771,27.108433734939755
1173,Mauro Icardi,ARG,FW,Paris S-G,Ligue 1,27,1993,12.0,6,2,1,2,3,4,13,30.8,9,3,1,2,3,9,7,0,0,2020-2021,90.0,22.5,45.0
1174,Oussama Idrissi,MAR,"FW,MF",Sevilla,La Liga,24,1996,0.3,1,1,0,1,0,1,2,50.0,1,2,0,2,1,2,0,0,0,2020-2021,90.0,300.0,300.0
1175,Blendi Idrizi,KVX,MF,Schalke 04,Bundesliga,22,1998,2.6,8,4,1,6,1,1,1,100.0,0,6,2,4,3,11,1,0,0,2020-2021,90.0,103.84615384615384,276.9230769230769
Rk,Player,Nation,Pos,Squad,Comp,0,0,90.0,0,0,3,3,3,Tkl,0,0.0,0,0,0,0,0,0,0,0,0,2020-2021,90.0,0.0,0.0
1176,Odion Ighalo,NGA,FW,Manchester Utd,Premier League,31,1989,0.1,0,0,0,0,0,0,1,0.0,1,0,0,0,0,0,0,0,0,2020-2021,90.0,0.0,0.0
1177,Iglesias,ESP,"DF,MF",Getafe,La Liga,22,1998,6.7,27,15,14,10,3,11,19,57.9,8,11,1,10,17,44,19,0,0,2020-2021,90.0,228.35820895522386,362.68656716417905
1178,Borja Iglesias,ESP,FW,Betis,La Liga,27,1993,15.7,1,1,0,0,1,1,8,12.5,7,7,2,5,3,4,9,0,0,2020-2021,90.0,17.197452229299365,5.7324840764331215
1179,Igor,BRA,DF,Fiorentina,Serie A,22,1998,13.0,15,9,9,6,0,7,12,58.3,5,17,9,8,23,38,34,0,0,2020-2021,90.00000000000001,159.23076923076925,103.84615384615385
1180,Kelechi Iheanacho,NGA,FW,Leicester City,Premier League,23,1996,16.2,12,5,2,4,6,4,17,23.5,13,14,0,14,2,14,1,1,0,2020-2021,90.0,11.11111111111111,66.66666666666667
1181,Jonathan Ikone,FRA,"MF,FW",Lille,Ligue 1,22,1998,24.2,18,12,3,8,7,9,22,40.9,13,16,1,15,7,25,9,0,0,2020-2021,90.0,26.03305785123967,66.94214876033058
1182,Yun Il-lok,KOR,"MF,FW",Montpellier,Ligue 1,28,1992,3.5,0,0,0,0,0,0,4,0.0,4,0,0,0,5,5,1,0,0,2020-2021,90.0,128.57142857142856,0.0
1183,Ivan Ilić,SRB,MF,Hellas Verona,Serie A,19,2001,20.4,26,14,11,11,4,7,21,33.3,14,17,5,12,27,53,26,0,0,2020-2021,90.0,119.11764705882354,114.70588235294119
1184,Josip Iličić,SVN,"MF,FW",Atalanta,Serie A,32,1988,17.0,9,4,1,5,3,5,21,23.8,16,12,0,12,2,11,0,1,0,2020-2021,90.0,10.588235294117647,47.64705882352941
1185,Asier Illarramendi,ESP,MF,Real Sociedad,La Liga,30,1990,3.7,5,2,1,4,0,1,5,20.0,4,2,0,2,5,10,7,0,0,2020-2021,90.0,121.62162162162161,121.62162162162161
1186,Stefan Ilsanker,AUT,"MF,DF",Eint Frankfurt,Bundesliga,31,1989,17.5,33,20,17,15,1,21,42,50.0,21,30,8,22,30,63,51,2,0,2020-2021,90.0,154.28571428571428,169.71428571428572
1187,Ciro Immobile,ITA,FW,Lazio,Serie A,30,1990,31.7,14,13,4,6,4,7,22,31.8,15,13,1,12,6,20,9,0,0,2020-2021,90.0,17.034700315457414,39.74763406940063
1188,Riccardo Improta,ITA,"DF,MF",Benevento,Serie A,26,1993,25.9,39,23,25,8,6,21,45,46.7,24,23,4,19,28,67,47,0,0,2020-2021,90.0,97.2972972972973,135.52123552123552
1189,Roberto Inglese,ITA,FW,Parma,Serie A,28,1991,6.4,5,2,1,2,2,2,11,18.2,9,10,0,10,0,5,3,0,0,2020-2021,90.0,0.0,70.3125
1190,Danny Ings,ENG,FW,Southampton,Premier League,28,1992,24.1,22,13,3,16,3,12,28,42.9,16,39,2,37,3,25,27,1,0,2020-2021,90.0,11.203319502074688,82.15767634854771
1191,Marcus Ingvartsen,DEN,"MF,FW",Union Berlin,Bundesliga,24,1996,21.8,17,11,5,6,6,8,26,30.8,18,22,0,22,18,35,10,0,0,2020-2021,90.0,74.31192660550458,70.18348623853211
1192,Lorenzo Insigne,ITA,FW,Napoli,Serie A,29,1991,31.8,26,18,8,12,6,13,72,18.1,59,30,1,29,37,63,6,1,0,2020-2021,90.0,104.71698113207547,73.58490566037736
1193,Roberto Insigne,ITA,"MF,FW",Benevento,Serie A,26,1994,17.8,16,10,8,3,5,7,27,25.9,20,10,0,10,7,23,9,0,0,2020-2021,90.0,35.39325842696629,80.89887640449439
1194,Pablo Insua,ESP,DF,Huesca,La Liga,26,1993,17.6,37,18,26,9,2,14,31,45.2,17,14,8,6,24,61,68,0,0,2020-2021,90.0,122.72727272727272,189.20454545454544
1195,Takashi Inui,JPN,"MF,FW",Eibar,La Liga,32,1988,20.2,13,8,6,3,4,3,12,25.0,9,19,0,19,12,25,7,0,0,2020-2021,90.0,53.46534653465346,57.92079207920792
1196,Artur Ioniță,MDA,MF,Benevento,Serie A,29,1990,31.5,47,22,11,31,5,17,63,27.0,46,38,14,24,19,66,28,0,0,2020-2021,90.0,54.28571428571429,134.2857142857143
1197,Alexander Isak,SWE,FW,Real Sociedad,La Liga,20,1999,26.0,9,5,0,3,6,3,8,37.5,5,17,1,16,3,12,7,0,0,2020-2021,90.00000000000001,10.384615384615385,31.153846153846157
1198,Isco,ESP,MF,Real Madrid,La Liga,28,1992,10.1,13,9,5,5,3,2,14,14.3,12,7,1,6,2,15,2,0,0,2020-2021,90.0,17.821782178217823,115.84158415841584
1199,Ardian Ismajli,ALB,DF,Spezia,Serie A,23,1996,14.4,19,9,10,8,1,8,13,61.5,5,10,7,3,23,42,52,1,0,2020-2021,90.0,143.75,118.75
1200,Abass Issah,GHA,"DF,FW",Mainz 05,Bundesliga,21,1998,0.2,0,0,0,0,0,0,0,0.0,0,0,0,0,0,0,0,0,0,2020-2021,90.0,0.0,0.0
Rk,Player,Nation,Pos,Squad,Comp,0,0,90.0,0,0,3,3,3,Tkl,0,0.0,0,0,0,0,0,0,0,0,0,2020-2021,90.0,0.0,0.0
1201,Branislav Ivanović,SRB,DF,West Brom,Premier League,36,1984,8.5,14,5,11,3,0,7,13,53.8,6,11,5,6,8,22,25,0,0,2020-2021,90.0,84.70588235294117,148.23529411764707
1202,Alex Iwobi,NGA,"FW,MF",Everton,Premier League,24,1996,17.1,27,10,10,14,3,13,25,52.0,12,20,1,19,16,43,14,0,0,2020-2021,90.0,84.21052631578948,142.10526315789474
1203,Jairo Izquierdo,ESP,"MF,DF",Cádiz,La Liga,26,1993,14.2,21,13,13,8,0,12,31,38.7,19,7,1,6,14,35,12,0,0,2020-2021,90.0,88.73239436619718,133.09859154929578
1204,José Izquierdo,COL,DF,Brighton,Premier League,28,1992,0.1,0,0,0,0,0,0,0,0.0,0,0,0,0,0,0,0,0,0,2020-2021,90.0,0.0,0.0
1205,Armando Izzo,ITA,DF,Torino,Serie A,28,1992,22.3,30,16,13,13,4,13,33,39.4,20,22,9,13,53,83,62,0,0,2020-2021,90.0,213.9013452914798,121.0762331838565
1206,Phil Jagielka,ENG,DF,Sheffield Utd,Premier League,37,1982,5.8,5,4,4,0,1,2,7,28.6,5,11,5,6,10,15,26,2,0,2020-2021,90.0,155.17241379310346,77.58620689655173
1207,Alireza Jahanbakhsh,IRN,"FW,MF",Brighton,Premier League,26,1993,5.9,9,7,3,5,1,2,12,16.7,10,8,0,8,8,17,1,0,0,2020-2021,90.0,122.03389830508473,137.28813559322032
1208,Mato Jajalo,BIH,MF,Udinese,Serie A,32,1988,0.4,1,1,1,0,0,1,1,100.0,0,1,0,1,2,3,0,0,0,2020-2021,90.0,450.0,225.0
1209,Ismail Jakobs,SEN,"MF,FW",Köln,Bundesliga,20,1999,19.2,25,10,17,4,4,11,21,52.4,10,18,1,17,16,41,36,0,0,2020-2021,90.0,75.0,117.18750000000001
1210,Daniel James,WAL,FW,Manchester Utd,Premier League,22,1997,10.1,15,9,4,7,4,3,18,16.7,15,10,1,9,0,15,6,0,0,2020-2021,90.0,0.0,133.66336633663366
1211,Reece James,ENG,DF,Chelsea,Premier League,20,1999,26.4,55,35,24,22,9,21,44,47.7,23,36,7,29,17,72,52,0,0,2020-2021,90.0,57.95454545454545,187.5
1212,Alexandre Jankewitz,SUI,MF,Southampton,Premier League,18,2001,0.0,2,1,2,0,0,1,1,100.0,0,0,0,0,0,2,0,0,0,2020-2021,,,inf
1213,Saidy Janko,GAM,DF,Valladolid,La Liga,24,1995,13.6,19,10,12,5,2,8,14,57.1,6,9,1,8,18,37,47,0,0,2020-2021,90.0,119.11764705882352,125.73529411764706
1214,Jakub Jankto,CZE,MF,Sampdoria,Serie A,24,1996,26.8,28,17,14,7,7,11,35,31.4,24,16,1,15,24,52,34,0,0,2020-2021,90.0,80.59701492537313,94.02985074626865
1215,Tony Jantschke,GER,DF,Gladbach,Bundesliga,30,1990,3.0,2,2,1,1,0,1,3,33.3,2,6,4,2,4,6,7,0,0,2020-2021,90.0,120.0,60.0
1216,Adnan Januzaj,BEL,"FW,MF",Real Sociedad,La Liga,25,1995,11.3,9,8,0,6,3,3,8,37.5,5,7,2,5,3,12,4,0,0,2020-2021,90.0,23.893805309734514,71.68141592920354
1217,Rune Jarstein,NOR,GK,Hertha BSC,Bundesliga,35,1984,8.0,0,0,0,0,0,0,0,0.0,0,0,0,0,0,0,7,1,0,2020-2021,90.0,0.0,0.0
1218,Jason,ESP,"MF,DF",Valencia,La Liga,26,1994,4.9,9,3,5,2,2,4,16,25.0,12,6,1,5,10,19,4,0,0,2020-2021,90.0,183.6734693877551,165.30612244897958
1219,Luis Javier Suárez,COL,"FW,MF",Granada,La Liga,22,1997,18.5,19,11,5,7,7,6,17,35.3,11,10,1,9,8,27,11,0,0,2020-2021,90.0,38.91891891891892,92.43243243243244
1220,Corentin Jean,FRA,"FW,MF",Lens,Ligue 1,25,1995,6.4,4,3,1,1,2,0,5,0.0,5,4,0,4,2,6,2,0,0,2020-2021,90.0,28.125,56.25
1221,Daniel Jebbison,ENG,FW,Sheffield Utd,Premier League,16,2003,3.2,6,2,1,3,2,3,7,42.9,4,6,1,5,1,7,0,0,0,2020-2021,90.0,28.125,168.75
1222,Tin Jedvaj,CRO,DF,Leverkusen,Bundesliga,24,1995,1.7,5,2,2,3,0,1,3,33.3,2,2,1,1,2,7,9,0,0,2020-2021,90.0,105.88235294117646,264.70588235294116
1223,Fredrik Jensen,FIN,"FW,MF",Augsburg,Bundesliga,22,1997,4.2,3,2,1,2,0,3,6,50.0,3,4,1,3,2,5,6,0,0,2020-2021,90.0,42.857142857142854,64.28571428571428
1224,Jesé,ESP,FW,Paris S-G,Ligue 1,27,1993,0.3,0,0,0,0,0,0,1,0.0,1,0,0,0,0,0,0,0,0,2020-2021,90.0,0.0,0.0
1225,Gabriel Jesus,BRA,FW,Manchester City,Premier League,23,1997,22.9,17,6,5,5,7,11,28,39.3,17,16,0,16,15,32,5,0,0,2020-2021,90.0,58.951965065502186,66.81222707423582
Rk,Player,Nation,Pos,Squad,Comp,0,0,90.0,0,0,3,3,3,Tkl,0,0.0,0,0,0,0,0,0,0,0,0,2020-2021,90.0,0.0,0.0
1226,Juan Jesus,BRA,DF,Roma,Serie A,29,1991,1.7,3,1,2,1,0,2,4,50.0,2,1,0,1,2,5,5,0,0,2020-2021,90.0,105.88235294117646,158.8235294117647
1227,Raúl Jiménez,MEX,FW,Wolves,Premier League,29,1991,9.1,3,2,1,2,0,0,7,0.0,7,2,0,2,8,11,12,0,0,2020-2021,90.0,79.12087912087912,29.67032967032967
1228,Joaquín,ESP,"FW,MF",Betis,La Liga,39,1981,14.3,9,3,1,5,3,4,12,33.3,8,8,0,8,17,26,11,0,0,2020-2021,90.0,106.993006993007,56.64335664335665
1229,John Joe,IRL,"MF,FW",Getafe,La Liga,16,2003,0.7,2,0,0,2,0,0,0,0.0,0,0,0,0,0,2,0,0,0,2020-2021,90.0,0.0,257.14285714285717
1230,Joelinton,BRA,"FW,MF",Newcastle Utd,Premier League,23,1996,22.0,33,21,7,21,5,14,37,37.8,23,30,2,28,9,42,24,0,0,2020-2021,90.0,36.81818181818182,135.0
1231,Marco John,GER,DF,Hoffenheim,Bundesliga,18,2002,11.1,21,15,9,5,7,10,22,45.5,12,18,1,17,16,37,21,0,0,2020-2021,90.0,129.72972972972974,170.2702702702703
1232,Ben Johnson,ENG,"DF,FW",West Ham,Premier League,20,2000,5.8,11,5,5,3,3,7,9,77.8,2,5,1,4,11,22,9,0,0,2020-2021,90.0,170.6896551724138,170.6896551724138
1233,Sam Johnstone,ENG,GK,West Brom,Premier League,27,1993,37.0,0,0,0,0,0,0,0,0.0,0,0,0,0,2,2,15,2,0,2020-2021,90.0,4.864864864864865,0.0
1234,Curtis Jones,ENG,MF,Liverpool,Premier League,19,2001,13.1,16,6,6,7,3,12,25,48.0,13,13,0,13,19,35,11,1,0,2020-2021,90.0,130.5343511450382,109.92366412213741
1235,Frenkie de Jong,NED,"MF,DF",Barcelona,La Liga,23,1997,35.0,44,27,21,19,4,15,35,42.9,20,20,4,16,38,82,29,2,0,2020-2021,90.0,97.71428571428571,113.14285714285714
1236,Luuk de Jong,NED,FW,Sevilla,La Liga,29,1990,14.1,9,5,3,2,4,1,7,14.3,6,11,3,8,5,14,15,0,0,2020-2021,89.99999999999999,31.914893617021274,57.44680851063829
1237,Jony,ESP,"MF,FW",Osasuna,La Liga,29,1991,9.7,7,3,1,2,4,5,20,25.0,15,5,0,5,14,21,3,0,0,2020-2021,90.0,129.89690721649487,64.94845360824743
1238,Joan Jordán,ESP,MF,Sevilla,La Liga,26,1994,26.7,52,28,17,29,6,17,76,22.4,59,22,3,19,27,79,25,0,0,2020-2021,90.00000000000001,91.0112359550562,175.2808988764045
1239,Jorginho,ITA,MF,Chelsea,Premier League,28,1991,22.3,57,30,22,31,4,31,76,40.8,45,33,5,28,40,97,21,3,0,2020-2021,90.0,161.43497757847533,230.04484304932734
1240,Josan,ESP,"MF,DF",Elche,La Liga,30,1989,21.4,34,18,23,11,0,13,39,33.3,26,24,1,23,21,55,26,1,0,2020-2021,90.0,88.3177570093458,142.99065420560748
1241,Willian José,BRA,FW,Wolves,Premier League,28,1991,12.3,2,1,1,1,0,1,4,25.0,3,6,1,5,1,3,12,0,0,2020-2021,89.99999999999999,7.317073170731707,14.634146341463413
1242,Willian José,BRA,FW,Real Sociedad,La Liga,28,1991,7.7,3,1,0,3,0,1,3,33.3,2,3,1,2,0,3,8,0,0,2020-2021,90.0,0.0,35.064935064935064
1243,Joselu,ESP,FW,Alavés,La Liga,30,1990,33.6,27,14,6,15,6,8,28,28.6,20,26,3,23,15,42,58,1,0,2020-2021,90.0,40.17857142857142,72.32142857142857
1244,Josema,ESP,DF,Elche,La Liga,24,1996,21.8,43,28,33,10,0,10,18,55.6,8,17,7,10,37,80,92,0,0,2020-2021,90.0,152.75229357798165,177.52293577981652
1245,Jota,POR,"MF,FW",Valladolid,La Liga,21,1999,7.4,7,3,1,4,2,5,10,50.0,5,4,0,4,6,13,5,1,0,2020-2021,90.0,72.97297297297297,85.13513513513513
1246,Jota,ESP,MF,Alavés,La Liga,29,1991,15.5,19,14,6,7,6,3,29,10.3,26,12,0,12,9,28,9,0,0,2020-2021,90.0,52.25806451612903,110.3225806451613
1247,Diogo Jota,POR,FW,Liverpool,Premier League,23,1996,12.4,12,6,4,7,1,2,29,6.9,27,9,0,9,5,17,3,0,0,2020-2021,90.0,36.29032258064516,87.09677419354838
1248,Stevan Jovetić,MNE,"FW,MF",Monaco,Ligue 1,30,1989,8.9,8,4,2,3,3,3,13,23.1,10,1,0,1,3,11,3,0,0,2020-2021,90.0,30.337078651685395,80.89887640449439
1249,Luka Jović,SRB,FW,Real Madrid,La Liga,22,1997,1.7,0,0,0,0,0,0,0,0.0,0,0,0,0,0,0,0,0,0,2020-2021,90.0,0.0,0.0
1250,Luka Jović,SRB,FW,Eint Frankfurt,Bundesliga,22,1997,9.9,2,0,0,2,0,0,4,0.0,4,3,0,3,1,3,7,0,0,2020-2021,90.0,9.090909090909092,18.181818181818183
Rk,Player,Nation,Pos,Squad,Comp,0,0,90.0,0,0,3,3,3,Tkl,0,0.0,0,0,0,0,0,0,0,0,0,2020-2021,90.0,0.0,0.0
1251,Juanmi,ESP,"FW,MF",Betis,La Liga,27,1993,6.7,13,9,3,5,5,4,18,22.2,14,4,0,4,2,15,4,0,0,2020-2021,90.0,26.865671641791042,174.62686567164178
1252,Hamed Junior Traorè,CIV,"MF,FW",Sassuolo,Serie A,20,2000,19.9,29,17,10,10,9,14,35,40.0,21,27,3,24,18,47,9,0,0,2020-2021,90.0,81.4070351758794,131.15577889447238
1253,Vinicius Júnior,BRA,FW,Real Madrid,La Liga,20,2000,21.9,32,22,14,10,8,11,43,25.6,32,28,0,28,7,39,4,0,0,2020-2021,90.0,28.767123287671236,131.5068493150685
1254,James Justin,ENG,DF,Leicester City,Premier League,22,1998,23.0,61,37,38,18,5,20,41,48.8,21,36,10,26,30,91,58,1,0,2020-2021,90.0,117.3913043478261,238.69565217391306
1255,Musa Juwara,GAM,"MF,DF",Bologna,Serie A,18,2001,0.5,2,2,2,0,0,1,3,33.3,2,1,0,1,0,2,0,0,0,2020-2021,90.0,0.0,360.0
1256,Jens Jønsson,DEN,MF,Cádiz,La Liga,27,1993,29.1,55,29,25,25,5,22,52,42.3,30,39,7,32,51,106,45,0,0,2020-2021,90.0,157.7319587628866,170.10309278350513
1257,Ozan Kabak,TUR,DF,Liverpool,Premier League,20,2000,8.9,19,10,11,4,4,6,9,66.7,3,2,2,0,12,31,28,1,0,2020-2021,90.0,121.34831460674158,192.13483146067415
1258,Ozan Kabak,TUR,DF,Schalke 04,Bundesliga,20,2000,13.8,17,9,11,5,1,6,13,46.2,7,20,11,9,13,30,57,0,0,2020-2021,90.0,84.78260869565217,110.8695652173913
1259,Abdoul Kader Bamba,FRA,"FW,MF",Nantes,Ligue 1,26,1994,10.2,18,3,7,8,3,11,18,61.1,7,10,0,10,7,25,4,1,0,2020-2021,90.0,61.76470588235294,158.82352941176472
1260,Pavel Kadeřábek,CZE,"DF,FW",Hoffenheim,Bundesliga,28,1992,17.6,15,12,7,6,2,6,15,40.0,9,12,3,9,18,33,31,0,0,2020-2021,90.0,92.04545454545455,76.70454545454545
1261,Tino Kadewere,ZIM,FW,Lyon,Ligue 1,24,1996,22.3,35,22,12,16,7,17,49,34.7,32,16,3,13,21,56,31,0,0,2020-2021,90.0,84.75336322869954,141.2556053811659
1262,Damian Kądzior,POL,"FW,MF",Eibar,La Liga,28,1992,2.2,1,0,0,1,0,1,5,20.0,4,1,0,1,0,1,0,0,0,2020-2021,90.0,0.0,40.90909090909091
1263,Florian Kainz,AUT,"MF,FW",Köln,Bundesliga,27,1992,5.0,4,2,0,4,0,2,8,25.0,6,7,0,7,3,7,3,0,0,2020-2021,90.0,54.0,72.0
1264,Gaël Kakuta,COD,"MF,FW",Lens,Ligue 1,29,1991,26.6,38,23,10,18,10,8,44,18.2,36,24,3,21,17,55,4,0,0,2020-2021,90.0,57.5187969924812,128.57142857142856
1265,Sasa Kalajdzic,AUT,FW,Stuttgart,Bundesliga,23,1997,23.7,16,12,4,5,7,2,17,11.8,15,10,1,9,9,25,21,0,0,2020-2021,90.0,34.17721518987342,60.75949367088608
1266,Arnaud Kalimuendo,FRA,FW,Paris S-G,Ligue 1,18,2002,0.8,0,0,0,0,0,0,0,0.0,0,0,0,0,0,0,0,0,0,2020-2021,90.0,0.0,0.0
1267,Arnaud Kalimuendo,FRA,"FW,MF",Lens,Ligue 1,18,2002,13.5,8,2,2,2,4,1,7,14.3,6,11,0,11,2,10,2,0,0,2020-2021,90.0,13.333333333333334,53.333333333333336
1268,Nikola Kalinić,CRO,FW,Hellas Verona,Serie A,32,1988,11.8,5,1,2,2,1,0,3,0.0,3,6,0,6,1,6,7,0,0,2020-2021,90.0,7.627118644067796,38.13559322033898
1269,Yayah Kallon,SLE,FW,Genoa,Serie A,19,2001,0.5,0,0,0,0,0,0,0,0.0,0,0,0,0,0,0,0,0,0,2020-2021,90.0,0.0,0.0
1270,Samuel Kalu,NGA,"FW,MF",Bordeaux,Ligue 1,22,1997,10.7,21,12,11,8,2,4,13,30.8,9,14,0,14,9,30,2,0,0,2020-2021,90.0,75.70093457943926,176.6355140186916
1271,Pierre Kalulu,FRA,DF,Milan,Serie A,20,2000,8.1,18,14,11,6,1,10,14,71.4,4,9,3,6,19,37,20,0,0,2020-2021,90.0,211.11111111111111,200.0
1272,Daichi Kamada,JPN,MF,Eint Frankfurt,Bundesliga,23,1996,26.2,48,28,21,16,11,16,49,32.7,33,18,1,17,14,62,22,0,0,2020-2021,90.0,48.091603053435115,164.8854961832061
1273,Aboubakar Kamara,MTN,"FW,MF",Fulham,Premier League,25,1995,3.5,2,2,1,1,0,0,5,0.0,5,6,0,6,1,3,0,0,0,2020-2021,90.0,25.714285714285715,51.42857142857143
1274,Aboubakar Kamara,MTN,"FW,MF",Dijon,Ligue 1,25,1995,6.2,3,1,0,2,1,1,7,14.3,6,1,0,1,0,3,2,0,0,2020-2021,90.0,0.0,43.54838709677419
1275,Bingourou Kamara,SEN,GK,Strasbourg,Ligue 1,23,1996,8.0,1,1,1,0,0,1,3,33.3,2,0,0,0,1,2,2,1,0,2020-2021,90.0,11.25,11.25
Rk,Player,Nation,Pos,Squad,Comp,0,0,90.0,0,0,3,3,3,Tkl,0,0.0,0,0,0,0,0,0,0,0,0,2020-2021,90.0,0.0,0.0
1276,Boubacar Kamara,FRA,MF,Marseille,Ligue 1,20,1999,32.2,88,51,31,49,8,40,74,54.1,34,36,13,23,34,122,51,0,0,2020-2021,90.0,95.03105590062111,245.96273291925465
1277,Hassane Kamara,CIV,"DF,FW",Nice,Ligue 1,26,1994,32.9,65,39,40,16,9,27,49,55.1,22,39,12,27,55,120,61,1,0,2020-2021,90.0,150.45592705167175,177.8115501519757
1278,Marcin Kamiński,POL,DF,Stuttgart,Bundesliga,28,1992,2.4,1,1,0,0,1,0,0,0.0,0,2,1,1,1,2,10,0,0,2020-2021,90.0,37.5,37.5
1279,Kevin Kampl,SVN,MF,RB Leipzig,Bundesliga,29,1990,21.5,38,26,9,24,5,18,35,51.4,17,20,2,18,29,67,14,0,0,2020-2021,90.0,121.3953488372093,159.06976744186045
1280,Harry Kane,ENG,FW,Tottenham,Premier League,27,1993,34.2,22,12,1,17,4,8,26,30.8,18,28,11,17,11,33,40,0,0,2020-2021,90.0,28.94736842105263,57.89473684210526
1281,Lee Kang-in,KOR,"FW,MF",Valencia,La Liga,19,2001,14.0,15,11,8,4,3,3,31,9.7,28,12,0,12,2,17,0,0,0,2020-2021,90.0,12.857142857142858,96.42857142857143
1282,Wilfried Kanga,CIV,FW,Angers,Ligue 1,22,1998,1.5,0,0,0,0,0,0,1,0.0,1,1,0,1,0,0,2,0,0,2020-2021,90.0,0.0,0.0
1283,N'Golo Kanté,FRA,MF,Chelsea,Premier League,29,1991,23.8,79,42,39,35,5,27,56,48.2,29,42,4,38,59,138,34,0,0,2020-2021,90.00000000000001,223.109243697479,298.73949579831935
1284,Jimmy Kaparos,GER,MF,Schalke 04,Bundesliga,18,2001,0.2,0,0,0,0,0,0,1,0.0,1,0,0,0,0,0,0,0,0,2020-2021,90.0,0.0,0.0
1285,Yann Karamoh,FRA,"FW,MF",Parma,Serie A,22,1998,14.4,27,17,8,12,7,11,31,35.5,20,6,0,6,4,31,11,0,0,2020-2021,90.0,25.0,168.75
1286,Isaac Karamoko,FRA,DF,Sassuolo,Serie A,18,2002,0.0,1,0,0,0,1,1,1,100.0,0,0,0,0,0,1,0,0,0,2020-2021,,,inf
1287,Atakan Karazor,GER,"DF,MF",Stuttgart,Bundesliga,23,1996,11.5,20,12,12,7,1,13,22,59.1,9,18,8,10,21,41,50,2,0,2020-2021,90.0,164.34782608695653,156.52173913043478
1288,Augustus Kargbo,SLE,FW,Crotone,Serie A,20,1999,0.4,0,0,0,0,0,0,0,0.0,0,0,0,0,0,0,0,0,0,2020-2021,90.0,0.0,0.0
1289,Loris Karius,GER,GK,Union Berlin,Bundesliga,27,1993,3.2,0,0,0,0,0,0,0,0.0,0,0,0,0,0,0,2,0,0,2020-2021,90.0,0.0,0.0
1290,Rick Karsdorp,NED,DF,Roma,Serie A,25,1995,28.3,36,23,19,12,5,21,48,43.8,27,18,1,17,30,66,32,0,0,2020-2021,90.0,95.40636042402826,114.48763250883391
1291,Silas Katompa,COD,"DF,FW",Stuttgart,Bundesliga,21,1998,21.3,48,29,19,19,10,21,44,47.7,23,29,1,28,22,70,11,2,0,2020-2021,90.0,92.95774647887325,202.81690140845072
1292,Noah Katterbach,GER,"DF,MF",Köln,Bundesliga,19,2001,12.3,18,11,11,6,1,13,21,61.9,8,7,3,4,23,41,22,0,0,2020-2021,89.99999999999999,168.29268292682926,131.7073170731707
1293,Eiji Kawashima,JPN,GK,Strasbourg,Ligue 1,37,1983,24.0,1,0,1,0,0,1,1,100.0,0,0,0,0,0,1,4,2,0,2020-2021,90.0,0.0,3.75
1294,Moise Kean,ITA,"FW,MF",Everton,Premier League,20,2000,0.2,0,0,0,0,0,0,0,0.0,0,0,0,0,0,0,0,0,0,2020-2021,90.0,0.0,0.0
1295,Moise Kean,ITA,FW,Paris S-G,Ligue 1,20,2000,18.9,11,8,2,6,3,3,12,25.0,9,7,1,6,8,19,10,0,0,2020-2021,90.0,38.095238095238095,52.38095238095238
1296,Michael Keane,ENG,DF,Everton,Premier League,27,1993,33.2,28,15,20,8,0,14,31,45.2,17,46,33,13,51,79,161,0,0,2020-2021,90.0,138.25301204819274,75.90361445783131
1297,Neeskens Kebano,COD,"FW,MF",Fulham,Premier League,28,1992,1.3,0,0,0,0,0,0,1,0.0,1,3,0,3,0,0,0,0,0,2020-2021,90.0,0.0,0.0
1298,Thilo Kehrer,GER,DF,Paris S-G,Ligue 1,23,1996,18.0,31,26,17,11,3,10,26,38.5,16,16,4,12,15,46,37,1,0,2020-2021,90.0,75.0,155.0
1299,Habib Keita,MLI,MF,Lyon,Ligue 1,18,2002,0.1,0,0,0,0,0,0,0,0.0,0,0,0,0,0,0,0,0,0,2020-2021,90.0,0.0,0.0
1300,Naby Keïta,GUI,MF,Liverpool,Premier League,25,1995,5.8,11,5,1,8,2,7,17,41.2,10,10,0,10,9,20,6,0,0,2020-2021,90.0,139.6551724137931,170.6896551724138
Rk,Player,Nation,Pos,Squad,Comp,0,0,90.0,0,0,3,3,3,Tkl,0,0.0,0,0,0,0,0,0,0,0,0,2020-2021,90.0,0.0,0.0
1301,Yannik Keitel,GER,MF,Freiburg,Bundesliga,20,2000,5.5,12,8,7,4,1,7,9,77.8,2,9,3,6,10,22,8,0,0,2020-2021,90.0,163.63636363636365,196.36363636363637
1302,Caoimhín Kelleher,IRL,GK,Liverpool,Premier League,21,1998,2.0,0,0,0,0,0,0,0,0.0,0,0,0,0,0,0,2,0,0,2020-2021,90.0,0.0,0.0
1303,Stephane Keller,CMR,DF,Alavés,La Liga,18,2001,0.2,1,0,1,0,0,1,1,100.0,0,0,0,0,0,1,0,0,0,2020-2021,90.0,0.0,450.0
1304,Martin Kelly,ENG,DF,Crystal Palace,Premier League,30,1990,0.0,1,0,1,0,0,1,1,100.0,0,0,0,0,0,1,0,0,0,2020-2021,,,inf
1305,Marc-Oliver Kempf,GER,DF,Stuttgart,Bundesliga,25,1995,30.3,49,26,28,18,3,29,49,59.2,20,40,25,15,68,117,103,1,0,2020-2021,90.0,201.98019801980197,145.54455445544554
1306,Kenedy,BRA,"FW,MF",Granada,La Liga,24,1996,16.3,22,12,10,7,5,5,25,20.0,20,21,4,17,26,48,15,1,0,2020-2021,90.0,143.55828220858896,121.47239263803681
1307,Jonjoe Kenny,ENG,DF,Everton,Premier League,23,1997,0.9,2,1,1,0,1,2,2,100.0,0,0,0,0,1,3,3,0,0,2020-2021,90.0,100.0,200.0
1308,Franck Kessié,CIV,MF,Milan,Serie A,23,1996,35.8,53,30,28,19,6,20,38,52.6,18,47,15,32,46,99,51,0,0,2020-2021,90.0,115.64245810055867,133.24022346368716
1309,Reda Khadra,GER,MF,Brighton,Premier League,19,2001,0.1,0,0,0,0,0,0,0,0.0,0,0,0,0,0,0,0,0,0,2020-2021,90.0,0.0,0.0
1310,Omar Khailoti,ITA,DF,Bologna,Serie A,18,2001,0.3,0,0,0,0,0,0,0,0.0,0,2,0,2,1,1,0,0,0,2020-2021,90.0,300.0,0.0
1311,Saîf-Eddine Khaoui,TUN,"FW,DF",Marseille,Ligue 1,25,1995,6.7,19,11,7,6,6,7,16,43.8,9,8,0,8,12,31,1,0,0,2020-2021,90.0,161.19402985074626,255.2238805970149
1312,Wahbi Khazri,TUN,FW,Saint-Étienne,Ligue 1,29,1991,13.1,24,15,12,7,5,12,24,50.0,12,10,1,9,4,28,11,0,0,2020-2021,90.0,27.480916030534353,164.8854961832061
1313,Rani Khedira,GER,MF,Augsburg,Bundesliga,26,1994,20.2,29,10,13,15,1,10,20,50.0,10,14,5,9,31,60,47,0,0,2020-2021,90.0,138.11881188118812,129.2079207920792
1314,Sami Khedira,GER,MF,Hertha BSC,Bundesliga,33,1987,4.4,11,6,3,7,1,6,12,50.0,6,4,0,4,9,20,7,0,0,2020-2021,90.0,184.0909090909091,225.0
1315,Kiké,ESP,FW,Eibar,La Liga,30,1989,34.3,24,18,5,7,12,6,22,27.3,16,24,1,23,7,31,29,0,0,2020-2021,90.0,18.367346938775512,62.973760932944614
1316,Luca Kilian,GER,DF,Mainz 05,Bundesliga,20,1999,4.2,14,7,10,4,0,9,17,52.9,8,3,1,2,13,27,12,0,0,2020-2021,90.0,278.57142857142856,300.0
1317,Max Kilman,ENG,DF,Wolves,Premier League,23,1997,14.6,21,14,13,4,4,8,14,57.1,6,17,8,9,19,40,46,0,0,2020-2021,90.0,117.12328767123289,129.45205479452056
1318,Joshua Kimmich,GER,MF,Bayern Munich,Bundesliga,25,1995,24.4,40,28,16,19,5,10,53,18.9,43,25,5,20,36,76,19,0,0,2020-2021,90.0,132.78688524590166,147.5409836065574
1319,Presnel Kimpembe,FRA,DF,Paris S-G,Ligue 1,24,1995,25.6,46,28,23,19,4,24,34,70.6,10,19,11,8,30,76,61,4,0,2020-2021,90.0,105.46875,161.71875
1320,Joshua King,NOR,"MF,FW",Everton,Premier League,28,1992,1.6,4,1,2,1,1,0,0,0.0,0,3,0,3,1,5,1,0,0,2020-2021,90.0,56.25,225.0
1321,Simon Kjær,DEN,DF,Milan,Serie A,31,1989,26.6,45,26,23,20,2,18,30,60.0,12,42,26,16,42,87,125,0,0,2020-2021,90.0,142.10526315789474,152.25563909774436
1322,Davy Klaassen,NED,MF,Werder Bremen,Bundesliga,27,1993,2.5,3,1,0,1,2,0,5,0.0,5,5,1,4,3,6,4,0,0,2020-2021,90.0,108.0,108.0
1323,Felix Klaus,GER,"DF,MF",Wolfsburg,Bundesliga,27,1992,1.5,7,4,3,4,0,4,5,80.0,1,4,0,4,2,9,4,0,0,2020-2021,90.0,120.0,420.0
1324,Klauss,BRA,"MF,FW",Hoffenheim,Bundesliga,23,1997,0.6,1,0,0,0,1,0,1,0.0,1,0,0,0,0,1,0,0,0,2020-2021,90.0,0.0,150.0
1325,Ragnar Klavan,EST,DF,Cagliari,Serie A,34,1985,8.6,15,9,9,5,1,7,11,63.6,4,9,4,5,8,23,34,0,0,2020-2021,90.0,83.72093023255815,156.97674418604652
Rk,Player,Nation,Pos,Squad,Comp,0,0,90.0,0,0,3,3,3,Tkl,0,0.0,0,0,0,0,0,0,0,0,0,2020-2021,90.0,0.0,0.0
1326,Philipp Klement,GER,"MF,FW",Stuttgart,Bundesliga,27,1992,4.7,7,3,6,0,1,3,7,42.9,4,9,2,7,6,13,7,0,0,2020-2021,90.0,114.89361702127658,134.04255319148936
1327,Mateusz Klich,POL,MF,Leeds United,Premier League,30,1990,26.6,38,20,14,20,4,14,61,23.0,47,13,4,9,11,49,16,0,0,2020-2021,90.0,37.21804511278195,128.57142857142856
1328,Mateo Klimowicz,GER,"MF,FW",Stuttgart,Bundesliga,20,2000,13.3,20,15,6,10,4,5,18,27.8,13,5,1,4,2,22,2,0,0,2020-2021,90.0,13.533834586466165,135.33834586466165
1329,Fabian Klos,GER,FW,Arminia,Bundesliga,32,1987,30.1,24,13,9,11,4,7,26,26.9,19,20,6,14,4,28,29,0,0,2020-2021,90.00000000000001,11.960132890365449,71.76079734219269
1330,Lukas Klostermann,GER,DF,RB Leipzig,Bundesliga,24,1996,16.1,23,19,8,12,3,11,18,61.1,7,16,6,10,18,41,44,1,0,2020-2021,90.0,100.62111801242236,128.57142857142856
1331,Justin Kluivert,NED,MF,Roma,Serie A,21,1999,0.2,0,0,0,0,0,0,0,0.0,0,0,0,0,0,0,0,0,0,2020-2021,90.0,0.0,0.0
1332,Justin Kluivert,NED,"FW,MF",RB Leipzig,Bundesliga,21,1999,9.0,2,1,1,1,0,0,2,0.0,2,4,0,4,5,7,3,0,0,2020-2021,90.0,50.0,20.0
1333,Lukas Klünter,GER,DF,Hertha BSC,Bundesliga,24,1996,11.0,10,5,6,4,0,5,10,50.0,5,3,1,2,11,21,29,1,0,2020-2021,90.0,90.0,81.81818181818183
1334,Ansgar Knauff,GER,"MF,FW",Dortmund,Bundesliga,18,2002,0.8,0,0,0,0,0,0,1,0.0,1,3,1,2,0,0,0,0,0,2020-2021,90.0,0.0,0.0
1335,Robin Knoche,GER,DF,Union Berlin,Bundesliga,28,1992,33.8,44,29,30,12,2,23,39,59.0,16,43,27,16,49,93,118,2,0,2020-2021,90.0,130.4733727810651,117.15976331360947
1336,Gregor Kobel,SUI,GK,Stuttgart,Bundesliga,22,1997,33.0,2,2,2,0,0,2,2,100.0,0,0,0,0,2,4,8,1,0,2020-2021,90.0,5.454545454545455,5.454545454545455
1337,Robin Koch,GER,"DF,MF",Leeds United,Premier League,24,1996,12.6,27,16,17,10,0,10,19,52.6,9,18,12,6,27,54,34,2,0,2020-2021,90.0,192.8571428571429,192.8571428571429
1338,Giorgi Kochorashvili,GEO,MF,Levante,La Liga,21,1999,0.3,1,0,1,0,0,0,0,0.0,0,0,0,0,0,1,0,0,0,2020-2021,90.0,0.0,300.0
1339,Kenan Kodro,BIH,"FW,MF",Valladolid,La Liga,26,1993,5.1,0,0,0,0,0,0,2,0.0,2,2,1,1,2,2,6,0,0,2020-2021,90.0,35.294117647058826,0.0
1340,Kenan Kodro,BIH,"FW,MF",Athletic Club,La Liga,26,1993,0.5,0,0,0,0,0,0,1,0.0,1,0,0,0,0,0,0,0,0,2020-2021,90.0,0.0,0.0
1341,Dominik Kohr,GER,MF,Mainz 05,Bundesliga,26,1994,14.1,47,31,14,26,7,20,39,51.3,19,18,5,13,27,74,15,0,0,2020-2021,89.99999999999999,172.3404255319149,300.0
1342,Dominik Kohr,GER,"MF,DF",Eint Frankfurt,Bundesliga,26,1994,2.9,11,7,0,7,4,4,9,44.4,5,5,1,4,9,20,9,0,0,2020-2021,90.0,279.3103448275862,341.3793103448276
1343,Koba Koindredi,FRA,MF,Valencia,La Liga,18,2001,0.2,1,1,1,0,0,0,1,0.0,1,0,0,0,0,1,0,0,0,2020-2021,90.0,0.0,450.0
1344,Koke,ESP,MF,Atlético Madrid,La Liga,28,1992,33.6,64,42,22,31,11,28,98,28.6,70,35,6,29,36,100,40,0,0,2020-2021,90.0,96.42857142857143,171.42857142857142
1345,Aleksandr Kokorin,RUS,"FW,MF",Fiorentina,Serie A,29,1991,1.0,1,0,0,1,0,0,1,0.0,1,1,0,1,0,1,0,0,0,2020-2021,90.0,0.0,90.0
1346,Aleksandar Kolarov,SRB,DF,Inter,Serie A,34,1985,4.3,4,4,0,4,0,1,2,50.0,1,2,0,2,7,11,8,0,0,2020-2021,90.0,146.51162790697677,83.72093023255815
1347,Sead Kolašinac,BIH,DF,Arsenal,Premier League,27,1993,1.0,0,0,0,0,0,0,0,0.0,0,0,0,0,1,1,0,0,0,2020-2021,90.0,90.0,0.0
1348,Sead Kolašinac,BIH,"DF,MF",Schalke 04,Bundesliga,27,1993,15.8,20,17,10,7,3,8,18,44.4,10,17,5,12,20,40,17,0,0,2020-2021,90.0,113.92405063291137,113.92405063291137
1349,Randal Kolo Muani,FRA,FW,Nantes,Ligue 1,21,1998,33.7,22,14,1,13,8,7,27,25.9,20,15,2,13,8,30,26,0,0,2020-2021,90.0,21.364985163204746,58.753709198813056
1350,Timothée Kolodziejczak,FRA,DF,Saint-Étienne,Ligue 1,28,1991,22.6,28,15,23,5,0,19,27,70.4,8,24,15,9,36,64,80,1,0,2020-2021,90.0,143.36283185840708,111.50442477876106
Rk,Player,Nation,Pos,Squad,Comp,0,0,90.0,0,0,3,3,3,Tkl,0,0.0,0,0,0,0,0,0,0,0,0,2020-2021,90.0,0.0,0.0
1351,Ghislain Konan,CIV,DF,Reims,Ligue 1,24,1995,29.0,57,32,35,17,5,32,56,57.1,24,25,11,14,30,87,67,0,0,2020-2021,90.0,93.10344827586206,176.8965517241379
1352,Ibrahima Konaté,FRA,DF,RB Leipzig,Bundesliga,21,1999,7.7,6,4,2,3,1,2,8,25.0,6,6,3,3,8,14,24,0,0,2020-2021,90.0,93.50649350649351,70.12987012987013
1353,Moussa Konaté,SEN,FW,Dijon,Ligue 1,27,1993,13.3,5,3,1,2,2,2,11,18.2,9,4,1,3,5,10,8,0,0,2020-2021,90.0,33.83458646616541,33.83458646616541
1354,Geoffrey Kondogbia,CTA,MF,Valencia,La Liga,27,1993,4.9,16,9,9,4,3,7,19,36.8,12,6,1,5,8,24,8,0,0,2020-2021,90.0,146.93877551020407,293.87755102040813
1355,Geoffrey Kondogbia,CTA,MF,Atlético Madrid,La Liga,27,1993,6.8,30,20,12,16,2,11,20,55.0,9,11,5,6,11,41,8,1,0,2020-2021,90.0,145.58823529411765,397.05882352941177
1356,Lamine Koné,CIV,DF,Strasbourg,Ligue 1,31,1989,11.6,9,6,5,4,0,5,8,62.5,3,4,3,1,15,24,36,0,0,2020-2021,90.0,116.37931034482759,69.82758620689656
1357,Moussa Koné,SEN,FW,Nîmes,Ligue 1,23,1996,19.5,13,6,1,8,4,2,9,22.2,7,7,1,6,2,15,7,0,0,2020-2021,90.0,9.23076923076923,60.0
1358,Youssouf Koné,MLI,"DF,MF",Elche,La Liga,25,1995,0.8,2,0,1,0,1,0,1,0.0,1,0,0,0,0,2,0,0,0,2020-2021,90.0,0.0,225.0
1359,Terence Kongolo,NED,DF,Fulham,Premier League,26,1994,1.0,3,2,1,2,0,1,1,100.0,0,0,0,0,2,5,3,0,0,2020-2021,90.0,180.0,270.0
1360,Ezri Konsa,ENG,DF,Aston Villa,Premier League,22,1997,35.5,25,13,18,6,1,9,13,69.2,4,53,47,6,29,54,162,1,0,2020-2021,90.0,73.52112676056338,63.38028169014085
1361,Laurent Koscielny,FRA,DF,Bordeaux,Ligue 1,34,1985,24.6,29,17,18,11,0,16,24,66.7,8,44,34,10,54,83,115,1,0,2020-2021,89.99999999999999,197.56097560975607,106.09756097560974
1362,Filip Kostić,SRB,DF,Eint Frankfurt,Bundesliga,27,1992,28.2,54,31,22,23,9,22,54,40.7,32,43,6,37,26,80,28,2,0,2020-2021,89.99999999999999,82.97872340425532,172.3404255319149
1363,Márk Kosznovszky,HUN,MF,Parma,Serie A,18,2002,1.0,2,2,1,1,0,1,4,25.0,3,2,0,2,1,3,1,0,0,2020-2021,90.0,90.0,180.0
1364,Christian Kouamé,CIV,FW,Fiorentina,Serie A,22,1997,11.1,9,4,2,4,3,4,12,33.3,8,9,1,8,5,14,4,0,0,2020-2021,90.0,40.54054054054055,72.97297297297298
1365,Kalidou Koulibaly,SEN,DF,Napoli,Serie A,29,1991,24.5,36,24,25,7,4,19,32,59.4,13,46,26,20,29,65,64,2,0,2020-2021,90.00000000000001,106.53061224489797,132.24489795918367
1366,Jules Koundé,FRA,DF,Sevilla,La Liga,21,1998,33.1,27,15,14,11,2,10,24,41.7,14,24,16,8,40,67,104,0,0,2020-2021,90.0,108.76132930513594,73.41389728096676
1367,Boubakar Kouyaté,MLI,DF,Metz,Ligue 1,23,1997,21.8,60,35,45,15,0,32,58,55.2,26,44,27,17,60,120,132,1,0,2020-2021,90.0,247.7064220183486,247.7064220183486
1368,Cheikhou Kouyaté,SEN,DF,Crystal Palace,Premier League,30,1989,34.7,58,37,44,12,2,25,43,58.1,18,42,26,16,32,90,125,2,0,2020-2021,90.0,82.99711815561959,150.4322766570605
1369,Mateo Kovačić,CRO,MF,Chelsea,Premier League,26,1994,20.2,46,28,19,24,3,17,32,53.1,15,18,1,17,15,61,11,2,0,2020-2021,90.0,66.83168316831683,204.95049504950495
1370,Viktor Kovalenko,UKR,FW,Atalanta,Serie A,24,1996,0.0,0,0,0,0,0,0,0,0.0,0,0,0,0,0,0,1,0,0,2020-2021,,,
1371,Emil Krafth,SWE,DF,Newcastle Utd,Premier League,25,1994,14.3,19,8,9,9,1,12,25,48.0,13,15,9,6,15,34,52,2,0,2020-2021,90.0,94.40559440559441,119.58041958041959
1372,Andrej Kramarić,CRO,"FW,MF",Hoffenheim,Bundesliga,29,1991,26.4,7,4,4,0,3,3,8,37.5,5,8,1,7,7,14,5,1,0,2020-2021,90.0,23.863636363636363,23.863636363636363
1373,Christoph Kramer,GER,MF,Gladbach,Bundesliga,29,1991,22.6,55,37,22,28,5,28,58,48.3,30,32,11,21,34,89,39,0,0,2020-2021,90.0,135.39823008849558,219.02654867256638
1374,Jean-Philippe Krasso,CIV,FW,Saint-Étienne,Ligue 1,23,1997,2.5,5,3,1,4,0,2,4,50.0,2,5,0,5,1,6,3,0,0,2020-2021,90.0,36.0,180.0
1375,Toni Kroos,GER,MF,Real Madrid,La Liga,30,1990,23.5,42,22,15,15,12,11,44,25.0,33,26,6,20,15,57,10,3,0,2020-2021,90.0,57.44680851063829,160.85106382978722
Rk,Player,Nation,Pos,Squad,Comp,0,0,90.0,0,0,3,3,3,Tkl,0,0.0,0,0,0,0,0,0,0,0,0,2020-2021,90.0,0.0,0.0
1376,Filip Krovinović,CRO,MF,West Brom,Premier League,24,1995,6.1,13,10,6,5,2,6,18,33.3,12,2,0,2,4,17,2,0,0,2020-2021,90.0,59.016393442622956,191.8032786885246
1377,Rade Krunić,BIH,"MF,FW",Milan,Serie A,26,1993,8.0,15,12,6,6,3,7,17,41.2,10,12,2,10,10,25,9,0,0,2020-2021,90.0,112.5,168.75
1378,Max Kruse,GER,"FW,MF",Union Berlin,Bundesliga,32,1988,18.1,7,3,1,5,1,2,9,22.2,7,11,0,11,3,10,3,0,0,2020-2021,90.0,14.917127071823202,34.80662983425414
1379,Lukas Kübler,GER,"DF,MF",Freiburg,Bundesliga,27,1992,9.8,15,8,9,5,1,9,14,64.3,5,9,3,6,21,36,31,0,0,2020-2021,90.0,192.85714285714283,137.75510204081633
1380,Takefusa Kubo,JPN,"MF,FW",Villarreal,La Liga,19,2001,3.3,1,1,0,0,1,1,5,20.0,4,2,0,2,1,2,2,0,0,2020-2021,90.0,27.272727272727273,27.272727272727273
1381,Takefusa Kubo,JPN,"MF,FW",Getafe,La Liga,19,2001,8.9,7,4,2,3,2,1,14,7.1,13,14,0,14,14,21,4,0,0,2020-2021,90.0,141.57303370786516,70.78651685393258
1382,Juraj Kucka,SVK,"MF,FW",Parma,Serie A,33,1987,25.9,67,36,21,37,9,26,74,35.1,48,25,3,22,28,95,25,0,0,2020-2021,90.0,97.2972972972973,232.81853281853284
1383,Kuki,ESP,MF,Valladolid,La Liga,22,1998,0.3,1,1,0,0,1,0,1,0.0,1,0,0,0,0,1,0,0,0,2020-2021,90.0,0.0,300.0
1384,Dejan Kulusevski,SWE,"MF,FW",Juventus,Serie A,20,2000,21.4,33,19,12,10,11,14,43,32.6,29,22,0,22,9,42,2,1,0,2020-2021,90.0,37.85046728971963,138.78504672897196
1385,Marash Kumbulla,ALB,DF,Roma,Serie A,20,2000,15.1,16,11,8,7,1,5,17,29.4,12,12,5,7,24,40,38,1,0,2020-2021,90.0,143.04635761589404,95.36423841059603
1386,Pierre Kunde,CMR,MF,Mainz 05,Bundesliga,25,1995,5.7,8,4,1,5,2,2,9,22.2,7,6,0,6,10,18,9,0,0,2020-2021,90.0,157.89473684210526,126.3157894736842
1387,Fabian Kunze,GER,MF,Arminia,Bundesliga,22,1998,14.1,38,26,19,15,4,19,42,45.2,23,19,3,16,18,56,22,1,0,2020-2021,89.99999999999999,114.89361702127658,242.5531914893617
1388,Jasmin Kurtić,SVN,MF,Parma,Serie A,31,1989,30.4,46,28,22,21,3,21,70,30.0,49,22,2,20,33,79,57,1,0,2020-2021,90.0,97.69736842105263,136.18421052631578
1389,Layvin Kurzawa,FRA,DF,Paris S-G,Ligue 1,27,1992,14.2,26,19,10,10,6,9,28,32.1,19,20,5,15,28,54,26,1,0,2020-2021,90.0,177.46478873239437,164.7887323943662
1390,Dereck Kutesa,SUI,"MF,FW",Reims,Ligue 1,22,1997,7.6,15,7,7,3,5,5,14,35.7,9,7,1,6,7,22,3,0,0,2020-2021,90.0,82.89473684210526,177.6315789473684
1391,Ahmed Kutucu,TUR,"FW,MF",Schalke 04,Bundesliga,20,2000,1.2,1,0,0,0,1,1,2,50.0,1,1,0,1,0,1,0,0,0,2020-2021,90.0,0.0,75.0
1392,Enock Kwateng,FRA,DF,Bordeaux,Ligue 1,23,1997,11.5,21,12,15,4,2,14,27,51.9,13,15,3,12,26,47,27,0,0,2020-2021,90.0,203.47826086956525,164.34782608695653
1393,Giorgos Kyriakopoulos,GRE,DF,Sassuolo,Serie A,24,1996,16.2,35,18,17,12,6,8,28,28.6,20,16,5,11,15,50,42,0,0,2020-2021,90.0,83.33333333333334,194.44444444444446
1394,Antonino La Gumina,ITA,FW,Sampdoria,Serie A,24,1996,3.8,3,2,0,1,2,0,3,0.0,3,5,1,4,3,6,5,0,0,2020-2021,90.0,71.05263157894737,71.05263157894737
1395,Gaëtan Laborde,FRA,"FW,MF",Montpellier,Ligue 1,26,1994,36.2,43,22,21,17,5,16,60,26.7,44,29,3,26,16,59,25,1,0,2020-2021,90.0,39.77900552486187,106.90607734806629
1396,Alexandre Lacazette,FRA,FW,Arsenal,Premier League,29,1991,21.4,18,10,4,11,3,4,22,18.2,18,20,1,19,12,30,13,0,0,2020-2021,90.0,50.46728971962617,75.70093457943926
1397,Tom Lacoux,FRA,MF,Bordeaux,Ligue 1,18,2002,5.8,22,14,10,11,1,9,21,42.9,12,12,3,9,12,34,7,0,0,2020-2021,90.0,186.20689655172413,341.3793103448276
1398,Maxence Lacroix,FRA,DF,Wolfsburg,Bundesliga,20,2000,28.8,49,29,37,12,0,24,45,53.3,21,51,21,30,65,114,140,1,0,2020-2021,90.0,203.125,153.125
1399,Alban Lafont,FRA,GK,Nantes,Ligue 1,21,1999,38.0,1,0,1,0,0,1,1,100.0,0,1,0,1,0,1,14,0,0,2020-2021,90.0,0.0,2.3684210526315788
1400,Víctor Laguardia,ESP,DF,Alavés,La Liga,30,1989,29.2,20,12,13,6,1,14,31,45.2,17,25,13,12,37,57,104,0,0,2020-2021,90.0,114.04109589041097,61.64383561643836
Rk,Player,Nation,Pos,Squad,Comp,0,0,90.0,0,0,3,3,3,Tkl,0,0.0,0,0,0,0,0,0,0,0,0,2020-2021,90.0,0.0,0.0
1401,Konrad Laimer,AUT,"DF,MF",RB Leipzig,Bundesliga,23,1997,0.9,2,0,0,1,1,0,4,0.0,4,2,0,2,1,3,0,0,0,2020-2021,90.0,100.0,200.0
1402,Stefan Lainer,AUT,DF,Gladbach,Bundesliga,27,1992,30.8,62,37,30,22,10,27,60,45.0,33,34,5,29,35,97,85,1,0,2020-2021,90.0,102.27272727272728,181.1688311688312
1403,Diego Lainez,MEX,"FW,MF",Betis,La Liga,20,2000,9.6,9,4,3,5,1,6,16,37.5,10,15,0,15,11,20,6,0,0,2020-2021,90.0,103.125,84.375
1404,Kenny Lala,MAD,DF,Strasbourg,Ligue 1,28,1991,20.4,22,13,13,8,1,11,22,50.0,11,12,6,6,23,45,33,1,0,2020-2021,90.0,101.47058823529412,97.05882352941177
1405,Adam Lallana,ENG,"MF,FW",Brighton,Premier League,32,1988,17.7,28,13,11,13,4,8,39,20.5,31,18,3,15,15,43,13,0,0,2020-2021,90.0,76.27118644067797,142.3728813559322
1406,Érik Lamela,ARG,"FW,MF",Tottenham,Premier League,28,1992,8.0,17,9,1,11,5,8,21,38.1,13,11,1,10,6,23,2,0,0,2020-2021,90.0,67.5,191.25
1407,Sam Lammers,NED,"FW,MF",Atalanta,Serie A,23,1997,3.2,2,0,0,2,0,0,6,0.0,6,0,0,0,0,2,3,0,0,2020-2021,90.0,0.0,56.25
1408,Tariq Lamptey,GHA,"DF,MF",Brighton,Premier League,19,2000,9.8,17,9,7,6,4,6,13,46.2,7,8,1,7,19,36,12,1,0,2020-2021,90.0,174.48979591836735,156.12244897959184
1409,Loïck Landre,FRA,DF,Nîmes,Ligue 1,28,1992,18.1,14,7,9,5,0,13,28,46.4,15,22,19,3,31,45,52,0,0,2020-2021,90.0,154.14364640883977,69.61325966850828
1410,Michael Langer,AUT,GK,Schalke 04,Bundesliga,35,1985,2.7,0,0,0,0,0,0,0,0.0,0,0,0,0,0,0,3,0,0,2020-2021,90.0,0.0,0.0
1411,Manuel Lanzini,ARG,"MF,FW",West Ham,Premier League,27,1993,6.3,9,2,3,4,2,3,10,30.0,7,9,0,9,7,16,5,0,0,2020-2021,90.0,100.00000000000001,128.57142857142858
1412,Gianluca Lapadula,PER,FW,Benevento,Serie A,30,1990,28.5,22,12,3,13,6,6,25,24.0,19,18,3,15,5,27,16,0,0,2020-2021,90.0,15.789473684210527,69.47368421052632
1413,Aymeric Laporte,ESP,DF,Manchester City,Premier League,26,1994,14.9,13,6,10,3,0,7,11,63.6,4,12,7,5,11,24,28,0,0,2020-2021,90.0,66.44295302013423,78.5234899328859
1414,Julien Laporte,FRA,DF,Lorient,Ligue 1,26,1993,29.5,65,39,48,16,1,42,74,56.8,32,34,23,11,65,130,125,0,0,2020-2021,90.0,198.3050847457627,198.3050847457627
1415,Danilo Larangeira,BRA,DF,Bologna,Serie A,36,1984,34.8,33,24,23,10,0,8,29,27.6,21,58,36,22,51,84,127,2,0,2020-2021,90.0,131.89655172413794,85.3448275862069
1416,Gautier Larsonneur,FRA,GK,Brest,Ligue 1,23,1997,35.0,1,1,1,0,0,1,1,100.0,0,2,0,2,0,1,16,3,0,2020-2021,90.0,0.0,2.571428571428571
1417,Kevin Lasagna,ITA,FW,Udinese,Serie A,27,1992,12.3,6,1,2,3,1,3,14,21.4,11,11,0,11,6,12,7,0,0,2020-2021,89.99999999999999,43.90243902439024,43.90243902439024
1418,Kevin Lasagna,ITA,FW,Hellas Verona,Serie A,27,1992,14.1,7,3,0,5,2,1,5,20.0,4,12,1,11,1,8,11,0,0,2020-2021,89.99999999999999,6.382978723404255,44.680851063829785
1419,Jamaal Lascelles,ENG,DF,Newcastle Utd,Premier League,26,1993,18.1,14,7,5,9,0,3,6,50.0,3,27,17,10,12,26,86,0,0,2020-2021,90.0,59.66850828729281,69.61325966850828
1420,Paul Lasne,FRA,MF,Brest,Ligue 1,31,1989,18.7,46,26,25,19,2,17,40,42.5,23,25,5,20,47,93,17,2,0,2020-2021,90.0,226.20320855614972,221.3903743315508
1421,Toni Lato,ESP,DF,Valencia,La Liga,22,1997,8.1,13,6,7,3,3,6,13,46.2,7,12,1,11,10,23,21,0,0,2020-2021,90.0,111.11111111111111,144.44444444444446
1422,Danny Latza,GER,MF,Mainz 05,Bundesliga,30,1989,20.0,43,26,12,19,12,23,70,32.9,47,39,3,36,27,70,23,0,0,2020-2021,90.0,121.5,193.5
1423,Armand Lauriente,FRA,"MF,FW",Lorient,Ligue 1,21,1998,18.0,30,10,10,19,1,7,26,26.9,19,21,0,21,15,45,4,0,0,2020-2021,90.0,75.0,150.0
1424,Vincent Laurini,FRA,DF,Parma,Serie A,31,1989,9.7,16,11,8,6,2,7,9,77.8,2,8,4,4,17,33,22,1,0,2020-2021,90.0,157.73195876288662,148.4536082474227
1425,Lauti,URU,MF,Celta Vigo,La Liga,19,2001,0.2,0,0,0,0,0,0,0,0.0,0,0,0,0,0,0,1,0,0,2020-2021,90.0,0.0,0.0
Rk,Player,Nation,Pos,Squad,Comp,0,0,90.0,0,0,3,3,3,Tkl,0,0.0,0,0,0,0,0,0,0,0,0,2020-2021,90.0,0.0,0.0
1426,Wesley Lautoa,NCL,"MF,DF",Dijon,Ligue 1,32,1987,17.9,36,20,20,13,3,11,37,29.7,26,17,8,9,29,65,33,1,0,2020-2021,90.0,145.8100558659218,181.0055865921788
1427,Valentino Lazaro,AUT,"DF,FW",Gladbach,Bundesliga,24,1996,13.8,17,11,7,5,5,12,19,63.2,7,18,1,17,15,32,20,0,0,2020-2021,90.0,97.82608695652173,110.8695652173913
1428,Darko Lazović,SRB,"DF,MF",Hellas Verona,Serie A,29,1990,27.8,29,17,8,17,4,20,42,47.6,22,17,7,10,20,49,29,0,0,2020-2021,90.0,64.74820143884892,93.88489208633094
1429,Manuel Lazzari,ITA,DF,Lazio,Serie A,26,1993,29.0,24,14,15,4,5,14,39,35.9,25,22,3,19,18,42,28,0,0,2020-2021,90.0,55.86206896551724,74.48275862068965
1430,Jérémy Le Douaron,FRA,"FW,MF",Brest,Ligue 1,22,1998,9.1,15,10,9,4,2,7,21,33.3,14,14,1,13,8,23,11,0,0,2020-2021,90.0,79.12087912087912,148.35164835164835
1431,Enzo Le Fée,FRA,MF,Lorient,Ligue 1,20,2000,20.2,51,28,23,23,5,27,73,37.0,46,30,6,24,25,76,10,0,0,2020-2021,90.0,111.38613861386139,227.22772277227722
1432,Vincent Le Goff,FRA,DF,Lorient,Ligue 1,30,1989,25.6,42,29,16,24,2,18,49,36.7,31,27,5,22,44,86,44,0,0,2020-2021,90.0,154.6875,147.65625
1433,Maxime Le Marchand,FRA,DF,Fulham,Premier League,30,1989,1.4,2,2,2,0,0,2,2,100.0,0,0,0,0,0,2,3,0,0,2020-2021,90.0,0.0,128.57142857142858
1434,Robin Le Normand,ESP,DF,Real Sociedad,La Liga,23,1996,30.5,34,20,25,8,1,9,19,47.4,10,35,24,11,36,70,87,1,0,2020-2021,90.0,106.22950819672131,100.327868852459
1435,Damien Le Tallec,FRA,"MF,DF",Montpellier,Ligue 1,30,1990,13.6,16,10,10,4,2,10,30,33.3,20,15,8,7,25,41,21,2,0,2020-2021,90.0,165.44117647058823,105.88235294117646
1436,James Lea Siliki,CMR,MF,Rennes,Ligue 1,24,1996,2.8,5,2,1,3,1,2,2,100.0,0,3,0,3,1,6,1,1,0,2020-2021,90.0,32.142857142857146,160.71428571428572
1437,Rafael Leão,POR,FW,Milan,Serie A,21,1999,21.4,13,6,4,7,2,6,15,40.0,9,17,0,17,4,17,14,1,0,2020-2021,90.0,16.82242990654206,54.67289719626169
1438,Jean-Louis Leca,FRA,GK,Lens,Ligue 1,34,1985,36.8,3,2,3,0,0,3,5,60.0,2,0,0,0,1,4,14,4,0,2020-2021,90.0,2.4456521739130435,7.336956521739131
1439,Mathew Leckie,AUS,"FW,DF",Hertha BSC,Bundesliga,29,1991,5.6,12,3,5,5,2,4,11,36.4,7,8,0,8,13,25,9,0,0,2020-2021,90.0,208.92857142857144,192.85714285714286
1440,Benjamin Lecomte,FRA,GK,Monaco,Ligue 1,29,1991,28.0,0,0,0,0,0,0,2,0.0,2,1,0,1,2,2,20,1,0,2020-2021,90.0,6.428571428571429,0.0
1441,Jeremías Ledesma,ARG,GK,Cádiz,La Liga,27,1993,32.0,1,0,1,0,0,1,1,100.0,0,1,0,1,0,1,22,6,0,2020-2021,90.0,0.0,2.8125
1442,Pierre Lees-Melou,FRA,MF,Nice,Ligue 1,27,1993,22.9,67,39,33,31,3,25,83,30.1,58,50,14,36,29,96,31,1,0,2020-2021,90.0,113.97379912663757,263.31877729257644
1443,Lucas Leiva,BRA,MF,Lazio,Serie A,33,1987,23.7,68,32,38,28,2,30,86,34.9,56,21,0,21,57,125,21,0,0,2020-2021,90.0,216.45569620253167,258.22784810126586
1444,Florian Lejeune,FRA,DF,Alavés,La Liga,29,1991,33.5,43,32,36,7,0,21,35,60.0,14,38,24,14,51,94,149,1,0,2020-2021,90.0,137.01492537313433,115.52238805970148
1445,Iñigo Lekue,ESP,DF,Athletic Club,La Liga,27,1993,7.2,9,7,6,3,0,3,8,37.5,5,8,1,7,4,13,24,0,0,2020-2021,90.0,50.0,112.5
1446,Thomas Lemar,FRA,MF,Atlético Madrid,La Liga,24,1995,15.2,30,17,9,17,4,11,24,45.8,13,22,1,21,11,41,10,0,0,2020-2021,90.0,65.13157894736842,177.6315789473684
1447,Mario Lemina,GAB,MF,Fulham,Premier League,26,1993,18.9,62,35,25,30,7,23,44,52.3,21,26,5,21,30,92,21,0,0,2020-2021,90.0,142.85714285714286,295.23809523809524
1448,Fabien Lemoine,FRA,MF,Lorient,Ligue 1,33,1987,21.5,74,45,39,33,2,36,89,40.4,53,25,1,24,27,101,35,0,0,2020-2021,90.0,113.02325581395348,309.7674418604651
1449,Clément Lenglet,FRA,DF,Barcelona,La Liga,25,1995,27.5,36,21,23,10,3,19,28,67.9,9,26,12,14,33,69,71,1,0,2020-2021,89.99999999999999,107.99999999999999,117.81818181818181
1450,Bernd Leno,GER,GK,Arsenal,Premier League,28,1992,34.8,1,0,1,0,0,1,1,100.0,0,1,0,1,0,1,11,2,0,2020-2021,90.0,0.0,2.586206896551724
Rk,Player,Nation,Pos,Squad,Comp,0,0,90.0,0,0,3,3,3,Tkl,0,0.0,0,0,0,0,0,0,0,0,0,2020-2021,90.0,0.0,0.0
1451,Christopher Lenz,GER,"DF,FW",Union Berlin,Bundesliga,25,1994,25.0,74,41,39,30,5,35,71,49.3,36,34,5,29,35,109,50,0,0,2020-2021,90.0,126.0,266.4
1452,Pedro León,ESP,"MF,FW",Eibar,La Liga,33,1986,10.4,9,8,3,3,3,3,17,17.6,14,11,0,11,7,16,2,0,0,2020-2021,90.0,60.57692307692307,77.88461538461537
1453,Sergio León,ESP,FW,Levante,La Liga,31,1989,8.3,6,2,0,4,2,2,8,25.0,6,4,0,4,3,9,2,0,0,2020-2021,90.0,32.53012048192771,65.06024096385542
1454,Lukas Lerager,DEN,MF,Genoa,Serie A,27,1993,12.9,24,13,14,9,1,11,30,36.7,19,13,3,10,14,38,25,1,0,2020-2021,90.0,97.67441860465115,167.44186046511626
1455,Mehdi Léris,ALG,"DF,MF",Sampdoria,Serie A,22,1998,4.3,11,5,6,4,1,6,16,37.5,10,12,2,10,12,23,15,0,0,2020-2021,90.0,251.16279069767444,230.23255813953492
1456,Khanya Leshabela,RSA,MF,Leicester City,Premier League,20,1999,0.1,0,0,0,0,0,0,0,0.0,0,0,0,0,0,0,0,0,0,2020-2021,90.0,0.0,0.0
1457,Karlo Letica,CRO,GK,Sampdoria,Serie A,23,1997,1.0,0,0,0,0,0,0,0,0.0,0,0,0,0,0,0,2,0,0,2020-2021,90.0,0.0,0.0
1458,Gaetano Letizia,ITA,DF,Benevento,Serie A,30,1990,17.4,36,25,19,13,4,17,36,47.2,19,15,3,12,20,56,42,1,0,2020-2021,90.0,103.44827586206897,186.20689655172413
1459,Robert Lewandowski,POL,FW,Bayern Munich,Bundesliga,31,1988,27.3,15,9,0,7,8,2,13,15.4,11,9,1,8,3,18,11,0,0,2020-2021,90.0,9.89010989010989,49.450549450549445
1460,Jamal Lewis,NIR,DF,Newcastle Utd,Premier League,22,1998,20.4,37,20,23,13,1,16,38,42.1,22,21,7,14,11,48,44,1,0,2020-2021,90.0,48.529411764705884,163.23529411764707
1461,Aaron Leya Iseka,BEL,FW,Metz,Ligue 1,22,1997,11.2,6,4,2,3,1,0,4,0.0,4,4,2,2,0,6,6,0,0,2020-2021,90.0,0.0,48.214285714285715
1462,Yanis Lhery,FRA,MF,Saint-Étienne,Ligue 1,17,2003,0.3,0,0,0,0,0,0,0,0.0,0,0,0,0,0,0,0,0,0,2020-2021,90.0,0.0,0.0
1463,Dimitri Liénard,FRA,MF,Strasbourg,Ligue 1,32,1988,20.3,39,27,17,19,3,24,55,43.6,31,23,1,22,18,57,10,0,0,2020-2021,90.0,79.80295566502463,172.9064039408867
1464,Philipp Lienhart,AUT,DF,Freiburg,Bundesliga,24,1996,33.3,21,13,12,7,2,9,20,45.0,11,30,21,9,42,63,100,0,0,2020-2021,90.0,113.51351351351352,56.75675675675676
1465,Matthijs de Ligt,NED,DF,Juventus,Serie A,20,1999,24.7,37,19,20,16,1,18,28,64.3,10,42,21,21,31,68,64,0,0,2020-2021,90.0,112.95546558704454,134.8178137651822
1466,Isaac Lihadji,FRA,"MF,FW",Lille,Ligue 1,18,2002,2.2,11,4,2,6,3,4,5,80.0,1,5,1,4,1,12,0,1,0,2020-2021,90.0,40.90909090909091,450.0
1467,Dimitris Limnios,GRE,"MF,FW",Köln,Bundesliga,22,1998,4.2,9,6,3,5,1,5,6,83.3,1,5,0,5,2,11,1,0,0,2020-2021,90.0,42.857142857142854,192.85714285714286
1468,Victor Lindelöf,SWE,DF,Manchester Utd,Premier League,26,1994,28.7,22,10,12,10,0,12,24,50.0,12,22,14,8,30,52,95,1,0,2020-2021,90.0,94.07665505226481,68.98954703832753
1469,Karol Linetty,POL,MF,Torino,Serie A,25,1995,20.4,38,28,13,19,6,16,45,35.6,29,19,5,14,15,53,7,0,0,2020-2021,90.0,66.1764705882353,167.64705882352942
1470,Jesse Lingard,ENG,"MF,FW",West Ham,Premier League,27,1992,15.8,12,6,4,8,0,5,14,35.7,9,7,1,6,4,16,0,0,0,2020-2021,90.0,22.784810126582276,68.35443037974683
1471,Pol Lirola,ESP,"DF,FW",Fiorentina,Serie A,22,1997,5.5,13,8,8,2,3,6,12,50.0,6,6,3,3,6,19,9,0,0,2020-2021,90.0,98.18181818181819,212.72727272727275
1472,Pol Lirola,ESP,"DF,FW",Marseille,Ligue 1,22,1997,17.3,28,16,11,15,2,16,28,57.1,12,18,5,13,25,53,26,0,0,2020-2021,90.0,130.05780346820808,145.66473988439304
1473,Jake Livermore,ENG,MF,West Brom,Premier League,30,1989,13.8,33,18,14,16,3,14,31,45.2,17,21,6,15,16,49,26,0,0,2020-2021,90.0,104.34782608695652,215.2173913043478
1474,Diego Llorente,ESP,DF,Leeds United,Premier League,26,1993,13.4,34,21,21,13,0,19,32,59.4,13,18,13,5,20,54,40,2,0,2020-2021,90.0,134.32835820895522,228.35820895522386
1475,Diego Llorente,ESP,DF,Real Sociedad,La Liga,26,1993,1.0,1,0,1,0,0,1,2,50.0,1,1,1,0,2,3,5,0,0,2020-2021,90.0,180.0,90.0
Rk,Player,Nation,Pos,Squad,Comp,0,0,90.0,0,0,3,3,3,Tkl,0,0.0,0,0,0,0,0,0,0,0,0,2020-2021,90.0,0.0,0.0
1476,Fernando Llorente,ESP,FW,Udinese,Serie A,35,1985,7.9,4,1,2,2,0,2,5,40.0,3,3,0,3,2,6,17,0,0,2020-2021,90.0,22.784810126582276,45.56962025316455
1477,Fernando Llorente,ESP,"FW,MF",Napoli,Serie A,35,1985,0.6,0,0,0,0,0,0,0,0.0,0,0,0,0,0,0,0,0,0,2020-2021,90.0,0.0,0.0
1478,Marcos Llorente,ESP,"MF,FW",Atlético Madrid,La Liga,25,1995,32.8,71,42,21,40,10,26,62,41.9,36,40,3,37,29,100,28,0,0,2020-2021,90.0,79.57317073170732,194.81707317073173
1479,Hugo Lloris,FRA,GK,Tottenham,Premier League,33,1986,38.0,0,0,0,0,0,0,1,0.0,1,0,0,0,0,0,10,1,0,2020-2021,90.0,0.0,0.0
1480,Giovani Lo Celso,ARG,MF,Tottenham,Premier League,24,1996,10.5,28,22,12,11,5,10,29,34.5,19,12,1,11,7,35,5,0,0,2020-2021,90.0,60.0,240.0
1481,Stanislav Lobotka,SVK,MF,Napoli,Serie A,25,1994,1.7,1,1,0,1,0,0,1,0.0,1,1,1,0,0,1,1,1,0,2020-2021,90.0,0.0,52.94117647058823
1482,Manuel Locatelli,ITA,MF,Sassuolo,Serie A,22,1998,32.0,81,47,43,28,10,29,56,51.8,27,35,15,20,51,132,65,1,0,2020-2021,90.0,143.4375,227.8125
1483,Renan Lodi,BRA,"DF,FW",Atlético Madrid,La Liga,22,1998,12.5,30,17,13,12,5,17,26,65.4,9,15,0,15,16,46,18,0,0,2020-2021,90.0,115.19999999999999,216.0
1484,Ruben Loftus-Cheek,ENG,FW,Chelsea,Premier League,24,1996,0.7,0,0,0,0,0,0,0,0.0,0,0,0,0,0,0,0,0,0,2020-2021,90.0,0.0,0.0
1485,Ruben Loftus-Cheek,ENG,"MF,FW",Fulham,Premier League,24,1996,21.2,25,14,7,15,3,7,23,30.4,16,20,2,18,7,32,18,0,0,2020-2021,90.0,29.716981132075475,106.13207547169812
1486,Niklas Lomb,GER,GK,Leverkusen,Bundesliga,27,1993,1.5,0,0,0,0,0,0,0,0.0,0,0,0,0,0,0,0,2,0,2020-2021,90.0,0.0,0.0
1487,Kevin Long,IRL,DF,Burnley,Premier League,29,1990,7.1,11,6,9,2,0,7,9,77.8,2,11,7,4,6,17,24,0,0,2020-2021,90.0,76.05633802816902,139.43661971830986
1488,Shane Long,IRL,FW,Southampton,Premier League,33,1987,2.3,2,1,0,0,2,2,3,66.7,1,0,0,0,3,5,1,0,0,2020-2021,90.0,117.3913043478261,78.26086956521739
1489,Matthew Longstaff,ENG,MF,Newcastle Utd,Premier League,20,2000,4.2,3,2,2,1,0,2,8,25.0,6,7,0,7,7,10,2,0,0,2020-2021,90.0,150.0,64.28571428571428
1490,Sean Longstaff,ENG,MF,Newcastle Utd,Premier League,22,1997,15.7,31,14,13,15,3,18,42,42.9,24,26,5,21,19,50,14,2,0,2020-2021,90.0,108.9171974522293,177.70700636942678
1491,Ademola Lookman,NGA,"FW,MF",Fulham,Premier League,22,1997,30.5,35,11,18,9,8,13,44,29.5,31,31,1,30,20,55,9,0,0,2020-2021,90.0,59.01639344262295,103.27868852459015
1492,Anthony Lopes,POR,GK,Lyon,Ligue 1,29,1990,38.0,1,1,1,0,0,1,2,50.0,1,1,0,1,1,2,20,1,0,2020-2021,90.0,2.3684210526315788,2.3684210526315788
1493,Rony Lopes,POR,"FW,MF",Nice,Ligue 1,24,1995,19.8,20,14,4,13,3,6,27,22.2,21,14,3,11,8,28,6,0,0,2020-2021,90.0,36.36363636363637,90.9090909090909
1494,Adrián López,ESP,"FW,MF",Osasuna,La Liga,32,1988,5.3,3,3,0,1,2,1,5,20.0,4,3,0,3,0,3,3,0,0,2020-2021,90.0,0.0,50.943396226415096
1495,Javi López,ESP,"DF,MF",Alavés,La Liga,18,2002,2.8,5,5,3,2,0,2,3,66.7,1,2,0,2,3,8,3,1,0,2020-2021,90.0,96.42857142857143,160.71428571428572
1496,Maxime Lopez,FRA,MF,Sassuolo,Serie A,22,1997,20.7,24,13,15,6,3,14,41,34.1,27,9,0,9,16,40,10,1,0,2020-2021,90.0,69.56521739130436,104.34782608695653
1497,Maxime Lopez,FRA,"FW,MF",Marseille,Ligue 1,22,1997,1.5,1,1,1,0,0,0,2,0.0,2,0,0,0,2,3,2,0,0,2020-2021,90.0,120.0,60.0
1498,Pedro López Muñoz,ESP,DF,Huesca,La Liga,36,1983,11.9,23,15,10,8,5,15,22,68.2,7,10,4,6,16,39,23,1,0,2020-2021,90.00000000000001,121.00840336134455,173.9495798319328
1499,Pau López,ESP,GK,Roma,Serie A,25,1994,20.2,2,0,2,0,0,2,2,100.0,0,1,0,1,0,2,7,4,0,2020-2021,90.0,0.0,8.910891089108912
1500,Roberto López,ESP,"MF,FW",Real Sociedad,La Liga,20,2000,5.6,5,1,1,2,2,2,5,40.0,3,2,0,2,4,9,6,0,0,2020-2021,90.0,64.28571428571429,80.35714285714286
Rk,Player,Nation,Pos,Squad,Comp,0,0,90.0,0,0,3,3,3,Tkl,0,0.0,0,0,0,0,0,0,0,0,0,2020-2021,90.0,0.0,0.0
1501,Unai López,ESP,MF,Athletic Club,La Liga,24,1995,15.8,27,17,13,13,1,10,29,34.5,19,20,5,15,18,45,9,1,0,2020-2021,90.0,102.53164556962024,153.79746835443035
1502,Dion Lopy,SEN,MF,Reims,Ligue 1,18,2002,2.8,1,1,0,1,0,0,0,0.0,0,0,0,0,2,3,1,0,0,2020-2021,90.0,64.28571428571429,32.142857142857146
1503,Jordan Lotomba,SUI,"DF,MF",Nice,Ligue 1,21,1998,23.6,35,25,19,11,5,20,34,58.8,14,19,7,12,33,68,52,1,0,2020-2021,90.0,125.84745762711863,133.47457627118644
1504,Adrien Louveau,FRA,MF,Lens,Ligue 1,20,2000,0.1,0,0,0,0,0,0,0,0.0,0,0,0,0,0,0,1,0,0,2020-2021,90.0,0.0,0.0
1505,Imran Louza,MAR,MF,Nantes,Ligue 1,21,1999,26.4,55,28,25,26,4,21,69,30.4,48,20,4,16,33,88,15,2,0,2020-2021,90.0,112.5,187.5
1506,Matteo Lovato,ITA,DF,Hellas Verona,Serie A,20,2000,15.4,21,12,14,5,2,10,21,47.6,11,20,10,10,37,58,48,1,0,2020-2021,90.0,216.23376623376623,122.72727272727273
1507,Max Lowe,ENG,DF,Sheffield Utd,Premier League,23,1997,6.1,26,11,18,6,2,9,21,42.9,12,12,4,8,5,31,11,0,0,2020-2021,90.0,73.7704918032787,383.6065573770492
1508,Eduard Löwen,GER,"MF,DF",Hertha BSC,Bundesliga,23,1997,0.9,5,1,3,1,1,2,5,40.0,3,1,0,1,1,6,1,0,0,2020-2021,90.0,100.0,500.0
1509,Matthew Lowton,ENG,DF,Burnley,Premier League,31,1989,34.0,54,32,31,22,1,32,73,43.8,41,36,13,23,56,110,91,1,0,2020-2021,90.0,148.23529411764707,142.94117647058823
1510,Anthony Lozano,HON,FW,Cádiz,La Liga,27,1993,16.9,12,4,1,5,6,2,13,15.4,11,3,1,2,3,15,8,0,0,2020-2021,90.0,15.976331360946746,63.905325443786985
1511,Hirving Lozano,MEX,FW,Napoli,Serie A,25,1995,21.8,29,18,10,13,6,10,36,27.8,26,37,1,36,18,47,14,0,0,2020-2021,90.0,74.31192660550458,119.72477064220183
1512,Jan Luca Schuler,GER,FW,Schalke 04,Bundesliga,21,1999,0.4,2,2,1,1,0,0,1,0.0,1,1,0,1,0,2,0,0,0,2020-2021,90.0,0.0,450.0
1513,Jean Lucas,BRA,MF,Lyon,Ligue 1,22,1998,1.9,3,2,2,1,0,1,4,25.0,3,3,1,2,2,5,1,0,0,2020-2021,90.0,94.73684210526315,142.10526315789474
1514,Jean Lucas,BRA,"MF,FW",Brest,Ligue 1,22,1998,11.2,19,13,10,9,0,8,29,27.6,21,7,0,7,8,27,10,1,0,2020-2021,90.0,64.28571428571429,152.67857142857144
1515,Anderson Lucoqui,ANG,DF,Arminia,Bundesliga,23,1997,17.8,40,25,23,17,0,20,40,50.0,20,30,7,23,27,67,53,0,0,2020-2021,90.0,136.51685393258427,202.24719101123597
1516,Jeison Lucumí,COL,MF,Elche,La Liga,25,1995,0.5,1,1,0,1,0,0,0,0.0,0,1,0,1,0,1,0,0,0,2020-2021,90.0,0.0,180.0
1517,Kilian Ludewig,GER,"DF,FW",Schalke 04,Bundesliga,20,2000,5.8,16,6,10,5,1,8,25,32.0,17,7,0,7,3,19,14,0,0,2020-2021,90.0,46.55172413793103,248.27586206896552
1518,Florentino Luís,POR,MF,Monaco,Ligue 1,20,1999,2.7,7,2,4,2,1,6,10,60.0,4,1,0,1,6,13,2,1,0,2020-2021,90.0,199.99999999999997,233.33333333333331
1519,José Luis Gayà,ESP,DF,Valencia,La Liga,25,1995,31.6,59,33,40,13,6,33,68,48.5,35,22,3,19,38,97,62,1,0,2020-2021,90.0,108.2278481012658,168.0379746835443
1520,José Luis Morales,ESP,"MF,FW",Levante,La Liga,33,1987,27.1,18,10,7,9,2,8,36,22.2,28,17,0,17,11,29,11,0,0,2020-2021,90.0,36.53136531365314,59.77859778597786
1521,José Luis Palomino,ARG,DF,Atalanta,Serie A,30,1990,27.0,67,33,41,19,7,24,48,50.0,24,30,16,14,79,146,60,2,0,2020-2021,90.0,263.33333333333337,223.33333333333334
1522,Luisinho,POR,DF,Huesca,La Liga,35,1985,2.0,3,3,2,1,0,1,3,33.3,2,3,0,3,4,7,7,0,0,2020-2021,90.0,180.0,135.0
1523,Luismi,ESP,"MF,DF",Elche,La Liga,28,1992,1.9,4,2,1,3,0,1,2,50.0,1,2,0,2,4,8,0,0,0,2020-2021,90.0,189.4736842105263,189.4736842105263
1524,David Luiz,BRA,DF,Arsenal,Premier League,33,1987,15.5,12,9,5,7,0,4,4,100.0,0,16,9,7,16,28,50,2,0,2020-2021,90.0,92.90322580645162,69.6774193548387
1525,Douglas Luiz,BRA,MF,Aston Villa,Premier League,22,1998,30.9,49,18,22,26,1,20,58,34.5,38,52,17,35,43,92,44,2,0,2020-2021,90.0,125.24271844660194,142.71844660194176
Rk,Player,Nation,Pos,Squad,Comp,0,0,90.0,0,0,3,3,3,Tkl,0,0.0,0,0,0,0,0,0,0,0,0,2020-2021,90.0,0.0,0.0
1526,Romelu Lukaku,BEL,FW,Inter,Serie A,27,1993,32.0,11,1,1,6,4,6,14,42.9,8,11,1,10,3,14,34,0,0,2020-2021,90.0,8.4375,30.9375
1527,Dodi Lukebakio,BEL,"FW,MF",Hertha BSC,Bundesliga,22,1997,20.6,21,14,13,5,3,9,20,45.0,11,14,1,13,12,33,8,0,0,2020-2021,90.0,52.42718446601942,91.74757281553399
1528,Saša Lukić,SRB,MF,Torino,Serie A,23,1996,23.4,32,13,11,18,3,15,50,30.0,35,23,5,18,17,49,17,0,0,2020-2021,89.99999999999999,65.38461538461539,123.07692307692307
1529,Senad Lulić,BIH,DF,Lazio,Serie A,34,1986,8.0,14,7,6,5,3,7,15,46.7,8,10,1,9,4,18,13,0,0,2020-2021,90.0,45.0,157.5
1530,John Lundstram,ENG,MF,Sheffield Utd,Premier League,26,1994,22.6,25,16,12,11,2,13,47,27.7,34,26,8,18,14,39,29,1,0,2020-2021,90.0,55.75221238938053,99.5575221238938
1531,Sebastiano Luperto,ITA,DF,Crotone,Serie A,23,1996,20.9,38,20,28,8,2,16,27,59.3,11,17,7,10,27,65,74,1,0,2020-2021,90.0,116.26794258373207,163.63636363636363
1532,Andreas Luthe,GER,GK,Union Berlin,Bundesliga,33,1987,30.8,1,1,1,0,0,1,3,33.3,2,1,0,1,0,1,8,3,0,2020-2021,90.0,0.0,2.9220779220779223
1533,Lyanco,BRA,DF,Torino,Serie A,23,1997,21.8,21,14,13,6,2,8,14,57.1,6,36,26,10,46,67,76,0,0,2020-2021,90.0,189.90825688073394,86.69724770642202
1534,Charalambos Lykogiannis,GRE,DF,Cagliari,Serie A,26,1993,26.9,34,21,22,9,3,22,38,57.9,16,34,13,21,32,66,94,0,0,2020-2021,90.0,107.06319702602231,113.75464684014871
1535,Yann M'Vila,FRA,MF,Saint-Étienne,Ligue 1,30,1990,0.2,0,0,0,0,0,0,2,0.0,2,0,0,0,1,1,0,0,0,2020-2021,90.0,450.0,0.0
1536,Alexis Mac Allister,ARG,"MF,FW",Brighton,Premier League,21,1998,12.4,26,12,6,16,4,11,38,28.9,27,25,4,21,9,35,4,0,0,2020-2021,90.0,65.3225806451613,188.70967741935485
1537,Darwin Machís,VEN,"FW,MF",Granada,La Liga,27,1993,22.5,30,17,12,10,8,6,19,31.6,13,21,2,19,22,52,13,0,0,2020-2021,90.0,88.0,120.0
1538,Tim Maciejewski,GER,FW,Union Berlin,Bundesliga,19,2001,0.1,0,0,0,0,0,0,0,0.0,0,0,0,0,0,0,0,0,0,2020-2021,90.0,0.0,0.0
1539,Luca Mack,GER,MF,Stuttgart,Bundesliga,20,2000,0.1,0,0,0,0,0,0,0,0.0,0,0,0,0,0,0,1,0,0,2020-2021,90.0,0.0,0.0
1540,Yvann Macon,FRA,DF,Saint-Étienne,Ligue 1,21,1998,6.0,30,20,20,8,2,7,19,36.8,12,6,2,4,9,39,13,0,0,2020-2021,90.0,135.0,450.0
1541,James Maddison,ENG,MF,Leicester City,Premier League,23,1996,23.3,32,16,5,16,11,14,41,34.1,27,14,1,13,9,41,5,0,0,2020-2021,90.0,34.763948497854074,123.60515021459227
1542,Mikail Maden,NOR,FW,Schalke 04,Bundesliga,18,2002,0.1,0,0,0,0,0,0,0,0.0,0,0,0,0,0,0,0,0,0,2020-2021,90.0,0.0,0.0
1543,Pablo Maffeo,ESP,DF,Huesca,La Liga,23,1997,21.8,26,17,21,4,1,12,26,46.2,14,18,6,12,35,61,27,0,0,2020-2021,90.0,144.4954128440367,107.3394495412844
1544,Gabriel Magalhães,BRA,DF,Arsenal,Premier League,22,1997,22.2,25,15,19,5,1,13,19,68.4,6,27,19,8,26,51,74,2,0,2020-2021,90.0,105.40540540540542,101.35135135135135
1545,Lisandro Magallán,ARG,DF,Crotone,Serie A,26,1993,24.2,54,31,28,24,2,17,42,40.5,25,29,15,14,44,98,78,1,0,2020-2021,90.0,163.63636363636363,200.82644628099172
1546,Christian Maggio,ITA,DF,Benevento,Serie A,38,1982,3.3,9,4,2,7,0,3,9,33.3,6,4,1,3,2,11,6,0,0,2020-2021,90.0,54.54545454545455,245.45454545454547
1547,Giulio Maggiore,ITA,MF,Spezia,Serie A,22,1998,24.6,61,36,26,28,7,21,53,39.6,32,33,6,27,19,80,25,1,0,2020-2021,89.99999999999999,69.51219512195121,223.17073170731703
1548,Francesco Magnanelli,ITA,MF,Sassuolo,Serie A,35,1984,4.9,7,5,2,5,0,3,10,30.0,7,6,2,4,13,20,10,0,0,2020-2021,90.0,238.77551020408163,128.57142857142856
1549,Giangiacomo Magnani,ITA,DF,Hellas Verona,Serie A,24,1995,16.8,26,15,14,9,3,9,16,56.3,7,25,16,9,44,70,105,1,0,2020-2021,90.0,235.7142857142857,139.28571428571428
1550,Hugo Magnetti,FRA,MF,Brest,Ligue 1,22,1998,6.7,24,12,10,13,1,20,40,50.0,20,6,1,5,14,38,8,0,0,2020-2021,90.0,188.0597014925373,322.3880597014925
Rk,Player,Nation,Pos,Squad,Comp,0,0,90.0,0,0,3,3,3,Tkl,0,0.0,0,0,0,0,0,0,0,0,0,2020-2021,90.0,0.0,0.0
1551,Harry Maguire,ENG,DF,Manchester Utd,Premier League,27,1993,33.9,29,17,19,10,0,18,29,62.1,11,28,23,5,60,89,122,4,0,2020-2021,90.0,159.2920353982301,76.99115044247787
1552,Abdallahi Mahmoud,MTN,MF,Alavés,La Liga,20,2000,0.7,2,2,1,1,0,0,1,0.0,1,0,0,0,1,3,0,0,0,2020-2021,90.0,128.57142857142858,257.14285714285717
1553,Hicham Mahou,FRA,FW,Nice,Ligue 1,21,1999,0.4,1,1,1,0,0,1,2,50.0,1,2,0,2,1,2,0,0,0,2020-2021,90.0,225.0,225.0
1554,Riyad Mahrez,ALG,FW,Manchester City,Premier League,29,1991,21.7,20,5,2,10,8,6,30,20.0,24,19,0,19,8,28,4,0,0,2020-2021,90.0,33.17972350230415,82.94930875576037
1555,Arne Maier,GER,MF,Arminia,Bundesliga,21,1999,11.5,13,9,5,7,1,4,11,36.4,7,10,3,7,8,21,11,1,0,2020-2021,90.0,62.60869565217392,101.73913043478262
1556,Arne Maier,GER,MF,Hertha BSC,Bundesliga,21,1999,0.3,1,1,0,1,0,0,1,0.0,1,0,0,0,0,1,0,0,0,2020-2021,90.0,0.0,300.0
1557,Habib Maïga,CIV,MF,Metz,Ligue 1,24,1996,29.9,81,52,36,40,5,42,85,49.4,43,37,6,31,49,130,36,0,0,2020-2021,90.0,147.49163879598663,243.81270903010036
1558,Mike Maignan,FRA,GK,Lille,Ligue 1,25,1995,38.0,0,0,0,0,0,0,0,0.0,0,0,0,0,0,0,7,2,0,2020-2021,90.0,0.0,0.0
1559,Ainsley Maitland-Niles,ENG,"MF,DF",Arsenal,Premier League,22,1997,5.4,11,7,6,5,0,8,12,66.7,4,12,2,10,14,25,7,1,0,2020-2021,90.0,233.33333333333331,183.33333333333331
1560,Ainsley Maitland-Niles,ENG,MF,West Brom,Premier League,22,1997,13.7,22,10,7,8,7,9,28,32.1,19,12,1,11,17,39,24,0,0,2020-2021,90.0,111.67883211678833,144.52554744525548
1561,Josh Maja,NGA,FW,Fulham,Premier League,21,1998,9.0,7,4,0,3,4,4,10,40.0,6,3,1,2,4,11,1,0,0,2020-2021,90.0,40.0,70.0
1562,Josh Maja,NGA,FW,Bordeaux,Ligue 1,21,1998,8.9,8,2,3,3,2,3,14,21.4,11,3,0,3,6,14,9,0,0,2020-2021,90.0,60.67415730337079,80.89887640449439
1563,Radosław Majecki,POL,GK,Monaco,Ligue 1,20,1999,1.0,0,0,0,0,0,0,0,0.0,0,0,0,0,0,0,1,0,0,2020-2021,90.0,0.0,0.0
1564,Abdul Majeed Waris,GHA,"FW,MF",Strasbourg,Ligue 1,28,1991,6.1,1,1,1,0,0,1,6,16.7,5,0,0,0,2,3,2,0,0,2020-2021,90.0,29.508196721311478,14.754098360655739
1565,Marco Majouga,CTA,"FW,MF",Nîmes,Ligue 1,19,2001,1.4,1,1,1,0,0,1,3,33.3,2,0,0,0,0,1,0,0,0,2020-2021,90.0,0.0,64.28571428571429
1566,Jean-Victor Makengo,FRA,MF,Udinese,Serie A,22,1998,5.8,8,7,5,3,0,3,13,23.1,10,7,1,6,5,13,7,0,0,2020-2021,90.0,77.58620689655173,124.13793103448276
1567,Nemanja Maksimović,SRB,MF,Getafe,La Liga,25,1995,30.3,50,28,22,24,4,19,46,41.3,27,40,9,31,57,107,46,1,0,2020-2021,90.0,169.30693069306932,148.5148514851485
1568,Nikola Maksimović,SRB,DF,Napoli,Serie A,28,1991,13.4,18,9,11,6,1,9,18,50.0,9,15,6,9,21,39,49,3,0,2020-2021,90.0,141.04477611940297,120.89552238805969
1569,Filip Malbašić,SRB,"FW,MF",Cádiz,La Liga,27,1992,9.6,12,7,4,5,3,6,18,33.3,12,10,0,10,4,16,2,0,0,2020-2021,90.0,37.5,112.50000000000001
1570,Kévin Malcuit,MAR,DF,Fiorentina,Serie A,29,1991,2.3,5,3,2,2,1,0,1,0.0,1,5,0,5,3,8,6,0,0,2020-2021,90.0,117.3913043478261,195.6521739130435
1571,Kévin Malcuit,MAR,"FW,MF",Napoli,Serie A,29,1991,0.4,2,1,2,0,0,0,1,0.0,1,0,0,0,2,4,2,0,0,2020-2021,90.0,450.0,450.0
1572,Daniel Maldini,ITA,"FW,DF",Milan,Serie A,18,2001,0.3,1,0,0,1,0,0,2,0.0,2,0,0,0,0,1,0,0,0,2020-2021,90.0,0.0,300.0
1573,Ruslan Malinovskyi,UKR,"MF,FW",Atalanta,Serie A,27,1993,20.8,19,8,2,13,4,8,23,34.8,15,16,1,15,2,21,4,0,0,2020-2021,90.0,8.653846153846153,82.21153846153845
1574,Yunus Mallı,TUR,MF,Wolfsburg,Bundesliga,28,1992,0.6,1,0,0,1,0,1,1,100.0,0,0,0,0,0,1,0,0,0,2020-2021,90.0,0.0,150.0
1575,Hugo Mallo,ESP,DF,Celta Vigo,La Liga,29,1991,28.9,58,40,34,23,1,24,52,46.2,28,42,11,31,37,95,77,0,0,2020-2021,90.00000000000001,115.2249134948097,180.62283737024225
Rk,Player,Nation,Pos,Squad,Comp,0,0,90.0,0,0,3,3,3,Tkl,0,0.0,0,0,0,0,0,0,0,0,0,2020-2021,90.0,0.0,0.0
1576,Mickael Malsa,MTQ,MF,Levante,La Liga,24,1995,26.0,55,26,28,24,3,23,51,45.1,28,38,9,29,43,98,36,2,0,2020-2021,90.00000000000001,148.84615384615387,190.38461538461542
1577,Dennis Man,ROU,"FW,MF",Parma,Serie A,21,1998,7.8,12,6,6,4,2,6,21,28.6,15,5,0,5,2,14,6,0,0,2020-2021,90.0,23.076923076923077,138.46153846153845
1578,Hianga Mananga Mbock,FRA,"MF,FW",Brest,Ligue 1,20,1999,5.1,4,3,2,2,0,2,9,22.2,7,2,0,2,3,7,6,0,0,2020-2021,90.0,52.94117647058824,70.58823529411765
1579,Vincent Manceau,FRA,DF,Angers,Ligue 1,31,1989,25.7,42,27,23,17,2,30,63,47.6,33,23,2,21,35,77,61,0,0,2020-2021,90.0,122.568093385214,147.0817120622568
1580,Gianluca Mancini,ITA,DF,Roma,Serie A,24,1996,31.7,50,29,29,19,2,18,31,58.1,13,38,18,20,72,122,77,3,0,2020-2021,90.0,204.41640378548897,141.9558359621451
1581,Steve Mandanda,FRA,GK,Marseille,Ligue 1,35,1985,37.0,0,0,0,0,0,0,1,0.0,1,0,0,0,2,2,8,6,0,2020-2021,90.0,4.864864864864865,0.0
1582,Reinildo Mandava,MOZ,DF,Lille,Ligue 1,26,1994,24.2,79,43,39,32,8,35,58,60.3,23,26,3,23,45,124,53,0,0,2020-2021,90.0,167.35537190082644,293.80165289256195
1583,Aïssa Mandi,ALG,DF,Betis,La Liga,28,1991,26.6,30,17,20,10,0,10,16,62.5,6,21,13,8,39,69,90,0,0,2020-2021,90.0,131.95488721804512,101.50375939849623
1584,Rolando Mandragora,ITA,MF,Udinese,Serie A,23,1997,4.4,8,5,3,4,1,3,10,30.0,7,10,3,7,6,14,5,0,0,2020-2021,90.0,122.72727272727272,163.63636363636363
1585,Rolando Mandragora,ITA,MF,Torino,Serie A,23,1997,16.9,19,4,4,9,6,7,30,23.3,23,19,6,13,20,39,19,0,0,2020-2021,90.0,106.50887573964498,101.18343195266273
1586,Mario Mandžukić,CRO,FW,Milan,Serie A,34,1986,2.4,7,6,2,4,1,2,3,66.7,1,0,0,0,2,9,3,0,0,2020-2021,90.0,75.0,262.5
1587,Sadio Mané,SEN,FW,Liverpool,Premier League,28,1992,31.2,48,30,6,22,20,12,33,36.4,21,30,0,30,15,63,11,0,0,2020-2021,90.0,43.26923076923077,138.46153846153845
1588,Niccolò Manfredini,ITA,GK,Benevento,Serie A,32,1988,1.0,0,0,0,0,0,0,0,0.0,0,0,0,0,0,0,2,1,0,2020-2021,90.0,0.0,0.0
1589,Eliaquim Mangala,FRA,DF,Valencia,La Liga,29,1991,3.6,0,0,0,0,0,0,1,0.0,1,8,6,2,6,6,12,0,0,2020-2021,90.0,150.0,0.0
1590,Orel Mangala,BEL,MF,Stuttgart,Bundesliga,22,1998,23.4,27,15,13,11,3,17,28,60.7,11,27,10,17,26,53,30,0,0,2020-2021,89.99999999999999,100.0,103.84615384615384
1591,Thomas Mangani,FRA,MF,Angers,Ligue 1,33,1987,29.9,54,37,25,26,3,30,90,33.3,60,31,8,23,38,92,39,0,0,2020-2021,90.0,114.38127090301005,162.5418060200669
1592,Vito Mannone,ITA,GK,Monaco,Ligue 1,32,1988,9.0,0,0,0,0,0,0,0,0.0,0,0,0,0,0,0,3,1,0,2020-2021,90.0,0.0,0.0
1593,Kostas Manolas,GRE,DF,Napoli,Serie A,29,1991,25.5,31,18,24,7,0,17,24,70.8,7,22,13,9,23,54,82,2,0,2020-2021,90.0,81.17647058823529,109.41176470588236
1594,Javier Manquillo,ESP,DF,Newcastle Utd,Premier League,26,1994,9.2,24,14,8,14,2,11,17,64.7,6,8,1,7,9,33,15,1,0,2020-2021,90.0,88.04347826086958,234.7826086956522
1595,Juan Manuel Ramos,URU,DF,Spezia,Serie A,23,1996,3.3,5,0,3,0,2,4,7,57.1,3,1,0,1,2,7,6,0,0,2020-2021,90.0,54.54545454545455,136.36363636363637
1596,Myziane Maolida,COM,"FW,MF",Nice,Ligue 1,21,1999,12.0,13,8,4,4,5,4,11,36.4,7,6,1,5,6,19,4,0,0,2020-2021,90.0,45.0,97.5
1597,Faitout Maouassa,FRA,DF,Rennes,Ligue 1,22,1998,13.0,20,11,10,8,2,11,19,57.9,8,9,1,8,17,37,36,0,0,2020-2021,90.00000000000001,117.69230769230771,138.46153846153848
1598,Sekou Mara,FRA,"FW,MF",Bordeaux,Ligue 1,18,2002,2.5,5,3,1,3,1,2,10,20.0,8,0,0,0,1,6,1,0,0,2020-2021,90.0,36.0,180.0
1599,Fernando Marçal,BRA,"DF,MF",Wolves,Premier League,31,1989,6.9,13,5,6,7,0,6,11,54.5,5,11,2,9,12,25,25,0,0,2020-2021,90.0,156.52173913043475,169.56521739130434
1600,Fernando Marçal,BRA,DF,Lyon,Ligue 1,31,1989,0.9,1,0,0,1,0,0,0,0.0,0,0,0,0,2,3,0,0,0,2020-2021,90.0,200.0,100.0
Rk,Player,Nation,Pos,Squad,Comp,0,0,90.0,0,0,3,3,3,Tkl,0,0.0,0,0,0,0,0,0,0,0,0,2020-2021,90.0,0.0,0.0
1601,Marcelo,BRA,"DF,MF",Real Madrid,La Liga,32,1988,11.7,25,21,11,6,8,11,24,45.8,13,13,1,12,10,35,15,0,0,2020-2021,89.99999999999999,76.92307692307692,192.3076923076923
1602,Marcelo,BRA,DF,Lyon,Ligue 1,33,1987,32.3,44,29,30,12,2,26,37,70.3,11,35,25,10,49,93,122,2,0,2020-2021,90.0,136.5325077399381,122.60061919504645
1603,Solly March,ENG,"DF,MF",Brighton,Premier League,26,1994,18.6,49,23,24,15,10,18,34,52.9,16,30,5,25,22,71,30,0,0,2020-2021,90.0,106.4516129032258,237.09677419354836
1604,Federico Marchetti,ITA,GK,Genoa,Serie A,37,1983,3.7,1,0,1,0,0,1,1,100.0,0,0,0,0,0,1,2,1,0,2020-2021,90.0,0.0,24.324324324324323
1605,Riccardo Marchizza,ITA,DF,Spezia,Serie A,22,1998,17.3,20,11,12,5,3,12,21,57.1,9,13,4,9,11,31,27,0,0,2020-2021,90.0,57.22543352601156,104.04624277456647
1606,Gian Marco Ferrari,ITA,DF,Sassuolo,Serie A,28,1992,33.5,32,20,15,14,3,10,23,43.5,13,46,37,9,50,82,100,1,0,2020-2021,90.0,134.32835820895522,85.97014925373134
1607,Iván Marcone,ARG,MF,Elche,La Liga,30,1990,29.4,64,41,42,17,5,35,84,41.7,49,27,8,19,36,100,33,3,0,2020-2021,90.0,110.20408163265306,195.91836734693877
1608,Óscar de Marcos,ESP,"DF,MF",Athletic Club,La Liga,31,1989,16.9,28,17,12,10,6,10,25,40.0,15,12,1,11,12,40,38,0,0,2020-2021,90.0,63.905325443786985,149.11242603550298
1609,Dario Maresic,AUT,DF,Reims,Ligue 1,20,1999,5.7,12,7,8,4,0,8,14,57.1,6,7,2,5,10,22,17,1,0,2020-2021,90.0,157.89473684210526,189.4736842105263
1610,José Mari,ESP,MF,Cádiz,La Liga,32,1987,16.1,32,17,13,18,1,14,31,45.2,17,16,7,9,27,59,33,1,0,2020-2021,90.0,150.93167701863354,178.88198757763973
1611,Pablo Marí,ESP,DF,Arsenal,Premier League,26,1993,10.0,15,9,12,3,0,5,10,50.0,5,8,7,1,9,24,30,2,0,2020-2021,90.0,81.0,135.0
1612,José María Giménez,URU,DF,Atlético Madrid,La Liga,25,1995,19.6,20,7,14,5,1,12,17,70.6,5,17,11,6,21,41,65,0,0,2020-2021,90.0,96.42857142857142,91.83673469387755
1613,Mariano,DOM,FW,Real Madrid,La Liga,26,1993,5.7,4,2,2,1,1,0,9,0.0,9,3,1,2,0,4,3,0,0,2020-2021,90.0,0.0,63.1578947368421
1614,Jordan Marié,FRA,MF,Dijon,Ligue 1,28,1991,15.9,34,17,9,23,2,23,56,41.1,33,14,5,9,23,57,12,2,0,2020-2021,90.0,130.18867924528303,192.45283018867926
1615,Adrián Marín,ESP,"DF,MF",Alavés,La Liga,23,1997,1.0,1,1,0,1,0,0,2,0.0,2,1,0,1,2,3,2,0,0,2020-2021,90.0,180.0,90.0
1616,Adrián Marín,ESP,"DF,MF",Granada,La Liga,23,1997,3.0,5,2,1,3,1,2,3,66.7,1,5,2,3,4,9,9,0,0,2020-2021,90.0,120.0,150.0
1617,Răzvan Marin,ROU,MF,Cagliari,Serie A,24,1996,32.9,54,33,26,22,6,27,53,50.9,26,29,10,19,29,83,15,0,0,2020-2021,90.0,79.33130699088147,147.72036474164136
1618,Guillermo Maripán,CHI,DF,Monaco,Ligue 1,26,1994,23.2,26,11,17,9,0,15,27,55.6,12,18,11,7,27,53,66,1,0,2020-2021,90.0,104.74137931034483,100.86206896551724
1619,Marlon,BRA,DF,Sassuolo,Serie A,24,1995,19.4,19,13,13,6,0,13,18,72.2,5,23,17,6,27,46,44,2,0,2020-2021,90.0,125.2577319587629,88.14432989690722
1620,Omar Marmoush,EGY,FW,Wolfsburg,Bundesliga,21,1999,0.0,0,0,0,0,0,0,0,0.0,0,0,0,0,0,0,0,0,0,2020-2021,,,
1621,Marquinhos,BRA,DF,Paris S-G,Ligue 1,26,1994,23.6,27,21,14,10,3,15,26,57.7,11,21,9,12,27,54,75,2,0,2020-2021,90.0,102.96610169491524,102.96610169491524
1622,Luca Marrone,ITA,DF,Crotone,Serie A,30,1990,17.6,25,18,16,9,0,13,21,61.9,8,22,11,11,26,51,56,1,0,2020-2021,90.0,132.95454545454544,127.84090909090908
1623,Roger Martí,ESP,FW,Levante,La Liga,29,1991,24.4,11,7,5,4,2,6,23,26.1,17,10,3,7,4,15,6,0,0,2020-2021,90.0,14.754098360655739,40.57377049180328
1624,Anthony Martial,FRA,FW,Manchester Utd,Premier League,24,1995,16.4,2,1,1,1,0,0,10,0.0,10,17,3,14,1,3,8,0,0,2020-2021,90.0,5.487804878048781,10.975609756097562
1625,Aarón Martín,ESP,DF,Celta Vigo,La Liga,23,1997,17.1,34,20,15,16,3,10,33,30.3,23,15,4,11,13,47,37,0,0,2020-2021,90.0,68.42105263157895,178.94736842105263
Rk,Player,Nation,Pos,Squad,Comp,0,0,90.0,0,0,3,3,3,Tkl,0,0.0,0,0,0,0,0,0,0,0,0,2020-2021,90.0,0.0,0.0
1626,Aarón Martín,ESP,"DF,FW",Mainz 05,Bundesliga,23,1997,2.9,3,2,2,1,0,2,4,50.0,2,1,0,1,2,5,2,0,0,2020-2021,90.0,62.06896551724138,93.10344827586206
1627,Álex Martín,ESP,DF,Cádiz,La Liga,22,1998,1.1,2,0,1,1,0,2,4,50.0,2,1,1,0,0,2,6,0,0,2020-2021,90.0,0.0,163.63636363636363
1628,Jonas Martin,FRA,MF,Rennes,Ligue 1,30,1990,5.4,11,9,5,4,2,5,14,35.7,9,11,2,9,13,24,2,1,0,2020-2021,90.0,216.66666666666666,183.33333333333331
1629,Gabriel Martinelli,BRA,FW,Arsenal,Premier League,19,2001,6.5,7,1,2,3,2,4,10,40.0,6,6,0,6,8,15,4,0,0,2020-2021,90.00000000000001,110.76923076923077,96.92307692307693
1630,Emiliano Martínez,ARG,GK,Aston Villa,Premier League,27,1992,38.0,3,3,3,0,0,3,4,75.0,1,0,0,0,2,5,10,2,0,2020-2021,90.0,4.7368421052631575,7.105263157894737
1631,Iñigo Martínez,ESP,DF,Athletic Club,La Liga,29,1991,28.0,22,15,16,6,0,9,27,33.3,18,17,7,10,28,50,96,0,0,2020-2021,90.0,90.0,70.71428571428571
1632,Javi Martínez,ESP,"MF,FW",Osasuna,La Liga,20,1999,5.1,9,4,1,6,2,5,12,41.7,7,9,0,9,5,14,4,0,0,2020-2021,90.0,88.23529411764706,158.82352941176472
1633,Javi Martínez,ESP,"DF,MF",Bayern Munich,Bundesliga,31,1988,5.2,10,5,4,4,2,7,9,77.8,2,8,4,4,13,23,19,0,0,2020-2021,90.0,224.99999999999997,173.07692307692307
1634,Josep Martinez,ESP,GK,RB Leipzig,Bundesliga,22,1998,1.0,0,0,0,0,0,0,0,0.0,0,0,0,0,0,0,0,0,0,2020-2021,90.0,0.0,0.0
1635,Lautaro Martínez,ARG,FW,Inter,Serie A,22,1997,28.5,25,12,5,11,9,7,24,29.2,17,31,1,30,27,52,16,0,0,2020-2021,90.0,85.26315789473685,78.94736842105263
1636,Pablo Martinez,FRA,DF,Nîmes,Ligue 1,31,1989,6.0,10,7,7,3,0,7,7,100.0,0,6,4,2,11,21,28,0,0,2020-2021,90.0,165.0,150.0
1637,Lucas Martínez Quarta,ARG,DF,Fiorentina,Serie A,24,1996,16.5,32,20,17,11,4,18,41,43.9,23,27,9,18,39,71,48,0,0,2020-2021,90.0,212.72727272727275,174.54545454545456
1638,Gelson Martins,POR,"MF,FW",Monaco,Ligue 1,25,1995,17.2,41,26,12,16,13,15,37,40.5,22,20,0,20,13,54,8,0,0,2020-2021,90.0,68.0232558139535,214.53488372093025
1639,Adam Marušić,MNE,DF,Lazio,Serie A,27,1992,33.0,38,22,22,15,1,20,40,50.0,20,38,6,32,40,78,54,0,0,2020-2021,90.0,109.0909090909091,103.63636363636364
1640,Sylvain Marveaux,FRA,"MF,FW",Lorient,Ligue 1,34,1986,2.2,6,3,1,4,1,3,3,100.0,0,2,0,2,1,7,2,0,0,2020-2021,90.0,40.90909090909091,245.45454545454544
1641,Marvin,ESP,"DF,MF",Real Madrid,La Liga,20,2000,1.5,3,2,0,3,0,1,2,50.0,1,1,0,1,2,5,3,0,0,2020-2021,90.0,120.0,180.0
1642,Omar Mascarell,EQG,MF,Schalke 04,Bundesliga,27,1993,19.6,41,24,15,19,7,21,54,38.9,33,40,14,26,37,78,32,1,0,2020-2021,90.0,169.89795918367346,188.26530612244898
1643,Andrea Masiello,ITA,DF,Genoa,Serie A,34,1986,28.5,38,22,29,6,3,23,48,47.9,25,32,13,19,53,91,107,3,0,2020-2021,90.0,167.3684210526316,120.0
1644,Jordi Masip,ESP,GK,Valladolid,La Liga,31,1989,25.0,0,0,0,0,0,0,2,0.0,2,2,0,2,2,2,8,1,0,2020-2021,90.0,7.199999999999999,0.0
1645,Roberto Massimo,GER,"DF,FW",Stuttgart,Bundesliga,19,2000,8.4,21,11,13,5,3,11,24,45.8,13,5,1,4,11,32,13,0,0,2020-2021,90.0,117.85714285714285,225.0
1646,Giuseppe Mastinu,ITA,FW,Spezia,Serie A,28,1991,0.4,1,1,0,0,1,1,1,100.0,0,1,0,1,0,1,0,0,0,2020-2021,90.0,0.0,225.0
1647,Arthur Masuaku,COD,"DF,MF",West Ham,Premier League,26,1993,11.2,20,12,14,6,0,11,34,32.4,23,12,0,12,8,28,28,2,0,2020-2021,90.0,64.28571428571429,160.71428571428572
1648,Jaime Mata,ESP,FW,Getafe,La Liga,31,1988,22.6,12,7,1,3,8,3,18,16.7,15,13,2,11,6,18,16,0,0,2020-2021,90.0,23.893805309734514,47.78761061946903
1649,Juan Mata,ESP,"FW,MF",Manchester Utd,Premier League,32,1988,5.7,1,0,1,0,0,0,7,0.0,7,3,0,3,3,4,3,0,0,2020-2021,90.0,47.368421052631575,15.789473684210526
1650,Pape Matar Sarr,SEN,MF,Metz,Ligue 1,17,2002,17.7,45,29,19,21,5,20,38,52.6,18,24,4,20,27,72,16,0,0,2020-2021,90.0,137.28813559322035,228.8135593220339
Rk,Player,Nation,Pos,Squad,Comp,0,0,90.0,0,0,3,3,3,Tkl,0,0.0,0,0,0,0,0,0,0,0,0,2020-2021,90.0,0.0,0.0
1651,Eliot Matazo,BEL,MF,Monaco,Ligue 1,18,2002,3.5,11,5,6,5,0,3,7,42.9,4,1,0,1,1,12,2,0,0,2020-2021,90.0,25.714285714285715,282.85714285714283
1652,Jean-Philippe Mateta,FRA,FW,Crystal Palace,Premier League,23,1997,2.5,1,1,0,1,0,1,3,33.3,2,1,0,1,0,1,2,0,0,2020-2021,90.0,0.0,36.0
1653,Jean-Philippe Mateta,FRA,FW,Mainz 05,Bundesliga,23,1997,11.1,6,3,1,3,2,0,3,0.0,3,3,1,2,4,10,6,0,0,2020-2021,90.0,32.432432432432435,48.64864864864865
1654,Nemanja Matić,SRB,MF,Manchester Utd,Premier League,31,1988,12.3,25,11,13,12,0,13,31,41.9,18,19,5,14,22,47,10,3,0,2020-2021,89.99999999999999,160.97560975609753,182.92682926829266
1655,Joël Matip,CMR,DF,Liverpool,Premier League,28,1991,7.7,14,9,7,7,0,7,8,87.5,1,6,0,6,7,21,22,0,0,2020-2021,90.0,81.81818181818183,163.63636363636365
1656,Rabbi Matondo,WAL,"FW,MF",Schalke 04,Bundesliga,19,2000,2.4,3,2,0,3,0,2,3,66.7,1,1,0,1,1,4,1,0,0,2020-2021,90.0,37.5,112.50000000000001
1657,Ryder Matos,BRA,MF,Udinese,Serie A,27,1993,0.1,0,0,0,0,0,0,0,0.0,0,0,0,0,0,0,0,0,0,2020-2021,90.0,0.0,0.0
1658,Henning Matriciani,GER,DF,Schalke 04,Bundesliga,20,2000,0.3,1,1,1,0,0,1,1,100.0,0,1,0,1,0,1,1,0,0,2020-2021,90.0,0.0,300.0
1659,Chrislain Matsima,FRA,"DF,FW",Monaco,Ligue 1,18,2002,3.9,5,4,3,2,0,4,7,57.1,3,3,0,3,4,9,12,0,0,2020-2021,90.0,92.3076923076923,115.38461538461539
1660,Federico Mattiello,ITA,DF,Spezia,Serie A,25,1995,0.4,0,0,0,0,0,0,0,0.0,0,0,0,0,0,0,0,0,0,2020-2021,90.0,0.0,0.0
1661,Neal Maupay,FRA,"FW,MF",Brighton,Premier League,23,1996,27.9,20,8,9,7,4,4,24,16.7,20,20,0,20,13,33,6,0,0,2020-2021,90.0,41.935483870967744,64.51612903225806
1662,Tony Mauricio,FRA,MF,Lens,Ligue 1,26,1994,5.6,19,12,7,8,4,11,17,64.7,6,8,1,7,3,22,4,0,0,2020-2021,90.0,48.214285714285715,305.3571428571429
1663,Stephy Mavididi,ENG,"FW,MF",Montpellier,Ligue 1,22,1998,22.6,18,5,7,10,1,8,23,34.8,15,12,0,12,14,32,6,0,0,2020-2021,90.0,55.75221238938053,71.68141592920354
1664,Konstantinos Mavropanos,GRE,DF,Stuttgart,Bundesliga,22,1997,16.3,42,29,29,12,1,27,46,58.7,19,25,10,15,59,101,66,1,0,2020-2021,90.0,325.76687116564415,231.90184049079755
1665,Eric Maxim Choupo-Moting,CMR,"FW,MF",Bayern Munich,Bundesliga,31,1989,9.1,8,2,0,5,3,1,4,25.0,3,6,0,6,2,10,7,0,0,2020-2021,90.0,19.78021978021978,79.12087912087912
1666,Borja Mayoral,ESP,FW,Roma,Serie A,23,1997,17.2,3,2,0,0,3,1,10,10.0,9,5,0,5,0,3,5,2,0,2020-2021,90.0,0.0,15.697674418604652
1667,Borja Mayoral,ESP,FW,Real Madrid,La Liga,23,1997,0.3,0,0,0,0,0,0,1,0.0,1,0,0,0,0,0,0,0,0,2020-2021,90.0,0.0,0.0
1668,Youssef Maziz,FRA,"MF,FW",Metz,Ligue 1,22,1998,2.9,2,0,1,1,0,1,5,20.0,4,1,0,1,6,8,1,0,0,2020-2021,90.0,186.20689655172413,62.06896551724138
1669,Antonio Mazzotta,ITA,DF,Crotone,Serie A,30,1989,0.6,1,1,0,1,0,0,0,0.0,0,0,0,0,0,1,1,0,0,2020-2021,90.0,0.0,150.0
1670,Kevin Mbabu,SUI,DF,Wolfsburg,Bundesliga,25,1995,18.2,51,33,27,17,7,24,35,68.6,11,28,7,21,22,73,59,1,0,2020-2021,90.0,108.79120879120879,252.1978021978022
1671,Kylian Mbappé,FRA,FW,Paris S-G,Ligue 1,21,1998,26.4,4,2,0,1,3,2,9,22.2,7,7,1,6,3,7,4,1,0,2020-2021,90.0,10.227272727272727,13.636363636363637
1672,Ibrahima Mbaye,SEN,DF,Bologna,Serie A,25,1994,4.8,6,5,5,1,0,3,5,60.0,2,5,3,2,1,7,10,0,0,2020-2021,90.0,18.75,112.50000000000001
1673,Jean-Manuel Mbom,GER,"MF,DF",Werder Bremen,Bundesliga,20,2000,12.9,19,13,14,3,2,8,27,29.6,19,17,6,11,13,32,27,0,0,2020-2021,90.0,90.69767441860465,132.5581395348837
1674,Nathanael Mbuku,FRA,"MF,FW",Reims,Ligue 1,18,2002,24.6,33,19,9,13,11,8,28,28.6,20,17,0,17,14,47,10,0,0,2020-2021,89.99999999999999,51.21951219512194,120.73170731707316
1675,James McArthur,SCO,MF,Crystal Palace,Premier League,32,1987,16.3,57,32,25,27,5,15,39,38.5,24,28,3,25,23,80,31,0,0,2020-2021,90.0,126.99386503067484,314.7239263803681
Rk,Player,Nation,Pos,Squad,Comp,0,0,90.0,0,0,3,3,3,Tkl,0,0.0,0,0,0,0,0,0,0,0,0,2020-2021,90.0,0.0,0.0
1676,Oliver McBurnie,SCO,FW,Sheffield Utd,Premier League,24,1996,14.7,15,7,7,7,1,5,17,29.4,12,10,3,7,6,21,30,0,0,2020-2021,90.0,36.734693877551024,91.83673469387756
1677,Alex McCarthy,ENG,GK,Southampton,Premier League,30,1989,30.0,1,0,1,0,0,1,4,25.0,3,0,0,0,0,1,11,1,0,2020-2021,90.0,0.0,3.0
1678,James McCarthy,IRL,MF,Crystal Palace,Premier League,29,1990,9.1,16,12,9,7,0,8,21,38.1,13,15,7,8,8,24,12,0,0,2020-2021,90.0,79.12087912087912,158.24175824175825
1679,John McGinn,SCO,MF,Aston Villa,Premier League,25,1994,37.0,61,37,23,31,7,27,84,32.1,57,38,6,32,43,104,23,2,0,2020-2021,90.0,104.5945945945946,148.3783783783784
1680,David McGoldrick,IRL,"FW,MF",Sheffield Utd,Premier League,32,1987,26.6,33,21,8,15,10,13,31,41.9,18,19,3,16,2,35,25,0,0,2020-2021,90.0,6.7669172932330826,111.65413533834585
1681,Weston McKennie,USA,MF,Juventus,Serie A,21,1998,18.9,34,19,9,20,5,12,33,36.4,21,21,3,18,28,62,26,0,0,2020-2021,90.0,133.33333333333334,161.9047619047619
1682,Dwight McNeil,ENG,MF,Burnley,Premier League,20,1999,34.1,47,24,24,18,5,18,56,32.1,38,44,6,38,32,79,32,1,0,2020-2021,90.0,84.4574780058651,124.04692082111437
1683,Scott McTominay,SCO,MF,Manchester Utd,Premier League,23,1996,23.7,51,24,23,25,3,23,36,63.9,13,35,10,25,29,80,46,0,0,2020-2021,90.0,110.12658227848102,193.6708860759494
1684,Gary Medel,CHI,"DF,MF",Bologna,Serie A,32,1987,5.7,12,9,6,5,1,4,10,40.0,6,8,6,2,7,19,10,0,0,2020-2021,90.0,110.52631578947367,189.4736842105263
1685,Facundo Medina,ARG,DF,Lens,Ligue 1,21,1999,22.3,39,22,22,15,2,24,38,63.2,14,25,9,16,39,78,51,3,0,2020-2021,90.0,157.39910313901345,157.39910313901345
1686,Nathan de Medina,BEL,DF,Arminia,Bundesliga,22,1997,7.1,16,10,9,6,1,3,10,30.0,7,12,2,10,11,27,22,0,0,2020-2021,90.0,139.43661971830986,202.81690140845072
1687,Ben Mee,ENG,DF,Burnley,Premier League,30,1989,29.9,32,15,16,14,2,14,29,48.3,15,54,45,9,43,75,148,2,0,2020-2021,90.0,129.4314381270903,96.32107023411372
1688,Joshua Mees,GER,FW,Union Berlin,Bundesliga,24,1996,0.1,0,0,0,0,0,0,0,0.0,0,0,0,0,0,0,0,0,0,2020-2021,90.0,0.0,0.0
1689,Admir Mehmedi,SUI,"MF,FW",Wolfsburg,Bundesliga,29,1991,9.1,17,9,6,7,4,6,16,37.5,10,7,0,7,5,22,1,0,0,2020-2021,90.0,49.45054945054945,168.13186813186815
1690,Soualiho Meïté,FRA,MF,Torino,Serie A,26,1994,10.2,11,7,6,4,1,5,16,31.3,11,18,1,17,10,21,9,1,0,2020-2021,90.0,88.23529411764706,97.05882352941177
1691,Soualiho Meïté,FRA,MF,Milan,Serie A,26,1994,6.5,18,10,10,6,2,8,17,47.1,9,9,2,7,8,26,16,0,0,2020-2021,90.00000000000001,110.76923076923077,249.23076923076925
1692,Hannibal Mejbri,TUN,MF,Manchester Utd,Premier League,17,2003,0.1,0,0,0,0,0,0,0,0.0,0,0,0,0,0,0,0,0,0,2020-2021,90.0,0.0,0.0
1693,Farid El Melali,ALG,"FW,MF",Angers,Ligue 1,23,1997,4.6,9,5,5,4,0,2,13,15.4,11,12,0,12,6,15,2,0,0,2020-2021,90.0,117.3913043478261,176.08695652173915
1694,Filippo Melegoni,ITA,"MF,DF",Genoa,Serie A,21,1999,4.3,7,6,2,5,0,3,6,50.0,3,5,0,5,5,12,8,0,0,2020-2021,90.0,104.65116279069768,146.51162790697677
1695,Gonzalo Melero,ESP,"MF,FW",Levante,La Liga,26,1994,20.6,24,15,11,6,7,10,39,25.6,29,14,5,9,18,42,22,1,0,2020-2021,90.0,78.64077669902913,104.85436893203884
1696,Birger Meling,NOR,DF,Nîmes,Ligue 1,25,1994,25.9,49,31,27,15,7,33,50,66.0,17,43,9,34,36,85,70,0,0,2020-2021,90.0,125.09652509652511,170.2702702702703
1697,Arthur Melo,BRA,MF,Juventus,Serie A,23,1996,12.9,17,9,7,10,0,12,31,38.7,19,6,1,5,18,35,9,1,0,2020-2021,90.0,125.5813953488372,118.60465116279069
1698,Memphis,NED,FW,Lyon,Ligue 1,26,1994,32.5,4,3,0,3,1,1,20,5.0,19,11,1,10,5,9,3,0,0,2020-2021,90.0,13.846153846153847,11.076923076923077
1699,Houboulang Mendes,GNB,DF,Lorient,Ligue 1,22,1998,14.4,28,19,19,5,4,16,28,57.1,12,14,2,12,14,42,35,0,0,2020-2021,90.0,87.5,175.0
1700,Pedro Mendes,POR,DF,Montpellier,Ligue 1,29,1990,18.1,21,19,16,5,0,14,21,66.7,7,23,13,10,34,55,58,0,0,2020-2021,90.0,169.06077348066296,104.41988950276242
Rk,Player,Nation,Pos,Squad,Comp,0,0,90.0,0,0,3,3,3,Tkl,0,0.0,0,0,0,0,0,0,0,0,0,2020-2021,90.0,0.0,0.0
1701,Thiago Mendes,BRA,MF,Lyon,Ligue 1,28,1992,24.9,37,22,13,20,4,18,38,47.4,20,33,7,26,39,76,21,2,0,2020-2021,90.0,140.96385542168673,133.73493975903614
1702,Brais Méndez,ESP,"MF,FW",Celta Vigo,La Liga,23,1997,29.7,59,31,23,27,9,16,65,24.6,49,27,2,25,32,91,34,0,0,2020-2021,90.0,96.96969696969697,178.78787878787878
1703,Édgar Méndez,ESP,"MF,FW",Alavés,La Liga,30,1990,23.2,39,29,18,13,8,15,48,31.3,33,20,3,17,19,58,14,0,0,2020-2021,90.0,73.70689655172414,151.29310344827587
1704,Eñaut Mendía,ESP,FW,Eibar,La Liga,21,1999,0.7,2,1,2,0,0,1,2,50.0,1,1,1,0,0,2,0,0,0,2020-2021,90.0,0.0,257.14285714285717
1705,Batista Mendy,FRA,MF,Nantes,Ligue 1,20,2000,0.8,1,1,0,1,0,0,1,0.0,1,3,1,2,1,2,1,0,0,2020-2021,90.0,112.5,112.5
1706,Benjamin Mendy,FRA,DF,Manchester City,Premier League,26,1994,10.6,13,9,1,8,4,5,21,23.8,16,12,5,7,5,18,14,1,0,2020-2021,90.0,42.45283018867925,110.37735849056604
1707,Edouard Mendy,SEN,GK,Chelsea,Premier League,28,1992,30.5,0,0,0,0,0,0,1,0.0,1,0,0,0,1,1,9,3,0,2020-2021,90.0,2.9508196721311473,0.0
1708,Edouard Mendy,SEN,GK,Rennes,Ligue 1,28,1992,1.0,0,0,0,0,0,0,0,0.0,0,0,0,0,0,0,0,0,0,2020-2021,90.0,0.0,0.0
1709,Ferland Mendy,FRA,DF,Real Madrid,La Liga,25,1995,24.5,26,16,17,6,3,12,24,50.0,12,16,4,12,26,52,32,1,0,2020-2021,90.00000000000001,95.51020408163266,95.51020408163266
1710,Nampalys Mendy,SEN,MF,Leicester City,Premier League,28,1992,16.2,26,17,18,6,2,7,20,35.0,13,12,1,11,14,40,8,0,0,2020-2021,90.0,77.77777777777779,144.44444444444446
1711,Hamza Mendyl,MAR,"FW,DF",Schalke 04,Bundesliga,22,1997,1.1,2,2,2,0,0,0,2,0.0,2,2,0,2,0,2,2,0,0,2020-2021,90.0,0.0,163.63636363636363
1712,Levent Mercan,GER,FW,Schalke 04,Bundesliga,19,2000,0.1,0,0,0,0,0,0,0,0.0,0,0,0,0,0,0,0,0,0,2020-2021,90.0,0.0,0.0
1713,Jorge Meré,ESP,DF,Köln,Bundesliga,23,1997,14.4,13,6,9,3,1,6,13,46.2,7,14,11,3,15,28,63,0,0,2020-2021,90.0,93.75,81.25
1714,Alex Meret,ITA,GK,Napoli,Serie A,23,1997,22.0,0,0,0,0,0,0,1,0.0,1,0,0,0,0,0,5,0,0,2020-2021,90.0,0.0,0.0
1715,Mikel Merino,ESP,MF,Real Sociedad,La Liga,24,1996,23.9,61,36,14,36,11,18,45,40.0,27,36,8,28,32,93,26,0,0,2020-2021,90.0,120.50209205020921,229.7071129707113
1716,Martín Merquelanz,ESP,"MF,FW",Real Sociedad,La Liga,25,1995,6.1,9,3,3,2,4,2,7,28.6,5,7,1,6,3,12,4,0,0,2020-2021,90.0,44.26229508196722,132.78688524590166
1717,Yıldırım Mert Çetin,TUR,DF,Hellas Verona,Serie A,23,1997,4.6,8,4,3,5,0,2,6,33.3,4,7,5,2,14,22,11,1,0,2020-2021,90.0,273.9130434782609,156.52173913043478
1718,Dries Mertens,BEL,"FW,MF",Napoli,Serie A,33,1987,16.2,16,14,4,7,5,5,25,20.0,20,7,1,6,9,25,3,1,0,2020-2021,90.0,50.0,88.88888888888889
1719,Roque Mesa,ESP,MF,Valladolid,La Liga,31,1989,19.6,46,29,18,24,4,20,47,42.6,27,11,2,9,14,60,23,1,0,2020-2021,90.0,64.28571428571428,211.22448979591834
1720,Illan Meslier,FRA,GK,Leeds United,Premier League,20,2000,35.0,0,0,0,0,0,0,1,0.0,1,0,0,0,0,0,17,8,0,2020-2021,90.0,0.0,0.0
1721,Lionel Messi,ARG,"FW,MF",Barcelona,La Liga,33,1987,33.6,18,10,3,9,6,6,17,35.3,11,12,0,12,6,24,0,2,0,2020-2021,90.0,16.07142857142857,48.214285714285715
1722,Junior Messias,BRA,"MF,FW",Crotone,Serie A,29,1991,35.7,60,35,26,24,10,22,70,31.4,48,32,12,20,35,95,40,0,0,2020-2021,90.0,88.23529411764704,151.26050420168065
1723,Thomas Meunier,BEL,DF,Dortmund,Bundesliga,28,1991,16.4,30,21,19,6,5,20,29,69.0,9,16,6,10,18,48,29,2,0,2020-2021,90.0,98.78048780487806,164.63414634146343
1724,Mexer,MOZ,DF,Bordeaux,Ligue 1,31,1988,7.9,9,6,8,0,1,5,10,50.0,5,8,5,3,17,26,22,0,0,2020-2021,90.0,193.67088607594934,102.53164556962024
1725,Max Meyer,GER,MF,Köln,Bundesliga,24,1995,3.9,7,4,3,3,1,4,8,50.0,4,4,1,3,3,10,1,0,0,2020-2021,90.0,69.23076923076923,161.53846153846152
Rk,Player,Nation,Pos,Squad,Comp,0,0,90.0,0,0,3,3,3,Tkl,0,0.0,0,0,0,0,0,0,0,0,0,2020-2021,90.0,0.0,0.0
1726,Omenuke Mfulu,COD,MF,Elche,La Liga,26,1994,8.8,18,12,10,8,0,5,15,33.3,10,7,1,6,11,29,18,0,0,2020-2021,90.0,112.5,184.0909090909091
1727,Míchel,ESP,MF,Valladolid,La Liga,32,1988,10.5,18,11,10,3,5,5,22,22.7,17,10,1,9,9,27,12,1,0,2020-2021,90.0,77.14285714285714,154.28571428571428
1728,Jonas Michelbrink,GER,MF,Hertha BSC,Bundesliga,19,2001,0.4,0,0,0,0,0,0,0,0.0,0,0,0,0,0,0,0,0,0,2020-2021,90.0,0.0,0.0
1729,Clément Michelin,FRA,DF,Lens,Ligue 1,23,1997,12.8,25,19,13,9,3,9,16,56.3,7,13,4,9,25,50,32,0,0,2020-2021,90.0,175.78125,175.78125
1730,Edouard Michut,FRA,MF,Paris S-G,Ligue 1,17,2003,0.0,0,0,0,0,0,0,0,0.0,0,0,0,0,0,0,0,0,0,2020-2021,,,
1731,Petar Mićin,SRB,MF,Udinese,Serie A,21,1998,0.2,0,0,0,0,0,0,0,0.0,0,0,0,0,0,0,0,0,0,2020-2021,90.0,0.0,0.0
1732,Florian Miguel,FRA,DF,Nîmes,Ligue 1,23,1996,17.1,14,13,12,2,0,9,17,52.9,8,21,13,8,45,59,66,1,0,2020-2021,90.0,236.8421052631579,73.6842105263158
1733,Valentin Mihaila,ROU,"FW,MF",Parma,Serie A,20,2000,7.8,2,1,1,1,0,0,10,0.0,10,8,1,7,5,7,8,0,0,2020-2021,90.0,57.69230769230769,23.076923076923077
1734,Nikola Milenković,SRB,DF,Fiorentina,Serie A,22,1997,33.7,49,29,33,14,2,21,33,63.6,12,42,33,9,44,93,122,1,0,2020-2021,90.0,117.50741839762611,130.86053412462908
1735,Arkadiusz Milik,POL,FW,Marseille,Ligue 1,26,1994,13.6,14,9,0,7,7,2,12,16.7,10,5,1,4,2,16,9,0,0,2020-2021,90.0,13.235294117647058,92.6470588235294
1736,Sergej Milinković-Savić,SRB,MF,Lazio,Serie A,25,1995,30.5,59,40,20,30,9,27,84,32.1,57,52,12,40,33,92,47,0,0,2020-2021,90.0,97.37704918032786,174.0983606557377
1737,Vanja Milinković-Savić,SRB,GK,Torino,Serie A,23,1997,5.0,1,1,1,0,0,1,1,100.0,0,0,0,0,0,1,1,3,0,2020-2021,90.0,0.0,18.0
1738,Éder Militão,BRA,DF,Real Madrid,La Liga,22,1998,12.6,20,8,13,6,1,8,14,57.1,6,19,6,13,19,39,42,0,0,2020-2021,90.0,135.71428571428572,142.85714285714286
1739,Luka Milivojević,SRB,MF,Crystal Palace,Premier League,29,1991,26.2,65,34,25,31,9,42,77,54.5,35,29,6,23,35,100,47,2,0,2020-2021,90.0,120.2290076335878,223.28244274809163
1740,Luis Milla,ESP,MF,Granada,La Liga,25,1994,13.9,22,11,11,10,1,6,28,21.4,22,10,0,10,24,46,16,1,0,2020-2021,90.0,155.3956834532374,142.44604316546764
1741,Pere Milla,ESP,"FW,MF",Elche,La Liga,27,1992,22.0,24,17,12,10,2,8,37,21.6,29,17,5,12,13,37,17,1,0,2020-2021,90.0,53.18181818181819,98.18181818181819
1742,Álex Millán,ESP,FW,Villarreal,La Liga,20,1999,0.0,0,0,0,0,0,0,0,0.0,0,0,0,0,0,0,0,0,0,2020-2021,,,
1743,Vincenzo Millico,ITA,"FW,MF",Torino,Serie A,19,2000,0.2,0,0,0,0,0,0,0,0.0,0,0,0,0,0,0,0,0,0,2020-2021,90.0,0.0,0.0
1744,Enzo Millot,FRA,MF,Monaco,Ligue 1,18,2002,0.5,2,0,0,1,1,1,1,100.0,0,0,0,0,2,4,0,0,0,2020-2021,90.0,360.0,360.0
1745,James Milner,ENG,"MF,DF",Liverpool,Premier League,34,1986,11.9,26,19,9,14,3,11,33,33.3,22,30,3,27,14,40,16,1,0,2020-2021,90.00000000000001,105.88235294117648,196.6386554621849
1746,Santi Mina,ESP,FW,Celta Vigo,La Liga,24,1995,26.8,31,13,9,12,10,6,37,16.2,31,15,3,12,6,37,17,0,0,2020-2021,90.0,20.149253731343283,104.10447761194028
1747,Yerry Mina,COL,DF,Everton,Premier League,25,1994,21.5,21,14,17,4,0,8,12,66.7,4,30,23,7,24,45,110,1,0,2020-2021,90.0,100.46511627906976,87.90697674418604
1748,Takumi Minamino,JPN,MF,Southampton,Premier League,25,1995,7.9,7,3,2,5,0,2,19,10.5,17,13,1,12,4,11,9,0,0,2020-2021,90.0,45.56962025316455,79.74683544303797
1749,Takumi Minamino,JPN,"MF,FW",Liverpool,Premier League,25,1995,3.3,4,3,1,2,1,0,12,0.0,12,1,0,1,2,6,3,0,0,2020-2021,90.0,54.54545454545455,109.0909090909091
1750,Tyrone Mings,ENG,DF,Aston Villa,Premier League,27,1993,35.5,32,16,23,7,2,16,24,66.7,8,59,40,19,41,73,172,3,0,2020-2021,90.0,103.94366197183099,81.12676056338029
Rk,Player,Nation,Pos,Squad,Comp,0,0,90.0,0,0,3,3,3,Tkl,0,0.0,0,0,0,0,0,0,0,0,0,2020-2021,90.0,0.0,0.0
1751,Óscar Mingueza,ESP,DF,Barcelona,La Liga,21,1999,21.1,52,33,28,17,7,30,53,56.6,23,19,6,13,20,72,48,2,0,2020-2021,90.0,85.30805687203791,221.80094786729856
1752,Rafa Mir,ESP,FW,Huesca,La Liga,23,1997,32.0,15,9,4,4,7,7,22,31.8,15,14,2,12,15,30,25,0,0,2020-2021,90.0,42.1875,42.1875
1753,Jorge Miramón,ESP,DF,Levante,La Liga,31,1989,19.2,32,22,26,6,0,21,35,60.0,14,22,2,20,27,59,54,0,0,2020-2021,90.0,126.56250000000001,150.0
1754,Aleksei Miranchuk,RUS,"MF,FW",Atalanta,Serie A,24,1995,7.5,24,13,8,9,7,6,9,66.7,3,1,0,1,3,27,1,0,0,2020-2021,90.0,36.0,288.0
1755,Juan Miranda,ESP,DF,Betis,La Liga,20,2000,18.4,27,11,16,9,2,16,32,50.0,16,18,2,16,29,56,58,1,0,2020-2021,90.0,141.84782608695653,132.06521739130434
1756,Antonio Mirante,ITA,GK,Roma,Serie A,37,1983,12.8,0,0,0,0,0,0,1,0.0,1,1,0,1,0,0,7,2,0,2020-2021,90.0,0.0,0.0
1757,Tyrick Mitchell,ENG,DF,Crystal Palace,Premier League,20,1999,19.0,64,35,48,9,7,23,40,57.5,17,29,10,19,21,85,62,1,0,2020-2021,90.0,99.47368421052632,303.1578947368421
1758,Aleksandar Mitrović,SRB,FW,Fulham,Premier League,25,1994,15.6,7,4,0,3,4,2,8,25.0,6,12,3,9,3,10,8,0,0,2020-2021,90.0,17.307692307692307,40.38461538461538
1759,Stefan Mitrović,SRB,DF,Strasbourg,Ligue 1,30,1990,30.9,36,27,29,7,0,24,37,64.9,13,23,13,10,31,67,108,5,0,2020-2021,90.0,90.29126213592234,104.85436893203884
1760,Maximilian Mittelstädt,GER,"DF,FW",Hertha BSC,Bundesliga,23,1997,20.0,66,39,42,21,3,35,72,48.6,37,34,5,29,55,121,61,1,0,2020-2021,90.0,247.5,297.0
1761,Henrikh Mkhitaryan,ARM,"MF,FW",Roma,Serie A,31,1989,30.5,58,24,13,27,18,13,62,21.0,49,34,0,34,39,97,10,0,0,2020-2021,90.0,115.08196721311475,171.14754098360655
1762,Jakub Moder,POL,"DF,MF",Brighton,Premier League,21,1999,7.2,15,7,5,7,3,7,20,35.0,13,12,1,11,3,18,9,0,0,2020-2021,90.0,37.5,187.5
1763,Anthony Modeste,FRA,"FW,MF",Saint-Étienne,Ligue 1,32,1988,3.3,2,1,0,2,0,1,4,25.0,3,3,1,2,0,2,3,0,0,2020-2021,90.0,0.0,54.54545454545455
1764,Anthony Modeste,FRA,FW,Köln,Bundesliga,32,1988,2.5,2,0,0,2,0,0,1,0.0,1,0,0,0,0,2,2,0,0,2020-2021,90.0,0.0,72.0
1765,Luka Modrić,CRO,MF,Real Madrid,La Liga,34,1985,30.4,37,23,18,16,3,13,36,36.1,23,14,2,12,48,85,14,1,0,2020-2021,90.0,142.10526315789474,109.53947368421052
1766,Terem Moffi,NGA,FW,Lorient,Ligue 1,21,1999,23.0,13,8,0,8,5,4,19,21.1,15,5,2,3,4,17,8,0,0,2020-2021,90.0,15.65217391304348,50.86956521739131
1767,Kevin Möhwald,GER,MF,Werder Bremen,Bundesliga,27,1993,17.3,15,9,9,5,1,4,18,22.2,14,10,3,7,32,47,19,2,0,2020-2021,90.0,166.47398843930634,78.03468208092485
1768,Niklas Moisander,FIN,DF,Werder Bremen,Bundesliga,34,1985,13.6,14,11,11,3,0,8,14,57.1,6,15,8,7,22,36,61,0,0,2020-2021,90.0,145.58823529411765,92.6470588235294
1769,Dion Moise Sahi,CIV,"FW,MF",Strasbourg,Ligue 1,18,2001,1.0,1,0,0,1,0,1,1,100.0,0,1,0,1,0,1,0,0,0,2020-2021,90.0,0.0,90.0
1770,Johan Mojica,COL,DF,Atalanta,Serie A,27,1992,3.3,4,4,3,1,0,2,3,66.7,1,3,0,3,7,11,6,0,0,2020-2021,90.0,190.9090909090909,109.0909090909091
1771,Johan Mojica,COL,DF,Elche,La Liga,27,1992,13.4,21,10,15,5,1,8,18,44.4,10,15,4,11,15,36,27,0,0,2020-2021,90.0,100.74626865671641,141.04477611940297
1772,Guillem Molina,ESP,DF,Valencia,La Liga,20,2000,1.7,1,0,1,0,0,0,5,0.0,5,1,1,0,4,5,5,0,0,2020-2021,90.0,211.76470588235293,52.94117647058823
1773,Jorge Molina,ESP,FW,Granada,La Liga,38,1982,17.9,11,4,3,5,3,8,22,36.4,14,5,1,4,3,14,19,0,0,2020-2021,90.0,15.083798882681567,55.30726256983241
1774,Nahuel Molina,ARG,DF,Udinese,Serie A,22,1998,20.3,27,18,13,10,4,16,42,38.1,26,26,4,22,21,48,49,1,0,2020-2021,90.0,93.10344827586206,119.70443349753694
1775,Salvatore Molina,ITA,"MF,DF",Crotone,Serie A,28,1992,25.7,39,22,18,14,7,29,45,64.4,16,30,8,22,17,56,41,0,0,2020-2021,90.0,59.53307392996109,136.5758754863813
Rk,Player,Nation,Pos,Squad,Comp,0,0,90.0,0,0,3,3,3,Tkl,0,0.0,0,0,0,0,0,0,0,0,0,2020-2021,90.0,0.0,0.0
1776,Victor Mollejo,ESP,"MF,DF",Getafe,La Liga,19,2001,0.8,2,1,1,0,1,0,1,0.0,1,0,0,0,0,2,0,0,0,2020-2021,90.0,0.0,225.0
1777,Florent Mollet,FRA,MF,Montpellier,Ligue 1,28,1991,26.2,20,15,7,11,2,12,47,25.5,35,18,4,14,32,52,9,1,0,2020-2021,90.0,109.92366412213741,68.70229007633588
1778,Jayson Molumby,IRL,MF,Brighton,Premier League,20,1999,0.0,0,0,0,0,0,0,0,0.0,0,0,0,0,0,0,0,0,0,2020-2021,,,
1779,Alkhaly Momo Cissé,GUI,"FW,DF",Stuttgart,Bundesliga,17,2002,0.4,1,1,1,0,0,0,0,0.0,0,1,0,1,0,1,0,0,0,2020-2021,90.0,0.0,225.0
1780,Jon Moncayola,ESP,MF,Osasuna,La Liga,22,1998,29.6,61,36,27,23,11,24,67,35.8,43,27,9,18,23,84,38,0,0,2020-2021,90.0,69.93243243243244,185.47297297297297
1781,Gabriele Moncini,ITA,"FW,MF",Benevento,Serie A,24,1996,4.0,2,1,2,0,0,0,1,0.0,1,2,0,2,2,4,4,0,0,2020-2021,90.0,45.0,45.0
1782,Thomas Monconduit,FRA,MF,Lorient,Ligue 1,29,1991,12.8,28,15,9,16,3,15,41,36.6,26,10,3,7,13,41,21,1,0,2020-2021,90.0,91.40625,196.875
1783,Kévin Monnet-Paquet,FRA,"MF,FW",Saint-Étienne,Ligue 1,31,1988,6.3,11,7,7,2,2,5,10,50.0,5,5,0,5,6,17,7,0,0,2020-2021,90.0,85.71428571428572,157.14285714285717
1784,Nacho Monreal,ESP,DF,Real Sociedad,La Liga,34,1986,23.1,31,19,17,11,3,7,20,35.0,13,14,3,11,31,62,43,0,0,2020-2021,89.99999999999999,120.77922077922076,120.77922077922076
1785,Cristóbal Montiel,ESP,"MF,FW",Fiorentina,Serie A,20,2000,0.0,0,0,0,0,0,0,1,0.0,1,0,0,0,0,0,0,0,0,2020-2021,,,
1786,Lorenzo Montipò,ITA,GK,Benevento,Serie A,24,1996,37.0,0,0,0,0,0,0,0,0.0,0,1,0,1,0,0,16,3,0,2020-2021,90.0,0.0,0.0
1787,Ángel Montoro,ESP,MF,Granada,La Liga,32,1988,15.1,15,9,7,7,1,4,16,25.0,12,13,3,10,22,37,21,0,0,2020-2021,90.0,131.12582781456953,89.40397350993378
1788,Martín Montoya,ESP,DF,Betis,La Liga,29,1991,2.7,6,3,2,2,2,1,3,33.3,2,1,1,0,2,8,6,0,0,2020-2021,90.0,66.66666666666666,199.99999999999997
1789,Emre Mor,TUR,"FW,MF",Celta Vigo,La Liga,23,1997,5.6,8,4,1,3,4,0,3,0.0,3,5,0,5,5,13,0,0,0,2020-2021,90.0,80.35714285714286,128.57142857142858
1790,Luca Mora,ITA,MF,Spezia,Serie A,32,1988,1.3,3,1,1,2,0,2,4,50.0,2,2,1,1,0,3,2,0,0,2020-2021,90.0,0.0,207.69230769230768
1791,Wesley Moraes,BRA,FW,Aston Villa,Premier League,23,1996,0.2,0,0,0,0,0,0,1,0.0,1,0,0,0,0,0,0,0,0,2020-2021,90.0,0.0,0.0
1792,Álvaro Morata,ESP,FW,Juventus,Serie A,27,1992,22.4,17,12,2,10,5,4,28,14.3,24,22,2,20,5,22,21,0,0,2020-2021,90.0,20.089285714285715,68.30357142857143
1793,Jan Morávek,CZE,MF,Augsburg,Bundesliga,30,1989,3.0,5,3,4,1,0,1,8,12.5,7,3,0,3,7,12,2,0,0,2020-2021,90.0,210.0,150.0
1794,Jon Morcillo,ESP,"MF,FW",Athletic Club,La Liga,21,1998,15.1,16,9,3,6,7,7,30,23.3,23,9,0,9,15,31,11,0,0,2020-2021,90.0,89.40397350993378,95.36423841059603
1795,Jérémy Morel,MAD,DF,Lorient,Ligue 1,36,1984,27.7,31,19,21,10,0,20,39,51.3,19,26,11,15,44,75,81,1,0,2020-2021,90.0,142.96028880866427,100.72202166064983
1796,Alberto Moreno,ESP,DF,Villarreal,La Liga,28,1992,2.1,7,4,7,0,0,2,5,40.0,3,2,1,1,3,10,2,0,0,2020-2021,90.0,128.57142857142856,300.0
1797,Álex Moreno,ESP,DF,Betis,La Liga,27,1993,19.8,42,26,25,12,5,20,43,46.5,23,18,4,14,35,77,48,0,0,2020-2021,90.0,159.0909090909091,190.9090909090909
1798,Gerard Moreno,ESP,FW,Villarreal,La Liga,28,1992,29.7,24,15,8,10,6,7,34,20.6,27,17,4,13,15,39,26,0,0,2020-2021,90.0,45.45454545454545,72.72727272727272
1799,Tete Morente,ESP,"MF,FW",Elche,La Liga,23,1996,22.4,31,17,17,9,5,9,39,23.1,30,20,0,20,13,44,28,0,0,2020-2021,90.0,52.23214285714286,124.55357142857143
1800,Mateu Morey,ESP,DF,Dortmund,Bundesliga,20,2000,9.2,13,7,4,7,2,9,12,75.0,3,6,1,5,18,31,7,1,0,2020-2021,90.0,176.08695652173915,127.17391304347827
Rk,Player,Nation,Pos,Squad,Comp,0,0,90.0,0,0,3,3,3,Tkl,0,0.0,0,0,0,0,0,0,0,0,0,2020-2021,90.0,0.0,0.0
1801,Wes Morgan,JAM,DF,Leicester City,Premier League,36,1984,0.2,0,0,0,0,0,0,0,0.0,0,0,0,0,0,0,1,0,0,2020-2021,90.0,0.0,0.0
1802,Ilaix Moriba,GUI,MF,Barcelona,La Liga,17,2003,6.0,14,6,5,7,2,5,10,50.0,5,16,1,15,5,19,4,1,0,2020-2021,90.0,75.0,210.0
1803,Raúl Moro,ESP,FW,Lazio,Serie A,17,2002,0.1,0,0,0,0,0,0,1,0.0,1,0,0,0,0,0,0,0,0,2020-2021,90.0,0.0,0.0
1804,Loren Morón,ESP,FW,Betis,La Liga,26,1993,11.0,11,7,2,6,3,1,16,6.3,15,11,0,11,3,14,14,0,0,2020-2021,90.0,24.545454545454547,90.0
1805,Pedro Mosquera,ESP,MF,Huesca,La Liga,32,1988,22.8,38,18,19,18,1,13,53,24.5,40,23,6,17,31,69,38,1,0,2020-2021,90.0,122.36842105263158,150.0
1806,Aimen Moueffek,FRA,"DF,MF",Saint-Étienne,Ligue 1,19,2001,8.3,25,15,16,6,3,13,32,40.6,19,17,2,15,9,34,18,0,0,2020-2021,90.0,97.59036144578312,271.0843373493976
1807,Youssoufa Moukoko,GER,"FW,MF",Dortmund,Bundesliga,15,2004,4.7,3,2,1,1,1,0,0,0.0,0,3,0,3,0,3,2,0,0,2020-2021,90.0,0.0,57.44680851063829
1808,Harold Moukoudi,CMR,DF,Saint-Étienne,Ligue 1,22,1997,25.3,46,27,37,8,1,28,38,73.7,10,24,10,14,42,88,78,1,0,2020-2021,89.99999999999999,149.4071146245059,163.63636363636363
1809,Jessy Moulin,FRA,GK,Saint-Étienne,Ligue 1,34,1986,29.0,2,1,2,0,0,2,3,66.7,1,0,0,0,2,4,9,2,0,2020-2021,90.0,6.206896551724138,6.206896551724138
1810,Steve Mounié,BEN,FW,Brest,Ligue 1,25,1994,29.8,15,11,3,11,1,3,28,10.7,25,18,3,15,12,27,40,0,0,2020-2021,90.0,36.241610738255034,45.30201342281879
1811,Mason Mount,ENG,MF,Chelsea,Premier League,21,1999,32.1,75,35,22,38,15,25,69,36.2,44,40,2,38,31,106,14,0,0,2020-2021,90.0,86.91588785046729,210.28037383177568
1812,Lucas Moura,BRA,"FW,MF",Tottenham,Premier League,27,1992,15.7,32,16,12,16,4,8,29,27.6,21,12,0,12,18,50,10,0,0,2020-2021,90.0,103.18471337579619,183.4394904458599
1813,Lys Mousset,FRA,"FW,MF",Sheffield Utd,Premier League,24,1996,3.3,1,0,0,0,1,0,2,0.0,2,1,0,1,0,1,1,1,0,2020-2021,90.0,0.0,27.272727272727273
1814,João Moutinho,POR,MF,Wolves,Premier League,33,1986,28.1,75,40,34,35,6,35,91,38.5,56,18,3,15,47,122,28,0,0,2020-2021,90.0,150.53380782918148,240.2135231316726
1815,Samuel Moutoussamy,COD,FW,Nantes,Ligue 1,23,1996,0.9,0,0,0,0,0,0,1,0.0,1,1,0,1,0,0,0,0,0,2020-2021,90.0,0.0,0.0
1816,Loris Mouyokolo,FRA,DF,Lorient,Ligue 1,19,2001,0.2,1,1,1,0,0,1,1,100.0,0,1,1,0,0,1,1,0,0,2020-2021,90.0,0.0,450.0
1817,Javi Moyano,ESP,DF,Valladolid,La Liga,34,1986,1.1,0,0,0,0,0,0,0,0.0,0,2,0,2,0,0,2,0,0,2020-2021,90.0,0.0,0.0
1818,Nordi Mukiele,FRA,DF,RB Leipzig,Bundesliga,22,1997,18.6,44,30,14,28,2,21,37,56.8,16,33,1,32,23,67,33,2,0,2020-2021,90.0,111.29032258064515,212.9032258064516
1819,Mert Müldür,TUR,DF,Sassuolo,Serie A,21,1999,18.6,43,20,26,9,8,27,53,50.9,26,17,1,16,36,79,41,0,0,2020-2021,90.0,174.19354838709674,208.06451612903223
1820,Florian Müller,GER,GK,Freiburg,Bundesliga,22,1997,31.0,0,0,0,0,0,0,3,0.0,3,1,0,1,2,2,10,1,0,2020-2021,90.0,5.806451612903226,0.0
1821,Sebastian Müller,GER,"MF,DF",Arminia,Bundesliga,19,2001,0.0,0,0,0,0,0,0,0,0.0,0,0,0,0,0,0,0,0,0,2020-2021,,,
1822,Thomas Müller,GER,MF,Bayern Munich,Bundesliga,30,1989,29.7,49,22,11,23,15,24,73,32.9,49,43,3,40,21,70,18,1,0,2020-2021,90.0,63.63636363636363,148.48484848484847
1823,Joel Mumbongo,SWE,FW,Burnley,Premier League,21,1999,0.4,0,0,0,0,0,0,0,0.0,0,1,0,1,0,0,0,0,0,2020-2021,90.0,0.0,0.0
1824,Marshall Munetsi,ZIM,"MF,DF",Reims,Ligue 1,24,1996,21.4,35,19,19,14,2,21,41,51.2,20,33,25,8,57,92,85,3,0,2020-2021,90.0,239.71962616822432,147.196261682243
1825,Iker Muniain,ESP,"MF,FW",Athletic Club,La Liga,27,1992,21.6,20,7,4,10,6,6,24,25.0,18,15,0,15,11,31,4,0,0,2020-2021,90.0,45.83333333333333,83.33333333333333
Rk,Player,Nation,Pos,Squad,Comp,0,0,90.0,0,0,3,3,3,Tkl,0,0.0,0,0,0,0,0,0,0,0,0,2020-2021,90.0,0.0,0.0
1826,Aihen Muñoz,ESP,DF,Real Sociedad,La Liga,22,1997,13.4,23,16,15,5,3,11,19,57.9,8,12,2,10,10,33,31,0,0,2020-2021,90.0,67.16417910447761,154.4776119402985
1827,Joaquín Muñoz,ESP,FW,Huesca,La Liga,21,1999,0.5,0,0,0,0,0,0,2,0.0,2,0,0,0,1,1,0,0,0,2020-2021,90.0,180.0,0.0
1828,Luis Muriel,COL,FW,Atalanta,Serie A,29,1991,16.0,20,9,4,8,8,9,26,34.6,17,17,0,17,7,27,4,0,0,2020-2021,90.0,39.375,112.5
1829,Jeison Murillo,COL,DF,Celta Vigo,La Liga,28,1992,30.0,45,21,35,9,1,24,44,54.5,20,29,17,12,36,81,100,2,0,2020-2021,90.0,108.0,135.0
1830,Vedat Muriqi,KVX,FW,Lazio,Serie A,26,1994,9.2,3,1,0,2,1,0,8,0.0,8,9,2,7,3,6,20,0,0,2020-2021,90.0,29.347826086956523,29.347826086956523
1831,Jacob Murphy,ENG,"DF,MF",Newcastle Utd,Premier League,25,1995,18.1,39,24,25,12,2,24,49,49.0,25,27,3,24,14,53,29,0,0,2020-2021,90.0,69.61325966850828,193.92265193370164
1832,Nicola Murru,ITA,DF,Torino,Serie A,25,1994,6.3,9,6,1,5,3,3,5,60.0,2,11,1,10,12,21,24,0,0,2020-2021,90.0,171.42857142857144,128.57142857142858
1833,Petar Musa,CRO,FW,Union Berlin,Bundesliga,22,1998,7.9,12,8,3,6,3,4,8,50.0,4,10,0,10,4,16,5,0,0,2020-2021,90.0,45.56962025316455,136.70886075949366
1834,Mateo Musacchio,ARG,DF,Lazio,Serie A,29,1990,2.5,1,1,1,0,0,0,0,0.0,0,5,2,3,2,3,5,0,0,2020-2021,90.0,72.0,36.0
1835,Mateo Musacchio,ARG,DF,Milan,Serie A,29,1990,0.4,2,1,2,0,0,2,3,66.7,1,1,0,1,3,5,0,0,0,2020-2021,90.0,675.0,450.0
1836,Yunus Musah,USA,MF,Valencia,La Liga,17,2002,17.0,21,18,12,3,6,8,24,33.3,16,20,0,20,15,36,12,1,0,2020-2021,90.0,79.41176470588235,111.17647058823529
1837,Jamal Musiala,GER,"FW,MF",Bayern Munich,Bundesliga,17,2003,9.8,20,12,5,7,8,7,22,31.8,15,17,2,15,14,34,3,0,0,2020-2021,90.0,128.57142857142856,183.6734693877551
1838,Juan Musso,ARG,GK,Udinese,Serie A,26,1994,35.0,1,1,1,0,0,1,1,100.0,0,0,0,0,1,2,8,1,0,2020-2021,90.0,2.571428571428571,2.571428571428571
1839,Shkodran Mustafi,GER,DF,Arsenal,Premier League,28,1992,0.5,1,1,1,0,0,1,1,100.0,0,1,0,1,0,1,3,0,0,2020-2021,90.0,0.0,180.0
1840,Shkodran Mustafi,GER,DF,Schalke 04,Bundesliga,28,1992,11.5,16,5,15,1,0,3,12,25.0,9,20,15,5,32,48,76,1,0,2020-2021,90.0,250.43478260869568,125.21739130434784
1841,Yoshinori Mutō,JPN,"FW,MF",Eibar,La Liga,28,1992,12.5,12,7,1,4,7,3,8,37.5,5,5,0,5,3,15,2,0,0,2020-2021,90.0,21.599999999999998,86.39999999999999
1842,Phillipp Mwene,AUT,"DF,MF",Mainz 05,Bundesliga,26,1994,18.6,36,23,21,11,4,19,38,50.0,19,26,3,23,24,60,33,0,0,2020-2021,90.0,116.1290322580645,174.19354838709674
1843,Joakim Mæhle,DEN,DF,Atalanta,Serie A,23,1997,13.5,18,10,7,5,6,8,19,42.1,11,17,2,15,11,29,5,0,0,2020-2021,90.0,73.33333333333334,120.0
1844,Obite N'Dicka,CIV,DF,Eint Frankfurt,Bundesliga,20,1999,22.7,31,23,16,15,0,16,28,57.1,12,27,6,21,47,78,85,0,0,2020-2021,89.99999999999999,186.34361233480175,122.90748898678413
1845,Kévin N'Doram,FRA,MF,Metz,Ligue 1,24,1996,3.4,3,2,0,3,0,1,3,33.3,2,0,0,0,6,9,2,0,0,2020-2021,90.0,158.8235294117647,79.41176470588235
1846,Stanley N'Soki,FRA,DF,Nice,Ligue 1,21,1999,13.8,27,19,15,9,3,13,22,59.1,9,17,4,13,26,53,38,2,0,2020-2021,90.0,169.56521739130434,176.08695652173913
1847,Nacho,ESP,DF,Valladolid,La Liga,31,1989,20.1,43,21,29,10,4,24,52,46.2,28,21,1,20,29,72,47,0,0,2020-2021,90.0,129.8507462686567,192.5373134328358
1848,Nacho,ESP,DF,Real Madrid,La Liga,30,1990,22.2,27,14,13,11,3,12,35,34.3,23,19,9,10,40,67,58,0,0,2020-2021,90.0,162.1621621621622,109.45945945945947
1849,Yuto Nagatomo,JPN,DF,Marseille,Ligue 1,33,1986,17.7,23,16,12,8,3,9,18,50.0,9,14,3,11,29,52,43,0,0,2020-2021,90.0,147.45762711864407,116.94915254237289
1850,Kenny Nagera,FRA,FW,Paris S-G,Ligue 1,18,2002,0.0,0,0,0,0,0,0,0,0.0,0,0,0,0,0,0,0,0,0,2020-2021,,,
Rk,Player,Nation,Pos,Squad,Comp,0,0,90.0,0,0,3,3,3,Tkl,0,0.0,0,0,0,0,0,0,0,0,0,2020-2021,90.0,0.0,0.0
1851,Radja Nainggolan,BEL,MF,Cagliari,Serie A,32,1988,20.5,41,26,22,14,5,19,34,55.9,15,18,0,18,15,56,15,1,0,2020-2021,90.0,65.85365853658537,180.0
1852,Radja Nainggolan,BEL,MF,Inter,Serie A,32,1988,0.5,0,0,0,0,0,0,0,0.0,0,0,0,0,1,1,0,0,0,2020-2021,90.0,180.0,0.0
1853,Marvelous Nakamba,ZIM,MF,Aston Villa,Premier League,26,1994,8.3,22,14,10,11,1,7,12,58.3,5,16,5,11,17,39,9,1,0,2020-2021,90.0,184.33734939759034,238.55421686746985
1854,Nahitan Nández,URU,"MF,DF",Cagliari,Serie A,24,1995,30.4,56,28,23,23,10,25,68,36.8,43,26,4,22,23,79,49,0,0,2020-2021,90.0,68.09210526315789,165.78947368421052
1855,Nano,ESP,FW,Cádiz,La Liga,25,1995,0.1,0,0,0,0,0,0,0,0.0,0,0,0,0,0,0,0,0,0,2020-2021,90.0,0.0,0.0
1856,Paul Nardi,FRA,GK,Lorient,Ligue 1,26,1994,23.0,0,0,0,0,0,0,1,0.0,1,1,0,1,0,0,15,2,0,2020-2021,90.0,0.0,0.0
1857,Matija Nastasić,SRB,DF,Schalke 04,Bundesliga,27,1993,13.6,11,7,9,2,0,9,16,56.3,7,22,18,4,26,37,51,1,0,2020-2021,90.0,172.05882352941177,72.79411764705883
1858,Roberto Navarro,ESP,MF,Real Sociedad,La Liga,18,2002,0.4,1,1,1,0,0,0,2,0.0,2,0,0,0,1,2,0,0,0,2020-2021,90.0,225.0,225.0
1859,Ximo Navarro,ESP,DF,Alavés,La Liga,30,1990,26.4,54,30,36,17,1,14,30,46.7,16,14,4,10,47,101,75,3,0,2020-2021,90.0,160.22727272727272,184.0909090909091
1860,Jesús Navas,ESP,DF,Sevilla,La Liga,34,1985,31.4,27,21,15,11,1,15,22,68.2,7,10,3,7,37,64,62,1,0,2020-2021,90.0,106.05095541401275,77.38853503184714
1861,Keylor Navas,CRC,GK,Paris S-G,Ligue 1,33,1986,28.0,0,0,0,0,0,0,0,0.0,0,0,0,0,0,0,10,0,0,2020-2021,90.0,0.0,0.0
1862,Raúl Navas,ESP,DF,Osasuna,La Liga,32,1988,1.9,6,3,5,1,0,4,6,66.7,2,0,0,0,3,9,13,0,0,2020-2021,90.0,142.10526315789474,284.2105263157895
1863,Papa Ndiaga Yade,MTN,"FW,MF",Metz,Ligue 1,20,2000,11.1,15,8,9,2,4,7,20,35.0,13,9,0,9,4,19,6,0,0,2020-2021,90.0,32.432432432432435,121.62162162162163
1864,Iliman Ndiaye,SEN,MF,Sheffield Utd,Premier League,20,2000,0.1,1,1,0,1,0,1,1,100.0,0,0,0,0,0,1,0,0,0,2020-2021,90.0,0.0,900.0
1865,Wilfred Ndidi,NGA,"MF,DF",Leicester City,Premier League,23,1996,24.2,96,63,45,44,7,26,66,39.4,40,38,11,27,61,157,55,0,0,2020-2021,90.0,226.8595041322314,357.0247933884297
1866,Bridge Ndilu,FRA,"FW,MF",Nantes,Ligue 1,20,2000,0.5,0,0,0,0,0,0,2,0.0,2,2,0,2,0,0,0,0,0,2020-2021,90.0,0.0,0.0
1867,Tanguy Ndombele,FRA,MF,Tottenham,Premier League,23,1996,23.2,41,20,11,21,9,18,44,40.9,26,28,4,24,19,60,15,0,0,2020-2021,90.0,73.70689655172414,159.05172413793105
1868,Dan Ndoye,SUI,"FW,MF",Nice,Ligue 1,19,2000,6.1,7,6,3,4,0,1,8,12.5,7,4,0,4,7,14,4,0,0,2020-2021,90.0,103.27868852459018,103.27868852459018
1869,Paul Nebel,GER,"MF,FW",Mainz 05,Bundesliga,17,2002,0.6,1,1,0,1,0,0,1,0.0,1,0,0,0,2,3,0,0,0,2020-2021,90.0,300.0,150.0
1870,Álvaro Negredo,ESP,FW,Cádiz,La Liga,34,1985,24.4,11,5,3,4,4,5,11,45.5,6,7,2,5,3,14,19,0,0,2020-2021,90.0,11.065573770491804,40.57377049180328
1871,Reiss Nelson,ENG,"FW,MF",Arsenal,Premier League,20,1999,0.8,1,0,0,0,1,0,0,0.0,0,0,0,0,1,2,1,0,0,2020-2021,90.0,112.5,112.5
1872,Ilija Nestorovski,MKD,"FW,MF",Udinese,Serie A,30,1990,7.8,6,4,2,3,1,2,13,15.4,11,5,0,5,1,7,7,0,0,2020-2021,90.0,11.538461538461538,69.23076923076923
1873,Neto,BRA,GK,Barcelona,La Liga,31,1989,7.0,0,0,0,0,0,0,1,0.0,1,0,0,0,0,0,3,1,0,2020-2021,90.0,0.0,0.0
1874,Pedro Neto,POR,"FW,MF",Wolves,Premier League,20,2000,28.3,16,9,4,6,6,6,28,21.4,22,18,2,16,31,47,8,0,0,2020-2021,90.0,98.58657243816253,50.88339222614841
1875,Luca Netz,GER,"DF,FW",Hertha BSC,Bundesliga,17,2003,3.4,14,8,12,2,0,6,17,35.3,11,3,0,3,6,20,8,0,0,2020-2021,90.0,158.8235294117647,370.5882352941176
Rk,Player,Nation,Pos,Squad,Comp,0,0,90.0,0,0,3,3,3,Tkl,0,0.0,0,0,0,0,0,0,0,0,0,2020-2021,90.0,0.0,0.0
1876,Manuel Neuer,GER,GK,Bayern Munich,Bundesliga,34,1986,33.0,0,0,0,0,0,0,1,0.0,1,0,0,0,2,2,12,3,0,2020-2021,90.0,5.454545454545455,0.0
1877,Florian Neuhaus,GER,MF,Gladbach,Bundesliga,23,1997,29.1,48,28,19,26,3,19,63,30.2,44,35,7,28,50,98,20,1,0,2020-2021,90.0,154.63917525773195,148.45360824742266
1878,Carlos Neva,ESP,DF,Granada,La Liga,24,1996,20.0,12,6,6,6,0,6,11,54.5,5,16,4,12,27,39,58,0,0,2020-2021,90.0,121.5,54.0
1879,Rúben Neves,POR,MF,Wolves,Premier League,23,1997,29.7,86,46,42,38,6,36,88,40.9,52,55,11,44,65,151,46,2,0,2020-2021,90.0,196.96969696969697,260.60606060606057
1880,Neymar,BRA,"MF,FW",Paris S-G,Ligue 1,28,1992,15.7,14,11,1,6,7,8,37,21.6,29,8,0,8,9,23,0,0,0,2020-2021,90.0,51.592356687898096,80.2547770700637
1881,Yvan Neyou,CMR,MF,Saint-Étienne,Ligue 1,23,1997,27.1,58,31,24,33,1,25,60,41.7,35,34,5,29,31,89,13,1,0,2020-2021,90.0,102.9520295202952,192.61992619926198
1882,Jessic Ngankam,GER,FW,Hertha BSC,Bundesliga,20,2000,3.3,5,2,1,2,2,1,3,33.3,2,6,1,5,0,5,1,0,0,2020-2021,90.0,0.0,136.36363636363637
1883,Muzinga Ngonda,COD,DF,Dijon,Ligue 1,25,1994,25.6,59,40,37,21,1,30,50,60.0,20,28,3,25,72,131,58,0,0,2020-2021,90.0,253.125,207.421875
1884,Ahmad Ngouyamsa,CMR,DF,Dijon,Ligue 1,19,2000,1.7,6,4,5,1,0,4,8,50.0,4,2,1,1,2,8,8,0,0,2020-2021,90.0,105.88235294117646,317.6470588235294
1885,Opa Nguette,SEN,"FW,MF",Metz,Ligue 1,26,1994,12.6,15,8,2,8,5,3,10,30.0,7,14,2,12,1,16,1,0,0,2020-2021,90.0,7.142857142857143,107.14285714285715
1886,Moussa Niakhate,SEN,DF,Mainz 05,Bundesliga,24,1996,31.8,42,22,28,13,1,14,29,48.3,15,31,15,16,49,91,79,0,0,2020-2021,90.0,138.67924528301887,118.86792452830188
1887,Ibrahima Niane,SEN,FW,Metz,Ligue 1,21,1999,7.4,1,1,0,0,1,1,2,50.0,1,3,0,3,0,1,8,0,0,2020-2021,90.0,0.0,12.162162162162161
1888,M'Baye Niang,SEN,FW,Rennes,Ligue 1,25,1994,4.7,3,2,2,1,0,0,0,0.0,0,2,0,2,1,4,2,0,0,2020-2021,90.0,19.148936170212764,57.44680851063829
1889,Mamor Niang,SEN,"MF,FW",Getafe,La Liga,18,2002,0.2,1,1,0,1,0,0,0,0.0,0,1,0,1,0,1,0,0,0,2020-2021,90.0,0.0,450.0
1890,Tanguy Nianzou,FRA,"DF,FW",Bayern Munich,Bundesliga,18,2002,1.3,3,1,3,0,0,1,1,100.0,0,0,0,0,3,6,1,0,0,2020-2021,90.0,207.69230769230768,207.69230769230768
1891,Florian Niederlechner,GER,FW,Augsburg,Bundesliga,29,1990,19.3,7,5,1,4,2,0,10,0.0,10,8,3,5,10,17,18,0,0,2020-2021,90.0,46.6321243523316,32.64248704663212
1892,Nieto,ESP,"FW,DF",Cádiz,La Liga,22,1998,0.2,1,1,0,1,0,0,0,0.0,0,0,0,0,0,1,1,0,0,2020-2021,90.0,0.0,450.0
1893,Saúl Ñíguez,ESP,"MF,DF",Atlético Madrid,La Liga,25,1994,22.6,57,34,27,23,7,30,59,50.8,29,35,2,33,19,76,43,0,0,2020-2021,90.0,75.66371681415929,226.99115044247787
1894,Joakim Nilsson,SWE,DF,Arminia,Bundesliga,26,1994,24.0,36,24,23,12,1,14,23,60.9,9,29,22,7,39,75,111,0,0,2020-2021,90.0,146.25,135.0
1895,Casimir Ninga,CHA,FW,Angers,Ligue 1,27,1993,0.3,0,0,0,0,0,0,0,0.0,0,0,0,0,0,0,1,0,0,2020-2021,90.0,0.0,0.0
1896,Nino,ESP,"FW,MF",Elche,La Liga,40,1980,3.2,0,0,0,0,0,0,1,0.0,1,1,0,1,0,0,0,0,0,2020-2021,90.0,0.0,0.0
1897,Fernando Niño,ESP,FW,Villarreal,La Liga,19,2000,6.6,8,3,0,4,4,2,9,22.2,7,1,0,1,2,10,2,0,0,2020-2021,90.0,27.272727272727273,109.0909090909091
1898,Eddie Nketiah,ENG,FW,Arsenal,Premier League,21,1999,4.7,3,1,0,2,1,0,2,0.0,2,6,0,6,0,3,5,0,0,2020-2021,90.0,0.0,57.44680851063829
1899,Nicolas Nkoulou,CMR,DF,Torino,Serie A,30,1990,15.1,14,9,11,3,0,7,12,58.3,5,28,14,14,33,47,71,1,0,2020-2021,90.0,196.6887417218543,83.44370860927152
1900,Niels Nkounkou,FRA,"DF,FW",Everton,Premier League,19,2000,0.9,4,3,1,2,1,3,8,37.5,5,4,0,4,0,4,4,0,0,2020-2021,90.0,0.0,400.0
Rk,Player,Nation,Pos,Squad,Comp,0,0,90.0,0,0,3,3,3,Tkl,0,0.0,0,0,0,0,0,0,0,0,0,2020-2021,90.0,0.0,0.0
1901,Christopher Nkunku,FRA,"FW,MF",RB Leipzig,Bundesliga,22,1997,21.0,16,11,3,7,6,8,18,44.4,10,27,1,26,9,25,14,0,0,2020-2021,90.0,38.57142857142857,68.57142857142857
1902,Dan Nlundulu,ENG,"FW,MF",Southampton,Premier League,21,1999,1.2,0,0,0,0,0,0,1,0.0,1,2,0,2,0,0,2,0,0,2020-2021,90.0,0.0,0.0
1903,Mark Noble,ENG,MF,West Ham,Premier League,33,1987,7.9,8,4,2,5,1,4,14,28.6,10,7,3,4,13,21,3,0,0,2020-2021,90.0,148.1012658227848,91.1392405063291
1904,Nolito,ESP,"MF,FW",Celta Vigo,La Liga,33,1986,28.9,70,36,30,30,10,32,92,34.8,60,46,2,44,22,92,19,0,0,2020-2021,90.00000000000001,68.51211072664361,217.9930795847751
1905,Arnaud Nordin,FRA,"MF,FW",Saint-Étienne,Ligue 1,22,1998,19.7,14,8,5,5,4,6,21,28.6,15,13,2,11,9,23,10,0,0,2020-2021,90.0,41.11675126903553,63.95939086294416
1906,Håvard Nordtveit,NOR,DF,Hoffenheim,Bundesliga,30,1990,7.8,6,2,5,1,0,6,8,75.0,2,4,2,2,13,19,42,0,0,2020-2021,90.0,150.0,69.23076923076923
1907,Will Norris,ENG,GK,Burnley,Premier League,26,1993,2.0,0,0,0,0,0,0,0,0.0,0,0,0,0,0,0,0,0,0,2020-2021,90.0,0.0,0.0
1908,Oliver Norwood,NIR,MF,Sheffield Utd,Premier League,29,1991,24.7,49,22,16,28,5,21,72,29.2,51,29,12,17,36,85,51,1,0,2020-2021,90.0,131.1740890688259,178.5425101214575
1909,Olivier Ntcham,CMR,MF,Marseille,Ligue 1,24,1996,1.3,1,0,0,1,0,1,3,33.3,2,3,1,2,2,3,3,0,0,2020-2021,90.0,138.46153846153845,69.23076923076923
1910,Alexander Nübel,GER,GK,Bayern Munich,Bundesliga,23,1996,1.0,0,0,0,0,0,0,0,0.0,0,0,0,0,0,0,1,0,0,2020-2021,90.0,0.0,0.0
1911,Kasim Nuhu,GHA,DF,Hoffenheim,Bundesliga,25,1995,11.0,13,7,9,4,0,6,10,60.0,4,8,3,5,15,28,38,0,0,2020-2021,90.0,122.72727272727273,106.36363636363637
1912,Unai Núñez,ESP,DF,Athletic Club,La Liga,23,1997,23.4,23,12,16,7,0,10,15,66.7,5,19,14,5,32,55,110,0,0,2020-2021,89.99999999999999,123.07692307692307,88.46153846153845
1913,Bram Nuytinck,NED,DF,Udinese,Serie A,30,1990,18.2,21,15,10,9,2,13,20,65.0,7,30,17,13,25,46,77,0,0,2020-2021,90.0,123.62637362637363,103.84615384615385
1914,Kelechi Nwakali,NGA,"MF,FW",Huesca,La Liga,22,1998,1.6,4,3,1,2,1,0,4,0.0,4,1,0,1,1,5,1,0,0,2020-2021,90.0,56.25,225.0
1915,Simeon Nwankwo,NGA,FW,Crotone,Serie A,28,1992,32.7,9,2,2,6,1,3,22,13.6,19,21,5,16,6,15,51,0,0,2020-2021,90.0,16.513761467889907,24.77064220183486
1916,Gerzino Nyamsi,FRA,DF,Rennes,Ligue 1,23,1997,9.7,12,10,2,8,2,4,6,66.7,2,8,5,3,10,22,32,1,0,2020-2021,90.0,92.78350515463919,111.34020618556703
1917,Allan Nyom,CMR,"MF,DF",Getafe,La Liga,32,1988,25.8,38,23,14,19,5,15,30,50.0,15,16,2,14,22,60,42,0,0,2020-2021,90.0,76.74418604651163,132.5581395348837
1918,M'Bala Nzola,ANG,FW,Spezia,Serie A,23,1996,21.1,12,5,2,6,4,4,7,57.1,3,15,1,14,3,15,20,0,0,2020-2021,90.0,12.796208530805687,51.18483412322275
1919,Steven Nzonzi,FRA,MF,Rennes,Ligue 1,31,1988,32.3,34,16,15,16,3,12,31,38.7,19,24,10,14,16,50,26,0,0,2020-2021,90.0,44.582043343653254,94.73684210526316
1920,Jack O'Connell,ENG,DF,Sheffield Utd,Premier League,26,1994,2.0,3,1,1,1,1,0,1,0.0,1,4,3,1,2,5,7,0,0,2020-2021,90.0,90.0,135.0
1921,Dara O'Shea,IRL,DF,West Brom,Premier League,21,1999,23.4,45,25,30,13,2,21,45,46.7,24,32,17,15,45,90,108,0,0,2020-2021,89.99999999999999,173.07692307692307,173.07692307692307
1922,Michael Obafemi,IRL,FW,Southampton,Premier League,20,2000,0.7,1,0,0,1,0,0,1,0.0,1,1,0,1,0,1,0,0,0,2020-2021,90.0,0.0,128.57142857142858
1923,Pedro Obiang,EQG,MF,Sassuolo,Serie A,28,1992,16.3,35,22,17,15,3,12,35,34.3,23,26,7,19,22,57,27,0,0,2020-2021,90.0,121.47239263803681,193.25153374233128
1924,Jan Oblak,SVN,GK,Atlético Madrid,La Liga,27,1993,38.0,0,0,0,0,0,0,0,0.0,0,0,0,0,0,0,6,2,0,2020-2021,90.0,0.0,0.0
1925,Lucas Ocampos,ARG,FW,Sevilla,La Liga,26,1994,29.2,36,24,12,16,8,13,37,35.1,24,33,1,32,19,55,30,1,0,2020-2021,90.0,58.561643835616444,110.95890410958904
Rk,Player,Nation,Pos,Squad,Comp,0,0,90.0,0,0,3,3,3,Tkl,0,0.0,0,0,0,0,0,0,0,0,0,2020-2021,90.0,0.0,0.0
1926,Bastian Oczipka,GER,"DF,FW",Schalke 04,Bundesliga,31,1989,21.4,33,20,22,10,1,7,21,33.3,14,22,4,18,24,57,41,0,0,2020-2021,90.0,100.93457943925235,138.78504672897196
1927,Brian Oddei,ITA,"FW,MF",Sassuolo,Serie A,17,2002,0.5,2,1,1,1,0,2,3,66.7,1,1,0,1,0,2,1,0,0,2020-2021,90.0,0.0,360.0
1928,Denis Odoi,GHA,DF,Fulham,Premier League,32,1988,3.0,3,3,2,1,0,1,4,25.0,3,3,1,2,5,8,5,0,0,2020-2021,90.0,150.0,90.0
1929,Álvaro Odriozola,ESP,DF,Real Madrid,La Liga,24,1995,9.2,14,7,5,8,1,3,5,60.0,2,6,3,3,6,20,12,1,0,2020-2021,90.0,58.69565217391305,136.95652173913044
1930,Angelo Ogbonna,ITA,DF,West Ham,Premier League,32,1988,27.7,26,13,20,5,1,9,17,52.9,8,25,11,14,30,56,119,0,0,2020-2021,90.0,97.47292418772564,84.47653429602889
1931,Stefano Okaka,ITA,FW,Udinese,Serie A,30,1989,16.5,10,7,2,5,3,2,10,20.0,8,7,1,6,2,12,19,0,0,2020-2021,90.0,10.90909090909091,54.54545454545455
1932,Shinji Okazaki,JPN,"FW,MF",Huesca,La Liga,34,1986,12.5,7,5,5,0,2,0,5,0.0,5,5,0,5,4,11,6,0,0,2020-2021,90.0,28.799999999999997,50.4
1933,Masaya Okugawa,JPN,MF,Arminia,Bundesliga,24,1996,10.2,17,8,5,11,1,6,14,42.9,8,17,2,15,8,25,5,0,0,2020-2021,90.0,70.58823529411765,150.0
1934,Lucas Olaza,URU,DF,Valladolid,La Liga,26,1994,14.0,20,9,11,7,2,9,17,52.9,8,15,7,8,15,35,38,0,0,2020-2021,90.0,96.42857142857143,128.57142857142856
1935,Lucas Olaza,URU,DF,Celta Vigo,La Liga,26,1994,17.9,25,16,12,12,1,10,18,55.6,8,15,1,14,24,49,34,0,0,2020-2021,90.0,120.67039106145253,125.69832402234638
1936,Christian Oliva,URU,MF,Cagliari,Serie A,24,1996,4.3,10,4,6,3,1,6,17,35.3,11,11,1,10,8,18,7,0,0,2020-2021,90.0,167.4418604651163,209.30232558139537
1937,Christian Oliva,URU,MF,Valencia,La Liga,24,1996,2.2,2,0,1,1,0,1,6,16.7,5,1,0,1,6,8,0,0,0,2020-2021,90.0,245.45454545454544,81.81818181818181
1938,Kiko Olivas,ESP,DF,Valladolid,La Liga,31,1988,2.0,3,2,2,1,0,3,5,60.0,2,2,2,0,7,10,3,0,0,2020-2021,90.0,315.0,135.0
1939,Paulo Oliveira,POR,DF,Eibar,La Liga,28,1992,29.3,42,21,32,8,2,19,36,52.8,17,39,14,25,59,101,112,0,0,2020-2021,90.0,181.22866894197952,129.01023890784984
1940,Mathías Olivera,URU,DF,Getafe,La Liga,22,1997,29.0,61,33,31,21,9,32,56,57.1,24,33,3,30,31,92,55,0,0,2020-2021,90.0,96.20689655172413,189.3103448275862
1941,Maximiliano Olivera,URU,DF,Fiorentina,Serie A,28,1992,1.0,2,0,1,1,0,1,1,100.0,0,3,1,2,0,2,8,0,0,2020-2021,90.0,0.0,180.0
1942,Dani Olmo,ESP,MF,RB Leipzig,Bundesliga,22,1998,24.4,23,14,6,13,4,4,23,17.4,19,15,0,15,13,36,21,0,0,2020-2021,90.0,47.95081967213115,84.8360655737705
1943,Robin Olsen,SWE,GK,Everton,Premier League,30,1990,7.0,0,0,0,0,0,0,0,0.0,0,0,0,0,0,0,4,1,0,2020-2021,90.0,0.0,0.0
1944,Jonas Omlin,SUI,GK,Montpellier,Ligue 1,26,1994,29.7,1,1,1,0,0,1,4,25.0,3,0,0,0,0,1,9,1,0,2020-2021,90.0,0.0,3.0303030303030303
1945,Jérôme Onguéné,CMR,DF,Genoa,Serie A,22,1997,2.0,2,1,2,0,0,2,7,28.6,5,2,0,2,2,4,8,0,0,2020-2021,90.0,90.0,90.0
1946,Karim Onisiwo,AUT,"FW,MF",Mainz 05,Bundesliga,28,1992,20.5,31,20,7,15,9,14,23,60.9,9,20,1,19,5,36,12,0,0,2020-2021,90.0,21.951219512195124,136.09756097560975
1947,Josh Onomah,ENG,MF,Fulham,Premier League,23,1997,4.2,11,8,1,6,4,0,5,0.0,5,4,2,2,2,13,1,0,0,2020-2021,90.0,42.857142857142854,235.7142857142857
1948,Javier Ontiveros,ESP,"FW,MF",Huesca,La Liga,22,1997,10.2,21,14,10,10,1,9,26,34.6,17,12,0,12,9,30,6,0,0,2020-2021,90.0,79.41176470588236,185.29411764705884
1949,Henry Onyekuru,NGA,FW,Monaco,Ligue 1,23,1997,1.6,1,0,1,0,0,1,4,25.0,3,1,0,1,0,1,0,0,0,2020-2021,90.0,0.0,56.25
1950,Willi Orban,HUN,DF,RB Leipzig,Bundesliga,27,1992,26.3,40,26,19,15,6,23,37,62.2,14,29,20,9,40,80,74,0,0,2020-2021,90.0,136.88212927756655,136.88212927756655
Rk,Player,Nation,Pos,Squad,Comp,0,0,90.0,0,0,3,3,3,Tkl,0,0.0,0,0,0,0,0,0,0,0,0,2020-2021,90.0,0.0,0.0
1951,Fabián Orellana,CHI,"MF,FW",Valladolid,La Liga,34,1986,23.8,33,19,12,14,7,12,55,21.8,43,18,0,18,15,48,9,0,0,2020-2021,90.00000000000001,56.72268907563026,124.78991596638656
1952,Divock Origi,BEL,FW,Liverpool,Premier League,25,1995,2.1,3,2,0,2,1,1,3,33.3,2,5,1,4,1,4,2,0,0,2020-2021,90.0,42.857142857142854,128.57142857142856
1953,Riccardo Orsolini,ITA,"FW,MF",Bologna,Serie A,23,1997,19.5,37,18,13,12,12,16,39,41.0,23,22,3,19,10,47,22,0,0,2020-2021,90.0,46.15384615384615,170.76923076923077
1954,Stefan Ortega,GER,GK,Arminia,Bundesliga,27,1992,34.0,2,1,2,0,0,2,6,33.3,4,0,0,0,0,2,12,3,0,2020-2021,90.0,0.0,5.294117647058823
1955,Yuya Osako,JPN,"MF,FW",Werder Bremen,Bundesliga,30,1990,8.5,12,8,2,5,5,2,9,22.2,7,6,1,5,5,17,7,0,0,2020-2021,90.0,52.94117647058824,127.05882352941177
1956,Ben Osborn,ENG,"MF,DF",Sheffield Utd,Premier League,25,1994,17.8,33,18,15,10,8,13,40,32.5,27,20,3,17,12,45,17,0,0,2020-2021,90.0,60.67415730337079,166.85393258426967
1957,Victor Osimhen,NGA,FW,Napoli,Serie A,21,1998,17.5,22,15,2,6,14,3,15,20.0,12,6,0,6,7,29,10,0,0,2020-2021,90.0,36.0,113.14285714285714
1958,Yordan Osorio,VEN,DF,Parma,Serie A,26,1994,20.1,22,14,13,9,0,9,24,37.5,15,30,18,12,53,75,77,1,0,2020-2021,90.0,237.31343283582086,98.50746268656715
1959,David Ospina,COL,GK,Napoli,Serie A,31,1988,16.0,0,0,0,0,0,0,0,0.0,0,0,0,0,0,0,4,0,0,2020-2021,90.0,0.0,0.0
1960,Owen Otasowie,USA,"MF,FW",Wolves,Premier League,19,2001,2.1,5,5,3,2,0,1,2,50.0,1,1,1,0,3,8,4,0,0,2020-2021,90.0,128.57142857142856,214.28571428571428
1961,Otávio,BRA,MF,Bordeaux,Ligue 1,26,1994,17.3,54,31,33,19,2,26,55,47.3,29,20,5,15,26,80,36,0,0,2020-2021,90.0,135.2601156069364,280.9248554913295
1962,Paulo Otávio,BRA,DF,Wolfsburg,Bundesliga,25,1994,19.3,60,40,32,22,6,34,62,54.8,28,51,7,44,42,102,59,0,0,2020-2021,90.0,195.85492227979273,279.7927461139896
1963,Remi Oudin,FRA,"FW,MF",Bordeaux,Ligue 1,23,1996,26.9,34,16,22,7,5,15,36,41.7,21,22,2,20,51,85,40,1,0,2020-2021,90.0,170.63197026022306,113.75464684014871
1964,Alexandre Oukidja,ALG,GK,Metz,Ligue 1,32,1988,34.0,0,0,0,0,0,0,1,0.0,1,1,0,1,0,0,17,3,0,2020-2021,90.0,0.0,0.0
1965,Zinédine Ould Khaled,FRA,MF,Angers,Ligue 1,20,2000,0.4,0,0,0,0,0,0,0,0.0,0,0,0,0,1,1,0,0,0,2020-2021,90.0,225.0,0.0
1966,Adam Ounas,ALG,"FW,MF",Crotone,Serie A,23,1996,13.3,9,4,4,4,1,0,7,0.0,7,12,1,11,3,12,4,0,0,2020-2021,90.0,20.30075187969925,60.90225563909774
1967,Adam Ounas,ALG,"MF,FW",Cagliari,Serie A,23,1996,3.4,3,2,3,0,0,0,11,0.0,11,5,0,5,3,6,0,0,0,2020-2021,90.0,79.41176470588235,79.41176470588235
1968,Thomas Ouwejan,NED,DF,Udinese,Serie A,23,1996,4.6,4,1,0,3,1,2,9,22.2,7,4,0,4,5,9,6,0,0,2020-2021,90.0,97.82608695652175,78.26086956521739
1969,Reece Oxford,ENG,DF,Augsburg,Bundesliga,21,1998,15.1,26,18,15,11,0,10,17,58.8,7,28,22,6,29,55,89,0,0,2020-2021,90.0,172.8476821192053,154.96688741721854
1970,Alex Oxlade-Chamberlain,ENG,"MF,FW",Liverpool,Premier League,26,1993,2.8,4,0,0,3,1,0,2,0.0,2,1,0,1,2,6,0,0,0,2020-2021,90.0,64.28571428571429,128.57142857142858
1971,Mikel Oyarzabal,ESP,"FW,MF",Real Sociedad,La Liga,23,1997,26.8,30,17,14,12,4,10,31,32.3,21,30,5,25,15,45,17,0,0,2020-2021,90.0,50.373134328358205,100.74626865671641
1972,Ambroise Oyongo,CMR,DF,Montpellier,Ligue 1,29,1991,6.2,13,6,10,3,0,9,15,60.0,6,3,2,1,8,21,26,1,0,2020-2021,90.0,116.12903225806451,188.70967741935485
1973,Salih Özcan,TUR,MF,Köln,Bundesliga,22,1998,15.2,21,13,11,10,0,12,33,36.4,21,11,2,9,20,41,14,1,0,2020-2021,90.0,118.42105263157895,124.34210526315789
1974,Levin Öztunalı,GER,"DF,FW",Mainz 05,Bundesliga,24,1996,8.4,24,18,14,8,2,8,17,47.1,9,15,0,15,15,39,16,0,0,2020-2021,90.0,160.7142857142857,257.1428571428571
1975,Pablo,BRA,DF,Bordeaux,Ligue 1,29,1991,12.0,17,11,13,4,0,8,14,57.1,6,17,12,5,25,42,46,1,0,2020-2021,90.0,187.5,127.5
Rk,Player,Nation,Pos,Squad,Comp,0,0,90.0,0,0,3,3,3,Tkl,0,0.0,0,0,0,0,0,0,0,0,0,2020-2021,90.0,0.0,0.0
1976,Fernando Pacheco,ESP,GK,Alavés,La Liga,28,1992,37.2,2,0,2,0,0,2,4,50.0,2,0,0,0,2,4,19,0,0,2020-2021,90.0,4.838709677419354,4.838709677419354
1977,Jon Pacheco,ESP,DF,Real Sociedad,La Liga,19,2001,0.4,0,0,0,0,0,0,0,0.0,0,0,0,0,1,1,0,0,0,2020-2021,90.0,225.0,0.0
1978,Gonçalo Paciência,POR,FW,Schalke 04,Bundesliga,25,1994,8.3,8,3,4,1,3,4,16,25.0,12,4,1,3,1,9,3,0,0,2020-2021,90.0,10.843373493975902,86.74698795180721
1979,Daniele Padelli,ITA,GK,Inter,Serie A,34,1985,0.5,0,0,0,0,0,0,0,0.0,0,0,0,0,0,0,0,0,0,2020-2021,90.0,0.0,0.0
1980,Mattia Pagliuca,ITA,MF,Bologna,Serie A,18,2002,0.1,0,0,0,0,0,0,0,0.0,0,0,0,0,1,1,0,0,0,2020-2021,90.0,900.0,0.0
1981,Vincent Pajot,FRA,MF,Metz,Ligue 1,29,1990,10.2,35,20,19,11,5,10,18,55.6,8,9,2,7,42,77,11,0,0,2020-2021,90.0,370.5882352941177,308.8235294117647
1982,Rodrigo Palacio,ARG,FW,Bologna,Serie A,38,1982,27.8,13,6,2,3,8,1,15,6.7,14,18,0,18,7,20,29,0,0,2020-2021,90.0,22.66187050359712,42.0863309352518
1983,Exequiel Palacios,ARG,MF,Leverkusen,Bundesliga,21,1998,6.4,31,17,12,16,3,17,30,56.7,13,13,0,13,12,43,7,0,0,2020-2021,90.0,168.75,435.9375
1984,Helibelton Palacios,COL,DF,Elche,La Liga,27,1993,8.3,20,10,16,3,1,8,13,61.5,5,9,1,8,5,25,21,0,0,2020-2021,90.0,54.21686746987951,216.86746987951804
1985,Ante Palaversa,CRO,MF,Getafe,La Liga,20,2000,0.1,0,0,0,0,0,0,1,0.0,1,0,0,0,0,0,0,0,0,2020-2021,90.0,0.0,0.0
1986,Alberto Paleari,ITA,GK,Genoa,Serie A,27,1992,2.3,0,0,0,0,0,0,0,0.0,0,0,0,0,0,0,1,0,0,2020-2021,90.0,0.0,0.0
1987,Nicolas Pallois,FRA,DF,Nantes,Ligue 1,32,1987,30.8,58,36,42,14,2,38,72,52.8,34,44,20,24,37,95,155,1,0,2020-2021,90.0,108.11688311688312,169.4805194805195
1988,Emerson Palmieri,ITA,DF,Chelsea,Premier League,25,1994,1.0,3,3,2,0,1,1,3,33.3,2,0,0,0,1,4,6,0,0,2020-2021,90.0,90.0,270.0
1989,Antonio Palumbo,ITA,MF,Sampdoria,Serie A,23,1996,0.1,0,0,0,0,0,0,1,0.0,1,0,0,0,0,0,0,0,0,2020-2021,90.0,0.0,0.0
1990,Martin Palumbo,NOR,MF,Udinese,Serie A,18,2002,0.7,0,0,0,0,0,0,0,0.0,0,5,0,5,1,1,0,0,0,2020-2021,90.0,128.57142857142858,0.0
1991,Goran Pandev,MKD,"FW,MF",Genoa,Serie A,37,1983,15.6,9,5,1,6,2,4,10,40.0,6,6,0,6,2,11,7,1,0,2020-2021,90.0,11.538461538461538,51.92307692307692
1992,Ivor Pandur,CRO,GK,Hellas Verona,Serie A,20,2000,3.7,0,0,0,0,0,0,0,0.0,0,0,0,0,0,0,0,0,0,2020-2021,90.0,0.0,0.0
1993,Jonathan Panzo,ENG,DF,Dijon,Ligue 1,19,2000,20.0,17,12,13,4,0,8,11,72.7,3,27,13,14,59,76,91,2,0,2020-2021,90.0,265.5,76.5
1994,Merveille Papela,GER,DF,Mainz 05,Bundesliga,19,2001,0.0,0,0,0,0,0,0,1,0.0,1,0,0,0,0,0,0,0,0,2020-2021,,,
1995,Lucas Paquetá,BRA,MF,Lyon,Ligue 1,22,1997,25.3,70,36,30,28,12,23,66,34.8,43,28,3,25,20,90,16,1,0,2020-2021,89.99999999999999,71.14624505928853,249.01185770750985
1996,Gaëtan Paquiez,FRA,DF,Nîmes,Ligue 1,26,1994,11.6,21,12,12,7,2,12,29,41.4,17,10,3,7,16,37,28,0,0,2020-2021,90.0,124.13793103448276,162.93103448275863
1997,Rubén Pardo,ESP,MF,Bordeaux,Ligue 1,27,1992,0.3,0,0,0,0,0,0,0,0.0,0,0,0,0,1,1,0,0,0,2020-2021,90.0,300.0,0.0
1998,Leandro Paredes,ARG,MF,Paris S-G,Ligue 1,26,1994,14.5,30,18,12,15,3,19,39,48.7,20,17,5,12,17,47,13,1,0,2020-2021,90.0,105.51724137931033,186.20689655172413
1999,Daniel Parejo,ESP,MF,Villarreal,La Liga,31,1989,34.6,65,40,32,23,10,33,81,40.7,48,35,8,27,45,110,21,3,0,2020-2021,90.0,117.05202312138728,169.07514450867052
2000,Vittorio Parigini,ITA,"MF,DF",Genoa,Serie A,24,1996,0.6,5,2,4,0,1,0,1,0.0,1,0,0,0,0,5,0,0,0,2020-2021,90.0,0.0,750.0
Rk,Player,Nation,Pos,Squad,Comp,0,0,90.0,0,0,3,3,3,Tkl,0,0.0,0,0,0,0,0,0,0,0,0,2020-2021,90.0,0.0,0.0
2001,Marco Parolo,ITA,"DF,MF",Lazio,Serie A,35,1985,7.3,21,8,8,11,2,8,20,40.0,12,20,6,14,14,35,31,0,0,2020-2021,90.0,172.6027397260274,258.9041095890411
2002,Thomas Partey,GHA,MF,Arsenal,Premier League,27,1993,17.0,44,21,16,24,4,24,56,42.9,32,17,5,12,23,67,18,0,0,2020-2021,90.0,121.76470588235294,232.94117647058823
2003,Thomas Partey,GHA,MF,Atlético Madrid,La Liga,27,1993,2.2,7,4,4,3,0,5,8,62.5,3,4,1,3,2,9,1,0,0,2020-2021,90.0,81.81818181818181,286.3636363636364
2004,Mario Pašalić,CRO,MF,Atalanta,Serie A,25,1995,12.5,26,15,5,17,4,12,19,63.2,7,12,1,11,8,34,6,0,0,2020-2021,90.0,57.599999999999994,187.2
2005,Felix Passlack,GER,DF,Dortmund,Bundesliga,22,1998,4.0,9,6,4,2,3,4,8,50.0,4,11,1,10,3,12,2,0,0,2020-2021,90.0,67.5,202.5
2006,Christian Pastina,ITA,DF,Benevento,Serie A,19,2001,1.3,0,0,0,0,0,0,1,0.0,1,1,0,1,1,1,8,0,0,2020-2021,90.0,69.23076923076923,0.0
2007,Javier Pastore,ARG,"MF,FW",Roma,Serie A,31,1989,0.9,2,2,2,0,0,2,2,100.0,0,0,0,0,0,2,0,0,0,2020-2021,90.0,0.0,200.0
2008,Patric,ESP,DF,Lazio,Serie A,27,1993,17.7,30,16,15,11,4,13,24,54.2,11,13,3,10,18,48,51,1,0,2020-2021,90.0,91.52542372881356,152.54237288135593
2009,Rui Patrício,POR,GK,Wolves,Premier League,32,1988,37.0,0,0,0,0,0,0,1,0.0,1,0,0,0,1,1,3,3,0,2020-2021,90.0,2.4324324324324325,0.0
2010,Paulinho,BRA,FW,Leverkusen,Bundesliga,20,2000,0.7,0,0,0,0,0,0,0,0.0,0,0,0,0,0,0,0,0,0,2020-2021,90.0,0.0,0.0
2011,Gabriel Paulista,BRA,DF,Valencia,La Liga,29,1990,30.2,17,11,9,5,3,6,17,35.3,11,32,27,5,59,76,132,3,0,2020-2021,90.0,175.82781456953643,50.66225165562914
2012,Benjamin Pavard,FRA,DF,Bayern Munich,Bundesliga,24,1996,21.6,44,27,20,16,8,23,40,57.5,17,29,5,24,48,92,31,1,0,2020-2021,90.0,199.99999999999997,183.33333333333331
2013,Jiří Pavlenka,CZE,GK,Werder Bremen,Bundesliga,28,1992,34.0,2,0,2,0,0,2,2,100.0,0,0,0,0,1,3,17,4,0,2020-2021,90.0,2.6470588235294117,5.294117647058823
2014,Vasileios Pavlidis,GRE,FW,Schalke 04,Bundesliga,17,2002,0.0,0,0,0,0,0,0,0,0.0,0,0,0,0,0,0,0,0,0,2020-2021,,,
2015,Mateo Pavlović,BIH,DF,Angers,Ligue 1,30,1990,12.3,11,6,8,3,0,8,23,34.8,15,13,11,2,21,32,40,0,0,2020-2021,89.99999999999999,153.65853658536582,80.48780487804876
2016,Strahinja Pavlović,SRB,DF,Monaco,Ligue 1,19,2001,0.0,0,0,0,0,0,0,0,0.0,0,0,0,0,0,0,0,0,0,2020-2021,,,
2017,Leonardo Pavoletti,ITA,FW,Cagliari,Serie A,31,1988,17.6,7,3,2,5,0,1,20,5.0,19,4,2,2,4,11,32,0,0,2020-2021,90.0,20.454545454545453,35.79545454545455
2018,Dimitri Payet,FRA,"FW,MF",Marseille,Ligue 1,33,1987,26.9,27,17,4,16,7,17,40,42.5,23,19,2,17,8,35,10,0,0,2020-2021,90.0,26.765799256505577,90.33457249070632
2019,Nehuén Paz,ARG,DF,Bologna,Serie A,27,1993,4.0,9,4,4,5,0,6,7,85.7,1,4,2,2,11,20,16,0,0,2020-2021,90.0,247.5,202.5
2020,Bailey Peacock-Farrell,NIR,GK,Burnley,Premier League,23,1996,4.0,0,0,0,0,0,0,0,0.0,0,0,0,0,0,0,0,0,0,2020-2021,90.0,0.0,0.0
2021,Mads Pedersen,DEN,DF,Augsburg,Bundesliga,23,1996,9.9,25,16,20,3,2,10,22,45.5,12,13,3,10,15,40,32,0,0,2020-2021,90.0,136.36363636363637,227.27272727272728
2022,Alfonso Pedraza,ESP,DF,Villarreal,La Liga,24,1996,23.3,35,19,16,11,8,11,31,35.5,20,21,5,16,34,69,47,1,0,2020-2021,90.0,131.3304721030043,135.1931330472103
2023,Pedri,ESP,MF,Barcelona,La Liga,17,2002,26.8,44,27,16,16,12,17,71,23.9,54,46,1,45,33,77,7,0,0,2020-2021,90.0,110.82089552238804,147.76119402985074
2024,Pedro,ESP,"MF,FW",Roma,Serie A,33,1987,17.7,22,14,6,11,5,7,35,20.0,28,10,0,10,9,31,2,1,0,2020-2021,90.0,45.76271186440678,111.86440677966102
2025,João Pedro,ITA,"FW,MF",Cagliari,Serie A,28,1992,36.1,13,6,2,6,5,2,27,7.4,25,32,6,26,13,26,28,0,0,2020-2021,90.0,32.40997229916897,32.40997229916897
Rk,Player,Nation,Pos,Squad,Comp,0,0,90.0,0,0,3,3,3,Tkl,0,0.0,0,0,0,0,0,0,0,0,0,2020-2021,90.0,0.0,0.0
2026,Gianluca Pegolo,ITA,GK,Sassuolo,Serie A,39,1981,1.0,0,0,0,0,0,0,0,0.0,0,0,0,0,0,0,1,0,0,2020-2021,90.0,0.0,0.0
2027,Peter Pekarík,SVK,DF,Hertha BSC,Bundesliga,33,1986,18.8,24,18,17,7,0,17,31,54.8,14,19,8,11,27,51,41,0,0,2020-2021,90.0,129.25531914893617,114.89361702127658
2028,Yohann Pelé,FRA,GK,Marseille,Ligue 1,37,1982,1.0,0,0,0,0,0,0,0,0.0,0,0,0,0,0,0,0,0,0,2020-2021,90.0,0.0,0.0
2029,Graziano Pellè,ITA,FW,Parma,Serie A,35,1985,6.8,2,2,0,1,1,1,8,12.5,7,3,0,3,2,4,8,0,0,2020-2021,90.0,26.470588235294116,26.470588235294116
2030,Pietro Pellegri,ITA,"FW,MF",Monaco,Ligue 1,19,2001,2.6,2,1,0,2,0,0,0,0.0,0,1,0,1,0,2,0,0,0,2020-2021,90.0,0.0,69.23076923076923
2031,Lorenzo Pellegrini,ITA,MF,Roma,Serie A,24,1996,28.9,40,24,13,20,7,21,60,35.0,39,37,2,35,42,82,23,1,0,2020-2021,90.00000000000001,130.79584775086508,124.56747404844292
2032,Luca Pellegrini,ITA,"DF,MF",Genoa,Serie A,21,1999,7.1,9,6,6,2,1,4,10,40.0,6,11,2,9,8,17,13,1,0,2020-2021,90.0,101.40845070422536,114.08450704225353
2033,Facundo Pellistri,URU,"MF,FW",Alavés,La Liga,18,2001,6.0,8,5,2,4,2,3,13,23.1,10,0,0,0,4,12,3,0,0,2020-2021,90.0,60.0,120.0
2034,Andy Pelmard,FRA,DF,Nice,Ligue 1,20,2000,13.4,18,12,12,5,1,9,12,75.0,3,11,3,8,20,38,35,0,0,2020-2021,90.0,134.32835820895522,120.89552238805969
2035,Lee Peltier,ENG,DF,West Brom,Premier League,33,1986,2.5,9,4,8,1,0,4,4,100.0,0,1,1,0,1,10,11,0,0,2020-2021,90.0,36.0,324.0
2036,Federico Peluso,ITA,DF,Sassuolo,Serie A,36,1984,2.3,1,1,1,0,0,1,2,50.0,1,2,2,0,3,4,12,0,0,2020-2021,90.0,117.3913043478261,39.130434782608695
2037,Timothee Pembele,FRA,DF,Paris S-G,Ligue 1,17,2002,4.3,8,7,4,4,0,5,14,35.7,9,4,0,4,5,13,8,1,0,2020-2021,90.0,104.65116279069768,167.4418604651163
2038,Rubén Peña,ESP,DF,Villarreal,La Liga,29,1991,12.4,25,14,8,15,2,19,33,57.6,14,20,1,19,13,38,19,0,0,2020-2021,90.0,94.35483870967742,181.4516129032258
2039,Philipp Pentke,GER,GK,Hoffenheim,Bundesliga,35,1985,3.0,0,0,0,0,0,0,0,0.0,0,0,0,0,0,0,0,0,0,2020-2021,90.0,0.0,0.0
2040,Nicolas Pépé,CIV,FW,Arsenal,Premier League,25,1995,18.0,20,15,8,6,6,8,23,34.8,15,16,1,15,12,32,19,0,0,2020-2021,90.0,60.0,100.0
2041,Alberto Perea,ESP,MF,Cádiz,La Liga,29,1990,17.2,28,17,12,10,6,9,35,25.7,26,26,1,25,21,49,9,0,0,2020-2021,90.0,109.88372093023257,146.51162790697677
2042,Andreas Pereira,BRA,"FW,MF",Lazio,Serie A,24,1996,6.0,5,0,1,3,1,2,12,16.7,10,6,0,6,1,6,4,0,0,2020-2021,90.0,15.0,75.0
2043,Danilo Pereira,POR,"MF,DF",Paris S-G,Ligue 1,28,1991,15.9,21,11,6,11,4,6,14,42.9,8,14,6,8,29,50,33,4,0,2020-2021,90.0,164.1509433962264,118.86792452830188
2044,Mathias Pereira Lage,POR,"FW,MF",Angers,Ligue 1,23,1996,16.3,29,17,12,15,2,10,40,25.0,30,21,4,17,15,44,16,0,0,2020-2021,90.0,82.82208588957056,160.12269938650306
2045,Matheus Pereira,POR,"MF,FW",West Brom,Premier League,24,1996,28.6,26,15,14,10,2,12,54,22.2,42,18,0,18,29,55,16,0,0,2020-2021,90.0,91.25874125874127,81.81818181818183
2046,Pedro Pereira,POR,DF,Crotone,Serie A,22,1998,28.3,50,32,29,17,4,21,40,52.5,19,33,11,22,19,69,61,0,0,2020-2021,90.0,60.42402826855123,159.01060070671377
2047,Ricardo Pereira,POR,"DF,FW",Leicester City,Premier League,26,1993,10.7,31,22,16,8,7,14,35,40.0,21,24,1,23,15,46,23,0,0,2020-2021,90.0,126.16822429906543,260.7476635514019
2048,Gastón Pereiro,URU,"MF,DF",Cagliari,Serie A,25,1995,3.0,3,1,2,1,0,1,2,50.0,1,2,0,2,1,4,2,1,0,2020-2021,90.0,30.0,90.0
2049,Bruno Peres,BRA,DF,Roma,Serie A,30,1990,15.9,21,11,11,7,3,13,24,54.2,11,18,4,14,27,48,11,0,0,2020-2021,90.0,152.83018867924528,118.86792452830188
2050,Roberto Pereyra,ARG,"MF,FW",Udinese,Serie A,29,1991,32.5,18,11,7,8,3,7,23,30.4,16,24,5,19,27,45,24,0,0,2020-2021,90.0,74.76923076923077,49.84615384615385
Rk,Player,Nation,Pos,Squad,Comp,0,0,90.0,0,0,3,3,3,Tkl,0,0.0,0,0,0,0,0,0,0,0,0,2020-2021,90.0,0.0,0.0
2051,Ayoze Pérez,ESP,"MF,FW",Leicester City,Premier League,27,1993,14.8,32,15,6,20,6,13,48,27.1,35,28,0,28,10,42,7,0,0,2020-2021,90.0,60.81081081081081,194.59459459459458
2052,Carles Pérez,ESP,"MF,FW",Roma,Serie A,22,1998,8.6,9,4,3,6,0,6,31,19.4,25,9,0,9,6,15,1,0,0,2020-2021,90.0,62.79069767441861,94.18604651162792
2053,Iñigo Pérez,ESP,"MF,DF",Osasuna,La Liga,32,1988,15.0,20,10,9,6,5,10,16,62.5,6,12,0,12,15,35,8,1,0,2020-2021,90.0,90.0,120.0
2054,Juan Pérez,ESP,GK,Osasuna,La Liga,24,1996,3.0,0,0,0,0,0,0,0,0.0,0,0,0,0,0,0,1,0,0,2020-2021,90.0,0.0,0.0
2055,Kike Pérez,ESP,MF,Valladolid,La Liga,23,1997,12.9,26,19,8,14,4,7,33,21.2,26,10,1,9,17,43,18,0,0,2020-2021,90.0,118.60465116279069,181.3953488372093
2056,Lucas Pérez,ESP,FW,Alavés,La Liga,31,1988,19.5,6,2,3,3,0,2,10,20.0,8,6,1,5,2,8,5,0,0,2020-2021,90.0,9.23076923076923,27.69230769230769
2057,Luis Pérez,ESP,DF,Valladolid,La Liga,25,1995,14.4,33,17,16,17,0,18,30,60.0,12,26,8,18,14,47,54,1,0,2020-2021,90.0,87.5,206.25
2058,Manuel Perez,FRA,"MF,FW",Lens,Ligue 1,29,1991,1.4,1,0,1,0,0,0,8,0.0,8,2,0,2,2,3,2,0,0,2020-2021,90.0,128.57142857142858,64.28571428571429
2059,Nehuén Pérez,ARG,DF,Granada,La Liga,20,2000,8.2,6,3,6,0,0,4,6,66.7,2,5,4,1,12,18,33,0,0,2020-2021,90.0,131.70731707317074,65.85365853658537
2060,Mattia Perin,ITA,GK,Genoa,Serie A,27,1992,32.0,0,0,0,0,0,0,0,0.0,0,0,0,0,1,1,6,0,0,2020-2021,90.0,2.8125,0.0
2061,Ivan Perišić,CRO,"DF,FW",Inter,Serie A,31,1989,19.9,22,13,11,6,5,12,33,36.4,21,33,4,29,19,41,36,1,0,2020-2021,90.0,85.92964824120604,99.49748743718594
2062,Romain Perraud,FRA,DF,Brest,Ligue 1,22,1997,34.9,60,34,42,16,2,24,45,53.3,21,36,3,33,45,105,76,0,0,2020-2021,90.0,116.04584527220631,154.72779369627509
2063,Lucas Perrin,FRA,DF,Marseille,Ligue 1,21,1998,3.4,7,4,4,3,0,5,12,41.7,7,5,4,1,8,15,16,0,0,2020-2021,90.0,211.76470588235293,185.2941176470588
2064,Pavao Pervan,AUT,GK,Wolfsburg,Bundesliga,32,1987,2.0,0,0,0,0,0,0,0,0.0,0,0,0,0,0,0,1,0,0,2020-2021,90.0,0.0,0.0
2065,Matteo Pessina,ITA,MF,Atalanta,Serie A,23,1997,18.3,14,7,4,6,4,7,24,29.2,17,17,2,15,17,31,7,1,0,2020-2021,90.0,83.60655737704919,68.85245901639344
2066,Andrea Petagna,ITA,FW,Napoli,Serie A,25,1995,10.7,2,0,0,2,0,2,7,28.6,5,4,0,4,1,3,7,0,0,2020-2021,90.0,8.41121495327103,16.82242990654206
2067,Nils Petersen,GER,FW,Freiburg,Bundesliga,31,1988,14.5,11,7,2,6,3,3,21,14.3,18,25,1,24,9,20,28,0,0,2020-2021,90.0,55.86206896551724,68.27586206896551
2068,Lukas Petkov,BUL,MF,Augsburg,Bundesliga,19,2000,0.0,0,0,0,0,0,0,0,0.0,0,0,0,0,0,0,0,0,0,2020-2021,,,
2069,Jacopo Petriccione,ITA,MF,Crotone,Serie A,25,1995,10.6,14,8,6,7,1,9,24,37.5,15,11,2,9,8,22,11,0,0,2020-2021,90.0,67.9245283018868,118.8679245283019
2070,Jens Petter Hauge,NOR,FW,Milan,Serie A,20,1999,5.9,7,4,3,3,1,6,10,60.0,4,4,0,4,1,8,3,0,0,2020-2021,90.0,15.254237288135592,106.77966101694915
2071,Germán Pezzella,ARG,DF,Fiorentina,Serie A,29,1991,30.5,34,20,22,12,0,18,32,56.3,14,26,14,12,36,70,109,1,0,2020-2021,90.0,106.22950819672131,100.327868852459
2072,Giuseppe Pezzella,ITA,DF,Parma,Serie A,22,1997,20.3,34,19,23,9,2,22,41,53.7,19,22,9,13,12,46,52,3,0,2020-2021,90.0,53.20197044334975,150.73891625615764
2073,Maximilian Philipp,GER,MF,Wolfsburg,Bundesliga,26,1994,12.3,15,6,3,6,6,5,21,23.8,16,17,0,17,6,21,3,0,0,2020-2021,89.99999999999999,43.90243902439024,109.75609756097559
2074,Rayan Philippe,FRA,FW,Dijon,Ligue 1,19,2000,1.0,3,1,1,1,1,2,2,100.0,0,0,0,0,0,3,0,0,0,2020-2021,90.0,0.0,270.0
2075,Romain Philippoteaux,FRA,"FW,MF",Nîmes,Ligue 1,32,1988,2.4,1,1,1,0,0,1,5,20.0,4,2,0,2,2,3,1,0,0,2020-2021,90.0,75.0,37.5
Rk,Player,Nation,Pos,Squad,Comp,0,0,90.0,0,0,3,3,3,Tkl,0,0.0,0,0,0,0,0,0,0,0,0,2020-2021,90.0,0.0,0.0
2076,Romain Philippoteaux,FRA,"MF,FW",Brest,Ligue 1,32,1988,6.5,11,6,6,3,2,6,9,66.7,3,4,0,4,10,21,2,0,0,2020-2021,90.00000000000001,138.46153846153848,152.30769230769232
2077,Kalvin Phillips,ENG,MF,Leeds United,Premier League,24,1995,27.0,74,38,38,29,7,26,62,41.9,36,49,14,35,45,119,53,3,0,2020-2021,90.0,150.0,246.66666666666669
2078,Matt Phillips,SCO,MF,West Brom,Premier League,29,1991,20.3,15,8,4,11,0,7,23,30.4,16,32,4,28,10,25,32,1,0,2020-2021,90.0,44.33497536945813,66.50246305418719
2079,Nathaniel Phillips,ENG,DF,Liverpool,Premier League,23,1997,16.2,22,14,15,7,0,11,24,45.8,13,17,14,3,20,42,81,0,0,2020-2021,90.0,111.11111111111111,122.22222222222223
2080,Jaden Philogene Bidace,ENG,FW,Aston Villa,Premier League,18,2002,0.0,0,0,0,0,0,0,0,0.0,0,0,0,0,0,0,0,0,0,2020-2021,,,
2081,Krzysztof Piątek,POL,FW,Hertha BSC,Bundesliga,25,1995,18.1,9,4,1,7,1,3,22,13.6,19,11,0,11,6,15,14,0,0,2020-2021,90.0,29.834254143646405,44.75138121546961
2082,Pablo Piatti,ARG,"MF,FW",Elche,La Liga,31,1989,4.0,8,6,3,3,2,3,12,25.0,9,5,0,5,2,10,1,0,0,2020-2021,90.0,45.0,180.0
2083,Cristiano Piccini,ITA,DF,Atalanta,Serie A,27,1992,0.7,1,1,1,0,0,0,1,0.0,1,1,0,1,0,1,0,0,0,2020-2021,90.0,0.0,128.57142857142858
2084,Cristiano Piccini,ITA,DF,Valencia,La Liga,27,1992,0.7,1,1,1,0,0,1,2,50.0,1,0,0,0,0,1,3,0,0,2020-2021,90.0,0.0,128.57142857142858
2085,Roberto Piccoli,ITA,FW,Spezia,Serie A,19,2001,7.8,7,3,0,4,3,2,4,50.0,2,4,0,4,2,9,5,0,0,2020-2021,90.0,23.076923076923077,80.76923076923076
2086,Jordan Pickford,ENG,GK,Everton,Premier League,26,1994,30.5,0,0,0,0,0,0,2,0.0,2,2,0,2,3,3,16,4,0,2020-2021,90.0,8.852459016393443,0.0
2087,Jérémy Pied,FRA,DF,Lille,Ligue 1,31,1989,3.5,7,0,3,3,1,4,9,44.4,5,3,1,2,6,13,8,0,0,2020-2021,90.0,154.28571428571428,180.0
2088,Amos Pieper,GER,DF,Arminia,Bundesliga,22,1998,29.8,58,32,39,17,2,20,33,60.6,13,48,35,13,66,124,160,3,0,2020-2021,90.0,199.32885906040266,175.16778523489933
2089,Ronaël Pierre-Gabriel,FRA,DF,Brest,Ligue 1,22,1998,25.6,60,40,42,16,2,35,52,67.3,17,17,7,10,30,90,57,0,0,2020-2021,90.0,105.46875,210.9375
2090,Erik Pieters,NED,"DF,MF",Burnley,Premier League,31,1988,14.1,30,21,18,9,3,19,39,48.7,20,30,9,21,12,42,34,0,0,2020-2021,89.99999999999999,76.59574468085106,191.48936170212764
2091,Tomás Pina Isla,ESP,MF,Alavés,La Liga,32,1987,28.6,39,18,18,16,5,16,42,38.1,26,28,8,20,37,76,42,0,0,2020-2021,90.0,116.43356643356644,122.72727272727273
2092,Andrea Pinamonti,ITA,FW,Inter,Serie A,21,1999,1.9,0,0,0,0,0,0,0,0.0,0,1,0,1,1,1,2,0,0,2020-2021,90.0,47.368421052631575,0.0
2093,Yeremi Pino,ESP,"FW,MF",Villarreal,La Liga,17,2002,8.9,19,11,10,7,2,8,28,28.6,20,20,1,19,9,28,8,0,0,2020-2021,90.0,91.01123595505618,192.13483146067415
2094,Carlo Pinsoglio,ITA,GK,Juventus,Serie A,30,1990,0.3,0,0,0,0,0,0,0,0.0,0,0,0,0,0,0,0,0,0,2020-2021,90.0,0.0,0.0
2095,Gerard Piqué,ESP,DF,Barcelona,La Liga,33,1987,16.5,16,11,11,5,0,9,12,75.0,3,9,4,5,26,42,46,0,0,2020-2021,90.0,141.81818181818184,87.27272727272728
2096,Fabio Pisacane,ITA,DF,Cagliari,Serie A,34,1986,2.5,3,2,2,1,0,3,7,42.9,4,8,5,3,1,4,9,1,0,2020-2021,90.0,36.0,108.0
2097,Łukasz Piszczek,POL,DF,Dortmund,Bundesliga,35,1985,5.1,10,7,6,4,0,5,12,41.7,7,5,1,4,5,15,12,0,0,2020-2021,90.0,88.23529411764706,176.47058823529412
2098,Marko Pjaca,CRO,"FW,MF",Genoa,Serie A,25,1995,15.8,13,6,6,3,4,4,16,25.0,12,7,2,5,7,20,12,0,0,2020-2021,90.0,39.87341772151898,74.0506329113924
2099,Miralem Pjanić,BIH,MF,Barcelona,La Liga,30,1990,7.0,13,8,7,4,2,7,13,53.8,6,5,1,4,11,24,5,0,0,2020-2021,90.0,141.42857142857142,167.14285714285714
2100,Óscar Plano,ESP,"MF,FW",Valladolid,La Liga,29,1991,28.0,42,24,24,12,6,14,46,30.4,32,35,6,29,34,76,43,0,0,2020-2021,90.0,109.28571428571428,135.0
Rk,Player,Nation,Pos,Squad,Comp,0,0,90.0,0,0,3,3,3,Tkl,0,0.0,0,0,0,0,0,0,0,0,0,2020-2021,90.0,0.0,0.0
2101,Marvin Plattenhardt,GER,DF,Hertha BSC,Bundesliga,28,1992,11.9,15,10,6,7,2,5,9,55.6,4,9,1,8,1,16,19,1,0,2020-2021,90.00000000000001,7.563025210084034,113.44537815126051
2102,Alassane Pléa,FRA,FW,Gladbach,Bundesliga,27,1993,20.0,19,9,4,10,5,5,20,25.0,15,1,0,1,5,24,7,0,0,2020-2021,90.0,22.5,85.5
2103,Dani Plomer,ESP,FW,Granada,La Liga,21,1998,0.5,0,0,0,0,0,0,1,0.0,1,0,0,0,0,0,1,0,0,2020-2021,90.0,0.0,0.0
2104,Tommaso Pobega,ITA,MF,Spezia,Serie A,21,1999,13.7,24,13,7,13,4,11,31,35.5,20,10,2,8,9,33,22,0,0,2020-2021,90.0,59.12408759124089,157.66423357664235
2105,Daniel Podence,POR,"MF,FW",Wolves,Premier League,24,1995,18.5,12,6,5,5,2,2,19,10.5,17,5,1,4,13,25,2,0,0,2020-2021,90.0,63.24324324324325,58.37837837837838
2106,Paul Pogba,FRA,"MF,FW",Manchester Utd,Premier League,27,1993,21.1,36,26,15,16,5,11,33,33.3,22,24,2,22,26,62,37,0,0,2020-2021,90.0,110.90047393364928,153.55450236966823
2107,Joel Pohjanpalo,FIN,FW,Union Berlin,Bundesliga,25,1994,9.5,5,1,0,3,2,1,6,16.7,5,1,0,1,1,6,12,0,0,2020-2021,90.0,9.473684210526315,47.36842105263158
2108,Joel Pohjanpalo,FIN,MF,Leverkusen,Bundesliga,25,1994,0.1,0,0,0,0,0,0,0,0.0,0,0,0,0,0,0,0,0,0,2020-2021,90.0,0.0,0.0
2109,Andrea Poli,ITA,MF,Bologna,Serie A,30,1989,4.3,9,7,4,2,3,6,12,50.0,6,7,1,6,7,16,7,0,0,2020-2021,90.0,146.51162790697677,188.37209302325584
2110,Matteo Politano,ITA,"FW,MF",Napoli,Serie A,26,1993,21.2,24,16,13,9,2,11,47,23.4,36,14,1,13,14,38,18,0,0,2020-2021,90.0,59.43396226415095,101.88679245283019
2111,Jorge Pombo,ESP,"FW,MF",Cádiz,La Liga,26,1994,5.8,7,3,3,2,2,1,8,12.5,7,2,0,2,2,9,3,0,0,2020-2021,90.0,31.03448275862069,108.62068965517241
2112,Marin Pongračić,CRO,DF,Wolfsburg,Bundesliga,22,1997,6.4,13,9,9,3,1,6,8,75.0,2,12,5,7,11,24,27,0,0,2020-2021,90.0,154.6875,182.8125
2113,Pere Pons,ESP,MF,Alavés,La Liga,27,1993,13.2,20,10,8,8,4,5,16,31.3,11,15,2,13,7,27,10,0,0,2020-2021,90.0,47.72727272727273,136.36363636363637
2114,Nick Pope,ENG,GK,Burnley,Premier League,28,1992,32.0,1,1,1,0,0,0,1,0.0,1,0,0,0,2,3,29,2,0,2020-2021,90.0,5.625,2.8125
2115,Manolo Portanova,ITA,"MF,FW",Genoa,Serie A,20,2000,0.7,3,3,1,1,1,0,2,0.0,2,3,1,2,1,4,2,0,0,2020-2021,90.0,128.57142857142858,385.7142857142857
2116,Manolo Portanova,ITA,MF,Juventus,Serie A,20,2000,0.8,2,0,2,0,0,0,2,0.0,2,4,1,3,0,2,1,0,0,2020-2021,90.0,0.0,225.0
2117,Francisco Portillo,ESP,"MF,FW",Getafe,La Liga,30,1990,4.6,5,3,1,4,0,2,14,14.3,12,3,0,3,5,10,1,0,0,2020-2021,90.0,97.82608695652175,97.82608695652175
2118,Portu,ESP,"FW,MF",Real Sociedad,La Liga,28,1992,24.3,18,8,4,10,4,7,36,19.4,29,24,2,22,8,26,5,0,0,2020-2021,90.0,29.629629629629626,66.66666666666666
2119,Stefan Posch,AUT,DF,Hoffenheim,Bundesliga,23,1997,23.5,52,24,29,17,6,27,47,57.4,20,27,8,19,37,89,73,1,0,2020-2021,90.0,141.70212765957447,199.14893617021275
2120,Sergio Postigo,ESP,DF,Levante,La Liga,31,1988,18.0,16,12,12,3,1,7,18,38.9,11,21,10,11,33,49,84,1,0,2020-2021,90.0,165.0,80.0
2121,Yussuf Poulsen,DEN,FW,RB Leipzig,Bundesliga,26,1994,15.0,10,6,1,6,3,1,17,5.9,16,16,0,16,6,16,13,0,0,2020-2021,90.0,36.0,60.0
2122,Maxime Poundjé,FRA,DF,Bordeaux,Ligue 1,27,1992,5.5,10,7,9,1,0,2,6,33.3,4,7,3,4,11,21,5,0,0,2020-2021,90.0,180.0,163.63636363636365
2123,Darío Poveda,ESP,FW,Getafe,La Liga,23,1997,0.1,0,0,0,0,0,0,0,0.0,0,1,0,1,0,0,0,0,0,2020-2021,90.0,0.0,0.0
2124,Ian Poveda,ENG,MF,Leeds United,Premier League,20,2000,3.9,5,4,3,0,2,1,7,14.3,6,5,1,4,1,6,2,0,0,2020-2021,90.0,23.076923076923077,115.38461538461539
2125,Alejandro Pozo Pozo,ESP,"DF,MF",Eibar,La Liga,21,1999,24.3,38,22,17,15,6,17,38,44.7,21,35,2,33,27,65,40,1,0,2020-2021,90.0,100.0,140.74074074074073
Rk,Player,Nation,Pos,Squad,Comp,0,0,90.0,0,0,3,3,3,Tkl,0,0.0,0,0,0,0,0,0,0,0,0,2020-2021,90.0,0.0,0.0
2126,Dennis Praet,BEL,MF,Leicester City,Premier League,26,1994,8.0,14,7,4,7,3,6,15,40.0,9,12,2,10,7,21,3,0,0,2020-2021,90.0,78.75,157.5
2127,Sanjin Prcić,BIH,MF,Strasbourg,Ligue 1,26,1993,3.9,3,2,0,3,0,2,5,40.0,3,4,3,1,4,7,2,1,0,2020-2021,90.0,92.3076923076923,69.23076923076923
2128,Nicolas de Préville,FRA,"FW,MF",Bordeaux,Ligue 1,29,1991,17.9,19,14,7,6,6,9,42,21.4,33,15,0,15,13,32,7,0,0,2020-2021,90.0,65.36312849162012,95.53072625698326
2129,Manuel Prietl,AUT,MF,Arminia,Bundesliga,28,1991,28.0,65,44,33,28,4,12,73,16.4,61,34,7,27,45,110,24,0,0,2020-2021,90.0,144.64285714285714,208.92857142857142
2130,Grischa Prömel,GER,MF,Union Berlin,Bundesliga,25,1995,20.2,39,23,14,23,2,18,34,52.9,16,20,2,18,24,63,22,0,0,2020-2021,90.0,106.93069306930693,173.76237623762376
2131,Davy Pröpper,NED,MF,Brighton,Premier League,28,1991,2.4,6,5,0,6,0,2,5,40.0,3,3,0,3,1,7,0,0,0,2020-2021,90.0,37.5,225.00000000000003
2132,Ivan Provedel,ITA,GK,Spezia,Serie A,26,1994,29.0,2,0,2,0,0,2,6,33.3,4,0,0,0,2,4,20,1,0,2020-2021,90.0,6.206896551724138,6.206896551724138
2133,Antonio Puertas,ESP,"FW,MF",Granada,La Liga,28,1992,24.1,27,13,9,12,6,10,32,31.3,22,24,5,19,12,39,25,0,0,2020-2021,90.0,44.81327800829875,100.8298755186722
2134,Riqui Puig,ESP,"MF,FW",Barcelona,La Liga,20,1999,3.2,5,3,1,3,1,4,8,50.0,4,0,0,0,1,6,0,0,0,2020-2021,90.0,28.125,140.625
2135,Erick Pulgar,CHI,MF,Fiorentina,Serie A,26,1994,22.2,41,18,17,23,1,22,49,44.9,27,24,10,14,41,82,45,1,0,2020-2021,90.0,166.21621621621622,166.21621621621622
2136,Jorge Pulido,ESP,DF,Huesca,La Liga,29,1991,32.1,39,24,31,8,0,17,29,58.6,12,32,18,14,52,91,98,0,0,2020-2021,90.0,145.79439252336448,109.34579439252336
2137,Christian Pulisic,USA,"FW,MF",Chelsea,Premier League,21,1998,19.3,19,11,8,10,1,8,21,38.1,13,25,2,23,12,31,9,0,0,2020-2021,90.0,55.95854922279792,88.60103626943004
2138,Ignacio Pussetto,ARG,FW,Udinese,Serie A,24,1995,8.4,16,8,5,6,5,6,17,35.3,11,14,0,14,13,29,6,0,0,2020-2021,90.0,139.28571428571428,171.42857142857142
2139,Fabio Quagliarella,ITA,FW,Sampdoria,Serie A,37,1983,24.5,12,8,4,4,4,2,19,10.5,17,14,1,13,7,19,10,0,0,2020-2021,90.00000000000001,25.714285714285715,44.08163265306123
2140,Robin Quaison,SWE,"FW,MF",Mainz 05,Bundesliga,26,1993,16.4,14,6,3,6,5,7,14,50.0,7,10,0,10,13,27,10,0,0,2020-2021,90.0,71.34146341463415,76.82926829268294
2141,Domingos Quina,POR,MF,Granada,La Liga,20,1999,3.8,5,5,1,3,1,3,6,50.0,3,8,0,8,2,7,0,0,0,2020-2021,90.0,47.368421052631575,118.42105263157895
2142,Quini,ESP,DF,Granada,La Liga,30,1989,13.2,33,22,23,7,3,19,36,52.8,17,15,6,9,15,48,39,0,0,2020-2021,90.0,102.27272727272727,225.0
2143,Quique,ESP,"FW,MF",Eibar,La Liga,30,1990,1.9,0,0,0,0,0,0,1,0.0,1,2,0,2,0,0,0,0,0,2020-2021,90.0,0.0,0.0
2144,Dani Raba,ESP,"MF,FW",Villarreal,La Liga,24,1995,1.7,2,1,0,1,1,2,8,25.0,6,1,0,1,0,2,0,0,0,2020-2021,90.0,0.0,105.88235294117646
2145,Simone Rabbi,ITA,"FW,DF",Bologna,Serie A,18,2001,0.4,0,0,0,0,0,0,1,0.0,1,0,0,0,0,0,0,0,0,2020-2021,90.0,0.0,0.0
2146,Adrien Rabiot,FRA,MF,Juventus,Serie A,25,1995,25.7,72,42,24,41,7,28,60,46.7,32,32,11,21,43,115,29,1,0,2020-2021,90.0,150.58365758754863,252.14007782101166
2147,Uroš Račić,SRB,MF,Valencia,La Liga,22,1998,24.3,38,22,16,16,6,16,54,29.6,38,33,11,22,26,64,54,0,0,2020-2021,90.0,96.29629629629629,140.74074074074073
2148,Anthony Racioppi,SUI,GK,Dijon,Ligue 1,21,1998,21.0,0,0,0,0,0,0,2,0.0,2,0,0,0,2,2,12,4,0,2020-2021,90.0,8.571428571428571,0.0
2149,Nemanja Radoja,SRB,MF,Levante,La Liga,27,1993,12.5,23,15,12,10,1,5,19,26.3,14,9,3,6,19,42,12,1,0,2020-2021,90.0,136.79999999999998,165.6
2150,Nemanja Radonjić,SRB,FW,Marseille,Ligue 1,24,1996,4.4,6,5,1,2,3,2,12,16.7,10,8,0,8,3,9,1,0,0,2020-2021,90.0,61.36363636363636,122.72727272727272
Rk,Player,Nation,Pos,Squad,Comp,0,0,90.0,0,0,3,3,3,Tkl,0,0.0,0,0,0,0,0,0,0,0,0,2020-2021,90.0,0.0,0.0
2151,Nemanja Radonjić,SRB,"FW,MF",Hertha BSC,Bundesliga,24,1996,6.8,5,3,2,2,1,1,5,20.0,4,1,0,1,2,7,1,0,0,2020-2021,90.0,26.470588235294116,66.17647058823529
2152,Aleksandar Radovanović,SRB,DF,Lens,Ligue 1,26,1993,1.0,1,1,0,1,0,0,0,0.0,0,2,1,1,0,1,2,0,0,2020-2021,90.0,0.0,90.0
2153,Ivan Radovanović,SRB,"DF,MF",Genoa,Serie A,31,1988,24.8,18,15,13,5,0,12,31,38.7,19,39,21,18,37,55,114,2,0,2020-2021,90.0,134.2741935483871,65.3225806451613
2154,Ionuț Radu,ROU,GK,Inter,Serie A,23,1997,1.5,0,0,0,0,0,0,0,0.0,0,0,0,0,0,0,1,0,0,2020-2021,90.0,0.0,0.0
2155,Ștefan Radu,ROU,DF,Lazio,Serie A,33,1986,27.3,43,24,20,19,4,25,40,62.5,15,27,14,13,45,88,73,1,0,2020-2021,90.0,148.35164835164835,141.75824175824175
2156,Rafael,BRA,GK,Spezia,Serie A,38,1982,2.3,0,0,0,0,0,0,0,0.0,0,0,0,0,0,0,0,0,0,2020-2021,90.0,0.0,0.0
2157,Rafinha,BRA,"MF,FW",Paris S-G,Ligue 1,27,1993,15.1,54,26,18,28,8,28,49,57.1,21,18,3,15,13,67,6,0,0,2020-2021,90.0,77.48344370860927,321.8543046357616
2158,Antonio Raimondo,ITA,FW,Bologna,Serie A,16,2004,0.0,0,0,0,0,0,0,0,0.0,0,0,0,0,0,0,0,0,0,2020-2021,,,
2159,Predrag Rajković,SRB,GK,Reims,Ligue 1,24,1995,36.5,2,1,2,0,0,2,5,40.0,3,1,0,1,2,4,17,3,0,2020-2021,90.0,4.931506849315069,4.931506849315069
2160,Ivan Rakitić,CRO,MF,Sevilla,La Liga,32,1988,24.8,32,18,18,10,4,12,41,29.3,29,19,4,15,26,58,29,1,0,2020-2021,90.0,94.35483870967742,116.12903225806451
2161,Jonás Ramalho,ESP,DF,Osasuna,La Liga,27,1993,3.4,5,4,4,0,1,1,3,33.3,2,3,0,3,2,7,7,0,0,2020-2021,90.0,52.94117647058823,132.35294117647058
2162,Benito Raman,BEL,"FW,MF",Schalke 04,Bundesliga,25,1994,13.8,19,13,11,6,2,6,29,20.7,23,11,0,11,5,24,5,0,0,2020-2021,90.0,32.60869565217391,123.91304347826086
2163,Gastón Ramírez,URU,"FW,MF",Sampdoria,Serie A,29,1990,10.8,31,15,10,17,4,8,27,29.6,19,19,3,16,4,35,13,0,0,2020-2021,90.0,33.33333333333333,258.3333333333333
2164,Sandro Ramírez,ESP,FW,Huesca,La Liga,25,1995,14.3,13,9,3,8,2,4,11,36.4,7,11,1,10,10,23,2,0,0,2020-2021,90.0,62.93706293706294,81.81818181818183
2165,Sergio Ramos,ESP,DF,Real Madrid,La Liga,34,1986,14.2,15,12,8,6,1,6,10,60.0,4,9,5,4,19,34,39,1,0,2020-2021,90.0,120.42253521126761,95.07042253521128
2166,Aaron Ramsdale,ENG,GK,Sheffield Utd,Premier League,22,1998,38.0,1,1,1,0,0,1,1,100.0,0,0,0,0,2,3,22,6,0,2020-2021,90.0,4.7368421052631575,2.3684210526315788
2167,Aaron Ramsey,WAL,MF,Juventus,Serie A,29,1990,12.1,22,14,8,13,1,8,25,32.0,17,13,2,11,7,29,8,2,0,2020-2021,90.0,52.06611570247934,163.63636363636363
2168,Jacob Ramsey,ENG,MF,Aston Villa,Premier League,19,2001,7.0,10,5,3,4,3,2,12,16.7,10,13,6,7,4,14,5,0,0,2020-2021,90.0,51.42857142857143,128.57142857142856
2169,Kayne Ramsey,ENG,DF,Southampton,Premier League,19,2000,1.0,5,2,4,1,0,3,3,100.0,0,0,0,0,0,5,3,0,0,2020-2021,90.0,0.0,450.0
2170,Darren Randolph,IRL,GK,West Ham,Premier League,33,1987,3.0,0,0,0,0,0,0,0,0.0,0,0,0,0,0,0,1,0,0,2020-2021,90.0,0.0,0.0
2171,Andrea Ranocchia,ITA,DF,Inter,Serie A,32,1988,7.8,13,10,6,6,1,7,8,87.5,1,5,3,2,12,25,19,0,0,2020-2021,90.0,138.46153846153845,150.0
2172,Raphinha,BRA,"MF,FW",Leeds United,Premier League,23,1996,26.2,34,17,13,16,5,12,58,20.7,46,31,1,30,29,63,27,0,0,2020-2021,90.0,99.61832061068702,116.79389312977099
2173,Raphinha,BRA,"FW,MF",Rennes,Ligue 1,23,1996,4.5,5,2,1,3,1,1,4,25.0,3,5,0,5,3,8,4,0,0,2020-2021,90.0,60.0,100.0
2174,Marcus Rashford,ENG,FW,Manchester Utd,Premier League,22,1997,32.4,18,9,2,8,8,7,27,25.9,20,22,2,20,8,26,10,0,0,2020-2021,90.0,22.22222222222222,50.0
2175,Milot Rashica,KVX,"FW,MF",Werder Bremen,Bundesliga,24,1996,16.2,24,12,11,11,2,12,23,52.2,11,7,0,7,4,28,6,0,0,2020-2021,90.0,22.22222222222222,133.33333333333334
Rk,Player,Nation,Pos,Squad,Comp,0,0,90.0,0,0,3,3,3,Tkl,0,0.0,0,0,0,0,0,0,0,0,0,2020-2021,90.0,0.0,0.0
2176,Giacomo Raspadori,ITA,"FW,MF",Sassuolo,Serie A,20,2000,13.7,5,3,1,1,3,0,4,0.0,4,13,5,8,2,7,9,0,0,2020-2021,90.0,13.138686131386862,32.846715328467155
2177,Federico Ravaglia,ITA,GK,Bologna,Serie A,20,1999,4.0,0,0,0,0,0,0,1,0.0,1,0,0,0,0,0,2,0,0,2020-2021,90.0,0.0,0.0
2178,Tim Ream,USA,DF,Fulham,Premier League,32,1987,7.0,12,5,9,3,0,8,11,72.7,3,8,5,3,6,18,26,1,0,2020-2021,90.0,77.14285714285714,154.28571428571428
2179,Ante Rebić,CRO,FW,Milan,Serie A,26,1993,19.7,26,9,4,8,14,8,37,21.6,29,21,1,20,7,33,17,0,0,2020-2021,90.0,31.97969543147208,118.78172588832487
2180,Arkadiusz Reca,POL,DF,Crotone,Serie A,25,1995,25.7,34,16,15,11,8,10,45,22.2,35,30,3,27,50,84,64,0,0,2020-2021,90.0,175.09727626459144,119.06614785992218
2181,Recio,ESP,MF,Eibar,La Liga,29,1991,8.2,17,5,4,8,5,8,18,44.4,10,6,0,6,4,21,1,0,0,2020-2021,90.0,43.90243902439025,186.58536585365854
2182,Daishawn Redan,NED,"FW,MF",Hertha BSC,Bundesliga,19,2001,1.1,0,0,0,0,0,0,0,0.0,0,1,0,1,0,0,0,0,0,2020-2021,90.0,0.0,0.0
2183,Nathan Redmond,ENG,"MF,FW",Southampton,Premier League,26,1994,19.3,30,17,14,12,4,8,24,33.3,16,24,2,22,11,41,9,0,0,2020-2021,90.0,51.295336787564764,139.8963730569948
2184,Harrison Reed,ENG,MF,Fulham,Premier League,25,1995,25.0,63,38,28,28,7,29,73,39.7,44,34,11,23,50,113,31,1,0,2020-2021,90.0,180.0,226.79999999999998
2185,Vasco Regini,ITA,DF,Sampdoria,Serie A,29,1990,1.0,2,2,2,0,0,2,2,100.0,0,1,1,0,1,3,5,0,0,2020-2021,90.0,90.0,180.0
2186,Sergio Reguilón,ESP,DF,Tottenham,Premier League,23,1996,24.9,47,25,30,13,4,23,48,47.9,25,39,7,32,32,79,50,1,0,2020-2021,90.0,115.66265060240964,169.87951807228916
2187,Bobby Reid,JAM,"MF,FW",Fulham,Premier League,27,1993,26.4,31,15,17,10,4,18,39,46.2,21,19,5,14,21,52,39,0,0,2020-2021,90.0,71.5909090909091,105.68181818181819
2188,Pepe Reina,ESP,GK,Lazio,Serie A,37,1982,29.0,0,0,0,0,0,0,1,0.0,1,0,0,0,1,1,6,0,0,2020-2021,90.0,3.103448275862069,0.0
2189,Jeff Reine-Adélaïde,FRA,"MF,FW",Nice,Ligue 1,22,1998,11.8,7,4,1,4,2,2,9,22.2,7,10,1,9,4,11,6,0,0,2020-2021,90.0,30.508474576271183,53.389830508474574
2190,Jeff Reine-Adélaïde,FRA,FW,Lyon,Ligue 1,22,1998,0.3,0,0,0,0,0,0,0,0.0,0,0,0,0,0,0,0,0,0,2020-2021,90.0,0.0,0.0
2191,Reinier,BRA,"MF,FW",Dortmund,Bundesliga,18,2002,2.9,9,4,6,1,2,2,4,50.0,2,4,1,3,2,11,0,0,0,2020-2021,90.0,62.06896551724138,279.3103448275862
2192,Francisco Reis Ferreira,POR,DF,Valencia,La Liga,23,1997,2.0,1,1,1,0,0,0,3,0.0,3,0,0,0,0,1,6,0,0,2020-2021,90.0,0.0,45.0
2193,Rocco Reitz,GER,MF,Gladbach,Bundesliga,18,2002,0.7,3,2,0,3,0,2,2,100.0,0,3,1,2,1,4,1,0,0,2020-2021,90.0,128.57142857142858,385.7142857142857
2194,Karim Rekik,NED,DF,Sevilla,La Liga,25,1994,7.3,7,5,2,5,0,1,4,25.0,3,8,3,5,6,13,17,0,0,2020-2021,90.0,73.97260273972603,86.3013698630137
2195,Álex Remiro,ESP,GK,Real Sociedad,La Liga,25,1995,38.0,0,0,0,0,0,0,1,0.0,1,0,0,0,3,3,14,0,0,2020-2021,90.0,7.105263157894737,0.0
2196,Panagiotis Retsos,GRE,DF,Saint-Étienne,Ligue 1,21,1998,3.0,5,3,5,0,0,3,7,42.9,4,1,1,0,3,8,12,0,0,2020-2021,90.0,90.0,150.0
2197,Marco Reus,GER,"MF,FW",Dortmund,Bundesliga,31,1989,25.3,33,16,9,16,8,9,33,27.3,24,22,2,20,14,47,13,0,0,2020-2021,89.99999999999999,49.80237154150197,117.39130434782608
2198,Elvis Rexhbeçaj,GER,"MF,FW",Köln,Bundesliga,22,1997,20.4,53,32,17,27,9,19,53,35.8,34,32,7,25,26,79,18,0,0,2020-2021,90.0,114.70588235294119,233.82352941176472
2199,Oriol Rey,ESP,MF,Valladolid,La Liga,22,1998,0.2,0,0,0,0,0,0,0,0.0,0,0,0,0,1,1,0,0,0,2020-2021,90.0,450.0,0.0
2200,Gio Reyna,USA,"MF,FW",Dortmund,Bundesliga,17,2002,22.0,24,13,9,8,7,9,25,36.0,16,14,1,13,10,34,11,0,0,2020-2021,90.0,40.909090909090914,98.18181818181819
Rk,Player,Nation,Pos,Squad,Comp,0,0,90.0,0,0,3,3,3,Tkl,0,0.0,0,0,0,0,0,0,0,0,0,2020-2021,90.0,0.0,0.0
2201,Baptiste Reynet,FRA,GK,Nîmes,Ligue 1,29,1990,38.0,2,1,2,0,0,2,4,50.0,2,1,0,1,1,3,9,2,0,2020-2021,90.0,2.3684210526315788,4.7368421052631575
2202,Bryan Reynolds,USA,DF,Roma,Serie A,19,2001,3.1,4,2,1,1,2,1,5,20.0,4,4,0,4,6,10,4,0,0,2020-2021,90.0,174.19354838709677,116.12903225806451
2203,Franck Ribéry,FRA,FW,Fiorentina,Serie A,37,1983,23.9,24,11,4,9,11,5,29,17.2,24,11,2,9,3,27,1,0,0,2020-2021,90.0,11.297071129707113,90.3765690376569
2204,Federico Ricci,ITA,FW,Sassuolo,Serie A,26,1994,0.0,0,0,0,0,0,0,0,0.0,0,0,0,0,0,0,0,0,0,2020-2021,,,
2205,Giacomo Ricci,ITA,DF,Parma,Serie A,23,1996,0.7,3,1,1,2,0,0,0,0.0,0,2,2,0,1,4,4,0,0,2020-2021,90.0,128.57142857142858,385.7142857142857
2206,Matteo Ricci,ITA,MF,Spezia,Serie A,26,1994,24.8,40,23,14,24,2,27,52,51.9,25,24,4,20,34,74,13,0,0,2020-2021,90.0,123.38709677419355,145.16129032258064
2207,Declan Rice,ENG,MF,West Ham,Premier League,21,1999,32.0,59,35,33,25,1,21,51,41.2,30,39,11,28,59,118,41,0,0,2020-2021,90.0,165.9375,165.9375
2208,Chris Richards,USA,DF,Hoffenheim,Bundesliga,20,2000,10.5,19,8,12,6,1,10,16,62.5,6,13,4,9,21,40,40,1,0,2020-2021,90.0,180.0,162.85714285714286
2209,Chris Richards,USA,DF,Bayern Munich,Bundesliga,20,2000,1.0,0,0,0,0,0,0,0,0.0,0,0,0,0,1,1,1,0,0,2020-2021,90.0,90.0,0.0
2210,Lewis Richardson,ENG,"FW,MF",Burnley,Premier League,17,2003,0.0,0,0,0,0,0,0,0,0.0,0,0,0,0,0,0,0,0,0,2020-2021,,,
2211,Richarlison,BRA,FW,Everton,Premier League,23,1997,31.8,50,32,21,22,7,16,51,31.4,35,28,3,25,14,64,36,1,0,2020-2021,90.0,39.62264150943396,141.50943396226415
2212,Marco Richter,GER,"FW,MF",Augsburg,Bundesliga,22,1997,15.7,17,9,3,12,2,7,23,30.4,16,10,0,10,6,23,9,0,0,2020-2021,90.0,34.39490445859873,97.45222929936307
2213,Mikel Rico,ESP,MF,Huesca,La Liga,35,1984,24.3,24,12,14,8,2,11,34,32.4,23,20,3,17,23,47,22,0,0,2020-2021,90.0,85.18518518518518,88.88888888888889
2214,Sergio Rico,ESP,GK,Paris S-G,Ligue 1,26,1993,9.0,0,0,0,0,0,0,0,0.0,0,0,0,0,0,0,1,0,0,2020-2021,90.0,0.0,0.0
2215,Jaïro Riedewald,NED,MF,Crystal Palace,Premier League,23,1996,20.2,34,15,13,17,4,16,36,44.4,20,39,7,32,29,63,25,0,0,2020-2021,90.0,129.2079207920792,151.4851485148515
2216,Emiliano Rigoni,ARG,MF,Elche,La Liga,27,1993,12.7,12,7,3,8,1,3,15,20.0,12,16,1,15,6,18,9,0,0,2020-2021,90.0,42.51968503937008,85.03937007874016
2217,Tomás Rincón,VEN,MF,Torino,Serie A,32,1988,31.6,68,38,27,33,8,36,71,50.7,35,32,7,25,31,99,44,0,0,2020-2021,90.0,88.29113924050633,193.67088607594934
2218,Luis Rioja,ESP,"MF,FW",Alavés,La Liga,26,1993,23.2,21,14,11,7,3,7,39,17.9,32,23,1,22,20,41,30,0,0,2020-2021,90.0,77.58620689655173,81.46551724137932
2219,Renaud Ripart,FRA,"MF,FW",Nîmes,Ligue 1,27,1993,33.9,52,30,25,19,8,26,84,31.0,58,58,12,46,36,88,53,0,0,2020-2021,90.0,95.57522123893806,138.05309734513276
2220,Andrea Rispoli,ITA,DF,Crotone,Serie A,31,1988,7.2,6,3,2,3,1,2,7,28.6,5,12,3,9,5,11,15,1,0,2020-2021,90.0,62.5,75.0
2221,Mihailo Ristić,SRB,DF,Montpellier,Ligue 1,24,1995,24.8,45,22,25,13,7,28,44,63.6,16,30,9,21,26,71,57,0,0,2020-2021,90.0,94.35483870967742,163.30645161290323
2222,Matt Ritchie,SCO,"DF,MF",Newcastle Utd,Premier League,30,1989,15.0,10,3,5,3,2,3,17,17.6,14,17,2,15,12,22,47,0,0,2020-2021,90.0,72.0,60.0
2223,Maxence Rivera,FRA,"MF,FW",Saint-Étienne,Ligue 1,18,2002,2.7,12,10,6,4,2,4,10,40.0,6,5,0,5,1,13,0,0,0,2020-2021,90.0,33.33333333333333,399.99999999999994
2224,Emmanuel Rivière,FRA,FW,Crotone,Serie A,30,1990,7.1,2,1,2,0,0,0,3,0.0,3,5,1,4,1,3,0,0,0,2020-2021,90.0,12.67605633802817,25.35211267605634
2225,Rober,ESP,"DF,MF",Levante,La Liga,25,1995,15.8,14,7,8,3,3,8,18,44.4,10,24,16,8,35,49,52,1,0,2020-2021,90.0,199.36708860759492,79.74683544303797
Rk,Player,Nation,Pos,Squad,Comp,0,0,90.0,0,0,3,3,3,Tkl,0,0.0,0,0,0,0,0,0,0,0,0,2020-2021,90.0,0.0,0.0
2226,Roberto,ESP,GK,Valladolid,La Liga,34,1986,13.0,0,0,0,0,0,0,1,0.0,1,0,0,0,0,0,7,0,0,2020-2021,90.00000000000001,0.0,0.0
2227,Sergi Roberto,ESP,"DF,FW",Barcelona,La Liga,28,1992,10.5,9,6,5,2,2,7,13,53.8,6,12,6,6,10,19,20,0,0,2020-2021,90.0,85.71428571428571,77.14285714285714
2228,Tyler Roberts,WAL,"MF,FW",Leeds United,Premier League,21,1999,14.9,15,13,1,11,3,5,22,22.7,17,17,2,15,9,24,12,0,0,2020-2021,90.0,54.36241610738254,90.60402684563758
2229,Andrew Robertson,SCO,DF,Liverpool,Premier League,26,1994,37.6,46,34,23,18,5,28,57,49.1,29,39,9,30,21,67,79,1,0,2020-2021,90.0,50.26595744680851,110.1063829787234
2230,Antonee Robinson,USA,DF,Fulham,Premier League,22,1997,24.0,45,28,24,16,5,27,44,61.4,17,21,4,17,37,82,68,0,0,2020-2021,90.0,138.75,168.75
2231,Callum Robinson,IRL,"FW,MF",West Brom,Premier League,25,1995,17.3,7,5,5,1,1,3,19,15.8,16,9,0,9,7,14,8,0,0,2020-2021,90.0,36.41618497109826,36.41618497109826
2232,Jack Robinson,ENG,DF,Sheffield Utd,Premier League,26,1993,9.7,14,6,8,5,1,6,11,54.5,5,10,4,6,9,23,42,0,0,2020-2021,90.0,83.50515463917527,129.89690721649487
2233,Joel Robles,ESP,GK,Betis,La Liga,30,1990,18.0,0,0,0,0,0,0,1,0.0,1,1,0,1,0,0,11,2,0,2020-2021,90.0,0.0,0.0
2234,Hal Robson-Kanu,WAL,FW,West Brom,Premier League,31,1989,6.2,2,1,1,0,1,0,1,0.0,1,2,0,2,2,4,7,0,0,2020-2021,90.0,29.032258064516128,29.032258064516128
2235,Marc Roca,ESP,MF,Bayern Munich,Bundesliga,23,1996,2.0,2,2,0,0,2,0,4,0.0,4,4,1,3,2,4,1,0,0,2020-2021,90.0,90.0,90.0
2236,Christopher Rocchia,FRA,"DF,FW",Marseille,Ligue 1,22,1998,0.2,1,0,1,0,0,0,2,0.0,2,0,0,0,0,1,1,0,0,2020-2021,90.0,0.0,450.0
2237,Rubén Rochina,ESP,MF,Levante,La Liga,29,1991,15.6,38,28,12,23,3,12,35,34.3,23,22,2,20,22,60,7,0,0,2020-2021,90.0,126.92307692307692,219.23076923076923
2238,Marek Rodák,SVK,GK,Fulham,Premier League,23,1996,2.0,0,0,0,0,0,0,0,0.0,0,0,0,0,0,0,0,0,0,2020-2021,90.0,0.0,0.0
2239,Sebastian Rode,GER,MF,Eint Frankfurt,Bundesliga,29,1990,18.1,44,25,21,16,7,14,46,30.4,32,30,3,27,47,91,18,0,0,2020-2021,90.0,233.70165745856352,218.7845303867403
2240,Joe Rodon,WAL,DF,Tottenham,Premier League,22,1997,8.1,14,9,11,2,1,3,4,75.0,1,10,8,2,21,35,36,2,0,2020-2021,90.0,233.33333333333334,155.55555555555557
2241,Rodri,ESP,MF,Manchester City,Premier League,24,1996,30.5,72,40,24,40,8,33,66,50.0,33,23,9,14,36,108,54,3,0,2020-2021,90.0,106.22950819672131,212.45901639344262
2242,Rodri,ESP,"FW,MF",Betis,La Liga,20,2000,6.0,3,3,1,2,0,1,6,16.7,5,7,0,7,2,5,0,0,0,2020-2021,90.0,30.0,45.0
2243,Rodrigo,ESP,"MF,FW",Leeds United,Premier League,29,1991,14.3,14,7,8,3,3,4,22,18.2,18,7,0,7,5,19,16,0,0,2020-2021,90.0,31.46853146853147,88.11188811188812
2244,Kévin Rodrigues,POR,"DF,MF",Eibar,La Liga,26,1994,12.2,16,8,8,5,3,7,23,30.4,16,10,1,9,20,36,15,1,0,2020-2021,90.0,147.5409836065574,118.03278688524591
2245,Ángel Rodríguez,ESP,"FW,MF",Getafe,La Liga,33,1987,15.3,7,4,1,4,2,1,16,6.3,15,7,0,7,2,9,8,0,0,2020-2021,90.0,11.76470588235294,41.17647058823529
2246,Óscar Rodríguez Arnaiz,ESP,"MF,FW",Sevilla,La Liga,22,1998,5.7,15,9,3,8,4,6,13,46.2,7,2,0,2,10,25,1,0,0,2020-2021,90.0,157.89473684210526,236.84210526315786
2247,Guido Rodríguez,ARG,MF,Betis,La Liga,26,1994,31.8,98,56,52,40,6,40,85,47.1,45,52,14,38,68,166,58,2,0,2020-2021,90.0,192.45283018867926,277.35849056603774
2248,James Rodríguez,COL,"FW,MF",Everton,Premier League,29,1991,19.6,28,17,8,15,5,11,46,23.9,35,17,0,17,15,43,3,0,0,2020-2021,90.0,68.87755102040816,128.57142857142856
2249,Jay Rodriguez,ENG,FW,Burnley,Premier League,31,1989,14.1,25,16,5,15,5,13,28,46.4,15,25,4,21,2,27,7,0,0,2020-2021,89.99999999999999,12.76595744680851,159.57446808510636
2250,Miguel Rodríguez,ESP,"FW,DF",Celta Vigo,La Liga,17,2003,0.3,1,1,0,1,0,0,0,0.0,0,0,0,0,0,1,0,0,0,2020-2021,90.0,0.0,300.0
Rk,Player,Nation,Pos,Squad,Comp,0,0,90.0,0,0,3,3,3,Tkl,0,0.0,0,0,0,0,0,0,0,0,0,2020-2021,90.0,0.0,0.0
2251,Ricardo Rodríguez,SUI,DF,Torino,Serie A,27,1992,13.8,21,14,11,8,2,13,22,59.1,9,16,5,11,20,41,43,0,0,2020-2021,90.0,130.43478260869563,136.9565217391304
2252,Víctor Rodríguez,ESP,MF,Elche,La Liga,31,1989,4.7,4,3,3,1,0,0,9,0.0,9,5,1,4,5,9,4,0,0,2020-2021,90.0,95.74468085106382,76.59574468085106
2253,Rodrygo,BRA,FW,Real Madrid,La Liga,19,2001,10.9,15,6,10,4,1,2,17,11.8,15,15,0,15,7,22,4,0,0,2020-2021,90.0,57.798165137614674,123.8532110091743
2254,Marko Rog,CRO,MF,Cagliari,Serie A,25,1995,12.9,40,24,15,22,3,16,37,43.2,21,17,6,11,19,59,15,0,0,2020-2021,90.0,132.5581395348837,279.06976744186045
2255,Rogério,BRA,DF,Sassuolo,Serie A,22,1998,20.9,26,13,19,5,2,19,27,70.4,8,26,5,21,31,57,53,0,0,2020-2021,90.0,133.4928229665072,111.96172248803828
2256,Luis Rojas,CHI,"MF,FW",Crotone,Serie A,18,2002,1.2,1,0,0,1,0,1,2,50.0,1,2,0,2,1,2,0,0,0,2020-2021,90.0,75.0,75.0
2257,Alessio Romagnoli,ITA,DF,Milan,Serie A,25,1995,21.2,17,7,8,7,2,8,19,42.1,11,29,22,7,24,41,80,0,0,2020-2021,90.0,101.88679245283019,72.16981132075472
2258,Cristian Romero,ARG,DF,Atalanta,Serie A,22,1998,28.3,63,32,41,19,3,27,49,55.1,22,31,13,18,96,159,71,2,0,2020-2021,90.0,305.3003533568904,200.35335689045934
2259,Oriol Romeu,ESP,MF,Southampton,Premier League,28,1991,19.6,69,35,25,39,5,26,68,38.2,42,28,7,21,30,99,18,0,0,2020-2021,90.0,137.75510204081633,316.83673469387753
2260,Cristiano Ronaldo,POR,FW,Juventus,Serie A,35,1985,31.1,6,3,1,3,2,3,15,20.0,12,11,3,8,5,11,15,1,0,2020-2021,90.0,14.469453376205788,17.363344051446944
2261,Facundo Roncaglia,ARG,DF,Osasuna,La Liga,33,1987,13.7,25,14,14,11,0,11,20,55.0,9,11,6,5,25,50,26,0,0,2020-2021,90.0,164.23357664233578,164.23357664233578
2262,Valentin Rongier,FRA,MF,Marseille,Ligue 1,25,1994,21.0,93,59,31,55,7,43,85,50.6,42,32,2,30,28,121,21,1,0,2020-2021,90.0,120.0,398.57142857142856
2263,Marten de Roon,NED,MF,Atalanta,Serie A,29,1991,33.6,80,48,30,36,14,36,84,42.9,48,44,9,35,69,149,40,0,0,2020-2021,90.0,184.82142857142856,214.28571428571428
2264,Jérôme Roussillon,FRA,DF,Wolfsburg,Bundesliga,27,1993,13.7,24,12,14,8,2,11,20,55.0,9,10,1,9,19,43,28,0,0,2020-2021,90.0,124.8175182481752,157.66423357664235
2265,Nolan Roux,FRA,FW,Nîmes,Ligue 1,32,1988,7.2,7,3,1,4,2,3,8,37.5,5,6,0,6,5,12,4,0,0,2020-2021,90.0,62.5,87.5
2266,Nicolò Rovella,ITA,MF,Genoa,Serie A,18,2001,13.2,29,16,15,11,3,9,32,28.1,23,11,0,11,20,49,19,1,0,2020-2021,90.0,136.36363636363637,197.72727272727272
2267,Amir Rrahmani,KVX,DF,Napoli,Serie A,26,1994,12.2,13,8,7,6,0,6,9,66.7,3,17,14,3,8,21,39,1,0,2020-2021,90.0,59.016393442622956,95.9016393442623
2268,Rubén,ESP,GK,Osasuna,La Liga,36,1984,2.1,0,0,0,0,0,0,0,0.0,0,0,0,0,0,0,1,0,0,2020-2021,90.0,0.0,0.0
2269,Waldo Rubio,ESP,"FW,MF",Valladolid,La Liga,24,1995,4.2,6,4,2,2,2,1,14,7.1,13,6,0,6,3,9,3,0,0,2020-2021,90.0,64.28571428571428,128.57142857142856
2270,John Ruddy,ENG,GK,Wolves,Premier League,33,1986,1.0,0,0,0,0,0,0,0,0.0,0,0,0,0,0,0,0,0,0,2020-2021,90.0,0.0,0.0
2271,Antonio Rüdiger,GER,DF,Chelsea,Premier League,27,1993,19.0,31,23,16,14,1,12,15,80.0,3,17,10,7,18,49,51,0,0,2020-2021,90.0,85.26315789473684,146.8421052631579
2272,Sebastian Rudy,GER,"MF,FW",Hoffenheim,Bundesliga,30,1990,18.6,35,26,15,15,5,16,45,35.6,29,24,4,20,13,48,21,1,0,2020-2021,90.0,62.9032258064516,169.3548387096774
2273,Sebastian Rudy,GER,DF,Schalke 04,Bundesliga,30,1990,2.0,4,2,2,0,2,4,7,57.1,3,6,4,2,1,5,4,0,0,2020-2021,90.0,45.0,180.0
2274,Kevin Rüegg,SUI,"DF,MF",Hellas Verona,Serie A,21,1998,2.3,0,0,0,0,0,0,0,0.0,0,3,0,3,2,2,3,0,0,2020-2021,90.0,78.26086956521739,0.0
2275,Daniele Rugani,ITA,DF,Cagliari,Serie A,26,1994,11.1,24,11,10,12,2,10,20,50.0,10,15,10,5,15,39,46,0,0,2020-2021,90.0,121.62162162162163,194.5945945945946
Rk,Player,Nation,Pos,Squad,Comp,0,0,90.0,0,0,3,3,3,Tkl,0,0.0,0,0,0,0,0,0,0,0,0,2020-2021,90.0,0.0,0.0
2276,Daniele Rugani,ITA,DF,Rennes,Ligue 1,26,1994,1.0,0,0,0,0,0,0,1,0.0,1,1,1,0,1,1,1,0,0,2020-2021,90.0,90.0,0.0
2277,Matteo Ruggeri,ITA,DF,Atalanta,Serie A,18,2002,2.3,3,0,1,2,0,2,3,66.7,1,2,0,2,4,7,2,0,0,2020-2021,90.0,156.52173913043478,117.3913043478261
2278,Mário Rui,POR,DF,Napoli,Serie A,29,1991,18.5,24,13,17,6,1,17,33,51.5,16,17,4,13,28,52,29,1,0,2020-2021,90.0,136.21621621621622,116.75675675675676
2279,Aitor Ruibal,ESP,"FW,MF",Betis,La Liga,24,1996,17.7,32,18,14,14,4,10,35,28.6,25,26,0,26,11,43,8,0,0,2020-2021,90.0,55.93220338983051,162.71186440677968
2280,Kays Ruiz Atil,FRA,"FW,MF",Paris S-G,Ligue 1,17,2002,2.1,1,1,0,1,0,0,4,0.0,4,1,0,1,3,4,2,0,0,2020-2021,90.0,128.57142857142856,42.857142857142854
2281,Isma Ruiz,ESP,MF,Granada,La Liga,19,2001,0.7,1,0,0,1,0,0,1,0.0,1,0,0,0,0,1,3,0,0,2020-2021,90.0,0.0,128.57142857142858
2282,Fabián Ruiz Peña,ESP,MF,Napoli,Serie A,24,1996,28.5,58,31,26,21,11,25,70,35.7,45,33,3,30,36,94,32,1,0,2020-2021,90.0,113.6842105263158,183.1578947368421
2283,Víctor Ruiz,ESP,DF,Betis,La Liga,31,1989,24.0,11,7,7,4,0,4,13,30.8,9,17,13,4,44,55,85,0,0,2020-2021,90.0,165.0,41.25
2284,Gerónimo Rulli,ARG,GK,Villarreal,La Liga,28,1992,2.0,0,0,0,0,0,0,0,0.0,0,0,0,0,0,0,0,1,0,2020-2021,90.0,0.0,0.0
2285,Georginio Rutter,FRA,"FW,MF",Rennes,Ligue 1,18,2002,0.5,2,2,0,1,1,1,3,33.3,2,2,0,2,0,2,0,0,0,2020-2021,90.0,0.0,360.0
2286,Georginio Rutter,FRA,FW,Hoffenheim,Bundesliga,18,2002,2.7,4,4,2,2,0,1,2,50.0,1,2,0,2,0,4,2,0,0,2020-2021,90.0,0.0,133.33333333333331
2287,Mathew Ryan,AUS,GK,Arsenal,Premier League,28,1992,3.0,0,0,0,0,0,0,0,0.0,0,0,0,0,0,0,1,0,0,2020-2021,90.0,0.0,0.0
2288,Mathew Ryan,AUS,GK,Brighton,Premier League,28,1992,11.0,1,0,1,0,0,0,0,0.0,0,0,0,0,0,1,4,0,0,2020-2021,90.0,0.0,8.181818181818182
2289,Julian Ryerson,NOR,"DF,MF",Union Berlin,Bundesliga,22,1997,11.9,22,15,4,14,4,12,15,80.0,3,13,0,13,11,33,17,0,0,2020-2021,90.00000000000001,83.19327731092437,166.38655462184875
2290,Frederik Rønnow,DEN,GK,Schalke 04,Bundesliga,27,1992,10.5,0,0,0,0,0,0,0,0.0,0,0,0,0,1,1,9,1,0,2020-2021,90.0,8.571428571428571,0.0
2291,João Victor Santos Sá,BRA,FW,Wolfsburg,Bundesliga,26,1994,5.2,9,6,2,6,1,6,11,54.5,5,11,0,11,8,17,2,0,0,2020-2021,90.0,138.46153846153845,155.76923076923075
2292,Roli Pereira de Sa,FRA,"FW,MF",Nantes,Ligue 1,23,1996,0.6,4,3,1,3,0,3,4,75.0,1,2,0,2,0,4,0,0,0,2020-2021,90.0,0.0,600.0
2293,Idriss Saadi,ALG,"MF,FW",Strasbourg,Ligue 1,28,1992,1.4,0,0,0,0,0,0,2,0.0,2,0,0,0,0,0,0,0,0,2020-2021,90.0,0.0,0.0
2294,Youssouf Sabaly,SEN,DF,Bordeaux,Ligue 1,27,1993,32.3,47,33,24,17,6,27,45,60.0,18,31,8,23,49,96,57,2,0,2020-2021,90.0,136.5325077399381,130.95975232198143
2295,Mathys Saban,FRA,FW,Saint-Étienne,Ligue 1,18,2002,0.1,0,0,0,0,0,0,0,0.0,0,0,0,0,0,0,0,0,0,2020-2021,90.0,0.0,0.0
2296,Marcel Sabitzer,AUT,MF,RB Leipzig,Bundesliga,26,1994,22.5,29,21,12,16,1,12,37,32.4,25,7,2,5,35,64,27,0,0,2020-2021,90.0,140.0,116.0
2297,Alexis Saelemaekers,BEL,FW,Milan,Serie A,21,1999,22.4,43,26,20,18,5,19,60,31.7,41,29,1,28,25,68,6,0,0,2020-2021,90.0,100.44642857142857,172.76785714285714
2298,Modibo Sagnan,MLI,DF,Real Sociedad,La Liga,21,1999,6.9,12,7,6,6,0,4,6,66.7,2,7,2,5,6,18,25,1,0,2020-2021,90.0,78.26086956521738,156.52173913043475
2299,Allan Saint-Maximin,FRA,"FW,MF",Newcastle Utd,Premier League,23,1997,17.3,16,9,6,9,1,4,9,44.4,5,10,0,10,4,20,2,0,0,2020-2021,90.0,20.809248554913292,83.23699421965317
2300,Borja Sainz,ESP,"MF,FW",Alavés,La Liga,19,2001,5.0,7,3,3,2,2,4,16,25.0,12,4,0,4,6,13,1,0,0,2020-2021,90.0,108.0,126.0
Rk,Player,Nation,Pos,Squad,Comp,0,0,90.0,0,0,3,3,3,Tkl,0,0.0,0,0,0,0,0,0,0,0,0,2020-2021,90.0,0.0,0.0
2301,Romain Saïss,MAR,DF,Wolves,Premier League,30,1990,26.7,35,24,23,12,0,19,33,57.6,14,28,13,15,52,87,115,1,0,2020-2021,90.00000000000001,175.2808988764045,117.97752808988766
2302,Bukayo Saka,ENG,"FW,MF",Arsenal,Premier League,18,2001,28.4,25,16,10,13,2,11,40,27.5,29,21,2,19,25,50,24,0,0,2020-2021,90.0,79.22535211267606,79.22535211267606
2303,Hiroki Sakai,JPN,DF,Marseille,Ligue 1,30,1990,26.5,81,48,34,35,12,39,51,76.5,12,21,5,16,54,135,65,0,0,2020-2021,90.0,183.39622641509433,275.0943396226415
2304,Moïse Sakava,CMR,MF,Reims,Ligue 1,19,2000,0.1,0,0,0,0,0,0,0,0.0,0,0,0,0,0,0,0,0,0,2020-2021,90.0,0.0,0.0
2305,Mamadou Sakho,FRA,DF,Crystal Palace,Premier League,30,1990,3.1,3,2,1,2,0,3,3,100.0,0,3,2,1,3,6,11,0,0,2020-2021,90.0,87.09677419354838,87.09677419354838
2306,Jacopo Sala,ITA,DF,Spezia,Serie A,28,1991,4.2,17,9,14,1,2,8,22,36.4,14,5,2,3,5,22,6,0,0,2020-2021,90.0,107.14285714285714,364.2857142857143
2307,Mohamed Salah,EGY,FW,Liverpool,Premier League,28,1992,34.2,18,9,4,4,10,7,16,43.8,9,10,0,10,1,19,10,1,0,2020-2021,90.0,2.6315789473684212,47.368421052631575
2308,Eddie Salcedo,ITA,"MF,FW",Hellas Verona,Serie A,18,2001,8.4,6,2,3,2,1,3,3,100.0,0,6,0,6,6,12,6,0,0,2020-2021,90.0,64.28571428571428,64.28571428571428
2309,William Saliba,FRA,DF,Nice,Ligue 1,19,2001,20.0,15,9,8,5,2,5,6,83.3,1,17,16,1,26,41,80,2,0,2020-2021,90.0,117.0,67.5
2310,Romain Salin,FRA,GK,Rennes,Ligue 1,36,1984,15.0,0,0,0,0,0,0,1,0.0,1,0,0,0,1,1,6,3,0,2020-2021,90.0,6.0,0.0
2311,Mohammed Salisu,GHA,DF,Southampton,Premier League,21,1999,9.4,38,21,20,16,2,25,34,73.5,9,22,5,17,17,55,30,0,0,2020-2021,90.0,162.7659574468085,363.82978723404256
2312,Roland Sallai,HUN,"MF,FW",Freiburg,Bundesliga,23,1997,18.5,18,14,7,9,2,5,13,38.5,8,11,1,10,11,29,8,0,0,2020-2021,90.0,53.513513513513516,87.56756756756756
2313,Salvi,ESP,"MF,FW",Cádiz,La Liga,29,1991,21.5,18,10,14,3,1,8,26,30.8,18,14,1,13,20,38,24,0,0,2020-2021,90.0,83.72093023255813,75.34883720930232
2314,Lazar Samardzic,SRB,MF,RB Leipzig,Bundesliga,18,2002,2.2,10,7,4,6,0,5,13,38.5,8,6,0,6,2,12,1,0,0,2020-2021,90.0,81.81818181818181,409.09090909090907
2315,Diadie Samassékou,MLI,MF,Hoffenheim,Bundesliga,24,1996,28.5,71,41,22,42,7,33,90,36.7,57,41,12,29,78,149,50,0,0,2020-2021,90.0,246.31578947368422,224.21052631578948
2316,Mama Samba Baldé,GNB,FW,Dijon,Ligue 1,24,1995,24.0,23,9,4,13,6,9,22,40.9,13,16,1,15,4,27,26,0,0,2020-2021,90.0,15.0,86.25
2317,Junior Sambia,FRA,"DF,MF",Montpellier,Ligue 1,23,1996,27.2,41,29,20,14,7,26,38,68.4,12,27,14,13,39,80,46,0,0,2020-2021,90.0,129.0441176470588,135.66176470588235
2318,Frédéric Sammaritano,FRA,"FW,MF",Dijon,Ligue 1,34,1986,12.6,15,10,9,5,1,9,26,34.6,17,6,0,6,9,24,3,0,0,2020-2021,90.0,64.28571428571429,107.14285714285715
2319,Fede San Emeterio,ESP,MF,Valladolid,La Liga,23,1997,16.2,25,14,15,7,3,11,31,35.5,20,23,8,15,28,53,33,0,0,2020-2021,90.0,155.55555555555557,138.88888888888889
2320,Antonio Sanabria,PAR,FW,Torino,Serie A,24,1996,10.9,8,3,0,4,4,2,9,22.2,7,5,0,5,5,13,8,0,0,2020-2021,90.0,41.28440366972477,66.05504587155963
2321,Antonio Sanabria,PAR,FW,Betis,La Liga,24,1996,10.4,5,5,0,4,1,0,2,0.0,2,8,1,7,3,8,9,0,0,2020-2021,90.0,25.96153846153846,43.26923076923077
2322,Oihan Sancet,ESP,"FW,MF",Athletic Club,La Liga,20,2000,11.5,8,2,3,4,1,2,7,28.6,5,4,0,4,5,13,7,0,0,2020-2021,90.0,39.130434782608695,62.60869565217392
2323,Renato Sanches,POR,MF,Lille,Ligue 1,22,1997,14.1,13,7,4,8,1,5,25,20.0,20,13,2,11,13,26,8,0,0,2020-2021,89.99999999999999,82.97872340425532,82.97872340425532
2324,Ricard Sánchez,ESP,DF,Atlético Madrid,La Liga,20,2000,0.3,1,1,0,0,1,0,0,0.0,0,1,0,1,0,1,1,0,0,2020-2021,90.0,0.0,300.0
2325,Alexis Sánchez,CHI,FW,Inter,Serie A,31,1988,12.7,14,8,4,4,6,5,18,27.8,13,11,0,11,7,21,1,1,0,2020-2021,90.0,49.60629921259843,99.21259842519686
Rk,Player,Nation,Pos,Squad,Comp,0,0,90.0,0,0,3,3,3,Tkl,0,0.0,0,0,0,0,0,0,0,0,0,2020-2021,90.0,0.0,0.0
2326,Davinson Sánchez,COL,DF,Tottenham,Premier League,24,1996,16.5,40,20,31,9,0,21,32,65.6,11,18,13,5,14,54,85,2,0,2020-2021,90.0,76.36363636363637,218.1818181818182
2327,Germán Sánchez,ESP,DF,Granada,La Liga,33,1986,29.3,24,11,13,9,2,11,23,47.8,12,28,26,2,38,62,130,1,0,2020-2021,90.0,116.72354948805462,73.72013651877134
2328,Javi Sánchez,ESP,DF,Valladolid,La Liga,23,1997,10.2,15,10,10,4,1,9,10,90.0,1,15,7,8,15,30,37,0,0,2020-2021,90.0,132.3529411764706,132.3529411764706
2329,Manu Sánchez,ESP,DF,Osasuna,La Liga,19,2000,10.8,27,15,10,10,7,11,25,44.0,14,8,0,8,8,35,14,0,0,2020-2021,90.0,66.66666666666666,224.99999999999997
2330,Manu Sánchez,ESP,DF,Atlético Madrid,La Liga,19,2000,0.5,0,0,0,0,0,0,1,0.0,1,1,0,1,0,0,1,0,0,2020-2021,90.0,0.0,0.0
2331,Juan Sánchez Miño,ARG,"DF,MF",Elche,La Liga,30,1990,5.5,8,5,5,3,0,6,14,42.9,8,4,0,4,4,12,7,0,0,2020-2021,90.0,65.45454545454545,130.9090909090909
2332,Pepe Sánchez,ESP,DF,Granada,La Liga,20,2000,2.8,4,2,2,2,0,3,4,75.0,1,5,2,3,4,8,9,0,0,2020-2021,90.0,128.57142857142858,128.57142857142858
2333,Robert Sánchez,ESP,GK,Brighton,Premier League,22,1997,27.0,1,0,1,0,0,1,1,100.0,0,1,0,1,1,2,11,2,0,2020-2021,90.0,3.3333333333333335,3.3333333333333335
2334,Jadon Sancho,ENG,"FW,MF",Dortmund,Bundesliga,20,2000,22.9,18,11,4,10,4,7,16,43.8,9,20,1,19,16,34,9,0,0,2020-2021,90.0,62.882096069869,70.74235807860262
2335,Alex Sandro,BRA,DF,Juventus,Serie A,29,1991,20.6,37,23,19,13,5,13,25,52.0,12,20,4,16,31,68,57,0,0,2020-2021,90.0,135.4368932038835,161.6504854368932
2336,Leroy Sané,GER,"FW,MF",Bayern Munich,Bundesliga,24,1996,20.1,18,10,2,10,6,13,30,43.3,17,23,1,22,9,27,8,1,0,2020-2021,90.0,40.298507462686565,80.59701492537313
2337,Salif Sané,SEN,DF,Schalke 04,Bundesliga,29,1990,11.9,17,9,9,7,1,13,23,56.5,10,25,13,12,25,42,66,0,0,2020-2021,90.00000000000001,189.07563025210086,128.57142857142858
2338,Oier Sanjurjo,ESP,MF,Osasuna,La Liga,34,1986,23.2,39,16,8,27,4,17,60,28.3,43,24,6,18,29,68,41,0,0,2020-2021,90.0,112.5,151.29310344827587
2339,Mohamed Sankoh,NED,MF,Stuttgart,Bundesliga,16,2003,0.2,0,0,0,0,0,0,0,0.0,0,1,0,1,0,0,0,0,0,2020-2021,90.0,0.0,0.0
2340,Siriki Sanogo,CIV,MF,Benevento,Serie A,18,2001,0.1,0,0,0,0,0,0,0,0.0,0,0,0,0,0,0,0,0,0,2020-2021,90.0,0.0,0.0
2341,Morgan Sanson,FRA,MF,Aston Villa,Premier League,25,1994,3.3,7,4,4,2,1,1,4,25.0,3,5,0,5,4,11,1,0,0,2020-2021,90.0,109.0909090909091,190.9090909090909
2342,Morgan Sanson,FRA,MF,Marseille,Ligue 1,25,1994,9.2,21,12,6,12,3,9,28,32.1,19,12,0,12,9,30,5,0,0,2020-2021,90.0,88.04347826086958,205.43478260869566
2343,Nicola Sansone,ITA,"FW,MF",Bologna,Serie A,28,1991,13.0,22,11,7,12,3,10,31,32.3,21,15,0,15,9,31,7,0,0,2020-2021,90.00000000000001,62.307692307692314,152.30769230769232
2344,Baptiste Santamaria,FRA,MF,Angers,Ligue 1,25,1995,3.0,9,6,3,5,1,2,7,28.6,5,4,0,4,7,16,8,0,0,2020-2021,90.0,210.0,270.0
2345,Baptiste Santamaria,FRA,MF,Freiburg,Bundesliga,25,1995,24.5,51,38,19,24,8,20,54,37.0,34,36,7,29,52,103,34,1,0,2020-2021,90.00000000000001,191.02040816326533,187.3469387755102
2346,Federico Santander,PAR,FW,Bologna,Serie A,29,1991,0.4,0,0,0,0,0,0,0,0.0,0,0,0,0,0,0,0,0,0,2020-2021,90.0,0.0,0.0
2347,Davide Santon,ITA,DF,Roma,Serie A,29,1991,6.5,4,3,2,2,0,3,7,42.9,4,10,1,9,4,8,12,0,0,2020-2021,90.00000000000001,55.38461538461539,55.38461538461539
2348,Samir Santos,BRA,DF,Udinese,Serie A,25,1994,24.6,40,23,26,12,2,13,29,44.8,16,33,17,16,58,98,60,1,0,2020-2021,89.99999999999999,212.19512195121948,146.34146341463412
2349,Riccardo Saponara,ITA,MF,Fiorentina,Serie A,28,1991,0.6,2,1,0,2,0,1,3,33.3,2,0,0,0,1,3,0,0,0,2020-2021,90.0,150.0,300.0
2350,Riccardo Saponara,ITA,"FW,MF",Spezia,Serie A,28,1991,4.3,4,1,1,0,3,1,3,33.3,2,1,0,1,1,5,4,0,0,2020-2021,90.0,20.930232558139537,83.72093023255815
Rk,Player,Nation,Pos,Squad,Comp,0,0,90.0,0,0,3,3,3,Tkl,0,0.0,0,0,0,0,0,0,0,0,0,2020-2021,90.0,0.0,0.0
2351,Ivan Šaponjić,SRB,FW,Cádiz,La Liga,22,1997,4.3,1,0,0,1,0,0,2,0.0,2,2,0,2,1,2,4,0,0,2020-2021,90.0,20.930232558139537,20.930232558139537
2352,Pablo Sarabia,ESP,"FW,MF",Paris S-G,Ligue 1,28,1992,14.7,15,11,6,6,3,10,38,26.3,28,9,1,8,5,20,8,0,0,2020-2021,90.0,30.612244897959183,91.83673469387756
2353,Josh Sargent,USA,"FW,MF",Werder Bremen,Bundesliga,20,2000,27.8,32,19,13,13,6,13,27,48.1,14,39,4,35,17,49,36,0,0,2020-2021,90.0,55.03597122302158,103.59712230215828
2354,Bouna Sarr,SEN,DF,Marseille,Ligue 1,28,1992,0.8,1,1,0,0,1,1,1,100.0,0,1,1,0,1,2,1,0,0,2020-2021,90.0,112.5,112.5
2355,Bouna Sarr,SEN,DF,Bayern Munich,Bundesliga,28,1992,5.0,9,8,4,3,2,3,6,50.0,3,7,0,7,10,19,7,1,0,2020-2021,90.0,180.0,162.0
2356,Sidy Sarr,SEN,MF,Nîmes,Ligue 1,24,1996,5.1,10,6,4,6,0,2,5,40.0,3,1,1,0,7,17,4,0,0,2020-2021,90.0,123.52941176470588,176.47058823529412
2357,Marco Sau,ITA,"MF,FW",Benevento,Serie A,32,1987,8.7,6,2,0,6,0,1,16,6.3,15,7,0,7,5,11,3,0,0,2020-2021,90.0,51.724137931034484,62.06896551724138
2358,Téji Savanier,FRA,MF,Montpellier,Ligue 1,28,1991,24.1,49,33,16,25,8,22,73,30.1,51,28,6,22,38,87,15,0,0,2020-2021,90.0,141.90871369294607,182.9875518672199
2359,Stefan Savić,MNE,DF,Atlético Madrid,La Liga,29,1991,32.8,40,25,32,7,1,21,34,61.8,13,33,19,14,42,82,110,0,0,2020-2021,90.0,115.24390243902441,109.75609756097562
2360,Romaine Sawyers,SKN,MF,West Brom,Premier League,28,1991,16.5,30,18,16,12,2,14,43,32.6,29,20,4,16,18,48,12,3,0,2020-2021,90.0,98.18181818181819,163.63636363636365
2361,Gianluca Scamacca,ITA,FW,Genoa,Serie A,21,1999,15.0,19,10,6,7,6,7,19,36.8,12,21,4,17,9,28,12,0,0,2020-2021,90.0,54.0,114.0
2362,Dane Scarlett,ENG,FW,Tottenham,Premier League,16,2004,0.0,0,0,0,0,0,0,0,0.0,0,0,0,0,0,0,0,0,0,2020-2021,,,
2363,Fabian Schär,SUI,DF,Newcastle Utd,Premier League,28,1991,13.8,13,4,8,5,0,7,19,36.8,12,19,12,7,27,40,52,1,0,2020-2021,90.0,176.08695652173913,84.78260869565217
2364,Aurélien Scheidler,FRA,FW,Dijon,Ligue 1,22,1998,3.8,2,0,0,2,0,0,2,0.0,2,0,0,0,1,3,5,0,0,2020-2021,90.0,23.684210526315788,47.368421052631575
2365,Nicolás Schiappacasse,URU,MF,Sassuolo,Serie A,21,1999,0.2,0,0,0,0,0,0,0,0.0,0,0,0,0,0,0,0,0,0,2020-2021,90.0,0.0,0.0
2366,Pasquale Schiattarella,ITA,MF,Benevento,Serie A,33,1987,25.0,37,22,25,12,0,19,47,40.4,28,19,5,14,32,69,29,2,0,2020-2021,90.0,115.19999999999999,133.2
2367,Patrik Schick,CZE,FW,Leverkusen,Bundesliga,24,1996,20.7,7,2,0,5,2,1,4,25.0,3,5,2,3,3,10,20,0,0,2020-2021,90.0,13.043478260869566,30.434782608695656
2368,Sven Schipplock,GER,"FW,MF",Arminia,Bundesliga,31,1988,8.3,15,8,7,6,2,6,27,22.2,21,13,2,11,6,21,8,0,0,2020-2021,90.0,65.06024096385542,162.65060240963854
2369,Xaver Schlager,AUT,MF,Wolfsburg,Bundesliga,22,1997,29.2,66,40,20,38,8,22,68,32.4,46,50,6,44,54,120,38,0,0,2020-2021,90.0,166.43835616438358,203.4246575342466
2370,Keven Schlotterbeck,GER,DF,Freiburg,Bundesliga,23,1997,18.4,31,10,16,15,0,10,23,43.5,13,26,18,8,36,67,89,2,0,2020-2021,90.0,176.08695652173915,151.63043478260872
2371,Nico Schlotterbeck,GER,DF,Union Berlin,Bundesliga,20,1999,14.3,34,19,14,19,1,18,28,64.3,10,13,6,7,31,65,29,1,0,2020-2021,90.0,195.10489510489512,213.986013986014
2372,Jeffrey Schlupp,GHA,MF,Crystal Palace,Premier League,27,1992,15.9,29,16,14,12,3,6,23,26.1,17,24,8,16,22,51,16,0,0,2020-2021,90.0,124.52830188679245,164.1509433962264
2373,Kasper Schmeichel,DEN,GK,Leicester City,Premier League,33,1986,38.0,0,0,0,0,0,0,0,0.0,0,0,0,0,0,0,10,0,0,2020-2021,90.0,0.0,0.0
2374,Jonathan Schmid,FRA,"MF,DF",Freiburg,Bundesliga,30,1990,26.6,37,19,17,13,7,16,30,53.3,14,26,10,16,28,65,38,0,0,2020-2021,90.0,94.73684210526315,125.18796992481202
2375,Romano Schmid,AUT,"MF,FW",Werder Bremen,Bundesliga,20,2000,13.1,22,16,8,10,4,8,35,22.9,27,21,0,21,8,30,6,0,0,2020-2021,90.0,54.961832061068705,151.14503816793894
Rk,Player,Nation,Pos,Squad,Comp,0,0,90.0,0,0,3,3,3,Tkl,0,0.0,0,0,0,0,0,0,0,0,0,2020-2021,90.0,0.0,0.0
2376,Benno Schmitz,GER,DF,Köln,Bundesliga,25,1994,4.6,14,7,6,7,1,7,13,53.8,6,8,2,6,6,20,7,0,0,2020-2021,90.0,117.3913043478261,273.9130434782609
2377,Morgan Schneiderlin,FRA,MF,Nice,Ligue 1,30,1989,24.4,51,31,21,24,6,20,54,37.0,34,21,11,10,53,104,46,0,0,2020-2021,90.0,195.49180327868854,188.11475409836066
2378,Alessandro Schöpf,AUT,"FW,MF",Schalke 04,Bundesliga,26,1994,10.5,11,9,3,7,1,1,6,16.7,5,15,1,14,6,17,6,0,0,2020-2021,90.0,51.42857142857143,94.28571428571428
2379,Jerdy Schouten,NED,MF,Bologna,Serie A,23,1997,27.9,50,25,23,25,2,16,37,43.2,21,36,13,23,79,129,37,6,0,2020-2021,90.0,254.83870967741936,161.29032258064515
2380,Nico Schulz,GER,DF,Dortmund,Bundesliga,27,1993,6.8,9,6,4,3,2,2,11,18.2,9,12,4,8,6,15,10,0,0,2020-2021,90.0,79.41176470588235,119.11764705882352
2381,Alexander Schwolow,GER,GK,Hertha BSC,Bundesliga,28,1992,26.0,0,0,0,0,0,0,0,0.0,0,1,0,1,0,0,6,0,0,2020-2021,90.00000000000001,0.0,0.0
2382,Christopher Scott,GER,"MF,FW",Bayern Munich,Bundesliga,18,2002,0.4,2,1,0,1,1,2,2,100.0,0,0,0,0,0,2,1,0,0,2020-2021,90.0,0.0,450.0
2383,Matteo Scozzarella,ITA,MF,Parma,Serie A,32,1988,1.7,4,0,3,1,0,2,3,66.7,1,3,1,2,6,10,0,0,0,2020-2021,90.0,317.6470588235294,211.76470588235293
2384,Simone Scuffet,ITA,GK,Udinese,Serie A,24,1996,1.0,0,0,0,0,0,0,0,0.0,0,0,0,0,0,0,0,0,0,2020-2021,90.0,0.0,0.0
2385,Jacopo Segre,ITA,MF,Torino,Serie A,23,1997,2.1,5,2,2,1,2,2,5,40.0,3,0,0,0,0,5,1,0,0,2020-2021,90.0,0.0,214.28571428571428
2386,Davie Selke,GER,FW,Werder Bremen,Bundesliga,25,1995,9.0,3,2,1,1,1,0,6,0.0,6,3,2,1,1,4,7,0,0,2020-2021,90.0,10.0,30.0
2387,Malik Sellouki,FRA,"FW,MF",Nice,Ligue 1,20,2000,0.7,0,0,0,0,0,0,1,0.0,1,2,0,2,2,2,0,0,0,2020-2021,90.0,257.14285714285717,0.0
2388,Matz Sels,BEL,GK,Strasbourg,Ligue 1,28,1992,6.0,0,0,0,0,0,0,0,0.0,0,0,0,0,0,0,4,0,0,2020-2021,90.0,0.0,0.0
2389,Nélson Semedo,POR,"DF,MF",Wolves,Premier League,26,1993,33.1,85,48,53,23,9,42,72,58.3,30,30,10,20,41,126,78,2,0,2020-2021,90.0,111.48036253776434,231.11782477341387
2390,Léo Sena,BRA,MF,Spezia,Serie A,24,1995,9.8,22,12,7,10,5,12,26,46.2,14,19,4,15,11,33,5,0,0,2020-2021,90.0,101.0204081632653,202.0408163265306
2391,Stefano Sensi,ITA,MF,Inter,Serie A,24,1995,6.7,9,6,3,5,1,4,11,36.4,7,6,1,5,7,16,1,0,0,2020-2021,90.0,94.02985074626865,120.89552238805969
2392,Jaime Seoane,ESP,MF,Huesca,La Liga,23,1997,22.9,50,30,20,23,7,24,65,36.9,41,27,6,21,17,67,14,0,0,2020-2021,90.0,66.81222707423582,196.50655021834064
2393,Luigi Sepe,ITA,GK,Parma,Serie A,29,1991,36.0,0,0,0,0,0,0,2,0.0,2,0,0,0,2,2,13,2,0,2020-2021,90.0,5.0,0.0
2394,Suat Serdar,GER,MF,Schalke 04,Bundesliga,23,1997,21.7,55,35,18,33,4,17,52,32.7,35,29,4,25,23,78,21,0,0,2020-2021,90.0,95.39170506912443,228.110599078341
2395,Jean Seri,CIV,MF,Bordeaux,Ligue 1,29,1991,7.9,17,9,3,12,2,4,15,26.7,11,8,2,6,12,29,7,0,0,2020-2021,90.0,136.70886075949366,193.67088607594934
2396,Femi Seriki,ENG,MF,Sheffield Utd,Premier League,18,2002,0.0,0,0,0,0,0,0,0,0.0,0,0,0,0,0,0,0,0,0,2020-2021,,,
2397,Ryan Sessegnon,ENG,"DF,FW",Hoffenheim,Bundesliga,20,2000,17.5,47,25,26,13,8,15,34,44.1,19,26,3,23,30,77,46,0,0,2020-2021,90.0,154.28571428571428,241.71428571428572
2398,Nils Seufert,GER,"MF,FW",Arminia,Bundesliga,23,1997,3.8,12,9,2,5,5,2,8,25.0,6,3,1,2,5,17,6,0,0,2020-2021,90.0,118.42105263157895,284.2105263157895
2399,Edgar Sevikyan,ARM,MF,Levante,La Liga,18,2001,0.1,0,0,0,0,0,0,0,0.0,0,0,0,0,0,0,0,0,0,2020-2021,90.0,0.0,0.0
2400,Stephan El Shaarawy,ITA,"MF,FW",Roma,Serie A,27,1992,6.4,4,3,0,3,1,2,9,22.2,7,3,1,2,3,7,2,0,0,2020-2021,90.0,42.1875,56.25
Rk,Player,Nation,Pos,Squad,Comp,0,0,90.0,0,0,3,3,3,Tkl,0,0.0,0,0,0,0,0,0,0,0,0,2020-2021,90.0,0.0,0.0
2401,Jamie Shackleton,ENG,"MF,DF",Leeds United,Premier League,20,1999,5.1,10,6,6,4,0,4,11,36.4,7,3,1,2,9,19,3,0,0,2020-2021,90.0,158.82352941176472,176.47058823529412
2402,Xherdan Shaqiri,SUI,"MF,FW",Liverpool,Premier League,28,1991,6.2,7,4,3,1,3,2,7,28.6,5,4,0,4,2,9,0,0,0,2020-2021,90.0,29.032258064516128,101.61290322580645
2403,Billy Sharp,ENG,FW,Sheffield Utd,Premier League,34,1986,8.2,5,1,0,3,2,2,9,22.2,7,2,0,2,0,5,2,0,0,2020-2021,90.0,0.0,54.87804878048781
2404,Luke Shaw,ENG,DF,Manchester Utd,Premier League,25,1995,29.5,44,28,21,16,7,21,36,58.3,15,34,9,25,20,64,44,2,0,2020-2021,90.0,61.016949152542374,134.23728813559322
2405,Jonjo Shelvey,ENG,MF,Newcastle Utd,Premier League,28,1992,29.1,39,14,18,19,2,10,37,27.0,27,26,14,12,36,75,42,0,0,2020-2021,90.0,111.340206185567,120.61855670103091
2406,Eldor Shomurodov,UZB,FW,Genoa,Serie A,25,1995,18.6,28,14,7,13,8,9,37,24.3,28,17,2,15,6,34,11,0,0,2020-2021,90.0,29.032258064516125,135.48387096774192
2407,Shola Shoretire,ENG,FW,Manchester Utd,Premier League,16,2004,0.1,0,0,0,0,0,0,0,0.0,0,0,0,0,0,0,0,0,0,2020-2021,90.0,0.0,0.0
2408,Mahame Siby,MLI,MF,Strasbourg,Ligue 1,24,1996,0.2,0,0,0,0,0,0,1,0.0,1,0,0,0,0,0,1,0,0,2020-2021,90.0,0.0,0.0
2409,Abdoulaye Sidibé,FRA,MF,Saint-Étienne,Ligue 1,18,2002,0.1,1,1,1,0,0,1,2,50.0,1,0,0,0,0,1,0,0,0,2020-2021,90.0,0.0,900.0
2410,Djibril Sidibé,FRA,DF,Monaco,Ligue 1,28,1992,22.0,58,34,26,29,3,37,52,71.2,15,20,5,15,50,108,37,2,0,2020-2021,90.0,204.54545454545456,237.27272727272728
2411,Sidnei,BRA,DF,Betis,La Liga,30,1989,7.7,9,3,6,3,0,4,9,44.4,5,6,4,2,16,25,28,0,0,2020-2021,90.0,187.01298701298703,105.1948051948052
2412,Kaj Sierhuis,NED,"FW,MF",Reims,Ligue 1,22,1998,7.2,7,2,1,2,4,2,9,22.2,7,2,1,1,2,9,5,0,0,2020-2021,90.0,25.0,87.5
2413,Tim Siersleben,GER,DF,Wolfsburg,Bundesliga,20,2000,0.4,2,2,2,0,0,1,1,100.0,0,1,0,1,0,2,0,0,0,2020-2021,90.0,0.0,450.0
2414,Gylfi Sigurðsson,ISL,"MF,FW",Everton,Premier League,30,1989,25.0,30,20,9,14,7,13,44,29.5,31,31,2,29,34,64,21,1,0,2020-2021,90.0,122.39999999999999,108.0
2415,Luca Siligardi,ITA,"MF,FW",Crotone,Serie A,32,1988,0.5,4,2,0,3,1,1,5,20.0,4,0,0,0,0,4,0,0,0,2020-2021,90.0,0.0,720.0
2416,Luca Siligardi,ITA,"FW,MF",Parma,Serie A,32,1988,0.4,0,0,0,0,0,0,2,0.0,2,0,0,0,0,0,0,0,0,2020-2021,90.0,0.0,0.0
2417,Adrien Silva,POR,MF,Sampdoria,Serie A,31,1989,17.8,49,22,21,22,6,18,54,33.3,36,34,1,33,30,79,10,1,0,2020-2021,90.0,151.68539325842696,247.75280898876406
2418,André Silva,POR,FW,Eint Frankfurt,Bundesliga,24,1995,30.7,11,2,0,7,4,6,13,46.2,7,11,1,10,3,14,15,0,0,2020-2021,90.0,8.794788273615636,32.247557003257334
2419,Bernardo Silva,POR,"MF,FW",Manchester City,Premier League,25,1994,22.9,26,14,7,12,7,11,52,21.2,41,17,1,16,17,43,8,0,0,2020-2021,90.0,66.81222707423582,102.18340611353713
2420,Caio Henrique Oliveira Silva,BRA,DF,Monaco,Ligue 1,23,1997,26.3,50,34,25,20,5,31,51,60.8,20,20,3,17,16,66,37,0,0,2020-2021,90.0,54.752851711026615,171.10266159695817
2421,David Silva,ESP,MF,Real Sociedad,La Liga,34,1986,15.5,19,12,2,14,3,8,21,38.1,13,14,1,13,13,32,8,2,0,2020-2021,90.0,75.48387096774194,110.3225806451613
2422,Fábio Silva,POR,FW,Wolves,Premier League,18,2002,15.2,6,4,1,4,1,4,12,33.3,8,12,1,11,4,10,5,1,0,2020-2021,90.0,23.684210526315788,35.526315789473685
2423,Florent da Silva,FRA,FW,Lyon,Ligue 1,17,2003,0.0,0,0,0,0,0,0,0,0.0,0,0,0,0,0,0,0,0,0,2020-2021,,,
2424,Gabriel Silva,BRA,DF,Saint-Étienne,Ligue 1,29,1991,3.9,7,6,7,0,0,1,2,50.0,1,4,1,3,6,13,8,0,0,2020-2021,90.0,138.46153846153845,161.53846153846152
2425,Gastón Silva,URU,DF,Huesca,La Liga,26,1994,6.7,16,12,11,5,0,8,14,57.1,6,10,4,6,11,27,16,0,0,2020-2021,90.0,147.76119402985074,214.92537313432834
Rk,Player,Nation,Pos,Squad,Comp,0,0,90.0,0,0,3,3,3,Tkl,0,0.0,0,0,0,0,0,0,0,0,0,2020-2021,90.0,0.0,0.0
2426,Rui Silva,POR,GK,Granada,La Liga,26,1994,32.0,1,0,1,0,0,1,3,33.3,2,0,0,0,2,3,14,0,0,2020-2021,90.0,5.625,2.8125
2427,Thiago Silva,BRA,DF,Chelsea,Premier League,35,1984,21.5,20,12,11,8,1,14,21,66.7,7,21,13,8,33,53,86,1,0,2020-2021,90.0,138.13953488372093,83.72093023255813
2428,Marco Silvestri,ITA,GK,Hellas Verona,Serie A,29,1991,34.0,0,0,0,0,0,0,0,0.0,0,0,0,0,0,0,14,1,0,2020-2021,90.0,0.0,0.0
2429,Mohamed Simakan,FRA,DF,Strasbourg,Ligue 1,20,2000,17.9,32,22,21,6,5,9,18,50.0,9,17,11,6,31,63,41,0,0,2020-2021,90.0,155.8659217877095,160.89385474860336
2430,Giovanni Simeone,ARG,FW,Cagliari,Serie A,25,1995,19.3,24,11,2,15,7,7,31,22.6,24,23,1,22,10,34,18,0,0,2020-2021,90.0,46.6321243523316,111.91709844559584
2431,Moses Simon,NGA,"FW,MF",Nantes,Ligue 1,25,1995,25.8,27,14,11,9,7,17,36,47.2,19,24,1,23,15,42,15,1,0,2020-2021,90.0,52.325581395348834,94.18604651162791
2432,Unai Simón,ESP,GK,Athletic Club,La Liga,23,1997,37.0,1,0,1,0,0,1,2,50.0,1,0,0,0,0,1,7,7,0,2020-2021,90.0,0.0,2.4324324324324325
2433,Xavi Simons,NED,MF,Paris S-G,Ligue 1,17,2003,0.0,0,0,0,0,0,0,0,0.0,0,0,0,0,0,0,0,0,0,2020-2021,,,
2434,Jóan Símun Edmundsson,FRO,"FW,MF",Arminia,Bundesliga,29,1991,0.6,0,0,0,0,0,0,0,0.0,0,1,0,1,1,1,0,0,0,2020-2021,90.0,150.0,0.0
2435,Wilfried Singo,CIV,DF,Torino,Serie A,19,2000,20.6,29,14,16,6,7,17,33,51.5,16,13,3,10,29,58,40,0,0,2020-2021,90.0,126.69902912621359,126.69902912621359
2436,Daley Sinkgraven,NED,DF,Leverkusen,Bundesliga,25,1995,17.4,32,17,13,16,3,18,35,51.4,17,22,5,17,23,55,23,0,0,2020-2021,90.0,118.96551724137932,165.51724137931035
2437,Dimitris Siovas,GRE,DF,Huesca,La Liga,31,1988,34.1,46,24,34,10,2,20,30,66.7,10,38,17,21,62,108,125,2,0,2020-2021,90.0,163.63636363636363,121.40762463343108
2438,Tobias Sippel,GER,GK,Gladbach,Bundesliga,32,1988,3.8,0,0,0,0,0,0,0,0.0,0,0,0,0,1,1,4,0,0,2020-2021,90.0,23.684210526315788,0.0
2439,Salvatore Sirigu,ITA,GK,Torino,Serie A,33,1987,32.0,1,0,1,0,0,1,2,50.0,1,0,0,0,0,1,6,2,0,2020-2021,90.0,0.0,2.8125
2440,Issouf Sissokho,MLI,"MF,DF",Bordeaux,Ligue 1,18,2002,0.9,6,4,4,2,0,3,6,50.0,3,2,0,2,1,7,0,0,0,2020-2021,90.0,100.0,600.0
2441,Ibrahima Sissoko,MLI,MF,Strasbourg,Ligue 1,22,1997,28.7,68,48,25,35,8,28,68,41.2,40,22,5,17,48,116,44,0,0,2020-2021,90.0,150.5226480836237,213.2404181184669
2442,Moussa Sissoko,FRA,MF,Tottenham,Premier League,30,1989,17.6,22,16,19,3,0,8,20,40.0,12,11,4,7,23,45,25,0,0,2020-2021,90.0,117.61363636363636,112.5
2443,Nelson Sissoko,FRA,DF,Saint-Étienne,Ligue 1,23,1997,5.3,12,6,6,3,3,7,12,58.3,5,2,1,1,12,24,16,1,0,2020-2021,90.0,203.77358490566039,203.77358490566039
2444,Antonio Sivera,ESP,GK,Alavés,La Liga,23,1996,0.8,0,0,0,0,0,0,0,0.0,0,0,0,0,0,0,0,0,0,2020-2021,90.0,0.0,0.0
2445,Jacques Siwe,FRA,FW,Dijon,Ligue 1,19,2001,1.9,4,1,1,1,2,0,1,0.0,1,1,0,1,1,5,1,0,0,2020-2021,90.0,47.368421052631575,189.4736842105263
2446,Ellyes Skhiri,TUN,MF,Köln,Bundesliga,25,1995,30.9,83,48,44,31,8,33,65,50.8,32,49,13,36,82,165,38,2,0,2020-2021,90.0,238.83495145631068,241.747572815534
2447,Łukasz Skorupski,POL,GK,Bologna,Serie A,29,1991,28.0,1,1,1,0,0,1,4,25.0,3,0,0,0,0,1,23,5,0,2020-2021,90.0,0.0,3.2142857142857144
2448,Andreas Skov Olsen,DEN,"FW,DF",Bologna,Serie A,20,1999,13.1,19,10,11,4,4,11,21,52.4,10,15,0,15,3,22,25,0,0,2020-2021,90.0,20.610687022900763,130.5343511450382
2449,Robert Skov,DEN,"FW,MF",Hoffenheim,Bundesliga,24,1996,12.9,19,10,9,7,3,7,16,43.8,9,9,2,7,15,34,10,1,0,2020-2021,90.0,104.65116279069767,132.5581395348837
2450,Milan Škriniar,SVK,DF,Inter,Serie A,25,1995,30.9,48,32,29,16,3,23,34,67.6,11,30,19,11,30,78,89,1,0,2020-2021,90.0,87.37864077669903,139.80582524271844
Rk,Player,Nation,Pos,Squad,Comp,0,0,90.0,0,0,3,3,3,Tkl,0,0.0,0,0,0,0,0,0,0,0,0,2020-2021,90.0,0.0,0.0
2451,Steven Skrzybski,GER,"FW,DF",Schalke 04,Bundesliga,27,1992,4.7,5,4,0,5,0,1,7,14.3,6,13,1,12,5,10,1,1,0,2020-2021,90.0,95.74468085106382,95.74468085106382
2452,Petar Škuletić,SRB,"FW,MF",Montpellier,Ligue 1,30,1990,2.6,3,2,1,2,0,0,5,0.0,5,4,2,2,0,3,4,0,0,2020-2021,90.0,0.0,103.84615384615384
2453,Islam Slimani,ALG,FW,Leicester City,Premier League,32,1988,0.2,0,0,0,0,0,0,0,0.0,0,0,0,0,0,0,0,0,0,2020-2021,90.0,0.0,0.0
2454,Islam Slimani,ALG,FW,Lyon,Ligue 1,32,1988,6.4,7,5,3,1,3,3,12,25.0,9,4,1,3,1,8,6,0,0,2020-2021,90.0,14.0625,98.4375
2455,William Smallbone,IRL,MF,Southampton,Premier League,20,2000,1.9,6,3,2,4,0,1,3,33.3,2,5,0,5,2,8,1,0,0,2020-2021,90.0,94.73684210526315,284.2105263157895
2456,Chris Smalling,ENG,DF,Roma,Serie A,30,1989,12.3,14,8,5,7,2,6,10,60.0,4,17,11,6,28,42,46,1,0,2020-2021,89.99999999999999,204.87804878048777,102.43902439024389
2457,Emile Smith Rowe,ENG,"MF,FW",Arsenal,Premier League,20,2000,16.0,14,7,5,5,4,6,17,35.3,11,15,1,14,10,24,12,0,0,2020-2021,90.0,56.25,78.75
2458,Robert Snodgrass,SCO,"MF,FW",West Brom,Premier League,32,1987,5.8,17,12,12,4,1,10,16,62.5,6,11,2,9,1,18,12,0,0,2020-2021,90.0,15.517241379310345,263.7931034482759
2459,Robert Snodgrass,SCO,"FW,MF",West Ham,Premier League,32,1987,0.1,0,0,0,0,0,0,0,0.0,0,0,0,0,0,0,0,0,0,2020-2021,90.0,0.0,0.0
2460,Cédric Soares,POR,DF,Arsenal,Premier League,28,1991,8.3,12,8,6,4,2,6,21,28.6,15,6,1,5,8,20,16,1,0,2020-2021,90.0,86.74698795180721,130.12048192771084
2461,Rafa Soares,POR,DF,Eibar,La Liga,25,1995,12.6,28,17,16,8,4,15,21,71.4,6,14,4,10,20,48,32,0,0,2020-2021,90.0,142.85714285714286,200.00000000000003
2462,Rubén Sobrino,ESP,"MF,FW",Valencia,La Liga,28,1992,0.5,1,1,1,0,0,0,1,0.0,1,0,0,0,0,1,1,0,0,2020-2021,90.0,0.0,180.0
2463,Rubén Sobrino,ESP,"FW,MF",Cádiz,La Liga,28,1992,12.4,29,13,8,16,5,8,18,44.4,10,19,0,19,15,44,11,0,0,2020-2021,90.0,108.87096774193549,210.48387096774195
2464,Simon Sohm,SUI,MF,Parma,Serie A,19,2001,10.0,18,12,11,6,1,11,26,42.3,15,8,0,8,5,23,7,0,0,2020-2021,90.0,45.0,162.0
2465,Augusto Solari,ARG,MF,Celta Vigo,La Liga,28,1992,5.4,18,13,9,8,1,6,26,23.1,20,13,1,12,6,24,5,0,0,2020-2021,90.0,99.99999999999999,300.0
2466,Roberto Soldado,ESP,FW,Granada,La Liga,35,1985,16.0,7,4,1,4,2,2,11,18.2,9,8,0,8,4,11,13,1,0,2020-2021,90.0,22.5,39.375
2467,Carlos Soler,ESP,MF,Valencia,La Liga,23,1997,30.4,41,24,14,24,3,19,52,36.5,33,35,11,24,23,64,41,0,0,2020-2021,90.0,68.09210526315789,121.38157894736841
2468,Yann Sommer,SUI,GK,Gladbach,Bundesliga,31,1988,30.1,1,1,1,0,0,1,1,100.0,0,0,0,0,2,3,9,2,0,2020-2021,90.00000000000001,5.980066445182724,2.990033222591362
2469,Son,ESP,"DF,MF",Levante,La Liga,26,1994,12.3,18,10,11,6,1,9,19,47.4,10,11,2,9,12,30,20,0,0,2020-2021,89.99999999999999,87.80487804878048,131.7073170731707
2470,Brandon Soppy,FRA,DF,Rennes,Ligue 1,18,2002,6.2,21,15,16,5,0,10,16,62.5,6,3,0,3,6,27,12,0,0,2020-2021,90.0,87.09677419354838,304.83870967741933
2471,David Soria,ESP,GK,Getafe,La Liga,27,1993,28.0,2,2,2,0,0,1,3,33.3,2,0,0,0,1,3,12,0,0,2020-2021,90.0,3.2142857142857144,6.428571428571429
2472,Roberto Soriano,ITA,MF,Bologna,Serie A,29,1991,36.1,48,26,15,20,13,15,64,23.4,49,31,8,23,18,66,43,0,0,2020-2021,90.0,44.87534626038781,119.66759002770083
2473,Alberto Soro,ESP,"FW,MF",Granada,La Liga,21,1999,4.4,7,2,2,4,1,4,10,40.0,6,7,0,7,1,8,2,0,0,2020-2021,90.0,20.454545454545453,143.1818181818182
2474,Borna Sosa,CRO,"DF,FW",Stuttgart,Bundesliga,22,1998,22.7,14,10,6,6,2,8,25,32.0,17,23,4,19,31,45,74,0,0,2020-2021,89.99999999999999,122.90748898678413,55.50660792951542
2475,Hugo Sotelo,ESP,MF,Celta Vigo,La Liga,16,2003,0.0,0,0,0,0,0,0,0,0.0,0,0,0,0,0,0,0,0,0,2020-2021,,,
Rk,Player,Nation,Pos,Squad,Comp,0,0,90.0,0,0,3,3,3,Tkl,0,0.0,0,0,0,0,0,0,0,0,0,2020-2021,90.0,0.0,0.0
2476,Florian Sotoca,FRA,FW,Lens,Ligue 1,29,1990,26.8,31,20,3,20,8,6,22,27.3,16,27,0,27,9,40,24,0,0,2020-2021,90.0,30.223880597014922,104.10447761194028
2477,Riccardo Sottil,ITA,"FW,MF",Cagliari,Serie A,21,1999,13.2,7,3,2,3,2,0,7,0.0,7,4,0,4,5,12,3,0,0,2020-2021,90.0,34.09090909090909,47.72727272727273
2478,Cheick Souaré,FRA,MF,Marseille,Ligue 1,17,2002,0.1,0,0,0,0,0,0,0,0.0,0,1,1,0,1,1,0,0,0,2020-2021,90.0,900.0,0.0
2479,Tomáš Souček,CZE,MF,West Ham,Premier League,25,1995,38.0,78,41,37,36,5,28,77,36.4,49,43,18,25,62,140,107,0,0,2020-2021,90.0,146.8421052631579,184.73684210526315
2480,Rayan Souici,FRA,DF,Saint-Étienne,Ligue 1,22,1998,0.1,0,0,0,0,0,0,0,0.0,0,0,0,0,0,0,0,0,0,2020-2021,90.0,0.0,0.0
2481,Cebio Soukou,BEN,"FW,MF",Arminia,Bundesliga,27,1992,5.1,12,8,5,5,2,6,11,54.5,5,3,0,3,3,15,4,0,0,2020-2021,90.0,52.94117647058824,211.76470588235296
2482,Adama Soumaoro,FRA,DF,Bologna,Serie A,28,1992,19.5,24,14,17,7,0,6,12,50.0,6,28,23,5,20,44,72,0,0,2020-2021,90.0,92.3076923076923,110.76923076923076
2483,Adama Soumaoro,FRA,DF,Lille,Ligue 1,28,1992,1.6,1,0,0,0,1,0,0,0.0,0,1,1,0,2,3,2,0,0,2020-2021,90.0,112.5,56.25
2484,Boubakary Soumaré,FRA,MF,Lille,Ligue 1,21,1999,21.3,44,29,16,25,3,14,29,48.3,15,14,6,8,39,83,21,0,0,2020-2021,90.0,164.7887323943662,185.9154929577465
2485,Yaya Soumaré,MLI,FW,Lyon,Ligue 1,20,2000,0.0,1,1,1,0,0,1,2,50.0,1,0,0,0,2,3,0,0,0,2020-2021,,inf,inf
2486,Arnaud Souquet,FRA,DF,Montpellier,Ligue 1,28,1992,13.6,50,33,35,13,2,27,48,56.3,21,15,6,9,17,67,34,0,0,2020-2021,90.0,112.5,330.88235294117646
2487,Ansou Sow,SEN,MF,Lens,Ligue 1,20,2000,0.1,0,0,0,0,0,0,0,0.0,0,1,0,1,0,0,0,0,0,2020-2021,90.0,0.0,0.0
2488,Djibril Sow,SUI,MF,Eint Frankfurt,Bundesliga,23,1997,24.2,58,33,19,32,7,18,41,43.9,23,31,8,23,51,109,17,0,0,2020-2021,90.0,189.6694214876033,215.70247933884298
2489,Saidou Sow,GUI,DF,Saint-Étienne,Ligue 1,18,2002,11.1,23,12,17,6,0,13,19,68.4,6,12,8,4,14,37,39,1,0,2020-2021,90.0,113.51351351351353,186.4864864864865
2490,Çağlar Söyüncü,TUR,DF,Leicester City,Premier League,24,1996,20.2,27,17,13,14,0,17,30,56.7,13,12,9,3,28,55,80,1,0,2020-2021,90.0,124.75247524752476,120.29702970297029
2491,Leonardo Spinazzola,ITA,DF,Roma,Serie A,27,1993,23.6,12,6,3,9,0,8,20,40.0,12,16,1,15,25,37,31,0,0,2020-2021,90.0,95.33898305084745,45.762711864406775
2492,Marco Sportiello,ITA,GK,Atalanta,Serie A,28,1992,14.0,2,2,2,0,0,1,3,33.3,2,0,0,0,2,4,5,1,0,2020-2021,90.0,12.857142857142858,12.857142857142858
2493,Mattia Sprocati,ITA,"MF,FW",Parma,Serie A,27,1993,0.2,1,0,0,1,0,1,1,100.0,0,0,0,0,1,2,0,0,0,2020-2021,90.0,450.0,450.0
2494,Jerry St. Juste,NED,DF,Mainz 05,Bundesliga,23,1996,32.0,65,38,37,26,2,20,36,55.6,16,46,27,19,64,129,82,1,0,2020-2021,90.0,180.0,182.8125
2495,Benjamin Stambouli,FRA,"DF,MF",Schalke 04,Bundesliga,29,1990,21.7,45,29,24,18,3,15,37,40.5,22,42,14,28,49,94,45,1,0,2020-2021,90.0,203.2258064516129,186.63594470046084
2496,Josip Stanišić,CRO,DF,Bayern Munich,Bundesliga,20,2000,1.0,2,2,1,1,0,1,1,100.0,0,3,0,3,2,4,2,0,0,2020-2021,90.0,180.0,180.0
2497,Niklas Stark,GER,"DF,MF",Hertha BSC,Bundesliga,25,1995,31.0,49,28,20,27,2,13,31,41.9,18,43,16,27,42,91,101,0,0,2020-2021,90.0,121.93548387096774,142.25806451612902
2498,Renato Steffen,SUI,"FW,MF",Wolfsburg,Bundesliga,28,1991,17.4,24,15,6,12,6,13,24,54.2,11,21,2,19,22,46,15,0,0,2020-2021,90.0,113.79310344827586,124.13793103448276
2499,Zack Steffen,USA,GK,Manchester City,Premier League,25,1995,1.0,0,0,0,0,0,0,0,0.0,0,0,0,0,0,0,0,0,0,2020-2021,90.0,0.0,0.0
2500,Pascal Stenzel,GER,DF,Stuttgart,Bundesliga,24,1996,14.2,33,14,15,17,1,22,50,44.0,28,19,4,15,26,59,39,1,0,2020-2021,90.0,164.7887323943662,209.1549295774648
Rk,Player,Nation,Pos,Squad,Comp,0,0,90.0,0,0,3,3,3,Tkl,0,0.0,0,0,0,0,0,0,0,0,0,2020-2021,90.0,0.0,0.0
2501,Dale Stephens,ENG,MF,Burnley,Premier League,31,1989,2.9,11,6,2,7,2,3,6,50.0,3,3,0,3,8,19,2,0,0,2020-2021,90.0,248.27586206896552,341.3793103448276
2502,Jack Stephens,ENG,DF,Southampton,Premier League,26,1994,17.1,34,19,19,15,0,17,38,44.7,21,25,14,11,28,62,64,2,0,2020-2021,90.0,147.3684210526316,178.94736842105263
2503,Raheem Sterling,ENG,FW,Manchester City,Premier League,25,1994,28.2,21,10,5,12,4,5,12,41.7,7,15,0,15,15,36,4,0,0,2020-2021,89.99999999999999,47.87234042553191,67.02127659574468
2504,Enda Stevens,IRL,DF,Sheffield Utd,Premier League,30,1990,30.0,59,26,32,19,8,33,58,56.9,25,41,12,29,22,81,81,1,0,2020-2021,90.0,66.0,177.0
2505,Lars Stindl,GER,"MF,FW",Gladbach,Bundesliga,31,1988,21.8,24,17,3,16,5,7,32,21.9,25,26,3,23,13,37,14,0,0,2020-2021,90.0,53.6697247706422,99.08256880733944
2506,Kevin Stöger,AUT,"MF,FW",Mainz 05,Bundesliga,26,1993,6.0,12,6,2,9,1,5,16,31.3,11,5,0,5,6,18,4,0,0,2020-2021,90.0,90.0,180.0
2507,John Stones,ENG,DF,Manchester City,Premier League,26,1994,21.5,21,10,13,5,3,9,14,64.3,5,23,15,8,18,39,56,1,0,2020-2021,90.0,75.34883720930232,87.90697674418604
2508,Thomas Strakosha,ALB,GK,Lazio,Serie A,25,1995,9.0,1,1,1,0,0,0,0,0.0,0,0,0,0,1,2,4,0,0,2020-2021,90.0,10.0,10.0
2509,Tobias Strobl,GER,MF,Augsburg,Bundesliga,30,1990,20.5,21,10,12,9,0,10,30,33.3,20,21,8,13,28,49,27,0,0,2020-2021,90.0,122.92682926829268,92.19512195121952
2510,Kevin Strootman,NED,MF,Genoa,Serie A,30,1990,14.6,30,18,13,15,2,14,32,43.8,18,35,3,32,25,55,18,0,0,2020-2021,90.0,154.1095890410959,184.93150684931507
2511,Kevin Strootman,NED,"MF,FW",Marseille,Ligue 1,30,1990,2.6,9,6,5,4,0,4,8,50.0,4,5,2,3,5,14,7,0,0,2020-2021,90.0,173.07692307692307,311.5384615384615
2512,Pascal Struijk,NED,"DF,MF",Leeds United,Premier League,20,1999,23.1,49,30,28,19,2,17,28,60.7,11,35,21,14,47,96,92,0,0,2020-2021,89.99999999999999,183.1168831168831,190.90909090909088
2513,Jens Stryger Larsen,DEN,DF,Udinese,Serie A,29,1991,29.3,17,11,14,3,0,8,25,32.0,17,26,11,15,24,41,65,0,0,2020-2021,90.0,73.72013651877134,52.218430034129696
2514,Stefano Sturaro,ITA,MF,Hellas Verona,Serie A,27,1993,4.7,4,3,3,0,1,2,8,25.0,6,5,1,4,5,9,10,0,0,2020-2021,90.0,95.74468085106382,76.59574468085106
2515,Stefano Sturaro,ITA,MF,Genoa,Serie A,27,1993,4.9,11,5,3,6,2,3,15,20.0,12,5,0,5,7,18,2,0,0,2020-2021,90.0,128.57142857142856,202.0408163265306
2516,Damián Suárez,URU,DF,Getafe,La Liga,32,1988,27.0,59,39,29,23,7,30,81,37.0,51,43,2,41,31,90,42,0,0,2020-2021,90.0,103.33333333333334,196.66666666666669
2517,Denis Suárez,ESP,MF,Celta Vigo,La Liga,26,1994,31.7,64,32,22,30,12,21,94,22.3,73,30,2,28,22,86,15,2,0,2020-2021,90.0,62.46056782334385,181.70347003154575
2518,Luis Suárez,URU,FW,Atlético Madrid,La Liga,33,1987,27.9,11,7,0,4,7,3,12,25.0,9,7,0,7,5,16,13,0,0,2020-2021,90.0,16.129032258064516,35.483870967741936
2519,Marek Suchý,CZE,DF,Augsburg,Bundesliga,32,1988,3.4,4,2,1,3,0,1,2,50.0,1,3,3,0,4,8,9,0,0,2020-2021,90.0,105.88235294117646,105.88235294117646
2520,Niklas Süle,GER,DF,Bayern Munich,Bundesliga,24,1995,16.7,32,21,15,14,3,13,21,61.9,8,24,12,12,21,53,36,1,0,2020-2021,90.0,113.17365269461078,172.4550898203593
2521,Suso,ESP,FW,Sevilla,La Liga,26,1993,24.6,20,10,8,6,6,10,41,24.4,31,12,0,12,8,28,8,0,0,2020-2021,89.99999999999999,29.268292682926827,73.17073170731706
2522,Bosko Sutalo,CRO,DF,Atalanta,Serie A,20,2000,2.6,5,5,0,3,2,4,5,80.0,1,2,1,1,2,7,7,1,0,2020-2021,90.0,69.23076923076923,173.07692307692307
2523,Mattias Svanberg,SWE,MF,Bologna,Serie A,21,1999,20.6,38,17,21,9,8,16,45,35.6,29,25,4,21,30,68,25,1,0,2020-2021,90.0,131.06796116504853,166.01941747572815
2524,Abdoulaye Sylla,GUI,DF,Nantes,Ligue 1,20,2000,0.1,2,1,2,0,0,1,1,100.0,0,1,0,1,0,2,1,0,0,2020-2021,90.0,0.0,1800.0
2525,Issiaga Sylla,GUI,"DF,MF",Lens,Ligue 1,26,1994,12.4,28,20,11,17,0,11,21,52.4,10,13,3,10,16,44,21,0,0,2020-2021,90.0,116.12903225806451,203.2258064516129
Rk,Player,Nation,Pos,Squad,Comp,0,0,90.0,0,0,3,3,3,Tkl,0,0.0,0,0,0,0,0,0,0,0,0,2020-2021,90.0,0.0,0.0
2526,Eddy Sylvestre,FRA,"FW,MF",Nice,Ligue 1,20,1999,1.1,1,1,1,0,0,0,1,0.0,1,1,0,1,1,2,0,0,0,2020-2021,90.0,81.81818181818181,81.81818181818181
2527,Ádám Szalai,HUN,FW,Mainz 05,Bundesliga,32,1987,8.1,7,6,3,2,2,2,8,25.0,6,4,1,3,2,9,4,0,0,2020-2021,90.0,22.22222222222222,77.77777777777779
2528,Wojciech Szczęsny,POL,GK,Juventus,Serie A,30,1990,29.7,0,0,0,0,0,0,0,0.0,0,2,0,2,3,3,5,1,0,2020-2021,90.0,9.09090909090909,0.0
2529,Frederik Sørensen,DEN,DF,Köln,Bundesliga,28,1992,1.1,2,1,0,2,0,1,1,100.0,0,2,0,2,0,2,0,0,0,2020-2021,90.0,0.0,163.63636363636363
2530,Alexander Sørloth,NOR,FW,RB Leipzig,Bundesliga,24,1995,16.0,7,5,0,5,2,2,14,14.3,12,13,2,11,3,10,13,0,0,2020-2021,90.0,16.875,39.375
2531,Tachi,ESP,DF,Alavés,La Liga,22,1997,9.4,11,9,9,2,0,6,14,42.9,8,9,6,3,11,22,32,0,0,2020-2021,90.0,105.31914893617021,105.31914893617021
2532,Jonathan Tah,GER,DF,Leverkusen,Bundesliga,24,1996,24.7,30,17,19,9,2,11,21,52.4,10,19,12,7,33,63,89,1,0,2020-2021,90.0,120.24291497975709,109.31174089068826
2533,Waniss Taibi,FRA,MF,Angers,Ligue 1,18,2002,0.4,0,0,0,0,0,0,2,0.0,2,1,0,1,0,0,0,0,0,2020-2021,90.0,0.0,0.0
2534,Flavien Tait,FRA,"MF,FW",Rennes,Ligue 1,27,1993,15.2,26,11,11,12,3,10,32,31.3,22,17,3,14,13,39,2,0,0,2020-2021,90.0,76.97368421052632,153.94736842105263
2535,Adrien Tameze,CMR,MF,Hellas Verona,Serie A,26,1994,25.6,39,25,23,15,1,11,27,40.7,16,31,8,23,32,71,46,2,0,2020-2021,90.0,112.5,137.109375
2536,Japhet Tanganga,ENG,DF,Tottenham,Premier League,21,1999,5.4,5,4,3,2,0,1,3,33.3,2,6,5,1,3,8,15,0,0,2020-2021,90.0,49.99999999999999,83.33333333333333
2537,Renato Tapia,PER,MF,Celta Vigo,La Liga,25,1995,30.0,93,44,50,34,9,32,83,38.6,51,56,13,43,53,146,75,2,0,2020-2021,90.0,159.0,279.0
2538,Edmond Tapsoba,BFA,DF,Leverkusen,Bundesliga,21,1999,29.5,54,28,35,18,1,21,45,46.7,24,55,29,26,48,102,96,0,0,2020-2021,90.0,146.4406779661017,164.74576271186442
2539,Matt Targett,ENG,DF,Aston Villa,Premier League,24,1995,37.8,83,39,52,20,11,56,88,63.6,32,40,14,26,55,138,102,1,0,2020-2021,90.0,130.95238095238096,197.61904761904762
2540,James Tarkowski,ENG,DF,Burnley,Premier League,27,1992,36.0,66,39,52,11,3,25,49,51.0,24,54,42,12,44,110,163,1,0,2020-2021,90.0,110.0,165.0
2541,Ciprian Tătărușanu,ROU,GK,Milan,Serie A,34,1986,1.0,0,0,0,0,0,0,0,0.0,0,0,0,0,0,0,0,1,0,2020-2021,90.0,0.0,0.0
2542,Percy Tau,RSA,FW,Brighton,Premier League,26,1994,1.1,1,1,1,0,0,0,2,0.0,2,1,0,1,0,1,1,0,0,2020-2021,90.0,0.0,81.81818181818181
2543,Niklas Tauer,GER,"MF,DF",Mainz 05,Bundesliga,19,2001,0.8,1,1,0,1,0,1,2,50.0,1,3,1,2,3,4,1,0,0,2020-2021,90.0,337.5,112.5
2544,Heriberto Tavares,POR,"FW,MF",Brest,Ligue 1,23,1997,0.5,2,0,0,0,2,1,3,33.3,2,0,0,0,1,3,1,0,0,2020-2021,90.0,180.0,360.0
2545,Sidnei Tavares,POR,MF,Leicester City,Premier League,18,2001,0.9,1,1,0,1,0,0,0,0.0,0,1,1,0,0,1,0,0,0,2020-2021,90.0,0.0,100.0
2546,Tomás Tavares,POR,"MF,DF",Alavés,La Liga,19,2001,0.7,2,1,2,0,0,2,2,100.0,0,1,0,1,0,2,1,0,0,2020-2021,90.0,0.0,257.14285714285717
2547,Charlie Taylor,ENG,DF,Burnley,Premier League,26,1993,27.0,48,28,30,15,3,25,46,54.3,21,36,19,17,29,77,87,2,0,2020-2021,90.0,96.66666666666667,160.0
2548,Neil Taylor,WAL,DF,Aston Villa,Premier League,31,1989,0.2,1,1,1,0,0,0,0,0.0,0,1,0,1,0,1,0,0,0,2020-2021,90.0,0.0,450.0
2549,Allan Tchaptchet,FRA,DF,Southampton,Premier League,18,2001,0.1,0,0,0,0,0,0,0,0.0,0,0,0,0,0,0,0,0,0,2020-2021,90.0,0.0,0.0
2550,Warren Tchimbembé,CGO,"MF,FW",Metz,Ligue 1,22,1998,5.5,7,4,4,3,0,3,9,33.3,6,6,1,5,2,9,3,0,0,2020-2021,90.0,32.72727272727273,114.54545454545455
Rk,Player,Nation,Pos,Squad,Comp,0,0,90.0,0,0,3,3,3,Tkl,0,0.0,0,0,0,0,0,0,0,0,0,2020-2021,90.0,0.0,0.0
2551,Aurélien Tchouaméni,FRA,MF,Monaco,Ligue 1,20,2000,34.0,127,68,47,62,18,48,92,52.2,44,39,11,28,60,187,47,0,0,2020-2021,90.0,158.8235294117647,336.1764705882353
2552,Álvaro Tejero,ESP,DF,Eibar,La Liga,24,1996,1.2,1,1,0,0,1,1,3,33.3,2,1,0,1,3,4,6,0,0,2020-2021,90.0,225.00000000000003,75.0
2553,Nathan Tella,NGA,"FW,MF",Southampton,Premier League,21,1999,8.3,8,5,1,4,3,6,15,40.0,9,13,0,13,3,11,2,0,0,2020-2021,90.0,32.53012048192771,86.74698795180721
2554,Alex Telles,BRA,DF,Manchester Utd,Premier League,27,1992,7.7,14,7,10,3,1,8,17,47.1,9,7,2,5,16,30,20,0,0,2020-2021,90.0,187.01298701298703,163.63636363636365
2555,Andrés Tello,COL,"DF,MF",Benevento,Serie A,23,1996,4.6,9,6,8,0,1,5,20,25.0,15,8,1,7,6,15,6,0,0,2020-2021,90.0,117.3913043478261,176.08695652173915
2556,Cristian Tello,ESP,"FW,MF",Betis,La Liga,28,1991,14.3,16,10,5,9,2,4,22,18.2,18,14,0,14,11,27,8,0,0,2020-2021,90.0,69.23076923076923,100.69930069930071
2557,Lino Tempelmann,GER,MF,Freiburg,Bundesliga,21,1999,3.0,5,3,2,2,1,0,4,0.0,4,6,1,5,2,7,6,0,0,2020-2021,90.0,60.0,150.0
2558,Hidde ter Avest,NED,DF,Udinese,Serie A,23,1997,3.9,5,2,3,2,0,2,5,40.0,3,3,1,2,2,7,5,0,0,2020-2021,90.0,46.15384615384615,115.38461538461539
2559,Marc-André ter Stegen,GER,GK,Barcelona,La Liga,28,1992,31.0,0,0,0,0,0,0,2,0.0,2,0,0,0,0,0,12,2,0,2020-2021,90.0,0.0,0.0
2560,Pietro Terracciano,ITA,GK,Fiorentina,Serie A,30,1990,3.0,0,0,0,0,0,0,0,0.0,0,0,0,0,0,0,1,0,0,2020-2021,90.0,0.0,0.0
2561,Martin Terrier,FRA,"FW,MF",Rennes,Ligue 1,23,1997,27.1,33,15,5,15,13,10,36,27.8,26,23,0,23,16,49,7,0,0,2020-2021,90.0,53.13653136531365,109.5940959409594
2562,Claudio Terzi,ITA,DF,Spezia,Serie A,36,1984,20.8,34,21,19,14,1,19,28,67.9,9,23,12,11,35,69,55,1,0,2020-2021,90.0,151.44230769230768,147.1153846153846
2563,Kenny Tete,NED,"DF,MF",Fulham,Premier League,24,1995,16.5,48,30,27,16,5,10,18,55.6,8,14,5,9,27,75,49,0,0,2020-2021,90.0,147.27272727272728,261.8181818181818
2564,Kenny Tete,NED,DF,Lyon,Ligue 1,24,1995,0.2,2,0,1,1,0,0,0,0.0,0,0,0,0,2,4,0,0,0,2020-2021,90.0,900.0,900.0
2565,Cedric Teuchert,GER,"FW,MF",Union Berlin,Bundesliga,23,1997,8.4,7,5,2,4,1,3,16,18.8,13,12,0,12,5,12,6,0,0,2020-2021,90.0,53.57142857142857,75.0
2566,Florian Thauvin,FRA,"FW,MF",Marseille,Ligue 1,27,1993,30.4,40,22,14,21,5,20,54,37.0,34,26,2,24,14,54,11,0,0,2020-2021,90.0,41.44736842105263,118.42105263157895
2567,Malick Thiaw,GER,DF,Schalke 04,Bundesliga,18,2001,16.1,42,27,24,17,1,15,26,57.7,11,17,12,5,33,75,70,0,0,2020-2021,90.0,184.47204968944098,234.78260869565216
2568,Jan Thielmann,GER,"FW,MF",Köln,Bundesliga,18,2002,11.4,11,6,1,8,2,5,9,55.6,4,10,1,9,9,20,2,0,0,2020-2021,90.0,71.05263157894736,86.84210526315789
2569,Sada Thioub,SEN,"FW,MF",Angers,Ligue 1,25,1995,14.0,17,14,7,6,4,7,23,30.4,16,10,0,10,9,26,3,0,0,2020-2021,90.0,57.857142857142854,109.28571428571428
2570,Luke Thomas,ENG,DF,Leicester City,Premier League,19,2001,10.8,23,14,11,5,7,14,21,66.7,7,15,2,13,17,40,21,0,0,2020-2021,90.0,141.66666666666666,191.66666666666666
2571,Romain Thomas,FRA,DF,Angers,Ligue 1,32,1988,33.6,47,25,34,11,2,20,35,57.1,15,35,20,15,50,97,138,0,0,2020-2021,90.0,133.92857142857142,125.89285714285714
2572,Adrien Thomasson,FRA,"MF,FW",Strasbourg,Ligue 1,26,1993,29.2,36,17,8,16,12,12,58,20.7,46,44,5,39,22,58,2,0,0,2020-2021,90.0,67.8082191780822,110.95890410958904
2573,Erik Thommy,GER,"MF,DF",Stuttgart,Bundesliga,25,1994,3.5,3,1,0,3,0,0,3,0.0,3,3,0,3,3,6,4,0,0,2020-2021,90.0,77.14285714285714,77.14285714285714
2574,Morten Thorsby,NOR,MF,Sampdoria,Serie A,24,1996,29.4,76,42,32,36,8,20,60,33.3,40,51,16,35,25,101,30,0,0,2020-2021,90.0,76.53061224489797,232.6530612244898
2575,Khéphren Thuram,FRA,MF,Nice,Ligue 1,19,2001,16.6,32,16,5,21,6,9,27,33.3,18,21,9,12,18,50,22,1,0,2020-2021,90.0,97.59036144578312,173.49397590361443
Rk,Player,Nation,Pos,Squad,Comp,0,0,90.0,0,0,3,3,3,Tkl,0,0.0,0,0,0,0,0,0,0,0,0,2020-2021,90.0,0.0,0.0
2576,Marcus Thuram,FRA,"FW,MF",Gladbach,Bundesliga,22,1997,19.2,24,14,9,10,5,10,23,43.5,13,27,4,23,15,39,13,1,0,2020-2021,90.0,70.3125,112.50000000000001
2577,Cheikh Tidiane Sabaly,SEN,FW,Metz,Ligue 1,21,1999,0.1,0,0,0,0,0,0,0,0.0,0,0,0,0,0,0,0,0,0,2020-2021,90.0,0.0,0.0
2578,Youri Tielemans,BEL,MF,Leicester City,Premier League,23,1997,37.3,86,45,32,38,16,45,108,41.7,63,35,8,27,46,132,20,1,0,2020-2021,90.0,110.99195710455766,207.50670241286866
2579,Kieran Tierney,SCO,DF,Arsenal,Premier League,23,1997,25.5,27,15,5,14,8,11,31,35.5,20,31,10,21,16,43,63,0,0,2020-2021,90.0,56.470588235294116,95.29411764705883
2580,Steffen Tigges,GER,"FW,DF",Dortmund,Bundesliga,22,1998,0.6,4,4,0,1,3,2,3,66.7,1,1,0,1,0,4,1,0,0,2020-2021,90.0,0.0,600.0
2581,Guus Til,NED,FW,Freiburg,Bundesliga,22,1997,1.4,4,3,2,1,1,2,3,66.7,1,2,0,2,2,6,2,0,0,2020-2021,90.0,128.57142857142858,257.14285714285717
2582,David Timor,ESP,"MF,DF",Getafe,La Liga,30,1989,15.5,13,9,5,6,2,9,21,42.9,12,5,1,4,19,32,32,1,0,2020-2021,90.0,110.3225806451613,75.48387096774194
2583,Jean-Clair Todibo,FRA,DF,Nice,Ligue 1,20,1999,14.8,25,15,16,9,0,16,31,51.6,15,13,7,6,19,44,48,1,0,2020-2021,90.0,115.54054054054053,152.02702702702703
2584,Karl Toko Ekambi,CMR,FW,Lyon,Ligue 1,27,1992,31.2,16,10,5,3,8,8,32,25.0,24,20,1,19,26,42,8,0,0,2020-2021,90.0,75.0,46.15384615384615
2585,Corentin Tolisso,FRA,MF,Bayern Munich,Bundesliga,25,1994,8.7,19,19,4,11,4,9,29,31.0,20,15,2,13,6,25,8,0,0,2020-2021,90.0,62.06896551724138,196.55172413793105
2586,Jeremy Toljan,GER,DF,Sassuolo,Serie A,25,1994,16.6,21,12,16,3,2,12,27,44.4,15,15,7,8,13,34,28,0,0,2020-2021,90.0,70.48192771084337,113.85542168674698
2587,Rafael Tolói,ITA,DF,Atalanta,Serie A,29,1990,28.2,51,23,21,26,4,26,48,54.2,22,37,7,30,33,84,66,0,0,2020-2021,89.99999999999999,105.31914893617021,162.7659574468085
2588,Takehiro Tomiyasu,JPN,DF,Bologna,Serie A,21,1998,30.2,47,31,27,14,6,21,34,61.8,13,37,19,18,54,101,106,0,0,2020-2021,90.0,160.9271523178808,140.0662251655629
2589,James Tomkins,ENG,DF,Crystal Palace,Premier League,31,1989,6.1,4,2,4,0,0,3,4,75.0,1,4,3,1,4,8,45,0,0,2020-2021,90.0,59.016393442622956,59.016393442622956
2590,Fikayo Tomori,ENG,DF,Chelsea,Premier League,22,1997,0.5,2,1,2,0,0,0,0,0.0,0,1,1,0,2,4,8,0,0,2020-2021,90.0,360.0,360.0
2591,Fikayo Tomori,ENG,DF,Milan,Serie A,22,1997,16.3,28,18,17,9,2,8,14,57.1,6,32,20,12,18,46,61,1,0,2020-2021,90.0,99.38650306748467,154.60122699386503
2592,Sandro Tonali,ITA,MF,Milan,Serie A,20,2000,14.8,28,19,14,13,1,13,28,46.4,15,18,5,13,22,50,18,0,0,2020-2021,90.0,133.78378378378378,170.27027027027026
2593,Lorenzo Tonelli,ITA,DF,Sampdoria,Serie A,30,1990,19.8,33,18,20,11,2,10,21,47.6,11,21,14,7,25,58,94,1,0,2020-2021,90.0,113.63636363636364,150.0
2594,Toño,ESP,"DF,FW",Levante,La Liga,30,1989,8.1,4,0,4,0,0,0,2,0.0,2,10,1,9,7,11,12,0,0,2020-2021,90.0,77.77777777777779,44.44444444444444
2595,Ömer Toprak,TUR,DF,Werder Bremen,Bundesliga,31,1989,21.6,23,16,15,6,2,12,24,50.0,12,27,16,11,36,59,115,1,0,2020-2021,90.0,150.0,95.83333333333333
2596,Tyron Tormin,FRA,"FW,MF",Saint-Étienne,Ligue 1,19,2001,0.2,0,0,0,0,0,0,0,0.0,0,0,0,0,0,0,0,0,0,2020-2021,90.0,0.0,0.0
2597,Ernesto Torregrossa,VEN,FW,Sampdoria,Serie A,28,1992,1.9,1,1,0,0,1,0,2,0.0,2,4,0,4,1,2,1,0,0,2020-2021,90.0,47.368421052631575,47.368421052631575
2598,Lucas Torreira,URU,MF,Atlético Madrid,La Liga,24,1996,5.8,8,4,2,3,3,0,3,0.0,3,5,3,2,12,20,8,0,0,2020-2021,90.0,186.20689655172413,124.13793103448276
2599,Ferrán Torres,ESP,"FW,MF",Manchester City,Premier League,20,2000,14.5,12,5,4,6,2,5,16,31.3,11,16,0,16,3,15,8,0,0,2020-2021,90.0,18.620689655172413,74.48275862068965
2600,Óliver Torres,ESP,"MF,FW",Sevilla,La Liga,25,1994,15.6,34,22,13,15,6,19,53,35.8,34,15,0,15,15,49,9,0,0,2020-2021,90.0,86.53846153846153,196.15384615384616
Rk,Player,Nation,Pos,Squad,Comp,0,0,90.0,0,0,3,3,3,Tkl,0,0.0,0,0,0,0,0,0,0,0,0,2020-2021,90.0,0.0,0.0
2601,Pau Torres,ESP,DF,Villarreal,La Liga,23,1997,33.0,17,11,10,5,2,11,18,61.1,7,33,25,8,23,40,111,1,0,2020-2021,90.0,62.727272727272734,46.36363636363637
2602,Roberto Torres,ESP,"MF,FW",Osasuna,La Liga,31,1989,21.0,15,8,6,5,4,8,29,27.6,21,12,0,12,16,31,13,0,0,2020-2021,90.0,68.57142857142857,64.28571428571428
2603,Lucas Torró,ESP,MF,Osasuna,La Liga,26,1994,17.2,32,15,11,19,2,21,34,61.8,13,16,7,9,27,59,43,0,0,2020-2021,90.0,141.27906976744188,167.4418604651163
2604,Jordan Torunarigha,GER,DF,Hertha BSC,Bundesliga,22,1997,10.8,7,4,7,0,0,5,8,62.5,3,8,2,6,15,22,54,1,0,2020-2021,90.0,124.99999999999999,58.33333333333333
2605,Cenk Tosun,TUR,FW,Everton,Premier League,29,1991,0.5,0,0,0,0,0,0,1,0.0,1,0,0,0,0,0,0,0,0,2020-2021,90.0,0.0,0.0
2606,Abdoulaye Touré,GUI,MF,Nantes,Ligue 1,26,1994,18.7,28,12,10,16,2,14,31,45.2,17,17,2,15,22,50,19,0,0,2020-2021,90.0,105.88235294117646,134.75935828877004
2607,Almamy Touré,MLI,DF,Eint Frankfurt,Bundesliga,24,1996,7.8,18,12,8,7,3,10,14,71.4,4,5,1,4,8,26,22,0,0,2020-2021,90.0,92.3076923076923,207.69230769230768
2608,Lucas Tousart,FRA,MF,Hertha BSC,Bundesliga,23,1997,23.2,33,18,16,15,2,13,27,48.1,14,33,6,27,40,73,52,0,0,2020-2021,90.0,155.17241379310346,128.01724137931035
2609,Andros Townsend,ENG,"MF,FW",Crystal Palace,Premier League,29,1991,25.1,78,41,45,20,13,30,79,38.0,49,48,2,46,41,119,19,0,0,2020-2021,90.0,147.01195219123505,279.68127490039836
2610,Conor Townsend,ENG,DF,West Brom,Premier League,27,1993,24.8,44,28,32,9,3,30,49,61.2,19,38,15,23,36,80,55,2,0,2020-2021,90.0,130.6451612903226,159.67741935483872
2611,Mattéo Tramoni,FRA,"MF,FW",Cagliari,Serie A,20,2000,0.8,4,2,2,1,1,1,2,50.0,1,5,0,5,1,5,2,0,0,2020-2021,90.0,112.5,450.0
2612,Adama Traoré,ESP,"FW,MF",Wolves,Premier League,24,1996,29.4,28,16,11,13,4,13,21,61.9,8,23,1,22,7,35,12,1,0,2020-2021,90.0,21.42857142857143,85.71428571428572
2613,Amadou Traore,FRA,"FW,MF",Bordeaux,Ligue 1,18,2002,3.4,6,1,2,2,2,2,9,22.2,7,9,0,9,1,7,2,0,0,2020-2021,90.0,26.470588235294116,158.8235294117647
2614,Bertrand Traoré,BFA,FW,Aston Villa,Premier League,24,1995,25.7,26,10,8,10,8,10,34,29.4,24,23,1,22,15,41,14,1,0,2020-2021,90.0,52.52918287937743,91.05058365758755
2615,Boubacar Traoré,MLI,MF,Metz,Ligue 1,18,2001,0.6,3,2,1,2,0,1,1,100.0,0,1,0,1,0,3,0,0,0,2020-2021,90.0,0.0,450.00000000000006
2616,Chaka Traorè,CIV,"FW,DF",Parma,Serie A,15,2004,0.2,0,0,0,0,0,0,0,0.0,0,0,0,0,0,0,1,1,0,2020-2021,90.0,0.0,0.0
2617,Charles Traore,MLI,DF,Nantes,Ligue 1,28,1992,18.9,53,34,30,17,6,27,54,50.0,27,26,5,21,36,89,65,0,0,2020-2021,90.0,171.42857142857144,252.38095238095238
2618,Cheick Traoré,MLI,DF,Lens,Ligue 1,25,1995,0.4,2,2,1,1,0,2,4,50.0,2,1,0,1,2,4,1,0,0,2020-2021,90.0,450.0,450.0
2619,Hamari Traoré,MLI,DF,Rennes,Ligue 1,28,1992,33.3,56,38,23,27,6,22,59,37.3,37,31,5,26,76,132,50,0,0,2020-2021,90.0,205.40540540540542,151.35135135135135
2620,Ibrahima Traoré,GUI,"FW,DF",Gladbach,Bundesliga,32,1988,1.1,4,1,1,2,1,0,0,0.0,0,2,0,2,0,4,0,0,0,2020-2021,90.0,0.0,327.27272727272725
2621,Ismaël Traoré,CIV,DF,Angers,Ligue 1,33,1986,33.3,32,14,23,9,0,20,37,54.1,17,27,13,14,40,72,107,0,0,2020-2021,90.0,108.10810810810811,86.48648648648648
2622,Kevin Trapp,GER,GK,Eint Frankfurt,Bundesliga,30,1990,33.0,0,0,0,0,0,0,1,0.0,1,1,0,1,3,3,11,3,0,2020-2021,90.0,8.181818181818182,0.0
2623,Miguel Trauco,PER,DF,Saint-Étienne,Ligue 1,27,1992,22.6,47,29,25,14,8,23,43,53.5,20,19,4,15,30,77,34,1,0,2020-2021,90.0,119.46902654867256,187.16814159292034
2624,Trézéguet,EGY,FW,Aston Villa,Premier League,25,1994,13.0,33,18,14,15,4,13,45,28.9,32,13,1,12,19,52,17,0,0,2020-2021,90.00000000000001,131.53846153846155,228.46153846153848
2625,Manu Trigueros,ESP,MF,Villarreal,La Liga,28,1991,28.1,51,30,25,21,5,21,77,27.3,56,32,2,30,17,68,19,0,0,2020-2021,90.0,54.44839857651245,163.34519572953735
Rk,Player,Nation,Pos,Squad,Comp,0,0,90.0,0,0,3,3,3,Tkl,0,0.0,0,0,0,0,0,0,0,0,0,2020-2021,90.0,0.0,0.0
2626,Christopher Trimmel,AUT,"DF,FW",Union Berlin,Bundesliga,33,1987,28.6,50,25,28,18,4,28,54,51.9,26,32,7,25,50,100,99,0,0,2020-2021,90.0,157.34265734265733,157.34265734265733
2627,Francisco Trincão,POR,"FW,MF",Barcelona,La Liga,20,1999,7.8,4,2,0,3,1,2,5,40.0,3,4,0,4,1,5,2,0,0,2020-2021,90.0,11.538461538461538,46.15384615384615
2628,Alessandro Tripaldelli,ITA,DF,Cagliari,Serie A,21,1999,3.3,13,6,5,6,2,5,6,83.3,1,6,1,5,3,16,15,0,0,2020-2021,90.0,81.81818181818181,354.54545454545456
2629,Kieran Trippier,ENG,DF,Atlético Madrid,La Liga,29,1990,27.5,61,39,30,25,6,26,52,50.0,26,22,4,18,40,101,58,1,0,2020-2021,89.99999999999999,130.9090909090909,199.63636363636363
2630,Leandro Trossard,BEL,"MF,FW",Brighton,Premier League,25,1994,29.0,33,14,11,16,6,10,36,27.8,26,34,2,32,26,59,7,1,0,2020-2021,90.0,80.6896551724138,102.41379310344827
2631,Alexis Trouillet,FRA,"MF,FW",Nice,Ligue 1,19,2000,1.2,5,4,1,4,0,4,5,80.0,1,0,0,0,3,8,0,0,0,2020-2021,90.0,225.00000000000003,375.0
2632,Adrien Truffert,FRA,"DF,MF",Rennes,Ligue 1,18,2001,21.7,38,18,18,12,8,13,24,54.2,11,26,5,21,18,56,38,1,0,2020-2021,90.0,74.65437788018433,157.6036866359447
2633,Marvin Tshibuabua,FRA,DF,Saint-Étienne,Ligue 1,18,2002,0.5,1,0,1,0,0,0,0,0.0,0,0,0,0,1,2,1,0,0,2020-2021,90.0,180.0,180.0
2634,Kostas Tsimikas,GRE,"DF,FW",Liverpool,Premier League,24,1996,0.1,0,0,0,0,0,0,0,0.0,0,0,0,0,0,0,0,0,0,2020-2021,90.0,0.0,0.0
2635,Axel Tuanzebe,COD,DF,Manchester Utd,Premier League,22,1997,4.5,13,7,5,7,1,8,9,88.9,1,7,5,2,3,16,18,0,0,2020-2021,90.0,60.0,260.0
2636,Alessandro Tuia,ITA,DF,Benevento,Serie A,30,1990,19.6,39,17,34,4,1,15,25,60.0,10,22,10,12,36,75,91,1,0,2020-2021,90.0,165.30612244897958,179.0816326530612
2637,Ľubomír Tupta,SVK,FW,Hellas Verona,Serie A,22,1998,0.6,0,0,0,0,0,0,0,0.0,0,0,0,0,0,0,0,0,0,2020-2021,90.0,0.0,0.0
2638,Tuta,BRA,DF,Eint Frankfurt,Bundesliga,21,1999,16.2,35,20,22,13,0,24,43,55.8,19,19,2,17,29,64,53,0,0,2020-2021,90.0,161.11111111111111,194.44444444444446
2639,Destiny Udogie,ITA,"DF,MF",Hellas Verona,Serie A,17,2002,1.9,6,4,2,2,2,2,2,100.0,0,3,0,3,2,8,4,0,0,2020-2021,90.0,94.73684210526315,284.2105263157895
2640,Matthieu Udol,FRA,DF,Metz,Ligue 1,24,1996,19.2,34,21,18,12,4,17,39,43.6,22,25,5,20,39,73,30,0,0,2020-2021,90.0,182.8125,159.375
2641,Naomichi Ueda,JPN,DF,Nîmes,Ligue 1,25,1994,7.9,4,2,3,1,0,4,6,66.7,2,5,4,1,6,10,30,1,0,2020-2021,90.0,68.35443037974683,45.56962025316455
2642,Lesley Ugochukwu,FRA,MF,Rennes,Ligue 1,16,2004,0.7,3,1,0,3,0,2,3,66.7,1,1,0,1,0,3,0,0,0,2020-2021,90.0,0.0,385.7142857142857
2643,Hwang Ui-jo,KOR,"FW,MF",Bordeaux,Ligue 1,27,1992,27.8,14,6,5,8,1,6,25,24.0,19,17,2,15,8,22,14,0,0,2020-2021,90.0,25.89928057553957,45.32374100719424
2644,Samir Ujkani,KVX,GK,Torino,Serie A,32,1988,1.0,0,0,0,0,0,0,0,0.0,0,0,0,0,0,0,1,0,0,2020-2021,90.0,0.0,0.0
2645,Samuel Umtiti,FRA,DF,Barcelona,La Liga,26,1993,7.2,5,1,3,2,0,1,2,50.0,1,11,6,5,9,14,15,0,0,2020-2021,90.0,112.5,62.5
2646,Enes Ünal,TUR,FW,Getafe,La Liga,23,1997,14.6,11,3,0,8,3,4,15,26.7,11,11,0,11,2,13,14,0,0,2020-2021,90.0,12.328767123287673,67.8082191780822
2647,Cengiz Ünder,TUR,"FW,MF",Leicester City,Premier League,23,1997,3.1,4,1,0,3,1,3,5,60.0,2,3,0,3,2,6,0,0,0,2020-2021,90.0,58.064516129032256,116.12903225806451
2648,Dayot Upamecano,FRA,DF,RB Leipzig,Bundesliga,21,1998,25.9,37,30,18,19,0,14,20,70.0,6,25,14,11,33,70,74,2,0,2020-2021,90.0,114.67181467181469,128.57142857142858
2649,Kacper Urbanski,POL,FW,Bologna,Serie A,15,2004,0.0,0,0,0,0,0,0,0,0.0,0,0,0,0,0,0,0,0,0,2020-2021,,,
2650,Mark Uth,GER,"FW,MF",Schalke 04,Bundesliga,28,1991,16.6,25,13,13,10,2,5,23,21.7,18,21,0,21,5,30,10,0,0,2020-2021,90.0,27.108433734939755,135.5421686746988
Rk,Player,Nation,Pos,Squad,Comp,0,0,90.0,0,0,3,3,3,Tkl,0,0.0,0,0,0,0,0,0,0,0,0,2020-2021,90.0,0.0,0.0
2651,Tomáš Vaclík,CZE,GK,Sevilla,La Liga,31,1989,5.0,0,0,0,0,0,0,1,0.0,1,0,0,0,0,0,0,1,0,2020-2021,90.0,0.0,0.0
2652,Eugeni Valderrama,ESP,"MF,FW",Huesca,La Liga,26,1994,1.3,2,2,1,0,1,0,1,0.0,1,0,0,0,5,7,3,0,0,2020-2021,90.0,346.15384615384613,138.46153846153845
2653,Lautaro Valenti,ARG,DF,Parma,Serie A,21,1999,5.5,10,4,7,2,1,6,15,40.0,9,11,3,8,11,21,30,0,0,2020-2021,90.0,180.0,163.63636363636365
2654,Antoine Valerio,FRA,MF,Nîmes,Ligue 1,20,1999,0.8,0,0,0,0,0,0,1,0.0,1,1,0,1,2,2,0,0,0,2020-2021,90.0,225.0,0.0
2655,Borja Valero,ESP,"MF,FW",Fiorentina,Serie A,35,1985,5.5,13,9,7,4,2,3,15,20.0,12,6,1,5,6,19,2,0,0,2020-2021,90.0,98.18181818181819,212.72727272727275
2656,Yan Valery,TUN,"DF,MF",Southampton,Premier League,21,1999,1.1,5,3,2,3,0,1,5,20.0,4,2,0,2,2,7,5,0,0,2020-2021,90.0,163.63636363636363,409.09090909090907
2657,Jesús Vallejo,ESP,DF,Granada,La Liga,23,1997,15.0,11,6,7,3,1,7,18,38.9,11,21,11,10,13,24,55,0,0,2020-2021,90.0,78.0,66.0
2658,Manu Vallejo,ESP,"FW,MF",Valencia,La Liga,23,1997,10.6,18,8,5,8,5,5,26,19.2,21,8,0,8,3,21,3,0,0,2020-2021,90.0,25.471698113207548,152.83018867924528
2659,Federico Valverde,URU,MF,Real Madrid,La Liga,22,1998,14.8,25,16,9,8,8,10,26,38.5,16,16,2,14,22,47,4,0,0,2020-2021,90.0,133.78378378378378,152.02702702702703
2660,Virgil van Dijk,NED,DF,Liverpool,Premier League,29,1991,4.1,3,2,1,2,0,0,0,0.0,0,1,1,0,5,8,8,1,0,2020-2021,90.0,109.75609756097562,65.85365853658537
2661,Raphaël Varane,FRA,DF,Real Madrid,La Liga,27,1993,30.2,22,14,16,5,1,10,19,52.6,9,26,18,8,36,58,114,2,0,2020-2021,90.0,107.28476821192054,65.56291390728477
2662,Jamie Vardy,ENG,FW,Leicester City,Premier League,33,1987,31.6,18,12,1,8,9,2,15,13.3,13,14,5,9,4,22,32,0,0,2020-2021,90.0,11.392405063291138,51.26582278481012
2663,Ruben Vargas,SUI,"MF,FW",Augsburg,Bundesliga,21,1998,17.9,18,12,6,9,3,1,16,6.3,15,26,2,24,18,36,27,0,0,2020-2021,90.0,90.5027932960894,90.5027932960894
2664,Denis Vavro,SVK,DF,Lazio,Serie A,24,1996,0.4,0,0,0,0,0,0,1,0.0,1,0,0,0,1,1,3,0,0,2020-2021,90.0,225.0,0.0
2665,Denis Vavro,SVK,DF,Huesca,La Liga,24,1996,6.8,7,4,2,4,1,2,5,40.0,3,2,0,2,11,18,21,0,0,2020-2021,90.0,145.58823529411765,92.6470588235294
2666,Franco Vázquez,ARG,"FW,MF",Sevilla,La Liga,31,1989,1.8,5,1,0,3,2,1,5,20.0,4,2,1,1,1,6,1,0,0,2020-2021,90.0,50.0,250.0
2667,Kevin Vázquez,ESP,DF,Celta Vigo,La Liga,27,1993,6.2,11,5,9,2,0,3,9,33.3,6,8,0,8,9,20,18,0,0,2020-2021,90.0,130.6451612903226,159.67741935483872
2668,Lucas Vázquez,ESP,"DF,FW",Real Madrid,La Liga,29,1991,20.5,61,37,30,22,9,22,52,42.3,30,14,1,13,19,80,31,1,0,2020-2021,90.0,83.41463414634147,267.8048780487805
2669,Matías Vecino,URU,MF,Inter,Serie A,28,1991,3.1,1,1,0,0,1,0,5,0.0,5,7,1,6,4,5,3,0,0,2020-2021,90.0,116.12903225806451,29.032258064516128
2670,Koke Vegas,ESP,GK,Levante,La Liga,24,1995,1.0,0,0,0,0,0,0,0,0.0,0,0,0,0,0,0,1,1,0,2020-2021,90.0,0.0,0.0
2671,Gabriel Veiga,ESP,"MF,DF",Celta Vigo,La Liga,18,2002,1.3,3,0,3,0,0,1,4,25.0,3,3,0,3,3,6,0,0,0,2020-2021,90.0,207.69230769230768,207.69230769230768
2672,Miloš Veljković,SRB,DF,Werder Bremen,Bundesliga,24,1995,19.1,24,14,17,6,1,15,31,48.4,16,22,9,13,29,53,94,1,0,2020-2021,90.0,136.64921465968587,113.08900523560209
2673,Miguel Veloso,POR,MF,Hellas Verona,Serie A,34,1986,14.6,24,17,10,10,4,12,34,35.3,22,12,1,11,12,36,25,0,0,2020-2021,90.0,73.97260273972603,147.94520547945206
2674,Joël Veltman,NED,DF,Brighton,Premier League,28,1992,25.3,67,33,34,25,8,29,57,50.9,28,24,5,19,33,100,64,0,0,2020-2021,89.99999999999999,117.39130434782608,238.33992094861657
2675,Unai Vencedor Paris,ESP,MF,Athletic Club,La Liga,19,2000,18.9,31,21,10,15,6,11,42,26.2,31,17,6,11,18,49,14,0,0,2020-2021,90.0,85.71428571428572,147.61904761904762
Rk,Player,Nation,Pos,Squad,Comp,0,0,90.0,0,0,3,3,3,Tkl,0,0.0,0,0,0,0,0,0,0,0,0,2020-2021,90.0,0.0,0.0
2676,Lorenzo Venuti,ITA,DF,Fiorentina,Serie A,25,1995,19.5,24,11,14,7,3,14,28,50.0,14,18,3,15,17,41,24,0,0,2020-2021,90.0,78.46153846153845,110.76923076923076
2677,Daniele Verde,ITA,FW,Spezia,Serie A,24,1996,10.9,5,4,2,2,1,4,10,40.0,6,5,0,5,9,14,7,0,0,2020-2021,90.0,74.31192660550458,41.28440366972477
2678,Simone Verdi,ITA,"MF,FW",Torino,Serie A,28,1992,18.0,19,12,10,6,3,6,19,31.6,13,8,0,8,8,27,2,2,0,2020-2021,90.0,40.0,95.0
2679,Gonzalo Verdú,ESP,DF,Elche,La Liga,31,1988,32.7,34,19,26,8,0,16,28,57.1,12,40,30,10,52,86,113,0,0,2020-2021,90.0,143.11926605504587,93.57798165137615
2680,Jordan Veretout,FRA,MF,Roma,Serie A,27,1993,22.8,20,12,8,12,0,9,33,27.3,24,14,3,11,14,34,21,3,0,2020-2021,90.0,55.263157894736835,78.94736842105263
2681,Edoardo Vergani,ITA,FW,Bologna,Serie A,19,2001,0.1,0,0,0,0,0,0,0,0.0,0,0,0,0,0,0,0,0,0,2020-2021,90.0,0.0,0.0
2682,Marco Verratti,ITA,MF,Paris S-G,Ligue 1,27,1992,16.6,53,30,17,25,11,24,72,33.3,48,22,5,17,26,79,4,1,0,2020-2021,90.0,140.96385542168673,287.34939759036143
2683,Valerio Verre,ITA,"FW,MF",Sampdoria,Serie A,26,1994,11.1,11,7,2,7,2,4,19,21.1,15,14,2,12,9,20,3,0,0,2020-2021,90.0,72.97297297297298,89.1891891891892
2684,Mikel Vesga,ESP,MF,Athletic Club,La Liga,27,1993,19.1,28,14,8,16,4,12,50,24.0,38,28,8,20,27,55,35,1,0,2020-2021,90.0,127.22513089005236,131.9371727748691
2685,Jannik Vestergaard,DEN,DF,Southampton,Premier League,27,1992,28.6,50,31,31,15,4,35,52,67.3,17,29,16,13,42,92,122,0,0,2020-2021,90.0,132.16783216783216,157.34265734265733
2686,Rúben Vezo,POR,DF,Levante,La Liga,26,1994,25.7,34,19,26,7,1,12,29,41.4,17,22,11,11,46,80,106,3,0,2020-2021,90.0,161.08949416342412,119.06614785992218
2687,Guglielmo Vicario,ITA,GK,Cagliari,Serie A,23,1996,4.0,0,0,0,0,0,0,0,0.0,0,0,0,0,0,0,1,0,0,2020-2021,90.0,0.0,0.0
2688,Iñigo Vicente,ESP,"FW,MF",Athletic Club,La Liga,22,1998,0.6,1,1,1,0,0,1,1,100.0,0,0,0,0,0,1,0,0,0,2020-2021,90.0,0.0,150.0
2689,Fede Vico,ESP,"MF,FW",Granada,La Liga,26,1994,8.5,10,6,5,5,0,3,10,30.0,7,15,1,14,12,22,5,0,0,2020-2021,90.0,127.05882352941177,105.88235294117648
2690,Aleix Vidal,ESP,DF,Sevilla,La Liga,30,1989,6.6,9,5,5,3,1,5,12,41.7,7,10,1,9,12,21,9,0,0,2020-2021,90.0,163.63636363636363,122.72727272727273
2691,Arturo Vidal,CHI,MF,Inter,Serie A,33,1987,12.6,27,14,8,13,6,12,41,29.3,29,23,3,20,29,56,11,0,0,2020-2021,90.0,207.14285714285717,192.8571428571429
2692,Clément Vidal,FRA,DF,Montpellier,Ligue 1,20,2000,1.0,2,1,1,1,0,2,4,50.0,2,4,4,0,1,3,6,1,0,2020-2021,90.0,90.0,180.0
2693,Nacho Vidal,ESP,DF,Osasuna,La Liga,25,1995,26.1,56,28,27,22,7,22,31,71.0,9,39,10,29,43,99,68,0,0,2020-2021,90.0,148.2758620689655,193.10344827586204
2694,Ronaldo Vieira,ENG,"MF,DF",Hellas Verona,Serie A,22,1998,2.5,5,3,1,3,1,0,2,0.0,2,4,3,1,0,5,2,0,0,2020-2021,90.0,0.0,180.0
2695,Luca Vignali,ITA,DF,Spezia,Serie A,24,1996,17.7,19,9,10,6,3,7,25,28.0,18,13,5,8,22,41,25,0,0,2020-2021,90.0,111.86440677966102,96.61016949152543
2696,Emanuel Vignato,ITA,"FW,MF",Bologna,Serie A,19,2000,13.4,18,9,9,6,3,3,15,20.0,12,6,1,5,10,28,7,0,0,2020-2021,90.0,67.16417910447761,120.89552238805969
2697,Toni Villa,ESP,"MF,FW",Valladolid,La Liga,25,1995,10.8,31,16,11,14,6,15,42,35.7,27,15,1,14,5,36,3,0,0,2020-2021,90.0,41.666666666666664,258.3333333333333
2698,Asier Villalibre,ESP,FW,Athletic Club,La Liga,22,1997,17.7,3,2,0,2,1,2,8,25.0,6,4,0,4,2,5,16,0,0,2020-2021,90.0,10.16949152542373,15.254237288135593
2699,Gonzalo Villar,ESP,MF,Roma,Serie A,22,1998,20.7,44,18,14,24,6,18,61,29.5,43,25,3,22,22,66,14,1,0,2020-2021,90.0,95.65217391304348,191.30434782608697
2700,Iván Villar,ESP,GK,Celta Vigo,La Liga,23,1997,19.8,0,0,0,0,0,0,1,0.0,1,0,0,0,0,0,18,0,0,2020-2021,90.0,0.0,0.0
Rk,Player,Nation,Pos,Squad,Comp,0,0,90.0,0,0,3,3,3,Tkl,0,0.0,0,0,0,0,0,0,0,0,0,2020-2021,90.0,0.0,0.0
2701,Rúben Vinagre,POR,"MF,DF",Wolves,Premier League,21,1999,1.9,7,5,5,2,0,3,4,75.0,1,3,0,3,2,9,4,0,0,2020-2021,90.0,94.73684210526315,331.57894736842104
2702,Carlos Vinícius,BRA,FW,Tottenham,Premier League,25,1995,3.4,3,1,2,1,0,1,1,100.0,0,0,0,0,2,5,5,0,0,2020-2021,90.0,52.94117647058823,79.41176470588235
2703,Nicolas Viola,ITA,MF,Benevento,Serie A,30,1989,11.5,16,9,2,11,3,6,28,21.4,22,10,3,7,9,25,7,0,0,2020-2021,90.0,70.43478260869566,125.21739130434784
2704,João Virgínia,POR,GK,Everton,Premier League,20,1999,0.5,0,0,0,0,0,0,0,0.0,0,0,0,0,0,0,0,0,0,2020-2021,90.0,0.0,0.0
2705,Vitinha,POR,MF,Wolves,Premier League,20,2000,5.8,7,3,2,5,0,3,8,37.5,5,3,0,3,3,10,1,0,0,2020-2021,90.0,46.55172413793103,108.62068965517241
2706,Vitolo,ESP,"MF,FW",Atlético Madrid,La Liga,30,1989,3.3,4,1,2,0,2,1,6,16.7,5,3,0,3,3,7,2,0,0,2020-2021,90.0,81.81818181818181,109.0909090909091
2707,Dušan Vlahović,SRB,FW,Fiorentina,Serie A,20,2000,32.5,13,4,3,4,6,5,16,31.3,11,16,2,14,4,17,15,0,0,2020-2021,90.0,11.076923076923077,36.0
2708,Michel Vlap,NED,"MF,FW",Arminia,Bundesliga,23,1997,4.1,1,1,0,1,0,0,8,0.0,8,4,0,4,5,6,3,0,0,2020-2021,90.0,109.75609756097562,21.951219512195124
2709,Andreas Voglsammer,GER,"FW,MF",Arminia,Bundesliga,28,1992,11.1,12,8,6,6,0,8,17,47.1,9,11,0,11,3,15,11,0,0,2020-2021,90.0,24.324324324324326,97.2972972972973
2710,Kevin Vogt,GER,DF,Hoffenheim,Bundesliga,28,1991,20.5,18,12,11,6,1,12,21,57.1,9,21,12,9,16,34,71,0,0,2020-2021,90.0,70.2439024390244,79.02439024390245
2711,Mërgim Vojvoda,KVX,"DF,FW",Torino,Serie A,25,1995,15.1,24,14,18,5,1,12,22,54.5,10,19,4,15,18,42,35,1,0,2020-2021,90.0,107.28476821192054,143.04635761589404
2712,Jake Vokins,ENG,DF,Southampton,Premier League,20,2000,0.7,0,0,0,0,0,0,1,0.0,1,0,0,0,0,0,0,0,0,2020-2021,90.0,0.0,0.0
2713,Kevin Volland,GER,"FW,MF",Monaco,Ligue 1,28,1992,30.8,33,16,11,19,3,8,34,23.5,26,23,0,23,4,37,4,0,0,2020-2021,90.0,11.688311688311689,96.42857142857143
2714,Stefan de Vrij,NED,DF,Inter,Serie A,28,1992,30.4,28,16,15,12,1,15,24,62.5,9,24,18,6,41,69,95,0,0,2020-2021,90.0,121.38157894736841,82.89473684210526
2715,Giacomo Vrioni,ALB,FW,Juventus,Serie A,21,1998,0.0,0,0,0,0,0,0,0,0.0,0,0,0,0,0,0,0,0,0,2020-2021,,,
2716,Šime Vrsaljko,CRO,"FW,DF",Atlético Madrid,La Liga,28,1992,5.8,18,12,13,5,0,8,12,66.7,4,5,0,5,8,26,14,0,0,2020-2021,90.0,124.13793103448276,279.3103448275862
2717,Nikola Vukčević,MNE,MF,Levante,La Liga,28,1991,9.0,14,7,5,8,1,9,18,50.0,9,8,5,3,8,22,12,1,0,2020-2021,90.0,80.0,140.0
2718,Miloš Vulić,SRB,MF,Crotone,Serie A,23,1996,14.5,15,8,9,1,5,8,21,38.1,13,10,1,9,8,23,8,0,0,2020-2021,90.0,49.6551724137931,93.10344827586206
2719,Matěj Vydra,CZE,FW,Burnley,Premier League,28,1992,15.2,9,5,2,4,3,1,8,12.5,7,8,1,7,6,15,5,0,0,2020-2021,90.0,35.526315789473685,53.28947368421053
2720,Franklin Wadja,CMR,"MF,FW",Lorient,Ligue 1,25,1995,0.4,4,2,0,2,2,2,2,100.0,0,0,0,0,2,6,1,0,0,2020-2021,90.0,450.0,900.0
2721,Elye Wahi,FRA,FW,Montpellier,Ligue 1,17,2003,6.2,4,3,2,1,1,1,6,16.7,5,4,0,4,2,6,5,0,0,2020-2021,90.0,29.032258064516128,58.064516129032256
2722,Walace,BRA,MF,Udinese,Serie A,25,1995,22.8,50,23,28,19,3,21,60,35.0,39,36,3,33,34,84,23,0,0,2020-2021,90.0,134.21052631578945,197.36842105263156
2723,Theo Walcott,ENG,"MF,FW",Southampton,Premier League,31,1989,18.0,23,11,8,9,6,11,32,34.4,21,16,0,16,14,37,5,0,0,2020-2021,90.0,70.0,115.0
2724,Theo Walcott,ENG,FW,Everton,Premier League,31,1989,0.1,0,0,0,0,0,0,0,0.0,0,0,0,0,0,0,0,0,0,2020-2021,90.0,0.0,0.0
2725,Kyle Walker,ENG,DF,Manchester City,Premier League,30,1990,21.6,29,19,15,12,2,16,24,66.7,8,19,7,12,14,43,28,0,0,2020-2021,90.0,58.33333333333333,120.83333333333333
Rk,Player,Nation,Pos,Squad,Comp,0,0,90.0,0,0,3,3,3,Tkl,0,0.0,0,0,0,0,0,0,0,0,0,2020-2021,90.0,0.0,0.0
2726,Kyle Walker-Peters,ENG,DF,Southampton,Premier League,23,1997,29.4,83,53,56,25,2,34,57,59.6,23,41,10,31,38,121,66,2,0,2020-2021,90.0,116.3265306122449,254.08163265306123
2727,Sebastian Walukiewicz,POL,DF,Cagliari,Serie A,20,2000,18.0,27,19,11,13,3,12,30,40.0,18,22,14,8,36,63,60,0,0,2020-2021,90.0,180.0,135.0
2728,Aaron Wan-Bissaka,ENG,DF,Manchester Utd,Premier League,22,1997,34.0,88,54,53,29,6,32,45,71.1,13,65,17,48,62,150,84,2,0,2020-2021,90.0,164.11764705882354,232.94117647058823
2729,Joel Ward,ENG,DF,Crystal Palace,Premier League,30,1989,25.1,43,25,29,14,0,24,42,57.1,18,27,8,19,41,84,87,2,0,2020-2021,90.0,147.01195219123505,154.1832669322709
2730,James Ward-Prowse,ENG,MF,Southampton,Premier League,25,1994,38.0,75,49,30,41,4,29,70,41.4,41,36,4,32,42,117,60,0,0,2020-2021,90.0,99.47368421052632,177.6315789473684
2731,Daniel Wass,DEN,"MF,DF",Valencia,La Liga,31,1989,33.1,52,31,21,29,2,22,55,40.0,33,33,13,20,47,99,69,0,0,2020-2021,90.0,127.79456193353474,141.38972809667672
2732,Ollie Watkins,ENG,FW,Aston Villa,Premier League,24,1995,37.0,29,17,5,16,8,10,33,30.3,23,21,2,19,7,36,24,0,0,2020-2021,90.0,17.027027027027028,70.54054054054055
2733,Caleb Watts,AUS,MF,Southampton,Premier League,18,2002,0.4,2,1,2,0,0,1,2,50.0,1,0,0,0,0,2,0,0,0,2020-2021,90.0,0.0,450.0
2734,Timothy Weah,USA,"FW,MF",Lille,Ligue 1,20,2000,9.8,15,7,3,9,3,7,14,50.0,7,7,0,7,4,19,5,0,0,2020-2021,90.0,36.73469387755102,137.75510204081633
2735,Adam Webster,ENG,DF,Brighton,Premier League,25,1995,28.8,29,16,15,10,4,12,25,48.0,13,29,16,13,47,76,92,3,0,2020-2021,90.0,146.875,90.625
2736,Wout Weghorst,NED,FW,Wolfsburg,Bundesliga,27,1992,32.7,13,8,2,8,3,4,20,20.0,16,17,3,14,4,17,26,0,0,2020-2021,90.0,11.009174311926605,35.77981651376147
2737,Mitchell Weiser,GER,DF,Leverkusen,Bundesliga,26,1994,2.5,4,1,1,2,1,2,4,50.0,2,1,0,1,3,7,4,0,0,2020-2021,90.0,108.0,144.0
2738,Shon Weissman,ISR,FW,Valladolid,La Liga,24,1996,23.7,12,9,4,5,3,2,23,8.7,21,17,3,14,8,20,7,0,0,2020-2021,90.0,30.37974683544304,45.56962025316456
2739,Danny Welbeck,ENG,FW,Brighton,Premier League,29,1990,17.2,12,6,2,6,4,7,19,36.8,12,17,0,17,7,19,13,0,0,2020-2021,90.0,36.62790697674419,62.79069767441861
2740,Wendell,BRA,DF,Leverkusen,Bundesliga,27,1993,16.2,53,35,27,18,8,23,49,46.9,26,26,3,23,25,78,39,1,0,2020-2021,90.0,138.88888888888889,294.44444444444446
2741,Oscar Wendt,SWE,DF,Gladbach,Bundesliga,34,1985,13.9,12,6,2,9,1,4,12,33.3,8,18,4,14,14,26,23,0,0,2020-2021,90.0,90.64748201438849,77.6978417266187
2742,Timo Werner,GER,"FW,MF",Chelsea,Premier League,24,1996,28.9,20,9,6,11,3,7,43,16.3,36,23,1,22,8,28,8,0,0,2020-2021,90.00000000000001,24.913494809688583,62.28373702422146
2743,Ashley Westwood,ENG,MF,Burnley,Premier League,30,1990,37.9,23,15,6,12,5,10,42,23.8,32,26,9,17,44,67,33,0,0,2020-2021,90.0,104.48548812664907,54.617414248021106
2744,Ben White,ENG,"DF,MF",Brighton,Premier League,22,1997,35.5,49,26,21,24,4,24,57,42.1,33,46,22,24,62,111,56,0,0,2020-2021,90.0,157.1830985915493,124.22535211267606
2745,Georginio Wijnaldum,NED,MF,Liverpool,Premier League,29,1990,32.7,23,7,6,14,3,7,31,22.6,24,18,3,15,26,49,18,1,0,2020-2021,90.0,71.55963302752293,63.30275229357798
2746,William,BRA,"MF,FW",Wolfsburg,Bundesliga,25,1995,0.0,0,0,0,0,0,0,0,0.0,0,0,0,0,0,0,0,0,0,2020-2021,,,
2747,William,BRA,"DF,FW",Schalke 04,Bundesliga,25,1995,5.3,14,10,10,4,0,5,15,33.3,10,16,5,11,11,25,15,1,0,2020-2021,90.0,186.7924528301887,237.7358490566038
2748,Brandon Williams,ENG,DF,Manchester Utd,Premier League,19,2000,2.1,0,0,0,0,0,0,1,0.0,1,1,0,1,1,1,7,0,0,2020-2021,90.0,42.857142857142854,0.0
2749,Iñaki Williams,GHA,FW,Athletic Club,La Liga,26,1994,26.5,11,7,0,4,7,2,14,14.3,12,13,1,12,5,16,22,0,0,2020-2021,90.0,16.9811320754717,37.35849056603774
2750,Neco Williams,WAL,DF,Liverpool,Premier League,19,2001,2.8,6,5,4,2,0,5,9,55.6,4,3,1,2,6,12,6,0,0,2020-2021,90.0,192.85714285714286,192.85714285714286
Rk,Player,Nation,Pos,Squad,Comp,0,0,90.0,0,0,3,3,3,Tkl,0,0.0,0,0,0,0,0,0,0,0,0,2020-2021,90.0,0.0,0.0
2751,Nico Williams,ESP,MF,Athletic Club,La Liga,18,2002,0.6,1,0,1,0,0,0,2,0.0,2,0,0,0,1,2,0,0,0,2020-2021,90.0,150.0,150.0
2752,Rhys Williams,ENG,DF,Liverpool,Premier League,19,2001,7.3,6,4,3,3,0,3,3,100.0,0,4,3,1,6,12,27,1,0,2020-2021,90.0,73.97260273972603,73.97260273972603
2753,Willian,BRA,FW,Arsenal,Premier League,31,1988,15.6,13,7,6,6,1,6,16,37.5,10,13,0,13,8,21,8,0,0,2020-2021,90.0,46.15384615384615,75.0
2754,Joe Willock,ENG,MF,Arsenal,Premier League,20,1999,2.6,6,3,1,4,1,3,7,42.9,4,6,1,5,3,9,0,0,0,2020-2021,90.0,103.84615384615384,207.69230769230768
2755,Joe Willock,ENG,MF,Newcastle Utd,Premier League,20,1999,10.9,26,13,16,7,3,9,42,21.4,33,21,3,18,17,43,15,1,0,2020-2021,90.0,140.36697247706422,214.6788990825688
2756,Callum Wilson,ENG,FW,Newcastle Utd,Premier League,28,1992,23.2,12,5,1,6,5,2,12,16.7,10,10,3,7,7,19,14,0,0,2020-2021,90.0,27.155172413793103,46.55172413793103
2757,Marten Winkler,GER,FW,Hertha BSC,Bundesliga,17,2002,0.0,0,0,0,0,0,0,0,0.0,0,0,0,0,0,0,0,0,0,2020-2021,,,
2758,Harry Winks,ENG,MF,Tottenham,Premier League,24,1996,9.6,16,9,11,5,0,5,20,25.0,15,16,4,12,11,27,12,1,0,2020-2021,90.0,103.125,150.0
2759,Florian Wirtz,GER,MF,Leverkusen,Bundesliga,17,2003,24.7,35,18,8,22,5,11,37,29.7,26,27,1,26,9,44,8,0,0,2020-2021,90.0,32.79352226720648,127.53036437246963
2760,Yoane Wissa,COD,"MF,FW",Lorient,Ligue 1,23,1996,29.7,35,20,12,14,9,11,34,32.4,23,25,3,22,20,55,14,0,0,2020-2021,90.0,60.6060606060606,106.06060606060606
2761,Axel Witsel,BEL,MF,Dortmund,Bundesliga,31,1989,12.6,18,12,6,11,1,8,16,50.0,8,13,3,10,22,40,13,0,0,2020-2021,90.0,157.14285714285717,128.57142857142858
2762,Hannes Wolf,AUT,"MF,FW",Gladbach,Bundesliga,21,1999,15.3,26,13,8,10,8,8,36,22.2,28,18,1,17,9,35,4,0,0,2020-2021,90.0,52.94117647058823,152.94117647058823
2763,Marius Wolf,GER,"MF,DF",Köln,Bundesliga,25,1995,28.3,35,19,19,13,3,13,38,34.2,25,29,3,26,28,63,47,1,0,2020-2021,90.0,89.04593639575971,111.30742049469964
2764,Nick Woltemade,GER,"MF,FW",Werder Bremen,Bundesliga,18,2002,1.6,3,2,1,1,1,2,4,50.0,2,1,0,1,0,3,0,0,0,2020-2021,90.0,0.0,168.75
2765,Jeong Woo-yeong,KOR,"FW,MF",Freiburg,Bundesliga,20,1999,9.1,9,5,1,6,2,2,11,18.2,9,8,1,7,11,20,11,0,0,2020-2021,90.0,108.79120879120879,89.01098901098901
2766,Chris Wood,NZL,FW,Burnley,Premier League,28,1991,30.5,12,7,2,4,6,5,18,27.8,13,14,3,11,1,13,21,0,0,2020-2021,90.0,2.9508196721311473,35.40983606557377
2767,Joscha Wosz,GER,DF,RB Leipzig,Bundesliga,18,2002,0.4,1,1,1,0,0,0,0,0.0,0,1,0,1,1,2,0,0,0,2020-2021,90.0,225.0,225.0
2768,Xeka,POR,MF,Lille,Ligue 1,25,1994,13.3,33,17,14,15,4,16,43,37.2,27,14,2,12,20,53,18,0,0,2020-2021,90.0,135.33834586466165,223.3082706766917
2769,Granit Xhaka,SUI,"MF,DF",Arsenal,Premier League,27,1992,28.0,50,26,18,17,15,30,58,51.7,28,23,7,16,24,74,38,3,0,2020-2021,90.0,77.14285714285714,160.71428571428572
2770,Reinhold Yabo,GER,"MF,FW",Arminia,Bundesliga,28,1992,7.2,5,2,2,2,1,2,9,22.2,7,6,1,5,4,9,1,0,0,2020-2021,90.0,50.0,62.5
2771,Jawad El Yamiq,MAR,DF,Valladolid,La Liga,28,1992,15.3,21,14,14,7,0,8,11,72.7,3,15,10,5,46,67,100,0,0,2020-2021,90.0,270.5882352941176,123.52941176470587
2772,Rubén Yáñez,ESP,GK,Getafe,La Liga,26,1993,10.0,0,0,0,0,0,0,1,0.0,1,0,0,0,2,2,2,0,0,2020-2021,90.0,18.0,0.0
2773,Andriy Yarmolenko,UKR,"FW,MF",West Ham,Premier League,30,1989,4.2,5,4,2,2,1,2,8,25.0,6,1,0,1,1,6,2,0,0,2020-2021,90.0,21.428571428571427,107.14285714285714
2774,Yusuf Yazıcı,TUR,"FW,MF",Lille,Ligue 1,23,1997,12.1,12,5,6,2,4,1,24,4.2,23,5,1,4,2,14,2,0,0,2020-2021,90.0,14.87603305785124,89.25619834710743
2775,DeAndre Yedlin,USA,DF,Newcastle Utd,Premier League,27,1993,4.8,9,4,8,1,0,4,10,40.0,6,5,1,4,7,16,17,0,0,2020-2021,90.0,131.25,168.75
Rk,Player,Nation,Pos,Squad,Comp,0,0,90.0,0,0,3,3,3,Tkl,0,0.0,0,0,0,0,0,0,0,0,0,2020-2021,90.0,0.0,0.0
2776,Burak Yılmaz,TUR,FW,Lille,Ligue 1,35,1985,22.8,13,6,3,7,3,4,30,13.3,26,7,0,7,5,18,22,0,0,2020-2021,90.0,19.736842105263158,51.315789473684205
2777,Yoel,ESP,GK,Eibar,La Liga,31,1988,3.3,0,0,0,0,0,0,0,0.0,0,0,0,0,0,0,2,0,0,2020-2021,90.0,0.0,0.0
2778,Okay Yokuşlu,TUR,MF,West Brom,Premier League,26,1994,14.6,38,25,21,13,4,17,35,48.6,18,15,3,12,35,73,33,1,0,2020-2021,90.0,215.75342465753425,234.24657534246577
2779,Okay Yokuşlu,TUR,MF,Celta Vigo,La Liga,26,1994,5.1,14,8,8,4,2,5,9,55.6,4,5,2,3,10,24,9,0,0,2020-2021,90.0,176.47058823529412,247.05882352941177
2780,Maya Yoshida,JPN,DF,Sampdoria,Serie A,31,1988,25.3,17,4,10,7,0,7,13,53.8,6,45,34,11,57,74,93,1,0,2020-2021,89.99999999999999,202.76679841897231,60.47430830039525
2781,Amin Younes,GER,MF,Eint Frankfurt,Bundesliga,26,1993,15.5,25,14,8,10,7,6,32,18.8,26,19,1,18,13,38,4,0,0,2020-2021,90.0,75.48387096774194,145.16129032258064
2782,Ashley Young,ENG,DF,Inter,Serie A,35,1985,15.8,15,7,8,4,3,3,13,23.1,10,13,0,13,6,21,31,0,0,2020-2021,90.0,34.177215189873415,85.44303797468353
2783,Wilitty Younoussa,CMR,MF,Dijon,Ligue 1,18,2001,0.9,6,3,3,3,0,3,7,42.9,4,3,0,3,2,8,0,0,0,2020-2021,90.0,200.0,600.0
2784,Zaydou Youssouf,FRA,MF,Saint-Étienne,Ligue 1,21,1999,13.7,30,15,19,10,1,16,40,40.0,24,15,0,15,25,55,12,1,0,2020-2021,90.0,164.23357664233578,197.08029197080293
2785,Mattia Zaccagni,ITA,MF,Hellas Verona,Serie A,25,1995,29.0,27,13,8,11,8,8,25,32.0,17,28,4,24,27,54,13,1,0,2020-2021,90.0,83.79310344827586,83.79310344827586
2786,Dan-Axel Zagadou,FRA,DF,Dortmund,Bundesliga,21,1999,3.1,2,2,2,0,0,0,0,0.0,0,3,2,1,6,8,13,0,0,2020-2021,90.0,174.19354838709677,58.064516129032256
2787,Vasilios Zagaritis,GRE,DF,Parma,Serie A,19,2001,0.7,0,0,0,0,0,0,0,0.0,0,1,0,1,0,0,0,0,0,2020-2021,90.0,0.0,0.0
2788,Arthur Zagre,FRA,"DF,MF",Dijon,Ligue 1,18,2001,1.4,3,1,2,1,0,2,2,100.0,0,1,1,0,3,6,1,0,0,2020-2021,90.0,192.85714285714286,192.85714285714286
2789,Wilfried Zaha,CIV,FW,Crystal Palace,Premier League,27,1992,29.0,26,18,8,15,3,11,30,36.7,19,21,0,21,9,35,4,0,0,2020-2021,90.0,27.93103448275862,80.6896551724138
2790,Miha Zajc,SVN,MF,Genoa,Serie A,26,1994,20.7,22,14,9,10,3,13,39,33.3,26,30,4,26,27,49,19,0,0,2020-2021,90.0,117.3913043478261,95.65217391304348
2791,Denis Zakaria,SUI,"MF,DF",Gladbach,Bundesliga,23,1996,15.8,30,15,12,15,3,11,20,55.0,9,20,7,13,23,53,29,1,0,2020-2021,90.0,131.01265822784808,170.88607594936707
2792,Joseba Zaldúa,ESP,DF,Real Sociedad,La Liga,28,1992,7.1,15,12,7,5,3,6,18,33.3,12,6,2,4,6,21,13,0,0,2020-2021,90.0,76.05633802816902,190.14084507042256
2793,Nicola Zalewski,POL,MF,Roma,Serie A,18,2002,0.1,1,1,0,1,0,1,1,100.0,0,0,0,0,0,1,0,0,0,2020-2021,90.0,0.0,900.0
2794,Andre-Frank Zambo Anguissa,CMR,MF,Fulham,Premier League,24,1995,28.7,78,37,27,38,13,27,68,39.7,41,35,6,29,56,134,17,2,0,2020-2021,90.0,175.609756097561,244.5993031358885
2795,Niccolò Zanellato,ITA,MF,Crotone,Serie A,22,1998,18.2,24,14,16,6,2,13,36,36.1,23,19,5,14,16,40,12,2,0,2020-2021,90.0,79.12087912087912,118.68131868131869
2796,Cristián Zapata,COL,DF,Genoa,Serie A,33,1986,10.8,18,12,11,7,0,10,14,71.4,4,15,11,4,15,33,56,0,0,2020-2021,90.0,124.99999999999999,150.0
2797,Duván Zapata,COL,FW,Atalanta,Serie A,29,1991,26.4,12,5,2,3,7,4,13,30.8,9,19,5,14,6,18,19,0,0,2020-2021,90.0,20.454545454545453,40.90909090909091
2798,Gabriele Zappa,ITA,DF,Cagliari,Serie A,20,1999,26.6,34,17,16,15,3,22,49,44.9,27,36,4,32,24,58,50,0,0,2020-2021,90.0,81.203007518797,115.0375939849624
2799,Davide Zappacosta,ITA,DF,Genoa,Serie A,28,1992,22.7,33,16,15,13,5,15,30,50.0,15,17,1,16,18,51,41,0,0,2020-2021,89.99999999999999,71.36563876651982,130.83700440528634
2800,Oier Zarraga,ESP,MF,Athletic Club,La Liga,21,1999,1.1,1,1,0,1,0,1,2,50.0,1,1,0,1,0,1,0,0,0,2020-2021,90.0,0.0,81.81818181818181
Rk,Player,Nation,Pos,Squad,Comp,0,0,90.0,0,0,3,3,3,Tkl,0,0.0,0,0,0,0,0,0,0,0,0,2020-2021,90.0,0.0,0.0
2801,Simone Zaza,ITA,FW,Torino,Serie A,29,1991,16.6,15,9,4,6,5,6,20,30.0,14,14,0,14,3,18,5,1,0,2020-2021,90.0,16.265060240963855,81.32530120481927
2802,Deyovaisio Zeefuik,NED,"DF,FW",Hertha BSC,Bundesliga,22,1998,10.1,13,9,8,3,2,8,19,42.1,11,15,3,12,12,25,36,0,0,2020-2021,90.0,106.93069306930693,115.84158415841584
2803,Marvin Zeegelaar,NED,DF,Udinese,Serie A,29,1990,19.3,40,18,23,16,1,20,39,51.3,19,21,9,12,24,64,43,0,0,2020-2021,90.0,111.91709844559584,186.5284974093264
2804,Arber Zeneli,KVX,"MF,FW",Reims,Ligue 1,25,1995,14.3,20,10,11,1,8,8,22,36.4,14,12,1,11,3,23,8,0,0,2020-2021,90.0,18.88111888111888,125.87412587412588
2805,Robin Zentner,GER,GK,Mainz 05,Bundesliga,25,1994,31.0,1,1,1,0,0,1,3,33.3,2,0,0,0,3,4,9,2,0,2020-2021,90.0,8.709677419354838,2.903225806451613
2806,Andi Zeqiri,SUI,"FW,DF",Brighton,Premier League,21,1999,1.9,3,2,0,2,1,1,2,50.0,1,1,0,1,0,3,2,0,0,2020-2021,90.0,0.0,142.10526315789474
2807,Mehdi Zerkane,ALG,"MF,FW",Bordeaux,Ligue 1,21,1999,13.2,23,15,7,10,6,5,18,27.8,13,15,2,13,9,32,5,0,0,2020-2021,90.0,61.36363636363637,156.8181818181818
2808,Ron-Robert Zieler,GER,GK,Köln,Bundesliga,31,1989,0.6,0,0,0,0,0,0,0,0.0,0,0,0,0,0,0,0,0,0,2020-2021,90.0,0.0,0.0
2809,Piotr Zieliński,POL,MF,Napoli,Serie A,26,1994,28.0,18,10,8,7,3,7,20,35.0,13,23,4,19,18,36,12,0,0,2020-2021,90.0,57.857142857142854,57.857142857142854
2810,Oleksandr Zinchenko,UKR,DF,Manchester City,Premier League,23,1996,16.4,25,15,12,9,4,14,24,58.3,10,17,4,13,23,48,28,0,0,2020-2021,90.0,126.21951219512196,137.19512195121953
2811,Joshua Zirkzee,NED,"FW,MF",Parma,Serie A,19,2001,1.3,2,2,1,1,0,1,3,33.3,2,1,1,0,0,2,1,0,0,2020-2021,90.0,0.0,138.46153846153845
2812,Joshua Zirkzee,NED,FW,Bayern Munich,Bundesliga,19,2001,1.0,1,0,0,1,0,1,2,50.0,1,0,0,0,0,1,0,0,0,2020-2021,90.0,0.0,90.0
2813,Hakim Ziyech,MAR,"MF,FW",Chelsea,Premier League,27,1993,13.0,14,10,5,7,2,5,19,26.3,14,9,1,8,10,24,2,0,0,2020-2021,90.00000000000001,69.23076923076924,96.92307692307693
2814,Jeroen Zoet,NED,GK,Spezia,Serie A,29,1991,6.7,0,0,0,0,0,0,1,0.0,1,0,0,0,0,0,4,2,0,2020-2021,90.0,0.0,0.0
2815,Kévin Zohi,MLI,"FW,MF",Strasbourg,Ligue 1,23,1996,4.8,9,5,3,4,2,2,6,33.3,4,6,0,6,6,15,3,0,0,2020-2021,90.0,112.50000000000001,168.75
2816,Kurt Zouma,FRA,DF,Chelsea,Premier League,25,1994,22.5,16,10,8,6,2,4,8,50.0,4,13,9,4,28,44,93,0,0,2020-2021,90.0,112.0,64.0
2817,Igor Zubeldia,ESP,DF,Real Sociedad,La Liga,23,1997,21.8,23,16,15,8,0,8,14,57.1,6,20,13,7,12,35,46,0,0,2020-2021,90.0,49.54128440366972,94.95412844036697
2818,Steven Zuber,SUI,"DF,MF",Eint Frankfurt,Bundesliga,28,1991,6.5,24,12,8,13,3,8,16,50.0,8,4,1,3,4,28,1,0,0,2020-2021,90.00000000000001,55.38461538461539,332.3076923076923
2819,Martín Zubimendi,ESP,MF,Real Sociedad,La Liga,21,1999,20.9,41,22,18,20,3,20,34,58.8,14,22,10,12,40,81,39,0,0,2020-2021,90.0,172.2488038277512,176.555023923445
2820,Martin Ødegaard,NOR,MF,Arsenal,Premier League,21,1998,9.6,9,3,2,6,1,4,14,28.6,10,2,0,2,2,11,5,0,0,2020-2021,90.0,18.75,84.375
2821,Martin Ødegaard,NOR,MF,Real Madrid,La Liga,21,1998,2.6,1,0,0,1,0,1,2,50.0,1,1,0,1,1,2,0,0,0,2020-2021,90.0,34.61538461538461,34.61538461538461
2822,Filip Đuričić,SRB,"MF,FW",Sassuolo,Serie A,28,1992,23.1,32,23,6,16,10,12,30,40.0,18,20,2,18,9,41,12,0,0,2020-2021,89.99999999999999,35.06493506493506,124.67532467532466
1,Max Aarons,ENG,DF,Norwich City,Premier League,21,2000,32.0,64,44,49,15,0,37,55,67.3,18,39,19,20,28,92,96,1,0,2021-2022,90.0,78.75,180.0
2,Yunis Abdelhamid,MAR,DF,Reims,Ligue 1,33,1987,33.1,48,27,34,14,0,16,32,50.0,16,50,25,25,68,116,104,0,0,2021-2022,90.0,184.8942598187311,130.51359516616313
3,Salis Abdul Samed,GHA,MF,Clermont Foot,Ligue 1,21,2000,27.4,43,23,25,16,2,20,57,35.1,37,18,1,17,42,85,15,0,0,2021-2022,90.0,137.95620437956205,141.24087591240877
4,Laurent Abergel,FRA,MF,Lorient,Ligue 1,28,1993,32.8,110,60,44,53,13,71,166,42.8,95,58,1,57,55,165,13,0,0,2021-2022,90.0,150.91463414634148,301.82926829268297
5,Charles Abi,FRA,FW,Saint-Étienne,Ligue 1,21,2000,0.5,0,0,0,0,0,0,1,0.0,1,2,0,2,0,0,0,0,0,2021-2022,90.0,0.0,0.0
6,Dickson Abiama,NGA,FW,Greuther Fürth,Bundesliga,22,1998,8.1,11,7,4,5,2,2,10,20.0,8,12,1,11,4,15,8,0,0,2021-2022,90.0,44.44444444444444,122.22222222222223
7,Matthis Abline,FRA,FW,Rennes,Ligue 1,18,2003,1.1,0,0,0,0,0,0,0,0.0,0,2,0,2,0,0,1,0,0,2021-2022,90.0,0.0,0.0
8,Tammy Abraham,ENG,FW,Roma,Serie A,23,1997,34.3,27,13,7,14,6,9,22,40.9,13,17,3,14,5,32,27,0,0,2021-2022,90.0,13.119533527696795,70.8454810495627
9,Luis Abram,PER,DF,Granada,La Liga,25,1996,6.2,6,3,3,3,0,2,4,50.0,2,6,5,1,5,11,37,1,0,2021-2022,90.0,72.58064516129032,87.09677419354838
10,Francesco Acerbi,ITA,DF,Lazio,Serie A,33,1988,28.2,25,12,15,9,1,12,19,63.2,7,37,28,9,34,59,92,0,0,2021-2022,89.99999999999999,108.51063829787233,79.78723404255318
11,Ragnar Ache,GER,"MF,FW",Eint Frankfurt,Bundesliga,23,1998,2.9,2,0,0,1,1,1,4,25.0,3,3,0,3,0,2,1,0,0,2021-2022,90.0,0.0,62.06896551724138
12,Mohamed Achi,FRA,MF,Nantes,Ligue 1,19,2002,0.1,0,0,0,0,0,0,0,0.0,0,0,0,0,0,0,0,0,0,2021-2022,90.0,0.0,0.0
13,Marcos Acuña,ARG,DF,Sevilla,La Liga,29,1991,25.1,50,29,27,14,9,30,46,65.2,16,22,5,17,14,64,25,1,0,2021-2022,90.0,50.199203187250994,179.2828685258964
14,Che Adams,SCO,FW,Southampton,Premier League,25,1996,22.7,13,6,5,5,3,2,16,12.5,14,18,2,16,8,21,18,0,0,2021-2022,89.99999999999999,31.71806167400881,51.541850220264315
15,Tyler Adams,USA,MF,RB Leipzig,Bundesliga,22,1999,15.0,23,7,5,16,2,7,25,28.0,18,24,1,23,16,39,19,2,0,2021-2022,90.0,96.0,138.0
16,Sargis Adamyan,ARM,"FW,MF",Hoffenheim,Bundesliga,28,1993,3.7,8,6,3,4,1,3,11,27.3,8,4,0,4,1,9,2,0,0,2021-2022,90.0,24.324324324324323,194.59459459459458
17,Martin Adeline,FRA,"MF,FW",Reims,Ligue 1,17,2003,3.9,15,11,5,8,2,8,16,50.0,8,0,0,0,11,26,6,0,0,2021-2022,90.0,253.84615384615384,346.15384615384613
18,Amine Adli,MAR,"FW,MF",Leverkusen,Bundesliga,21,2000,14.0,27,14,10,14,3,8,15,53.3,7,26,2,24,11,38,12,0,0,2021-2022,90.0,70.71428571428571,173.57142857142856
19,Yacine Adli,FRA,"MF,FW",Bordeaux,Ligue 1,21,2000,25.1,43,27,22,14,7,19,68,27.9,49,33,3,30,37,80,11,2,0,2021-2022,90.0,132.66932270916334,154.1832669322709
20,Michel Aebischer,SUI,MF,Bologna,Serie A,24,1997,4.9,14,5,5,8,1,6,11,54.5,5,4,1,3,6,20,3,0,0,2021-2022,90.0,110.20408163265306,257.1428571428571
21,Felix Afena-Gyan,GHA,"FW,MF",Roma,Serie A,18,2003,7.4,10,3,1,6,3,4,7,57.1,3,4,0,4,3,13,0,0,0,2021-2022,90.0,36.486486486486484,121.62162162162161
22,Martin Agirregabiria,ESP,DF,Alavés,La Liga,25,1996,18.0,34,22,17,11,6,18,37,48.6,19,20,3,17,25,59,38,0,0,2021-2022,90.0,125.0,170.0
23,Julen Agirrezabala,ESP,GK,Athletic Club,La Liga,20,2000,4.0,0,0,0,0,0,0,0,0.0,0,0,0,0,0,0,2,0,0,2021-2022,90.0,0.0,0.0
24,Lucien Agoume,FRA,MF,Brest,Ligue 1,19,2002,20.8,51,31,24,20,7,23,45,51.1,22,30,9,21,52,103,27,1,0,2021-2022,90.0,224.99999999999997,220.6730769230769
25,Kevin Agudelo,COL,"MF,FW",Spezia,Serie A,22,1998,13.7,44,26,13,26,5,7,20,35.0,13,22,0,22,8,52,6,0,0,2021-2022,90.0,52.55474452554745,289.05109489051097
Rk,Player,Nation,Pos,Squad,Comp,0,0,90.0,0,0,3,3,3,Tkl,0,0.0,0,0,0,0,0,0,0,0,0,2021-2022,90.0,0.0,0.0
26,Nayef Aguerd,MAR,DF,Rennes,Ligue 1,25,1996,30.4,27,18,16,11,0,14,24,58.3,10,24,14,10,24,51,127,1,0,2021-2022,90.0,71.05263157894737,79.93421052631578
27,Sergio Agüero,ARG,FW,Barcelona,La Liga,33,1988,1.7,1,1,0,0,1,0,2,0.0,2,0,0,0,0,1,0,0,0,2021-2022,90.0,0.0,52.94117647058823
28,Ruben Aguilar,FRA,DF,Monaco,Ligue 1,28,1993,23.8,78,53,39,32,7,43,68,63.2,25,19,4,15,44,122,57,0,0,2021-2022,90.00000000000001,166.38655462184875,294.95798319327736
29,Álvaro Aguirre,ESP,FW,Rayo Vallecano,La Liga,21,2000,0.1,0,0,0,0,0,0,0,0.0,0,0,0,0,0,0,0,0,0,2021-2022,90.0,0.0,0.0
30,Naouirou Ahamada,FRA,"MF,DF",Stuttgart,Bundesliga,19,2002,0.7,1,0,1,0,0,1,3,33.3,2,0,0,0,0,1,0,0,0,2021-2022,90.0,0.0,128.57142857142858
31,Anel Ahmedhodžić,BIH,DF,Bordeaux,Ligue 1,22,1999,15.0,38,26,27,9,2,20,31,64.5,11,16,8,8,22,60,44,0,0,2021-2022,90.0,132.0,228.0
32,Jean-Eudes Aholou,CIV,MF,Strasbourg,Ligue 1,27,1994,11.2,16,9,4,9,3,5,19,26.3,14,8,1,7,19,35,7,0,0,2021-2022,90.0,152.67857142857144,128.57142857142858
33,Joseph Aidoo,GHA,DF,Celta Vigo,La Liga,25,1995,29.3,39,26,28,10,1,17,31,54.8,14,23,13,10,38,77,96,3,0,2021-2022,90.0,116.72354948805462,119.79522184300342
34,Ola Aina,NGA,DF,Torino,Serie A,24,1996,16.0,27,19,11,10,6,15,23,65.2,8,17,3,14,28,55,30,0,0,2021-2022,90.0,157.5,151.875
35,Rayan Aït-Nouri,ALG,"DF,MF",Wolves,Premier League,20,2001,20.3,64,36,46,15,3,22,44,50.0,22,24,2,22,22,86,39,1,0,2021-2022,90.0,97.53694581280787,283.743842364532
36,Kristoffer Ajer,NOR,DF,Brentford,Premier League,23,1998,22.2,29,18,21,6,2,13,21,61.9,8,19,11,8,26,55,74,0,0,2021-2022,90.0,105.40540540540542,117.56756756756758
37,Ludovic Ajorque,FRA,FW,Strasbourg,Ligue 1,27,1994,30.4,36,25,5,19,12,7,40,17.5,33,28,3,25,8,44,31,1,0,2021-2022,90.0,23.684210526315788,106.57894736842105
38,Manuel Akanji,SUI,DF,Dortmund,Bundesliga,26,1995,25.1,33,23,20,11,2,22,32,68.8,10,26,15,11,35,68,58,0,0,2021-2022,90.0,125.49800796812748,118.32669322709162
39,Carlos Akapo,EQG,DF,Cádiz,La Liga,28,1993,20.5,43,31,26,15,2,21,37,56.8,16,26,7,19,51,94,61,0,0,2021-2022,90.0,223.90243902439025,188.78048780487805
40,Marley Aké,FRA,"FW,MF",Juventus,Serie A,20,2001,0.9,0,0,0,0,0,0,2,0.0,2,0,0,0,1,1,0,0,0,2021-2022,90.0,100.0,0.0
41,Nathan Aké,NED,DF,Manchester City,Premier League,26,1995,10.3,16,9,7,8,1,6,8,75.0,2,7,5,2,8,24,23,0,0,2021-2022,90.0,69.90291262135922,139.80582524271844
42,Ilias Akhomach,MAR,FW,Barcelona,La Liga,17,2004,1.4,2,0,0,1,1,0,0,0.0,0,0,0,0,0,2,0,0,0,2021-2022,90.0,0.0,128.57142857142858
43,Maghnes Akliouche,FRA,"MF,FW",Monaco,Ligue 1,19,2002,0.6,2,0,0,2,0,0,1,0.0,1,2,0,2,0,2,0,0,0,2021-2022,90.0,0.0,300.0
44,Paul Akouokou,CIV,MF,Betis,La Liga,23,1997,5.7,14,9,5,7,2,8,12,66.7,4,6,0,6,11,25,6,0,0,2021-2022,90.0,173.68421052631578,221.05263157894734
45,Jean-Daniel Akpa-Akpro,CIV,MF,Lazio,Serie A,28,1992,3.5,17,10,7,9,1,7,12,58.3,5,4,2,2,2,19,6,0,0,2021-2022,90.0,51.42857142857143,437.1428571428571
46,Kevin Akpoguma,NGA,"DF,FW",Hoffenheim,Bundesliga,26,1995,17.0,33,19,16,11,6,16,28,57.1,12,32,2,30,20,53,29,2,0,2021-2022,90.0,105.88235294117648,174.7058823529412
47,David Alaba,AUT,DF,Real Madrid,La Liga,29,1992,29.4,23,13,15,6,2,9,19,47.4,10,26,15,11,22,45,70,1,0,2021-2022,90.0,67.34693877551021,70.40816326530613
48,Sofiane Alakouch,MAR,"DF,MF",Metz,Ligue 1,23,1998,1.8,7,4,3,4,0,2,5,40.0,3,4,0,4,1,8,4,0,0,2021-2022,90.0,50.0,350.0
49,Tomás Alarcón,CHI,MF,Cádiz,La Liga,22,1999,15.8,31,20,17,10,4,10,31,32.3,21,19,7,12,30,61,31,0,0,2021-2022,90.0,170.88607594936707,176.58227848101265
50,Lucas Alario,ARG,FW,Leverkusen,Bundesliga,28,1992,7.3,6,5,0,2,4,2,5,40.0,3,5,0,5,1,7,6,0,0,2021-2022,90.0,12.328767123287673,73.97260273972603
Rk,Player,Nation,Pos,Squad,Comp,0,0,90.0,0,0,3,3,3,Tkl,0,0.0,0,0,0,0,0,0,0,0,0,2021-2022,90.0,0.0,0.0
51,Jordi Alba,ESP,DF,Barcelona,La Liga,32,1989,29.4,47,34,12,26,9,27,47,57.4,20,26,6,20,33,80,41,1,0,2021-2022,90.0,101.0204081632653,143.87755102040816
52,Josué Albert,GUF,DF,Clermont Foot,Ligue 1,29,1992,0.2,0,0,0,0,0,0,0,0.0,0,0,0,0,1,1,2,0,0,2021-2022,90.0,450.0,0.0
53,Luis Alberto,ESP,MF,Lazio,Serie A,28,1992,26.1,29,17,8,11,10,8,52,15.4,44,32,4,28,13,42,7,0,0,2021-2022,90.0,44.82758620689655,99.99999999999999
54,Raúl Albiol,ESP,DF,Villarreal,La Liga,35,1985,27.4,26,15,20,5,1,14,18,77.8,4,24,15,9,21,47,126,1,0,2021-2022,90.0,68.97810218978103,85.4014598540146
55,Marc Albrighton,ENG,"FW,DF",Leicester City,Premier League,31,1989,12.6,31,19,16,9,6,10,47,21.3,37,15,3,12,14,45,20,0,0,2021-2022,90.0,100.00000000000001,221.42857142857144
56,Paco Alcácer,ESP,FW,Villarreal,La Liga,27,1993,8.7,9,3,2,4,3,1,5,20.0,4,7,0,7,6,15,1,0,0,2021-2022,90.0,62.06896551724138,93.10344827586206
57,Thiago Alcántara,ESP,MF,Liverpool,Premier League,30,1991,17.0,48,29,14,24,10,10,42,23.8,32,22,2,20,26,74,13,2,0,2021-2022,90.0,137.64705882352942,254.11764705882354
58,Rubén Alcaraz,ESP,MF,Cádiz,La Liga,30,1991,12.3,41,20,14,24,3,22,45,48.9,23,10,2,8,13,54,14,0,0,2021-2022,89.99999999999999,95.12195121951218,299.99999999999994
59,Omar Alderete,PAR,DF,Valencia,La Liga,24,1996,26.7,53,34,34,17,2,34,53,64.2,19,30,18,12,35,88,153,0,0,2021-2022,90.00000000000001,117.97752808988766,178.65168539325845
60,Iván Alejo,ESP,"MF,FW",Cádiz,La Liga,26,1995,11.8,33,15,21,10,2,15,44,34.1,29,12,0,12,8,41,17,0,0,2021-2022,90.0,61.01694915254237,251.69491525423726
61,Doğan Alemdar,TUR,GK,Rennes,Ligue 1,18,2002,12.0,0,0,0,0,0,0,0,0.0,0,0,0,0,0,0,9,1,0,2021-2022,90.0,0.0,0.0
62,Carles Aleñá,ESP,MF,Getafe,La Liga,23,1998,25.8,27,19,11,13,3,9,48,18.8,39,21,2,19,15,42,16,0,0,2021-2022,90.0,52.325581395348834,94.18604651162791
63,Trent Alexander-Arnold,ENG,DF,Liverpool,Premier League,22,1998,31.7,40,23,19,13,8,27,60,45.0,33,22,4,18,43,83,40,0,0,2021-2022,90.0,122.08201892744479,113.56466876971609
64,Mohamed Ali Cho,FRA,FW,Angers,Ligue 1,17,2004,20.4,10,5,1,4,5,5,17,29.4,12,17,1,16,8,18,0,1,0,2021-2022,90.0,35.294117647058826,44.11764705882353
65,Alisson,BRA,GK,Liverpool,Premier League,28,1992,36.0,3,1,3,0,0,3,5,60.0,2,1,0,1,0,3,28,1,0,2021-2022,90.0,0.0,7.5
66,Allan,BRA,MF,Everton,Premier League,30,1991,24.3,74,44,28,39,7,34,105,32.4,71,40,9,31,23,97,39,1,0,2021-2022,90.0,85.18518518518518,274.0740740740741
67,Jim Allevinah,GAB,FW,Clermont Foot,Ligue 1,26,1995,16.5,18,13,8,8,2,5,18,27.8,13,11,0,11,6,24,4,0,0,2021-2022,90.0,32.72727272727273,98.18181818181819
68,Dele Alli,ENG,MF,Tottenham,Premier League,25,1996,7.3,14,8,10,3,1,5,17,29.4,12,22,5,17,6,20,16,0,0,2021-2022,90.0,73.97260273972603,172.6027397260274
69,Dele Alli,ENG,"MF,FW",Everton,Premier League,25,1996,3.8,7,2,3,4,0,0,4,0.0,4,7,2,5,6,13,10,0,0,2021-2022,90.0,142.10526315789474,165.78947368421052
70,Miguel Almirón,PAR,"MF,FW",Newcastle Utd,Premier League,27,1994,19.1,47,29,23,17,7,11,44,25.0,33,14,1,13,20,67,13,0,0,2021-2022,90.0,94.24083769633508,221.46596858638742
71,Marcos Alonso,ESP,DF,Chelsea,Premier League,30,1990,24.1,41,29,20,12,9,17,36,47.2,19,29,5,24,43,84,53,0,0,2021-2022,90.0,160.58091286307052,153.11203319502076
72,Giorgio Altare,ITA,DF,Cagliari,Serie A,22,1998,16.3,39,28,18,18,3,21,26,80.8,5,17,5,12,30,69,70,0,0,2021-2022,90.0,165.64417177914112,215.33742331288343
73,Hugo Álvarez,ESP,FW,Celta Vigo,La Liga,18,2003,0.1,1,0,1,0,0,0,0,0.0,0,0,0,0,0,1,1,0,0,2021-2022,90.0,0.0,900.0
74,Yeray Álvarez,ESP,DF,Athletic Club,La Liga,26,1995,20.7,24,14,15,8,1,10,18,55.6,8,21,16,5,45,69,97,0,0,2021-2022,90.0,195.6521739130435,104.34782608695653
75,Dani Alves,BRA,DF,Barcelona,La Liga,38,1983,12.2,30,19,13,13,4,14,26,53.8,12,10,3,7,11,41,10,2,0,2021-2022,90.0,81.14754098360656,221.31147540983608
Rk,Player,Nation,Pos,Squad,Comp,0,0,90.0,0,0,3,3,3,Tkl,0,0.0,0,0,0,0,0,0,0,0,0,2021-2022,90.0,0.0,0.0
76,Steven Alzate,COL,MF,Brighton,Premier League,22,1998,4.5,10,4,4,5,1,4,7,57.1,3,2,1,1,10,20,10,0,0,2021-2022,90.0,200.0,200.0
77,Ibrahim Amadou,FRA,"DF,MF",Metz,Ligue 1,28,1993,9.0,16,8,10,6,0,8,15,53.3,7,4,2,2,14,30,26,0,0,2021-2022,90.0,140.0,160.0
78,Emmanuel Amankwaa Akurugu,GHA,DF,Getafe,La Liga,19,2001,0.9,0,0,0,0,0,0,2,0.0,2,1,0,1,0,0,0,0,0,2021-2022,90.0,0.0,0.0
79,Daniel Amartey,GHA,DF,Leicester City,Premier League,26,1994,23.6,26,13,19,7,0,19,29,65.5,10,30,22,8,21,47,93,4,0,2021-2022,90.0,80.08474576271186,99.15254237288134
80,Amath,SEN,"FW,MF",Mallorca,La Liga,25,1996,9.8,21,11,11,6,4,7,17,41.2,10,12,0,12,7,28,7,0,0,2021-2022,90.0,64.28571428571428,192.85714285714283
81,Jordan Amavi,FRA,DF,Nice,Ligue 1,27,1994,4.6,16,10,8,7,1,10,17,58.8,7,3,1,2,15,31,7,0,0,2021-2022,90.0,293.47826086956525,313.04347826086956
82,Jordan Amavi,FRA,"DF,FW",Marseille,Ligue 1,27,1994,1.4,6,5,3,1,2,5,10,50.0,5,1,0,1,1,7,3,0,0,2021-2022,90.0,64.28571428571429,385.7142857142857
83,Wisdom Amey,ITA,DF,Bologna,Serie A,15,2005,0.8,3,2,1,1,1,2,3,66.7,1,2,0,2,3,6,1,0,0,2021-2022,90.0,337.5,337.5
84,Kelvin Amian,FRA,DF,Spezia,Serie A,23,1998,29.4,66,42,43,18,5,30,41,73.2,11,39,21,18,32,98,75,0,0,2021-2022,90.0,97.95918367346938,202.0408163265306
85,Nadiem Amiri,GER,"MF,FW",Genoa,Serie A,24,1996,7.6,6,4,2,2,2,2,9,22.2,7,7,0,7,0,6,0,0,0,2021-2022,90.0,0.0,71.05263157894737
86,Nadiem Amiri,GER,"MF,FW",Leverkusen,Bundesliga,24,1996,4.1,8,4,3,2,3,4,8,50.0,4,4,2,2,5,13,0,0,0,2021-2022,90.0,109.75609756097562,175.609756097561
87,Ethan Ampadu,WAL,"MF,DF",Venezia,Serie A,20,2000,25.4,67,43,37,27,3,24,58,41.4,34,49,19,30,51,118,76,0,0,2021-2022,90.0,180.70866141732284,237.40157480314963
88,Sofyan Amrabat,MAR,MF,Fiorentina,Serie A,24,1996,10.5,24,13,9,13,2,11,19,57.9,8,25,8,17,5,29,6,1,0,2021-2022,90.0,42.857142857142854,205.71428571428572
89,Joachim Andersen,DEN,DF,Crystal Palace,Premier League,25,1996,32.4,30,23,21,9,0,16,27,59.3,11,29,19,10,37,67,125,3,0,2021-2022,90.0,102.77777777777779,83.33333333333334
90,Felipe Anderson,BRA,FW,Lazio,Serie A,28,1993,32.1,71,45,30,33,8,27,99,27.3,72,65,6,59,20,91,16,0,0,2021-2022,90.0,56.074766355140184,199.06542056074764
91,Sebastian Andersson,SWE,FW,Köln,Bundesliga,30,1991,14.0,11,7,0,3,8,3,9,33.3,6,8,0,8,3,14,14,0,0,2021-2022,90.0,19.285714285714285,70.71428571428571
92,Florin Andone,ROU,FW,Cádiz,La Liga,28,1993,2.0,1,1,1,0,0,0,1,0.0,1,2,0,2,0,1,1,0,0,2021-2022,90.0,0.0,45.0
93,Andrés Andrade Cedeño,PAN,DF,Arminia,Bundesliga,22,1998,11.6,27,16,18,8,1,17,35,48.6,18,16,7,9,19,46,44,0,0,2021-2022,90.0,147.41379310344828,209.48275862068965
94,Benjamin André,FRA,MF,Lille,Ligue 1,30,1990,30.6,123,69,49,65,9,51,113,45.1,62,49,11,38,50,173,56,0,0,2021-2022,90.0,147.05882352941177,361.7647058823529
95,Fredrik André Bjørkan,NOR,DF,Hertha BSC,Bundesliga,22,1998,3.9,12,10,7,4,1,7,9,77.8,2,6,2,4,6,18,8,0,0,2021-2022,90.0,138.46153846153845,276.9230769230769
96,Marcos André,BRA,"FW,MF",Valencia,La Liga,24,1996,10.8,15,11,4,6,5,5,16,31.3,11,15,0,15,7,22,13,0,0,2021-2022,90.0,58.33333333333333,124.99999999999999
97,Robert Andrich,GER,MF,Leverkusen,Bundesliga,26,1994,20.2,33,17,18,14,1,14,28,50.0,14,19,7,12,31,64,46,0,0,2021-2022,90.0,138.11881188118812,147.02970297029702
98,José Ángel,ESP,DF,Osasuna,La Liga,31,1989,12.0,20,13,9,9,2,9,14,64.3,5,6,1,5,10,30,21,0,0,2021-2022,90.0,75.0,150.0
99,Angeliño,ESP,DF,RB Leipzig,Bundesliga,24,1997,25.5,28,21,14,13,1,14,30,46.7,16,24,3,21,29,57,40,0,0,2021-2022,90.0,102.3529411764706,98.82352941176471
100,Ebenezer Annan,GHA,DF,Bologna,Serie A,18,2002,0.3,1,1,1,0,0,0,0,0.0,0,0,0,0,1,2,1,0,0,2021-2022,90.0,300.0,300.0
Rk,Player,Nation,Pos,Squad,Comp,0,0,90.0,0,0,3,3,3,Tkl,0,0.0,0,0,0,0,0,0,0,0,0,2021-2022,90.0,0.0,0.0
101,Cristian Ansaldi,ARG,DF,Torino,Serie A,34,1986,7.7,20,9,11,7,2,10,13,76.9,3,9,1,8,6,26,10,0,0,2021-2022,90.0,70.12987012987013,233.76623376623377
102,Janis Antiste,FRA,FW,Spezia,Serie A,18,2002,8.8,18,11,6,6,6,5,13,38.5,8,7,1,6,4,22,6,0,0,2021-2022,90.0,40.90909090909091,184.0909090909091
103,Waldemar Anton,GER,DF,Stuttgart,Bundesliga,25,1996,28.8,40,26,22,15,3,19,32,59.4,13,27,16,11,32,72,116,1,0,2021-2022,90.0,100.0,125.0
104,Josep Antoni Gayá,ESP,DF,Mallorca,La Liga,21,2000,0.6,0,0,0,0,0,0,0,0.0,0,1,0,1,1,1,3,1,0,2021-2022,90.0,150.0,0.0
105,Michail Antonio,JAM,FW,West Ham,Premier League,31,1990,33.0,23,17,5,9,9,7,18,38.9,11,19,1,18,3,26,13,0,0,2021-2022,90.0,8.181818181818182,62.727272727272734
106,Christopher Antwi-Adjei,GHA,"FW,MF",Bochum,Bundesliga,27,1994,12.6,21,18,7,8,6,6,26,23.1,20,12,0,12,1,22,8,0,0,2021-2022,90.0,7.142857142857143,150.00000000000003
107,Houssem Aouar,ALG,"MF,FW",Lyon,Ligue 1,23,1998,27.8,46,30,9,25,12,27,54,50.0,27,26,1,25,20,66,5,0,0,2021-2022,90.0,64.74820143884892,148.9208633093525
108,Adil Aouchiche,FRA,"MF,FW",Saint-Étienne,Ligue 1,19,2002,12.0,13,6,5,5,3,5,33,15.2,28,18,1,17,17,30,4,0,0,2021-2022,90.0,127.5,97.5
109,Dennis Appiah,FRA,DF,Nantes,Ligue 1,29,1992,23.3,55,34,35,18,2,28,48,58.3,20,30,13,17,27,82,74,0,0,2021-2022,90.0,104.29184549356223,212.44635193133047
110,Mauro Arambarri,URU,MF,Getafe,La Liga,25,1995,29.6,62,37,19,32,11,20,68,29.4,48,35,5,30,32,94,18,0,0,2021-2022,90.0,97.29729729729729,188.51351351351352
111,Mattia Aramu,ITA,"MF,FW",Venezia,Serie A,26,1995,23.3,20,15,5,9,6,8,33,24.2,25,20,2,18,8,28,19,0,0,2021-2022,90.0,30.901287553648068,77.25321888412017
112,Charles Aránguiz,CHI,MF,Leverkusen,Bundesliga,32,1989,17.5,45,25,18,21,6,22,52,42.3,30,24,4,20,33,78,21,0,0,2021-2022,90.0,169.71428571428572,231.42857142857142
113,Néstor Araujo,MEX,DF,Celta Vigo,La Liga,29,1991,29.1,22,14,17,5,0,9,21,42.9,12,17,10,7,27,49,105,2,0,2021-2022,90.0,83.50515463917525,68.04123711340206
114,Ronald Araújo,URU,DF,Barcelona,La Liga,22,1999,25.2,41,23,29,12,0,21,25,84.0,4,37,20,17,23,64,66,1,0,2021-2022,90.0,82.14285714285715,146.42857142857144
115,Cameron Archer,ENG,"FW,MF",Aston Villa,Premier League,20,2001,0.3,0,0,0,0,0,0,0,0.0,0,0,0,0,0,0,0,0,0,2021-2022,90.0,0.0,0.0
116,Alphonse Areola,FRA,GK,West Ham,Premier League,28,1993,1.0,0,0,0,0,0,0,0,0.0,0,0,0,0,0,0,1,0,0,2021-2022,90.0,0.0,0.0
117,Jesús Areso,ESP,DF,Osasuna,La Liga,22,1999,2.1,3,3,2,1,0,0,2,0.0,2,0,0,0,0,3,2,1,0,2021-2022,90.0,0.0,128.57142857142856
118,Matias Arezo,URU,"FW,MF",Granada,La Liga,18,2002,1.8,5,3,2,1,2,4,9,44.4,5,1,0,1,1,6,1,0,0,2021-2022,90.0,50.0,250.0
119,Santiago Arias,COL,DF,Granada,La Liga,29,1992,4.9,12,5,8,3,1,4,9,44.4,5,8,4,4,5,17,10,0,0,2021-2022,90.0,91.83673469387755,220.40816326530611
120,Adam Armstrong,ENG,FW,Southampton,Premier League,24,1997,15.7,10,4,2,2,6,0,6,0.0,6,13,1,12,3,13,6,0,0,2021-2022,90.0,17.197452229299365,57.32484076433121
121,Stuart Armstrong,SCO,MF,Southampton,Premier League,29,1992,16.4,27,19,15,6,6,9,23,39.1,14,10,1,9,8,35,15,0,0,2021-2022,90.0,43.90243902439025,148.1707317073171
122,Marko Arnautović,AUT,FW,Bologna,Serie A,32,1989,29.9,17,9,1,11,5,7,30,23.3,23,13,2,11,7,24,17,0,0,2021-2022,90.0,21.070234113712377,51.17056856187291
123,Maximilian Arnold,GER,MF,Wolfsburg,Bundesliga,27,1994,33.3,37,20,19,16,2,20,50,40.0,30,43,15,28,37,74,55,0,0,2021-2022,90.0,100.0,100.0
124,Kepa Arrizabalaga,ESP,GK,Chelsea,Premier League,26,1994,4.0,0,0,0,0,0,0,0,0.0,0,0,0,0,0,0,4,0,0,2021-2022,90.0,0.0,0.0
125,Tolgay Arslan,GER,MF,Udinese,Serie A,30,1990,18.4,35,20,15,16,4,19,50,38.0,31,17,4,13,13,48,23,1,0,2021-2022,90.0,63.58695652173913,171.19565217391306
Rk,Player,Nation,Pos,Squad,Comp,0,0,90.0,0,0,3,3,3,Tkl,0,0.0,0,0,0,0,0,0,0,0,0,2021-2022,90.0,0.0,0.0
126,Santiago Arzamendia,PAR,MF,Cádiz,La Liga,23,1998,5.2,14,6,6,5,3,6,13,46.2,7,6,0,6,4,18,7,0,0,2021-2022,90.0,69.23076923076923,242.3076923076923
127,Takuma Asano,JPN,"FW,MF",Bochum,Bundesliga,26,1994,17.9,11,6,3,6,2,5,19,26.3,14,14,1,13,7,18,7,0,0,2021-2022,90.0,35.19553072625699,55.30726256983241
128,Santiago Ascacíbar,ARG,MF,Hertha BSC,Bundesliga,24,1997,26.4,93,54,50,37,6,38,89,42.7,51,31,6,25,41,134,42,0,0,2021-2022,90.0,139.77272727272728,317.04545454545456
129,Sergio Asenjo,ESP,GK,Villarreal,La Liga,32,1989,6.0,0,0,0,0,0,0,1,0.0,1,0,0,0,1,1,6,0,0,2021-2022,90.0,15.0,0.0
130,Alejandro Asensio,ESP,FW,Rayo Vallecano,La Liga,20,2000,0.1,0,0,0,0,0,0,0,0.0,0,0,0,0,0,0,0,0,0,2021-2022,90.0,0.0,0.0
131,Marco Asensio,ESP,"FW,MF",Real Madrid,La Liga,25,1996,19.2,12,8,6,4,2,4,18,22.2,14,8,1,7,12,24,6,1,0,2021-2022,90.0,56.25000000000001,56.25000000000001
132,Harrison Ashby,SCO,DF,West Ham,Premier League,19,2001,0.1,0,0,0,0,0,0,0,0.0,0,1,0,1,1,1,1,0,0,2021-2022,90.0,900.0,0.0
133,Kristoffer Askildsen,NOR,MF,Sampdoria,Serie A,20,2001,8.4,18,6,7,11,0,9,19,47.4,10,14,7,7,15,33,15,0,0,2021-2022,90.0,160.7142857142857,192.85714285714286
134,Fisnik Asllani,KVX,"MF,FW",Hoffenheim,Bundesliga,18,2002,0.1,0,0,0,0,0,0,1,0.0,1,0,0,0,0,0,0,0,0,2021-2022,90.0,0.0,0.0
135,Kristjan Asllani,ALB,MF,Empoli,Serie A,19,2002,15.0,18,9,9,8,1,11,29,37.9,18,16,7,9,19,37,15,1,0,2021-2022,90.0,114.0,108.0
136,Iago Aspas,ESP,FW,Celta Vigo,La Liga,33,1987,34.3,14,7,1,5,8,4,24,16.7,20,23,2,21,11,25,19,0,0,2021-2022,90.0,28.86297376093295,36.734693877551024
137,Lorenz Assignon,TOG,DF,Rennes,Ligue 1,21,2000,6.8,15,10,11,3,1,5,9,55.6,4,3,1,2,11,26,19,0,0,2021-2022,90.0,145.58823529411765,198.52941176470588
138,Simon Asta,GER,DF,Greuther Fürth,Bundesliga,20,2001,8.7,13,6,4,5,4,4,8,50.0,4,14,2,12,8,21,16,0,0,2021-2022,90.0,82.75862068965517,134.48275862068965
139,Youcef Atal,ALG,DF,Nice,Ligue 1,25,1996,12.7,29,19,17,10,2,14,25,56.0,11,13,2,11,32,61,21,0,0,2021-2022,90.0,226.7716535433071,205.51181102362204
140,Pierre-Emerick Aubameyang,GAB,FW,Arsenal,Premier League,32,1989,11.5,11,5,6,4,1,3,10,30.0,7,12,1,11,0,11,4,0,0,2021-2022,90.0,0.0,86.08695652173914
141,Pierre-Emerick Aubameyang,GAB,FW,Barcelona,La Liga,32,1989,12.0,2,2,0,1,1,0,5,0.0,5,9,1,8,2,4,4,0,0,2021-2022,90.0,15.0,15.0
142,Emil Audero,ITA,GK,Sampdoria,Serie A,24,1997,28.4,3,1,3,0,0,3,5,60.0,2,0,0,0,2,5,17,2,0,2021-2022,90.0,6.338028169014085,9.507042253521128
143,Tommaso Augello,ITA,DF,Sampdoria,Serie A,26,1994,26.6,36,20,22,8,6,17,29,58.6,12,19,4,15,29,65,68,1,0,2021-2022,90.0,98.1203007518797,121.80451127819548
144,Jean-Kévin Augustin,FRA,"FW,MF",Nantes,Ligue 1,24,1997,0.9,1,0,0,0,1,0,3,0.0,3,1,0,1,0,1,0,0,0,2021-2022,90.0,0.0,100.0
145,Ludwig Augustinsson,SWE,"DF,FW",Sevilla,La Liga,27,1994,8.8,18,14,11,3,4,8,13,61.5,5,10,3,7,5,23,21,0,0,2021-2022,90.0,51.13636363636363,184.0909090909091
146,Serge Aurier,CIV,DF,Villarreal,La Liga,28,1992,11.2,14,9,11,2,1,4,7,57.1,3,14,7,7,11,25,25,0,0,2021-2022,90.0,88.39285714285714,112.5
147,Ezequiel Ávila,ARG,"FW,MF",Osasuna,La Liga,27,1994,20.8,17,7,6,7,4,7,21,33.3,14,14,2,12,13,30,15,1,0,2021-2022,90.0,56.24999999999999,73.5576923076923
148,Taiwo Awoniyi,NGA,FW,Union Berlin,Bundesliga,23,1997,24.2,11,7,3,6,2,1,9,11.1,8,11,2,9,2,13,29,0,0,2021-2022,90.0,7.43801652892562,40.90909090909091
149,Ramzi Aya,ITA,DF,Salernitana,Serie A,30,1990,1.5,1,1,1,0,0,1,1,100.0,0,0,0,0,0,1,4,0,0,2021-2022,90.0,0.0,60.0
150,Jordan Ayew,GHA,FW,Crystal Palace,Premier League,29,1991,22.4,47,30,20,20,7,17,31,54.8,14,33,3,30,15,62,15,0,0,2021-2022,90.0,60.267857142857146,188.83928571428572
Rk,Player,Nation,Pos,Squad,Comp,0,0,90.0,0,0,3,3,3,Tkl,0,0.0,0,0,0,0,0,0,0,0,0,2021-2022,90.0,0.0,0.0
151,Kaan Ayhan,TUR,DF,Sassuolo,Serie A,26,1994,15.0,20,12,14,6,0,7,15,46.7,8,20,14,6,13,33,57,0,0,2021-2022,90.0,78.0,120.0
152,Luke Ayling,ENG,DF,Leeds United,Premier League,29,1991,25.2,74,42,46,23,5,51,97,52.6,46,46,25,21,28,102,52,1,0,2021-2022,90.0,100.00000000000001,264.28571428571433
153,Karim Azamoum,FRA,DF,Troyes,Ligue 1,31,1990,4.3,6,5,4,2,0,3,5,60.0,2,4,2,2,1,7,10,0,0,2021-2022,90.0,20.930232558139537,125.58139534883722
154,Sardar Azmoun,IRN,"FW,MF",Leverkusen,Bundesliga,26,1995,4.0,3,1,0,2,1,0,5,0.0,5,2,0,2,0,3,8,0,0,2021-2022,90.0,0.0,67.5
155,César Azpilicueta,ESP,DF,Chelsea,Premier League,31,1989,23.0,51,28,18,27,6,16,35,45.7,19,32,9,23,23,74,65,1,0,2021-2022,90.0,90.0,199.56521739130437
156,Iddrisu Baba,GHA,MF,Mallorca,La Liga,25,1996,21.5,57,30,31,23,3,25,43,58.1,18,19,5,14,24,81,34,1,0,2021-2022,90.0,100.46511627906976,238.60465116279067
157,Carlos Bacca,COL,FW,Granada,La Liga,34,1986,5.7,4,4,2,0,2,0,3,0.0,3,5,0,5,1,5,5,0,0,2021-2022,90.0,15.789473684210526,63.1578947368421
158,Daniel Bachmann,AUT,GK,Watford,Premier League,27,1994,12.0,0,0,0,0,0,0,0,0.0,0,0,0,0,1,1,5,0,0,2021-2022,90.0,7.5,0.0
159,Loïc Bade,FRA,DF,Rennes,Ligue 1,21,2000,10.9,6,5,4,2,0,3,5,60.0,2,12,10,2,12,18,48,0,0,2021-2022,90.0,99.08256880733944,49.54128440366972
160,Milan Badelj,CRO,MF,Genoa,Serie A,32,1989,31.6,64,37,25,30,9,34,80,42.5,46,39,7,32,85,149,43,0,0,2021-2022,90.0,242.0886075949367,182.2784810126582
161,Édgar Badía,ESP,GK,Elche,La Liga,29,1992,24.0,0,0,0,0,0,0,0,0.0,0,0,0,0,0,0,16,2,0,2021-2022,90.0,0.0,0.0
162,Benoît Badiashile,FRA,DF,Monaco,Ligue 1,20,2001,20.4,36,19,21,15,0,14,23,60.9,9,18,12,6,28,64,68,1,0,2021-2022,90.0,123.52941176470588,158.82352941176472
163,Youssouph Badji,SEN,"FW,MF",Brest,Ligue 1,19,2001,1.5,1,0,0,1,0,0,1,0.0,1,0,0,0,0,1,0,0,0,2021-2022,90.0,0.0,60.0
164,Miguel Baeza,ESP,DF,Celta Vigo,La Liga,21,2000,0.0,0,0,0,0,0,0,0,0.0,0,0,0,0,0,0,0,0,0,2021-2022,,,
165,Nicola Bagnolini,ITA,GK,Bologna,Serie A,17,2004,0.0,0,0,0,0,0,0,0,0.0,0,0,0,0,0,0,0,0,0,2021-2022,,,
166,Issa Bah,LUX,FW,Venezia,Serie A,19,2002,0.1,0,0,0,0,0,0,0,0.0,0,0,0,0,0,0,0,0,0,2021-2022,90.0,0.0,0.0
167,Stéphane Bahoken,CMR,FW,Angers,Ligue 1,29,1992,12.2,13,8,2,7,4,1,9,11.1,8,15,0,15,3,16,3,0,0,2021-2022,90.0,22.13114754098361,95.9016393442623
168,Leon Bailey,JAM,"FW,MF",Aston Villa,Premier League,23,1997,8.5,17,11,6,8,3,6,13,46.2,7,10,1,9,1,18,2,0,0,2021-2022,90.0,10.588235294117647,180.0
169,Eric Bailly,CIV,DF,Manchester Utd,Premier League,27,1994,2.4,5,4,4,0,1,3,4,75.0,1,4,2,2,3,8,11,0,0,2021-2022,90.0,112.50000000000001,187.5
170,Dénys Bain,FRA,DF,Brest,Ligue 1,28,1993,2.0,3,3,1,2,0,1,1,100.0,0,3,1,2,3,6,5,0,0,2021-2022,90.0,135.0,135.0
171,Stefan Bajic,FRA,GK,Saint-Étienne,Ligue 1,19,2001,5.7,0,0,0,0,0,0,0,0.0,0,0,0,0,0,0,4,0,0,2021-2022,90.0,0.0,0.0
172,Nedim Bajrami,ALB,"MF,FW",Empoli,Serie A,22,1999,22.8,21,14,5,13,3,4,14,28.6,10,11,0,11,3,24,8,0,0,2021-2022,90.0,11.842105263157894,82.89473684210526
173,Cédric Bakambu,COD,FW,Marseille,Ligue 1,30,1991,4.0,2,0,1,0,1,0,3,0.0,3,2,0,2,0,2,1,0,0,2021-2022,90.0,0.0,45.0
174,Abdoulaye Bakayoko,FRA,DF,Saint-Étienne,Ligue 1,18,2002,3.4,15,9,13,2,0,8,12,66.7,4,5,4,1,12,27,15,0,0,2021-2022,90.0,317.6470588235294,397.05882352941177
175,Tiemoué Bakayoko,FRA,MF,Milan,Serie A,26,1994,5.6,19,13,9,7,3,5,16,31.3,11,8,1,7,9,28,10,2,0,2021-2022,90.0,144.64285714285714,305.3571428571429
Rk,Player,Nation,Pos,Squad,Comp,0,0,90.0,0,0,3,3,3,Tkl,0,0.0,0,0,0,0,0,0,0,0,0,2021-2022,90.0,0.0,0.0
176,Mitchel Bakker,NED,DF,Leverkusen,Bundesliga,21,2000,20.2,33,22,16,12,5,20,34,58.8,14,13,2,11,23,56,42,3,0,2021-2022,90.0,102.47524752475248,147.02970297029702
177,Ridle Baku,GER,"DF,FW",Wolfsburg,Bundesliga,23,1998,27.2,62,37,30,24,8,25,65,38.5,40,43,1,42,21,83,52,1,0,2021-2022,90.0,69.48529411764706,205.14705882352942
178,Dilane Bakwa,FRA,"FW,MF",Bordeaux,Ligue 1,18,2002,0.5,1,1,0,1,0,1,2,50.0,1,0,0,0,0,1,1,0,0,2021-2022,90.0,0.0,180.0
179,Tommaso Baldanzi,ITA,FW,Empoli,Serie A,18,2003,0.2,0,0,0,0,0,0,0,0.0,0,1,0,1,0,0,0,0,0,2021-2022,90.0,0.0,0.0
180,Alejandro Balde,ESP,"DF,FW",Barcelona,La Liga,17,2003,2.1,2,1,1,0,1,0,0,0.0,0,2,2,0,1,3,1,0,0,2021-2022,90.0,42.857142857142854,85.71428571428571
181,Ibrahima Baldé,FRA,"FW,MF",Lens,Ligue 1,18,2003,0.6,0,0,0,0,0,0,0,0.0,0,0,0,0,0,0,0,0,0,2021-2022,90.0,0.0,0.0
182,Keita Baldé,SEN,FW,Cagliari,Serie A,26,1995,13.7,8,4,1,5,2,1,10,10.0,9,6,0,6,4,12,6,0,0,2021-2022,90.0,26.277372262773724,52.55474452554745
183,Gareth Bale,WAL,FW,Real Madrid,La Liga,32,1989,3.1,2,1,1,0,1,1,4,25.0,3,2,0,2,2,4,1,0,0,2021-2022,90.0,58.064516129032256,58.064516129032256
184,Mikel Balenziaga,ESP,DF,Athletic Club,La Liga,33,1988,22.5,33,24,15,15,3,25,43,58.1,18,27,4,23,21,54,79,0,0,2021-2022,90.0,84.0,132.0
185,Leonardo Balerdi,ARG,DF,Marseille,Ligue 1,22,1999,10.6,9,6,9,0,0,5,14,35.7,9,11,4,7,19,28,30,0,0,2021-2022,90.0,161.32075471698113,76.41509433962264
186,Iván Balliu,ALB,DF,Rayo Vallecano,La Liga,29,1992,35.0,45,22,25,11,9,19,31,61.3,12,24,5,19,39,84,64,0,0,2021-2022,90.0,100.28571428571428,115.71428571428571
187,Fodé Ballo-Touré,SEN,DF,Milan,Serie A,24,1997,5.0,18,14,5,13,0,4,9,44.4,5,6,2,4,3,21,5,0,0,2021-2022,90.0,54.0,324.0
188,Folarin Balogun,USA,FW,Arsenal,Premier League,20,2001,0.8,1,1,0,0,1,0,0,0.0,0,1,0,1,0,1,1,0,0,2021-2022,90.0,0.0,112.5
189,Abdoulaye Bamba,CIV,"DF,FW",Angers,Ligue 1,31,1990,5.1,6,5,6,0,0,4,11,36.4,7,5,1,4,9,15,13,0,0,2021-2022,90.0,158.82352941176472,105.88235294117648
190,Jonathan Bamba,CIV,"MF,FW",Lille,Ligue 1,25,1996,27.0,30,12,13,9,8,13,36,36.1,23,24,1,23,21,51,10,0,0,2021-2022,90.0,70.0,100.0
191,Patrick Bamford,ENG,FW,Leeds United,Premier League,27,1993,6.2,1,0,0,1,0,0,3,0.0,3,8,2,6,2,3,8,0,0,2021-2022,90.0,29.032258064516128,14.516129032258064
192,Filippo Bandinelli,ITA,MF,Empoli,Serie A,26,1995,21.7,33,20,10,17,6,15,31,48.4,16,22,5,17,10,43,37,2,0,2021-2022,90.0,41.474654377880185,136.8663594470046
193,Mattia Bani,ITA,DF,Genoa,Serie A,27,1993,13.5,23,13,17,6,0,14,18,77.8,4,19,11,8,20,43,76,0,0,2021-2022,90.0,133.33333333333334,153.33333333333334
194,Simon Banza,COD,FW,Lens,Ligue 1,24,1996,1.4,2,1,0,0,2,0,2,0.0,2,1,0,1,1,3,2,0,0,2021-2022,90.0,64.28571428571429,128.57142857142858
195,Shandon Baptiste,GRN,MF,Brentford,Premier League,23,1998,10.1,14,4,9,4,1,6,15,40.0,9,10,0,10,11,25,12,0,0,2021-2022,90.0,98.01980198019803,124.75247524752476
196,Antonín Barák,CZE,"MF,FW",Hellas Verona,Serie A,26,1994,26.0,18,8,9,8,1,5,17,29.4,12,32,5,27,6,24,26,0,0,2021-2022,90.00000000000001,20.76923076923077,62.307692307692314
197,Barbero,ESP,"FW,MF",Osasuna,La Liga,22,1998,0.2,0,0,0,0,0,0,0,0.0,0,0,0,0,0,0,1,0,0,2021-2022,90.0,0.0,0.0
198,Danilo Barbosa,BRA,DF,Nice,Ligue 1,25,1996,1.0,0,0,0,0,0,0,0,0.0,0,1,1,0,2,2,10,0,0,2021-2022,90.0,180.0,0.0
199,Barcia,ESP,DF,Granada,La Liga,20,2000,0.8,0,0,0,0,0,0,0,0.0,0,1,1,0,1,1,0,1,0,2021-2022,90.0,112.5,0.0
200,Bradley Barcola,FRA,"FW,MF",Lyon,Ligue 1,18,2002,2.9,7,4,2,3,2,1,8,12.5,7,7,1,6,2,9,1,0,0,2021-2022,90.0,62.06896551724138,217.24137931034483
Rk,Player,Nation,Pos,Squad,Comp,0,0,90.0,0,0,3,3,3,Tkl,0,0.0,0,0,0,0,0,0,0,0,0,2021-2022,90.0,0.0,0.0
201,Melvin Bard,FRA,DF,Nice,Ligue 1,20,2000,28.8,59,37,38,17,4,41,63,65.1,22,33,10,23,51,110,56,0,0,2021-2022,90.0,159.375,184.375
202,Enis Bardhi,MKD,"MF,FW",Levante,La Liga,26,1995,18.9,29,12,12,14,3,12,35,34.3,23,13,2,11,10,39,7,0,0,2021-2022,90.0,47.61904761904762,138.0952380952381
203,Francesco Bardi,ITA,GK,Bologna,Serie A,29,1992,2.0,0,0,0,0,0,0,0,0.0,0,0,0,0,0,0,0,0,0,2021-2022,90.0,0.0,0.0
204,Keidi Bare,ALB,MF,Espanyol,La Liga,23,1997,16.5,27,17,14,12,1,11,31,35.5,20,20,10,10,15,42,26,1,0,2021-2022,90.0,81.81818181818183,147.27272727272728
205,Nicolò Barella,ITA,MF,Inter,Serie A,24,1997,32.4,63,42,17,35,11,29,55,52.7,26,26,2,24,21,84,8,2,0,2021-2022,90.0,58.333333333333336,175.0
206,Kike Barja,ESP,"MF,FW",Osasuna,La Liga,24,1997,9.6,15,11,4,7,4,8,22,36.4,14,10,1,9,9,24,4,0,0,2021-2022,90.0,84.375,140.625
207,Ross Barkley,ENG,"MF,FW",Chelsea,Premier League,27,1993,2.0,0,0,0,0,0,0,1,0.0,1,1,0,1,1,1,0,0,0,2021-2022,90.0,45.0,0.0
208,Aymen Barkok,MAR,"MF,DF",Eint Frankfurt,Bundesliga,23,1998,1.8,6,2,2,3,1,2,7,28.6,5,4,1,3,5,11,6,0,0,2021-2022,90.0,250.0,300.0
209,Ashley Barnes,ENG,FW,Burnley,Premier League,31,1989,9.0,11,2,2,7,2,2,9,22.2,7,8,1,7,2,13,5,0,0,2021-2022,90.0,20.0,110.0
210,Harvey Barnes,ENG,"FW,MF",Leicester City,Premier League,23,1997,23.3,31,16,9,11,11,7,23,30.4,16,24,1,23,5,36,7,0,0,2021-2022,90.0,19.313304721030043,119.74248927038626
211,Antonio Barragán,ESP,DF,Elche,La Liga,34,1987,11.3,21,14,13,7,1,11,17,64.7,6,5,3,2,17,38,34,0,0,2021-2022,90.0,135.39823008849558,167.2566371681416
212,Leandro Barreiro Martins,LUX,MF,Mainz 05,Bundesliga,21,2000,19.9,63,32,23,27,13,29,50,58.0,21,23,6,17,32,95,23,0,0,2021-2022,90.0,144.72361809045228,284.9246231155779
213,Ander Barrenetxea,ESP,"FW,MF",Real Sociedad,La Liga,19,2001,6.1,15,10,9,6,0,8,18,44.4,10,7,0,7,2,17,2,0,0,2021-2022,90.0,29.508196721311478,221.31147540983608
214,Jacob Barrett Laursen,DEN,DF,Arminia,Bundesliga,26,1994,18.1,16,12,10,6,0,8,21,38.1,13,19,7,12,28,44,43,0,0,2021-2022,90.0,139.22651933701655,79.55801104972375
215,Musa Barrow,GAM,"FW,MF",Bologna,Serie A,22,1998,23.7,12,4,4,4,4,6,20,30.0,14,20,1,19,6,18,8,0,0,2021-2022,90.0,22.78481012658228,45.56962025316456
216,Abdourahmane Barry,GUI,DF,Greuther Fürth,Bundesliga,21,2000,2.3,6,4,3,3,0,5,7,71.4,2,5,2,3,4,10,1,0,0,2021-2022,90.0,156.52173913043478,234.7826086956522
217,Marc Bartra,ESP,DF,Betis,La Liga,30,1991,22.1,39,14,18,17,4,19,35,54.3,16,39,22,17,33,72,105,1,0,2021-2022,90.0,134.3891402714932,158.8235294117647
218,Daniele Baselli,ITA,"MF,FW",Torino,Serie A,29,1992,1.7,3,3,2,0,1,2,6,33.3,4,0,0,0,1,4,2,0,0,2021-2022,90.0,52.94117647058823,158.8235294117647
219,Daniele Baselli,ITA,MF,Cagliari,Serie A,29,1992,3.2,6,5,3,1,2,1,5,20.0,4,2,0,2,2,8,5,0,0,2021-2022,90.0,56.25,168.75
220,Toma Bašić,CRO,MF,Lazio,Serie A,24,1996,10.9,12,8,3,9,0,5,17,29.4,12,13,4,9,4,16,21,0,0,2021-2022,90.0,33.027522935779814,99.08256880733944
221,Toma Bašić,CRO,MF,Bordeaux,Ligue 1,24,1996,2.3,2,2,1,0,1,0,4,0.0,4,4,1,3,2,4,0,0,0,2021-2022,90.0,78.26086956521739,78.26086956521739
222,Amine Bassi,FRA,"MF,FW",Metz,Ligue 1,23,1997,2.0,6,3,2,3,1,1,3,33.3,2,5,0,5,0,6,0,0,0,2021-2022,90.0,0.0,270.0
223,Álvaro Bastida,ESP,MF,Cádiz,La Liga,17,2004,2.2,7,4,2,4,1,4,5,80.0,1,1,0,1,3,10,1,0,0,2021-2022,90.0,122.72727272727272,286.3636363636364
224,Alessandro Bastoni,ITA,DF,Inter,Serie A,22,1999,25.7,44,25,28,13,3,17,34,50.0,17,22,12,10,35,79,59,1,0,2021-2022,90.0,122.568093385214,154.08560311284046
225,Simone Bastoni,ITA,"MF,DF",Spezia,Serie A,24,1996,25.4,52,34,28,17,7,21,65,32.3,44,38,11,27,30,82,31,0,0,2021-2022,90.0,106.2992125984252,184.251968503937
Rk,Player,Nation,Pos,Squad,Comp,0,0,90.0,0,0,3,3,3,Tkl,0,0.0,0,0,0,0,0,0,0,0,0,2021-2022,90.0,0.0,0.0
226,Lewis Bate,ENG,MF,Leeds United,Premier League,18,2002,1.6,1,0,0,0,1,0,8,0.0,8,1,0,1,1,2,1,0,0,2021-2022,90.0,56.25,56.25
227,Rodrigo Battaglia,ARG,MF,Mallorca,La Liga,30,1991,13.1,32,16,13,19,0,15,30,50.0,15,21,10,11,10,42,36,0,0,2021-2022,90.0,68.70229007633588,219.84732824427482
228,Maximilian Bauer,GER,DF,Greuther Fürth,Bundesliga,21,2000,18.8,28,15,17,10,1,11,28,39.3,17,24,14,10,29,57,99,0,0,2021-2022,90.0,138.82978723404256,134.04255319148936
229,Oliver Baumann,GER,GK,Hoffenheim,Bundesliga,31,1990,33.0,0,0,0,0,0,0,3,0.0,3,0,0,0,0,0,19,1,0,2021-2022,90.0,0.0,0.0
230,Timo Baumgartl,GER,DF,Union Berlin,Bundesliga,25,1996,24.1,59,28,34,21,4,31,47,66.0,16,27,11,16,37,96,58,0,0,2021-2022,90.0,138.17427385892117,220.33195020746888
231,Julian Baumgartlinger,AUT,"MF,FW",Leverkusen,Bundesliga,33,1988,1.0,3,1,2,1,0,1,2,50.0,1,1,0,1,2,5,0,0,0,2021-2022,90.0,180.0,270.0
232,Christoph Baumgartner,AUT,"MF,FW",Hoffenheim,Bundesliga,21,1999,21.0,28,15,14,7,7,13,32,40.6,19,24,3,21,8,36,16,0,0,2021-2022,90.0,34.285714285714285,120.0
233,Jon Bautista,ESP,MF,Real Sociedad,La Liga,26,1995,0.5,3,0,0,3,0,0,1,0.0,1,1,0,1,1,4,1,0,0,2021-2022,90.0,180.0,540.0
234,Paul Baysse,FRA,"MF,DF",Bordeaux,Ligue 1,33,1988,0.1,1,1,0,1,0,0,0,0.0,0,0,0,0,0,1,1,0,0,2021-2022,90.0,0.0,900.0
235,Noah Joel Sarenren Bazee,NGA,"MF,FW",Augsburg,Bundesliga,24,1996,2.7,5,2,2,2,1,3,4,75.0,1,8,2,6,1,6,4,0,0,2021-2022,90.0,33.33333333333333,166.66666666666666
236,Bebé,CPV,FW,Rayo Vallecano,La Liga,31,1990,9.6,6,5,1,3,2,4,16,25.0,12,18,0,18,3,9,6,0,0,2021-2022,90.0,28.125000000000004,56.25000000000001
237,Ihlas Bebou,TOG,"FW,DF",Hoffenheim,Bundesliga,27,1994,23.2,22,14,5,12,5,7,21,33.3,14,20,3,17,12,34,25,0,0,2021-2022,90.0,46.55172413793103,85.3448275862069
238,Rodrigo Becão,BRA,DF,Udinese,Serie A,25,1996,34.8,81,46,49,30,2,34,60,56.7,26,45,20,25,42,123,89,3,0,2021-2022,90.0,108.62068965517241,209.48275862068965
239,Mads Bech Sørensen,DEN,DF,Brentford,Premier League,22,1999,9.3,8,7,6,2,0,6,7,85.7,1,9,6,3,6,14,25,0,0,2021-2022,90.0,58.06451612903225,77.41935483870967
240,Sheraldo Becker,SUR,"FW,MF",Union Berlin,Bundesliga,26,1995,19.5,9,6,3,4,2,6,18,33.3,12,11,0,11,2,11,4,0,0,2021-2022,90.0,9.23076923076923,41.53846153846154
241,Jan Bednarek,POL,DF,Southampton,Premier League,25,1996,29.2,32,15,18,13,1,19,33,57.6,14,48,27,21,72,104,141,0,0,2021-2022,90.0,221.91780821917808,98.63013698630138
242,Donny van de Beek,NED,MF,Manchester Utd,Premier League,24,1997,0.8,6,4,4,1,1,1,2,50.0,1,5,1,4,2,8,1,0,0,2021-2022,90.0,225.0,675.0
243,Donny van de Beek,NED,MF,Everton,Premier League,24,1997,5.4,15,7,8,6,1,6,13,46.2,7,6,2,4,6,21,4,0,0,2021-2022,90.0,99.99999999999999,249.99999999999997
244,Asmir Begović,BIH,GK,Everton,Premier League,34,1987,3.0,0,0,0,0,0,0,0,0.0,0,0,0,0,0,0,3,0,0,2021-2022,90.0,0.0,0.0
245,Valon Behrami,SUI,"MF,FW",Genoa,Serie A,36,1985,3.5,3,1,0,2,1,0,7,0.0,7,4,1,3,1,4,4,0,0,2021-2022,90.0,25.714285714285715,77.14285714285714
246,Kevin Behrens,GER,FW,Union Berlin,Bundesliga,30,1991,5.5,3,2,1,1,1,0,4,0.0,4,3,0,3,3,6,7,0,0,2021-2022,90.0,49.09090909090909,49.09090909090909
247,Youcef Belaïli,ALG,"MF,FW",Brest,Ligue 1,29,1992,9.2,2,1,0,0,2,2,9,22.2,7,5,1,4,7,9,4,0,0,2021-2022,90.0,68.47826086956522,19.565217391304348
248,Vid Belec,SVN,GK,Salernitana,Serie A,31,1990,21.5,0,0,0,0,0,0,0,0.0,0,0,0,0,0,0,9,1,0,2021-2022,90.0,0.0,0.0
249,Ishak Belfodil,ALG,FW,Hertha BSC,Bundesliga,29,1992,18.2,9,6,4,4,1,4,8,50.0,4,9,1,8,5,14,16,0,0,2021-2022,90.0,24.725274725274726,44.505494505494504
250,Haris Belkebla,ALG,MF,Brest,Ligue 1,27,1994,25.7,46,23,21,21,4,18,39,46.2,21,26,6,20,48,94,30,1,0,2021-2022,90.0,168.09338521400778,161.08949416342412
Rk,Player,Nation,Pos,Squad,Comp,0,0,90.0,0,0,3,3,3,Tkl,0,0.0,0,0,0,0,0,0,0,0,0,2021-2022,90.0,0.0,0.0
251,Stefan Bell,GER,DF,Mainz 05,Bundesliga,29,1991,31.8,54,23,37,16,1,30,63,47.6,33,26,15,11,41,95,112,1,0,2021-2022,90.0,116.0377358490566,152.83018867924528
252,Armel Bella Kotchap,GER,DF,Bochum,Bundesliga,19,2001,19.6,34,20,25,9,0,18,28,64.3,10,21,16,5,42,76,84,2,0,2021-2022,90.0,192.85714285714283,156.12244897959184
253,Raoul Bellanova,ITA,"DF,FW",Cagliari,Serie A,21,2000,27.7,29,15,14,12,3,6,27,22.2,21,39,8,31,21,50,51,0,0,2021-2022,90.0,68.23104693140795,94.22382671480145
254,Karim Bellarabi,GER,"FW,MF",Leverkusen,Bundesliga,31,1990,7.6,9,4,4,4,1,3,13,23.1,10,5,0,5,9,18,4,0,0,2021-2022,90.0,106.57894736842105,106.57894736842105
255,Jean-Ricner Bellegarde,FRA,MF,Strasbourg,Ligue 1,23,1998,25.9,51,32,21,21,9,17,41,41.5,24,29,4,25,27,78,19,0,0,2021-2022,90.0,93.82239382239383,177.22007722007723
256,Héctor Bellerín,ESP,DF,Betis,La Liga,26,1995,22.0,52,32,29,20,3,31,44,70.5,13,11,2,9,23,75,57,1,0,2021-2022,90.0,94.0909090909091,212.72727272727275
257,Jude Bellingham,ENG,MF,Dortmund,Bundesliga,18,2003,31.0,52,34,15,31,6,21,53,39.6,32,50,4,46,42,94,32,0,0,2021-2022,90.0,121.93548387096774,150.96774193548387
258,George Bello,USA,DF,Arminia,Bundesliga,19,2002,4.8,7,7,7,0,0,4,4,100.0,0,5,4,1,6,13,11,0,0,2021-2022,90.0,112.50000000000001,131.25
259,Jeanuël Belocian,FRA,DF,Rennes,Ligue 1,16,2005,0.1,0,0,0,0,0,0,0,0.0,0,0,0,0,0,0,0,0,0,2021-2022,90.0,0.0,0.0
260,Andrea Belotti,ITA,FW,Torino,Serie A,27,1993,15.2,7,3,2,2,3,3,12,25.0,9,12,4,8,2,9,9,0,0,2021-2022,90.0,11.842105263157894,41.44736842105263
261,Fran Beltrán,ESP,MF,Celta Vigo,La Liga,22,1999,28.9,56,41,27,23,6,28,68,41.2,40,29,5,24,32,88,39,0,0,2021-2022,90.00000000000001,99.65397923875433,174.3944636678201
262,Hatem Ben Arfa,FRA,"FW,MF",Lille,Ligue 1,34,1987,3.5,4,2,2,1,1,2,4,50.0,2,3,0,3,0,4,1,0,0,2021-2022,90.0,0.0,102.85714285714286
263,Salim Ben Seghir,FRA,MF,Marseille,Ligue 1,18,2003,0.0,0,0,0,0,0,0,0,0.0,0,0,0,0,0,0,0,0,0,2021-2022,,,
264,Wissam Ben Yedder,FRA,FW,Monaco,Ligue 1,30,1990,28.1,18,8,1,11,6,6,15,40.0,9,12,1,11,0,18,1,0,0,2021-2022,90.0,0.0,57.65124555160142
265,Marco Benassi,ITA,"DF,MF",Fiorentina,Serie A,26,1994,1.8,1,0,1,0,0,1,2,50.0,1,3,0,3,3,4,3,0,0,2021-2022,90.0,150.0,50.0
266,Marco Benassi,ITA,MF,Empoli,Serie A,26,1994,4.2,6,3,3,2,1,1,10,10.0,9,4,0,4,3,9,6,0,0,2021-2022,90.0,64.28571428571428,128.57142857142856
267,Darío Benedetto,ARG,"FW,MF",Elche,La Liga,31,1990,6.6,5,1,2,2,1,3,6,50.0,3,4,0,4,1,6,1,0,0,2021-2022,90.0,13.636363636363637,68.18181818181819
268,Darío Benedetto,ARG,"FW,MF",Marseille,Ligue 1,31,1990,0.6,0,0,0,0,0,0,0,0.0,0,2,0,2,0,0,0,0,0,2021-2022,90.0,0.0,0.0
269,László Bénes,SVK,MF,Gladbach,Bundesliga,23,1997,2.7,5,3,1,3,1,1,6,16.7,5,5,2,3,2,7,5,0,0,2021-2022,90.0,66.66666666666666,166.66666666666666
270,Walter Benítez,ARG,GK,Nice,Ligue 1,28,1993,37.0,0,0,0,0,0,0,2,0.0,2,1,0,1,0,0,12,2,0,2021-2022,90.0,0.0,0.0
271,Iker Benito,ESP,"FW,MF",Osasuna,La Liga,18,2002,1.3,2,1,1,0,1,0,1,0.0,1,2,0,2,0,2,2,0,0,2021-2022,90.0,0.0,138.46153846153845
272,Loris Benito,SUI,DF,Bordeaux,Ligue 1,29,1992,0.7,0,0,0,0,0,0,0,0.0,0,0,0,0,1,1,3,1,0,2021-2022,90.0,128.57142857142858,0.0
273,Pedro Benito,ESP,FW,Cádiz,La Liga,21,2000,0.3,0,0,0,0,0,0,1,0.0,1,0,0,0,0,0,0,0,0,2021-2022,90.0,0.0,0.0
274,Filip Benković,CRO,"DF,FW",Udinese,Serie A,24,1997,0.1,0,0,0,0,0,0,0,0.0,0,0,0,0,0,0,0,0,0,2021-2022,90.0,0.0,0.0
275,Ismaël Bennacer,ALG,MF,Milan,Serie A,23,1997,16.9,44,30,22,15,7,21,50,42.0,29,20,4,16,25,69,15,0,0,2021-2022,90.0,133.13609467455623,234.31952662721895
Rk,Player,Nation,Pos,Squad,Comp,0,0,90.0,0,0,3,3,3,Tkl,0,0.0,0,0,0,0,0,0,0,0,0,2021-2022,90.0,0.0,0.0
276,Keanan Bennetts,ENG,"FW,DF",Gladbach,Bundesliga,22,1999,0.6,2,0,1,1,0,1,1,100.0,0,1,0,1,0,2,0,0,0,2021-2022,90.0,0.0,300.0
277,Saïd Benrahma,ALG,"FW,MF",West Ham,Premier League,25,1995,24.1,28,17,16,9,3,15,38,39.5,23,17,1,16,9,37,8,0,0,2021-2022,90.0,33.60995850622407,104.5643153526971
278,Ramy Bensebaini,ALG,DF,Gladbach,Bundesliga,26,1995,22.4,42,30,24,15,3,27,44,61.4,17,33,7,26,39,81,77,1,0,2021-2022,90.0,156.69642857142858,168.75
279,Nabil Bentaleb,ALG,MF,Angers,Ligue 1,26,1994,16.8,42,24,15,20,7,16,29,55.2,13,24,9,15,28,70,13,0,0,2021-2022,90.0,150.0,225.0
280,Rodrigo Bentancur,URU,MF,Tottenham,Premier League,24,1997,15.1,36,18,14,14,8,16,32,50.0,16,24,9,15,20,56,35,0,0,2021-2022,90.0,119.20529801324504,214.56953642384107
281,Rodrigo Bentancur,URU,MF,Juventus,Serie A,24,1997,12.8,32,18,11,18,3,7,20,35.0,13,15,2,13,26,58,15,1,0,2021-2022,90.0,182.8125,225.0
282,Christian Benteke,BEL,FW,Crystal Palace,Premier League,30,1990,12.7,3,2,1,2,0,2,6,33.3,4,7,3,4,2,5,33,0,0,2021-2022,90.0,14.173228346456694,21.25984251968504
283,Karim Benzema,FRA,FW,Real Madrid,La Liga,33,1987,28.8,11,9,5,3,3,2,9,22.2,7,10,0,10,4,15,13,0,0,2021-2022,90.0,12.5,34.375
284,Alessandro Berardi,ITA,GK,Hellas Verona,Serie A,30,1991,1.0,0,0,0,0,0,0,0,0.0,0,0,0,0,0,0,0,0,0,2021-2022,90.0,0.0,0.0
285,Domenico Berardi,ITA,FW,Sassuolo,Serie A,26,1994,31.3,32,19,9,16,7,15,57,26.3,42,39,2,37,31,63,23,0,0,2021-2022,90.0,89.13738019169328,92.01277955271566
286,Yuri Berchiche,ESP,DF,Athletic Club,La Liga,31,1990,11.3,25,11,10,11,4,7,14,50.0,7,19,6,13,13,38,25,0,0,2021-2022,90.0,103.53982300884955,199.1150442477876
287,Álex Berenguer,ESP,MF,Athletic Club,La Liga,26,1995,24.1,45,26,23,14,8,11,51,21.6,40,40,2,38,16,61,20,0,0,2021-2022,90.0,59.75103734439834,168.04979253112032
288,Bartosz Bereszyński,POL,DF,Sampdoria,Serie A,29,1992,32.7,64,38,34,25,5,37,80,46.3,43,38,12,26,42,106,73,1,0,2021-2022,90.0,115.59633027522935,176.14678899082568
289,Jóhann Berg Guðmundsson,ISL,MF,Burnley,Premier League,30,1990,12.2,16,6,7,7,2,5,20,25.0,15,11,2,9,12,28,22,0,0,2021-2022,90.0,88.52459016393443,118.03278688524591
290,Patrick Berg,NOR,MF,Lens,Ligue 1,23,1997,3.4,14,6,6,8,0,0,4,0.0,4,2,1,1,4,18,3,0,0,2021-2022,90.0,105.88235294117646,370.5882352941176
291,Mitchell van Bergen,NED,"FW,MF",Reims,Ligue 1,21,1999,10.9,8,5,7,0,1,6,15,40.0,9,9,0,9,4,12,7,0,0,2021-2022,90.0,33.027522935779814,66.05504587155963
292,Steven Bergwijn,NED,"FW,MF",Tottenham,Premier League,23,1997,6.3,3,2,2,1,0,1,10,10.0,9,3,0,3,1,4,8,0,0,2021-2022,90.0,14.285714285714286,42.85714285714286
293,Etrit Berisha,ALB,GK,Torino,Serie A,32,1989,10.0,0,0,0,0,0,0,0,0.0,0,0,0,0,0,0,4,0,0,2021-2022,90.0,0.0,0.0
294,Valon Berisha,KVX,"MF,FW",Reims,Ligue 1,28,1993,5.1,10,7,2,5,3,2,10,20.0,8,9,0,9,4,14,3,0,0,2021-2022,90.0,70.58823529411765,176.47058823529412
295,Federico Bernardeschi,ITA,"MF,FW",Juventus,Serie A,27,1994,16.4,16,10,7,4,5,6,13,46.2,7,12,4,8,5,21,15,0,0,2021-2022,90.0,27.439024390243905,87.8048780487805
296,Paul Bernardoni,FRA,GK,Angers,Ligue 1,24,1997,13.0,3,2,3,0,0,3,4,75.0,1,0,0,0,0,3,8,1,0,2021-2022,90.00000000000001,0.0,20.76923076923077
297,Paul Bernardoni,FRA,GK,Saint-Étienne,Ligue 1,24,1997,19.0,0,0,0,0,0,0,0,0.0,0,0,0,0,0,0,14,2,0,2021-2022,90.0,0.0,0.0
298,Juan Bernat,ESP,"DF,MF",Paris S-G,Ligue 1,28,1993,10.6,24,14,10,10,4,13,18,72.2,5,8,0,8,8,32,16,0,0,2021-2022,90.0,67.9245283018868,203.77358490566039
299,Dimitry Bertaud,COD,GK,Montpellier,Ligue 1,23,1998,9.3,0,0,0,0,0,0,1,0.0,1,0,0,0,0,0,5,1,0,2021-2022,90.0,0.0,0.0
300,Jason Berthomier,FRA,MF,Clermont Foot,Ligue 1,31,1990,19.2,29,14,5,17,7,12,34,35.3,22,14,2,12,8,37,4,1,0,2021-2022,90.0,37.5,135.9375
Rk,Player,Nation,Pos,Squad,Comp,0,0,90.0,0,0,3,3,3,Tkl,0,0.0,0,0,0,0,0,0,0,0,0,2021-2022,90.0,0.0,0.0
301,Nicolò Bertola,ITA,"MF,DF",Spezia,Serie A,18,2003,0.4,3,2,3,0,0,3,4,75.0,1,0,0,0,3,6,1,0,0,2021-2022,90.0,675.0,675.0
302,Ryan Bertrand,ENG,DF,Leicester City,Premier League,31,1989,3.7,8,5,3,4,1,2,5,40.0,3,8,3,5,1,9,7,0,0,2021-2022,90.0,24.324324324324323,194.59459459459458
303,Daniel Bessa,ITA,MF,Hellas Verona,Serie A,28,1993,8.5,7,2,3,3,1,4,15,26.7,11,13,3,10,5,12,11,0,0,2021-2022,90.0,52.94117647058824,74.11764705882354
304,Beto,GNB,FW,Udinese,Serie A,23,1998,24.1,21,6,2,14,5,9,19,47.4,10,16,1,15,5,26,25,1,0,2021-2022,90.0,18.672199170124482,78.42323651452283
305,Jordan Beyer,GER,DF,Gladbach,Bundesliga,21,2000,15.4,46,27,32,13,1,23,39,59.0,16,18,5,13,15,61,52,2,0,2021-2022,90.0,87.66233766233766,268.83116883116884
306,Giulian Biancone,FRA,"DF,MF",Troyes,Ligue 1,21,2000,25.5,70,42,44,22,4,40,69,58.0,29,23,8,15,53,123,71,1,0,2021-2022,90.0,187.05882352941177,247.05882352941177
307,Bartosz Białek,POL,"FW,DF",Wolfsburg,Bundesliga,19,2001,2.0,0,0,0,0,0,0,1,0.0,1,1,0,1,0,0,2,0,0,2021-2022,90.0,0.0,0.0
308,Ermin Bičakčić,BIH,DF,Hoffenheim,Bundesliga,31,1990,0.1,0,0,0,0,0,0,0,0.0,0,0,0,0,0,0,0,0,0,2021-2022,90.0,0.0,0.0
309,Mads Bidstrup,DEN,MF,Brentford,Premier League,20,2001,0.5,1,0,0,1,0,0,3,0.0,3,0,0,0,1,2,2,0,0,2021-2022,90.0,180.0,180.0
310,Pedro Bigas,ESP,DF,Elche,La Liga,30,1990,17.2,24,10,16,8,0,9,20,45.0,11,21,16,5,18,42,77,1,0,2021-2022,90.0,94.18604651162792,125.58139534883722
311,El Bilal Touré,MLI,FW,Reims,Ligue 1,19,2001,13.3,13,6,4,6,3,2,7,28.6,5,10,3,7,6,19,19,0,0,2021-2022,90.0,40.6015037593985,87.96992481203007
312,Jean-Claude Billong,CMR,DF,Clermont Foot,Ligue 1,27,1993,10.9,17,8,14,1,2,8,11,72.7,3,9,1,8,10,27,35,0,0,2021-2022,90.0,82.56880733944953,140.36697247706422
313,Luis Binks,ENG,DF,Bologna,Serie A,19,2001,7.2,8,4,7,1,0,4,6,66.7,2,6,5,1,17,25,33,1,0,2021-2022,90.0,212.5,100.0
314,Cristiano Biraghi,ITA,DF,Fiorentina,Serie A,28,1992,35.0,37,24,17,15,5,22,53,41.5,31,28,10,18,19,56,31,1,0,2021-2022,90.0,48.857142857142854,95.14285714285714
315,Davide Biraschi,ITA,DF,Genoa,Serie A,27,1994,10.3,31,16,19,9,3,17,24,70.8,7,16,9,7,16,47,26,0,0,2021-2022,90.0,139.80582524271844,270.873786407767
316,Tom Bischof,GER,MF,Hoffenheim,Bundesliga,16,2005,0.2,0,0,0,0,0,0,0,0.0,0,1,0,1,0,0,1,0,0,2021-2022,90.0,0.0,0.0
317,Yves Bissouma,MLI,MF,Brighton,Premier League,24,1996,23.5,76,49,35,37,4,21,37,56.8,16,33,3,30,50,126,49,0,0,2021-2022,90.0,191.48936170212764,291.063829787234
318,Nathan Bitu Mazala,FRA,DF,Paris S-G,Ligue 1,18,2002,0.1,0,0,0,0,0,0,0,0.0,0,1,0,1,0,0,0,0,0,2021-2022,90.0,0.0,0.0
319,Marco Bizot,NED,GK,Brest,Ligue 1,30,1991,38.0,3,1,3,0,0,3,5,60.0,2,1,0,1,0,3,24,1,0,2021-2022,90.0,0.0,7.105263157894737
320,Bjarki Bjarkason,ISL,MF,Venezia,Serie A,21,2000,0.0,0,0,0,0,0,0,0,0.0,0,0,0,0,0,0,0,0,0,2021-2022,,,
321,Antonio Blanco,ESP,MF,Real Madrid,La Liga,21,2000,0.3,2,0,1,1,0,0,0,0.0,0,1,1,0,1,3,0,0,0,2021-2022,90.0,300.0,600.0
322,Ludovic Blas,FRA,"MF,FW",Nantes,Ligue 1,23,1997,32.9,33,18,7,20,6,15,44,34.1,29,33,3,30,31,64,6,1,0,2021-2022,90.0,84.80243161094225,90.27355623100304
323,Danny Blum,GER,FW,Bochum,Bundesliga,30,1991,3.8,2,1,0,0,2,0,2,0.0,2,4,0,4,2,4,1,0,0,2021-2022,90.0,47.368421052631575,47.368421052631575
324,Myron Boadu,NED,FW,Monaco,Ligue 1,20,2001,10.7,9,7,2,3,4,1,5,20.0,4,6,0,6,2,11,1,0,0,2021-2022,90.0,16.82242990654206,75.70093457943926
325,Jérôme Boateng,GER,DF,Lyon,Ligue 1,32,1988,18.0,20,15,11,9,0,9,17,52.9,8,20,10,10,20,40,73,0,0,2021-2022,90.0,100.0,100.0
Rk,Player,Nation,Pos,Squad,Comp,0,0,90.0,0,0,3,3,3,Tkl,0,0.0,0,0,0,0,0,0,0,0,0,2021-2022,90.0,0.0,0.0
326,Kevin-Prince Boateng,GHA,"MF,FW",Hertha BSC,Bundesliga,34,1987,7.7,6,5,1,4,1,3,9,33.3,6,7,2,5,6,12,11,0,0,2021-2022,90.0,70.12987012987013,70.12987012987013
327,Antonin Bobichon,FRA,"MF,FW",Angers,Ligue 1,25,1995,0.4,1,0,0,1,0,0,0,0.0,0,0,0,0,1,2,0,0,0,2021-2022,90.0,225.0,225.0
328,Herbert Bockhorn,GER,DF,Bochum,Bundesliga,26,1995,9.4,20,14,13,4,3,12,20,60.0,8,10,1,9,14,34,18,0,0,2021-2022,90.0,134.04255319148936,191.48936170212764
329,Jean-Paul Boëtius,NED,MF,Mainz 05,Bundesliga,27,1994,20.0,40,23,18,17,5,22,53,41.5,31,41,3,38,25,65,11,0,0,2021-2022,90.0,112.5,180.0
330,Jeremie Boga,CIV,"FW,MF",Atalanta,Serie A,24,1997,8.5,7,3,0,4,3,4,6,66.7,2,6,0,6,1,8,3,1,0,2021-2022,90.0,10.588235294117647,74.11764705882354
331,Jeremie Boga,CIV,"FW,MF",Sassuolo,Serie A,24,1997,7.4,7,4,1,2,4,2,3,66.7,1,3,0,3,2,9,1,1,0,2021-2022,90.0,24.324324324324323,85.13513513513513
332,Luka Bogdan,CRO,DF,Salernitana,Serie A,25,1996,4.4,6,3,6,0,0,4,8,50.0,4,3,2,1,6,12,21,0,0,2021-2022,90.0,122.72727272727272,122.72727272727272
333,Emil Bohinen,NOR,MF,Salernitana,Serie A,22,1999,7.8,15,9,4,9,2,10,20,50.0,10,17,3,14,12,27,14,0,0,2021-2022,90.0,138.46153846153845,173.07692307692307
334,Quentin Boisgard,FRA,"MF,FW",Lorient,Ligue 1,24,1997,10.6,19,11,6,10,3,8,17,47.1,9,15,0,15,6,25,5,0,0,2021-2022,90.0,50.943396226415096,161.32075471698113
335,Charles Boli,FRA,"MF,DF",Lens,Ligue 1,22,1998,0.4,2,1,0,2,0,0,0,0.0,0,0,0,0,0,2,0,0,0,2021-2022,90.0,0.0,450.0
336,Willy Boly,CIV,DF,Wolves,Premier League,30,1991,10.0,25,19,18,7,0,8,15,53.3,7,14,6,8,14,39,35,0,0,2021-2022,90.0,126.0,225.0
337,Giacomo Bonaventura,ITA,MF,Fiorentina,Serie A,31,1989,25.2,33,17,12,16,5,21,46,45.7,25,20,2,18,14,47,9,1,0,2021-2022,90.0,50.00000000000001,117.85714285714288
338,Federico Bonazzoli,ITA,"FW,MF",Salernitana,Serie A,24,1997,20.7,24,12,9,8,7,6,25,24.0,19,17,1,16,6,30,7,0,0,2021-2022,90.0,26.086956521739133,104.34782608695653
339,Tarsis Bonga,GER,"MF,FW",Bochum,Bundesliga,24,1997,0.2,0,0,0,0,0,0,0,0.0,0,0,0,0,0,0,0,0,0,2021-2022,90.0,0.0,0.0
340,Kevin Bonifazi,ITA,DF,Bologna,Serie A,25,1996,13.4,25,16,16,7,2,13,14,92.9,1,22,7,15,16,41,35,0,0,2021-2022,90.0,107.46268656716417,167.910447761194
341,Solomon Bonnah,NED,DF,RB Leipzig,Bundesliga,17,2003,0.1,0,0,0,0,0,0,0,0.0,0,1,0,1,1,1,0,0,0,2021-2022,90.0,900.0,0.0
342,Leonardo Bonucci,ITA,DF,Juventus,Serie A,34,1987,22.3,14,5,4,10,0,8,13,61.5,5,22,17,5,26,40,82,0,0,2021-2022,90.0,104.93273542600896,56.502242152466366
343,Sebastiaan Bornauw,BEL,DF,Wolfsburg,Bundesliga,22,1999,22.3,30,19,23,5,2,16,25,64.0,9,29,8,21,42,72,97,1,0,2021-2022,90.0,169.50672645739908,121.0762331838565
344,Rafael Borré,COL,FW,Eint Frankfurt,Bundesliga,25,1995,26.4,31,22,4,13,14,7,33,21.2,26,24,4,20,5,36,9,0,0,2021-2022,90.0,17.045454545454547,105.68181818181819
345,Sven Botman,NED,DF,Lille,Ligue 1,21,2000,25.0,24,11,13,11,0,12,18,66.7,6,32,21,11,26,50,116,0,0,2021-2022,90.0,93.6,86.39999999999999
346,Denis Bouanga,GAB,"FW,MF",Saint-Étienne,Ligue 1,26,1994,27.1,46,25,14,13,19,22,63,34.9,41,30,0,30,8,54,34,1,0,2021-2022,90.0,26.568265682656826,152.76752767527677
347,Hicham Boudaoui,ALG,MF,Nice,Ligue 1,21,1999,18.0,31,18,15,10,6,13,36,36.1,23,17,4,13,18,49,15,0,0,2021-2022,90.0,90.0,155.0
348,Ryad Boudebouz,ALG,"MF,FW",Saint-Étienne,Ligue 1,31,1990,25.0,27,15,11,12,4,12,29,41.4,17,17,2,15,10,37,5,0,0,2021-2022,90.0,36.0,97.19999999999999
349,Sofiane Boufal,MAR,"FW,MF",Angers,Ligue 1,27,1993,25.9,44,29,19,16,9,18,38,47.4,20,19,2,17,7,51,1,0,0,2021-2022,90.0,24.324324324324326,152.8957528957529
350,Farid Boulaya,ALG,"MF,FW",Metz,Ligue 1,28,1993,17.0,18,10,7,9,2,14,38,36.8,24,8,2,6,12,30,5,0,0,2021-2022,90.0,63.529411764705884,95.29411764705883
Rk,Player,Nation,Pos,Squad,Comp,0,0,90.0,0,0,3,3,3,Tkl,0,0.0,0,0,0,0,0,0,0,0,0,2021-2022,90.0,0.0,0.0
351,Yassine Bounou,MAR,GK,Sevilla,La Liga,30,1991,31.0,0,0,0,0,0,0,0,0.0,0,0,0,0,0,0,11,1,0,2021-2022,90.0,0.0,0.0
352,Ismaëlben Boura,COM,DF,Lens,Ligue 1,20,2000,1.1,2,2,1,1,0,0,0,0.0,0,1,1,0,2,4,5,0,0,2021-2022,90.0,163.63636363636363,163.63636363636363
353,Mehdi Bourabia,MAR,MF,Spezia,Serie A,29,1991,3.1,5,1,2,3,0,3,11,27.3,8,7,6,1,3,8,10,0,0,2021-2022,90.0,87.09677419354838,145.16129032258064
354,Benjamin Bourigeaud,FRA,"FW,MF",Rennes,Ligue 1,27,1994,35.5,46,24,16,18,12,24,67,35.8,43,33,3,30,30,76,44,0,0,2021-2022,90.0,76.05633802816902,116.61971830985915
355,Redwan Bourles,FRA,"MF,FW",Lorient,Ligue 1,18,2003,0.2,0,0,0,0,0,0,0,0.0,0,0,0,0,0,0,0,0,0,2021-2022,90.0,0.0,0.0
356,Edoardo Bove,ITA,"MF,DF",Roma,Serie A,19,2002,0.8,1,1,1,0,0,0,2,0.0,2,1,0,1,1,2,0,0,0,2021-2022,90.0,112.5,112.5
357,Jarrod Bowen,ENG,FW,West Ham,Premier League,24,1996,33.1,36,20,20,11,5,17,44,38.6,27,29,2,27,21,57,14,0,0,2021-2022,90.0,57.09969788519637,97.88519637462235
358,Dedryck Boyata,BEL,DF,Hertha BSC,Bundesliga,30,1990,21.1,15,13,11,3,1,8,11,72.7,3,17,13,4,17,32,134,1,0,2021-2022,90.0,72.51184834123222,63.981042654028435
359,Lucas Boyé,ARG,FW,Elche,La Liga,25,1996,19.0,27,13,5,15,7,9,24,37.5,15,24,1,23,2,29,23,0,0,2021-2022,90.0,9.473684210526315,127.89473684210526
360,Domagoj Bradarić,CRO,DF,Lille,Ligue 1,21,1999,4.6,11,9,8,2,1,7,12,58.3,5,5,2,3,10,21,7,1,0,2021-2022,90.0,195.6521739130435,215.21739130434784
361,Bilal Brahimi,ALG,MF,Nice,Ligue 1,21,2000,4.2,1,1,0,1,0,0,2,0.0,2,1,0,1,2,3,1,0,0,2021-2022,90.0,42.857142857142854,21.428571428571427
362,Bilal Brahimi,ALG,FW,Angers,Ligue 1,21,2000,3.8,1,1,0,1,0,0,3,0.0,3,0,0,0,1,2,1,0,0,2021-2022,90.0,23.684210526315788,23.684210526315788
363,Martin Braithwaite,DEN,FW,Barcelona,La Liga,30,1991,2.6,1,1,0,0,1,0,0,0.0,0,2,0,2,1,2,1,0,0,2021-2022,90.0,34.61538461538461,34.61538461538461
364,Julian Brandt,GER,"MF,FW",Dortmund,Bundesliga,25,1996,23.1,37,19,13,20,4,17,54,31.5,37,19,2,17,24,61,14,1,0,2021-2022,89.99999999999999,93.50649350649348,144.15584415584414
365,Jarrad Branthwaite,ENG,DF,Everton,Premier League,19,2002,4.3,4,1,3,1,0,3,8,37.5,5,3,2,1,1,5,20,0,0,2021-2022,90.0,20.930232558139537,83.72093023255815
366,Darko Brašanac,SRB,MF,Osasuna,La Liga,29,1992,26.7,35,22,19,14,2,14,40,35.0,26,25,8,17,25,60,15,0,0,2021-2022,90.00000000000001,84.26966292134833,117.97752808988766
367,Lilian Brassier,FRA,DF,Brest,Ligue 1,21,1999,25.1,40,24,23,13,4,10,21,47.6,11,31,21,10,32,72,86,0,0,2021-2022,90.0,114.7410358565737,143.42629482071712
368,Claudio Bravo,CHI,GK,Betis,La Liga,38,1983,16.2,0,0,0,0,0,0,0,0.0,0,0,0,0,0,0,6,2,0,2021-2022,90.0,0.0,0.0
369,Iker Bravo,ESP,FW,Leverkusen,Bundesliga,16,2005,0.1,1,1,0,1,0,0,0,0.0,0,0,0,0,0,1,0,0,0,2021-2022,90.0,0.0,900.0
370,Fabian Bredlow,GER,GK,Stuttgart,Bundesliga,26,1995,4.0,0,0,0,0,0,0,0,0.0,0,0,0,0,0,0,1,0,0,2021-2022,90.0,0.0,0.0
371,Josip Brekalo,CRO,MF,Torino,Serie A,23,1998,25.4,9,5,5,1,3,3,21,14.3,18,16,1,15,4,13,7,1,0,2021-2022,90.0,14.173228346456694,31.88976377952756
372,Josip Brekalo,CRO,FW,Wolfsburg,Bundesliga,23,1998,0.2,0,0,0,0,0,0,0,0.0,0,0,0,0,0,0,0,0,0,2021-2022,90.0,0.0,0.0
373,Gleison Bremer,BRA,DF,Torino,Serie A,24,1997,32.1,49,24,27,22,0,18,28,64.3,10,54,23,31,105,154,137,0,0,2021-2022,90.0,294.39252336448595,137.38317757009344
374,Jimmy Briand,FRA,"FW,MF",Bordeaux,Ligue 1,35,1985,2.5,2,0,2,0,0,0,2,0.0,2,0,0,0,1,3,2,0,0,2021-2022,90.0,36.0,72.0
375,Yan Brice Eteki,CMR,MF,Granada,La Liga,23,1997,3.8,6,3,3,2,1,3,7,42.9,4,7,3,4,4,10,6,1,0,2021-2022,90.0,94.73684210526315,142.10526315789474
Rk,Player,Nation,Pos,Squad,Comp,0,0,90.0,0,0,3,3,3,Tkl,0,0.0,0,0,0,0,0,0,0,0,0,2021-2022,90.0,0.0,0.0
376,Brian Brobbey,NED,"FW,MF",RB Leipzig,Bundesliga,19,2002,1.5,1,0,0,1,0,1,1,100.0,0,1,0,1,0,1,0,0,0,2021-2022,90.0,0.0,60.0
377,Armando Broja,ALB,FW,Southampton,Premier League,19,2001,21.9,12,5,2,7,3,2,9,22.2,7,17,1,16,3,15,11,0,0,2021-2022,90.0,12.328767123287673,49.31506849315069
378,Dylan Bronn,TUN,DF,Metz,Ligue 1,26,1995,28.3,47,29,33,13,1,20,31,64.5,11,32,19,13,40,87,78,1,0,2021-2022,90.0,127.20848056537102,149.46996466431094
379,John Brooks,USA,DF,Wolfsburg,Bundesliga,28,1993,29.1,47,25,25,18,4,36,60,60.0,24,33,19,14,41,88,125,1,0,2021-2022,90.0,126.8041237113402,145.36082474226802
380,Daniel Brosinski,GER,DF,Mainz 05,Bundesliga,33,1988,4.3,2,1,1,1,0,1,1,100.0,0,6,0,6,3,5,9,0,0,2021-2022,90.0,62.79069767441861,41.86046511627907
381,Josh Brownhill,ENG,MF,Burnley,Premier League,25,1995,32.8,73,37,25,42,6,21,53,39.6,32,37,12,25,68,141,42,1,0,2021-2022,90.0,186.58536585365854,200.30487804878052
382,Marcelo Brozović,CRO,MF,Inter,Serie A,28,1992,32.6,77,45,34,35,8,34,68,50.0,34,28,10,18,37,114,36,2,0,2021-2022,90.0,102.14723926380368,212.57668711656441
383,Cédric Brunner,SUI,DF,Arminia,Bundesliga,27,1994,24.3,51,35,29,20,2,25,49,51.0,24,27,10,17,43,94,84,0,0,2021-2022,90.0,159.25925925925924,188.88888888888889
384,Lewis Brunt,ENG,MF,Leicester City,Premier League,20,2000,0.3,0,0,0,0,0,0,0,0.0,0,1,0,1,0,0,0,0,0,2021-2022,90.0,0.0,0.0
385,Jacob Bruun Larsen,DEN,"FW,MF",Hoffenheim,Bundesliga,22,1998,9.0,2,1,1,1,0,0,5,0.0,5,14,3,11,5,7,5,2,0,2021-2022,90.0,50.0,20.0
386,Ante Budimir,CRO,FW,Osasuna,La Liga,30,1991,19.3,24,10,3,15,6,6,19,31.6,13,22,4,18,3,27,16,0,0,2021-2022,90.0,13.98963730569948,111.91709844559584
387,Emi Buendía,ARG,"MF,FW",Aston Villa,Premier League,24,1996,21.1,38,18,16,13,9,21,51,41.2,30,21,3,18,9,47,11,0,0,2021-2022,90.0,38.38862559241706,162.08530805687204
388,Osman Bukari,GHA,"FW,MF",Nantes,Ligue 1,22,1998,11.2,18,8,7,6,5,8,22,36.4,14,8,0,8,8,26,1,0,0,2021-2022,90.0,64.28571428571429,144.64285714285714
389,Aleksander Buksa,POL,FW,Genoa,Serie A,18,2003,0.7,0,0,0,0,0,0,1,0.0,1,0,0,0,0,0,1,0,0,2021-2022,90.0,0.0,0.0
390,Alessandro Buongiorno,ITA,DF,Torino,Serie A,22,1999,13.1,20,9,9,8,3,9,13,69.2,4,12,6,6,31,51,44,0,0,2021-2022,90.0,212.97709923664124,137.40458015267177
391,Sascha Burchert,GER,GK,Greuther Fürth,Bundesliga,31,1989,14.0,1,1,1,0,0,1,2,50.0,1,0,0,0,0,1,11,1,0,2021-2022,90.0,0.0,6.428571428571429
392,Delano Burgzorg,NED,MF,Mainz 05,Bundesliga,22,1998,0.3,1,1,1,0,0,0,1,0.0,1,0,0,0,0,1,0,0,0,2021-2022,90.0,0.0,300.0
393,Jonathan Burkardt,GER,"FW,MF",Mainz 05,Bundesliga,21,2000,29.0,17,8,0,10,7,6,25,24.0,19,31,5,26,8,25,16,0,0,2021-2022,90.0,24.82758620689655,52.75862068965517
394,Roman Bürki,SUI,GK,Dortmund,Bundesliga,30,1990,1.0,0,0,0,0,0,0,0,0.0,0,0,0,0,0,0,0,0,0,2021-2022,90.0,0.0,0.0
395,Dan Burn,ENG,DF,Newcastle Utd,Premier League,29,1992,16.0,16,11,11,4,1,7,11,63.6,4,22,14,8,20,36,101,0,0,2021-2022,90.0,112.5,90.0
396,Dan Burn,ENG,DF,Brighton,Premier League,29,1992,11.4,22,12,13,8,1,6,15,40.0,9,14,10,4,24,46,51,0,0,2021-2022,90.0,189.4736842105263,173.68421052631578
397,Maxime Busi,BEL,DF,Reims,Ligue 1,21,1999,14.4,26,15,20,5,1,19,36,52.8,17,19,5,14,17,43,28,0,0,2021-2022,90.0,106.25,162.5
398,Gianluca Busio,USA,MF,Venezia,Serie A,19,2002,21.7,53,28,27,20,6,28,63,44.4,35,45,13,32,21,74,30,1,0,2021-2022,90.0,87.09677419354838,219.81566820276498
399,Oriol Busquets,ESP,MF,Clermont Foot,Ligue 1,22,1999,2.2,3,3,0,3,0,2,6,33.3,4,7,4,3,1,4,2,0,0,2021-2022,90.0,40.90909090909091,122.72727272727272
400,Sergio Busquets,ESP,MF,Barcelona,La Liga,33,1988,35.5,93,49,31,48,14,46,83,55.4,37,44,8,36,45,138,31,0,0,2021-2022,90.0,114.08450704225352,235.77464788732397
Rk,Player,Nation,Pos,Squad,Comp,0,0,90.0,0,0,3,3,3,Tkl,0,0.0,0,0,0,0,0,0,0,0,0,2021-2022,90.0,0.0,0.0
401,Jack Butland,ENG,GK,Crystal Palace,Premier League,28,1993,8.5,0,0,0,0,0,0,0,0.0,0,0,0,0,0,0,1,0,0,2021-2022,90.0,0.0,0.0
402,Adrián Butzke,ESP,FW,Granada,La Liga,22,1999,0.0,0,0,0,0,0,0,0,0.0,0,0,0,0,0,0,0,0,0,2021-2022,,,
403,Marcin Bułka,POL,GK,Nice,Ligue 1,21,1999,1.0,0,0,0,0,0,0,0,0.0,0,0,0,0,0,0,0,0,0,2021-2022,90.0,0.0,0.0
404,Sam Byram,ENG,DF,Norwich City,Premier League,27,1993,11.4,24,15,17,6,1,19,27,70.4,8,21,11,10,22,46,48,0,0,2021-2022,90.0,173.68421052631578,189.4736842105263
405,Erick Cabaco,URU,DF,Getafe,La Liga,26,1995,4.5,2,1,1,1,0,2,5,40.0,3,5,2,3,4,6,10,0,0,2021-2022,90.0,80.0,40.0
406,Willy Caballero,ARG,GK,Southampton,Premier League,39,1981,2.0,0,0,0,0,0,0,0,0.0,0,0,0,0,0,0,2,1,0,2021-2022,90.0,0.0,0.0
407,Rémy Cabella,FRA,"MF,FW",Montpellier,Ligue 1,31,1990,3.5,15,7,4,8,3,5,15,33.3,10,7,0,7,5,20,1,0,0,2021-2022,90.0,128.57142857142856,385.7142857142857
408,Jimmy Cabot,FRA,DF,Angers,Ligue 1,27,1994,22.3,81,44,59,15,7,47,83,56.6,36,29,0,29,32,113,30,0,0,2021-2022,90.0,129.14798206278027,326.90582959641256
409,Arthur Cabral,BRA,FW,Fiorentina,Serie A,23,1998,8.3,9,5,2,5,2,4,7,57.1,3,4,1,3,1,10,8,0,0,2021-2022,90.0,10.843373493975902,97.59036144578312
410,Jovane Cabral,CPV,FW,Lazio,Serie A,23,1998,2.1,2,1,1,0,1,0,0,0.0,0,1,1,0,1,3,1,0,0,2021-2022,90.0,42.857142857142854,85.71428571428571
411,Leandro Cabrera,URU,DF,Espanyol,La Liga,30,1991,37.0,37,24,27,10,0,21,34,61.8,13,32,23,9,44,81,222,2,0,2021-2022,90.0,107.02702702702703,90.0
412,Liberato Cacace,NZL,DF,Empoli,Serie A,20,2000,5.2,15,6,8,4,3,8,8,100.0,0,7,2,5,8,23,9,0,0,2021-2022,90.0,138.46153846153845,259.6153846153846
413,Martín Cáceres,URU,DF,Cagliari,Serie A,34,1987,9.2,13,7,5,5,3,4,12,33.3,8,12,3,9,14,27,21,0,0,2021-2022,90.0,136.95652173913044,127.17391304347827
414,Martín Cáceres,URU,DF,Levante,La Liga,34,1987,7.4,2,2,2,0,0,1,5,20.0,4,2,2,0,11,13,16,1,0,2021-2022,90.0,133.78378378378378,24.324324324324323
415,Anthony Caci,FRA,DF,Strasbourg,Ligue 1,24,1997,26.6,65,34,35,24,6,33,55,60.0,22,22,3,19,33,98,49,1,0,2021-2022,90.0,111.65413533834585,219.92481203007517
416,Mathieu Cafaro,FRA,"MF,FW",Reims,Ligue 1,24,1997,2.1,4,2,3,1,0,0,7,0.0,7,2,0,2,3,7,1,0,0,2021-2022,90.0,128.57142857142856,171.42857142857142
417,Yannick Cahuzac,FRA,MF,Lens,Ligue 1,36,1985,6.9,5,2,2,3,0,0,5,0.0,5,8,2,6,9,14,12,0,0,2021-2022,90.0,117.39130434782608,65.21739130434781
418,Felipe Caicedo,ECU,FW,Genoa,Serie A,32,1988,3.2,3,3,0,2,1,0,1,0.0,1,1,0,1,0,3,4,0,0,2021-2022,90.0,0.0,84.375
419,Felipe Caicedo,ECU,"FW,DF",Inter,Serie A,32,1988,0.3,0,0,0,0,0,0,0,0.0,0,1,0,1,0,0,0,0,0,2021-2022,90.0,0.0,0.0
420,Moisés Caicedo,ECU,MF,Brighton,Premier League,19,2001,7.3,16,10,7,7,2,5,12,41.7,7,18,4,14,10,26,7,0,0,2021-2022,90.0,123.28767123287672,197.26027397260276
421,Marc-Aurèle Caillard,FRA,GK,Metz,Ligue 1,27,1994,17.1,0,0,0,0,0,0,2,0.0,2,0,0,0,2,2,9,1,0,2021-2022,90.0,10.526315789473685,0.0
422,Jens Cajuste,SWE,"MF,FW",Reims,Ligue 1,21,1999,4.0,10,6,6,2,2,6,17,35.3,11,7,2,5,5,15,6,0,0,2021-2022,90.0,112.5,225.0
423,Cala,ESP,DF,Cádiz,La Liga,31,1989,10.5,9,4,9,0,0,8,17,47.1,9,12,6,6,12,21,56,0,0,2021-2022,90.0,102.85714285714286,77.14285714285714
424,Davide Calabria,ITA,DF,Milan,Serie A,24,1996,23.5,62,37,31,23,8,37,72,51.4,35,25,5,20,23,85,40,1,0,2021-2022,90.0,88.08510638297872,237.44680851063828
425,Riccardo Calafiori,ITA,DF,Genoa,Serie A,19,2002,0.9,1,0,0,0,1,1,2,50.0,1,2,1,1,2,3,4,0,0,2021-2022,90.0,200.0,100.0
Rk,Player,Nation,Pos,Squad,Comp,0,0,90.0,0,0,3,3,3,Tkl,0,0.0,0,0,0,0,0,0,0,0,0,2021-2022,90.0,0.0,0.0
426,Riccardo Calafiori,ITA,DF,Roma,Serie A,19,2002,1.9,5,4,2,2,1,1,5,20.0,4,3,0,3,3,8,1,0,0,2021-2022,90.0,142.10526315789474,236.8421052631579
427,Mattia Caldara,ITA,DF,Venezia,Serie A,27,1994,30.0,48,28,30,15,3,20,34,58.8,14,49,37,12,62,110,147,1,0,2021-2022,90.0,186.0,144.0
428,Calderón,ESP,DF,Betis,La Liga,21,2000,0.7,2,0,1,0,1,1,3,33.3,2,0,0,0,0,2,2,0,0,2021-2022,90.0,0.0,257.14285714285717
429,Fernando Calero,ESP,DF,Espanyol,La Liga,25,1995,12.1,17,10,12,5,0,8,13,61.5,5,7,2,5,16,33,63,1,0,2021-2022,90.0,119.00826446280992,126.44628099173553
430,Duje Ćaleta-Car,CRO,DF,Marseille,Ligue 1,24,1996,22.9,21,8,15,6,0,11,14,78.6,3,11,7,4,24,45,55,2,0,2021-2022,90.0,94.3231441048035,82.53275109170306
431,Hakan Çalhanoğlu,TUR,MF,Inter,Serie A,27,1994,27.6,41,23,16,19,6,11,40,27.5,29,29,5,24,25,66,12,0,0,2021-2022,90.0,81.52173913043477,133.69565217391303
432,Daniel Caligiuri,ITA,"DF,MF",Augsburg,Bundesliga,33,1988,22.3,46,30,17,26,3,27,72,37.5,45,36,5,31,18,64,33,0,0,2021-2022,90.0,72.64573991031389,185.65022421524662
433,José Callejón,ESP,FW,Fiorentina,Serie A,34,1987,14.4,15,6,6,6,3,13,31,41.9,18,6,0,6,3,18,1,1,0,2021-2022,90.0,18.75,93.75
434,Lucas Calodat,FRA,DF,Saint-Étienne,Ligue 1,19,2002,0.0,0,0,0,0,0,0,0,0.0,0,0,0,0,0,0,0,0,0,2021-2022,,,
435,Dominic Calvert-Lewin,ENG,FW,Everton,Premier League,24,1997,14.3,11,8,1,6,4,3,8,37.5,5,5,2,3,3,14,12,0,0,2021-2022,90.0,18.88111888111888,69.23076923076923
436,Mahdi Camara,FRA,"MF,DF",Saint-Étienne,Ligue 1,23,1998,34.1,101,57,39,50,12,39,70,55.7,31,44,8,36,57,158,35,1,0,2021-2022,90.0,150.4398826979472,266.5689149560117
437,Mamadou Camara,MLI,FW,Troyes,Ligue 1,20,2001,0.4,1,1,1,0,0,0,0,0.0,0,0,0,0,0,1,0,0,0,2021-2022,90.0,0.0,225.0
438,Víctor Camarasa,ESP,"MF,FW",Betis,La Liga,27,1994,1.2,2,1,1,1,0,0,1,0.0,1,2,1,1,2,4,2,0,0,2021-2022,90.0,150.0,150.0
439,Eduardo Camavinga,FRA,MF,Real Madrid,La Liga,18,2002,13.7,52,35,22,20,10,20,38,52.6,18,20,2,18,17,69,14,1,0,2021-2022,90.0,111.67883211678833,341.6058394160584
440,Eduardo Camavinga,FRA,MF,Rennes,Ligue 1,18,2002,1.6,4,1,2,1,1,2,5,40.0,3,1,1,0,1,5,3,0,0,2021-2022,90.0,56.25,225.0
441,Andrea Cambiaso,ITA,DF,Genoa,Serie A,21,2000,19.9,46,20,28,14,4,18,32,56.3,14,33,8,25,23,69,37,1,0,2021-2022,90.0,104.02010050251258,208.04020100502515
442,José Campaña,ESP,MF,Levante,La Liga,28,1993,15.8,27,16,13,10,4,12,32,37.5,20,13,2,11,21,48,19,1,0,2021-2022,90.0,119.62025316455694,153.79746835443035
443,Chem Campbell,WAL,MF,Wolves,Premier League,18,2002,0.1,1,1,0,1,0,0,0,0.0,0,0,0,0,0,1,0,0,0,2021-2022,90.0,0.0,900.0
444,Emre Can,GER,"DF,MF",Dortmund,Bundesliga,27,1994,18.8,36,22,20,16,0,15,30,50.0,15,26,10,16,36,72,40,2,0,2021-2022,90.0,172.3404255319149,172.3404255319149
445,Sergio Canales,ESP,"FW,MF",Betis,La Liga,30,1991,31.0,24,14,8,12,4,10,35,28.6,25,16,1,15,10,34,12,0,0,2021-2022,90.0,29.032258064516128,69.6774193548387
446,Matteo Cancellieri,ITA,"MF,DF",Hellas Verona,Serie A,19,2002,2.5,4,4,2,2,0,0,5,0.0,5,2,0,2,1,5,0,0,0,2021-2022,90.0,36.0,144.0
447,João Cancelo,POR,DF,Manchester City,Premier League,27,1994,35.9,83,54,33,35,15,46,91,50.5,45,25,3,22,59,142,45,1,0,2021-2022,90.0,147.9108635097493,208.0779944289694
448,Fali Candé,GNB,DF,Metz,Ligue 1,23,1998,10.8,30,18,13,15,2,13,31,41.9,18,11,2,9,6,36,21,0,0,2021-2022,90.0,49.99999999999999,249.99999999999997
449,Antonio Candreva,ITA,"MF,FW",Sampdoria,Serie A,34,1987,34.7,27,16,9,11,7,19,55,34.5,36,23,2,21,33,60,19,0,0,2021-2022,90.0,85.5907780979827,70.02881844380403
450,Sergi Canós,ESP,"DF,FW",Brentford,Premier League,24,1997,23.1,56,25,32,15,9,33,60,55.0,27,32,3,29,22,78,38,0,0,2021-2022,89.99999999999999,85.7142857142857,218.18181818181816
Rk,Player,Nation,Pos,Squad,Comp,0,0,90.0,0,0,3,3,3,Tkl,0,0.0,0,0,0,0,0,0,0,0,0,2021-2022,90.0,0.0,0.0
451,Álex Cantero,ESP,"FW,MF",Levante,La Liga,21,2000,6.8,6,4,2,3,1,1,8,12.5,7,2,0,2,1,7,0,0,0,2021-2022,90.0,13.235294117647058,79.41176470588235
452,Todd Cantwell,ENG,"FW,MF",Norwich City,Premier League,23,1998,4.9,15,13,8,6,1,6,17,35.3,11,2,0,2,3,18,2,0,0,2021-2022,90.0,55.10204081632653,275.51020408163265
453,Ander Capa,ESP,DF,Athletic Club,La Liga,29,1992,0.0,0,0,0,0,0,0,0,0.0,0,0,0,0,0,0,0,0,0,2021-2022,,,
454,Pierrick Capelle,FRA,"MF,DF",Angers,Ligue 1,34,1987,13.3,36,24,16,17,3,18,52,34.6,34,12,1,11,16,52,20,0,0,2021-2022,90.0,108.27067669172932,243.60902255639095
455,Leonardo Capezzi,ITA,MF,Salernitana,Serie A,26,1995,1.9,3,1,0,3,0,1,4,25.0,3,8,4,4,0,3,2,0,0,2021-2022,90.0,0.0,142.10526315789474
456,Étienne Capoue,FRA,MF,Villarreal,La Liga,33,1988,25.4,44,26,18,23,3,15,28,53.6,13,17,5,12,35,79,51,0,0,2021-2022,90.0,124.01574803149607,155.90551181102364
457,Gianluca Caprari,ITA,"MF,FW",Hellas Verona,Serie A,28,1993,30.4,43,25,10,22,11,17,51,33.3,34,32,0,32,4,47,7,0,0,2021-2022,90.0,11.842105263157894,127.30263157894737
458,Francesco Caputo,ITA,FW,Sampdoria,Serie A,33,1987,31.0,5,2,1,3,1,1,6,16.7,5,5,0,5,2,7,10,0,0,2021-2022,90.0,5.806451612903226,14.516129032258064
459,Francesco Caputo,ITA,FW,Sassuolo,Serie A,33,1987,1.7,0,0,0,0,0,0,0,0.0,0,0,0,0,0,0,0,0,0,2021-2022,90.0,0.0,0.0
460,Maxence Caqueret,FRA,MF,Lyon,Ligue 1,21,2000,25.9,73,40,29,36,8,30,80,37.5,50,38,10,28,43,116,26,2,0,2021-2022,90.0,149.42084942084944,253.6679536679537
461,Andrea Carboni,ITA,DF,Cagliari,Serie A,20,2001,24.6,53,24,33,16,4,19,42,45.2,23,42,15,27,27,80,87,0,0,2021-2022,89.99999999999999,98.78048780487804,193.90243902439022
462,Isaac Carcelen,ESP,"DF,MF",Cádiz,La Liga,28,1993,17.2,43,29,29,12,2,28,56,50.0,28,25,6,19,34,77,42,0,0,2021-2022,90.0,177.90697674418607,225.00000000000003
463,Cárdenas,ESP,GK,Levante,La Liga,24,1997,24.0,1,1,1,0,0,0,3,0.0,3,0,0,0,1,2,19,0,0,2021-2022,90.0,3.75,3.75
464,Irvin Cardona,FRA,"FW,MF",Brest,Ligue 1,23,1997,14.8,13,7,5,4,4,3,16,18.8,13,10,0,10,5,18,17,0,0,2021-2022,90.0,30.405405405405403,79.05405405405405
465,Igor Carioca,BRA,DF,Lorient,Ligue 1,24,1996,17.5,27,16,16,8,3,15,43,34.9,28,17,2,15,25,52,28,0,0,2021-2022,90.0,128.57142857142856,138.85714285714286
466,Carlo,ESP,MF,Villarreal,La Liga,20,2001,0.1,0,0,0,0,0,0,0,0.0,0,0,0,0,0,0,0,0,0,2021-2022,90.0,0.0,0.0
467,Diego Carlos,BRA,DF,Sevilla,La Liga,28,1993,32.9,35,24,20,13,2,16,24,66.7,8,48,33,15,24,59,120,5,0,2021-2022,90.0,65.65349544072949,95.74468085106383
468,Carmona,ESP,DF,Sevilla,La Liga,19,2002,0.3,0,0,0,0,0,0,0,0.0,0,0,0,0,1,1,0,0,0,2021-2022,90.0,300.0,0.0
469,Yannick Carrasco,BEL,"FW,MF",Atlético Madrid,La Liga,27,1993,28.7,34,19,16,12,6,19,44,43.2,25,26,5,21,19,53,12,2,0,2021-2022,90.0,59.58188153310105,106.62020905923345
470,Guido Carrillo,ARG,FW,Elche,La Liga,30,1991,13.0,7,4,2,4,1,3,13,23.1,10,9,2,7,1,8,27,0,0,2021-2022,90.00000000000001,6.923076923076923,48.46153846153847
471,Dani Carvajal,ESP,DF,Real Madrid,La Liga,29,1992,17.2,43,28,21,15,7,15,26,57.7,11,22,8,14,20,63,38,2,0,2021-2022,90.0,104.65116279069768,225.00000000000003
472,William Carvalho,POR,MF,Betis,La Liga,29,1992,20.1,49,33,20,25,4,15,40,37.5,25,18,7,11,16,65,20,0,0,2021-2022,90.0,71.64179104477611,219.40298507462686
473,Nicolò Casale,ITA,DF,Hellas Verona,Serie A,23,1998,28.7,46,30,25,19,2,21,37,56.8,16,31,12,19,49,95,95,0,0,2021-2022,90.0,153.65853658536585,144.25087108013938
474,Casemiro,BRA,MF,Real Madrid,La Liga,29,1992,28.5,79,51,45,30,4,30,67,44.8,37,65,19,46,38,117,65,3,0,2021-2022,90.0,120.0,249.47368421052633
475,Matty Cash,POL,DF,Aston Villa,Premier League,23,1997,37.5,89,50,52,34,3,47,78,60.3,31,54,16,38,49,138,100,2,0,2021-2022,90.0,117.6,213.6
Rk,Player,Nation,Pos,Squad,Comp,0,0,90.0,0,0,3,3,3,Tkl,0,0.0,0,0,0,0,0,0,0,0,0,2021-2022,90.0,0.0,0.0
476,Kiko Casilla,ESP,GK,Elche,La Liga,34,1986,14.0,0,0,0,0,0,0,1,0.0,1,0,0,0,1,1,2,2,0,2021-2022,90.0,6.428571428571429,0.0
477,Moreto Cassamã,GNB,MF,Reims,Ligue 1,23,1998,8.9,12,6,7,4,1,3,19,15.8,16,10,5,5,9,21,5,0,0,2021-2022,90.0,91.01123595505618,121.34831460674158
478,Francesco Cassata,ITA,MF,Genoa,Serie A,24,1997,0.1,0,0,0,0,0,0,0,0.0,0,0,0,0,0,0,0,0,0,2021-2022,90.0,0.0,0.0
479,Timothy Castagne,BEL,DF,Leicester City,Premier League,25,1995,23.6,67,31,38,22,7,27,43,62.8,16,28,9,19,29,96,54,1,0,2021-2022,90.0,110.59322033898304,255.50847457627117
480,Koen Casteels,BEL,GK,Wolfsburg,Bundesliga,29,1992,28.0,0,0,0,0,0,0,1,0.0,1,0,0,0,0,0,9,2,0,2021-2022,90.0,0.0,0.0
481,Jean-Charles Castelletto,CMR,DF,Nantes,Ligue 1,26,1995,27.9,45,24,27,17,1,25,35,71.4,10,38,27,11,30,75,73,0,0,2021-2022,90.0,96.7741935483871,145.16129032258064
482,Samu Castillejo,ESP,"FW,MF",Milan,Serie A,26,1995,1.4,4,2,0,2,2,1,8,12.5,7,4,1,3,2,6,1,0,0,2021-2022,90.0,128.57142857142858,257.14285714285717
483,Gonzalo Castro,GER,"MF,FW",Arminia,Bundesliga,34,1987,4.8,8,3,4,4,0,1,5,20.0,4,3,0,3,3,11,3,0,0,2021-2022,90.0,56.25000000000001,150.0
484,Jonny Castro,ESP,DF,Wolves,Premier League,27,1994,11.4,25,15,13,11,1,11,20,55.0,9,14,3,11,13,38,11,0,0,2021-2022,90.0,102.63157894736841,197.36842105263156
485,Gaetano Castrovilli,ITA,MF,Fiorentina,Serie A,24,1997,15.5,25,17,15,6,4,12,23,52.2,11,18,4,14,11,36,6,0,0,2021-2022,90.0,63.87096774193549,145.16129032258064
486,Danilo Cataldi,ITA,MF,Lazio,Serie A,26,1994,19.0,36,17,15,17,4,12,38,31.6,26,24,12,12,17,53,19,1,0,2021-2022,90.0,80.52631578947368,170.52631578947367
487,Catena,ESP,DF,Rayo Vallecano,La Liga,26,1994,36.0,39,23,24,15,0,25,42,59.5,17,26,19,7,30,69,168,3,0,2021-2022,90.0,75.0,97.5
488,Craig Cathcart,NIR,DF,Watford,Premier League,32,1989,26.6,32,15,25,6,1,16,30,53.3,14,39,29,10,28,60,132,3,0,2021-2022,90.0,94.73684210526315,108.27067669172932
489,Edinson Cavani,URU,FW,Manchester Utd,Premier League,34,1987,8.5,4,1,0,3,1,2,8,25.0,6,6,0,6,2,6,8,0,0,2021-2022,90.0,21.176470588235293,42.35294117647059
490,Dani Ceballos,ESP,MF,Real Madrid,La Liga,24,1996,3.1,7,5,4,3,0,1,5,20.0,4,8,2,6,4,11,2,0,0,2021-2022,90.0,116.12903225806451,203.2258064516129
491,Pietro Ceccaroni,ITA,DF,Venezia,Serie A,25,1995,34.7,55,31,33,18,4,25,36,69.4,11,45,32,13,30,85,143,0,0,2021-2022,90.0,77.80979827089337,142.65129682997116
492,Federico Ceccherini,ITA,DF,Hellas Verona,Serie A,29,1992,26.2,32,16,19,10,3,19,33,57.6,14,13,8,5,50,82,76,1,0,2021-2022,90.0,171.7557251908397,109.92366412213741
493,Emil Ceide,NOR,"FW,MF",Sassuolo,Serie A,19,2001,0.6,1,1,0,1,0,1,2,50.0,1,1,0,1,0,1,0,0,0,2021-2022,90.0,0.0,150.0
494,Zeki Çelik,TUR,DF,Lille,Ligue 1,24,1997,30.0,64,37,43,17,4,36,63,57.1,27,32,9,23,43,107,62,2,0,2021-2022,90.0,129.0,192.0
495,Fabien Centonze,FRA,DF,Metz,Ligue 1,25,1996,17.6,33,21,22,9,2,13,32,40.6,19,37,8,29,32,65,51,0,0,2021-2022,90.0,163.63636363636363,168.75
496,Luca Ceppitelli,ITA,DF,Cagliari,Serie A,31,1989,16.1,23,12,13,10,0,16,27,59.3,11,21,14,7,25,48,54,0,0,2021-2022,90.0,139.75155279503105,128.57142857142856
497,Franco Cervi,ARG,MF,Celta Vigo,La Liga,27,1994,20.0,73,41,35,22,16,33,77,42.9,44,38,2,36,21,94,19,0,0,2021-2022,90.0,94.5,328.5
498,Damir Ceter,COL,FW,Cagliari,Serie A,23,1997,0.1,0,0,0,0,0,0,0,0.0,0,0,0,0,0,0,0,0,0,2021-2022,90.0,0.0,0.0
499,Julian Chabot,GER,DF,Sampdoria,Serie A,23,1998,5.4,12,10,8,4,0,8,10,80.0,2,7,4,3,9,21,28,1,0,2021-2022,90.0,150.0,199.99999999999997
500,Julian Chabot,GER,DF,Köln,Bundesliga,23,1998,2.3,8,3,4,4,0,2,5,40.0,3,4,2,2,3,11,5,1,0,2021-2022,90.0,117.3913043478261,313.04347826086956
Rk,Player,Nation,Pos,Squad,Comp,0,0,90.0,0,0,3,3,3,Tkl,0,0.0,0,0,0,0,0,0,0,0,0,2021-2022,90.0,0.0,0.0
501,El Chadaille Bitshiabu,FRA,DF,Paris S-G,Ligue 1,16,2005,0.1,0,0,0,0,0,0,0,0.0,0,0,0,0,0,0,2,0,0,2021-2022,90.0,0.0,0.0
502,Nassim Chadli,FRA,"MF,DF",Troyes,Ligue 1,20,2001,1.1,5,3,3,0,2,2,4,50.0,2,1,0,1,0,5,0,0,0,2021-2022,90.0,0.0,409.09090909090907
503,Kayky Chagas,BRA,FW,Manchester City,Premier League,18,2003,0.1,0,0,0,0,0,0,0,0.0,0,0,0,0,0,0,0,0,0,2021-2022,90.0,0.0,0.0
504,Mehdi Chahiri,MAR,DF,Strasbourg,Ligue 1,25,1996,0.2,1,1,1,0,0,1,1,100.0,0,0,0,0,0,1,0,0,0,2021-2022,90.0,0.0,450.0
505,Trevoh Chalobah,ENG,DF,Chelsea,Premier League,22,1999,16.1,40,27,22,18,0,24,31,77.4,7,16,6,10,19,59,43,2,0,2021-2022,90.0,106.21118012422359,223.60248447204967
506,Calum Chambers,ENG,DF,Arsenal,Premier League,26,1995,1.9,5,3,3,1,1,3,4,75.0,1,6,3,3,0,5,10,0,0,2021-2022,90.0,0.0,236.8421052631579
507,Calum Chambers,ENG,DF,Aston Villa,Premier League,26,1995,9.2,16,8,10,6,0,4,6,66.7,2,14,8,6,5,21,42,0,0,2021-2022,90.0,48.913043478260875,156.52173913043478
508,Dylan Chambost,FRA,"MF,FW",Troyes,Ligue 1,23,1997,8.4,16,11,6,9,1,4,25,16.0,21,9,2,7,8,24,4,0,0,2021-2022,90.0,85.71428571428571,171.42857142857142
509,Timothy Chandler,USA,DF,Eint Frankfurt,Bundesliga,31,1990,13.5,18,12,10,8,0,11,24,45.8,13,10,3,7,19,37,28,1,0,2021-2022,90.0,126.66666666666667,120.0
510,Chapela,ESP,"MF,FW",Cádiz,La Liga,22,1999,4.4,4,2,1,0,3,2,4,50.0,2,6,1,5,4,8,5,0,0,2021-2022,90.0,81.81818181818181,81.81818181818181
511,Brendan Chardonnet,FRA,DF,Brest,Ligue 1,26,1994,29.8,44,25,32,11,1,29,40,72.5,11,42,29,13,55,99,141,0,0,2021-2022,90.0,166.10738255033556,132.88590604026845
512,Xavier Chavalerin,FRA,MF,Troyes,Ligue 1,30,1991,30.2,49,26,19,25,5,12,55,21.8,43,32,5,27,39,88,36,0,0,2021-2022,90.0,116.22516556291392,146.02649006622516
513,Xavier Chavalerin,FRA,MF,Reims,Ligue 1,30,1991,2.4,4,4,2,1,1,1,3,33.3,2,2,0,2,5,9,2,1,0,2021-2022,90.0,187.5,150.0
514,Justin Che,USA,"FW,DF",Hoffenheim,Bundesliga,17,2003,0.5,2,0,1,0,1,1,2,50.0,1,0,0,0,1,3,0,0,0,2021-2022,90.0,180.0,360.0
515,Chema,ESP,MF,Getafe,La Liga,29,1992,0.5,0,0,0,0,0,0,1,0.0,1,0,0,0,0,0,0,0,0,2021-2022,90.0,0.0,0.0
516,Rayan Cherki,FRA,"FW,MF",Lyon,Ligue 1,17,2003,4.9,6,2,1,3,2,4,9,44.4,5,2,0,2,1,7,0,0,0,2021-2022,90.0,18.36734693877551,110.20408163265306
517,Denis Cheryshev,RUS,"MF,FW",Valencia,La Liga,30,1990,6.3,14,5,6,1,7,6,15,40.0,9,9,1,8,9,23,9,0,0,2021-2022,90.0,128.57142857142858,200.00000000000003
518,Daniel Chesters,ENG,MF,West Ham,Premier League,19,2002,0.0,0,0,0,0,0,0,0,0.0,0,0,0,0,0,0,0,0,0,2021-2022,,,
519,Giorgio Chiellini,ITA,DF,Juventus,Serie A,36,1984,15.0,22,13,17,4,1,7,13,53.8,6,24,18,6,22,44,59,0,0,2021-2022,90.0,132.0,132.0
520,Federico Chiesa,ITA,"MF,FW",Juventus,Serie A,23,1997,9.6,26,19,9,9,8,12,26,46.2,14,7,0,7,4,30,3,0,0,2021-2022,90.0,37.5,243.75000000000003
521,Ben Chilwell,ENG,DF,Chelsea,Premier League,24,1996,6.0,8,3,2,6,0,2,5,40.0,3,7,0,7,4,12,14,1,0,2021-2022,90.0,60.0,120.0
522,Chiquinho,POR,"DF,FW",Wolves,Premier League,21,2000,2.3,9,6,4,5,0,4,5,80.0,1,5,0,5,2,11,1,0,0,2021-2022,90.0,78.26086956521739,352.1739130434783
523,Vlad Chiricheș,ROU,DF,Sassuolo,Serie A,31,1989,25.6,28,15,19,9,0,10,21,47.6,11,34,21,13,41,69,71,4,0,2021-2022,90.0,144.140625,98.4375
524,Pedro Chirivella,ESP,MF,Nantes,Ligue 1,24,1997,29.3,49,31,14,26,9,25,70,35.7,45,23,2,21,37,86,11,0,0,2021-2022,90.0,113.65187713310581,150.51194539249147
525,Joris Chotard,FRA,MF,Montpellier,Ligue 1,19,2001,32.6,59,30,33,23,3,36,78,46.2,42,27,15,12,42,101,56,0,0,2021-2022,90.0,115.95092024539878,162.88343558282207
Rk,Player,Nation,Pos,Squad,Comp,0,0,90.0,0,0,3,3,3,Tkl,0,0.0,0,0,0,0,0,0,0,0,0,2021-2022,90.0,0.0,0.0
526,Hamza Choudhury,ENG,"DF,MF",Leicester City,Premier League,23,1997,3.2,9,3,4,4,1,3,5,60.0,2,0,0,0,12,21,10,0,0,2021-2022,90.0,337.5,253.125
527,Andreas Christensen,DEN,DF,Chelsea,Premier League,25,1996,16.6,14,8,9,4,1,4,7,57.1,3,14,6,8,29,43,57,1,0,2021-2022,90.0,157.2289156626506,75.90361445783131
528,Max Christiansen,GER,MF,Greuther Fürth,Bundesliga,24,1996,22.8,46,25,19,22,5,18,43,41.9,25,52,16,36,68,114,56,0,0,2021-2022,90.0,268.4210526315789,181.57894736842104
529,Carney Chukwuemeka,ENG,"MF,FW",Aston Villa,Premier League,17,2003,3.3,7,1,2,5,0,3,5,60.0,2,3,0,3,1,8,2,1,0,2021-2022,90.0,27.272727272727273,190.9090909090909
530,Samuel Chukwueze,NGA,"MF,FW",Villarreal,La Liga,22,1999,14.8,13,9,6,5,2,3,6,50.0,3,7,0,7,5,18,4,0,0,2021-2022,90.0,30.405405405405403,79.05405405405405
531,Víctor Chust,ESP,DF,Cádiz,La Liga,21,2000,20.3,19,10,14,4,1,11,17,64.7,6,20,8,12,16,35,87,0,0,2021-2022,90.0,70.935960591133,84.23645320197043
532,Riccardo Ciervo,ITA,"MF,DF",Sampdoria,Serie A,19,2002,2.5,8,3,4,3,1,2,6,33.3,4,1,0,1,2,10,2,0,0,2021-2022,90.0,72.0,288.0
533,Jasper Cillessen,NED,GK,Valencia,La Liga,32,1989,16.2,0,0,0,0,0,0,1,0.0,1,0,0,0,1,1,6,0,0,2021-2022,90.0,5.555555555555555,0.0
534,Pathé Ciss,SEN,MF,Rayo Vallecano,La Liga,27,1994,12.2,31,15,20,8,3,12,26,46.2,14,16,6,10,30,61,27,0,0,2021-2022,90.0,221.31147540983608,228.68852459016395
535,Moustapha Cissé,GUI,FW,Atalanta,Serie A,17,2003,0.4,1,0,0,1,0,0,3,0.0,3,0,0,0,0,1,0,0,0,2021-2022,90.0,0.0,225.0
536,Giorgio Cittadini,ITA,DF,Atalanta,Serie A,19,2002,0.0,0,0,0,0,0,0,0,0.0,0,0,0,0,1,1,0,0,0,2021-2022,,inf,
537,Ciaran Clark,IRL,DF,Newcastle Utd,Premier League,31,1989,11.3,13,10,4,7,2,9,14,64.3,5,14,11,3,13,26,43,1,0,2021-2022,90.0,103.53982300884955,103.53982300884955
538,Alexis Claude-Maurice,FRA,MF,Nice,Ligue 1,23,1998,2.3,2,0,1,0,1,1,4,25.0,3,7,0,7,3,5,1,0,0,2021-2022,90.0,117.3913043478261,78.26086956521739
539,Jonathan Clauss,FRA,DF,Lens,Ligue 1,28,1992,33.8,63,34,33,20,10,22,55,40.0,33,43,1,42,73,136,51,0,0,2021-2022,90.0,194.3786982248521,167.75147928994085
540,Carlos Clerc,ESP,DF,Levante,La Liga,29,1992,16.8,35,17,21,10,4,7,19,36.8,12,8,3,5,26,61,32,1,0,2021-2022,90.0,139.28571428571428,187.5
541,Tom Cleverley,ENG,MF,Watford,Premier League,31,1989,18.0,37,20,19,17,1,18,33,54.5,15,23,6,17,18,55,19,3,0,2021-2022,90.0,90.0,185.0
542,Nathaniel Clyne,ENG,DF,Crystal Palace,Premier League,30,1991,15.0,21,10,11,9,1,10,20,50.0,10,7,2,5,15,36,32,0,0,2021-2022,90.0,90.0,126.0
543,Conor Coady,ENG,DF,Wolves,Premier League,28,1993,37.3,31,14,23,7,1,16,28,57.1,12,46,40,6,28,59,140,0,0,2021-2022,90.0,67.56032171581771,74.79892761394103
544,Marcus Coco,FRA,"MF,FW",Nantes,Ligue 1,25,1996,10.3,34,14,17,11,6,8,18,44.4,10,11,1,10,10,44,15,0,0,2021-2022,90.0,87.37864077669903,297.0873786407767
545,Coke,ESP,DF,Levante,La Liga,34,1987,1.3,3,2,1,1,1,3,4,75.0,1,1,0,1,2,5,7,0,0,2021-2022,90.0,138.46153846153845,207.69230769230768
546,Séamus Coleman,IRL,DF,Everton,Premier League,32,1988,29.5,61,36,35,16,10,33,51,64.7,18,30,11,19,32,93,80,2,0,2021-2022,90.0,97.62711864406779,186.10169491525423
547,Álex Collado,ESP,"MF,FW",Granada,La Liga,22,1999,11.3,27,12,6,16,5,12,31,38.7,19,28,2,26,6,33,11,0,0,2021-2022,90.0,47.78761061946903,215.0442477876106
548,Ebrima Colley,GAM,"FW,MF",Spezia,Serie A,21,2000,4.4,6,1,3,2,1,1,7,14.3,6,8,0,8,3,9,2,0,0,2021-2022,90.0,61.36363636363636,122.72727272727272
549,Omar Colley,GAM,DF,Sampdoria,Serie A,28,1992,30.5,47,36,32,14,1,22,32,68.8,10,31,19,12,80,127,135,2,0,2021-2022,90.0,236.0655737704918,138.68852459016392
550,Nathan Collins,IRL,DF,Burnley,Premier League,20,2001,18.6,37,15,27,8,2,17,27,63.0,10,38,25,13,24,61,83,2,0,2021-2022,90.0,116.1290322580645,179.0322580645161
Rk,Player,Nation,Pos,Squad,Comp,0,0,90.0,0,0,3,3,3,Tkl,0,0.0,0,0,0,0,0,0,0,0,0,2021-2022,90.0,0.0,0.0
551,Kingsley Coman,FRA,"FW,DF",Bayern Munich,Bundesliga,25,1996,15.1,14,8,1,9,4,5,16,31.3,11,14,0,14,8,22,5,0,0,2021-2022,90.0,47.682119205298015,83.44370860927152
552,Eray Cömert,SUI,DF,Valencia,La Liga,23,1998,4.5,5,3,4,1,0,3,6,50.0,3,3,2,1,2,7,6,0,0,2021-2022,90.0,40.0,100.0
553,Santi Comesaña,ESP,MF,Rayo Vallecano,La Liga,24,1996,29.8,87,56,45,33,9,40,104,38.5,64,46,6,40,33,120,30,0,0,2021-2022,90.0,99.66442953020133,262.75167785234896
554,Diego Conde,ESP,GK,Getafe,La Liga,22,1998,0.1,0,0,0,0,0,0,0,0.0,0,0,0,0,0,0,0,0,0,2021-2022,90.0,0.0,0.0
555,Aaron Connolly,IRL,"FW,MF",Brighton,Premier League,21,2000,1.7,0,0,0,0,0,0,1,0.0,1,2,0,2,0,0,0,0,0,2021-2022,90.0,0.0,0.0
556,Andrea Consigli,ITA,GK,Sassuolo,Serie A,34,1987,36.9,0,0,0,0,0,0,2,0.0,2,0,0,0,0,0,23,3,0,2021-2022,90.0,0.0,0.0
557,Abdu Conté,POR,DF,Troyes,Ligue 1,23,1998,15.0,22,12,16,5,1,12,24,50.0,12,12,2,10,4,26,10,0,0,2021-2022,90.0,24.0,132.0
558,Andrea Conti,ITA,"DF,MF",Sampdoria,Serie A,27,1994,2.6,4,2,2,1,1,3,6,50.0,3,4,0,4,7,11,4,0,0,2021-2022,90.0,242.3076923076923,138.46153846153845
559,Andrea Conti,ITA,DF,Milan,Serie A,27,1994,0.1,0,0,0,0,0,0,0,0.0,0,0,0,0,0,0,0,0,0,2021-2022,90.0,0.0,0.0
560,Liam Cooper,SCO,DF,Leeds United,Premier League,29,1991,20.2,41,23,27,13,1,23,33,69.7,10,29,18,11,43,84,72,2,0,2021-2022,90.0,191.58415841584159,182.67326732673268
561,Lucas Copado,GER,FW,Bayern Munich,Bundesliga,17,2004,0.2,1,0,1,0,0,1,1,100.0,0,0,0,0,0,1,0,0,0,2021-2022,90.0,0.0,450.0
562,Diego Coppola,ITA,DF,Hellas Verona,Serie A,17,2003,2.8,8,4,4,4,0,3,3,100.0,0,5,1,4,4,12,5,0,0,2021-2022,90.0,128.57142857142858,257.14285714285717
563,Francis Coquelin,FRA,MF,Villarreal,La Liga,30,1991,9.2,26,17,9,11,6,11,20,55.0,9,15,5,10,19,45,11,0,0,2021-2022,90.0,185.8695652173913,254.34782608695653
564,Sébastien Corchia,FRA,DF,Nantes,Ligue 1,30,1990,14.7,33,20,17,11,5,24,42,57.1,18,24,3,21,13,46,36,0,0,2021-2022,90.0,79.59183673469389,202.0408163265306
565,Sergio Córdova,VEN,"FW,MF",Augsburg,Bundesliga,23,1997,3.6,4,3,2,2,0,1,2,50.0,1,4,0,4,0,4,4,0,0,2021-2022,90.0,0.0,100.0
566,Jack Cork,ENG,MF,Burnley,Premier League,32,1989,18.6,20,6,6,11,3,7,20,35.0,13,17,4,13,17,37,29,1,0,2021-2022,90.0,82.25806451612902,96.77419354838709
567,Maxwel Cornet,CIV,"FW,MF",Burnley,Premier League,24,1996,19.6,16,9,7,5,4,7,15,46.7,8,13,4,9,10,26,14,0,0,2021-2022,90.0,45.91836734693877,73.46938775510203
568,Maxwel Cornet,CIV,DF,Lyon,Ligue 1,24,1996,0.7,3,1,1,0,2,3,4,75.0,1,0,0,0,1,4,1,0,0,2021-2022,90.0,128.57142857142858,385.7142857142857
569,Jesús Corona,MEX,"FW,DF",Sevilla,La Liga,28,1993,12.9,12,7,7,5,0,3,6,50.0,3,4,0,4,8,20,6,0,0,2021-2022,90.0,55.81395348837209,83.72093023255813
570,Ángel Correa,ARG,"FW,MF",Atlético Madrid,La Liga,26,1995,20.6,16,8,5,10,1,7,29,24.1,22,25,2,23,10,26,4,0,0,2021-2022,90.0,43.689320388349515,69.90291262135922
571,Joaquín Correa,ARG,FW,Inter,Serie A,26,1994,11.4,11,5,2,6,3,1,13,7.7,12,8,1,7,3,14,2,0,0,2021-2022,90.0,23.684210526315788,86.84210526315789
572,Thierry Correia,POR,DF,Valencia,La Liga,22,1999,15.7,35,23,26,6,3,14,29,48.3,15,20,5,15,19,54,27,0,0,2021-2022,90.0,108.9171974522293,200.63694267515925
573,Danny da Costa,GER,"DF,MF",Eint Frankfurt,Bundesliga,28,1993,8.1,15,4,6,7,2,6,18,33.3,12,14,1,13,11,26,18,1,0,2021-2022,90.0,122.22222222222223,166.66666666666669
574,David Pereira da Costa,POR,"MF,FW",Lens,Ligue 1,20,2001,16.3,22,12,9,6,7,11,26,42.3,15,12,0,12,13,35,5,0,0,2021-2022,90.0,71.77914110429448,121.47239263803681
575,Hélder Costa,ANG,MF,Leeds United,Premier League,27,1994,0.2,0,0,0,0,0,0,0,0.0,0,1,0,1,0,0,0,0,0,2021-2022,90.0,0.0,0.0
Rk,Player,Nation,Pos,Squad,Comp,0,0,90.0,0,0,3,3,3,Tkl,0,0.0,0,0,0,0,0,0,0,0,0,2021-2022,90.0,0.0,0.0
576,Hélder Costa,ANG,"MF,FW",Valencia,La Liga,27,1994,12.4,27,16,11,9,7,14,41,34.1,27,12,1,11,3,30,9,0,0,2021-2022,90.0,21.774193548387096,195.96774193548387
577,Jaume Costa,ESP,DF,Mallorca,La Liga,33,1988,20.3,35,26,23,7,5,23,31,74.2,8,22,7,15,23,58,55,0,0,2021-2022,90.0,101.9704433497537,155.17241379310343
578,Benoît Costil,FRA,GK,Bordeaux,Ligue 1,34,1987,25.0,1,0,1,0,0,1,2,50.0,1,0,0,0,0,1,6,3,0,2021-2022,90.0,0.0,3.5999999999999996
579,Vladimír Coufal,CZE,DF,West Ham,Premier League,28,1992,24.5,45,25,24,14,7,18,36,50.0,18,31,9,22,22,67,64,1,0,2021-2022,90.00000000000001,80.81632653061226,165.3061224489796
580,Kalifa Coulibaly,MLI,FW,Nantes,Ligue 1,29,1991,9.4,5,1,1,1,3,0,4,0.0,4,2,2,0,0,5,11,0,0,2021-2022,90.0,0.0,47.87234042553191
581,Lassana Coulibaly,MLI,MF,Salernitana,Serie A,25,1996,25.9,58,32,29,26,3,24,62,38.7,38,40,13,27,22,80,27,0,0,2021-2022,90.0,76.44787644787645,201.54440154440158
582,Mamadou Coulibaly,SEN,MF,Salernitana,Serie A,22,1999,9.0,15,12,8,5,2,7,20,35.0,13,9,0,9,11,26,9,0,0,2021-2022,90.0,110.0,150.0
583,Tanguy Coulibaly,FRA,"FW,MF",Stuttgart,Bundesliga,20,2001,12.0,27,15,14,11,2,9,19,47.4,10,14,2,12,4,31,10,0,0,2021-2022,90.0,30.0,202.5
584,Thibaut Courtois,BEL,GK,Real Madrid,La Liga,29,1992,36.0,1,0,1,0,0,1,2,50.0,1,0,0,0,0,1,9,1,0,2021-2022,90.0,0.0,2.5
585,Philippe Coutinho,BRA,"MF,FW",Aston Villa,Premier League,29,1992,14.8,17,12,4,11,2,6,21,28.6,15,11,1,10,7,24,4,0,0,2021-2022,90.0,42.567567567567565,103.37837837837837
586,Philippe Coutinho,BRA,"MF,FW",Barcelona,La Liga,29,1992,5.6,6,3,3,3,0,3,11,27.3,8,3,0,3,4,10,3,0,0,2021-2022,90.0,64.28571428571429,96.42857142857143
587,Nicolas Cozza,FRA,DF,Montpellier,Ligue 1,22,1999,30.8,80,47,50,23,7,35,65,53.8,30,35,19,16,38,118,82,1,0,2021-2022,90.0,111.03896103896105,233.76623376623377
588,Alessio Cragno,ITA,GK,Cagliari,Serie A,27,1994,35.0,3,3,2,1,0,3,3,100.0,0,0,0,0,1,4,14,1,0,2021-2022,90.0,2.571428571428571,7.714285714285714
589,Aaron Cresswell,ENG,DF,West Ham,Premier League,31,1989,30.3,28,18,18,6,4,13,25,52.0,12,31,18,13,35,63,66,0,0,2021-2022,90.0,103.96039603960396,83.16831683168317
590,Charlie Cresswell,ENG,DF,Leeds United,Premier League,18,2002,1.6,5,2,1,4,0,3,3,100.0,0,1,1,0,2,7,6,0,0,2021-2022,90.0,112.5,281.25
591,Domenico Criscito,ITA,DF,Genoa,Serie A,34,1986,18.0,37,21,19,14,4,16,25,64.0,9,22,12,10,39,76,57,0,0,2021-2022,90.0,195.0,185.0
592,Bryan Cristante,ITA,MF,Roma,Serie A,26,1995,29.8,79,39,31,39,9,37,69,53.6,32,31,5,26,40,119,45,0,0,2021-2022,90.0,120.80536912751677,238.59060402684563
593,Cristo,ESP,DF,Real Sociedad,La Liga,21,2000,0.2,0,0,0,0,0,0,0,0.0,0,0,0,0,0,0,0,0,0,2021-2022,90.0,0.0,0.0
594,Enzo Crivelli,FRA,"FW,MF",Saint-Étienne,Ligue 1,26,1995,1.1,1,0,0,0,1,0,0,0.0,0,0,0,0,0,1,1,0,0,2021-2022,90.0,0.0,81.81818181818181
595,Domen Črnigoj,SVN,MF,Venezia,Serie A,25,1995,20.9,21,13,7,11,3,11,29,37.9,18,27,8,19,24,45,42,0,0,2021-2022,90.0,103.34928229665071,90.43062200956938
596,Giovanni Crociata,ITA,FW,Empoli,Serie A,23,1997,0.2,0,0,0,0,0,0,1,0.0,1,0,0,0,0,0,0,0,0,2021-2022,90.0,0.0,0.0
597,Juan Cruz Armada,ESP,DF,Osasuna,La Liga,29,1992,21.5,28,21,15,12,1,8,16,50.0,8,15,12,3,16,44,58,1,0,2021-2022,90.0,66.9767441860465,117.20930232558139
598,Juan Cuadrado,COL,"DF,MF",Juventus,Serie A,33,1988,27.6,48,23,30,13,5,30,55,54.5,25,23,5,18,29,77,34,0,0,2021-2022,90.0,94.56521739130434,156.52173913043475
599,Cucho,COL,"FW,MF",Watford,Premier League,22,1999,12.7,13,5,5,5,3,5,27,18.5,22,13,1,12,5,18,9,0,0,2021-2022,90.0,35.43307086614173,92.1259842519685
600,Marc Cucurella,ESP,DF,Brighton,Premier League,23,1998,34.3,93,62,43,32,18,44,71,62.0,27,42,14,28,30,123,74,0,0,2021-2022,90.0,78.71720116618077,244.02332361516036
Rk,Player,Nation,Pos,Squad,Comp,0,0,90.0,0,0,3,3,3,Tkl,0,0.0,0,0,0,0,0,0,0,0,0,2021-2022,90.0,0.0,0.0
601,Marc Cucurella,ESP,"MF,DF",Getafe,La Liga,23,1998,0.3,0,0,0,0,0,0,0,0.0,0,0,0,0,0,0,0,0,0,2021-2022,90.0,0.0,0.0
602,Jorge Cuenca,ESP,DF,Getafe,La Liga,21,1999,29.8,46,32,30,15,1,21,28,75.0,7,29,14,15,39,85,155,0,0,2021-2022,90.0,117.78523489932886,138.92617449664428
603,Mickaël Cuisance,FRA,MF,Venezia,Serie A,21,1999,10.2,23,9,7,12,4,10,28,35.7,18,14,0,14,12,35,5,0,0,2021-2022,90.0,105.88235294117648,202.94117647058823
604,Mickaël Cuisance,FRA,MF,Bayern Munich,Bundesliga,21,1999,0.1,1,1,0,1,0,0,0,0.0,0,0,0,0,0,1,0,0,0,2021-2022,90.0,0.0,900.0
605,Luke Cundle,ENG,MF,Wolves,Premier League,19,2002,2.0,4,3,0,4,0,1,1,100.0,0,0,0,0,1,5,1,0,0,2021-2022,90.0,45.0,180.0
606,Matheus Cunha,BRA,FW,Atlético Madrid,La Liga,22,1999,11.8,19,12,3,11,5,5,20,25.0,15,18,2,16,6,25,9,0,0,2021-2022,90.0,45.762711864406775,144.9152542372881
607,Matheus Cunha,BRA,FW,Hertha BSC,Bundesliga,22,1999,0.7,0,0,0,0,0,0,0,0.0,0,0,0,0,0,0,0,0,0,2021-2022,90.0,0.0,0.0
608,Patrick Cutrone,ITA,FW,Empoli,Serie A,23,1998,15.6,5,2,0,3,2,1,9,11.1,8,11,1,10,5,10,1,0,0,2021-2022,90.0,28.846153846153847,28.846153846153847
609,Wylan Cyprien,FRA,MF,Nantes,Ligue 1,26,1995,16.6,33,17,12,18,3,13,32,40.6,19,16,6,10,10,43,14,2,0,2021-2022,90.0,54.21686746987951,178.9156626506024
610,Rafael Czichos,GER,DF,Köln,Bundesliga,31,1990,15.6,29,18,18,9,2,14,28,50.0,14,23,13,10,19,48,53,2,0,2021-2022,90.0,109.61538461538461,167.3076923076923
611,Lennart-Marten Czyborra,GER,DF,Arminia,Bundesliga,22,1999,1.5,0,0,0,0,0,0,2,0.0,2,0,0,0,3,3,3,1,0,2021-2022,90.0,180.0,0.0
612,Danilo D'Ambrosio,ITA,DF,Inter,Serie A,32,1988,11.1,30,15,21,8,1,11,22,50.0,11,21,10,11,8,38,20,0,0,2021-2022,90.0,64.86486486486487,243.24324324324326
613,Lucas Da Cunha,FRA,MF,Nice,Ligue 1,20,2001,4.4,13,7,2,7,4,6,11,54.5,5,2,0,2,1,14,2,0,0,2021-2022,90.0,20.454545454545453,265.9090909090909
614,Lucas Da Cunha,FRA,"FW,MF",Clermont Foot,Ligue 1,20,2001,9.3,17,11,5,8,4,9,18,50.0,9,13,0,13,1,18,3,0,0,2021-2022,90.0,9.677419354838708,164.51612903225805
615,Damien Da Silva,FRA,DF,Lyon,Ligue 1,33,1988,12.5,13,9,7,5,1,5,9,55.6,4,15,10,5,22,35,53,1,0,2021-2022,90.0,158.4,93.6
616,Moanes Dabbur,ISR,"FW,MF",Hoffenheim,Bundesliga,29,1992,14.6,18,10,3,5,10,4,17,23.5,13,10,0,10,5,23,4,0,0,2021-2022,90.0,30.82191780821918,110.95890410958904
617,Colin Dagba,FRA,DF,Paris S-G,Ligue 1,22,1998,1.8,4,2,2,2,0,3,6,50.0,3,4,2,2,2,6,1,0,0,2021-2022,90.0,100.0,200.0
618,Finn Dahmen,GER,GK,Mainz 05,Bundesliga,23,1998,2.0,0,0,0,0,0,0,0,0.0,0,0,0,0,0,0,2,0,0,2021-2022,90.0,0.0,0.0
619,Mahmoud Dahoud,GER,MF,Dortmund,Bundesliga,25,1996,18.4,42,19,10,24,8,20,46,43.5,26,18,3,15,17,59,16,0,0,2021-2022,90.0,83.15217391304348,205.43478260869566
620,Patson Daka,ZAM,FW,Leicester City,Premier League,22,1998,12.9,15,10,2,8,5,2,19,10.5,17,7,0,7,2,17,8,0,0,2021-2022,90.0,13.953488372093023,104.65116279069767
621,Stuart Dallas,NIR,"DF,MF",Leeds United,Premier League,30,1991,32.4,93,55,58,31,4,56,105,53.3,49,45,14,31,57,150,63,2,0,2021-2022,90.0,158.33333333333334,258.33333333333337
622,Diogo Dalot,POR,DF,Manchester Utd,Premier League,22,1999,20.0,55,41,35,12,8,31,57,54.4,26,24,13,11,29,84,59,0,0,2021-2022,90.0,130.5,247.5
623,Mikkel Damsgaard,DEN,"MF,FW",Sampdoria,Serie A,21,2000,6.4,27,13,12,11,4,20,36,55.6,16,16,1,15,7,34,7,0,0,2021-2022,90.0,98.4375,379.6875
624,Flavius Daniliuc,AUT,DF,Nice,Ligue 1,20,2001,14.4,46,31,26,17,3,34,43,79.1,9,13,7,6,14,60,34,1,0,2021-2022,90.0,87.5,287.5
625,Danilo,BRA,"DF,MF",Juventus,Serie A,30,1991,21.0,37,26,20,13,4,18,28,64.3,10,21,12,9,32,69,53,1,0,2021-2022,90.0,137.14285714285714,158.57142857142856
Rk,Player,Nation,Pos,Squad,Comp,0,0,90.0,0,0,3,3,3,Tkl,0,0.0,0,0,0,0,0,0,0,0,0,2021-2022,90.0,0.0,0.0
626,Arnaut Danjuma,NED,FW,Villarreal,La Liga,24,1997,16.4,7,6,3,0,4,2,4,50.0,2,5,0,5,2,9,3,0,0,2021-2022,90.0,10.975609756097562,38.41463414634147
627,Kevin Danso,AUT,DF,Lens,Ligue 1,22,1998,31.0,41,29,29,12,0,23,34,67.6,11,38,25,13,40,81,111,0,0,2021-2022,90.0,116.12903225806451,119.03225806451613
628,Dante,BRA,DF,Nice,Ligue 1,37,1983,31.9,42,29,30,12,0,23,33,69.7,10,43,27,16,49,91,96,1,0,2021-2022,90.0,138.24451410658307,118.49529780564264
629,Ebrima Darboe,GAM,MF,Roma,Serie A,20,2001,0.7,1,1,0,1,0,0,0,0.0,0,0,0,0,1,2,0,1,0,2021-2022,90.0,128.57142857142858,128.57142857142858
630,Márton Dárdai,HUN,DF,Hertha BSC,Bundesliga,19,2002,8.4,10,4,8,2,0,8,18,44.4,10,16,6,10,20,30,33,2,0,2021-2022,90.0,214.28571428571428,107.14285714285714
631,Sergi Darder,ESP,MF,Espanyol,La Liga,27,1993,34.7,45,22,16,19,10,18,54,33.3,36,16,1,15,26,71,32,1,0,2021-2022,90.0,67.43515850144091,116.71469740634005
632,Vladimír Darida,CZE,MF,Hertha BSC,Bundesliga,30,1990,19.8,32,18,15,13,4,13,32,40.6,19,22,3,19,20,52,17,2,0,2021-2022,90.0,90.9090909090909,145.45454545454547
633,Karl Darlow,ENG,GK,Newcastle Utd,Premier League,30,1990,8.0,0,0,0,0,0,0,0,0.0,0,0,0,0,0,0,5,1,0,2021-2022,90.0,0.0,0.0
634,Matteo Darmian,ITA,DF,Inter,Serie A,31,1989,16.7,32,16,17,9,6,16,41,39.0,25,16,1,15,19,51,25,0,0,2021-2022,90.0,102.39520958083833,172.4550898203593
635,Josh Dasilva,ENG,"MF,FW",Brentford,Premier League,22,1998,2.9,2,1,0,1,1,1,2,50.0,1,3,0,3,1,3,7,0,0,2021-2022,90.0,31.03448275862069,62.06896551724138
636,Jonathan David,CAN,FW,Lille,Ligue 1,21,2000,31.2,24,9,7,11,6,9,30,30.0,21,14,4,10,5,29,15,0,0,2021-2022,90.0,14.423076923076923,69.23076923076923
637,Alphonso Davies,CAN,DF,Bayern Munich,Bundesliga,20,2000,19.3,34,17,17,8,9,13,31,41.9,18,27,1,26,23,57,26,1,0,2021-2022,90.0,107.25388601036268,158.54922279792746
638,Ben Davies,WAL,DF,Tottenham,Premier League,28,1993,28.2,36,21,20,12,4,13,26,50.0,13,32,19,13,30,66,75,1,0,2021-2022,89.99999999999999,95.74468085106382,114.89361702127658
639,Tom Davies,ENG,MF,Everton,Premier League,23,1998,2.6,3,1,1,1,1,2,5,40.0,3,2,1,1,2,5,9,0,0,2021-2022,90.0,69.23076923076923,103.84615384615384
640,Keinan Davis,ENG,FW,Aston Villa,Premier League,23,1998,0.1,0,0,0,0,0,0,0,0.0,0,0,0,0,0,0,0,0,0,2021-2022,90.0,0.0,0.0
641,Paweł Dawidowicz,POL,DF,Hellas Verona,Serie A,26,1995,13.3,30,18,16,10,4,16,25,64.0,9,14,11,3,21,51,53,0,0,2021-2022,90.0,142.10526315789474,203.00751879699246
642,Craig Dawson,ENG,DF,West Ham,Premier League,31,1990,30.6,29,17,20,8,1,14,25,56.0,11,59,52,7,29,58,139,0,0,2021-2022,90.0,85.29411764705881,85.29411764705881
643,Kevin De Bruyne,BEL,MF,Manchester City,Premier League,30,1991,24.5,32,16,4,15,13,12,37,32.4,25,32,2,30,6,38,16,0,0,2021-2022,90.00000000000001,22.040816326530614,117.55102040816328
644,Konrad De La Fuente,USA,"FW,MF",Marseille,Ligue 1,20,2001,8.7,11,7,8,2,1,7,11,63.6,4,5,0,5,2,13,4,0,0,2021-2022,90.0,20.689655172413794,113.79310344827586
645,Sebastien De Maio,FRA,DF,Udinese,Serie A,34,1987,2.0,5,1,4,1,0,1,9,11.1,8,6,5,1,1,6,9,0,0,2021-2022,90.0,45.0,225.0
646,Tommaso De Nipoti,ITA,FW,Atalanta,Serie A,18,2003,0.1,0,0,0,0,0,0,0,0.0,0,0,0,0,0,0,0,0,0,2021-2022,90.0,0.0,0.0
647,Rodrigo De Paul,ARG,MF,Atlético Madrid,La Liga,27,1994,23.9,55,30,22,25,8,30,60,50.0,30,24,3,21,21,76,17,2,0,2021-2022,90.0,79.0794979079498,207.11297071129707
648,Mattia De Sciglio,ITA,DF,Juventus,Serie A,28,1992,13.0,24,12,7,9,8,11,24,45.8,13,10,0,10,10,34,30,0,0,2021-2022,90.00000000000001,69.23076923076924,166.15384615384616
649,Lorenzo De Silvestri,ITA,DF,Bologna,Serie A,33,1988,25.5,23,14,13,8,2,9,31,29.0,22,25,7,18,26,49,52,0,0,2021-2022,90.0,91.76470588235294,81.17647058823529
650,Saulo Decarli,SUI,DF,Bochum,Bundesliga,29,1992,0.1,0,0,0,0,0,0,0,0.0,0,0,0,0,0,0,0,0,0,2021-2022,90.0,0.0,0.0
Rk,Player,Nation,Pos,Squad,Comp,0,0,90.0,0,0,3,3,3,Tkl,0,0.0,0,0,0,0,0,0,0,0,0,2021-2022,90.0,0.0,0.0
651,Troy Deeney,ENG,FW,Watford,Premier League,33,1988,0.3,0,0,0,0,0,0,1,0.0,1,0,0,0,0,0,2,0,0,2021-2022,90.0,0.0,0.0
652,Grégoire Defrel,MTQ,FW,Sassuolo,Serie A,30,1991,15.1,15,9,4,8,3,6,16,37.5,10,11,1,10,4,19,11,0,0,2021-2022,90.0,23.841059602649008,89.40397350993378
653,Alessandro Deiola,ITA,MF,Cagliari,Serie A,25,1995,23.7,47,22,15,25,7,23,58,39.7,35,28,10,18,26,73,45,0,0,2021-2022,90.0,98.73417721518989,178.48101265822785
654,Romain Del Castillo,FRA,"MF,FW",Rennes,Ligue 1,25,1996,0.3,2,1,0,1,1,2,2,100.0,0,0,0,0,1,3,0,0,0,2021-2022,90.0,300.0,600.0
655,Romain Del Castillo,FRA,"MF,FW",Brest,Ligue 1,25,1996,10.8,27,16,3,17,7,12,31,38.7,19,12,0,12,7,34,3,0,0,2021-2022,90.0,58.33333333333333,224.99999999999997
656,Thomas Delaine,FRA,DF,Metz,Ligue 1,29,1992,25.7,48,35,34,12,2,22,42,52.4,20,20,7,13,27,75,31,0,0,2021-2022,90.0,94.55252918287937,168.09338521400778
657,Thomas Delaney,DEN,MF,Sevilla,La Liga,29,1991,17.2,41,24,17,21,3,16,30,53.3,14,19,10,9,13,54,35,0,0,2021-2022,90.0,68.0232558139535,214.53488372093025
658,Thomas Delaney,DEN,MF,Dortmund,Bundesliga,29,1991,0.2,0,0,0,0,0,0,0,0.0,0,0,0,0,0,0,0,0,0,2021-2022,90.0,0.0,0.0
659,Liam Delap,ENG,FW,Manchester City,Premier League,18,2003,0.1,0,0,0,0,0,0,0,0.0,0,0,0,0,0,0,0,0,0,2021-2022,90.0,0.0,0.0
660,Sacha Delaye,FRA,"MF,FW",Montpellier,Ligue 1,19,2002,2.9,8,6,3,2,3,2,8,25.0,6,1,0,1,1,9,1,1,0,2021-2022,90.0,31.03448275862069,248.27586206896552
661,Filippo Delli Carri,ITA,DF,Salernitana,Serie A,22,1999,3.7,6,4,4,2,0,5,14,35.7,9,6,2,4,4,10,14,0,0,2021-2022,90.0,97.29729729729729,145.94594594594594
662,Andy Delort,ALG,FW,Nice,Ligue 1,29,1991,27.2,15,9,3,5,7,7,12,58.3,5,13,4,9,9,24,14,0,0,2021-2022,90.0,29.77941176470588,49.63235294117647
663,Andy Delort,ALG,FW,Montpellier,Ligue 1,29,1991,3.0,2,0,0,1,1,0,1,0.0,1,1,0,1,0,2,4,0,0,2021-2022,90.0,0.0,60.0
664,Fabian Delph,ENG,MF,Everton,Premier League,31,1989,7.4,18,15,10,7,1,8,21,38.1,13,12,5,7,14,32,10,0,0,2021-2022,90.0,170.27027027027026,218.9189189189189
665,Moussa Dembélé,FRA,FW,Lyon,Ligue 1,25,1996,24.5,18,9,5,5,8,6,15,40.0,9,13,0,13,8,26,30,1,0,2021-2022,90.00000000000001,29.38775510204082,66.12244897959184
666,Ousmane Dembélé,FRA,FW,Barcelona,La Liga,24,1997,15.7,24,16,6,10,8,7,23,30.4,16,8,0,8,8,32,3,0,0,2021-2022,90.0,45.85987261146497,137.57961783439492
667,Yusuf Demir,AUT,FW,Barcelona,La Liga,18,2003,2.1,3,1,1,1,1,2,5,40.0,3,1,0,1,2,5,1,0,0,2021-2022,90.0,85.71428571428571,128.57142857142856
668,Merih Demiral,TUR,DF,Atalanta,Serie A,23,1998,21.3,31,17,18,12,1,15,28,53.6,13,26,14,12,58,89,68,1,0,2021-2022,90.0,245.07042253521126,130.98591549295776
669,Kerem Demirbay,GER,MF,Leverkusen,Bundesliga,28,1993,22.8,52,31,19,30,3,16,41,39.0,25,32,9,23,33,85,21,0,0,2021-2022,90.0,130.26315789473682,205.26315789473682
670,Ermedin Demirović,BIH,FW,Freiburg,Bundesliga,23,1998,9.7,12,6,4,4,4,1,10,10.0,9,14,1,13,1,13,7,0,0,2021-2022,90.0,9.278350515463918,111.34020618556703
671,Diego Demme,GER,MF,Napoli,Serie A,29,1991,7.7,21,12,4,13,4,10,21,47.6,11,11,2,9,9,30,2,0,0,2021-2022,90.0,105.1948051948052,245.45454545454547
672,Jason Denayer,BEL,DF,Lyon,Ligue 1,26,1995,11.1,11,4,8,3,0,6,7,85.7,1,8,7,1,16,27,52,0,0,2021-2022,90.0,129.72972972972974,89.1891891891892
673,Leander Dendoncker,BEL,MF,Wolves,Premier League,26,1995,21.7,42,17,25,14,3,22,50,44.0,28,37,10,27,9,51,38,1,0,2021-2022,90.0,37.327188940092164,174.19354838709677
674,Emmanuel Dennis,NGA,"FW,MF",Watford,Premier League,23,1997,28.7,51,35,20,22,9,17,52,32.7,35,36,2,34,15,66,13,0,0,2021-2022,90.0,47.038327526132406,159.93031358885017
675,Fabio Depaoli,ITA,DF,Hellas Verona,Serie A,24,1997,7.8,12,7,6,4,2,1,7,14.3,6,9,2,7,8,20,14,0,0,2021-2022,90.0,92.3076923076923,138.46153846153845
Rk,Player,Nation,Pos,Squad,Comp,0,0,90.0,0,0,3,3,3,Tkl,0,0.0,0,0,0,0,0,0,0,0,0,2021-2022,90.0,0.0,0.0
676,Fabio Depaoli,ITA,"MF,DF",Sampdoria,Serie A,24,1997,1.2,3,1,1,2,0,0,2,0.0,2,2,1,1,1,4,2,0,0,2021-2022,90.0,75.0,225.00000000000003
677,Mike van der Hoorn,NED,DF,Arminia,Bundesliga,28,1992,0.2,1,0,1,0,0,0,0,0.0,0,0,0,0,1,2,2,0,0,2021-2022,90.0,450.0,450.0
678,Arthur Desmas,FRA,GK,Clermont Foot,Ligue 1,27,1994,14.5,0,0,0,0,0,0,3,0.0,3,0,0,0,0,0,1,3,0,2021-2022,90.0,0.0,0.0
679,Sergiño Dest,USA,"DF,FW",Barcelona,La Liga,20,2000,16.8,32,15,21,10,1,13,18,72.2,5,22,4,18,2,34,18,0,0,2021-2022,90.0,10.714285714285714,171.42857142857142
680,Mattia Destro,ITA,FW,Genoa,Serie A,30,1991,19.4,9,4,1,4,4,1,6,16.7,5,14,1,13,2,11,16,0,0,2021-2022,90.0,9.278350515463918,41.75257731958764
681,Gerard Deulofeu,ESP,"FW,MF",Udinese,Serie A,27,1994,29.1,11,6,2,3,6,7,29,24.1,22,14,0,14,9,20,4,0,0,2021-2022,90.0,27.83505154639175,34.02061855670103
682,Kiernan Dewsbury-Hall,ENG,MF,Leicester City,Premier League,22,1998,23.4,39,24,20,14,5,19,40,47.5,21,37,8,29,21,60,26,1,0,2021-2022,89.99999999999999,80.76923076923076,150.0
683,Jacopo Dezi,ITA,MF,Venezia,Serie A,29,1992,0.2,0,0,0,0,0,0,1,0.0,1,0,0,0,1,1,0,0,0,2021-2022,90.0,450.0,0.0
684,Samuel Di Carmine,ITA,FW,Hellas Verona,Serie A,32,1988,0.4,0,0,0,0,0,0,0,0.0,0,0,0,0,0,0,0,0,0,2021-2022,90.0,0.0,0.0
685,Federico Di Francesco,ITA,"FW,MF",Empoli,Serie A,27,1994,15.2,16,5,2,8,6,9,23,39.1,14,17,1,16,9,25,11,0,0,2021-2022,90.0,53.28947368421053,94.73684210526315
686,Giovanni Di Lorenzo,ITA,DF,Napoli,Serie A,27,1993,31.9,58,36,30,20,8,33,58,56.9,25,28,10,18,38,96,46,1,0,2021-2022,90.0,107.21003134796238,163.63636363636363
687,Ángel Di María,ARG,FW,Paris S-G,Ligue 1,33,1988,18.3,29,18,6,13,10,14,37,37.8,23,17,0,17,6,35,3,0,0,2021-2022,90.0,29.508196721311474,142.62295081967213
688,Francesco Di Mariano,ITA,FW,Venezia,Serie A,25,1996,0.7,1,1,0,1,0,0,0,0.0,0,2,1,1,0,1,0,0,0,2021-2022,90.0,0.0,128.57142857142858
689,Francesco Di Tacchio,ITA,MF,Salernitana,Serie A,31,1990,13.9,17,7,5,10,2,9,25,36.0,16,16,8,8,22,39,25,0,0,2021-2022,90.0,142.44604316546764,110.07194244604317
690,Boulaye Dia,SEN,FW,Villarreal,La Liga,24,1996,14.1,8,6,3,4,1,2,5,40.0,3,6,1,5,5,13,4,0,0,2021-2022,89.99999999999999,31.914893617021274,51.06382978723404
691,Moussa Diaby,FRA,"FW,MF",Leverkusen,Bundesliga,22,1999,30.7,20,11,8,9,3,5,38,13.2,33,11,0,11,8,28,2,0,0,2021-2022,90.0,23.452768729641697,58.63192182410424
692,Yadaly Diaby,GUI,"FW,MF",Clermont Foot,Ligue 1,20,2000,0.7,0,0,0,0,0,0,1,0.0,1,0,0,0,2,2,2,0,0,2021-2022,90.0,257.14285714285717,0.0
693,Mouctar Diakhaby,GUI,DF,Valencia,La Liga,24,1996,21.6,35,24,18,15,2,13,23,56.5,10,29,17,12,30,65,87,3,0,2021-2022,90.0,124.99999999999999,145.83333333333331
694,Ibrahim Diakité,GUI,MF,Reims,Ligue 1,17,2003,0.0,0,0,0,0,0,0,1,0.0,1,0,0,0,0,0,0,0,0,2021-2022,,,
695,Abdou Diallo,SEN,DF,Paris S-G,Ligue 1,25,1996,9.7,22,14,10,9,3,8,14,57.1,6,6,2,4,10,32,19,1,0,2021-2022,90.0,92.78350515463919,204.1237113402062
696,Habib Diallo,SEN,FW,Strasbourg,Ligue 1,26,1995,17.1,9,5,0,8,1,0,8,0.0,8,13,4,9,4,13,11,0,0,2021-2022,90.0,21.05263157894737,47.368421052631575
697,Ibrahima Diallo,FRA,MF,Southampton,Premier League,22,1999,11.4,22,11,10,9,3,10,24,41.7,14,7,0,7,9,31,10,0,0,2021-2022,90.0,71.05263157894736,173.68421052631578
698,Habib Diarra,SEN,MF,Strasbourg,Ligue 1,17,2004,1.2,2,1,1,1,0,1,1,100.0,0,0,0,0,0,2,0,0,0,2021-2022,90.0,0.0,150.0
699,Stéphane Diarra,FRA,"MF,FW",Lorient,Ligue 1,22,1998,5.8,11,9,7,3,1,5,10,50.0,5,4,0,4,7,18,1,0,0,2021-2022,90.0,108.62068965517241,170.6896551724138
700,Rúben Dias,POR,DF,Manchester City,Premier League,24,1997,26.7,26,19,11,12,3,8,15,53.3,7,19,13,6,23,49,66,0,0,2021-2022,90.00000000000001,77.52808988764046,87.64044943820225
Rk,Player,Nation,Pos,Squad,Comp,0,0,90.0,0,0,3,3,3,Tkl,0,0.0,0,0,0,0,0,0,0,0,0,2021-2022,90.0,0.0,0.0
701,Krépin Diatta,SEN,"MF,DF",Monaco,Ligue 1,22,1999,3.2,3,2,1,0,2,1,3,33.3,2,2,0,2,1,4,0,0,0,2021-2022,90.0,28.125,84.375
702,Amadou Diawara,GUI,MF,Roma,Serie A,24,1997,1.9,7,2,5,2,0,1,3,33.3,2,2,0,2,0,7,1,0,0,2021-2022,90.0,0.0,331.57894736842104
703,Brahim Díaz,MAR,MF,Milan,Serie A,21,1999,20.6,23,17,3,11,9,8,22,36.4,14,11,0,11,8,31,4,0,0,2021-2022,90.0,34.95145631067961,100.48543689320388
704,Javier Díaz,ESP,GK,Sevilla,La Liga,24,1997,1.0,0,0,0,0,0,0,0,0.0,0,0,0,0,0,0,0,0,0,2021-2022,90.0,0.0,0.0
705,Luis Díaz,COL,FW,Liverpool,Premier League,24,1997,10.6,9,7,3,5,1,2,8,25.0,6,7,0,7,4,13,2,0,0,2021-2022,90.0,33.9622641509434,76.41509433962264
706,Víctor Díaz,ESP,DF,Granada,La Liga,33,1988,16.7,23,15,14,9,0,12,25,48.0,13,19,11,8,17,40,71,1,0,2021-2022,90.0,91.61676646706587,123.95209580838323
707,Daniel Didavi,GER,"MF,FW",Stuttgart,Bundesliga,31,1990,3.1,6,2,0,4,2,4,7,57.1,3,4,1,3,1,7,1,0,0,2021-2022,90.0,29.032258064516128,174.19354838709677
708,Bamba Dieng,SEN,FW,Marseille,Ligue 1,21,2000,10.8,17,11,5,5,7,4,14,28.6,10,7,0,7,5,22,8,0,0,2021-2022,90.0,41.666666666666664,141.66666666666666
709,Eric Dier,ENG,DF,Tottenham,Premier League,27,1994,34.1,15,9,6,8,1,7,14,50.0,7,37,32,5,27,42,142,1,0,2021-2022,90.0,71.26099706744868,39.589442815249264
710,Elhadji Dieye,SEN,"FW,MF",Saint-Étienne,Ligue 1,19,2002,0.4,3,2,2,1,0,0,1,0.0,1,2,0,2,1,4,0,0,0,2021-2022,90.0,225.0,675.0
711,Lucas Digne,FRA,DF,Aston Villa,Premier League,28,1993,14.1,13,10,8,3,2,9,19,47.4,10,15,8,7,23,36,40,0,0,2021-2022,89.99999999999999,146.80851063829786,82.97872340425532
712,Lucas Digne,FRA,DF,Everton,Premier League,28,1993,13.0,33,19,26,4,3,21,28,75.0,7,16,5,11,14,47,30,0,0,2021-2022,90.00000000000001,96.92307692307693,228.46153846153848
713,Mitchell Dijks,NED,"DF,FW",Bologna,Serie A,28,1993,7.7,15,6,6,6,3,5,12,41.7,7,11,2,9,3,18,10,1,0,2021-2022,90.0,35.064935064935064,175.32467532467533
714,Javairô Dilrosun,NED,"MF,FW",Bordeaux,Ligue 1,23,1998,19.2,13,4,2,8,3,7,24,29.2,17,14,1,13,11,24,5,0,0,2021-2022,90.0,51.5625,60.93750000000001
715,Javairô Dilrosun,NED,FW,Hertha BSC,Bundesliga,23,1998,1.5,3,1,1,2,0,1,1,100.0,0,1,0,1,0,3,0,0,0,2021-2022,90.0,0.0,180.0
716,Federico Dimarco,ITA,DF,Inter,Serie A,23,1997,15.9,28,15,10,15,3,13,24,54.2,11,6,1,5,19,47,19,0,0,2021-2022,90.0,107.54716981132076,158.49056603773585
717,Landry Dimata,BEL,"FW,MF",Espanyol,La Liga,23,1997,6.0,2,2,1,1,0,1,4,25.0,3,0,0,0,1,3,7,0,0,2021-2022,90.0,15.0,30.0
718,Stole Dimitrievski,MKD,GK,Rayo Vallecano,La Liga,27,1993,30.8,0,0,0,0,0,0,0,0.0,0,0,0,0,1,1,14,3,0,2021-2022,90.0,2.9220779220779223,0.0
719,Junior Dina Ebimbe,FRA,MF,Paris S-G,Ligue 1,20,2000,3.5,9,4,3,4,2,2,3,66.7,1,5,3,2,2,11,1,0,0,2021-2022,90.0,51.42857142857143,231.42857142857142
720,Tristan Dingomé,CMR,"MF,FW",Troyes,Ligue 1,30,1991,12.0,23,11,10,12,1,10,18,55.6,8,7,1,6,9,32,3,0,0,2021-2022,90.0,67.5,172.5
721,Sinaly Diomande,CIV,DF,Lyon,Ligue 1,20,2001,6.4,6,3,4,2,0,5,6,83.3,1,6,6,0,12,18,26,0,0,2021-2022,90.0,168.75,84.375
722,Issa Diop,FRA,DF,West Ham,Premier League,24,1997,10.7,10,8,5,5,0,4,11,36.4,7,14,13,1,7,17,44,0,0,2021-2022,90.0,58.8785046728972,84.11214953271029
723,Sofiane Diop,FRA,"MF,FW",Monaco,Ligue 1,21,2000,21.6,38,20,12,19,7,15,47,31.9,32,10,0,10,23,61,4,0,0,2021-2022,90.0,95.83333333333333,158.33333333333331
724,Andy Diouf,FRA,MF,Rennes,Ligue 1,18,2003,0.2,1,1,1,0,0,1,1,100.0,0,1,0,1,0,1,0,0,0,2021-2022,90.0,0.0,450.0
725,Assane Dioussé,SEN,MF,Saint-Étienne,Ligue 1,23,1997,0.3,1,1,1,0,0,1,1,100.0,0,0,0,0,0,1,0,0,0,2021-2022,90.0,0.0,300.0
Rk,Player,Nation,Pos,Squad,Comp,0,0,90.0,0,0,3,3,3,Tkl,0,0.0,0,0,0,0,0,0,0,0,0,2021-2022,90.0,0.0,0.0
726,Axel Disasi,FRA,DF,Monaco,Ligue 1,23,1998,30.2,42,27,20,21,1,23,39,59.0,16,40,30,10,26,68,75,0,0,2021-2022,90.0,77.48344370860927,125.16556291390728
727,Filippo Distefano,ITA,FW,Fiorentina,Serie A,17,2003,0.0,0,0,0,0,0,0,0,0.0,0,0,0,0,0,0,0,0,0,2021-2022,,,
728,Matías Dituro,ARG,GK,Celta Vigo,La Liga,34,1987,38.0,0,0,0,0,0,0,0,0.0,0,0,0,0,0,0,10,5,0,2021-2022,90.0,0.0,0.0
729,Tiago Djaló,POR,DF,Lille,Ligue 1,21,2000,25.9,60,39,39,19,2,26,39,66.7,13,26,10,16,24,84,71,0,0,2021-2022,90.0,83.39768339768341,208.49420849420852
730,Djené,TOG,DF,Getafe,La Liga,29,1991,34.6,44,26,24,16,4,23,34,67.6,11,24,5,19,59,103,109,2,0,2021-2022,90.0,153.46820809248553,114.45086705202311
731,Moussa Djenepo,MLI,MF,Southampton,Premier League,23,1998,5.1,9,3,3,5,1,3,11,27.3,8,6,1,5,2,11,6,1,0,2021-2022,90.0,35.294117647058826,158.82352941176472
732,Koffi Djidji,CIV,DF,Torino,Serie A,28,1992,19.3,48,29,21,23,4,14,18,77.8,4,20,9,11,34,82,60,0,0,2021-2022,90.0,158.54922279792746,223.83419689119168
733,Alexander Djiku,GHA,DF,Strasbourg,Ligue 1,26,1994,29.9,50,37,33,13,4,18,35,51.4,17,30,13,17,61,111,90,2,0,2021-2022,90.0,183.6120401337793,150.5016722408027
734,Bryan Djile Nokoué,CMR,"DF,MF",Saint-Étienne,Ligue 1,19,2002,0.6,3,3,1,2,0,2,2,100.0,0,1,0,1,1,4,2,0,0,2021-2022,90.0,150.0,450.00000000000006
735,Berat Djimsiti,ALB,DF,Atalanta,Serie A,28,1993,25.1,43,24,21,20,2,29,46,63.0,17,21,11,10,31,74,56,0,0,2021-2022,90.0,111.15537848605577,154.1832669322709
736,Ouparine Djoco,GNB,GK,Clermont Foot,Ligue 1,23,1998,23.5,0,0,0,0,0,0,0,0.0,0,0,0,0,1,1,14,2,0,2021-2022,90.0,3.829787234042553,0.0
737,Naïs Djouahra,FRA,"FW,MF",Real Sociedad,La Liga,21,1999,2.4,7,3,2,2,3,4,8,50.0,4,3,0,3,2,9,2,0,0,2021-2022,90.0,75.0,262.5
738,Marko Dmitrović,SRB,GK,Sevilla,La Liga,29,1992,6.0,0,0,0,0,0,0,0,0.0,0,0,0,0,0,0,3,1,0,2021-2022,90.0,0.0,0.0
739,Lewis Dobbin,ENG,"FW,MF",Everton,Premier League,18,2003,0.4,2,1,0,1,1,1,2,50.0,1,0,0,0,0,2,0,0,0,2021-2022,90.0,0.0,450.0
740,Matt Doherty,IRL,DF,Tottenham,Premier League,29,1992,9.7,18,12,5,11,2,8,14,57.1,6,11,2,9,13,31,20,0,0,2021-2022,90.0,120.61855670103094,167.01030927835055
741,Jeremy Doku,BEL,"FW,MF",Rennes,Ligue 1,19,2002,5.2,10,5,3,5,2,3,6,50.0,3,4,0,4,3,13,0,0,0,2021-2022,90.0,51.92307692307692,173.07692307692307
742,Kasper Dolberg,DEN,FW,Nice,Ligue 1,23,1997,16.6,9,4,4,3,2,3,9,33.3,6,15,1,14,6,15,17,0,0,2021-2022,90.0,32.53012048192771,48.79518072289156
743,Jaume Doménech,ESP,GK,Valencia,La Liga,30,1990,3.8,0,0,0,0,0,0,0,0.0,0,0,0,0,0,0,3,1,0,2021-2022,90.0,0.0,0.0
744,Brandon Domingues,FRA,"MF,FW",Troyes,Ligue 1,21,2000,2.6,6,2,2,4,0,2,3,66.7,1,3,0,3,3,9,0,0,0,2021-2022,90.0,103.84615384615384,207.69230769230768
745,Carlos Dominguez,ESP,DF,Celta Vigo,La Liga,20,2001,3.8,4,1,4,0,0,4,6,66.7,2,2,1,1,4,8,21,0,0,2021-2022,90.0,94.73684210526315,94.73684210526315
746,Mario Dominguez,ESP,FW,Valencia,La Liga,17,2004,0.3,0,0,0,0,0,0,0,0.0,0,0,0,0,0,0,1,0,0,2021-2022,90.0,0.0,0.0
747,Nicolás Domínguez,ARG,MF,Bologna,Serie A,23,1998,22.4,76,45,36,32,8,32,76,42.1,44,38,9,29,32,108,34,1,0,2021-2022,90.0,128.57142857142858,305.3571428571429
748,John Donald,ESP,DF,Elche,La Liga,20,2000,2.0,7,4,4,2,1,5,8,62.5,3,5,3,2,3,10,3,0,0,2021-2022,90.0,135.0,315.0
749,Lee Dongjun,KOR,"MF,FW",Hertha BSC,Bundesliga,24,1997,1.3,2,1,0,2,0,1,3,33.3,2,2,0,2,2,4,1,0,0,2021-2022,90.0,138.46153846153845,138.46153846153845
750,Anastasios Donis,GRE,"FW,MF",Reims,Ligue 1,24,1996,4.1,8,7,4,2,2,2,6,33.3,4,3,0,3,0,8,1,0,0,2021-2022,90.0,0.0,175.609756097561
Rk,Player,Nation,Pos,Squad,Comp,0,0,90.0,0,0,3,3,3,Tkl,0,0.0,0,0,0,0,0,0,0,0,0,2021-2022,90.0,0.0,0.0
751,Gianluigi Donnarumma,ITA,GK,Paris S-G,Ligue 1,22,1999,17.0,0,0,0,0,0,0,0,0.0,0,0,0,0,0,0,9,2,0,2021-2022,90.0,0.0,0.0
752,Niklas Dorsch,GER,MF,Augsburg,Bundesliga,23,1998,25.8,76,47,47,23,6,30,60,50.0,30,34,12,22,35,111,36,3,0,2021-2022,90.0,122.09302325581395,265.1162790697674
753,Jodel Dossou,BEN,FW,Clermont Foot,Ligue 1,29,1992,22.3,36,17,15,14,7,15,43,34.9,28,14,0,14,5,41,7,0,0,2021-2022,90.0,20.179372197309416,145.29147982062779
754,Lohann Doucet,FRA,"MF,DF",Nantes,Ligue 1,18,2002,0.1,0,0,0,0,0,0,0,0.0,0,0,0,0,1,1,0,0,0,2021-2022,90.0,900.0,0.0
755,Abdoulaye Doucouré,MLI,MF,Everton,Premier League,28,1993,28.2,75,43,30,37,8,32,71,45.1,39,33,8,25,28,103,32,0,0,2021-2022,89.99999999999999,89.36170212765957,239.36170212765956
756,Cheick Doucouré,MLI,MF,Lens,Ligue 1,21,2000,32.7,75,43,34,34,7,35,79,44.3,44,30,7,23,68,143,24,0,0,2021-2022,90.0,187.1559633027523,206.42201834862385
757,Fodé Doucouré,MLI,"DF,FW",Reims,Ligue 1,20,2001,1.7,12,9,9,3,0,9,11,81.8,2,1,0,1,4,16,6,0,0,2021-2022,90.0,211.76470588235293,635.2941176470588
758,Ismaël Doukouré,FRA,DF,Strasbourg,Ligue 1,18,2003,0.2,0,0,0,0,0,0,0,0.0,0,0,0,0,0,0,1,0,0,2021-2022,90.0,0.0,0.0
759,Kamory Doumbia,MLI,"MF,FW",Reims,Ligue 1,18,2003,3.9,8,2,2,5,1,5,13,38.5,8,9,3,6,3,11,3,0,0,2021-2022,90.0,69.23076923076923,184.6153846153846
760,Moussa Doumbia,MLI,FW,Reims,Ligue 1,26,1994,1.0,0,0,0,0,0,0,1,0.0,1,0,0,0,0,0,0,0,0,2021-2022,90.0,0.0,0.0
761,Souleyman Doumbia,CIV,"DF,FW",Angers,Ligue 1,24,1996,24.7,30,20,16,9,5,13,27,48.1,14,25,4,21,39,69,51,0,0,2021-2022,90.0,142.10526315789474,109.31174089068826
762,Kieran Dowell,ENG,"FW,MF",Norwich City,Premier League,23,1997,10.1,18,7,8,7,3,9,32,28.1,23,10,1,9,7,25,4,0,0,2021-2022,90.0,62.37623762376238,160.3960396039604
763,Bartłomiej Drągowski,POL,GK,Fiorentina,Serie A,23,1997,6.2,0,0,0,0,0,0,0,0.0,0,0,0,0,1,1,5,2,0,2021-2022,90.0,14.516129032258064,0.0
764,Radu Drăgușin,ROU,DF,Sampdoria,Serie A,19,2002,6.9,4,3,2,2,0,2,6,33.3,4,8,4,4,10,14,33,0,0,2021-2022,90.0,130.43478260869563,52.17391304347826
765,Radu Drăgușin,ROU,DF,Salernitana,Serie A,19,2002,5.4,5,4,2,3,0,4,10,40.0,6,7,3,4,13,18,17,0,0,2021-2022,90.0,216.66666666666666,83.33333333333333
766,Cody Drameh,ENG,"DF,MF",Leeds United,Premier League,19,2001,1.4,4,2,3,1,0,1,3,33.3,2,0,0,0,1,5,4,0,0,2021-2022,90.0,64.28571428571429,257.14285714285717
767,Julian Draxler,GER,"FW,MF",Paris S-G,Ligue 1,27,1993,6.1,3,2,0,3,0,0,4,0.0,4,3,0,3,5,8,3,0,0,2021-2022,90.0,73.7704918032787,44.26229508196722
768,Matthieu Dreyer,FRA,GK,Lorient,Ligue 1,32,1989,16.0,1,1,1,0,0,1,1,100.0,0,0,0,0,0,1,9,0,0,2021-2022,90.0,0.0,5.625
769,Domingos Duarte,POR,DF,Granada,La Liga,26,1995,18.7,18,14,9,9,0,6,11,54.5,5,27,20,7,22,40,82,0,0,2021-2022,90.0,105.88235294117646,86.63101604278074
770,Óscar Duarte,CRC,DF,Levante,La Liga,32,1989,19.7,18,8,12,6,0,8,23,34.8,15,18,9,9,24,42,102,0,0,2021-2022,90.0,109.64467005076142,82.23350253807106
771,Rubén Duarte,ESP,DF,Alavés,La Liga,25,1995,29.1,76,47,43,27,6,43,85,50.6,42,40,6,34,57,133,82,0,0,2021-2022,90.0,176.28865979381442,235.05154639175257
772,Leo Dubois,FRA,DF,Lyon,Ligue 1,26,1994,19.4,43,27,22,14,7,27,46,58.7,19,27,3,24,22,65,35,1,0,2021-2022,90.0,102.0618556701031,199.48453608247425
773,Martin Dúbravka,SVK,GK,Newcastle Utd,Premier League,32,1989,26.0,1,1,1,0,0,0,1,0.0,1,0,0,0,0,1,8,2,0,2021-2022,90.00000000000001,0.0,3.4615384615384617
774,Ondrej Duda,SVK,"MF,FW",Köln,Bundesliga,26,1994,17.9,23,16,4,12,7,6,23,26.1,17,14,2,12,17,40,9,0,0,2021-2022,90.0,85.47486033519554,115.64245810055867
775,Jeremy Dudziak,TUN,"MF,FW",Greuther Fürth,Bundesliga,25,1995,12.6,17,6,5,8,4,3,14,21.4,11,8,0,8,10,27,4,0,0,2021-2022,90.0,71.42857142857143,121.42857142857144
Rk,Player,Nation,Pos,Squad,Comp,0,0,90.0,0,0,3,3,3,Tkl,0,0.0,0,0,0,0,0,0,0,0,0,2021-2022,90.0,0.0,0.0
776,Shane Duffy,IRL,DF,Brighton,Premier League,29,1992,16.0,15,12,12,3,0,8,14,57.1,6,24,18,6,16,31,76,1,0,2021-2022,90.0,90.0,84.375
777,Unai Dufur,ESP,DF,Osasuna,La Liga,22,1999,1.0,0,0,0,0,0,0,0,0.0,0,1,0,1,4,4,4,0,0,2021-2022,90.0,360.0,0.0
778,Denzel Dumfries,NED,DF,Inter,Serie A,25,1996,22.5,32,12,9,14,9,16,32,50.0,16,15,6,9,9,41,26,0,0,2021-2022,90.0,36.0,128.0
779,Paul Dummett,WAL,DF,Newcastle Utd,Premier League,29,1991,2.2,7,3,3,4,0,5,8,62.5,3,5,0,5,3,10,5,0,0,2021-2022,90.0,122.72727272727272,286.3636363636364
780,Alfred Duncan,GHA,MF,Fiorentina,Serie A,28,1993,21.5,34,19,13,16,5,11,32,34.4,21,32,3,29,10,44,7,0,0,2021-2022,90.0,41.860465116279066,142.32558139534882
781,Lewis Dunk,ENG,DF,Brighton,Premier League,29,1991,28.6,10,8,5,5,0,5,11,45.5,6,32,28,4,27,37,113,3,0,2021-2022,90.0,84.96503496503497,31.46853146853147
782,Erik Durm,GER,DF,Eint Frankfurt,Bundesliga,29,1992,5.3,13,7,6,5,2,10,13,76.9,3,8,1,7,10,23,7,0,0,2021-2022,90.0,169.811320754717,220.75471698113208
783,Hugo Duro,ESP,"DF,MF",Getafe,La Liga,21,1999,0.1,0,0,0,0,0,0,0,0.0,0,0,0,0,0,0,0,0,0,2021-2022,90.0,0.0,0.0
784,Hugo Duro,ESP,"FW,MF",Valencia,La Liga,21,1999,20.4,25,19,11,13,1,15,38,39.5,23,24,2,22,4,29,20,1,0,2021-2022,90.0,17.647058823529413,110.29411764705883
785,Jean-Kevin Duverne,HAI,DF,Brest,Ligue 1,24,1997,33.4,71,44,43,21,7,42,90,46.7,48,40,5,35,53,124,92,0,0,2021-2022,90.0,142.81437125748502,191.31736526946108
786,Paulo Dybala,ARG,"FW,MF",Juventus,Serie A,27,1993,22.9,30,13,7,14,9,8,35,22.9,27,19,0,19,9,39,4,3,0,2021-2022,90.0,35.37117903930131,117.90393013100437
787,Edin Džeko,BIH,FW,Inter,Serie A,35,1986,27.4,14,8,7,4,3,8,25,32.0,17,22,5,17,4,18,35,0,0,2021-2022,90.0,13.138686131386862,45.98540145985402
788,Enzo Ebosse,CMR,DF,Angers,Ligue 1,22,1999,21.0,25,14,19,6,0,11,19,57.9,8,19,9,10,15,40,42,0,0,2021-2022,90.0,64.28571428571428,107.14285714285714
789,Tyronne Ebuehi,NGA,DF,Venezia,Serie A,25,1995,12.6,28,12,16,8,4,10,18,55.6,8,13,3,10,16,44,38,1,0,2021-2022,90.0,114.28571428571429,200.00000000000003
790,Ederson,BRA,GK,Manchester City,Premier League,27,1993,37.0,2,1,2,0,0,0,2,0.0,2,0,0,0,0,2,12,0,0,2021-2022,90.0,0.0,4.864864864864865
791,Éderson,BRA,MF,Salernitana,Serie A,22,1999,12.7,29,18,11,14,4,14,26,53.8,12,11,2,9,19,48,8,0,0,2021-2022,90.0,134.64566929133858,205.51181102362204
792,Odsonne Édouard,FRA,FW,Crystal Palace,Premier League,23,1998,17.4,16,10,2,7,7,7,21,33.3,14,20,5,15,0,16,18,0,0,2021-2022,90.0,0.0,82.75862068965517
793,CJ Egan-Riley,ENG,DF,Manchester City,Premier League,18,2003,0.0,1,1,1,0,0,1,1,100.0,0,0,0,0,0,1,0,0,0,2021-2022,,,inf
794,Maximilian Eggestein,GER,MF,Freiburg,Bundesliga,24,1996,24.4,48,28,17,25,6,22,50,44.0,28,35,11,24,30,78,32,1,0,2021-2022,90.0,110.65573770491804,177.04918032786887
795,Lilian Egloff,GER,"MF,DF",Stuttgart,Bundesliga,18,2002,0.3,1,0,0,1,0,0,0,0.0,0,1,0,1,0,1,0,0,0,2021-2022,90.0,0.0,300.0
796,Kingsley Ehizibue,NED,DF,Köln,Bundesliga,26,1995,7.6,32,18,27,5,0,15,24,62.5,9,13,4,9,9,41,26,0,0,2021-2022,90.0,106.57894736842105,378.9473684210526
797,Julian Eitschberger,GER,DF,Hertha BSC,Bundesliga,17,2004,0.5,0,0,0,0,0,0,1,0.0,1,1,1,0,2,2,2,0,0,2021-2022,90.0,360.0,0.0
798,Albin Ekdal,SWE,MF,Sampdoria,Serie A,32,1989,18.2,43,28,17,21,5,26,56,46.4,30,27,7,20,29,72,25,0,0,2021-2022,90.0,143.4065934065934,212.63736263736263
799,Hugo Ekitike,FRA,FW,Reims,Ligue 1,19,2002,14.1,18,10,8,6,4,4,11,36.4,7,9,2,7,6,24,15,0,0,2021-2022,89.99999999999999,38.29787234042553,114.89361702127658
800,Jurgen Ekkelenkamp,NED,"MF,FW",Hertha BSC,Bundesliga,21,2000,8.0,8,3,2,6,0,2,7,28.6,5,9,2,7,4,12,5,0,0,2021-2022,90.0,45.0,90.0
Rk,Player,Nation,Pos,Squad,Comp,0,0,90.0,0,0,3,3,3,Tkl,0,0.0,0,0,0,0,0,0,0,0,0,2021-2022,90.0,0.0,0.0
801,Caleb Ekuban,GHA,"FW,MF",Genoa,Serie A,27,1994,19.1,19,12,2,12,5,7,23,30.4,16,19,5,14,9,28,6,0,0,2021-2022,90.0,42.40837696335078,89.52879581151832
802,Anthony Elanga,SWE,FW,Manchester Utd,Premier League,19,2002,13.5,26,20,12,12,2,15,29,51.7,14,17,1,16,9,35,7,0,0,2021-2022,90.0,60.0,173.33333333333334
803,Alberth Elis,HON,"FW,MF",Bordeaux,Ligue 1,25,1996,15.7,19,10,5,5,9,11,25,44.0,14,9,0,9,7,26,10,0,0,2021-2022,90.0,40.12738853503185,108.9171974522293
804,Harvey Elliott,ENG,MF,Liverpool,Premier League,18,2003,3.8,3,0,1,1,1,0,6,0.0,6,8,1,7,4,7,2,0,0,2021-2022,90.0,94.73684210526315,71.05263157894737
805,Elif Elmas,MKD,"FW,MF",Napoli,Serie A,21,1999,18.0,25,15,10,10,5,12,28,42.9,16,13,2,11,8,33,17,0,0,2021-2022,90.0,40.0,125.0
806,Mohamed Elneny,EGY,MF,Arsenal,Premier League,29,1992,9.0,16,8,10,5,1,7,12,58.3,5,7,1,6,14,30,13,0,0,2021-2022,90.0,140.0,160.0
807,Aritz Elustondo,ESP,DF,Real Sociedad,La Liga,27,1994,23.4,21,14,16,5,0,10,20,50.0,10,19,13,6,29,50,86,0,0,2021-2022,89.99999999999999,111.53846153846153,80.76923076923076
808,Nico Elvedi,SUI,DF,Gladbach,Bundesliga,24,1996,27.0,40,24,23,17,0,22,36,61.1,14,33,22,11,34,74,83,1,0,2021-2022,90.0,113.33333333333334,133.33333333333334
809,Mohamed Elyounoussi,NOR,"MF,FW",Southampton,Premier League,26,1994,22.7,36,17,14,15,7,11,39,28.2,28,23,2,21,12,48,28,0,0,2021-2022,89.99999999999999,47.57709251101321,142.73127753303964
810,Adri Embarba,ESP,"FW,MF",Espanyol,La Liga,29,1992,22.1,44,29,22,15,7,26,69,37.7,43,35,3,32,19,63,30,0,0,2021-2022,90.0,77.37556561085972,179.18552036199094
811,Breel Embolo,SUI,FW,Gladbach,Bundesliga,24,1997,24.1,16,11,1,12,3,3,8,37.5,5,14,2,12,6,22,7,0,0,2021-2022,90.0,22.406639004149376,59.75103734439834
812,Emerson,BRA,"DF,MF",Tottenham,Premier League,22,1999,25.4,72,47,50,16,6,36,67,53.7,31,25,2,23,22,94,92,1,0,2021-2022,90.0,77.95275590551182,255.11811023622047
813,Emerson,BRA,DF,Barcelona,La Liga,22,1999,1.0,3,3,2,1,0,1,2,50.0,1,1,0,1,2,5,1,0,0,2021-2022,90.0,180.0,270.0
814,Renaud Emond,BEL,"FW,MF",Nantes,Ligue 1,29,1991,2.1,1,0,0,1,0,0,4,0.0,4,2,1,1,0,1,1,0,0,2021-2022,90.0,0.0,42.857142857142854
815,Youssef En-Nesyri,MAR,FW,Sevilla,La Liga,24,1997,14.2,10,5,5,2,3,4,11,36.4,7,9,1,8,4,14,18,0,0,2021-2022,90.0,25.35211267605634,63.38028169014085
816,Keita Endo,JPN,MF,Union Berlin,Bundesliga,23,1997,0.6,1,1,1,0,0,0,0,0.0,0,1,0,1,0,1,0,0,0,2021-2022,90.0,0.0,150.0
817,Wataru Endo,JPN,MF,Stuttgart,Bundesliga,28,1993,32.2,73,41,34,34,5,31,72,43.1,41,43,12,31,30,103,64,0,0,2021-2022,90.0,83.85093167701862,204.03726708074532
818,Christian Eriksen,DEN,MF,Brentford,Premier League,29,1992,10.4,13,6,4,5,4,8,17,47.1,9,9,1,8,9,22,14,0,0,2021-2022,90.0,77.88461538461537,112.49999999999999
819,Martin Erlic,CRO,DF,Spezia,Serie A,23,1998,28.6,28,16,18,10,0,10,18,55.6,8,54,39,15,28,56,122,1,0,2021-2022,90.0,88.11188811188812,88.11188811188812
820,Gonzalo Escalante,ARG,MF,Lazio,Serie A,28,1993,0.1,1,0,1,0,0,1,1,100.0,0,2,1,1,1,2,0,0,0,2021-2022,90.0,900.0,900.0
821,Gonzalo Escalante,ARG,MF,Alavés,La Liga,28,1993,14.4,30,14,9,20,1,13,34,38.2,21,27,2,25,21,51,28,0,0,2021-2022,90.0,131.25,187.5
822,Aarón Escandell,ESP,GK,Granada,La Liga,25,1995,3.2,0,0,0,0,0,0,1,0.0,1,0,0,0,0,0,4,0,0,2021-2022,90.0,0.0,0.0
823,Sergio Escudero,ESP,"DF,MF",Granada,La Liga,31,1989,15.9,46,24,25,17,4,26,54,48.1,28,18,3,15,26,72,35,0,0,2021-2022,90.0,147.16981132075472,260.37735849056605
824,Alfonso Espino,URU,DF,Cádiz,La Liga,29,1992,37.0,107,63,58,39,10,44,112,39.3,68,45,10,35,54,161,87,1,0,2021-2022,90.0,131.35135135135135,260.27027027027026
825,Michael Esser,GER,GK,Bochum,Bundesliga,33,1987,3.0,0,0,0,0,0,0,1,0.0,1,0,0,0,0,0,2,0,0,2021-2022,90.0,0.0,0.0
Rk,Player,Nation,Pos,Squad,Comp,0,0,90.0,0,0,3,3,3,Tkl,0,0.0,0,0,0,0,0,0,0,0,0,2021-2022,90.0,0.0,0.0
826,Estanis,ESP,FW,Barcelona,La Liga,17,2003,0.1,1,1,0,1,0,1,1,100.0,0,0,0,0,0,1,0,0,0,2021-2022,90.0,0.0,900.0
827,Maxime Estève,FRA,DF,Montpellier,Ligue 1,19,2002,20.6,27,18,22,4,1,15,27,55.6,12,31,24,7,22,49,69,1,0,2021-2022,90.0,96.11650485436893,117.96116504854369
828,Pervis Estupiñán,ECU,DF,Villarreal,La Liga,23,1998,17.5,36,22,20,11,5,17,24,70.8,7,13,5,8,25,61,29,2,0,2021-2022,90.0,128.57142857142856,185.14285714285714
829,Oghenekaro Etebo,NGA,MF,Watford,Premier League,25,1995,4.5,11,8,7,4,0,3,8,37.5,5,3,1,2,5,16,5,0,0,2021-2022,90.0,100.0,220.0
830,Jonny Evans,NIR,DF,Leicester City,Premier League,33,1988,15.0,24,14,14,8,2,14,22,63.6,8,17,13,4,20,44,59,0,0,2021-2022,90.0,120.0,144.0
831,Eberechi Eze,ENG,"MF,FW",Crystal Palace,Premier League,23,1998,6.7,10,6,5,2,3,6,11,54.5,5,4,1,3,5,15,1,0,0,2021-2022,90.0,67.16417910447761,134.32835820895522
832,Abde Ezzalzouli,MAR,FW,Barcelona,La Liga,19,2001,6.4,17,9,9,5,3,5,8,62.5,3,3,0,3,9,26,0,0,0,2021-2022,90.0,126.5625,239.0625
833,Łukasz Fabiański,POL,GK,West Ham,Premier League,36,1985,37.0,0,0,0,0,0,0,0,0.0,0,0,0,0,0,0,11,0,0,2021-2022,90.0,0.0,0.0
834,Fabinho,BRA,MF,Liverpool,Premier League,27,1993,25.7,46,25,17,23,6,24,70,34.3,46,33,10,23,39,85,25,1,0,2021-2022,90.0,136.5758754863813,161.08949416342412
835,Fábio,BRA,DF,Nantes,Ligue 1,31,1990,18.5,61,40,31,23,7,36,74,48.6,38,29,7,22,35,96,31,1,0,2021-2022,90.0,170.2702702702703,296.7567567567568
836,Cesc Fàbregas,ESP,MF,Monaco,Ligue 1,34,1987,0.4,1,0,0,1,0,1,1,100.0,0,0,0,0,1,2,0,0,0,2021-2022,90.0,225.0,225.0
837,Wout Faes,BEL,DF,Reims,Ligue 1,23,1998,37.0,40,24,30,9,1,25,33,75.8,8,47,37,10,53,93,169,2,0,2021-2022,90.0,128.91891891891893,97.2972972972973
838,Wahid Faghir,DEN,FW,Stuttgart,Bundesliga,18,2003,1.4,0,0,0,0,0,0,1,0.0,1,2,0,2,0,0,0,0,0,2021-2022,90.0,0.0,0.0
839,Romain Faivre,FRA,"FW,MF",Lyon,Ligue 1,23,1998,9.9,10,4,2,6,2,4,13,30.8,9,4,0,4,3,13,2,0,0,2021-2022,90.0,27.272727272727273,90.9090909090909
840,Romain Faivre,FRA,MF,Brest,Ligue 1,23,1998,19.9,30,18,12,13,5,12,30,40.0,18,11,0,11,13,43,10,0,0,2021-2022,90.0,58.79396984924624,135.678391959799
841,Radamel Falcao,COL,FW,Rayo Vallecano,La Liga,35,1986,9.3,2,1,0,1,1,1,4,25.0,3,4,1,3,2,4,11,0,0,2021-2022,90.0,19.354838709677416,19.354838709677416
842,Diego Falcinelli,ITA,FW,Bologna,Serie A,30,1991,0.7,2,2,2,0,0,0,0,0.0,0,0,0,0,1,3,1,0,0,2021-2022,90.0,128.57142857142858,257.14285714285717
843,Wladimiro Falcone,ITA,GK,Sampdoria,Serie A,26,1995,9.5,0,0,0,0,0,0,0,0.0,0,0,0,0,1,1,5,0,0,2021-2022,90.0,9.473684210526315,0.0
844,Fali,ESP,"DF,MF",Cádiz,La Liga,27,1993,20.0,32,19,24,8,0,17,32,53.1,15,26,16,10,24,56,82,0,0,2021-2022,90.0,108.0,144.0
845,Paolo Faragò,ITA,MF,Cagliari,Serie A,28,1993,0.2,1,1,1,0,0,0,0,0.0,0,2,0,2,0,1,0,0,0,2021-2022,90.0,0.0,450.0
846,Omar Faraj,PLE,FW,Levante,La Liga,19,2002,0.0,1,0,1,0,0,1,1,100.0,0,0,0,0,0,1,0,0,0,2021-2022,,,inf
847,Davide Faraoni,ITA,DF,Hellas Verona,Serie A,29,1991,28.6,62,40,38,21,3,29,62,46.8,33,38,5,33,23,85,62,1,0,2021-2022,90.0,72.37762237762237,195.10489510489512
848,Mohamed Fares,ALG,"DF,FW",Genoa,Serie A,25,1996,6.5,4,2,1,3,0,0,4,0.0,4,8,3,5,8,12,11,0,0,2021-2022,90.00000000000001,110.76923076923077,55.38461538461539
849,Diego Farias,BRA,"MF,FW",Cagliari,Serie A,31,1990,0.7,1,1,0,1,0,1,3,33.3,2,0,0,0,0,1,0,0,0,2021-2022,90.0,0.0,128.57142857142858
850,Wuilker Faríñez,VEN,GK,Lens,Ligue 1,23,1998,12.3,0,0,0,0,0,0,0,0.0,0,0,0,0,0,0,4,0,0,2021-2022,89.99999999999999,0.0,0.0
Rk,Player,Nation,Pos,Squad,Comp,0,0,90.0,0,0,3,3,3,Tkl,0,0.0,0,0,0,0,0,0,0,0,0,2021-2022,90.0,0.0,0.0
851,Ömer Faruk Beyaz,TUR,"DF,MF",Stuttgart,Bundesliga,17,2003,0.8,4,3,1,3,0,1,5,20.0,4,0,0,0,2,6,0,0,0,2021-2022,90.0,225.0,450.0
852,Noah Fatar,FRA,"DF,MF",Angers,Ligue 1,19,2002,0.1,1,0,0,0,1,0,1,0.0,1,0,0,0,1,2,0,0,0,2021-2022,90.0,900.0,900.0
853,Ansu Fati,ESP,FW,Barcelona,La Liga,18,2002,3.7,3,2,0,2,1,1,1,100.0,0,4,0,4,1,4,0,0,0,2021-2022,90.0,24.324324324324323,72.97297297297297
854,Julien Faussurier,FRA,"MF,DF",Brest,Ligue 1,34,1987,5.4,10,6,3,3,4,6,13,46.2,7,12,1,11,5,15,6,0,0,2021-2022,90.0,83.33333333333333,166.66666666666666
855,Andrea Favilli,ITA,FW,Genoa,Serie A,24,1997,0.4,1,1,0,0,1,0,0,0.0,0,0,0,0,0,1,2,0,0,2021-2022,90.0,0.0,225.0
856,Federico Fazio,ARG,DF,Salernitana,Serie A,34,1987,15.9,17,11,10,6,1,9,12,75.0,3,21,16,5,27,44,67,1,0,2021-2022,90.0,152.83018867924528,96.22641509433963
857,Aleix Febas,ESP,MF,Mallorca,La Liga,25,1996,1.3,4,1,0,4,0,2,4,50.0,2,0,0,0,0,4,0,0,0,2021-2022,90.0,0.0,276.9230769230769
858,Peter Federico,DOM,"MF,DF",Real Madrid,La Liga,19,2002,0.3,0,0,0,0,0,0,0,0.0,0,0,0,0,1,1,0,0,0,2021-2022,90.0,300.0,0.0
859,Adrian Fein,GER,MF,Greuther Fürth,Bundesliga,22,1999,0.4,0,0,0,0,0,0,1,0.0,1,0,0,0,2,2,0,0,0,2021-2022,90.0,450.0,0.0
860,Nabil Fekir,FRA,MF,Betis,La Liga,28,1993,31.0,43,29,5,25,13,7,36,19.4,29,14,0,14,7,50,7,0,0,2021-2022,90.0,20.322580645161292,124.83870967741936
861,Felipe,BRA,DF,Atlético Madrid,La Liga,32,1989,16.7,20,15,11,8,1,8,18,44.4,10,17,11,6,28,48,77,0,0,2021-2022,90.0,150.89820359281438,107.78443113772455
862,Luiz Felipe,ITA,DF,Lazio,Serie A,24,1997,27.7,41,23,21,16,4,20,34,58.8,14,40,33,7,33,74,102,1,0,2021-2022,90.0,107.2202166064982,133.2129963898917
863,João Félix,POR,"FW,MF",Atlético Madrid,La Liga,21,1999,14.0,5,2,1,4,0,1,5,20.0,4,4,1,3,7,12,8,0,0,2021-2022,90.0,45.0,32.14285714285714
864,Ohis Felix Uduokhai,GER,DF,Augsburg,Bundesliga,23,1997,8.7,9,6,6,3,0,6,11,54.5,5,13,8,5,9,18,33,0,0,2021-2022,90.0,93.10344827586206,93.10344827586206
865,Kiko Femenía,ESP,DF,Watford,Premier League,30,1991,23.8,35,22,23,10,2,21,37,56.8,16,24,8,16,37,72,51,0,0,2021-2022,90.00000000000001,139.91596638655463,132.3529411764706
866,Evan Ferguson,IRL,MF,Brighton,Premier League,16,2004,0.3,0,0,0,0,0,0,0,0.0,0,0,0,0,0,0,0,0,0,2021-2022,90.0,0.0,0.0
867,Nathan Ferguson,ENG,DF,Crystal Palace,Premier League,20,2000,0.1,0,0,0,0,0,0,0,0.0,0,0,0,0,0,0,0,0,0,2021-2022,90.0,0.0,0.0
868,Bruno Fernandes,POR,MF,Manchester Utd,Premier League,26,1994,34.6,54,28,26,22,6,26,91,28.6,65,36,0,36,17,71,42,2,0,2021-2022,90.0,44.21965317919075,140.46242774566474
869,Edimilson Fernandes,SUI,"MF,FW",Arminia,Bundesliga,25,1996,3.1,2,0,1,1,0,1,4,25.0,3,2,2,0,2,4,6,0,0,2021-2022,90.0,58.064516129032256,58.064516129032256
870,Aitor Fernández,ESP,GK,Levante,La Liga,30,1991,13.0,2,1,2,0,0,2,2,100.0,0,0,0,0,0,2,7,0,0,2021-2022,90.00000000000001,0.0,13.846153846153847
871,Álex Fernández,ESP,MF,Cádiz,La Liga,28,1992,22.8,47,31,22,17,8,21,61,34.4,40,30,7,23,30,77,31,0,0,2021-2022,90.0,118.42105263157893,185.52631578947367
872,Álvaro Fernández,ESP,GK,Brentford,Premier League,23,1998,12.0,0,0,0,0,0,0,0,0.0,0,0,0,0,0,0,5,2,0,2021-2022,90.0,0.0,0.0
873,Federico Fernández,ARG,DF,Newcastle Utd,Premier League,32,1989,5.8,3,0,3,0,0,2,5,40.0,3,10,10,0,4,7,28,0,0,2021-2022,90.0,62.06896551724138,46.55172413793103
874,Fernandinho,BRA,"MF,DF",Manchester City,Premier League,36,1985,10.7,21,10,7,10,4,9,27,33.3,18,8,2,6,8,29,13,1,0,2021-2022,90.0,67.28971962616824,176.6355140186916
875,Fernando,BRA,"MF,DF",Sevilla,La Liga,34,1987,20.6,24,17,14,9,1,12,33,36.4,21,21,13,8,29,53,32,2,0,2021-2022,90.0,126.69902912621359,104.85436893203884
Rk,Player,Nation,Pos,Squad,Comp,0,0,90.0,0,0,3,3,3,Tkl,0,0.0,0,0,0,0,0,0,0,0,0,2021-2022,90.0,0.0,0.0
876,Alex Ferrari,ITA,DF,Sampdoria,Serie A,27,1994,18.3,40,22,28,9,3,19,33,57.6,14,31,22,9,39,79,63,1,0,2021-2022,90.0,191.80327868852459,196.72131147540983
877,Salvador Ferrer,ESP,"DF,MF",Spezia,Serie A,23,1998,16.6,32,18,15,9,8,12,25,48.0,13,24,12,12,18,50,46,0,0,2021-2022,90.0,97.59036144578312,173.49397590361443
878,Jordan Ferri,FRA,MF,Montpellier,Ligue 1,29,1992,32.3,55,35,28,23,4,29,87,33.3,58,21,5,16,30,85,35,0,0,2021-2022,90.0,83.59133126934985,153.25077399380805
879,Riccardo Fiamozzi,ITA,DF,Empoli,Serie A,28,1993,6.9,7,5,2,2,3,2,4,50.0,2,6,5,1,7,14,12,0,0,2021-2022,90.0,91.30434782608695,91.30434782608695
880,Fidel,ESP,MF,Elche,La Liga,31,1989,25.1,44,23,18,17,9,14,57,24.6,43,9,1,8,7,51,20,0,0,2021-2022,90.0,25.099601593625497,157.76892430278883
881,Karol Fila,POL,DF,Strasbourg,Ligue 1,23,1998,6.2,10,8,5,4,1,4,8,50.0,4,7,2,5,4,14,6,0,0,2021-2022,90.0,58.064516129032256,145.16129032258064
882,Alfreð Finnbogason,ISL,FW,Augsburg,Bundesliga,32,1989,3.2,3,1,0,2,1,2,4,50.0,2,5,1,4,2,5,8,0,0,2021-2022,90.0,56.25,84.375
883,Luca Fiordilino,ITA,MF,Venezia,Serie A,25,1996,7.3,21,13,11,6,4,13,27,48.1,14,14,4,10,11,32,12,0,0,2021-2022,90.0,135.6164383561644,258.9041095890411
884,Vincenzo Fiorillo,ITA,GK,Salernitana,Serie A,31,1990,1.0,0,0,0,0,0,0,0,0.0,0,0,0,0,0,0,1,0,0,2021-2022,90.0,0.0,0.0
885,Roberto Firmino,BRA,FW,Liverpool,Premier League,29,1991,11.0,23,14,5,8,10,3,16,18.8,13,20,0,20,4,27,3,0,0,2021-2022,90.0,32.72727272727273,188.1818181818182
886,Junior Firpo,DOM,"DF,MF",Leeds United,Premier League,24,1996,19.0,61,29,30,26,5,31,59,52.5,28,22,6,16,24,85,37,0,0,2021-2022,90.0,113.6842105263158,288.94736842105266
887,Mark Flekken,NED,GK,Freiburg,Bundesliga,28,1993,32.0,0,0,0,0,0,0,2,0.0,2,1,0,1,2,2,10,1,0,2021-2022,90.0,5.625,0.0
888,Ashley Fletcher,ENG,FW,Watford,Premier League,25,1995,0.3,2,1,1,1,0,1,1,100.0,0,1,1,0,0,2,0,0,0,2021-2022,90.0,0.0,600.0
889,Alexis Flips,FRA,"MF,DF",Reims,Ligue 1,21,2000,11.7,37,21,21,9,7,22,45,48.9,23,21,0,21,24,61,17,0,0,2021-2022,89.99999999999999,184.6153846153846,284.6153846153846
890,Alessandro Florenzi,ITA,"DF,FW",Milan,Serie A,30,1991,12.8,28,14,14,7,7,14,32,43.8,18,9,2,7,27,55,10,1,0,2021-2022,90.0,189.84375,196.875
891,Phil Foden,ENG,FW,Manchester City,Premier League,21,2000,23.6,16,8,10,4,2,7,17,41.2,10,9,0,9,11,27,5,0,0,2021-2022,90.0,41.94915254237288,61.01694915254237
892,Mamadou Fofana,MLI,DF,Metz,Ligue 1,23,1998,0.4,1,1,0,1,0,1,2,50.0,1,2,1,1,1,2,2,0,0,2021-2022,90.0,225.0,225.0
893,Seko Fofana,CIV,MF,Lens,Ligue 1,26,1995,37.3,27,19,11,13,3,12,58,20.7,46,24,2,22,26,53,17,1,0,2021-2022,90.0,62.73458445040215,65.14745308310992
894,Wesley Fofana,FRA,DF,Leicester City,Premier League,20,2000,7.0,12,8,11,1,0,7,11,63.6,4,5,2,3,12,24,26,1,0,2021-2022,90.0,154.28571428571428,154.28571428571428
895,Youssouf Fofana,FRA,MF,Monaco,Ligue 1,22,1999,24.3,69,43,19,41,9,29,56,51.8,27,29,7,22,32,101,22,2,0,2021-2022,90.0,118.5185185185185,255.55555555555554
896,Thomas Foket,BEL,"DF,FW",Reims,Ligue 1,26,1994,24.8,28,19,12,13,3,18,40,45.0,22,26,4,22,33,61,35,0,0,2021-2022,90.0,119.75806451612904,101.61290322580645
897,Thomas Fontaine,MAD,DF,Lorient,Ligue 1,30,1991,1.9,2,0,1,0,1,0,1,0.0,1,3,3,0,2,4,4,0,0,2021-2022,90.0,94.73684210526315,94.73684210526315
898,José Fontán,ESP,DF,Celta Vigo,La Liga,21,2000,3.1,5,3,3,2,0,1,5,20.0,4,3,1,2,10,15,10,0,0,2021-2022,90.0,290.3225806451613,145.16129032258064
899,José Fonte,POR,DF,Lille,Ligue 1,37,1983,38.0,23,12,14,7,2,11,25,44.0,14,39,32,7,44,67,159,1,0,2021-2022,90.0,104.21052631578948,54.473684210526315
900,Fernando Forestieri,ITA,"FW,MF",Udinese,Serie A,31,1990,0.6,0,0,0,0,0,0,1,0.0,1,1,0,1,0,0,1,0,0,2021-2022,90.0,0.0,0.0
Rk,Player,Nation,Pos,Squad,Comp,0,0,90.0,0,0,3,3,3,Tkl,0,0.0,0,0,0,0,0,0,0,0,0,2021-2022,90.0,0.0,0.0
901,Pablo Fornals,ESP,"FW,MF",West Ham,Premier League,25,1996,31.1,54,28,21,21,12,22,84,26.2,62,49,2,47,27,81,16,1,0,2021-2022,90.0,78.13504823151125,156.2700964630225
902,Emil Forsberg,SWE,MF,RB Leipzig,Bundesliga,29,1991,19.0,21,12,2,11,8,7,22,31.8,15,18,0,18,2,23,2,1,0,2021-2022,90.0,9.473684210526315,99.47368421052632
903,Adam Forshaw,ENG,MF,Leeds United,Premier League,29,1991,17.0,53,23,21,27,5,21,54,38.9,33,17,1,16,19,72,12,2,0,2021-2022,90.0,100.58823529411765,280.5882352941177
904,Marcus Forss,FIN,"FW,MF",Brentford,Premier League,22,1999,2.3,3,3,0,2,1,2,4,50.0,2,5,0,5,1,4,0,0,0,2021-2022,90.0,39.130434782608695,117.3913043478261
905,Fraser Forster,ENG,GK,Southampton,Premier League,33,1988,19.0,1,0,1,0,0,0,1,0.0,1,0,0,0,0,1,23,2,0,2021-2022,90.0,0.0,4.7368421052631575
906,Philipp Förster,GER,"MF,FW",Stuttgart,Bundesliga,26,1995,10.7,20,13,4,12,4,11,26,42.3,15,12,1,11,3,23,2,0,0,2021-2022,90.0,25.233644859813086,168.22429906542058
907,Francesco Forte,ITA,FW,Venezia,Serie A,28,1993,4.7,3,2,0,2,1,2,5,40.0,3,1,0,1,0,3,2,0,0,2021-2022,90.0,0.0,57.44680851063829
908,Steven Fortes,CPV,DF,Lens,Ligue 1,29,1992,1.0,2,0,2,0,0,1,2,50.0,1,2,1,1,0,2,4,0,0,2021-2022,90.0,0.0,180.0
909,Ben Foster,ENG,GK,Watford,Premier League,38,1983,26.0,0,0,0,0,0,0,3,0.0,3,0,0,0,0,0,9,4,0,2021-2022,90.00000000000001,0.0,0.0
910,Tariqe Fosu,GHA,DF,Brentford,Premier League,25,1995,0.2,0,0,0,0,0,0,0,0.0,0,1,0,1,0,0,0,0,0,2021-2022,90.0,0.0,0.0
911,Timothy Fosu-Mensah,NED,DF,Leverkusen,Bundesliga,23,1998,1.6,5,3,3,1,1,4,4,100.0,0,1,0,1,2,7,2,0,0,2021-2022,90.0,112.5,281.25
912,Dimitri Foulquier,FRA,DF,Granada,La Liga,28,1993,2.0,0,0,0,0,0,0,1,0.0,1,2,1,1,1,1,2,0,0,2021-2022,90.0,45.0,0.0
913,Dimitri Foulquier,FRA,DF,Valencia,La Liga,28,1993,26.0,36,17,17,15,4,21,34,61.8,13,19,3,16,29,65,49,0,0,2021-2022,90.00000000000001,100.3846153846154,124.61538461538463
914,Juan Foyth,ARG,DF,Villarreal,La Liga,23,1998,21.4,69,49,35,28,6,35,47,74.5,12,29,7,22,20,89,50,0,0,2021-2022,90.0,84.11214953271029,290.1869158878505
915,Gianluca Frabotta,ITA,"DF,MF",Hellas Verona,Serie A,22,1999,0.2,0,0,0,0,0,0,1,0.0,1,1,0,1,1,1,0,0,0,2021-2022,90.0,450.0,0.0
916,Raphael Framberger,GER,DF,Augsburg,Bundesliga,25,1995,9.4,26,19,12,10,4,13,27,48.1,14,8,2,6,9,35,25,0,0,2021-2022,90.0,86.17021276595744,248.93617021276594
917,Przemysław Frankowski,POL,DF,Lens,Ligue 1,26,1995,27.2,57,39,22,27,8,36,74,48.6,38,27,0,27,28,85,52,0,0,2021-2022,90.0,92.6470588235294,188.60294117647058
918,Enric Franquesa,ESP,"DF,FW",Levante,La Liga,24,1997,6.9,5,3,4,0,1,0,1,0.0,1,4,0,4,7,12,11,0,0,2021-2022,90.0,91.30434782608695,65.21739130434781
919,Fransérgio,BRA,MF,Bordeaux,Ligue 1,30,1990,14.0,24,10,8,12,4,12,43,27.9,31,18,6,12,23,47,23,0,0,2021-2022,90.0,147.85714285714286,154.28571428571428
920,Ryan Fraser,SCO,"FW,MF",Newcastle Utd,Premier League,27,1994,16.3,10,3,5,3,2,5,13,38.5,8,11,1,10,11,21,11,0,0,2021-2022,90.0,60.736196319018404,55.214723926380366
921,Davide Frattesi,ITA,MF,Sassuolo,Serie A,21,1999,31.7,46,16,26,18,2,26,52,50.0,26,44,12,32,29,75,62,1,0,2021-2022,90.0,82.33438485804416,130.5993690851735
922,Fred,BRA,MF,Manchester Utd,Premier League,28,1993,22.5,63,27,32,24,7,22,79,27.8,57,38,11,27,32,95,24,0,0,2021-2022,90.0,128.0,252.0
923,Ryan Fredericks,ENG,DF,West Ham,Premier League,28,1992,3.4,2,2,2,0,0,0,1,0.0,1,2,1,1,4,6,6,0,0,2021-2022,90.0,105.88235294117646,52.94117647058823
924,Morten Frendrup,DEN,"DF,MF",Genoa,Serie A,20,2001,7.7,40,24,19,13,8,13,29,44.8,16,19,2,17,17,57,7,1,0,2021-2022,90.0,198.7012987012987,467.53246753246754
925,Remo Freuler,SUI,MF,Atalanta,Serie A,29,1992,26.3,69,39,22,33,14,30,70,42.9,40,48,8,40,35,104,26,1,0,2021-2022,90.0,119.77186311787072,236.12167300380227
Rk,Player,Nation,Pos,Squad,Comp,0,0,90.0,0,0,3,3,3,Tkl,0,0.0,0,0,0,0,0,0,0,0,0,2021-2022,90.0,0.0,0.0
926,Marvin Friedrich,GER,DF,Gladbach,Bundesliga,25,1995,6.7,14,8,10,4,0,9,11,81.8,2,5,3,2,5,19,26,0,0,2021-2022,90.0,67.16417910447761,188.0597014925373
927,Marvin Friedrich,GER,DF,Union Berlin,Bundesliga,25,1995,13.0,17,5,14,3,0,10,16,62.5,6,13,7,6,23,40,47,0,0,2021-2022,90.00000000000001,159.23076923076925,117.69230769230771
928,Jeremie Frimpong,NED,DF,Leverkusen,Bundesliga,20,2000,22.8,32,18,19,12,1,12,23,52.2,11,24,6,18,17,49,40,2,0,2021-2022,90.0,67.10526315789473,126.3157894736842
929,Christian Früchtl,GER,GK,Bayern Munich,Bundesliga,21,2000,0.1,0,0,0,0,0,0,0,0.0,0,0,0,0,0,0,0,0,0,2021-2022,90.0,0.0,0.0
930,Jorge de Frutos,ESP,"MF,FW",Levante,La Liga,24,1997,19.6,33,15,14,11,8,10,51,19.6,41,11,1,10,12,45,13,0,0,2021-2022,90.0,55.10204081632653,151.53061224489795
931,Leo Fuhr Hjelde,NOR,"MF,DF",Leeds United,Premier League,17,2003,1.7,5,4,3,2,0,3,3,100.0,0,3,3,0,4,9,7,0,0,2021-2022,90.0,211.76470588235293,264.70588235294116
932,Chris Führich,GER,"FW,MF",Stuttgart,Bundesliga,23,1998,19.0,28,16,10,10,8,18,39,46.2,21,31,2,29,8,36,9,0,0,2021-2022,90.0,37.89473684210526,132.6315789473684
933,Angelo Fulgini,FRA,"MF,FW",Angers,Ligue 1,24,1996,32.5,35,25,8,18,9,14,44,31.8,30,21,5,16,22,57,5,1,0,2021-2022,90.0,60.92307692307693,96.92307692307692
934,Marius Funk,GER,GK,Greuther Fürth,Bundesliga,25,1996,8.0,0,0,0,0,0,0,0,0.0,0,0,0,0,0,0,8,1,0,2021-2022,90.0,0.0,0.0
935,Stephan Fürstner,GER,MF,Mainz 05,Bundesliga,33,1987,0.1,0,0,0,0,0,0,2,0.0,2,0,0,0,0,0,1,0,0,2021-2022,90.0,0.0,0.0
936,Matteo Gabbia,ITA,DF,Milan,Serie A,21,1999,6.0,4,3,1,3,0,0,4,0.0,4,2,2,0,8,12,12,0,0,2021-2022,90.0,120.0,60.0
937,Manolo Gabbiadini,ITA,"FW,MF",Sampdoria,Serie A,29,1991,12.7,6,4,3,2,1,1,7,14.3,6,5,2,3,3,9,10,0,0,2021-2022,90.0,21.25984251968504,42.51968503937008
938,Mijat Gaćinović,SRB,"FW,MF",Hoffenheim,Bundesliga,26,1995,1.2,3,3,1,1,1,3,3,100.0,0,1,0,1,1,4,2,0,0,2021-2022,90.0,75.0,225.00000000000003
939,Gianluca Gaetano,ITA,MF,Napoli,Serie A,21,2000,0.2,1,1,1,0,0,1,2,50.0,1,0,0,0,2,3,0,0,0,2021-2022,90.0,900.0,450.0
940,Luca Gagliano,ITA,"FW,DF",Cagliari,Serie A,21,2000,0.1,0,0,0,0,0,0,0,0.0,0,1,0,1,0,0,1,0,0,2021-2022,90.0,0.0,0.0
941,Roberto Gagliardini,ITA,MF,Inter,Serie A,27,1994,7.2,12,6,7,4,1,1,13,7.7,12,14,5,9,9,21,7,0,0,2021-2022,90.0,112.5,150.0
942,Riccardo Gagliolo,SWE,DF,Salernitana,Serie A,31,1990,12.6,23,12,16,4,3,16,27,59.3,11,15,8,7,28,51,52,0,0,2021-2022,90.0,200.00000000000003,164.2857142857143
943,Javi Galán,ESP,DF,Celta Vigo,La Liga,26,1994,36.6,108,66,60,37,11,42,99,42.4,57,48,8,40,45,153,52,0,0,2021-2022,90.0,110.65573770491802,265.57377049180326
944,Iñigo Ruiz de Galarreta,ESP,MF,Mallorca,La Liga,27,1993,15.3,40,21,14,21,5,14,30,46.7,16,16,2,14,20,60,21,0,0,2021-2022,90.0,117.6470588235294,235.2941176470588
945,Nicolas Galazzi,ITA,MF,Venezia,Serie A,20,2000,0.2,2,1,1,0,1,0,1,0.0,1,0,0,0,0,2,0,0,0,2021-2022,90.0,0.0,900.0
946,Pablo Galdames Millán,CHI,MF,Genoa,Serie A,24,1996,11.4,28,12,6,16,6,12,35,34.3,23,16,2,14,8,36,9,1,0,2021-2022,90.0,63.1578947368421,221.05263157894734
947,Thiago Galhardo,BRA,"FW,MF",Celta Vigo,La Liga,32,1989,12.8,12,6,3,3,6,2,12,16.7,10,15,2,13,6,18,9,0,0,2021-2022,90.0,42.1875,84.375
948,Conor Gallagher,ENG,MF,Crystal Palace,Premier League,21,2000,31.6,69,38,35,20,14,21,69,30.4,48,58,9,49,29,98,26,0,0,2021-2022,90.0,82.59493670886074,196.51898734177212
949,Gauthier Gallon,FRA,GK,Troyes,Ligue 1,28,1993,31.0,3,0,3,0,0,1,1,100.0,0,0,0,0,2,5,12,1,0,2021-2022,90.0,5.806451612903226,8.709677419354838
950,Cristian Gamboa,CRC,DF,Bochum,Bundesliga,31,1989,19.1,59,36,40,16,3,30,61,49.2,31,22,7,15,32,91,35,1,0,2021-2022,90.0,150.7853403141361,278.0104712041885
Rk,Player,Nation,Pos,Squad,Comp,0,0,90.0,0,0,3,3,3,Tkl,0,0.0,0,0,0,0,0,0,0,0,0,2021-2022,90.0,0.0,0.0
951,Kévin Gameiro,FRA,FW,Strasbourg,Ligue 1,34,1987,26.5,19,10,5,9,5,6,18,33.3,12,22,1,21,6,25,1,0,0,2021-2022,90.0,20.37735849056604,64.52830188679245
952,Idrissa Gana Gueye,SEN,MF,Paris S-G,Ligue 1,31,1989,18.2,60,36,24,24,12,18,44,40.9,26,23,4,19,24,84,13,0,0,2021-2022,90.0,118.68131868131869,296.7032967032967
953,Ignatius Ganago,CMR,FW,Lens,Ligue 1,22,1999,11.4,3,2,1,2,0,2,6,33.3,4,4,0,4,2,5,3,0,0,2021-2022,90.0,15.789473684210526,23.684210526315788
954,Silvère Ganvoula M'Boussy,CGO,FW,Bochum,Bundesliga,25,1996,1.7,0,0,0,0,0,0,1,0.0,1,0,0,0,0,0,1,0,0,2021-2022,90.0,0.0,0.0
955,Álvaro García,ESP,"FW,MF",Rayo Vallecano,La Liga,28,1992,33.3,42,23,15,18,9,8,35,22.9,27,27,3,24,42,84,24,0,0,2021-2022,90.0,113.51351351351352,113.51351351351352
956,Dani García,ESP,MF,Athletic Club,La Liga,31,1990,24.2,36,22,15,17,4,14,47,29.8,33,27,10,17,24,60,41,1,0,2021-2022,90.0,89.25619834710743,133.88429752066116
957,David García,ESP,DF,Osasuna,La Liga,27,1994,34.5,28,14,15,11,2,12,22,54.5,10,27,21,6,52,80,168,0,0,2021-2022,90.0,135.65217391304347,73.04347826086956
958,Eric García,ESP,DF,Barcelona,La Liga,20,2001,22.7,27,18,13,13,1,11,26,42.3,15,22,12,10,44,71,53,3,0,2021-2022,89.99999999999999,174.44933920704844,107.04845814977973
959,Fran Garcia,ESP,DF,Rayo Vallecano,La Liga,21,1999,33.6,60,35,44,12,4,39,73,53.4,34,34,8,26,45,105,53,0,0,2021-2022,90.0,120.53571428571428,160.7142857142857
960,Joan García,ESP,GK,Espanyol,La Liga,20,2001,1.2,0,0,0,0,0,0,0,0.0,0,0,0,0,1,1,1,2,0,2021-2022,90.0,75.0,0.0
961,Manu García,ESP,MF,Alavés,La Liga,23,1998,12.0,18,9,6,9,3,9,27,33.3,18,8,2,6,13,31,4,0,0,2021-2022,90.0,97.5,135.0
962,Raúl García,ESP,FW,Athletic Club,La Liga,35,1986,20.0,27,17,6,11,10,8,36,22.2,28,30,4,26,9,36,21,0,0,2021-2022,90.0,40.5,121.5
963,Rubén García,ESP,"MF,FW",Osasuna,La Liga,28,1993,26.4,43,26,12,23,8,16,49,32.7,33,31,4,27,24,67,16,0,0,2021-2022,90.0,81.81818181818181,146.5909090909091
964,Saúl García,ESP,MF,Alavés,La Liga,26,1994,0.0,1,1,1,0,0,0,0,0.0,0,0,0,0,0,1,0,0,0,2021-2022,,,inf
965,Unai García,ESP,DF,Osasuna,La Liga,29,1992,15.6,21,12,14,6,1,14,17,82.4,3,19,11,8,22,43,78,0,0,2021-2022,90.0,126.92307692307692,121.15384615384615
966,Alejandro Garnacho,ARG,"FW,MF",Manchester Utd,Premier League,17,2004,0.1,0,0,0,0,0,0,1,0.0,1,0,0,0,0,0,0,0,0,2021-2022,90.0,0.0,0.0
967,Mario Gaspar,ESP,DF,Villarreal,La Liga,30,1990,6.9,10,4,2,5,3,6,10,60.0,4,6,3,3,6,16,15,0,0,2021-2022,90.0,78.26086956521738,130.43478260869563
968,Djeidi Gassama,FRA,FW,Paris S-G,Ligue 1,17,2003,0.0,0,0,0,0,0,0,0,0.0,0,1,1,0,0,0,0,0,0,2021-2022,,,
969,Johan Gastien,FRA,MF,Clermont Foot,Ligue 1,33,1988,30.5,56,34,26,25,5,27,74,36.5,47,45,11,34,53,109,49,1,0,2021-2022,90.0,156.3934426229508,165.24590163934425
970,Gavi,ESP,"MF,FW",Barcelona,La Liga,16,2004,25.7,38,18,13,18,7,9,33,27.3,24,36,0,36,25,63,13,0,0,2021-2022,90.0,87.54863813229572,133.0739299610895
971,Dwight Gayle,ENG,"FW,DF",Newcastle Utd,Premier League,30,1990,0.4,1,0,0,1,0,0,1,0.0,1,0,0,0,1,2,0,0,0,2021-2022,90.0,225.0,225.0
972,Jean-Philippe Gbamin,CIV,MF,Everton,Premier League,25,1995,0.7,1,1,1,0,0,0,2,0.0,2,0,0,0,1,2,1,0,0,2021-2022,90.0,128.57142857142858,128.57142857142858
973,David de Gea,ESP,GK,Manchester Utd,Premier League,30,1990,38.0,0,0,0,0,0,0,0,0.0,0,0,0,0,0,0,11,2,0,2021-2022,90.0,0.0,0.0
974,Linus Gechter,GER,DF,Hertha BSC,Bundesliga,17,2004,8.0,15,8,13,2,0,7,14,50.0,7,12,7,5,11,26,29,0,0,2021-2022,90.0,123.75,168.75
975,Dennis Geiger,GER,MF,Hoffenheim,Bundesliga,23,1998,15.3,34,23,9,20,5,17,30,56.7,13,15,1,14,14,48,7,1,0,2021-2022,90.0,82.35294117647058,199.99999999999997
Rk,Player,Nation,Pos,Squad,Comp,0,0,90.0,0,0,3,3,3,Tkl,0,0.0,0,0,0,0,0,0,0,0,0,2021-2022,90.0,0.0,0.0
976,Joe Gelhardt,ENG,"FW,MF",Leeds United,Premier League,19,2002,8.3,4,3,1,0,3,2,10,20.0,8,9,0,9,0,4,3,0,0,2021-2022,90.0,0.0,43.37349397590361
977,Luca Gemello,ITA,GK,Torino,Serie A,21,2000,1.0,0,0,0,0,0,0,0,0.0,0,0,0,0,0,0,0,0,0,2021-2022,90.0,0.0,0.0
978,Yannick Gerhardt,GER,"MF,DF",Wolfsburg,Bundesliga,27,1994,17.5,42,20,18,17,7,22,36,61.1,14,24,1,23,25,67,25,1,0,2021-2022,90.0,128.57142857142856,216.0
979,Valère Germain,FRA,FW,Montpellier,Ligue 1,31,1990,21.9,23,14,6,11,6,8,31,25.8,23,13,1,12,9,32,27,0,0,2021-2022,90.0,36.986301369863014,94.52054794520548
980,Gerson,BRA,"MF,FW",Marseille,Ligue 1,24,1997,28.3,42,17,16,20,6,8,35,22.9,27,26,4,22,16,58,16,2,0,2021-2022,90.0,50.88339222614841,133.56890459363956
981,Willem Geubbels,FRA,"FW,MF",Nantes,Ligue 1,19,2001,6.0,8,5,4,2,2,5,12,41.7,7,5,0,5,6,14,5,0,0,2021-2022,90.0,90.0,120.0
982,Hamadi Al Ghaddioui,MAR,FW,Stuttgart,Bundesliga,30,1990,5.5,5,4,2,1,2,0,4,0.0,4,3,1,2,0,5,4,0,0,2021-2022,90.0,0.0,81.81818181818183
983,Ismaël Gharbi,ESP,FW,Paris S-G,Ligue 1,17,2004,0.0,0,0,0,0,0,0,0,0.0,0,0,0,0,0,0,0,0,0,2021-2022,,,
984,Anwar El Ghazi,NED,"FW,MF",Aston Villa,Premier League,26,1995,4.3,4,4,2,2,0,2,7,28.6,5,6,0,6,1,5,2,0,0,2021-2022,90.0,20.930232558139537,83.72093023255815
985,Anwar El Ghazi,NED,"FW,MF",Everton,Premier League,26,1995,0.1,1,1,1,0,0,1,1,100.0,0,3,0,3,0,1,0,0,0,2021-2022,90.0,0.0,900.0
986,Lamine Ghezali,FRA,DF,Saint-Étienne,Ligue 1,22,1999,0.0,0,0,0,0,0,0,0,0.0,0,1,0,1,0,0,0,0,0,2021-2022,,,
987,Paolo Ghiglione,ITA,DF,Genoa,Serie A,24,1997,6.7,17,12,8,6,3,9,14,64.3,5,11,5,6,10,27,12,1,0,2021-2022,90.0,134.32835820895522,228.35820895522386
988,Saman Ghoddos,IRN,"MF,DF",Brentford,Premier League,27,1993,6.0,17,10,8,6,3,9,15,60.0,6,2,0,2,3,20,16,0,0,2021-2022,90.0,45.0,255.0
989,Faouzi Ghoulam,ALG,DF,Napoli,Serie A,30,1991,3.7,3,1,1,2,0,0,3,0.0,3,2,1,1,3,6,10,0,0,2021-2022,90.0,72.97297297297297,72.97297297297297
990,Dimitris Giannoulis,GRE,DF,Norwich City,Premier League,25,1995,13.0,36,21,17,17,2,24,36,66.7,12,22,6,16,19,55,41,1,0,2021-2022,90.00000000000001,131.53846153846155,249.23076923076925
991,Morgan Gibbs-White,ENG,"DF,FW",Wolves,Premier League,21,2000,0.1,0,0,0,0,0,0,0,0.0,0,1,0,1,0,0,0,0,0,2021-2022,90.0,0.0,0.0
992,Ben Gibson,ENG,DF,Norwich City,Premier League,28,1993,27.7,23,16,17,6,0,7,12,58.3,5,36,30,6,27,50,139,2,0,2021-2022,90.0,87.72563176895308,74.72924187725633
993,Niko Gießelmann,GER,"DF,FW",Union Berlin,Bundesliga,29,1991,23.1,24,17,10,11,3,15,38,39.5,23,26,4,22,18,42,29,1,0,2021-2022,89.99999999999999,70.12987012987011,93.50649350649348
994,Rafał Gikiewicz,POL,GK,Augsburg,Bundesliga,33,1987,34.0,2,0,2,0,0,2,7,28.6,5,0,0,0,3,5,11,5,0,2021-2022,90.0,7.9411764705882355,5.294117647058823
995,Bryan Gil,ESP,"FW,MF",Tottenham,Premier League,20,2001,1.0,3,0,1,0,2,1,2,50.0,1,2,0,2,0,3,0,0,0,2021-2022,90.0,0.0,270.0
996,Bryan Gil,ESP,"MF,FW",Valencia,La Liga,20,2001,8.4,13,8,6,3,4,2,13,15.4,11,13,0,13,1,14,4,0,0,2021-2022,90.0,10.714285714285714,139.28571428571428
997,Óscar Gil,ESP,DF,Espanyol,La Liga,24,1997,18.8,52,35,27,20,5,25,46,54.3,21,33,9,24,19,71,33,2,0,2021-2022,90.0,90.95744680851064,248.93617021276594
998,Mario Gila,ESP,DF,Real Madrid,La Liga,20,2000,0.3,1,0,1,0,0,0,1,0.0,1,0,0,0,1,2,1,0,0,2021-2022,90.0,300.0,300.0
999,Billy Gilmour,SCO,MF,Norwich City,Premier League,20,2001,20.6,41,21,16,21,4,14,52,26.9,38,21,4,17,17,58,29,0,0,2021-2022,90.0,74.27184466019418,179.126213592233
1000,Daniel Ginczek,GER,"MF,FW",Wolfsburg,Bundesliga,30,1991,0.1,0,0,0,0,0,0,0,0.0,0,0,0,0,0,0,0,0,0,2021-2022,90.0,0.0,0.0
Rk,Player,Nation,Pos,Squad,Comp,0,0,90.0,0,0,3,3,3,Tkl,0,0.0,0,0,0,0,0,0,0,0,0,2021-2022,90.0,0.0,0.0
1001,Matthias Ginter,GER,DF,Gladbach,Bundesliga,27,1994,26.2,36,22,20,13,3,27,40,67.5,13,21,10,11,33,69,76,0,0,2021-2022,90.0,113.3587786259542,123.66412213740459
1002,Nicholas Gioacchini,USA,"FW,MF",Montpellier,Ligue 1,21,2000,5.5,7,5,3,2,2,4,10,40.0,6,8,0,8,4,11,5,0,0,2021-2022,90.0,65.45454545454545,114.54545454545455
1003,Sebastian Giovinco,ITA,MF,Sampdoria,Serie A,34,1987,0.4,0,0,0,0,0,0,1,0.0,1,0,0,0,0,0,0,0,0,2021-2022,90.0,0.0,0.0
1004,Jimmy Giraudon,FRA,DF,Troyes,Ligue 1,29,1992,18.0,14,6,10,4,0,7,22,31.8,15,24,14,10,37,51,68,1,0,2021-2022,90.0,185.0,70.0
1005,Andrei Girotto,BRA,"DF,MF",Nantes,Ligue 1,29,1992,35.0,85,52,49,32,4,52,103,50.5,51,67,33,34,69,154,143,0,0,2021-2022,90.0,177.42857142857142,218.57142857142856
1006,Olivier Giroud,FRA,FW,Milan,Serie A,34,1986,21.0,15,11,4,6,5,3,17,17.6,14,13,4,9,3,18,19,0,0,2021-2022,90.0,12.857142857142858,64.28571428571428
1007,Jamie Gittens,ENG,FW,Dortmund,Bundesliga,16,2004,1.5,3,2,0,2,1,2,5,40.0,3,4,1,3,1,4,1,0,0,2021-2022,90.0,60.0,180.0
1008,Serge Gnabry,GER,"FW,DF",Bayern Munich,Bundesliga,26,1995,24.3,47,31,16,20,11,22,57,38.6,35,26,0,26,14,61,3,0,0,2021-2022,90.0,51.85185185185185,174.07407407407408
1009,Ben Godfrey,ENG,DF,Everton,Premier League,23,1998,22.5,47,32,29,14,4,24,39,61.5,15,41,19,22,15,62,100,2,0,2021-2022,90.0,60.0,188.0
1010,Diego Godín,URU,DF,Cagliari,Serie A,35,1986,9.1,18,7,13,3,2,10,15,66.7,5,7,5,2,13,31,46,0,0,2021-2022,90.0,128.57142857142858,178.02197802197801
1011,Edoardo Goldaniga,ITA,DF,Cagliari,Serie A,27,1993,10.4,12,5,7,5,0,4,11,36.4,7,8,5,3,22,34,23,0,0,2021-2022,90.0,190.38461538461536,103.84615384615384
1012,Edoardo Goldaniga,ITA,"DF,MF",Sassuolo,Serie A,27,1993,0.0,0,0,0,0,0,0,0,0.0,0,0,0,0,0,0,0,0,0,2021-2022,,,
1013,Aleksandr Golovin,RUS,"FW,MF",Monaco,Ligue 1,25,1996,16.7,40,22,10,18,12,18,41,43.9,23,26,1,25,12,52,8,0,0,2021-2022,90.0,64.67065868263472,215.5688622754491
1014,André Gomes,POR,MF,Everton,Premier League,28,1993,6.9,16,4,6,6,4,8,32,25.0,24,8,2,6,1,17,7,1,0,2021-2022,90.0,13.043478260869565,208.69565217391303
1015,Angel Gomes,ENG,"MF,FW",Lille,Ligue 1,20,2000,10.6,23,13,6,12,5,10,15,66.7,5,4,0,4,3,26,4,0,0,2021-2022,90.0,25.471698113207548,195.28301886792454
1016,Toti Gomes,POR,DF,Wolves,Premier League,22,1999,4.0,11,7,10,1,0,7,9,77.8,2,6,3,3,8,19,15,0,0,2021-2022,90.0,180.0,247.5
1017,Dani Gómez,ESP,FW,Levante,La Liga,23,1998,11.8,7,4,3,2,2,4,12,33.3,8,3,0,3,3,10,5,0,0,2021-2022,90.0,22.881355932203387,53.389830508474574
1018,Joe Gomez,ENG,DF,Liverpool,Premier League,24,1997,3.7,10,6,5,2,3,5,9,55.6,4,4,1,3,5,15,6,0,0,2021-2022,90.0,121.62162162162161,243.24324324324323
1019,Maxi Gómez,URU,FW,Valencia,La Liga,24,1996,21.7,5,3,1,2,2,5,8,62.5,3,5,1,4,3,8,22,0,0,2021-2022,90.0,12.442396313364055,20.737327188940093
1020,Moi Gómez,ESP,"MF,FW",Villarreal,La Liga,27,1994,14.3,15,7,8,3,4,5,17,29.4,12,5,0,5,6,21,6,0,0,2021-2022,90.0,37.76223776223776,94.40559440559441
1021,Papu Gómez,ARG,"FW,MF",Sevilla,La Liga,33,1988,19.8,19,11,9,5,5,9,35,25.7,26,15,2,13,7,26,12,2,0,2021-2022,90.0,31.818181818181817,86.36363636363636
1022,Sergi Gómez,ESP,DF,Espanyol,La Liga,29,1992,30.2,33,24,29,3,1,18,27,66.7,9,33,23,10,40,73,125,2,0,2021-2022,90.0,119.20529801324504,98.34437086092716
1023,Victor Gomez,ESP,DF,Espanyol,La Liga,21,2000,0.0,0,0,0,0,0,0,0,0.0,0,0,0,0,0,0,0,0,0,2021-2022,,,
1024,Alfred Gomis,SEN,GK,Rennes,Ligue 1,27,1993,25.0,1,0,1,0,0,1,2,50.0,1,0,0,0,1,2,8,2,0,2021-2022,90.0,3.5999999999999996,3.5999999999999996
1025,Maxime Gonalons,FRA,MF,Granada,La Liga,32,1989,17.2,43,28,17,22,4,14,39,35.9,25,33,10,23,18,61,29,0,0,2021-2022,90.0,94.18604651162792,225.00000000000003
Rk,Player,Nation,Pos,Squad,Comp,0,0,90.0,0,0,3,3,3,Tkl,0,0.0,0,0,0,0,0,0,0,0,0,2021-2022,90.0,0.0,0.0
1026,Vagner Gonçalves,CPV,FW,Metz,Ligue 1,25,1996,1.0,2,1,0,2,0,1,1,100.0,0,0,0,0,1,3,0,0,0,2021-2022,90.0,90.0,180.0
1027,Cedric Gondo,CIV,FW,Salernitana,Serie A,24,1996,7.8,5,2,2,2,1,2,5,40.0,3,2,0,2,3,8,2,0,0,2021-2022,90.0,34.61538461538461,57.69230769230769
1028,Álvaro González,ESP,DF,Marseille,Ligue 1,31,1990,5.0,1,1,1,0,0,1,1,100.0,0,0,0,0,1,2,9,0,0,2021-2022,90.0,18.0,18.0
1029,Diego González,ESP,DF,Elche,La Liga,26,1995,19.9,25,16,18,7,0,9,16,56.3,7,21,13,8,19,44,87,0,0,2021-2022,90.0,85.92964824120604,113.06532663316584
1030,Édgar González,ESP,DF,Betis,La Liga,24,1997,16.3,25,19,15,8,2,17,24,70.8,7,17,11,6,23,48,82,0,0,2021-2022,90.0,126.99386503067484,138.03680981595093
1031,Giovanni González,URU,DF,Mallorca,La Liga,26,1994,4.1,9,3,4,4,1,3,5,60.0,2,7,2,5,4,13,14,0,0,2021-2022,90.0,87.8048780487805,197.56097560975613
1032,Nicolás González,ARG,FW,Fiorentina,Serie A,23,1998,26.2,21,16,6,8,7,9,28,32.1,19,26,2,24,21,42,4,1,0,2021-2022,90.0,72.13740458015268,72.13740458015268
1033,Nicolás González,ESP,MF,Barcelona,La Liga,19,2002,12.4,31,20,5,23,3,11,27,40.7,16,12,0,12,6,37,12,0,0,2021-2022,90.0,43.54838709677419,225.0
1034,Roberto González,ESP,"FW,MF",Betis,La Liga,20,2001,1.5,5,4,3,2,0,4,6,66.7,2,5,0,5,1,6,1,0,0,2021-2022,90.0,60.0,300.0
1035,Charlie Goode,ENG,DF,Brentford,Premier League,25,1995,5.0,7,5,5,2,0,4,4,100.0,0,4,2,2,2,9,8,0,0,2021-2022,90.0,36.0,126.0
1036,Anthony Gordon,ENG,"MF,FW",Everton,Premier League,20,2001,25.4,54,32,20,30,4,21,59,35.6,38,49,3,46,22,76,17,0,0,2021-2022,90.0,77.95275590551182,191.33858267716536
1037,Kaide Gordon,ENG,FW,Liverpool,Premier League,16,2004,0.1,1,0,0,0,1,0,0,0.0,0,0,0,0,0,1,0,0,0,2021-2022,90.0,0.0,900.0
1038,Leon Goretzka,GER,MF,Bayern Munich,Bundesliga,26,1995,15.5,25,15,12,9,4,11,26,42.3,15,11,1,10,17,42,23,2,0,2021-2022,90.0,98.70967741935483,145.16129032258064
1039,Gori,ESP,MF,Espanyol,La Liga,19,2002,0.1,0,0,0,0,0,0,0,0.0,0,2,0,2,0,0,0,0,0,2021-2022,90.0,0.0,0.0
1040,Andoni Gorosabel,ESP,DF,Real Sociedad,La Liga,24,1996,25.4,47,31,32,9,6,25,47,53.2,22,16,3,13,18,65,49,0,0,2021-2022,90.0,63.77952755905512,166.53543307086616
1041,Robin Gosens,GER,DF,Atalanta,Serie A,27,1994,5.1,7,3,3,4,0,4,8,50.0,4,4,0,4,9,16,1,0,0,2021-2022,90.0,158.82352941176472,123.52941176470588
1042,Robin Gosens,GER,DF,Inter,Serie A,27,1994,1.9,3,1,1,2,0,0,0,0.0,0,5,2,3,3,6,3,0,0,2021-2022,90.0,142.10526315789474,142.10526315789474
1043,Dan Gosling,ENG,MF,Watford,Premier League,31,1990,1.8,2,1,1,1,0,2,6,33.3,4,2,0,2,0,2,3,0,0,2021-2022,90.0,0.0,100.0
1044,Amine Gouiri,ALG,"FW,MF",Nice,Ligue 1,21,2000,30.6,22,13,2,13,7,10,32,31.3,22,22,5,17,11,33,17,1,0,2021-2022,90.0,32.35294117647059,64.70588235294117
1045,Lucas Gourna-Douath,FRA,MF,Saint-Étienne,Ligue 1,17,2003,20.0,45,26,22,18,5,21,36,58.3,15,22,3,19,13,58,9,2,0,2021-2022,90.0,58.5,202.5
1046,Jeffrey Gouweleeuw,NED,DF,Augsburg,Bundesliga,30,1991,28.6,50,27,33,17,0,22,36,61.1,14,35,18,17,49,99,116,0,0,2021-2022,90.0,154.1958041958042,157.34265734265733
1047,Jonathan Gradit,FRA,DF,Lens,Ligue 1,28,1992,34.1,60,28,24,28,8,25,45,55.6,20,39,27,12,65,125,106,0,0,2021-2022,90.0,171.5542521994135,158.35777126099705
1048,Jens Grahl,GER,GK,Eint Frankfurt,Bundesliga,32,1988,1.0,0,0,0,0,0,0,0,0.0,0,0,0,0,0,0,1,0,0,2021-2022,90.0,0.0,0.0
1049,Alberto Grassi,ITA,MF,Cagliari,Serie A,26,1995,24.2,47,26,13,30,4,16,38,42.1,22,27,9,18,63,110,33,1,0,2021-2022,90.0,234.29752066115702,174.79338842975207
1050,Jaume Grau,ESP,MF,Osasuna,La Liga,24,1997,0.0,1,1,1,0,0,0,1,0.0,1,0,0,0,0,1,0,0,0,2021-2022,,,inf
Rk,Player,Nation,Pos,Squad,Comp,0,0,90.0,0,0,3,3,3,Tkl,0,0.0,0,0,0,0,0,0,0,0,0,2021-2022,90.0,0.0,0.0
1051,Andrew Gravillon,GLP,DF,Reims,Ligue 1,23,1998,23.7,32,24,19,13,0,17,27,63.0,10,25,15,10,33,65,83,1,0,2021-2022,90.0,125.31645569620254,121.51898734177216
1052,Demarai Gray,JAM,"MF,FW",Everton,Premier League,25,1996,26.0,30,19,13,10,7,10,22,45.5,12,30,2,28,15,45,21,1,0,2021-2022,90.00000000000001,51.92307692307693,103.84615384615385
1053,Adrian Grbić,AUT,"FW,MF",Lorient,Ligue 1,24,1996,5.8,2,1,0,2,0,2,6,33.3,4,3,1,2,0,2,7,0,0,2021-2022,90.0,0.0,31.03448275862069
1054,Ivo Grbić,CRO,GK,Lille,Ligue 1,25,1996,21.0,0,0,0,0,0,0,0,0.0,0,0,0,0,0,0,14,1,0,2021-2022,90.0,0.0,0.0
1055,Jack Grealish,ENG,FW,Manchester City,Premier League,25,1995,21.3,18,17,4,10,4,5,13,38.5,8,11,1,10,8,26,7,0,0,2021-2022,90.0,33.80281690140845,76.05633802816901
1056,Etienne Green,ENG,GK,Saint-Étienne,Ligue 1,21,2000,13.3,1,1,1,0,0,0,0,0.0,0,0,0,0,1,2,9,0,0,2021-2022,90.0,6.7669172932330826,6.7669172932330826
1057,Julian Green,USA,MF,Greuther Fürth,Bundesliga,26,1995,11.7,9,5,0,8,1,2,8,25.0,6,10,2,8,7,16,10,0,0,2021-2022,89.99999999999999,53.84615384615385,69.23076923076923
1058,Mason Greenwood,ENG,"FW,MF",Manchester Utd,Premier League,19,2001,14.1,15,9,9,1,5,3,9,33.3,6,5,0,5,1,16,6,0,0,2021-2022,89.99999999999999,6.382978723404255,95.74468085106382
1059,Sam Greenwood,ENG,"MF,FW",Leeds United,Premier League,19,2002,2.6,8,5,0,5,3,4,7,57.1,3,3,0,3,2,10,1,0,0,2021-2022,90.0,69.23076923076923,276.9230769230769
1060,Michael Gregoritsch,AUT,"FW,MF",Augsburg,Bundesliga,27,1994,15.5,19,8,4,10,5,2,15,13.3,13,18,2,16,6,25,29,0,0,2021-2022,90.0,34.83870967741935,110.3225806451613
1061,Dominik Greif,SVK,GK,Mallorca,La Liga,24,1997,1.0,0,0,0,0,0,0,0,0.0,0,0,0,0,0,0,0,0,0,2021-2022,90.0,0.0,0.0
1062,Clément Grenier,FRA,MF,Mallorca,La Liga,30,1991,0.7,0,0,0,0,0,0,0,0.0,0,1,1,0,0,0,1,0,0,2021-2022,90.0,0.0,0.0
1063,Sebastian Griesbeck,GER,"DF,MF",Greuther Fürth,Bundesliga,30,1990,27.1,60,31,38,19,3,39,62,62.9,23,38,13,25,43,103,100,1,0,2021-2022,90.0,142.80442804428046,199.2619926199262
1064,Sebastian Griesbeck,GER,MF,Union Berlin,Bundesliga,30,1990,0.1,1,1,0,1,0,1,1,100.0,0,0,0,0,0,1,0,0,0,2021-2022,90.0,0.0,900.0
1065,Antoine Griezmann,FRA,FW,Barcelona,La Liga,30,1991,2.9,13,5,3,10,0,2,6,33.3,4,4,0,4,3,16,5,0,0,2021-2022,90.0,93.10344827586206,403.44827586206895
1066,Antoine Griezmann,FRA,"FW,MF",Atlético Madrid,La Liga,30,1991,18.8,30,14,11,15,4,12,32,37.5,20,18,1,17,7,37,18,0,0,2021-2022,90.0,33.51063829787234,143.61702127659572
1067,Vincenzo Grifo,ITA,"MF,FW",Freiburg,Bundesliga,28,1993,30.8,27,15,9,13,5,9,26,34.6,17,12,2,10,13,40,28,0,0,2021-2022,90.0,37.98701298701299,78.8961038961039
1068,Lennart Grill,GER,GK,Leverkusen,Bundesliga,22,1999,1.0,0,0,0,0,0,0,0,0.0,0,0,0,0,0,0,0,0,0,2021-2022,90.0,0.0,0.0
1069,Florian Grillitsch,AUT,"DF,MF",Hoffenheim,Bundesliga,25,1995,16.6,37,19,15,21,1,17,31,54.8,14,18,7,11,29,66,36,1,0,2021-2022,90.0,157.2289156626506,200.6024096385542
1070,Pascal Groß,GER,"MF,DF",Brighton,Premier League,30,1991,22.6,28,15,15,11,2,12,33,36.4,21,34,8,26,18,46,23,0,0,2021-2022,90.0,71.68141592920354,111.50442477876106
1071,Carlos Gruezo,ECU,MF,Augsburg,Bundesliga,26,1995,10.8,22,11,10,10,2,8,21,38.1,13,11,2,9,9,31,15,0,0,2021-2022,90.0,75.0,183.33333333333331
1072,Vicente Guaita,ESP,GK,Crystal Palace,Premier League,34,1987,29.5,1,0,1,0,0,1,1,100.0,0,0,0,0,1,2,8,1,0,2021-2022,90.0,3.0508474576271185,3.0508474576271185
1073,Andrés Guardado,MEX,MF,Betis,La Liga,34,1986,15.5,30,13,12,17,1,13,34,38.2,21,18,4,14,21,51,29,1,0,2021-2022,90.0,121.93548387096774,174.19354838709677
1074,Sergi Guardiola,ESP,FW,Rayo Vallecano,La Liga,30,1991,19.0,10,9,3,5,2,1,21,4.8,20,14,2,12,4,14,17,0,0,2021-2022,90.0,18.94736842105263,47.36842105263158
1075,Nemanja Gudelj,SRB,"DF,MF",Sevilla,La Liga,29,1991,11.6,16,7,10,4,2,5,8,62.5,3,14,9,5,22,38,37,0,0,2021-2022,90.0,170.6896551724138,124.13793103448276
Rk,Player,Nation,Pos,Squad,Comp,0,0,90.0,0,0,3,3,3,Tkl,0,0.0,0,0,0,0,0,0,0,0,0,2021-2022,90.0,0.0,0.0
1076,Gabriel Gudmundsson,SWE,"DF,MF",Lille,Ligue 1,22,1999,14.9,43,31,24,16,3,17,35,48.6,18,15,3,12,20,63,13,0,0,2021-2022,90.0,120.80536912751677,259.7315436241611
1077,Noah Guede-Nadje,FRA,MF,Angers,Ligue 1,17,2003,0.0,0,0,0,0,0,0,0,0.0,0,0,0,0,0,0,0,0,0,2021-2022,,,
1078,Gonçalo Guedes,POR,"FW,MF",Valencia,La Liga,24,1996,29.0,21,14,6,7,8,2,22,9.1,20,14,0,14,9,30,1,0,0,2021-2022,90.0,27.93103448275862,65.17241379310344
1079,Marc Guéhi,ENG,DF,Crystal Palace,Premier League,21,2000,35.8,35,17,24,10,1,15,16,93.8,1,34,26,8,30,65,127,0,0,2021-2022,90.0,75.41899441340783,87.98882681564247
1080,Mattéo Guendouzi,FRA,MF,Marseille,Ligue 1,22,1999,35.0,45,30,10,26,9,13,47,27.7,34,15,1,14,16,61,18,0,0,2021-2022,90.0,41.14285714285714,115.71428571428571
1081,Yanis Guermouche,FRA,"MF,FW",Montpellier,Ligue 1,20,2001,0.1,2,1,0,1,1,1,1,100.0,0,0,0,0,0,2,0,0,0,2021-2022,90.0,0.0,1800.0
1082,Raphaël Guerreiro,POR,DF,Dortmund,Bundesliga,27,1993,19.9,35,19,19,12,4,16,31,51.6,15,18,2,16,25,60,14,1,0,2021-2022,90.0,113.06532663316584,158.29145728643218
1083,Evann Guessand,CIV,FW,Nice,Ligue 1,20,2001,4.9,9,8,2,5,2,3,8,37.5,5,4,0,4,0,9,1,0,0,2021-2022,90.0,0.0,165.30612244897958
1084,Ander Guevara,ESP,MF,Real Sociedad,La Liga,24,1997,9.6,18,13,6,10,2,10,17,58.8,7,12,6,6,12,30,8,0,0,2021-2022,90.0,112.50000000000001,168.75
1085,Lamine Gueye,SEN,"FW,MF",Metz,Ligue 1,23,1998,6.2,5,5,1,1,3,3,7,42.9,4,4,0,4,6,11,1,0,0,2021-2022,90.0,87.09677419354838,72.58064516129032
1086,Pape Gueye,SEN,MF,Marseille,Ligue 1,22,1999,17.0,38,19,15,22,1,16,31,51.6,15,15,3,12,24,62,16,0,0,2021-2022,90.0,127.05882352941177,201.1764705882353
1087,John Guidetti,SWE,"FW,MF",Alavés,La Liga,29,1992,3.1,2,1,0,0,2,0,1,0.0,1,1,0,1,0,2,0,0,0,2021-2022,90.0,0.0,58.064516129032256
1088,Josuha Guilavogui,FRA,"MF,DF",Bordeaux,Ligue 1,30,1990,14.8,39,16,18,17,4,14,29,48.3,15,16,8,8,36,75,23,0,0,2021-2022,90.0,218.9189189189189,237.16216216216216
1089,Josuha Guilavogui,FRA,"MF,DF",Wolfsburg,Bundesliga,30,1990,10.5,23,14,13,9,1,7,18,38.9,11,11,6,5,25,48,42,0,0,2021-2022,90.0,214.28571428571428,197.14285714285714
1090,Frederic Guilbert,FRA,DF,Strasbourg,Ligue 1,26,1994,28.0,69,39,33,24,12,32,62,51.6,30,37,11,26,55,124,39,0,0,2021-2022,90.0,176.78571428571428,221.78571428571428
1091,Hugo Guillamón,ESP,"MF,DF",Valencia,La Liga,21,2000,26.2,43,27,20,16,7,18,44,40.9,26,26,10,16,30,73,53,1,0,2021-2022,90.0,103.05343511450383,147.70992366412216
1092,Bruno Guimarães,BRA,MF,Newcastle Utd,Premier League,23,1997,11.5,44,23,18,22,4,21,38,55.3,17,25,6,19,9,53,13,0,0,2021-2022,90.0,70.43478260869566,344.34782608695656
1093,Bruno Guimarães,BRA,MF,Lyon,Ligue 1,23,1997,18.2,50,31,20,25,5,23,59,39.0,36,21,4,17,21,71,11,1,0,2021-2022,90.0,103.84615384615385,247.25274725274727
1094,Serhou Guirassy,GUI,FW,Rennes,Ligue 1,25,1996,11.3,4,2,1,2,1,1,7,14.3,6,4,0,4,1,5,8,0,0,2021-2022,90.0,7.964601769911504,31.858407079646017
1095,Péter Gulácsi,HUN,GK,RB Leipzig,Bundesliga,31,1990,33.0,0,0,0,0,0,0,0,0.0,0,0,0,0,1,1,15,1,0,2021-2022,90.0,2.7272727272727275,0.0
1096,Manuel Gulde,GER,DF,Freiburg,Bundesliga,30,1991,13.6,18,10,14,3,1,8,11,72.7,3,16,8,8,17,35,37,0,0,2021-2022,90.0,112.5,119.11764705882352
1097,Gerard Gumbau,ESP,MF,Elche,La Liga,26,1994,21.0,46,19,22,19,5,22,51,43.1,29,18,4,14,23,69,25,0,0,2021-2022,90.0,98.57142857142857,197.14285714285714
1098,Robert Gumny,POL,DF,Augsburg,Bundesliga,23,1998,25.2,48,29,25,20,3,25,43,58.1,18,24,7,17,28,76,57,3,0,2021-2022,90.0,100.00000000000001,171.42857142857144
1099,İlkay Gündoğan,GER,MF,Manchester City,Premier League,30,1990,20.6,23,9,10,12,1,12,31,38.7,19,11,1,10,15,38,10,0,0,2021-2022,90.0,65.53398058252426,100.48543689320388
1100,Angus Gunn,SCO,GK,Norwich City,Premier League,25,1996,9.0,0,0,0,0,0,0,0,0.0,0,0,0,0,0,0,11,0,0,2021-2022,90.0,0.0,0.0
Rk,Player,Nation,Pos,Squad,Comp,0,0,90.0,0,0,3,3,3,Tkl,0,0.0,0,0,0,0,0,0,0,0,0,2021-2022,90.0,0.0,0.0
1101,Christian Günter,GER,"DF,MF",Freiburg,Bundesliga,28,1993,34.0,34,20,16,15,3,18,50,36.0,32,23,6,17,17,51,49,2,0,2021-2022,90.0,45.0,90.0
1102,Koray Günter,GER,DF,Hellas Verona,Serie A,26,1994,26.8,32,18,19,11,2,16,32,50.0,16,27,21,6,69,101,110,1,0,2021-2022,90.0,231.71641791044775,107.46268656716417
1103,Lasse Günther,GER,DF,Augsburg,Bundesliga,18,2003,1.8,8,5,4,3,1,5,9,55.6,4,0,0,0,2,10,2,0,0,2021-2022,90.0,100.0,400.0
1104,Jon Guridi,ESP,MF,Real Sociedad,La Liga,26,1995,2.3,5,3,2,3,0,1,4,25.0,3,3,1,2,3,8,4,0,0,2021-2022,90.0,117.3913043478261,195.6521739130435
1105,Malo Gusto,FRA,DF,Lyon,Ligue 1,18,2003,20.9,55,35,29,21,5,24,40,60.0,16,21,6,15,33,88,41,1,0,2021-2022,90.0,142.10526315789474,236.8421052631579
1106,Raúl Guti,ESP,MF,Elche,La Liga,24,1996,18.1,25,15,7,14,4,10,30,33.3,20,9,3,6,25,50,7,0,0,2021-2022,90.0,124.30939226519335,124.30939226519335
1107,Marcos Mauro López Gutiérrez,ARG,DF,Cádiz,La Liga,30,1991,1.5,1,0,0,1,0,0,2,0.0,2,2,1,1,1,2,9,0,0,2021-2022,90.0,60.0,60.0
1108,Miguel Gutiérrez,ESP,DF,Real Madrid,La Liga,20,2001,2.9,7,5,5,0,2,3,5,60.0,2,0,0,0,2,9,2,0,0,2021-2022,90.0,62.06896551724138,217.24137931034483
1109,Albert Guðmundsson,ISL,"FW,MF",Genoa,Serie A,24,1997,6.7,5,3,2,1,2,3,8,37.5,5,2,0,2,5,10,4,0,0,2021-2022,90.0,67.16417910447761,67.16417910447761
1110,Joško Gvardiol,CRO,DF,RB Leipzig,Bundesliga,19,2002,26.8,47,31,28,17,2,22,39,56.4,17,30,11,19,51,98,62,2,0,2021-2022,90.0,171.2686567164179,157.83582089552237
1111,Emmanuel Gyasi,GHA,"FW,MF",Spezia,Serie A,27,1994,33.7,47,30,31,9,7,21,41,51.2,20,22,4,18,16,63,43,1,0,2021-2022,90.0,42.72997032640949,125.51928783382789
1112,Norbert Gyömbér,SVK,DF,Salernitana,Serie A,29,1992,28.5,53,32,40,11,2,33,50,66.0,17,38,24,14,44,97,126,1,0,2021-2022,90.0,138.94736842105263,167.3684210526316
1113,Erling Haaland,NOR,FW,Dortmund,Bundesliga,21,2000,21.2,2,1,0,1,1,0,1,0.0,1,8,1,7,1,3,31,0,0,2021-2022,90.0,4.245283018867925,8.49056603773585
1114,Nicolas Haas,SUI,MF,Empoli,Serie A,25,1996,11.1,35,22,15,10,10,17,39,43.6,22,24,4,20,9,44,17,1,0,2021-2022,90.0,72.97297297297298,283.7837837837838
1115,Janik Haberer,GER,MF,Freiburg,Bundesliga,27,1994,9.1,14,8,5,6,3,7,19,36.8,12,11,4,7,16,30,11,0,0,2021-2022,90.0,158.24175824175825,138.46153846153845
1116,Alexander Hack,GER,DF,Mainz 05,Bundesliga,27,1993,23.0,52,26,35,17,0,29,46,63.0,17,31,14,17,51,103,95,1,0,2021-2022,90.0,199.56521739130437,203.47826086956525
1117,Robin Hack,GER,"FW,MF",Arminia,Bundesliga,22,1998,15.2,14,8,6,5,3,3,21,14.3,18,18,1,17,5,19,4,0,0,2021-2022,90.0,29.605263157894736,82.89473684210526
1118,Munir El Haddadi,MAR,"FW,MF",Sevilla,La Liga,25,1995,5.3,8,4,1,6,1,2,8,25.0,6,7,1,6,5,13,2,0,0,2021-2022,90.0,84.9056603773585,135.8490566037736
1119,André Hahn,GER,"MF,FW",Augsburg,Bundesliga,30,1990,23.3,36,20,9,15,12,17,50,34.0,33,38,5,33,15,51,43,0,0,2021-2022,90.0,57.93991416309013,139.0557939914163
1120,Amadou Haidara,MLI,MF,RB Leipzig,Bundesliga,23,1998,14.7,30,14,11,19,0,17,37,45.9,20,22,6,16,16,46,8,1,0,2021-2022,90.0,97.95918367346938,183.67346938775512
1121,Massadio Haïdara,MLI,DF,Lens,Ligue 1,28,1992,12.0,28,21,18,7,3,15,24,62.5,9,18,4,14,22,50,31,0,0,2021-2022,90.0,165.0,210.0
1122,Oualid El Hajjam,MAR,DF,Troyes,Ligue 1,30,1991,11.9,22,11,12,6,4,15,23,65.2,8,12,6,6,22,44,28,0,0,2021-2022,90.00000000000001,166.38655462184875,166.38655462184875
1123,Achraf Hakimi,MAR,DF,Paris S-G,Ligue 1,22,1998,27.5,74,51,38,27,9,40,72,55.6,32,26,5,21,28,102,23,2,0,2021-2022,89.99999999999999,91.63636363636363,242.18181818181816
1124,Marcel Halstenberg,GER,DF,RB Leipzig,Bundesliga,29,1991,5.6,10,7,6,4,0,6,11,54.5,5,6,0,6,7,17,11,0,0,2021-2022,90.0,112.5,160.71428571428572
1125,Pierre-Yves Hamel,FRA,"FW,MF",Lorient,Ligue 1,27,1994,0.3,0,0,0,0,0,0,1,0.0,1,0,0,0,2,2,0,0,0,2021-2022,90.0,600.0,0.0
Rk,Player,Nation,Pos,Squad,Comp,0,0,90.0,0,0,3,3,3,Tkl,0,0.0,0,0,0,0,0,0,0,0,0,2021-2022,90.0,0.0,0.0
1126,Pierre-Yves Hamel,FRA,FW,Clermont Foot,Ligue 1,27,1994,5.8,11,6,0,5,6,5,6,83.3,1,2,1,1,0,11,0,0,0,2021-2022,90.0,0.0,170.6896551724138
1127,Romain Hamouma,FRA,"FW,MF",Saint-Étienne,Ligue 1,34,1987,9.8,10,7,1,5,4,2,13,15.4,11,8,0,8,4,14,1,0,0,2021-2022,90.0,36.73469387755102,91.83673469387755
1128,Samir Handanović,SVN,GK,Inter,Serie A,37,1984,37.0,1,0,1,0,0,1,2,50.0,1,1,0,1,0,1,6,3,0,2021-2022,90.0,0.0,2.4324324324324325
1129,Grant Hanley,SCO,DF,Norwich City,Premier League,29,1991,32.2,44,25,28,14,2,18,35,51.4,17,56,45,11,56,100,176,2,0,2021-2022,90.0,156.52173913043478,122.98136645962732
1130,Ridgeciano Haps,SUR,DF,Venezia,Serie A,28,1993,22.8,36,20,26,4,6,11,21,52.4,10,34,12,22,29,65,57,1,0,2021-2022,90.0,114.4736842105263,142.1052631578947
1131,Genki Haraguchi,JPN,MF,Union Berlin,Bundesliga,30,1991,19.5,37,20,12,22,3,15,48,31.3,33,25,3,22,26,63,15,0,0,2021-2022,90.0,120.0,170.76923076923077
1132,Amine Harit,MAR,"FW,MF",Marseille,Ligue 1,24,1997,12.9,18,11,9,9,0,9,17,52.9,8,10,0,10,4,22,2,0,0,2021-2022,90.0,27.906976744186046,125.5813953488372
1133,Varazdat Haroyan,ARM,DF,Cádiz,La Liga,28,1992,16.0,31,21,20,10,1,19,29,65.5,10,22,12,10,15,46,62,0,0,2021-2022,90.0,84.375,174.375
1134,Jack Harrison,ENG,"FW,MF",Leeds United,Premier League,24,1996,29.3,57,37,22,22,13,31,76,40.8,45,35,1,34,21,78,19,0,0,2021-2022,90.0,64.50511945392492,175.08532423208192
1135,Abdou Harroui,NED,MF,Sassuolo,Serie A,23,1998,5.0,11,4,4,7,0,8,11,72.7,3,14,0,14,4,15,5,0,0,2021-2022,90.0,72.0,198.0
1136,Luis Hartwig,GER,FW,Bochum,Bundesliga,18,2002,0.0,0,0,0,0,0,0,0,0.0,0,0,0,0,0,0,0,0,0,2021-2022,,,
1137,Makoto Hasebe,JPN,DF,Eint Frankfurt,Bundesliga,37,1984,13.2,27,12,15,11,1,13,29,44.8,16,24,8,16,22,49,36,0,0,2021-2022,90.0,150.0,184.0909090909091
1138,Hans Hateboer,NED,"DF,MF",Atalanta,Serie A,27,1994,15.4,22,14,10,8,4,11,26,42.3,15,11,1,10,7,29,20,0,0,2021-2022,90.0,40.909090909090914,128.57142857142858
1139,Kortney Hause,ENG,DF,Aston Villa,Premier League,26,1995,4.4,3,3,2,0,1,3,4,75.0,1,8,5,3,6,9,13,0,0,2021-2022,90.0,122.72727272727272,61.36363636363636
1140,Kai Havertz,GER,"FW,MF",Chelsea,Premier League,22,1999,20.1,17,8,5,7,5,4,14,28.6,10,28,1,27,4,21,32,1,0,2021-2022,90.0,17.91044776119403,76.11940298507461
1141,Isaac Hayden,ENG,"MF,DF",Newcastle Utd,Premier League,26,1995,11.1,28,14,11,14,3,12,29,41.4,17,17,8,9,14,42,24,0,0,2021-2022,90.0,113.51351351351353,227.02702702702706
1142,Eden Hazard,BEL,"FW,MF",Real Madrid,La Liga,30,1991,8.0,6,3,3,2,1,3,7,42.9,4,3,0,3,2,8,0,0,0,2021-2022,90.0,22.5,67.5
1143,Thorgan Hazard,BEL,"FW,DF",Dortmund,Bundesliga,28,1993,14.9,23,13,8,10,5,15,40,37.5,25,23,1,22,6,29,4,0,0,2021-2022,90.0,36.241610738255034,138.92617449664428
1144,Jonas Hector,GER,DF,Köln,Bundesliga,31,1990,28.4,76,39,36,26,14,29,74,39.2,45,59,8,51,50,126,68,1,0,2021-2022,90.0,158.45070422535213,240.84507042253523
1145,Hwang Hee-chan,KOR,"FW,MF",Wolves,Premier League,25,1996,20.2,27,13,9,16,2,14,44,31.8,30,10,0,10,13,40,7,1,0,2021-2022,90.0,57.92079207920792,120.29702970297029
1146,Hwang Hee-chan,KOR,FW,RB Leipzig,Bundesliga,25,1996,0.5,0,0,0,0,0,0,0,0.0,0,0,0,0,1,1,0,0,0,2021-2022,90.0,180.0,0.0
1147,Silvan Hefti,SUI,DF,Genoa,Serie A,23,1997,14.3,50,30,23,22,5,32,58,55.2,26,20,4,16,20,70,34,1,0,2021-2022,90.0,125.87412587412588,314.68531468531467
1148,Dominique Heintz,GER,DF,Union Berlin,Bundesliga,27,1993,5.2,8,5,5,3,0,3,6,50.0,3,7,4,3,7,15,14,0,0,2021-2022,90.0,121.15384615384615,138.46153846153845
1149,Dominique Heintz,GER,DF,Freiburg,Bundesliga,27,1993,0.3,0,0,0,0,0,0,0,0.0,0,0,0,0,1,1,0,0,0,2021-2022,90.0,300.0,0.0
1150,Jordan Henderson,ENG,MF,Liverpool,Premier League,31,1990,28.9,36,20,9,25,2,17,44,38.6,27,25,1,24,23,59,14,0,0,2021-2022,90.00000000000001,71.62629757785469,112.11072664359862
Rk,Player,Nation,Pos,Squad,Comp,0,0,90.0,0,0,3,3,3,Tkl,0,0.0,0,0,0,0,0,0,0,0,0,2021-2022,90.0,0.0,0.0
1151,Liam Henderson,SCO,MF,Empoli,Serie A,25,1996,22.4,22,13,7,8,7,9,31,29.0,22,14,4,10,9,31,13,0,0,2021-2022,90.0,36.160714285714285,88.39285714285714
1152,Jeff Hendrick,IRL,MF,Newcastle Utd,Premier League,29,1992,0.8,1,1,0,1,0,1,1,100.0,0,0,0,0,0,1,1,0,0,2021-2022,90.0,0.0,112.5
1153,Wayne Hennessey,WAL,GK,Burnley,Premier League,34,1987,2.0,0,0,0,0,0,0,0,0.0,0,0,0,0,1,1,0,1,0,2021-2022,90.0,45.0,0.0
1154,Benjamin Henrichs,GER,DF,RB Leipzig,Bundesliga,24,1997,12.7,30,21,18,6,6,12,22,54.5,10,16,1,15,19,49,14,0,0,2021-2022,90.0,134.64566929133858,212.5984251968504
1155,Henrique,BRA,DF,Lyon,Ligue 1,27,1994,12.3,13,7,10,1,2,5,16,31.3,11,13,1,12,22,35,14,0,0,2021-2022,89.99999999999999,160.97560975609753,95.12195121951218
1156,Dalbert Henrique,BRA,"DF,MF",Cagliari,Serie A,27,1993,23.1,43,23,23,16,4,11,35,31.4,24,28,5,23,24,67,34,0,0,2021-2022,89.99999999999999,93.50649350649348,167.5324675324675
1157,Luis Henrique,BRA,"FW,MF",Marseille,Ligue 1,19,2001,7.8,4,3,2,1,1,2,5,40.0,3,2,0,2,5,9,1,0,0,2021-2022,90.0,57.69230769230769,46.15384615384615
1158,Matheus Henrique,BRA,MF,Sassuolo,Serie A,23,1997,12.0,10,3,6,3,1,6,24,25.0,18,14,2,12,7,17,12,1,0,2021-2022,90.0,52.5,75.0
1159,Rico Henry,ENG,DF,Brentford,Premier League,24,1997,30.8,28,20,18,8,2,12,34,35.3,22,31,10,21,26,54,76,1,0,2021-2022,90.0,75.97402597402598,81.81818181818183
1160,Thomas Henry,FRA,FW,Venezia,Serie A,26,1994,23.5,9,4,2,3,4,5,13,38.5,8,11,5,6,2,11,25,0,0,2021-2022,90.0,7.659574468085106,34.46808510638298
1161,Christophe Hérelle,MTQ,DF,Brest,Ligue 1,28,1992,21.5,48,28,30,16,2,17,26,65.4,9,20,15,5,44,92,84,1,0,2021-2022,90.0,184.1860465116279,200.93023255813952
1162,Jérôme Hergault,FRA,DF,Lorient,Ligue 1,35,1986,3.9,3,1,1,2,0,2,5,40.0,3,4,1,3,4,7,7,0,0,2021-2022,90.0,92.3076923076923,69.23076923076923
1163,Kike Hermoso,ESP,DF,Betis,La Liga,21,1999,1.0,2,1,2,0,0,2,2,100.0,0,2,1,1,0,2,5,1,0,2021-2022,90.0,0.0,180.0
1164,Mario Hermoso,ESP,DF,Atlético Madrid,La Liga,26,1995,20.7,30,15,23,4,3,20,38,52.6,18,18,3,15,29,59,49,2,0,2021-2022,90.0,126.08695652173914,130.43478260869566
1165,Aridane Hernández,ESP,DF,Osasuna,La Liga,32,1989,12.9,12,9,10,2,0,3,13,23.1,10,11,9,2,20,32,71,0,0,2021-2022,90.0,139.53488372093022,83.72093023255813
1166,Lucas Hernández,FRA,DF,Bayern Munich,Bundesliga,25,1996,22.6,50,31,20,24,6,26,42,61.9,16,22,11,11,28,78,54,1,0,2021-2022,90.0,111.50442477876106,199.1150442477876
1167,Luis Hernández,ESP,DF,Cádiz,La Liga,32,1989,15.2,9,5,9,0,0,5,8,62.5,3,5,3,2,16,25,34,0,0,2021-2022,90.0,94.73684210526315,53.28947368421053
1168,Mario Hernández,ESP,"DF,FW",Rayo Vallecano,La Liga,22,1999,4.4,10,4,7,3,0,5,9,55.6,4,1,0,1,4,14,7,0,0,2021-2022,90.0,81.81818181818181,204.54545454545453
1169,Theo Hernández,FRA,DF,Milan,Serie A,23,1997,30.1,53,35,34,14,5,29,40,72.5,11,16,3,13,23,76,29,3,0,2021-2022,90.00000000000001,68.77076411960132,158.4717607973422
1170,Hernani,BRA,"MF,FW",Genoa,Serie A,27,1994,7.6,20,10,8,9,3,13,32,40.6,19,17,4,13,13,33,5,1,0,2021-2022,90.0,153.94736842105263,236.8421052631579
1171,Ander Herrera,ESP,MF,Paris S-G,Ligue 1,31,1989,12.1,29,17,7,16,6,14,39,35.9,25,22,8,14,14,43,8,0,0,2021-2022,90.0,104.13223140495867,215.70247933884298
1172,Héctor Herrera,MEX,MF,Atlético Madrid,La Liga,31,1990,9.5,16,8,11,4,1,7,20,35.0,13,13,2,11,12,28,16,0,0,2021-2022,90.0,113.6842105263158,151.57894736842104
1173,Sergio Herrera,ESP,GK,Osasuna,La Liga,28,1993,36.0,3,2,3,0,0,3,6,50.0,3,1,0,1,1,4,18,0,0,2021-2022,90.0,2.5,7.5
1174,Yangel Herrera,VEN,MF,Espanyol,La Liga,23,1998,18.3,41,31,19,19,3,18,39,46.2,21,27,5,22,19,60,33,1,0,2021-2022,90.0,93.44262295081967,201.63934426229508
1175,Patrick Herrmann,GER,"DF,FW",Gladbach,Bundesliga,30,1991,8.4,15,7,5,6,4,9,24,37.5,15,10,1,9,6,21,8,0,0,2021-2022,90.0,64.28571428571428,160.7142857142857
Rk,Player,Nation,Pos,Squad,Comp,0,0,90.0,0,0,3,3,3,Tkl,0,0.0,0,0,0,0,0,0,0,0,0,2021-2022,90.0,0.0,0.0
1176,Son Heung-min,KOR,"MF,FW",Tottenham,Premier League,29,1992,33.4,15,6,5,7,3,5,23,21.7,18,27,6,21,13,28,8,0,0,2021-2022,90.0,35.02994011976048,40.41916167664671
1177,Daan Heymans,BEL,"MF,FW",Venezia,Serie A,22,1999,2.8,3,1,1,2,0,1,5,20.0,4,7,3,4,4,7,3,0,0,2021-2022,90.0,128.57142857142858,96.42857142857143
1178,Aaron Hickey,SCO,DF,Bologna,Serie A,19,2002,31.3,46,29,24,15,7,20,30,66.7,10,36,13,23,29,75,44,0,0,2021-2022,90.0,83.38658146964856,132.26837060702874
1179,Piero Hincapié,ECU,DF,Leverkusen,Bundesliga,19,2002,19.5,33,23,23,8,2,19,25,76.0,6,34,15,19,33,66,56,2,0,2021-2022,90.0,152.3076923076923,152.3076923076923
1180,Martin Hinteregger,AUT,DF,Eint Frankfurt,Bundesliga,28,1992,24.7,45,28,28,16,1,28,43,65.1,15,36,16,20,42,87,78,3,0,2021-2022,90.0,153.03643724696357,163.9676113360324
1181,Marwin Hitz,SUI,GK,Dortmund,Bundesliga,33,1987,4.5,0,0,0,0,0,0,0,0.0,0,0,0,0,0,0,2,0,0,2021-2022,90.0,0.0,0.0
1182,Ki-Jana Hoever,NED,"DF,MF",Wolves,Premier League,19,2002,3.4,10,6,5,5,0,7,12,58.3,5,6,0,6,6,16,8,0,0,2021-2022,90.0,158.8235294117647,264.70588235294116
1183,Nicolas Höfler,GER,MF,Freiburg,Bundesliga,31,1990,28.9,73,42,37,29,7,28,62,45.2,34,50,21,29,46,119,42,0,0,2021-2022,90.00000000000001,143.25259515570937,227.33564013840834
1184,Jonas Hofmann,GER,"MF,FW",Gladbach,Bundesliga,29,1992,23.1,30,20,6,17,7,17,42,40.5,25,23,0,23,12,42,10,0,0,2021-2022,89.99999999999999,46.75324675324674,116.88311688311687
1185,Rob Holding,ENG,DF,Arsenal,Premier League,25,1995,9.4,13,9,11,1,1,5,6,83.3,1,23,18,5,10,23,42,1,0,2021-2022,90.0,95.74468085106382,124.46808510638297
1186,Lucas Höler,GER,FW,Freiburg,Bundesliga,27,1994,28.7,41,25,10,17,14,13,28,46.4,15,25,4,21,17,58,39,2,0,2021-2022,90.0,53.31010452961672,128.57142857142858
1187,Mason Holgate,ENG,DF,Everton,Premier League,24,1996,23.7,35,18,26,9,0,11,26,42.3,15,25,17,8,26,61,95,1,0,2021-2022,90.0,98.73417721518989,132.9113924050633
1188,Gerrit Holtmann,PHI,"FW,MF",Bochum,Bundesliga,26,1995,20.4,15,9,5,3,7,6,22,27.3,16,26,2,24,8,23,6,0,0,2021-2022,90.0,35.294117647058826,66.1764705882353
1189,Martin Hongla,CMR,MF,Hellas Verona,Serie A,23,1998,7.2,14,8,5,6,3,4,8,50.0,4,6,2,4,4,18,16,1,0,2021-2022,90.0,50.0,175.0
1190,Franck Honorat,FRA,"FW,MF",Brest,Ligue 1,24,1996,32.2,54,38,25,13,16,27,47,57.4,20,24,2,22,15,69,25,0,0,2021-2022,90.0,41.92546583850931,150.93167701863354
1191,Justin Hoogma,NED,DF,Greuther Fürth,Bundesliga,23,1998,3.0,6,5,4,2,0,4,6,66.7,2,5,5,0,4,10,4,0,0,2021-2022,90.0,120.0,180.0
1192,Sydney van Hooijdonk,NED,"FW,MF",Bologna,Serie A,21,2000,0.4,0,0,0,0,0,0,1,0.0,1,1,0,1,0,0,0,0,0,2021-2022,90.0,0.0,0.0
1193,Matthew Hoppe,USA,"FW,MF",Mallorca,La Liga,20,2001,1.5,1,0,0,0,1,0,3,0.0,3,0,0,0,0,1,0,0,0,2021-2022,90.0,0.0,60.0
1194,Jannes Horn,GER,DF,Köln,Bundesliga,24,1997,5.3,6,4,4,2,0,4,8,50.0,4,1,1,0,3,9,9,0,0,2021-2022,90.0,50.943396226415096,101.88679245283019
1195,Timo Horn,GER,GK,Köln,Bundesliga,28,1993,13.0,0,0,0,0,0,0,1,0.0,1,0,0,0,0,0,5,0,0,2021-2022,90.00000000000001,0.0,0.0
1196,Fraser Hornby,SCO,"FW,MF",Reims,Ligue 1,21,1999,3.9,3,1,1,2,0,0,2,0.0,2,3,0,3,4,7,5,0,0,2021-2022,90.0,92.3076923076923,69.23076923076923
1197,Cédric Hountondji,BEN,DF,Clermont Foot,Ligue 1,27,1994,22.6,33,17,20,12,1,16,24,66.7,8,23,12,11,34,67,76,0,0,2021-2022,90.0,135.39823008849558,131.41592920353983
1198,Lukáš Hrádecký,FIN,GK,Leverkusen,Bundesliga,31,1989,32.0,1,1,1,0,0,1,1,100.0,0,0,0,0,0,1,10,1,0,2021-2022,90.0,0.0,2.8125
1199,Branimir Hrgota,SWE,FW,Greuther Fürth,Bundesliga,28,1993,30.9,46,29,10,31,5,21,72,29.2,51,27,1,26,11,57,3,1,0,2021-2022,90.0,32.03883495145631,133.98058252427185
1200,Petko Hristov,BUL,DF,Spezia,Serie A,22,1999,13.9,17,10,11,6,0,10,16,62.5,6,29,23,6,19,36,47,0,0,2021-2022,90.0,123.02158273381295,110.07194244604317
Rk,Player,Nation,Pos,Squad,Comp,0,0,90.0,0,0,3,3,3,Tkl,0,0.0,0,0,0,0,0,0,0,0,0,2021-2022,90.0,0.0,0.0
1201,Ajdin Hrustic,AUS,MF,Eint Frankfurt,Bundesliga,25,1996,10.7,16,11,5,7,4,11,32,34.4,21,18,1,17,10,26,7,0,0,2021-2022,90.0,84.11214953271029,134.57943925233647
1202,Timo Hübers,GER,DF,Köln,Bundesliga,25,1996,19.3,45,27,28,17,0,27,45,60.0,18,31,19,12,52,97,95,0,0,2021-2022,90.0,242.48704663212433,209.84455958549222
1203,Benjamin Hübner,GER,DF,Hoffenheim,Bundesliga,32,1989,4.2,9,5,0,7,2,3,5,60.0,2,2,2,0,9,18,7,0,0,2021-2022,90.0,192.85714285714286,192.85714285714286
1204,Callum Hudson-Odoi,ENG,"MF,FW",Chelsea,Premier League,20,2000,10.7,14,10,5,6,3,8,23,34.8,15,8,0,8,2,16,6,1,0,2021-2022,90.0,16.82242990654206,117.7570093457944
1205,Will Hughes,ENG,MF,Crystal Palace,Premier League,26,1995,11.7,29,14,10,16,3,7,16,43.8,9,13,7,6,8,37,10,0,0,2021-2022,89.99999999999999,61.53846153846153,223.07692307692307
1206,Mats Hummels,GER,DF,Dortmund,Bundesliga,32,1988,19.6,34,22,20,13,1,20,36,55.6,16,18,13,5,32,66,66,1,0,2021-2022,90.0,146.93877551020407,156.12244897959184
1207,Elseid Hysaj,ALB,DF,Lazio,Serie A,27,1994,22.5,46,30,25,17,4,29,45,64.4,16,18,6,12,24,70,34,1,0,2021-2022,90.0,96.0,184.0
1208,Suk Hyun-jun,KOR,"FW,MF",Troyes,Ligue 1,30,1991,1.7,0,0,0,0,0,0,0,0.0,0,2,0,2,0,0,2,0,0,2021-2022,90.0,0.0,0.0
1209,Pierre Højbjerg,DEN,MF,Tottenham,Premier League,25,1995,35.5,78,45,31,38,9,38,85,44.7,47,61,13,48,48,126,54,0,0,2021-2022,90.0,121.69014084507043,197.74647887323945
1210,Iago,BRA,DF,Augsburg,Bundesliga,24,1997,24.2,49,29,25,19,5,15,34,44.1,19,28,6,22,27,76,62,0,0,2021-2022,90.0,100.41322314049586,182.23140495867767
1211,Robert Ibáñez,ESP,"MF,FW",Osasuna,La Liga,28,1993,1.0,3,3,2,0,1,1,2,50.0,1,1,0,1,1,4,1,0,0,2021-2022,90.0,90.0,270.0
1212,Roger Ibanez,BRA,DF,Roma,Serie A,22,1998,32.1,54,32,31,19,4,26,43,60.5,17,26,7,19,62,116,104,2,0,2021-2022,90.0,173.83177570093457,151.4018691588785
1213,Vicente Iborra,ESP,MF,Villarreal,La Liga,33,1988,11.5,19,10,9,7,3,12,24,50.0,12,11,5,6,11,30,27,1,0,2021-2022,90.0,86.08695652173914,148.69565217391306
1214,Zlatan Ibrahimović,SWE,FW,Milan,Serie A,39,1981,11.3,0,0,0,0,0,0,2,0.0,2,2,1,1,3,3,9,0,0,2021-2022,90.0,23.893805309734514,0.0
1215,Mauro Icardi,ARG,FW,Paris S-G,Ligue 1,28,1993,11.4,5,3,1,3,1,3,7,42.9,4,3,0,3,5,10,12,0,0,2021-2022,90.0,39.473684210526315,39.473684210526315
1216,Adam Idah,IRL,"FW,MF",Norwich City,Premier League,20,2001,6.9,9,6,2,5,2,2,3,66.7,1,4,2,2,3,12,7,0,0,2021-2022,90.0,39.13043478260869,117.39130434782608
1217,Oussama Idrissi,MAR,"MF,FW",Sevilla,La Liga,25,1996,1.4,1,0,0,1,0,0,1,0.0,1,1,0,1,1,2,1,0,0,2021-2022,90.0,64.28571428571429,64.28571428571429
1218,Oussama Idrissi,MAR,MF,Cádiz,La Liga,25,1996,10.0,8,4,3,4,1,4,15,26.7,11,8,0,8,3,11,5,0,0,2021-2022,90.0,27.0,72.0
1219,Iglesias,ESP,DF,Getafe,La Liga,23,1998,8.0,19,10,11,8,0,7,17,41.2,10,8,2,6,10,29,28,0,0,2021-2022,90.0,112.5,213.75
1220,Borja Iglesias,ESP,FW,Betis,La Liga,28,1993,17.5,6,4,1,2,3,0,8,0.0,8,11,1,10,4,10,7,0,0,2021-2022,90.0,20.57142857142857,30.857142857142858
1221,Jonathan Iglesias,URU,MF,Clermont Foot,Ligue 1,32,1988,6.4,18,11,6,10,2,10,18,55.6,8,8,2,6,5,23,2,1,0,2021-2022,90.0,70.3125,253.125
1222,Juan Ignacio Ramírez,URU,FW,Saint-Étienne,Ligue 1,24,1997,1.4,2,1,0,1,1,0,0,0.0,0,0,0,0,0,2,0,0,0,2021-2022,90.0,0.0,128.57142857142858
1223,Igor,BRA,DF,Fiorentina,Serie A,23,1998,24.9,53,31,34,16,3,30,40,75.0,10,37,19,18,31,84,46,4,0,2021-2022,90.0,112.04819277108433,191.56626506024097
1224,Kelechi Iheanacho,NGA,FW,Leicester City,Premier League,24,1996,14.0,10,7,2,5,3,3,14,21.4,11,19,0,19,4,14,10,0,0,2021-2022,90.0,25.714285714285715,64.28571428571428
1225,Danylo Ihnatenko,UKR,MF,Bordeaux,Ligue 1,24,1997,7.7,17,9,8,7,2,10,24,41.7,14,9,2,7,6,23,17,1,0,2021-2022,90.0,70.12987012987013,198.7012987012987
Rk,Player,Nation,Pos,Squad,Comp,0,0,90.0,0,0,3,3,3,Tkl,0,0.0,0,0,0,0,0,0,0,0,0,2021-2022,90.0,0.0,0.0
1226,Jonathan Ikone,FRA,FW,Fiorentina,Serie A,23,1998,7.2,7,3,2,3,2,3,10,30.0,7,10,2,8,1,8,2,0,0,2021-2022,90.0,12.5,87.5
1227,Jonathan Ikone,FRA,"MF,FW",Lille,Ligue 1,23,1998,11.8,11,3,6,4,1,4,11,36.4,7,13,1,12,5,16,4,0,0,2021-2022,90.0,38.13559322033898,83.89830508474576
1228,Ivan Ilić,SRB,MF,Hellas Verona,Serie A,20,2001,28.1,39,18,16,19,4,20,54,37.0,34,34,12,22,22,61,55,0,0,2021-2022,90.0,70.46263345195729,124.91103202846975
1229,Josip Iličić,SVN,"MF,FW",Atalanta,Serie A,33,1988,9.3,7,7,3,2,2,4,17,23.5,13,6,1,5,3,10,1,0,0,2021-2022,90.0,29.032258064516125,67.74193548387096
1230,Asier Illarramendi,ESP,MF,Real Sociedad,La Liga,31,1990,4.2,9,5,5,3,1,1,10,10.0,9,5,1,4,4,13,12,0,0,2021-2022,90.0,85.71428571428571,192.85714285714286
1231,Stefan Ilsanker,AUT,"DF,MF",Eint Frankfurt,Bundesliga,32,1989,3.0,14,8,7,6,1,5,10,50.0,5,6,2,4,6,20,15,1,0,2021-2022,90.0,180.0,420.0
1232,Ciro Immobile,ITA,FW,Lazio,Serie A,31,1990,30.1,10,5,4,4,2,1,15,6.7,14,7,1,6,3,13,16,0,0,2021-2022,90.00000000000001,8.970099667774086,29.900332225913623
1233,Burak İnce,TUR,FW,Arminia,Bundesliga,17,2004,1.5,1,1,1,0,0,1,2,50.0,1,1,0,1,0,1,0,0,0,2021-2022,90.0,0.0,60.0
1234,Danny Ings,ENG,FW,Aston Villa,Premier League,29,1992,21.1,23,16,2,16,5,13,37,35.1,24,31,2,29,6,29,22,0,0,2021-2022,90.0,25.592417061611375,98.1042654028436
1235,Marcus Ingvartsen,DEN,MF,Union Berlin,Bundesliga,25,1996,1.4,0,0,0,0,0,0,2,0.0,2,0,0,0,2,2,1,0,0,2021-2022,90.0,128.57142857142858,0.0
1236,Marcus Ingvartsen,DEN,"FW,MF",Mainz 05,Bundesliga,25,1996,7.6,3,2,2,0,1,3,9,33.3,6,6,0,6,6,9,7,1,0,2021-2022,90.0,71.05263157894737,35.526315789473685
1237,Bonke Innocent,NGA,MF,Lorient,Ligue 1,25,1996,9.7,27,16,10,16,1,11,26,42.3,15,11,3,8,16,43,14,0,0,2021-2022,90.0,148.4536082474227,250.5154639175258
1238,Lorenzo Insigne,ITA,FW,Napoli,Serie A,30,1991,25.4,23,14,8,12,3,8,44,18.2,36,30,1,29,20,43,3,1,0,2021-2022,90.0,70.86614173228347,81.49606299212599
1239,Nikita Iosifov,RUS,MF,Villarreal,La Liga,20,2001,0.0,0,0,0,0,0,0,0,0.0,0,0,0,0,0,0,0,0,0,2021-2022,,,
1240,Tim Iroegbunam,ENG,MF,Aston Villa,Premier League,18,2003,1.0,5,4,2,3,0,1,1,100.0,0,0,0,0,2,7,1,0,0,2021-2022,90.0,180.0,450.0
1241,Alexander Isak,SWE,FW,Real Sociedad,La Liga,21,1999,23.8,7,4,1,3,3,2,12,16.7,10,14,2,12,3,10,10,0,0,2021-2022,90.00000000000001,11.344537815126051,26.47058823529412
1242,Isco,ESP,"MF,FW",Real Madrid,La Liga,29,1992,3.7,9,5,4,4,1,5,12,41.7,7,1,0,1,2,11,1,0,0,2021-2022,90.0,48.648648648648646,218.9189189189189
1243,Wilson Isidor,FRA,"FW,MF",Monaco,Ligue 1,20,2000,0.6,0,0,0,0,0,0,4,0.0,4,1,0,1,0,0,0,0,0,2021-2022,90.0,0.0,0.0
1244,Ardian Ismajli,ALB,DF,Empoli,Serie A,24,1996,14.1,13,9,8,4,1,5,14,35.7,9,21,11,10,24,37,80,0,0,2021-2022,89.99999999999999,153.1914893617021,82.97872340425532
1245,Hiroki Ito,JPN,DF,Stuttgart,Bundesliga,22,1999,26.1,43,31,21,19,3,25,43,58.1,18,40,19,21,53,96,95,0,0,2021-2022,90.0,182.75862068965515,148.2758620689655
1246,Cedric Itten,SUI,FW,Greuther Fürth,Bundesliga,24,1996,7.1,5,2,1,2,2,1,6,16.7,5,3,0,3,2,7,4,0,0,2021-2022,90.0,25.35211267605634,63.38028169014085
1247,Gian-Luca Itter,GER,DF,Greuther Fürth,Bundesliga,22,1999,16.2,44,26,30,11,3,21,38,55.3,17,24,9,15,13,57,51,0,0,2021-2022,90.0,72.22222222222223,244.44444444444446
1248,Alex Iwobi,NGA,"MF,DF",Everton,Premier League,25,1996,22.6,40,19,23,12,5,21,52,40.4,31,39,3,36,20,60,25,2,0,2021-2022,90.0,79.64601769911505,159.2920353982301
1249,Armando Izzo,ITA,DF,Torino,Serie A,29,1992,5.8,16,9,14,2,0,9,11,81.8,2,5,4,1,17,33,21,0,0,2021-2022,90.0,263.7931034482759,248.27586206896552
1250,Nicolas Jackson,SEN,"FW,MF",Villarreal,La Liga,20,2001,1.8,2,0,1,0,1,0,0,0.0,0,0,0,0,1,3,1,0,0,2021-2022,90.0,50.0,100.0
Rk,Player,Nation,Pos,Squad,Comp,0,0,90.0,0,0,3,3,3,Tkl,0,0.0,0,0,0,0,0,0,0,0,0,2021-2022,90.0,0.0,0.0
1251,Lee Jae-sung,KOR,"MF,FW",Mainz 05,Bundesliga,28,1992,16.0,30,12,8,14,8,6,27,22.2,21,20,2,18,18,48,18,0,0,2021-2022,90.0,101.25,168.75
1252,Paul Jaeckel,GER,DF,Union Berlin,Bundesliga,23,1998,22.7,51,29,27,24,0,29,51,56.9,22,34,10,24,57,108,81,0,0,2021-2022,89.99999999999999,225.99118942731278,202.20264317180616
1253,Mato Jajalo,BIH,MF,Udinese,Serie A,33,1988,7.0,24,14,14,7,3,11,23,47.8,12,7,0,7,11,35,5,0,0,2021-2022,90.0,141.42857142857142,308.57142857142856
1254,Kristijan Jakić,CRO,MF,Eint Frankfurt,Bundesliga,24,1997,20.9,37,22,10,21,6,15,62,24.2,47,33,3,30,21,58,25,1,0,2021-2022,90.0,90.43062200956938,159.33014354066987
1255,Ismail Jakobs,SEN,"DF,FW",Monaco,Ligue 1,21,1999,13.4,32,16,14,15,3,16,35,45.7,19,16,1,15,17,49,31,0,0,2021-2022,90.0,114.17910447761193,214.92537313432834
1256,Marin Jakoliš,CRO,FW,Angers,Ligue 1,24,1996,2.5,2,1,0,1,1,0,6,0.0,6,0,0,0,1,3,0,0,0,2021-2022,90.0,36.0,72.0
1257,Abdel Jalil Medioub,ALG,DF,Bordeaux,Ligue 1,23,1997,6.9,9,5,5,3,1,3,4,75.0,1,8,4,4,12,21,34,0,0,2021-2022,90.0,156.52173913043475,117.39130434782608
1258,Daniel James,WAL,FW,Manchester Utd,Premier League,23,1997,1.4,2,1,0,2,0,0,0,0.0,0,2,0,2,0,2,1,0,0,2021-2022,90.0,0.0,128.57142857142858
1259,Daniel James,WAL,"FW,MF",Leeds United,Premier League,23,1997,26.3,24,14,8,8,8,10,23,43.5,13,18,1,17,8,32,12,0,0,2021-2022,90.0,27.376425855513308,82.12927756653993
1260,Reece James,ENG,DF,Chelsea,Premier League,21,1999,20.7,33,25,14,18,1,9,22,40.9,13,20,2,18,17,50,22,0,0,2021-2022,90.0,73.91304347826087,143.47826086956522
1261,Vitaly Janelt,GER,MF,Brentford,Premier League,23,1998,25.5,61,32,26,27,8,27,53,50.9,26,23,7,16,28,89,35,0,0,2021-2022,90.0,98.82352941176471,215.29411764705884
1262,Jakub Jankto,CZE,"DF,MF",Getafe,La Liga,25,1996,6.5,11,7,5,5,1,10,17,58.8,7,4,0,4,4,15,7,0,0,2021-2022,90.00000000000001,55.38461538461539,152.30769230769232
1263,Pontus Jansson,SWE,DF,Brentford,Premier League,30,1991,36.9,40,21,32,8,0,22,34,64.7,12,37,27,10,52,92,187,0,0,2021-2022,90.0,126.82926829268294,97.5609756097561
1264,Tony Jantschke,GER,DF,Gladbach,Bundesliga,31,1990,2.5,6,5,2,4,0,3,6,50.0,3,3,2,1,5,11,8,0,0,2021-2022,90.0,180.0,216.0
1265,Adnan Januzaj,BEL,"FW,MF",Real Sociedad,La Liga,26,1995,18.1,17,11,5,8,4,9,24,37.5,15,15,3,12,12,29,15,0,0,2021-2022,90.0,59.66850828729281,84.53038674033148
1266,Léo Jardim,BRA,GK,Lille,Ligue 1,26,1995,17.0,0,0,0,0,0,0,0,0.0,0,0,0,0,1,1,10,0,0,2021-2022,90.0,5.294117647058823,0.0
1267,Paweł Jaroszyński,POL,DF,Salernitana,Serie A,26,1994,5.7,10,5,7,3,0,5,7,71.4,2,4,0,4,10,20,19,0,0,2021-2022,90.0,157.89473684210526,157.89473684210526
1268,Jason,ESP,"MF,FW",Alavés,La Liga,27,1994,7.5,11,7,6,4,1,7,20,35.0,13,7,0,7,7,18,5,0,0,2021-2022,90.0,84.0,132.0
1269,Jason,ESP,"MF,DF",Valencia,La Liga,27,1994,0.8,4,1,2,1,1,0,1,0.0,1,2,0,2,1,5,1,0,0,2021-2022,90.0,112.5,450.0
1270,Dennis Jastrzembski,POL,"DF,FW",Hertha BSC,Bundesliga,21,2000,2.5,2,1,1,1,0,2,8,25.0,6,1,0,1,5,7,3,0,0,2021-2022,90.0,180.0,72.0
1271,Luis Javier Suárez,COL,FW,Granada,La Liga,23,1997,31.6,26,14,9,9,8,8,27,29.6,19,25,3,22,6,32,23,0,0,2021-2022,90.0,17.088607594936708,74.0506329113924
1272,Corentin Jean,FRA,"FW,MF",Lens,Ligue 1,26,1995,2.8,9,6,4,4,1,3,6,50.0,3,5,0,5,1,10,0,0,0,2021-2022,90.0,32.142857142857146,289.2857142857143
1273,Jemerson,BRA,DF,Metz,Ligue 1,28,1992,13.4,37,25,30,7,0,18,26,69.2,8,23,8,15,25,62,33,1,0,2021-2022,90.0,167.910447761194,248.50746268656715
1274,Fredrik Jensen,FIN,"MF,FW",Augsburg,Bundesliga,23,1997,4.6,5,4,1,3,1,4,7,57.1,3,5,1,4,2,7,4,0,0,2021-2022,90.0,39.130434782608695,97.82608695652175
1275,Mathias Jensen,DEN,MF,Brentford,Premier League,25,1996,17.8,33,18,12,16,5,22,63,34.9,41,32,3,29,22,55,13,0,0,2021-2022,90.0,111.23595505617978,166.85393258426967
Rk,Player,Nation,Pos,Squad,Comp,0,0,90.0,0,0,3,3,3,Tkl,0,0.0,0,0,0,0,0,0,0,0,0,2021-2022,90.0,0.0,0.0
1276,Moritz Jenz,GER,DF,Lorient,Ligue 1,22,1999,15.3,26,12,18,6,2,11,24,45.8,13,19,11,8,28,54,55,0,0,2021-2022,90.0,164.70588235294116,152.94117647058823
1277,Gabriel Jesus,BRA,FW,Manchester City,Premier League,24,1997,20.9,18,12,2,4,12,6,26,23.1,20,18,0,18,15,33,8,0,0,2021-2022,90.0,64.5933014354067,77.51196172248804
1278,Juan Jesus,BRA,DF,Napoli,Serie A,30,1991,14.2,25,17,14,11,0,12,18,66.7,6,21,16,5,9,34,34,0,0,2021-2022,90.0,57.04225352112677,158.45070422535213
1279,Álvaro Jiménez,ESP,"MF,FW",Cádiz,La Liga,26,1995,2.6,6,3,3,2,1,4,7,57.1,3,3,0,3,3,9,0,0,0,2021-2022,90.0,103.84615384615384,207.69230769230768
1280,Raúl Jiménez,MEX,FW,Wolves,Premier League,30,1991,29.2,29,14,6,16,7,6,30,20.0,24,31,5,26,13,42,26,0,0,2021-2022,90.0,40.06849315068494,89.38356164383562
1281,João Pedro,BRA,"FW,MF",Watford,Premier League,19,2001,18.3,20,14,7,8,5,6,23,26.1,17,23,3,20,15,35,17,0,0,2021-2022,90.0,73.77049180327869,98.36065573770492
1282,Joaquín,ESP,"FW,MF",Betis,La Liga,40,1981,5.2,6,2,4,2,0,3,8,37.5,5,5,2,3,3,9,10,0,0,2021-2022,90.0,51.92307692307692,103.84615384615384
1283,Joelinton,BRA,"MF,FW",Newcastle Utd,Premier League,24,1996,28.4,72,38,30,33,9,26,61,42.6,35,46,11,35,34,106,50,2,0,2021-2022,90.0,107.74647887323944,228.16901408450707
1284,Jofre,ESP,"MF,DF",Espanyol,La Liga,20,2001,0.2,1,1,0,0,1,1,1,100.0,0,0,0,0,0,1,0,0,0,2021-2022,90.0,0.0,450.0
1285,Marco John,GER,DF,Hoffenheim,Bundesliga,19,2002,0.5,0,0,0,0,0,0,1,0.0,1,1,0,1,1,1,1,0,0,2021-2022,90.0,180.0,0.0
1286,Dennis Johnsen,NOR,"FW,MF",Venezia,Serie A,23,1998,16.1,14,10,8,4,2,6,18,33.3,12,14,1,13,5,19,3,0,0,2021-2022,90.0,27.95031055900621,78.26086956521739
1287,Ben Johnson,ENG,DF,West Ham,Premier League,21,2000,15.5,33,16,15,15,3,21,28,75.0,7,16,8,8,22,55,55,0,0,2021-2022,90.0,127.74193548387098,191.61290322580646
1288,Curtis Jones,ENG,MF,Liverpool,Premier League,20,2001,9.5,11,9,3,6,2,1,10,10.0,9,4,0,4,6,17,4,0,0,2021-2022,90.0,56.8421052631579,104.21052631578948
1289,Phil Jones,ENG,DF,Manchester Utd,Premier League,29,1992,1.8,5,5,3,1,1,2,3,66.7,1,4,4,0,3,8,8,0,0,2021-2022,90.0,150.0,250.0
1290,Frenkie de Jong,NED,MF,Barcelona,La Liga,24,1997,27.5,35,19,12,18,5,12,23,52.2,11,19,5,14,20,55,16,0,0,2021-2022,89.99999999999999,65.45454545454545,114.54545454545453
1291,Luuk de Jong,NED,FW,Barcelona,La Liga,30,1990,7.3,9,7,1,5,3,1,2,50.0,1,4,0,4,0,9,12,0,0,2021-2022,90.0,0.0,110.95890410958904
1292,Joan Jordán,ESP,MF,Sevilla,La Liga,27,1994,27.9,61,30,22,31,8,28,65,43.1,37,27,6,21,30,91,18,1,0,2021-2022,90.0,96.7741935483871,196.7741935483871
1293,Kaio Jorge,BRA,"MF,FW",Juventus,Serie A,19,2002,1.3,2,1,0,2,0,1,3,33.3,2,1,0,1,0,2,2,0,0,2021-2022,90.0,0.0,138.46153846153845
1294,Jorginho,ITA,MF,Chelsea,Premier League,29,1991,25.3,64,33,27,31,6,29,83,34.9,54,27,4,23,36,100,21,1,0,2021-2022,89.99999999999999,128.06324110671935,227.66798418972328
1295,Josan,ESP,"DF,MF",Elche,La Liga,31,1989,13.5,36,22,23,9,4,26,44,59.1,18,11,4,7,10,46,21,0,0,2021-2022,90.0,66.66666666666667,240.0
1296,Willian José,BRA,FW,Betis,La Liga,29,1991,17.8,15,13,2,10,3,2,8,25.0,6,10,2,8,3,18,16,0,0,2021-2022,90.0,15.168539325842698,75.84269662921348
1297,Joselu,ESP,FW,Alavés,La Liga,31,1990,34.7,16,11,1,9,6,7,25,28.0,18,21,4,17,7,23,45,0,0,2021-2022,90.0,18.155619596541786,41.498559077809794
1298,Josema,ESP,DF,Elche,La Liga,25,1996,2.0,3,2,1,1,1,0,2,0.0,2,1,1,0,0,3,11,0,0,2021-2022,90.0,0.0,135.0
1299,Lenny Joseph,FRA,"FW,MF",Metz,Ligue 1,20,2000,1.7,2,1,1,1,0,0,0,0.0,0,3,0,3,0,2,0,0,0,2021-2022,90.0,0.0,105.88235294117646
1300,Diogo Jota,POR,FW,Liverpool,Premier League,24,1996,26.3,39,18,12,18,9,13,55,23.6,42,19,2,17,6,45,6,0,0,2021-2022,90.0,20.53231939163498,133.46007604562737
Rk,Player,Nation,Pos,Squad,Comp,0,0,90.0,0,0,3,3,3,Tkl,0,0.0,0,0,0,0,0,0,0,0,0,2021-2022,90.0,0.0,0.0
1301,Stevan Jovetić,MNE,"FW,MF",Hertha BSC,Bundesliga,31,1989,11.3,5,2,0,2,3,1,6,16.7,5,3,0,3,1,6,6,0,0,2021-2022,90.0,7.964601769911504,39.823008849557525
1302,Luka Jović,SRB,FW,Real Madrid,La Liga,23,1997,4.1,1,1,0,1,0,0,1,0.0,1,3,0,3,1,2,4,0,0,2021-2022,90.0,21.951219512195124,21.951219512195124
1303,Miguel Juan Llambrich,ESP,DF,Espanyol,La Liga,25,1996,0.8,2,2,1,1,0,0,0,0.0,0,1,0,1,0,2,5,0,0,2021-2022,90.0,0.0,225.0
1304,José Juan Macías,MEX,"FW,MF",Getafe,La Liga,21,1999,2.2,1,0,0,0,1,0,1,0.0,1,1,0,1,1,2,0,0,0,2021-2022,90.0,40.90909090909091,40.90909090909091
1305,Juanmi,ESP,FW,Betis,La Liga,28,1993,23.7,39,25,11,19,9,19,49,38.8,30,24,1,23,9,48,10,1,0,2021-2022,90.0,34.17721518987342,148.10126582278482
1306,Gideon Jung,GER,DF,Greuther Fürth,Bundesliga,26,1994,1.6,3,1,1,2,0,2,4,50.0,2,1,1,0,2,5,5,0,0,2021-2022,90.0,112.5,168.75
1307,Flavio Junior Bianchi,ITA,"FW,MF",Genoa,Serie A,21,2000,3.5,2,2,1,0,1,0,2,0.0,2,0,0,0,0,2,0,0,0,2021-2022,90.0,0.0,51.42857142857143
1308,Lago Junior,CIV,"FW,MF",Mallorca,La Liga,30,1990,2.0,3,2,3,0,0,3,5,60.0,2,0,0,0,2,5,2,0,0,2021-2022,90.0,90.0,135.0
1309,Hamed Junior Traorè,CIV,"FW,MF",Sassuolo,Serie A,21,2000,19.7,32,18,8,14,10,10,46,21.7,36,22,2,20,12,44,6,1,0,2021-2022,90.0,54.82233502538071,146.19289340101523
1310,Vinicius Júnior,BRA,FW,Real Madrid,La Liga,21,2000,29.9,46,24,23,19,4,15,50,30.0,35,25,0,25,6,52,6,0,0,2021-2022,90.0,18.06020066889632,138.46153846153848
1311,James Justin,ENG,DF,Leicester City,Premier League,23,1998,11.1,22,13,11,8,3,7,15,46.7,8,16,4,12,17,39,34,0,0,2021-2022,90.0,137.83783783783784,178.3783783783784
1312,Ferran Jutglà,ESP,FW,Barcelona,La Liga,22,1999,3.3,2,1,0,1,1,0,1,0.0,1,2,0,2,1,3,1,0,0,2021-2022,90.0,27.272727272727273,54.54545454545455
1313,Jens Jønsson,DEN,MF,Cádiz,La Liga,28,1993,14.5,40,29,22,17,1,17,35,48.6,18,17,7,10,34,74,32,0,0,2021-2022,90.0,211.03448275862067,248.2758620689655
1314,Mathias Jørgensen,DEN,DF,Brentford,Premier League,31,1990,5.8,10,4,3,5,2,7,10,70.0,3,6,1,5,10,20,13,0,0,2021-2022,90.0,155.17241379310346,155.17241379310346
1315,Ozan Kabak,TUR,DF,Norwich City,Premier League,21,2000,10.2,10,5,4,6,0,5,9,55.6,4,19,11,8,16,26,26,0,0,2021-2022,90.0,141.1764705882353,88.23529411764706
1316,Christian Kabasele,BEL,DF,Watford,Premier League,30,1991,13.3,11,5,10,1,0,7,10,70.0,3,20,16,4,14,25,67,1,0,2021-2022,90.0,94.73684210526315,74.4360902255639
1317,Issa Kaboré,BFA,"DF,MF",Troyes,Ligue 1,20,2001,25.0,45,22,22,14,9,20,38,52.6,18,27,2,25,20,65,38,1,0,2021-2022,90.0,72.0,162.0
1318,Anton Kade,GER,"FW,MF",Hertha BSC,Bundesliga,17,2004,0.9,4,2,3,1,0,2,8,25.0,6,3,0,3,3,7,1,0,0,2021-2022,90.0,300.0,400.0
1319,Pavel Kadeřábek,CZE,"DF,MF",Hoffenheim,Bundesliga,29,1992,13.3,11,10,6,3,2,5,16,31.3,11,18,6,12,13,24,22,0,0,2021-2022,90.0,87.96992481203007,74.4360902255639
1320,Tino Kadewere,ZIM,FW,Lyon,Ligue 1,25,1996,5.6,7,5,2,2,3,4,13,30.8,9,7,0,7,4,11,1,1,0,2021-2022,90.0,64.28571428571429,112.5
1321,Florian Kainz,AUT,"MF,FW",Köln,Bundesliga,28,1992,25.8,41,26,9,25,7,23,51,45.1,28,27,3,24,32,73,24,0,0,2021-2022,90.0,111.62790697674419,143.02325581395348
1322,Gaël Kakuta,COD,"MF,FW",Lens,Ligue 1,30,1991,18.6,22,14,2,13,7,4,20,20.0,16,10,0,10,4,26,3,0,0,2021-2022,90.0,19.354838709677416,106.4516129032258
1323,Sasa Kalajdzic,AUT,FW,Stuttgart,Bundesliga,24,1997,13.6,10,6,2,5,3,3,11,27.3,8,5,0,5,2,12,14,0,0,2021-2022,90.0,13.235294117647058,66.17647058823529
1324,Arnaud Kalimuendo,FRA,FW,Lens,Ligue 1,19,2002,23.9,9,8,1,3,5,2,7,28.6,5,6,1,5,8,17,0,0,0,2021-2022,90.0,30.125523012552303,33.89121338912134
1325,Arnaud Kalimuendo,FRA,FW,Paris S-G,Ligue 1,19,2002,0.1,0,0,0,0,0,0,0,0.0,0,0,0,0,0,0,0,0,0,2021-2022,90.0,0.0,0.0
Rk,Player,Nation,Pos,Squad,Comp,0,0,90.0,0,0,3,3,3,Tkl,0,0.0,0,0,0,0,0,0,0,0,0,2021-2022,90.0,0.0,0.0
1326,Nikola Kalinić,CRO,FW,Hellas Verona,Serie A,33,1988,4.5,2,0,0,1,1,1,2,50.0,1,2,0,2,0,2,2,0,0,2021-2022,90.0,0.0,40.0
1327,Yayah Kallon,SLE,"FW,MF",Genoa,Serie A,20,2001,7.1,15,11,5,6,4,3,11,27.3,8,7,1,6,1,16,5,0,0,2021-2022,90.0,12.67605633802817,190.14084507042256
1328,Samuel Kalu,NGA,FW,Watford,Premier League,23,1997,2.5,2,2,0,2,0,1,1,100.0,0,2,0,2,3,5,3,0,0,2021-2022,90.0,108.0,72.0
1329,Samuel Kalu,NGA,"FW,MF",Bordeaux,Ligue 1,23,1997,3.6,8,5,3,4,1,2,5,40.0,3,2,0,2,3,11,1,0,0,2021-2022,90.0,75.0,200.0
1330,Pierre Kalulu,FRA,DF,Milan,Serie A,21,2000,21.6,61,36,36,21,4,17,22,77.3,5,36,15,21,26,87,54,0,0,2021-2022,90.0,108.33333333333333,254.16666666666666
1331,Daichi Kamada,JPN,MF,Eint Frankfurt,Bundesliga,24,1996,23.8,40,21,7,26,7,11,40,27.5,29,18,0,18,8,48,10,0,0,2021-2022,90.00000000000001,30.252100840336137,151.26050420168067
1332,Boubacar Kamara,FRA,"MF,DF",Marseille,Ligue 1,21,1999,30.9,68,38,27,36,5,26,47,55.3,21,29,10,19,46,114,44,1,0,2021-2022,90.0,133.98058252427185,198.05825242718447
1333,Hassane Kamara,CIV,DF,Watford,Premier League,27,1994,18.0,53,34,31,16,6,27,43,62.8,16,20,4,16,69,122,67,0,0,2021-2022,90.0,345.0,265.0
1334,Hassane Kamara,CIV,"MF,DF",Nice,Ligue 1,27,1994,6.0,13,10,4,6,3,5,8,62.5,3,10,2,8,9,22,4,0,0,2021-2022,90.0,135.0,195.0
1335,Dimitrije Kamenović,SRB,DF,Lazio,Serie A,21,2000,0.5,1,1,1,0,0,1,1,100.0,0,0,0,0,2,3,1,0,0,2021-2022,90.0,360.0,180.0
1336,Kevin Kampl,SVN,MF,RB Leipzig,Bundesliga,30,1990,21.1,41,19,16,20,5,10,42,23.8,32,24,5,19,24,65,17,0,0,2021-2022,90.0,102.3696682464455,174.8815165876777
1337,Jean-Armel Kana-Biyik,CMR,DF,Metz,Ligue 1,32,1989,7.4,10,6,8,2,0,4,9,44.4,5,11,4,7,16,26,22,1,0,2021-2022,90.0,194.59459459459458,121.62162162162161
1338,Nordine Kandil,FRA,"MF,FW",Strasbourg,Ligue 1,19,2001,1.0,2,1,2,0,0,1,1,100.0,0,1,1,0,0,2,0,0,0,2021-2022,90.0,0.0,180.0
1339,Harry Kane,ENG,FW,Tottenham,Premier League,28,1993,35.9,15,5,2,10,3,7,18,38.9,11,26,8,18,3,18,39,0,0,2021-2022,90.0,7.520891364902508,37.60445682451254
1340,Lee Kang-in,KOR,"MF,FW",Mallorca,La Liga,20,2001,15.7,13,6,2,9,2,5,29,17.2,24,11,1,10,5,18,7,0,0,2021-2022,90.0,28.662420382165607,74.52229299363059
1341,N'Golo Kanté,FRA,MF,Chelsea,Premier League,30,1991,19.7,59,31,20,27,12,25,40,62.5,15,37,2,35,31,90,8,0,0,2021-2022,90.0,141.62436548223351,269.5431472081218
1342,Stefanos Kapino,GRE,GK,Arminia,Bundesliga,27,1994,1.0,0,0,0,0,0,0,0,0.0,0,0,0,0,0,0,0,0,0,2021-2022,90.0,0.0,0.0
1343,Atakan Karazor,GER,MF,Stuttgart,Bundesliga,24,1996,21.1,48,24,18,27,3,18,36,50.0,18,37,14,23,34,82,47,0,0,2021-2022,90.0,145.02369668246445,204.739336492891
1344,Rick Karsdorp,NED,"DF,FW",Roma,Serie A,26,1995,32.0,53,38,33,13,7,28,50,56.0,22,22,5,17,34,87,26,1,0,2021-2022,90.0,95.625,149.0625
1345,Denso Kasius,NED,"DF,FW",Bologna,Serie A,18,2002,2.0,9,7,5,3,1,2,5,40.0,3,4,0,4,3,12,4,0,0,2021-2022,90.0,135.0,405.0
1346,Grigoris Kastanos,CYP,"MF,FW",Salernitana,Serie A,23,1998,15.0,30,19,9,19,2,7,23,30.4,16,21,5,16,22,52,8,0,0,2021-2022,90.0,132.0,180.0
1347,Silas Katompa,COD,"FW,MF",Stuttgart,Bundesliga,22,1998,3.1,5,4,4,0,1,3,7,42.9,4,5,0,5,2,7,1,0,0,2021-2022,90.0,58.064516129032256,145.16129032258064
1348,Noah Katterbach,GER,DF,Köln,Bundesliga,20,2001,0.2,1,1,1,0,0,1,1,100.0,0,0,0,0,0,1,1,0,0,2021-2022,90.0,0.0,450.0
1349,Eiji Kawashima,JPN,GK,Strasbourg,Ligue 1,38,1983,1.0,0,0,0,0,0,0,0,0.0,0,0,0,0,0,0,0,0,0,2021-2022,90.0,0.0,0.0
1350,Edo Kayembe,COD,MF,Watford,Premier League,23,1998,8.9,21,13,11,9,1,8,16,50.0,8,6,1,5,9,30,13,0,0,2021-2022,90.0,91.01123595505618,212.35955056179776
Rk,Player,Nation,Pos,Squad,Comp,0,0,90.0,0,0,3,3,3,Tkl,0,0.0,0,0,0,0,0,0,0,0,0,2021-2022,90.0,0.0,0.0
1351,Moise Kean,ITA,FW,Everton,Premier League,21,2000,0.0,0,0,0,0,0,0,0,0.0,0,0,0,0,0,0,0,0,0,2021-2022,,,
1352,Moise Kean,ITA,FW,Juventus,Serie A,21,2000,12.2,9,4,2,5,2,6,16,37.5,10,5,0,5,3,12,8,1,0,2021-2022,90.0,22.13114754098361,66.39344262295083
1353,Michael Keane,ENG,DF,Everton,Premier League,28,1993,31.0,46,25,32,13,1,28,45,62.2,17,33,28,5,62,108,128,2,0,2021-2022,90.0,180.0,133.5483870967742
1354,Ilan Kebbal,ALG,"MF,FW",Reims,Ligue 1,23,1998,19.7,31,15,13,10,8,12,44,27.3,32,16,0,16,13,44,3,0,0,2021-2022,90.0,59.390862944162436,141.62436548223351
1355,Wajdi Kechrida,TUN,"DF,MF",Salernitana,Serie A,25,1995,10.6,9,6,6,3,0,8,13,61.5,5,10,2,8,8,17,15,0,0,2021-2022,90.0,67.9245283018868,76.41509433962264
1356,Thilo Kehrer,GER,DF,Paris S-G,Ligue 1,24,1996,16.8,21,14,9,11,1,9,21,42.9,12,19,11,8,24,45,29,0,0,2021-2022,90.0,128.57142857142856,112.5
1357,Habib Keita,MLI,"MF,FW",Lyon,Ligue 1,19,2002,0.1,0,0,0,0,0,0,0,0.0,0,0,0,0,0,0,0,0,0,2021-2022,90.0,0.0,0.0
1358,Naby Keïta,GUI,MF,Liverpool,Premier League,26,1995,13.0,46,23,17,19,10,26,42,61.9,16,33,2,31,14,60,8,0,0,2021-2022,90.00000000000001,96.92307692307693,318.4615384615385
1359,Yannik Keitel,GER,MF,Freiburg,Bundesliga,21,2000,5.6,11,4,5,4,2,5,15,33.3,10,7,1,6,1,12,8,0,0,2021-2022,90.0,16.071428571428573,176.78571428571428
1360,Caoimhín Kelleher,IRL,GK,Liverpool,Premier League,22,1998,2.0,1,1,1,0,0,1,1,100.0,0,0,0,0,0,1,1,0,0,2021-2022,90.0,0.0,45.0
1361,Marc-Oliver Kempf,GER,DF,Hertha BSC,Bundesliga,26,1995,11.7,10,9,9,1,0,5,14,35.7,9,14,7,7,25,35,49,1,0,2021-2022,89.99999999999999,192.3076923076923,76.92307692307692
1362,Marc-Oliver Kempf,GER,DF,Stuttgart,Bundesliga,26,1995,9.3,13,8,7,4,2,3,10,30.0,7,16,14,2,16,29,26,2,0,2021-2022,90.0,154.83870967741933,125.8064516129032
1363,Kenedy,BRA,DF,Chelsea,Premier League,25,1996,0.6,5,2,1,2,2,2,3,66.7,1,0,0,0,0,5,0,0,0,2021-2022,90.0,0.0,750.0
1364,Jonjoe Kenny,ENG,DF,Everton,Premier League,24,1997,11.3,17,7,11,6,0,13,21,61.9,8,8,1,7,20,37,31,0,0,2021-2022,90.0,159.2920353982301,135.39823008849558
1365,Dimitrios Keramitsis,GRE,MF,Roma,Serie A,17,2004,0.0,0,0,0,0,0,0,0,0.0,0,0,0,0,0,0,0,0,0,2021-2022,,,
1366,Franck Kessié,CIV,MF,Milan,Serie A,24,1996,25.6,41,23,12,24,5,17,26,65.4,9,39,10,29,23,64,22,0,0,2021-2022,90.0,80.859375,144.140625
1367,Saîf-Eddine Khaoui,TUN,"MF,FW",Clermont Foot,Ligue 1,26,1995,10.3,19,10,5,10,4,9,18,50.0,9,9,0,9,14,33,5,0,0,2021-2022,90.0,122.33009708737863,166.01941747572815
1368,Wahbi Khazri,TUN,"FW,MF",Saint-Étienne,Ligue 1,30,1991,24.7,33,18,7,17,9,9,34,26.5,25,21,0,21,12,45,7,0,0,2021-2022,90.0,43.7246963562753,120.24291497975709
1369,Rani Khedira,GER,MF,Union Berlin,Bundesliga,27,1994,30.6,75,38,25,42,8,32,66,48.5,34,21,8,13,50,125,27,1,0,2021-2022,90.0,147.05882352941177,220.58823529411762
1370,Kiké,ESP,FW,Osasuna,La Liga,31,1989,20.7,11,7,3,4,4,3,23,13.0,20,10,1,9,3,14,12,0,0,2021-2022,90.0,13.043478260869566,47.82608695652174
1371,Luca Kilian,GER,FW,Mainz 05,Bundesliga,21,1999,0.0,0,0,0,0,0,0,0,0.0,0,0,0,0,0,0,0,0,0,2021-2022,,,
1372,Luca Kilian,GER,DF,Köln,Bundesliga,21,1999,25.3,42,24,30,9,3,21,41,51.2,20,31,13,18,46,88,109,3,0,2021-2022,89.99999999999999,163.63636363636363,149.4071146245059
1373,Max Kilman,ENG,DF,Wolves,Premier League,24,1997,29.9,50,26,38,10,2,24,37,64.9,13,36,21,15,45,95,113,3,0,2021-2022,90.0,135.45150501672242,150.5016722408027
1374,Joshua Kimmich,GER,MF,Bayern Munich,Bundesliga,26,1995,27.5,39,20,14,17,8,18,58,31.0,40,34,8,26,52,91,29,1,0,2021-2022,89.99999999999999,170.18181818181816,127.63636363636363
1375,Presnel Kimpembe,FRA,DF,Paris S-G,Ligue 1,25,1995,28.6,34,19,18,15,1,14,23,60.9,9,20,14,6,38,72,73,1,0,2021-2022,90.0,119.58041958041959,106.993006993007
Rk,Player,Nation,Pos,Squad,Comp,0,0,90.0,0,0,3,3,3,Tkl,0,0.0,0,0,0,0,0,0,0,0,0,2021-2022,90.0,0.0,0.0
1376,Joshua King,NOR,FW,Watford,Premier League,29,1992,25.0,19,15,7,6,6,4,17,23.5,13,15,4,11,8,27,31,0,0,2021-2022,90.0,28.799999999999997,68.39999999999999
1377,Jakub Kiwior,POL,MF,Spezia,Serie A,21,2000,21.8,50,27,25,19,6,26,57,45.6,31,38,15,23,40,90,53,0,0,2021-2022,90.0,165.13761467889907,206.42201834862385
1378,Sofian Kiyine,MAR,"MF,FW",Venezia,Serie A,23,1997,13.8,24,14,9,11,4,12,32,37.5,20,15,1,14,10,34,9,0,0,2021-2022,90.0,65.21739130434781,156.52173913043475
1379,Simon Kjær,DEN,DF,Milan,Serie A,32,1989,8.9,20,12,9,8,3,6,12,50.0,6,17,13,4,9,29,39,0,0,2021-2022,90.0,91.01123595505618,202.24719101123597
1380,Kristoffer Klaesson,NOR,GK,Leeds United,Premier League,20,2000,0.4,0,0,0,0,0,0,0,0.0,0,0,0,0,0,0,0,0,0,2021-2022,90.0,0.0,0.0
1381,Philipp Klement,GER,MF,Stuttgart,Bundesliga,28,1992,3.8,7,3,1,4,2,3,3,100.0,0,6,1,5,1,8,0,0,0,2021-2022,90.0,23.684210526315788,165.78947368421052
1382,Mateusz Klich,POL,MF,Leeds United,Premier League,31,1990,23.0,47,25,18,23,6,25,66,37.9,41,22,4,18,11,58,20,0,0,2021-2022,90.0,43.04347826086957,183.91304347826087
1383,Thibault Klidje,TOG,"MF,FW",Bordeaux,Ligue 1,20,2001,1.0,0,0,0,0,0,0,1,0.0,1,1,1,0,2,2,0,0,0,2021-2022,90.0,180.0,0.0
1384,Mateo Klimowicz,GER,"MF,FW",Stuttgart,Bundesliga,21,2000,6.7,13,6,6,7,0,5,16,31.3,11,2,0,2,4,17,3,0,0,2021-2022,90.0,53.731343283582085,174.62686567164178
1385,Fabian Klos,GER,FW,Arminia,Bundesliga,33,1987,15.8,7,5,0,5,2,2,10,20.0,8,17,4,13,0,7,31,0,0,2021-2022,90.0,0.0,39.87341772151898
1386,Lukas Klostermann,GER,DF,RB Leipzig,Bundesliga,25,1996,18.3,29,16,11,15,3,13,19,68.4,6,16,3,13,26,55,58,0,0,2021-2022,90.0,127.8688524590164,142.62295081967213
1387,Justin Kluivert,NED,MF,Nice,Ligue 1,22,1999,20.8,19,9,6,12,1,5,21,23.8,16,13,1,12,14,33,6,0,0,2021-2022,90.0,60.57692307692307,82.21153846153845
1388,Lukas Klünter,GER,DF,Hertha BSC,Bundesliga,25,1996,2.2,1,1,1,0,0,1,5,20.0,4,1,0,1,2,3,2,0,0,2021-2022,90.0,81.81818181818181,40.90909090909091
1389,Ansgar Knauff,GER,"FW,MF",Dortmund,Bundesliga,19,2002,1.3,3,1,1,1,1,0,4,0.0,4,2,0,2,0,3,4,0,0,2021-2022,90.0,0.0,207.69230769230768
1390,Ansgar Knauff,GER,"DF,MF",Eint Frankfurt,Bundesliga,19,2002,8.4,18,14,8,5,5,8,15,53.3,7,11,1,10,8,26,6,0,0,2021-2022,90.0,85.71428571428571,192.85714285714286
1391,Robin Knoche,GER,DF,Union Berlin,Bundesliga,29,1992,33.0,50,24,38,12,0,30,53,56.6,23,45,26,19,49,99,151,1,0,2021-2022,90.0,133.63636363636365,136.36363636363637
1392,Gregor Kobel,SUI,GK,Dortmund,Bundesliga,23,1997,28.5,0,0,0,0,0,0,2,0.0,2,0,0,0,1,1,20,0,0,2021-2022,90.0,3.1578947368421053,0.0
1393,Robin Koch,GER,"MF,DF",Leeds United,Premier League,25,1996,17.5,21,13,9,10,2,9,34,26.5,25,26,10,16,20,41,44,0,0,2021-2022,90.0,102.85714285714286,108.0
1394,Samuel Koeberlé,FRA,FW,Reims,Ligue 1,16,2004,0.0,0,0,0,0,0,0,0,0.0,0,0,0,0,0,0,0,0,0,2021-2022,,,
1395,Philippe Koffi,CIV,FW,Reims,Ligue 1,19,2002,4.2,4,0,0,3,1,0,2,0.0,2,2,1,1,3,7,3,0,0,2021-2022,90.0,64.28571428571428,85.71428571428571
1396,Dominik Kohr,GER,MF,Mainz 05,Bundesliga,27,1994,17.9,40,20,18,19,3,16,42,38.1,26,21,2,19,35,75,22,0,0,2021-2022,90.0,175.97765363128494,201.1173184357542
1397,Koba Koindredi,FRA,MF,Valencia,La Liga,19,2001,2.0,4,3,2,1,1,2,6,33.3,4,3,0,3,4,8,5,0,0,2021-2022,90.0,180.0,180.0
1398,Koke,ESP,MF,Atlético Madrid,La Liga,29,1992,27.9,55,30,19,29,7,26,63,41.3,37,21,5,16,24,79,31,1,0,2021-2022,90.0,77.41935483870968,177.41935483870967
1399,Aleksandr Kokorin,RUS,"FW,MF",Fiorentina,Serie A,30,1991,0.6,1,1,1,0,0,0,0,0.0,0,1,0,1,0,1,0,0,0,2021-2022,90.0,0.0,150.0
1400,Aleksandar Kolarov,SRB,DF,Inter,Serie A,35,1985,0.5,1,1,1,0,0,1,1,100.0,0,0,0,0,1,2,2,0,0,2021-2022,90.0,180.0,180.0
Rk,Player,Nation,Pos,Squad,Comp,0,0,90.0,0,0,3,3,3,Tkl,0,0.0,0,0,0,0,0,0,0,0,0,2021-2022,90.0,0.0,0.0
1401,Sead Kolašinac,BIH,DF,Arsenal,Premier League,28,1993,1.0,0,0,0,0,0,0,0,0.0,0,0,0,0,4,4,1,0,0,2021-2022,90.0,360.0,0.0
1402,Sead Kolašinac,BIH,DF,Marseille,Ligue 1,28,1993,4.9,7,6,2,3,2,5,8,62.5,3,4,0,4,0,7,7,1,0,2021-2022,90.0,0.0,128.57142857142856
1403,Luca Koleosho,ITA,FW,Espanyol,La Liga,16,2004,0.0,0,0,0,0,0,0,0,0.0,0,0,0,0,0,0,0,0,0,2021-2022,,,
1404,Randal Kolo Muani,FRA,"FW,MF",Nantes,Ligue 1,22,1998,32.8,28,14,7,10,11,10,25,40.0,15,14,3,11,6,34,31,0,0,2021-2022,90.0,16.463414634146343,76.82926829268294
1405,Timothée Kolodziejczak,FRA,DF,Saint-Étienne,Ligue 1,29,1991,28.5,43,24,22,14,7,20,36,55.6,16,29,7,22,60,103,72,1,0,2021-2022,90.0,189.47368421052633,135.78947368421052
1406,Ghislain Konan,CIV,DF,Reims,Ligue 1,25,1995,26.9,35,19,19,15,1,16,30,53.3,14,35,8,27,28,63,45,0,0,2021-2022,90.0,93.68029739776952,117.10037174721191
1407,Ibrahima Konaté,FRA,DF,Liverpool,Premier League,22,1999,11.0,16,10,9,6,1,7,10,70.0,3,13,9,4,16,32,37,1,0,2021-2022,90.0,130.9090909090909,130.9090909090909
1408,Geoffrey Kondogbia,CTA,"MF,DF",Atlético Madrid,La Liga,28,1993,20.9,74,44,25,40,9,21,49,42.9,28,16,5,11,44,118,24,0,0,2021-2022,90.0,189.47368421052633,318.66028708133973
1409,Ibrahima Koné,MLI,FW,Lorient,Ligue 1,22,1999,8.1,7,4,0,3,4,2,3,66.7,1,8,3,5,1,8,3,0,0,2021-2022,90.0,11.11111111111111,77.77777777777779
1410,Manu Koné,FRA,MF,Gladbach,Bundesliga,20,2001,24.3,60,37,29,28,3,25,42,59.5,17,27,4,23,34,94,12,0,0,2021-2022,90.0,125.92592592592592,222.2222222222222
1411,Youssouf Koné,MLI,DF,Troyes,Ligue 1,26,1995,10.9,30,18,21,8,1,19,30,63.3,11,8,3,5,10,40,25,0,0,2021-2022,90.0,82.56880733944953,247.7064220183486
1412,Ezri Konsa,ENG,DF,Aston Villa,Premier League,23,1997,27.5,25,15,13,11,1,10,13,76.9,3,31,22,9,15,40,86,2,0,2021-2022,89.99999999999999,49.090909090909086,81.81818181818181
1413,Teun Koopmeiners,NED,MF,Atalanta,Serie A,23,1998,23.6,40,24,10,19,11,22,54,40.7,32,31,2,29,15,55,19,0,0,2021-2022,90.0,57.20338983050847,152.54237288135593
1414,Laurent Koscielny,FRA,DF,Bordeaux,Ligue 1,35,1985,10.4,14,9,10,3,1,8,13,61.5,5,17,12,5,12,26,39,0,0,2021-2022,90.0,103.84615384615384,121.15384615384615
1415,Odilon Kossonou,CIV,DF,Leverkusen,Bundesliga,20,2001,19.9,23,17,16,6,1,15,25,60.0,10,36,14,22,26,49,66,0,0,2021-2022,90.0,117.58793969849248,104.02010050251258
1416,Filip Kostić,SRB,"DF,FW",Eint Frankfurt,Bundesliga,28,1992,28.0,44,17,26,9,9,20,53,37.7,33,24,1,23,15,59,24,0,0,2021-2022,90.0,48.214285714285715,141.42857142857142
1417,Rominigue Kouamé,MLI,MF,Troyes,Ligue 1,24,1996,33.0,47,22,24,20,3,19,58,32.8,39,33,5,28,46,93,22,2,0,2021-2022,90.0,125.45454545454547,128.1818181818182
1418,Kalidou Koulibaly,SEN,DF,Napoli,Serie A,30,1991,26.7,39,23,31,6,2,25,38,65.8,13,41,25,16,29,68,90,1,0,2021-2022,90.00000000000001,97.75280898876406,131.46067415730337
1419,Jules Koundé,FRA,DF,Sevilla,La Liga,22,1998,30.4,40,17,27,10,3,18,28,64.3,10,33,18,15,21,61,101,2,0,2021-2022,90.0,62.171052631578945,118.42105263157895
1420,Christos Kourfalidis,GRE,"MF,FW",Cagliari,Serie A,18,2002,0.2,0,0,0,0,0,0,1,0.0,1,1,0,1,0,0,0,0,0,2021-2022,90.0,0.0,0.0
1421,Boubakar Kouyaté,MLI,DF,Metz,Ligue 1,24,1997,29.6,84,50,56,28,0,48,77,62.3,29,63,33,30,79,163,217,3,0,2021-2022,90.0,240.2027027027027,255.4054054054054
1422,Cheikhou Kouyaté,SEN,MF,Crystal Palace,Premier League,31,1989,21.9,52,38,28,22,2,18,39,46.2,21,40,14,26,38,90,39,0,0,2021-2022,90.0,156.16438356164386,213.6986301369863
1423,Mateo Kovačić,CRO,MF,Chelsea,Premier League,27,1994,17.3,51,31,14,26,11,17,35,48.6,18,19,4,15,7,58,9,1,0,2021-2022,90.0,36.41618497109826,265.31791907514446
1424,Viktor Kovalenko,UKR,MF,Spezia,Serie A,25,1996,14.7,16,10,7,8,1,9,21,42.9,12,16,3,13,13,29,8,0,0,2021-2022,90.0,79.59183673469389,97.95918367346938
1425,Emil Krafth,SWE,DF,Newcastle Utd,Premier League,26,1994,18.2,37,16,25,11,1,27,36,75.0,9,16,10,6,25,62,56,0,0,2021-2022,90.0,123.62637362637363,182.96703296703296
Rk,Player,Nation,Pos,Squad,Comp,0,0,90.0,0,0,3,3,3,Tkl,0,0.0,0,0,0,0,0,0,0,0,0,2021-2022,90.0,0.0,0.0
1426,Alex Král,CZE,MF,West Ham,Premier League,23,1998,0.0,0,0,0,0,0,0,0,0.0,0,0,0,0,0,0,0,0,0,2021-2022,,,
1427,Andrej Kramarić,CRO,"FW,MF",Hoffenheim,Bundesliga,30,1991,30.1,8,4,1,5,2,7,17,41.2,10,10,0,10,9,17,7,1,0,2021-2022,90.00000000000001,26.91029900332226,23.920265780730897
1428,Christoph Kramer,GER,MF,Gladbach,Bundesliga,30,1991,8.3,28,11,15,10,3,12,28,42.9,16,18,5,13,12,40,9,0,0,2021-2022,90.0,130.12048192771084,303.61445783132524
1429,Jean-Philippe Krasso,CIV,FW,Saint-Étienne,Ligue 1,24,1997,5.0,7,5,0,5,2,2,10,20.0,8,7,1,6,0,7,1,0,0,2021-2022,90.0,0.0,126.0
1430,Julian Kristoffersen,NOR,FW,Salernitana,Serie A,24,1997,0.1,0,0,0,0,0,0,0,0.0,0,0,0,0,0,0,0,0,0,2021-2022,90.0,0.0,0.0
1431,Toni Kroos,GER,MF,Real Madrid,La Liga,31,1990,23.4,34,26,13,17,4,14,36,38.9,22,16,3,13,12,46,13,1,0,2021-2022,89.99999999999999,46.15384615384615,130.76923076923077
1432,Florian Krüger,GER,"FW,MF",Arminia,Bundesliga,22,1999,12.5,3,1,0,3,0,2,10,20.0,8,12,1,11,2,5,13,0,0,2021-2022,90.0,14.399999999999999,21.599999999999998
1433,Tim Krul,NED,GK,Norwich City,Premier League,33,1988,29.0,1,1,1,0,0,1,4,25.0,3,0,0,0,0,1,10,4,0,2021-2022,90.0,0.0,3.103448275862069
1434,Rade Krunić,BIH,"MF,FW",Milan,Serie A,27,1993,15.7,33,18,16,14,3,15,31,48.4,16,19,2,17,16,49,17,0,0,2021-2022,90.0,91.71974522292994,189.171974522293
1435,Max Kruse,GER,"MF,FW",Wolfsburg,Bundesliga,33,1988,12.5,9,3,4,4,1,5,12,41.7,7,2,0,2,3,12,4,0,0,2021-2022,90.0,21.599999999999998,64.8
1436,Max Kruse,GER,"FW,MF",Union Berlin,Bundesliga,33,1988,14.1,4,1,0,3,1,2,16,12.5,14,12,0,12,3,7,2,0,0,2021-2022,89.99999999999999,19.148936170212764,25.53191489361702
1437,Lukas Kübler,GER,"DF,MF",Freiburg,Bundesliga,28,1992,25.9,62,35,38,16,8,28,49,57.1,21,24,8,16,44,106,70,0,0,2021-2022,90.0,152.8957528957529,215.44401544401546
1438,Takefusa Kubo,JPN,"FW,MF",Mallorca,La Liga,20,2001,17.8,31,19,12,14,5,10,24,41.7,14,24,3,21,8,39,4,0,0,2021-2022,90.0,40.449438202247194,156.74157303370788
1439,Juraj Kucka,SVK,MF,Watford,Premier League,34,1987,21.3,59,39,32,25,2,27,73,37.0,46,30,9,21,27,86,46,2,0,2021-2022,90.0,114.08450704225352,249.29577464788733
1440,Mykola Kukharevych,UKR,FW,Troyes,Ligue 1,20,2001,0.2,0,0,0,0,0,0,0,0.0,0,0,0,0,0,0,0,0,0,2021-2022,90.0,0.0,0.0
1441,Dejan Kulusevski,SWE,"MF,FW",Tottenham,Premier League,21,2000,14.0,19,13,7,10,2,5,23,21.7,18,14,0,14,13,32,3,0,0,2021-2022,90.0,83.57142857142857,122.14285714285714
1442,Dejan Kulusevski,SWE,"FW,MF",Juventus,Serie A,21,2000,8.6,15,12,9,6,0,8,21,38.1,13,14,0,14,5,20,5,0,0,2021-2022,90.0,52.32558139534884,156.97674418604652
1443,Marash Kumbulla,ALB,DF,Roma,Serie A,21,2000,11.4,21,13,13,7,1,8,15,53.3,7,17,8,9,16,37,26,0,0,2021-2022,90.0,126.3157894736842,165.78947368421052
1444,Fabian Kunze,GER,MF,Arminia,Bundesliga,23,1998,14.0,35,21,14,20,1,15,32,46.9,17,17,2,15,19,54,27,1,0,2021-2022,90.0,122.14285714285714,225.0
1445,Enock Kwateng,FRA,DF,Bordeaux,Ligue 1,24,1997,22.2,54,35,31,19,4,33,72,45.8,39,17,4,13,43,97,48,1,0,2021-2022,90.0,174.32432432432435,218.91891891891893
1446,Grejohn Kyei,FRA,FW,Clermont Foot,Ligue 1,25,1995,4.4,3,2,1,1,1,0,6,0.0,6,6,0,6,0,3,1,0,0,2021-2022,90.0,0.0,61.36363636363636
1447,Giorgos Kyriakopoulos,GRE,"DF,FW",Sassuolo,Serie A,25,1996,21.9,30,14,19,7,4,19,38,50.0,19,32,9,23,11,41,52,0,0,2021-2022,90.0,45.205479452054796,123.28767123287672
1448,Andrea La Mantia,ITA,"FW,MF",Empoli,Serie A,30,1991,5.4,2,0,0,0,2,1,2,50.0,1,3,1,2,1,3,6,0,0,2021-2022,90.0,16.666666666666664,33.33333333333333
1449,Gaëtan Laborde,FRA,FW,Montpellier,Ligue 1,27,1994,3.8,2,2,1,1,0,2,4,50.0,2,3,0,3,5,7,5,0,0,2021-2022,90.0,118.42105263157895,47.368421052631575
1450,Gaëtan Laborde,FRA,FW,Rennes,Ligue 1,27,1994,30.3,19,7,5,8,6,3,22,13.6,19,29,3,26,8,27,16,0,0,2021-2022,90.0,23.762376237623762,56.43564356435643
Rk,Player,Nation,Pos,Squad,Comp,0,0,90.0,0,0,3,3,3,Tkl,0,0.0,0,0,0,0,0,0,0,0,0,2021-2022,90.0,0.0,0.0
1451,Alexandre Lacazette,FRA,FW,Arsenal,Premier League,30,1991,19.8,27,10,8,13,6,7,21,33.3,14,12,1,11,5,32,6,0,0,2021-2022,90.0,22.727272727272727,122.72727272727273
1452,Tom Lacoux,FRA,"DF,MF",Bordeaux,Ligue 1,19,2002,10.1,18,13,11,5,2,9,24,37.5,15,14,4,10,9,27,20,1,0,2021-2022,90.0,80.1980198019802,160.3960396039604
1453,Lenny Lacroix,FRA,DF,Metz,Ligue 1,18,2003,2.2,9,7,8,1,0,5,8,62.5,3,5,1,4,10,19,5,0,0,2021-2022,90.0,409.09090909090907,368.1818181818182
1454,Maxence Lacroix,FRA,DF,Wolfsburg,Bundesliga,21,2000,27.7,59,33,41,16,2,29,40,72.5,11,35,16,19,60,119,144,0,0,2021-2022,90.0,194.94584837545128,191.6967509025271
1455,Alban Lafont,FRA,GK,Nantes,Ligue 1,22,1999,38.0,3,3,3,0,0,3,8,37.5,5,1,0,1,1,4,25,2,0,2021-2022,90.0,2.3684210526315788,7.105263157894737
1456,Víctor Laguardia,ESP,DF,Alavés,La Liga,31,1989,33.8,29,16,21,8,0,19,30,63.3,11,36,24,12,27,56,151,1,0,2021-2022,90.0,71.89349112426036,77.21893491124261
1457,Konrad Laimer,AUT,MF,RB Leipzig,Bundesliga,24,1997,13.8,38,24,11,22,5,24,53,45.3,29,29,3,26,4,42,9,0,0,2021-2022,90.0,26.08695652173913,247.82608695652172
1458,Stefan Lainer,AUT,DF,Gladbach,Bundesliga,28,1992,16.3,19,11,9,7,3,12,28,42.9,16,24,5,19,14,33,31,0,0,2021-2022,90.0,77.30061349693251,104.9079754601227
1459,Diego Lainez,MEX,FW,Betis,La Liga,21,2000,1.6,1,1,0,1,0,0,3,0.0,3,3,0,3,1,2,0,0,0,2021-2022,90.0,56.25,56.25
1460,Adam Lallana,ENG,MF,Brighton,Premier League,33,1988,17.3,34,17,14,14,6,12,41,29.3,29,16,6,10,16,50,13,1,0,2021-2022,90.0,83.23699421965317,176.878612716763
1461,Vassilis Lambropoulos,GRE,DF,Bochum,Bundesliga,31,1990,13.0,18,12,13,3,2,11,25,44.0,14,21,10,11,17,35,56,0,0,2021-2022,90.00000000000001,117.69230769230771,124.61538461538463
1462,Érik Lamela,ARG,"FW,MF",Sevilla,La Liga,29,1992,11.3,31,18,12,14,5,10,29,34.5,19,11,0,11,5,36,3,0,0,2021-2022,90.0,39.823008849557525,246.90265486725664
1463,Mohamed Lamine Bayo,GUI,FW,Clermont Foot,Ligue 1,23,1998,26.8,12,5,4,3,5,3,24,12.5,21,7,1,6,7,19,14,0,0,2021-2022,90.0,23.507462686567163,40.298507462686565
1464,Didier Lamkel Zé,CMR,FW,Metz,Ligue 1,24,1996,6.7,3,1,1,0,2,1,3,33.3,2,3,1,2,1,4,7,0,0,2021-2022,90.0,13.432835820895521,40.298507462686565
1465,Sam Lammers,NED,"FW,MF",Atalanta,Serie A,24,1997,0.4,1,0,0,0,1,0,0,0.0,0,0,0,0,0,1,0,0,0,2021-2022,90.0,0.0,225.0
1466,Sam Lammers,NED,"FW,MF",Eint Frankfurt,Bundesliga,24,1997,5.7,4,4,0,2,2,2,6,33.3,4,9,2,7,2,6,4,0,0,2021-2022,90.0,31.57894736842105,63.1578947368421
1467,Tariq Lamptey,GHA,"DF,FW",Brighton,Premier League,20,2000,17.3,36,25,14,17,5,15,25,60.0,10,13,3,10,21,57,23,0,0,2021-2022,90.0,109.24855491329478,187.28323699421964
1468,Manuel Lanzini,ARG,"MF,FW",West Ham,Premier League,28,1993,19.8,28,15,10,11,7,10,35,28.6,25,16,0,16,19,47,10,0,0,2021-2022,90.0,86.36363636363636,127.27272727272727
1469,Aymeric Laporte,ESP,DF,Manchester City,Premier League,27,1994,31.4,33,15,22,10,1,14,20,70.0,6,15,10,5,20,53,64,2,0,2021-2022,90.0,57.32484076433121,94.5859872611465
1470,Julien Laporte,FRA,DF,Lorient,Ligue 1,27,1993,32.1,63,45,35,26,2,32,64,50.0,32,37,22,15,54,117,174,0,0,2021-2022,90.0,151.4018691588785,176.63551401869157
1471,Yasser Larouci,ALG,DF,Troyes,Ligue 1,20,2001,3.8,6,5,2,4,0,3,3,100.0,0,1,0,1,7,13,5,0,0,2021-2022,90.0,165.78947368421052,142.10526315789474
1472,Kevin Lasagna,ITA,"MF,FW",Hellas Verona,Serie A,28,1992,13.2,13,7,4,5,4,4,15,26.7,11,16,0,16,3,16,7,0,0,2021-2022,90.0,20.454545454545453,88.63636363636364
1473,Jamaal Lascelles,ENG,DF,Newcastle Utd,Premier League,27,1993,22.9,15,7,9,5,1,4,12,33.3,8,38,28,10,22,37,121,1,0,2021-2022,90.0,86.46288209606988,58.951965065502186
1474,Bryan Lasme,FRA,FW,Arminia,Bundesliga,22,1998,9.7,6,6,1,2,3,0,3,0.0,3,7,0,7,1,7,9,0,0,2021-2022,90.0,9.278350515463918,55.67010309278351
1475,Paul Lasne,FRA,MF,Brest,Ligue 1,32,1989,9.4,26,12,6,16,4,8,18,44.4,10,11,2,9,24,50,10,0,0,2021-2022,90.0,229.78723404255317,248.93617021276594
Rk,Player,Nation,Pos,Squad,Comp,0,0,90.0,0,0,3,3,3,Tkl,0,0.0,0,0,0,0,0,0,0,0,0,2021-2022,90.0,0.0,0.0
1476,Juanmi Latasa,ESP,FW,Real Madrid,La Liga,20,2001,0.1,0,0,0,0,0,0,0,0.0,0,0,0,0,0,0,0,0,0,2021-2022,90.0,0.0,0.0
1477,Toni Lato,ESP,DF,Valencia,La Liga,23,1997,6.6,17,12,12,3,2,9,16,56.3,7,6,0,6,8,25,14,0,0,2021-2022,90.0,109.0909090909091,231.8181818181818
1478,Armand Lauriente,FRA,"FW,MF",Lorient,Ligue 1,22,1998,27.5,33,18,9,16,8,11,30,36.7,19,27,2,25,15,48,3,0,0,2021-2022,89.99999999999999,49.090909090909086,107.99999999999999
1479,Darko Lazović,SRB,DF,Hellas Verona,Serie A,30,1990,30.7,36,23,20,8,8,21,39,53.8,18,28,4,24,19,55,49,1,0,2021-2022,90.0,55.700325732899024,105.53745928338763
1480,Manuel Lazzari,ITA,DF,Lazio,Serie A,27,1993,18.5,28,14,13,15,0,16,26,61.5,10,10,2,8,12,40,16,1,0,2021-2022,90.0,58.37837837837838,136.21621621621622
1481,Théo Le Bris,FRA,MF,Lorient,Ligue 1,18,2002,0.7,2,1,1,1,0,1,2,50.0,1,2,0,2,0,2,1,0,0,2021-2022,90.0,0.0,257.14285714285717
1482,Jérémy Le Douaron,FRA,"FW,MF",Brest,Ligue 1,23,1998,16.1,11,5,4,4,3,1,17,5.9,16,15,0,15,4,15,14,0,0,2021-2022,90.0,22.360248447204967,61.49068322981366
1483,Enzo Le Fée,FRA,"MF,FW",Lorient,Ligue 1,21,2000,24.4,70,44,25,36,9,41,90,45.6,49,25,1,24,29,99,18,0,0,2021-2022,90.0,106.96721311475412,258.1967213114754
1484,Vincent Le Goff,FRA,DF,Lorient,Ligue 1,31,1989,34.0,61,38,38,19,4,37,62,59.7,25,18,3,15,37,98,50,0,0,2021-2022,90.0,97.94117647058823,161.47058823529412
1485,Maxime Le Marchand,FRA,DF,Strasbourg,Ligue 1,31,1989,9.6,17,8,16,1,0,8,10,80.0,2,9,5,4,14,31,32,0,0,2021-2022,90.0,131.25,159.375
1486,Robin Le Normand,ESP,DF,Real Sociedad,La Liga,24,1996,37.0,49,32,36,8,5,28,36,77.8,8,34,22,12,48,97,125,0,0,2021-2022,90.0,116.75675675675676,119.1891891891892
1487,Patrick Leal,USA,FW,Venezia,Serie A,18,2003,0.0,0,0,0,0,0,0,1,0.0,1,0,0,0,0,0,0,0,0,2021-2022,,,
1488,Rafael Leão,POR,FW,Milan,Serie A,22,1999,28.9,17,7,3,9,5,10,20,50.0,10,12,1,11,12,29,8,0,0,2021-2022,90.00000000000001,37.37024221453288,52.94117647058824
1489,Jean-Louis Leca,FRA,GK,Lens,Ligue 1,35,1985,25.7,0,0,0,0,0,0,0,0.0,0,1,0,1,1,1,11,1,0,2021-2022,90.0,3.501945525291829,0.0
1490,Jeremías Ledesma,ARG,GK,Cádiz,La Liga,28,1993,38.0,3,1,3,0,0,3,4,75.0,1,0,0,0,1,4,21,4,0,2021-2022,90.0,2.3684210526315788,7.105263157894737
1491,Pierre Lees-Melou,FRA,MF,Norwich City,Premier League,28,1993,25.2,58,36,23,29,6,25,92,27.2,67,37,11,26,25,83,23,0,0,2021-2022,90.0,89.28571428571429,207.14285714285717
1492,Wu Lei,CHN,"FW,MF",Espanyol,La Liga,29,1991,5.3,3,2,1,2,0,3,8,37.5,5,4,0,4,4,7,3,0,0,2021-2022,90.0,67.9245283018868,50.943396226415096
1493,Maxim Leitsch,GER,DF,Bochum,Bundesliga,23,1998,17.1,18,10,9,7,2,10,15,66.7,5,31,19,12,31,49,74,1,0,2021-2022,90.0,163.1578947368421,94.73684210526315
1494,Lucas Leiva,BRA,MF,Lazio,Serie A,34,1987,18.9,55,30,26,25,4,15,53,28.3,38,27,10,17,28,83,37,0,0,2021-2022,90.0,133.33333333333334,261.9047619047619
1495,Florian Lejeune,FRA,DF,Alavés,La Liga,30,1991,30.0,33,24,22,10,1,12,20,60.0,8,30,19,11,31,64,158,0,0,2021-2022,90.0,93.0,99.0
1496,Iñigo Lekue,ESP,DF,Athletic Club,La Liga,28,1993,21.4,32,23,16,12,4,22,44,50.0,22,37,12,25,23,55,63,0,0,2021-2022,90.0,96.72897196261682,134.57943925233647
1497,Thomas Lemar,FRA,MF,Atlético Madrid,La Liga,25,1995,16.0,24,14,9,12,3,8,23,34.8,15,18,0,18,8,32,11,0,0,2021-2022,90.0,45.0,135.0
1498,Félix Lemaréchal,FRA,MF,Monaco,Ligue 1,17,2003,0.1,0,0,0,0,0,0,1,0.0,1,0,0,0,0,0,0,0,0,2021-2022,90.0,0.0,0.0
1499,Mario Lemina,GAB,MF,Nice,Ligue 1,27,1993,21.9,62,35,25,33,4,28,38,73.7,10,32,9,23,48,110,37,0,0,2021-2022,90.0,197.26027397260276,254.7945205479452
1500,Fabien Lemoine,FRA,MF,Lorient,Ligue 1,34,1987,12.4,35,22,20,14,1,17,41,41.5,24,21,4,17,14,49,24,1,0,2021-2022,90.0,101.61290322580645,254.03225806451613
Rk,Player,Nation,Pos,Squad,Comp,0,0,90.0,0,0,3,3,3,Tkl,0,0.0,0,0,0,0,0,0,0,0,0,2021-2022,90.0,0.0,0.0
1501,Tim Lemperle,GER,"FW,MF",Köln,Bundesliga,19,2002,1.7,4,1,2,1,1,1,3,33.3,2,1,0,1,2,6,2,0,0,2021-2022,90.0,105.88235294117646,211.76470588235293
1502,Ruben Lendinez,ESP,DF,Valencia,La Liga,18,2003,1.5,3,3,1,2,0,3,8,37.5,5,4,0,4,2,5,6,0,0,2021-2022,90.0,120.0,180.0
1503,Clément Lenglet,FRA,DF,Barcelona,La Liga,26,1995,9.2,20,11,11,7,2,8,13,61.5,5,7,3,4,13,33,21,0,0,2021-2022,90.0,127.17391304347827,195.6521739130435
1504,Aaron Lennon,ENG,"MF,FW",Burnley,Premier League,34,1987,17.2,33,17,10,13,10,10,34,29.4,24,26,4,22,9,42,14,0,0,2021-2022,90.0,47.09302325581396,172.67441860465118
1505,Bernd Leno,GER,GK,Arsenal,Premier League,29,1992,4.0,1,1,1,0,0,1,1,100.0,0,0,0,0,0,1,1,0,0,2021-2022,90.0,0.0,22.5
1506,Christopher Lenz,GER,DF,Eint Frankfurt,Bundesliga,26,1994,7.4,29,15,22,6,1,12,21,57.1,9,9,4,5,7,36,21,0,0,2021-2022,90.0,85.13513513513513,352.7027027027027
1507,Léo Leroy,FRA,MF,Montpellier,Ligue 1,21,2000,7.0,31,21,17,11,3,12,34,35.3,22,20,4,16,8,39,8,0,0,2021-2022,90.0,102.85714285714286,398.57142857142856
1508,Alexandre Letellier,FRA,GK,Paris S-G,Ligue 1,30,1990,0.1,0,0,0,0,0,0,0,0.0,0,0,0,0,0,0,0,0,0,2021-2022,90.0,0.0,0.0
1509,Robert Lewandowski,POL,FW,Bayern Munich,Bundesliga,32,1988,32.7,10,3,0,6,4,5,17,29.4,12,17,2,15,6,16,8,0,0,2021-2022,90.0,16.513761467889907,27.522935779816514
1510,Jamie Leweling,GER,"FW,MF",Greuther Fürth,Bundesliga,20,2001,21.8,13,8,3,7,3,3,16,18.8,13,9,0,9,13,26,5,0,0,2021-2022,90.0,53.6697247706422,53.6697247706422
1511,Jamal Lewis,NIR,DF,Newcastle Utd,Premier League,23,1998,2.9,8,6,6,1,1,3,4,75.0,1,3,2,1,3,11,8,0,0,2021-2022,90.0,93.10344827586206,248.27586206896552
1512,Luca Lezzerini,ITA,GK,Venezia,Serie A,26,1995,5.5,0,0,0,0,0,0,0,0.0,0,1,0,1,0,0,0,0,0,2021-2022,90.0,0.0,0.0
1513,Ben Lhassine Kone,CIV,MF,Torino,Serie A,21,2000,0.9,3,3,1,2,0,1,2,50.0,1,0,0,0,1,4,1,0,0,2021-2022,90.0,100.0,300.0
1514,Yanis Lhery,FRA,"FW,MF",Saint-Étienne,Ligue 1,18,2003,0.8,0,0,0,0,0,0,0,0.0,0,4,0,4,0,0,0,0,0,2021-2022,90.0,0.0,0.0
1515,Dimitri Liénard,FRA,"DF,MF",Strasbourg,Ligue 1,33,1988,22.7,71,43,40,21,10,46,77,59.7,31,12,0,12,21,92,28,0,0,2021-2022,89.99999999999999,83.25991189427312,281.4977973568282
1516,Philipp Lienhart,AUT,DF,Freiburg,Bundesliga,25,1996,31.9,24,13,17,6,1,13,24,54.2,11,33,23,10,50,74,158,1,0,2021-2022,90.0,141.06583072100312,67.7115987460815
1517,Matthijs de Ligt,NED,DF,Juventus,Serie A,21,1999,29.7,34,19,21,13,0,15,18,83.3,3,31,21,10,26,60,103,0,0,2021-2022,90.0,78.78787878787878,103.03030303030303
1518,Isaac Lihadji,FRA,"MF,FW",Lille,Ligue 1,19,2002,2.6,3,3,1,1,1,1,5,20.0,4,1,0,1,2,5,0,0,0,2021-2022,90.0,69.23076923076923,103.84615384615384
1519,Anderson Lima,BRA,MF,Lazio,Serie A,21,1999,0.7,2,0,1,1,0,0,2,0.0,2,1,0,1,2,4,1,0,0,2021-2022,90.0,257.14285714285717,257.14285714285717
1520,Andreas Linde,SWE,GK,Greuther Fürth,Bundesliga,28,1993,12.0,0,0,0,0,0,0,0,0.0,0,0,0,0,1,1,1,1,0,2021-2022,90.0,7.5,0.0
1521,Victor Lindelöf,SWE,DF,Manchester Utd,Premier League,27,1994,26.2,16,11,9,7,0,9,14,64.3,5,26,17,9,25,41,96,0,0,2021-2022,90.0,85.87786259541986,54.961832061068705
1522,Jesper Lindstrøm,DEN,"MF,FW",Eint Frankfurt,Bundesliga,21,2000,22.0,28,13,6,13,9,12,36,33.3,24,30,0,30,24,52,11,1,0,2021-2022,90.0,98.18181818181819,114.54545454545455
1523,Karol Linetty,POL,"MF,FW",Torino,Serie A,26,1995,10.0,14,8,3,4,7,6,18,33.3,12,8,0,8,3,17,2,0,0,2021-2022,90.0,27.0,126.0
1524,Jesse Lingard,ENG,"FW,MF",Manchester Utd,Premier League,28,1992,4.1,9,7,4,3,2,2,6,33.3,4,4,0,4,0,9,1,0,0,2021-2022,90.0,0.0,197.56097560975613
1525,Pol Lirola,ESP,"DF,FW",Marseille,Ligue 1,23,1997,19.7,28,16,15,9,4,13,28,46.4,15,15,0,15,13,41,22,0,0,2021-2022,90.0,59.390862944162436,127.91878172588832
Rk,Player,Nation,Pos,Squad,Comp,0,0,90.0,0,0,3,3,3,Tkl,0,0.0,0,0,0,0,0,0,0,0,0,2021-2022,90.0,0.0,0.0
1526,Valentino Livramento,ENG,DF,Southampton,Premier League,18,2002,24.5,54,28,30,18,6,27,45,60.0,18,23,9,14,47,101,50,1,0,2021-2022,90.00000000000001,172.65306122448982,198.36734693877554
1527,Dejan Ljubicic,AUT,"MF,FW",Köln,Bundesliga,23,1997,21.9,33,19,12,13,8,13,49,26.5,36,19,1,18,15,48,11,0,0,2021-2022,90.0,61.64383561643836,135.6164383561644
1528,Javier Llabrés,ESP,"FW,MF",Mallorca,La Liga,18,2002,1.5,2,1,0,1,1,1,2,50.0,1,1,0,1,0,2,0,0,0,2021-2022,90.0,0.0,120.0
1529,Diego Llorente,ESP,DF,Leeds United,Premier League,27,1993,26.0,53,31,32,19,2,33,47,70.2,14,35,17,18,40,93,77,2,0,2021-2022,90.00000000000001,138.46153846153848,183.46153846153848
1530,Marcos Llorente,ESP,"MF,DF",Atlético Madrid,La Liga,26,1995,27.2,51,23,25,22,4,28,43,65.1,15,33,10,23,27,78,44,0,0,2021-2022,90.0,89.33823529411765,168.75
1531,Hugo Lloris,FRA,GK,Tottenham,Premier League,34,1986,38.0,1,1,1,0,0,1,2,50.0,1,0,0,0,1,2,24,3,0,2021-2022,90.0,2.3684210526315788,2.3684210526315788
1532,Giovani Lo Celso,ARG,"MF,FW",Tottenham,Premier League,25,1996,2.6,8,4,4,2,2,4,10,40.0,6,6,1,5,1,9,0,1,0,2021-2022,90.0,34.61538461538461,276.9230769230769
1533,Giovani Lo Celso,ARG,"FW,MF",Villarreal,La Liga,25,1996,11.0,22,12,8,10,4,9,22,40.9,13,4,0,4,5,27,3,0,0,2021-2022,90.0,40.909090909090914,180.0
1534,Julen Lobete,ESP,"FW,MF",Real Sociedad,La Liga,20,2000,3.2,4,3,3,0,1,1,2,50.0,1,6,1,5,1,5,1,0,0,2021-2022,90.0,28.125,112.5
1535,Stanislav Lobotka,SVK,MF,Napoli,Serie A,26,1994,18.7,39,24,16,20,3,14,36,38.9,22,9,1,8,12,51,13,1,0,2021-2022,90.0,57.75401069518716,187.70053475935828
1536,Jürgen Locadia,CUW,"MF,FW",Brighton,Premier League,27,1993,0.3,0,0,0,0,0,0,0,0.0,0,0,0,0,0,0,0,0,0,2021-2022,90.0,0.0,0.0
1537,Jürgen Locadia,CUW,"FW,MF",Bochum,Bundesliga,27,1993,4.9,4,2,1,0,3,1,1,100.0,0,1,0,1,1,5,2,0,0,2021-2022,90.0,18.36734693877551,73.46938775510203
1538,Manuel Locatelli,ITA,MF,Juventus,Serie A,23,1998,24.0,44,25,21,16,7,21,47,44.7,26,43,21,22,22,66,33,0,0,2021-2022,90.0,82.5,165.0
1539,Bradley Locko,FRA,"MF,DF",Reims,Ligue 1,19,2002,11.2,28,19,13,11,4,14,24,58.3,10,20,8,12,14,42,15,0,0,2021-2022,90.0,112.5,225.0
1540,Renan Lodi,BRA,DF,Atlético Madrid,La Liga,23,1998,13.1,31,18,14,13,4,11,27,40.7,16,22,4,18,13,44,19,1,0,2021-2022,90.0,89.31297709923665,212.97709923664124
1541,Ruben Loftus-Cheek,ENG,"MF,DF",Chelsea,Premier League,25,1996,15.5,29,10,16,11,2,10,19,52.6,9,15,6,9,11,40,17,0,0,2021-2022,90.0,63.87096774193549,168.38709677419354
1542,Kevin Long,IRL,DF,Burnley,Premier League,30,1990,4.6,3,2,1,2,0,1,2,50.0,1,4,1,3,1,4,20,0,0,2021-2022,90.0,19.565217391304348,58.69565217391305
1543,Shane Long,IRL,FW,Southampton,Premier League,34,1987,3.4,9,5,2,4,3,1,1,100.0,0,4,0,4,0,9,2,0,0,2021-2022,90.0,0.0,238.23529411764704
1544,Sean Longstaff,ENG,MF,Newcastle Utd,Premier League,23,1997,16.3,54,34,18,31,5,24,65,36.9,41,18,6,12,9,63,18,0,0,2021-2022,90.0,49.693251533742334,298.159509202454
1545,Ademola Lookman,NGA,"FW,MF",Leicester City,Premier League,23,1997,16.1,32,14,10,13,9,10,28,35.7,18,19,1,18,10,42,4,0,0,2021-2022,90.0,55.90062111801242,178.88198757763973
1546,Anthony Lopes,POR,GK,Lyon,Ligue 1,30,1990,33.1,0,0,0,0,0,0,0,0.0,0,0,0,0,3,3,12,3,0,2021-2022,90.0,8.157099697885196,0.0
1547,David López,ESP,"MF,DF",Espanyol,La Liga,31,1989,8.3,18,13,9,8,1,9,16,56.3,7,10,8,2,10,28,25,2,0,2021-2022,90.0,108.43373493975902,195.18072289156623
1548,Diego López,ESP,GK,Espanyol,La Liga,39,1981,35.3,0,0,0,0,0,0,2,0.0,2,0,0,0,1,1,21,1,0,2021-2022,90.0,2.54957507082153,0.0
1549,Javi López,ESP,DF,Alavés,La Liga,19,2002,5.1,8,6,6,2,0,4,6,66.7,2,7,1,6,4,12,15,0,0,2021-2022,90.0,70.58823529411765,141.1764705882353
1550,Maxime Lopez,FRA,MF,Sassuolo,Serie A,23,1997,32.6,69,36,40,27,2,35,87,40.2,52,33,7,26,42,111,38,1,0,2021-2022,90.0,115.95092024539878,190.49079754601226
Rk,Player,Nation,Pos,Squad,Comp,0,0,90.0,0,0,3,3,3,Tkl,0,0.0,0,0,0,0,0,0,0,0,0,2021-2022,90.0,0.0,0.0
1551,Pau López,ESP,GK,Marseille,Ligue 1,26,1994,29.0,0,0,0,0,0,0,1,0.0,1,0,0,0,0,0,12,1,0,2021-2022,90.0,0.0,0.0
1552,Unai López,ESP,MF,Rayo Vallecano,La Liga,25,1995,12.9,19,9,6,10,3,10,33,30.3,23,7,0,7,10,29,8,1,0,2021-2022,90.0,69.76744186046511,132.5581395348837
1553,Dion Lopy,SEN,MF,Reims,Ligue 1,19,2002,18.2,53,29,22,24,7,21,53,39.6,32,20,4,16,22,75,17,0,0,2021-2022,90.0,108.79120879120879,262.0879120879121
1554,Samuel Loric,FRA,DF,Lorient,Ligue 1,21,2000,3.0,7,5,2,3,2,5,8,62.5,3,2,0,2,5,12,9,0,0,2021-2022,90.0,150.0,210.0
1555,Anthony Losilla,FRA,MF,Bochum,Bundesliga,35,1986,32.6,65,39,29,30,6,34,69,49.3,35,32,9,23,70,135,53,1,0,2021-2022,90.0,193.25153374233128,179.4478527607362
1556,Jonas Lössl,DEN,GK,Brentford,Premier League,32,1989,2.0,0,0,0,0,0,0,0,0.0,0,0,0,0,0,0,1,0,0,2021-2022,90.0,0.0,0.0
1557,Marcel Lotka,POL,GK,Hertha BSC,Bundesliga,20,2001,9.8,1,0,1,0,0,1,1,100.0,0,0,0,0,1,2,3,3,0,2021-2022,90.0,9.183673469387754,9.183673469387754
1558,Jordan Lotomba,SUI,DF,Nice,Ligue 1,22,1998,19.8,33,17,21,9,3,16,30,53.3,14,17,4,13,12,45,28,0,0,2021-2022,90.0,54.54545454545455,150.0
1559,Johaneko Louisjean,FRA,DF,Bordeaux,Ligue 1,17,2004,0.1,0,0,0,0,0,0,0,0.0,0,0,0,0,0,0,0,0,0,2021-2022,90.0,0.0,0.0
1560,Mamadou Loum,SEN,MF,Alavés,La Liga,24,1996,25.7,49,22,26,22,1,17,45,37.8,28,30,11,19,37,86,68,1,0,2021-2022,90.0,129.57198443579767,171.5953307392996
1561,Imran Louza,MAR,MF,Watford,Premier League,22,1999,15.7,41,21,18,20,3,16,38,42.1,22,28,6,22,42,83,20,1,0,2021-2022,90.0,240.7643312101911,235.031847133758
1562,Matteo Lovato,ITA,DF,Atalanta,Serie A,21,2000,3.4,5,4,4,1,0,0,1,0.0,1,4,2,2,7,12,8,0,0,2021-2022,90.0,185.2941176470588,132.35294117647058
1563,Matteo Lovato,ITA,DF,Cagliari,Serie A,21,2000,13.8,23,15,13,10,0,8,20,40.0,12,21,10,11,28,51,43,0,0,2021-2022,90.0,182.6086956521739,149.99999999999997
1564,Eduard Löwen,GER,MF,Bochum,Bundesliga,24,1997,15.7,28,22,12,11,5,10,43,23.3,33,17,2,15,9,37,15,1,0,2021-2022,90.0,51.592356687898096,160.5095541401274
1565,Matthew Lowton,ENG,DF,Burnley,Premier League,32,1989,19.7,38,24,20,10,8,20,37,54.1,17,25,11,14,26,64,68,0,0,2021-2022,90.0,118.78172588832487,173.60406091370558
1566,Anthony Lozano,HON,"FW,MF",Cádiz,La Liga,28,1993,18.6,8,4,2,3,3,5,18,27.8,13,16,2,14,2,10,7,0,0,2021-2022,90.0,9.677419354838708,38.70967741935483
1567,Hirving Lozano,MEX,FW,Napoli,Serie A,26,1995,17.9,28,20,12,11,5,8,30,26.7,22,24,0,24,9,37,9,0,0,2021-2022,90.0,45.2513966480447,140.78212290502796
1568,Jean Lucas,BRA,MF,Monaco,Ligue 1,23,1998,16.1,43,25,14,24,5,17,40,42.5,23,15,5,10,13,56,4,1,0,2021-2022,90.0,72.67080745341615,240.3726708074534
1569,Anderson Lucoqui,ANG,DF,Mainz 05,Bundesliga,24,1997,8.3,22,10,11,6,5,11,22,50.0,11,15,3,12,11,33,10,0,0,2021-2022,90.0,119.27710843373492,238.55421686746985
1570,Florentino Luís,POR,MF,Getafe,La Liga,21,1999,11.0,42,25,22,17,3,17,35,48.6,18,21,2,19,21,63,11,1,0,2021-2022,90.0,171.8181818181818,343.6363636363636
1571,José Luis Gayà,ESP,DF,Valencia,La Liga,26,1995,20.8,35,21,24,10,1,16,34,47.1,18,17,3,14,19,54,37,0,0,2021-2022,90.0,82.21153846153845,151.44230769230768
1572,José Luis Morales,ESP,"FW,MF",Levante,La Liga,34,1987,30.2,27,17,6,9,12,12,42,28.6,30,29,0,29,4,31,7,0,0,2021-2022,90.0,11.920529801324504,80.4635761589404
1573,José Luis Palomino,ARG,DF,Atalanta,Serie A,31,1990,29.7,78,40,42,33,3,32,50,64.0,18,43,21,22,100,178,80,2,0,2021-2022,90.0,303.030303030303,236.36363636363635
1574,Luismi,ESP,"FW,MF",Sevilla,La Liga,20,2001,0.1,0,0,0,0,0,0,0,0.0,0,0,0,0,0,0,0,0,0,2021-2022,90.0,0.0,0.0
1575,Douglas Luiz,BRA,MF,Aston Villa,Premier League,23,1998,30.2,59,39,30,24,5,21,72,29.2,51,30,7,23,34,93,28,1,0,2021-2022,90.0,101.32450331125828,175.82781456953643
Rk,Player,Nation,Pos,Squad,Comp,0,0,90.0,0,0,3,3,3,Tkl,0,0.0,0,0,0,0,0,0,0,0,0,2021-2022,90.0,0.0,0.0
1576,Romelu Lukaku,BEL,FW,Chelsea,Premier League,28,1993,17.7,2,1,0,1,1,1,5,20.0,4,11,1,10,0,2,20,0,0,2021-2022,90.0,0.0,10.16949152542373
1577,Castello Lukeba,FRA,DF,Lyon,Ligue 1,18,2002,23.3,34,19,27,7,0,15,23,65.2,8,18,9,9,38,72,64,2,0,2021-2022,90.0,146.78111587982832,131.3304721030043
1578,Dodi Lukebakio,BEL,FW,Hertha BSC,Bundesliga,23,1997,2.0,2,1,2,0,0,1,3,33.3,2,2,0,2,2,4,0,0,0,2021-2022,90.0,90.0,90.0
1579,Dodi Lukebakio,BEL,"FW,MF",Wolfsburg,Bundesliga,23,1997,9.8,7,4,3,2,2,1,10,10.0,9,5,0,5,13,20,4,0,0,2021-2022,90.0,119.38775510204081,64.28571428571428
1580,Saša Lukić,SRB,MF,Torino,Serie A,24,1996,33.1,51,34,17,27,7,19,43,44.2,24,34,6,28,24,75,41,0,0,2021-2022,90.0,65.25679758308156,138.67069486404833
1581,Levi Lumeka,ENG,"DF,FW",Troyes,Ligue 1,22,1998,0.7,0,0,0,0,0,0,2,0.0,2,0,0,0,0,0,2,0,0,2021-2022,90.0,0.0,0.0
1582,Andriy Lunin,UKR,GK,Real Madrid,La Liga,22,1999,2.0,0,0,0,0,0,0,0,0.0,0,0,0,0,0,0,2,0,0,2021-2022,90.0,0.0,0.0
1583,Andrey Lunyov,RUS,GK,Leverkusen,Bundesliga,29,1991,1.0,0,0,0,0,0,0,0,0.0,0,0,0,0,0,0,0,0,0,2021-2022,90.0,0.0,0.0
1584,Sebastiano Luperto,ITA,DF,Empoli,Serie A,24,1996,21.8,29,17,17,10,2,10,20,50.0,10,32,26,6,45,74,132,0,0,2021-2022,90.0,185.77981651376146,119.72477064220183
1585,Andreas Luthe,GER,GK,Union Berlin,Bundesliga,34,1987,27.0,0,0,0,0,0,0,1,0.0,1,0,0,0,0,0,11,4,0,2021-2022,90.0,0.0,0.0
1586,Lyanco,BRA,DF,Southampton,Premier League,24,1997,10.1,18,15,11,7,0,10,18,55.6,8,18,13,5,13,31,50,1,0,2021-2022,90.0,115.84158415841584,160.3960396039604
1587,Charalambos Lykogiannis,GRE,"DF,FW",Cagliari,Serie A,27,1993,20.2,19,12,16,1,2,11,20,55.0,9,18,8,10,31,50,73,0,0,2021-2022,90.0,138.11881188118812,84.65346534653466
1588,Yannis M'Bemba,GAB,"DF,FW",Nantes,Ligue 1,20,2001,0.1,0,0,0,0,0,0,0,0.0,0,0,0,0,0,0,1,0,0,2021-2022,90.0,0.0,0.0
1589,Alexis Mac Allister,ARG,"MF,FW",Brighton,Premier League,22,1998,23.6,65,40,23,30,12,29,68,42.6,39,37,7,30,13,78,22,0,0,2021-2022,90.0,49.57627118644067,247.88135593220338
1590,Deiver Machado,COL,"DF,MF",Lens,Ligue 1,27,1993,5.8,16,14,11,1,4,12,14,85.7,2,9,1,8,3,19,12,1,0,2021-2022,90.0,46.55172413793103,248.27586206896552
1591,Darwin Machís,VEN,"MF,FW",Granada,La Liga,28,1993,15.3,23,13,11,8,4,9,23,39.1,14,10,0,10,15,38,17,0,0,2021-2022,90.0,88.23529411764706,135.2941176470588
1592,Yvann Macon,FRA,DF,Saint-Étienne,Ligue 1,22,1998,17.0,41,22,24,14,3,16,42,38.1,26,18,4,14,18,59,27,0,0,2021-2022,90.0,95.29411764705883,217.05882352941177
1593,James Maddison,ENG,"MF,FW",Leicester City,Premier League,24,1996,27.3,40,20,8,24,8,14,46,30.4,32,18,3,15,11,51,12,0,0,2021-2022,90.0,36.26373626373626,131.86813186813185
1594,Niki Mäenpää,FIN,GK,Venezia,Serie A,36,1985,16.5,0,0,0,0,0,0,0,0.0,0,0,0,0,0,0,8,2,0,2021-2022,90.0,0.0,0.0
1595,Pablo Maffeo,ESP,DF,Mallorca,La Liga,24,1997,32.7,84,47,48,28,8,38,69,55.1,31,30,13,17,46,130,74,0,0,2021-2022,90.0,126.60550458715596,231.1926605504587
1596,Louis Mafouta,CTA,FW,Metz,Ligue 1,27,1994,5.8,0,0,0,0,0,0,5,0.0,5,1,0,1,0,0,4,0,0,2021-2022,90.0,0.0,0.0
1597,Gabriel Magalhães,BRA,DF,Arsenal,Premier League,23,1997,34.0,50,30,36,12,2,30,41,73.2,11,34,26,8,13,63,112,4,0,2021-2022,90.0,34.411764705882355,132.35294117647058
1598,Giulio Maggiore,ITA,MF,Spezia,Serie A,23,1998,31.3,58,32,20,32,6,31,77,40.3,46,30,5,25,29,87,33,0,0,2021-2022,90.0,83.38658146964856,166.77316293929712
1599,Matej Maglica,CRO,MF,Stuttgart,Bundesliga,22,1998,0.1,0,0,0,0,0,0,1,0.0,1,0,0,0,0,0,0,0,0,2021-2022,90.0,0.0,0.0
1600,Francesco Magnanelli,ITA,MF,Sassuolo,Serie A,36,1984,3.0,5,4,4,1,0,1,9,11.1,8,3,1,2,1,6,3,0,0,2021-2022,90.0,30.0,150.0
Rk,Player,Nation,Pos,Squad,Comp,0,0,90.0,0,0,3,3,3,Tkl,0,0.0,0,0,0,0,0,0,0,0,0,2021-2022,90.0,0.0,0.0
1601,Giangiacomo Magnani,ITA,DF,Hellas Verona,Serie A,25,1995,5.9,10,7,5,5,0,8,16,50.0,8,5,3,2,10,20,46,0,0,2021-2022,90.0,152.54237288135593,152.54237288135593
1602,Giangiacomo Magnani,ITA,DF,Sampdoria,Serie A,25,1995,2.7,4,2,4,0,0,1,1,100.0,0,2,2,0,7,11,12,0,0,2021-2022,90.0,233.33333333333331,133.33333333333331
1603,Hugo Magnetti,FRA,MF,Brest,Ligue 1,23,1998,16.3,50,34,27,20,3,22,50,44.0,28,14,3,11,25,75,13,0,0,2021-2022,90.0,138.03680981595093,276.07361963190186
1604,Yohann Magnin,FRA,"MF,DF",Clermont Foot,Ligue 1,24,1997,19.1,53,31,22,26,5,24,42,57.1,18,17,7,10,20,73,36,0,0,2021-2022,90.0,94.24083769633508,249.73821989528795
1605,Harry Maguire,ENG,DF,Manchester Utd,Premier League,28,1993,27.9,34,21,22,8,4,19,31,61.3,12,36,29,7,32,66,101,3,0,2021-2022,90.0,103.22580645161291,109.6774193548387
1606,Riyad Mahrez,ALG,FW,Manchester City,Premier League,30,1991,16.6,11,3,5,4,2,5,19,26.3,14,15,1,14,6,17,6,0,0,2021-2022,90.0,32.53012048192771,59.63855421686746
1607,Arne Maier,GER,MF,Augsburg,Bundesliga,22,1999,20.7,20,13,6,10,4,8,26,30.8,18,18,1,17,15,35,13,0,0,2021-2022,90.0,65.21739130434783,86.95652173913044
1608,Habib Maïga,CIV,MF,Metz,Ligue 1,25,1996,14.1,47,28,29,13,5,24,48,50.0,24,20,7,13,14,61,18,0,0,2021-2022,89.99999999999999,89.36170212765957,300.0
1609,Mike Maignan,FRA,GK,Milan,Serie A,26,1995,32.0,2,1,2,0,0,2,2,100.0,0,0,0,0,1,3,4,2,0,2021-2022,90.0,2.8125,5.625
1610,Ainsley Maitland-Niles,ENG,MF,Arsenal,Premier League,23,1997,3.0,8,4,5,3,0,2,4,50.0,2,2,0,2,4,12,4,0,0,2021-2022,90.0,120.0,240.0
1611,Ainsley Maitland-Niles,ENG,DF,Roma,Serie A,23,1997,5.4,8,6,5,0,3,5,14,35.7,9,7,0,7,6,14,7,0,0,2021-2022,90.0,99.99999999999999,133.33333333333331
1612,Josh Maja,NGA,FW,Bordeaux,Ligue 1,22,1998,0.1,0,0,0,0,0,0,0,0.0,0,1,0,1,0,0,0,0,0,2021-2022,90.0,0.0,0.0
1613,Abdul Majeed Waris,GHA,"FW,MF",Strasbourg,Ligue 1,29,1991,3.6,5,3,2,3,0,5,10,50.0,5,2,0,2,0,5,1,0,0,2021-2022,90.0,0.0,125.0
1614,Lovro Majer,CRO,"MF,FW",Rennes,Ligue 1,23,1998,20.4,32,21,9,14,9,11,42,26.2,31,26,2,24,11,43,9,0,0,2021-2022,90.0,48.529411764705884,141.1764705882353
1615,Jean-Victor Makengo,FRA,MF,Udinese,Serie A,23,1998,26.1,30,21,7,17,6,15,29,51.7,14,26,6,20,19,49,17,0,0,2021-2022,90.0,65.51724137931033,103.44827586206895
1616,Béni Makouana,CGO,"FW,MF",Montpellier,Ligue 1,18,2002,3.6,2,2,0,0,2,0,1,0.0,1,1,0,1,3,5,2,0,0,2021-2022,90.0,75.0,50.0
1617,Nemanja Maksimović,SRB,MF,Getafe,La Liga,26,1995,32.6,56,32,24,26,6,18,49,36.7,31,42,13,29,71,127,41,0,0,2021-2022,90.0,196.01226993865032,154.60122699386503
1618,Nikola Maksimović,SRB,DF,Genoa,Serie A,29,1991,12.4,14,6,10,4,0,7,9,77.8,2,17,11,6,12,26,61,1,0,2021-2022,90.0,87.09677419354838,101.61290322580645
1619,Kévin Malcuit,MAR,"DF,MF",Napoli,Serie A,30,1991,3.2,4,2,4,0,0,2,2,100.0,0,3,0,3,8,12,6,0,0,2021-2022,90.0,225.0,112.5
1620,Daniel Maldini,ITA,MF,Milan,Serie A,19,2001,1.6,8,3,4,3,1,2,6,33.3,4,4,0,4,1,9,0,0,0,2021-2022,90.0,56.25,450.0
1621,Youssef Maleh,MAR,MF,Fiorentina,Serie A,22,1998,11.3,27,16,8,13,6,12,25,48.0,13,14,1,13,6,33,2,0,0,2021-2022,90.0,47.78761061946903,215.0442477876106
1622,Donyell Malen,NED,FW,Dortmund,Bundesliga,22,1999,18.7,13,10,4,5,4,7,13,53.8,6,10,0,10,10,23,11,0,0,2021-2022,90.0,48.1283422459893,62.56684491978609
1623,Ruslan Malinovskyi,UKR,"MF,FW",Atalanta,Serie A,28,1993,17.7,18,10,3,10,5,5,19,26.3,14,27,3,24,5,23,1,0,0,2021-2022,90.0,25.423728813559322,91.52542372881356
1624,Hugo Mallo,ESP,DF,Celta Vigo,La Liga,30,1991,20.3,45,25,24,19,2,16,31,51.6,15,23,9,14,20,65,53,0,0,2021-2022,90.0,88.66995073891626,199.50738916256157
1625,Lennard Maloney,USA,DF,Dortmund,Bundesliga,21,1999,0.1,1,0,1,0,0,1,1,100.0,0,0,0,0,0,1,0,0,0,2021-2022,90.0,0.0,900.0
Rk,Player,Nation,Pos,Squad,Comp,0,0,90.0,0,0,3,3,3,Tkl,0,0.0,0,0,0,0,0,0,0,0,0,2021-2022,90.0,0.0,0.0
1626,Mickael Malsa,MTQ,MF,Levante,La Liga,25,1995,12.7,37,17,16,18,3,15,42,35.7,27,20,8,12,18,55,15,0,0,2021-2022,90.0,127.55905511811024,262.20472440944883
1627,Giorgi Mamardashvili,GEO,GK,Valencia,La Liga,20,2000,18.0,0,0,0,0,0,0,0,0.0,0,0,0,0,0,0,6,1,0,2021-2022,90.0,0.0,0.0
1628,Rey Manaj,ALB,FW,Spezia,Serie A,24,1997,19.6,19,12,3,11,5,6,26,23.1,20,16,0,16,4,23,13,0,0,2021-2022,90.0,18.36734693877551,87.24489795918367
1629,Hianga Mananga Mbock,FRA,MF,Brest,Ligue 1,21,1999,8.9,18,12,8,7,3,9,21,42.9,12,5,2,3,5,23,6,0,0,2021-2022,90.0,50.56179775280899,182.02247191011236
1630,Vincent Manceau,FRA,DF,Angers,Ligue 1,32,1989,26.2,32,19,18,13,1,14,37,37.8,23,23,6,17,32,64,72,0,0,2021-2022,90.0,109.92366412213741,109.92366412213741
1631,Gianluca Mancini,ITA,DF,Roma,Serie A,25,1996,32.0,41,25,22,18,1,18,33,54.5,15,38,19,19,39,80,69,0,0,2021-2022,90.0,109.6875,115.3125
1632,Leonardo Mancuso,ITA,FW,Empoli,Serie A,29,1992,4.7,1,1,0,1,0,0,6,0.0,6,2,0,2,1,2,2,0,0,2021-2022,90.0,19.148936170212764,19.148936170212764
1633,Steve Mandanda,FRA,GK,Marseille,Ligue 1,36,1985,9.0,0,0,0,0,0,0,1,0.0,1,1,0,1,1,1,4,1,0,2021-2022,90.0,10.0,0.0
1634,Reinildo Mandava,MOZ,DF,Atlético Madrid,La Liga,27,1994,14.4,45,25,30,14,1,22,30,73.3,8,18,9,9,21,66,38,0,0,2021-2022,90.0,131.25,281.25
1635,Reinildo Mandava,MOZ,DF,Lille,Ligue 1,27,1994,16.9,43,23,29,11,3,32,51,62.7,19,13,4,9,37,80,55,0,0,2021-2022,90.0,197.0414201183432,228.9940828402367
1636,Aïssa Mandi,ALG,DF,Villarreal,La Liga,29,1991,15.3,11,5,2,8,1,3,6,50.0,3,17,14,3,13,24,49,3,0,2021-2022,90.0,76.47058823529412,64.70588235294117
1637,Rolando Mandragora,ITA,MF,Torino,Serie A,24,1997,14.7,21,10,3,16,2,12,21,57.1,9,18,4,14,10,31,13,0,0,2021-2022,90.0,61.224489795918366,128.57142857142858
1638,Anthony Mandrea,ALG,GK,Angers,Ligue 1,24,1996,10.0,0,0,0,0,0,0,0,0.0,0,0,0,0,0,0,9,0,0,2021-2022,90.0,0.0,0.0
1639,Sadio Mané,SEN,FW,Liverpool,Premier League,29,1992,31.3,33,20,7,14,12,8,26,30.8,18,30,1,29,8,41,15,0,0,2021-2022,90.0,23.003194888178914,94.88817891373802
1640,Eliaquim Mangala,FRA,DF,Saint-Étienne,Ligue 1,30,1991,13.1,17,12,12,5,0,8,12,66.7,4,11,8,3,17,34,61,1,0,2021-2022,90.0,116.79389312977099,116.79389312977099
1641,Orel Mangala,BEL,MF,Stuttgart,Bundesliga,23,1998,20.6,17,10,5,7,5,11,22,50.0,11,11,4,7,12,29,19,1,0,2021-2022,90.0,52.42718446601942,74.27184466019418
1642,Thomas Mangani,FRA,MF,Angers,Ligue 1,34,1987,24.4,58,30,23,34,1,31,68,45.6,37,38,11,27,36,94,29,0,0,2021-2022,90.0,132.78688524590166,213.93442622950823
1643,Ricardo Mangas,POR,DF,Bordeaux,Ligue 1,23,1998,26.1,35,22,22,8,5,26,41,63.4,15,18,4,14,25,60,47,3,0,2021-2022,90.0,86.20689655172413,120.68965517241378
1644,Kostas Manolas,GRE,DF,Napoli,Serie A,30,1991,3.5,2,2,1,1,0,2,3,66.7,1,2,1,1,4,6,10,1,0,2021-2022,90.0,102.85714285714286,51.42857142857143
1645,Javier Manquillo,ESP,DF,Newcastle Utd,Premier League,27,1994,14.0,39,29,28,10,1,21,36,58.3,15,15,6,9,10,49,32,0,0,2021-2022,90.0,64.28571428571428,250.71428571428572
1646,Myziane Maolida,COM,MF,Nice,Ligue 1,22,1999,0.4,1,0,0,1,0,0,0,0.0,0,1,0,1,0,1,0,0,0,2021-2022,90.0,0.0,225.0
1647,Myziane Maolida,COM,"FW,MF",Hertha BSC,Bundesliga,22,1999,8.6,7,4,5,1,1,3,9,33.3,6,5,0,5,1,8,6,0,0,2021-2022,90.0,10.465116279069768,73.25581395348838
1648,Sekou Mara,FRA,"FW,MF",Bordeaux,Ligue 1,19,2002,10.1,8,4,1,1,6,1,8,12.5,7,7,0,7,2,10,6,0,0,2021-2022,90.0,17.821782178217823,71.2871287128713
1649,Nikola Maraš,SRB,DF,Rayo Vallecano,La Liga,25,1995,11.6,13,9,12,1,0,9,15,60.0,6,17,13,4,15,28,51,0,0,2021-2022,90.0,116.37931034482759,100.86206896551724
1650,Fernando Marçal,BRA,"MF,DF",Wolves,Premier League,32,1989,16.1,42,22,27,14,1,21,37,56.8,16,25,4,21,28,70,52,0,0,2021-2022,90.0,156.52173913043478,234.78260869565216
Rk,Player,Nation,Pos,Squad,Comp,0,0,90.0,0,0,3,3,3,Tkl,0,0.0,0,0,0,0,0,0,0,0,0,2021-2022,90.0,0.0,0.0
1651,Marcelo,BRA,DF,Real Madrid,La Liga,33,1988,5.8,8,4,2,3,3,5,10,50.0,5,7,2,5,1,9,11,0,0,2021-2022,90.0,15.517241379310345,124.13793103448276
1652,Marcelo,BRA,DF,Bordeaux,Ligue 1,34,1987,10.0,9,5,7,2,0,4,6,66.7,2,4,3,1,13,22,46,1,0,2021-2022,90.0,117.0,81.0
1653,Marcelo,BRA,DF,Lyon,Ligue 1,34,1987,2.0,4,3,0,4,0,4,6,66.7,2,3,2,1,4,8,10,0,0,2021-2022,90.0,180.0,180.0
1654,Solly March,ENG,"DF,FW",Brighton,Premier League,27,1994,19.4,30,17,11,9,10,7,22,31.8,15,22,3,19,17,47,25,0,0,2021-2022,90.0,78.86597938144331,139.1752577319588
1655,Riccardo Marchizza,ITA,DF,Empoli,Serie A,23,1998,15.0,21,15,11,8,2,11,16,68.8,5,15,6,9,10,31,24,0,0,2021-2022,90.0,60.0,126.0
1656,Gian Marco Ferrari,ITA,DF,Sassuolo,Serie A,29,1992,34.7,16,11,10,6,0,10,23,43.5,13,37,27,10,43,59,114,2,0,2021-2022,90.0,111.52737752161381,41.498559077809794
1657,Iván Marcone,ARG,MF,Elche,La Liga,31,1990,9.0,24,14,17,6,1,12,24,50.0,12,8,3,5,12,36,13,0,0,2021-2022,90.0,120.0,240.0
1658,Óscar de Marcos,ESP,DF,Athletic Club,La Liga,32,1989,18.7,50,37,24,19,7,28,43,65.1,15,20,3,17,19,69,27,0,0,2021-2022,90.0,91.44385026737967,240.6417112299465
1659,Davide Marfella,ITA,GK,Napoli,Serie A,21,1999,0.1,0,0,0,0,0,0,0,0.0,0,0,0,0,0,0,0,0,0,2021-2022,90.0,0.0,0.0
1660,José Mari,ESP,MF,Cádiz,La Liga,33,1987,4.3,14,7,3,10,1,7,8,87.5,1,4,1,3,7,21,2,0,0,2021-2022,90.0,146.51162790697677,293.02325581395354
1661,Pablo Marí,ESP,DF,Arsenal,Premier League,27,1993,2.0,5,3,1,3,1,3,6,50.0,3,5,4,1,3,8,10,0,0,2021-2022,90.0,135.0,225.0
1662,Pablo Marí,ESP,DF,Udinese,Serie A,27,1993,14.9,16,8,8,6,2,8,16,50.0,8,18,12,6,21,37,72,0,0,2021-2022,90.0,126.84563758389261,96.64429530201342
1663,José María Giménez,URU,DF,Atlético Madrid,La Liga,26,1995,22.7,18,12,12,6,0,8,16,50.0,8,25,19,6,25,43,96,1,0,2021-2022,89.99999999999999,99.11894273127753,71.36563876651982
1664,Mariano,DOM,FW,Real Madrid,La Liga,27,1993,3.8,2,0,2,0,0,0,0,0.0,0,2,0,2,1,3,3,0,0,2021-2022,90.0,23.684210526315788,47.368421052631575
1665,Răzvan Marin,ROU,MF,Cagliari,Serie A,25,1996,31.3,42,21,16,22,4,24,54,44.4,30,23,5,18,10,52,17,1,0,2021-2022,90.0,28.75399361022364,120.76677316293929
1666,Guillermo Maripán,CHI,DF,Monaco,Ligue 1,27,1994,20.4,36,24,27,9,0,20,40,50.0,20,21,14,7,25,61,66,1,0,2021-2022,90.0,110.29411764705883,158.82352941176472
1667,Mika Màrmol,ESP,DF,Barcelona,La Liga,19,2002,0.0,0,0,0,0,0,0,0,0.0,0,0,0,0,0,0,0,0,0,2021-2022,,,
1668,Omar Marmoush,EGY,FW,Wolfsburg,Bundesliga,22,1999,0.3,0,0,0,0,0,0,0,0.0,0,0,0,0,0,0,0,0,0,2021-2022,90.0,0.0,0.0
1669,Omar Marmoush,EGY,FW,Stuttgart,Bundesliga,22,1999,17.5,26,17,6,14,6,4,20,20.0,16,9,1,8,7,33,6,0,0,2021-2022,90.0,36.0,133.71428571428572
1670,Marquinhos,BRA,DF,Paris S-G,Ligue 1,27,1994,31.8,37,14,25,11,1,20,35,57.1,15,35,19,16,16,53,102,0,0,2021-2022,90.0,45.283018867924525,104.71698113207547
1671,Roger Martí,ESP,FW,Levante,La Liga,30,1991,23.5,23,14,3,13,7,8,30,26.7,22,14,0,14,2,25,8,0,0,2021-2022,90.0,7.659574468085106,88.08510638297872
1672,Anthony Martial,FRA,FW,Manchester Utd,Premier League,25,1995,2.4,0,0,0,0,0,0,1,0.0,1,1,0,1,0,0,1,0,0,2021-2022,90.0,0.0,0.0
1673,Anthony Martial,FRA,"FW,MF",Sevilla,La Liga,25,1995,5.4,2,1,0,0,2,2,6,33.3,4,4,0,4,0,2,3,0,0,2021-2022,90.0,0.0,33.33333333333333
1674,Martín,ESP,MF,Cádiz,La Liga,22,1999,1.3,2,2,0,2,0,0,0,0.0,0,1,0,1,1,3,3,0,0,2021-2022,90.0,69.23076923076923,138.46153846153845
1675,Aarón Martín,ESP,DF,Mainz 05,Bundesliga,24,1997,25.5,54,33,32,18,4,24,55,43.6,31,24,4,20,20,74,35,0,0,2021-2022,90.0,70.58823529411765,190.58823529411765
Rk,Player,Nation,Pos,Squad,Comp,0,0,90.0,0,0,3,3,3,Tkl,0,0.0,0,0,0,0,0,0,0,0,0,2021-2022,90.0,0.0,0.0
1676,Ander Martin,ESP,"FW,MF",Real Sociedad,La Liga,20,2000,1.0,1,0,0,1,0,1,1,100.0,0,0,0,0,3,4,1,0,0,2021-2022,90.0,270.0,90.0
1677,Andrés Martín,ESP,"FW,MF",Rayo Vallecano,La Liga,22,1999,2.1,0,0,0,0,0,0,1,0.0,1,1,0,1,0,0,0,0,0,2021-2022,90.0,0.0,0.0
1678,Carlos Martín,ESP,DF,Atlético Madrid,La Liga,19,2002,0.1,0,0,0,0,0,0,0,0.0,0,0,0,0,0,0,1,0,0,2021-2022,90.0,0.0,0.0
1679,Iván Martín,ESP,"MF,FW",Alavés,La Liga,22,1999,1.8,1,1,1,0,0,0,1,0.0,1,2,0,2,1,2,1,0,0,2021-2022,90.0,50.0,50.0
1680,Jonas Martin,FRA,MF,Rennes,Ligue 1,31,1990,23.4,35,20,12,21,2,19,53,35.8,34,17,3,14,22,57,28,1,0,2021-2022,89.99999999999999,84.61538461538461,134.6153846153846
1681,Gabriel Martinelli,BRA,"FW,MF",Arsenal,Premier League,20,2001,20.7,27,19,7,14,6,10,29,34.5,19,26,1,25,20,47,15,0,0,2021-2022,90.0,86.95652173913044,117.3913043478261
1682,Emiliano Martínez,ARG,GK,Aston Villa,Premier League,28,1992,36.0,1,1,1,0,0,1,3,33.3,2,0,0,0,0,1,6,1,0,2021-2022,90.0,0.0,2.5
1683,Iñigo Martínez,ESP,DF,Athletic Club,La Liga,30,1991,26.0,28,13,18,7,3,14,23,60.9,9,22,10,12,39,67,143,0,0,2021-2022,90.00000000000001,135.0,96.92307692307693
1684,Javi Martínez,ESP,"MF,FW",Osasuna,La Liga,21,1999,9.8,21,14,8,11,2,10,29,34.5,19,6,0,6,9,30,10,0,0,2021-2022,90.0,82.65306122448979,192.85714285714283
1685,Josep Martinez,ESP,GK,RB Leipzig,Bundesliga,23,1998,1.0,0,0,0,0,0,0,0,0.0,0,0,0,0,0,0,0,0,0,2021-2022,90.0,0.0,0.0
1686,Lautaro Martínez,ARG,FW,Inter,Serie A,23,1997,25.4,20,10,3,10,7,6,11,54.5,5,21,1,20,18,38,6,0,0,2021-2022,90.0,63.77952755905512,70.86614173228347
1687,Pablo Martínez,ESP,MF,Levante,La Liga,23,1998,7.3,15,8,7,8,0,4,13,30.8,9,6,3,3,15,30,5,0,0,2021-2022,90.0,184.93150684931507,184.93150684931507
1688,Lucas Martínez Quarta,ARG,DF,Fiorentina,Serie A,25,1996,15.9,36,25,23,11,2,21,34,61.8,13,22,9,13,19,55,46,0,0,2021-2022,90.0,107.54716981132076,203.77358490566039
1689,Gelson Martins,POR,"MF,FW",Monaco,Ligue 1,26,1995,21.2,42,27,10,26,6,21,59,35.6,38,26,1,25,17,59,4,0,0,2021-2022,90.0,72.16981132075472,178.30188679245285
1690,Adam Marušić,MNE,DF,Lazio,Serie A,28,1992,30.2,30,18,16,12,2,13,32,40.6,19,19,8,11,41,71,71,0,0,2021-2022,90.0,122.18543046357615,89.40397350993378
1691,Omar Mascarell,EQG,MF,Elche,La Liga,28,1993,27.7,46,26,16,23,7,24,60,40.0,36,42,14,28,48,94,52,2,0,2021-2022,90.0,155.956678700361,149.45848375451266
1692,Andrea Masiello,ITA,DF,Genoa,Serie A,35,1986,5.7,5,3,4,1,0,4,7,57.1,3,8,4,4,11,16,20,1,0,2021-2022,90.0,173.68421052631578,78.94736842105263
1693,Adam Masina,MAR,DF,Watford,Premier League,27,1994,12.0,24,13,11,10,3,12,29,41.4,17,18,6,12,18,42,45,0,0,2021-2022,90.0,135.0,180.0
1694,Erhan Mašović,SRB,DF,Bochum,Bundesliga,22,1998,17.2,35,20,21,13,1,21,33,63.6,12,28,19,9,34,69,64,1,0,2021-2022,90.0,177.90697674418607,183.13953488372096
1695,Roberto Massimo,GER,"DF,FW",Stuttgart,Bundesliga,20,2000,9.7,14,5,6,7,1,4,16,25.0,12,9,0,9,3,17,6,0,0,2021-2022,90.0,27.835051546391757,129.89690721649487
1696,Arthur Masuaku,COD,"DF,FW",West Ham,Premier League,27,1993,7.2,31,23,19,11,1,14,23,60.9,9,9,1,8,9,40,17,0,0,2021-2022,90.0,112.5,387.5
1697,Jaime Mata,ESP,FW,Getafe,La Liga,32,1988,7.5,7,5,3,1,3,1,9,11.1,8,4,1,3,1,8,5,0,0,2021-2022,90.0,12.0,84.0
1698,Juan Mata,ESP,MF,Manchester Utd,Premier League,33,1988,2.6,6,4,2,3,1,3,5,60.0,2,1,0,1,1,7,1,0,0,2021-2022,90.0,34.61538461538461,207.69230769230768
1699,Pape Matar Sarr,SEN,MF,Metz,Ligue 1,18,2002,23.7,45,26,21,23,1,18,39,46.2,21,33,3,30,29,74,22,0,0,2021-2022,90.0,110.12658227848102,170.8860759493671
1700,Eliot Matazo,BEL,MF,Monaco,Ligue 1,19,2002,8.8,8,7,4,4,0,2,11,18.2,9,11,3,8,13,21,9,0,0,2021-2022,90.0,132.95454545454544,81.81818181818181
Rk,Player,Nation,Pos,Squad,Comp,0,0,90.0,0,0,3,3,3,Tkl,0,0.0,0,0,0,0,0,0,0,0,0,2021-2022,90.0,0.0,0.0
1701,Aleš Matějů,CZE,DF,Venezia,Serie A,25,1996,8.1,16,12,10,5,1,13,29,44.8,16,10,6,4,9,25,15,0,0,2021-2022,90.0,100.0,177.77777777777777
1702,Jean-Philippe Mateta,FRA,FW,Crystal Palace,Premier League,24,1997,12.7,8,4,2,5,1,3,18,16.7,15,11,3,8,4,12,13,0,0,2021-2022,90.0,28.34645669291339,56.69291338582678
1703,Nemanja Matić,SRB,MF,Manchester Utd,Premier League,32,1988,15.4,31,18,19,11,1,15,31,48.4,16,21,6,15,31,62,21,3,0,2021-2022,90.0,181.1688311688312,181.1688311688312
1704,Joël Matip,CMR,DF,Liverpool,Premier League,29,1991,31.0,47,34,23,19,5,20,31,64.5,11,26,14,12,44,91,93,1,0,2021-2022,90.0,127.74193548387098,136.4516129032258
1705,Chrislain Matsima,FRA,DF,Monaco,Ligue 1,19,2002,1.5,3,2,1,2,0,2,7,28.6,5,3,3,0,1,4,6,1,0,2021-2022,90.0,60.0,180.0
1706,Azor Matusiwa,NED,MF,Reims,Ligue 1,23,1998,27.4,58,32,28,26,4,26,55,47.3,29,49,19,30,62,120,43,0,0,2021-2022,90.0,203.64963503649636,190.5109489051095
1707,Neal Maupay,FRA,FW,Brighton,Premier League,24,1996,25.3,17,10,2,6,9,4,18,22.2,14,21,2,19,2,19,2,0,0,2021-2022,89.99999999999999,7.114624505928853,60.47430830039525
1708,Stephy Mavididi,ENG,"FW,MF",Montpellier,Ligue 1,23,1998,25.5,24,13,11,7,6,14,39,35.9,25,23,2,21,8,32,11,0,0,2021-2022,90.0,28.235294117647058,84.70588235294117
1709,Konstantinos Mavropanos,GRE,DF,Stuttgart,Bundesliga,23,1997,30.1,57,39,35,21,1,30,51,58.8,21,46,23,23,69,126,174,2,0,2021-2022,90.00000000000001,206.312292358804,170.43189368770766
1710,Eric Maxim Choupo-Moting,CMR,"FW,MF",Bayern Munich,Bundesliga,32,1989,4.2,10,9,3,6,1,3,10,30.0,7,1,0,1,5,15,2,0,0,2021-2022,90.0,107.14285714285714,214.28571428571428
1711,Luís Maximiano,POR,GK,Granada,La Liga,22,1999,34.8,3,1,3,0,0,3,6,50.0,3,0,0,0,1,4,16,2,0,2021-2022,90.0,2.586206896551724,7.758620689655173
1712,Borja Mayoral,ESP,"FW,DF",Roma,Serie A,24,1997,1.1,0,0,0,0,0,0,0,0.0,0,0,0,0,0,0,0,0,0,2021-2022,90.0,0.0,0.0
1713,Borja Mayoral,ESP,FW,Getafe,La Liga,24,1997,11.6,7,5,2,3,2,1,2,50.0,1,10,4,6,4,11,3,0,0,2021-2022,90.0,31.03448275862069,54.310344827586206
1714,Derek Mazou-Sacko,FRA,"FW,DF",Troyes,Ligue 1,16,2004,0.0,1,0,0,0,1,1,1,100.0,0,0,0,0,0,1,1,0,0,2021-2022,,,inf
1715,Pasquale Mazzocchi,ITA,DF,Venezia,Serie A,26,1995,13.8,18,8,11,4,3,10,26,38.5,16,11,8,3,21,39,31,1,0,2021-2022,90.0,136.9565217391304,117.39130434782608
1716,Pasquale Mazzocchi,ITA,DF,Salernitana,Serie A,26,1995,14.1,28,19,15,11,2,14,34,41.2,20,5,0,5,11,39,31,0,0,2021-2022,89.99999999999999,70.2127659574468,178.72340425531914
1717,Kevin Mbabu,SUI,DF,Wolfsburg,Bundesliga,26,1995,15.5,31,20,21,5,5,12,23,52.2,11,25,8,17,35,66,35,0,0,2021-2022,90.0,203.2258064516129,180.0
1718,Kylian Mbappé,FRA,FW,Paris S-G,Ligue 1,22,1998,33.6,11,8,1,4,6,7,13,53.8,6,6,0,6,5,16,13,0,0,2021-2022,90.0,13.392857142857142,29.46428571428571
1719,Ibrahima Mbaye,SEN,DF,Bologna,Serie A,26,1994,1.2,1,1,1,0,0,1,2,50.0,1,1,1,0,1,2,6,0,0,2021-2022,90.0,75.0,75.0
1720,Amadou Mbengue,SEN,"DF,MF",Metz,Ligue 1,19,2002,6.8,19,10,10,9,0,11,22,50.0,11,7,2,5,10,29,19,0,0,2021-2022,90.0,132.35294117647058,251.47058823529412
1721,Bryan Mbeumo,CMR,FW,Brentford,Premier League,21,1999,32.3,28,16,1,12,15,6,20,30.0,14,21,6,15,11,39,20,0,0,2021-2022,90.0,30.650154798761612,78.0185758513932
1722,Jason Mbock,FRA,FW,Angers,Ligue 1,21,1999,0.2,0,0,0,0,0,0,0,0.0,0,0,0,0,0,0,0,0,0,2021-2022,90.0,0.0,0.0
1723,Jordi Mboula,ESP,FW,Mallorca,La Liga,22,1999,4.8,8,2,3,3,2,5,9,55.6,4,7,1,6,3,11,3,0,0,2021-2022,90.0,56.25000000000001,150.0
1724,Moustapha Mbow,SEN,DF,Reims,Ligue 1,21,2000,1.0,6,6,3,2,1,3,3,100.0,0,0,0,0,1,7,6,0,0,2021-2022,90.0,90.0,540.0
1725,Nathanael Mbuku,FRA,"FW,MF",Reims,Ligue 1,19,2002,15.8,14,13,4,7,3,2,8,25.0,6,14,0,14,11,25,4,0,0,2021-2022,90.0,62.658227848101255,79.74683544303797
Rk,Player,Nation,Pos,Squad,Comp,0,0,90.0,0,0,3,3,3,Tkl,0,0.0,0,0,0,0,0,0,0,0,0,2021-2022,90.0,0.0,0.0
1726,James McArthur,SCO,MF,Crystal Palace,Premier League,33,1987,16.0,33,23,13,19,1,16,44,36.4,28,23,9,14,30,63,27,0,0,2021-2022,90.0,168.75,185.625
1727,James Mcatee,ENG,"MF,FW",Manchester City,Premier League,18,2002,0.2,0,0,0,0,0,0,2,0.0,2,0,0,0,0,0,0,0,0,2021-2022,90.0,0.0,0.0
1728,Kasey McAteer,ENG,FW,Leicester City,Premier League,19,2001,0.0,0,0,0,0,0,0,0,0.0,0,0,0,0,0,0,0,0,0,2021-2022,,,
1729,Liam McCarron,SCO,FW,Leeds United,Premier League,20,2001,0.1,0,0,0,0,0,0,0,0.0,0,1,0,1,0,0,0,0,0,2021-2022,90.0,0.0,0.0
1730,Alex McCarthy,ENG,GK,Southampton,Premier League,31,1989,17.0,0,0,0,0,0,0,0,0.0,0,0,0,0,0,0,4,0,0,2021-2022,90.0,0.0,0.0
1731,John McGinn,SCO,MF,Aston Villa,Premier League,26,1994,34.3,106,64,35,55,16,54,104,51.9,50,53,6,47,35,141,34,0,0,2021-2022,90.0,91.83673469387756,278.13411078717206
1732,Weston McKennie,USA,MF,Juventus,Serie A,22,1998,15.2,20,11,11,7,2,8,26,30.8,18,17,8,9,23,43,20,0,0,2021-2022,90.0,136.18421052631578,118.42105263157895
1733,Stuart McKinstry,SCO,MF,Leeds United,Premier League,18,2002,0.0,0,0,0,0,0,0,0,0.0,0,0,0,0,0,0,0,0,0,2021-2022,,,
1734,Kenny McLean,SCO,MF,Norwich City,Premier League,29,1992,30.1,42,22,18,20,4,17,59,28.8,42,29,7,22,34,76,54,0,0,2021-2022,90.00000000000001,101.66112956810632,125.58139534883722
1735,Dwight McNeil,ENG,MF,Burnley,Premier League,21,1999,34.5,78,49,27,38,13,33,73,45.2,40,64,11,53,35,113,31,1,0,2021-2022,90.0,91.30434782608695,203.4782608695652
1736,Scott McTominay,SCO,MF,Manchester Utd,Premier League,24,1996,26.5,65,33,32,24,9,30,61,49.2,31,45,10,35,31,96,60,1,0,2021-2022,90.0,105.28301886792453,220.75471698113208
1737,Gary Medel,CHI,DF,Bologna,Serie A,33,1987,31.4,39,23,27,11,1,16,36,44.4,20,30,21,9,44,83,112,0,0,2021-2022,90.0,126.11464968152868,111.78343949044587
1738,Facundo Medina,ARG,DF,Lens,Ligue 1,22,1999,28.8,61,42,34,23,4,38,62,61.3,24,24,8,16,37,98,78,3,0,2021-2022,90.0,115.625,190.625
1739,Nathan de Medina,BEL,DF,Arminia,Bundesliga,23,1997,8.6,17,10,11,6,0,6,10,60.0,4,14,3,11,10,27,28,0,0,2021-2022,90.0,104.65116279069768,177.90697674418607
1740,Ben Mee,ENG,DF,Burnley,Premier League,31,1989,20.4,26,12,16,7,3,12,19,63.2,7,28,22,6,24,50,94,1,0,2021-2022,90.0,105.88235294117648,114.70588235294119
1741,Admir Mehmedi,SUI,DF,Wolfsburg,Bundesliga,30,1991,0.0,0,0,0,0,0,0,0,0.0,0,0,0,0,0,0,0,0,0,2021-2022,,,
1742,Hannibal Mejbri,TUN,FW,Manchester Utd,Premier League,18,2003,0.8,2,1,1,1,0,1,1,100.0,0,0,0,0,0,2,0,0,0,2021-2022,90.0,0.0,225.0
1743,Farid El Melali,ALG,FW,Angers,Ligue 1,24,1997,0.2,0,0,0,0,0,0,1,0.0,1,1,0,1,0,0,1,0,0,2021-2022,90.0,0.0,0.0
1744,Filippo Melegoni,ITA,"MF,FW",Genoa,Serie A,22,1999,10.9,20,12,5,8,7,8,16,50.0,8,10,1,9,11,31,8,1,0,2021-2022,90.0,90.82568807339449,165.13761467889907
1745,Óscar Melendo,ESP,"MF,FW",Espanyol,La Liga,23,1997,11.0,11,5,4,4,3,3,13,23.1,10,4,1,3,1,12,10,0,0,2021-2022,90.0,8.181818181818182,90.0
1746,Gonzalo Melero,ESP,MF,Levante,La Liga,27,1994,18.8,29,16,10,15,4,16,36,44.4,20,21,8,13,7,36,22,0,0,2021-2022,90.0,33.51063829787234,138.82978723404256
1747,Birger Meling,NOR,DF,Rennes,Ligue 1,26,1994,20.3,43,27,25,11,7,23,31,74.2,8,23,7,16,22,65,40,0,0,2021-2022,90.0,97.53694581280787,190.64039408866995
1748,Arthur Melo,BRA,MF,Juventus,Serie A,24,1996,10.7,25,12,10,14,1,13,24,54.2,11,11,2,9,7,32,8,1,0,2021-2022,90.0,58.8785046728972,210.28037383177573
1749,Memphis,NED,FW,Barcelona,La Liga,27,1994,20.6,10,4,2,4,4,3,13,23.1,10,9,1,8,3,13,4,0,0,2021-2022,90.0,13.106796116504855,43.689320388349515
1750,Houboulang Mendes,GNB,DF,Lorient,Ligue 1,23,1998,35.8,58,28,37,18,3,40,57,70.2,17,41,21,20,41,99,128,4,0,2021-2022,90.0,103.07262569832403,145.8100558659218
Rk,Player,Nation,Pos,Squad,Comp,0,0,90.0,0,0,3,3,3,Tkl,0,0.0,0,0,0,0,0,0,0,0,0,2021-2022,90.0,0.0,0.0
1751,Nuno Mendes,POR,DF,Paris S-G,Ligue 1,19,2002,18.4,48,29,23,18,7,25,47,53.2,22,27,5,22,21,69,17,1,0,2021-2022,90.0,102.71739130434783,234.7826086956522
1752,Pedro Mendes,POR,DF,Montpellier,Ligue 1,30,1990,0.2,1,1,1,0,0,0,0,0.0,0,1,1,0,0,1,2,0,0,2021-2022,90.0,0.0,450.0
1753,Thiago Mendes,BRA,"MF,DF",Lyon,Ligue 1,29,1992,20.7,36,22,18,16,2,12,30,40.0,18,24,5,19,34,70,56,1,0,2021-2022,90.0,147.82608695652175,156.52173913043478
1754,Tomás Mendes,ESP,MF,Alavés,La Liga,16,2004,0.1,0,0,0,0,0,0,0,0.0,0,0,0,0,0,0,1,0,0,2021-2022,90.0,0.0,0.0
1755,Brais Méndez,ESP,MF,Celta Vigo,La Liga,24,1997,33.6,68,35,24,35,9,26,87,29.9,61,52,6,46,37,105,30,0,0,2021-2022,90.0,99.10714285714285,182.14285714285714
1756,Édgar Méndez,ESP,"FW,MF",Alavés,La Liga,31,1990,17.9,25,14,11,10,4,11,34,32.4,23,16,0,16,4,29,17,0,0,2021-2022,90.0,20.11173184357542,125.69832402234638
1757,Arial Mendy,SEN,"DF,FW",Clermont Foot,Ligue 1,26,1994,8.8,6,4,4,2,0,2,11,18.2,9,6,1,5,7,13,17,0,0,2021-2022,90.0,71.5909090909091,61.36363636363636
1758,Batista Mendy,FRA,"MF,DF",Angers,Ligue 1,21,2000,26.8,49,28,21,22,6,23,45,51.1,22,37,6,31,34,83,40,0,0,2021-2022,90.0,114.17910447761193,164.55223880597012
1759,Benjamin Mendy,FRA,DF,Manchester City,Premier League,27,1994,0.9,2,2,1,1,0,2,6,33.3,4,0,0,0,0,2,0,0,0,2021-2022,90.0,0.0,200.0
1760,Edouard Mendy,SEN,GK,Chelsea,Premier League,29,1992,34.0,1,0,1,0,0,1,3,33.3,2,0,0,0,0,1,13,4,0,2021-2022,90.0,0.0,2.6470588235294117
1761,Ferland Mendy,FRA,DF,Real Madrid,La Liga,26,1995,19.3,24,14,11,10,3,8,14,57.1,6,8,2,6,18,42,27,3,0,2021-2022,90.0,83.93782383419688,111.91709844559584
1762,Nampalys Mendy,SEN,MF,Leicester City,Premier League,29,1992,11.5,12,6,8,4,0,6,17,35.3,11,7,4,3,11,23,11,1,0,2021-2022,90.0,86.08695652173914,93.91304347826087
1763,Gideon Mensah,GHA,DF,Bordeaux,Ligue 1,23,1998,13.4,37,24,19,12,6,18,38,47.4,20,11,2,9,16,53,21,0,0,2021-2022,90.0,107.46268656716417,248.50746268656715
1764,Jorge Meré,ESP,DF,Köln,Bundesliga,24,1997,5.4,9,6,3,6,0,4,7,57.1,3,6,4,2,10,19,19,0,0,2021-2022,90.0,166.66666666666666,150.0
1765,Alex Meret,ITA,GK,Napoli,Serie A,24,1997,6.9,0,0,0,0,0,0,0,0.0,0,0,0,0,0,0,3,1,0,2021-2022,90.0,0.0,0.0
1766,Fran Mérida,ESP,MF,Espanyol,La Liga,31,1990,3.0,7,3,5,2,0,4,10,40.0,6,1,0,1,6,13,1,0,0,2021-2022,90.0,180.0,210.0
1767,Mikel Merino,ESP,MF,Real Sociedad,La Liga,25,1996,32.1,71,38,21,40,10,26,67,38.8,41,50,10,40,21,92,56,2,0,2021-2022,90.0,58.87850467289719,199.06542056074764
1768,Quentin Merlin,FRA,"DF,MF",Nantes,Ligue 1,19,2002,21.4,45,28,19,20,6,26,49,53.1,23,25,4,21,27,72,29,2,0,2021-2022,90.0,113.5514018691589,189.25233644859816
1769,Martín Merquelanz,ESP,"FW,MF",Rayo Vallecano,La Liga,26,1995,1.9,2,1,2,0,0,2,6,33.3,4,2,0,2,0,2,1,0,0,2021-2022,90.0,0.0,94.73684210526315
1770,Yıldırım Mert Çetin,TUR,MF,Hellas Verona,Serie A,24,1997,0.5,1,0,1,0,0,1,1,100.0,0,0,0,0,0,1,2,0,0,2021-2022,90.0,0.0,180.0
1771,Dries Mertens,BEL,"FW,MF",Napoli,Serie A,34,1987,15.4,16,7,1,11,4,3,16,18.8,13,8,2,6,9,25,2,0,0,2021-2022,90.0,52.5974025974026,93.50649350649351
1772,Illan Meslier,FRA,GK,Leeds United,Premier League,21,2000,37.6,1,1,1,0,0,1,1,100.0,0,0,0,0,0,1,27,1,0,2021-2022,90.0,0.0,2.3936170212765955
1773,Lionel Messi,ARG,"FW,MF",Paris S-G,Ligue 1,34,1987,23.9,10,3,1,5,4,3,13,23.1,10,5,0,5,4,14,0,0,0,2021-2022,90.0,15.062761506276152,37.65690376569038
1774,Junior Messias,BRA,"FW,MF",Milan,Serie A,30,1991,15.9,34,18,11,14,9,15,34,44.1,19,11,1,10,17,51,17,0,0,2021-2022,90.0,96.22641509433963,192.45283018867926
1775,Thomas Meunier,BEL,DF,Dortmund,Bundesliga,29,1991,15.6,29,19,13,12,4,16,33,48.5,17,10,2,8,12,41,25,1,0,2021-2022,90.0,69.23076923076923,167.3076923076923
Rk,Player,Nation,Pos,Squad,Comp,0,0,90.0,0,0,3,3,3,Tkl,0,0.0,0,0,0,0,0,0,0,0,0,2021-2022,90.0,0.0,0.0
1776,Mexer,MOZ,DF,Bordeaux,Ligue 1,32,1988,13.6,14,10,11,3,0,11,17,64.7,6,12,7,5,21,35,60,2,0,2021-2022,90.0,138.97058823529412,92.6470588235294
1777,Marco Meyerhöfer,GER,DF,Greuther Fürth,Bundesliga,25,1995,25.3,53,35,22,22,9,24,37,64.9,13,38,19,19,47,100,64,1,0,2021-2022,89.99999999999999,167.19367588932803,188.5375494071146
1778,Matt Miazga,USA,DF,Alavés,La Liga,26,1995,9.3,7,7,3,4,0,2,7,28.6,5,14,12,2,11,18,55,1,0,2021-2022,90.0,106.4516129032258,67.74193548387096
1779,Kingsley Michael,NGA,MF,Bologna,Serie A,21,1999,0.8,4,1,2,2,0,1,2,50.0,1,2,1,1,1,5,1,1,0,2021-2022,90.0,112.5,450.0
1780,Sven Michel,GER,FW,Union Berlin,Bundesliga,31,1990,3.8,10,6,5,3,2,2,8,25.0,6,3,0,3,1,11,1,0,0,2021-2022,90.0,23.684210526315788,236.8421052631579
1781,Edouard Michut,FRA,MF,Paris S-G,Ligue 1,18,2003,0.8,0,0,0,0,0,0,2,0.0,2,2,0,2,1,1,2,0,0,2021-2022,90.0,112.5,0.0
1782,Miguel,ESP,"FW,MF",Alavés,La Liga,21,1999,9.2,7,3,1,5,1,2,15,13.3,13,6,0,6,1,8,7,0,0,2021-2022,90.0,9.782608695652174,68.47826086956522
1783,Valentin Mihaila,ROU,"MF,FW",Atalanta,Serie A,21,2000,0.8,1,1,0,1,0,0,1,0.0,1,2,0,2,0,1,0,0,0,2021-2022,90.0,0.0,112.5
1784,Mikael,BRA,"FW,MF",Salernitana,Serie A,22,1999,1.0,1,1,0,1,0,0,0,0.0,0,0,0,0,0,1,1,0,0,2021-2022,90.0,0.0,90.0
1785,Hilmir Mikaelsson,ISL,FW,Venezia,Serie A,17,2004,0.2,2,0,0,1,1,0,0,0.0,0,0,0,0,0,2,0,0,0,2021-2022,90.0,0.0,900.0
1786,Georges Mikautadze,GEO,FW,Metz,Ligue 1,20,2000,0.0,0,0,0,0,0,0,0,0.0,0,0,0,0,0,0,0,0,0,2021-2022,,,
1787,William Mikelbrencis,FRA,DF,Metz,Ligue 1,17,2004,6.8,11,5,6,4,1,6,9,66.7,3,6,3,3,5,16,9,0,0,2021-2022,90.0,66.17647058823529,145.58823529411765
1788,Nikola Milenković,SRB,DF,Fiorentina,Serie A,23,1997,32.5,54,32,31,20,3,29,34,85.3,5,30,15,15,39,93,94,0,0,2021-2022,90.0,108.0,149.53846153846155
1789,Arkadiusz Milik,POL,FW,Marseille,Ligue 1,27,1994,15.7,9,2,0,5,4,4,18,22.2,14,9,1,8,3,12,10,1,0,2021-2022,90.0,17.197452229299365,51.592356687898096
1790,Sergej Milinković-Savić,SRB,MF,Lazio,Serie A,26,1995,34.4,67,44,20,32,15,29,67,43.3,38,50,9,41,34,101,43,1,0,2021-2022,90.0,88.95348837209303,175.29069767441862
1791,Vanja Milinković-Savić,SRB,GK,Torino,Serie A,24,1997,27.0,0,0,0,0,0,0,1,0.0,1,0,0,0,0,0,7,2,0,2021-2022,90.0,0.0,0.0
1792,Éder Militão,BRA,DF,Real Madrid,La Liga,23,1998,33.7,50,32,30,12,8,20,39,51.3,19,42,20,22,52,102,107,3,0,2021-2022,90.0,138.87240356083086,133.53115727002967
1793,Luka Milivojević,SRB,MF,Crystal Palace,Premier League,30,1991,8.6,18,9,9,6,3,10,16,62.5,6,6,1,5,11,29,15,0,0,2021-2022,90.0,115.11627906976746,188.37209302325584
1794,Luis Milla,ESP,MF,Granada,La Liga,26,1994,30.8,59,29,25,30,4,25,64,39.1,39,28,4,24,25,84,34,0,0,2021-2022,90.0,73.05194805194806,172.40259740259742
1795,Pere Milla,ESP,"MF,FW",Elche,La Liga,28,1992,18.3,20,15,14,5,1,8,44,18.2,36,21,1,20,5,25,21,0,0,2021-2022,90.0,24.59016393442623,98.36065573770492
1796,Enzo Millot,FRA,MF,Stuttgart,Bundesliga,19,2002,0.6,2,0,0,2,0,0,1,0.0,1,0,0,0,1,3,1,0,0,2021-2022,90.0,150.0,300.0
1797,James Milner,ENG,"MF,DF",Liverpool,Premier League,35,1986,9.5,28,16,12,11,5,12,29,41.4,17,19,5,14,17,45,20,0,0,2021-2022,90.0,161.05263157894737,265.2631578947368
1798,Santi Mina,ESP,FW,Celta Vigo,La Liga,25,1995,26.3,27,17,8,15,4,5,32,15.6,27,28,2,26,6,33,22,0,0,2021-2022,90.0,20.53231939163498,92.39543726235742
1799,Yerry Mina,COL,DF,Everton,Premier League,26,1994,9.4,12,10,12,0,0,10,13,76.9,3,13,9,4,11,23,38,1,0,2021-2022,90.0,105.31914893617021,114.89361702127658
1800,Takumi Minamino,JPN,"FW,MF",Liverpool,Premier League,26,1995,2.1,3,2,1,1,1,2,8,25.0,6,2,0,2,1,4,2,0,0,2021-2022,90.0,42.857142857142854,128.57142857142856
Rk,Player,Nation,Pos,Squad,Comp,0,0,90.0,0,0,3,3,3,Tkl,0,0.0,0,0,0,0,0,0,0,0,0,2021-2022,90.0,0.0,0.0
1801,Tyrone Mings,ENG,DF,Aston Villa,Premier League,28,1993,35.4,23,12,17,3,3,14,22,63.6,8,47,30,17,46,69,153,2,0,2021-2022,90.0,116.94915254237289,58.47457627118644
1802,Óscar Mingueza,ESP,DF,Barcelona,La Liga,22,1999,9.9,25,11,12,11,2,16,23,69.6,7,5,0,5,9,34,22,1,0,2021-2022,90.0,81.81818181818181,227.27272727272728
1803,Rafa Mir,ESP,FW,Sevilla,La Liga,24,1997,20.1,4,3,1,1,2,0,11,0.0,11,4,3,1,0,4,17,0,0,2021-2022,90.0,0.0,17.91044776119403
1804,Jorge Miramón,ESP,DF,Levante,La Liga,32,1989,22.0,36,19,16,12,8,15,44,34.1,29,15,3,12,35,71,58,0,0,2021-2022,90.0,143.1818181818182,147.27272727272728
1805,Aleksei Miranchuk,RUS,"MF,FW",Atalanta,Serie A,25,1995,8.6,11,7,3,7,1,4,12,33.3,8,3,0,3,1,12,7,0,0,2021-2022,90.0,10.465116279069768,115.11627906976746
1806,Juan Miranda,ESP,DF,Betis,La Liga,21,2000,8.7,21,11,16,4,1,12,22,54.5,10,10,4,6,15,36,22,0,0,2021-2022,90.0,155.17241379310346,217.24137931034483
1807,Fabio Miretti,ITA,MF,Juventus,Serie A,17,2003,3.6,4,2,2,2,0,2,9,22.2,7,3,1,2,2,6,3,0,0,2021-2022,90.0,50.0,100.0
1808,Tyrick Mitchell,ENG,DF,Crystal Palace,Premier League,21,1999,34.5,104,57,67,26,11,46,67,68.7,21,47,5,42,41,145,101,0,0,2021-2022,90.0,106.95652173913042,271.30434782608694
1809,Stefan Mitrović,SRB,DF,Getafe,La Liga,31,1990,29.6,16,8,12,4,0,8,13,61.5,5,28,18,10,22,38,114,1,0,2021-2022,90.0,66.89189189189189,48.648648648648646
1810,Maximilian Mittelstädt,GER,"DF,FW",Hertha BSC,Bundesliga,24,1997,16.6,52,33,30,12,10,26,50,52.0,24,28,5,23,46,98,37,0,0,2021-2022,90.0,249.39759036144576,281.92771084337346
1811,Henrikh Mkhitaryan,ARM,"MF,FW",Roma,Serie A,32,1989,27.7,45,29,11,27,7,17,52,32.7,35,33,2,31,22,67,33,0,0,2021-2022,90.0,71.48014440433214,146.20938628158845
1812,Jakub Moder,POL,MF,Brighton,Premier League,22,1999,18.9,42,25,18,17,7,23,42,54.8,19,25,2,23,10,52,22,1,0,2021-2022,90.0,47.61904761904762,200.0
1813,Anthony Modeste,FRA,FW,Köln,Bundesliga,33,1988,29.0,10,6,4,5,1,3,18,16.7,15,11,2,9,4,14,29,0,0,2021-2022,90.0,12.413793103448276,31.034482758620687
1814,Marco Modolo,ITA,DF,Venezia,Serie A,32,1989,4.4,6,3,4,2,0,2,5,40.0,3,6,6,0,4,10,26,0,0,2021-2022,90.0,81.81818181818181,122.72727272727272
1815,Luka Modrić,CRO,MF,Real Madrid,La Liga,35,1985,22.6,18,10,8,7,3,6,27,22.2,21,10,4,6,20,38,9,0,0,2021-2022,90.0,79.64601769911505,71.68141592920354
1816,Terem Moffi,NGA,FW,Lorient,Ligue 1,22,1999,30.1,17,10,3,12,2,9,32,28.1,23,11,2,9,4,21,22,0,0,2021-2022,90.00000000000001,11.960132890365449,50.83056478405316
1817,Kevin Möhwald,GER,MF,Union Berlin,Bundesliga,28,1993,3.9,7,1,3,3,1,1,7,14.3,6,3,0,3,3,10,6,0,0,2021-2022,90.0,69.23076923076923,161.53846153846152
1818,Dion Moise Sahi,CIV,"FW,MF",Strasbourg,Ligue 1,19,2001,1.4,0,0,0,0,0,0,0,0.0,0,1,0,1,1,1,1,0,0,2021-2022,90.0,64.28571428571429,0.0
1819,Johan Mojica,COL,DF,Elche,La Liga,28,1992,31.7,46,25,34,7,5,23,31,74.2,8,22,3,19,25,71,61,3,0,2021-2022,90.0,70.97791798107255,130.5993690851735
1820,Clinton Mola,ENG,DF,Stuttgart,Bundesliga,20,2001,1.3,3,1,2,1,0,2,4,50.0,2,5,5,0,3,6,2,0,0,2021-2022,90.0,207.69230769230768,207.69230769230768
1821,Jorge Molina,ESP,FW,Granada,La Liga,39,1982,21.8,4,2,2,1,1,2,18,11.1,16,13,2,11,6,10,11,0,0,2021-2022,90.0,24.77064220183486,16.513761467889907
1822,Nahuel Molina,ARG,DF,Udinese,Serie A,23,1998,29.3,41,24,17,21,3,16,48,33.3,32,24,3,21,22,63,44,2,0,2021-2022,90.0,67.57679180887372,125.93856655290102
1823,Cristian Molinaro,ITA,DF,Venezia,Serie A,38,1983,6.1,12,9,10,2,0,5,7,71.4,2,7,2,5,6,18,20,0,0,2021-2022,90.0,88.52459016393443,177.04918032786887
1824,Florent Mollet,FRA,"FW,MF",Montpellier,Ligue 1,29,1991,29.2,31,22,14,12,5,14,57,24.6,43,27,4,23,24,55,13,0,0,2021-2022,90.0,73.97260273972603,95.54794520547946
1825,Jon Moncayola,ESP,MF,Osasuna,La Liga,23,1998,32.4,40,20,18,18,4,17,44,38.6,27,26,9,17,20,60,43,0,0,2021-2022,90.0,55.55555555555556,111.11111111111111
Rk,Player,Nation,Pos,Squad,Comp,0,0,90.0,0,0,3,3,3,Tkl,0,0.0,0,0,0,0,0,0,0,0,0,2021-2022,90.0,0.0,0.0
1826,Monchu,ESP,MF,Granada,La Liga,21,1999,7.4,15,6,5,9,1,5,10,50.0,5,8,3,5,4,19,4,0,0,2021-2022,90.0,48.648648648648646,182.43243243243242
1827,Thomas Monconduit,FRA,MF,Lorient,Ligue 1,30,1991,25.0,41,25,19,17,5,20,57,35.1,37,21,10,11,22,63,51,1,0,2021-2022,90.0,79.2,147.6
1828,Gonzalo Montiel,ARG,DF,Sevilla,La Liga,24,1997,11.8,15,4,8,5,2,12,24,50.0,12,8,2,6,10,25,22,0,0,2021-2022,90.0,76.27118644067797,114.40677966101694
1829,Lorenzo Montipò,ITA,GK,Hellas Verona,Serie A,25,1996,34.0,0,0,0,0,0,0,0,0.0,0,0,0,0,1,1,16,3,0,2021-2022,90.0,2.6470588235294117,0.0
1830,Ángel Montoro,ESP,MF,Granada,La Liga,33,1988,14.8,26,13,16,7,3,17,27,63.0,10,11,1,10,11,37,29,1,0,2021-2022,90.0,66.89189189189189,158.1081081081081
1831,Martín Montoya,ESP,DF,Betis,La Liga,30,1991,5.8,20,12,11,7,2,15,26,57.7,11,6,0,6,11,31,20,0,0,2021-2022,90.0,170.6896551724138,310.3448275862069
1832,Wesley Moraes,BRA,FW,Aston Villa,Premier League,24,1996,0.0,0,0,0,0,0,0,0,0.0,0,0,0,0,0,0,0,0,0,2021-2022,,,
1833,Álvaro Morata,ESP,FW,Juventus,Serie A,28,1992,25.6,18,9,4,9,5,8,31,25.8,23,26,1,25,5,23,24,0,0,2021-2022,90.0,17.578125,63.28125
1834,Jan Morávek,CZE,MF,Augsburg,Bundesliga,31,1989,5.2,11,6,3,7,1,6,18,33.3,12,11,2,9,6,17,8,0,0,2021-2022,90.0,103.84615384615384,190.38461538461536
1835,Jon Morcillo,ESP,"MF,FW",Athletic Club,La Liga,22,1998,0.6,3,0,1,2,0,3,4,75.0,1,1,0,1,0,3,0,0,0,2021-2022,90.0,0.0,450.00000000000006
1836,Jérémy Morel,MAD,DF,Lorient,Ligue 1,37,1984,6.7,13,9,8,4,1,6,6,100.0,0,9,7,2,7,20,31,0,0,2021-2022,90.0,94.02985074626865,174.62686567164178
1837,Alberto Moreno,ESP,"MF,DF",Villarreal,La Liga,29,1992,13.6,13,7,5,7,1,5,18,27.8,13,13,1,12,27,40,15,0,0,2021-2022,90.0,178.6764705882353,86.02941176470588
1838,Álex Moreno,ESP,DF,Betis,La Liga,28,1993,26.7,76,40,53,15,8,33,60,55.0,27,28,6,22,34,110,82,1,0,2021-2022,90.00000000000001,114.60674157303372,256.1797752808989
1839,Gerard Moreno,ESP,FW,Villarreal,La Liga,29,1992,13.2,5,2,2,2,1,1,7,14.3,6,6,1,5,6,11,14,0,0,2021-2022,90.0,40.90909090909091,34.09090909090909
1840,Tete Morente,ESP,MF,Elche,La Liga,24,1996,18.1,21,14,13,7,1,7,28,25.0,21,30,1,29,12,33,12,0,0,2021-2022,90.0,59.66850828729281,104.41988950276242
1841,Ilaix Moriba,GUI,MF,Valencia,La Liga,18,2003,9.1,26,18,10,13,3,14,35,40.0,21,15,0,15,12,38,14,0,0,2021-2022,90.0,118.68131868131869,257.14285714285717
1842,Ilaix Moriba,GUI,MF,RB Leipzig,Bundesliga,18,2003,0.4,0,0,0,0,0,0,4,0.0,4,2,0,2,1,1,0,0,0,2021-2022,90.0,225.0,0.0
1843,Manu Morlanes,ESP,MF,Espanyol,La Liga,22,1999,12.7,36,15,16,17,3,18,43,41.9,25,24,5,19,13,49,17,0,0,2021-2022,90.0,92.1259842519685,255.11811023622047
1844,Raúl Moro,ESP,FW,Lazio,Serie A,18,2002,2.2,3,3,0,2,1,1,5,20.0,4,2,0,2,0,3,0,0,0,2021-2022,90.0,0.0,122.72727272727272
1845,Loren Morón,ESP,"FW,MF",Espanyol,La Liga,27,1993,6.3,6,4,1,3,2,0,12,0.0,12,11,1,10,2,8,9,0,0,2021-2022,90.0,28.571428571428573,85.71428571428572
1846,Loren Morón,ESP,FW,Betis,La Liga,27,1993,0.0,1,1,1,0,0,1,1,100.0,0,0,0,0,0,1,0,0,0,2021-2022,,,inf
1847,Tyler Morton,ENG,MF,Liverpool,Premier League,18,2002,0.7,0,0,0,0,0,0,2,0.0,2,0,0,0,3,3,0,0,0,2021-2022,90.0,385.7142857142857,0.0
1848,Cristhian Mosquera,ESP,DF,Valencia,La Liga,17,2004,2.4,4,2,3,0,1,3,6,50.0,3,1,0,1,3,7,1,1,0,2021-2022,90.0,112.50000000000001,150.0
1849,Lebo Mothiba,RSA,"FW,MF",Troyes,Ligue 1,25,1996,5.8,8,4,4,3,1,2,5,40.0,3,3,0,3,2,10,0,0,0,2021-2022,90.0,31.03448275862069,124.13793103448276
1850,Lebo Mothiba,RSA,FW,Strasbourg,Ligue 1,25,1996,0.0,0,0,0,0,0,0,0,0.0,0,0,0,0,0,0,0,0,0,2021-2022,,,
Rk,Player,Nation,Pos,Squad,Comp,0,0,90.0,0,0,3,3,3,Tkl,0,0.0,0,0,0,0,0,0,0,0,0,2021-2022,90.0,0.0,0.0
1851,Andrei Motoc,ROU,DF,Salernitana,Serie A,19,2002,1.0,1,1,0,1,0,0,0,0.0,0,2,2,0,2,3,1,0,0,2021-2022,90.0,180.0,90.0
1852,Baptiste Mouazan,FRA,MF,Lorient,Ligue 1,19,2001,1.1,4,3,2,2,0,1,3,33.3,2,3,0,3,1,5,1,0,0,2021-2022,90.0,81.81818181818181,327.27272727272725
1853,Aimen Moueffek,FRA,MF,Saint-Étienne,Ligue 1,20,2001,4.8,7,4,2,3,2,2,8,25.0,6,3,0,3,2,9,4,0,0,2021-2022,90.0,37.5,131.25
1854,Youssoufa Moukoko,GER,"FW,MF",Dortmund,Bundesliga,16,2004,2.5,1,0,0,1,0,0,1,0.0,1,5,0,5,3,4,0,0,0,2021-2022,90.0,108.0,36.0
1855,Harold Moukoudi,CMR,DF,Saint-Étienne,Ligue 1,23,1997,18.5,25,12,17,8,0,14,25,56.0,11,27,14,13,35,60,48,0,0,2021-2022,90.0,170.2702702702703,121.62162162162163
1856,Jessy Moulin,FRA,GK,Troyes,Ligue 1,35,1986,7.0,0,0,0,0,0,0,0,0.0,0,0,0,0,1,1,7,0,0,2021-2022,90.0,12.857142857142858,0.0
1857,Steve Mounié,BEN,FW,Brest,Ligue 1,26,1994,25.7,17,6,3,12,2,4,27,14.8,23,13,1,12,6,23,12,0,0,2021-2022,90.0,21.011673151750973,59.53307392996109
1858,Mason Mount,ENG,MF,Chelsea,Premier League,22,1999,26.3,41,16,10,17,14,10,34,29.4,24,18,1,17,13,54,12,0,0,2021-2022,90.0,44.48669201520913,140.3041825095057
1859,Lucas Moura,BRA,"FW,MF",Tottenham,Premier League,28,1992,19.7,25,10,7,14,4,8,35,22.9,27,19,0,19,18,43,19,0,0,2021-2022,90.0,82.23350253807106,114.21319796954315
1860,Lys Mousset,FRA,"MF,FW",Salernitana,Serie A,25,1996,1.8,1,0,0,1,0,0,0,0.0,0,2,0,2,0,1,0,0,0,2021-2022,90.0,0.0,50.0
1861,João Moutinho,POR,MF,Wolves,Premier League,34,1986,33.0,74,39,34,27,13,30,106,28.3,76,48,8,40,34,108,36,2,0,2021-2022,90.0,92.72727272727273,201.81818181818184
1862,Samuel Moutoussamy,COD,MF,Nantes,Ligue 1,24,1996,16.8,48,32,20,20,8,23,62,37.1,39,14,2,12,17,65,16,0,0,2021-2022,90.0,91.07142857142857,257.1428571428571
1863,Toni Moya,ESP,MF,Alavés,La Liga,23,1998,15.4,23,10,7,13,3,13,43,30.2,30,18,5,13,20,43,18,0,0,2021-2022,90.0,116.88311688311688,134.41558441558442
1864,Samuel Mráz,SVK,FW,Spezia,Serie A,24,1997,0.6,0,0,0,0,0,0,0,0.0,0,1,0,1,0,0,0,0,0,2021-2022,90.0,0.0,0.0
1865,Nordi Mukiele,FRA,"DF,FW",RB Leipzig,Bundesliga,23,1997,20.5,35,22,23,9,3,14,27,51.9,13,31,5,26,31,66,44,2,0,2021-2022,90.0,136.09756097560975,153.65853658536585
1866,Mert Müldür,TUR,DF,Sassuolo,Serie A,22,1999,22.7,52,35,43,7,2,27,49,55.1,22,25,6,19,24,76,44,1,0,2021-2022,89.99999999999999,95.15418502202643,206.16740088105726
1867,Florian Müller,GER,GK,Stuttgart,Bundesliga,23,1997,30.0,0,0,0,0,0,0,1,0.0,1,1,0,1,0,0,13,2,0,2021-2022,90.0,0.0,0.0
1868,Thomas Müller,GER,MF,Bayern Munich,Bundesliga,31,1989,28.4,35,20,7,16,12,16,54,29.6,38,32,1,31,15,50,12,0,0,2021-2022,90.0,47.53521126760564,110.91549295774648
1869,Bali Mumba,ENG,DF,Norwich City,Premier League,19,2001,0.5,1,1,1,0,0,0,0,0.0,0,0,0,0,0,1,5,0,0,2021-2022,90.0,0.0,180.0
1870,Marshall Munetsi,ZIM,"MF,DF",Reims,Ligue 1,25,1996,20.9,34,17,21,11,2,17,39,43.6,22,39,13,26,43,77,72,2,0,2021-2022,90.0,185.16746411483254,146.41148325358853
1871,Iker Muniain,ESP,MF,Athletic Club,La Liga,28,1992,30.9,32,10,8,19,5,12,40,30.0,28,20,1,19,17,49,8,1,0,2021-2022,90.0,49.51456310679612,93.20388349514563
1872,Aihen Muñoz,ESP,DF,Real Sociedad,La Liga,23,1997,14.9,28,17,14,13,1,18,29,62.1,11,11,1,10,17,45,34,0,0,2021-2022,90.0,102.68456375838926,169.12751677852347
1873,Luis Muriel,COL,"FW,MF",Atalanta,Serie A,30,1991,17.1,15,4,2,7,6,3,19,15.8,16,12,0,12,4,19,5,0,0,2021-2022,90.0,21.05263157894737,78.94736842105263
1874,Jeison Murillo,COL,DF,Celta Vigo,La Liga,29,1992,12.4,15,10,13,2,0,9,13,69.2,4,11,8,3,17,32,37,0,0,2021-2022,90.0,123.38709677419355,108.87096774193549
1875,Vedat Muriqi,KVX,FW,Lazio,Serie A,27,1994,2.4,1,0,1,0,0,0,5,0.0,5,0,0,0,0,1,2,0,0,2021-2022,90.0,0.0,37.5
Rk,Player,Nation,Pos,Squad,Comp,0,0,90.0,0,0,3,3,3,Tkl,0,0.0,0,0,0,0,0,0,0,0,0,2021-2022,90.0,0.0,0.0
1876,Vedat Muriqi,KVX,FW,Mallorca,La Liga,27,1994,16.0,6,3,1,3,2,1,7,14.3,6,12,0,12,6,12,29,0,0,2021-2022,90.0,33.75,33.75
1877,Jacob Murphy,ENG,"FW,DF",Newcastle Utd,Premier League,26,1995,16.4,49,26,34,11,4,26,41,63.4,15,20,2,18,23,72,17,0,0,2021-2022,90.0,126.21951219512196,268.9024390243903
1878,Nicola Murru,ITA,DF,Sampdoria,Serie A,26,1994,10.9,22,17,10,11,1,8,13,61.5,5,17,3,14,7,29,20,1,0,2021-2022,90.0,57.798165137614674,181.65137614678898
1879,Yunus Musah,USA,"MF,FW",Valencia,La Liga,18,2002,14.0,23,13,8,8,7,6,20,30.0,14,19,1,18,14,37,11,0,0,2021-2022,90.0,90.0,147.85714285714286
1880,Torben Müsel,GER,MF,Gladbach,Bundesliga,22,1999,0.1,0,0,0,0,0,0,0,0.0,0,0,0,0,0,0,0,0,0,2021-2022,90.0,0.0,0.0
1881,Jamal Musiala,GER,"MF,FW",Bayern Munich,Bundesliga,18,2003,16.3,40,26,11,16,13,15,36,41.7,21,25,0,25,19,59,2,1,0,2021-2022,90.0,104.9079754601227,220.85889570552146
1882,Juan Musso,ARG,GK,Atalanta,Serie A,27,1994,32.6,1,1,1,0,0,0,0,0.0,0,0,0,0,0,1,17,1,0,2021-2022,90.0,0.0,2.7607361963190185
1883,Shkodran Mustafi,GER,DF,Levante,La Liga,29,1992,7.3,9,6,6,3,0,5,9,55.6,4,6,3,3,15,24,40,0,0,2021-2022,90.0,184.93150684931507,110.95890410958904
1884,Junior Mwanga,FRA,DF,Bordeaux,Ligue 1,18,2003,1.0,5,2,4,1,0,3,3,100.0,0,1,0,1,0,5,1,0,0,2021-2022,90.0,0.0,450.0
1885,Enock Mwepu,ZAM,MF,Brighton,Premier League,23,1998,11.1,22,12,10,10,2,5,27,18.5,22,20,2,18,12,34,19,0,0,2021-2022,90.0,97.2972972972973,178.3783783783784
1886,Vitaliy Mykolenko,UKR,DF,Everton,Premier League,22,1999,11.7,25,15,15,7,3,12,21,57.1,9,15,2,13,16,41,37,0,0,2021-2022,89.99999999999999,123.07692307692307,192.3076923076923
1887,Joakim Mæhle,DEN,"DF,MF",Atalanta,Serie A,24,1997,16.3,21,11,6,9,6,12,27,44.4,15,18,2,16,14,35,13,0,0,2021-2022,90.0,77.30061349693251,115.95092024539878
1888,Obite N'Dicka,CIV,DF,Eint Frankfurt,Bundesliga,21,1999,31.7,60,34,29,27,4,44,59,74.6,15,46,20,26,48,108,137,0,0,2021-2022,90.0,136.2776025236593,170.34700315457414
1889,Kévin N'Doram,FRA,MF,Metz,Ligue 1,25,1996,13.7,10,8,3,5,2,3,20,15.0,17,24,5,19,19,29,21,0,0,2021-2022,90.0,124.8175182481752,65.69343065693431
1890,Eric N'Jo,FRA,DF,Troyes,Ligue 1,17,2004,1.1,0,0,0,0,0,0,1,0.0,1,1,1,0,2,2,1,0,0,2021-2022,90.0,163.63636363636363,0.0
1891,Vital N'Simba,COD,DF,Clermont Foot,Ligue 1,28,1993,31.0,66,45,38,23,5,36,63,57.1,27,28,7,21,29,95,30,0,0,2021-2022,90.0,84.19354838709677,191.61290322580646
1892,Nacho,ESP,DF,Real Madrid,La Liga,31,1990,17.3,18,14,9,9,0,12,22,54.5,10,22,15,7,34,52,50,0,0,2021-2022,90.0,176.878612716763,93.64161849710982
1893,Mickael Nade,FRA,DF,Saint-Étienne,Ligue 1,22,1999,28.5,57,35,37,18,2,23,38,60.5,15,29,15,14,60,117,84,0,0,2021-2022,90.0,189.47368421052633,180.0
1894,Marvelous Nakamba,ZIM,MF,Aston Villa,Premier League,27,1994,10.0,32,19,18,14,0,12,34,35.3,22,14,4,10,12,44,17,1,0,2021-2022,90.0,108.0,288.0
1895,Nahitan Nández,URU,"MF,DF",Cagliari,Serie A,25,1995,16.9,39,21,16,15,8,18,33,54.5,15,16,1,15,9,48,15,1,0,2021-2022,90.0,47.92899408284024,207.6923076923077
1896,Nani,POR,"MF,FW",Venezia,Serie A,34,1986,3.2,2,1,1,1,0,0,1,0.0,1,1,0,1,2,4,0,1,0,2021-2022,90.0,56.25,56.25
1897,Paul Nardi,FRA,GK,Lorient,Ligue 1,27,1994,22.0,1,0,1,0,0,1,2,50.0,1,0,0,0,0,1,10,2,0,2021-2022,90.0,0.0,4.090909090909091
1898,Nikolas Nartey,DEN,"MF,DF",Stuttgart,Bundesliga,21,2000,4.5,6,3,0,5,1,3,9,33.3,6,4,2,2,7,13,5,0,0,2021-2022,90.0,140.0,120.0
1899,Matija Nastasić,SRB,DF,Fiorentina,Serie A,28,1993,2.4,1,1,1,0,0,1,1,100.0,0,1,1,0,5,6,11,0,0,2021-2022,90.0,187.5,37.5
1900,Roberto Navarro,ESP,"MF,FW",Real Sociedad,La Liga,19,2002,2.2,5,3,1,1,3,3,5,60.0,2,2,0,2,2,7,2,0,0,2021-2022,90.0,81.81818181818181,204.54545454545453
Rk,Player,Nation,Pos,Squad,Comp,0,0,90.0,0,0,3,3,3,Tkl,0,0.0,0,0,0,0,0,0,0,0,0,2021-2022,90.0,0.0,0.0
1901,Ximo Navarro,ESP,DF,Alavés,La Liga,31,1990,15.0,28,19,21,6,1,13,27,48.1,14,11,5,6,22,50,56,2,0,2021-2022,90.0,132.0,168.0
1902,Jesús Navas,ESP,DF,Sevilla,La Liga,35,1985,19.8,18,13,11,5,2,9,17,52.9,8,15,2,13,17,35,26,1,0,2021-2022,90.0,77.27272727272727,81.81818181818181
1903,Keylor Navas,CRC,GK,Paris S-G,Ligue 1,34,1986,20.6,0,0,0,0,0,0,0,0.0,0,0,0,0,0,0,5,1,0,2021-2022,90.0,0.0,0.0
1904,Papa Ndiaga Yade,MTN,"DF,FW",Metz,Ligue 1,21,2000,7.7,15,10,8,7,0,8,18,44.4,10,4,1,3,10,25,9,0,0,2021-2022,90.0,116.88311688311688,175.32467532467533
1905,Wilfred Ndidi,NGA,"MF,DF",Leicester City,Premier League,24,1996,18.0,60,32,32,27,1,22,55,40.0,33,36,8,28,42,102,54,1,0,2021-2022,90.0,210.0,300.0
1906,Tanguy Ndombele,FRA,MF,Tottenham,Premier League,24,1996,5.4,10,7,3,5,2,1,8,12.5,7,5,0,5,1,11,1,0,0,2021-2022,90.0,16.666666666666664,166.66666666666666
1907,Tanguy Ndombele,FRA,MF,Lyon,Ligue 1,24,1996,7.8,25,14,5,17,3,12,19,63.2,7,8,3,5,3,28,6,2,0,2021-2022,90.0,34.61538461538461,288.46153846153845
1908,Dan Ndoye,SUI,"FW,MF",Nice,Ligue 1,20,2000,2.3,0,0,0,0,0,0,2,0.0,2,4,0,4,0,0,0,0,0,2021-2022,90.0,0.0,0.0
1909,Paul Nebel,GER,"MF,FW",Mainz 05,Bundesliga,18,2002,2.5,5,3,3,1,1,2,3,66.7,1,0,0,0,0,5,1,0,0,2021-2022,90.0,0.0,180.0
1910,Álvaro Negredo,ESP,FW,Cádiz,La Liga,35,1985,24.0,5,3,1,4,0,3,6,50.0,3,11,5,6,2,7,23,0,0,2021-2022,90.0,7.5,18.75
1911,Reiss Nelson,ENG,FW,Arsenal,Premier League,21,1999,0.2,1,0,0,0,1,0,1,0.0,1,1,0,1,0,1,0,0,0,2021-2022,90.0,0.0,450.0
1912,David Nemeth,AUT,DF,Mainz 05,Bundesliga,20,2001,3.5,3,2,2,1,0,1,3,33.3,2,5,1,4,6,9,11,1,0,2021-2022,90.0,154.28571428571428,77.14285714285714
1913,Ilija Nestorovski,MKD,FW,Udinese,Serie A,31,1990,2.1,0,0,0,0,0,0,3,0.0,3,0,0,0,0,0,4,0,0,2021-2022,90.0,0.0,0.0
1914,Neto,BRA,GK,Barcelona,La Liga,32,1989,3.0,0,0,0,0,0,0,0,0.0,0,0,0,0,0,0,2,1,0,2021-2022,90.0,0.0,0.0
1915,Pedro Neto,POR,"FW,MF",Wolves,Premier League,21,2000,5.2,4,4,2,0,2,0,9,0.0,9,0,0,0,6,10,1,0,0,2021-2022,90.0,103.84615384615384,69.23076923076923
1916,Luca Netz,GER,"DF,FW",Gladbach,Bundesliga,18,2003,15.5,24,11,12,10,2,11,40,27.5,29,24,4,20,13,37,33,1,0,2021-2022,90.0,75.48387096774194,139.3548387096774
1917,Manuel Neuer,GER,GK,Bayern Munich,Bundesliga,35,1986,27.9,2,1,2,0,0,1,2,50.0,1,0,0,0,0,2,7,1,0,2021-2022,90.0,0.0,6.451612903225807
1918,Florian Neuhaus,GER,MF,Gladbach,Bundesliga,24,1997,23.6,55,28,24,26,5,27,64,42.2,37,38,6,32,31,86,19,4,0,2021-2022,90.0,118.22033898305084,209.7457627118644
1919,Carlos Neva,ESP,DF,Granada,La Liga,25,1996,23.4,31,19,24,7,0,16,28,57.1,12,27,9,18,32,63,81,0,0,2021-2022,89.99999999999999,123.07692307692307,119.23076923076923
1920,Rúben Neves,POR,MF,Wolves,Premier League,24,1997,29.6,68,37,23,41,4,24,87,27.6,63,39,5,34,41,109,49,3,0,2021-2022,90.0,124.66216216216216,206.75675675675674
1921,Neymar,BRA,"FW,MF",Paris S-G,Ligue 1,29,1992,20.6,29,19,5,12,12,12,36,33.3,24,9,1,8,4,33,2,1,0,2021-2022,90.0,17.475728155339805,126.69902912621359
1922,Yvan Neyou,CMR,MF,Saint-Étienne,Ligue 1,24,1997,10.4,29,13,14,12,3,9,27,33.3,18,8,3,5,23,52,13,0,0,2021-2022,90.0,199.03846153846152,250.96153846153845
1923,Jeremy Ngakia,ENG,DF,Watford,Premier League,20,2000,10.0,31,18,23,5,3,11,26,42.3,15,11,4,7,12,43,32,0,0,2021-2022,90.0,108.0,279.0
1924,Jessic Ngankam,GER,FW,Greuther Fürth,Bundesliga,21,2000,3.8,3,1,1,1,1,1,2,50.0,1,3,0,3,0,3,1,0,0,2021-2022,90.0,0.0,71.05263157894737
1925,Opa Nguette,SEN,"FW,MF",Metz,Ligue 1,27,1994,11.6,21,14,9,6,6,5,14,35.7,9,13,3,10,2,23,9,0,0,2021-2022,90.0,15.517241379310345,162.93103448275863
Rk,Player,Nation,Pos,Squad,Comp,0,0,90.0,0,0,3,3,3,Tkl,0,0.0,0,0,0,0,0,0,0,0,0,2021-2022,90.0,0.0,0.0
1926,Aurélien Nguiamba,FRA,MF,Spezia,Serie A,22,1999,0.6,3,2,1,2,0,2,3,66.7,1,2,1,1,0,3,1,0,0,2021-2022,90.0,0.0,450.00000000000006
1927,Sikou Niakaté,MLI,DF,Metz,Ligue 1,22,1999,7.3,8,7,8,0,0,4,11,36.4,7,5,3,2,27,35,34,0,0,2021-2022,90.0,332.87671232876716,98.63013698630138
1928,Moussa Niakhate,SEN,DF,Mainz 05,Bundesliga,25,1996,28.5,40,23,25,13,2,20,33,60.6,13,37,11,26,50,90,69,1,0,2021-2022,90.0,157.89473684210526,126.31578947368422
1929,Ibrahima Niane,SEN,FW,Metz,Ligue 1,22,1999,17.6,1,1,0,1,0,0,5,0.0,5,6,1,5,3,4,16,0,0,2021-2022,90.0,15.34090909090909,5.113636363636363
1930,M'Baye Niang,SEN,FW,Bordeaux,Ligue 1,26,1994,8.6,4,0,0,2,2,0,4,0.0,4,9,1,8,1,5,4,0,0,2021-2022,90.0,10.465116279069768,41.86046511627907
1931,Tanguy Nianzou,FRA,DF,Bayern Munich,Bundesliga,19,2002,6.5,11,7,7,3,1,7,11,63.6,4,7,2,5,7,18,17,0,0,2021-2022,90.00000000000001,96.92307692307693,152.30769230769232
1932,Cheikh Niasse,SEN,"FW,MF",Lille,Ligue 1,21,2000,0.5,2,2,0,2,0,2,3,66.7,1,1,1,0,1,3,2,0,0,2021-2022,90.0,180.0,360.0
1933,Florian Niederlechner,GER,FW,Augsburg,Bundesliga,30,1990,12.9,6,5,1,3,2,4,13,30.8,9,9,0,9,4,10,7,0,0,2021-2022,90.0,27.906976744186046,41.860465116279066
1934,Håvard Nielsen,NOR,"MF,FW",Greuther Fürth,Bundesliga,28,1993,15.2,17,12,5,11,1,8,21,38.1,13,18,1,17,7,24,22,0,0,2021-2022,90.0,41.44736842105263,100.6578947368421
1935,Saúl Ñíguez,ESP,"DF,MF",Chelsea,Premier League,26,1994,5.3,20,9,11,9,0,9,16,56.3,7,14,3,11,7,27,10,1,0,2021-2022,90.0,118.8679245283019,339.622641509434
1936,Saúl Ñíguez,ESP,"FW,MF",Atlético Madrid,La Liga,26,1994,2.2,7,2,0,6,1,3,4,75.0,1,7,1,6,0,7,3,0,0,2021-2022,90.0,0.0,286.3636363636364
1937,Dimitris Nikolaou,GRE,DF,Spezia,Serie A,22,1998,36.0,39,26,29,7,3,22,34,64.7,12,48,24,24,49,88,132,1,0,2021-2022,90.0,122.5,97.5
1938,Joakim Nilsson,SWE,DF,Arminia,Bundesliga,27,1994,30.4,37,19,24,13,0,20,26,76.9,6,36,23,13,56,93,143,1,0,2021-2022,90.0,165.78947368421052,109.53947368421052
1939,Casimir Ninga,CHA,FW,Angers,Ligue 1,28,1993,4.5,5,1,1,4,0,2,5,40.0,3,2,0,2,1,6,0,0,0,2021-2022,90.0,20.0,100.0
1940,Fernando Niño,ESP,FW,Mallorca,La Liga,20,2000,9.8,10,4,3,2,5,2,12,16.7,10,9,2,7,3,13,15,0,0,2021-2022,90.0,27.551020408163264,91.83673469387755
1941,Eddie Nketiah,ENG,FW,Arsenal,Premier League,22,1999,9.3,9,4,1,4,4,1,4,25.0,3,9,2,7,4,13,5,0,0,2021-2022,90.0,38.70967741935483,87.09677419354837
1942,Nicolas Nkoulou,CMR,DF,Watford,Premier League,31,1990,1.9,1,0,0,1,0,0,0,0.0,0,2,1,1,2,3,8,0,0,2021-2022,90.0,94.73684210526315,47.368421052631575
1943,Christopher Nkunku,FRA,"FW,MF",RB Leipzig,Bundesliga,23,1997,30.3,23,10,10,11,2,9,35,25.7,26,23,2,21,15,38,15,0,0,2021-2022,90.0,44.554455445544555,68.31683168316832
1944,Felix Nmecha,GER,"MF,FW",Wolfsburg,Bundesliga,20,2000,3.6,3,1,1,1,1,0,2,0.0,2,2,0,2,7,10,6,0,0,2021-2022,90.0,175.0,75.0
1945,Lukas Nmecha,GER,"FW,MF",Wolfsburg,Bundesliga,22,1998,18.1,12,5,5,5,2,5,19,26.3,14,9,1,8,4,16,10,0,0,2021-2022,90.0,19.889502762430936,59.66850828729281
1946,Mark Noble,ENG,MF,West Ham,Premier League,34,1987,3.7,8,2,7,1,0,5,11,45.5,6,4,1,3,4,12,2,1,0,2021-2022,90.0,97.29729729729729,194.59459459459458
1947,Peru Nolaskoain,ESP,DF,Athletic Club,La Liga,22,1998,0.0,0,0,0,0,0,0,0,0.0,0,0,0,0,0,0,0,0,0,2021-2022,,,
1948,Nolito,ESP,MF,Celta Vigo,La Liga,34,1986,15.4,25,15,14,7,4,13,47,27.7,34,20,1,19,9,34,5,0,0,2021-2022,90.0,52.5974025974026,146.10389610389612
1949,Arnaud Nordin,FRA,"FW,MF",Saint-Étienne,Ligue 1,23,1998,20.8,21,11,8,8,5,8,22,36.4,14,19,0,19,6,27,8,0,0,2021-2022,90.0,25.96153846153846,90.86538461538461
1950,Håvard Nordtveit,NOR,DF,Hoffenheim,Bundesliga,31,1990,3.4,7,6,2,4,1,4,4,100.0,0,2,1,1,10,17,11,0,0,2021-2022,90.0,264.70588235294116,185.2941176470588
Rk,Player,Nation,Pos,Squad,Comp,0,0,90.0,0,0,3,3,3,Tkl,0,0.0,0,0,0,0,0,0,0,0,0,2021-2022,90.0,0.0,0.0
1951,Mathias Normann,NOR,MF,Norwich City,Premier League,25,1996,18.3,34,21,19,14,1,17,46,37.0,29,17,8,9,19,53,43,1,0,2021-2022,90.0,93.44262295081967,167.21311475409837
1952,Connor Noß,IRL,MF,Gladbach,Bundesliga,20,2001,0.6,1,0,0,1,0,0,1,0.0,1,1,1,0,0,1,0,0,0,2021-2022,90.0,0.0,150.0
1953,Hugo Novoa,ESP,"MF,FW",RB Leipzig,Bundesliga,18,2003,1.5,4,4,2,0,2,2,7,28.6,5,2,0,2,1,5,0,0,0,2021-2022,90.0,60.0,240.0
1954,Soma Novothny,HUN,"FW,MF",Bochum,Bundesliga,27,1994,0.9,1,1,1,0,0,0,1,0.0,1,1,0,1,0,1,2,0,0,2021-2022,90.0,0.0,100.0
1955,Jean-Pierre Nsame,CMR,FW,Venezia,Serie A,28,1993,2.7,1,1,0,0,1,0,0,0.0,0,0,0,0,0,1,1,0,0,2021-2022,90.0,0.0,33.33333333333333
1956,Randy Nteka,ANG,"FW,MF",Rayo Vallecano,La Liga,23,1997,16.2,24,13,9,11,4,8,19,42.1,11,21,1,20,8,32,12,0,0,2021-2022,90.0,44.44444444444444,133.33333333333334
1957,Alexander Nübel,GER,GK,Monaco,Ligue 1,24,1996,38.0,0,0,0,0,0,0,1,0.0,1,0,0,0,0,0,11,1,0,2021-2022,90.0,0.0,0.0
1958,Kasim Nuhu,GHA,DF,Hoffenheim,Bundesliga,26,1995,0.1,0,0,0,0,0,0,1,0.0,1,0,0,0,0,0,1,0,0,2021-2022,90.0,0.0,0.0
1959,Unai Núñez,ESP,DF,Athletic Club,La Liga,24,1997,6.9,4,4,2,2,0,3,6,50.0,3,9,8,1,8,12,26,2,0,2021-2022,90.0,104.34782608695652,52.17391304347826
1960,Hans Nunoo Sarpei,GHA,"DF,MF",Greuther Fürth,Bundesliga,22,1998,7.1,16,11,9,7,0,10,14,71.4,4,8,5,3,14,30,21,0,0,2021-2022,90.0,177.46478873239437,202.81690140845072
1961,Bram Nuytinck,NED,DF,Udinese,Serie A,31,1990,22.6,38,24,24,13,1,15,34,44.1,19,42,31,11,22,60,101,0,0,2021-2022,90.0,87.61061946902655,151.32743362831857
1962,Simeon Nwankwo,NGA,FW,Salernitana,Serie A,29,1992,9.4,5,5,0,4,1,4,10,40.0,6,8,3,5,3,8,10,0,0,2021-2022,90.0,28.723404255319146,47.87234042553191
1963,Gerzino Nyamsi,FRA,DF,Strasbourg,Ligue 1,24,1997,33.2,35,21,24,9,2,20,27,74.1,7,25,16,9,25,60,90,1,0,2021-2022,90.0,67.7710843373494,94.87951807228914
1964,Allan Nyom,CMR,DF,Getafe,La Liga,33,1988,2.7,3,1,2,1,0,2,2,100.0,0,2,1,1,2,5,7,0,0,2021-2022,90.0,66.66666666666666,99.99999999999999
1965,M'Bala Nzola,ANG,FW,Spezia,Serie A,24,1996,11.9,2,2,0,0,2,1,6,16.7,5,8,0,8,0,2,13,0,0,2021-2022,90.00000000000001,0.0,15.126050420168069
1966,Christian Nørgaard,DEN,MF,Brentford,Premier League,27,1994,33.9,109,60,42,58,9,52,101,51.5,49,48,9,39,64,173,58,1,0,2021-2022,90.0,169.91150442477877,289.38053097345136
1967,Adam Obert,SVK,"DF,MF",Cagliari,Serie A,18,2002,3.0,8,5,6,2,0,5,6,83.3,1,6,4,2,4,12,11,0,0,2021-2022,90.0,120.0,240.0
1968,Joel Obi,NGA,"MF,DF",Salernitana,Serie A,30,1991,12.7,23,14,5,14,4,5,12,41.7,7,17,6,11,10,33,7,0,0,2021-2022,90.0,70.86614173228347,162.99212598425197
1969,Jan Oblak,SVN,GK,Atlético Madrid,La Liga,28,1993,38.0,0,0,0,0,0,0,0,0.0,0,0,0,0,1,1,10,4,0,2021-2022,90.0,2.3684210526315788,0.0
1970,Lucas Ocampos,ARG,FW,Sevilla,La Liga,27,1994,23.6,45,24,23,18,4,23,55,41.8,32,35,1,34,9,54,24,1,0,2021-2022,90.0,34.32203389830508,171.6101694915254
1971,Bastian Oczipka,GER,DF,Union Berlin,Bundesliga,32,1989,10.4,24,15,15,7,2,10,13,76.9,3,10,2,8,12,36,21,0,0,2021-2022,90.0,103.84615384615384,207.69230769230768
1972,Brian Oddei,ITA,FW,Sassuolo,Serie A,18,2002,0.1,0,0,0,0,0,0,0,0.0,0,0,0,0,0,0,0,0,0,2021-2022,90.0,0.0,0.0
1973,Álvaro Odriozola,ESP,DF,Fiorentina,Serie A,25,1995,19.3,25,15,12,6,7,15,32,46.9,17,17,6,11,8,33,25,2,0,2021-2022,90.0,37.30569948186528,116.580310880829
1974,Angelo Ogbonna,ITA,DF,West Ham,Premier League,33,1988,10.2,7,4,5,2,0,3,7,42.9,4,5,4,1,11,18,29,0,0,2021-2022,90.0,97.05882352941177,61.76470588235294
1975,Florent Ogier,FRA,DF,Clermont Foot,Ligue 1,32,1989,27.0,31,17,18,12,1,17,31,54.8,14,41,27,14,37,68,89,0,0,2021-2022,90.0,123.33333333333334,103.33333333333334
Rk,Player,Nation,Pos,Squad,Comp,0,0,90.0,0,0,3,3,3,Tkl,0,0.0,0,0,0,0,0,0,0,0,0,2021-2022,90.0,0.0,0.0
1976,Stefano Okaka,ITA,FW,Udinese,Serie A,31,1989,0.2,0,0,0,0,0,0,0,0.0,0,2,0,2,0,0,1,0,0,2021-2022,90.0,0.0,0.0
1977,David Okereke,NGA,"FW,MF",Venezia,Serie A,23,1997,22.8,16,10,4,9,3,3,20,15.0,17,19,3,16,10,26,20,0,0,2021-2022,90.0,39.473684210526315,63.1578947368421
1978,Masaya Okugawa,JPN,"MF,FW",Arminia,Bundesliga,25,1996,28.1,46,25,18,22,6,12,37,32.4,25,29,1,28,20,66,13,0,0,2021-2022,90.0,64.05693950177935,147.33096085409252
1979,Lucas Olaza,URU,DF,Elche,La Liga,27,1994,3.3,5,3,3,1,1,1,1,100.0,0,5,1,4,4,9,6,0,0,2021-2022,90.0,109.0909090909091,136.36363636363637
1980,Oier Olazábal,ESP,GK,Espanyol,La Liga,31,1989,1.5,0,0,0,0,0,0,0,0.0,0,0,0,0,0,0,0,0,0,2021-2022,90.0,0.0,0.0
1981,Mathias Olesen,LUX,"MF,FW",Köln,Bundesliga,20,2001,0.2,0,0,0,0,0,0,0,0.0,0,0,0,0,1,1,0,0,0,2021-2022,90.0,450.0,0.0
1982,Michael Olise,FRA,"FW,MF",Crystal Palace,Premier League,19,2001,12.7,22,18,8,11,3,7,24,29.2,17,17,0,17,6,28,6,0,0,2021-2022,90.0,42.51968503937008,155.90551181102364
1983,Christian Oliva,URU,MF,Cagliari,Serie A,25,1996,0.5,2,2,2,0,0,1,4,25.0,3,0,0,0,0,2,0,0,0,2021-2022,90.0,0.0,360.0
1984,Brian Oliván,ESP,DF,Mallorca,La Liga,27,1994,24.3,33,20,22,9,2,12,23,52.2,11,17,7,10,28,61,63,0,0,2021-2022,90.0,103.7037037037037,122.22222222222221
1985,Sérgio Oliveira,POR,MF,Roma,Serie A,29,1992,9.9,27,14,11,14,2,15,30,50.0,15,13,0,13,10,37,7,0,0,2021-2022,90.0,90.9090909090909,245.45454545454547
1986,Mathías Olivera,URU,DF,Getafe,La Liga,23,1997,31.1,79,47,39,34,6,40,69,58.0,29,45,4,41,55,134,67,1,0,2021-2022,90.0,159.16398713826365,228.61736334405145
1987,Dani Olmo,ESP,"MF,FW",RB Leipzig,Bundesliga,23,1998,8.3,14,6,5,7,2,5,18,27.8,13,5,1,4,4,18,1,0,0,2021-2022,90.0,43.37349397590361,151.80722891566262
1988,Robin Olsen,SWE,GK,Aston Villa,Premier League,31,1990,1.0,0,0,0,0,0,0,0,0.0,0,0,0,0,0,0,0,0,0,2021-2022,90.0,0.0,0.0
1989,Warmed Omari,FRA,DF,Rennes,Ligue 1,21,2000,31.1,33,17,22,10,1,15,23,65.2,8,20,13,7,31,64,94,5,0,2021-2022,90.0,89.71061093247589,95.49839228295819
1990,Jonas Omlin,SUI,GK,Montpellier,Ligue 1,27,1994,28.7,2,1,2,0,0,2,3,66.7,1,0,0,0,0,2,12,3,0,2021-2022,90.0,0.0,6.2717770034843205
1991,Andrew Omobamidele,IRL,DF,Norwich City,Premier League,19,2002,4.2,8,6,5,3,0,5,11,45.5,6,8,8,0,5,13,13,0,0,2021-2022,90.0,107.14285714285714,171.42857142857142
1992,Amadou Onana,BEL,MF,Lille,Ligue 1,19,2001,15.1,48,31,17,27,4,18,25,72.0,7,10,3,7,30,78,19,0,0,2021-2022,90.0,178.80794701986756,286.0927152317881
1993,Jean Onana,CMR,MF,Bordeaux,Ligue 1,21,2000,20.4,70,49,33,33,4,35,86,40.7,51,37,5,32,36,106,23,1,0,2021-2022,90.0,158.82352941176472,308.8235294117647
1994,Karim Onisiwo,AUT,FW,Mainz 05,Bundesliga,29,1992,26.2,18,10,4,6,8,7,22,31.8,15,27,2,25,7,25,8,0,0,2021-2022,90.0,24.045801526717558,61.832061068702295
1995,Javier Ontiveros,ESP,"FW,MF",Osasuna,La Liga,23,1997,0.4,0,0,0,0,0,0,2,0.0,2,0,0,0,1,1,0,1,0,2021-2022,90.0,225.0,0.0
1996,Tyler Onyango,ENG,MF,Everton,Premier League,18,2003,0.3,0,0,0,0,0,0,0,0.0,0,0,0,0,0,0,1,0,0,2021-2022,90.0,0.0,0.0
1997,Frank Onyeka,NGA,MF,Brentford,Premier League,23,1998,11.6,25,17,13,9,3,8,27,29.6,19,16,2,14,14,39,13,0,0,2021-2022,90.0,108.62068965517241,193.9655172413793
1998,Willi Orban,HUN,DF,RB Leipzig,Bundesliga,28,1992,29.4,32,22,20,11,1,13,25,52.0,12,40,24,16,44,76,123,2,0,2021-2022,90.0,134.69387755102042,97.95918367346938
1999,Divock Origi,BEL,FW,Liverpool,Premier League,26,1995,1.5,0,0,0,0,0,0,2,0.0,2,1,0,1,1,1,2,0,0,2021-2022,90.0,60.0,0.0
2000,Riccardo Orsolini,ITA,"FW,MF",Bologna,Serie A,24,1997,19.8,21,13,9,11,1,13,29,44.8,16,9,4,5,5,26,14,0,0,2021-2022,90.0,22.727272727272727,95.45454545454545
Rk,Player,Nation,Pos,Squad,Comp,0,0,90.0,0,0,3,3,3,Tkl,0,0.0,0,0,0,0,0,0,0,0,0,2021-2022,90.0,0.0,0.0
2001,Stefan Ortega,GER,GK,Arminia,Bundesliga,28,1992,33.0,1,0,1,0,0,1,2,50.0,1,2,0,2,0,1,5,1,0,2021-2022,90.0,0.0,2.7272727272727275
2002,Pedro Ortiz,ESP,MF,Sevilla,La Liga,20,2000,0.1,0,0,0,0,0,0,0,0.0,0,0,0,0,0,0,1,0,0,2021-2022,90.0,0.0,0.0
2003,Victor Osimhen,NGA,FW,Napoli,Serie A,22,1998,22.0,10,5,1,2,7,2,6,33.3,4,16,3,13,3,13,17,0,0,2021-2022,90.0,12.272727272727273,40.909090909090914
2004,Milutin Osmajić,MNE,"FW,MF",Cádiz,La Liga,22,1999,2.9,1,1,0,1,0,0,0,0.0,0,0,0,0,1,2,3,0,0,2021-2022,90.0,31.03448275862069,31.03448275862069
2005,David Ospina,COL,GK,Napoli,Serie A,32,1988,31.0,0,0,0,0,0,0,0,0.0,0,0,0,0,1,1,11,1,0,2021-2022,90.0,2.903225806451613,0.0
2006,Patrick Osterhage,GER,MF,Bochum,Bundesliga,21,2000,6.7,9,6,3,5,1,3,7,42.9,4,7,1,6,11,20,8,0,0,2021-2022,90.0,147.76119402985074,120.89552238805969
2007,Tomáš Ostrák,CZE,"MF,FW",Köln,Bundesliga,21,2000,0.3,1,0,0,0,1,1,3,33.3,2,0,0,0,1,2,0,0,0,2021-2022,90.0,300.0,300.0
2008,Otávio,BRA,MF,Bordeaux,Ligue 1,27,1994,12.7,36,23,13,21,2,16,39,41.0,23,9,3,6,18,54,11,0,0,2021-2022,90.0,127.55905511811024,255.11811023622047
2009,Paulo Otávio,BRA,"DF,MF",Wolfsburg,Bundesliga,26,1994,4.0,14,10,7,4,3,8,15,53.3,7,11,6,5,4,18,9,0,0,2021-2022,90.0,90.0,315.0
2010,Dango Ouattara,BFA,"MF,FW",Lorient,Ligue 1,19,2002,9.0,21,15,9,11,1,11,23,47.8,12,10,1,9,14,35,15,1,0,2021-2022,90.0,140.0,210.0
2011,Remi Oudin,FRA,"MF,FW",Bordeaux,Ligue 1,24,1996,19.3,34,18,19,13,2,18,32,56.3,14,14,3,11,27,61,21,0,0,2021-2022,90.0,125.90673575129533,158.54922279792746
2012,Alexandre Oukidja,ALG,GK,Metz,Ligue 1,33,1988,20.8,0,0,0,0,0,0,1,0.0,1,1,0,1,1,1,17,2,0,2021-2022,90.0,4.326923076923077,0.0
2013,Azzedine Ounahi,MAR,MF,Angers,Ligue 1,21,2000,18.1,39,22,16,22,1,11,40,27.5,29,19,1,18,26,65,13,0,0,2021-2022,90.0,129.2817679558011,193.92265193370164
2014,Adam Ounas,ALG,"MF,FW",Napoli,Serie A,24,1996,3.6,6,1,0,3,3,3,7,42.9,4,3,0,3,2,8,3,0,0,2021-2022,90.0,50.0,150.0
2015,Jesús Owono,EQG,GK,Alavés,La Liga,20,2001,1.0,0,0,0,0,0,0,0,0.0,0,0,0,0,0,0,1,0,0,2021-2022,90.0,0.0,0.0
2016,Reece Oxford,ENG,DF,Augsburg,Bundesliga,22,1998,29.9,27,14,16,9,2,15,31,48.4,16,42,33,9,72,99,172,1,0,2021-2022,90.0,216.72240802675586,81.27090301003345
2017,Alex Oxlade-Chamberlain,ENG,"MF,FW",Liverpool,Premier League,27,1993,8.7,15,11,2,8,5,3,14,21.4,11,12,2,10,6,21,5,0,0,2021-2022,90.0,62.06896551724138,155.17241379310346
2018,Mikel Oyarzabal,ESP,"FW,MF",Real Sociedad,La Liga,24,1997,18.6,18,10,7,7,4,7,21,33.3,14,18,2,16,10,28,16,1,0,2021-2022,90.0,48.387096774193544,87.09677419354837
2019,Ambroise Oyongo,CMR,DF,Montpellier,Ligue 1,30,1991,7.3,13,4,7,4,2,9,15,60.0,6,5,1,4,6,19,17,0,0,2021-2022,90.0,73.97260273972603,160.27397260273975
2020,Salih Özcan,TUR,MF,Köln,Bundesliga,23,1998,25.7,42,30,14,23,5,22,51,43.1,29,37,5,32,51,93,35,1,0,2021-2022,90.0,178.59922178988327,147.0817120622568
2021,Levin Öztunalı,GER,MF,Union Berlin,Bundesliga,25,1996,6.4,14,11,6,5,3,7,17,41.2,10,3,0,3,4,18,12,0,0,2021-2022,90.0,56.25,196.875
2022,Fernando Pacheco,ESP,GK,Alavés,La Liga,29,1992,33.9,2,1,2,0,0,2,2,100.0,0,0,0,0,0,2,18,1,0,2021-2022,90.0,0.0,5.3097345132743365
2023,Jon Pacheco,ESP,DF,Real Sociedad,La Liga,20,2001,4.2,6,4,4,2,0,3,3,100.0,0,6,4,2,6,12,18,0,0,2021-2022,90.0,128.57142857142856,128.57142857142856
2024,Gonçalo Paciência,POR,FW,Eint Frankfurt,Bundesliga,26,1994,5.7,4,2,2,1,1,1,3,33.3,2,2,0,2,1,5,4,0,0,2021-2022,90.0,15.789473684210526,63.1578947368421
2025,Daniele Padelli,ITA,GK,Udinese,Serie A,35,1985,3.0,0,0,0,0,0,0,0,0.0,0,0,0,0,0,0,2,1,0,2021-2022,90.0,0.0,0.0
Rk,Player,Nation,Pos,Squad,Comp,0,0,90.0,0,0,3,3,3,Tkl,0,0.0,0,0,0,0,0,0,0,0,0,2021-2022,90.0,0.0,0.0
2026,Simone Pafundi,ITA,FW,Udinese,Serie A,15,2006,0.3,0,0,0,0,0,0,1,0.0,1,0,0,0,0,0,0,0,0,2021-2022,90.0,0.0,0.0
2027,Vincent Pajot,FRA,MF,Metz,Ligue 1,30,1990,25.7,86,56,35,47,4,20,46,43.5,26,33,6,27,51,137,38,0,0,2021-2022,90.0,178.59922178988327,301.16731517509726
2028,Exequiel Palacios,ARG,MF,Leverkusen,Bundesliga,22,1998,12.2,30,19,12,14,4,15,38,39.5,23,20,1,19,28,58,11,2,0,2021-2022,90.0,206.55737704918036,221.31147540983608
2029,Helibelton Palacios,COL,DF,Elche,La Liga,28,1993,21.5,69,38,56,10,3,37,55,67.3,18,21,8,13,18,87,61,0,0,2021-2022,90.0,75.34883720930232,288.83720930232556
2030,Isaac Palazón Camacho,ESP,"FW,MF",Rayo Vallecano,La Liga,26,1994,25.4,42,28,20,19,3,18,59,30.5,41,31,3,28,13,55,22,0,0,2021-2022,90.0,46.06299212598425,148.8188976377953
2031,Nicolas Pallois,FRA,DF,Nantes,Ligue 1,33,1987,27.2,51,33,40,11,0,34,59,57.6,25,40,19,21,53,104,116,1,0,2021-2022,90.0,175.36764705882354,168.75
2032,Cole Palmer,ENG,"FW,MF",Manchester City,Premier League,19,2002,1.4,2,1,1,1,0,0,2,0.0,2,3,0,3,1,3,0,0,0,2021-2022,90.0,64.28571428571429,128.57142857142858
2033,Erik Palmer-Brown,USA,DF,Troyes,Ligue 1,24,1997,19.3,37,22,29,8,0,20,26,76.9,6,26,18,8,34,71,87,1,0,2021-2022,90.0,158.54922279792746,172.53886010362692
2034,Emerson Palmieri,ITA,DF,Chelsea,Premier League,26,1994,0.1,0,0,0,0,0,0,0,0.0,0,0,0,0,0,0,0,0,0,2021-2022,90.0,0.0,0.0
2035,Emerson Palmieri,ITA,DF,Lyon,Ligue 1,26,1994,25.2,46,25,16,22,8,22,34,64.7,12,23,8,15,27,73,66,0,0,2021-2022,90.0,96.42857142857144,164.2857142857143
2036,Martin Palumbo,NOR,FW,Juventus,Serie A,19,2002,0.1,0,0,0,0,0,0,1,0.0,1,0,0,0,0,0,0,0,0,2021-2022,90.0,0.0,0.0
2037,Goran Pandev,MKD,"FW,MF",Genoa,Serie A,38,1983,9.4,2,0,1,0,1,0,9,0.0,9,3,1,2,2,4,0,0,0,2021-2022,90.0,19.148936170212764,19.148936170212764
2038,Ivor Pandur,CRO,GK,Hellas Verona,Serie A,21,2000,3.0,0,0,0,0,0,0,0,0.0,0,0,0,0,0,0,2,0,0,2021-2022,90.0,0.0,0.0
2039,Miloš Pantović,SRB,"MF,FW",Bochum,Bundesliga,25,1996,17.0,19,10,8,7,4,6,25,24.0,19,26,4,22,18,37,14,0,0,2021-2022,90.0,95.29411764705883,100.58823529411765
2040,Antonios Papadopoulos,GER,"DF,MF",Dortmund,Bundesliga,21,1999,0.2,0,0,0,0,0,0,0,0.0,0,1,0,1,0,0,0,0,0,2021-2022,90.0,0.0,0.0
2041,Merveille Papela,GER,MF,Mainz 05,Bundesliga,20,2001,0.9,3,2,2,1,0,2,3,66.7,1,2,0,2,2,5,0,0,0,2021-2022,90.0,200.0,300.0
2042,Lucas Paquetá,BRA,"MF,FW",Lyon,Ligue 1,23,1997,30.0,68,38,24,26,18,17,51,33.3,34,43,5,38,9,77,22,0,0,2021-2022,90.0,27.0,204.0
2043,Rubén Pardo,ESP,MF,Bordeaux,Ligue 1,28,1992,0.1,0,0,0,0,0,0,0,0.0,0,0,0,0,0,0,0,0,0,2021-2022,90.0,0.0,0.0
2044,Kevin Paredes,USA,"FW,DF",Wolfsburg,Bundesliga,18,2003,0.2,1,0,0,0,1,0,0,0.0,0,1,0,1,0,1,0,0,0,2021-2022,90.0,0.0,450.0
2045,Leandro Paredes,ARG,MF,Paris S-G,Ligue 1,27,1994,9.3,23,13,9,11,3,12,24,50.0,12,10,6,4,10,33,5,2,0,2021-2022,90.0,96.77419354838709,222.5806451612903
2046,Daniel Parejo,ESP,MF,Villarreal,La Liga,32,1989,30.0,43,29,15,15,13,20,52,38.5,32,32,7,25,29,72,19,1,0,2021-2022,90.0,87.0,129.0
2047,Fabiano Parisi,ITA,DF,Empoli,Serie A,20,2000,16.4,35,19,25,5,5,13,31,41.9,18,30,10,20,22,57,42,0,0,2021-2022,90.0,120.73170731707319,192.07317073170734
2048,Raúl Parra,ESP,DF,Cádiz,La Liga,21,1999,1.0,2,1,2,0,0,1,3,33.3,2,0,0,0,0,2,5,0,0,2021-2022,90.0,0.0,180.0
2049,Thomas Partey,GHA,MF,Arsenal,Premier League,28,1993,22.5,43,29,22,17,4,18,44,40.9,26,22,4,18,23,66,35,2,0,2021-2022,90.0,92.0,172.0
2050,Mario Pašalić,CRO,"MF,FW",Atalanta,Serie A,26,1995,22.2,27,12,8,13,6,12,30,40.0,18,27,6,21,20,47,14,0,0,2021-2022,90.0,81.0810810810811,109.45945945945947
Rk,Player,Nation,Pos,Squad,Comp,0,0,90.0,0,0,3,3,3,Tkl,0,0.0,0,0,0,0,0,0,0,0,0,2021-2022,90.0,0.0,0.0
2051,Felix Passlack,GER,DF,Dortmund,Bundesliga,23,1998,5.2,13,9,8,4,1,6,12,50.0,6,5,1,4,4,17,7,0,0,2021-2022,90.0,69.23076923076923,224.99999999999997
2052,Javier Pastore,ARG,"MF,FW",Elche,La Liga,32,1989,5.8,7,3,3,2,2,3,12,25.0,9,5,1,4,4,11,2,0,0,2021-2022,90.0,62.06896551724138,108.62068965517241
2053,Patric,ESP,DF,Lazio,Serie A,28,1993,18.3,21,15,17,4,0,9,20,45.0,11,22,11,11,12,33,44,2,0,2021-2022,90.0,59.01639344262295,103.27868852459017
2054,Rui Patrício,POR,GK,Roma,Serie A,33,1988,38.0,0,0,0,0,0,0,0,0.0,0,1,0,1,0,0,10,3,0,2021-2022,90.0,0.0,0.0
2055,Paulinho,BRA,"FW,MF",Leverkusen,Bundesliga,21,2000,13.5,22,13,6,13,3,13,27,48.1,14,14,1,13,6,28,7,0,0,2021-2022,90.0,40.0,146.66666666666669
2056,Gabriel Paulista,BRA,DF,Valencia,La Liga,30,1990,17.7,21,12,16,5,0,14,20,70.0,6,18,12,6,39,60,88,0,0,2021-2022,90.0,198.3050847457627,106.77966101694916
2057,Benjamin Pavard,FRA,DF,Bayern Munich,Bundesliga,25,1996,23.1,35,20,21,13,1,19,29,65.5,10,28,16,12,36,71,50,1,0,2021-2022,89.99999999999999,140.25974025974023,136.36363636363635
2058,Strahinja Pavlović,SRB,DF,Monaco,Ligue 1,20,2001,5.0,23,16,8,13,2,8,12,66.7,4,5,3,2,9,32,15,0,0,2021-2022,90.0,162.0,414.0
2059,Leonardo Pavoletti,ITA,FW,Cagliari,Serie A,32,1988,16.9,10,6,2,5,3,3,9,33.3,6,9,5,4,2,12,12,0,0,2021-2022,90.0,10.650887573964498,53.25443786982249
2060,Dimitri Payet,FRA,"FW,MF",Marseille,Ligue 1,34,1987,28.8,16,8,4,10,2,7,31,22.6,24,9,0,9,9,25,3,0,0,2021-2022,90.0,28.125,50.0
2061,Mads Pedersen,DEN,"MF,DF",Augsburg,Bundesliga,24,1996,15.5,28,21,8,15,5,12,27,44.4,15,13,4,9,15,43,30,0,0,2021-2022,90.0,87.09677419354838,162.58064516129033
2062,Alfonso Pedraza,ESP,DF,Villarreal,La Liga,25,1996,18.9,34,16,17,12,5,10,28,35.7,18,12,3,9,31,65,32,0,0,2021-2022,90.0,147.61904761904762,161.9047619047619
2063,Pedri,ESP,MF,Barcelona,La Liga,18,2002,9.8,20,12,9,8,3,7,20,35.0,13,13,0,13,5,25,7,1,0,2021-2022,90.0,45.91836734693877,183.6734693877551
2064,Pedro,ESP,FW,Lazio,Serie A,34,1987,22.6,36,23,8,19,9,16,47,34.0,31,18,2,16,6,42,8,0,0,2021-2022,90.0,23.893805309734514,143.36283185840708
2065,João Pedro,ITA,FW,Cagliari,Serie A,29,1992,36.9,15,12,2,8,5,4,18,22.2,14,23,5,18,8,23,18,1,0,2021-2022,90.0,19.51219512195122,36.58536585365854
2066,Adrià Pedrosa,ESP,DF,Espanyol,La Liga,23,1998,30.2,58,30,38,14,6,26,57,45.6,31,25,7,18,25,83,92,2,0,2021-2022,90.0,74.50331125827815,172.8476821192053
2067,Gianluca Pegolo,ITA,GK,Sassuolo,Serie A,40,1981,1.0,0,0,0,0,0,0,0,0.0,0,0,0,0,0,0,0,1,0,2021-2022,90.0,0.0,0.0
2068,Peter Pekarík,SVK,DF,Hertha BSC,Bundesliga,34,1986,24.8,45,29,33,11,1,32,46,69.6,14,28,10,18,29,74,58,0,0,2021-2022,90.0,105.24193548387098,163.30645161290323
2069,Pietro Pellegri,ITA,FW,Torino,Serie A,20,2001,2.4,1,1,0,1,0,0,4,0.0,4,0,0,0,0,1,5,0,0,2021-2022,90.0,0.0,37.5
2070,Pietro Pellegri,ITA,FW,Milan,Serie A,20,2001,1.5,2,2,0,1,1,0,1,0.0,1,0,0,0,0,2,1,0,0,2021-2022,90.0,0.0,120.0
2071,Lorenzo Pellegrini,ITA,MF,Roma,Serie A,25,1996,25.4,35,14,10,17,8,16,60,26.7,44,29,1,28,27,62,20,0,0,2021-2022,90.0,95.66929133858268,124.01574803149607
2072,Luca Pellegrini,ITA,DF,Juventus,Serie A,22,1999,12.3,23,10,13,5,5,12,19,63.2,7,9,1,8,5,28,23,0,0,2021-2022,89.99999999999999,36.58536585365853,168.29268292682926
2073,Facundo Pellistri,URU,"MF,FW",Alavés,La Liga,19,2001,7.5,9,5,4,3,2,1,10,10.0,9,13,2,11,6,15,7,0,0,2021-2022,90.0,72.0,108.0
2074,Federico Peluso,ITA,DF,Sassuolo,Serie A,37,1984,0.1,1,1,0,1,0,1,1,100.0,0,0,0,0,0,1,0,0,0,2021-2022,90.0,0.0,900.0
2075,Timothee Pembele,FRA,DF,Bordeaux,Ligue 1,18,2002,15.7,20,8,8,10,2,10,29,34.5,19,12,3,9,16,36,24,0,0,2021-2022,90.0,91.71974522292994,114.64968152866243
Rk,Player,Nation,Pos,Squad,Comp,0,0,90.0,0,0,3,3,3,Tkl,0,0.0,0,0,0,0,0,0,0,0,0,2021-2022,90.0,0.0,0.0
2076,Rubén Peña,ESP,"MF,FW",Villarreal,La Liga,30,1991,1.5,2,0,1,1,0,2,6,33.3,4,1,0,1,5,7,2,0,0,2021-2022,90.0,300.0,120.0
2077,Philipp Pentke,GER,GK,Hoffenheim,Bundesliga,36,1985,1.0,0,0,0,0,0,0,0,0.0,0,0,0,0,0,0,0,0,0,2021-2022,90.0,0.0,0.0
2078,Nicolas Pépé,CIV,"FW,MF",Arsenal,Premier League,26,1995,7.7,8,5,3,5,0,3,9,33.3,6,9,1,8,8,16,2,0,0,2021-2022,90.0,93.50649350649351,93.50649350649351
2079,Ricardo Pepi,USA,"FW,MF",Augsburg,Bundesliga,18,2003,5.3,4,2,1,3,0,1,8,12.5,7,7,0,7,3,7,8,0,0,2021-2022,90.0,50.943396226415096,67.9245283018868
2080,Alberto Perea,ESP,MF,Cádiz,La Liga,30,1990,8.6,19,9,7,9,3,6,20,30.0,14,15,1,14,9,28,4,0,0,2021-2022,90.0,94.18604651162792,198.8372093023256
2081,Brayann Pereira,FRA,"DF,MF",Lens,Ligue 1,18,2003,0.2,1,1,1,0,0,1,1,100.0,0,0,0,0,0,1,1,0,0,2021-2022,90.0,0.0,450.0
2082,Danilo Pereira,POR,MF,Paris S-G,Ligue 1,29,1991,22.6,33,17,10,20,3,14,28,50.0,14,19,10,9,37,70,29,1,0,2021-2022,90.0,147.34513274336283,131.41592920353983
2083,Mathias Pereira Lage,POR,DF,Angers,Ligue 1,24,1996,11.6,21,7,10,7,4,8,30,26.7,22,18,7,11,21,42,22,0,0,2021-2022,90.0,162.93103448275863,162.93103448275863
2084,Ricardo Pereira,POR,DF,Leicester City,Premier League,27,1993,11.0,37,20,19,13,5,21,40,52.5,19,13,1,12,17,54,39,0,0,2021-2022,90.0,139.0909090909091,302.72727272727275
2085,Gastón Pereiro,URU,"FW,MF",Cagliari,Serie A,26,1995,10.8,13,5,7,4,2,5,18,27.8,13,12,1,11,1,14,8,0,0,2021-2022,90.0,8.333333333333332,108.33333333333333
2086,Luan Peres Petroni,BRA,DF,Marseille,Ligue 1,27,1994,29.8,65,35,33,25,7,36,52,69.2,16,26,12,14,43,108,64,1,0,2021-2022,90.0,129.86577181208054,196.30872483221475
2087,Dor Peretz,ISR,MF,Venezia,Serie A,26,1995,6.5,27,18,8,16,3,13,25,52.0,12,8,4,4,8,35,11,0,0,2021-2022,90.00000000000001,110.76923076923077,373.84615384615387
2088,Roberto Pereyra,ARG,"MF,FW",Udinese,Serie A,30,1991,19.9,18,12,7,6,5,7,23,30.4,16,26,5,21,12,30,11,0,0,2021-2022,90.0,54.2713567839196,81.4070351758794
2089,Ayoze Pérez,ESP,"MF,FW",Leicester City,Premier League,28,1993,4.9,4,2,0,3,1,0,13,0.0,13,11,1,10,2,6,5,0,0,2021-2022,90.0,36.73469387755102,73.46938775510203
2090,Carles Pérez,ESP,"MF,FW",Roma,Serie A,23,1998,6.2,8,3,3,1,4,3,12,25.0,9,10,0,10,2,10,2,0,0,2021-2022,90.0,29.032258064516128,116.12903225806451
2091,Iñigo Pérez,ESP,MF,Osasuna,La Liga,33,1988,3.8,3,2,2,1,0,2,4,50.0,2,1,0,1,0,3,3,0,0,2021-2022,90.0,0.0,71.05263157894737
2092,Juan Pérez,ESP,GK,Osasuna,La Liga,25,1996,2.0,0,0,0,0,0,0,1,0.0,1,0,0,0,0,0,1,1,0,2021-2022,90.0,0.0,0.0
2093,Kike Pérez,ESP,"MF,FW",Elche,La Liga,24,1997,5.8,8,6,1,3,4,0,10,0.0,10,6,1,5,3,11,4,0,0,2021-2022,90.0,46.55172413793103,124.13793103448276
2094,Lucas Pérez,ESP,FW,Elche,La Liga,32,1988,14.1,4,1,2,1,1,3,10,30.0,7,2,0,2,3,7,4,0,0,2021-2022,89.99999999999999,19.148936170212764,25.53191489361702
2095,Lucas Pérez,ESP,"FW,MF",Cádiz,La Liga,32,1988,11.8,3,3,2,1,0,0,10,0.0,10,3,1,2,0,3,1,0,0,2021-2022,90.0,0.0,22.881355932203387
2096,Nehuén Pérez,ARG,DF,Udinese,Serie A,21,2000,18.8,44,21,21,21,2,16,25,64.0,9,27,9,18,21,65,47,0,0,2021-2022,90.0,100.53191489361701,210.63829787234042
2097,Mattia Perin,ITA,GK,Juventus,Serie A,28,1992,4.5,0,0,0,0,0,0,0,0.0,0,0,0,0,0,0,3,0,0,2021-2022,90.0,0.0,0.0
2098,Ivan Perišić,CRO,DF,Inter,Serie A,32,1989,31.3,38,22,18,11,9,28,50,56.0,22,39,7,32,47,85,42,0,0,2021-2022,90.0,135.14376996805112,109.26517571884983
2099,Sonny Perkins,ENG,MF,West Ham,Premier League,17,2004,0.0,0,0,0,0,0,0,0,0.0,0,0,0,0,0,0,0,0,0,2021-2022,,,
2100,Diego Perotti,ARG,"MF,FW",Salernitana,Serie A,33,1988,3.2,11,5,7,1,3,4,13,30.8,9,1,0,1,2,13,6,0,0,2021-2022,90.0,56.25,309.375
Rk,Player,Nation,Pos,Squad,Comp,0,0,90.0,0,0,3,3,3,Tkl,0,0.0,0,0,0,0,0,0,0,0,0,2021-2022,90.0,0.0,0.0
2101,Romain Perraud,FRA,DF,Southampton,Premier League,23,1997,18.0,34,22,18,14,2,16,29,55.2,13,24,6,18,17,51,42,0,0,2021-2022,90.0,85.0,170.0
2102,Lucas Perrin,FRA,DF,Strasbourg,Ligue 1,22,1998,27.8,43,32,24,17,2,26,45,57.8,19,28,11,17,42,85,67,0,0,2021-2022,90.0,135.97122302158274,139.20863309352518
2103,Mario Perrone,ITA,DF,Salernitana,Serie A,18,2003,0.2,0,0,0,0,0,0,0,0.0,0,0,0,0,0,0,0,0,0,2021-2022,90.0,0.0,0.0
2104,Pavao Pervan,AUT,GK,Wolfsburg,Bundesliga,33,1987,6.0,0,0,0,0,0,0,0,0.0,0,0,0,0,0,0,3,0,0,2021-2022,90.0,0.0,0.0
2105,Matteo Pessina,ITA,"MF,FW",Atalanta,Serie A,24,1997,16.0,27,14,10,11,6,14,33,42.4,19,22,3,19,13,40,7,0,0,2021-2022,90.0,73.125,151.875
2106,Andrea Petagna,ITA,FW,Napoli,Serie A,26,1995,6.5,3,3,0,3,0,1,4,25.0,3,1,0,1,0,3,5,0,0,2021-2022,90.00000000000001,0.0,41.53846153846154
2107,Nils Petersen,GER,FW,Freiburg,Bundesliga,32,1988,6.4,5,3,2,3,0,1,13,7.7,12,7,0,7,2,7,17,0,0,2021-2022,90.0,28.125,70.3125
2108,Danijel Petković,MNE,GK,Angers,Ligue 1,28,1993,15.0,0,0,0,0,0,0,1,0.0,1,0,0,0,1,1,9,5,0,2021-2022,90.0,6.0,0.0
2109,Léo Pétrot,FRA,DF,Lorient,Ligue 1,24,1997,20.2,31,17,23,8,0,21,29,72.4,8,33,17,16,22,53,86,0,0,2021-2022,90.0,98.01980198019803,138.11881188118812
2110,Njegoš Petrović,SRB,MF,Granada,La Liga,22,1999,10.2,24,11,4,19,1,8,14,57.1,6,16,4,12,9,33,11,0,0,2021-2022,90.0,79.41176470588236,211.76470588235296
2111,Jens Petter Hauge,NOR,"MF,FW",Eint Frankfurt,Bundesliga,21,1999,11.6,14,5,6,7,1,7,23,30.4,16,7,0,7,3,17,5,0,0,2021-2022,90.0,23.275862068965516,108.62068965517241
2112,Alex Petxa,ESP,"DF,MF",Athletic Club,La Liga,24,1997,4.6,12,9,4,7,1,4,8,50.0,4,8,2,6,4,16,6,0,0,2021-2022,90.0,78.26086956521739,234.7826086956522
2113,Germán Pezzella,ARG,DF,Betis,La Liga,30,1991,22.1,21,9,16,5,0,16,29,55.2,13,29,18,11,39,60,106,0,0,2021-2022,90.0,158.8235294117647,85.52036199095022
2114,Giuseppe Pezzella,ITA,"DF,MF",Atalanta,Serie A,23,1997,11.9,28,13,15,7,6,8,18,44.4,10,13,5,8,9,37,16,0,0,2021-2022,90.00000000000001,68.0672268907563,211.76470588235296
2115,Immanuel Pherai,SUR,MF,Dortmund,Bundesliga,20,2001,0.0,0,0,0,0,0,0,0,0.0,0,0,0,0,0,0,0,0,0,2021-2022,,,
2116,Maximilian Philipp,GER,MF,Wolfsburg,Bundesliga,27,1994,10.7,15,11,6,7,2,5,21,23.8,16,12,1,11,4,19,5,0,0,2021-2022,90.0,33.64485981308412,126.16822429906543
2117,Romain Philippoteaux,FRA,MF,Brest,Ligue 1,33,1988,0.3,1,1,0,1,0,0,0,0.0,0,0,0,0,0,1,0,0,0,2021-2022,90.0,0.0,300.0
2118,Kalvin Phillips,ENG,MF,Leeds United,Premier League,25,1995,17.7,54,25,24,25,5,24,57,42.1,33,37,9,28,24,78,18,0,0,2021-2022,90.0,122.03389830508475,274.5762711864407
2119,Jaden Philogene Bidace,ENG,FW,Aston Villa,Premier League,19,2002,0.1,0,0,0,0,0,0,0,0.0,0,0,0,0,0,0,0,0,0,2021-2022,90.0,0.0,0.0
2120,Jérôme Phojo,FRA,DF,Clermont Foot,Ligue 1,28,1993,0.1,0,0,0,0,0,0,0,0.0,0,0,0,0,0,0,1,0,0,2021-2022,90.0,0.0,0.0
2121,Krzysztof Piątek,POL,FW,Fiorentina,Serie A,26,1995,8.1,5,4,1,1,3,2,3,66.7,1,6,0,6,2,7,8,0,0,2021-2022,90.0,22.22222222222222,55.55555555555556
2122,Krzysztof Piątek,POL,FW,Hertha BSC,Bundesliga,26,1995,3.9,2,2,0,1,1,0,1,0.0,1,0,0,0,0,2,6,0,0,2021-2022,90.0,0.0,46.15384615384615
2123,Pablo Piatti,ARG,"MF,FW",Elche,La Liga,32,1989,3.5,9,4,5,3,1,3,8,37.5,5,5,1,4,2,11,3,0,0,2021-2022,90.0,51.42857142857143,231.42857142857142
2124,Cristiano Piccini,ITA,DF,Valencia,La Liga,28,1992,3.6,14,8,9,5,0,5,7,71.4,2,3,2,1,1,15,11,0,0,2021-2022,90.0,25.0,350.0
2125,Roberto Piccoli,ITA,FW,Genoa,Serie A,20,2001,2.4,1,1,0,1,0,0,0,0.0,0,0,0,0,1,2,1,1,0,2021-2022,90.0,37.5,37.5
Rk,Player,Nation,Pos,Squad,Comp,0,0,90.0,0,0,3,3,3,Tkl,0,0.0,0,0,0,0,0,0,0,0,0,2021-2022,90.0,0.0,0.0
2126,Roberto Piccoli,ITA,FW,Atalanta,Serie A,20,2001,2.2,2,0,0,0,2,0,2,0.0,2,1,0,1,0,2,0,0,0,2021-2022,90.0,0.0,81.81818181818181
2127,Jordan Pickford,ENG,GK,Everton,Premier League,27,1994,35.0,1,1,1,0,0,0,1,0.0,1,1,0,1,1,2,14,1,0,2021-2022,90.0,2.571428571428571,2.571428571428571
2128,Jérémy Pied,FRA,"DF,FW",Lille,Ligue 1,32,1989,0.1,0,0,0,0,0,0,0,0.0,0,0,0,0,1,1,0,0,0,2021-2022,90.0,900.0,0.0
2129,Amos Pieper,GER,DF,Arminia,Bundesliga,23,1998,26.4,58,29,38,19,1,32,51,62.7,19,37,23,14,50,108,132,1,0,2021-2022,90.0,170.45454545454547,197.72727272727272
2130,Ronaël Pierre-Gabriel,FRA,DF,Brest,Ligue 1,23,1998,28.3,79,45,52,21,6,42,73,57.5,31,22,7,15,48,127,74,0,0,2021-2022,90.0,152.6501766784452,251.23674911660774
2131,Erik Pieters,NED,DF,Burnley,Premier League,32,1988,8.1,28,15,15,11,2,17,28,60.7,11,18,7,11,10,38,38,0,0,2021-2022,90.0,111.11111111111111,311.11111111111114
2132,Tomás Pina Isla,ESP,MF,Alavés,La Liga,33,1987,16.0,28,16,13,11,4,14,29,48.3,15,12,3,9,22,50,23,0,0,2021-2022,90.0,123.75,157.5
2133,Andrea Pinamonti,ITA,FW,Empoli,Serie A,22,1999,31.9,11,6,0,7,4,2,18,11.1,16,24,3,21,7,18,23,0,0,2021-2022,90.0,19.74921630094044,31.03448275862069
2134,Orbelín Pineda,MEX,"MF,FW",Celta Vigo,La Liga,25,1996,1.1,4,1,4,0,0,1,2,50.0,1,0,0,0,0,4,1,0,0,2021-2022,90.0,0.0,327.27272727272725
2135,Ethan Pinnock,JAM,DF,Brentford,Premier League,28,1993,29.9,51,35,37,12,2,25,38,65.8,13,30,11,19,44,95,154,1,0,2021-2022,90.0,132.44147157190636,153.51170568561875
2136,Yeremi Pino,ESP,"MF,FW",Villarreal,La Liga,18,2002,18.6,32,14,14,8,10,10,24,41.7,14,33,4,29,6,38,12,1,0,2021-2022,90.0,29.032258064516125,154.83870967741933
2137,Carlo Pinsoglio,ITA,GK,Juventus,Serie A,31,1990,0.5,0,0,0,0,0,0,0,0.0,0,0,0,0,0,0,0,0,0,2021-2022,90.0,0.0,0.0
2138,Riccardo Pinzi,ITA,FW,Udinese,Serie A,17,2003,0.0,0,0,0,0,0,0,0,0.0,0,0,0,0,0,0,0,0,0,2021-2022,,,
2139,Gerard Piqué,ESP,DF,Barcelona,La Liga,34,1987,23.2,22,12,18,4,0,11,14,78.6,3,19,16,3,34,56,86,1,0,2021-2022,90.0,131.89655172413794,85.3448275862069
2140,Marko Pjaca,CRO,MF,Torino,Serie A,26,1995,12.8,7,4,1,4,2,3,8,37.5,5,10,2,8,4,11,2,0,0,2021-2022,90.0,28.125,49.21875
2141,Marvin Plattenhardt,GER,DF,Hertha BSC,Bundesliga,29,1992,18.2,25,11,18,6,1,15,27,55.6,12,18,3,15,17,42,52,0,0,2021-2022,90.0,84.06593406593407,123.62637362637363
2142,Alassane Pléa,FRA,"MF,FW",Gladbach,Bundesliga,28,1993,23.0,18,14,6,9,3,7,20,35.0,13,9,1,8,4,22,9,0,0,2021-2022,90.0,15.65217391304348,70.43478260869566
2143,Tommaso Pobega,ITA,MF,Torino,Serie A,22,1999,24.9,48,30,17,20,11,21,40,52.5,19,32,3,29,25,73,38,0,0,2021-2022,90.0,90.36144578313252,173.49397590361446
2144,Daniel Podence,POR,"FW,MF",Wolves,Premier League,25,1995,16.5,18,11,10,5,3,4,17,23.5,13,8,1,7,10,28,1,0,0,2021-2022,90.0,54.54545454545455,98.18181818181819
2145,Suf Podgoreanu,ISR,FW,Spezia,Serie A,19,2002,1.3,2,0,1,1,0,1,4,25.0,3,2,0,2,1,3,3,0,0,2021-2022,90.0,69.23076923076923,138.46153846153845
2146,Paul Pogba,FRA,"MF,FW",Manchester Utd,Premier League,28,1993,15.0,13,9,5,7,1,6,28,21.4,22,11,0,11,13,26,16,0,0,2021-2022,90.0,78.0,78.0
2147,Joel Pohjanpalo,FIN,FW,Leverkusen,Bundesliga,26,1994,0.1,0,0,0,0,0,0,0,0.0,0,0,0,0,0,0,0,0,0,2021-2022,90.0,0.0,0.0
2148,Matteo Politano,ITA,FW,Napoli,Serie A,27,1993,18.3,24,12,8,11,5,15,54,27.8,39,11,2,9,13,37,5,0,0,2021-2022,90.0,63.9344262295082,118.0327868852459
2149,Julian Pollersbeck,GER,GK,Lyon,Ligue 1,26,1994,4.8,0,0,0,0,0,0,0,0.0,0,0,0,0,1,1,1,0,0,2021-2022,90.0,18.75,0.0
2150,Sebastian Polter,GER,FW,Bochum,Bundesliga,30,1991,26.0,9,3,1,4,4,2,11,18.2,9,15,5,10,2,11,24,0,0,2021-2022,90.00000000000001,6.923076923076923,31.153846153846157
Rk,Player,Nation,Pos,Squad,Comp,0,0,90.0,0,0,3,3,3,Tkl,0,0.0,0,0,0,0,0,0,0,0,0,2021-2022,90.0,0.0,0.0
2151,Ezequiel Ponce,ARG,FW,Elche,La Liga,24,1997,7.4,5,4,1,3,1,3,10,30.0,7,5,0,5,1,6,7,0,0,2021-2022,90.0,12.162162162162161,60.81081081081081
2152,Marin Pongračić,CRO,DF,Dortmund,Bundesliga,23,1997,9.2,17,10,13,4,0,6,10,60.0,4,11,5,6,17,34,32,2,0,2021-2022,90.0,166.30434782608697,166.30434782608697
2153,Pere Pons,ESP,MF,Alavés,La Liga,28,1993,15.2,26,18,4,20,2,7,21,33.3,14,10,1,9,6,32,11,0,0,2021-2022,90.0,35.526315789473685,153.94736842105263
2154,Nick Pope,ENG,GK,Burnley,Premier League,29,1992,36.0,0,0,0,0,0,0,2,0.0,2,0,0,0,2,2,30,3,0,2021-2022,90.0,5.0,0.0
2155,Manolo Portanova,ITA,"FW,MF",Genoa,Serie A,21,2000,14.7,46,28,9,26,11,14,34,41.2,20,26,2,24,17,63,22,0,0,2021-2022,90.0,104.08163265306122,281.6326530612245
2156,Portu,ESP,"FW,MF",Real Sociedad,La Liga,29,1992,17.7,16,7,2,6,8,3,19,15.8,16,21,3,18,7,23,8,0,0,2021-2022,90.0,35.59322033898305,81.35593220338984
2157,Stefan Posch,AUT,DF,Hoffenheim,Bundesliga,24,1997,24.4,48,30,20,26,2,22,39,56.4,17,43,18,25,28,76,71,2,0,2021-2022,90.0,103.27868852459018,177.04918032786887
2158,Sergio Postigo,ESP,DF,Levante,La Liga,32,1988,9.4,11,7,8,2,1,4,8,50.0,4,7,5,2,7,18,45,1,0,2021-2022,90.0,67.02127659574468,105.31914893617021
2159,Yussuf Poulsen,DEN,"FW,MF",RB Leipzig,Bundesliga,27,1994,12.0,13,4,3,6,4,3,13,23.1,10,13,0,13,3,16,9,0,0,2021-2022,90.0,22.5,97.5
2160,Gaëtan Poussin,FRA,GK,Bordeaux,Ligue 1,22,1999,13.0,1,1,1,0,0,1,1,100.0,0,0,0,0,0,1,15,1,0,2021-2022,90.00000000000001,0.0,6.923076923076923
2161,Darío Poveda,ESP,"FW,MF",Getafe,La Liga,24,1997,4.2,2,0,1,0,1,0,5,0.0,5,7,1,6,1,3,1,0,0,2021-2022,90.0,21.428571428571427,42.857142857142854
2162,José Pozo,ESP,"MF,DF",Rayo Vallecano,La Liga,25,1996,0.8,2,2,0,2,0,2,3,66.7,1,1,0,1,0,2,1,0,0,2021-2022,90.0,0.0,225.0
2163,Dennis Praet,BEL,MF,Torino,Serie A,27,1994,17.1,19,10,6,8,5,8,22,36.4,14,12,1,11,3,22,4,0,0,2021-2022,90.0,15.789473684210526,100.0
2164,Mateusz Praszelik,POL,MF,Hellas Verona,Serie A,20,2000,0.3,0,0,0,0,0,0,0,0.0,0,0,0,0,0,0,0,0,0,2021-2022,90.0,0.0,0.0
2165,Abdón Prats,ESP,FW,Mallorca,La Liga,28,1992,7.1,2,2,1,0,1,1,5,20.0,4,5,0,5,1,3,6,0,0,2021-2022,90.0,12.67605633802817,25.35211267605634
2166,Sanjin Prcić,BIH,MF,Strasbourg,Ligue 1,27,1993,24.3,47,28,14,27,6,14,29,48.3,15,18,3,15,47,94,19,0,0,2021-2022,90.0,174.07407407407408,174.07407407407408
2167,Nicolas de Préville,FRA,"FW,MF",Metz,Ligue 1,30,1991,21.9,17,8,7,8,2,3,19,15.8,16,12,4,8,5,22,11,0,0,2021-2022,90.0,20.547945205479454,69.86301369863014
2168,Isaac Price,NIR,MF,Everton,Premier League,17,2003,0.2,0,0,0,0,0,0,0,0.0,0,1,0,1,0,0,0,0,0,2021-2022,90.0,0.0,0.0
2169,Manuel Prietl,AUT,MF,Arminia,Bundesliga,29,1991,23.6,59,26,23,31,5,23,60,38.3,37,28,3,25,39,98,33,0,0,2021-2022,90.0,148.72881355932202,224.99999999999997
2170,Alejandro Primo,ESP,GK,Levante,La Liga,17,2004,1.0,0,0,0,0,0,0,0,0.0,0,0,0,0,0,0,0,0,0,2021-2022,90.0,0.0,0.0
2171,Grischa Prömel,GER,MF,Union Berlin,Bundesliga,26,1995,26.9,36,22,14,17,5,22,52,42.3,30,18,3,15,23,59,22,0,0,2021-2022,90.0,76.95167286245353,120.4460966542751
2172,Nick Proschwitz,GER,FW,Hoffenheim,Bundesliga,34,1986,0.3,0,0,0,0,0,0,0,0.0,0,0,0,0,0,0,0,0,0,2021-2022,90.0,0.0,0.0
2173,Ivan Provedel,ITA,GK,Spezia,Serie A,27,1994,30.7,0,0,0,0,0,0,1,0.0,1,0,0,0,2,2,10,2,0,2021-2022,90.0,5.863192182410424,0.0
2174,Javi Puado,ESP,"MF,FW",Espanyol,La Liga,23,1998,24.9,24,14,18,5,1,12,37,32.4,25,18,2,16,11,35,24,0,0,2021-2022,90.0,39.75903614457831,86.74698795180723
2175,Marc Pubill,ESP,"DF,MF",Levante,La Liga,18,2003,5.7,12,6,10,2,0,4,8,50.0,4,7,2,5,4,16,8,2,0,2021-2022,90.0,63.1578947368421,189.4736842105263
Rk,Player,Nation,Pos,Squad,Comp,0,0,90.0,0,0,3,3,3,Tkl,0,0.0,0,0,0,0,0,0,0,0,0,2021-2022,90.0,0.0,0.0
2176,Antonio Puertas,ESP,"MF,FW",Granada,La Liga,29,1992,25.1,34,20,18,12,4,17,44,38.6,27,33,3,30,11,45,36,0,0,2021-2022,90.0,39.44223107569721,121.91235059760956
2177,Riqui Puig,ESP,MF,Barcelona,La Liga,21,1999,5.4,6,3,2,4,0,2,14,14.3,12,5,0,5,3,9,0,0,0,2021-2022,90.0,49.99999999999999,99.99999999999999
2178,Teemu Pukki,FIN,FW,Norwich City,Premier League,31,1990,36.1,23,11,2,14,7,6,29,20.7,23,21,1,20,4,27,3,0,0,2021-2022,90.0,9.972299168975068,57.340720221606645
2179,Erick Pulgar,CHI,MF,Fiorentina,Serie A,27,1994,3.8,6,6,4,2,0,4,9,44.4,5,5,1,4,5,11,2,1,0,2021-2022,90.0,118.42105263157895,142.10526315789474
2180,Christian Pulisic,USA,"MF,FW",Chelsea,Premier League,22,1998,14.3,10,7,6,3,1,3,17,17.6,14,12,0,12,5,15,10,0,0,2021-2022,90.0,31.46853146853147,62.93706293706294
2181,Afimico Pululu,FRA,"FW,MF",Greuther Fürth,Bundesliga,22,1999,0.8,1,0,1,0,0,1,2,50.0,1,1,0,1,0,1,0,0,0,2021-2022,90.0,0.0,112.5
2182,Ignacio Pussetto,ARG,"FW,MF",Udinese,Serie A,25,1995,13.4,17,9,2,9,6,2,10,20.0,8,18,2,16,4,21,13,0,0,2021-2022,90.0,26.865671641791042,114.17910447761193
2183,Niklas Pyyhtiä,FIN,MF,Bologna,Serie A,17,2003,0.2,0,0,0,0,0,0,1,0.0,1,0,0,0,0,0,0,0,0,2021-2022,90.0,0.0,0.0
2184,Przemysław Płacheta,POL,"FW,MF",Norwich City,Premier League,23,1998,5.6,4,3,3,1,0,2,7,28.6,5,3,1,2,2,6,5,1,0,2021-2022,90.0,32.142857142857146,64.28571428571429
2185,Yacine Qasmi,MAR,FW,Rayo Vallecano,La Liga,30,1991,0.0,0,0,0,0,0,0,0,0.0,0,0,0,0,0,0,0,0,0,2021-2022,,,
2186,Fabio Quagliarella,ITA,FW,Sampdoria,Serie A,38,1983,18.5,6,2,2,2,2,2,15,13.3,13,14,1,13,3,9,12,0,0,2021-2022,90.0,14.594594594594595,29.18918918918919
2187,Quini,ESP,DF,Granada,La Liga,31,1989,25.6,73,34,48,21,4,42,79,53.2,37,28,10,18,36,109,62,0,0,2021-2022,90.0,126.5625,256.640625
2188,Dani Raba,ESP,"MF,FW",Villarreal,La Liga,25,1995,1.0,1,0,0,1,0,1,2,50.0,1,2,0,2,0,1,2,0,0,2021-2022,90.0,0.0,90.0
2189,Dani Raba,ESP,"MF,FW",Granada,La Liga,25,1995,0.3,2,2,1,0,1,2,3,66.7,1,0,0,0,1,3,0,0,0,2021-2022,90.0,300.0,600.0
2190,Adrien Rabiot,FRA,MF,Juventus,Serie A,26,1995,25.4,64,43,32,24,8,15,34,44.1,19,34,8,26,20,84,41,1,0,2021-2022,90.0,70.86614173228347,226.7716535433071
2191,Uroš Račić,SRB,MF,Valencia,La Liga,23,1998,13.4,32,18,9,19,4,12,33,36.4,21,16,6,10,16,48,21,0,0,2021-2022,90.0,107.46268656716417,214.92537313432834
2192,Nemanja Radoja,SRB,MF,Levante,La Liga,28,1993,13.5,25,8,9,13,3,8,20,40.0,12,16,9,7,22,47,16,2,0,2021-2022,90.0,146.66666666666669,166.66666666666669
2193,Nemanja Radonjić,SRB,FW,Marseille,Ligue 1,25,1996,0.2,0,0,0,0,0,0,0,0.0,0,0,0,0,0,0,0,0,0,2021-2022,90.0,0.0,0.0
2194,Ivan Radovanović,SRB,"DF,MF",Salernitana,Serie A,32,1988,11.7,11,7,8,3,0,7,19,36.8,12,14,7,7,7,18,29,0,0,2021-2022,89.99999999999999,53.84615384615385,84.61538461538461
2195,Ionuț Radu,ROU,GK,Inter,Serie A,24,1997,1.0,0,0,0,0,0,0,0,0.0,0,0,0,0,0,0,0,1,0,2021-2022,90.0,0.0,0.0
2196,Ștefan Radu,ROU,DF,Lazio,Serie A,34,1986,6.2,9,6,3,6,0,5,9,55.6,4,7,2,5,5,14,15,0,0,2021-2022,90.0,72.58064516129032,130.6451612903226
2197,Boris Radunović,SRB,GK,Cagliari,Serie A,25,1996,3.0,0,0,0,0,0,0,0,0.0,0,0,0,0,0,0,0,0,0,2021-2022,90.0,0.0,0.0
2198,Sidney Raebiger,GER,MF,RB Leipzig,Bundesliga,16,2005,0.0,0,0,0,0,0,0,0,0.0,0,0,0,0,0,0,0,0,0,2021-2022,,,
2199,Rafinha,BRA,MF,Real Sociedad,La Liga,28,1993,11.7,43,27,17,20,6,16,28,57.1,12,21,2,19,12,55,4,0,0,2021-2022,89.99999999999999,92.3076923076923,330.7692307692308
2200,Rafinha,BRA,"FW,MF",Paris S-G,Ligue 1,28,1993,2.4,14,8,3,9,2,7,11,63.6,4,3,0,3,4,18,0,0,0,2021-2022,90.0,150.0,525.0
Rk,Player,Nation,Pos,Squad,Comp,0,0,90.0,0,0,3,3,3,Tkl,0,0.0,0,0,0,0,0,0,0,0,0,2021-2022,90.0,0.0,0.0
2201,Antonio Raillo,ESP,DF,Mallorca,La Liga,29,1991,17.0,16,7,10,4,2,5,6,83.3,1,17,14,3,18,34,81,0,0,2021-2022,90.0,95.29411764705883,84.70588235294117
2202,Antonio Raimondo,ITA,FW,Bologna,Serie A,17,2004,0.8,0,0,0,0,0,0,1,0.0,1,1,0,1,0,0,1,0,0,2021-2022,90.0,0.0,0.0
2203,Predrag Rajković,SRB,GK,Reims,Ligue 1,25,1995,38.0,2,2,2,0,0,2,3,66.7,1,1,0,1,1,3,21,1,0,2021-2022,90.0,2.3684210526315788,4.7368421052631575
2204,Jesurun Rak Sakyi,ENG,"FW,MF",Crystal Palace,Premier League,18,2002,0.9,0,0,0,0,0,0,1,0.0,1,3,0,3,1,1,0,0,0,2021-2022,90.0,100.0,0.0
2205,Ivan Rakitić,CRO,MF,Sevilla,La Liga,33,1988,24.2,40,22,12,23,5,13,40,32.5,27,31,8,23,23,63,35,0,0,2021-2022,90.0,85.53719008264463,148.7603305785124
2206,Diant Ramaj,GER,GK,Eint Frankfurt,Bundesliga,19,2001,1.0,0,0,0,0,0,0,0,0.0,0,0,0,0,0,0,3,0,0,2021-2022,90.0,0.0,0.0
2207,Jonás Ramalho,ESP,DF,Osasuna,La Liga,28,1993,2.7,4,2,2,2,0,2,3,66.7,1,4,1,3,3,7,9,0,0,2021-2022,90.0,99.99999999999999,133.33333333333331
2208,Adil Rami,FRA,DF,Troyes,Ligue 1,35,1985,13.0,10,9,6,4,0,7,8,87.5,1,17,9,8,16,26,43,0,0,2021-2022,90.00000000000001,110.76923076923077,69.23076923076924
2209,Sandro Ramírez,ESP,FW,Getafe,La Liga,26,1995,16.2,7,3,1,3,3,1,12,8.3,11,14,3,11,2,9,3,0,0,2021-2022,90.0,11.11111111111111,38.88888888888889
2210,Guilherme Ramos,POR,DF,Arminia,Bundesliga,23,1997,10.1,25,15,17,8,0,12,19,63.2,7,21,8,13,27,52,52,0,0,2021-2022,90.0,240.59405940594058,222.77227722772278
2211,Sergio Ramos,ESP,DF,Paris S-G,Ligue 1,35,1986,8.9,12,5,6,6,0,8,15,53.3,7,4,2,2,8,20,27,0,0,2021-2022,90.0,80.89887640449439,121.34831460674158
2212,Aaron Ramsdale,ENG,GK,Arsenal,Premier League,23,1998,34.0,2,1,2,0,0,1,2,50.0,1,0,0,0,0,2,26,3,0,2021-2022,90.0,0.0,5.294117647058823
2213,Aaron Ramsey,WAL,MF,Juventus,Serie A,30,1990,1.1,0,0,0,0,0,0,0,0.0,0,0,0,0,1,1,0,0,0,2021-2022,90.0,81.81818181818181,0.0
2214,Jacob Ramsey,ENG,MF,Aston Villa,Premier League,20,2001,27.4,67,44,31,28,8,30,69,43.5,39,36,7,29,24,91,28,0,0,2021-2022,90.0,78.83211678832117,220.07299270072994
2215,Luca Ranieri,ITA,DF,Salernitana,Serie A,22,1999,23.4,38,21,23,11,4,19,33,57.6,14,18,8,10,22,60,67,0,0,2021-2022,89.99999999999999,84.61538461538461,146.15384615384616
2216,Andrea Ranocchia,ITA,DF,Inter,Serie A,33,1988,3.8,8,4,5,1,2,1,3,33.3,2,4,3,1,4,12,16,0,0,2021-2022,90.0,94.73684210526315,189.4736842105263
2217,Raphinha,BRA,"FW,MF",Leeds United,Premier League,24,1996,32.4,51,29,25,14,12,22,71,31.0,49,43,0,43,29,80,28,1,0,2021-2022,90.0,80.55555555555556,141.66666666666669
2218,Tobias Raschl,GER,MF,Greuther Fürth,Bundesliga,21,2000,6.6,12,9,4,8,0,5,7,71.4,2,10,1,9,3,15,1,0,0,2021-2022,90.0,40.90909090909091,163.63636363636363
2219,Elba Rashani,KVX,"FW,MF",Clermont Foot,Ligue 1,28,1993,19.5,40,21,15,21,4,17,55,30.9,38,34,3,31,11,51,20,0,0,2021-2022,90.0,50.76923076923077,184.6153846153846
2220,Marcus Rashford,ENG,"FW,MF",Manchester Utd,Premier League,23,1997,13.7,6,5,1,4,1,2,13,15.4,11,10,1,9,5,11,5,1,0,2021-2022,90.0,32.846715328467155,39.416058394160586
2221,Milot Rashica,KVX,"FW,MF",Norwich City,Premier League,25,1996,24.8,31,19,12,12,7,11,30,36.7,19,22,3,19,15,46,23,0,0,2021-2022,90.0,54.435483870967744,112.5
2222,Giacomo Raspadori,ITA,"MF,FW",Sassuolo,Serie A,21,2000,30.4,29,18,5,15,9,11,38,28.9,27,29,3,26,9,38,11,0,0,2021-2022,90.0,26.644736842105264,85.85526315789474
2223,Raúl,ESP,"FW,DF",Betis,La Liga,20,2000,0.0,0,0,0,0,0,0,0,0.0,0,0,0,0,0,0,0,0,0,2021-2022,,,
2224,David Raum,GER,"DF,FW",Hoffenheim,Bundesliga,23,1998,30.6,52,29,30,10,12,30,64,46.9,34,38,5,33,27,79,39,1,0,2021-2022,90.0,79.41176470588235,152.94117647058823
2225,Nicola Ravaglia,ITA,GK,Sampdoria,Serie A,32,1988,0.1,0,0,0,0,0,0,0,0.0,0,0,0,0,0,0,0,0,0,2021-2022,90.0,0.0,0.0
Rk,Player,Nation,Pos,Squad,Comp,0,0,90.0,0,0,3,3,3,Tkl,0,0.0,0,0,0,0,0,0,0,0,0,2021-2022,90.0,0.0,0.0
2226,David Raya,ESP,GK,Brentford,Premier League,25,1995,24.0,0,0,0,0,0,0,0,0.0,0,1,0,1,0,0,10,1,0,2021-2022,90.0,0.0,0.0
2227,Ante Rebić,CRO,FW,Milan,Serie A,27,1993,9.9,14,8,3,6,5,7,20,35.0,13,14,0,14,3,17,3,1,0,2021-2022,90.0,27.272727272727273,127.27272727272727
2228,Arkadiusz Reca,POL,DF,Spezia,Serie A,26,1995,19.7,31,19,21,3,7,20,30,66.7,10,20,7,13,32,63,47,2,0,2021-2022,90.0,146.19289340101523,141.62436548223351
2229,Lluís Recasens,ESP,DF,Espanyol,La Liga,19,2002,0.5,2,0,2,0,0,1,1,100.0,0,0,0,0,2,4,2,0,0,2021-2022,90.0,360.0,360.0
2230,Nathan Redmond,ENG,"MF,FW",Southampton,Premier League,27,1994,20.4,22,14,9,9,4,7,30,23.3,23,21,2,19,8,30,16,0,0,2021-2022,90.0,35.294117647058826,97.05882352941177
2231,Sergio Reguilón,ESP,"DF,MF",Tottenham,Premier League,24,1996,21.3,40,24,15,18,7,22,43,51.2,21,20,8,12,31,71,45,1,0,2021-2022,90.0,130.98591549295776,169.01408450704224
2232,Manolo Reina,ESP,GK,Mallorca,La Liga,36,1985,21.0,0,0,0,0,0,0,0,0.0,0,0,0,0,1,1,6,2,0,2021-2022,90.0,4.285714285714286,0.0
2233,Pepe Reina,ESP,GK,Lazio,Serie A,38,1982,15.0,0,0,0,0,0,0,1,0.0,1,0,0,0,0,0,1,1,0,2021-2022,90.0,0.0,0.0
2234,Jeff Reine-Adélaïde,FRA,"MF,DF",Lyon,Ligue 1,23,1998,2.2,5,3,4,1,0,4,5,80.0,1,2,0,2,0,5,0,1,0,2021-2022,90.0,0.0,204.54545454545453
2235,Reinier,BRA,"FW,MF",Dortmund,Bundesliga,19,2002,1.8,5,3,4,0,1,1,1,100.0,0,3,0,3,0,5,0,0,0,2021-2022,90.0,0.0,250.0
2236,Karim Rekik,NED,DF,Sevilla,La Liga,26,1994,12.2,11,8,4,6,1,2,9,22.2,7,11,6,5,9,20,19,0,0,2021-2022,90.0,66.39344262295083,81.14754098360656
2237,Álex Remiro,ESP,GK,Real Sociedad,La Liga,26,1995,35.0,0,0,0,0,0,0,0,0.0,0,0,0,0,1,1,24,2,0,2021-2022,90.0,2.571428571428571,0.0
2238,Panagiotis Retsos,GRE,DF,Hellas Verona,Serie A,22,1998,0.6,0,0,0,0,0,0,2,0.0,2,0,0,0,2,2,3,0,0,2021-2022,90.0,300.0,0.0
2239,Panagiotis Retsos,GRE,"DF,FW",Leverkusen,Bundesliga,22,1998,0.4,0,0,0,0,0,0,0,0.0,0,0,0,0,1,1,0,1,0,2021-2022,90.0,225.0,0.0
2240,Marco Reus,GER,"MF,FW",Dortmund,Bundesliga,32,1989,27.8,45,30,13,21,11,16,42,38.1,26,23,6,17,12,57,41,1,0,2021-2022,90.0,38.84892086330935,145.68345323741008
2241,Elvis Rexhbeçaj,GER,MF,Bochum,Bundesliga,23,1997,28.2,41,20,17,19,5,19,40,47.5,21,41,6,35,27,68,15,0,0,2021-2022,89.99999999999999,86.17021276595744,130.85106382978722
2242,Gio Reyna,USA,MF,Dortmund,Bundesliga,18,2002,4.9,7,4,2,4,1,3,9,33.3,6,6,0,6,1,8,3,0,0,2021-2022,90.0,18.36734693877551,128.57142857142856
2243,Bryan Reynolds,USA,DF,Roma,Serie A,20,2001,0.0,0,0,0,0,0,0,1,0.0,1,0,0,0,0,0,1,0,0,2021-2022,,,
2244,Nico Ribaudo,ESP,"MF,FW",Espanyol,La Liga,20,2001,12.4,15,6,9,5,1,11,34,32.4,23,14,2,12,7,22,3,0,0,2021-2022,90.0,50.806451612903224,108.87096774193549
2245,Tiago Ribeiro,POR,FW,Monaco,Ligue 1,19,2002,0.0,0,0,0,0,0,0,0,0.0,0,0,0,0,0,0,0,0,0,2021-2022,,,
2246,Franck Ribéry,FRA,"MF,FW",Salernitana,Serie A,38,1983,15.8,17,10,6,6,5,8,13,61.5,5,12,0,12,3,20,1,0,0,2021-2022,90.0,17.088607594936708,96.83544303797467
2247,Samuele Ricci,ITA,MF,Torino,Serie A,19,2001,8.0,8,4,4,2,2,2,5,40.0,3,7,1,6,14,22,9,0,0,2021-2022,90.0,157.5,90.0
2248,Samuele Ricci,ITA,MF,Empoli,Serie A,19,2001,17.0,33,19,17,13,3,20,34,58.8,14,24,5,19,31,64,18,0,0,2021-2022,90.0,164.11764705882354,174.7058823529412
2249,Declan Rice,ENG,MF,West Ham,Premier League,22,1999,35.3,80,42,45,32,3,38,71,53.5,33,45,21,24,63,143,52,1,0,2021-2022,90.0,160.62322946175638,203.9660056657224
2250,Chris Richards,USA,DF,Hoffenheim,Bundesliga,21,2000,14.5,26,15,10,15,1,11,18,61.1,7,21,9,12,22,48,50,1,0,2021-2022,90.0,136.55172413793102,161.3793103448276
Rk,Player,Nation,Pos,Squad,Comp,0,0,90.0,0,0,3,3,3,Tkl,0,0.0,0,0,0,0,0,0,0,0,0,2021-2022,90.0,0.0,0.0
2251,Chris Richards,USA,DF,Bayern Munich,Bundesliga,21,2000,0.0,0,0,0,0,0,0,0,0.0,0,1,0,1,0,0,0,0,0,2021-2022,,,
2252,Omar Richards,ENG,DF,Bayern Munich,Bundesliga,23,1998,4.9,19,12,11,5,3,11,16,68.8,5,7,1,6,4,23,7,0,0,2021-2022,90.0,73.46938775510203,348.9795918367347
2253,Taylor Richards,ENG,MF,Brighton,Premier League,20,2000,0.3,1,0,0,1,0,1,2,50.0,1,0,0,0,0,1,0,0,0,2021-2022,90.0,0.0,300.0
2254,Richarlison,BRA,FW,Everton,Premier League,24,1997,28.0,40,23,18,15,7,15,31,48.4,16,42,4,38,12,52,34,0,0,2021-2022,90.0,38.57142857142857,128.57142857142856
2255,Marco Richter,GER,"FW,MF",Hertha BSC,Bundesliga,23,1997,18.9,30,16,14,10,6,13,36,36.1,23,30,4,26,16,46,24,0,0,2021-2022,90.0,76.19047619047619,142.85714285714286
2256,Diego Rico,ESP,DF,Real Sociedad,La Liga,28,1993,18.3,41,20,19,17,5,22,45,48.9,23,29,4,25,30,71,54,0,0,2021-2022,90.0,147.54098360655738,201.63934426229508
2257,Sergio Rico,ESP,GK,Mallorca,La Liga,27,1993,14.0,0,0,0,0,0,0,0,0.0,0,0,0,0,0,0,5,2,0,2021-2022,90.0,0.0,0.0
2258,Sergio Rico,ESP,GK,Paris S-G,Ligue 1,27,1993,0.3,0,0,0,0,0,0,0,0.0,0,0,0,0,0,0,1,0,0,2021-2022,90.0,0.0,0.0
2259,Jaïro Riedewald,NED,MF,Crystal Palace,Premier League,24,1996,1.3,1,1,0,1,0,1,2,50.0,1,1,0,1,1,2,2,0,0,2021-2022,90.0,69.23076923076923,69.23076923076923
2260,Manuel Riemann,GER,GK,Bochum,Bundesliga,32,1988,31.0,1,0,1,0,0,1,4,25.0,3,0,0,0,1,2,12,3,0,2021-2022,90.0,2.903225806451613,2.903225806451613
2261,Tomás Rincón,VEN,MF,Torino,Serie A,33,1988,1.8,2,2,2,0,0,0,3,0.0,3,3,1,2,2,4,4,0,0,2021-2022,90.0,100.0,100.0
2262,Tomás Rincón,VEN,MF,Sampdoria,Serie A,33,1988,13.0,22,13,9,10,3,13,34,38.2,21,15,2,13,18,40,11,0,0,2021-2022,90.00000000000001,124.61538461538463,152.30769230769232
2263,Luis Rioja,ESP,"MF,FW",Alavés,La Liga,27,1993,34.6,28,15,11,10,7,14,58,24.1,44,22,1,21,25,53,20,0,0,2021-2022,90.0,65.02890173410404,72.83236994219652
2264,Renaud Ripart,FRA,"MF,FW",Troyes,Ligue 1,28,1993,21.0,38,21,18,15,5,18,50,36.0,32,21,1,20,19,57,21,1,0,2021-2022,90.0,81.42857142857143,162.85714285714286
2265,Mihailo Ristić,SRB,DF,Montpellier,Ligue 1,25,1995,20.0,44,32,26,16,2,25,43,58.1,18,16,6,10,17,61,48,0,0,2021-2022,90.0,76.5,198.0
2266,Matt Ritchie,SCO,DF,Newcastle Utd,Premier League,31,1989,14.9,22,15,10,10,2,10,27,37.0,17,10,2,8,13,35,26,0,0,2021-2022,90.0,78.5234899328859,132.88590604026845
2267,Maxence Rivera,FRA,FW,Saint-Étienne,Ligue 1,19,2002,0.1,0,0,0,0,0,0,0,0.0,0,0,0,0,0,0,0,0,0,2021-2022,90.0,0.0,0.0
2268,Rober,ESP,DF,Levante,La Liga,26,1995,22.3,36,20,27,7,2,23,39,59.0,16,25,15,10,30,66,90,1,0,2021-2022,90.0,121.0762331838565,145.29147982062779
2269,Sergi Roberto,ESP,"MF,DF",Barcelona,La Liga,29,1992,4.4,5,1,2,3,0,3,5,60.0,2,2,0,2,4,9,6,0,0,2021-2022,90.0,81.81818181818181,102.27272727272727
2270,Connor Roberts,WAL,DF,Burnley,Premier League,25,1995,18.8,20,13,10,7,3,10,15,66.7,5,25,5,20,22,42,62,1,0,2021-2022,90.0,105.31914893617021,95.74468085106382
2271,Patrick Roberts,ENG,MF,Troyes,Ligue 1,24,1997,0.2,0,0,0,0,0,0,0,0.0,0,0,0,0,0,0,0,0,0,2021-2022,90.0,0.0,0.0
2272,Tyler Roberts,WAL,"MF,FW",Leeds United,Premier League,22,1999,11.0,16,7,6,7,3,9,16,56.3,7,11,1,10,5,21,11,0,0,2021-2022,90.0,40.909090909090914,130.9090909090909
2273,Andrew Robertson,SCO,DF,Liverpool,Premier League,27,1994,28.2,36,21,16,15,5,20,35,57.1,15,24,3,21,23,59,61,0,0,2021-2022,89.99999999999999,73.40425531914893,114.89361702127658
2274,Marc Roca,ESP,MF,Bayern Munich,Bundesliga,24,1996,4.2,9,7,2,4,3,2,8,25.0,6,6,0,6,6,15,4,0,0,2021-2022,90.0,128.57142857142856,192.85714285714286
2275,Rubén Rochina,ESP,"MF,FW",Granada,La Liga,30,1991,8.3,21,13,7,8,6,8,28,28.6,20,11,1,10,6,27,5,1,0,2021-2022,90.0,65.06024096385542,227.71084337349396
Rk,Player,Nation,Pos,Squad,Comp,0,0,90.0,0,0,3,3,3,Tkl,0,0.0,0,0,0,0,0,0,0,0,0,2021-2022,90.0,0.0,0.0
2276,Cimo Röcker,GER,DF,Hertha BSC,Bundesliga,27,1994,0.2,0,0,0,0,0,0,0,0.0,0,0,0,0,2,2,0,0,0,2021-2022,90.0,900.0,0.0
2277,Enzo Roco,CHI,DF,Elche,La Liga,28,1992,28.4,36,20,24,11,1,15,24,62.5,9,38,27,11,28,64,110,3,0,2021-2022,90.0,88.73239436619718,114.08450704225353
2278,Stian Rode Gregersen,NOR,DF,Bordeaux,Ligue 1,26,1995,21.7,39,26,23,12,4,18,33,54.5,15,26,16,10,38,77,103,2,0,2021-2022,90.0,157.6036866359447,161.75115207373273
2279,Sebastian Rode,GER,MF,Eint Frankfurt,Bundesliga,30,1990,8.4,15,7,5,8,2,5,17,29.4,12,11,1,10,13,28,8,0,0,2021-2022,90.0,139.28571428571428,160.7142857142857
2280,Joe Rodon,WAL,DF,Tottenham,Premier League,23,1997,1.0,0,0,0,0,0,0,0,0.0,0,2,1,1,0,0,7,0,0,2021-2022,90.0,0.0,0.0
2281,Rodri,ESP,MF,Manchester City,Premier League,25,1996,32.0,72,43,24,38,10,32,59,54.2,27,28,5,23,28,100,45,0,0,2021-2022,90.0,78.75,202.5
2282,Rodri,ESP,FW,Betis,La Liga,21,2000,9.8,10,7,4,5,1,5,22,22.7,17,11,0,11,3,13,4,0,0,2021-2022,90.0,27.551020408163264,91.83673469387755
2283,Rodrigo,ESP,"MF,FW",Leeds United,Premier League,30,1991,25.2,20,9,7,6,7,4,32,12.5,28,12,0,12,11,31,27,1,0,2021-2022,90.0,39.28571428571429,71.42857142857143
2284,Gerson Rodrigues,LUX,"FW,MF",Troyes,Ligue 1,26,1995,9.4,12,9,2,6,4,1,17,5.9,16,8,1,7,0,12,2,0,0,2021-2022,90.0,0.0,114.89361702127658
2285,Kévin Rodrigues,POR,"DF,FW",Rayo Vallecano,La Liga,27,1994,4.8,15,11,8,7,0,6,10,60.0,4,10,1,9,7,22,6,0,0,2021-2022,90.0,131.25,281.25
2286,Ángel Rodríguez,ESP,"FW,MF",Mallorca,La Liga,34,1987,17.2,15,9,6,7,2,4,21,19.0,17,15,1,14,3,18,13,0,0,2021-2022,90.0,15.697674418604652,78.48837209302326
2287,Óscar Rodríguez Arnaiz,ESP,"MF,FW",Getafe,La Liga,23,1998,10.5,16,11,6,8,2,4,12,33.3,8,7,1,6,11,27,6,0,0,2021-2022,90.0,94.28571428571428,137.14285714285714
2288,Óscar Rodríguez Arnaiz,ESP,"FW,MF",Sevilla,La Liga,23,1998,4.6,4,3,1,3,0,2,3,66.7,1,2,0,2,5,9,7,1,0,2021-2022,90.0,97.82608695652175,78.26086956521739
2289,Dani Rodríguez,ESP,"MF,FW",Mallorca,La Liga,33,1988,31.5,53,31,20,24,9,15,46,32.6,31,28,3,25,20,73,27,0,0,2021-2022,90.0,57.142857142857146,151.42857142857144
2290,Guido Rodríguez,ARG,MF,Betis,La Liga,27,1994,28.1,97,53,46,45,6,54,98,55.1,44,55,12,43,31,128,56,0,0,2021-2022,90.0,99.288256227758,310.6761565836299
2291,Jay Rodriguez,ENG,FW,Burnley,Premier League,32,1989,15.4,20,12,8,8,4,4,14,28.6,10,19,1,18,4,24,12,0,0,2021-2022,90.0,23.376623376623378,116.88311688311688
2292,Ricardo Rodríguez,SUI,DF,Torino,Serie A,28,1992,27.5,36,21,11,23,2,18,33,54.5,15,22,8,14,41,77,48,1,0,2021-2022,89.99999999999999,134.18181818181816,117.81818181818181
2293,Rodrygo,BRA,FW,Real Madrid,La Liga,20,2001,16.9,18,14,7,4,7,3,18,16.7,15,21,0,21,11,29,3,0,0,2021-2022,90.0,58.57988165680474,95.85798816568048
2294,Mads Roerslev,DEN,DF,Brentford,Premier League,22,1999,13.8,23,12,19,2,2,14,32,43.8,18,14,5,9,16,39,29,0,0,2021-2022,90.0,104.34782608695652,149.99999999999997
2295,Marko Rog,CRO,MF,Cagliari,Serie A,26,1995,3.5,5,3,1,2,2,1,8,12.5,7,6,1,5,1,6,3,0,0,2021-2022,90.0,25.714285714285715,128.57142857142856
2296,Rogério,BRA,DF,Sassuolo,Serie A,23,1998,19.2,21,13,12,5,4,15,22,68.2,7,20,8,12,18,39,42,1,0,2021-2022,90.0,84.375,98.4375
2297,Alessio Romagnoli,ITA,DF,Milan,Serie A,26,1995,15.7,24,14,14,10,0,14,18,77.8,4,21,12,9,19,43,45,0,0,2021-2022,90.0,108.9171974522293,137.57961783439492
2298,Simone Romagnoli,ITA,DF,Empoli,Serie A,31,1990,16.6,28,12,14,12,2,15,20,75.0,5,34,28,6,9,37,86,0,0,2021-2022,90.0,48.79518072289156,151.80722891566262
2299,Leo Román,ESP,GK,Mallorca,La Liga,21,2000,2.0,0,0,0,0,0,0,0,0.0,0,0,0,0,0,0,2,0,0,2021-2022,90.0,0.0,0.0
2300,Cristian Romero,ARG,DF,Tottenham,Premier League,23,1998,20.5,62,39,39,21,2,22,34,64.7,12,46,21,25,33,95,74,1,0,2021-2022,90.0,144.8780487804878,272.1951219512195
Rk,Player,Nation,Pos,Squad,Comp,0,0,90.0,0,0,3,3,3,Tkl,0,0.0,0,0,0,0,0,0,0,0,0,2021-2022,90.0,0.0,0.0
2301,Iván Romero,ESP,FW,Sevilla,La Liga,20,2001,2.0,2,2,0,2,0,0,0,0.0,0,1,0,1,2,4,0,0,0,2021-2022,90.0,90.0,90.0
2302,Luka Romero,ARG,FW,Lazio,Serie A,16,2004,0.9,2,1,0,1,1,0,2,0.0,2,0,0,0,1,3,0,0,0,2021-2022,90.0,100.0,200.0
2303,Sergio Romero,ARG,GK,Venezia,Serie A,34,1987,16.0,2,2,2,0,0,2,2,100.0,0,0,0,0,1,3,10,0,0,2021-2022,90.0,5.625,11.25
2304,Oriol Romeu,ESP,MF,Southampton,Premier League,29,1991,32.1,77,39,25,45,7,28,73,38.4,45,39,8,31,51,128,43,0,0,2021-2022,90.0,142.99065420560746,215.8878504672897
2305,Cristiano Ronaldo,POR,FW,Manchester Utd,Premier League,36,1985,27.3,8,6,1,5,2,2,6,33.3,4,8,0,8,2,10,29,0,0,2021-2022,90.0,6.593406593406593,26.373626373626372
2306,Cristiano Ronaldo,POR,FW,Juventus,Serie A,36,1985,0.3,1,0,0,1,0,1,1,100.0,0,0,0,0,0,1,0,0,0,2021-2022,90.0,0.0,300.0
2307,Salomón Rondón,VEN,FW,Everton,Premier League,31,1989,8.8,6,1,1,2,3,4,14,28.6,10,5,0,5,0,6,10,0,0,2021-2022,90.0,0.0,61.36363636363636
2308,Valentin Rongier,FRA,"MF,DF",Marseille,Ligue 1,26,1994,24.4,77,51,36,36,5,28,60,46.7,32,26,5,21,33,110,14,0,0,2021-2022,90.0,121.72131147540985,284.016393442623
2309,Marten de Roon,NED,"MF,DF",Atalanta,Serie A,30,1991,28.3,69,42,33,29,7,34,62,54.8,28,36,2,34,45,114,41,0,0,2021-2022,90.0,143.1095406360424,219.43462897526499
2310,Unai Ropero,ESP,MF,Alavés,La Liga,19,2001,0.1,0,0,0,0,0,0,0,0.0,0,0,0,0,1,1,0,0,0,2021-2022,90.0,900.0,0.0
2311,Pablo Rosario,NED,MF,Nice,Ligue 1,24,1997,30.3,59,37,18,32,9,26,66,39.4,40,33,7,26,38,97,43,0,0,2021-2022,90.0,112.87128712871286,175.24752475247524
2312,Romario Rösch,GER,MF,Mainz 05,Bundesliga,22,1999,0.0,0,0,0,0,0,0,0,0.0,0,0,0,0,0,0,0,0,0,2021-2022,,,
2313,Danny Rose,ENG,DF,Watford,Premier League,31,1990,7.7,16,10,11,4,1,10,24,41.7,14,8,5,3,14,30,11,1,0,2021-2022,90.0,163.63636363636365,187.01298701298703
2314,Francesco Rossi,ITA,GK,Atalanta,Serie A,30,1991,0.4,0,0,0,0,0,0,0,0.0,0,0,0,0,0,0,0,0,0,2021-2022,90.0,0.0,0.0
2315,Tom Rothe,GER,DF,Dortmund,Bundesliga,16,2004,1.0,4,3,2,2,0,3,6,50.0,3,2,0,2,2,6,3,0,0,2021-2022,90.0,180.0,360.0
2316,Jérôme Roussillon,FRA,DF,Wolfsburg,Bundesliga,28,1993,19.7,14,9,8,6,0,10,16,62.5,6,24,5,19,14,28,34,2,0,2021-2022,90.0,63.95939086294416,63.95939086294416
2317,Nicolò Rovella,ITA,MF,Genoa,Serie A,19,2001,16.3,37,26,16,14,7,15,40,37.5,25,21,1,20,20,57,20,0,0,2021-2022,90.0,110.42944785276073,204.29447852760737
2318,Jon Rowe,ENG,"FW,MF",Norwich City,Premier League,18,2003,2.5,3,2,2,1,0,2,3,66.7,1,7,0,7,3,6,1,0,0,2021-2022,90.0,108.0,108.0
2319,Amir Rrahmani,KVX,DF,Napoli,Serie A,27,1994,32.5,21,11,15,5,1,15,19,78.9,4,36,25,11,19,40,89,0,0,2021-2022,90.0,52.61538461538461,58.15384615384615
2320,Ruan,BRA,DF,Sassuolo,Serie A,22,1999,2.4,7,4,7,0,0,3,4,75.0,1,6,5,1,2,9,24,1,0,2021-2022,90.0,75.0,262.5
2321,Rubén,ESP,DF,Espanyol,La Liga,20,2001,1.7,6,1,4,2,0,4,7,57.1,3,0,0,0,2,8,4,0,0,2021-2022,90.0,105.88235294117646,317.6470588235294
2322,John Ruddy,ENG,GK,Wolves,Premier League,34,1986,1.5,0,0,0,0,0,0,0,0.0,0,0,0,0,0,0,3,0,0,2021-2022,90.0,0.0,0.0
2323,Antonio Rüdiger,GER,DF,Chelsea,Premier League,28,1993,33.7,48,28,29,15,4,36,48,75.0,12,20,11,9,28,76,91,1,0,2021-2022,90.0,74.77744807121661,128.18991097922847
2324,Sebastian Rudy,GER,MF,Hoffenheim,Bundesliga,31,1990,8.6,22,12,9,13,0,11,21,52.4,10,8,3,5,11,33,8,1,0,2021-2022,90.0,115.11627906976746,230.23255813953492
2325,Daniele Rugani,ITA,DF,Juventus,Serie A,27,1994,9.8,8,5,4,4,0,4,7,57.1,3,9,4,5,11,19,47,0,0,2021-2022,90.0,101.0204081632653,73.46938775510203
Rk,Player,Nation,Pos,Squad,Comp,0,0,90.0,0,0,3,3,3,Tkl,0,0.0,0,0,0,0,0,0,0,0,0,2021-2022,90.0,0.0,0.0
2326,Matteo Ruggeri,ITA,DF,Salernitana,Serie A,19,2002,7.5,8,4,5,2,1,7,10,70.0,3,6,1,5,2,10,25,0,0,2021-2022,90.0,24.0,96.0
2327,Mário Rui,POR,DF,Napoli,Serie A,30,1991,33.2,68,43,32,28,8,39,84,46.4,45,31,7,24,40,108,50,0,0,2021-2022,90.0,108.43373493975902,184.33734939759034
2328,Aitor Ruibal,ESP,"FW,DF",Betis,La Liga,25,1996,9.5,21,15,13,3,5,10,34,29.4,24,8,0,8,8,29,6,0,0,2021-2022,90.0,75.78947368421052,198.94736842105263
2329,Isma Ruiz,ESP,MF,Granada,La Liga,20,2001,3.1,3,1,3,0,0,1,9,11.1,8,5,2,3,3,6,2,0,0,2021-2022,90.0,87.09677419354838,87.09677419354838
2330,Fabián Ruiz Peña,ESP,MF,Napoli,Serie A,25,1996,26.5,55,33,22,29,4,29,67,43.3,38,34,1,33,22,77,32,0,0,2021-2022,90.0,74.71698113207547,186.79245283018867
2331,Víctor Ruiz,ESP,DF,Betis,La Liga,32,1989,15.8,11,9,7,2,2,6,9,66.7,3,18,13,5,29,40,71,1,0,2021-2022,90.0,165.1898734177215,62.658227848101255
2332,Gerónimo Rulli,ARG,GK,Villarreal,La Liga,29,1992,32.0,0,0,0,0,0,0,4,0.0,4,0,0,0,1,1,15,5,0,2021-2022,90.0,2.8125,0.0
2333,Lukas Rupp,GER,MF,Norwich City,Premier League,30,1991,8.5,9,4,5,3,1,4,15,26.7,11,11,1,10,9,18,7,0,0,2021-2022,90.0,95.29411764705883,95.29411764705883
2334,Alessandro Russo,ITA,MF,Salernitana,Serie A,17,2003,0.3,1,0,1,0,0,0,1,0.0,1,0,0,0,0,1,1,0,0,2021-2022,90.0,0.0,300.0
2335,Franco Russo,ARG,DF,Mallorca,La Liga,26,1994,16.3,19,10,10,9,0,13,31,41.9,18,14,9,5,27,46,73,1,0,2021-2022,90.0,149.079754601227,104.9079754601227
2336,Georginio Rutter,FRA,"FW,MF",Hoffenheim,Bundesliga,19,2002,17.9,18,13,4,8,6,6,17,35.3,11,29,1,28,6,24,11,1,0,2021-2022,90.0,30.167597765363134,90.5027932960894
2337,Mathew Ryan,AUS,GK,Real Sociedad,La Liga,29,1992,3.0,0,0,0,0,0,0,0,0.0,0,0,0,0,0,0,2,0,0,2021-2022,90.0,0.0,0.0
2338,Julian Ryerson,NOR,DF,Union Berlin,Bundesliga,23,1997,15.9,27,15,11,12,4,17,25,68.0,8,12,4,8,16,43,32,0,0,2021-2022,90.0,90.56603773584905,152.83018867924528
2339,Frederik Rønnow,DEN,GK,Union Berlin,Bundesliga,28,1992,7.0,0,0,0,0,0,0,0,0.0,0,0,0,0,0,0,1,0,0,2021-2022,90.0,0.0,0.0
2340,José Sá,POR,GK,Wolves,Premier League,28,1993,36.5,2,1,2,0,0,2,4,50.0,2,0,0,0,2,4,19,5,0,2021-2022,90.0,4.931506849315069,4.931506849315069
2341,Roli Pereira de Sa,FRA,MF,Nantes,Ligue 1,24,1996,6.4,12,4,3,5,4,3,20,15.0,17,6,0,6,6,18,3,0,0,2021-2022,90.0,84.375,168.75
2342,Youssouf Sabaly,SEN,DF,Betis,La Liga,28,1993,8.8,12,10,11,0,1,7,13,53.8,6,11,4,7,13,25,16,1,0,2021-2022,90.0,132.95454545454544,122.72727272727272
2343,Mathys Saban,FRA,"FW,MF",Saint-Étienne,Ligue 1,19,2002,0.8,4,2,2,2,0,1,1,100.0,0,1,0,1,0,4,0,0,0,2021-2022,90.0,0.0,450.0
2344,Stefano Sabelli,ITA,DF,Genoa,Serie A,28,1993,3.9,6,3,3,2,1,3,9,33.3,6,5,1,4,3,9,12,0,0,2021-2022,90.0,69.23076923076923,138.46153846153845
2345,Abdelhamid Sabiri,MAR,"MF,FW",Sampdoria,Serie A,24,1996,9.9,34,18,10,15,9,7,25,28.0,18,10,2,8,7,41,3,0,0,2021-2022,90.0,63.63636363636363,309.09090909090907
2346,Marcel Sabitzer,AUT,"MF,FW",RB Leipzig,Bundesliga,27,1994,0.5,2,1,1,1,0,1,1,100.0,0,0,0,0,1,3,0,0,0,2021-2022,90.0,180.0,360.0
2347,Marcel Sabitzer,AUT,"MF,DF",Bayern Munich,Bundesliga,27,1994,10.1,18,7,8,8,2,9,19,47.4,10,7,0,7,9,27,10,1,0,2021-2022,90.0,80.1980198019802,160.3960396039604
2348,Falaye Sacko,MLI,DF,Saint-Étienne,Ligue 1,26,1995,7.4,15,10,14,1,0,13,16,81.3,3,11,7,4,4,19,18,2,0,2021-2022,90.0,48.648648648648646,182.43243243243242
2349,Alexis Saelemaekers,BEL,FW,Milan,Serie A,22,1999,20.7,43,22,12,17,14,15,51,29.4,36,19,0,19,15,58,8,0,0,2021-2022,90.0,65.21739130434783,186.95652173913044
2350,Rafiki Said,COM,"MF,FW",Brest,Ligue 1,21,2000,1.4,4,3,1,2,1,3,4,75.0,1,2,0,2,0,4,0,0,0,2021-2022,90.0,0.0,257.14285714285717
Rk,Player,Nation,Pos,Squad,Comp,0,0,90.0,0,0,3,3,3,Tkl,0,0.0,0,0,0,0,0,0,0,0,0,2021-2022,90.0,0.0,0.0
2351,Wesley Saïd,FRA,"FW,MF",Lens,Ligue 1,26,1995,7.3,10,5,1,8,1,1,9,11.1,8,4,0,4,2,12,0,0,0,2021-2022,90.0,24.657534246575345,123.28767123287672
2352,Allan Saint-Maximin,FRA,"FW,MF",Newcastle Utd,Premier League,24,1997,31.2,13,8,6,4,3,3,17,17.6,14,13,2,11,11,24,3,0,0,2021-2022,90.0,31.73076923076923,37.5
2353,Romain Saïss,MAR,DF,Wolves,Premier League,31,1990,30.1,40,27,28,11,1,19,33,57.6,14,41,21,20,58,98,158,2,0,2021-2022,90.00000000000001,173.42192691029902,119.60132890365449
2354,Bukayo Saka,ENG,"FW,MF",Arsenal,Premier League,19,2001,33.1,40,21,12,17,11,13,39,33.3,26,28,2,26,22,62,23,0,0,2021-2022,90.0,59.81873111782477,108.76132930513594
2355,Mamadou Sakho,FRA,DF,Montpellier,Ligue 1,31,1990,28.6,34,22,26,8,0,16,26,61.5,10,41,34,7,41,75,134,4,0,2021-2022,90.0,129.020979020979,106.993006993007
2356,Bakary Sako,MLI,"FW,MF",Saint-Étienne,Ligue 1,33,1988,1.7,0,0,0,0,0,0,1,0.0,1,3,1,2,0,0,0,0,0,2021-2022,90.0,0.0,0.0
2357,Jacopo Sala,ITA,MF,Spezia,Serie A,29,1991,9.8,22,11,10,10,2,13,30,43.3,17,6,0,6,14,36,11,0,0,2021-2022,90.0,128.57142857142856,202.0408163265306
2358,Mohamed Salah,EGY,FW,Liverpool,Premier League,29,1992,30.7,17,8,5,9,3,6,19,31.6,13,7,1,6,6,23,5,0,0,2021-2022,90.0,17.58957654723127,49.8371335504886
2359,Eddie Salcedo,ITA,"MF,FW",Spezia,Serie A,19,2001,4.8,1,1,0,0,1,0,1,0.0,1,2,1,1,0,1,7,1,0,2021-2022,90.0,0.0,18.75
2360,William Saliba,FRA,DF,Marseille,Ligue 1,20,2001,36.0,54,32,36,16,2,27,35,77.1,8,24,16,8,48,102,85,0,0,2021-2022,90.0,120.0,135.0
2361,Romain Salin,FRA,GK,Rennes,Ligue 1,37,1984,1.0,0,0,0,0,0,0,0,0.0,0,0,0,0,0,0,0,0,0,2021-2022,90.0,0.0,0.0
2362,Mohammed Salisu,GHA,DF,Southampton,Premier League,22,1999,33.0,80,47,54,22,4,40,65,61.5,25,49,26,23,78,158,158,4,0,2021-2022,90.0,212.72727272727275,218.1818181818182
2363,Roland Sallai,HUN,"MF,FW",Freiburg,Bundesliga,24,1997,17.2,22,16,8,11,3,7,23,30.4,16,12,0,12,11,33,12,0,0,2021-2022,90.0,57.55813953488373,115.11627906976746
2364,Yoann Salmier,GUF,DF,Troyes,Ligue 1,28,1992,29.6,58,33,44,11,3,26,34,76.5,8,30,14,16,40,98,94,0,0,2021-2022,90.0,121.62162162162161,176.35135135135135
2365,Salvi,ESP,"MF,FW",Cádiz,La Liga,30,1991,15.5,20,10,9,8,3,8,20,40.0,12,17,2,15,6,26,11,0,0,2021-2022,90.0,34.83870967741935,116.12903225806451
2366,Lazar Samardzic,SRB,"MF,FW",Udinese,Serie A,19,2002,5.4,13,9,4,7,2,7,26,26.9,19,6,0,6,2,15,2,0,0,2021-2022,90.0,33.33333333333333,216.66666666666666
2367,Diadie Samassékou,MLI,MF,Hoffenheim,Bundesliga,25,1996,18.4,41,26,14,21,6,21,44,47.7,23,27,11,16,28,69,26,0,0,2021-2022,90.0,136.95652173913044,200.5434782608696
2368,Mama Samba Baldé,GNB,"MF,FW",Troyes,Ligue 1,25,1995,19.1,40,28,16,14,10,8,26,30.8,18,32,1,31,5,45,9,0,0,2021-2022,90.0,23.56020942408377,188.48167539267016
2369,Albert Sambi Lokonga,BEL,MF,Arsenal,Premier League,21,1999,12.6,22,18,11,9,2,12,14,85.7,2,12,7,5,13,35,12,4,0,2021-2022,90.0,92.85714285714286,157.14285714285717
2370,Junior Sambia,FRA,"DF,FW",Montpellier,Ligue 1,24,1996,17.0,22,13,12,7,3,13,22,59.1,9,22,3,19,21,43,31,0,0,2021-2022,90.0,111.17647058823529,116.47058823529412
2371,Luigi Samele,ITA,FW,Sassuolo,Serie A,19,2002,0.1,0,0,0,0,0,0,0,0.0,0,0,0,0,0,0,1,0,0,2021-2022,90.0,0.0,0.0
2372,Fede San Emeterio,ESP,MF,Cádiz,La Liga,24,1997,9.2,16,5,5,8,3,5,15,33.3,10,5,0,5,8,24,6,0,0,2021-2022,90.0,78.26086956521739,156.52173913043478
2373,Antonio Sanabria,PAR,FW,Torino,Serie A,25,1996,20.0,3,2,0,1,2,1,4,25.0,3,11,4,7,2,5,10,0,0,2021-2022,90.0,9.0,13.5
2374,Oihan Sancet,ESP,FW,Athletic Club,La Liga,21,2000,15.8,12,7,2,8,2,5,20,25.0,15,2,0,2,5,17,13,0,0,2021-2022,90.0,28.481012658227844,68.35443037974683
2375,Renato Sanches,POR,"MF,FW",Lille,Ligue 1,23,1997,18.3,19,7,8,10,1,9,26,34.6,17,14,3,11,14,33,7,0,0,2021-2022,90.0,68.85245901639344,93.44262295081967
Rk,Player,Nation,Pos,Squad,Comp,0,0,90.0,0,0,3,3,3,Tkl,0,0.0,0,0,0,0,0,0,0,0,0,2021-2022,90.0,0.0,0.0
2376,Alexis Sánchez,CHI,FW,Inter,Serie A,32,1988,9.8,9,8,0,6,3,2,11,18.2,9,4,0,4,2,11,3,0,0,2021-2022,90.0,18.36734693877551,82.65306122448979
2377,Antonio Sánchez,ESP,"MF,FW",Mallorca,La Liga,24,1997,18.0,53,24,29,17,7,19,49,38.8,30,32,2,30,32,85,32,1,0,2021-2022,90.0,160.0,265.0
2378,Davinson Sánchez,COL,DF,Tottenham,Premier League,25,1996,18.1,41,22,25,14,2,19,28,67.9,9,24,16,8,30,71,54,3,0,2021-2022,90.0,149.17127071823202,203.8674033149171
2379,Germán Sánchez,ESP,DF,Granada,La Liga,34,1986,25.5,27,19,18,9,0,11,20,55.0,9,19,16,3,28,55,137,0,0,2021-2022,90.0,98.82352941176471,95.29411764705883
2380,Manu Sánchez,ESP,DF,Osasuna,La Liga,20,2000,25.1,72,34,41,22,9,43,79,54.4,36,28,3,25,18,90,43,0,0,2021-2022,90.0,64.5418326693227,258.1673306772908
2381,Robert Sánchez,ESP,GK,Brighton,Premier League,23,1997,37.0,2,1,2,0,0,1,1,100.0,0,1,0,1,0,2,11,4,0,2021-2022,90.0,0.0,4.864864864864865
2382,Jadon Sancho,ENG,"FW,MF",Manchester Utd,Premier League,21,2000,21.1,14,8,9,4,1,8,22,36.4,14,19,0,19,15,29,5,3,0,2021-2022,90.0,63.981042654028435,59.71563981042654
2383,Philippe Sandler,NED,DF,Troyes,Ligue 1,24,1997,0.8,0,0,0,0,0,0,0,0.0,0,1,1,0,3,3,6,0,0,2021-2022,90.0,337.5,0.0
2384,Alex Sandro,BRA,DF,Juventus,Serie A,30,1991,19.8,27,16,15,9,3,11,25,44.0,14,17,6,11,27,54,40,0,0,2021-2022,90.0,122.72727272727273,122.72727272727273
2385,Leroy Sané,GER,"FW,MF",Bayern Munich,Bundesliga,25,1996,22.0,28,16,5,19,4,9,24,37.5,15,18,0,18,12,40,2,1,0,2021-2022,90.0,49.09090909090909,114.54545454545455
2386,Oier Sanjurjo,ESP,MF,Osasuna,La Liga,35,1986,8.4,10,6,3,7,0,2,19,10.5,17,8,3,5,1,11,9,0,0,2021-2022,90.0,10.714285714285714,107.14285714285714
2387,Mohamed Sankoh,NED,FW,Stuttgart,Bundesliga,17,2003,0.0,0,0,0,0,0,0,0,0.0,0,0,0,0,0,0,0,0,0,2021-2022,,,
2388,Morgan Sanson,FRA,MF,Aston Villa,Premier League,26,1994,4.0,12,8,7,2,3,3,7,42.9,4,13,0,13,10,22,2,1,0,2021-2022,90.0,225.0,270.0
2389,Nicola Sansone,ITA,"FW,MF",Bologna,Serie A,29,1991,10.0,13,7,5,6,2,3,15,20.0,12,1,0,1,4,17,2,0,0,2021-2022,90.0,36.0,117.0
2390,Baptiste Santamaria,FRA,"MF,DF",Rennes,Ligue 1,26,1995,28.0,52,27,15,31,6,24,44,54.5,20,33,12,21,33,85,42,0,0,2021-2022,90.0,106.07142857142857,167.14285714285714
2391,Baptiste Santamaria,FRA,MF,Freiburg,Bundesliga,26,1995,0.2,0,0,0,0,0,0,1,0.0,1,0,0,0,1,1,1,0,0,2021-2022,90.0,450.0,0.0
2392,Federico Santander,PAR,"FW,DF",Bologna,Serie A,30,1991,0.7,2,1,1,1,0,1,1,100.0,0,0,0,0,0,2,0,0,0,2021-2022,90.0,0.0,257.14285714285717
2393,Jesús Santiago,ESP,MF,Valencia,La Liga,17,2004,0.9,2,2,1,1,0,0,2,0.0,2,1,0,1,0,2,1,0,0,2021-2022,90.0,0.0,200.0
2394,Samir Santos,BRA,DF,Watford,Premier League,26,1994,18.6,24,11,18,6,0,8,19,42.1,11,21,11,10,43,67,85,3,0,2021-2022,90.0,208.06451612903223,116.1290322580645
2395,Samir Santos,BRA,DF,Udinese,Serie A,26,1994,15.8,36,16,22,13,1,15,25,60.0,10,21,7,14,42,78,62,0,0,2021-2022,90.0,239.24050632911388,205.06329113924048
2396,Sergio Santos,ESP,DF,Real Madrid,La Liga,20,2001,0.1,0,0,0,0,0,0,0,0.0,0,0,0,0,0,0,0,0,0,2021-2022,90.0,0.0,0.0
2397,Alvaro Sanz,ESP,MF,Barcelona,La Liga,20,2001,0.3,0,0,0,0,0,0,1,0.0,1,0,0,0,0,0,0,0,0,2021-2022,90.0,0.0,0.0
2398,Riccardo Saponara,ITA,FW,Fiorentina,Serie A,29,1991,14.3,10,2,1,6,3,6,16,37.5,10,5,0,5,1,11,3,0,0,2021-2022,90.0,6.293706293706294,62.93706293706294
2399,Pablo Sarabia,ESP,FW,Paris S-G,Ligue 1,29,1992,0.2,0,0,0,0,0,0,1,0.0,1,0,0,0,0,0,0,0,0,2021-2022,90.0,0.0,0.0
2400,Marcelo Saracchi,URU,DF,Levante,La Liga,23,1998,2.1,8,5,6,1,1,2,4,50.0,2,3,0,3,4,12,7,1,0,2021-2022,90.0,171.42857142857142,342.85714285714283
Rk,Player,Nation,Pos,Squad,Comp,0,0,90.0,0,0,3,3,3,Tkl,0,0.0,0,0,0,0,0,0,0,0,0,2021-2022,90.0,0.0,0.0
2401,Josh Sargent,USA,"FW,MF",Norwich City,Premier League,21,2000,17.5,26,14,15,7,4,14,39,35.9,25,29,2,27,11,37,18,2,0,2021-2022,90.0,56.57142857142857,133.71428571428572
2402,Jeremy Sarmiento,ECU,"FW,MF",Brighton,Premier League,19,2002,0.5,1,1,0,0,1,0,2,0.0,2,2,0,2,0,1,0,0,0,2021-2022,90.0,0.0,180.0
2403,Bouna Sarr,SEN,DF,Bayern Munich,Bundesliga,29,1992,0.7,4,4,2,1,1,4,5,80.0,1,2,1,1,6,10,1,0,0,2021-2022,90.0,771.4285714285714,514.2857142857143
2404,Ismaila Sarr,SEN,"FW,MF",Watford,Premier League,23,1998,20.7,12,7,4,3,5,5,19,26.3,14,10,1,9,9,21,10,0,0,2021-2022,90.0,39.130434782608695,52.173913043478265
2405,Malang Sarr,FRA,DF,Chelsea,Premier League,22,1999,6.1,14,7,10,2,2,7,12,58.3,5,6,3,3,11,25,20,0,0,2021-2022,90.0,162.29508196721312,206.55737704918036
2406,Joan Sastre Vanrell,ESP,DF,Mallorca,La Liga,24,1997,2.9,6,3,5,0,1,3,4,75.0,1,3,0,3,2,8,10,0,0,2021-2022,90.0,62.06896551724138,186.20689655172413
2407,Giacomo Satalino,ITA,GK,Sassuolo,Serie A,22,1999,0.1,0,0,0,0,0,0,0,0.0,0,0,0,0,0,0,0,0,0,2021-2022,90.0,0.0,0.0
2408,Martin Satriano,URU,"FW,MF",Inter,Serie A,20,2001,0.4,1,0,0,0,1,1,1,100.0,0,0,0,0,0,1,0,0,0,2021-2022,90.0,0.0,225.0
2409,Martin Satriano,URU,FW,Brest,Ligue 1,20,2001,10.4,5,2,1,1,3,2,7,28.6,5,8,0,8,2,7,3,0,0,2021-2022,90.0,17.307692307692307,43.26923076923077
2410,Téji Savanier,FRA,MF,Montpellier,Ligue 1,29,1991,26.8,46,27,18,19,9,21,59,35.6,38,23,1,22,25,71,12,1,0,2021-2022,90.0,83.955223880597,154.4776119402985
2411,Esteban Saveljich,MNE,DF,Rayo Vallecano,La Liga,30,1991,18.9,18,11,11,7,0,9,15,60.0,6,20,12,8,16,34,69,0,0,2021-2022,90.0,76.19047619047619,85.71428571428572
2412,Stefan Savić,MNE,DF,Atlético Madrid,La Liga,30,1991,27.1,46,20,25,20,1,29,43,67.4,14,19,12,7,37,83,102,1,0,2021-2022,90.0,122.87822878228782,152.76752767527677
2413,Joe Scally,USA,DF,Gladbach,Bundesliga,18,2002,21.2,40,30,21,14,5,17,41,41.5,24,27,4,23,22,62,38,0,0,2021-2022,90.0,93.39622641509435,169.811320754717
2414,Giorgio Scalvini,ITA,"DF,MF",Atalanta,Serie A,17,2003,8.5,22,11,13,8,1,9,19,47.4,10,12,1,11,22,44,16,0,0,2021-2022,90.0,232.94117647058823,232.94117647058823
2415,Gianluca Scamacca,ITA,FW,Sassuolo,Serie A,22,1999,23.8,19,14,2,5,12,5,21,23.8,16,16,1,15,5,24,22,1,0,2021-2022,90.00000000000001,18.907563025210084,71.84873949579833
2416,Dane Scarlett,ENG,MF,Tottenham,Premier League,17,2004,0.0,0,0,0,0,0,0,0,0.0,0,0,0,0,0,0,0,0,0,2021-2022,,,
2417,Kevin Schade,GER,"MF,FW",Freiburg,Bundesliga,19,2001,9.2,9,7,6,2,1,3,10,30.0,7,15,3,12,3,12,16,0,0,2021-2022,90.0,29.347826086956523,88.04347826086958
2418,András Schäfer,HUN,MF,Union Berlin,Bundesliga,22,1999,2.7,4,1,3,1,0,0,5,0.0,5,7,1,6,2,6,4,0,0,2021-2022,90.0,66.66666666666666,133.33333333333331
2419,Fabian Schär,SUI,DF,Newcastle Utd,Premier League,29,1991,24.0,16,11,11,3,2,8,16,50.0,8,27,18,9,32,48,95,2,0,2021-2022,90.0,120.0,60.0
2420,Louis Schaub,AUT,"MF,FW",Köln,Bundesliga,26,1994,7.3,16,10,7,7,2,11,20,55.0,9,17,3,14,3,19,3,0,0,2021-2022,90.0,36.986301369863014,197.26027397260276
2421,Andrea Schiavone,ITA,MF,Salernitana,Serie A,28,1993,6.3,14,8,5,9,0,10,23,43.5,13,13,3,10,8,22,12,0,0,2021-2022,90.0,114.28571428571429,200.00000000000003
2422,Patrik Schick,CZE,FW,Leverkusen,Bundesliga,25,1996,23.1,5,2,2,2,1,1,9,11.1,8,6,1,5,3,8,28,0,0,2021-2022,89.99999999999999,11.688311688311686,19.480519480519476
2423,Kingsley Schindler,GHA,"DF,FW",Köln,Bundesliga,28,1993,3.9,1,0,0,0,1,1,5,20.0,4,5,1,4,5,6,5,0,0,2021-2022,90.0,115.38461538461539,23.076923076923077
2424,Xaver Schlager,AUT,MF,Wolfsburg,Bundesliga,23,1997,11.6,43,20,20,20,3,20,49,40.8,29,25,2,23,9,52,14,0,0,2021-2022,90.0,69.82758620689656,333.62068965517244
2425,Keven Schlotterbeck,GER,"DF,FW",Freiburg,Bundesliga,24,1997,3.5,11,5,6,5,0,5,6,83.3,1,7,4,3,11,22,24,1,0,2021-2022,90.0,282.85714285714283,282.85714285714283
Rk,Player,Nation,Pos,Squad,Comp,0,0,90.0,0,0,3,3,3,Tkl,0,0.0,0,0,0,0,0,0,0,0,0,2021-2022,90.0,0.0,0.0
2426,Nico Schlotterbeck,GER,DF,Freiburg,Bundesliga,21,1999,30.9,72,43,36,34,2,33,48,68.8,15,41,32,9,56,128,154,1,0,2021-2022,90.0,163.10679611650485,209.70873786407768
2427,Jeffrey Schlupp,GHA,"MF,FW",Crystal Palace,Premier League,28,1992,20.6,46,25,16,23,7,24,50,48.0,26,39,9,30,18,64,32,0,0,2021-2022,90.0,78.64077669902913,200.97087378640776
2428,Kasper Schmeichel,DEN,GK,Leicester City,Premier League,34,1986,37.0,0,0,0,0,0,0,2,0.0,2,0,0,0,1,1,15,2,0,2021-2022,90.0,2.4324324324324325,0.0
2429,Jonathan Schmid,FRA,DF,Freiburg,Bundesliga,31,1990,6.5,12,6,6,3,3,5,7,71.4,2,7,1,6,6,18,15,0,0,2021-2022,90.00000000000001,83.07692307692308,166.15384615384616
2430,Benno Schmitz,GER,DF,Köln,Bundesliga,26,1994,26.9,57,37,21,27,9,42,86,48.8,44,44,8,36,39,96,39,0,0,2021-2022,90.0,130.48327137546468,190.70631970260223
2431,David Schnegg,AUT,DF,Venezia,Serie A,22,1998,1.6,2,0,1,1,0,1,3,33.3,2,4,0,4,3,5,6,0,0,2021-2022,90.0,168.75,112.5
2432,Morgan Schneiderlin,FRA,MF,Nice,Ligue 1,31,1989,7.2,21,12,9,11,1,6,13,46.2,7,8,2,6,20,41,18,0,0,2021-2022,90.0,250.0,262.5
2433,Alessandro Schöpf,AUT,MF,Arminia,Bundesliga,27,1994,26.6,40,22,19,16,5,14,30,46.7,16,31,5,26,30,70,21,1,0,2021-2022,90.0,101.50375939849623,135.33834586466165
2434,Jerdy Schouten,NED,MF,Bologna,Serie A,24,1997,15.5,25,17,10,12,3,9,22,40.9,13,22,5,17,33,58,29,1,0,2021-2022,90.0,191.61290322580646,145.16129032258064
2435,Nico Schulz,GER,DF,Dortmund,Bundesliga,28,1993,9.3,21,12,9,7,5,9,21,42.9,12,8,1,7,11,32,8,0,0,2021-2022,90.0,106.4516129032258,203.22580645161287
2436,Marvin Schwäbe,GER,GK,Köln,Bundesliga,26,1995,21.0,0,0,0,0,0,0,0,0.0,0,0,0,0,0,0,8,1,0,2021-2022,90.0,0.0,0.0
2437,Alexander Schwolow,GER,GK,Hertha BSC,Bundesliga,29,1992,24.2,0,0,0,0,0,0,1,0.0,1,0,0,0,2,2,18,3,0,2021-2022,90.0,7.43801652892562,0.0
2438,Valentino Scotta,ESP,DF,Sevilla,La Liga,19,2001,0.0,0,0,0,0,0,0,0,0.0,0,0,0,0,0,0,0,0,0,2021-2022,,,
2439,Demba Seck,SEN,"MF,FW",Torino,Serie A,20,2001,1.6,2,1,0,2,0,0,0,0.0,0,0,0,0,0,2,0,0,0,2021-2022,90.0,0.0,112.5
2440,Aleksandar Sedlar,SRB,"DF,MF",Mallorca,La Liga,29,1991,4.5,5,3,4,1,0,3,5,60.0,2,4,4,0,5,10,19,0,0,2021-2022,90.0,100.0,100.0
2441,Paul Seguin,GER,MF,Greuther Fürth,Bundesliga,26,1995,23.4,50,31,15,32,3,26,56,46.4,30,27,3,24,19,69,30,1,0,2021-2022,89.99999999999999,73.07692307692308,192.3076923076923
2442,Alidu Seidu,GHA,DF,Clermont Foot,Ligue 1,21,2000,15.7,34,20,20,13,1,16,27,59.3,11,25,11,14,34,68,49,1,0,2021-2022,90.0,194.90445859872614,194.90445859872614
2443,Davie Selke,GER,FW,Hertha BSC,Bundesliga,26,1995,11.2,5,4,1,3,1,1,3,33.3,2,6,1,5,1,6,11,0,0,2021-2022,90.0,8.035714285714286,40.17857142857143
2444,Matz Sels,BEL,GK,Strasbourg,Ligue 1,29,1992,37.0,1,1,1,0,0,0,0,0.0,0,0,0,0,1,2,22,0,0,2021-2022,90.0,2.4324324324324325,2.4324324324324325
2445,Ken Sema,SWE,"MF,FW",Watford,Premier League,27,1993,9.5,16,6,11,4,1,9,20,45.0,11,10,0,10,5,21,11,0,0,2021-2022,90.0,47.36842105263158,151.57894736842104
2446,Nélson Semedo,POR,"MF,DF",Wolves,Premier League,27,1993,23.7,58,39,39,17,2,25,49,51.0,24,23,4,19,21,79,64,1,0,2021-2022,90.0,79.74683544303798,220.25316455696205
2447,Lion Semić,GER,DF,Dortmund,Bundesliga,17,2003,0.0,0,0,0,0,0,0,0,0.0,0,0,0,0,0,0,0,0,0,2021-2022,,,
2448,Adrian Šemper,CRO,GK,Genoa,Serie A,23,1998,1.0,0,0,0,0,0,0,0,0.0,0,0,0,0,0,0,0,0,0,2021-2022,90.0,0.0,0.0
2449,Stefano Sensi,ITA,"MF,FW",Sampdoria,Serie A,25,1995,8.4,18,9,10,6,2,10,23,43.5,13,2,0,2,6,24,4,0,0,2021-2022,90.0,64.28571428571428,192.85714285714286
2450,Stefano Sensi,ITA,"MF,FW",Inter,Serie A,25,1995,1.9,4,3,1,3,0,2,4,50.0,2,2,0,2,0,4,2,0,0,2021-2022,90.0,0.0,189.4736842105263
Rk,Player,Nation,Pos,Squad,Comp,0,0,90.0,0,0,3,3,3,Tkl,0,0.0,0,0,0,0,0,0,0,0,0,2021-2022,90.0,0.0,0.0
2451,Luigi Sepe,ITA,GK,Salernitana,Serie A,30,1991,15.5,0,0,0,0,0,0,0,0.0,0,0,0,0,1,1,3,0,0,2021-2022,90.0,5.806451612903226,0.0
2452,Suat Serdar,GER,"MF,FW",Hertha BSC,Bundesliga,24,1997,24.6,64,30,24,29,11,25,55,45.5,30,32,3,29,20,84,14,0,0,2021-2022,89.99999999999999,73.17073170731706,234.14634146341461
2453,Laurens Serpe,ITA,DF,Genoa,Serie A,20,2001,0.5,1,0,1,0,0,1,2,50.0,1,0,0,0,0,1,1,0,0,2021-2022,90.0,0.0,180.0
2454,Janni Serra,GER,FW,Arminia,Bundesliga,23,1998,12.4,4,2,2,0,2,2,7,28.6,5,8,3,5,5,9,19,0,0,2021-2022,90.0,36.29032258064516,29.032258064516128
2455,Javier Serrano,ESP,MF,Atlético Madrid,La Liga,18,2003,0.8,3,1,0,3,0,2,4,50.0,2,0,0,0,3,6,2,0,0,2021-2022,90.0,337.5,337.5
2456,Nicolás Serrano,ESP,"MF,FW",Athletic Club,La Liga,18,2003,3.5,9,6,3,5,1,3,10,30.0,7,5,1,4,2,11,3,0,0,2021-2022,90.0,51.42857142857143,231.42857142857142
2457,Zidan Sertdemir,DEN,"MF,FW",Leverkusen,Bundesliga,16,2005,0.2,2,2,2,0,0,0,0,0.0,0,0,0,0,0,2,0,0,0,2021-2022,90.0,0.0,900.0
2458,Ryan Sessegnon,ENG,"DF,MF",Tottenham,Premier League,21,2000,11.6,25,19,14,7,4,11,22,50.0,11,18,3,15,7,32,26,0,0,2021-2022,90.0,54.310344827586206,193.9655172413793
2459,Nils Seufert,GER,MF,Greuther Fürth,Bundesliga,24,1997,1.1,3,2,1,1,1,0,1,0.0,1,0,0,0,0,3,0,0,0,2021-2022,90.0,0.0,245.45454545454544
2460,Salva Sevilla,ESP,MF,Mallorca,La Liga,37,1984,16.7,18,12,8,8,2,6,17,35.3,11,12,6,6,14,32,11,0,0,2021-2022,90.0,75.44910179640719,97.0059880239521
2461,Stephan El Shaarawy,ITA,"FW,DF",Roma,Serie A,28,1992,11.7,13,8,4,9,0,4,6,66.7,2,10,2,8,11,24,8,0,0,2021-2022,89.99999999999999,84.61538461538461,100.0
2462,Jamie Shackleton,ENG,"DF,MF",Leeds United,Premier League,21,1999,7.9,27,16,19,7,1,13,25,52.0,12,11,7,4,8,35,12,1,0,2021-2022,90.0,91.1392405063291,307.5949367088607
2463,Xherdan Shaqiri,SUI,"FW,MF",Lyon,Ligue 1,29,1991,7.5,7,3,0,5,2,2,10,20.0,8,2,0,2,2,9,2,0,0,2021-2022,90.0,24.0,84.0
2464,Luke Shaw,ENG,DF,Manchester Utd,Premier League,26,1995,17.8,21,13,9,9,3,12,21,57.1,9,22,11,11,9,30,22,2,0,2021-2022,90.0,45.50561797752809,106.17977528089888
2465,Jonjo Shelvey,ENG,MF,Newcastle Utd,Premier League,29,1992,22.0,30,17,12,18,0,14,34,41.2,20,22,7,15,22,52,20,2,0,2021-2022,90.0,90.0,122.72727272727273
2466,Aimar Sher,SWE,MF,Spezia,Serie A,18,2002,0.5,2,1,1,1,0,0,1,0.0,1,1,0,1,3,5,1,0,0,2021-2022,90.0,540.0,360.0
2467,Eldor Shomurodov,UZB,"FW,MF",Roma,Serie A,26,1995,8.7,5,4,0,4,1,1,10,10.0,9,8,0,8,2,7,5,0,0,2021-2022,90.0,20.689655172413794,51.724137931034484
2468,Shola Shoretire,ENG,MF,Manchester Utd,Premier League,17,2004,0.2,0,0,0,0,0,0,0,0.0,0,0,0,0,0,0,0,0,0,2021-2022,90.0,0.0,0.0
2469,Mahame Siby,MLI,DF,Strasbourg,Ligue 1,25,1996,0.2,0,0,0,0,0,0,0,0.0,0,0,0,0,1,1,2,0,0,2021-2022,90.0,450.0,0.0
2470,Aboubakar Sidibé,FRA,DF,Clermont Foot,Ligue 1,25,1996,0.1,0,0,0,0,0,0,0,0.0,0,0,0,0,0,0,0,0,0,2021-2022,90.0,0.0,0.0
2471,Alassane Sidibe,CIV,MF,Atalanta,Serie A,19,2002,0.1,1,1,1,0,0,0,0,0.0,0,0,0,0,0,1,0,0,0,2021-2022,90.0,0.0,900.0
2472,Djibril Sidibé,FRA,DF,Monaco,Ligue 1,29,1992,10.5,24,13,13,8,3,9,24,37.5,15,10,1,9,16,40,13,0,0,2021-2022,90.0,137.14285714285714,205.71428571428572
2473,Kaj Sierhuis,NED,FW,Reims,Ligue 1,23,1998,0.9,1,1,1,0,0,1,3,33.3,2,0,0,0,0,1,1,0,0,2021-2022,90.0,0.0,100.0
2474,Francisco Sierralta,CHI,DF,Watford,Premier League,24,1997,4.7,7,3,7,0,0,5,8,62.5,3,7,2,5,6,13,35,0,0,2021-2022,90.0,114.89361702127658,134.04255319148936
2475,Arnór Sigurðsson,ISL,"FW,MF",Venezia,Serie A,22,1999,2.0,1,1,0,1,0,1,2,50.0,1,2,0,2,1,2,0,0,0,2021-2022,90.0,45.0,45.0
Rk,Player,Nation,Pos,Squad,Comp,0,0,90.0,0,0,3,3,3,Tkl,0,0.0,0,0,0,0,0,0,0,0,0,2021-2022,90.0,0.0,0.0
2476,Kiliann Sildillia,FRA,"DF,MF",Freiburg,Bundesliga,19,2002,1.9,7,3,3,4,0,3,6,50.0,3,1,0,1,2,9,7,1,0,2021-2022,90.0,94.73684210526315,331.57894736842104
2477,Adrien Silva,POR,MF,Sampdoria,Serie A,32,1989,12.0,24,12,14,5,5,9,33,27.3,24,15,5,10,23,47,23,0,0,2021-2022,90.0,172.5,180.0
2478,André Silva,POR,FW,RB Leipzig,Bundesliga,25,1995,23.1,13,9,2,3,8,4,13,30.8,9,20,2,18,2,15,15,0,0,2021-2022,89.99999999999999,7.792207792207791,50.64935064935064
2479,Bernardo Silva,POR,"MF,FW",Manchester City,Premier League,26,1994,31.7,57,29,19,19,19,31,67,46.3,36,24,2,22,20,77,19,0,0,2021-2022,90.0,56.782334384858046,161.82965299684543
2480,Caio Henrique Oliveira Silva,BRA,DF,Monaco,Ligue 1,24,1997,29.6,53,30,31,18,4,28,59,47.5,31,30,6,24,27,80,37,3,0,2021-2022,90.0,82.0945945945946,161.14864864864865
2481,David Silva,ESP,MF,Real Sociedad,La Liga,35,1986,19.1,28,17,10,11,7,3,20,15.0,17,13,3,10,7,35,12,0,0,2021-2022,90.0,32.98429319371728,131.9371727748691
2482,Fábio Silva,POR,FW,Wolves,Premier League,19,2002,6.4,3,2,0,2,1,0,8,0.0,8,2,0,2,1,4,1,0,0,2021-2022,90.0,14.0625,42.1875
2483,Gabriel Silva,BRA,"DF,MF",Saint-Étienne,Ligue 1,30,1991,7.9,12,7,7,2,3,9,13,69.2,4,9,3,6,18,30,13,0,0,2021-2022,90.0,205.06329113924048,136.70886075949366
2484,Jonathan Silva,ARG,"DF,FW",Getafe,La Liga,27,1994,2.5,10,8,4,4,2,7,12,58.3,5,4,0,4,3,13,7,0,0,2021-2022,90.0,108.0,360.0
2485,Rui Silva,POR,GK,Betis,La Liga,27,1994,21.8,1,0,1,0,0,1,2,50.0,1,0,0,0,1,2,11,1,0,2021-2022,90.0,4.128440366972477,4.128440366972477
2486,Thiago Silva,BRA,DF,Chelsea,Premier League,36,1984,29.4,32,21,19,12,1,11,22,50.0,11,54,31,23,44,76,100,0,0,2021-2022,90.0,134.69387755102042,97.95918367346938
2487,Marco Silvestri,ITA,GK,Udinese,Serie A,30,1991,35.0,0,0,0,0,0,0,1,0.0,1,0,0,0,1,1,11,1,0,2021-2022,90.0,2.571428571428571,0.0
2488,Mohamed Simakan,FRA,DF,RB Leipzig,Bundesliga,21,2000,22.3,48,27,25,21,2,27,41,65.9,14,22,11,11,40,88,46,1,0,2021-2022,90.0,161.43497757847533,193.72197309417038
2489,Giovanni Simeone,ARG,FW,Hellas Verona,Serie A,26,1995,29.5,27,15,6,12,9,9,39,23.1,30,37,3,34,6,33,23,0,0,2021-2022,90.0,18.305084745762713,82.37288135593221
2490,Giovanni Simeone,ARG,FW,Cagliari,Serie A,26,1995,0.1,0,0,0,0,0,0,0,0.0,0,0,0,0,0,0,0,0,0,2021-2022,90.0,0.0,0.0
2491,Giuliano Simeone,ARG,MF,Atlético Madrid,La Liga,18,2002,0.0,0,0,0,0,0,0,0,0.0,0,0,0,0,0,0,0,0,0,2021-2022,,,
2492,Ellis Simms,ENG,FW,Everton,Premier League,20,2001,0.7,0,0,0,0,0,0,0,0.0,0,1,1,0,0,0,1,0,0,2021-2022,90.0,0.0,0.0
2493,Moses Simon,NGA,"FW,MF",Nantes,Ligue 1,26,1995,25.9,17,11,6,5,6,11,23,47.8,12,14,3,11,12,29,5,0,0,2021-2022,90.0,41.698841698841704,59.07335907335908
2494,Unai Simón,ESP,GK,Athletic Club,La Liga,24,1997,34.0,0,0,0,0,0,0,0,0.0,0,0,0,0,1,1,5,1,0,2021-2022,90.0,2.6470588235294117,0.0
2495,Xavi Simons,NED,"MF,FW",Paris S-G,Ligue 1,18,2003,1.5,1,1,0,1,0,1,2,50.0,1,3,0,3,0,1,0,0,0,2021-2022,90.0,0.0,60.0
2496,Wilfried Singo,CIV,DF,Torino,Serie A,20,2000,29.0,55,35,24,24,7,24,34,70.6,10,26,6,20,23,78,47,0,0,2021-2022,90.0,71.37931034482759,170.68965517241378
2497,Daley Sinkgraven,NED,DF,Leverkusen,Bundesliga,26,1995,3.9,6,2,4,0,2,3,7,42.9,4,3,1,2,3,9,6,0,0,2021-2022,90.0,69.23076923076923,138.46153846153845
2498,Tobias Sippel,GER,GK,Gladbach,Bundesliga,33,1988,1.0,0,0,0,0,0,0,0,0.0,0,0,0,0,0,0,0,0,0,2021-2022,90.0,0.0,0.0
2499,Hugo Siquet,BEL,DF,Freiburg,Bundesliga,19,2002,0.2,0,0,0,0,0,0,0,0.0,0,0,0,0,0,0,0,0,0,2021-2022,90.0,0.0,0.0
2500,Salvatore Sirigu,ITA,GK,Genoa,Serie A,34,1987,37.0,1,1,1,0,0,1,2,50.0,1,0,0,0,0,1,19,2,0,2021-2022,90.0,0.0,2.4324324324324325
Rk,Player,Nation,Pos,Squad,Comp,0,0,90.0,0,0,3,3,3,Tkl,0,0.0,0,0,0,0,0,0,0,0,0,2021-2022,90.0,0.0,0.0
2501,Issouf Sissokho,MLI,MF,Bordeaux,Ligue 1,19,2002,4.8,17,8,2,13,2,8,17,47.1,9,8,1,7,7,24,0,0,0,2021-2022,90.0,131.25,318.75
2502,Ibrahima Sissoko,MLI,"MF,DF",Strasbourg,Ligue 1,23,1997,25.6,47,23,18,20,9,19,46,41.3,27,32,11,21,35,82,31,0,0,2021-2022,90.0,123.046875,165.234375
2503,Moussa Sissoko,FRA,MF,Watford,Premier League,31,1989,35.8,53,27,27,20,6,28,42,66.7,14,42,13,29,30,83,64,0,0,2021-2022,90.0,75.41899441340783,133.24022346368716
2504,Nelson Sissoko,FRA,DF,Saint-Étienne,Ligue 1,24,1997,0.5,2,0,2,0,0,1,1,100.0,0,0,0,0,0,2,2,0,0,2021-2022,90.0,0.0,360.0
2505,Sambou Sissoko,FRA,"MF,DF",Reims,Ligue 1,22,1999,2.0,12,6,6,4,2,6,8,75.0,2,2,0,2,2,14,7,0,0,2021-2022,90.0,90.0,540.0
2506,Antonio Sivera,ESP,GK,Alavés,La Liga,24,1996,3.1,0,0,0,0,0,0,1,0.0,1,0,0,0,0,0,0,0,0,2021-2022,90.0,0.0,0.0
2507,Ellyes Skhiri,TUN,MF,Köln,Bundesliga,26,1995,20.2,55,33,25,26,4,22,41,53.7,19,41,7,34,37,92,35,1,0,2021-2022,90.0,164.85148514851485,245.04950495049505
2508,Oliver Skipp,ENG,MF,Tottenham,Premier League,20,2000,15.0,33,19,14,18,1,15,31,48.4,16,19,7,12,12,45,10,1,0,2021-2022,90.0,72.0,198.0
2509,Leo Skiri Østigård,NOR,DF,Genoa,Serie A,21,1999,13.0,16,9,8,7,1,9,11,81.8,2,17,10,7,8,24,55,1,0,2021-2022,90.00000000000001,55.38461538461539,110.76923076923077
2510,Łukasz Skorupski,POL,GK,Bologna,Serie A,30,1991,36.0,0,0,0,0,0,0,1,0.0,1,0,0,0,0,0,17,0,0,2021-2022,90.0,0.0,0.0
2511,Andreas Skov Olsen,DEN,"FW,DF",Bologna,Serie A,21,1999,8.3,12,10,4,4,4,5,11,45.5,6,9,1,8,3,15,11,0,0,2021-2022,90.0,32.53012048192771,130.12048192771084
2512,Robert Skov,DEN,"FW,DF",Hoffenheim,Bundesliga,25,1996,4.1,3,2,1,1,1,2,9,22.2,7,2,0,2,3,6,3,0,0,2021-2022,90.0,65.85365853658537,65.85365853658537
2513,Milan Škriniar,SVK,DF,Inter,Serie A,26,1995,35.0,47,27,26,17,4,24,42,57.1,18,36,25,11,25,72,90,1,0,2021-2022,90.0,64.28571428571428,120.85714285714286
2514,Islam Slimani,ALG,FW,Lyon,Ligue 1,33,1988,6.4,3,2,0,1,2,1,6,16.7,5,4,0,4,2,5,5,0,0,2021-2022,90.0,28.125,42.1875
2515,William Smallbone,IRL,"MF,FW",Southampton,Premier League,21,2000,1.5,4,4,2,2,0,1,3,33.3,2,4,0,4,2,6,0,0,0,2021-2022,90.0,120.0,240.0
2516,Chris Smalling,ENG,DF,Roma,Serie A,31,1989,23.2,36,23,28,8,0,18,25,72.0,7,32,24,8,26,62,92,1,0,2021-2022,90.0,100.86206896551724,139.6551724137931
2517,Emile Smith Rowe,ENG,"MF,FW",Arsenal,Premier League,21,2000,21.3,14,7,7,7,0,4,20,20.0,16,18,1,17,15,29,10,1,0,2021-2022,90.0,63.38028169014085,59.15492957746479
2518,Cédric Soares,POR,DF,Arsenal,Premier League,29,1991,16.5,38,26,23,9,6,16,25,64.0,9,18,7,11,16,54,31,1,0,2021-2022,90.0,87.27272727272728,207.27272727272728
2519,Danilo Soares,BRA,DF,Bochum,Bundesliga,29,1991,28.5,109,71,61,39,9,56,84,66.7,28,63,9,54,62,171,65,2,0,2021-2022,90.0,195.78947368421055,344.2105263157895
2520,Rubén Sobrino,ESP,MF,Valencia,La Liga,29,1992,0.2,1,1,1,0,0,1,1,100.0,0,1,0,1,2,3,0,0,0,2021-2022,90.0,900.0,450.0
2521,Rubén Sobrino,ESP,"FW,MF",Cádiz,La Liga,29,1992,20.7,28,17,11,10,7,5,35,14.3,30,21,1,20,21,49,18,0,0,2021-2022,90.0,91.30434782608697,121.73913043478262
2522,Alex Sola,ESP,"DF,FW",Real Sociedad,La Liga,22,1999,0.5,1,1,1,0,0,1,3,33.3,2,1,0,1,2,3,3,0,0,2021-2022,90.0,360.0,180.0
2523,Augusto Solari,ARG,"MF,DF",Celta Vigo,La Liga,29,1992,7.9,24,12,9,12,3,12,32,37.5,20,14,4,10,7,31,10,1,0,2021-2022,90.0,79.74683544303797,273.4177215189873
2524,Roberto Soldado,ESP,FW,Levante,La Liga,36,1985,7.4,3,1,0,1,2,1,3,33.3,2,4,0,4,1,4,7,0,0,2021-2022,90.0,12.162162162162161,36.486486486486484
2525,Carlos Soler,ESP,MF,Valencia,La Liga,24,1997,27.5,29,19,10,15,4,11,37,29.7,26,19,4,15,14,43,28,0,0,2021-2022,89.99999999999999,45.81818181818181,94.9090909090909
Rk,Player,Nation,Pos,Squad,Comp,0,0,90.0,0,0,3,3,3,Tkl,0,0.0,0,0,0,0,0,0,0,0,0,2021-2022,90.0,0.0,0.0
2526,Yann Sommer,SUI,GK,Gladbach,Bundesliga,32,1988,33.0,0,0,0,0,0,0,2,0.0,2,0,0,0,3,3,8,3,0,2021-2022,90.0,8.181818181818182,0.0
2527,Son,ESP,DF,Levante,La Liga,27,1994,21.9,28,18,16,7,5,17,34,50.0,17,11,5,6,19,47,33,1,0,2021-2022,90.0,78.08219178082193,115.06849315068494
2528,Brandon Soppy,FRA,"DF,MF",Udinese,Serie A,19,2002,8.6,20,9,8,10,2,11,16,68.8,5,10,2,8,5,25,9,1,0,2021-2022,90.0,52.32558139534884,209.30232558139537
2529,David Soria,ESP,GK,Getafe,La Liga,28,1993,37.9,1,0,1,0,0,1,2,50.0,1,0,0,0,0,1,22,2,0,2021-2022,90.0,0.0,2.37467018469657
2530,Roberto Soriano,ITA,MF,Bologna,Serie A,30,1991,29.1,57,30,27,22,8,17,56,30.4,39,37,3,34,22,79,32,0,0,2021-2022,90.0,68.04123711340206,176.28865979381442
2531,Alberto Soro,ESP,"MF,FW",Granada,La Liga,22,1999,6.4,12,10,3,6,3,1,7,14.3,6,21,2,19,3,15,4,0,0,2021-2022,90.0,42.1875,168.75
2532,Borna Sosa,CRO,"DF,FW",Stuttgart,Bundesliga,23,1998,27.8,22,12,14,5,3,12,26,46.2,14,30,3,27,26,48,61,0,0,2021-2022,90.0,84.1726618705036,71.22302158273382
2533,Hugo Sotelo,ESP,FW,Celta Vigo,La Liga,17,2003,0.0,0,0,0,0,0,0,0,0.0,0,0,0,0,0,0,0,0,0,2021-2022,,,
2534,Florian Sotoca,FRA,"FW,MF",Lens,Ligue 1,30,1990,27.6,31,19,7,20,4,12,51,23.5,39,31,4,27,25,56,41,0,0,2021-2022,90.0,81.52173913043477,101.08695652173913
2535,Riccardo Sottil,ITA,FW,Fiorentina,Serie A,22,1999,13.8,9,4,4,4,1,3,9,33.3,6,3,0,3,1,10,2,0,0,2021-2022,90.0,6.521739130434782,58.69565217391304
2536,Tomáš Souček,CZE,MF,West Ham,Premier League,26,1995,34.0,66,32,27,33,6,28,65,43.1,37,34,13,21,52,118,98,1,0,2021-2022,90.0,137.64705882352942,174.7058823529412
2537,Matìas Soulé,ARG,FW,Juventus,Serie A,18,2003,0.1,0,0,0,0,0,0,1,0.0,1,0,0,0,0,0,0,0,0,2021-2022,90.0,0.0,0.0
2538,Sambou Soumano,SEN,"FW,MF",Lorient,Ligue 1,20,2001,5.0,4,1,1,2,1,2,2,100.0,0,3,0,3,1,5,7,0,0,2021-2022,90.0,18.0,72.0
2539,Adama Soumaoro,FRA,DF,Bologna,Serie A,29,1992,25.2,15,5,5,8,2,4,9,44.4,5,22,16,6,34,49,95,0,0,2021-2022,90.0,121.42857142857144,53.57142857142858
2540,Boubakary Soumaré,FRA,MF,Leicester City,Premier League,22,1999,12.2,19,13,10,8,1,8,17,47.1,9,13,1,12,14,33,18,0,0,2021-2022,90.0,103.27868852459018,140.16393442622953
2541,Arnaud Souquet,FRA,DF,Montpellier,Ligue 1,29,1992,25.9,56,35,30,17,9,32,65,49.2,33,21,7,14,34,90,60,1,0,2021-2022,90.0,118.14671814671816,194.5945945945946
2542,Djibril Sow,SUI,MF,Eint Frankfurt,Bundesliga,24,1997,26.8,57,33,28,25,4,22,60,36.7,38,35,8,27,50,107,20,1,0,2021-2022,90.0,167.910447761194,191.4179104477612
2543,Saidou Sow,GUI,DF,Saint-Étienne,Ligue 1,19,2002,11.0,28,17,21,6,1,16,21,76.2,5,15,5,10,23,51,34,0,0,2021-2022,90.0,188.1818181818182,229.0909090909091
2544,Çağlar Söyüncü,TUR,DF,Leicester City,Premier League,25,1996,27.7,47,30,32,12,3,26,42,61.9,16,44,27,17,32,79,115,1,0,2021-2022,90.0,103.971119133574,152.70758122743683
2545,Leonardo Spinazzola,ITA,DF,Roma,Serie A,28,1993,1.4,0,0,0,0,0,0,1,0.0,1,4,1,3,0,0,3,0,0,2021-2022,90.0,0.0,0.0
2546,Marco Sportiello,ITA,GK,Atalanta,Serie A,29,1992,5.0,0,0,0,0,0,0,0,0.0,0,0,0,0,0,0,2,0,0,2021-2022,90.0,0.0,0.0
2547,Tony Springett,IRL,"MF,FW",Norwich City,Premier League,18,2002,1.6,2,1,1,1,0,1,4,25.0,3,0,0,0,0,2,2,0,0,2021-2022,90.0,0.0,112.5
2548,Jerry St. Juste,NED,DF,Mainz 05,Bundesliga,24,1996,6.7,13,9,7,6,0,7,8,87.5,1,7,3,4,14,27,14,0,0,2021-2022,90.0,188.0597014925373,174.62686567164178
2549,Anton Stach,GER,MF,Mainz 05,Bundesliga,22,1998,20.7,28,19,14,13,1,15,38,39.5,23,24,5,19,51,79,25,0,0,2021-2022,90.0,221.73913043478262,121.73913043478262
2550,Kostas Stafylidis,GRE,"DF,MF",Bochum,Bundesliga,27,1993,15.4,37,27,22,13,2,20,26,76.9,6,19,6,13,31,68,43,0,0,2021-2022,90.0,181.1688311688312,216.23376623376623
Rk,Player,Nation,Pos,Squad,Comp,0,0,90.0,0,0,3,3,3,Tkl,0,0.0,0,0,0,0,0,0,0,0,0,2021-2022,90.0,0.0,0.0
2551,Luca Stanga,ITA,DF,Milan,Serie A,19,2002,0.0,1,0,0,1,0,0,0,0.0,0,0,0,0,0,1,0,0,0,2021-2022,,,inf
2552,Josip Stanišić,CRO,DF,Bayern Munich,Bundesliga,21,2000,7.2,21,10,7,12,2,12,18,66.7,6,7,0,7,11,32,10,2,0,2021-2022,90.0,137.5,262.5
2553,Niklas Stark,GER,DF,Hertha BSC,Bundesliga,26,1995,22.6,28,16,18,10,0,12,17,70.6,5,27,17,10,36,64,122,2,0,2021-2022,90.0,143.36283185840708,111.50442477876106
2554,Jason Steele,ENG,GK,Brighton,Premier League,30,1990,1.0,0,0,0,0,0,0,0,0.0,0,0,0,0,0,0,0,0,0,2021-2022,90.0,0.0,0.0
2555,Jed Steer,ENG,GK,Aston Villa,Premier League,28,1992,1.0,0,0,0,0,0,0,0,0.0,0,0,0,0,0,0,0,0,0,2021-2022,90.0,0.0,0.0
2556,Renato Steffen,SUI,"FW,MF",Wolfsburg,Bundesliga,29,1991,10.7,20,16,10,10,0,9,16,56.3,7,7,0,7,13,33,14,0,0,2021-2022,90.0,109.34579439252337,168.22429906542058
2557,Zack Steffen,USA,GK,Manchester City,Premier League,26,1995,1.0,0,0,0,0,0,0,0,0.0,0,0,0,0,0,0,2,0,0,2021-2022,90.0,0.0,0.0
2558,Calvin Stengs,NED,MF,Nice,Ligue 1,22,1998,11.9,16,7,6,9,1,7,20,35.0,13,10,0,10,8,24,6,0,0,2021-2022,90.00000000000001,60.504201680672274,121.00840336134455
2559,Pascal Stenzel,GER,DF,Stuttgart,Bundesliga,25,1996,10.0,24,11,15,5,4,17,33,51.5,16,13,3,10,11,35,25,0,0,2021-2022,90.0,99.0,216.0
2560,Dale Stephens,ENG,MF,Burnley,Premier League,32,1989,1.4,4,1,0,3,1,3,8,37.5,5,4,1,3,1,5,1,0,0,2021-2022,90.0,64.28571428571429,257.14285714285717
2561,Jack Stephens,ENG,DF,Southampton,Premier League,27,1994,9.0,19,12,13,5,1,6,16,37.5,10,12,7,5,19,38,42,0,0,2021-2022,90.0,190.0,190.0
2562,Raheem Sterling,ENG,FW,Manchester City,Premier League,26,1994,23.6,23,10,3,11,9,10,23,43.5,13,12,0,12,12,35,3,0,0,2021-2022,90.0,45.762711864406775,87.71186440677965
2563,Finley Stevens,WAL,DF,Brentford,Premier League,18,2003,0.2,3,1,0,3,0,1,1,100.0,0,0,0,0,0,3,0,0,0,2021-2022,90.0,0.0,1350.0
2564,Angelo Stiller,GER,MF,Hoffenheim,Bundesliga,20,2001,18.8,30,17,11,15,4,9,23,39.1,14,32,6,26,9,39,16,2,0,2021-2022,90.0,43.08510638297872,143.61702127659572
2565,Lars Stindl,GER,"MF,FW",Gladbach,Bundesliga,32,1988,18.1,23,15,6,14,3,9,33,27.3,24,28,2,26,10,33,14,0,0,2021-2022,90.0,49.72375690607734,114.36464088397788
2566,Riccardo Stivanello,ITA,DF,Bologna,Serie A,17,2004,0.5,1,1,1,0,0,1,1,100.0,0,2,2,0,0,1,6,0,0,2021-2022,90.0,0.0,180.0
2567,Kevin Stöger,AUT,MF,Mainz 05,Bundesliga,27,1993,4.7,10,5,5,5,0,4,10,40.0,6,6,0,6,5,15,1,1,0,2021-2022,90.0,95.74468085106382,191.48936170212764
2568,Petar Stojanović,SVN,DF,Empoli,Serie A,25,1995,30.4,96,63,55,32,9,59,114,51.8,55,39,13,26,27,123,65,1,0,2021-2022,90.0,79.93421052631578,284.2105263157895
2569,John Stones,ENG,DF,Manchester City,Premier League,27,1994,12.4,5,3,3,2,0,2,3,66.7,1,3,3,0,11,16,27,1,0,2021-2022,90.0,79.83870967741936,36.29032258064516
2570,Thomas Strakosha,ALB,GK,Lazio,Serie A,26,1995,23.0,0,0,0,0,0,0,0,0.0,0,0,0,0,0,0,7,2,0,2021-2022,90.0,0.0,0.0
2571,Stefan Strandberg,NOR,DF,Salernitana,Serie A,31,1990,10.4,13,8,10,3,0,8,11,72.7,3,15,13,2,9,22,49,0,0,2021-2022,90.0,77.88461538461537,112.49999999999999
2572,Dávid Strelec,SVK,"FW,MF",Spezia,Serie A,20,2001,5.6,4,4,1,2,1,2,9,22.2,7,8,1,7,2,6,1,0,0,2021-2022,90.0,32.142857142857146,64.28571428571429
2573,Tobias Strobl,GER,"MF,DF",Augsburg,Bundesliga,31,1990,3.6,8,3,3,5,0,3,11,27.3,8,7,2,5,7,15,3,0,0,2021-2022,90.0,175.0,200.0
2574,Kevin Strootman,NED,MF,Cagliari,Serie A,31,1990,7.1,8,4,2,4,2,5,12,41.7,7,11,2,9,10,18,15,0,0,2021-2022,90.0,126.7605633802817,101.40845070422536
2575,Pascal Struijk,NED,"DF,MF",Leeds United,Premier League,21,1999,22.8,61,39,34,23,4,30,50,60.0,20,35,23,12,33,94,60,2,0,2021-2022,90.0,130.26315789473682,240.7894736842105
Rk,Player,Nation,Pos,Squad,Comp,0,0,90.0,0,0,3,3,3,Tkl,0,0.0,0,0,0,0,0,0,0,0,0,2021-2022,90.0,0.0,0.0
2576,Jens Stryger Larsen,DEN,DF,Udinese,Serie A,30,1991,7.6,5,2,3,1,1,2,3,66.7,1,2,0,2,4,9,17,0,0,2021-2022,90.0,47.368421052631575,59.21052631578947
2577,Leo Štulac,SVN,MF,Empoli,Serie A,26,1994,9.3,13,6,5,6,2,7,19,36.8,12,6,2,4,8,21,15,0,0,2021-2022,90.0,77.41935483870967,125.8064516129032
2578,Stefano Sturaro,ITA,MF,Genoa,Serie A,28,1993,19.6,43,26,16,16,11,22,48,45.8,26,25,1,24,15,58,29,2,0,2021-2022,90.0,68.87755102040816,197.44897959183672
2579,Damián Suárez,URU,DF,Getafe,La Liga,33,1988,30.1,74,47,34,30,10,42,91,46.2,49,46,5,41,31,105,30,0,0,2021-2022,90.00000000000001,92.69102990033223,221.2624584717608
2580,Denis Suárez,ESP,MF,Celta Vigo,La Liga,27,1994,31.3,61,29,20,33,8,25,82,30.5,57,32,4,28,16,77,11,0,0,2021-2022,90.0,46.00638977635783,175.39936102236422
2581,Luis Suárez,URU,FW,Atlético Madrid,La Liga,34,1987,20.4,8,5,2,4,2,2,10,20.0,8,8,1,7,1,9,14,0,0,2021-2022,90.0,4.411764705882353,35.294117647058826
2582,Mario Suárez,ESP,DF,Rayo Vallecano,La Liga,34,1987,7.9,9,4,7,2,0,3,9,33.3,6,6,4,2,7,16,37,1,0,2021-2022,90.0,79.74683544303797,102.53164556962024
2583,Isaac Success,NGA,"FW,MF",Udinese,Serie A,25,1996,10.1,5,2,0,3,2,1,5,20.0,4,2,0,2,2,7,6,0,0,2021-2022,90.0,17.821782178217823,44.554455445544555
2584,Niklas Süle,GER,DF,Bayern Munich,Bundesliga,25,1995,20.4,29,23,21,7,1,18,24,75.0,6,16,12,4,28,57,49,0,0,2021-2022,90.0,123.52941176470588,127.94117647058825
2585,Kamaldeen Sulemana,GHA,"MF,FW",Rennes,Ligue 1,19,2002,11.3,23,12,7,9,7,10,17,58.8,7,10,1,9,4,27,5,0,0,2021-2022,90.0,31.858407079646017,183.1858407079646
2586,Crysencio Summerville,NED,"MF,FW",Leeds United,Premier League,19,2001,1.4,5,3,1,1,3,2,3,66.7,1,2,0,2,2,7,0,0,0,2021-2022,90.0,128.57142857142858,321.42857142857144
2587,Vladyslav Supriaha,UKR,FW,Sampdoria,Serie A,21,2000,0.2,0,0,0,0,0,0,1,0.0,1,0,0,0,0,0,0,0,0,2021-2022,90.0,0.0,0.0
2588,Suso,ESP,FW,Sevilla,La Liga,27,1993,4.3,4,3,1,3,0,3,13,23.1,10,4,0,4,0,4,0,0,0,2021-2022,90.0,0.0,83.72093023255815
2589,Bosko Sutalo,CRO,DF,Hellas Verona,Serie A,21,2000,10.2,20,13,11,6,3,8,16,50.0,8,10,5,5,17,37,39,0,0,2021-2022,90.0,150.0,176.47058823529412
2590,Mattias Svanberg,SWE,MF,Bologna,Serie A,22,1999,28.5,39,15,15,16,8,16,54,29.6,38,31,9,22,28,67,34,0,0,2021-2022,90.0,88.42105263157895,123.15789473684211
2591,Michael Svoboda,AUT,DF,Venezia,Serie A,22,1998,13.7,33,17,26,6,1,18,32,56.3,14,27,15,12,10,43,61,5,0,2021-2022,90.0,65.69343065693431,216.78832116788323
2592,Abdoulaye Sylla,GUI,DF,Nantes,Ligue 1,21,2000,1.7,4,4,2,1,1,2,4,50.0,2,5,3,2,1,5,3,0,0,2021-2022,90.0,52.94117647058823,211.76470588235293
2593,Mamadou Sylla,SEN,"FW,MF",Alavés,La Liga,27,1994,4.4,2,2,0,1,1,0,1,0.0,1,0,0,0,1,3,5,0,0,2021-2022,90.0,20.454545454545453,40.90909090909091
2594,Mamadou Sylla,SEN,FW,Rayo Vallecano,La Liga,27,1994,2.8,1,1,1,0,0,0,1,0.0,1,2,0,2,4,5,3,0,0,2021-2022,90.0,128.57142857142858,32.142857142857146
2595,Ádám Szalai,HUN,FW,Mainz 05,Bundesliga,33,1987,2.9,3,2,0,2,1,0,2,0.0,2,2,0,2,0,3,0,0,0,2021-2022,90.0,0.0,93.10344827586206
2596,Wojciech Szczęsny,POL,GK,Juventus,Serie A,31,1990,33.0,1,1,1,0,0,1,2,50.0,1,0,0,0,0,1,8,1,0,2021-2022,90.0,0.0,2.7272727272727275
2597,Dominik Szoboszlai,HUN,"MF,FW",RB Leipzig,Bundesliga,20,2000,17.1,17,12,5,9,3,8,27,29.6,19,30,3,27,10,27,15,0,0,2021-2022,90.0,52.63157894736842,89.47368421052632
2598,Jakob Sørensen,DEN,"MF,DF",Norwich City,Premier League,23,1998,6.7,22,11,6,14,2,10,20,50.0,10,7,3,4,10,32,19,0,0,2021-2022,90.0,134.32835820895522,295.5223880597015
2599,Alexander Sørloth,NOR,FW,Real Sociedad,La Liga,25,1995,19.6,20,7,4,10,6,7,17,41.2,10,14,1,13,4,24,15,0,0,2021-2022,90.0,18.36734693877551,91.83673469387755
2600,Tachi,ESP,DF,Alavés,La Liga,23,1997,2.7,6,3,3,3,0,5,7,71.4,2,4,3,1,1,7,9,0,0,2021-2022,90.0,33.33333333333333,199.99999999999997
Rk,Player,Nation,Pos,Squad,Comp,0,0,90.0,0,0,3,3,3,Tkl,0,0.0,0,0,0,0,0,0,0,0,0,2021-2022,90.0,0.0,0.0
2601,Jonathan Tah,GER,DF,Leverkusen,Bundesliga,25,1996,32.0,25,18,19,5,1,17,33,51.5,16,31,20,11,43,68,156,0,0,2021-2022,90.0,120.9375,70.3125
2602,Waniss Taibi,FRA,"MF,FW",Angers,Ligue 1,19,2002,1.5,8,7,4,4,0,2,4,50.0,2,0,0,0,1,9,1,0,0,2021-2022,90.0,60.0,480.0
2603,Flavien Tait,FRA,MF,Rennes,Ligue 1,28,1993,23.6,28,19,13,9,6,13,40,32.5,27,15,4,11,19,47,13,1,0,2021-2022,90.0,72.45762711864406,106.77966101694915
2604,Adrien Tameze,CMR,"MF,DF",Hellas Verona,Serie A,27,1994,28.6,52,29,24,21,7,20,59,33.9,39,40,5,35,52,104,41,0,0,2021-2022,90.0,163.63636363636365,163.63636363636365
2605,Japhet Tanganga,ENG,DF,Tottenham,Premier League,22,1999,8.2,14,8,7,6,1,9,19,47.4,10,13,5,8,9,23,31,0,0,2021-2022,90.0,98.78048780487806,153.65853658536588
2606,Renato Tapia,PER,MF,Celta Vigo,La Liga,26,1995,15.7,50,31,15,31,4,20,50,40.0,30,21,5,16,28,78,43,0,0,2021-2022,90.0,160.5095541401274,286.62420382165607
2607,Edmond Tapsoba,BFA,DF,Leverkusen,Bundesliga,22,1999,20.2,35,17,24,10,1,20,32,62.5,12,27,15,12,29,64,72,1,0,2021-2022,90.0,129.2079207920792,155.94059405940595
2608,Florian Tardieu,FRA,MF,Troyes,Ligue 1,29,1992,29.2,58,25,31,21,6,31,71,43.7,40,31,9,22,42,100,38,0,0,2021-2022,90.0,129.45205479452056,178.76712328767124
2609,Matt Targett,ENG,DF,Aston Villa,Premier League,25,1995,15.9,34,18,28,5,1,24,45,53.3,21,16,9,7,23,57,35,0,0,2021-2022,90.0,130.18867924528303,192.45283018867926
2610,Matt Targett,ENG,DF,Newcastle Utd,Premier League,25,1995,16.0,41,26,26,14,1,24,37,64.9,13,15,4,11,25,66,39,1,0,2021-2022,90.0,140.625,230.625
2611,Oussama Targhalline,MAR,FW,Marseille,Ligue 1,19,2002,0.1,0,0,0,0,0,0,0,0.0,0,0,0,0,0,0,0,0,0,2021-2022,90.0,0.0,0.0
2612,James Tarkowski,ENG,DF,Burnley,Premier League,28,1992,34.5,65,45,47,17,1,33,47,70.2,14,75,61,14,48,113,186,4,0,2021-2022,90.0,125.21739130434781,169.56521739130434
2613,Ciprian Tătărușanu,ROU,GK,Milan,Serie A,35,1986,6.0,0,0,0,0,0,0,1,0.0,1,0,0,0,0,0,2,1,0,2021-2022,90.0,0.0,0.0
2614,Niklas Tauer,GER,"DF,MF",Mainz 05,Bundesliga,20,2001,5.4,16,9,9,7,0,9,14,64.3,5,6,2,4,9,25,14,0,0,2021-2022,90.0,150.0,266.66666666666663
2615,Nuno Tavares,POR,DF,Arsenal,Premier League,21,2000,13.1,21,14,10,7,4,8,18,44.4,10,15,5,10,9,30,33,1,0,2021-2022,90.0,61.832061068702295,144.27480916030535
2616,Charlie Taylor,ENG,DF,Burnley,Premier League,27,1993,30.3,45,26,31,11,3,26,44,59.1,18,42,20,22,58,103,95,2,0,2021-2022,90.0,172.27722772277227,133.66336633663366
2617,Loum Tchaouna,FRA,"FW,MF",Rennes,Ligue 1,17,2003,1.0,3,1,1,2,0,1,5,20.0,4,0,0,0,2,5,0,0,0,2021-2022,90.0,180.0,270.0
2618,Warren Tchimbembé,CGO,MF,Metz,Ligue 1,23,1998,2.3,1,1,0,1,0,0,1,0.0,1,2,1,1,2,3,2,0,0,2021-2022,90.0,78.26086956521739,39.130434782608695
2619,Aurélien Tchouaméni,FRA,MF,Monaco,Ligue 1,21,2000,32.5,86,45,33,49,4,29,55,52.7,26,39,7,32,101,187,34,0,0,2021-2022,90.0,279.6923076923077,238.15384615384616
2620,Mathys Tel,FRA,"FW,MF",Rennes,Ligue 1,16,2005,0.6,2,1,1,1,0,0,0,0.0,0,0,0,0,1,3,2,0,0,2021-2022,90.0,150.0,300.0
2621,Jordan Tell,GLP,FW,Clermont Foot,Ligue 1,24,1997,3.2,5,5,0,3,2,1,4,25.0,3,3,0,3,0,5,1,0,0,2021-2022,90.0,0.0,140.625
2622,Nathan Tella,NGA,"MF,FW",Southampton,Premier League,22,1999,8.9,13,9,5,7,1,6,17,35.3,11,13,0,13,6,19,9,0,0,2021-2022,90.0,60.67415730337079,131.46067415730337
2623,Alex Telles,BRA,DF,Manchester Utd,Premier League,28,1992,18.4,48,27,35,9,4,27,43,62.8,16,17,4,13,26,74,45,0,0,2021-2022,90.0,127.17391304347827,234.7826086956522
2624,Cristian Tello,ESP,FW,Betis,La Liga,29,1991,9.1,17,11,6,7,4,13,31,41.9,18,9,0,9,10,27,6,0,0,2021-2022,90.0,98.9010989010989,168.13186813186815
2625,Nahuel Tenaglia,ARG,DF,Alavés,La Liga,25,1996,11.9,42,27,30,9,3,24,37,64.9,13,10,2,8,26,68,42,0,0,2021-2022,90.00000000000001,196.6386554621849,317.64705882352945
Rk,Player,Nation,Pos,Squad,Comp,0,0,90.0,0,0,3,3,3,Tkl,0,0.0,0,0,0,0,0,0,0,0,0,2021-2022,90.0,0.0,0.0
2626,Marc Tenas,ESP,"FW,MF",Alavés,La Liga,20,2001,0.6,1,1,1,0,0,1,1,100.0,0,1,0,1,0,1,0,1,0,2021-2022,90.0,0.0,150.0
2627,Marc-André ter Stegen,GER,GK,Barcelona,La Liga,29,1992,35.0,0,0,0,0,0,0,1,0.0,1,0,0,0,1,1,13,5,0,2021-2022,90.0,2.571428571428571,0.0
2628,Filippo Terracciano,ITA,DF,Hellas Verona,Serie A,18,2003,0.1,0,0,0,0,0,0,0,0.0,0,0,0,0,0,0,1,0,0,2021-2022,90.0,0.0,0.0
2629,Pietro Terracciano,ITA,GK,Fiorentina,Serie A,31,1990,31.8,0,0,0,0,0,0,4,0.0,4,0,0,0,2,2,20,1,0,2021-2022,90.0,5.660377358490566,0.0
2630,Martin Terrier,FRA,"FW,MF",Rennes,Ligue 1,24,1997,30.9,55,33,22,16,17,25,43,58.1,18,29,3,26,18,73,17,0,0,2021-2022,90.0,52.42718446601942,160.19417475728156
2631,Aleksa Terzić,SRB,DF,Fiorentina,Serie A,21,1999,3.0,8,5,3,3,2,4,7,57.1,3,7,0,7,4,12,5,0,0,2021-2022,90.0,120.0,240.0
2632,Robert Tesche,GER,MF,Bochum,Bundesliga,34,1987,3.9,6,4,4,1,1,5,7,71.4,2,6,2,4,5,11,5,1,0,2021-2022,90.0,115.38461538461539,138.46153846153845
2633,Tanner Tessmann,USA,MF,Venezia,Serie A,19,2001,7.6,11,5,4,6,1,5,14,35.7,9,19,9,10,5,16,22,0,0,2021-2022,90.0,59.21052631578947,130.26315789473685
2634,Tetê,BRA,"FW,MF",Lyon,Ligue 1,21,2000,6.5,10,5,4,5,1,3,13,23.1,10,4,0,4,3,13,1,0,0,2021-2022,90.00000000000001,41.53846153846154,138.46153846153848
2635,Cedric Teuchert,GER,"MF,FW",Union Berlin,Bundesliga,24,1997,1.2,3,2,3,0,0,2,6,33.3,4,1,0,1,0,3,0,0,0,2021-2022,90.0,0.0,225.00000000000003
2636,Arthur Theate,BEL,DF,Bologna,Serie A,21,2000,26.9,33,19,26,3,4,14,31,45.2,17,29,16,13,42,75,69,0,0,2021-2022,90.0,140.5204460966543,110.40892193308551
2637,Jan Thielmann,GER,"MF,FW",Köln,Bundesliga,19,2002,13.2,24,16,6,12,6,8,23,34.8,15,23,2,21,10,34,11,0,0,2021-2022,90.0,68.18181818181819,163.63636363636363
2638,Sada Thioub,SEN,FW,Angers,Ligue 1,26,1995,0.0,0,0,0,0,0,0,0,0.0,0,0,0,0,0,0,0,0,0,2021-2022,,,
2639,Sada Thioub,SEN,"DF,MF",Saint-Étienne,Ligue 1,26,1995,10.6,13,8,5,8,0,6,14,42.9,8,9,0,9,10,23,8,0,0,2021-2022,90.0,84.9056603773585,110.37735849056604
2640,Luke Thomas,ENG,DF,Leicester City,Premier League,20,2001,21.2,50,31,33,13,4,28,65,43.1,37,35,14,21,40,90,55,0,0,2021-2022,90.0,169.811320754717,212.26415094339623
2641,Romain Thomas,FRA,DF,Angers,Ligue 1,33,1988,28.5,49,37,28,21,0,30,57,52.6,27,35,19,16,44,93,126,0,0,2021-2022,90.0,138.94736842105263,154.73684210526318
2642,Adrien Thomasson,FRA,MF,Strasbourg,Ligue 1,27,1993,26.5,64,31,18,27,19,30,93,32.3,63,56,4,52,29,93,16,1,0,2021-2022,90.0,98.49056603773585,217.35849056603772
2643,Erik Thommy,GER,"FW,MF",Stuttgart,Bundesliga,26,1994,3.0,2,0,0,2,0,1,2,50.0,1,3,0,3,4,6,0,0,0,2021-2022,90.0,120.0,60.0
2644,Dominic Thompson,ENG,DF,Brentford,Premier League,21,2000,1.6,1,0,1,0,0,0,1,0.0,1,2,2,0,2,3,3,0,0,2021-2022,90.0,112.5,56.25
2645,Morten Thorsby,NOR,MF,Sampdoria,Serie A,25,1996,32.7,46,26,15,23,8,28,56,50.0,28,37,12,25,25,71,39,0,0,2021-2022,90.0,68.80733944954129,126.60550458715596
2646,Thuler,BRA,DF,Montpellier,Ligue 1,22,1999,9.5,21,12,17,4,0,8,15,53.3,7,9,7,2,9,30,30,0,0,2021-2022,90.0,85.26315789473684,198.94736842105263
2647,Khéphren Thuram,FRA,MF,Nice,Ligue 1,20,2001,21.1,33,19,11,18,4,17,35,48.6,18,31,11,20,28,61,19,0,0,2021-2022,90.0,119.43127962085308,140.75829383886256
2648,Marcus Thuram,FRA,FW,Gladbach,Bundesliga,23,1997,10.9,6,5,0,5,1,1,4,25.0,3,5,0,5,5,11,5,0,0,2021-2022,90.0,41.28440366972477,49.54128440366972
2649,Alexis Tibidi,FRA,"MF,FW",Stuttgart,Bundesliga,17,2003,4.3,7,3,1,3,3,3,4,75.0,1,4,0,4,3,10,2,0,0,2021-2022,90.0,62.79069767441861,146.51162790697677
2650,Cheikh Tidiane Sabaly,SEN,"FW,MF",Metz,Ligue 1,22,1999,1.7,6,3,1,4,1,2,2,100.0,0,1,0,1,0,6,1,0,0,2021-2022,90.0,0.0,317.6470588235294
Rk,Player,Nation,Pos,Squad,Comp,0,0,90.0,0,0,3,3,3,Tkl,0,0.0,0,0,0,0,0,0,0,0,0,2021-2022,90.0,0.0,0.0
2651,Youri Tielemans,BEL,MF,Leicester City,Premier League,24,1997,29.2,74,38,23,45,6,42,100,42.0,58,47,13,34,21,95,41,3,0,2021-2022,90.0,64.72602739726028,228.08219178082194
2652,Kieran Tierney,SCO,DF,Arsenal,Premier League,24,1997,21.3,18,14,11,7,0,10,11,90.9,1,23,5,18,15,33,54,0,0,2021-2022,90.0,63.38028169014085,76.05633802816901
2653,Steffen Tigges,GER,"FW,MF",Dortmund,Bundesliga,23,1998,1.2,4,3,1,2,1,2,3,66.7,1,3,1,2,0,4,3,0,0,2021-2022,90.0,0.0,300.0
2654,Malik Tillman,USA,"FW,MF",Bayern Munich,Bundesliga,19,2002,1.2,2,1,0,1,1,0,1,0.0,1,5,1,4,2,4,1,0,0,2021-2022,90.0,150.0,150.0
2655,Timmy Tillman,GER,MF,Greuther Fürth,Bundesliga,22,1999,22.3,43,26,17,18,8,19,42,45.2,23,33,4,29,12,55,26,0,0,2021-2022,90.0,48.430493273542595,173.542600896861
2656,David Timor,ESP,MF,Getafe,La Liga,31,1989,3.8,1,1,1,0,0,0,3,0.0,3,3,2,1,1,2,4,1,0,2021-2022,90.0,23.684210526315788,23.684210526315788
2657,Mircea Ţîrlea,ROU,DF,Alavés,La Liga,21,2000,0.2,0,0,0,0,0,0,0,0.0,0,0,0,0,0,0,1,0,0,2021-2022,90.0,0.0,0.0
2658,Jean-Clair Todibo,FRA,DF,Nice,Ligue 1,21,1999,34.6,59,37,43,15,1,39,60,65.0,21,45,21,24,51,110,130,2,0,2021-2022,90.0,132.65895953757223,153.46820809248553
2659,Umut Tohumcu,GER,MF,Hoffenheim,Bundesliga,16,2004,0.1,0,0,0,0,0,0,0,0.0,0,0,0,0,0,0,0,0,0,2021-2022,90.0,0.0,0.0
2660,Karl Toko Ekambi,CMR,FW,Lyon,Ligue 1,28,1992,25.5,13,7,4,6,3,4,21,19.0,17,26,0,26,20,33,5,0,0,2021-2022,90.0,70.58823529411765,45.88235294117647
2661,Corentin Tolisso,FRA,MF,Bayern Munich,Bundesliga,26,1994,7.8,11,5,1,9,1,7,17,41.2,10,5,1,4,9,20,10,0,0,2021-2022,90.0,103.84615384615384,126.92307692307692
2662,Jeremy Toljan,GER,DF,Sassuolo,Serie A,26,1994,15.5,18,10,12,4,2,13,20,65.0,7,12,5,7,12,30,41,0,0,2021-2022,90.0,69.6774193548387,104.51612903225806
2663,Rafael Tolói,ITA,DF,Atalanta,Serie A,30,1990,16.0,38,15,12,15,11,24,39,61.5,15,23,11,12,26,64,35,0,0,2021-2022,90.0,146.25,213.75
2664,Raúl de Tomás,ESP,FW,Espanyol,La Liga,26,1994,32.4,15,11,6,7,2,6,17,35.3,11,12,3,9,6,21,42,1,0,2021-2022,90.0,16.666666666666668,41.66666666666667
2665,Tiago Tomás,POR,FW,Stuttgart,Bundesliga,19,2002,11.9,8,4,0,7,1,0,6,0.0,6,3,0,3,4,12,1,0,0,2021-2022,90.00000000000001,30.252100840336137,60.504201680672274
2666,Takehiro Tomiyasu,JPN,DF,Arsenal,Premier League,22,1998,18.7,35,17,19,13,3,21,32,65.6,11,22,3,19,24,59,64,2,0,2021-2022,90.0,115.50802139037432,168.44919786096256
2667,Takehiro Tomiyasu,JPN,DF,Bologna,Serie A,22,1998,0.1,0,0,0,0,0,0,0,0.0,0,1,0,1,1,1,0,0,0,2021-2022,90.0,900.0,0.0
2668,James Tomkins,ENG,DF,Crystal Palace,Premier League,32,1989,6.1,8,3,6,2,0,6,8,75.0,2,8,8,0,4,12,18,0,0,2021-2022,90.0,59.016393442622956,118.03278688524591
2669,Fikayo Tomori,ENG,DF,Milan,Serie A,23,1997,30.2,73,44,36,34,3,18,26,69.2,8,37,23,14,45,118,84,1,0,2021-2022,90.0,134.10596026490066,217.5496688741722
2670,Sandro Tonali,ITA,MF,Milan,Serie A,21,2000,28.9,54,37,23,25,6,21,41,51.2,20,26,8,18,34,88,19,0,0,2021-2022,90.00000000000001,105.88235294117648,168.16608996539796
2671,Lorenzo Tonelli,ITA,DF,Empoli,Serie A,31,1990,9.7,17,9,11,4,2,6,13,46.2,7,14,8,6,19,36,28,2,0,2021-2022,90.0,176.28865979381445,157.73195876288662
2672,Ivan Toney,ENG,FW,Brentford,Premier League,25,1996,32.3,33,21,5,20,8,12,38,31.6,26,16,2,14,14,47,44,1,0,2021-2022,90.0,39.0092879256966,91.95046439628483
2673,Ernesto Torregrossa,VEN,FW,Sampdoria,Serie A,29,1992,1.3,2,1,1,0,1,1,2,50.0,1,0,0,0,0,2,1,0,0,2021-2022,90.0,0.0,138.46153846153845
2674,Lucas Torreira,URU,MF,Fiorentina,Serie A,25,1996,24.4,37,29,13,21,3,18,40,45.0,22,18,1,17,26,63,18,0,0,2021-2022,90.0,95.9016393442623,136.47540983606558
2675,Raúl Torrente,ESP,DF,Granada,La Liga,19,2001,14.2,31,21,18,11,2,16,29,55.2,13,14,9,5,12,43,69,0,0,2021-2022,90.0,76.05633802816902,196.47887323943664
Rk,Player,Nation,Pos,Squad,Comp,0,0,90.0,0,0,3,3,3,Tkl,0,0.0,0,0,0,0,0,0,0,0,0,2021-2022,90.0,0.0,0.0
2676,Ferrán Torres,ESP,FW,Manchester City,Premier League,21,2000,3.4,2,2,0,1,1,0,3,0.0,3,2,0,2,0,2,1,0,0,2021-2022,90.0,0.0,52.94117647058823
2677,Ferrán Torres,ESP,FW,Barcelona,La Liga,21,2000,15.7,10,5,3,4,3,3,7,42.9,4,12,3,9,6,16,7,0,0,2021-2022,90.0,34.39490445859873,57.32484076433121
2678,Óliver Torres,ESP,"MF,FW",Sevilla,La Liga,26,1994,11.2,22,12,8,7,7,8,25,32.0,17,10,1,9,6,28,4,0,0,2021-2022,90.0,48.214285714285715,176.78571428571428
2679,Pau Torres,ESP,DF,Villarreal,La Liga,24,1997,31.7,32,19,23,7,2,18,25,72.0,7,32,23,9,19,51,105,2,0,2021-2022,90.0,53.943217665615144,90.85173501577287
2680,Roberto Torres,ESP,"MF,FW",Osasuna,La Liga,32,1989,9.0,7,4,3,1,3,3,15,20.0,12,8,0,8,8,15,4,0,0,2021-2022,90.0,80.0,70.0
2681,Lucas Torró,ESP,MF,Osasuna,La Liga,27,1994,30.3,71,40,25,38,8,29,57,50.9,28,32,11,21,47,118,55,0,0,2021-2022,90.0,139.6039603960396,210.89108910891088
2682,Jordan Torunarigha,GER,DF,Hertha BSC,Bundesliga,23,1997,5.4,4,1,1,3,0,4,5,80.0,1,4,2,2,17,21,30,0,0,2021-2022,90.0,283.3333333333333,66.66666666666666
2683,Cenk Tosun,TUR,MF,Everton,Premier League,30,1991,0.1,0,0,0,0,0,0,0,0.0,0,0,0,0,0,0,0,0,0,2021-2022,90.0,0.0,0.0
2684,Abdoulaye Touré,GUI,MF,Genoa,Serie A,27,1994,4.8,12,4,3,8,1,5,11,45.5,6,6,1,5,4,16,6,0,0,2021-2022,90.0,75.0,225.00000000000003
2685,Almamy Touré,MLI,"DF,MF",Eint Frankfurt,Bundesliga,25,1996,5.6,12,9,8,3,1,4,17,23.5,13,10,3,7,5,17,19,0,0,2021-2022,90.0,80.35714285714286,192.85714285714286
2686,Lucas Tousart,FRA,MF,Hertha BSC,Bundesliga,24,1997,21.8,42,25,15,22,5,10,34,29.4,24,30,6,24,35,77,55,0,0,2021-2022,90.0,144.4954128440367,173.39449541284404
2687,Yoann Touzghar,TUN,FW,Troyes,Ligue 1,34,1986,16.2,5,2,1,3,1,1,3,33.3,2,3,1,2,3,8,8,0,0,2021-2022,90.0,16.666666666666668,27.77777777777778
2688,Andros Townsend,ENG,"MF,FW",Everton,Premier League,30,1991,16.2,31,17,15,6,10,15,40,37.5,25,28,2,26,14,45,6,1,0,2021-2022,90.0,77.77777777777779,172.22222222222223
2689,Adama Traoré,ESP,"FW,MF",Wolves,Premier League,25,1996,11.9,8,3,6,0,2,3,7,42.9,4,4,1,3,2,10,1,0,0,2021-2022,90.00000000000001,15.126050420168069,60.504201680672274
2690,Adama Traoré,ESP,FW,Barcelona,La Liga,25,1996,4.2,4,2,0,3,1,3,5,60.0,2,2,0,2,4,8,3,1,0,2021-2022,90.0,85.71428571428571,85.71428571428571
2691,Amadou Traore,FRA,FW,Bordeaux,Ligue 1,19,2002,0.2,0,0,0,0,0,0,0,0.0,0,0,0,0,0,0,0,0,0,2021-2022,90.0,0.0,0.0
2692,Bertrand Traoré,BFA,"MF,FW",Aston Villa,Premier League,25,1995,2.4,3,3,0,1,2,1,2,50.0,1,0,0,0,0,3,1,0,0,2021-2022,90.0,0.0,112.50000000000001
2693,Boubacar Traoré,MLI,MF,Metz,Ligue 1,19,2001,19.2,43,26,18,23,2,10,39,25.6,29,29,5,24,25,68,11,1,0,2021-2022,90.0,117.18750000000001,201.5625
2694,Charles Traore,MLI,DF,Nantes,Ligue 1,29,1992,8.0,16,12,10,4,2,2,13,15.4,11,11,4,7,15,31,30,0,0,2021-2022,90.0,168.75,180.0
2695,Hamari Traoré,MLI,DF,Rennes,Ligue 1,29,1992,32.1,63,36,25,26,12,41,59,69.5,18,29,8,21,37,100,81,1,0,2021-2022,90.0,103.73831775700934,176.63551401869157
2696,Ismaël Traoré,CIV,DF,Angers,Ligue 1,34,1986,35.7,28,17,16,11,1,13,28,46.4,15,25,17,8,44,72,122,1,0,2021-2022,90.0,110.92436974789915,70.58823529411764
2697,Kevin Trapp,GER,GK,Eint Frankfurt,Bundesliga,31,1990,32.0,0,0,0,0,0,0,1,0.0,1,0,0,0,1,1,13,2,0,2021-2022,90.0,2.8125,0.0
2698,Miguel Trauco,PER,"DF,MF",Saint-Étienne,Ligue 1,28,1992,12.4,25,18,16,8,1,12,22,54.5,10,13,4,9,23,48,17,0,0,2021-2022,90.0,166.93548387096774,181.4516129032258
2699,Óscar Trejo,ARG,MF,Rayo Vallecano,La Liga,33,1988,22.3,42,24,14,18,10,15,50,30.0,35,26,1,25,13,55,11,0,0,2021-2022,90.0,52.46636771300448,169.50672645739908
2700,Trézéguet,EGY,FW,Aston Villa,Premier League,26,1994,0.1,0,0,0,0,0,0,0,0.0,0,0,0,0,0,0,0,0,0,2021-2022,90.0,0.0,0.0
Rk,Player,Nation,Pos,Squad,Comp,0,0,90.0,0,0,3,3,3,Tkl,0,0.0,0,0,0,0,0,0,0,0,0,2021-2022,90.0,0.0,0.0
2701,Manu Trigueros,ESP,"MF,FW",Villarreal,La Liga,29,1991,24.2,45,25,16,18,11,23,66,34.8,43,19,3,16,13,58,17,0,0,2021-2022,90.0,48.34710743801653,167.35537190082644
2702,Simone Trimboli,ITA,MF,Sampdoria,Serie A,19,2002,0.7,2,1,2,0,0,2,2,100.0,0,0,0,0,2,4,0,0,0,2021-2022,90.0,257.14285714285717,257.14285714285717
2703,Christopher Trimmel,AUT,"DF,FW",Union Berlin,Bundesliga,34,1987,22.1,49,30,25,19,5,26,45,57.8,19,20,3,17,34,83,75,0,0,2021-2022,90.0,138.46153846153845,199.54751131221718
2704,Francisco Trincão,POR,"FW,MF",Wolves,Premier League,21,1999,14.8,28,15,9,13,6,3,19,15.8,16,17,1,16,12,40,1,1,0,2021-2022,90.0,72.97297297297297,170.27027027027026
2705,Kieran Trippier,ENG,DF,Newcastle Utd,Premier League,30,1990,4.8,17,10,8,8,1,10,16,62.5,6,10,3,7,10,27,10,0,0,2021-2022,90.0,187.5,318.75
2706,Kieran Trippier,ENG,"DF,FW",Atlético Madrid,La Liga,30,1990,10.8,22,12,12,5,5,12,21,57.1,9,12,1,11,10,32,11,0,0,2021-2022,90.0,83.33333333333333,183.33333333333331
2707,William Troost-Ekong,NGA,DF,Watford,Premier League,27,1993,15.4,18,9,11,6,1,10,15,66.7,5,24,14,10,7,25,82,1,0,2021-2022,90.0,40.909090909090914,105.1948051948052
2708,Leandro Trossard,BEL,"FW,MF",Brighton,Premier League,26,1994,31.2,34,20,12,9,13,4,31,12.9,27,33,4,29,15,49,10,0,0,2021-2022,90.0,43.26923076923077,98.07692307692308
2709,Adrien Truffert,FRA,DF,Rennes,Ligue 1,19,2001,18.2,29,21,17,9,3,11,24,45.8,13,25,5,20,19,48,30,0,0,2021-2022,90.0,93.95604395604396,143.4065934065934
2710,Philipp Tschauner,GER,GK,RB Leipzig,Bundesliga,35,1985,0.0,0,0,0,0,0,0,0,0.0,0,0,0,0,0,0,0,0,0,2021-2022,,,
2711,Kostas Tsimikas,GRE,DF,Liverpool,Premier League,25,1996,9.7,27,12,12,8,7,12,16,75.0,4,6,2,4,10,37,22,2,0,2021-2022,90.0,92.78350515463919,250.5154639175258
2712,Axel Tuanzebe,COD,DF,Aston Villa,Premier League,23,1997,5.6,5,3,3,2,0,2,5,40.0,3,5,4,1,5,10,12,1,0,2021-2022,90.0,80.35714285714286,80.35714285714286
2713,Axel Tuanzebe,COD,DF,Napoli,Serie A,23,1997,0.1,0,0,0,0,0,0,0,0.0,0,1,1,0,0,0,0,0,0,2021-2022,90.0,0.0,0.0
2714,Ozan Tufan,TUR,MF,Watford,Premier League,26,1995,3.7,3,2,1,1,1,1,5,20.0,4,2,0,2,2,5,4,0,0,2021-2022,90.0,48.648648648648646,72.97297297297297
2715,Beñat Turrientes,ESP,MF,Real Sociedad,La Liga,19,2002,2.3,0,0,0,0,0,0,4,0.0,4,1,0,1,2,2,2,0,0,2021-2022,90.0,78.26086956521739,0.0
2716,Tuta,BRA,DF,Eint Frankfurt,Bundesliga,22,1999,24.3,46,28,20,22,4,26,47,55.3,21,43,15,28,41,87,76,1,0,2021-2022,90.0,151.85185185185185,170.37037037037035
2717,Christos Tzolis,GRE,"FW,MF",Norwich City,Premier League,19,2002,3.7,5,3,3,1,1,2,9,22.2,7,3,0,3,1,6,1,0,0,2021-2022,90.0,24.324324324324323,121.62162162162161
2718,Destiny Udogie,ITA,DF,Udinese,Serie A,18,2002,27.5,64,40,30,27,7,33,60,55.0,27,39,6,33,27,91,42,0,0,2021-2022,89.99999999999999,88.36363636363636,209.45454545454544
2719,Matthieu Udol,FRA,DF,Metz,Ligue 1,25,1996,11.2,23,14,11,10,2,12,18,66.7,6,20,7,13,31,54,29,1,0,2021-2022,90.0,249.10714285714286,184.82142857142858
2720,Ike Ugbo,CAN,FW,Troyes,Ligue 1,22,1998,9.0,3,1,0,1,2,0,1,0.0,1,4,1,3,2,5,1,0,0,2021-2022,90.0,20.0,30.0
2721,Lesley Ugochukwu,FRA,MF,Rennes,Ligue 1,17,2004,4.5,13,9,5,5,3,9,19,47.4,10,7,2,5,4,17,2,0,0,2021-2022,90.0,80.0,260.0
2722,Hwang Ui-jo,KOR,FW,Bordeaux,Ligue 1,28,1992,27.9,10,4,4,4,2,4,13,30.8,9,9,1,8,5,15,18,0,0,2021-2022,90.0,16.129032258064516,32.25806451612903
2723,Anthony Ujah,NGA,"FW,MF",Union Berlin,Bundesliga,30,1990,0.4,0,0,0,0,0,0,0,0.0,0,0,0,0,0,0,0,0,0,2021-2022,90.0,0.0,0.0
2724,Maximilian Ullmann,AUT,DF,Venezia,Serie A,25,1996,2.7,0,0,0,0,0,0,1,0.0,1,4,0,4,2,2,7,0,0,2021-2022,90.0,66.66666666666666,0.0
2725,Sven Ulreich,GER,GK,Bayern Munich,Bundesliga,32,1988,6.0,0,0,0,0,0,0,0,0.0,0,0,0,0,0,0,1,0,0,2021-2022,90.0,0.0,0.0
Rk,Player,Nation,Pos,Squad,Comp,0,0,90.0,0,0,3,3,3,Tkl,0,0.0,0,0,0,0,0,0,0,0,0,2021-2022,90.0,0.0,0.0
2726,Samuel Umtiti,FRA,DF,Barcelona,La Liga,27,1993,1.0,2,2,2,0,0,1,2,50.0,1,1,1,0,0,2,4,0,0,2021-2022,90.0,0.0,180.0
2727,Enes Ünal,TUR,FW,Getafe,La Liga,24,1997,31.1,37,22,2,18,17,5,42,11.9,37,25,5,20,5,42,36,0,0,2021-2022,90.0,14.469453376205788,107.07395498392283
2728,Cengiz Ünder,TUR,"FW,MF",Marseille,Ligue 1,24,1997,24.4,18,13,5,6,7,5,18,27.8,13,13,2,11,14,32,9,0,0,2021-2022,90.0,51.63934426229509,66.39344262295083
2729,Dayot Upamecano,FRA,DF,Bayern Munich,Bundesliga,22,1998,24.6,66,42,42,21,3,24,36,66.7,12,20,10,10,32,98,71,6,0,2021-2022,89.99999999999999,117.07317073170731,241.46341463414632
2730,Benjamin Uphoff,GER,GK,Freiburg,Bundesliga,27,1993,2.0,0,0,0,0,0,0,0,0.0,0,0,0,0,0,0,2,2,0,2021-2022,90.0,0.0,0.0
2731,Kacper Urbanski,POL,MF,Bologna,Serie A,16,2004,0.5,3,2,1,2,0,2,2,100.0,0,2,0,2,0,3,0,0,0,2021-2022,90.0,0.0,540.0
2732,Jere Uronen,FIN,DF,Brest,Ligue 1,27,1994,9.8,28,15,15,10,3,14,24,58.3,10,12,3,9,16,44,21,0,0,2021-2022,90.0,146.93877551020407,257.1428571428571
2733,Mark Uth,GER,"MF,FW",Köln,Bundesliga,29,1991,22.5,32,20,9,14,9,15,49,30.6,34,27,1,26,14,46,13,0,0,2021-2022,90.0,56.0,128.0
2734,Myrto Uzuni,ALB,"FW,MF",Granada,La Liga,26,1995,9.5,7,4,6,1,0,0,2,0.0,2,13,1,12,10,17,7,0,0,2021-2022,90.0,94.73684210526316,66.3157894736842
2735,Antonio Vacca,ITA,MF,Venezia,Serie A,31,1990,11.8,36,20,24,10,2,14,36,38.9,22,16,8,8,20,56,16,0,0,2021-2022,90.0,152.54237288135593,274.57627118644064
2736,Álvaro Vadillo,ESP,"DF,MF",Espanyol,La Liga,26,1994,0.1,1,1,1,0,0,1,2,50.0,1,0,0,0,0,1,1,0,0,2021-2022,90.0,0.0,900.0
2737,Óscar Valentín,ESP,MF,Rayo Vallecano,La Liga,26,1994,28.5,102,53,46,51,5,44,105,41.9,61,56,10,46,39,141,43,0,0,2021-2022,90.0,123.15789473684211,322.10526315789474
2738,Germán Valera,ESP,FW,Real Sociedad,La Liga,19,2002,0.6,3,2,3,0,0,1,1,100.0,0,0,0,0,0,3,1,0,0,2021-2022,90.0,0.0,450.00000000000006
2739,Yan Valery,TUN,DF,Southampton,Premier League,22,1999,4.1,8,6,4,3,1,4,9,44.4,5,6,3,3,6,14,19,1,0,2021-2022,90.0,131.70731707317074,175.609756097561
2740,Martin Valjent,SVK,DF,Mallorca,La Liga,25,1995,35.3,31,19,18,12,1,13,24,54.2,11,34,26,8,31,62,173,1,0,2021-2022,90.0,79.03682719546742,79.03682719546742
2741,Jesús Vallejo,ESP,DF,Real Madrid,La Liga,24,1997,3.8,7,5,7,0,0,5,6,83.3,1,9,8,1,6,13,16,0,0,2021-2022,90.0,142.10526315789474,165.78947368421052
2742,Manu Vallejo,ESP,"MF,FW",Alavés,La Liga,24,1997,4.1,8,2,1,4,3,4,13,30.8,9,7,0,7,0,8,4,0,0,2021-2022,90.0,0.0,175.609756097561
2743,Manu Vallejo,ESP,"FW,MF",Valencia,La Liga,24,1997,1.1,2,1,1,1,0,0,1,0.0,1,0,0,0,0,2,1,0,0,2021-2022,90.0,0.0,163.63636363636363
2744,Federico Valverde,URU,MF,Real Madrid,La Liga,23,1998,20.4,36,16,11,16,9,12,31,38.7,19,23,5,18,24,60,12,0,0,2021-2022,90.0,105.88235294117648,158.82352941176472
2745,Virgil van Dijk,NED,DF,Liverpool,Premier League,30,1991,34.0,16,10,11,5,0,11,16,68.8,5,21,14,7,31,47,109,0,0,2021-2022,90.0,82.05882352941177,42.35294117647059
2746,Vanderson,BRA,"FW,DF",Monaco,Ligue 1,20,2001,12.4,35,19,10,19,6,15,23,65.2,8,17,4,13,13,48,12,0,0,2021-2022,90.0,94.35483870967742,254.03225806451613
2747,Zinho Vanheusden,BEL,DF,Genoa,Serie A,22,1999,11.0,18,6,12,5,1,8,14,57.1,6,19,14,5,23,41,42,0,0,2021-2022,90.0,188.1818181818182,147.27272727272728
2748,Jonathan Varane,FRA,MF,Lens,Ligue 1,19,2001,0.0,0,0,0,0,0,0,0,0.0,0,0,0,0,0,0,0,0,0,2021-2022,,,
2749,Raphaël Varane,FRA,DF,Manchester Utd,Premier League,28,1993,20.3,28,19,21,6,1,10,22,45.5,12,18,9,9,18,46,82,1,0,2021-2022,90.0,79.80295566502463,124.13793103448275
2750,Jamie Vardy,ENG,FW,Leicester City,Premier League,34,1987,20.1,6,5,0,4,2,1,7,14.3,6,9,0,9,1,7,17,0,0,2021-2022,90.0,4.477611940298507,26.865671641791042
Rk,Player,Nation,Pos,Squad,Comp,0,0,90.0,0,0,3,3,3,Tkl,0,0.0,0,0,0,0,0,0,0,0,0,2021-2022,90.0,0.0,0.0
2751,Ruben Vargas,SUI,"MF,FW",Augsburg,Bundesliga,22,1998,22.0,28,21,7,14,7,11,30,36.7,19,9,1,8,16,44,13,0,0,2021-2022,90.0,65.45454545454545,114.54545454545455
2752,Sebastian Vasiliadis,GRE,MF,Arminia,Bundesliga,23,1997,13.3,31,17,12,15,4,15,42,35.7,27,15,2,13,25,56,31,1,0,2021-2022,90.0,169.17293233082705,209.77443609022555
2753,Johan Vásquez,MEX,DF,Genoa,Serie A,22,1998,25.3,79,46,44,32,3,48,75,64.0,27,32,10,22,42,121,85,0,0,2021-2022,89.99999999999999,149.4071146245059,281.0276679841897
2754,Denis Vavro,SVK,DF,Lazio,Serie A,25,1996,0.1,0,0,0,0,0,0,0,0.0,0,0,0,0,0,0,0,0,0,2021-2022,90.0,0.0,0.0
2755,José Luis García Vayá,ESP,MF,Levante,La Liga,22,1998,22.4,46,27,10,31,5,16,41,39.0,25,24,5,19,38,84,30,0,0,2021-2022,90.0,152.67857142857144,184.82142857142858
2756,Jesus Vazquez,ESP,DF,Valencia,La Liga,18,2003,9.0,24,13,10,8,6,10,22,45.5,12,16,3,13,9,33,19,0,0,2021-2022,90.0,90.0,240.0
2757,Kevin Vázquez,ESP,DF,Celta Vigo,La Liga,28,1993,14.8,34,24,12,13,9,14,28,50.0,14,20,7,13,36,70,34,0,0,2021-2022,90.0,218.9189189189189,206.75675675675674
2758,Lucas Vázquez,ESP,DF,Real Madrid,La Liga,30,1991,20.4,43,22,24,9,10,17,35,48.6,18,25,7,18,20,63,41,1,0,2021-2022,90.0,88.23529411764706,189.7058823529412
2759,Matías Vecino,URU,MF,Inter,Serie A,29,1991,4.2,7,5,2,3,2,3,9,33.3,6,10,1,9,4,11,7,0,0,2021-2022,90.0,85.71428571428571,150.0
2760,Gabriel Veiga,ESP,MF,Celta Vigo,La Liga,19,2002,1.2,5,4,0,4,1,3,12,25.0,9,2,0,2,4,9,1,0,0,2021-2022,90.0,300.0,375.0
2761,Miguel Veloso,POR,MF,Hellas Verona,Serie A,35,1986,14.9,23,15,4,17,2,10,16,62.5,6,18,5,13,11,34,18,1,0,2021-2022,90.0,66.44295302013423,138.92617449664428
2762,Joël Veltman,NED,DF,Brighton,Premier League,29,1992,31.9,74,48,47,21,6,21,53,39.6,32,46,16,30,45,119,89,0,0,2021-2022,90.0,126.95924764890282,208.77742946708463
2763,Micky van de Ven,NED,DF,Wolfsburg,Bundesliga,20,2001,2.1,4,4,3,1,0,0,1,0.0,1,4,1,3,2,6,8,0,0,2021-2022,90.0,85.71428571428571,171.42857142857142
2764,Unai Vencedor Paris,ESP,MF,Athletic Club,La Liga,20,2000,26.5,26,11,11,9,6,8,42,19.0,34,31,13,18,19,45,22,0,0,2021-2022,90.0,64.52830188679245,88.30188679245283
2765,Lorenzo Venuti,ITA,DF,Fiorentina,Serie A,26,1995,17.5,25,10,13,10,2,14,24,58.3,10,13,4,9,5,30,27,0,0,2021-2022,90.0,25.714285714285715,128.57142857142856
2766,Daniele Verde,ITA,"FW,MF",Spezia,Serie A,25,1996,21.7,11,4,8,2,1,9,20,45.0,11,17,2,15,18,29,8,0,0,2021-2022,90.0,74.65437788018433,45.622119815668206
2767,Simone Verdi,ITA,"MF,FW",Torino,Serie A,29,1992,0.5,1,1,0,1,0,0,0,0.0,0,0,0,0,0,1,0,0,0,2021-2022,90.0,0.0,180.0
2768,Simone Verdi,ITA,"FW,MF",Salernitana,Serie A,29,1992,9.2,12,8,5,2,5,9,20,45.0,11,4,0,4,3,15,1,0,0,2021-2022,90.0,29.347826086956523,117.3913043478261
2769,Gonzalo Verdú,ESP,DF,Elche,La Liga,32,1988,15.5,19,9,15,4,0,8,16,50.0,8,20,14,6,13,32,59,1,0,2021-2022,90.0,75.48387096774194,110.3225806451613
2770,Jordan Veretout,FRA,MF,Roma,Serie A,28,1993,25.8,34,25,20,12,2,15,39,38.5,24,12,1,11,27,61,22,1,0,2021-2022,90.0,94.18604651162791,118.60465116279069
2771,Edoardo Vergani,ITA,"FW,MF",Salernitana,Serie A,20,2001,1.1,2,2,2,0,0,0,0,0.0,0,2,2,0,0,2,2,0,0,2021-2022,90.0,0.0,163.63636363636363
2772,Vincent Vermeij,NED,MF,Freiburg,Bundesliga,26,1994,0.0,0,0,0,0,0,0,0,0.0,0,1,0,1,0,0,0,0,0,2021-2022,,,
2773,Marco Verratti,ITA,MF,Paris S-G,Ligue 1,28,1992,21.5,60,40,16,30,14,32,64,50.0,32,36,10,26,18,78,14,2,0,2021-2022,90.0,75.34883720930232,251.1627906976744
2774,Valerio Verre,ITA,"MF,FW",Sampdoria,Serie A,27,1994,4.7,7,5,1,4,2,4,9,44.4,5,7,0,7,0,7,5,0,0,2021-2022,90.0,0.0,134.04255319148936
2775,Valerio Verre,ITA,MF,Empoli,Serie A,27,1994,3.4,4,2,3,1,0,2,7,28.6,5,2,0,2,1,5,0,0,0,2021-2022,90.0,26.470588235294116,105.88235294117646
Rk,Player,Nation,Pos,Squad,Comp,0,0,90.0,0,0,3,3,3,Tkl,0,0.0,0,0,0,0,0,0,0,0,0,2021-2022,90.0,0.0,0.0
2776,Freddie Veseli,ALB,DF,Salernitana,Serie A,28,1992,6.6,7,2,4,3,0,5,6,83.3,1,10,5,5,4,11,19,0,0,2021-2022,90.0,54.54545454545455,95.45454545454545
2777,Mikel Vesga,ESP,MF,Athletic Club,La Liga,28,1993,15.1,27,14,7,18,2,11,31,35.5,20,16,5,11,20,47,34,2,0,2021-2022,90.0,119.20529801324504,160.9271523178808
2778,Jannik Vestergaard,DEN,DF,Leicester City,Premier League,28,1992,6.3,15,10,12,3,0,8,15,53.3,7,10,8,2,7,22,36,0,0,2021-2022,90.0,100.00000000000001,214.2857142857143
2779,Rúben Vezo,POR,DF,Levante,La Liga,27,1994,26.9,41,29,28,12,1,26,41,63.4,15,41,25,16,36,77,105,1,0,2021-2022,90.0,120.4460966542751,137.17472118959108
2780,Guglielmo Vicario,ITA,GK,Empoli,Serie A,24,1996,38.0,1,1,1,0,0,1,1,100.0,0,1,0,1,1,2,21,1,0,2021-2022,90.0,2.3684210526315788,2.3684210526315788
2781,Aleix Vidal,ESP,"DF,MF",Espanyol,La Liga,31,1989,21.1,31,25,17,9,5,19,39,48.7,20,19,6,13,25,56,35,2,0,2021-2022,90.0,106.63507109004739,132.22748815165878
2782,Arturo Vidal,CHI,MF,Inter,Serie A,34,1987,8.2,26,10,16,9,1,9,26,34.6,17,13,5,8,7,33,7,1,0,2021-2022,90.0,76.82926829268294,285.3658536585366
2783,Nacho Vidal,ESP,DF,Osasuna,La Liga,26,1995,32.2,83,47,49,25,9,39,77,50.6,38,32,14,18,58,141,79,0,0,2021-2022,90.0,162.111801242236,231.98757763975152
2784,Gabriel Vidovic,CRO,"FW,MF",Bayern Munich,Bundesliga,17,2003,0.4,0,0,0,0,0,0,0,0.0,0,0,0,0,0,0,0,0,0,2021-2022,90.0,0.0,0.0
2785,Ronaldo Vieira,ENG,MF,Sampdoria,Serie A,23,1998,5.5,10,6,6,4,0,5,10,50.0,5,5,2,3,6,16,5,1,0,2021-2022,90.0,98.18181818181819,163.63636363636365
2786,Nick Viergever,NED,DF,Greuther Fürth,Bundesliga,31,1989,23.7,32,23,25,7,0,24,34,70.6,10,31,22,9,37,69,119,1,0,2021-2022,90.0,140.50632911392407,121.51898734177216
2787,Luca Vignali,ITA,"DF,MF",Spezia,Serie A,25,1996,0.9,1,1,0,1,0,0,3,0.0,3,0,0,0,1,2,1,0,0,2021-2022,90.0,100.0,100.0
2788,Emanuel Vignato,ITA,"MF,DF",Bologna,Serie A,20,2000,6.6,12,7,5,7,0,6,13,46.2,7,2,0,2,2,14,5,0,0,2021-2022,90.0,27.272727272727273,163.63636363636363
2789,Dídac Vilà,ESP,"DF,MF",Espanyol,La Liga,32,1989,2.3,7,5,2,5,0,4,9,44.4,5,2,1,1,3,10,8,0,0,2021-2022,90.0,117.3913043478261,273.9130434782609
2790,Tonny Vilhena,NED,"MF,FW",Espanyol,La Liga,26,1995,10.3,16,6,7,8,1,7,21,33.3,14,10,2,8,8,24,17,0,0,2021-2022,90.0,69.90291262135922,139.80582524271844
2791,Daniel Villahermosa,ESP,MF,Espanyol,La Liga,20,2001,0.3,0,0,0,0,0,0,0,0.0,0,0,0,0,0,0,1,0,0,2021-2022,90.0,0.0,0.0
2792,Asier Villalibre,ESP,FW,Athletic Club,La Liga,23,1997,6.1,4,3,2,1,1,1,2,50.0,1,3,1,2,1,5,7,0,0,2021-2022,90.0,14.754098360655739,59.016393442622956
2793,Gonzalo Villar,ESP,MF,Getafe,La Liga,23,1998,3.3,5,3,4,1,0,2,5,40.0,3,4,1,3,1,6,1,0,0,2021-2022,90.0,27.272727272727273,136.36363636363637
2794,Matías Viña,URU,"DF,FW",Roma,Serie A,23,1997,17.4,46,30,27,14,5,29,59,49.2,30,26,3,23,25,71,33,0,0,2021-2022,90.0,129.31034482758622,237.93103448275863
2795,Nicolas Viola,ITA,MF,Bologna,Serie A,31,1989,1.1,2,2,1,1,0,1,2,50.0,1,1,1,0,0,2,1,0,0,2021-2022,90.0,0.0,163.63636363636363
2796,Mattia Viti,ITA,DF,Empoli,Serie A,19,2002,16.6,28,16,16,9,3,15,24,62.5,9,28,25,3,29,57,69,1,0,2021-2022,90.0,157.2289156626506,151.80722891566262
2797,Vitolo,ESP,MF,Getafe,La Liga,31,1989,2.5,3,2,1,1,1,2,5,40.0,3,3,0,3,1,4,1,0,0,2021-2022,90.0,36.0,108.0
2798,Daniel Vivian,ESP,DF,Athletic Club,La Liga,22,1999,22.1,32,21,24,7,1,17,24,70.8,7,20,15,5,26,58,107,1,0,2021-2022,90.0,105.88235294117646,130.31674208144796
2799,Dušan Vlahović,SRB,FW,Fiorentina,Serie A,21,2000,20.6,5,0,0,2,3,2,11,18.2,9,6,2,4,1,6,16,0,0,2021-2022,90.0,4.368932038834951,21.844660194174757
2800,Dušan Vlahović,SRB,FW,Juventus,Serie A,21,2000,12.0,0,0,0,0,0,0,4,0.0,4,3,0,3,0,0,7,0,0,2021-2022,90.0,0.0,0.0
Rk,Player,Nation,Pos,Squad,Comp,0,0,90.0,0,0,3,3,3,Tkl,0,0.0,0,0,0,0,0,0,0,0,0,2021-2022,90.0,0.0,0.0
2801,Nikola Vlašić,CRO,"FW,MF",West Ham,Premier League,23,1997,6.2,11,7,4,6,1,5,20,25.0,15,4,0,4,2,13,1,0,0,2021-2022,90.0,29.032258064516128,159.67741935483872
2802,Andreas Voglsammer,GER,"FW,MF",Union Berlin,Bundesliga,29,1992,9.8,14,9,8,3,3,6,14,42.9,8,9,2,7,2,16,7,0,0,2021-2022,90.0,18.36734693877551,128.57142857142856
2803,Kevin Vogt,GER,DF,Hoffenheim,Bundesliga,29,1991,28.5,21,12,15,6,0,11,21,52.4,10,18,7,11,13,34,101,1,0,2021-2022,90.0,41.05263157894737,66.31578947368422
2804,Mërgim Vojvoda,KVX,DF,Torino,Serie A,26,1995,22.0,38,23,23,11,4,20,36,55.6,16,27,8,19,20,58,51,0,0,2021-2022,90.0,81.81818181818183,155.45454545454547
2805,Kevin Volland,GER,"MF,FW",Monaco,Ligue 1,29,1992,27.1,24,10,2,18,4,6,31,19.4,25,20,0,20,3,27,9,0,0,2021-2022,90.0,9.963099630996311,79.70479704797049
2806,Cristian Volpato,ITA,"FW,MF",Roma,Serie A,17,2003,0.4,1,1,0,0,1,1,1,100.0,0,0,0,0,0,1,0,0,0,2021-2022,90.0,0.0,225.0
2807,Aster Vranckx,BEL,MF,Wolfsburg,Bundesliga,18,2002,12.7,34,13,14,16,4,14,26,53.8,12,19,7,12,13,47,16,0,0,2021-2022,90.0,92.1259842519685,240.9448818897638
2808,Stefan de Vrij,NED,DF,Inter,Serie A,29,1992,26.8,38,29,22,16,0,12,17,70.6,5,17,8,9,32,70,52,0,0,2021-2022,90.0,107.46268656716417,127.61194029850745
2809,Šime Vrsaljko,CRO,DF,Atlético Madrid,La Liga,29,1992,10.2,27,17,14,12,1,12,20,60.0,8,10,1,9,12,39,30,0,0,2021-2022,90.0,105.88235294117648,238.23529411764707
2810,Nikola Vukčević,MNE,MF,Levante,La Liga,29,1991,1.3,3,2,2,1,0,0,1,0.0,1,2,0,2,2,5,1,0,0,2021-2022,90.0,138.46153846153845,207.69230769230768
2811,Matěj Vydra,CZE,FW,Burnley,Premier League,29,1992,7.5,12,7,3,4,5,3,7,42.9,4,5,1,4,0,12,9,0,0,2021-2022,90.0,0.0,144.0
2812,Elye Wahi,FRA,FW,Montpellier,Ligue 1,18,2003,19.8,18,10,9,6,3,6,16,37.5,10,7,0,7,4,22,4,0,0,2021-2022,90.0,18.181818181818183,81.81818181818181
2813,Walace,BRA,MF,Udinese,Serie A,26,1995,33.0,83,49,37,38,8,50,113,44.2,63,51,5,46,54,137,32,1,0,2021-2022,90.0,147.27272727272728,226.36363636363637
2814,Theo Walcott,ENG,"MF,FW",Southampton,Premier League,32,1989,4.2,4,2,2,0,2,1,5,20.0,4,3,0,3,5,9,2,0,0,2021-2022,90.0,107.14285714285714,85.71428571428571
2815,Luca Waldschmidt,GER,"MF,FW",Wolfsburg,Bundesliga,25,1996,8.0,9,1,3,5,1,5,13,38.5,8,5,0,5,8,17,3,0,0,2021-2022,90.0,90.0,101.25
2816,Kyle Walker,ENG,DF,Manchester City,Premier League,31,1990,19.5,15,6,7,7,1,8,17,47.1,9,14,4,10,14,29,16,1,0,2021-2022,90.0,64.61538461538461,69.23076923076923
2817,Kyle Walker-Peters,ENG,DF,Southampton,Premier League,24,1997,29.3,57,33,28,21,8,26,38,68.4,12,29,8,21,37,94,53,1,0,2021-2022,90.0,113.65187713310581,175.08532423208192
2818,Sebastian Walukiewicz,POL,DF,Cagliari,Serie A,21,2000,3.4,9,5,7,2,0,3,5,60.0,2,5,2,3,7,16,14,0,0,2021-2022,90.0,185.2941176470588,238.23529411764704
2819,Aaron Wan-Bissaka,ENG,DF,Manchester Utd,Premier League,23,1997,19.9,49,36,25,18,6,14,20,70.0,6,24,14,10,34,83,41,2,0,2021-2022,90.0,153.76884422110555,221.60804020100505
2820,Paul Wanner,GER,"FW,MF",Bayern Munich,Bundesliga,15,2005,0.4,2,2,0,2,0,1,1,100.0,0,0,0,0,0,2,0,0,0,2021-2022,90.0,0.0,450.0
2821,Danny Ward,WAL,GK,Leicester City,Premier League,28,1993,1.0,0,0,0,0,0,0,0,0.0,0,0,0,0,0,0,1,0,0,2021-2022,90.0,0.0,0.0
2822,Joel Ward,ENG,DF,Crystal Palace,Premier League,31,1989,27.6,44,26,30,11,3,30,57,52.6,27,24,11,13,32,76,107,1,0,2021-2022,90.0,104.34782608695652,143.4782608695652
2823,James Ward-Prowse,ENG,MF,Southampton,Premier League,26,1994,35.7,41,24,12,24,5,19,70,27.1,51,43,15,28,40,81,45,1,0,2021-2022,90.0,100.84033613445376,103.36134453781511
2824,Magnus Warming,DEN,"MF,FW",Torino,Serie A,21,2000,0.6,1,1,0,1,0,0,0,0.0,0,2,0,2,0,1,0,0,0,2021-2022,90.0,0.0,150.0
2825,Daniel Wass,DEN,"DF,FW",Atlético Madrid,La Liga,32,1989,0.5,0,0,0,0,0,0,0,0.0,0,0,0,0,0,0,3,0,0,2021-2022,90.0,0.0,0.0
Rk,Player,Nation,Pos,Squad,Comp,0,0,90.0,0,0,3,3,3,Tkl,0,0.0,0,0,0,0,0,0,0,0,0,2021-2022,90.0,0.0,0.0
2826,Daniel Wass,DEN,MF,Valencia,La Liga,32,1989,17.6,23,13,6,14,3,8,31,25.8,23,13,2,11,13,36,19,0,0,2021-2022,90.0,66.47727272727272,117.61363636363636
2827,Ollie Watkins,ENG,FW,Aston Villa,Premier League,25,1995,32.8,17,13,2,7,8,2,15,13.3,13,25,3,22,12,29,27,0,0,2021-2022,90.0,32.926829268292686,46.646341463414636
2828,Timothy Weah,USA,"MF,FW",Lille,Ligue 1,21,2000,18.0,19,7,8,8,3,10,20,50.0,10,16,1,15,10,29,7,0,0,2021-2022,90.0,50.0,95.0
2829,Adam Webster,ENG,DF,Brighton,Premier League,26,1995,15.9,26,8,17,7,2,13,20,65.0,7,25,17,8,17,43,66,2,0,2021-2022,90.0,96.22641509433963,147.16981132075472
2830,Wout Weghorst,NED,FW,Burnley,Premier League,28,1992,16.1,17,9,3,9,5,6,19,31.6,13,16,5,11,6,23,13,0,0,2021-2022,90.0,33.54037267080745,95.03105590062111
2831,Wout Weghorst,NED,FW,Wolfsburg,Bundesliga,28,1992,17.3,13,7,3,3,7,7,17,41.2,10,10,3,7,2,15,11,1,0,2021-2022,90.0,10.404624277456646,67.6300578034682
2832,Noah Weißhaupt,GER,"MF,FW",Freiburg,Bundesliga,19,2001,1.1,1,1,1,0,0,1,2,50.0,1,2,0,2,1,2,1,1,0,2021-2022,90.0,81.81818181818181,81.81818181818181
2833,Danny Welbeck,ENG,"FW,MF",Brighton,Premier League,30,1990,16.4,14,7,2,8,4,3,10,30.0,7,18,2,16,5,19,18,0,0,2021-2022,90.0,27.439024390243905,76.82926829268294
2834,Timo Werner,GER,"FW,MF",Chelsea,Premier League,25,1996,14.3,8,4,3,3,2,2,20,10.0,18,9,0,9,2,10,4,0,0,2021-2022,90.0,12.587412587412588,50.349650349650354
2835,Ashley Westwood,ENG,MF,Burnley,Premier League,31,1990,25.4,21,12,8,12,1,10,31,32.3,21,21,9,12,30,51,16,1,0,2021-2022,90.0,106.2992125984252,74.40944881889764
2836,Ben White,ENG,DF,Arsenal,Premier League,23,1997,32.0,44,23,30,8,6,28,45,62.2,17,42,24,18,42,86,102,0,0,2021-2022,90.0,118.125,123.75
2837,Silvan Widmer,SUI,DF,Mainz 05,Bundesliga,28,1993,32.4,60,28,32,20,8,36,61,59.0,25,44,16,28,43,103,59,2,0,2021-2022,90.0,119.44444444444444,166.66666666666669
2838,Georginio Wijnaldum,NED,MF,Paris S-G,Ligue 1,30,1990,18.4,15,9,2,12,1,11,19,57.9,8,13,3,10,9,24,7,0,0,2021-2022,90.0,44.02173913043479,73.36956521739131
2839,Jetro Willems,NED,DF,Greuther Fürth,Bundesliga,27,1994,17.8,30,15,18,10,2,15,26,57.7,11,15,3,12,14,44,42,0,0,2021-2022,90.0,70.78651685393258,151.68539325842696
2840,Brandon Williams,ENG,DF,Norwich City,Premier League,20,2000,23.6,55,37,35,18,2,36,64,56.3,28,26,6,20,44,99,50,0,0,2021-2022,90.0,167.79661016949152,209.7457627118644
2841,Iñaki Williams,GHA,FW,Athletic Club,La Liga,27,1994,30.9,14,5,1,6,7,5,17,29.4,12,18,3,15,3,17,20,0,0,2021-2022,90.0,8.737864077669903,40.77669902912621
2842,Neco Williams,WAL,DF,Liverpool,Premier League,20,2001,0.1,0,0,0,0,0,0,0,0.0,0,0,0,0,0,0,0,0,0,2021-2022,90.0,0.0,0.0
2843,Nico Williams,ESP,MF,Athletic Club,La Liga,19,2002,14.9,20,10,6,11,3,10,31,32.3,21,18,2,16,5,25,9,0,0,2021-2022,90.0,30.201342281879192,120.80536912751677
2844,Joe Willock,ENG,MF,Newcastle Utd,Premier League,21,1999,22.6,64,37,30,28,6,29,68,42.6,39,37,6,31,21,85,10,1,0,2021-2022,90.0,83.6283185840708,254.86725663716814
2845,Callum Wilson,ENG,FW,Newcastle Utd,Premier League,29,1992,15.4,9,8,1,5,3,1,4,25.0,3,7,2,5,3,12,10,0,0,2021-2022,90.0,17.532467532467532,52.5974025974026
2846,Patrick Wimmer,AUT,"FW,MF",Arminia,Bundesliga,20,2001,22.8,53,31,13,31,9,22,61,36.1,39,30,1,29,27,80,13,0,0,2021-2022,90.0,106.57894736842104,209.21052631578945
2847,Jonas Wind,DEN,"FW,MF",Wolfsburg,Bundesliga,22,1999,13.1,10,6,1,7,2,1,4,25.0,3,8,3,5,6,16,13,0,0,2021-2022,90.0,41.221374045801525,68.70229007633588
2848,Marten Winkler,GER,MF,Hertha BSC,Bundesliga,18,2002,0.3,0,0,0,0,0,0,0,0.0,0,0,0,0,0,0,0,0,0,2021-2022,90.0,0.0,0.0
2849,Harry Winks,ENG,MF,Tottenham,Premier League,25,1996,10.1,15,10,4,9,2,8,21,38.1,13,14,3,11,16,31,10,2,0,2021-2022,90.0,142.5742574257426,133.66336633663366
2850,Frederik Winther,DEN,DF,Augsburg,Bundesliga,20,2001,3.6,7,2,7,0,0,5,6,83.3,1,4,1,3,8,15,21,0,0,2021-2022,90.0,200.0,175.0
Rk,Player,Nation,Pos,Squad,Comp,0,0,90.0,0,0,3,3,3,Tkl,0,0.0,0,0,0,0,0,0,0,0,0,2021-2022,90.0,0.0,0.0
2851,Florian Wirtz,GER,"MF,FW",Leverkusen,Bundesliga,18,2003,20.6,25,10,6,16,3,10,28,35.7,18,12,1,11,13,38,4,0,0,2021-2022,90.0,56.79611650485437,109.22330097087378
2852,Yoane Wissa,COD,FW,Brentford,Premier League,24,1996,14.3,12,6,5,4,3,1,16,6.3,15,12,5,7,8,20,6,0,0,2021-2022,90.0,50.349650349650354,75.52447552447552
2853,Axel Witsel,BEL,"MF,DF",Dortmund,Bundesliga,32,1989,21.6,42,27,12,23,7,18,30,60.0,12,24,9,15,27,69,38,0,0,2021-2022,90.0,112.49999999999999,175.0
2854,Hannes Wolf,AUT,"FW,MF",Gladbach,Bundesliga,22,1999,3.4,23,12,4,13,6,10,20,50.0,10,10,0,10,2,25,1,0,0,2021-2022,90.0,52.94117647058823,608.8235294117648
2855,Marius Wolf,GER,"DF,FW",Dortmund,Bundesliga,26,1995,14.7,26,10,13,9,4,12,24,50.0,12,14,1,13,13,39,8,0,0,2021-2022,90.0,79.59183673469389,159.18367346938777
2856,Luca Wollschläger,GER,"FW,MF",Hertha BSC,Bundesliga,18,2003,0.2,1,1,0,1,0,0,1,0.0,1,0,0,0,0,1,0,0,0,2021-2022,90.0,0.0,450.0
2857,Jeong Woo-yeong,KOR,"FW,MF",Freiburg,Bundesliga,21,1999,19.8,15,9,6,7,2,5,15,33.3,10,8,1,7,7,22,11,0,0,2021-2022,90.0,31.818181818181817,68.18181818181819
2858,Chris Wood,NZL,FW,Burnley,Premier League,29,1991,15.2,7,5,0,3,4,3,10,30.0,7,13,4,9,0,7,3,0,0,2021-2022,90.0,0.0,41.44736842105263
2859,Chris Wood,NZL,FW,Newcastle Utd,Premier League,29,1991,14.7,2,0,1,1,0,1,2,50.0,1,5,2,3,2,4,9,0,0,2021-2022,90.0,12.244897959183673,12.244897959183673
2860,Freddie Woodman,ENG,GK,Newcastle Utd,Premier League,24,1997,4.0,0,0,0,0,0,0,0,0.0,0,0,0,0,0,0,0,1,0,2021-2022,90.0,0.0,0.0
2861,Christopher Wooh,CMR,DF,Lens,Ligue 1,19,2001,11.7,29,11,20,8,1,11,18,61.1,7,21,14,7,21,50,40,1,0,2021-2022,89.99999999999999,161.53846153846152,223.07692307692307
2862,Joscha Wosz,GER,DF,RB Leipzig,Bundesliga,19,2002,0.1,0,0,0,0,0,0,0,0.0,0,0,0,0,0,0,0,0,0,2021-2022,90.0,0.0,0.0
2863,Xeka,POR,MF,Lille,Ligue 1,26,1994,18.0,47,27,18,24,5,27,56,48.2,29,23,3,20,24,71,26,1,0,2021-2022,90.0,120.0,235.0
2864,Granit Xhaka,SUI,"MF,DF",Arsenal,Premier League,28,1992,25.9,32,18,16,12,4,16,41,39.0,25,21,6,15,21,53,31,0,0,2021-2022,90.0,72.97297297297298,111.19691119691122
2865,Sekou Yansané,GUI,FW,Paris S-G,Ligue 1,18,2003,0.2,0,0,0,0,0,0,1,0.0,1,0,0,0,0,0,1,0,0,2021-2022,90.0,0.0,0.0
2866,Andriy Yarmolenko,UKR,"FW,MF",West Ham,Premier League,31,1989,3.5,4,2,2,2,0,2,8,25.0,6,4,2,2,0,4,2,0,0,2021-2022,90.0,0.0,102.85714285714286
2867,Yusuf Yazıcı,TUR,"MF,FW",Lille,Ligue 1,24,1997,5.7,10,5,3,6,1,1,9,11.1,8,4,0,4,2,12,1,0,0,2021-2022,90.0,31.57894736842105,157.89473684210526
2868,Kelvin Yeboah,ITA,"FW,MF",Genoa,Serie A,21,2000,9.4,14,7,5,7,2,9,19,47.4,10,22,1,21,1,15,7,0,0,2021-2022,90.0,9.574468085106382,134.04255319148936
2869,Gerard Yepes,ESP,"MF,DF",Sampdoria,Serie A,18,2002,0.2,1,0,0,1,0,1,1,100.0,0,1,0,1,0,1,0,0,0,2021-2022,90.0,0.0,450.0
2870,Burak Yılmaz,TUR,FW,Lille,Ligue 1,36,1985,24.6,7,2,0,2,5,2,17,11.8,15,8,1,7,2,9,11,0,0,2021-2022,89.99999999999999,7.317073170731707,25.60975609756097
2871,Okay Yokuşlu,TUR,"DF,MF",Getafe,La Liga,27,1994,5.2,9,8,6,2,1,5,5,100.0,0,7,5,2,5,14,17,0,0,2021-2022,90.0,86.53846153846153,155.76923076923075
2872,Okay Yokuşlu,TUR,"DF,MF",Celta Vigo,La Liga,27,1994,1.6,4,1,2,1,1,2,3,66.7,1,2,1,1,2,6,6,0,0,2021-2022,90.0,112.5,225.0
2873,Leny Yoro,FRA,MF,Lille,Ligue 1,15,2005,0.1,1,0,0,1,0,0,0,0.0,0,1,0,1,0,1,0,0,0,2021-2022,90.0,0.0,900.0
2874,Maya Yoshida,JPN,DF,Sampdoria,Serie A,32,1988,20.3,17,10,8,9,0,8,15,53.3,7,27,20,7,28,45,72,1,0,2021-2022,90.0,124.13793103448275,75.36945812807882
2875,Ashley Young,ENG,"DF,FW",Aston Villa,Premier League,36,1985,13.9,18,6,9,6,3,11,16,68.8,5,10,4,6,13,31,25,1,0,2021-2022,90.0,84.1726618705036,116.54676258992806
Rk,Player,Nation,Pos,Squad,Comp,0,0,90.0,0,0,3,3,3,Tkl,0,0.0,0,0,0,0,0,0,0,0,0,2021-2022,90.0,0.0,0.0
2876,Nathan Young-Coombes,ENG,MF,Brentford,Premier League,18,2003,0.0,0,0,0,0,0,0,0,0.0,0,0,0,0,0,0,0,0,0,2021-2022,,,
2877,Zaydou Youssouf,FRA,MF,Saint-Étienne,Ligue 1,22,1999,17.3,48,26,21,25,2,14,34,41.2,20,11,3,8,17,65,13,0,0,2021-2022,90.0,88.4393063583815,249.71098265895952
2878,Mattia Zaccagni,ITA,MF,Hellas Verona,Serie A,26,1995,2.0,3,1,1,0,2,1,2,50.0,1,1,0,1,4,7,0,0,0,2021-2022,90.0,180.0,135.0
2879,Mattia Zaccagni,ITA,FW,Lazio,Serie A,26,1995,20.8,33,16,10,13,10,11,19,57.9,8,17,2,15,20,53,5,0,0,2021-2022,90.0,86.53846153846153,142.78846153846152
2880,Dan-Axel Zagadou,FRA,DF,Dortmund,Bundesliga,22,1999,10.6,13,7,11,1,1,7,10,70.0,3,14,4,10,15,28,38,2,0,2021-2022,90.0,127.35849056603774,110.37735849056604
2881,Wilfried Zaha,CIV,FW,Crystal Palace,Premier League,28,1992,30.7,40,20,14,15,11,10,31,32.3,21,28,0,28,5,45,5,0,0,2021-2022,90.0,14.65798045602606,117.26384364820848
2882,Denis Zakaria,SUI,MF,Juventus,Serie A,24,1996,6.6,11,7,3,6,2,3,11,27.3,8,16,3,13,11,22,7,0,0,2021-2022,90.0,150.0,150.0
2883,Denis Zakaria,SUI,"MF,DF",Gladbach,Bundesliga,24,1996,15.5,23,14,9,10,4,12,35,34.3,23,25,5,20,19,42,22,1,0,2021-2022,90.0,110.3225806451613,133.5483870967742
2884,Joseba Zaldúa,ESP,DF,Real Sociedad,La Liga,29,1992,13.0,31,22,20,8,3,16,22,72.7,6,14,4,10,13,44,35,0,0,2021-2022,90.00000000000001,90.00000000000001,214.61538461538464
2885,Nicola Zalewski,POL,DF,Roma,Serie A,19,2002,8.8,32,19,17,11,4,21,35,60.0,14,18,1,17,16,48,4,0,0,2021-2022,90.0,163.63636363636363,327.27272727272725
2886,Andre-Frank Zambo Anguissa,CMR,MF,Napoli,Serie A,25,1995,21.4,50,26,24,17,9,25,51,49.0,26,31,5,26,24,74,33,1,0,2021-2022,90.0,100.93457943925235,210.28037383177573
2887,Nicolò Zaniolo,ITA,"FW,MF",Roma,Serie A,22,1999,21.9,24,15,0,15,9,6,28,21.4,22,19,0,19,7,31,6,0,0,2021-2022,90.0,28.767123287671236,98.63013698630138
2888,Alessandro Zanoli,ITA,DF,Napoli,Serie A,20,2000,5.1,10,7,6,3,1,3,5,60.0,2,2,1,1,4,14,16,0,0,2021-2022,90.0,70.58823529411765,176.47058823529412
2889,Mattia Zanotti,ITA,DF,Inter,Serie A,18,2003,0.1,1,0,1,0,0,0,1,0.0,1,0,0,0,0,1,0,0,0,2021-2022,90.0,0.0,900.0
2890,Duván Zapata,COL,FW,Atalanta,Serie A,30,1991,19.1,6,2,0,4,2,4,8,50.0,4,8,1,7,3,9,5,0,0,2021-2022,90.0,14.136125654450261,28.272251308900522
2891,Gabriele Zappa,ITA,DF,Cagliari,Serie A,21,1999,12.7,21,9,12,6,3,6,24,25.0,18,15,5,10,14,35,28,0,0,2021-2022,90.0,99.21259842519686,148.8188976377953
2892,Davide Zappacosta,ITA,DF,Atalanta,Serie A,29,1992,26.1,32,22,12,13,7,19,37,51.4,18,32,2,30,12,44,22,0,0,2021-2022,90.0,41.37931034482758,110.34482758620689
2893,Oier Zarraga,ESP,MF,Athletic Club,La Liga,22,1999,13.0,13,5,4,7,2,3,28,10.7,25,17,10,7,19,32,10,0,0,2021-2022,90.00000000000001,131.53846153846155,90.00000000000001
2894,Simone Zaza,ITA,"FW,DF",Torino,Serie A,30,1991,1.4,2,2,1,1,0,1,1,100.0,0,3,0,3,0,2,3,0,0,2021-2022,90.0,0.0,128.57142857142858
2895,Akim Zedadka,ALG,DF,Clermont Foot,Ligue 1,26,1995,37.1,72,44,34,29,9,37,71,52.1,34,32,8,24,58,130,48,0,0,2021-2022,90.0,140.70080862533692,174.66307277628033
2896,Deyovaisio Zeefuik,NED,DF,Hertha BSC,Bundesliga,23,1998,6.3,11,10,6,4,1,6,12,50.0,6,12,4,8,11,22,21,1,0,2021-2022,90.0,157.14285714285717,157.14285714285717
2897,Marvin Zeegelaar,NED,DF,Udinese,Serie A,30,1990,7.1,15,11,6,8,1,5,14,35.7,9,12,4,8,12,27,22,1,0,2021-2022,90.0,152.11267605633805,190.14084507042256
2898,Arber Zeneli,KVX,FW,Reims,Ligue 1,26,1995,4.5,1,0,0,0,1,1,5,20.0,4,0,0,0,1,2,1,0,0,2021-2022,90.0,20.0,20.0
2899,Robin Zentner,GER,GK,Mainz 05,Bundesliga,26,1994,32.0,2,2,2,0,0,2,2,100.0,0,0,0,0,2,4,21,1,0,2021-2022,90.0,5.625,5.625
2900,Andi Zeqiri,SUI,"FW,MF",Augsburg,Bundesliga,22,1999,11.3,14,7,3,5,6,3,12,25.0,9,10,1,9,2,16,12,0,0,2021-2022,90.0,15.929203539823009,111.50442477876106
Rk,Player,Nation,Pos,Squad,Comp,0,0,90.0,0,0,3,3,3,Tkl,0,0.0,0,0,0,0,0,0,0,0,0,2021-2022,90.0,0.0,0.0
2901,Mehdi Zerkane,ALG,"MF,DF",Bordeaux,Ligue 1,22,1999,0.9,0,0,0,0,0,0,1,0.0,1,1,1,0,2,2,0,0,0,2021-2022,90.0,200.0,0.0
2902,Edon Zhegrova,KVX,"MF,FW",Lille,Ligue 1,22,1999,5.3,14,5,2,8,4,5,6,83.3,1,4,1,3,2,16,2,0,0,2021-2022,90.0,33.9622641509434,237.7358490566038
2903,Luca Zidane,FRA,GK,Rayo Vallecano,La Liga,23,1998,7.2,0,0,0,0,0,0,1,0.0,1,0,0,0,0,0,1,1,0,2021-2022,90.0,0.0,0.0
2904,Piotr Zieliński,POL,MF,Napoli,Serie A,27,1994,23.2,19,12,5,9,5,6,21,28.6,15,13,2,11,8,27,4,0,0,2021-2022,90.0,31.03448275862069,73.70689655172414
2905,David Zima,CZE,DF,Torino,Serie A,20,2000,14.6,20,12,8,11,1,9,20,45.0,11,15,13,2,23,43,42,0,0,2021-2022,90.0,141.78082191780823,123.28767123287672
2906,Christoph Zimmermann,GER,DF,Norwich City,Premier League,28,1993,1.7,6,3,5,1,0,3,4,75.0,1,0,0,0,1,7,4,0,0,2021-2022,90.0,52.94117647058823,317.6470588235294
2907,Oleksandr Zinchenko,UKR,DF,Manchester City,Premier League,24,1996,11.6,20,14,7,10,3,11,20,55.0,9,11,3,8,14,34,15,1,0,2021-2022,90.0,108.62068965517241,155.17241379310346
2908,Hakim Ziyech,MAR,"MF,FW",Chelsea,Premier League,28,1993,14.7,19,10,5,12,2,10,36,27.8,26,11,1,10,10,29,10,0,0,2021-2022,90.0,61.224489795918366,116.3265306122449
2909,Jeroen Zoet,NED,GK,Spezia,Serie A,30,1991,7.0,1,0,1,0,0,1,1,100.0,0,0,0,0,0,1,4,0,0,2021-2022,90.0,0.0,12.857142857142858
2910,Simon Zoller,GER,FW,Bochum,Bundesliga,30,1991,6.6,4,2,2,1,1,1,3,33.3,2,3,0,3,4,8,2,0,0,2021-2022,90.0,54.54545454545455,54.54545454545455
2911,Nadir Zortea,ITA,"DF,MF",Salernitana,Serie A,22,1999,15.7,21,15,9,7,5,11,19,57.9,8,14,2,12,7,28,33,0,0,2021-2022,90.0,40.12738853503185,120.38216560509555
2912,Tanguy Zoukrou,FRA,DF,Troyes,Ligue 1,18,2003,0.9,1,0,1,0,0,1,2,50.0,1,0,0,0,0,1,2,0,0,2021-2022,90.0,0.0,100.0
2913,Kurt Zouma,FRA,DF,West Ham,Premier League,26,1994,23.1,11,6,8,3,0,4,7,57.1,3,31,26,5,34,45,132,0,0,2021-2022,89.99999999999999,132.46753246753244,42.85714285714285
2914,Petar Zovko,BIH,GK,Spezia,Serie A,19,2002,0.3,0,0,0,0,0,0,0,0.0,0,0,0,0,0,0,1,0,0,2021-2022,90.0,0.0,0.0
2915,Igor Zubeldia,ESP,DF,Real Sociedad,La Liga,24,1997,18.3,20,10,12,8,0,12,18,66.7,6,16,6,10,27,47,53,0,0,2021-2022,90.0,132.78688524590163,98.36065573770492
2916,Martín Zubimendi,ESP,MF,Real Sociedad,La Liga,22,1999,28.8,52,25,19,30,3,22,44,50.0,22,30,13,17,49,101,48,1,0,2021-2022,90.0,153.125,162.5
2917,Szymon Żurkowski,POL,MF,Empoli,Serie A,23,1997,25.6,58,33,24,21,13,29,68,42.6,39,43,10,33,35,93,32,1,0,2021-2022,90.0,123.046875,203.90625
2918,Martin Ødegaard,NOR,"MF,FW",Arsenal,Premier League,22,1998,30.9,49,21,6,24,19,22,61,36.1,39,18,1,17,11,60,11,1,0,2021-2022,90.0,32.03883495145631,142.71844660194176
2919,Milan Đurić,BIH,FW,Salernitana,Serie A,31,1990,24.1,1,1,0,1,0,1,3,33.3,2,6,1,5,2,3,32,0,0,2021-2022,90.0,7.468879668049793,3.7344398340248963
2920,Filip Đuričić,SRB,"MF,FW",Sassuolo,Serie A,29,1992,7.5,13,10,7,1,5,5,13,38.5,8,7,1,6,4,17,1,0,0,2021-2022,90.0,48.0,156.0
1,Brenden Aaronson,USA,"MF,FW",Leeds United,Premier League,21,2000,26.4,45,18,16,22,7,15,46,32.6,31,43,3,40,5,50,6,1,0,2022-2023,90.0,17.045454545454547,153.4090909090909
2,Paxten Aaronson,USA,"MF,DF",Eint Frankfurt,Bundesliga,18,2003,1.9,6,5,2,2,2,2,3,66.7,1,2,1,1,0,6,2,0,0,2022-2023,90.0,0.0,284.2105263157895
3,James Abankwah,IRL,DF,Udinese,Serie A,18,2004,0.7,1,1,0,1,0,0,0,0.0,0,4,2,2,0,1,5,0,0,2022-2023,90.0,0.0,128.57142857142858
4,George Abbott,ENG,MF,Tottenham,Premier League,16,2005,0.0,0,0,0,0,0,0,0,0.0,0,0,0,0,1,1,0,0,0,2022-2023,,inf,
5,Yunis Abdelhamid,MAR,DF,Reims,Ligue 1,34,1987,37.0,82,50,47,33,2,39,52,75.0,13,65,27,38,64,146,116,1,0,2022-2023,90.0,155.67567567567568,199.45945945945948
6,Himad Abdelli,ALG,"MF,FW",Angers,Ligue 1,22,1999,23.7,64,38,22,32,10,31,67,46.3,36,30,1,29,28,92,15,0,0,2022-2023,90.0,106.32911392405065,243.03797468354432
7,Salis Abdul Samed,GHA,MF,Lens,Ligue 1,22,2000,32.2,46,26,18,23,5,29,52,55.8,23,38,9,29,36,82,26,0,0,2022-2023,90.0,100.62111801242236,128.57142857142856
8,Laurent Abergel,FRA,MF,Lorient,Ligue 1,29,1993,26.0,92,52,59,30,3,39,92,42.4,53,47,8,39,34,126,39,0,0,2022-2023,90.00000000000001,117.69230769230771,318.4615384615385
9,Oliver Abildgaard,DEN,MF,Hellas Verona,Serie A,26,1996,6.6,10,6,6,3,1,7,16,43.8,9,7,1,6,5,15,17,0,0,2022-2023,90.0,68.18181818181819,136.36363636363637
10,Matthis Abline,FRA,"FW,MF",Auxerre,Ligue 1,19,2003,9.0,4,2,0,3,1,0,5,0.0,5,6,1,5,1,5,1,0,0,2022-2023,90.0,10.0,40.0
11,Matthis Abline,FRA,"FW,MF",Rennes,Ligue 1,19,2003,1.2,1,1,0,0,1,1,1,100.0,0,1,0,1,2,3,1,0,0,2022-2023,90.0,150.0,75.0
12,Abner,BRA,DF,Betis,La Liga,22,2000,6.7,12,9,9,2,1,7,16,43.8,9,8,2,6,8,20,24,0,0,2022-2023,90.0,107.46268656716417,161.19402985074626
13,Zakaria Aboukhlal,MAR,"FW,MF",Toulouse,Ligue 1,22,2000,27.5,33,23,13,9,11,14,45,31.1,31,18,1,17,22,55,23,0,0,2022-2023,89.99999999999999,72.0,107.99999999999999
14,Tammy Abraham,ENG,FW,Roma,Serie A,24,1997,24.3,17,10,4,8,5,3,16,18.8,13,10,4,6,3,20,14,0,0,2022-2023,90.0,11.11111111111111,62.96296296296296
15,Christian Acella,ITA,MF,Cremonese,Serie A,20,2002,0.2,1,0,1,0,0,0,2,0.0,2,0,0,0,0,1,0,0,0,2022-2023,90.0,0.0,450.0
16,Francesco Acerbi,ITA,DF,Inter,Serie A,34,1988,26.9,33,19,22,7,4,20,27,74.1,7,25,18,7,41,74,85,2,0,2022-2023,90.0,137.17472118959108,110.40892193308551
17,Álvaro Aceves,ESP,GK,Valladolid,La Liga,19,2003,0.1,0,0,0,0,0,0,0,0.0,0,0,0,0,0,0,0,0,0,2022-2023,90.0,0.0,0.0
18,Mohamed Achi,FRA,FW,Nantes,Ligue 1,20,2002,0.4,1,1,1,0,0,1,1,100.0,0,0,0,0,0,1,0,0,0,2022-2023,90.0,0.0,225.0
19,Marcos Acuña,ARG,DF,Sevilla,La Liga,30,1991,21.2,57,36,34,17,6,30,42,71.4,12,16,5,11,23,80,36,0,0,2022-2023,90.0,97.64150943396227,241.98113207547172
20,Che Adams,SCO,FW,Southampton,Premier League,26,1996,22.1,17,13,7,8,2,7,12,58.3,5,13,4,9,4,21,22,0,0,2022-2023,90.0,16.289592760180994,69.23076923076923
21,Tyler Adams,USA,MF,Leeds United,Premier League,23,1999,24.0,89,46,44,35,10,50,77,64.9,27,48,8,40,35,124,29,0,0,2022-2023,90.0,131.25,333.75
22,Sargis Adamyan,ARM,"FW,MF",Köln,Bundesliga,29,1993,7.2,14,7,5,3,6,7,17,41.2,10,12,0,12,4,18,5,0,0,2022-2023,90.0,50.0,175.0
23,Tosin Adarabioyo,ENG,DF,Fulham,Premier League,24,1997,23.2,30,13,22,6,2,16,23,69.6,7,20,15,5,26,56,140,1,0,2022-2023,90.0,100.86206896551724,116.37931034482759
24,Martin Adeline,FRA,"MF,FW",Reims,Ligue 1,18,2003,1.2,3,3,2,1,0,3,4,75.0,1,3,1,2,3,6,3,0,0,2022-2023,90.0,225.00000000000003,225.00000000000003
25,Karim Adeyemi,GER,"FW,MF",Dortmund,Bundesliga,20,2002,15.4,16,11,6,6,4,8,30,26.7,22,18,1,17,7,23,3,0,0,2022-2023,90.0,40.909090909090914,93.50649350649351
Rk,Player,Nation,Pos,Squad,Comp,0,0,90.0,0,0,3,3,3,Tkl,0,0.0,0,0,0,0,0,0,0,0,0,2022-2023,90.0,0.0,0.0
26,Amine Adli,MAR,"FW,MF",Leverkusen,Bundesliga,22,2000,15.9,18,10,4,6,8,5,17,29.4,12,28,2,26,6,24,7,0,0,2022-2023,90.0,33.9622641509434,101.88679245283019
27,Yacine Adli,FRA,"MF,FW",Milan,Serie A,22,2000,1.6,6,3,2,4,0,2,2,100.0,0,2,0,2,1,7,1,0,0,2022-2023,90.0,56.25,337.5
28,Michel Aebischer,SUI,"FW,MF",Bologna,Serie A,25,1997,17.1,12,6,3,6,3,2,18,11.1,16,14,2,12,7,19,9,0,0,2022-2023,90.0,36.8421052631579,63.1578947368421
29,Felix Afena-Gyan,GHA,"FW,MF",Cremonese,Serie A,19,2003,9.1,7,3,4,1,2,2,10,20.0,8,5,1,4,1,8,6,0,0,2022-2023,90.0,9.89010989010989,69.23076923076923
30,Emmanuel Agbadou,CIV,DF,Reims,Ligue 1,25,1997,26.5,71,49,53,16,2,42,65,64.6,23,30,14,16,32,103,107,3,0,2022-2023,90.0,108.67924528301886,241.1320754716981
31,Julen Agirrezabala,ESP,GK,Athletic Club,La Liga,21,2000,7.5,0,0,0,0,0,0,0,0.0,0,0,0,0,0,0,2,0,0,2022-2023,90.0,0.0,0.0
32,Lucien Agoume,FRA,MF,Troyes,Ligue 1,20,2002,12.2,42,25,18,15,9,17,33,51.5,16,14,5,9,27,69,24,0,0,2022-2023,90.0,199.1803278688525,309.83606557377055
33,Felix Agu,GER,"DF,FW",Werder Bremen,Bundesliga,22,1999,0.5,1,0,0,1,0,0,0,0.0,0,1,1,0,0,1,0,0,0,2022-2023,90.0,0.0,180.0
34,Álvaro Aguado,ESP,MF,Valladolid,La Liga,26,1996,21.0,27,15,13,11,3,15,25,60.0,10,16,4,12,13,40,15,0,0,2022-2023,90.0,55.714285714285715,115.71428571428571
35,Kevin Agudelo,COL,"MF,FW",Spezia,Serie A,23,1998,23.7,71,38,22,30,19,25,59,42.4,34,39,5,34,10,81,6,0,0,2022-2023,90.0,37.9746835443038,269.62025316455697
36,Nayef Aguerd,MAR,DF,West Ham,Premier League,26,1996,17.7,27,18,18,8,1,13,20,65.0,7,26,24,2,18,45,79,2,0,2022-2023,90.0,91.52542372881356,137.28813559322035
37,Ruben Aguilar,FRA,DF,Monaco,Ligue 1,29,1993,13.0,19,9,7,7,5,8,22,36.4,14,13,1,12,18,37,28,1,0,2022-2023,90.00000000000001,124.61538461538463,131.53846153846155
38,Naouirou Ahamada,FRA,"MF,FW",Crystal Palace,Premier League,20,2002,1.0,3,2,3,0,0,1,3,33.3,2,2,0,2,0,3,0,0,0,2022-2023,90.0,0.0,270.0
39,Naouirou Ahamada,FRA,MF,Stuttgart,Bundesliga,20,2002,15.5,17,11,7,7,3,8,20,40.0,12,16,5,11,8,25,7,0,0,2022-2023,90.0,46.45161290322581,98.70967741935483
40,Amar Ahmed,SWE,FW,Troyes,Ligue 1,18,2004,0.2,1,1,0,1,0,0,1,0.0,1,0,0,0,1,2,0,0,0,2022-2023,90.0,450.0,450.0
41,Jean-Eudes Aholou,CIV,MF,Strasbourg,Ligue 1,28,1994,14.4,34,20,10,20,4,12,31,38.7,19,25,0,25,24,58,15,0,0,2022-2023,90.0,150.0,212.5
42,Joseph Aidoo,GHA,DF,Celta Vigo,La Liga,26,1995,34.7,51,36,33,17,1,16,28,57.1,12,26,14,12,31,82,150,0,0,2022-2023,90.0,80.40345821325647,132.27665706051872
43,Ola Aina,NGA,DF,Torino,Serie A,25,1996,9.7,17,13,5,8,4,9,15,60.0,6,12,2,10,11,28,26,0,0,2022-2023,90.0,102.0618556701031,157.73195876288662
44,Rayan Aït-Nouri,ALG,DF,Wolves,Premier League,21,2001,12.0,33,20,25,7,1,9,16,56.3,7,3,0,3,9,42,28,0,0,2022-2023,90.0,67.5,247.5
45,Emanuel Aiwum,AUT,DF,Cremonese,Serie A,21,2000,18.4,55,34,36,17,2,33,47,70.2,14,28,16,12,25,80,52,3,0,2022-2023,90.0,122.28260869565219,269.0217391304348
46,Kristoffer Ajer,NOR,DF,Brentford,Premier League,24,1998,8.5,11,8,5,4,2,9,16,56.3,7,6,5,1,7,18,22,0,0,2022-2023,90.0,74.11764705882354,116.47058823529412
47,Ludovic Ajorque,FRA,FW,Strasbourg,Ligue 1,28,1994,8.6,5,4,1,4,0,3,9,33.3,6,3,1,2,2,7,7,0,0,2022-2023,90.0,20.930232558139537,52.32558139534884
48,Ludovic Ajorque,FRA,"FW,MF",Mainz 05,Bundesliga,28,1994,13.5,6,5,1,4,1,1,9,11.1,8,8,2,6,1,7,8,0,0,2022-2023,90.0,6.666666666666667,40.0
49,Manuel Akanji,SUI,DF,Manchester City,Premier League,27,1995,25.4,36,25,15,18,3,23,36,63.9,13,27,9,18,16,52,33,1,0,2022-2023,90.0,56.69291338582678,127.55905511811024
50,Nathan Aké,NED,DF,Manchester City,Premier League,27,1995,20.8,26,12,15,9,2,11,15,73.3,4,20,10,10,20,46,48,0,0,2022-2023,90.0,86.53846153846153,112.49999999999999
Rk,Player,Nation,Pos,Squad,Comp,0,0,90.0,0,0,3,3,3,Tkl,0,0.0,0,0,0,0,0,0,0,0,0,2022-2023,90.0,0.0,0.0
51,Sergio Akieme,ESP,DF,Almería,La Liga,24,1997,25.5,27,16,19,6,2,12,22,54.5,10,22,6,16,14,41,41,0,0,2022-2023,90.0,49.411764705882355,95.29411764705883
52,Babatunde Akinsola,NGA,FW,Valladolid,La Liga,19,2003,0.1,1,1,0,0,1,0,0,0.0,0,0,0,0,0,1,0,0,0,2022-2023,90.0,0.0,900.0
53,Maghnes Akliouche,FRA,"MF,FW",Monaco,Ligue 1,20,2002,4.5,7,4,4,3,0,2,8,25.0,6,2,0,2,3,10,2,0,0,2022-2023,90.0,60.0,140.0
54,Paul Akouokou,CIV,"MF,DF",Betis,La Liga,24,1997,5.0,16,9,13,3,0,13,20,65.0,7,2,2,0,12,28,17,1,0,2022-2023,90.0,216.0,288.0
55,Jean-Daniel Akpa-Akpro,CIV,"MF,FW",Empoli,Serie A,29,1992,15.1,53,37,25,19,9,23,42,54.8,19,35,4,31,13,66,27,0,0,2022-2023,90.0,77.48344370860927,315.89403973509934
56,Kevin Akpoguma,NGA,DF,Hoffenheim,Bundesliga,27,1995,21.7,75,44,45,27,3,32,45,71.1,13,45,16,29,24,99,70,1,0,2022-2023,90.0,99.53917050691244,311.0599078341014
57,David Alaba,AUT,DF,Real Madrid,La Liga,30,1992,20.4,15,11,8,4,3,9,15,60.0,6,18,9,9,14,29,37,1,0,2022-2023,90.0,61.76470588235294,66.1764705882353
58,Ángel Alarcón,ESP,FW,Barcelona,La Liga,18,2004,0.3,0,0,0,0,0,,0,0.0,0,0,0,0,0,0,0,0,0,2022-2023,90.0,0.0,0.0
59,Tomás Alarcón,CHI,MF,Cádiz,La Liga,23,1999,2.5,3,2,0,2,1,1,2,50.0,1,1,0,1,2,5,2,0,0,2022-2023,90.0,72.0,108.0
60,Lucas Alario,ARG,"FW,MF",Eint Frankfurt,Bundesliga,29,1992,3.7,3,2,1,0,2,0,1,0.0,1,0,0,0,2,5,13,0,0,2022-2023,90.0,48.648648648648646,72.97297297297297
61,Jordi Alba,ESP,DF,Barcelona,La Liga,33,1989,15.8,25,18,13,11,1,12,28,42.9,16,12,5,7,11,36,23,0,0,2022-2023,90.0,62.658227848101255,142.40506329113921
62,Luis Alberto,ESP,MF,Lazio,Serie A,29,1992,27.1,49,29,18,20,11,23,72,31.9,49,35,6,29,9,58,4,0,0,2022-2023,90.0,29.88929889298893,162.73062730627308
63,Raúl Albiol,ESP,DF,Villarreal,La Liga,36,1985,23.5,25,17,17,6,2,14,18,77.8,4,17,13,4,14,39,111,0,0,2022-2023,90.0,53.61702127659574,95.74468085106382
64,Marc Albrighton,ENG,"FW,MF",Leicester City,Premier League,32,1989,2.6,4,1,0,2,2,1,8,12.5,7,6,2,4,1,5,5,0,0,2022-2023,90.0,34.61538461538461,138.46153846153845
65,Thiago Alcántara,ESP,MF,Liverpool,Premier League,31,1991,13.9,43,24,20,21,2,14,23,60.9,9,15,3,12,21,64,13,2,0,2022-2023,90.0,135.97122302158274,278.41726618705036
66,Carlos Alcaraz,ARG,"MF,FW",Southampton,Premier League,19,2002,11.4,10,5,2,7,1,6,22,27.3,16,14,5,9,1,11,11,0,0,2022-2023,90.0,7.894736842105263,78.94736842105263
67,Rubén Alcaraz,ESP,MF,Cádiz,La Liga,31,1991,22.7,43,31,24,18,1,19,54,35.2,35,23,8,15,19,62,37,0,0,2022-2023,89.99999999999999,75.33039647577093,170.48458149779734
68,Omar Alderete,PAR,DF,Getafe,La Liga,25,1996,22.7,35,20,21,14,0,28,40,70.0,12,23,16,7,26,61,85,0,0,2022-2023,89.99999999999999,103.08370044052863,138.76651982378854
69,Iván Alejo,ESP,"MF,FW",Cádiz,La Liga,27,1995,14.6,32,21,19,9,4,17,37,45.9,20,18,3,15,5,37,12,1,0,2022-2023,90.0,30.82191780821918,197.26027397260276
70,Doğan Alemdar,TUR,GK,Rennes,Ligue 1,19,2002,4.5,0,0,0,0,0,0,0,0.0,0,0,0,0,0,0,1,1,0,2022-2023,90.0,0.0,0.0
71,Carles Aleñá,ESP,"MF,FW",Getafe,La Liga,24,1998,23.5,18,10,7,5,6,5,34,14.7,29,19,1,18,4,22,18,0,0,2022-2023,90.0,15.319148936170212,68.93617021276596
72,Trent Alexander-Arnold,ENG,DF,Liverpool,Premier League,23,1998,32.5,57,40,32,16,9,42,80,52.5,38,25,7,18,43,100,41,2,0,2022-2023,90.0,119.07692307692308,157.84615384615384
73,Alejandro Alfaro,ESP,MF,Elche,La Liga,20,2002,0.2,0,0,0,0,0,0,0,0.0,0,0,0,0,0,0,0,0,0,2022-2023,90.0,0.0,0.0
74,Ángel Algobia,ESP,MF,Getafe,La Liga,23,1999,12.6,27,13,14,13,0,22,48,45.8,26,15,5,10,3,30,11,0,0,2022-2023,90.0,21.42857142857143,192.8571428571429
75,Mohamed Ali Cho,FRA,"FW,MF",Real Sociedad,La Liga,18,2004,6.5,13,10,6,5,2,4,10,40.0,6,9,0,9,2,15,2,0,0,2022-2023,90.00000000000001,27.692307692307693,180.00000000000003
Rk,Player,Nation,Pos,Squad,Comp,0,0,90.0,0,0,3,3,3,Tkl,0,0.0,0,0,0,0,0,0,0,0,0,2022-2023,90.0,0.0,0.0
76,Faride Alidou,GER,"DF,MF",Eint Frankfurt,Bundesliga,21,2001,2.0,8,5,3,4,1,3,9,33.3,6,3,0,3,1,9,3,0,0,2022-2023,90.0,45.0,360.0
77,Alisson,BRA,GK,Liverpool,Premier League,29,1992,37.0,0,0,0,0,0,0,3,0.0,3,3,0,3,0,0,20,0,0,2022-2023,90.0,0.0,0.0
78,Jim Allevinah,GAB,"DF,FW",Clermont Foot,Ligue 1,27,1995,24.9,39,24,24,11,4,19,62,30.6,43,24,2,22,24,63,26,1,0,2022-2023,90.0,86.74698795180723,140.96385542168673
79,Dele Alli,ENG,MF,Everton,Premier League,26,1996,0.4,0,0,0,0,0,0,0,0.0,0,0,0,0,0,0,0,0,0,2022-2023,90.0,0.0,0.0
80,Domingos André Ribeiro Almeida,POR,MF,Valencia,La Liga,22,2000,28.2,66,42,23,32,11,26,57,45.6,31,26,0,26,20,86,16,1,0,2022-2023,89.99999999999999,63.82978723404255,210.63829787234042
81,Miguel Almirón,PAR,FW,Newcastle Utd,Premier League,28,1994,27.7,46,30,16,19,11,18,42,42.9,24,25,2,23,10,56,17,0,0,2022-2023,90.0,32.49097472924188,149.45848375451266
82,Marcos Alonso,ESP,DF,Barcelona,La Liga,31,1990,13.0,15,10,10,5,0,9,12,75.0,3,14,10,4,11,26,32,0,0,2022-2023,90.00000000000001,76.15384615384616,103.84615384615385
83,Mickaël Alphonse,GLP,DF,Ajaccio,Ligue 1,33,1989,15.1,35,23,20,11,4,20,33,60.6,13,17,5,12,35,70,44,1,0,2022-2023,90.0,208.60927152317882,208.60927152317882
84,Éder Álvarez Balanta,COL,"MF,FW",Schalke 04,Bundesliga,29,1993,2.6,5,4,2,3,0,2,6,33.3,4,0,0,0,3,8,4,0,0,2022-2023,90.0,103.84615384615384,173.07692307692307
85,Carlos Álvarez,ESP,MF,Sevilla,La Liga,18,2003,0.1,1,1,0,1,0,0,0,0.0,0,0,0,0,0,1,0,0,0,2022-2023,90.0,0.0,900.0
86,Gastón Álvarez,URU,DF,Getafe,La Liga,22,2000,16.7,38,30,24,9,5,23,42,54.8,19,15,5,10,15,53,35,0,0,2022-2023,90.0,80.83832335329342,204.79041916167665
87,Julián Álvarez,ARG,"FW,MF",Manchester City,Premier League,22,2000,16.3,26,16,3,13,10,9,30,30.0,21,13,0,13,2,28,6,0,0,2022-2023,90.0,11.042944785276074,143.55828220858896
88,Agustín Álvarez Martínez,URU,"FW,MF",Sassuolo,Serie A,21,2001,4.1,6,3,0,5,1,1,4,25.0,3,5,1,4,3,9,3,0,0,2022-2023,90.0,65.85365853658537,131.70731707317074
89,Yeray Álvarez,ESP,DF,Athletic Club,La Liga,27,1995,25.9,34,23,26,7,1,24,31,77.4,7,23,13,10,48,82,101,0,0,2022-2023,90.0,166.79536679536682,118.14671814671816
90,Ibrahim Amadou,FRA,"DF,MF",Angers,Ligue 1,29,1993,4.7,10,7,6,3,1,7,11,63.6,4,7,3,4,10,20,20,0,0,2022-2023,90.0,191.48936170212764,191.48936170212764
91,Selim Amallah,MAR,"MF,FW",Valladolid,La Liga,25,1996,3.0,15,9,7,8,0,5,8,62.5,3,2,0,2,5,20,2,0,0,2022-2023,90.0,150.0,450.0
92,Daniel Amartey,GHA,DF,Leicester City,Premier League,27,1994,17.9,19,8,13,5,1,12,14,85.7,2,24,17,7,8,27,71,0,0,2022-2023,90.0,40.22346368715084,95.53072625698326
93,Amath,SEN,"MF,FW",Mallorca,La Liga,26,1996,13.6,29,19,14,8,7,14,22,63.6,8,13,1,12,5,34,5,0,0,2022-2023,90.0,33.088235294117645,191.91176470588235
94,Jordan Amavi,FRA,DF,Getafe,La Liga,28,1994,2.2,3,2,3,0,0,1,3,33.3,2,3,0,3,4,7,7,0,0,2022-2023,90.0,163.63636363636363,122.72727272727272
95,Lukáš Ambros,CZE,MF,Wolfsburg,Bundesliga,18,2004,0.2,1,0,1,0,0,1,4,25.0,3,1,0,1,0,1,2,1,0,2022-2023,90.0,0.0,450.0
96,Kelvin Amian,FRA,DF,Spezia,Serie A,24,1998,26.4,54,32,33,12,9,24,31,77.4,7,34,12,22,22,76,87,1,0,2022-2023,90.0,75.0,184.0909090909091
97,Bruno Amione,ARG,DF,Hellas Verona,Serie A,20,2002,0.6,1,1,1,0,0,1,2,50.0,1,1,0,1,0,1,4,0,0,2022-2023,90.0,0.0,150.0
98,Bruno Amione,ARG,DF,Sampdoria,Serie A,20,2002,23.2,50,33,36,14,0,19,43,44.2,24,26,11,15,25,75,62,1,0,2022-2023,90.0,96.98275862068965,193.9655172413793
99,Nadiem Amiri,GER,"MF,FW",Leverkusen,Bundesliga,25,1996,10.9,15,6,5,8,2,9,20,45.0,11,12,1,11,6,21,10,2,0,2022-2023,90.0,49.54128440366972,123.8532110091743
100,Samuel Amo-Ameyaw,ENG,MF,Southampton,Premier League,16,2006,0.0,0,0,0,0,0,0,1,0.0,1,0,0,0,0,0,0,0,0,2022-2023,,,
Rk,Player,Nation,Pos,Squad,Comp,0,0,90.0,0,0,3,3,3,Tkl,0,0.0,0,0,0,0,0,0,0,0,0,2022-2023,90.0,0.0,0.0
101,Ethan Ampadu,WAL,"DF,MF",Spezia,Serie A,21,2000,29.3,66,37,33,28,5,17,41,41.5,24,48,23,25,36,102,98,0,0,2022-2023,90.0,110.580204778157,202.73037542662118
102,Sofyan Amrabat,MAR,MF,Fiorentina,Serie A,25,1996,22.2,39,24,15,17,7,16,29,55.2,13,23,5,18,21,60,18,2,0,2022-2023,90.0,85.13513513513514,158.10810810810813
103,Ayoub Amraoui,MAR,"DF,FW",Nice,Ligue 1,18,2004,3.3,6,5,3,3,0,2,5,40.0,3,1,0,1,4,10,4,0,0,2022-2023,90.0,109.0909090909091,163.63636363636363
104,Joachim Andersen,DEN,DF,Crystal Palace,Premier League,26,1996,30.9,42,22,30,12,0,16,32,50.0,16,28,13,15,24,66,188,1,0,2022-2023,90.0,69.90291262135922,122.33009708737865
105,Elliot Anderson,SCO,"MF,FW",Newcastle Utd,Premier League,19,2002,4.6,11,5,5,3,3,6,12,50.0,6,11,2,9,6,17,2,0,0,2022-2023,90.0,117.3913043478261,215.21739130434784
106,Felipe Anderson,BRA,FW,Lazio,Serie A,29,1993,32.9,80,50,31,41,8,31,88,35.2,57,58,6,52,31,111,27,0,0,2022-2023,90.0,84.80243161094225,218.84498480243164
107,Benjamin André,FRA,MF,Lille,Ligue 1,31,1990,32.4,128,74,51,60,17,65,121,53.7,56,50,8,42,47,175,60,0,0,2022-2023,90.0,130.55555555555557,355.55555555555554
108,Marcos André,BRA,"FW,MF",Valencia,La Liga,25,1996,5.0,4,1,1,1,2,1,2,50.0,1,4,1,3,0,4,0,0,0,2022-2023,90.0,0.0,72.0
109,Komnen Andrić,SRB,FW,Clermont Foot,Ligue 1,27,1995,16.1,13,5,2,7,4,2,15,13.3,13,8,1,7,8,21,13,0,0,2022-2023,90.0,44.72049689440993,72.67080745341615
110,Robert Andrich,GER,MF,Leverkusen,Bundesliga,27,1994,26.7,61,38,30,27,4,26,45,57.8,19,27,9,18,42,103,55,2,0,2022-2023,90.00000000000001,141.5730337078652,205.6179775280899
111,Angeliño,ESP,DF,Hoffenheim,Bundesliga,25,1997,29.1,40,24,19,18,3,23,37,62.2,14,32,6,26,25,65,67,0,0,2022-2023,90.0,77.31958762886597,123.71134020618555
112,Fabrizio Angileri,ARG,DF,Getafe,La Liga,28,1994,6.5,12,9,8,3,1,10,17,58.8,7,8,3,5,7,19,10,0,0,2022-2023,90.00000000000001,96.92307692307693,166.15384615384616
113,Jaidon Anthony,ENG,"MF,FW",Bournemouth,Premier League,22,1999,14.0,30,17,15,9,6,8,24,33.3,16,30,3,27,10,40,19,0,0,2022-2023,90.0,64.28571428571428,192.85714285714286
114,Janis Antiste,FRA,FW,Sassuolo,Serie A,19,2002,0.6,1,0,1,0,0,1,1,100.0,0,0,0,0,0,1,0,0,0,2022-2023,90.0,0.0,150.0
115,Waldemar Anton,GER,DF,Stuttgart,Bundesliga,26,1996,32.6,49,27,27,19,3,27,51,52.9,24,44,16,28,38,87,123,2,0,2022-2023,90.0,104.9079754601227,135.2760736196319
116,Josep Antoni Gayá,ESP,"DF,MF",Mallorca,La Liga,22,2000,1.1,0,0,0,0,0,0,0,0.0,0,4,2,2,1,1,6,0,0,2022-2023,90.0,81.81818181818181,0.0
117,José Antonio,ESP,"MF,DF",Cádiz,La Liga,18,2004,0.5,2,1,0,0,2,0,0,0.0,0,0,0,0,0,2,0,0,0,2022-2023,90.0,0.0,360.0
118,Marcos Antônio,BRA,MF,Lazio,Serie A,22,2000,6.6,9,6,4,5,0,9,20,45.0,11,7,2,5,11,20,18,0,0,2022-2023,90.0,150.0,122.72727272727273
119,Michail Antonio,JAM,FW,West Ham,Premier League,32,1990,20.3,14,7,1,8,5,3,12,25.0,9,13,5,8,5,19,9,0,0,2022-2023,90.0,22.167487684729064,62.068965517241374
120,Antony,BRA,FW,Manchester Utd,Premier League,22,2000,20.0,22,9,9,9,4,8,28,28.6,20,18,0,18,11,33,6,0,0,2022-2023,90.0,49.5,99.0
121,Valentin Antov,BUL,DF,Monza,Serie A,21,2000,3.4,6,5,3,3,0,1,5,20.0,4,5,4,1,4,10,14,1,0,2022-2023,90.0,105.88235294117646,158.8235294117647
122,Christopher Antwi-Adjei,GHA,"FW,MF",Bochum,Bundesliga,28,1994,22.0,23,15,7,8,8,10,29,34.5,19,17,0,17,5,28,16,0,0,2022-2023,90.0,20.454545454545457,94.0909090909091
123,Anuar,MAR,"MF,FW",Valladolid,La Liga,27,1995,2.3,4,4,0,1,3,0,0,0.0,0,5,2,3,3,7,3,0,0,2022-2023,90.0,117.3913043478261,156.52173913043478
124,Houssem Aouar,ALG,MF,Lyon,Ligue 1,24,1998,5.8,12,5,5,5,2,3,9,33.3,6,12,2,10,8,20,3,0,0,2022-2023,90.0,124.13793103448276,186.20689655172413
125,Adil Aouchiche,FRA,MF,Lorient,Ligue 1,20,2002,2.8,5,2,3,1,1,1,9,11.1,8,1,0,1,4,9,1,0,0,2022-2023,90.0,128.57142857142858,160.71428571428572
Rk,Player,Nation,Pos,Squad,Comp,0,0,90.0,0,0,3,3,3,Tkl,0,0.0,0,0,0,0,0,0,0,0,0,2022-2023,90.0,0.0,0.0
126,Dennis Appiah,FRA,"DF,MF",Nantes,Ligue 1,30,1992,8.8,21,11,14,7,0,10,27,37.0,17,13,5,8,10,31,16,0,0,2022-2023,90.0,102.27272727272727,214.77272727272725
127,Stredair Appuah,FRA,"DF,MF",Nantes,Ligue 1,18,2004,0.7,2,1,0,2,0,0,0,0.0,0,2,0,2,1,3,0,0,0,2022-2023,90.0,128.57142857142858,257.14285714285717
128,Mauro Arambarri,URU,MF,Getafe,La Liga,26,1995,11.0,14,6,9,4,1,3,17,17.6,14,17,5,12,14,28,19,0,0,2022-2023,90.0,114.54545454545455,114.54545454545455
129,Charles Aránguiz,CHI,MF,Leverkusen,Bundesliga,33,1989,5.5,17,7,7,10,0,12,20,60.0,8,4,0,4,7,24,4,0,0,2022-2023,90.0,114.54545454545455,278.1818181818182
130,Ronald Araújo,URU,DF,Barcelona,La Liga,23,1999,20.0,26,18,12,13,1,6,9,66.7,3,15,7,8,12,38,41,1,0,2022-2023,90.0,54.0,117.0
131,Cameron Archer,ENG,"FW,MF",Aston Villa,Premier League,21,2001,0.5,0,0,0,0,0,0,0,0.0,0,0,0,0,0,0,0,0,0,2022-2023,90.0,0.0,0.0
132,Taïryk Arconte,FRA,FW,Brest,Ligue 1,18,2003,1.4,1,1,0,0,1,0,3,0.0,3,1,0,1,0,1,2,0,0,2022-2023,90.0,0.0,64.28571428571429
133,Alphonse Areola,FRA,GK,West Ham,Premier League,29,1993,3.4,0,0,0,0,0,0,0,0.0,0,0,0,0,0,0,0,0,0,2022-2023,90.0,0.0,0.0
134,Adu Ares,ESP,"FW,MF",Athletic Club,La Liga,20,2001,0.9,4,2,2,1,1,4,4,100.0,0,1,0,1,2,6,1,0,0,2022-2023,90.0,200.0,400.0
135,Joe Aribo,NGA,"MF,FW",Southampton,Premier League,26,1996,13.6,31,20,15,12,4,11,20,55.0,9,14,1,13,10,41,11,0,0,2022-2023,90.0,66.17647058823529,205.14705882352942
136,Adam Armstrong,ENG,"FW,MF",Southampton,Premier League,25,1997,14.8,14,9,6,5,3,3,10,30.0,7,15,3,12,5,19,6,0,0,2022-2023,90.0,30.405405405405403,85.13513513513513
137,Stuart Armstrong,SCO,"MF,FW",Southampton,Premier League,30,1992,15.6,32,21,15,13,4,14,39,35.9,25,18,0,18,10,42,9,2,0,2022-2023,90.0,57.69230769230769,184.6153846153846
138,Marko Arnautović,AUT,FW,Bologna,Serie A,33,1989,17.0,9,6,2,5,2,1,6,16.7,5,11,1,10,2,11,10,0,0,2022-2023,90.0,10.588235294117647,47.64705882352941
139,Maximilian Arnold,GER,MF,Wolfsburg,Bundesliga,28,1994,30.7,62,31,25,28,9,28,54,51.9,26,34,11,23,26,88,65,2,0,2022-2023,90.0,76.22149837133551,181.75895765472313
140,Mohamed El Arouch,FRA,MF,Lyon,Ligue 1,18,2004,0.0,1,1,1,0,0,0,0,0.0,0,0,0,0,0,1,0,0,0,2022-2023,,,inf
141,Sergio Arribas,ESP,"MF,FW",Real Madrid,La Liga,20,2001,0.2,0,0,0,0,0,0,0,0.0,0,1,0,1,0,0,0,0,0,2022-2023,90.0,0.0,0.0
142,Kepa Arrizabalaga,ESP,GK,Chelsea,Premier League,27,1994,28.5,2,2,2,0,0,2,3,66.7,1,0,0,0,1,3,16,2,0,2022-2023,90.0,3.1578947368421053,6.315789473684211
143,Roberto Arroyo,ESP,MF,Valladolid,La Liga,18,2003,0.2,1,1,0,1,0,1,1,100.0,0,0,0,0,0,1,0,0,0,2022-2023,90.0,0.0,450.0
144,Tolgay Arslan,GER,MF,Udinese,Serie A,31,1990,13.5,29,18,13,15,1,14,39,35.9,25,19,0,19,12,41,9,1,0,2022-2023,90.0,80.0,193.33333333333334
145,Ricard Artero,ESP,"MF,FW",Girona,La Liga,19,2003,1.5,3,3,2,1,0,1,1,100.0,0,2,0,2,1,4,3,0,0,2022-2023,90.0,60.0,180.0
146,Santiago Arzamendia,PAR,"DF,MF",Cádiz,La Liga,24,1998,5.4,9,8,7,1,1,6,21,28.6,15,11,1,10,2,11,15,1,0,2022-2023,90.0,33.33333333333333,150.0
147,Takuma Asano,JPN,"FW,MF",Bochum,Bundesliga,27,1994,19.0,14,9,4,4,6,7,16,43.8,9,17,1,16,8,22,8,0,0,2022-2023,90.0,37.89473684210526,66.3157894736842
148,Santiago Ascacíbar,ARG,MF,Cremonese,Serie A,25,1997,8.1,29,14,17,10,2,14,35,40.0,21,14,2,12,13,42,11,0,0,2022-2023,90.0,144.44444444444446,322.22222222222223
149,Sergio Asenjo,ESP,GK,Valladolid,La Liga,33,1989,10.0,0,0,0,0,0,0,0,0.0,0,0,0,0,0,0,10,2,0,2022-2023,90.0,0.0,0.0
150,Marco Asensio,ESP,"FW,MF",Real Madrid,La Liga,26,1996,16.0,16,10,8,6,2,8,19,42.1,11,8,3,5,5,21,4,0,0,2022-2023,90.0,28.125,90.0
Rk,Player,Nation,Pos,Squad,Comp,0,0,90.0,0,0,3,3,3,Tkl,0,0.0,0,0,0,0,0,0,0,0,0,2022-2023,90.0,0.0,0.0
151,Kristoffer Askildsen,NOR,MF,Lecce,Serie A,21,2001,8.1,7,3,2,3,2,4,10,40.0,6,15,4,11,11,18,6,0,0,2022-2023,90.0,122.22222222222223,77.77777777777779
152,Fisnik Asllani,KVX,FW,Hoffenheim,Bundesliga,19,2002,1.9,0,0,0,0,0,0,4,0.0,4,2,0,2,3,3,3,0,0,2022-2023,90.0,142.10526315789474,0.0
153,Kristjan Asllani,ALB,MF,Inter,Serie A,20,2002,6.6,11,5,1,8,2,7,10,70.0,3,3,1,2,6,17,4,0,0,2022-2023,90.0,81.81818181818181,150.0
154,Iago Aspas,ESP,FW,Celta Vigo,La Liga,34,1987,31.9,8,4,0,4,4,3,22,13.6,19,10,1,9,7,15,23,0,0,2022-2023,90.0,19.74921630094044,22.570532915360502
155,Lorenz Assignon,TOG,DF,Rennes,Ligue 1,22,2000,2.9,6,2,4,2,0,2,4,50.0,2,6,0,6,2,8,9,0,0,2022-2023,90.0,62.06896551724138,186.20689655172413
156,Youcef Atal,ALG,"DF,MF",Nice,Ligue 1,26,1996,8.7,38,22,18,15,5,23,32,71.9,9,9,0,9,14,52,13,0,0,2022-2023,90.0,144.82758620689654,393.1034482758621
157,Valentin Atangana Edoa,FRA,MF,Reims,Ligue 1,16,2005,1.9,8,3,4,2,2,3,6,50.0,3,2,1,1,0,8,1,0,0,2022-2023,90.0,0.0,378.9473684210526
158,Pierre-Emerick Aubameyang,GAB,FW,Chelsea,Premier League,33,1989,6.2,1,0,1,0,0,0,1,0.0,1,2,0,2,2,3,4,2,0,2022-2023,90.0,29.032258064516128,14.516129032258064
159,Pierre-Emerick Aubameyang,GAB,FW,Barcelona,La Liga,33,1989,0.1,0,0,0,0,0,0,0,0.0,0,0,0,0,0,0,0,0,0,2022-2023,90.0,0.0,0.0
160,Emil Audero,ITA,GK,Sampdoria,Serie A,25,1997,25.0,0,0,0,0,0,0,2,0.0,2,0,0,0,0,0,7,1,0,2022-2023,90.0,0.0,0.0
161,Tommaso Augello,ITA,DF,Sampdoria,Serie A,27,1994,34.0,17,14,13,2,2,9,20,45.0,11,23,7,16,17,34,61,1,0,2022-2023,90.0,45.0,45.0
162,Ludwig Augustinsson,SWE,DF,Aston Villa,Premier League,28,1994,0.9,1,1,1,0,0,0,0,0.0,0,0,0,0,0,1,1,0,0,2022-2023,90.0,0.0,100.0
163,Ludwig Augustinsson,SWE,DF,Mallorca,La Liga,28,1994,1.5,2,1,2,0,0,1,3,33.3,2,1,0,1,1,3,3,0,0,2022-2023,90.0,60.0,120.0
164,Carlos Augusto,BRA,DF,Monza,Serie A,23,1999,34.3,73,38,42,23,8,33,54,61.1,21,24,6,18,24,97,85,1,0,2022-2023,90.0,62.973760932944614,191.5451895043732
165,Serge Aurier,CIV,DF,Nott'ham Forest,Premier League,29,1992,21.6,64,41,41,18,5,23,33,69.7,10,34,11,23,29,93,75,0,0,2022-2023,90.0,120.83333333333333,266.66666666666663
166,Mathias Autret,FRA,"MF,FW",Auxerre,Ligue 1,31,1991,14.3,22,10,10,10,2,7,16,43.8,9,14,2,12,12,34,13,0,0,2022-2023,90.0,75.52447552447552,138.46153846153845
167,Ezequiel Ávila,ARG,"FW,MF",Osasuna,La Liga,28,1994,19.0,8,5,2,4,2,6,23,26.1,17,12,1,11,8,16,16,0,0,2022-2023,90.0,37.89473684210526,37.89473684210526
168,Cédric Avinel,GLP,DF,Ajaccio,Ligue 1,35,1986,19.9,13,7,8,5,0,8,12,66.7,4,20,13,7,15,28,91,1,0,2022-2023,90.0,67.8391959798995,58.79396984924624
169,Taiwo Awoniyi,NGA,FW,Nott'ham Forest,Premier League,24,1997,15.6,17,10,2,10,5,6,12,50.0,6,18,4,14,4,21,20,0,0,2022-2023,90.0,23.076923076923077,98.07692307692308
170,Yasin Ayari,SWE,MF,Brighton,Premier League,18,2003,0.7,2,2,1,1,0,0,4,0.0,4,1,0,1,0,2,0,0,0,2022-2023,90.0,0.0,257.14285714285717
171,Mehmet Aydin,GER,"DF,FW",Schalke 04,Bundesliga,20,2002,6.3,25,18,14,9,2,11,24,45.8,13,11,0,11,10,35,15,0,0,2022-2023,90.0,142.85714285714286,357.14285714285717
172,André Ayew,GHA,"FW,MF",Nott'ham Forest,Premier League,32,1989,3.5,5,3,0,4,1,2,4,50.0,2,6,1,5,0,5,7,0,0,2022-2023,90.0,0.0,128.57142857142856
173,Jordan Ayew,GHA,"FW,MF",Crystal Palace,Premier League,30,1991,30.2,66,41,23,20,23,21,53,39.6,32,35,4,31,15,81,31,0,0,2022-2023,90.0,44.70198675496689,196.6887417218543
174,Kaan Ayhan,TUR,DF,Sassuolo,Serie A,27,1994,6.1,10,4,6,4,0,7,7,100.0,0,5,4,1,5,15,26,1,0,2022-2023,90.0,73.7704918032787,147.5409836065574
175,Luke Ayling,ENG,DF,Leeds United,Premier League,30,1991,22.8,66,37,42,15,9,42,85,49.4,43,34,11,23,26,92,52,2,0,2022-2023,90.0,102.63157894736841,260.52631578947364
Rk,Player,Nation,Pos,Squad,Comp,0,0,90.0,0,0,3,3,3,Tkl,0,0.0,0,0,0,0,0,0,0,0,0,2022-2023,90.0,0.0,0.0
176,Ayman Azhil,MAR,MF,Leverkusen,Bundesliga,21,2001,0.0,0,0,0,0,0,0,0,0.0,0,0,0,0,0,0,0,0,0,2022-2023,,,
177,Sardar Azmoun,IRN,"FW,MF",Leverkusen,Bundesliga,27,1995,10.3,6,3,1,4,1,1,7,14.3,6,4,0,4,2,8,14,0,0,2022-2023,90.0,17.475728155339805,52.42718446601942
178,César Azpilicueta,ESP,DF,Chelsea,Premier League,32,1989,17.0,43,25,23,15,5,22,37,59.5,15,26,5,21,19,62,54,1,0,2022-2023,90.0,100.58823529411765,227.64705882352942
179,Sanoussy Ba,GER,DF,RB Leipzig,Bundesliga,18,2004,0.0,0,0,0,0,0,0,0,0.0,0,0,0,0,0,0,0,0,0,2022-2023,,,
180,Iddrisu Baba,GHA,"MF,DF",Mallorca,La Liga,26,1996,18.9,31,17,15,16,0,15,32,46.9,17,18,8,10,11,42,39,0,0,2022-2023,90.0,52.38095238095238,147.61904761904762
181,Srđan Babić,SRB,DF,Almería,La Liga,26,1996,33.3,28,18,20,8,0,15,32,46.9,17,34,22,12,29,57,124,1,0,2022-2023,90.0,78.37837837837839,75.67567567567568
182,Loïc Bade,FRA,DF,Sevilla,La Liga,22,2000,16.1,27,20,23,3,1,17,30,56.7,13,21,13,8,23,50,77,0,0,2022-2023,90.0,128.57142857142856,150.93167701863354
183,Loïc Bade,FRA,DF,Rennes,Ligue 1,22,2000,1.0,1,1,1,0,0,0,0,0.0,0,0,0,0,1,2,3,0,0,2022-2023,90.0,90.0,90.0
184,Édgar Badía,ESP,GK,Elche,La Liga,30,1992,36.0,1,0,1,0,0,1,2,50.0,1,0,0,0,0,1,19,3,0,2022-2023,90.0,0.0,2.5
185,Benoît Badiashile,FRA,DF,Chelsea,Premier League,21,2001,10.1,14,8,10,4,0,9,14,64.3,5,5,2,3,16,30,34,1,0,2022-2023,90.0,142.5742574257426,124.75247524752476
186,Benoît Badiashile,FRA,DF,Monaco,Ligue 1,21,2001,9.3,10,8,6,4,0,5,10,50.0,5,9,6,3,17,27,40,1,0,2022-2023,90.0,164.51612903225805,96.77419354838709
187,Alex Baena,ESP,"MF,FW",Villarreal,La Liga,21,2001,21.6,30,17,9,15,6,15,45,33.3,30,15,3,12,7,37,16,0,0,2022-2023,90.0,29.166666666666664,124.99999999999999
188,Jaime Báez,URU,DF,Cremonese,Serie A,27,1995,1.1,4,2,3,0,1,3,6,50.0,3,0,0,0,0,4,2,1,0,2022-2023,90.0,0.0,327.27272727272725
189,Leon Bailey,JAM,"FW,MF",Aston Villa,Premier League,24,1997,21.9,14,6,6,7,1,5,20,25.0,15,13,0,13,6,20,12,0,0,2022-2023,90.0,24.657534246575345,57.53424657534247
190,Eric Bailly,CIV,DF,Marseille,Ligue 1,28,1994,6.0,13,10,6,6,1,7,7,100.0,0,15,12,3,12,25,18,1,0,2022-2023,90.0,180.0,195.0
191,Dénys Bain,FRA,DF,Auxerre,Ligue 1,29,1993,1.4,4,3,3,1,0,1,2,50.0,1,2,1,1,2,6,4,0,0,2022-2023,90.0,128.57142857142858,257.14285714285717
192,Brandon Baiye,BEL,MF,Clermont Foot,Ligue 1,21,2000,0.6,3,2,2,1,0,2,3,66.7,1,1,0,1,1,4,3,0,0,2022-2023,90.0,150.0,450.00000000000006
193,Stefan Bajcetic,ESP,MF,Liverpool,Premier League,17,2004,5.8,9,6,5,3,1,8,27,29.6,19,7,0,7,9,18,4,0,0,2022-2023,90.0,139.6551724137931,139.6551724137931
194,Nedim Bajrami,ALB,"MF,FW",Empoli,Serie A,23,1999,10.4,8,4,3,3,2,4,6,66.7,2,5,0,5,7,15,4,0,0,2022-2023,90.0,60.57692307692307,69.23076923076923
195,Nedim Bajrami,ALB,"FW,MF",Sassuolo,Serie A,23,1999,9.1,12,7,6,2,4,5,11,45.5,6,9,1,8,7,19,6,0,0,2022-2023,90.0,69.23076923076923,118.68131868131869
196,Cédric Bakambu,COD,MF,Marseille,Ligue 1,31,1991,0.7,2,1,2,0,0,2,2,100.0,0,0,0,0,0,2,0,0,0,2022-2023,90.0,0.0,257.14285714285717
197,Tiemoué Bakayoko,FRA,MF,Milan,Serie A,27,1994,0.5,5,5,4,1,0,3,3,100.0,0,0,0,0,0,5,0,1,0,2022-2023,90.0,0.0,900.0
198,Mitchel Bakker,NED,"DF,MF",Leverkusen,Bundesliga,22,2000,18.4,16,8,9,7,0,6,15,40.0,9,20,2,18,15,31,20,2,0,2022-2023,90.0,73.36956521739131,78.26086956521739
199,Ridle Baku,GER,"DF,FW",Wolfsburg,Bundesliga,24,1998,28.7,50,26,29,17,4,32,58,55.2,26,44,6,38,21,71,59,0,0,2022-2023,90.0,65.85365853658537,156.794425087108
200,Tommaso Baldanzi,ITA,MF,Empoli,Serie A,19,2003,19.7,25,12,9,13,3,7,32,21.9,25,21,1,20,2,27,5,0,0,2022-2023,90.0,9.137055837563452,114.21319796954315
Rk,Player,Nation,Pos,Squad,Comp,0,0,90.0,0,0,3,3,3,Tkl,0,0.0,0,0,0,0,0,0,0,0,0,2022-2023,90.0,0.0,0.0
201,Alejandro Balde,ESP,DF,Barcelona,La Liga,18,2003,27.5,42,30,22,16,4,24,41,58.5,17,25,3,22,12,54,17,1,0,2022-2023,89.99999999999999,39.272727272727266,137.45454545454544
202,Thierno Balde,FRA,"DF,MF",Troyes,Ligue 1,20,2002,23.9,27,14,19,4,4,18,30,60.0,12,15,3,12,23,50,39,0,0,2022-2023,90.0,86.61087866108787,101.67364016736403
203,Carlos Baleba,CMR,MF,Lille,Ligue 1,18,2004,5.3,13,11,2,9,2,9,14,64.3,5,13,3,10,1,14,3,2,0,2022-2023,90.0,16.9811320754717,220.75471698113208
204,Mikel Balenziaga,ESP,DF,Athletic Club,La Liga,34,1988,1.3,4,4,1,2,1,4,4,100.0,0,0,0,0,1,5,2,0,0,2022-2023,90.0,69.23076923076923,276.9230769230769
205,Leonardo Balerdi,ARG,DF,Marseille,Ligue 1,23,1999,29.3,57,37,43,12,2,32,45,71.1,13,48,29,19,63,120,91,1,0,2022-2023,90.0,193.51535836177476,175.08532423208192
206,Dominic Ballard,ENG,"FW,MF",Southampton,Premier League,17,2005,0.3,0,0,0,0,0,0,0,0.0,0,0,0,0,1,1,0,0,0,2022-2023,90.0,300.0,0.0
207,Iván Balliu,ALB,DF,Rayo Vallecano,La Liga,30,1992,35.9,52,29,26,20,6,18,30,60.0,12,26,3,23,25,77,72,1,0,2022-2023,90.0,62.6740947075209,130.36211699164346
208,Fodé Ballo-Touré,SEN,DF,Milan,Serie A,25,1997,5.8,14,9,7,6,1,7,10,70.0,3,11,3,8,2,16,3,0,0,2022-2023,90.0,31.03448275862069,217.24137931034483
209,Folarin Balogun,USA,FW,Reims,Ligue 1,21,2001,33.3,9,5,1,5,3,2,20,10.0,18,20,1,19,3,12,15,0,0,2022-2023,90.0,8.108108108108109,24.324324324324326
210,Abdoulaye Bamba,CIV,DF,Angers,Ligue 1,32,1990,15.2,22,12,15,5,2,16,19,84.2,3,7,3,4,18,40,38,0,0,2022-2023,90.0,106.57894736842105,130.26315789473685
211,Jonathan Bamba,CIV,FW,Lille,Ligue 1,26,1996,30.9,37,17,12,14,11,14,45,31.1,31,36,1,35,22,59,14,0,0,2022-2023,90.0,64.07766990291262,107.76699029126213
212,Patrick Bamford,ENG,FW,Leeds United,Premier League,28,1993,16.8,9,6,0,6,3,4,20,20.0,16,12,5,7,5,14,13,0,0,2022-2023,90.0,26.785714285714285,48.214285714285715
213,Lameck Banda,ZAM,"FW,MF",Lecce,Serie A,21,2001,18.2,30,20,13,14,3,15,41,36.6,26,24,2,22,8,38,5,0,0,2022-2023,90.0,39.56043956043956,148.35164835164835
214,Filippo Bandinelli,ITA,MF,Empoli,Serie A,27,1995,25.1,55,34,19,26,10,17,45,37.8,28,20,7,13,18,73,40,0,0,2022-2023,90.0,64.5418326693227,197.21115537848604
215,Léo Baptistão,BRA,"FW,MF",Almería,La Liga,29,1992,19.2,32,20,13,16,3,13,33,39.4,20,17,2,15,19,51,12,0,0,2022-2023,90.0,89.0625,150.0
216,Shandon Baptiste,GRN,MF,Brentford,Premier League,24,1998,6.9,15,9,6,6,3,7,17,41.2,10,10,2,8,7,22,10,0,0,2022-2023,90.0,91.30434782608695,195.65217391304347
217,Antonín Barák,CZE,MF,Hellas Verona,Serie A,27,1994,0.3,0,0,0,0,0,0,0,0.0,0,0,0,0,0,0,0,0,0,2022-2023,90.0,0.0,0.0
218,Antonín Barák,CZE,MF,Fiorentina,Serie A,27,1994,20.0,21,9,5,7,9,6,16,37.5,10,16,2,14,3,24,13,0,0,2022-2023,90.0,13.5,94.5
219,Andrea Barberis,ITA,MF,Monza,Serie A,28,1993,3.8,7,2,4,3,0,5,11,45.5,6,0,0,0,8,15,1,0,0,2022-2023,90.0,189.4736842105263,165.78947368421052
220,Tommaso Barbieri,ITA,DF,Juventus,Serie A,19,2002,1.2,3,3,3,0,0,3,8,37.5,5,3,0,3,0,3,2,0,0,2022-2023,90.0,0.0,225.00000000000003
221,Bradley Barcola,FRA,"FW,MF",Lyon,Ligue 1,19,2002,16.0,25,16,8,10,7,8,39,20.5,31,29,0,29,19,44,10,0,0,2022-2023,90.0,106.875,140.625
222,Melvin Bard,FRA,DF,Nice,Ligue 1,21,2000,27.3,96,60,61,29,6,59,89,66.3,30,35,4,31,64,160,40,1,0,2022-2023,90.0,210.98901098901098,316.4835164835165
223,Francesco Bardi,ITA,GK,Bologna,Serie A,30,1992,1.0,0,0,0,0,0,0,0,0.0,0,0,0,0,0,0,0,0,0,2022-2023,90.0,0.0,0.0
224,Keidi Bare,ALB,MF,Espanyol,La Liga,24,1997,5.6,15,8,7,5,3,7,13,53.8,6,8,2,6,11,26,8,0,0,2022-2023,90.0,176.78571428571428,241.07142857142858
225,Nicolò Barella,ITA,MF,Inter,Serie A,25,1997,29.0,49,25,17,26,6,28,53,52.8,25,29,5,24,12,61,12,0,0,2022-2023,90.0,37.241379310344826,152.06896551724137
Rk,Player,Nation,Pos,Squad,Comp,0,0,90.0,0,0,3,3,3,Tkl,0,0.0,0,0,0,0,0,0,0,0,0,2022-2023,90.0,0.0,0.0
226,Kike Barja,ESP,"FW,MF",Osasuna,La Liga,25,1997,14.6,15,9,6,5,4,8,24,33.3,16,7,0,7,4,19,3,0,0,2022-2023,90.0,24.657534246575345,92.46575342465754
227,Ross Barkley,ENG,"MF,FW",Nice,Ligue 1,28,1993,10.7,16,9,7,4,5,7,13,53.8,6,7,2,5,8,24,6,0,0,2022-2023,90.0,67.28971962616824,134.57943925233647
228,Aymen Barkok,MAR,MF,Mainz 05,Bundesliga,24,1998,6.5,18,8,10,5,3,5,10,50.0,5,7,0,7,3,21,9,0,0,2022-2023,90.00000000000001,41.53846153846154,249.23076923076925
229,Harvey Barnes,ENG,"FW,MF",Leicester City,Premier League,24,1997,30.1,26,14,8,14,4,14,42,33.3,28,32,1,31,8,34,12,0,0,2022-2023,90.00000000000001,23.920265780730897,77.74086378737542
230,Leandro Barreiro Martins,LUX,MF,Mainz 05,Bundesliga,22,2000,23.8,60,38,19,28,13,22,49,44.9,27,38,13,25,41,101,39,1,0,2022-2023,90.00000000000001,155.0420168067227,226.89075630252103
231,Enzo Barrenechea,ARG,MF,Juventus,Serie A,21,2001,1.8,8,3,3,4,1,3,5,60.0,2,3,0,3,2,10,3,0,0,2022-2023,90.0,100.0,400.0
232,Ander Barrenetxea,ESP,"FW,DF",Real Sociedad,La Liga,20,2001,9.8,21,15,15,6,0,12,28,42.9,16,15,1,14,5,26,7,0,0,2022-2023,90.0,45.91836734693877,192.85714285714283
233,Mickaël Barreto,FRA,MF,Ajaccio,Ligue 1,31,1991,14.7,32,20,12,17,3,8,45,17.8,37,17,0,17,18,50,11,0,0,2022-2023,90.0,110.20408163265306,195.91836734693877
234,Pablo Barrios,ESP,MF,Atlético Madrid,La Liga,19,2003,8.0,19,10,3,10,6,8,15,53.3,7,12,2,10,9,28,6,1,0,2022-2023,90.0,101.25,213.75
235,Musa Barrow,GAM,"FW,MF",Bologna,Serie A,23,1998,21.8,21,4,10,6,5,8,14,57.1,6,25,1,24,1,22,7,0,0,2022-2023,90.0,4.128440366972477,86.69724770642202
236,Federico Baschirotto,ITA,DF,Lecce,Serie A,25,1996,37.0,40,30,35,5,0,22,36,61.1,14,45,29,16,36,76,192,0,0,2022-2023,90.0,87.56756756756756,97.2972972972973
237,Toma Bašić,CRO,MF,Lazio,Serie A,25,1996,5.7,6,4,4,1,1,3,8,37.5,5,9,0,9,7,13,8,0,0,2022-2023,90.0,110.52631578947367,94.73684210526315
238,Alberto Basso,ITA,MF,Cremonese,Serie A,18,2004,0.2,0,0,0,0,0,0,0,0.0,0,0,0,0,0,0,0,0,0,2022-2023,90.0,0.0,0.0
239,Gil Bastião Dias,POR,FW,Stuttgart,Bundesliga,25,1996,4.4,8,6,3,4,1,3,12,25.0,9,7,0,7,2,10,3,0,0,2022-2023,90.0,40.90909090909091,163.63636363636363
240,Alessandro Bastoni,ITA,DF,Inter,Serie A,23,1999,24.0,41,20,20,14,7,11,27,40.7,16,27,13,14,24,65,45,0,0,2022-2023,90.0,90.0,153.75
241,Simone Bastoni,ITA,"MF,DF",Spezia,Serie A,25,1996,13.2,47,24,23,19,5,15,33,45.5,18,20,5,15,8,55,14,0,0,2022-2023,90.0,54.54545454545455,320.45454545454544
242,Rodrigo Battaglia,ARG,MF,Mallorca,La Liga,31,1991,7.6,12,5,7,5,0,6,14,42.9,8,16,7,9,5,17,18,0,0,2022-2023,90.0,59.21052631578947,142.10526315789474
243,Maximilian Bauer,GER,DF,Augsburg,Bundesliga,22,2000,20.5,31,17,18,12,1,17,34,50.0,17,25,9,16,23,54,79,1,0,2022-2023,90.0,100.97560975609757,136.09756097560975
244,Oliver Baumann,GER,GK,Hoffenheim,Bundesliga,32,1990,34.0,0,0,0,0,0,0,0,0.0,0,0,0,0,0,0,15,1,0,2022-2023,90.0,0.0,0.0
245,Timo Baumgartl,GER,DF,Union Berlin,Bundesliga,26,1996,6.2,11,6,5,4,2,5,18,27.8,13,12,4,8,2,13,14,0,0,2022-2023,90.0,29.032258064516128,159.67741935483872
246,Julian Baumgartlinger,AUT,MF,Augsburg,Bundesliga,34,1988,6.2,15,4,5,6,4,6,19,31.6,13,4,2,2,4,19,15,0,0,2022-2023,90.0,58.064516129032256,217.74193548387098
247,Christoph Baumgartner,AUT,"MF,FW",Hoffenheim,Bundesliga,22,1999,28.5,36,19,12,17,7,9,52,17.3,43,57,5,52,15,51,19,1,0,2022-2023,90.0,47.36842105263158,113.6842105263158
248,Cyrille Bayala,BFA,MF,Ajaccio,Ligue 1,26,1996,22.3,53,37,16,20,17,23,48,47.9,25,20,3,17,25,78,21,0,0,2022-2023,90.0,100.89686098654708,213.9013452914798
249,Brian Bayeye,COD,DF,Torino,Serie A,22,2000,0.7,3,0,3,0,0,1,1,100.0,0,1,1,0,1,4,2,0,0,2022-2023,90.0,128.57142857142858,385.7142857142857
250,Noah Joel Sarenren Bazee,NGA,"MF,FW",Augsburg,Bundesliga,25,1996,0.2,0,0,0,0,0,0,1,0.0,1,1,0,1,0,0,0,0,0,2022-2023,90.0,0.0,0.0
Rk,Player,Nation,Pos,Squad,Comp,0,0,90.0,0,0,3,3,3,Tkl,0,0.0,0,0,0,0,0,0,0,0,0,2022-2023,90.0,0.0,0.0
251,Gavin Bazunu,IRL,GK,Southampton,Premier League,20,2002,32.0,1,0,1,0,0,1,1,100.0,0,0,0,0,1,2,24,2,0,2022-2023,90.0,2.8125,2.8125
252,Bebé,CPV,FW,Rayo Vallecano,La Liga,32,1990,0.7,0,0,0,0,0,0,2,0.0,2,1,0,1,0,0,0,0,0,2022-2023,90.0,0.0,0.0
253,Ihlas Bebou,TOG,"FW,DF",Hoffenheim,Bundesliga,28,1994,15.7,19,16,8,7,4,11,17,64.7,6,9,2,7,7,26,15,0,0,2022-2023,90.0,40.12738853503185,108.9171974522293
254,Rodrigo Becão,BRA,DF,Udinese,Serie A,26,1996,27.6,70,36,50,17,3,40,53,75.5,13,44,24,20,26,96,68,2,0,2022-2023,90.0,84.78260869565217,228.26086956521738
255,Mads Bech Sørensen,DEN,"DF,MF",Brentford,Premier League,23,1999,0.2,0,0,0,0,0,0,0,0.0,0,0,0,0,1,1,1,0,0,2022-2023,90.0,450.0,0.0
256,Julius Beck,DEN,MF,Spezia,Serie A,17,2005,0.1,2,1,1,1,0,0,0,0.0,0,0,0,0,0,2,0,0,0,2022-2023,90.0,0.0,1800.0
257,Sheraldo Becker,SUR,FW,Union Berlin,Bundesliga,27,1995,28.4,15,5,1,7,7,2,11,18.2,9,13,1,12,3,18,7,1,0,2022-2023,90.0,9.507042253521128,47.53521126760564
258,Jan Bednarek,POL,DF,Southampton,Premier League,26,1996,18.6,27,21,20,7,0,12,16,75.0,4,38,27,11,49,76,87,0,0,2022-2023,90.0,237.09677419354836,130.64516129032256
259,Jan Bednarek,POL,DF,Aston Villa,Premier League,26,1996,1.1,3,3,0,3,0,1,1,100.0,0,3,1,2,2,5,5,0,0,2022-2023,90.0,163.63636363636363,245.45454545454544
260,Donny van de Beek,NED,MF,Manchester Utd,Premier League,25,1997,1.9,0,0,0,0,0,0,1,0.0,1,2,1,1,1,1,1,0,0,2022-2023,90.0,47.368421052631575,0.0
261,Asmir Begović,BIH,GK,Everton,Premier League,35,1987,1.0,0,0,0,0,0,0,0,0.0,0,0,0,0,0,0,1,0,0,2022-2023,90.0,0.0,0.0
262,Yanis Begraoui,MAR,"FW,MF",Toulouse,Ligue 1,21,2001,0.7,2,0,1,0,1,1,2,50.0,1,0,0,0,1,3,0,0,0,2022-2023,90.0,128.57142857142858,257.14285714285717
263,Kevin Behrens,GER,FW,Union Berlin,Bundesliga,31,1991,17.1,11,7,4,4,3,4,18,22.2,14,18,3,15,5,16,25,0,0,2022-2023,90.0,26.31578947368421,57.89473684210526
264,Alexis Beka Beka,FRA,"MF,DF",Nice,Ligue 1,21,2001,6.1,16,5,6,9,1,4,15,26.7,11,9,1,8,12,28,6,0,0,2022-2023,90.0,177.04918032786887,236.06557377049182
265,Jérémie Bela,ANG,"DF,MF",Clermont Foot,Ligue 1,29,1993,8.3,6,4,2,1,3,3,4,75.0,1,10,1,9,9,15,8,0,0,2022-2023,90.0,97.59036144578312,65.06024096385542
266,Reda Belahyane,FRA,MF,Nice,Ligue 1,18,2004,2.0,8,6,5,3,0,3,5,60.0,2,5,1,4,2,10,0,0,0,2022-2023,90.0,90.0,360.0
267,Youcef Belaïli,ALG,"MF,FW",Ajaccio,Ligue 1,30,1992,12.8,18,10,3,9,6,8,20,40.0,12,10,1,9,5,23,4,0,0,2022-2023,90.0,35.15625,126.5625
268,Youcef Belaïli,ALG,"FW,MF",Brest,Ligue 1,30,1992,4.0,5,2,3,2,0,2,7,28.6,5,2,0,2,1,6,1,0,0,2022-2023,90.0,22.5,112.5
269,Haris Belkebla,ALG,MF,Brest,Ligue 1,28,1994,29.5,80,48,35,40,5,44,85,51.8,41,32,6,26,52,132,21,3,0,2022-2023,90.0,158.64406779661016,244.0677966101695
270,Stefan Bell,GER,DF,Mainz 05,Bundesliga,30,1991,26.6,43,28,32,10,1,22,44,50.0,22,42,15,27,44,87,133,0,0,2022-2023,90.0,148.8721804511278,145.48872180451127
271,Armel Bella Kotchap,GER,DF,Southampton,Premier League,20,2001,20.9,37,17,28,9,0,15,20,75.0,5,29,12,17,44,81,110,0,0,2022-2023,90.0,189.47368421052633,159.33014354066987
272,Raoul Bellanova,ITA,DF,Inter,Serie A,22,2000,5.5,14,6,11,2,1,9,14,64.3,5,6,1,5,4,18,14,0,0,2022-2023,90.0,65.45454545454545,229.0909090909091
273,Karim Bellarabi,GER,"FW,MF",Leverkusen,Bundesliga,32,1990,0.9,2,0,1,1,0,2,3,66.7,1,0,0,0,0,2,0,0,0,2022-2023,90.0,0.0,200.0
274,Jean-Ricner Bellegarde,FRA,"MF,FW",Strasbourg,Ligue 1,24,1998,26.9,47,25,15,21,11,11,25,44.0,14,26,3,23,26,73,22,0,0,2022-2023,90.0,86.98884758364312,157.24907063197028
275,Héctor Bellerín,ESP,DF,Barcelona,La Liga,27,1995,1.6,2,0,0,2,0,2,3,66.7,1,2,0,2,3,5,2,0,0,2022-2023,90.0,168.75,112.5
Rk,Player,Nation,Pos,Squad,Comp,0,0,90.0,0,0,3,3,3,Tkl,0,0.0,0,0,0,0,0,0,0,0,0,2022-2023,90.0,0.0,0.0
276,Jude Bellingham,ENG,MF,Dortmund,Bundesliga,19,2003,29.9,76,42,28,34,14,34,51,66.7,17,51,4,47,35,111,30,0,0,2022-2023,90.0,105.35117056856188,228.7625418060201
277,Jeanuël Belocian,FRA,DF,Rennes,Ligue 1,17,2005,5.6,10,7,3,5,2,5,9,55.6,4,6,3,3,6,16,11,0,0,2022-2023,90.0,96.42857142857143,160.71428571428572
278,Andrea Belotti,ITA,FW,Roma,Serie A,28,1993,12.7,12,5,3,5,4,5,11,45.5,6,11,1,10,3,15,5,0,0,2022-2023,90.0,21.25984251968504,85.03937007874016
279,Fran Beltrán,ESP,MF,Celta Vigo,La Liga,23,1999,31.7,34,22,15,14,5,14,55,25.5,41,29,5,24,53,87,35,2,0,2022-2023,90.0,150.47318611987382,96.52996845425868
280,Eliesse Ben Seghir,MAR,"FW,MF",Monaco,Ligue 1,17,2005,11.7,18,10,4,12,2,4,12,33.3,8,18,1,17,4,22,1,0,0,2022-2023,89.99999999999999,30.769230769230766,138.46153846153845
281,Salim Ben Seghir,FRA,MF,Marseille,Ligue 1,19,2003,0.0,0,0,0,0,0,0,0,0.0,0,1,0,1,0,0,0,0,0,2022-2023,,,
282,Wissam Ben Yedder,FRA,FW,Monaco,Ligue 1,31,1990,23.5,16,9,2,5,9,4,13,30.8,9,15,0,15,4,20,0,0,0,2022-2023,90.0,15.319148936170212,61.27659574468085
283,Marco Benassi,ITA,DF,Fiorentina,Serie A,27,1994,1.0,3,3,2,0,1,3,4,75.0,1,0,0,0,1,4,1,0,0,2022-2023,90.0,90.0,270.0
284,Marco Benassi,ITA,MF,Cremonese,Serie A,27,1994,11.1,26,15,9,11,6,15,24,62.5,9,13,1,12,12,38,19,0,0,2022-2023,90.0,97.2972972972973,210.81081081081084
285,Iker Benito,ESP,"FW,MF",Osasuna,La Liga,19,2002,2.0,4,3,0,3,1,2,4,50.0,2,0,0,0,2,6,4,0,0,2022-2023,90.0,90.0,180.0
286,Ismaël Bennacer,ALG,MF,Milan,Serie A,24,1997,22.3,59,33,26,31,2,30,51,58.8,21,25,7,18,26,85,16,1,0,2022-2023,90.0,104.93273542600896,238.1165919282511
287,Saïd Benrahma,ALG,"FW,MF",West Ham,Premier League,26,1995,23.0,25,15,11,7,7,11,27,40.7,16,23,1,22,9,34,13,0,0,2022-2023,90.0,35.21739130434783,97.82608695652175
288,Ramy Bensebaini,ALG,DF,Gladbach,Bundesliga,27,1995,27.6,34,21,21,10,3,26,39,66.7,13,44,14,30,36,70,98,1,0,2022-2023,90.0,117.39130434782608,110.8695652173913
289,Nabil Bentaleb,ALG,MF,Angers,Ligue 1,27,1994,27.7,74,40,31,35,8,36,61,59.0,25,33,11,22,44,118,29,3,0,2022-2023,90.0,142.96028880866427,240.4332129963899
290,Rodrigo Bentancur,URU,MF,Tottenham,Premier League,25,1997,16.7,45,28,15,21,9,16,28,57.1,12,28,15,13,20,65,22,0,0,2022-2023,90.0,107.78443113772455,242.51497005988023
291,Daniel Bentley,ENG,GK,Wolves,Premier League,29,1993,2.0,1,1,1,0,0,1,1,100.0,0,0,0,0,0,1,0,1,0,2022-2023,90.0,0.0,45.0
292,Karim Benzema,FRA,FW,Real Madrid,La Liga,34,1987,22.6,9,5,2,4,3,2,11,18.2,9,11,0,11,2,11,5,0,0,2022-2023,90.0,7.964601769911504,35.84070796460177
293,Domenico Berardi,ITA,FW,Sassuolo,Serie A,27,1994,20.7,23,14,8,10,5,9,40,22.5,31,13,0,13,19,42,18,0,0,2022-2023,90.0,82.60869565217392,100.00000000000001
294,Yuri Berchiche,ESP,DF,Athletic Club,La Liga,32,1990,26.7,56,32,28,20,8,35,59,59.3,24,37,12,25,40,96,59,1,0,2022-2023,90.00000000000001,134.8314606741573,188.76404494382024
295,Álex Berenguer,ESP,FW,Athletic Club,La Liga,27,1995,25.5,58,37,17,25,16,23,60,38.3,37,37,4,33,10,68,6,0,0,2022-2023,90.0,35.294117647058826,204.7058823529412
296,Bartosz Bereszyński,POL,DF,Sampdoria,Serie A,30,1992,13.3,28,18,15,11,2,17,26,65.4,9,18,4,14,21,49,25,0,0,2022-2023,90.0,142.10526315789474,189.4736842105263
297,Bartosz Bereszyński,POL,DF,Napoli,Serie A,30,1992,1.8,3,2,1,1,1,2,2,100.0,0,4,0,4,3,6,3,0,0,2022-2023,90.0,150.0,150.0
298,Patrick Berg,NOR,"MF,FW",Lens,Ligue 1,24,1997,0.3,0,0,0,0,0,0,1,0.0,1,0,0,0,1,1,0,0,0,2022-2023,90.0,300.0,0.0
299,Mitchell van Bergen,NED,"FW,DF",Reims,Ligue 1,22,1999,10.1,18,8,6,7,5,8,20,40.0,12,8,2,6,6,24,11,0,0,2022-2023,90.0,53.46534653465346,160.3960396039604
300,Mergim Berisha,GER,FW,Augsburg,Bundesliga,24,1998,18.7,11,6,4,3,4,4,14,28.6,10,16,1,15,0,11,19,0,0,2022-2023,90.0,0.0,52.94117647058823
Rk,Player,Nation,Pos,Squad,Comp,0,0,90.0,0,0,3,3,3,Tkl,0,0.0,0,0,0,0,0,0,0,0,0,2022-2023,90.0,0.0,0.0
301,Quentin Bernard,FRA,DF,Auxerre,Ligue 1,33,1989,7.0,9,7,4,2,3,7,15,46.7,8,9,1,8,15,24,17,0,0,2022-2023,90.0,192.85714285714286,115.71428571428571
302,Paul Bernardoni,FRA,GK,Angers,Ligue 1,25,1997,27.0,2,0,2,0,0,2,3,66.7,1,1,0,1,1,3,12,1,0,2022-2023,90.0,3.3333333333333335,6.666666666666667
303,Juan Bernat,ESP,"DF,MF",Paris S-G,Ligue 1,29,1993,18.3,32,16,18,9,5,21,39,53.8,18,11,2,9,9,41,22,1,0,2022-2023,90.0,44.26229508196721,157.37704918032787
304,Victor Bernth Kristiansen,DEN,DF,Leicester City,Premier League,19,2002,9.9,38,23,18,16,4,22,30,73.3,8,16,4,12,3,41,26,1,0,2022-2023,90.0,27.272727272727273,345.45454545454544
305,Jason Berthomier,FRA,MF,Clermont Foot,Ligue 1,32,1990,0.3,0,0,0,0,0,0,0,0.0,0,0,0,0,0,0,0,0,0,2022-2023,90.0,0.0,0.0
306,Marco Bertini,ITA,MF,Lazio,Serie A,19,2002,0.0,0,0,0,0,0,0,0,0.0,0,0,0,0,0,0,0,0,0,2022-2023,,,
307,Beto,GNB,FW,Udinese,Serie A,24,1998,23.7,16,9,0,9,7,4,17,23.5,13,18,3,15,6,22,30,0,0,2022-2023,90.0,22.78481012658228,60.75949367088608
308,Owen Bevan,WAL,DF,Bournemouth,Premier League,18,2003,0.1,0,0,0,0,0,0,0,0.0,0,0,0,0,0,0,0,0,0,2022-2023,90.0,0.0,0.0
309,Matteo Bianchetti,ITA,DF,Cremonese,Serie A,29,1993,23.7,32,19,21,9,2,20,32,62.5,12,31,17,14,20,52,111,0,0,2022-2023,90.0,75.9493670886076,121.51898734177216
310,Alessandro Bianco,ITA,MF,Fiorentina,Serie A,19,2002,1.7,5,2,2,3,0,2,3,66.7,1,1,0,1,0,5,0,0,0,2022-2023,90.0,0.0,264.70588235294116
311,Giulian Biancone,FRA,DF,Nott'ham Forest,Premier League,22,2000,0.2,2,1,2,0,0,1,1,100.0,0,0,0,0,1,3,0,0,0,2022-2023,90.0,450.0,900.0
312,Ermin Bičakčić,BIH,DF,Hoffenheim,Bundesliga,32,1990,2.9,8,4,6,1,1,2,6,33.3,4,4,3,1,5,13,14,0,0,2022-2023,90.0,155.17241379310346,248.27586206896552
313,Pedro Bigas,ESP,DF,Elche,La Liga,31,1990,22.4,37,20,30,7,0,18,29,62.1,11,25,14,11,33,70,95,0,0,2022-2023,90.0,132.58928571428572,148.66071428571428
314,Jaka Bijol,SVN,DF,Udinese,Serie A,23,1999,30.3,39,23,32,7,0,16,27,59.3,11,41,25,16,29,68,165,0,0,2022-2023,90.0,86.13861386138613,115.84158415841584
315,El Bilal Touré,MLI,FW,Almería,La Liga,20,2001,14.0,4,3,2,1,1,0,3,0.0,3,6,1,5,1,5,23,0,0,2022-2023,90.0,6.428571428571429,25.714285714285715
316,El Bilal Touré,MLI,FW,Reims,Ligue 1,20,2001,1.0,0,0,0,0,0,0,0,0.0,0,2,0,2,0,0,1,0,0,2022-2023,90.0,0.0,0.0
317,Philip Billing,DEN,"MF,FW",Bournemouth,Premier League,26,1996,30.7,63,36,21,33,9,11,42,26.2,31,48,8,40,31,94,58,1,0,2022-2023,90.0,90.87947882736157,184.69055374592836
318,Jean-Claude Billong,CMR,MF,Clermont Foot,Ligue 1,28,1993,0.3,0,0,0,0,0,0,0,0.0,0,1,1,0,1,1,0,0,0,2022-2023,90.0,300.0,0.0
319,Cristiano Biraghi,ITA,DF,Fiorentina,Serie A,29,1992,28.3,65,38,29,29,7,32,65,49.2,33,32,7,25,14,79,42,1,0,2022-2023,90.0,44.522968197879855,206.7137809187279
320,Samuele Birindelli,ITA,DF,Monza,Serie A,23,1999,15.6,35,19,21,10,4,18,29,62.1,11,28,8,20,16,51,30,0,0,2022-2023,90.0,92.3076923076923,201.9230769230769
321,Veljko Birmančević,SRB,"FW,MF",Toulouse,Ligue 1,24,1998,4.9,13,7,5,4,4,7,21,33.3,14,12,2,10,7,20,1,0,0,2022-2023,90.0,128.57142857142856,238.77551020408163
322,Tom Bischof,GER,"MF,FW",Hoffenheim,Bundesliga,17,2005,3.5,15,10,8,3,4,7,10,70.0,3,5,1,4,1,16,1,0,0,2022-2023,90.0,25.714285714285715,385.7142857142857
323,Yves Bissouma,MLI,MF,Tottenham,Premier League,25,1996,11.2,16,13,6,6,4,2,7,28.6,5,15,6,9,12,28,10,0,0,2022-2023,90.0,96.42857142857143,128.57142857142858
324,Kristijan Bistrović,CRO,MF,Lecce,Serie A,24,1998,5.1,3,1,3,0,0,0,5,0.0,5,3,0,3,0,3,4,0,0,2022-2023,90.0,0.0,52.94117647058824
325,Leonardo Bittencourt,GER,"MF,DF",Werder Bremen,Bundesliga,28,1993,18.1,53,28,20,25,8,25,62,40.3,37,13,0,13,10,63,15,0,0,2022-2023,90.0,49.72375690607734,263.5359116022099
Rk,Player,Nation,Pos,Squad,Comp,0,0,90.0,0,0,3,3,3,Tkl,0,0.0,0,0,0,0,0,0,0,0,0,2022-2023,90.0,0.0,0.0
326,Marco Bizot,NED,GK,Brest,Ligue 1,31,1991,37.0,0,0,0,0,0,0,1,0.0,1,1,0,1,0,0,24,4,0,2022-2023,90.0,0.0,0.0
327,Antonio Blanco,ESP,MF,Cádiz,La Liga,22,2000,1.8,6,4,5,1,0,4,6,66.7,2,5,0,5,1,7,3,0,0,2022-2023,90.0,50.0,300.0
328,Lautaro Blanco,ARG,"DF,MF",Elche,La Liga,23,1999,9.7,16,9,10,4,2,9,26,34.6,17,8,1,7,2,18,10,1,0,2022-2023,90.0,18.556701030927837,148.4536082474227
329,Rubén Blanco,ESP,GK,Marseille,Ligue 1,27,1995,5.5,0,0,0,0,0,0,0,0.0,0,0,0,0,0,0,1,0,0,2022-2023,90.0,0.0,0.0
330,Ludovic Blas,FRA,"MF,FW",Nantes,Ligue 1,24,1997,31.3,47,30,17,19,11,17,49,34.7,32,26,1,25,19,66,8,0,0,2022-2023,90.0,54.632587859424916,135.14376996805112
331,Janis Blaswich,GER,GK,RB Leipzig,Bundesliga,31,1991,26.0,0,0,0,0,0,0,0,0.0,0,0,0,0,0,0,10,0,0,2022-2023,90.00000000000001,0.0,0.0
332,Miha Blažič,SVN,DF,Angers,Ligue 1,29,1993,22.0,8,6,8,0,0,7,15,46.7,8,25,19,6,22,30,80,1,0,2022-2023,90.0,90.0,32.72727272727273
333,Joaquín Blázquez,ARG,GK,Brest,Ligue 1,21,2001,1.0,0,0,0,0,0,0,0,0.0,0,0,0,0,0,0,2,0,0,2022-2023,90.0,0.0,0.0
334,Alexis Blin,FRA,MF,Lecce,Serie A,25,1996,26.4,69,39,27,33,9,38,73,52.1,35,55,15,40,34,103,74,0,0,2022-2023,90.0,115.9090909090909,235.22727272727272
335,Daley Blind,NED,"DF,MF",Bayern Munich,Bundesliga,32,1990,1.5,2,0,2,0,0,0,1,0.0,1,4,2,2,2,4,6,0,0,2022-2023,90.0,120.0,120.0
336,Myron Boadu,NED,FW,Monaco,Ligue 1,21,2001,3.3,3,3,0,2,1,1,7,14.3,6,1,0,1,0,3,1,0,0,2022-2023,90.0,0.0,81.81818181818181
337,Jérôme Boateng,GER,DF,Lyon,Ligue 1,33,1988,4.8,3,0,2,1,0,2,6,33.3,4,8,5,3,6,9,16,0,0,2022-2023,90.0,112.50000000000001,56.25000000000001
338,Kevin-Prince Boateng,GHA,MF,Hertha BSC,Bundesliga,35,1987,5.2,8,6,4,2,2,3,9,33.3,6,11,3,8,3,11,5,0,0,2022-2023,90.0,51.92307692307692,138.46153846153845
339,Antonin Bobichon,FRA,MF,Angers,Ligue 1,26,1995,0.2,0,0,0,0,0,0,0,0.0,0,1,0,1,0,0,0,0,0,2022-2023,90.0,0.0,0.0
340,Jean-Paul Boëtius,NED,MF,Hertha BSC,Bundesliga,28,1994,11.7,30,16,19,9,2,8,25,32.0,17,25,5,20,14,44,10,0,0,2022-2023,89.99999999999999,107.6923076923077,230.76923076923077
341,Jeremie Boga,CIV,"MF,FW",Atalanta,Serie A,25,1997,8.7,9,5,3,2,4,2,5,40.0,3,6,0,6,1,10,1,0,0,2022-2023,90.0,10.344827586206897,93.10344827586206
342,Emil Bohinen,NOR,MF,Salernitana,Serie A,23,1999,9.2,25,13,15,8,2,12,23,52.2,11,25,7,18,17,42,21,0,0,2022-2023,90.0,166.30434782608697,244.56521739130437
343,Quentin Boisgard,FRA,MF,Lorient,Ligue 1,25,1997,2.0,6,2,1,4,1,3,4,75.0,1,3,1,2,4,10,2,0,0,2022-2023,90.0,180.0,270.0
344,Willy Boly,CIV,DF,Nott'ham Forest,Premier League,31,1991,7.6,13,6,8,3,2,8,13,61.5,5,13,4,9,12,25,45,0,0,2022-2023,90.0,142.10526315789474,153.94736842105263
345,Giacomo Bonaventura,ITA,MF,Fiorentina,Serie A,32,1989,21.2,35,23,14,15,6,24,37,64.9,13,14,0,14,16,51,5,1,0,2022-2023,90.0,67.9245283018868,148.58490566037736
346,Federico Bonazzoli,ITA,"FW,MF",Salernitana,Serie A,25,1997,12.4,5,3,0,3,2,0,9,0.0,9,9,1,8,3,8,0,0,0,2022-2023,90.0,21.774193548387096,36.29032258064516
347,Warren Bondo,FRA,MF,Monza,Serie A,18,2003,0.7,1,0,1,0,0,0,0,0.0,0,1,0,1,0,1,0,0,0,2022-2023,90.0,0.0,128.57142857142858
348,Theo Bongonda,COD,"MF,FW",Cádiz,La Liga,26,1995,21.5,28,20,11,14,3,17,40,42.5,23,21,2,19,6,34,14,0,0,2022-2023,90.0,25.11627906976744,117.20930232558139
349,Kevin Bonifazi,ITA,DF,Bologna,Serie A,26,1996,10.0,13,8,7,6,0,6,12,50.0,6,11,8,3,12,25,39,0,0,2022-2023,90.0,108.0,117.0
350,Leonardo Bonucci,ITA,DF,Juventus,Serie A,35,1987,9.8,5,4,1,4,0,2,4,50.0,2,12,8,4,13,18,29,0,0,2022-2023,90.0,119.38775510204081,45.91836734693877
Rk,Player,Nation,Pos,Squad,Comp,0,0,90.0,0,0,3,3,3,Tkl,0,0.0,0,0,0,0,0,0,0,0,0,2022-2023,90.0,0.0,0.0
351,Neto Borges,BRA,DF,Clermont Foot,Ligue 1,25,1996,31.5,75,45,45,20,10,46,75,61.3,29,45,11,34,41,116,62,1,0,2022-2023,90.0,117.14285714285715,214.2857142857143
352,Yvandro Borges Sanches,LUX,"FW,MF",Gladbach,Bundesliga,18,2004,0.3,2,2,0,2,0,2,2,100.0,0,0,0,0,0,2,0,0,0,2022-2023,90.0,0.0,600.0
353,Sebastiaan Bornauw,BEL,DF,Wolfsburg,Bundesliga,23,1999,21.4,29,17,17,10,2,16,22,72.7,6,27,12,15,31,60,83,1,0,2022-2023,90.0,130.37383177570095,121.96261682242992
354,Rafael Borré,COL,"MF,FW",Eint Frankfurt,Bundesliga,26,1995,12.0,25,15,4,13,8,4,17,23.5,13,10,2,8,2,27,9,0,0,2022-2023,90.0,15.0,187.5
355,Erik Botheim,NOR,"MF,FW",Salernitana,Serie A,22,2000,9.6,11,7,3,4,4,6,13,46.2,7,3,0,3,0,11,4,0,0,2022-2023,90.0,0.0,103.125
356,Sven Botman,NED,DF,Newcastle Utd,Premier League,22,2000,34.7,38,24,31,7,0,22,28,78.6,6,44,24,20,34,72,126,2,0,2022-2023,90.0,88.18443804034581,98.55907780979825
357,Kenji-Van Boto,MAD,DF,Auxerre,Ligue 1,26,1996,2.0,3,2,2,0,1,2,4,50.0,2,0,0,0,1,4,3,0,0,2022-2023,90.0,45.0,135.0
358,Kouamé Botué,BFA,"FW,MF",Ajaccio,Ligue 1,19,2002,2.5,4,2,2,1,1,0,2,0.0,2,1,0,1,0,4,1,0,0,2022-2023,90.0,0.0,144.0
359,Badredine Bouanani,ALG,"FW,MF",Nice,Ligue 1,17,2004,9.6,13,9,2,7,4,7,14,50.0,7,4,0,4,1,14,2,0,0,2022-2023,90.0,9.375,121.87500000000001
360,Hicham Boudaoui,ALG,MF,Nice,Ligue 1,22,1999,20.8,67,32,31,30,6,35,53,66.0,18,34,5,29,36,103,16,0,0,2022-2023,90.0,155.76923076923075,289.90384615384613
361,Franci Bouebari,FRA,DF,Strasbourg,Ligue 1,18,2003,0.8,3,0,1,2,0,3,5,60.0,2,0,0,0,2,5,2,0,0,2022-2023,90.0,225.0,337.5
362,Sofiane Boufal,MAR,"FW,MF",Angers,Ligue 1,28,1993,9.3,14,9,7,4,3,3,14,21.4,11,6,0,6,5,19,1,0,0,2022-2023,90.0,48.387096774193544,135.48387096774192
363,Yassine Bounou,MAR,GK,Sevilla,La Liga,31,1991,23.9,2,1,2,0,0,1,4,25.0,3,0,0,0,2,4,11,1,0,2022-2023,90.0,7.531380753138076,7.531380753138076
364,Ismaëlben Boura,COM,"DF,FW",Lens,Ligue 1,21,2000,1.0,6,4,4,2,0,5,6,83.3,1,2,1,1,2,8,3,0,0,2022-2023,90.0,180.0,540.0
365,Mehdi Bourabia,MAR,MF,Spezia,Serie A,30,1991,30.8,41,20,13,22,6,19,41,46.3,22,39,12,27,32,73,57,0,0,2022-2023,90.0,93.50649350649351,119.80519480519482
366,Benjamin Bourigeaud,FRA,"MF,FW",Rennes,Ligue 1,28,1994,34.1,45,29,16,23,6,21,65,32.3,44,38,3,35,31,76,32,0,0,2022-2023,90.0,81.81818181818181,118.7683284457478
367,Edoardo Bove,ITA,MF,Roma,Serie A,20,2002,11.0,35,18,12,15,8,16,39,41.0,23,15,1,14,10,45,11,0,0,2022-2023,90.0,81.81818181818183,286.3636363636364
368,Jarrod Bowen,ENG,"FW,MF",West Ham,Premier League,25,1996,35.9,39,16,14,11,14,16,58,27.6,42,47,9,38,36,75,25,0,0,2022-2023,90.0,90.2506963788301,97.7715877437326
369,Lucas Boyé,ARG,FW,Elche,La Liga,26,1996,27.4,36,16,12,16,8,17,35,48.6,18,33,5,28,15,51,46,0,0,2022-2023,90.0,49.27007299270073,118.24817518248177
370,Jayden Braaf,NED,"MF,FW",Hellas Verona,Serie A,19,2002,3.2,5,3,2,3,0,0,0,0.0,0,1,0,1,2,7,1,0,0,2022-2023,90.0,56.25,140.625
371,Domagoj Bradarić,CRO,DF,Salernitana,Serie A,22,1999,25.0,26,19,14,8,4,7,16,43.8,9,20,5,15,21,47,44,0,0,2022-2023,90.0,75.6,93.6
372,Bilal Brahimi,ALG,"FW,MF",Nice,Ligue 1,22,2000,8.9,8,5,2,5,1,1,7,14.3,6,4,0,4,4,12,0,0,0,2022-2023,90.0,40.449438202247194,80.89887640449439
373,Martin Braithwaite,DEN,"FW,MF",Espanyol,La Liga,31,1991,27.3,12,2,2,4,6,5,14,35.7,9,10,0,10,5,17,11,0,0,2022-2023,90.0,16.483516483516482,39.56043956043956
374,Julian Brandt,GER,"MF,FW",Dortmund,Bundesliga,26,1996,26.6,29,20,6,14,9,12,43,27.9,31,23,0,23,15,44,9,1,0,2022-2023,90.0,50.751879699248114,98.1203007518797
375,Darko Brašanac,SRB,MF,Osasuna,La Liga,30,1992,11.6,29,20,12,10,7,12,23,52.2,11,14,2,12,12,41,9,0,0,2022-2023,90.0,93.10344827586206,225.0
Rk,Player,Nation,Pos,Squad,Comp,0,0,90.0,0,0,3,3,3,Tkl,0,0.0,0,0,0,0,0,0,0,0,0,2022-2023,90.0,0.0,0.0
376,Lilian Brassier,FRA,DF,Brest,Ligue 1,22,1999,34.4,42,30,31,8,3,23,32,71.9,9,42,19,23,53,95,132,1,0,2022-2023,90.0,138.66279069767444,109.88372093023257
377,Claudio Bravo,CHI,GK,Betis,La Liga,39,1983,12.0,0,0,0,0,0,0,0,0.0,0,0,0,0,2,2,1,1,0,2022-2023,90.0,15.0,0.0
378,Fabian Bredlow,GER,GK,Stuttgart,Bundesliga,27,1995,15.0,1,1,1,0,0,1,1,100.0,0,0,0,0,0,1,4,2,0,2022-2023,90.0,0.0,6.0
379,James Bree,ENG,DF,Southampton,Premier League,24,1997,4.1,5,3,4,1,0,3,4,75.0,1,3,1,2,6,11,11,0,0,2022-2023,90.0,131.70731707317074,109.75609756097562
380,Josip Brekalo,CRO,"FW,MF",Fiorentina,Serie A,24,1998,2.5,2,1,0,1,1,1,4,25.0,3,1,0,1,1,3,1,0,0,2022-2023,90.0,36.0,72.0
381,Josip Brekalo,CRO,"MF,FW",Wolfsburg,Bundesliga,24,1998,3.0,2,1,2,0,0,0,4,0.0,4,0,0,0,2,4,2,0,0,2022-2023,90.0,60.0,60.0
382,Gleison Bremer,BRA,DF,Juventus,Serie A,25,1997,29.3,29,20,23,5,1,19,26,73.1,7,44,22,22,42,71,120,2,0,2022-2023,90.0,129.01023890784984,89.07849829351537
383,Armando Broja,ALB,FW,Chelsea,Premier League,20,2001,3.3,4,1,0,3,1,1,1,100.0,0,10,1,9,1,5,1,0,0,2022-2023,90.0,27.272727272727273,109.0909090909091
384,Dylan Bronn,TUN,DF,Salernitana,Serie A,27,1995,18.7,34,18,17,16,1,20,30,66.7,10,32,20,12,20,54,58,1,0,2022-2023,90.0,96.2566844919786,163.63636363636363
385,David Brooks,WAL,"FW,MF",Bournemouth,Premier League,25,1997,1.9,1,0,1,0,0,0,1,0.0,1,2,0,2,2,3,5,0,0,2022-2023,90.0,94.73684210526315,47.368421052631575
386,John Brooks,USA,DF,Hoffenheim,Bundesliga,29,1993,15.0,18,12,10,8,0,13,18,72.2,5,17,12,5,10,28,105,0,0,2022-2023,90.0,60.0,108.0
387,Moritz Broschinski,GER,"FW,MF",Bochum,Bundesliga,21,2000,2.4,0,0,0,0,0,0,5,0.0,5,1,0,1,0,0,6,0,0,2022-2023,90.0,0.0,0.0
388,Marcelo Brozović,CRO,MF,Inter,Serie A,29,1992,19.7,37,22,13,22,2,11,37,29.7,26,23,7,16,22,59,28,0,0,2022-2023,90.0,100.50761421319797,169.03553299492387
389,Cédric Brunner,SUI,DF,Schalke 04,Bundesliga,28,1994,25.7,39,27,26,11,2,30,45,66.7,15,24,7,17,43,82,79,0,0,2022-2023,90.0,150.58365758754863,136.5758754863813
390,Lewis Brunt,ENG,DF,Leicester City,Premier League,21,2000,0.3,0,0,0,0,0,0,0,0.0,0,0,0,0,0,0,2,0,0,2022-2023,90.0,0.0,0.0
391,Jacob Bruun Larsen,DEN,FW,Hoffenheim,Bundesliga,23,1998,3.6,4,3,0,1,3,3,4,75.0,1,3,1,2,1,5,0,0,0,2022-2023,90.0,25.0,100.0
392,Andreas Bruus,DEN,"DF,FW",Troyes,Ligue 1,23,1999,18.1,12,6,9,3,0,8,20,40.0,12,13,2,11,17,29,24,0,0,2022-2023,90.0,84.53038674033148,59.66850828729281
393,Joe Bryan,ENG,"MF,DF",Nice,Ligue 1,28,1993,2.0,5,4,3,2,0,4,4,100.0,0,2,0,2,1,6,1,0,0,2022-2023,90.0,45.0,225.0
394,Lee Buchanan,ENG,"DF,FW",Werder Bremen,Bundesliga,21,2001,5.2,14,10,2,11,1,6,12,50.0,6,5,0,5,12,26,21,0,0,2022-2023,90.0,207.69230769230768,242.3076923076923
395,Ante Budimir,CRO,FW,Osasuna,La Liga,31,1991,20.0,19,9,0,12,7,2,10,20.0,8,10,0,10,5,24,19,0,0,2022-2023,90.0,22.5,85.5
396,Emi Buendía,ARG,"MF,FW",Aston Villa,Premier League,25,1996,26.8,52,23,20,20,12,21,74,28.4,53,20,2,18,20,72,17,0,0,2022-2023,90.0,67.16417910447761,174.62686567164178
397,Hugo Bueno,ESP,DF,Wolves,Premier League,19,2002,14.6,33,16,23,6,4,17,33,51.5,16,14,1,13,10,43,36,0,0,2022-2023,90.0,61.64383561643836,203.4246575342466
398,Manu Bueno,ESP,MF,Sevilla,La Liga,18,2004,1.7,7,4,3,3,1,5,8,62.5,3,0,0,0,0,7,2,0,0,2022-2023,90.0,0.0,370.5882352941176
399,Santiago Bueno,URU,DF,Girona,La Liga,23,1998,33.4,63,38,43,19,1,24,36,66.7,12,34,22,12,31,94,105,2,0,2022-2023,90.0,83.53293413173652,169.76047904191617
400,Adam Buksa,POL,"FW,MF",Lens,Ligue 1,26,1996,1.1,1,0,0,0,1,0,3,0.0,3,0,0,0,0,1,0,0,0,2022-2023,90.0,0.0,81.81818181818181
Rk,Player,Nation,Pos,Squad,Comp,0,0,90.0,0,0,3,3,3,Tkl,0,0.0,0,0,0,0,0,0,0,0,0,2022-2023,90.0,0.0,0.0
401,Marius Bülter,GER,"FW,MF",Schalke 04,Bundesliga,29,1993,28.9,22,11,8,7,7,12,32,37.5,20,34,1,33,10,32,20,0,0,2022-2023,90.00000000000001,31.14186851211073,68.51211072664361
402,Cristian Buonaiuto,ITA,"MF,FW",Cremonese,Serie A,29,1992,10.9,25,16,8,11,6,12,26,46.2,14,11,0,11,14,39,7,0,0,2022-2023,90.0,115.59633027522935,206.42201834862385
403,Facundo Buonanotte,ARG,"FW,MF",Brighton,Premier League,17,2004,6.3,2,1,1,1,0,1,22,4.5,21,5,2,3,4,6,3,0,0,2022-2023,90.0,57.142857142857146,28.571428571428573
404,Alessandro Buongiorno,ITA,DF,Torino,Serie A,23,1999,30.2,38,25,22,16,0,16,31,51.6,15,38,19,19,60,98,105,2,0,2022-2023,90.0,178.80794701986756,113.24503311258279
405,Delano Burgzorg,NED,"FW,MF",Mainz 05,Bundesliga,23,1998,2.7,3,3,1,1,1,2,3,66.7,1,2,0,2,0,3,2,0,0,2022-2023,90.0,0.0,99.99999999999999
406,Jonathan Burkardt,GER,"MF,FW",Mainz 05,Bundesliga,22,2000,5.9,3,1,0,1,2,1,4,25.0,3,6,1,5,1,4,1,0,0,2022-2023,90.0,15.254237288135592,45.762711864406775
407,Oliver Burke,SCO,"FW,MF",Werder Bremen,Bundesliga,25,1997,3.0,1,0,0,0,1,0,0,0.0,0,2,0,2,0,1,0,0,0,2022-2023,90.0,0.0,30.0
408,Dan Burn,ENG,DF,Newcastle Utd,Premier League,30,1992,34.6,60,38,29,23,8,34,67,50.7,33,42,16,26,32,92,120,2,0,2022-2023,90.0,83.23699421965317,156.0693641618497
409,Maxime Busi,BEL,DF,Reims,Ligue 1,22,1999,11.6,21,16,9,11,1,13,29,44.8,16,14,6,8,14,35,24,0,0,2022-2023,90.0,108.62068965517241,162.93103448275863
410,Sergio Busquets,ESP,MF,Barcelona,La Liga,34,1988,26.0,58,26,24,26,8,29,51,56.9,22,32,6,26,27,85,36,2,0,2022-2023,90.00000000000001,93.46153846153847,200.7692307692308
411,Aurélio Buta,POR,DF,Eint Frankfurt,Bundesliga,25,1997,14.6,33,19,15,13,5,15,27,55.6,12,18,1,17,9,42,34,0,0,2022-2023,90.0,55.47945205479452,203.4246575342466
412,Leonardo Buta,POR,DF,Udinese,Serie A,20,2002,0.2,1,1,0,1,0,0,0,0.0,0,0,0,0,0,1,0,0,0,2022-2023,90.0,0.0,450.0
413,Marcin Bułka,POL,GK,Nice,Ligue 1,22,1999,2.0,0,0,0,0,0,0,1,0.0,1,0,0,0,1,1,0,0,0,2022-2023,90.0,45.0,0.0
414,Rémy Cabella,FRA,"MF,FW",Lille,Ligue 1,32,1990,28.1,64,37,21,28,15,29,64,45.3,35,41,5,36,17,81,7,1,0,2022-2023,90.0,54.44839857651245,204.98220640569394
415,Jimmy Cabot,FRA,"DF,MF",Lens,Ligue 1,28,1994,5.7,20,12,10,8,2,12,26,46.2,14,5,0,5,4,24,12,0,0,2022-2023,90.0,63.1578947368421,315.7894736842105
416,Arthur Cabral,BRA,FW,Fiorentina,Serie A,24,1998,15.9,9,2,1,4,4,4,8,50.0,4,10,1,9,1,10,12,0,0,2022-2023,90.0,5.660377358490566,50.943396226415096
417,Leandro Cabrera,URU,DF,Espanyol,La Liga,31,1991,29.7,46,24,34,12,0,28,43,65.1,15,37,23,14,43,89,114,2,0,2022-2023,90.0,130.30303030303028,139.39393939393938
418,Liberato Cacace,NZL,DF,Empoli,Serie A,21,2000,6.5,25,10,12,8,5,9,15,60.0,6,15,7,8,4,29,16,0,0,2022-2023,90.00000000000001,55.38461538461539,346.1538461538462
419,Anthony Caci,FRA,DF,Mainz 05,Bundesliga,25,1997,22.6,58,33,32,20,6,28,42,66.7,14,28,4,24,54,112,40,0,0,2022-2023,90.0,215.0442477876106,230.97345132743362
420,Cafú,POR,MF,Nott'ham Forest,Premier League,29,1993,0.1,0,0,0,0,0,0,0,0.0,0,0,0,0,0,0,1,0,0,2022-2023,90.0,0.0,0.0
421,Moisés Caicedo,ECU,MF,Brighton,Premier League,20,2001,34.9,100,50,41,47,12,40,68,58.8,28,43,7,36,56,156,31,3,0,2022-2023,90.0,144.41260744985672,257.87965616045847
422,Tom Cairney,SCO,MF,Fulham,Premier League,31,1991,11.0,17,6,4,8,5,7,10,70.0,3,18,3,15,5,22,3,0,0,2022-2023,90.0,40.909090909090914,139.0909090909091
423,Jens Cajuste,SWE,MF,Reims,Ligue 1,22,1999,17.0,46,25,25,14,7,25,48,52.1,23,30,6,24,18,64,22,0,0,2022-2023,90.0,95.29411764705883,243.52941176470588
424,Cala,ESP,DF,Cádiz,La Liga,32,1989,1.5,2,1,1,1,0,1,2,50.0,1,2,1,1,1,3,12,0,0,2022-2023,90.0,60.0,120.0
425,Davide Calabria,ITA,DF,Milan,Serie A,25,1996,18.8,71,44,31,32,8,38,61,62.3,23,22,7,15,25,96,34,0,0,2022-2023,90.0,119.68085106382978,339.89361702127655
Rk,Player,Nation,Pos,Squad,Comp,0,0,90.0,0,0,3,3,3,Tkl,0,0.0,0,0,0,0,0,0,0,0,0,2022-2023,90.0,0.0,0.0
426,Mattia Caldara,ITA,DF,Spezia,Serie A,28,1994,13.9,23,14,10,11,2,9,20,45.0,11,23,16,7,17,40,88,2,0,2022-2023,90.0,110.07194244604317,148.9208633093525
427,Luca Caldirola,ITA,DF,Monza,Serie A,31,1991,26.1,26,14,19,4,3,13,26,50.0,13,32,18,14,25,51,66,1,0,2022-2023,90.0,86.20689655172413,89.6551724137931
428,Fernando Calero,ESP,"DF,MF",Espanyol,La Liga,26,1995,17.9,46,29,27,15,4,21,34,61.8,13,31,13,18,13,59,52,0,0,2022-2023,90.0,65.36312849162012,231.28491620111734
429,Duje Ćaleta-Car,CRO,DF,Southampton,Premier League,25,1996,10.5,14,10,9,4,1,6,9,66.7,3,15,11,4,15,29,65,1,0,2022-2023,90.0,128.57142857142856,120.0
430,Duje Ćaleta-Car,CRO,DF,Marseille,Ligue 1,25,1996,0.1,0,0,0,0,0,0,0,0.0,0,0,0,0,0,0,1,0,0,2022-2023,90.0,0.0,0.0
431,Hakan Çalhanoğlu,TUR,MF,Inter,Serie A,28,1994,26.3,48,27,17,26,5,16,43,37.2,27,30,5,25,25,73,13,1,0,2022-2023,90.0,85.55133079847909,164.25855513307985
432,Kerim Calhanoglu,GER,DF,Schalke 04,Bundesliga,19,2002,0.7,2,1,2,0,0,2,2,100.0,0,1,0,1,0,2,3,0,0,2022-2023,90.0,0.0,257.14285714285717
433,Daniel Caligiuri,ITA,"DF,MF",Augsburg,Bundesliga,34,1988,3.2,8,5,5,3,0,4,5,80.0,1,3,2,1,3,11,2,0,0,2022-2023,90.0,84.375,225.0
434,Alexander Callens,PER,DF,Girona,La Liga,30,1992,1.3,3,3,2,1,0,3,4,75.0,1,3,1,2,1,4,9,0,0,2022-2023,90.0,69.23076923076923,207.69230769230768
435,Dominic Calvert-Lewin,ENG,FW,Everton,Premier League,25,1997,12.9,4,2,1,0,3,1,5,20.0,4,5,1,4,3,7,18,0,0,2022-2023,90.0,20.930232558139533,27.906976744186046
436,Mahdi Camara,FRA,MF,Brest,Ligue 1,24,1998,20.2,63,36,18,38,7,25,43,58.1,18,35,4,31,40,103,16,0,0,2022-2023,90.0,178.21782178217822,280.6930693069307
437,Mohamed Camara,GUI,MF,Roma,Serie A,25,1997,7.7,13,10,3,7,3,5,15,33.3,10,5,1,4,10,23,8,0,0,2022-2023,90.0,116.88311688311688,151.94805194805195
438,Mohamed Camara,MLI,MF,Monaco,Ligue 1,22,2000,24.4,83,45,38,39,6,48,92,52.2,44,45,6,39,27,110,14,1,0,2022-2023,90.0,99.59016393442624,306.1475409836066
439,Ousmane Camara,GUI,"FW,MF",Auxerre,Ligue 1,20,2001,0.3,1,1,0,0,1,0,0,0.0,0,0,0,0,0,1,0,0,0,2022-2023,90.0,0.0,300.0
440,Ousmane Camara,FRA,DF,Angers,Ligue 1,19,2003,5.8,10,6,5,5,0,5,12,41.7,7,4,2,2,11,21,15,0,0,2022-2023,90.0,170.6896551724138,155.17241379310346
441,Eduardo Camavinga,FRA,"MF,DF",Real Madrid,La Liga,19,2002,22.3,68,48,32,21,15,24,64,37.5,40,24,5,19,17,85,25,0,0,2022-2023,90.0,68.60986547085201,274.43946188340806
442,Nicolò Cambiaghi,ITA,"FW,MF",Empoli,Serie A,21,2000,14.3,30,22,11,12,7,8,27,29.6,19,19,1,18,9,39,8,0,0,2022-2023,90.0,56.64335664335665,188.81118881118883
443,Andrea Cambiaso,ITA,DF,Bologna,Serie A,22,2000,24.1,57,34,34,20,3,28,65,43.1,37,26,2,24,26,83,33,1,0,2022-2023,90.0,97.0954356846473,212.86307053941908
444,Axel Camblan,FRA,"FW,MF",Brest,Ligue 1,18,2003,0.8,2,2,1,1,0,0,1,0.0,1,0,0,0,0,2,0,0,0,2022-2023,90.0,0.0,225.0
445,Sergio Camello,ESP,FW,Rayo Vallecano,La Liga,21,2001,26.7,16,10,3,9,4,5,17,29.4,12,9,1,8,2,18,26,0,0,2022-2023,90.00000000000001,6.741573033707866,53.932584269662925
446,Chem Campbell,WAL,"FW,MF",Wolves,Premier League,19,2002,0.8,2,1,1,1,0,0,1,0.0,1,2,0,2,1,3,0,0,0,2022-2023,90.0,112.5,225.0
447,Emre Can,GER,MF,Dortmund,Bundesliga,28,1994,21.1,57,28,25,27,5,22,43,51.2,21,16,6,10,25,82,39,1,0,2022-2023,90.0,106.63507109004739,243.12796208530804
448,Sergio Canales,ESP,"FW,MF",Betis,La Liga,31,1991,26.7,25,14,10,8,7,14,33,42.4,19,18,0,18,14,39,8,0,0,2022-2023,90.00000000000001,47.19101123595506,84.26966292134833
449,Matteo Cancellieri,ITA,FW,Lazio,Serie A,20,2002,2.8,10,4,5,3,2,5,9,55.6,4,4,0,4,1,11,2,0,0,2022-2023,90.0,32.142857142857146,321.42857142857144
450,João Cancelo,POR,DF,Manchester City,Premier League,28,1994,14.2,29,21,16,9,4,17,24,70.8,7,7,1,6,19,48,9,1,0,2022-2023,90.0,120.42253521126761,183.80281690140848
Rk,Player,Nation,Pos,Squad,Comp,0,0,90.0,0,0,3,3,3,Tkl,0,0.0,0,0,0,0,0,0,0,0,0,2022-2023,90.0,0.0,0.0
451,João Cancelo,POR,"DF,FW",Bayern Munich,Bundesliga,28,1994,11.2,23,14,9,10,4,10,23,43.5,13,14,2,12,15,38,22,0,0,2022-2023,90.0,120.53571428571429,184.82142857142858
452,Antonio Candreva,ITA,"MF,DF",Salernitana,Serie A,35,1987,30.3,17,7,13,2,2,11,38,28.9,27,7,3,4,17,34,32,0,0,2022-2023,90.0,50.495049504950494,50.495049504950494
453,Thomas Cannon,IRL,FW,Everton,Premier League,19,2002,0.3,0,0,0,0,0,0,0,0.0,0,0,0,0,0,0,0,0,0,2022-2023,90.0,0.0,0.0
454,Sergi Canós,ESP,"FW,DF",Brentford,Premier League,25,1997,0.9,0,0,0,0,0,0,2,0.0,2,3,1,2,0,0,1,0,0,2022-2023,90.0,0.0,0.0
455,Ander Capa,ESP,DF,Athletic Club,La Liga,30,1992,1.2,1,1,1,0,0,1,5,20.0,4,5,0,5,0,1,2,0,0,2022-2023,90.0,0.0,75.0
456,Pierrick Capelle,FRA,"MF,DF",Angers,Ligue 1,35,1987,15.9,36,21,17,15,4,22,55,40.0,33,24,3,21,15,51,24,0,0,2022-2023,90.0,84.90566037735849,203.77358490566039
457,Étienne Capoue,FRA,MF,Villarreal,La Liga,34,1988,21.7,21,12,6,13,2,10,18,55.6,8,12,5,7,19,40,20,1,0,2022-2023,90.0,78.80184331797236,87.09677419354838
458,Gianluca Caprari,ITA,"MF,FW",Monza,Serie A,29,1993,27.1,16,6,3,11,2,8,26,30.8,18,22,1,21,8,24,3,0,0,2022-2023,90.0,26.568265682656826,53.13653136531365
459,Francesco Caputo,ITA,FW,Sampdoria,Serie A,34,1987,12.2,3,1,0,0,3,0,3,0.0,3,0,0,0,1,4,3,0,0,2022-2023,90.0,7.3770491803278695,22.13114754098361
460,Francesco Caputo,ITA,FW,Empoli,Serie A,34,1987,19.0,2,2,0,1,1,0,1,0.0,1,7,2,5,2,4,8,0,0,2022-2023,90.0,9.473684210526315,9.473684210526315
461,Maxence Caqueret,FRA,MF,Lyon,Ligue 1,22,2000,30.7,87,54,27,38,22,43,109,39.4,66,45,3,42,39,126,27,0,0,2022-2023,90.0,114.33224755700327,255.04885993485343
462,Andrea Carboni,ITA,DF,Monza,Serie A,21,2001,1.9,3,2,2,0,1,2,5,40.0,3,3,2,1,3,6,2,1,0,2022-2023,90.0,142.10526315789474,142.10526315789474
463,Franco Carboni,ITA,"DF,FW",Monza,Serie A,19,2003,0.7,1,1,1,0,0,0,2,0.0,2,3,0,3,1,2,0,0,0,2022-2023,90.0,128.57142857142858,128.57142857142858
464,Valentin Carboni,ARG,"MF,DF",Inter,Serie A,17,2005,0.3,1,1,0,1,0,1,3,33.3,2,1,0,1,0,1,0,0,0,2022-2023,90.0,0.0,300.0
465,Isaac Carcelen,ESP,DF,Cádiz,La Liga,29,1993,24.4,69,51,41,22,6,41,63,65.1,22,35,11,24,19,88,80,1,0,2022-2023,90.0,70.08196721311477,254.5081967213115
466,Irvin Cardona,FRA,"FW,MF",Brest,Ligue 1,24,1997,2.6,2,0,1,1,0,0,3,0.0,3,3,0,3,2,4,2,0,0,2022-2023,90.0,69.23076923076923,69.23076923076923
467,Irvin Cardona,FRA,"MF,FW",Augsburg,Bundesliga,24,1997,3.5,1,1,1,0,0,1,5,20.0,4,3,0,3,4,5,8,0,0,2022-2023,90.0,102.85714285714286,25.714285714285715
468,Igor Carioca,BRA,DF,Lorient,Ligue 1,25,1996,5.1,18,11,12,2,4,12,21,57.1,9,7,0,7,5,23,17,0,0,2022-2023,90.0,88.23529411764706,317.64705882352945
469,Diego Carlos,BRA,DF,Aston Villa,Premier League,29,1993,2.3,1,0,0,1,0,0,1,0.0,1,2,2,0,1,2,2,0,0,2022-2023,90.0,39.130434782608695,39.130434782608695
470,Juan Carlos,ESP,GK,Girona,La Liga,34,1988,10.0,0,0,0,0,0,0,0,0.0,0,0,0,0,1,1,7,1,0,2022-2023,90.0,9.0,0.0
471,José Carlos Lazo,ESP,"MF,FW",Almería,La Liga,26,1996,0.2,0,0,0,0,0,0,0,0.0,0,0,0,0,0,0,0,0,0,2022-2023,90.0,0.0,0.0
472,José Carlos Lazo,ESP,"MF,FW",Espanyol,La Liga,26,1996,1.8,5,3,2,2,1,3,3,100.0,0,2,0,2,3,8,5,0,0,2022-2023,90.0,150.0,250.0
473,Carmona,ESP,"MF,DF",Elche,La Liga,20,2002,6.5,16,9,7,6,3,6,16,37.5,10,14,2,12,8,24,9,0,0,2022-2023,90.00000000000001,110.76923076923077,221.53846153846155
474,Carmona,ESP,DF,Sevilla,La Liga,20,2002,5.9,13,11,5,3,5,9,16,56.3,7,10,6,4,7,20,17,1,0,2022-2023,90.0,106.77966101694915,198.30508474576268
475,Marco Carnesecchi,ITA,GK,Cremonese,Serie A,22,2000,27.0,1,1,1,0,0,1,2,50.0,1,0,0,0,0,1,11,2,0,2022-2023,90.0,0.0,3.3333333333333335
Rk,Player,Nation,Pos,Squad,Comp,0,0,90.0,0,0,3,3,3,Tkl,0,0.0,0,0,0,0,0,0,0,0,0,2022-2023,90.0,0.0,0.0
476,Yannick Carrasco,BEL,"DF,MF",Atlético Madrid,La Liga,28,1993,25.7,35,14,21,10,4,23,54,42.6,31,23,1,22,12,47,19,0,0,2022-2023,90.0,42.023346303501945,122.568093385214
477,Dani Carvajal,ESP,DF,Real Madrid,La Liga,30,1992,19.8,32,18,15,12,5,18,35,51.4,17,24,6,18,15,47,49,0,0,2022-2023,90.0,68.18181818181819,145.45454545454547
478,Fabio Carvalho,POR,"MF,FW",Liverpool,Premier League,19,2002,3.9,8,8,3,3,2,3,6,50.0,3,6,0,6,6,14,0,0,0,2022-2023,90.0,138.46153846153845,184.6153846153846
479,Matis Carvalho,POR,GK,Montpellier,Ligue 1,23,1999,1.5,0,0,0,0,0,0,0,0.0,0,0,0,0,1,1,0,0,0,2022-2023,90.0,60.0,0.0
480,William Carvalho,POR,MF,Betis,La Liga,30,1992,27.1,43,27,18,23,2,17,44,38.6,27,27,6,21,16,59,22,0,0,2022-2023,90.0,53.13653136531365,142.80442804428046
481,Nicolò Casale,ITA,DF,Lazio,Serie A,24,1998,27.1,42,20,28,14,0,22,34,64.7,12,25,17,8,17,59,73,1,0,2022-2023,90.0,56.457564575645755,139.48339483394835
482,Casemiro,BRA,MF,Manchester Utd,Premier League,30,1992,23.6,88,46,43,35,10,47,92,51.1,45,49,11,38,34,122,64,0,0,2022-2023,90.0,129.66101694915253,335.59322033898303
483,Casemiro,BRA,MF,Real Madrid,La Liga,30,1992,0.1,0,0,0,0,0,0,0,0.0,0,0,0,0,0,0,1,0,0,2022-2023,90.0,0.0,0.0
484,Matty Cash,POL,DF,Aston Villa,Premier League,24,1997,20.2,55,32,36,15,4,26,37,70.3,11,20,5,15,26,81,43,0,0,2022-2023,90.0,115.84158415841584,245.04950495049505
485,Tommaso Cassandro,ITA,DF,Lecce,Serie A,22,2000,0.1,1,1,0,1,0,0,0,0.0,0,1,1,0,0,1,0,0,0,2022-2023,90.0,0.0,900.0
486,Timothy Castagne,BEL,DF,Leicester City,Premier League,26,1995,36.2,87,44,53,27,7,41,84,48.8,43,50,13,37,43,130,110,0,0,2022-2023,90.0,106.90607734806629,216.29834254143645
487,Michele Castagnetti,ITA,MF,Cremonese,Serie A,32,1989,15.7,46,21,20,24,2,18,54,33.3,36,14,4,10,15,61,22,0,0,2022-2023,90.0,85.98726114649682,263.69426751592357
488,Koen Casteels,BEL,GK,Wolfsburg,Bundesliga,30,1992,34.0,0,0,0,0,0,0,0,0.0,0,0,0,0,1,1,10,1,0,2022-2023,90.0,2.6470588235294117,0.0
489,Valentín Castellanos,ARG,FW,Girona,La Liga,23,1998,28.9,12,5,2,7,3,0,18,0.0,18,22,2,20,6,18,26,0,0,2022-2023,90.00000000000001,18.68512110726644,37.37024221453288
490,Jean-Charles Castelletto,CMR,DF,Nantes,Ligue 1,27,1995,28.5,43,26,29,12,2,22,36,61.1,14,35,22,13,58,101,90,0,0,2022-2023,90.0,183.1578947368421,135.78947368421052
491,Samu Castillejo,ESP,"FW,MF",Valencia,La Liga,27,1995,15.1,21,12,8,9,4,8,40,20.0,32,21,2,19,9,30,2,0,0,2022-2023,90.0,53.64238410596027,125.16556291390728
492,Jonny Castro,ESP,DF,Wolves,Premier League,28,1994,14.0,33,15,22,10,1,17,38,44.7,21,26,5,21,14,47,28,2,0,2022-2023,90.0,90.0,212.14285714285714
493,Gaetano Castrovilli,ITA,MF,Fiorentina,Serie A,25,1997,8.0,10,8,1,7,2,2,9,22.2,7,5,1,4,8,18,5,0,0,2022-2023,90.0,90.0,112.5
494,Danilo Cataldi,ITA,MF,Lazio,Serie A,27,1994,21.3,25,16,7,15,3,14,40,35.0,26,23,9,14,24,49,33,0,0,2022-2023,90.0,101.40845070422536,105.63380281690141
495,Catena,ESP,DF,Rayo Vallecano,La Liga,27,1994,34.5,29,14,23,4,2,13,27,48.1,14,32,25,7,28,57,159,1,0,2022-2023,90.0,73.04347826086956,75.65217391304347
496,Yoann Cathline,FRA,"FW,MF",Lorient,Ligue 1,20,2002,12.1,19,12,7,6,6,5,12,41.7,7,10,1,9,8,27,16,1,0,2022-2023,90.0,59.50413223140496,141.32231404958677
497,Maximiliano Caufriez,BEL,DF,Clermont Foot,Ligue 1,25,1997,24.7,40,24,31,8,1,20,28,71.4,8,33,18,15,34,74,70,0,0,2022-2023,90.0,123.88663967611336,145.74898785425103
498,Edinson Cavani,URU,FW,Valencia,La Liga,35,1987,16.1,7,4,3,3,1,3,15,20.0,12,10,3,7,2,9,11,0,0,2022-2023,90.0,11.180124223602483,39.130434782608695
499,Dani Ceballos,ESP,MF,Real Madrid,La Liga,25,1996,17.4,43,29,13,15,15,25,64,39.1,39,23,2,21,25,68,6,1,0,2022-2023,90.0,129.31034482758622,222.41379310344828
500,Pietro Ceccaroni,ITA,DF,Lecce,Serie A,26,1995,0.5,0,0,0,0,0,0,0,0.0,0,1,1,0,3,3,2,0,0,2022-2023,90.0,540.0,0.0
Rk,Player,Nation,Pos,Squad,Comp,0,0,90.0,0,0,3,3,3,Tkl,0,0.0,0,0,0,0,0,0,0,0,0,2022-2023,90.0,0.0,0.0
501,Federico Ceccherini,ITA,DF,Hellas Verona,Serie A,30,1992,15.7,25,19,15,9,1,13,23,56.5,10,17,10,7,19,44,55,0,0,2022-2023,90.0,108.9171974522293,143.31210191082803
502,Assan Ceesay,GAM,FW,Lecce,Serie A,28,1994,20.1,23,18,7,8,8,9,17,52.9,8,15,2,13,3,26,24,0,0,2022-2023,90.0,13.432835820895521,102.98507462686567
503,Emil Ceide,NOR,FW,Sassuolo,Serie A,20,2001,5.7,5,2,5,0,0,3,5,60.0,2,3,1,2,1,6,0,0,0,2022-2023,90.0,15.789473684210526,78.94736842105263
504,Zeki Çelik,TUR,DF,Roma,Serie A,25,1997,16.7,42,21,19,21,2,24,41,58.5,17,33,6,27,14,56,36,2,0,2022-2023,90.0,75.44910179640719,226.34730538922156
505,Álex Centelles,ESP,DF,Almería,La Liga,24,1997,12.5,22,14,16,3,3,16,22,72.7,6,13,2,11,11,33,40,0,0,2022-2023,90.0,79.2,158.4
506,Fabien Centonze,FRA,DF,Nantes,Ligue 1,26,1996,18.8,58,37,30,22,6,30,42,71.4,12,24,7,17,44,102,55,1,0,2022-2023,90.0,210.63829787234042,277.6595744680851
507,Michele Cerofolini,ITA,GK,Fiorentina,Serie A,23,1999,5.0,0,0,0,0,0,0,0,0.0,0,0,0,0,1,1,2,0,0,2022-2023,90.0,18.0,0.0
508,Franco Cervi,ARG,"MF,DF",Celta Vigo,La Liga,28,1994,21.0,76,46,29,36,11,33,66,50.0,33,33,1,32,36,112,16,0,0,2022-2023,90.0,154.28571428571428,325.7142857142857
509,Julian Chabot,GER,DF,Köln,Bundesliga,24,1998,20.0,36,23,19,14,3,20,35,57.1,15,30,18,12,41,77,105,0,0,2022-2023,90.0,184.5,162.0
510,Florian Chabrolle,FRA,MF,Ajaccio,Ligue 1,24,1998,3.7,6,4,1,5,0,2,4,50.0,2,3,0,3,7,13,2,0,0,2022-2023,90.0,170.27027027027026,145.94594594594594
511,El Chadaille Bitshiabu,FRA,DF,Paris S-G,Ligue 1,17,2005,6.5,10,7,7,2,1,3,12,25.0,9,9,7,2,9,19,13,3,0,2022-2023,90.00000000000001,124.61538461538463,138.46153846153848
512,Fares Chaïbi,ALG,"FW,MF",Toulouse,Ligue 1,19,2002,26.0,31,18,8,15,8,17,50,34.0,33,38,5,33,19,50,36,1,0,2022-2023,90.00000000000001,65.76923076923077,107.30769230769232
513,Nathaniel Chalobah,ENG,MF,Fulham,Premier League,27,1994,0.1,1,1,1,0,0,1,1,100.0,0,0,0,0,0,1,2,0,0,2022-2023,90.0,0.0,900.0
514,Trevoh Chalobah,ENG,DF,Chelsea,Premier League,23,1999,17.9,31,20,22,6,3,24,35,68.6,11,17,7,10,24,55,56,1,0,2022-2023,90.0,120.67039106145253,155.8659217877095
515,Muhammed Cham,AUT,MF,Clermont Foot,Ligue 1,21,2000,21.9,30,15,15,4,11,13,35,37.1,22,13,0,13,7,37,5,0,0,2022-2023,90.0,28.767123287671236,123.28767123287672
516,Calum Chambers,ENG,"DF,MF",Aston Villa,Premier League,27,1995,3.9,9,6,7,2,0,6,8,75.0,2,5,4,1,7,16,10,1,0,2022-2023,90.0,161.53846153846152,207.69230769230768
517,Timothy Chandler,USA,DF,Eint Frankfurt,Bundesliga,32,1990,1.0,2,2,2,0,0,2,2,100.0,0,1,0,1,0,2,3,0,0,2022-2023,90.0,0.0,180.0
518,Gaëtan Charbonnier,FRA,"FW,MF",Auxerre,Ligue 1,33,1988,2.8,2,1,0,2,0,0,4,0.0,4,2,0,2,0,2,5,0,0,2022-2023,90.0,0.0,64.28571428571429
519,Brendan Chardonnet,FRA,DF,Brest,Ligue 1,27,1994,27.7,45,27,27,18,0,20,38,52.6,18,40,19,21,63,108,86,1,0,2022-2023,90.0,204.69314079422384,146.20938628158845
520,Shea Charles,NIR,DF,Manchester City,Premier League,18,2003,0.3,4,0,4,0,0,1,1,100.0,0,0,0,0,1,5,2,0,0,2022-2023,90.0,300.0,1200.0
521,Xavier Chavalerin,FRA,MF,Troyes,Ligue 1,31,1991,27.0,82,50,39,30,13,27,71,38.0,44,31,8,23,41,123,24,0,0,2022-2023,90.0,136.66666666666669,273.33333333333337
522,Pep Chavarría,ESP,"FW,MF",Rayo Vallecano,La Liga,24,1998,4.1,6,4,2,1,3,1,5,20.0,4,8,0,8,2,8,8,0,0,2022-2023,90.0,43.90243902439025,131.70731707317074
523,Ivane Chegra,FRA,"MF,FW",Ajaccio,Ligue 1,18,2004,2.1,8,3,6,1,1,4,11,36.4,7,0,0,0,1,9,0,0,0,2022-2023,90.0,42.857142857142854,342.85714285714283
524,Pape Cheikh Diop,SEN,MF,Elche,La Liga,24,1997,0.4,0,0,0,0,0,0,1,0.0,1,0,0,0,0,0,0,0,0,2022-2023,90.0,0.0,0.0
525,Rayan Cherki,FRA,"MF,FW",Lyon,Ligue 1,18,2003,20.8,14,8,2,5,7,8,23,34.8,15,6,0,6,5,19,1,0,0,2022-2023,90.0,21.634615384615383,60.57692307692307
Rk,Player,Nation,Pos,Squad,Comp,0,0,90.0,0,0,3,3,3,Tkl,0,0.0,0,0,0,0,0,0,0,0,0,2022-2023,90.0,0.0,0.0
526,Ilyes Cheti,ALG,DF,Angers,Ligue 1,27,1995,2.3,6,4,4,0,2,5,8,62.5,3,5,1,4,4,10,7,0,0,2022-2023,90.0,156.52173913043478,234.7826086956522
527,Lucas Chevalier,FRA,GK,Lille,Ligue 1,20,2001,32.0,2,1,2,0,0,2,2,100.0,0,1,0,1,2,4,7,2,0,2022-2023,90.0,5.625,5.625
528,Fabio Chiarodia,ITA,DF,Werder Bremen,Bundesliga,17,2005,0.7,0,0,0,0,0,0,0,0.0,0,1,0,1,2,2,4,0,0,2022-2023,90.0,257.14285714285717,0.0
529,Federico Chiesa,ITA,"DF,MF",Juventus,Serie A,24,1997,9.5,22,11,6,6,10,5,14,35.7,9,13,1,12,0,22,1,0,0,2022-2023,90.0,0.0,208.42105263157896
530,Ben Chilwell,ENG,"DF,MF",Chelsea,Premier League,25,1996,15.6,21,17,12,8,1,13,25,52.0,12,21,2,19,18,39,26,0,0,2022-2023,90.0,103.84615384615384,121.15384615384615
531,Vlad Chiricheș,ROU,DF,Cremonese,Serie A,32,1989,10.9,35,20,27,7,1,16,24,66.7,8,36,23,13,22,57,44,0,0,2022-2023,90.0,181.65137614678898,288.9908256880734
532,Pedro Chirivella,ESP,MF,Nantes,Ligue 1,25,1997,22.5,33,22,12,15,6,17,44,38.6,27,24,1,23,20,53,7,0,0,2022-2023,90.0,80.0,132.0
533,Joris Chotard,FRA,MF,Montpellier,Ligue 1,20,2001,27.3,64,34,37,23,4,40,78,51.3,38,40,11,29,40,104,42,1,0,2022-2023,90.0,131.86813186813185,210.98901098901098
534,Andreas Christensen,DEN,DF,Barcelona,La Liga,26,1996,19.6,20,15,9,11,0,10,16,62.5,6,14,12,2,21,41,47,0,0,2022-2023,90.0,96.42857142857142,91.83673469387755
535,Oliver Christensen,DEN,GK,Hertha BSC,Bundesliga,23,1999,33.0,1,0,1,0,0,0,2,0.0,2,0,0,0,0,1,22,2,0,2022-2023,90.0,0.0,2.7272727272727275
536,Ryan Christie,SCO,"MF,FW",Bournemouth,Premier League,27,1995,20.4,34,22,10,23,1,14,50,28.0,36,16,4,12,26,60,20,0,0,2022-2023,90.0,114.70588235294119,150.0
537,Carney Chukwuemeka,ENG,"MF,FW",Chelsea,Premier League,18,2003,3.9,13,7,7,6,0,3,5,60.0,2,7,0,7,6,19,1,0,0,2022-2023,90.0,138.46153846153845,300.0
538,Samuel Chukwueze,NGA,"FW,MF",Villarreal,La Liga,23,1999,26.0,14,7,7,2,5,7,23,30.4,16,13,0,13,12,26,16,0,0,2022-2023,90.00000000000001,41.53846153846154,48.46153846153847
539,Chumi,ESP,DF,Almería,La Liga,23,1999,16.5,29,16,18,9,2,14,23,60.9,9,20,7,13,15,44,53,0,0,2022-2023,90.0,81.81818181818183,158.1818181818182
540,Darko Churlinov,MKD,FW,Stuttgart,Bundesliga,22,2000,0.3,3,2,2,1,0,2,3,66.7,1,1,0,1,0,3,0,0,0,2022-2023,90.0,0.0,900.0000000000001
541,Víctor Chust,ESP,DF,Cádiz,La Liga,22,2000,10.7,9,6,7,2,0,4,7,57.1,3,8,3,5,10,19,53,0,0,2022-2023,90.0,84.11214953271029,75.70093457943926
542,Tolga Ciğerci,TUR,MF,Hertha BSC,Bundesliga,30,1992,7.5,16,13,6,9,1,10,16,62.5,6,6,2,4,8,24,5,0,0,2022-2023,90.0,96.0,192.0
543,Yanis Cimignani,FRA,"MF,DF",Ajaccio,Ligue 1,20,2002,3.1,11,5,3,7,1,4,5,80.0,1,5,1,4,2,13,2,0,0,2022-2023,90.0,58.064516129032256,319.35483870967744
544,Daniel Ciofani,ITA,FW,Cremonese,Serie A,37,1985,11.8,6,3,1,2,3,4,7,57.1,3,7,1,6,2,8,10,0,0,2022-2023,90.0,15.254237288135592,45.762711864406775
545,Tio Cipot,SVN,"FW,MF",Spezia,Serie A,19,2003,1.5,12,7,6,3,3,6,8,75.0,2,0,0,0,0,12,2,0,0,2022-2023,90.0,0.0,720.0
546,Pathé Ciss,SEN,"MF,DF",Rayo Vallecano,La Liga,28,1994,14.2,39,29,11,23,5,15,34,44.1,19,23,10,13,22,61,34,0,0,2022-2023,90.0,139.43661971830986,247.1830985915493
547,Souleymane Cissé,FRA,DF,Clermont Foot,Ligue 1,19,2002,0.4,1,1,1,0,0,1,1,100.0,0,1,1,0,1,2,2,0,0,2022-2023,90.0,225.0,225.0
548,Patrick Ciurria,ITA,"DF,MF",Monza,Serie A,27,1995,30.6,31,18,20,10,1,17,33,51.5,16,24,2,22,7,38,32,0,0,2022-2023,90.0,20.588235294117645,91.17647058823529
549,Bobby Clark,ENG,MF,Liverpool,Premier League,17,2005,0.1,0,0,0,0,0,0,0,0.0,0,2,0,2,0,0,0,0,0,2022-2023,90.0,0.0,0.0
550,Alexis Claude-Maurice,FRA,FW,Nice,Ligue 1,24,1998,0.7,3,2,2,1,0,3,3,100.0,0,0,0,0,2,5,1,0,0,2022-2023,90.0,257.14285714285717,385.7142857142857
Rk,Player,Nation,Pos,Squad,Comp,0,0,90.0,0,0,3,3,3,Tkl,0,0.0,0,0,0,0,0,0,0,0,0,2022-2023,90.0,0.0,0.0
551,Alexis Claude-Maurice,FRA,"MF,FW",Lens,Ligue 1,24,1998,6.7,14,9,5,8,1,6,16,37.5,10,6,0,6,2,16,1,0,0,2022-2023,90.0,26.865671641791042,188.0597014925373
552,Jonathan Clauss,FRA,DF,Marseille,Ligue 1,29,1992,28.8,46,28,21,16,9,23,52,44.2,29,29,4,25,31,77,40,2,0,2022-2023,90.0,96.875,143.75
553,Carlos Clerc,ESP,"DF,MF",Elche,La Liga,30,1992,29.3,75,51,55,16,4,31,50,62.0,19,29,7,22,28,103,94,1,0,2022-2023,90.0,86.00682593856655,230.37542662116041
554,Nathaniel Clyne,ENG,DF,Crystal Palace,Premier League,31,1991,18.2,27,16,13,9,5,14,23,60.9,9,22,4,18,19,46,34,0,0,2022-2023,90.0,93.95604395604396,133.5164835164835
555,Conor Coady,ENG,DF,Everton,Premier League,29,1993,23.3,14,9,8,6,0,7,15,46.7,8,21,17,4,14,28,88,3,0,2022-2023,90.0,54.07725321888412,54.07725321888412
556,Nicolò Cocetta,ITA,DF,Udinese,Serie A,18,2003,0.4,0,0,0,0,0,0,1,0.0,1,1,1,0,1,1,1,0,0,2022-2023,90.0,225.0,0.0
557,Marcus Coco,FRA,"FW,MF",Nantes,Ligue 1,26,1996,7.1,24,15,11,9,4,11,23,47.8,12,13,3,10,14,38,7,0,0,2022-2023,90.0,177.46478873239437,304.2253521126761
558,Alexandre Coeff,FRA,DF,Auxerre,Ligue 1,30,1992,6.5,10,5,6,4,0,4,9,44.4,5,9,4,5,8,18,35,1,0,2022-2023,90.00000000000001,110.76923076923077,138.46153846153848
559,Jack Colback,ENG,MF,Nott'ham Forest,Premier League,32,1989,5.5,18,13,12,6,0,5,8,62.5,3,3,0,3,3,21,9,0,0,2022-2023,90.0,49.09090909090909,294.54545454545456
560,Séamus Coleman,IRL,DF,Everton,Premier League,33,1988,18.4,35,26,21,10,4,19,29,65.5,10,14,7,7,22,57,58,2,0,2022-2023,90.0,107.60869565217392,171.19565217391306
561,David Čolina,CRO,"DF,FW",Augsburg,Bundesliga,22,2000,1.8,4,1,1,1,2,2,2,100.0,0,8,0,8,4,8,3,0,0,2022-2023,90.0,200.0,200.0
562,Álex Collado,ESP,MF,Elche,La Liga,23,1999,8.1,26,14,13,11,2,8,13,61.5,5,12,1,11,2,28,4,0,0,2022-2023,90.0,22.22222222222222,288.8888888888889
563,Diego Collado,ESP,FW,Villarreal,La Liga,21,2001,0.1,0,0,0,0,0,0,0,0.0,0,0,0,0,0,0,0,0,0,2022-2023,90.0,0.0,0.0
564,Omar Colley,GAM,DF,Sampdoria,Serie A,29,1992,15.4,17,10,10,7,0,9,12,75.0,3,9,5,4,22,39,69,1,0,2022-2023,90.0,128.57142857142858,99.35064935064935
565,Nathan Collins,IRL,DF,Wolves,Premier League,21,2001,20.2,27,15,19,8,0,15,24,62.5,9,35,28,7,21,48,84,0,0,2022-2023,90.0,93.56435643564356,120.29702970297029
566,Lorenzo Colombo,ITA,FW,Lecce,Serie A,20,2002,16.8,17,9,1,9,7,6,14,42.9,8,22,0,22,2,19,7,0,0,2022-2023,90.0,10.714285714285714,91.07142857142857
567,Andrea Colpani,ITA,MF,Monza,Serie A,23,1999,10.5,14,9,6,5,3,8,12,66.7,4,14,2,12,3,17,6,0,0,2022-2023,90.0,25.714285714285715,120.0
568,Levi Colwill,ENG,DF,Brighton,Premier League,19,2003,13.6,8,7,4,4,0,4,9,44.4,5,5,3,2,15,23,37,1,0,2022-2023,90.0,99.26470588235294,52.94117647058823
569,Kingsley Coman,FRA,"FW,MF",Bayern Munich,Bundesliga,26,1996,15.7,11,8,3,5,3,7,17,41.2,10,19,1,18,2,13,7,0,0,2022-2023,90.0,11.464968152866243,63.05732484076434
570,Eray Cömert,SUI,DF,Valencia,La Liga,24,1998,18.6,35,23,24,10,1,17,33,51.5,16,23,8,15,29,64,76,1,0,2022-2023,90.0,140.32258064516128,169.3548387096774
571,Santi Comesaña,ESP,MF,Rayo Vallecano,La Liga,25,1996,27.2,71,44,24,41,6,38,82,46.3,44,39,3,36,32,103,17,0,0,2022-2023,90.0,105.88235294117646,234.9264705882353
572,Andrea Consigli,ITA,GK,Sassuolo,Serie A,35,1987,35.0,1,0,1,0,0,0,1,0.0,1,0,0,0,0,1,13,3,0,2022-2023,90.0,0.0,2.571428571428571
573,Abdu Conté,POR,DF,Troyes,Ligue 1,24,1998,14.6,25,17,14,8,3,12,22,54.5,10,13,6,7,6,31,25,0,0,2022-2023,90.0,36.986301369863014,154.1095890410959
574,Andrea Conti,ITA,DF,Sampdoria,Serie A,28,1994,0.3,0,0,0,0,0,0,0,0.0,0,0,0,0,0,0,0,0,0,2022-2023,90.0,0.0,0.0
575,Lewis Cook,ENG,MF,Bournemouth,Premier League,25,1997,19.1,37,22,10,22,5,18,44,40.9,26,29,10,19,23,60,31,0,0,2022-2023,90.0,108.37696335078533,174.3455497382199
Rk,Player,Nation,Pos,Squad,Comp,0,0,90.0,0,0,3,3,3,Tkl,0,0.0,0,0,0,0,0,0,0,0,0,2022-2023,90.0,0.0,0.0
576,Steve Cook,ENG,DF,Nott'ham Forest,Premier League,31,1991,10.6,8,4,4,4,0,5,7,71.4,2,16,11,5,12,20,51,0,0,2022-2023,90.0,101.88679245283019,67.9245283018868
577,Liam Cooper,SCO,DF,Leeds United,Premier League,30,1991,15.8,38,23,27,9,2,23,36,63.9,13,16,8,8,34,72,57,3,0,2022-2023,90.0,193.67088607594934,216.4556962025316
578,Copete,ESP,DF,Mallorca,La Liga,22,1999,24.5,53,28,35,16,2,26,36,72.2,10,38,17,21,44,97,111,2,0,2022-2023,90.00000000000001,161.63265306122452,194.69387755102042
579,Diego Coppola,ITA,DF,Hellas Verona,Serie A,18,2003,13.1,25,17,15,10,0,11,24,45.8,13,20,6,14,14,39,38,0,0,2022-2023,90.0,96.18320610687023,171.7557251908397
580,Francis Coquelin,FRA,MF,Villarreal,La Liga,31,1991,8.3,18,13,7,9,2,7,7,100.0,0,8,2,6,9,27,7,0,0,2022-2023,90.0,97.59036144578312,195.18072289156623
581,Sébastien Corchia,FRA,DF,Nantes,Ligue 1,31,1990,8.7,16,6,10,2,4,11,22,50.0,11,9,3,6,14,30,21,0,0,2022-2023,90.0,144.82758620689654,165.51724137931035
582,Alex Cordaz,ITA,GK,Inter,Serie A,39,1983,0.3,0,0,0,0,0,0,0,0.0,0,0,0,0,0,0,0,0,0,2022-2023,90.0,0.0,0.0
583,Maxwel Cornet,CIV,FW,West Ham,Premier League,25,1996,2.7,7,3,5,0,2,4,6,66.7,2,6,0,6,2,9,3,0,0,2022-2023,90.0,66.66666666666666,233.33333333333331
584,Jesús Corona,MEX,FW,Sevilla,La Liga,29,1993,1.2,1,0,1,0,0,0,1,0.0,1,0,0,0,1,2,1,0,0,2022-2023,90.0,75.0,75.0
585,Ángel Correa,ARG,"FW,MF",Atlético Madrid,La Liga,27,1995,16.2,12,6,6,3,3,5,16,31.3,11,17,0,17,10,22,6,1,0,2022-2023,90.0,55.55555555555556,66.66666666666667
586,Joaquín Correa,ARG,FW,Inter,Serie A,27,1994,10.6,12,7,3,6,3,4,15,26.7,11,4,1,3,3,15,0,0,0,2022-2023,90.0,25.471698113207548,101.88679245283019
587,Thierry Correia,POR,DF,Valencia,La Liga,23,1999,22.3,71,52,46,22,3,31,54,57.4,23,25,2,23,24,95,54,2,0,2022-2023,90.0,96.86098654708519,286.5470852017937
588,Alessandro Cortinovis,ITA,MF,Hellas Verona,Serie A,21,2001,0.1,1,0,1,0,0,0,0,0.0,0,1,0,1,0,1,0,0,0,2022-2023,90.0,0.0,900.0
589,Danny da Costa,GER,DF,Mainz 05,Bundesliga,29,1993,13.7,20,16,7,8,5,12,20,60.0,8,22,3,19,9,29,26,0,0,2022-2023,90.0,59.12408759124089,131.38686131386862
590,David Pereira da Costa,POR,"MF,FW",Lens,Ligue 1,21,2001,15.6,13,7,1,10,2,7,19,36.8,12,19,1,18,11,24,6,0,0,2022-2023,90.0,63.46153846153846,75.0
591,Diego Costa,ESP,FW,Wolves,Premier League,33,1988,13.8,3,1,3,0,0,2,9,22.2,7,6,1,5,2,5,17,0,0,2022-2023,90.0,13.043478260869565,19.565217391304344
592,Jaume Costa,ESP,DF,Mallorca,La Liga,34,1988,28.9,50,34,26,17,7,29,51,56.9,22,13,5,8,22,72,44,1,0,2022-2023,90.00000000000001,68.51211072664361,155.70934256055367
593,Logan Costa,CPV,DF,Toulouse,Ligue 1,21,2001,4.6,9,4,7,1,1,6,9,66.7,3,6,3,3,4,13,12,0,0,2022-2023,90.0,78.26086956521739,176.08695652173915
594,Nuno da Costa,CPV,"FW,MF",Auxerre,Ligue 1,31,1991,22.3,45,23,14,23,8,11,46,23.9,35,21,1,20,20,65,15,0,0,2022-2023,90.0,80.71748878923766,181.61434977578475
595,Samu Costa,POR,MF,Almería,La Liga,21,2000,22.1,61,31,35,20,6,29,61,47.5,32,29,7,22,37,98,64,4,0,2022-2023,90.0,150.6787330316742,248.41628959276017
596,Benoît Costil,FRA,GK,Auxerre,Ligue 1,35,1987,19.0,2,0,2,0,0,2,4,50.0,2,0,0,0,0,2,5,0,0,2022-2023,90.0,0.0,9.473684210526315
597,Vladimír Coufal,CZE,DF,West Ham,Premier League,29,1992,23.7,58,31,37,15,6,36,51,70.6,15,24,6,18,38,96,70,0,0,2022-2023,90.0,144.30379746835445,220.25316455696205
598,Lassana Coulibaly,MLI,MF,Salernitana,Serie A,26,1996,32.1,84,50,42,35,7,30,73,41.1,43,35,7,28,25,109,33,2,0,2022-2023,90.0,70.09345794392523,235.51401869158877
599,Soumaïla Coulibaly,FRA,DF,Dortmund,Bundesliga,18,2003,0.5,0,0,0,0,0,0,0,0.0,0,0,0,0,0,0,0,1,0,2022-2023,90.0,0.0,0.0
600,Tanguy Coulibaly,FRA,"FW,DF",Stuttgart,Bundesliga,21,2001,3.6,12,9,9,1,2,5,12,41.7,7,10,0,10,3,15,0,0,0,2022-2023,90.0,75.0,300.0
Rk,Player,Nation,Pos,Squad,Comp,0,0,90.0,0,0,3,3,3,Tkl,0,0.0,0,0,0,0,0,0,0,0,0,2022-2023,90.0,0.0,0.0
601,Thibaut Courtois,BEL,GK,Real Madrid,La Liga,30,1992,31.0,1,0,1,0,0,1,1,100.0,0,0,0,0,3,4,7,1,0,2022-2023,90.0,8.709677419354838,2.903225806451613
602,Mathieu Coutadeur,FRA,MF,Ajaccio,Ligue 1,36,1986,21.6,23,13,13,10,0,8,28,28.6,20,19,3,16,19,42,21,0,0,2022-2023,90.0,79.16666666666666,95.83333333333333
603,Philippe Coutinho,BRA,"MF,FW",Aston Villa,Premier League,30,1992,8.8,19,14,8,8,3,9,15,60.0,6,11,1,10,4,23,2,0,0,2022-2023,90.0,40.90909090909091,194.3181818181818
604,Yan Couto,BRA,"DF,MF",Girona,La Liga,20,2002,12.9,25,18,11,11,3,12,20,60.0,8,7,2,5,5,30,10,0,0,2022-2023,90.0,34.883720930232556,174.41860465116278
605,Conor Coventry,IRL,"MF,FW",West Ham,Premier League,22,2000,0.0,0,0,0,0,0,0,0,0.0,0,0,0,0,0,0,0,0,0,2022-2023,,,
606,Nicolas Cozza,FRA,DF,Montpellier,Ligue 1,23,1999,14.2,38,21,27,9,2,26,38,68.4,12,11,5,6,21,59,35,1,0,2022-2023,90.0,133.09859154929578,240.84507042253523
607,Nicolas Cozza,FRA,DF,Wolfsburg,Bundesliga,23,1999,1.1,3,3,1,2,0,2,3,66.7,1,3,1,2,0,3,0,0,0,2022-2023,90.0,0.0,245.45454545454544
608,Alessio Cragno,ITA,GK,Monza,Serie A,28,1994,1.0,0,0,0,0,0,0,1,0.0,1,0,0,0,0,0,0,0,0,2022-2023,90.0,0.0,0.0
609,Matthew Craig,SCO,MF,Tottenham,Premier League,19,2003,0.2,4,1,2,2,0,0,0,0.0,0,0,0,0,0,4,0,0,0,2022-2023,90.0,0.0,1800.0
610,Aaron Cresswell,ENG,DF,West Ham,Premier League,32,1989,24.8,21,11,12,7,2,12,31,38.7,19,21,11,10,27,48,56,0,0,2022-2023,90.0,97.98387096774194,76.20967741935483
611,Bryan Cristante,ITA,"MF,DF",Roma,Serie A,27,1995,32.6,113,62,55,49,9,55,90,61.1,35,39,10,29,18,131,53,0,0,2022-2023,90.0,49.693251533742334,311.9631901840491
612,Domen Črnigoj,SVN,MF,Salernitana,Serie A,26,1995,3.3,8,3,0,7,1,1,2,50.0,1,9,1,8,9,17,6,0,0,2022-2023,90.0,245.45454545454547,218.1818181818182
613,Juan Cruz Armada,ESP,DF,Osasuna,La Liga,30,1992,22.9,24,14,17,4,3,13,23,56.5,10,21,8,13,13,37,58,0,0,2022-2023,90.0,51.091703056768566,94.3231441048035
614,Juan Cruz,ESP,FW,Betis,La Liga,22,2000,2.0,1,0,0,1,0,1,3,33.3,2,1,0,1,0,1,0,0,0,2022-2023,90.0,0.0,45.0
615,Juan Cuadrado,COL,"DF,FW",Juventus,Serie A,34,1988,23.1,50,34,34,13,3,27,65,41.5,38,15,2,13,24,74,32,0,0,2022-2023,89.99999999999999,93.50649350649348,194.80519480519476
616,Marc Cucurella,ESP,DF,Chelsea,Premier League,24,1998,18.6,66,33,40,15,11,30,60,50.0,30,28,8,20,16,82,48,1,0,2022-2023,90.0,77.41935483870967,319.3548387096774
617,Jorge Cuenca,ESP,DF,Villarreal,La Liga,22,1999,5.6,9,7,7,2,0,4,7,57.1,3,10,8,2,6,15,44,0,0,2022-2023,90.0,96.42857142857143,144.64285714285714
618,Braian Cufré,ARG,DF,Mallorca,La Liga,25,1996,2.4,5,2,2,1,2,2,5,40.0,3,2,1,1,2,7,1,0,0,2022-2023,90.0,75.0,187.5
619,Mickaël Cuisance,FRA,MF,Sampdoria,Serie A,22,1999,6.9,13,10,7,5,1,5,23,21.7,18,10,0,10,5,18,4,0,0,2022-2023,90.0,65.21739130434781,169.56521739130434
620,Matheus Cunha,BRA,FW,Wolves,Premier League,23,1999,10.7,7,4,0,5,2,2,10,20.0,8,15,3,12,9,16,11,0,0,2022-2023,90.0,75.70093457943926,58.8785046728972
621,Matheus Cunha,BRA,"FW,MF",Atlético Madrid,La Liga,23,1999,4.2,4,1,1,3,0,0,3,0.0,3,4,1,3,2,6,3,0,0,2022-2023,90.0,42.857142857142854,85.71428571428571
622,Curro,ESP,MF,Almería,La Liga,26,1996,0.5,2,0,1,1,0,1,2,50.0,1,0,0,0,0,2,0,0,0,2022-2023,90.0,0.0,360.0
623,Marco D'Alessandro,ITA,"DF,FW",Monza,Serie A,31,1991,3.2,4,4,3,1,0,2,5,40.0,3,2,0,2,1,5,3,0,0,2022-2023,90.0,28.125,112.5
624,Danilo D'Ambrosio,ITA,DF,Inter,Serie A,33,1988,8.1,25,17,17,7,1,15,27,55.6,12,12,4,8,10,35,17,0,0,2022-2023,90.0,111.11111111111111,277.77777777777777
625,Luca D'Andrea,ITA,FW,Sassuolo,Serie A,17,2004,3.5,4,0,2,1,1,1,4,25.0,3,2,0,2,1,5,1,0,0,2022-2023,90.0,25.714285714285715,102.85714285714286
Rk,Player,Nation,Pos,Squad,Comp,0,0,90.0,0,0,3,3,3,Tkl,0,0.0,0,0,0,0,0,0,0,0,0,2022-2023,90.0,0.0,0.0
626,Damien Da Silva,FRA,DF,Lyon,Ligue 1,34,1988,3.8,8,7,5,3,0,3,3,100.0,0,4,3,1,5,13,12,0,0,2022-2023,90.0,118.42105263157895,189.4736842105263
627,Moanes Dabbur,ISR,FW,Hoffenheim,Bundesliga,30,1992,10.4,11,8,4,5,2,3,9,33.3,6,8,0,8,5,16,0,0,0,2022-2023,90.0,43.26923076923077,95.19230769230768
628,Andréa Dacourt,FRA,MF,Nice,Ligue 1,17,2005,0.0,0,0,0,0,0,0,0,0.0,0,0,0,0,0,0,0,0,0,2022-2023,,,
629,Colin Dagba,FRA,"DF,MF",Strasbourg,Ligue 1,23,1998,10.6,32,20,17,10,5,19,26,73.1,7,18,2,16,17,49,19,0,0,2022-2023,90.0,144.33962264150944,271.6981132075472
630,Finn Dahmen,GER,GK,Mainz 05,Bundesliga,24,1998,8.0,0,0,0,0,0,0,0,0.0,0,0,0,0,0,0,3,0,0,2022-2023,90.0,0.0,0.0
631,Mahmoud Dahoud,GER,MF,Dortmund,Bundesliga,26,1996,3.7,11,9,3,4,4,7,7,100.0,0,6,2,4,7,18,3,0,0,2022-2023,90.0,170.27027027027026,267.56756756756755
632,Patson Daka,ZAM,FW,Leicester City,Premier League,23,1998,13.2,14,8,6,8,0,3,13,23.1,10,14,2,12,7,21,7,0,0,2022-2023,90.0,47.72727272727273,95.45454545454545
633,Thijs Dallinga,NED,FW,Toulouse,Ligue 1,21,2000,26.1,8,6,2,2,4,1,13,7.7,12,17,3,14,3,11,20,0,0,2022-2023,90.0,10.344827586206895,27.586206896551722
634,Diogo Dalot,POR,DF,Manchester Utd,Premier League,23,1999,23.9,54,41,40,13,1,33,45,73.3,12,25,7,18,37,91,55,2,0,2022-2023,90.0,139.3305439330544,203.34728033472805
635,Muhammed Damar,GER,MF,Hoffenheim,Bundesliga,18,2004,1.8,6,3,1,2,3,1,2,50.0,1,3,0,3,0,6,0,0,0,2022-2023,90.0,0.0,300.0
636,Mikkel Damsgaard,DEN,"MF,FW",Brentford,Premier League,22,2000,11.0,31,21,13,13,5,15,42,35.7,27,20,2,18,10,41,14,0,0,2022-2023,90.0,81.81818181818183,253.63636363636365
637,Flavius Daniliuc,AUT,DF,Salernitana,Serie A,21,2001,24.4,57,29,37,17,3,26,47,55.3,21,30,13,17,29,86,76,0,0,2022-2023,90.0,106.96721311475412,210.24590163934428
638,Flavius Daniliuc,AUT,DF,Nice,Ligue 1,21,2001,1.0,2,0,2,0,0,1,1,100.0,0,4,1,3,0,2,1,0,0,2022-2023,90.0,0.0,180.0
639,Danilo,BRA,MF,Nott'ham Forest,Premier League,21,2001,10.8,18,7,7,9,2,6,25,24.0,19,26,6,20,9,27,19,0,0,2022-2023,90.0,75.0,150.0
640,Danilo,BRA,DF,Juventus,Serie A,31,1991,35.4,92,62,61,23,8,52,73,71.2,21,39,20,19,47,139,114,1,0,2022-2023,90.0,119.49152542372882,233.89830508474577
641,Arnaut Danjuma,NED,"FW,MF",Tottenham,Premier League,25,1997,1.9,2,0,1,1,0,0,0,0.0,0,1,0,1,0,2,0,0,0,2022-2023,90.0,0.0,94.73684210526315
642,Arnaut Danjuma,NED,FW,Villarreal,La Liga,25,1997,5.3,3,3,1,0,2,1,2,50.0,1,0,0,0,0,3,1,1,0,2022-2023,90.0,0.0,50.943396226415096
643,Kévin Danois,FRA,MF,Auxerre,Ligue 1,18,2004,0.0,1,1,0,1,0,0,0,0.0,0,0,0,0,1,2,0,0,0,2022-2023,,inf,inf
644,Kevin Danso,AUT,DF,Lens,Ligue 1,23,1998,35.9,37,19,25,11,1,19,30,63.3,11,48,34,14,33,70,124,0,0,2022-2023,90.0,82.72980501392759,92.75766016713092
645,Dante,BRA,DF,Nice,Ligue 1,38,1983,36.7,70,40,45,21,4,36,59,61.0,23,52,31,21,47,117,125,2,0,2022-2023,90.0,115.25885558583106,171.66212534059946
646,Márton Dárdai,HUN,"DF,MF",Hertha BSC,Bundesliga,20,2002,10.5,17,8,9,8,0,9,18,50.0,9,14,9,5,11,28,45,1,0,2022-2023,90.0,94.28571428571428,145.71428571428572
647,Sergi Darder,ESP,MF,Espanyol,La Liga,28,1993,36.9,69,38,12,43,14,29,73,39.7,44,34,2,32,24,93,23,0,0,2022-2023,90.0,58.53658536585366,168.2926829268293
648,Achraf Dari,MAR,DF,Brest,Ligue 1,23,1999,14.6,21,14,15,5,1,14,20,70.0,6,16,10,6,19,40,65,2,0,2022-2023,90.0,117.12328767123289,129.45205479452056
649,Vladimír Darida,CZE,MF,Hertha BSC,Bundesliga,31,1990,0.3,1,1,0,1,0,0,0,0.0,0,1,0,1,0,1,0,0,0,2022-2023,90.0,0.0,300.0
650,Matteo Darmian,ITA,DF,Inter,Serie A,32,1989,22.5,56,30,29,15,12,31,47,66.0,16,33,5,28,21,77,36,0,0,2022-2023,90.0,84.0,224.0
Rk,Player,Nation,Pos,Squad,Comp,0,0,90.0,0,0,3,3,3,Tkl,0,0.0,0,0,0,0,0,0,0,0,0,2022-2023,90.0,0.0,0.0
651,Josh Dasilva,ENG,MF,Brentford,Premier League,23,1998,15.4,18,9,6,6,6,6,16,37.5,10,22,6,16,5,23,7,1,0,2022-2023,90.0,29.22077922077922,105.1948051948052
652,David Datro Fofana,CIV,FW,Chelsea,Premier League,19,2002,0.8,3,1,1,1,1,1,1,100.0,0,1,0,1,0,3,0,0,0,2022-2023,90.0,0.0,337.5
653,Juan David Cabal,COL,DF,Hellas Verona,Serie A,21,2001,4.9,10,6,7,3,0,7,12,58.3,5,8,5,3,13,23,12,0,0,2022-2023,90.0,238.77551020408163,183.6734693877551
654,Jonathan David,CAN,FW,Lille,Ligue 1,22,2000,35.2,24,17,6,11,7,10,27,37.0,17,20,2,18,8,32,13,0,0,2022-2023,90.0,20.454545454545453,61.36363636363636
655,Alphonso Davies,CAN,DF,Bayern Munich,Bundesliga,21,2000,22.7,45,28,25,13,7,18,39,46.2,21,28,4,24,24,69,24,4,0,2022-2023,89.99999999999999,95.15418502202643,178.41409691629954
656,Ben Davies,WAL,DF,Tottenham,Premier League,29,1993,25.4,28,11,13,13,2,14,26,53.8,12,17,8,9,18,46,72,0,0,2022-2023,90.0,63.77952755905512,99.21259842519686
657,Tom Davies,ENG,MF,Everton,Premier League,24,1998,6.0,15,9,5,9,1,7,14,50.0,7,10,1,9,4,19,7,1,0,2022-2023,90.0,60.0,225.0
658,Paweł Dawidowicz,POL,DF,Hellas Verona,Serie A,27,1995,18.1,48,31,28,17,3,22,31,71.0,9,14,9,5,23,71,71,0,0,2022-2023,90.0,114.36464088397788,238.67403314917124
659,Craig Dawson,ENG,DF,West Ham,Premier League,32,1990,8.0,11,7,9,2,0,5,7,71.4,2,9,6,3,6,17,26,0,0,2022-2023,90.0,67.5,123.75
660,Craig Dawson,ENG,DF,Wolves,Premier League,32,1990,15.7,9,6,6,3,0,4,7,57.1,3,31,23,8,12,21,74,2,0,2022-2023,90.0,68.78980891719746,51.592356687898096
661,Kevin De Bruyne,BEL,MF,Manchester City,Premier League,31,1991,26.9,28,12,3,12,13,14,39,35.9,25,27,2,25,9,37,10,0,0,2022-2023,90.0,30.111524163568774,93.68029739776952
662,Charles De Ketelaere,BEL,"MF,FW",Milan,Serie A,21,2001,12.4,26,12,7,14,5,13,30,43.3,17,14,2,12,4,30,9,0,0,2022-2023,90.0,29.032258064516128,188.70967741935485
663,Manuel De Luca,ITA,"FW,MF",Sampdoria,Serie A,24,1998,0.5,0,0,0,0,0,0,0,0.0,0,0,0,0,0,0,0,0,0,2022-2023,90.0,0.0,0.0
664,Tommaso De Nipoti,ITA,MF,Atalanta,Serie A,19,2003,0.0,1,0,0,1,0,0,0,0.0,0,0,0,0,0,1,0,0,0,2022-2023,,,inf
665,Rodrigo De Paul,ARG,MF,Atlético Madrid,La Liga,28,1994,21.4,35,21,11,18,6,18,35,51.4,17,20,3,17,8,43,7,0,0,2022-2023,90.0,33.64485981308412,147.196261682243
666,Mattia De Sciglio,ITA,DF,Juventus,Serie A,29,1992,11.6,14,7,8,3,3,9,14,64.3,5,9,3,6,4,18,20,0,0,2022-2023,90.0,31.03448275862069,108.62068965517241
667,Lorenzo De Silvestri,ITA,DF,Bologna,Serie A,34,1988,7.5,3,2,2,0,1,3,7,42.9,4,6,5,1,3,6,20,0,0,2022-2023,90.0,36.0,36.0
668,Thibault De Smet,BEL,DF,Reims,Ligue 1,24,1998,19.5,24,17,10,14,0,11,37,29.7,26,28,5,23,20,44,40,1,0,2022-2023,90.0,92.3076923076923,110.76923076923076
669,Koni De Winter,BEL,DF,Empoli,Serie A,20,2002,11.4,14,9,11,3,0,5,13,38.5,8,14,12,2,6,20,65,0,0,2022-2023,90.0,47.368421052631575,110.52631578947367
670,Grégoire Defrel,MTQ,FW,Sassuolo,Serie A,31,1991,13.0,9,7,5,2,2,4,13,30.8,9,11,0,11,2,11,5,0,0,2022-2023,90.00000000000001,13.846153846153847,62.307692307692314
671,Duccio Degl'Innocenti,ITA,MF,Empoli,Serie A,19,2003,0.0,0,0,0,0,0,0,0,0.0,0,0,0,0,1,1,0,0,0,2022-2023,,inf,
672,Brecht Dejaegere,BEL,MF,Toulouse,Ligue 1,31,1991,20.1,40,23,10,20,10,15,51,29.4,36,25,5,20,14,54,11,0,0,2022-2023,90.0,62.686567164179095,179.10447761194027
673,Romain Del Castillo,FRA,"MF,FW",Brest,Ligue 1,26,1996,15.8,39,24,13,17,9,16,36,44.4,20,14,1,13,11,50,5,0,0,2022-2023,90.0,62.658227848101255,222.1518987341772
674,Alberto Del Moral,ESP,MF,Villarreal,La Liga,22,2000,0.1,0,0,0,0,0,0,0,0.0,0,0,0,0,0,0,0,0,0,2022-2023,90.0,0.0,0.0
675,Thomas Delaine,FRA,"DF,MF",Strasbourg,Ligue 1,30,1992,11.9,28,14,16,6,6,13,26,50.0,13,8,3,5,16,44,9,0,0,2022-2023,90.00000000000001,121.00840336134455,211.76470588235296
Rk,Player,Nation,Pos,Squad,Comp,0,0,90.0,0,0,3,3,3,Tkl,0,0.0,0,0,0,0,0,0,0,0,0,2022-2023,90.0,0.0,0.0
676,Thomas Delaney,DEN,MF,Sevilla,La Liga,30,1991,3.4,4,2,0,4,0,3,5,60.0,2,3,2,1,4,8,3,0,0,2022-2023,90.0,105.88235294117646,105.88235294117646
677,Thomas Delaney,DEN,MF,Hoffenheim,Bundesliga,30,1991,3.3,6,3,3,2,1,3,8,37.5,5,5,0,5,1,7,4,0,0,2022-2023,90.0,27.272727272727273,163.63636363636363
678,Sacha Delaye,FRA,"FW,MF",Montpellier,Ligue 1,20,2002,0.2,1,0,0,0,1,1,1,100.0,0,0,0,0,0,1,0,0,0,2022-2023,90.0,0.0,450.0
679,Fran Delgado,ESP,DF,Betis,La Liga,21,2001,0.1,0,0,0,0,0,0,0,0.0,0,0,0,0,0,0,0,0,0,2022-2023,90.0,0.0,0.0
680,Andy Delort,ALG,FW,Nice,Ligue 1,30,1991,8.7,2,0,1,1,0,1,2,50.0,1,0,0,0,1,3,7,0,0,2022-2023,90.0,10.344827586206897,20.689655172413794
681,Andy Delort,ALG,FW,Nantes,Ligue 1,30,1991,5.2,5,4,1,2,2,2,6,33.3,4,3,0,3,0,5,2,0,0,2022-2023,90.0,0.0,86.53846153846153
682,Karamoko Dembélé,ENG,"FW,MF",Brest,Ligue 1,19,2003,2.0,2,0,1,1,0,2,2,100.0,0,1,0,1,1,3,0,0,0,2022-2023,90.0,45.0,90.0
683,Moussa Dembélé,FRA,"FW,MF",Lyon,Ligue 1,26,1996,9.7,8,4,3,3,2,4,7,57.1,3,5,0,5,2,10,6,0,0,2022-2023,90.0,18.556701030927837,74.22680412371135
684,Ousmane Dembélé,FRA,FW,Barcelona,La Liga,25,1997,15.7,19,12,4,8,7,4,15,26.7,11,10,1,9,0,19,2,0,0,2022-2023,90.0,0.0,108.9171974522293
685,Siriki Dembélé,CIV,"FW,MF",Bournemouth,Premier League,25,1996,1.2,3,1,2,1,0,0,1,0.0,1,1,0,1,1,4,1,0,0,2022-2023,90.0,75.0,225.00000000000003
686,Siriki Dembélé,CIV,"MF,FW",Auxerre,Ligue 1,25,1996,4.1,10,6,4,3,3,4,12,33.3,8,2,0,2,1,11,2,0,0,2022-2023,90.0,21.951219512195124,219.51219512195124
687,Merih Demiral,TUR,DF,Atalanta,Serie A,24,1998,17.1,41,29,30,11,0,26,36,72.2,10,24,7,17,24,65,57,1,0,2022-2023,90.0,126.3157894736842,215.78947368421052
688,Kerem Demirbay,GER,MF,Leverkusen,Bundesliga,29,1993,17.2,36,18,16,17,3,18,34,52.9,16,26,6,20,16,52,11,0,0,2022-2023,90.0,83.72093023255815,188.37209302325584
689,Ermedin Demirović,BIH,"FW,MF",Augsburg,Bundesliga,24,1998,26.3,31,14,9,12,10,9,22,40.9,13,31,4,27,14,45,37,0,0,2022-2023,90.0,47.90874524714829,106.08365019011407
690,Diego Demme,GER,MF,Napoli,Serie A,30,1991,1.6,1,0,1,0,0,0,4,0.0,4,2,0,2,0,1,1,0,0,2022-2023,90.0,0.0,56.25
691,Sepp van den Berg,NED,DF,Schalke 04,Bundesliga,20,2001,7.7,5,4,2,2,1,1,4,25.0,3,8,5,3,13,18,33,2,0,2022-2023,90.0,151.94805194805195,58.44155844155844
692,Branco van den Boomen,NED,MF,Toulouse,Ligue 1,27,1995,32.1,71,36,26,32,13,36,89,40.4,53,27,4,23,10,81,27,2,0,2022-2023,90.0,28.037383177570092,199.06542056074764
693,Leander Dendoncker,BEL,MF,Aston Villa,Premier League,27,1995,7.7,19,9,11,6,2,11,22,50.0,11,19,4,15,10,29,12,0,0,2022-2023,90.0,116.88311688311688,222.0779220779221
694,Leander Dendoncker,BEL,MF,Wolves,Premier League,27,1995,2.4,4,2,0,3,1,2,3,66.7,1,2,0,2,9,13,4,0,0,2022-2023,90.0,337.5,150.0
695,Emmanuel Dennis,NGA,"FW,MF",Nott'ham Forest,Premier League,24,1997,8.0,17,11,5,5,7,8,18,44.4,10,13,1,12,2,19,6,0,0,2022-2023,90.0,22.5,191.25
696,Fabio Depaoli,ITA,DF,Hellas Verona,Serie A,25,1997,24.1,48,28,25,16,7,25,44,56.8,19,32,6,26,18,66,33,3,0,2022-2023,90.0,67.21991701244814,179.253112033195
697,Fabio Depaoli,ITA,"DF,MF",Sampdoria,Serie A,25,1997,1.5,5,3,2,3,0,3,4,75.0,1,1,0,1,1,6,4,0,0,2022-2023,90.0,60.0,300.0
698,Kastriot Dermaku,ALB,DF,Lecce,Serie A,30,1992,0.4,0,0,0,0,0,0,0,0.0,0,0,0,0,0,0,0,0,0,2022-2023,90.0,0.0,0.0
699,Halil Dervişoğlu,TUR,MF,Brentford,Premier League,22,1999,0.1,0,0,0,0,0,0,1,0.0,1,0,0,0,0,0,0,0,0,2022-2023,90.0,0.0,0.0
700,Rémy Descamps,FRA,GK,Nantes,Ligue 1,26,1996,1.0,0,0,0,0,0,0,0,0.0,0,0,0,0,0,0,0,0,0,2022-2023,90.0,0.0,0.0
Rk,Player,Nation,Pos,Squad,Comp,0,0,90.0,0,0,3,3,3,Tkl,0,0.0,0,0,0,0,0,0,0,0,0,2022-2023,90.0,0.0,0.0
701,Mikkel Desler,DEN,DF,Toulouse,Ligue 1,27,1995,25.1,71,38,36,27,8,43,67,64.2,24,35,6,29,36,107,48,2,0,2022-2023,90.0,129.0836653386454,254.5816733067729
702,Cyriel Dessers,NGA,FW,Cremonese,Serie A,27,1994,17.6,11,4,4,4,3,2,6,33.3,4,14,2,12,3,14,5,0,0,2022-2023,90.0,15.34090909090909,56.25
703,Sergiño Dest,USA,DF,Milan,Serie A,21,2000,3.7,12,6,3,5,4,3,4,75.0,1,1,0,1,4,16,2,0,0,2022-2023,90.0,97.29729729729729,291.8918918918919
704,Mattia Destro,ITA,"FW,MF",Empoli,Serie A,31,1991,6.4,1,1,0,1,0,0,0,0.0,0,2,0,2,1,2,5,0,0,2022-2023,90.0,14.0625,14.0625
705,Gerard Deulofeu,ESP,FW,Udinese,Serie A,28,1994,13.5,8,5,5,1,2,5,15,33.3,10,8,1,7,2,10,1,0,0,2022-2023,90.0,13.333333333333334,53.333333333333336
706,Kiernan Dewsbury-Hall,ENG,MF,Leicester City,Premier League,23,1998,25.6,53,29,14,34,5,19,47,40.4,28,55,13,42,28,81,21,0,0,2022-2023,90.0,98.4375,186.328125
707,Samuel Di Carmine,ITA,"FW,MF",Cremonese,Serie A,33,1988,0.3,0,0,0,0,0,0,0,0.0,0,0,0,0,0,0,0,0,0,2022-2023,90.0,0.0,0.0
708,Federico Di Francesco,ITA,"FW,MF",Lecce,Serie A,28,1994,22.6,28,16,7,11,10,9,19,47.4,10,16,0,16,8,36,14,0,0,2022-2023,90.0,31.858407079646017,111.50442477876106
709,Michele Di Gregorio,ITA,GK,Monza,Serie A,25,1997,37.0,0,0,0,0,0,0,3,0.0,3,1,0,1,4,4,18,3,0,2022-2023,90.0,9.72972972972973,0.0
710,Giovanni Di Lorenzo,ITA,DF,Napoli,Serie A,28,1993,36.2,60,29,33,19,8,25,49,51.0,24,30,9,21,30,90,60,0,0,2022-2023,90.0,74.58563535911601,149.17127071823202
711,Ángel Di María,ARG,"FW,MF",Juventus,Serie A,34,1988,15.1,10,5,3,5,2,3,19,15.8,16,15,0,15,7,17,0,0,0,2022-2023,90.0,41.72185430463576,59.60264900662252
712,Boulaye Dia,SEN,"FW,MF",Salernitana,Serie A,25,1996,28.0,12,5,3,6,3,2,7,28.6,5,10,0,10,7,19,27,1,0,2022-2023,90.0,22.5,38.57142857142857
713,Moussa Diaby,FRA,"FW,MF",Leverkusen,Bundesliga,23,1999,30.0,14,8,4,8,2,7,14,50.0,7,8,0,8,5,19,3,0,0,2022-2023,90.0,15.0,42.0
714,Mouctar Diakhaby,GUI,DF,Valencia,La Liga,25,1996,27.2,30,16,19,11,0,13,20,65.0,7,30,17,13,20,50,111,2,0,2022-2023,90.0,66.17647058823529,99.26470588235294
715,Mamadou Diakhon,FRA,FW,Reims,Ligue 1,16,2005,0.2,2,0,2,0,0,0,1,0.0,1,1,0,1,1,3,0,0,0,2022-2023,90.0,450.0,900.0
716,Bafodé Diakité,FRA,DF,Lille,Ligue 1,21,2001,29.5,54,35,23,24,7,32,57,56.1,25,37,8,29,17,71,58,0,0,2022-2023,90.0,51.86440677966102,164.74576271186442
717,Ibrahim Diakité,GUI,DF,Reims,Ligue 1,18,2003,1.5,3,3,3,0,0,2,3,66.7,1,0,0,0,5,8,6,0,0,2022-2023,90.0,300.0,180.0
718,Abdou Diallo,SEN,"DF,MF",RB Leipzig,Bundesliga,26,1996,5.3,6,5,5,1,0,1,3,33.3,2,8,5,3,8,14,22,0,0,2022-2023,90.0,135.8490566037736,101.88679245283019
719,Baila Diallo,FRA,"DF,MF",Clermont Foot,Ligue 1,21,2001,1.0,1,0,1,0,0,0,0,0.0,0,1,1,0,0,1,1,0,0,2022-2023,90.0,0.0,90.0
720,Habib Diallo,SEN,FW,Strasbourg,Ligue 1,27,1995,32.0,18,10,8,7,3,6,16,37.5,10,19,4,15,12,30,26,0,0,2022-2023,90.0,33.75,50.625
721,Ibrahima Diallo,FRA,MF,Southampton,Premier League,23,1999,9.1,25,15,14,10,1,8,14,57.1,6,11,1,10,6,31,11,0,0,2022-2023,90.0,59.34065934065934,247.25274725274727
722,Ismael Diallo,CIV,DF,Ajaccio,Ligue 1,25,1997,24.2,46,33,35,9,2,35,63,55.6,28,26,12,14,30,76,46,1,0,2022-2023,90.0,111.57024793388429,171.07438016528926
723,Habib Diarra,SEN,"MF,FW",Strasbourg,Ligue 1,18,2004,18.1,24,16,10,11,3,15,29,51.7,14,17,1,16,11,35,13,0,0,2022-2023,90.0,54.696132596685075,119.33701657458562
724,Mamady Diarra,MLI,"MF,DF",Cádiz,La Liga,22,2000,0.7,2,1,2,0,0,1,2,50.0,1,2,0,2,0,2,0,0,0,2022-2023,90.0,0.0,257.14285714285717
725,Moussa Diarra,MLI,DF,Toulouse,Ligue 1,21,2000,13.6,20,9,9,9,2,9,15,60.0,6,25,10,15,19,39,27,1,0,2022-2023,90.0,125.73529411764706,132.35294117647058
Rk,Player,Nation,Pos,Squad,Comp,0,0,90.0,0,0,3,3,3,Tkl,0,0.0,0,0,0,0,0,0,0,0,0,2022-2023,90.0,0.0,0.0
726,Stéphane Diarra,FRA,"FW,MF",Lorient,Ligue 1,23,1998,11.8,25,17,14,9,2,11,29,37.9,18,13,1,12,22,47,9,0,0,2022-2023,90.0,167.79661016949152,190.6779661016949
727,Youba Diarra,MLI,MF,Cádiz,La Liga,24,1998,1.1,3,0,2,1,0,1,5,20.0,4,7,1,6,2,5,3,0,0,2022-2023,90.0,163.63636363636363,245.45454545454544
728,Rúben Dias,POR,DF,Manchester City,Premier League,25,1997,22.2,21,13,10,10,1,11,18,61.1,7,21,13,8,18,39,56,1,0,2022-2023,90.0,72.97297297297298,85.13513513513514
729,Krépin Diatta,SEN,"MF,FW",Monaco,Ligue 1,23,1999,23.0,30,21,4,17,9,13,32,40.6,19,29,1,28,17,47,12,0,0,2022-2023,90.0,66.52173913043478,117.3913043478261
730,Mory Diaw,SEN,GK,Clermont Foot,Ligue 1,29,1993,37.0,0,0,0,0,0,0,4,0.0,4,0,0,0,2,2,13,5,0,2022-2023,90.0,4.864864864864865,0.0
731,Brahim Díaz,MAR,"MF,FW",Milan,Serie A,22,1999,21.4,32,15,5,22,5,5,15,33.3,10,11,0,11,7,39,6,0,0,2022-2023,90.0,29.4392523364486,134.57943925233647
732,Luis Díaz,COL,FW,Liverpool,Premier League,25,1997,11.1,17,11,4,8,5,8,15,53.3,7,8,0,8,6,23,2,0,0,2022-2023,90.0,48.64864864864865,137.83783783783784
733,Justin Diehl,GER,"MF,FW",Köln,Bundesliga,17,2004,0.2,0,0,0,0,0,0,0,0.0,0,0,0,0,0,0,0,0,0,2022-2023,90.0,0.0,0.0
734,Bamba Dieng,SEN,"FW,MF",Marseille,Ligue 1,22,2000,2.2,4,4,2,1,1,3,4,75.0,1,5,1,4,0,4,0,0,0,2022-2023,90.0,0.0,163.63636363636363
735,Bamba Dieng,SEN,FW,Lorient,Ligue 1,22,2000,8.3,19,10,5,12,2,3,11,27.3,8,6,0,6,2,21,6,0,0,2022-2023,90.0,21.686746987951803,206.02409638554215
736,Eric Dier,ENG,DF,Tottenham,Premier League,28,1994,31.3,30,19,16,12,2,9,19,47.4,10,41,24,17,35,65,112,2,0,2022-2023,90.0,100.63897763578274,86.26198083067092
737,Florian Dietz,GER,FW,Köln,Bundesliga,23,1998,4.4,2,1,0,2,0,1,4,25.0,3,4,1,3,0,2,2,0,0,2022-2023,90.0,0.0,40.90909090909091
738,Lucas Digne,FRA,DF,Aston Villa,Premier League,29,1993,16.7,30,12,20,9,1,20,33,60.6,13,18,5,13,18,48,45,0,0,2022-2023,90.0,97.0059880239521,161.67664670658684
739,Federico Dimarco,ITA,DF,Inter,Serie A,24,1997,23.0,31,25,6,18,7,9,19,47.4,10,15,4,11,18,49,20,0,0,2022-2023,90.0,70.43478260869566,121.30434782608697
740,Stole Dimitrievski,MKD,GK,Rayo Vallecano,La Liga,28,1993,36.9,1,0,1,0,0,1,2,50.0,1,2,0,2,1,2,17,3,0,2022-2023,90.0,2.4390243902439024,2.4390243902439024
741,Junior Dina Ebimbe,FRA,"DF,MF",Eint Frankfurt,Bundesliga,21,2000,11.8,30,19,16,14,0,16,33,48.5,17,18,5,13,11,41,20,0,0,2022-2023,90.0,83.89830508474576,228.81355932203388
742,Tristan Dingomé,CMR,MF,Troyes,Ligue 1,31,1991,1.1,1,1,0,1,0,0,2,0.0,2,0,0,0,0,1,0,0,0,2022-2023,90.0,0.0,81.81818181818181
743,Eren Dinkçi,GER,"FW,MF",Werder Bremen,Bundesliga,20,2001,2.6,5,5,2,1,2,2,6,33.3,4,2,0,2,0,5,2,0,0,2022-2023,90.0,0.0,173.07692307692307
744,Sinaly Diomande,CIV,DF,Lyon,Ligue 1,21,2001,21.7,42,24,26,15,1,31,49,63.3,18,26,13,13,49,91,75,1,0,2022-2023,90.0,203.2258064516129,174.19354838709677
745,Lois Diony,FRA,FW,Angers,Ligue 1,29,1992,5.6,1,0,0,1,0,1,3,33.3,2,2,0,2,0,1,1,0,0,2022-2023,90.0,0.0,16.071428571428573
746,Edan Diop,FRA,"DF,FW",Monaco,Ligue 1,17,2004,2.5,13,8,3,3,7,7,15,46.7,8,7,1,6,4,17,1,0,0,2022-2023,90.0,144.0,468.0
747,Issa Diop,FRA,DF,Fulham,Premier League,25,1997,22.4,28,19,18,9,1,17,32,53.1,15,24,17,7,35,63,86,0,0,2022-2023,90.0,140.625,112.5
748,Sofiane Diop,FRA,"MF,FW",Nice,Ligue 1,22,2000,13.6,23,11,12,6,5,7,20,35.0,13,14,2,12,16,39,5,0,0,2022-2023,90.0,105.88235294117646,152.2058823529412
749,Sofiane Diop,FRA,MF,Monaco,Ligue 1,22,2000,0.7,0,0,0,0,0,0,0,0.0,0,0,0,0,1,1,0,0,0,2022-2023,90.0,128.57142857142858,0.0
750,Yehvann Diouf,FRA,GK,Reims,Ligue 1,22,1999,31.0,2,0,2,0,0,1,3,33.3,2,0,0,0,1,3,13,5,0,2022-2023,90.0,2.903225806451613,5.806451612903226
Rk,Player,Nation,Pos,Squad,Comp,0,0,90.0,0,0,3,3,3,Tkl,0,0.0,0,0,0,0,0,0,0,0,0,2022-2023,90.0,0.0,0.0
751,Axel Disasi,FRA,DF,Monaco,Ligue 1,24,1998,37.0,30,20,13,13,4,13,27,48.1,14,51,31,20,56,86,112,2,0,2022-2023,90.0,136.21621621621622,72.97297297297298
752,Tiago Djaló,POR,DF,Lille,Ligue 1,22,2000,22.4,31,21,23,7,1,13,20,65.0,7,17,11,6,23,54,60,1,0,2022-2023,90.0,92.41071428571429,124.55357142857143
753,Djené,TOG,DF,Getafe,La Liga,30,1991,31.6,41,28,23,17,1,22,38,57.9,16,25,10,15,42,83,81,1,0,2022-2023,90.0,119.62025316455694,116.77215189873417
754,Moussa Djenepo,MLI,"DF,FW",Southampton,Premier League,24,1998,7.9,19,11,13,5,1,11,27,40.7,16,19,2,17,11,30,7,0,0,2022-2023,90.0,125.31645569620251,216.4556962025316
755,Koffi Djidji,CIV,DF,Torino,Serie A,29,1992,26.9,50,25,32,17,1,18,32,56.3,14,29,14,15,34,84,72,0,0,2022-2023,90.0,113.75464684014871,167.28624535315987
756,Alexander Djiku,GHA,DF,Strasbourg,Ligue 1,27,1994,29.7,53,36,37,16,0,26,46,56.5,20,45,19,26,66,119,151,3,0,2022-2023,90.0,200.0,160.6060606060606
757,Berat Djimsiti,ALB,DF,Atalanta,Serie A,29,1993,20.0,34,19,21,13,0,17,25,68.0,8,17,7,10,36,70,74,1,0,2022-2023,90.0,162.0,153.0
758,Moussa Djitte,SEN,FW,Ajaccio,Ligue 1,22,1999,1.5,1,0,0,0,1,1,2,50.0,1,0,0,0,0,1,1,0,0,2022-2023,90.0,0.0,60.0
759,Ouparine Djoco,GNB,GK,Clermont Foot,Ligue 1,24,1998,1.0,0,0,0,0,0,0,0,0.0,0,0,0,0,0,0,1,0,0,2022-2023,90.0,0.0,0.0
760,Marko Dmitrović,SRB,GK,Sevilla,La Liga,30,1992,14.1,0,0,0,0,0,0,0,0.0,0,0,0,0,0,0,6,0,0,2022-2023,89.99999999999999,0.0,0.0
761,Alan Do Marcolino,GAB,FW,Rennes,Ligue 1,20,2002,0.2,0,0,0,0,0,0,0,0.0,0,0,0,0,0,0,1,0,0,2022-2023,90.0,0.0,0.0
762,Ben Doak,SCO,FW,Liverpool,Premier League,16,2005,0.3,3,2,1,2,0,1,1,100.0,0,1,0,1,0,3,0,0,0,2022-2023,90.0,0.0,900.0000000000001
763,Ritsu Doan,JPN,"MF,FW",Freiburg,Bundesliga,24,1998,26.9,61,29,19,29,13,25,55,45.5,30,40,1,39,14,75,12,0,0,2022-2023,90.0,46.84014869888476,204.08921933085503
764,Dodô,BRA,DF,Fiorentina,Serie A,23,1998,25.9,40,22,20,14,6,22,46,47.8,24,26,2,24,25,65,37,0,0,2022-2023,90.0,86.87258687258688,138.99613899613902
765,Danilho Doekhi,NED,DF,Union Berlin,Bundesliga,24,1998,24.6,38,23,21,17,0,14,26,53.8,12,27,12,15,29,67,93,0,0,2022-2023,89.99999999999999,106.09756097560974,139.02439024390242
766,Matt Doherty,IRL,"DF,MF",Tottenham,Premier League,30,1992,7.4,16,10,12,3,1,8,10,80.0,2,11,6,5,8,24,14,1,0,2022-2023,90.0,97.29729729729729,194.59459459459458
767,Matt Doherty,IRL,DF,Atlético Madrid,La Liga,30,1992,0.2,0,0,0,0,0,0,0,0.0,0,2,0,2,0,0,0,0,0,2022-2023,90.0,0.0,0.0
768,Josh Doig,SCO,DF,Hellas Verona,Serie A,20,2002,15.0,19,8,6,7,6,6,16,37.5,10,25,6,19,11,30,13,1,0,2022-2023,90.0,66.0,114.0
769,Jeremy Doku,BEL,"MF,FW",Rennes,Ligue 1,20,2002,14.3,25,16,6,13,6,12,24,50.0,12,10,0,10,5,30,2,0,0,2022-2023,90.0,31.46853146853147,157.34265734265733
770,Kasper Dolberg,DEN,FW,Sevilla,La Liga,24,1997,2.2,1,0,0,1,0,1,3,33.3,2,0,0,0,0,1,5,0,0,2022-2023,90.0,0.0,40.90909090909091
771,Kasper Dolberg,DEN,"FW,MF",Hoffenheim,Bundesliga,24,1997,4.5,7,5,1,4,2,4,6,66.7,2,6,2,4,0,7,5,0,0,2022-2023,90.0,0.0,140.0
772,Carlos Dominguez,ESP,DF,Celta Vigo,La Liga,21,2001,1.2,1,1,0,1,0,1,2,50.0,1,1,1,0,0,1,7,0,0,2022-2023,90.0,0.0,75.0
773,Nicolás Domínguez,ARG,MF,Bologna,Serie A,24,1998,25.6,79,49,34,33,12,39,76,51.3,37,29,3,26,21,100,29,1,0,2022-2023,90.0,73.828125,277.734375
774,John Donald,ESP,"MF,DF",Elche,La Liga,21,2000,12.1,20,11,9,9,2,7,14,50.0,7,14,7,7,14,34,23,1,0,2022-2023,90.0,104.13223140495867,148.7603305785124
775,Giulio Donati,ITA,DF,Monza,Serie A,32,1990,4.7,4,1,1,1,2,3,6,50.0,3,3,1,2,4,8,11,0,0,2022-2023,90.0,76.59574468085106,76.59574468085106
Rk,Player,Nation,Pos,Squad,Comp,0,0,90.0,0,0,3,3,3,Tkl,0,0.0,0,0,0,0,0,0,0,0,0,2022-2023,90.0,0.0,0.0
776,Kyliane Dong,FRA,"MF,FW",Troyes,Ligue 1,17,2004,2.4,3,1,0,2,1,1,2,50.0,1,1,0,1,1,4,0,0,0,2022-2023,90.0,37.5,112.50000000000001
777,Jordan Dongmo,CMR,MF,Troyes,Ligue 1,21,2001,0.2,1,0,0,1,0,1,1,100.0,0,0,0,0,0,1,0,0,0,2022-2023,90.0,0.0,450.0
778,Gianluigi Donnarumma,ITA,GK,Paris S-G,Ligue 1,23,1999,37.9,1,0,1,0,0,1,2,50.0,1,0,0,0,0,1,12,4,0,2022-2023,90.0,0.0,2.37467018469657
779,Niklas Dorsch,GER,MF,Augsburg,Bundesliga,24,1998,5.4,21,12,8,11,2,9,16,56.3,7,9,3,6,6,27,9,0,0,2022-2023,90.0,99.99999999999999,350.0
780,Jodel Dossou,BEN,"MF,DF",Clermont Foot,Ligue 1,30,1992,2.9,7,4,3,2,2,4,4,100.0,0,2,1,1,1,8,0,0,0,2022-2023,90.0,31.03448275862069,217.24137931034483
781,Lohann Doucet,FRA,"MF,FW",Nantes,Ligue 1,19,2002,1.0,3,0,2,0,1,3,4,75.0,1,2,0,2,2,5,4,0,0,2022-2023,90.0,180.0,270.0
782,Abdoulaye Doucouré,MLI,MF,Everton,Premier League,29,1993,17.0,31,20,9,15,7,12,37,32.4,25,26,3,23,13,44,11,0,0,2022-2023,90.0,68.82352941176471,164.11764705882354
783,Cheick Doucouré,MLI,MF,Crystal Palace,Premier League,22,2000,30.8,77,46,40,33,4,29,52,55.8,23,47,13,34,56,133,48,0,0,2022-2023,90.0,163.63636363636365,225.0
784,Siriné Doucouré,MLI,"FW,MF",Lorient,Ligue 1,20,2002,1.5,2,2,2,0,0,1,2,50.0,1,0,0,0,1,3,0,0,0,2022-2023,90.0,60.0,120.0
785,Désiré Doué,FRA,"MF,FW",Rennes,Ligue 1,17,2005,12.4,37,18,10,23,4,13,32,40.6,19,17,1,16,13,50,3,0,0,2022-2023,90.0,94.35483870967742,268.5483870967742
786,Guela Doué,CIV,"FW,MF",Rennes,Ligue 1,19,2002,0.1,0,0,0,0,0,0,0,0.0,0,0,0,0,0,0,0,0,0,2022-2023,90.0,0.0,0.0
787,Ismaël Doukouré,FRA,"DF,MF",Strasbourg,Ligue 1,19,2003,25.5,48,24,23,21,4,20,34,58.8,14,26,8,18,27,75,54,0,0,2022-2023,90.0,95.29411764705883,169.41176470588235
788,Kamory Doumbia,MLI,MF,Reims,Ligue 1,19,2003,12.8,31,16,9,14,8,12,37,32.4,25,17,1,16,13,44,3,0,0,2022-2023,90.0,91.40625,217.96875
789,Souleyman Doumbia,CIV,"DF,FW",Angers,Ligue 1,25,1996,19.9,45,31,31,13,1,17,31,54.8,14,20,3,17,27,72,27,1,0,2022-2023,90.0,122.1105527638191,203.5175879396985
790,Flynn Downes,ENG,MF,West Ham,Premier League,23,1999,8.5,16,9,4,10,2,6,12,50.0,6,15,2,13,7,23,6,0,0,2022-2023,90.0,74.11764705882354,169.41176470588235
791,Kami Doyle,ENG,MF,Southampton,Premier League,16,2005,0.1,0,0,0,0,0,0,0,0.0,0,0,0,0,0,0,0,0,0,2022-2023,90.0,0.0,0.0
792,Bartłomiej Drągowski,POL,GK,Spezia,Serie A,24,1997,32.7,1,0,1,0,0,1,5,20.0,4,0,0,0,1,2,15,3,0,2022-2023,90.0,2.7522935779816513,2.7522935779816513
793,Cody Drameh,ENG,DF,Leeds United,Premier League,20,2001,0.8,5,4,0,4,1,2,3,66.7,1,0,0,0,1,6,1,0,0,2022-2023,90.0,112.5,562.5
794,Dion Drena Beljo,CRO,FW,Augsburg,Bundesliga,20,2002,12.5,7,6,3,2,2,2,13,15.4,11,15,2,13,1,8,14,0,0,2022-2023,90.0,7.199999999999999,50.4
795,Dominick Drexler,GER,"MF,FW",Schalke 04,Bundesliga,32,1990,15.2,25,17,12,10,3,9,22,40.9,13,18,2,16,8,33,12,0,0,2022-2023,90.0,47.368421052631575,148.02631578947367
796,Domingos Duarte,POR,DF,Getafe,La Liga,27,1995,29.5,26,18,21,5,0,19,26,73.1,7,29,23,6,39,65,145,0,0,2022-2023,90.0,118.98305084745763,79.32203389830508
797,Martin Dúbravka,SVK,GK,Newcastle Utd,Premier League,33,1989,1.7,0,0,0,0,0,0,1,0.0,1,0,0,0,0,0,1,0,0,2022-2023,90.0,0.0,0.0
798,Marvin Ducksch,GER,FW,Werder Bremen,Bundesliga,28,1994,31.7,8,3,2,4,2,3,16,18.8,13,13,2,11,9,17,41,1,0,2022-2023,90.0,25.55205047318612,22.71293375394322
799,Ondrej Duda,SVK,MF,Hellas Verona,Serie A,27,1994,11.8,22,14,7,12,3,9,16,56.3,7,11,0,11,13,35,8,0,0,2022-2023,90.0,99.15254237288134,167.79661016949152
800,Ondrej Duda,SVK,MF,Köln,Bundesliga,27,1994,7.7,9,8,2,5,2,4,11,36.4,7,7,1,6,2,11,3,0,0,2022-2023,90.0,23.376623376623378,105.1948051948052
Rk,Player,Nation,Pos,Squad,Comp,0,0,90.0,0,0,3,3,3,Tkl,0,0.0,0,0,0,0,0,0,0,0,0,2022-2023,90.0,0.0,0.0
801,Shane Duffy,IRL,"DF,FW",Fulham,Premier League,30,1992,0.2,0,0,0,0,0,0,0,0.0,0,0,0,0,0,0,0,1,0,2022-2023,90.0,0.0,0.0
802,Rémy Dugimont,FRA,"FW,MF",Auxerre,Ligue 1,36,1986,1.3,2,1,0,1,1,1,2,50.0,1,3,0,3,0,2,5,0,0,2022-2023,90.0,0.0,138.46153846153845
803,Denzel Dumfries,NED,DF,Inter,Serie A,26,1996,24.6,35,18,17,13,5,22,34,64.7,12,33,9,24,12,47,26,0,0,2022-2023,89.99999999999999,43.90243902439024,128.04878048780486
804,Alfred Duncan,GHA,MF,Fiorentina,Serie A,29,1993,12.3,18,10,0,17,1,10,21,47.6,11,9,0,9,8,26,6,0,0,2022-2023,89.99999999999999,58.536585365853654,131.7073170731707
805,Lewis Dunk,ENG,DF,Brighton,Premier League,30,1991,36.0,30,19,19,9,2,18,41,43.9,23,37,27,10,34,64,81,1,0,2022-2023,90.0,85.0,75.0
806,Maxime Dupé,FRA,GK,Toulouse,Ligue 1,29,1993,38.0,0,0,0,0,0,0,0,0.0,0,0,0,0,0,0,9,3,0,2022-2023,90.0,0.0,0.0
807,Jhon Durán,COL,"FW,MF",Aston Villa,Premier League,18,2003,1.5,2,2,0,1,1,1,4,25.0,3,0,0,0,2,4,2,0,0,2022-2023,90.0,120.0,120.0
808,Pablo Durán,ESP,"MF,DF",Celta Vigo,La Liga,21,2001,0.4,0,0,0,0,0,0,0,0.0,0,2,1,1,1,1,2,0,0,2022-2023,90.0,225.0,0.0
809,Julien Duranville,BEL,MF,Dortmund,Bundesliga,16,2006,0.3,1,1,0,1,0,1,1,100.0,0,0,0,0,0,1,0,0,0,2022-2023,90.0,0.0,300.0
810,Hugo Duro,ESP,FW,Valencia,La Liga,22,1999,15.4,15,12,2,6,7,7,17,41.2,10,11,1,10,2,17,7,1,0,2022-2023,90.0,11.688311688311689,87.66233766233766
811,Jean-Kevin Duverne,HAI,DF,Brest,Ligue 1,25,1997,27.9,72,38,44,24,4,42,73,57.5,31,33,5,28,28,100,65,1,0,2022-2023,90.0,90.3225806451613,232.25806451612902
812,Paulo Dybala,ARG,"MF,FW",Roma,Serie A,28,1993,19.3,14,4,1,8,5,8,26,30.8,18,12,1,11,8,22,4,0,0,2022-2023,90.0,37.30569948186528,65.28497409326424
813,Edin Džeko,BIH,FW,Inter,Serie A,36,1986,19.2,3,2,0,3,0,0,4,0.0,4,15,1,14,3,6,25,0,0,2022-2023,90.0,14.062500000000002,14.062500000000002
814,Malcolm Ebiowei,ENG,"MF,FW",Crystal Palace,Premier League,18,2003,0.4,1,1,1,0,0,0,1,0.0,1,2,0,2,0,1,0,0,0,2022-2023,90.0,0.0,225.0
815,Festy Ebosele,IRL,DF,Udinese,Serie A,19,2002,4.6,15,10,8,7,0,4,10,40.0,6,5,0,5,2,17,5,0,0,2022-2023,90.0,39.130434782608695,293.47826086956525
816,Enzo Ebosse,CMR,DF,Udinese,Serie A,23,1999,10.3,15,9,11,4,0,9,13,69.2,4,27,6,21,11,26,29,0,0,2022-2023,90.0,96.11650485436893,131.06796116504853
817,Tyronne Ebuehi,NGA,DF,Empoli,Serie A,26,1995,21.4,22,14,11,7,4,9,13,69.2,4,23,12,11,12,34,79,1,0,2022-2023,90.0,50.46728971962617,92.52336448598132
818,Ederson,BRA,GK,Manchester City,Premier League,28,1993,35.0,3,1,3,0,0,1,2,50.0,1,0,0,0,1,4,10,2,0,2022-2023,90.0,2.571428571428571,7.714285714285714
819,Éderson,BRA,MF,Atalanta,Serie A,23,1999,24.6,67,34,18,42,7,29,66,43.9,37,56,7,49,36,103,31,0,0,2022-2023,89.99999999999999,131.7073170731707,245.12195121951217
820,Odsonne Édouard,FRA,FW,Crystal Palace,Premier League,24,1998,20.0,25,13,7,12,6,7,13,53.8,6,17,5,12,3,28,22,0,0,2022-2023,90.0,13.5,112.5
821,Samuel Edozie,ENG,"FW,MF",Southampton,Premier League,19,2003,6.3,17,10,6,10,1,3,8,37.5,5,7,0,7,6,23,6,0,0,2022-2023,90.0,85.71428571428572,242.8571428571429
822,Maximilian Eggestein,GER,MF,Freiburg,Bundesliga,25,1996,27.2,51,29,21,24,6,17,35,48.6,18,37,8,29,36,87,27,0,0,2022-2023,90.0,119.11764705882352,168.75
823,Lilian Egloff,GER,"MF,FW",Stuttgart,Bundesliga,19,2002,2.7,12,10,4,5,3,4,6,66.7,2,2,0,2,1,13,1,0,0,2022-2023,90.0,33.33333333333333,399.99999999999994
824,Íñigo Eguaras,ESP,MF,Almería,La Liga,30,1992,10.7,11,8,4,6,1,5,18,27.8,13,9,3,6,6,17,15,0,0,2022-2023,90.0,50.46728971962617,92.52336448598132
825,Kingsley Ehizibue,NED,DF,Udinese,Serie A,27,1995,17.1,47,31,28,13,6,29,45,64.4,16,21,3,18,10,57,42,1,0,2022-2023,90.0,52.63157894736842,247.3684210526316
Rk,Player,Nation,Pos,Squad,Comp,0,0,90.0,0,0,3,3,3,Tkl,0,0.0,0,0,0,0,0,0,0,0,0,2022-2023,90.0,0.0,0.0
826,Kingsley Ehizibue,NED,DF,Köln,Bundesliga,27,1995,0.7,0,0,0,0,0,0,0,0.0,0,1,0,1,2,2,1,0,0,2022-2023,90.0,257.14285714285717,0.0
827,Julian Eitschberger,GER,FW,Hertha BSC,Bundesliga,18,2004,0.0,0,0,0,0,0,0,0,0.0,0,0,0,0,0,0,0,0,0,2022-2023,,,
828,Chidera Ejuke,NGA,"FW,MF",Hertha BSC,Bundesliga,24,1998,9.9,5,4,1,4,0,1,5,20.0,4,4,0,4,4,9,1,0,0,2022-2023,90.0,36.36363636363637,45.45454545454545
829,Albin Ekdal,SWE,MF,Spezia,Serie A,33,1989,19.3,37,20,14,20,3,19,45,42.2,26,24,2,22,26,63,36,0,0,2022-2023,90.0,121.24352331606217,172.53886010362692
830,Hugo Ekitike,FRA,FW,Paris S-G,Ligue 1,20,2002,12.8,12,4,1,10,1,4,12,33.3,8,12,0,12,9,21,3,0,0,2022-2023,90.0,63.28125,84.375
831,Emmanuel Ekong,SWE,"FW,MF",Empoli,Serie A,20,2002,0.2,0,0,0,0,0,0,0,0.0,0,0,0,0,0,0,0,0,0,2022-2023,90.0,0.0,0.0
832,Anthony Elanga,SWE,FW,Manchester Utd,Premier League,20,2002,4.7,3,0,0,2,1,1,2,50.0,1,4,0,4,2,5,4,0,0,2022-2023,90.0,38.29787234042553,57.44680851063829
833,Alberth Elis,HON,"MF,FW",Brest,Ligue 1,26,1996,2.9,4,3,1,2,1,1,7,14.3,6,1,0,1,1,5,2,0,0,2022-2023,90.0,31.03448275862069,124.13793103448276
834,Mikael Ellertsson,ISL,"MF,DF",Spezia,Serie A,20,2002,1.9,4,2,1,3,0,0,3,0.0,3,2,1,1,2,6,0,0,0,2022-2023,90.0,94.73684210526315,189.4736842105263
835,Harvey Elliott,ENG,"MF,FW",Liverpool,Premier League,19,2003,17.9,27,18,6,12,9,9,37,24.3,28,26,1,25,15,42,8,0,0,2022-2023,90.0,75.41899441340783,135.75418994413408
836,Elif Elmas,MKD,"FW,MF",Napoli,Serie A,22,1999,18.1,24,13,8,12,4,11,23,47.8,12,18,2,16,11,35,5,0,0,2022-2023,90.0,54.696132596685075,119.33701657458562
837,Mohamed Elneny,EGY,MF,Arsenal,Premier League,30,1992,1.3,1,1,1,0,0,1,1,100.0,0,0,0,0,0,1,0,0,0,2022-2023,90.0,0.0,69.23076923076923
838,Aritz Elustondo,ESP,DF,Real Sociedad,La Liga,28,1994,16.1,26,17,15,10,1,14,26,53.8,12,15,6,9,20,46,43,1,0,2022-2023,90.0,111.80124223602483,145.3416149068323
839,Nico Elvedi,SUI,DF,Gladbach,Bundesliga,25,1996,31.4,46,24,32,12,2,27,41,65.9,14,31,16,15,35,81,149,3,0,2022-2023,90.0,100.31847133757962,131.84713375796179
840,Rodrigo Ely,BRA,DF,Almería,La Liga,28,1993,35.1,30,21,26,4,0,18,25,72.0,7,46,33,13,31,61,203,1,0,2022-2023,90.0,79.48717948717949,76.92307692307692
841,Mohamed Elyounoussi,NOR,"MF,FW",Southampton,Premier League,27,1994,24.1,46,28,22,20,4,19,44,43.2,25,40,3,37,27,73,37,0,0,2022-2023,90.0,100.8298755186722,171.78423236514521
842,Adri Embarba,ESP,"FW,MF",Almería,La Liga,30,1992,16.4,50,27,21,26,3,22,46,47.8,24,23,0,23,9,59,9,0,0,2022-2023,90.0,49.39024390243903,274.39024390243907
843,Adri Embarba,ESP,FW,Espanyol,La Liga,30,1992,0.4,1,0,0,1,0,1,1,100.0,0,1,0,1,0,1,0,0,0,2022-2023,90.0,0.0,225.0
844,Breel Embolo,SUI,FW,Monaco,Ligue 1,25,1997,20.7,15,9,2,7,6,5,10,50.0,5,14,3,11,5,20,12,0,0,2022-2023,90.0,21.73913043478261,65.21739130434783
845,Emerson,BRA,DF,Tottenham,Premier League,23,1999,19.3,54,33,38,12,4,27,40,67.5,13,17,3,14,18,72,75,0,0,2022-2023,90.0,83.93782383419688,251.81347150259066
846,Youssef En-Nesyri,MAR,FW,Sevilla,La Liga,25,1997,18.5,16,8,3,7,6,4,14,28.6,10,6,2,4,4,20,16,0,0,2022-2023,90.0,19.45945945945946,77.83783783783784
847,Julio Enciso,PAR,"FW,MF",Brighton,Premier League,18,2004,9.0,13,4,3,6,4,8,13,61.5,5,9,0,9,4,17,2,0,0,2022-2023,90.0,40.0,130.0
848,Wataru Endo,JPN,MF,Stuttgart,Bundesliga,29,1993,32.5,70,37,30,31,9,38,85,44.7,47,44,6,38,26,96,63,0,0,2022-2023,90.0,72.0,193.84615384615384
849,Arne Engels,BEL,MF,Augsburg,Bundesliga,18,2003,16.0,20,9,9,10,1,8,19,42.1,11,17,5,12,15,35,12,1,0,2022-2023,90.0,84.375,112.5
850,Christian Eriksen,DEN,MF,Manchester Utd,Premier League,30,1992,22.8,22,18,10,7,5,10,33,30.3,23,23,9,14,11,33,20,1,0,2022-2023,90.0,43.421052631578945,86.84210526315789
Rk,Player,Nation,Pos,Squad,Comp,0,0,90.0,0,0,3,3,3,Tkl,0,0.0,0,0,0,0,0,0,0,0,0,2022-2023,90.0,0.0,0.0
851,Martin Erlic,CRO,DF,Sassuolo,Serie A,24,1998,25.9,27,16,18,8,1,10,23,43.5,13,36,23,13,31,58,120,1,0,2022-2023,90.0,107.72200772200773,93.82239382239383
852,Tjark Ernst,GER,GK,Hertha BSC,Bundesliga,19,2003,1.0,0,0,0,0,0,0,0,0.0,0,0,0,0,0,0,1,0,0,2022-2023,90.0,0.0,0.0
853,Gonzalo Escalante,ARG,MF,Cremonese,Serie A,29,1993,6.2,16,8,8,8,0,10,13,76.9,3,7,1,6,10,26,4,0,0,2022-2023,90.0,145.16129032258064,232.25806451612902
854,Gonzalo Escalante,ARG,MF,Cádiz,La Liga,29,1993,12.5,36,24,15,20,1,15,29,51.7,14,18,4,14,17,53,26,1,0,2022-2023,90.0,122.39999999999999,259.2
855,Sergio Escudero,ESP,DF,Valladolid,La Liga,32,1989,16.0,33,19,21,8,4,15,35,42.9,20,26,6,20,26,59,46,0,0,2022-2023,90.0,146.25,185.625
856,Alfonso Espino,URU,DF,Cádiz,La Liga,30,1992,34.7,87,56,55,20,12,48,96,50.0,48,52,11,41,48,135,99,3,0,2022-2023,90.0,124.49567723342938,225.64841498559076
857,Bernardo Espinosa,COL,DF,Girona,La Liga,33,1989,13.6,6,2,2,4,0,3,9,33.3,6,17,10,7,12,18,70,2,0,2022-2023,90.0,79.41176470588235,39.705882352941174
858,Salvatore Esposito,ITA,MF,Spezia,Serie A,21,2000,10.8,15,12,8,5,2,5,21,23.8,16,9,1,8,11,26,18,0,0,2022-2023,90.0,91.66666666666666,124.99999999999999
859,Maxime Estève,FRA,DF,Montpellier,Ligue 1,20,2002,18.3,24,13,17,5,2,12,17,70.6,5,28,17,11,34,58,90,0,0,2022-2023,90.0,167.21311475409837,118.0327868852459
860,Pervis Estupiñán,ECU,DF,Brighton,Premier League,24,1998,29.7,61,31,36,19,6,35,60,58.3,25,30,8,22,37,98,37,1,0,2022-2023,90.0,112.12121212121211,184.84848484848484
861,Jonny Evans,NIR,DF,Leicester City,Premier League,34,1988,11.7,13,5,12,1,0,7,11,63.6,4,15,11,4,18,31,51,0,0,2022-2023,89.99999999999999,138.46153846153845,100.0
862,Edu Expósito,ESP,MF,Espanyol,La Liga,25,1996,12.9,34,20,16,15,3,13,23,56.5,10,7,0,7,12,46,20,0,0,2022-2023,90.0,83.72093023255813,237.20930232558138
863,Eberechi Eze,ENG,"MF,FW",Crystal Palace,Premier League,24,1998,29.3,42,24,17,18,7,18,38,47.4,20,22,0,22,13,55,10,0,0,2022-2023,90.0,39.93174061433447,129.01023890784984
864,Kimberly Ezekwem,GER,DF,Freiburg,Bundesliga,21,2001,0.1,0,0,0,0,0,0,0,0.0,0,1,0,1,0,0,0,0,0,2022-2023,90.0,0.0,0.0
865,Nicolás Ezequiel Fernández,ARG,"MF,DF",Elche,La Liga,22,2000,5.7,23,12,10,7,6,9,17,52.9,8,7,0,7,5,28,2,1,0,2022-2023,90.0,78.94736842105263,363.1578947368421
866,Abde Ezzalzouli,MAR,"FW,MF",Osasuna,La Liga,20,2001,16.7,29,19,13,12,4,13,23,56.5,10,20,0,20,4,33,6,0,0,2022-2023,90.0,21.55688622754491,156.2874251497006
867,Łukasz Fabiański,POL,GK,West Ham,Premier League,37,1985,34.6,2,0,2,0,0,1,2,50.0,1,1,0,1,0,2,10,1,0,2022-2023,90.0,0.0,5.202312138728323
868,Fabinho,BRA,MF,Liverpool,Premier League,28,1993,29.7,65,38,18,40,7,24,62,38.7,38,38,11,27,37,102,40,0,0,2022-2023,90.0,112.12121212121211,196.96969696969697
869,Fábio,BRA,"DF,MF",Nantes,Ligue 1,32,1990,2.5,4,2,1,2,1,4,6,66.7,2,2,0,2,3,7,11,0,0,2022-2023,90.0,108.0,144.0
870,Noah Fadiga,SEN,DF,Brest,Ligue 1,22,1999,14.5,30,21,18,9,3,14,26,53.8,12,17,7,10,26,56,18,0,0,2022-2023,90.0,161.3793103448276,186.20689655172413
871,Wout Faes,BEL,DF,Leicester City,Premier League,24,1998,31.0,56,33,28,26,2,28,44,63.6,16,53,37,16,41,97,113,2,0,2022-2023,90.0,119.03225806451613,162.58064516129033
872,Wout Faes,BEL,DF,Reims,Ligue 1,24,1998,3.0,1,1,1,0,0,1,2,50.0,1,6,3,3,7,8,19,0,0,2022-2023,90.0,210.0,30.0
873,Nicolò Fagioli,ITA,MF,Juventus,Serie A,21,2001,16.9,29,19,12,15,2,8,27,29.6,19,16,2,14,8,37,7,1,0,2022-2023,90.0,42.60355029585799,154.43786982248523
874,Ralf Fährmann,GER,GK,Schalke 04,Bundesliga,33,1988,11.4,1,0,1,0,0,1,1,100.0,0,0,0,0,0,1,10,2,0,2022-2023,90.0,0.0,7.894736842105263
875,Romain Faivre,FRA,"MF,FW",Lorient,Ligue 1,24,1998,13.8,13,8,5,4,4,5,25,20.0,20,11,0,11,1,14,4,0,0,2022-2023,90.0,6.521739130434782,84.78260869565217
Rk,Player,Nation,Pos,Squad,Comp,0,0,90.0,0,0,3,3,3,Tkl,0,0.0,0,0,0,0,0,0,0,0,0,2022-2023,90.0,0.0,0.0
876,Romain Faivre,FRA,MF,Lyon,Ligue 1,24,1998,3.3,6,3,2,2,2,1,3,33.3,2,3,0,3,0,6,0,0,0,2022-2023,90.0,0.0,163.63636363636363
877,Radamel Falcao,COL,"FW,MF",Rayo Vallecano,La Liga,36,1986,6.8,4,4,1,3,0,1,8,12.5,7,5,1,4,2,6,10,0,0,2022-2023,90.0,26.470588235294116,52.94117647058823
878,Wladimiro Falcone,ITA,GK,Lecce,Serie A,27,1995,38.0,2,0,2,0,0,2,2,100.0,0,0,0,0,2,4,21,3,0,2022-2023,90.0,4.7368421052631575,4.7368421052631575
879,Fali,ESP,"DF,MF",Cádiz,La Liga,28,1993,19.0,27,19,19,8,0,18,29,62.1,11,24,15,9,13,40,70,1,0,2022-2023,90.0,61.578947368421055,127.89473684210526
880,Fallou Fall,SEN,DF,Reims,Ligue 1,18,2004,0.4,0,0,0,0,0,0,1,0.0,1,3,3,0,0,0,4,0,0,2022-2023,90.0,0.0,0.0
881,Mamadou Fall,SEN,DF,Villarreal,La Liga,19,2002,0.3,0,0,0,0,0,0,0,0.0,0,1,0,1,0,0,1,0,0,2022-2023,90.0,0.0,0.0
882,Davide Faraoni,ITA,DF,Hellas Verona,Serie A,30,1991,16.5,34,24,19,13,2,16,41,39.0,25,30,11,19,15,49,37,0,0,2022-2023,90.0,81.81818181818183,185.45454545454547
883,Ansu Fati,ESP,FW,Barcelona,La Liga,19,2002,15.5,16,9,8,4,4,5,18,27.8,13,19,0,19,5,21,6,0,0,2022-2023,90.0,29.032258064516128,92.90322580645162
884,Khalil Fayad,FRA,MF,Montpellier,Ligue 1,18,2004,8.0,30,14,12,16,2,12,21,57.1,9,8,1,7,9,39,4,0,0,2022-2023,90.0,101.25,337.5
885,Cheikh Faye,SEN,FW,Montpellier,Ligue 1,23,1999,0.4,0,0,0,0,0,0,0,0.0,0,0,0,0,1,1,0,0,0,2022-2023,90.0,225.0,0.0
886,Federico Fazio,ARG,DF,Salernitana,Serie A,35,1987,11.9,15,12,8,7,0,4,11,36.4,7,9,4,5,28,43,61,0,0,2022-2023,90.00000000000001,211.76470588235296,113.44537815126051
887,Jacopo Fazzini,ITA,MF,Empoli,Serie A,19,2003,9.2,31,17,20,8,3,18,34,52.9,16,15,3,12,7,38,19,0,0,2022-2023,90.0,68.47826086956522,303.26086956521743
888,Zouhair Feddal,MAR,DF,Valladolid,La Liga,33,1989,4.2,4,2,1,3,0,3,4,75.0,1,9,9,0,5,9,27,0,0,2022-2023,90.0,107.14285714285714,85.71428571428571
889,Nabil Fekir,FRA,MF,Betis,La Liga,29,1993,10.7,11,5,3,3,5,2,9,22.2,7,6,2,4,1,12,0,0,0,2022-2023,90.0,8.41121495327103,92.52336448598132
890,Felipe,BRA,DF,Nott'ham Forest,Premier League,33,1989,15.8,42,23,29,13,0,24,41,58.5,17,34,13,21,36,78,90,0,0,2022-2023,90.0,205.06329113924048,239.24050632911388
891,Felipe,BRA,DF,Atlético Madrid,La Liga,33,1989,2.2,3,2,1,2,0,2,4,50.0,2,2,2,0,0,3,7,0,0,2022-2023,90.0,0.0,122.72727272727272
892,Luiz Felipe,ITA,DF,Betis,La Liga,25,1997,19.6,34,23,23,11,0,18,34,52.9,16,43,24,19,28,62,106,0,0,2022-2023,90.0,128.57142857142856,156.12244897959184
893,João Félix,POR,"FW,MF",Chelsea,Premier League,22,1999,10.5,14,7,5,6,3,4,12,33.3,8,3,0,3,1,15,1,1,0,2022-2023,90.0,8.571428571428571,120.0
894,João Félix,POR,"FW,MF",Atlético Madrid,La Liga,22,1999,7.2,10,7,2,3,5,1,6,16.7,5,1,0,1,3,13,2,0,0,2022-2023,90.0,37.5,125.0
895,Ohis Felix Uduokhai,GER,DF,Augsburg,Bundesliga,24,1997,16.1,30,20,14,13,3,15,29,51.7,14,27,14,13,29,59,61,1,0,2022-2023,90.0,162.111801242236,167.70186335403724
896,Kiko Femenía,ESP,DF,Villarreal,La Liga,31,1991,12.6,18,9,14,3,1,13,18,72.2,5,15,6,9,20,38,22,0,0,2022-2023,90.0,142.85714285714286,128.57142857142858
897,Evan Ferguson,IRL,FW,Brighton,Premier League,17,2004,10.6,6,3,1,3,2,1,7,14.3,6,11,1,10,2,8,6,0,0,2022-2023,90.0,16.9811320754717,50.943396226415096
898,Lewis Ferguson,SCO,"MF,FW",Bologna,Serie A,22,1999,25.7,44,25,16,20,8,20,40,50.0,20,22,7,15,19,63,25,0,0,2022-2023,90.0,66.53696498054475,154.08560311284046
899,Bruno Fernandes,POR,"MF,FW",Manchester Utd,Premier League,27,1994,36.8,68,42,24,25,19,30,71,42.3,41,37,5,32,25,93,40,1,0,2022-2023,90.0,61.14130434782609,166.30434782608697
900,Edimilson Fernandes,SUI,DF,Mainz 05,Bundesliga,26,1996,27.1,35,25,26,5,4,18,34,52.9,16,37,16,21,54,89,87,2,0,2022-2023,90.0,179.33579335793357,116.23616236162361
Rk,Player,Nation,Pos,Squad,Comp,0,0,90.0,0,0,3,3,3,Tkl,0,0.0,0,0,0,0,0,0,0,0,0,2022-2023,90.0,0.0,0.0
901,Aitor Fernández,ESP,GK,Osasuna,La Liga,31,1991,21.0,1,1,1,0,0,0,1,0.0,1,0,0,0,2,3,17,0,0,2022-2023,90.0,8.571428571428571,4.285714285714286
902,Álex Fernández,ESP,"MF,FW",Cádiz,La Liga,29,1992,17.5,13,7,6,4,3,4,14,28.6,10,14,1,13,8,21,19,0,0,2022-2023,90.0,41.14285714285714,66.85714285714286
903,Álvaro Fernández,ESP,GK,Espanyol,La Liga,24,1998,11.0,0,0,0,0,0,0,0,0.0,0,0,0,0,0,0,7,2,0,2022-2023,90.0,0.0,0.0
904,Carlos Fernández,ESP,FW,Real Sociedad,La Liga,26,1996,7.0,6,4,1,3,2,1,15,6.7,14,1,0,1,1,7,4,0,0,2022-2023,90.0,12.857142857142858,77.14285714285714
905,Enzo Fernández,ARG,MF,Chelsea,Premier League,21,2001,17.2,45,27,25,17,3,21,56,37.5,35,32,2,30,16,61,12,1,0,2022-2023,90.0,83.72093023255815,235.4651162790698
906,Federico Fernández,ARG,DF,Elche,La Liga,33,1989,1.0,1,1,1,0,0,1,1,100.0,0,0,0,0,2,3,12,0,0,2022-2023,90.0,180.0,90.0
907,Joaquín Fernández,ESP,DF,Valladolid,La Liga,26,1996,24.0,35,28,20,11,4,19,30,63.3,11,31,22,9,27,62,98,1,0,2022-2023,90.0,101.25,131.25
908,Valery Fernández,ESP,"MF,DF",Girona,La Liga,22,1999,10.7,12,6,4,6,2,5,9,55.6,4,8,1,7,10,22,9,1,0,2022-2023,90.0,84.11214953271029,100.93457943925235
909,Fernando,ESP,GK,Almería,La Liga,32,1990,36.5,0,0,0,0,0,0,2,0.0,2,2,0,2,1,1,20,3,0,2022-2023,90.0,2.4657534246575343,0.0
910,Fernando,BRA,"MF,DF",Sevilla,La Liga,35,1987,17.5,34,23,14,17,3,18,30,60.0,12,21,10,11,24,58,29,0,0,2022-2023,90.0,123.42857142857143,174.85714285714286
911,Alex Ferrari,ITA,DF,Sampdoria,Serie A,28,1994,9.6,9,5,7,2,0,4,8,50.0,4,21,10,11,19,28,25,0,0,2022-2023,90.0,178.125,84.375
912,Alex Ferrari,ITA,DF,Cremonese,Serie A,28,1994,11.2,40,23,32,7,1,28,42,66.7,14,19,4,15,25,65,45,1,0,2022-2023,90.0,200.89285714285714,321.42857142857144
913,Salvador Ferrer,ESP,DF,Spezia,Serie A,24,1998,1.5,4,2,2,2,0,1,3,33.3,2,3,1,2,1,5,4,0,0,2022-2023,90.0,60.0,240.0
914,Jordan Ferri,FRA,MF,Montpellier,Ligue 1,30,1992,30.4,55,35,32,19,4,30,89,33.7,59,22,6,16,26,81,21,0,0,2022-2023,90.0,76.97368421052632,162.82894736842104
915,Fidel,ESP,"MF,FW",Elche,La Liga,32,1989,19.0,15,10,8,5,2,4,38,10.5,34,9,0,9,5,20,8,0,0,2022-2023,90.0,23.68421052631579,71.05263157894737
916,Karol Fila,POL,DF,Strasbourg,Ligue 1,24,1998,0.5,0,0,0,0,0,0,0,0.0,0,0,0,0,1,1,1,0,0,2022-2023,90.0,180.0,0.0
917,Vincenzo Fiorillo,ITA,GK,Salernitana,Serie A,32,1990,1.0,0,0,0,0,0,0,0,0.0,0,0,0,0,0,0,0,0,0,2022-2023,90.0,0.0,0.0
918,Roberto Firmino,BRA,"FW,MF",Liverpool,Premier League,30,1991,13.5,17,12,2,12,3,4,22,18.2,18,16,1,15,7,24,2,0,0,2022-2023,90.0,46.66666666666667,113.33333333333334
919,Junior Firpo,DOM,DF,Leeds United,Premier League,25,1996,15.2,47,25,27,15,5,24,46,52.2,22,23,7,16,24,71,40,0,0,2022-2023,90.0,142.10526315789474,278.2894736842105
920,Kilian Fischer,GER,"DF,FW",Wolfsburg,Bundesliga,21,2000,5.6,9,6,3,4,2,6,11,54.5,5,6,0,6,5,14,18,0,0,2022-2023,90.0,80.35714285714286,144.64285714285714
921,Mark Flekken,NED,GK,Freiburg,Bundesliga,29,1993,34.0,0,0,0,0,0,0,1,0.0,1,1,0,1,0,0,9,5,0,2022-2023,90.0,0.0,0.0
922,Florian Flick,GER,MF,Schalke 04,Bundesliga,22,2000,5.7,12,3,7,5,0,4,14,28.6,10,9,3,6,4,16,18,0,0,2022-2023,90.0,63.1578947368421,189.4736842105263
923,Alexis Flips,FRA,"FW,MF",Reims,Ligue 1,22,2000,22.0,51,30,18,17,16,27,64,42.2,37,35,5,30,24,75,12,0,0,2022-2023,90.0,98.18181818181819,208.63636363636365
924,Alessandro Florenzi,ITA,DF,Milan,Serie A,31,1991,2.3,6,4,3,2,1,4,7,57.1,3,1,0,1,4,10,2,0,0,2022-2023,90.0,156.52173913043478,234.7826086956522
925,Phil Foden,ENG,FW,Manchester City,Premier League,22,2000,20.5,16,10,9,5,2,8,19,42.1,11,25,2,23,5,21,12,0,0,2022-2023,90.0,21.951219512195124,70.2439024390244
Rk,Player,Nation,Pos,Squad,Comp,0,0,90.0,0,0,3,3,3,Tkl,0,0.0,0,0,0,0,0,0,0,0,0,2022-2023,90.0,0.0,0.0
926,Seko Fofana,CIV,MF,Lens,Ligue 1,27,1995,34.1,28,13,8,18,2,15,39,38.5,24,17,4,13,19,47,14,0,0,2022-2023,90.0,50.146627565982406,73.90029325513197
927,Wesley Fofana,FRA,DF,Leicester City,Premier League,21,2000,2.0,4,2,1,2,1,1,3,33.3,2,1,1,0,9,13,5,0,0,2022-2023,90.0,405.0,180.0
928,Wesley Fofana,FRA,DF,Chelsea,Premier League,21,2000,13.1,30,18,19,7,4,13,26,50.0,13,17,10,7,20,50,33,2,0,2022-2023,90.0,137.40458015267177,206.10687022900765
929,Yahia Fofana,CIV,GK,Angers,Ligue 1,21,2000,11.0,0,0,0,0,0,0,0,0.0,0,0,0,0,1,1,4,1,0,2022-2023,90.0,8.181818181818182,0.0
930,Youssouf Fofana,FRA,MF,Monaco,Ligue 1,23,1999,34.3,81,41,31,42,8,38,74,51.4,36,50,6,44,56,137,32,1,0,2022-2023,90.0,146.9387755102041,212.53644314868808
931,Thomas Foket,BEL,DF,Reims,Ligue 1,27,1994,22.0,35,22,18,11,6,17,46,37.0,29,21,7,14,33,68,29,2,0,2022-2023,90.0,135.0,143.1818181818182
932,José Fonte,POR,DF,Lille,Ligue 1,38,1983,28.8,23,17,18,4,1,10,21,47.6,11,27,14,13,25,48,112,2,0,2022-2023,90.0,78.125,71.875
933,Pablo Fornals,ESP,"FW,MF",West Ham,Premier League,26,1996,16.7,30,15,9,12,9,13,34,38.2,21,16,2,14,14,44,9,0,0,2022-2023,90.0,75.44910179640719,161.67664670658684
934,Emil Forsberg,SWE,"MF,FW",RB Leipzig,Bundesliga,30,1991,16.5,16,11,1,8,7,6,20,30.0,14,25,2,23,3,19,7,0,0,2022-2023,90.0,16.363636363636363,87.27272727272728
935,Adam Forshaw,ENG,MF,Leeds United,Premier League,30,1991,5.3,12,9,5,7,0,7,17,41.2,10,9,1,8,4,16,2,0,0,2022-2023,90.0,67.9245283018868,203.77358490566039
936,Fraser Forster,ENG,GK,Tottenham,Premier League,34,1988,13.5,1,0,1,0,0,0,0,0.0,0,1,0,1,0,1,3,1,0,2022-2023,90.0,0.0,6.666666666666667
937,Philipp Förster,GER,MF,Bochum,Bundesliga,27,1995,14.5,31,19,11,15,5,12,40,30.0,28,22,0,22,6,37,6,0,0,2022-2023,90.0,37.241379310344826,192.41379310344826
938,Steven Fortes,CPV,DF,Lens,Ligue 1,30,1992,0.1,0,0,0,0,0,0,0,0.0,0,0,0,0,0,0,0,0,0,2022-2023,90.0,0.0,0.0
939,Timothy Fosu-Mensah,NED,DF,Leverkusen,Bundesliga,24,1998,2.1,7,5,3,3,1,4,4,100.0,0,2,0,2,0,7,1,0,0,2022-2023,90.0,0.0,300.0
940,Dimitri Foulquier,FRA,DF,Valencia,La Liga,29,1993,19.3,31,19,17,8,6,20,28,71.4,8,19,3,16,14,45,40,0,0,2022-2023,90.0,65.28497409326424,144.55958549222797
941,Juan Foyth,ARG,DF,Villarreal,La Liga,24,1998,21.8,73,48,49,22,2,41,57,71.9,16,32,11,21,20,93,68,0,0,2022-2023,90.0,82.56880733944953,301.3761467889908
942,Raphael Framberger,GER,"DF,FW",Augsburg,Bundesliga,26,1995,2.0,10,6,6,4,0,3,5,60.0,2,2,1,1,2,12,5,0,0,2022-2023,90.0,90.0,450.0
943,Tyrese Francois,AUS,FW,Fulham,Premier League,22,2000,0.0,0,0,0,0,0,0,1,0.0,1,0,0,0,0,0,1,0,0,2022-2023,,,
944,Bartol Franjić,CRO,MF,Wolfsburg,Bundesliga,22,2000,2.5,4,2,2,2,0,0,2,0.0,2,4,1,3,5,9,4,0,0,2022-2023,90.0,180.0,144.0
945,Przemysław Frankowski,POL,"DF,MF",Lens,Ligue 1,27,1995,31.5,77,51,37,31,9,39,80,48.8,41,38,6,32,41,118,42,2,0,2022-2023,90.0,117.14285714285715,220.0
946,Ryan Fraser,SCO,FW,Newcastle Utd,Premier League,28,1994,3.5,2,2,0,0,2,2,5,40.0,3,3,1,2,0,2,3,0,0,2022-2023,90.0,0.0,51.42857142857143
947,Davide Frattesi,ITA,MF,Sassuolo,Serie A,22,1999,31.9,63,36,24,29,10,25,44,56.8,19,27,6,21,16,79,42,0,0,2022-2023,90.0,45.141065830721004,177.74294670846393
948,Oscar Fraulo,DEN,"FW,MF",Gladbach,Bundesliga,18,2003,0.1,0,0,0,0,0,0,0,0.0,0,0,0,0,0,0,0,0,0,2022-2023,90.0,0.0,0.0
949,Fred,BRA,MF,Manchester Utd,Premier League,29,1993,13.9,47,30,24,20,3,15,38,39.5,23,38,2,36,19,66,19,0,0,2022-2023,90.0,123.02158273381295,304.31654676258995
950,Ryan Fredericks,ENG,DF,Bournemouth,Premier League,29,1992,5.9,3,2,2,0,1,1,4,25.0,3,7,2,5,1,4,27,0,0,2022-2023,90.0,15.254237288135592,45.762711864406775
Rk,Player,Nation,Pos,Squad,Comp,0,0,90.0,0,0,3,3,3,Tkl,0,0.0,0,0,0,0,0,0,0,0,0,2022-2023,90.0,0.0,0.0
951,Iván Fresneda,ESP,DF,Valladolid,La Liga,17,2004,19.4,48,34,31,13,4,29,47,61.7,18,32,8,24,15,63,60,0,0,2022-2023,90.0,69.5876288659794,222.68041237113405
952,Remo Freuler,SUI,MF,Nott'ham Forest,Premier League,30,1992,24.0,43,23,23,15,5,19,43,44.2,24,36,9,27,29,72,45,0,0,2022-2023,90.0,108.75,161.25
953,Michael Frey,SUI,FW,Schalke 04,Bundesliga,28,1994,9.6,13,5,2,8,3,4,13,30.8,9,6,0,6,2,15,1,0,0,2022-2023,90.0,18.75,121.87500000000001
954,Marco Friedl,AUT,DF,Werder Bremen,Bundesliga,24,1998,28.8,62,46,40,22,0,41,68,60.3,27,46,17,29,58,120,127,1,0,2022-2023,90.0,181.25,193.75
955,Marvin Friedrich,GER,DF,Gladbach,Bundesliga,26,1995,13.9,17,11,13,3,1,10,13,76.9,3,14,6,8,11,28,52,0,0,2022-2023,90.0,71.22302158273382,110.07194244604317
956,Jeremie Frimpong,NED,"DF,MF",Leverkusen,Bundesliga,21,2000,30.1,53,27,22,26,5,23,44,52.3,21,24,3,21,16,69,40,0,0,2022-2023,90.00000000000001,47.840531561461795,158.4717607973422
957,Chris Führich,GER,"FW,MF",Stuttgart,Bundesliga,24,1998,20.9,36,14,15,14,7,24,44,54.5,20,29,2,27,7,43,13,0,0,2022-2023,90.0,30.14354066985646,155.02392344497608
958,Angelo Fulgini,FRA,"MF,FW",Lens,Ligue 1,25,1996,9.5,14,7,2,4,8,5,14,35.7,9,11,0,11,8,22,2,0,0,2022-2023,90.0,75.78947368421052,132.6315789473684
959,Angelo Fulgini,FRA,MF,Mainz 05,Bundesliga,25,1996,5.8,6,5,2,3,1,5,12,41.7,7,5,0,5,5,11,7,0,0,2022-2023,90.0,77.58620689655173,93.10344827586206
960,Niclas Füllkrug,GER,FW,Werder Bremen,Bundesliga,29,1993,27.5,9,4,0,6,3,3,13,23.1,10,13,4,9,1,10,24,0,0,2022-2023,89.99999999999999,3.2727272727272725,29.454545454545453
961,Matteo Gabbia,ITA,DF,Milan,Serie A,22,1999,6.8,17,10,12,5,0,6,8,75.0,2,8,3,5,5,22,29,0,0,2022-2023,90.0,66.17647058823529,225.0
962,Manolo Gabbiadini,ITA,"FW,MF",Sampdoria,Serie A,30,1991,26.2,23,15,8,9,6,9,23,39.1,14,16,2,14,6,29,25,0,0,2022-2023,90.0,20.610687022900763,79.00763358778626
963,Gianluca Gaetano,ITA,MF,Napoli,Serie A,22,2000,0.8,5,3,1,3,1,0,0,0.0,0,1,0,1,1,6,0,0,0,2022-2023,90.0,112.5,562.5
964,Roberto Gagliardini,ITA,MF,Inter,Serie A,28,1994,8.7,16,6,9,6,1,10,21,47.6,11,14,5,9,4,20,15,0,0,2022-2023,90.0,41.37931034482759,165.51724137931035
965,Adolfo Gaich,ARG,FW,Hellas Verona,Serie A,23,1999,8.1,5,3,0,3,2,1,6,16.7,5,7,2,5,3,8,7,1,0,2022-2023,90.0,33.333333333333336,55.55555555555556
966,Cody Gakpo,NED,"FW,MF",Liverpool,Premier League,23,1999,16.2,26,15,4,13,9,13,38,34.2,25,13,1,12,4,30,2,0,0,2022-2023,90.0,22.22222222222222,144.44444444444446
967,Javi Galán,ESP,DF,Celta Vigo,La Liga,27,1994,35.1,104,72,60,40,4,48,98,49.0,50,54,5,49,41,145,63,1,0,2022-2023,90.0,105.12820512820512,266.6666666666667
968,Iñigo Ruiz de Galarreta,ESP,MF,Mallorca,La Liga,28,1993,27.2,54,38,27,23,4,20,52,38.5,32,26,9,17,30,84,19,0,0,2022-2023,90.0,99.26470588235294,178.6764705882353
969,Pablo Galdames Millán,CHI,MF,Cremonese,Serie A,25,1996,8.2,14,10,8,3,3,5,33,15.2,28,13,2,11,10,24,13,0,0,2022-2023,90.0,109.75609756097562,153.65853658536588
970,Conor Gallagher,ENG,MF,Chelsea,Premier League,22,2000,18.0,46,33,17,19,10,10,37,27.0,27,41,10,31,23,69,18,1,0,2022-2023,90.0,115.0,230.0
971,Antonino Gallo,ITA,DF,Lecce,Serie A,22,2000,27.6,56,36,35,12,9,38,57,66.7,19,37,6,31,13,69,71,0,0,2022-2023,90.0,42.391304347826086,182.6086956521739
972,Gauthier Gallon,FRA,GK,Troyes,Ligue 1,29,1993,29.6,2,2,2,0,0,2,4,50.0,2,0,0,0,2,4,17,0,0,2022-2023,90.0,6.081081081081081,6.081081081081081
973,Cristian Gamboa,CRC,DF,Bochum,Bundesliga,32,1989,16.4,42,24,27,14,1,21,31,67.7,10,20,7,13,16,58,34,1,0,2022-2023,90.0,87.8048780487805,230.48780487804882
974,Kévin Gameiro,FRA,FW,Strasbourg,Ligue 1,35,1987,23.3,20,10,6,10,4,8,28,28.6,20,10,1,9,9,29,0,0,0,2022-2023,90.0,34.763948497854074,77.25321888412017
975,Idrissa Gana Gueye,SEN,MF,Everton,Premier League,32,1989,28.6,97,57,49,35,13,31,62,50.0,31,50,12,38,56,153,34,3,0,2022-2023,90.0,176.22377622377624,305.24475524475525
Rk,Player,Nation,Pos,Squad,Comp,0,0,90.0,0,0,3,3,3,Tkl,0,0.0,0,0,0,0,0,0,0,0,0,2022-2023,90.0,0.0,0.0
976,Ignatius Ganago,CMR,"FW,MF",Nantes,Ligue 1,23,1999,16.9,9,7,2,3,4,4,7,57.1,3,13,1,12,2,11,12,0,0,2022-2023,90.0,10.650887573964498,47.92899408284024
977,Ignatius Ganago,CMR,FW,Lens,Ligue 1,23,1999,0.7,0,0,0,0,0,0,0,0.0,0,0,0,0,0,0,1,0,0,2022-2023,90.0,0.0,0.0
978,Silvère Ganvoula M'Boussy,CGO,"FW,MF",Bochum,Bundesliga,26,1996,2.7,2,2,0,1,1,0,0,0.0,0,0,0,0,0,2,3,0,0,2022-2023,90.0,0.0,66.66666666666666
979,Aleix García,ESP,MF,Girona,La Liga,25,1997,26.0,37,20,9,18,10,15,33,45.5,18,24,8,16,31,68,35,1,0,2022-2023,90.00000000000001,107.30769230769232,128.0769230769231
980,Álvaro García,ESP,"FW,MF",Rayo Vallecano,La Liga,29,1992,31.9,49,28,21,13,15,11,33,33.3,22,41,4,37,34,83,24,1,0,2022-2023,90.0,95.92476489028213,138.24451410658307
981,Borja García,ESP,"MF,FW",Girona,La Liga,31,1990,7.5,10,4,7,2,1,2,9,22.2,7,3,1,2,5,15,6,1,0,2022-2023,90.0,60.0,120.0
982,Carlos García,ESP,DF,Cádiz,La Liga,22,2000,0.3,0,0,0,0,0,0,0,0.0,0,0,0,0,0,0,2,0,0,2022-2023,90.0,0.0,0.0
983,Dani García,ESP,MF,Athletic Club,La Liga,32,1990,16.5,46,27,17,25,4,29,47,61.7,18,21,6,15,19,65,21,1,0,2022-2023,90.0,103.63636363636364,250.90909090909093
984,David García,ESP,DF,Osasuna,La Liga,28,1994,29.8,34,20,22,12,0,19,22,86.4,3,28,13,15,45,79,151,0,0,2022-2023,90.0,135.90604026845637,102.68456375838926
985,Eric García,ESP,"DF,MF",Barcelona,La Liga,21,2001,15.7,24,16,16,5,3,9,20,45.0,11,23,10,13,19,43,36,1,0,2022-2023,90.0,108.9171974522293,137.57961783439492
986,Fran Garcia,ESP,DF,Rayo Vallecano,La Liga,22,1999,37.9,84,54,53,23,8,55,96,57.3,41,49,8,41,44,128,66,0,0,2022-2023,90.0,104.48548812664907,199.47229551451187
987,Joan García,ESP,GK,Espanyol,La Liga,21,2001,1.0,0,0,0,0,0,0,0,0.0,0,0,0,0,0,0,0,0,0,2022-2023,90.0,0.0,0.0
988,Raúl García,ESP,"FW,MF",Athletic Club,La Liga,36,1986,10.7,12,8,3,4,5,5,15,33.3,10,13,1,12,6,18,9,0,0,2022-2023,90.0,50.46728971962617,100.93457943925235
989,Rubén García,ESP,"FW,MF",Osasuna,La Liga,29,1993,12.9,20,11,12,4,4,7,24,29.2,17,14,1,13,12,32,13,0,0,2022-2023,90.0,83.72093023255813,139.53488372093022
990,Unai García,ESP,DF,Osasuna,La Liga,30,1992,19.0,23,13,13,8,2,12,17,70.6,5,23,14,9,19,42,60,2,0,2022-2023,90.0,90.0,108.94736842105263
991,Alejandro Garnacho,ARG,"FW,MF",Manchester Utd,Premier League,18,2004,6.3,5,2,2,0,3,1,11,9.1,10,5,0,5,5,10,3,0,0,2022-2023,90.0,71.42857142857143,71.42857142857143
992,James Garner,ENG,"MF,DF",Everton,Premier League,21,2001,8.9,16,13,4,8,4,9,19,47.4,10,9,1,8,12,28,13,0,0,2022-2023,90.0,121.34831460674158,161.79775280898878
993,Felix Garreta,ESP,DF,Betis,La Liga,18,2004,1.0,1,0,0,1,0,0,0,0.0,0,1,1,0,1,2,4,0,0,2022-2023,90.0,90.0,90.0
994,Aleix Garrido,ESP,FW,Barcelona,La Liga,18,2004,0.1,2,1,1,0,1,1,1,100.0,0,1,0,1,0,2,0,0,0,2022-2023,90.0,0.0,1800.0
995,Sékou Gassama,SEN,FW,Valladolid,La Liga,27,1995,0.4,0,0,0,0,0,0,0,0.0,0,0,0,0,0,0,0,0,0,2022-2023,90.0,0.0,0.0
996,Johan Gastien,FRA,MF,Clermont Foot,Ligue 1,34,1988,28.9,62,34,30,23,9,38,111,34.2,73,37,7,30,36,98,25,1,0,2022-2023,90.00000000000001,112.11072664359862,193.07958477508652
997,Federico Gatti,ITA,DF,Juventus,Serie A,24,1998,16.1,15,11,9,4,2,9,15,60.0,6,20,14,6,21,36,54,2,0,2022-2023,90.0,117.39130434782608,83.85093167701862
998,Gavi,ESP,"MF,FW",Barcelona,La Liga,17,2004,28.1,47,31,7,30,10,21,55,38.2,34,32,5,27,18,65,22,0,0,2022-2023,90.0,57.65124555160142,150.53380782918148
999,Paulo Gazzaniga,ARG,GK,Girona,La Liga,30,1992,28.0,0,0,0,0,0,0,1,0.0,1,0,0,0,1,1,9,5,0,2022-2023,90.0,3.2142857142857144,0.0
1000,David de Gea,ESP,GK,Manchester Utd,Premier League,31,1990,38.0,0,0,0,0,0,0,1,0.0,1,0,0,0,1,1,15,3,0,2022-2023,90.0,2.3684210526315788,0.0
Rk,Player,Nation,Pos,Squad,Comp,0,0,90.0,0,0,3,3,3,Tkl,0,0.0,0,0,0,0,0,0,0,0,0,2022-2023,90.0,0.0,0.0
1001,Dario Gebuhr,GER,DF,Eint Frankfurt,Bundesliga,19,2003,0.2,0,0,0,0,0,0,1,0.0,1,0,0,0,0,0,0,0,0,2022-2023,90.0,0.0,0.0
1002,Dennis Geiger,GER,MF,Hoffenheim,Bundesliga,24,1998,21.7,45,25,15,28,2,22,35,62.9,13,27,3,24,24,69,18,2,0,2022-2023,90.0,99.53917050691244,186.63594470046084
1003,Joe Gelhardt,ENG,FW,Leeds United,Premier League,20,2002,2.4,6,2,1,3,2,3,5,60.0,2,5,0,5,0,6,4,0,0,2022-2023,90.0,0.0,225.00000000000003
1004,Valentin Gendrey,FRA,DF,Lecce,Serie A,22,2000,34.5,88,57,54,25,9,40,71,56.3,31,45,4,41,37,125,89,0,0,2022-2023,90.0,96.52173913043478,229.56521739130434
1005,Denis Genreau,AUS,MF,Toulouse,Ligue 1,23,1999,7.3,35,13,16,12,7,13,31,41.9,18,16,1,15,8,43,9,0,0,2022-2023,90.0,98.63013698630138,431.5068493150685
1006,Yannick Gerhardt,GER,MF,Wolfsburg,Bundesliga,28,1994,20.7,29,15,10,11,8,12,30,40.0,18,26,5,21,7,36,24,0,0,2022-2023,90.0,30.434782608695656,126.08695652173914
1007,Valère Germain,FRA,"FW,MF",Montpellier,Ligue 1,32,1990,7.6,13,11,3,5,5,4,12,33.3,8,8,0,8,6,19,12,0,0,2022-2023,90.0,71.05263157894737,153.94736842105263
1008,Gerson,BRA,MF,Marseille,Ligue 1,25,1997,4.6,6,4,1,4,1,3,5,60.0,2,5,0,5,2,8,4,0,0,2022-2023,90.0,39.130434782608695,117.3913043478261
1009,Ismaël Gharbi,ESP,"MF,FW",Paris S-G,Ligue 1,18,2004,0.6,0,0,0,0,0,0,2,0.0,2,2,0,2,3,3,0,0,0,2022-2023,90.0,450.00000000000006,0.0
1010,Paolo Ghiglione,ITA,DF,Cremonese,Serie A,25,1997,7.9,16,11,10,3,3,10,23,43.5,13,9,4,5,4,20,12,0,0,2022-2023,90.0,45.56962025316455,182.2784810126582
1011,Saman Ghoddos,IRN,"MF,FW",Brentford,Premier League,28,1993,1.5,2,1,0,1,1,1,3,33.3,2,5,1,4,4,6,2,0,0,2022-2023,90.0,240.0,120.0
1012,Faouzi Ghoulam,ALG,DF,Angers,Ligue 1,31,1991,5.3,3,3,1,1,1,3,5,60.0,2,4,2,2,4,7,12,1,0,2022-2023,90.0,67.9245283018868,50.943396226415096
1013,Morgan Gibbs-White,ENG,"FW,MF",Wolves,Premier League,22,2000,2.0,3,1,3,0,0,2,4,50.0,2,2,0,2,1,4,3,0,0,2022-2023,90.0,45.0,135.0
1014,Morgan Gibbs-White,ENG,"MF,FW",Nott'ham Forest,Premier League,22,2000,33.0,26,14,7,7,12,11,33,33.3,22,23,4,19,14,40,15,0,0,2022-2023,90.0,38.18181818181819,70.90909090909092
1015,Niko Gießelmann,GER,DF,Union Berlin,Bundesliga,30,1991,14.5,21,11,9,9,3,13,31,41.9,18,17,5,12,9,30,28,0,0,2022-2023,90.0,55.86206896551724,130.3448275862069
1016,Samuel Gigot,FRA,DF,Marseille,Ligue 1,28,1993,20.9,46,24,22,21,3,12,15,80.0,3,24,7,17,45,91,85,1,0,2022-2023,90.0,193.7799043062201,198.08612440191388
1017,Rafał Gikiewicz,POL,GK,Augsburg,Bundesliga,34,1987,23.0,2,2,2,0,0,2,3,66.7,1,0,0,0,0,2,15,5,0,2022-2023,90.0,0.0,7.82608695652174
1018,Bryan Gil,ESP,"MF,FW",Tottenham,Premier League,21,2001,1.6,3,1,3,0,0,0,3,0.0,3,3,0,3,1,4,1,0,0,2022-2023,90.0,56.25,168.75
1019,Bryan Gil,ESP,"FW,DF",Sevilla,La Liga,21,2001,10.2,22,11,11,7,4,10,23,43.5,13,10,0,10,8,30,10,0,0,2022-2023,90.0,70.58823529411765,194.11764705882354
1020,David Gil,ESP,GK,Cádiz,La Liga,28,1994,4.0,0,0,0,0,0,0,0,0.0,0,0,0,0,0,0,3,0,0,2022-2023,90.0,0.0,0.0
1021,Óscar Gil,ESP,DF,Espanyol,La Liga,25,1997,28.4,63,37,38,16,9,32,61,52.5,29,51,18,33,31,94,55,1,0,2022-2023,90.0,98.23943661971832,199.64788732394368
1022,Mario Gila,ESP,DF,Lazio,Serie A,21,2000,1.0,3,1,3,0,0,0,1,0.0,1,0,0,0,3,6,3,0,0,2022-2023,90.0,270.0,270.0
1023,Billy Gilmour,SCO,MF,Brighton,Premier League,21,2001,5.6,5,2,2,2,1,2,8,25.0,6,5,2,3,6,11,5,0,0,2022-2023,90.0,96.42857142857143,80.35714285714286
1024,Álvaro Giménez,ESP,FW,Cádiz,La Liga,31,1991,0.2,0,0,0,0,0,0,1,0.0,1,0,0,0,0,0,0,0,0,2022-2023,90.0,0.0,0.0
1025,Gvidas Gineitis,LTU,MF,Torino,Serie A,18,2004,1.5,3,1,0,2,1,1,2,50.0,1,0,0,0,0,3,1,0,0,2022-2023,90.0,0.0,180.0
Rk,Player,Nation,Pos,Squad,Comp,0,0,90.0,0,0,3,3,3,Tkl,0,0.0,0,0,0,0,0,0,0,0,0,2022-2023,90.0,0.0,0.0
1026,Matthias Ginter,GER,DF,Freiburg,Bundesliga,28,1994,34.0,43,20,29,12,2,26,40,65.0,14,40,24,16,35,78,153,3,0,2022-2023,90.0,92.64705882352942,113.82352941176471
1027,Andrei Girotto,BRA,"DF,MF",Nantes,Ligue 1,30,1992,35.0,122,73,71,45,6,74,132,56.1,58,55,24,31,73,195,176,1,0,2022-2023,90.0,187.71428571428572,313.7142857142857
1028,Olivier Giroud,FRA,FW,Milan,Serie A,35,1986,23.8,8,5,2,4,2,2,10,20.0,8,11,3,8,3,11,23,0,0,2022-2023,90.00000000000001,11.344537815126051,30.252100840336137
1029,Jamie Gittens,ENG,"FW,MF",Dortmund,Bundesliga,17,2004,5.9,8,4,2,5,1,2,7,28.6,5,1,0,1,1,9,2,0,0,2022-2023,90.0,15.254237288135592,122.03389830508473
1030,Serge Gnabry,GER,"FW,MF",Bayern Munich,Bundesliga,27,1995,21.6,35,23,11,14,10,17,43,39.5,26,24,1,23,11,46,5,1,0,2022-2023,90.0,45.83333333333333,145.83333333333331
1031,Wilfried Gnonto,ITA,"FW,MF",Leeds United,Premier League,18,2003,15.0,27,17,7,15,5,10,30,33.3,20,24,1,23,5,32,7,0,0,2022-2023,90.0,30.0,162.0
1032,Ben Godfrey,ENG,DF,Everton,Premier League,24,1998,8.9,20,11,13,5,2,11,29,37.9,18,12,6,6,8,28,33,1,0,2022-2023,90.0,80.89887640449439,202.24719101123597
1033,Pierluigi Gollini,ITA,GK,Fiorentina,Serie A,27,1995,3.0,1,0,1,0,0,1,1,100.0,0,0,0,0,0,1,2,0,0,2022-2023,90.0,0.0,30.0
1034,Pierluigi Gollini,ITA,GK,Napoli,Serie A,27,1995,4.0,0,0,0,0,0,0,0,0.0,0,0,0,0,0,0,1,0,0,2022-2023,90.0,0.0,0.0
1035,Aleksandr Golovin,RUS,"MF,FW",Monaco,Ligue 1,26,1996,27.4,62,36,19,32,11,28,72,38.9,44,28,1,27,37,99,10,0,0,2022-2023,90.0,121.53284671532849,203.64963503649636
1036,André Gomes,POR,MF,Lille,Ligue 1,29,1993,18.1,37,19,12,17,8,19,52,36.5,33,20,5,15,9,46,16,1,0,2022-2023,90.0,44.75138121546961,183.97790055248618
1037,Angel Gomes,ENG,MF,Lille,Ligue 1,21,2000,31.3,41,19,12,21,8,18,49,36.7,31,22,2,20,13,54,11,1,0,2022-2023,90.0,37.38019169329073,117.89137380191693
1038,João Gomes,BRA,MF,Wolves,Premier League,21,2001,7.3,29,13,14,14,1,13,23,56.5,10,12,3,9,4,33,11,0,0,2022-2023,90.0,49.31506849315069,357.5342465753425
1039,Toti Gomes,POR,DF,Wolves,Premier League,23,1999,10.9,15,9,11,4,0,9,13,69.2,4,16,8,8,11,26,51,0,0,2022-2023,90.0,90.82568807339449,123.8532110091743
1040,Dani Gómez,ESP,"MF,FW",Espanyol,La Liga,24,1998,1.0,2,1,1,1,0,1,2,50.0,1,0,0,0,1,3,0,0,0,2022-2023,90.0,90.0,180.0
1041,Joe Gomez,ENG,DF,Liverpool,Premier League,25,1997,16.3,28,21,15,11,2,11,19,57.9,8,17,11,6,24,52,51,2,0,2022-2023,90.0,132.51533742331287,154.60122699386503
1042,Maxi Gómez,URU,FW,Valencia,La Liga,25,1996,1.2,0,0,0,0,0,0,0,0.0,0,0,0,0,0,0,2,0,0,2022-2023,90.0,0.0,0.0
1043,Moi Gómez,ESP,"MF,FW",Osasuna,La Liga,28,1994,27.3,26,17,9,14,3,15,32,46.9,17,15,3,12,10,36,5,1,0,2022-2023,90.0,32.967032967032964,85.71428571428571
1044,Papu Gómez,ARG,"FW,MF",Sevilla,La Liga,34,1988,11.8,6,4,3,3,0,2,10,20.0,8,8,1,7,4,10,5,0,0,2022-2023,90.0,30.508474576271183,45.762711864406775
1045,Sergi Gómez,ESP,DF,Espanyol,La Liga,30,1992,26.0,29,16,20,9,0,18,22,81.8,4,33,19,14,27,56,125,1,0,2022-2023,90.00000000000001,93.46153846153847,100.3846153846154
1046,Sergio Gómez,ESP,"DF,MF",Manchester City,Premier League,21,2000,3.9,9,4,6,1,2,5,8,62.5,3,5,3,2,2,11,9,1,0,2022-2023,90.0,46.15384615384615,207.69230769230768
1047,Antonio Gomis,ESP,GK,Atlético Madrid,La Liga,19,2003,0.1,0,0,0,0,0,0,0,0.0,0,0,0,0,0,0,0,0,0,2022-2023,90.0,0.0,0.0
1048,Maxime Gonalons,FRA,MF,Clermont Foot,Ligue 1,33,1989,16.1,52,32,25,21,6,25,53,47.2,28,21,1,20,20,72,7,1,0,2022-2023,90.0,111.80124223602483,290.6832298136646
1049,Diego González,ESP,DF,Elche,La Liga,27,1995,10.6,12,7,9,3,0,7,11,63.6,4,14,12,2,7,19,50,1,0,2022-2023,90.0,59.43396226415095,101.88679245283019
1050,Édgar González,ESP,DF,Betis,La Liga,25,1997,19.7,28,19,18,7,3,14,27,51.9,13,12,9,3,21,49,120,0,0,2022-2023,90.0,95.93908629441624,127.91878172588832
Rk,Player,Nation,Pos,Squad,Comp,0,0,90.0,0,0,3,3,3,Tkl,0,0.0,0,0,0,0,0,0,0,0,0,2022-2023,90.0,0.0,0.0
1051,Giovanni González,URU,DF,Mallorca,La Liga,27,1994,10.3,16,8,11,2,3,9,22,40.9,13,8,2,6,7,23,22,0,0,2022-2023,90.0,61.165048543689316,139.80582524271844
1052,Joan Gonzàlez,ESP,MF,Lecce,Serie A,20,2002,24.4,48,28,20,18,10,17,51,33.3,34,37,8,29,16,64,28,0,0,2022-2023,90.0,59.016393442622956,177.04918032786887
1053,Nicolás González,ARG,"FW,MF",Fiorentina,Serie A,24,1998,15.0,17,10,3,10,4,5,16,31.3,11,14,0,14,4,21,6,0,0,2022-2023,90.0,24.0,102.0
1054,Nicolás González,ESP,MF,Valencia,La Liga,20,2002,15.6,27,15,11,13,3,9,25,36.0,16,21,7,14,19,46,16,0,0,2022-2023,90.0,109.61538461538461,155.76923076923077
1055,Oumar Gonzalez,CMR,DF,Ajaccio,Ligue 1,24,1998,28.6,51,28,34,13,4,23,37,62.2,14,32,11,21,52,103,82,0,0,2022-2023,90.0,163.63636363636365,160.48951048951048
1056,Roberto González,ESP,"FW,MF",Betis,La Liga,21,2001,0.6,0,0,0,0,0,0,1,0.0,1,0,0,0,1,1,0,0,0,2022-2023,90.0,150.0,0.0
1057,Jacek Góralski,POL,MF,Bochum,Bundesliga,29,1992,1.6,6,3,3,3,0,4,6,66.7,2,4,0,4,3,9,5,0,0,2022-2023,90.0,168.75,337.5
1058,Anthony Gordon,ENG,"FW,MF",Newcastle Utd,Premier League,21,2001,5.4,14,12,5,7,2,9,20,45.0,11,9,1,8,2,16,1,1,0,2022-2023,90.0,33.33333333333333,233.33333333333331
1059,Anthony Gordon,ENG,FW,Everton,Premier League,21,2001,12.2,34,22,17,10,7,8,24,33.3,16,19,0,19,4,38,11,0,0,2022-2023,90.0,29.508196721311478,250.81967213114757
1060,Leon Goretzka,GER,MF,Bayern Munich,Bundesliga,27,1995,19.2,43,24,21,16,6,27,48,56.3,21,40,3,37,30,73,32,0,0,2022-2023,90.0,140.625,201.5625
1061,Andoni Gorosabel,ESP,DF,Real Sociedad,La Liga,25,1996,19.0,41,25,23,9,9,26,43,60.5,17,21,2,19,17,58,23,0,0,2022-2023,90.0,80.52631578947368,194.21052631578948
1062,Robin Gosens,GER,DF,Inter,Serie A,28,1994,13.2,34,18,15,10,9,15,25,60.0,10,16,2,14,23,57,15,0,0,2022-2023,90.0,156.8181818181818,231.8181818181818
1063,Mario Götze,GER,MF,Eint Frankfurt,Bundesliga,30,1992,30.4,42,25,13,22,7,14,47,29.8,33,25,0,25,13,55,12,0,0,2022-2023,90.0,38.48684210526316,124.34210526315789
1064,Amine Gouiri,ALG,"FW,MF",Nice,Ligue 1,22,2000,2.5,1,1,1,0,0,0,1,0.0,1,1,0,1,0,1,3,0,0,2022-2023,90.0,0.0,36.0
1065,Amine Gouiri,ALG,"FW,MF",Rennes,Ligue 1,22,2000,28.0,42,25,14,16,12,14,33,42.4,19,21,0,21,12,54,10,0,0,2022-2023,90.0,38.57142857142857,135.0
1066,Jeffrey Gouweleeuw,NED,DF,Augsburg,Bundesliga,31,1991,31.1,42,27,19,17,6,24,49,49.0,25,41,23,18,50,92,141,2,0,2022-2023,90.0,144.6945337620579,121.54340836012861
1067,Jonathan Gradit,FRA,DF,Lens,Ligue 1,29,1992,31.4,62,40,30,25,7,31,53,58.5,22,40,26,14,38,100,83,0,0,2022-2023,90.0,108.9171974522293,177.70700636942678
1068,José Gragera,ESP,"MF,DF",Espanyol,La Liga,21,2000,5.1,19,9,11,6,2,6,11,54.5,5,10,4,6,7,26,18,0,0,2022-2023,90.0,123.52941176470588,335.29411764705884
1069,Alberto Grassi,ITA,MF,Empoli,Serie A,27,1995,13.3,26,21,13,13,0,15,24,62.5,9,23,12,11,27,53,45,0,0,2022-2023,90.0,182.70676691729324,175.93984962406014
1070,Ryan Gravenberch,NED,MF,Bayern Munich,Bundesliga,20,2002,6.4,17,8,4,10,3,7,13,53.8,6,9,1,8,9,26,10,0,0,2022-2023,90.0,126.5625,239.0625
1071,Andrew Gravillon,GLP,DF,Torino,Serie A,24,1998,3.5,3,3,0,3,0,0,0,0.0,0,4,2,2,9,12,16,0,0,2022-2023,90.0,231.42857142857142,77.14285714285714
1072,Andrew Gravillon,GLP,DF,Reims,Ligue 1,24,1998,11.5,16,8,9,6,1,8,13,61.5,5,18,9,9,21,37,36,0,0,2022-2023,90.0,164.34782608695653,125.21739130434784
1073,Demarai Gray,JAM,"FW,MF",Everton,Premier League,26,1996,27.9,33,24,9,14,10,17,31,54.8,14,23,3,20,13,46,18,0,0,2022-2023,90.0,41.935483870967744,106.45161290322581
1074,Adrian Grbić,AUT,"MF,FW",Lorient,Ligue 1,25,1996,0.3,0,0,0,0,0,0,1,0.0,1,3,0,3,0,0,0,0,0,2022-2023,90.0,0.0,0.0
1075,Ivo Grbić,CRO,GK,Atlético Madrid,La Liga,26,1996,10.2,0,0,0,0,0,0,0,0.0,0,0,0,0,0,0,9,1,0,2022-2023,90.0,0.0,0.0
Rk,Player,Nation,Pos,Squad,Comp,0,0,90.0,0,0,3,3,3,Tkl,0,0.0,0,0,0,0,0,0,0,0,0,2022-2023,90.0,0.0,0.0
1076,Jack Grealish,ENG,FW,Manchester City,Premier League,26,1995,22.8,25,16,10,12,3,13,23,56.5,10,17,3,14,7,32,9,0,0,2022-2023,90.0,27.631578947368418,98.68421052631578
1077,Sam Greenwood,ENG,"MF,FW",Leeds United,Premier League,20,2002,4.7,15,7,7,8,0,8,21,38.1,13,10,2,8,1,16,1,0,0,2022-2023,90.0,19.148936170212764,287.23404255319144
1078,Michael Gregoritsch,AUT,FW,Freiburg,Bundesliga,28,1994,23.9,19,12,6,9,4,3,21,14.3,18,23,4,19,5,24,10,0,0,2022-2023,90.0,18.82845188284519,71.54811715481172
1079,Dominik Greif,SVK,GK,Mallorca,La Liga,25,1997,1.0,0,0,0,0,0,0,0,0.0,0,0,0,0,0,0,0,0,0,2022-2023,90.0,0.0,0.0
1080,Leo Greiml,AUT,DF,Schalke 04,Bundesliga,21,2001,4.0,10,5,4,5,1,5,12,41.7,7,7,3,4,3,13,16,0,0,2022-2023,90.0,67.5,225.0
1081,Clément Grenier,FRA,MF,Mallorca,La Liga,31,1991,8.0,20,8,6,12,2,10,20,50.0,10,9,1,8,6,26,7,0,0,2022-2023,90.0,67.5,225.0
1082,Antoine Griezmann,FRA,"FW,MF",Atlético Madrid,La Liga,31,1991,31.8,49,34,15,23,11,20,66,30.3,46,34,3,31,24,73,31,0,0,2022-2023,90.0,67.9245283018868,138.67924528301887
1083,Vincenzo Grifo,ITA,"MF,FW",Freiburg,Bundesliga,29,1993,26.8,29,16,6,15,8,13,31,41.9,18,18,1,17,19,48,19,0,0,2022-2023,90.0,63.805970149253724,97.38805970149252
1084,Lennart Grill,GER,GK,Union Berlin,Bundesliga,23,1999,5.0,0,0,0,0,0,0,1,0.0,1,0,0,0,0,0,1,1,0,2022-2023,90.0,0.0,0.0
1085,Christian Groß,GER,MF,Werder Bremen,Bundesliga,33,1989,21.0,56,25,20,34,2,29,60,48.3,31,20,5,15,23,79,38,1,0,2022-2023,90.0,98.57142857142857,240.0
1086,Pascal Groß,GER,"MF,DF",Brighton,Premier League,31,1991,36.0,59,38,23,27,9,25,55,45.5,30,32,10,22,13,72,21,1,0,2022-2023,90.0,32.5,147.5
1087,Brajan Gruda,GER,MF,Mainz 05,Bundesliga,18,2004,0.0,0,0,0,0,0,0,0,0.0,0,0,0,0,0,0,0,0,0,2022-2023,,,
1088,Ilia Gruev,BUL,MF,Werder Bremen,Bundesliga,22,2000,17.6,44,27,16,25,3,18,31,58.1,13,23,6,17,22,66,21,1,0,2022-2023,90.0,112.5,225.0
1089,Carlos Gruezo,ECU,MF,Augsburg,Bundesliga,27,1995,10.7,21,12,12,9,0,9,16,56.3,7,13,4,9,10,31,15,0,0,2022-2023,90.0,84.11214953271029,176.6355140186916
1090,Vicente Guaita,ESP,GK,Crystal Palace,Premier League,35,1987,27.0,0,0,0,0,0,0,0,0.0,0,0,0,0,0,0,9,1,0,2022-2023,90.0,0.0,0.0
1091,Andrés Guardado,MEX,MF,Betis,La Liga,35,1986,15.3,41,25,17,20,4,18,43,41.9,25,14,5,9,23,64,29,0,0,2022-2023,90.0,135.2941176470588,241.17647058823528
1092,Sergi Guardiola,ESP,FW,Valladolid,La Liga,31,1991,5.6,12,7,6,5,1,2,4,50.0,2,6,0,6,2,14,7,0,0,2022-2023,90.0,32.142857142857146,192.85714285714286
1093,Sergi Guardiola,ESP,FW,Cádiz,La Liga,31,1991,12.9,9,7,0,6,3,3,12,25.0,9,5,0,5,3,12,7,0,0,2022-2023,90.0,20.930232558139533,62.7906976744186
1094,Nemanja Gudelj,SRB,"DF,MF",Sevilla,La Liga,30,1991,30.9,43,33,22,18,3,20,33,60.6,13,39,29,10,34,77,102,1,0,2022-2023,90.0,99.02912621359224,125.24271844660194
1095,Gabriel Gudmundsson,SWE,"DF,FW",Lille,Ligue 1,23,1999,9.3,19,11,7,10,2,12,22,54.5,10,11,2,9,10,29,20,0,0,2022-2023,90.0,96.77419354838709,183.87096774193546
1096,Gonçalo Guedes,POR,"FW,MF",Wolves,Premier League,25,1996,7.9,8,6,4,3,1,5,8,62.5,3,4,0,4,1,9,2,0,0,2022-2023,90.0,11.392405063291138,91.1392405063291
1097,Axel Gueguin,FRA,"FW,MF",Montpellier,Ligue 1,17,2005,0.3,0,0,0,0,0,0,0,0.0,0,1,0,1,0,0,0,0,0,2022-2023,90.0,0.0,0.0
1098,Marc Guéhi,ENG,DF,Crystal Palace,Premier League,22,2000,37.0,52,27,39,11,2,26,42,61.9,16,45,24,21,45,97,134,3,0,2022-2023,90.0,109.45945945945947,126.4864864864865
1099,Mattéo Guendouzi,FRA,MF,Marseille,Ligue 1,23,1999,23.4,39,18,9,21,9,14,38,36.8,24,12,5,7,21,60,18,0,0,2022-2023,89.99999999999999,80.76923076923076,150.0
1100,Javier Guerra,ESP,MF,Valencia,La Liga,19,2003,6.7,16,13,7,4,5,9,20,45.0,11,8,1,7,11,27,9,0,0,2022-2023,90.0,147.76119402985074,214.92537313432834
Rk,Player,Nation,Pos,Squad,Comp,0,0,90.0,0,0,3,3,3,Tkl,0,0.0,0,0,0,0,0,0,0,0,0,2022-2023,90.0,0.0,0.0
1101,Raphaël Guerreiro,POR,"DF,MF",Dortmund,Bundesliga,28,1993,25.4,36,20,13,15,8,21,34,61.8,13,21,2,19,36,72,23,0,0,2022-2023,90.0,127.55905511811024,127.55905511811024
1102,Axel Guessand,FRA,DF,Udinese,Serie A,17,2004,0.9,2,1,2,0,0,1,2,50.0,1,1,0,1,2,4,3,0,0,2022-2023,90.0,200.0,200.0
1103,Evann Guessand,CIV,"FW,MF",Nantes,Ligue 1,21,2001,14.0,24,16,8,13,3,6,12,50.0,6,17,1,16,9,33,6,0,0,2022-2023,90.0,57.857142857142854,154.28571428571428
1104,Ander Guevara,ESP,MF,Real Sociedad,La Liga,25,1997,2.5,5,2,2,2,1,1,4,25.0,3,6,1,5,2,7,3,0,0,2022-2023,90.0,72.0,180.0
1105,Pape Gueye,SEN,MF,Sevilla,La Liga,23,1999,13.0,37,22,13,21,3,16,33,48.5,17,21,5,16,22,59,10,0,0,2022-2023,90.00000000000001,152.30769230769232,256.1538461538462
1106,Pape Gueye,SEN,"MF,DF",Marseille,Ligue 1,23,1999,5.5,18,7,10,7,1,7,15,46.7,8,9,2,7,9,27,2,0,0,2022-2023,90.0,147.27272727272728,294.54545454545456
1107,Josuha Guilavogui,FRA,"DF,MF",Wolfsburg,Bundesliga,31,1990,13.1,18,11,7,10,1,6,17,35.3,11,19,13,6,23,41,52,0,0,2022-2023,90.0,158.01526717557252,123.66412213740459
1108,Frederic Guilbert,FRA,DF,Strasbourg,Ligue 1,27,1994,16.2,47,29,18,23,6,25,43,58.1,18,24,3,21,43,90,33,1,0,2022-2023,90.0,238.88888888888889,261.11111111111114
1109,Hugo Guillamón,ESP,MF,Valencia,La Liga,22,2000,18.1,20,12,10,8,2,8,24,33.3,16,14,2,12,19,39,30,2,0,2022-2023,90.0,94.47513812154695,99.44751381215468
1110,Bruno Guimarães,BRA,MF,Newcastle Utd,Premier League,24,1997,30.3,78,40,27,46,5,38,65,58.5,27,28,4,24,36,114,22,1,0,2022-2023,90.0,106.93069306930693,231.68316831683168
1111,Serhou Guirassy,GUI,MF,Rennes,Ligue 1,26,1996,0.3,0,0,0,0,0,0,0,0.0,0,0,0,0,0,0,0,0,0,2022-2023,90.0,0.0,0.0
1112,Serhou Guirassy,GUI,FW,Stuttgart,Bundesliga,26,1996,18.3,4,1,2,2,0,1,2,50.0,1,7,2,5,0,4,14,0,0,2022-2023,90.0,0.0,19.672131147540984
1113,Rafik Guitane,FRA,FW,Reims,Ligue 1,23,1999,0.0,0,0,0,0,0,0,0,0.0,0,0,0,0,0,0,1,0,0,2022-2023,,,
1114,Péter Gulácsi,HUN,GK,RB Leipzig,Bundesliga,32,1990,6.0,0,0,0,0,0,0,0,0.0,0,0,0,0,0,0,2,0,0,2022-2023,90.0,0.0,0.0
1115,Manuel Gulde,GER,DF,Freiburg,Bundesliga,31,1991,7.1,14,8,10,4,0,2,4,50.0,2,5,1,4,19,33,25,0,0,2022-2023,90.0,240.84507042253523,177.46478873239437
1116,Gerard Gumbau,ESP,MF,Elche,La Liga,27,1994,30.4,44,25,17,23,4,18,51,35.3,33,32,8,24,28,72,40,0,0,2022-2023,90.0,82.89473684210526,130.26315789473685
1117,Robert Gumny,POL,DF,Augsburg,Bundesliga,24,1998,22.4,34,24,13,15,6,11,27,40.7,16,21,7,14,26,60,62,1,0,2022-2023,90.0,104.46428571428572,136.60714285714286
1118,İlkay Gündoğan,GER,MF,Manchester City,Premier League,31,1990,26.1,30,18,7,13,10,12,34,35.3,22,18,3,15,20,50,13,0,0,2022-2023,90.0,68.9655172413793,103.44827586206895
1119,Christian Günter,GER,"DF,MF",Freiburg,Bundesliga,29,1993,30.5,29,21,18,9,2,13,43,30.2,30,22,4,18,16,45,41,0,0,2022-2023,90.0,47.213114754098356,85.57377049180327
1120,Koray Günter,GER,DF,Hellas Verona,Serie A,27,1994,11.1,10,6,1,8,1,4,7,57.1,3,24,15,9,30,40,46,0,0,2022-2023,90.0,243.24324324324326,81.0810810810811
1121,Koray Günter,GER,DF,Sampdoria,Serie A,27,1994,8.6,10,8,6,4,0,6,9,66.7,3,10,5,5,11,21,46,0,0,2022-2023,90.0,115.11627906976746,104.65116279069768
1122,Gorka Guruzeta,ESP,FW,Athletic Club,La Liga,25,1996,15.8,24,20,6,12,6,11,24,45.8,13,23,2,21,4,28,8,0,0,2022-2023,90.0,22.784810126582276,136.70886075949366
1123,Malo Gusto,FRA,DF,Lyon,Ligue 1,19,2003,17.7,42,26,23,11,8,21,43,48.8,22,22,5,17,28,70,23,1,0,2022-2023,90.0,142.3728813559322,213.55932203389833
1124,Raúl Guti,ESP,MF,Elche,La Liga,25,1996,12.4,18,12,8,9,1,8,18,44.4,10,10,3,7,8,26,6,0,0,2022-2023,90.0,58.064516129032256,130.6451612903226
1125,Miguel Gutiérrez,ESP,DF,Girona,La Liga,21,2001,26.6,41,23,23,13,5,23,37,62.2,14,23,5,18,18,59,42,1,0,2022-2023,90.0,60.90225563909774,138.72180451127818
Rk,Player,Nation,Pos,Squad,Comp,0,0,90.0,0,0,3,3,3,Tkl,0,0.0,0,0,0,0,0,0,0,0,0,2022-2023,90.0,0.0,0.0
1126,Joško Gvardiol,CRO,DF,RB Leipzig,Bundesliga,20,2002,24.1,23,17,15,8,0,9,22,40.9,13,34,17,17,34,57,76,1,0,2022-2023,90.0,126.97095435684648,85.89211618257261
1127,Darko Gyabi,ENG,FW,Leeds United,Premier League,18,2004,0.1,2,2,1,1,0,0,0,0.0,0,2,0,2,0,2,0,0,0,2022-2023,90.0,0.0,1800.0
1128,Emmanuel Gyasi,GHA,"FW,DF",Spezia,Serie A,28,1994,31.2,24,15,11,10,3,9,36,25.0,27,24,6,18,8,32,26,0,0,2022-2023,90.0,23.076923076923077,69.23076923076923
1129,Norbert Gyömbér,SVK,DF,Salernitana,Serie A,30,1992,19.3,32,23,25,6,1,16,24,66.7,8,33,22,11,35,67,92,0,0,2022-2023,90.0,163.21243523316062,149.22279792746113
1130,Christian Gytkjær,DEN,"FW,MF",Monza,Serie A,32,1990,6.2,6,2,1,4,1,2,5,40.0,3,6,1,5,0,6,2,0,0,2022-2023,90.0,0.0,87.09677419354838
1131,Erling Haaland,NOR,FW,Manchester City,Premier League,22,2000,30.8,3,2,0,2,1,1,5,20.0,4,12,4,8,3,6,14,0,0,2022-2023,90.0,8.766233766233766,8.766233766233766
1132,Nicolas Haas,SUI,MF,Empoli,Serie A,26,1996,12.8,27,13,16,6,5,12,24,50.0,12,16,4,12,8,35,27,0,0,2022-2023,90.0,56.25,189.84375
1133,Janik Haberer,GER,MF,Union Berlin,Bundesliga,28,1994,24.3,29,17,8,18,3,17,48,35.4,31,35,2,33,14,43,25,0,0,2022-2023,90.0,51.85185185185185,107.4074074074074
1134,Alexander Hack,GER,DF,Mainz 05,Bundesliga,28,1993,12.6,30,18,21,9,0,19,33,57.6,14,18,5,13,24,54,45,1,0,2022-2023,90.0,171.42857142857144,214.2857142857143
1135,Munir El Haddadi,MAR,"MF,FW",Getafe,La Liga,26,1995,12.8,12,7,3,7,2,2,10,20.0,8,23,2,21,9,21,7,0,0,2022-2023,90.0,63.28125,84.375
1136,Jaouen Hadjam,ALG,DF,Nantes,Ligue 1,19,2003,8.9,27,21,13,9,5,16,25,64.0,9,10,3,7,12,39,12,0,0,2022-2023,90.0,121.34831460674158,273.03370786516854
1137,Dennis Hadzikadunic,BIH,DF,Mallorca,La Liga,24,1998,6.8,9,6,4,5,0,4,4,100.0,0,5,4,1,3,12,27,0,0,2022-2023,90.0,39.705882352941174,119.11764705882352
1138,André Hahn,GER,"FW,MF",Augsburg,Bundesliga,31,1990,4.3,9,5,4,4,1,8,12,66.7,4,9,2,7,4,13,14,0,0,2022-2023,90.0,83.72093023255815,188.37209302325584
1139,Amadou Haidara,MLI,MF,RB Leipzig,Bundesliga,24,1998,15.9,25,11,15,10,0,13,34,38.2,21,26,6,20,26,51,20,0,0,2022-2023,90.0,147.16981132075472,141.50943396226415
1140,Massadio Haïdara,MLI,"DF,MF",Lens,Ligue 1,29,1992,18.6,24,16,9,9,6,12,24,50.0,12,26,9,17,36,60,39,1,0,2022-2023,90.0,174.19354838709674,116.1290322580645
1141,Achraf Hakimi,MAR,"DF,MF",Paris S-G,Ligue 1,23,1998,22.8,54,34,19,20,15,31,59,52.5,28,34,2,32,16,70,19,0,0,2022-2023,90.0,63.1578947368421,213.15789473684208
1142,Lewis Hall,ENG,DF,Chelsea,Premier League,17,2004,7.3,23,12,19,4,0,15,22,68.2,7,8,0,8,11,34,11,1,0,2022-2023,90.0,135.6164383561644,283.56164383561645
1143,Sébastien Haller,CIV,FW,Dortmund,Bundesliga,28,1994,13.6,5,4,2,1,2,0,4,0.0,4,8,0,8,1,6,10,0,0,2022-2023,90.0,6.617647058823529,33.088235294117645
1144,Marcel Halstenberg,GER,DF,RB Leipzig,Bundesliga,30,1991,17.3,40,21,20,15,5,23,41,56.1,18,22,1,21,21,61,29,0,0,2022-2023,90.0,109.24855491329478,208.09248554913293
1145,Mathis Hamdi,FRA,DF,Troyes,Ligue 1,18,2003,0.8,0,0,0,0,0,0,1,0.0,1,0,0,0,1,1,1,0,0,2022-2023,90.0,112.5,0.0
1146,Ben Hamed Touré,CIV,FW,Ajaccio,Ligue 1,18,2003,2.3,4,4,2,2,0,1,5,20.0,4,2,0,2,1,5,4,0,0,2022-2023,90.0,39.130434782608695,156.52173913043478
1147,Romain Hamouma,FRA,"FW,MF",Ajaccio,Ligue 1,35,1987,12.0,8,3,3,3,2,3,6,50.0,3,8,0,8,2,10,2,0,0,2022-2023,90.0,15.0,60.0
1148,Saïd Hamulic,BIH,FW,Toulouse,Ligue 1,21,2000,1.2,0,0,0,0,0,0,0,0.0,0,0,0,0,0,0,0,0,0,2022-2023,90.0,0.0,0.0
1149,Andreas Hanche-Olsen,NOR,DF,Mainz 05,Bundesliga,25,1997,16.6,35,23,24,7,4,22,39,56.4,17,16,8,8,33,68,77,2,0,2022-2023,90.0,178.9156626506024,189.7590361445783
1150,Samir Handanović,SVN,GK,Inter,Serie A,38,1984,13.7,0,0,0,0,0,0,0,0.0,0,0,0,0,0,0,5,0,0,2022-2023,90.0,0.0,0.0
Rk,Player,Nation,Pos,Squad,Comp,0,0,90.0,0,0,3,3,3,Tkl,0,0.0,0,0,0,0,0,0,0,0,0,2022-2023,90.0,0.0,0.0
1151,Genki Haraguchi,JPN,MF,Stuttgart,Bundesliga,31,1991,8.3,16,7,7,7,2,4,16,25.0,12,13,2,11,8,24,6,0,0,2022-2023,90.0,86.74698795180721,173.49397590361443
1152,Genki Haraguchi,JPN,MF,Union Berlin,Bundesliga,31,1991,5.5,12,8,1,10,1,3,9,33.3,6,7,1,6,3,15,9,0,0,2022-2023,90.0,49.09090909090909,196.36363636363637
1153,Amine Harit,MAR,"MF,FW",Marseille,Ligue 1,25,1997,5.7,6,4,0,3,3,3,8,37.5,5,4,1,3,4,10,6,0,0,2022-2023,90.0,63.1578947368421,94.73684210526315
1154,Luke Harris,WAL,"MF,FW",Fulham,Premier League,17,2005,0.1,0,0,0,0,0,0,0,0.0,0,0,0,0,0,0,0,0,0,2022-2023,90.0,0.0,0.0
1155,Jack Harrison,ENG,"FW,MF",Leeds United,Premier League,25,1996,30.1,41,17,5,15,21,12,52,23.1,40,47,2,45,22,63,25,0,0,2022-2023,90.00000000000001,65.78073089700997,122.59136212624585
1156,Abdou Harroui,NED,MF,Sassuolo,Serie A,24,1998,7.2,17,6,6,7,4,2,7,28.6,5,6,1,5,2,19,10,0,0,2022-2023,90.0,25.0,212.5
1157,Makoto Hasebe,JPN,DF,Eint Frankfurt,Bundesliga,38,1984,14.5,18,12,16,2,0,7,22,31.8,15,22,9,13,17,35,45,0,0,2022-2023,90.0,105.51724137931033,111.72413793103448
1158,Haissem Hassan,FRA,"FW,MF",Villarreal,La Liga,20,2002,0.6,0,0,0,0,0,0,2,0.0,2,0,0,0,1,1,0,0,0,2022-2023,90.0,150.0,0.0
1159,Hans Hateboer,NED,DF,Atalanta,Serie A,28,1994,15.5,21,13,11,8,2,11,27,40.7,16,23,4,19,12,33,25,0,0,2022-2023,90.0,69.6774193548387,121.93548387096774
1160,Kai Havertz,GER,"FW,MF",Chelsea,Premier League,23,1999,28.5,34,16,4,20,10,10,30,33.3,20,28,0,28,7,41,41,0,0,2022-2023,90.0,22.105263157894736,107.36842105263159
1161,Eden Hazard,BEL,FW,Real Madrid,La Liga,31,1991,2.2,0,0,0,0,0,0,2,0.0,2,1,0,1,1,1,0,0,0,2022-2023,90.0,40.90909090909091,0.0
1162,Thorgan Hazard,BEL,"FW,DF",Dortmund,Bundesliga,29,1993,5.2,17,6,5,11,1,12,17,70.6,5,6,0,6,5,22,5,0,0,2022-2023,90.0,86.53846153846153,294.2307692307692
1163,Rhys Healey,WAL,FW,Toulouse,Ligue 1,27,1994,0.7,0,0,0,0,0,0,0,0.0,0,0,0,0,0,0,0,0,0,2022-2023,90.0,0.0,0.0
1164,Jan Paul van Hecke,NED,DF,Brighton,Premier League,22,2000,3.3,8,6,3,4,1,5,5,100.0,0,8,5,3,6,14,9,0,0,2022-2023,90.0,163.63636363636363,218.1818181818182
1165,Jonas Hector,GER,DF,Köln,Bundesliga,32,1990,31.4,112,66,59,43,10,66,113,58.4,47,61,9,52,39,151,74,1,0,2022-2023,90.0,111.78343949044587,321.0191082802548
1166,Hwang Hee-chan,KOR,"FW,MF",Wolves,Premier League,26,1996,12.6,20,9,7,8,5,6,20,30.0,14,18,2,16,5,25,5,0,0,2022-2023,90.0,35.714285714285715,142.85714285714286
1167,Gauthier Hein,FRA,"MF,FW",Auxerre,Ligue 1,25,1996,20.8,27,20,13,11,3,18,48,37.5,30,10,0,10,6,33,10,0,0,2022-2023,90.0,25.96153846153846,116.82692307692307
1168,Dominique Heintz,GER,DF,Bochum,Bundesliga,28,1993,8.8,13,9,5,7,1,6,17,35.3,11,11,7,4,12,25,34,0,0,2022-2023,90.0,122.72727272727272,132.95454545454544
1169,Dean Henderson,ENG,GK,Nott'ham Forest,Premier League,25,1997,18.0,0,0,0,0,0,0,0,0.0,0,0,0,0,0,0,12,1,0,2022-2023,90.0,0.0,0.0
1170,Jordan Henderson,ENG,MF,Liverpool,Premier League,32,1990,23.0,32,23,10,18,4,15,36,41.7,21,21,3,18,21,53,16,1,0,2022-2023,90.0,82.17391304347827,125.21739130434784
1171,Liam Henderson,SCO,MF,Empoli,Serie A,26,1996,11.2,13,10,6,5,2,4,21,19.0,17,10,2,8,10,23,10,0,0,2022-2023,90.0,80.35714285714286,104.46428571428572
1172,Jack Hendry,SCO,DF,Cremonese,Serie A,27,1995,2.4,0,0,0,0,0,0,1,0.0,1,2,1,1,1,1,7,0,0,2022-2023,90.0,37.5,0.0
1173,Wayne Hennessey,WAL,GK,Nott'ham Forest,Premier League,35,1987,3.0,1,0,1,0,0,1,1,100.0,0,0,0,0,0,1,2,0,0,2022-2023,90.0,0.0,30.0
1174,Benjamin Henrichs,GER,"DF,MF",RB Leipzig,Bundesliga,25,1997,24.3,73,46,41,29,3,43,66,65.2,23,48,4,44,35,108,46,0,0,2022-2023,90.0,129.62962962962962,270.3703703703704
1175,Henrique,BRA,"DF,FW",Lyon,Ligue 1,28,1994,4.0,9,4,3,2,4,6,13,46.2,7,3,1,2,5,14,8,0,0,2022-2023,90.0,112.5,202.5
Rk,Player,Nation,Pos,Squad,Comp,0,0,90.0,0,0,3,3,3,Tkl,0,0.0,0,0,0,0,0,0,0,0,0,2022-2023,90.0,0.0,0.0
1176,Luiz Henrique,BRA,FW,Betis,La Liga,21,2001,20.1,48,34,27,15,6,20,44,45.5,24,22,0,22,14,62,17,0,0,2022-2023,90.0,62.686567164179095,214.92537313432834
1177,Matheus Henrique,BRA,MF,Sassuolo,Serie A,24,1997,21.6,26,12,9,11,6,12,24,50.0,12,15,4,11,12,38,10,0,0,2022-2023,90.0,49.99999999999999,108.33333333333333
1178,Rico Henry,ENG,DF,Brentford,Premier League,25,1997,36.0,57,31,20,28,9,22,41,53.7,19,29,8,21,30,87,84,1,0,2022-2023,90.0,75.0,142.5
1179,Thomas Henry,FRA,FW,Hellas Verona,Serie A,27,1994,11.4,5,3,1,1,3,1,5,20.0,4,6,2,4,0,5,14,0,0,2022-2023,90.0,0.0,39.473684210526315
1180,Christophe Hérelle,MTQ,DF,Brest,Ligue 1,29,1992,11.8,10,4,7,2,1,4,13,30.8,9,16,11,5,20,30,48,0,0,2022-2023,90.0,152.54237288135593,76.27118644067797
1181,Mario Hermoso,ESP,DF,Atlético Madrid,La Liga,27,1995,23.4,22,15,14,6,2,9,30,30.0,21,19,9,10,19,41,85,1,0,2022-2023,89.99999999999999,73.07692307692308,84.61538461538461
1182,Javi Hernández,ESP,DF,Girona,La Liga,24,1998,12.4,21,12,12,7,2,13,21,61.9,8,10,5,5,7,28,38,0,0,2022-2023,90.0,50.806451612903224,152.41935483870967
1183,Aridane Hernández,ESP,DF,Osasuna,La Liga,33,1989,19.9,21,15,17,4,0,12,25,48.0,13,34,21,13,28,49,96,1,0,2022-2023,90.0,126.63316582914574,94.9748743718593
1184,Lucas Hernández,FRA,DF,Bayern Munich,Bundesliga,26,1996,5.3,6,4,3,3,0,5,6,83.3,1,2,1,1,5,11,7,0,0,2022-2023,90.0,84.9056603773585,101.88679245283019
1185,Luis Hernández,ESP,DF,Cádiz,La Liga,33,1989,35.0,33,21,25,7,1,22,36,61.1,14,31,24,7,31,64,145,0,0,2022-2023,90.0,79.71428571428571,84.85714285714286
1186,Mario Hernández,ESP,DF,Rayo Vallecano,La Liga,23,1999,1.1,3,2,2,1,0,3,7,42.9,4,2,0,2,2,5,0,0,0,2022-2023,90.0,163.63636363636363,245.45454545454544
1187,Theo Hernández,FRA,DF,Milan,Serie A,24,1997,30.8,43,24,27,15,1,22,38,57.9,16,34,7,27,21,64,35,1,0,2022-2023,90.0,61.36363636363637,125.64935064935065
1188,Jorge Herrando,ESP,DF,Osasuna,La Liga,21,2001,0.3,0,0,0,0,0,0,0,0.0,0,1,0,1,0,0,3,0,0,2022-2023,90.0,0.0,0.0
1189,Ander Herrera,ESP,MF,Athletic Club,La Liga,32,1989,7.7,18,10,8,7,3,6,18,33.3,12,12,3,9,11,29,12,0,0,2022-2023,90.0,128.57142857142858,210.3896103896104
1190,Sergio Herrera,ESP,GK,Osasuna,La Liga,29,1993,17.0,2,0,2,0,0,2,2,100.0,0,1,0,1,1,3,6,2,0,2022-2023,90.0,5.294117647058823,10.588235294117647
1191,Yangel Herrera,VEN,"MF,FW",Girona,La Liga,24,1998,10.7,26,9,9,14,3,6,15,40.0,9,14,1,13,4,30,12,0,0,2022-2023,90.0,33.64485981308412,218.69158878504675
1192,Patrick Herrmann,GER,"FW,MF",Gladbach,Bundesliga,31,1991,1.8,6,2,4,1,1,2,4,50.0,2,2,0,2,2,8,1,0,0,2022-2023,90.0,100.0,300.0
1193,Son Heung-min,KOR,"MF,FW",Tottenham,Premier League,30,1992,32.1,24,12,7,8,9,9,30,30.0,21,23,2,21,13,37,6,0,0,2022-2023,90.0,36.44859813084112,67.28971962616822
1194,Aaron Hickey,SCO,DF,Brentford,Premier League,20,2002,21.3,38,26,27,11,0,18,32,56.3,14,18,7,11,17,55,32,1,0,2022-2023,90.0,71.83098591549296,160.56338028169014
1195,Isak Hien,SWE,DF,Hellas Verona,Serie A,23,1999,29.0,73,36,54,19,0,38,61,62.3,23,40,17,23,31,104,92,1,0,2022-2023,90.0,96.20689655172413,226.55172413793102
1196,Omar El Hilali,MAR,"DF,MF",Espanyol,La Liga,18,2003,1.0,3,2,3,0,0,1,2,50.0,1,1,0,1,1,4,6,0,0,2022-2023,90.0,90.0,270.0
1197,Piero Hincapié,ECU,"DF,MF",Leverkusen,Bundesliga,20,2002,27.3,51,34,28,20,3,25,38,65.8,13,41,20,21,31,82,83,1,0,2022-2023,90.0,102.19780219780219,168.13186813186812
1198,Jack Hinshelwood,ENG,FW,Brighton,Premier League,17,2005,0.0,1,0,1,0,0,0,0,0.0,0,0,0,0,0,1,0,0,0,2022-2023,,,inf
1199,Morten Hjulmand,DEN,MF,Lecce,Serie A,23,1999,32.9,90,52,49,40,1,37,67,55.2,30,43,11,32,72,162,54,0,0,2022-2023,90.0,196.96048632218847,246.20060790273558
1200,Adam Hložek,CZE,"FW,MF",Leverkusen,Bundesliga,20,2002,14.3,9,4,4,3,2,3,9,33.3,6,9,2,7,6,15,9,0,0,2022-2023,90.0,37.76223776223776,56.64335664335665
Rk,Player,Nation,Pos,Squad,Comp,0,0,90.0,0,0,3,3,3,Tkl,0,0.0,0,0,0,0,0,0,0,0,0,2022-2023,90.0,0.0,0.0
1201,Joseph Hodge,IRL,MF,Wolves,Premier League,19,2002,1.9,5,2,1,3,1,3,4,75.0,1,5,0,5,0,5,2,1,0,2022-2023,90.0,0.0,236.8421052631579
1202,Nicolas Höfler,GER,MF,Freiburg,Bundesliga,32,1990,31.3,66,35,28,35,3,27,61,44.3,34,40,13,27,58,124,49,0,0,2022-2023,90.0,166.77316293929712,189.77635782747603
1203,Jonas Hofmann,GER,"FW,MF",Gladbach,Bundesliga,30,1992,29.8,31,16,17,8,6,15,52,28.8,37,36,2,34,16,47,21,0,0,2022-2023,90.0,48.32214765100671,93.62416107382549
1204,Philipp Hofmann,GER,FW,Bochum,Bundesliga,29,1993,29.2,18,11,0,13,5,5,12,41.7,7,20,8,12,6,24,48,0,0,2022-2023,90.0,18.493150684931507,55.47945205479452
1205,Rob Holding,ENG,DF,Arsenal,Premier League,26,1995,6.3,8,5,4,4,0,3,6,50.0,3,6,5,1,3,11,27,1,0,2022-2023,90.0,42.85714285714286,114.28571428571429
1206,Lucas Höler,GER,"FW,MF",Freiburg,Bundesliga,28,1994,16.7,19,14,5,7,7,6,22,27.3,16,22,5,17,10,29,17,0,0,2022-2023,90.0,53.89221556886228,102.39520958083833
1207,Mason Holgate,ENG,DF,Everton,Premier League,25,1996,5.6,11,7,8,3,0,3,11,27.3,8,7,3,4,7,18,28,0,0,2022-2023,90.0,112.5,176.78571428571428
1208,Emil Holm,SWE,DF,Spezia,Serie A,22,2000,15.5,26,15,13,8,5,16,31,51.6,15,21,6,15,9,35,41,0,0,2022-2023,90.0,52.25806451612903,150.96774193548387
1209,Noah Holm,NOR,"FW,MF",Reims,Ligue 1,21,2001,2.2,6,4,2,2,2,2,5,40.0,3,0,0,0,0,6,5,0,0,2022-2023,90.0,0.0,245.45454545454544
1210,Gerrit Holtmann,PHI,"FW,MF",Bochum,Bundesliga,27,1995,10.5,14,7,6,7,1,12,21,57.1,9,15,1,14,2,16,4,0,0,2022-2023,90.0,17.142857142857142,120.0
1211,Martin Hongla,CMR,MF,Hellas Verona,Serie A,24,1998,5.8,8,5,4,4,0,5,5,100.0,0,7,1,6,6,14,9,0,0,2022-2023,90.0,93.10344827586206,124.13793103448276
1212,Martin Hongla,CMR,"DF,MF",Valladolid,La Liga,24,1998,14.5,18,13,13,5,0,11,21,52.4,10,15,12,3,8,26,46,1,0,2022-2023,90.0,49.6551724137931,111.72413793103448
1213,Franck Honorat,FRA,"FW,MF",Brest,Ligue 1,25,1996,28.2,41,29,20,8,13,19,34,55.9,15,22,2,20,21,62,18,0,0,2022-2023,89.99999999999999,67.02127659574468,130.85106382978722
1214,Jannes Horn,GER,"DF,FW",Bochum,Bundesliga,25,1997,0.7,2,1,1,1,0,1,1,100.0,0,1,0,1,3,5,2,0,0,2022-2023,90.0,385.7142857142857,257.14285714285717
1215,Cédric Hountondji,BEN,DF,Angers,Ligue 1,28,1994,34.4,50,36,31,17,2,19,29,65.5,10,44,22,22,59,109,132,1,0,2022-2023,90.0,154.36046511627907,130.8139534883721
1216,Ilyes Housni,FRA,FW,Paris S-G,Ligue 1,17,2005,0.1,1,1,1,0,0,1,1,100.0,0,0,0,0,0,1,0,0,0,2022-2023,90.0,0.0,900.0
1217,Lukáš Hrádecký,FIN,GK,Leverkusen,Bundesliga,32,1989,33.0,0,0,0,0,0,0,0,0.0,0,0,0,0,0,0,3,3,0,2022-2023,90.0,0.0,0.0
1218,Petko Hristov,BUL,DF,Spezia,Serie A,23,1999,4.1,6,4,2,4,0,5,8,62.5,3,4,2,2,4,10,12,0,0,2022-2023,90.0,87.8048780487805,131.70731707317074
1219,Ajdin Hrustic,AUS,MF,Hellas Verona,Serie A,26,1996,2.5,2,1,1,1,0,1,2,50.0,1,2,0,2,0,2,2,1,0,2022-2023,90.0,0.0,72.0
1220,Timo Hübers,GER,DF,Köln,Bundesliga,26,1996,28.4,43,28,35,8,0,24,52,46.2,28,27,13,14,58,101,153,0,0,2022-2023,90.0,183.80281690140848,136.26760563380282
1221,Callum Hudson-Odoi,ENG,"FW,MF",Leverkusen,Bundesliga,21,2000,6.7,5,3,4,0,1,1,1,100.0,0,0,0,0,2,7,4,0,0,2022-2023,90.0,26.865671641791042,67.16417910447761
1222,Will Hughes,ENG,MF,Crystal Palace,Premier League,27,1995,9.4,29,16,11,16,2,11,20,55.0,9,16,7,9,16,45,9,0,0,2022-2023,90.0,153.1914893617021,277.6595744680851
1223,Mats Hummels,GER,DF,Dortmund,Bundesliga,33,1988,22.4,62,34,38,22,2,32,55,58.2,23,30,16,14,33,95,100,1,0,2022-2023,90.0,132.58928571428572,249.10714285714286
1224,Adrien Hunou,FRA,"MF,FW",Angers,Ligue 1,28,1994,24.8,39,20,17,16,6,16,45,35.6,29,35,0,35,7,46,7,0,0,2022-2023,90.0,25.403225806451612,141.53225806451613
1225,Denis Huseinbasic,BIH,"MF,FW",Köln,Bundesliga,21,2001,8.8,23,9,8,11,4,10,25,40.0,15,16,2,14,4,27,5,0,0,2022-2023,90.0,40.90909090909091,235.22727272727272
Rk,Player,Nation,Pos,Squad,Comp,0,0,90.0,0,0,3,3,3,Tkl,0,0.0,0,0,0,0,0,0,0,0,0,2022-2023,90.0,0.0,0.0
1226,Omari Hutchinson,ENG,FW,Chelsea,Premier League,18,2003,0.3,0,0,0,0,0,0,0,0.0,0,0,0,0,1,1,0,0,0,2022-2023,90.0,300.0,0.0
1227,Elseid Hysaj,ALB,DF,Lazio,Serie A,28,1994,22.2,39,23,24,11,4,23,41,56.1,18,31,7,24,20,59,42,0,0,2022-2023,90.0,81.0810810810811,158.10810810810813
1228,Pierre Højbjerg,DEN,MF,Tottenham,Premier League,26,1995,34.8,56,30,28,22,6,26,67,38.8,41,46,17,29,49,105,64,1,0,2022-2023,90.0,126.72413793103449,144.82758620689654
1229,Rasmus Højlund,DEN,FW,Atalanta,Serie A,19,2003,20.4,4,3,0,2,2,1,6,16.7,5,9,1,8,1,5,5,0,0,2022-2023,90.0,4.411764705882353,17.647058823529413
1230,Iago,BRA,"DF,MF",Augsburg,Bundesliga,25,1997,17.8,34,16,20,10,4,11,29,37.9,18,18,5,13,17,51,53,0,0,2022-2023,90.0,85.95505617977528,171.91011235955057
1231,Pablo Ibáñez,ESP,MF,Osasuna,La Liga,23,1998,11.8,29,13,7,17,5,12,35,34.3,23,19,2,17,8,37,24,0,0,2022-2023,90.0,61.01694915254237,221.1864406779661
1232,Roger Ibanez,BRA,DF,Roma,Serie A,23,1998,31.1,67,33,38,26,3,32,48,66.7,16,30,11,19,66,133,95,2,0,2022-2023,90.0,190.99678456591639,193.89067524115757
1233,Arijon Ibrahimović,GER,MF,Bayern Munich,Bundesliga,16,2005,0.2,1,1,1,0,0,0,0,0.0,0,0,0,0,0,1,0,0,0,2022-2023,90.0,0.0,450.0
1234,Zlatan Ibrahimović,SWE,FW,Milan,Serie A,40,1981,1.6,0,0,0,0,0,0,0,0.0,0,1,1,0,0,0,2,0,0,2022-2023,90.0,0.0,0.0
1235,Mounaim El Idrissy,FRA,FW,Ajaccio,Ligue 1,23,1999,27.7,32,19,5,20,7,10,36,27.8,26,22,0,22,13,45,20,0,0,2022-2023,90.0,42.238267148014444,103.971119133574
1236,Antonio Iervolino,ITA,MF,Salernitana,Serie A,19,2003,0.1,0,0,0,0,0,0,1,0.0,1,0,0,0,0,0,0,0,0,2022-2023,90.0,0.0,0.0
1237,Iglesias,ESP,"DF,MF",Getafe,La Liga,24,1998,23.8,61,35,40,18,3,33,65,50.8,32,40,5,35,21,82,91,1,0,2022-2023,90.00000000000001,79.41176470588236,230.67226890756305
1238,Borja Iglesias,ESP,FW,Betis,La Liga,29,1993,26.3,8,4,3,3,2,2,13,15.4,11,9,1,8,1,9,17,0,0,2022-2023,90.0,3.4220532319391634,27.376425855513308
1239,Igor,BRA,DF,Fiorentina,Serie A,24,1998,22.9,43,29,21,18,4,20,27,74.1,7,33,14,19,25,68,56,2,0,2022-2023,90.0,98.25327510917032,168.99563318777294
1240,Kelechi Iheanacho,NGA,"FW,MF",Leicester City,Premier League,25,1996,12.5,7,2,0,3,4,3,10,30.0,7,9,1,8,0,7,8,0,0,2022-2023,90.0,0.0,50.4
1241,Jonathan Ikone,FRA,FW,Fiorentina,Serie A,24,1998,22.3,16,8,5,6,5,5,14,35.7,9,18,1,17,4,20,3,0,0,2022-2023,90.0,16.143497757847534,64.57399103139014
1242,Ivan Ilić,SRB,MF,Hellas Verona,Serie A,21,2001,9.5,16,10,9,7,0,6,11,54.5,5,10,1,9,8,24,14,0,0,2022-2023,90.0,75.78947368421052,151.57894736842104
1243,Ivan Ilić,SRB,MF,Torino,Serie A,21,2001,13.1,18,7,6,11,1,10,20,50.0,10,12,3,9,5,23,10,0,0,2022-2023,90.0,34.35114503816794,123.66412213740459
1244,Rareş Ilie,ROU,"MF,FW",Nice,Ligue 1,19,2003,1.6,3,3,0,1,2,2,4,50.0,2,2,0,2,1,4,1,0,0,2022-2023,90.0,56.25,168.75
1245,Samuel Iling-Junior,ENG,"DF,FW",Juventus,Serie A,18,2003,3.5,7,2,3,1,3,4,9,44.4,5,5,1,4,2,9,6,0,0,2022-2023,90.0,51.42857142857143,180.0
1246,Emirhan İlkhan,TUR,MF,Torino,Serie A,18,2004,1.0,1,1,0,1,0,1,1,100.0,0,3,1,2,2,3,2,0,0,2022-2023,90.0,180.0,90.0
1247,Emirhan İlkhan,TUR,MF,Sampdoria,Serie A,18,2004,1.3,6,3,2,2,2,2,3,66.7,1,5,1,4,0,6,3,0,0,2022-2023,90.0,0.0,415.38461538461536
1248,Asier Illarramendi,ESP,MF,Real Sociedad,La Liga,32,1990,12.0,36,18,10,22,4,16,44,36.4,28,27,8,19,18,54,20,0,0,2022-2023,90.0,135.0,270.0
1249,Ciro Immobile,ITA,FW,Lazio,Serie A,32,1990,24.7,11,5,4,4,3,6,9,66.7,3,10,2,8,1,12,14,0,0,2022-2023,90.0,3.6437246963562755,40.08097165991903
1250,Danny Ings,ENG,FW,West Ham,Premier League,30,1992,8.6,9,8,0,4,5,5,14,35.7,9,8,2,6,3,12,5,0,0,2022-2023,90.0,31.395348837209305,94.18604651162792
Rk,Player,Nation,Pos,Squad,Comp,0,0,90.0,0,0,3,3,3,Tkl,0,0.0,0,0,0,0,0,0,0,0,0,2022-2023,90.0,0.0,0.0
1251,Danny Ings,ENG,FW,Aston Villa,Premier League,30,1992,9.2,10,5,1,6,3,1,6,16.7,5,12,1,11,1,11,11,0,0,2022-2023,90.0,9.782608695652174,97.82608695652175
1252,Marcus Ingvartsen,DEN,"FW,MF",Mainz 05,Bundesliga,26,1996,14.6,4,1,0,2,2,1,10,10.0,9,9,1,8,4,8,10,0,0,2022-2023,90.0,24.657534246575345,24.657534246575345
1253,Bonke Innocent,NGA,MF,Lorient,Ligue 1,26,1996,13.1,28,17,13,14,1,11,36,30.6,25,22,5,17,26,54,31,0,0,2022-2023,90.0,178.6259541984733,192.36641221374046
1254,Alexander Isak,SWE,FW,Newcastle Utd,Premier League,22,1999,16.9,18,8,4,7,7,10,28,35.7,18,21,2,19,4,22,8,0,0,2022-2023,90.0,21.301775147928996,95.85798816568048
1255,Alexander Isak,SWE,FW,Real Sociedad,La Liga,22,1999,1.7,1,1,0,0,1,0,0,0.0,0,0,0,0,0,1,2,0,0,2022-2023,90.0,0.0,52.94117647058823
1256,Isco,ESP,"MF,FW",Sevilla,La Liga,30,1992,8.9,15,9,6,5,4,8,14,57.1,6,3,0,3,10,25,3,0,0,2022-2023,90.0,101.12359550561798,151.68539325842696
1257,Ismaily,BRA,DF,Lille,Ligue 1,32,1990,19.8,41,18,16,16,9,17,32,53.1,15,25,5,20,21,62,39,0,0,2022-2023,90.0,95.45454545454545,186.36363636363637
1258,Ardian Ismajli,ALB,DF,Empoli,Serie A,25,1996,23.3,40,32,25,15,0,18,24,75.0,6,47,31,16,27,67,120,0,0,2022-2023,90.0,104.29184549356223,154.50643776824035
1259,Ko Itakura,JPN,DF,Gladbach,Bundesliga,25,1997,22.0,29,17,18,7,4,16,30,53.3,14,41,25,16,27,56,95,0,0,2022-2023,90.0,110.45454545454545,118.63636363636364
1260,Hiroki Ito,JPN,DF,Stuttgart,Bundesliga,23,1999,28.5,40,29,24,14,2,18,35,51.4,17,38,17,21,40,80,94,0,0,2022-2023,90.0,126.31578947368422,126.31578947368422
1261,Junya Ito,JPN,FW,Reims,Ligue 1,29,1993,32.4,40,20,14,15,11,13,53,24.5,40,29,1,28,8,48,4,1,0,2022-2023,90.0,22.22222222222222,111.11111111111111
1262,Diego Iturralde,ESP,DF,Sevilla,La Liga,19,2003,0.5,1,0,1,0,0,0,2,0.0,2,0,0,0,0,1,1,0,0,2022-2023,90.0,0.0,180.0
1263,Andreas Ivan,ROU,MF,Schalke 04,Bundesliga,27,1995,0.5,0,0,0,0,0,0,1,0.0,1,0,0,0,0,0,1,0,0,2022-2023,90.0,0.0,0.0
1264,Mihailo Ivanović,SRB,FW,Sampdoria,Serie A,17,2004,0.0,0,0,0,0,0,0,0,0.0,0,0,0,0,0,0,0,0,0,2022-2023,,,
1265,Daniel Iversen,DEN,GK,Leicester City,Premier League,25,1997,12.0,0,0,0,0,0,0,0,0.0,0,0,0,0,0,0,6,1,0,2022-2023,90.0,0.0,0.0
1266,Alex Iwobi,NGA,"MF,FW",Everton,Premier League,26,1996,37.5,69,37,37,28,4,33,65,50.8,32,41,2,39,25,94,29,0,0,2022-2023,90.0,60.0,165.6
1267,Armando Izzo,ITA,DF,Monza,Serie A,30,1992,27.4,73,50,44,27,2,29,45,64.4,16,29,17,12,50,123,87,1,0,2022-2023,90.0,164.23357664233578,239.78102189781026
1268,Nicolas Jackson,SEN,FW,Villarreal,La Liga,21,2001,17.8,14,11,2,10,2,2,8,25.0,6,18,2,16,2,16,4,0,0,2022-2023,90.0,10.112359550561798,70.78651685393258
1269,Lee Jae-sung,KOR,MF,Mainz 05,Bundesliga,29,1992,21.0,38,17,9,21,8,16,36,44.4,20,29,5,24,17,55,21,0,0,2022-2023,90.0,72.85714285714286,162.85714285714286
1270,Paul Jaeckel,GER,DF,Union Berlin,Bundesliga,24,1998,13.3,24,18,11,11,2,17,35,48.6,18,11,5,6,19,43,44,1,0,2022-2023,90.0,128.57142857142856,162.406015037594
1271,Mato Jajalo,BIH,MF,Udinese,Serie A,34,1988,0.7,0,0,0,0,0,0,1,0.0,1,0,0,0,0,0,2,0,0,2022-2023,90.0,0.0,0.0
1272,Kristijan Jakić,CRO,"DF,MF",Eint Frankfurt,Bundesliga,25,1997,16.2,33,21,19,12,2,22,41,53.7,19,32,10,22,14,47,49,1,0,2022-2023,90.0,77.77777777777779,183.33333333333334
1273,Ismail Jakobs,SEN,"DF,FW",Monaco,Ligue 1,22,1999,12.4,11,5,7,3,1,5,12,41.7,7,9,1,8,9,20,18,0,0,2022-2023,90.0,65.3225806451613,79.83870967741936
1274,Marin Jakoliš,CRO,FW,Angers,Ligue 1,25,1996,0.3,1,1,0,0,1,0,0,0.0,0,0,0,0,0,1,0,0,0,2022-2023,90.0,0.0,300.0
1275,Daniel James,WAL,FW,Leeds United,Premier League,24,1997,2.2,6,2,1,3,2,3,6,50.0,3,4,0,4,2,8,2,0,0,2022-2023,90.0,81.81818181818181,245.45454545454544
Rk,Player,Nation,Pos,Squad,Comp,0,0,90.0,0,0,3,3,3,Tkl,0,0.0,0,0,0,0,0,0,0,0,0,2022-2023,90.0,0.0,0.0
1276,Daniel James,WAL,FW,Fulham,Premier League,24,1997,6.9,10,6,4,5,1,4,9,44.4,5,5,1,4,1,11,5,0,0,2022-2023,90.0,13.043478260869565,130.43478260869563
1277,Reece James,ENG,"DF,MF",Chelsea,Premier League,22,1999,13.8,31,20,10,18,3,15,19,78.9,4,17,2,15,12,43,23,0,0,2022-2023,90.0,78.26086956521738,202.17391304347825
1278,Vitaly Janelt,GER,"MF,DF",Brentford,Premier League,24,1998,24.5,54,27,20,24,10,21,49,42.9,28,29,9,20,29,83,26,0,0,2022-2023,90.00000000000001,106.53061224489797,198.36734693877554
1279,Saidy Janko,GAM,DF,Bochum,Bundesliga,26,1995,12.6,23,15,13,8,2,12,20,60.0,8,24,10,14,11,34,33,1,0,2022-2023,90.0,78.57142857142858,164.2857142857143
1280,Pontus Jansson,SWE,DF,Brentford,Premier League,31,1991,8.0,5,3,4,1,0,3,5,60.0,2,13,9,4,9,14,38,0,0,2022-2023,90.0,101.25,56.25
1281,Tony Jantschke,GER,"DF,MF",Gladbach,Bundesliga,32,1990,1.1,2,1,1,1,0,1,1,100.0,0,5,3,2,0,2,5,0,0,2022-2023,90.0,0.0,163.63636363636363
1282,Adnan Januzaj,BEL,FW,Sevilla,La Liga,27,1995,0.5,0,0,0,0,0,0,1,0.0,1,0,0,0,1,1,0,0,0,2022-2023,90.0,180.0,0.0
1283,Léo Jardim,BRA,GK,Lille,Ligue 1,27,1995,6.0,0,0,0,0,0,0,1,0.0,1,0,0,0,0,0,0,1,0,2022-2023,90.0,0.0,0.0
1284,Luis Javier Suárez,COL,FW,Almería,La Liga,24,1997,16.6,17,11,5,6,6,6,26,23.1,20,13,3,10,3,20,10,0,0,2022-2023,90.0,16.265060240963855,92.16867469879517
1285,Luis Javier Suárez,COL,FW,Marseille,Ligue 1,24,1997,3.3,4,1,1,2,1,1,4,25.0,3,1,0,1,3,7,6,0,0,2022-2023,90.0,81.81818181818181,109.0909090909091
1286,Dany Jean,HAI,"DF,MF",Strasbourg,Ligue 1,19,2002,0.1,0,0,0,0,0,0,1,0.0,1,1,0,1,0,0,0,0,0,2022-2023,90.0,0.0,0.0
1287,Julian Jeanvier,GUI,DF,Auxerre,Ligue 1,30,1992,19.6,32,17,24,8,0,13,22,59.1,9,24,17,7,27,59,96,1,0,2022-2023,90.0,123.97959183673468,146.93877551020407
1288,Jeffinho,BRA,FW,Lyon,Ligue 1,22,1999,5.0,17,4,4,9,4,6,15,40.0,9,6,0,6,1,18,0,0,0,2022-2023,90.0,18.0,306.0
1289,Fredrik Jensen,FIN,"FW,MF",Augsburg,Bundesliga,24,1997,10.3,15,10,8,3,4,5,10,50.0,5,12,5,7,4,19,12,0,0,2022-2023,90.0,34.95145631067961,131.06796116504853
1290,Mathias Jensen,DEN,MF,Brentford,Premier League,26,1996,31.1,71,36,29,30,12,34,97,35.1,63,54,5,49,32,103,24,1,0,2022-2023,90.0,92.60450160771704,205.46623794212218
1291,Moritz Jenz,GER,DF,Schalke 04,Bundesliga,23,1999,10.5,14,11,8,5,1,5,8,62.5,3,16,10,6,8,22,53,1,0,2022-2023,90.0,68.57142857142857,120.0
1292,Jesé,ESP,FW,Sampdoria,Serie A,29,1993,2.3,2,0,0,2,0,0,1,0.0,1,3,1,2,1,3,2,0,0,2022-2023,90.0,39.130434782608695,78.26086956521739
1293,Gabriel Jesus,BRA,FW,Arsenal,Premier League,25,1997,22.9,33,25,16,8,9,15,31,48.4,16,27,3,24,11,44,15,1,0,2022-2023,90.0,43.23144104803494,129.69432314410483
1294,Juan Jesus,BRA,DF,Napoli,Serie A,31,1991,10.4,16,11,9,6,1,9,12,75.0,3,18,11,7,10,26,29,0,0,2022-2023,90.0,86.53846153846153,138.46153846153845
1295,Raúl Jiménez,MEX,FW,Wolves,Premier League,31,1991,9.4,9,6,3,5,1,3,6,50.0,3,9,0,9,0,9,8,0,0,2022-2023,90.0,0.0,86.17021276595744
1296,Joaquín,ESP,"MF,FW",Betis,La Liga,41,1981,5.5,3,3,2,1,0,1,3,33.3,2,7,2,5,4,7,5,0,0,2022-2023,90.0,65.45454545454545,49.09090909090909
1297,Joelinton,BRA,"MF,FW",Newcastle Utd,Premier League,25,1996,29.6,70,49,36,26,8,26,62,41.9,36,52,7,45,48,118,39,0,0,2022-2023,90.0,145.94594594594594,212.83783783783784
1298,Þórir Jóhann Helgason,ISL,MF,Lecce,Serie A,21,2000,2.5,2,2,1,0,1,2,3,66.7,1,3,1,2,3,5,3,0,0,2022-2023,90.0,108.0,72.0
1299,Ben Johnson,ENG,DF,West Ham,Premier League,22,2000,9.6,20,14,12,4,4,12,18,66.7,6,12,4,8,9,29,28,1,0,2022-2023,90.0,84.375,187.5
1300,Brennan Johnson,WAL,"FW,MF",Nott'ham Forest,Premier League,21,2001,32.6,34,20,18,8,8,8,29,27.6,21,30,1,29,5,39,7,1,0,2022-2023,90.0,13.803680981595091,93.86503067484662
Rk,Player,Nation,Pos,Squad,Comp,0,0,90.0,0,0,3,3,3,Tkl,0,0.0,0,0,0,0,0,0,0,0,0,2022-2023,90.0,0.0,0.0
1301,Sam Johnstone,ENG,GK,Crystal Palace,Premier League,29,1993,9.0,0,0,0,0,0,0,0,0.0,0,0,0,0,0,0,5,0,0,2022-2023,90.0,0.0,0.0
1302,Paul Joly,FRA,DF,Auxerre,Ligue 1,22,2000,9.6,33,21,21,10,2,19,35,54.3,16,13,2,11,24,57,29,2,0,2022-2023,90.0,225.00000000000003,309.375
1303,Curtis Jones,ENG,MF,Liverpool,Premier League,21,2001,11.5,34,17,8,12,14,18,31,58.1,13,12,2,10,3,37,9,0,0,2022-2023,90.0,23.47826086956522,266.0869565217391
1304,Frenkie de Jong,NED,MF,Barcelona,La Liga,25,1997,28.2,46,26,16,21,9,17,41,41.5,24,11,1,10,35,81,22,1,0,2022-2023,89.99999999999999,111.70212765957446,146.80851063829786
1305,Joan Jordán,ESP,MF,Sevilla,La Liga,28,1994,17.7,32,17,13,17,2,16,38,42.1,22,14,7,7,16,48,14,2,0,2022-2023,90.0,81.35593220338984,162.71186440677968
1306,Jorginho,ITA,MF,Arsenal,Premier League,30,1991,9.5,18,13,6,10,2,5,24,20.8,19,7,2,5,9,27,8,0,0,2022-2023,90.0,85.26315789473684,170.52631578947367
1307,Jorginho,ITA,MF,Chelsea,Premier League,30,1991,14.2,42,23,22,14,6,22,46,47.8,24,18,3,15,21,63,7,0,0,2022-2023,90.0,133.09859154929578,266.19718309859155
1308,Josan,ESP,"DF,MF",Elche,La Liga,32,1989,12.0,25,20,20,5,0,14,27,51.9,13,8,0,8,7,32,15,1,0,2022-2023,90.0,52.5,187.5
1309,Willian José,BRA,FW,Betis,La Liga,30,1991,8.1,9,6,6,3,0,4,9,44.4,5,4,0,4,1,10,15,0,0,2022-2023,90.0,11.11111111111111,100.0
1310,Joselu,ESP,FW,Espanyol,La Liga,32,1990,33.2,13,11,3,4,6,4,17,23.5,13,25,4,21,8,21,43,0,0,2022-2023,90.0,21.686746987951803,35.24096385542168
1311,Mateo Joseph,ESP,"FW,MF",Leeds United,Premier League,18,2003,0.3,0,0,0,0,0,0,0,0.0,0,1,0,1,0,0,1,0,0,2022-2023,90.0,0.0,0.0
1312,Diogo Jota,POR,FW,Liverpool,Premier League,25,1996,12.6,23,15,8,8,7,12,37,32.4,25,5,0,5,3,26,11,0,0,2022-2023,90.0,21.42857142857143,164.2857142857143
1313,Stevan Jovetić,MNE,"FW,MF",Hertha BSC,Bundesliga,32,1989,9.9,3,2,2,1,0,1,11,9.1,10,2,1,1,2,5,10,0,0,2022-2023,90.0,18.181818181818183,27.272727272727273
1314,Luka Jović,SRB,"FW,MF",Fiorentina,Serie A,24,1997,17.0,6,3,1,4,1,2,8,25.0,6,7,2,5,2,8,10,0,0,2022-2023,90.0,10.588235294117647,31.764705882352942
1315,Juanmi,ESP,FW,Betis,La Liga,29,1993,10.3,14,10,4,7,3,7,31,22.6,24,10,0,10,4,18,4,0,0,2022-2023,90.0,34.95145631067961,122.33009708737863
1316,Juanpe,ESP,DF,Girona,La Liga,31,1991,15.8,19,11,10,9,0,11,17,64.7,6,12,9,3,10,29,60,1,0,2022-2023,90.0,56.96202531645569,108.2278481012658
1317,Jubal,BRA,DF,Auxerre,Ligue 1,28,1993,35.7,41,26,29,11,1,19,38,50.0,19,57,34,23,53,94,193,0,0,2022-2023,90.0,133.61344537815125,103.36134453781511
1318,Christopher Jullien,FRA,DF,Montpellier,Ligue 1,29,1993,29.9,46,28,29,14,3,28,51,54.9,23,35,18,17,43,89,114,1,0,2022-2023,90.0,129.4314381270903,138.46153846153848
1319,Anthony Jung,GER,"DF,FW",Werder Bremen,Bundesliga,30,1991,29.1,46,27,19,20,7,31,58,53.4,27,30,6,24,22,68,63,0,0,2022-2023,90.0,68.04123711340206,142.26804123711338
1320,Eli Junior Kroupi,FRA,"FW,MF",Lorient,Ligue 1,16,2006,0.1,0,0,0,0,0,0,1,0.0,1,0,0,0,1,1,0,0,0,2022-2023,90.0,900.0,0.0
1321,Lago Junior,CIV,"FW,MF",Mallorca,La Liga,31,1990,0.6,1,0,0,1,0,1,1,100.0,0,0,0,0,0,1,0,0,0,2022-2023,90.0,0.0,150.0
1322,Hamed Junior Traorè,CIV,"FW,MF",Bournemouth,Premier League,22,2000,4.7,17,11,5,9,3,6,18,33.3,12,9,0,9,2,19,1,0,0,2022-2023,90.0,38.29787234042553,325.531914893617
1323,Hamed Junior Traorè,CIV,"MF,FW",Sassuolo,Serie A,22,2000,6.6,11,6,4,6,1,4,11,36.4,7,4,0,4,2,13,0,1,0,2022-2023,90.0,27.272727272727273,150.0
1324,Vinicius Júnior,BRA,FW,Real Madrid,La Liga,22,2000,31.4,30,21,10,12,8,14,39,35.9,25,24,1,23,6,36,1,0,0,2022-2023,90.0,17.197452229299365,85.98726114649682
1325,Josip Juranović,CRO,DF,Union Berlin,Bundesliga,26,1995,10.4,9,7,5,2,2,7,18,38.9,11,9,3,6,6,15,22,1,0,2022-2023,90.0,51.92307692307692,77.88461538461537
Rk,Player,Nation,Pos,Squad,Comp,0,0,90.0,0,0,3,3,3,Tkl,0,0.0,0,0,0,0,0,0,0,0,0,2022-2023,90.0,0.0,0.0
1326,James Justin,ENG,DF,Leicester City,Premier League,24,1998,13.9,20,18,7,12,1,9,18,50.0,9,24,6,18,15,35,47,0,0,2022-2023,90.0,97.12230215827338,129.49640287769785
1327,Filip Jørgensen,DEN,GK,Villarreal,La Liga,20,2002,2.0,0,0,0,0,0,0,1,0.0,1,0,0,0,0,0,0,0,0,2022-2023,90.0,0.0,0.0
1328,Mathias Jørgensen,DEN,DF,Brentford,Premier League,32,1990,12.3,17,8,9,8,0,9,21,42.9,12,19,12,7,16,33,39,1,0,2022-2023,89.99999999999999,117.07317073170731,124.39024390243901
1329,Ozan Kabak,TUR,DF,Hoffenheim,Bundesliga,22,2000,26.5,51,34,27,21,3,17,30,56.7,13,35,23,12,45,96,83,0,0,2022-2023,90.0,152.83018867924528,173.2075471698113
1330,Issa Kaboré,BFA,DF,Marseille,Ligue 1,21,2001,11.4,33,19,10,18,5,21,32,65.6,11,11,1,10,12,45,21,1,0,2022-2023,90.0,94.73684210526315,260.52631578947364
1331,Abdoul Kader Bamba,FRA,"FW,MF",Nantes,Ligue 1,28,1994,0.9,0,0,0,0,0,0,2,0.0,2,3,1,2,0,0,1,0,0,2022-2023,90.0,0.0,0.0
1332,Pavel Kadeřábek,CZE,DF,Hoffenheim,Bundesliga,30,1992,18.5,26,20,10,9,7,15,23,65.2,8,12,2,10,14,40,37,1,0,2022-2023,90.0,68.10810810810811,126.4864864864865
1333,Tino Kadewere,ZIM,"FW,MF",Mallorca,La Liga,26,1996,6.0,6,3,3,3,0,4,9,44.4,5,6,2,4,2,8,1,0,0,2022-2023,90.0,30.0,90.0
1334,Kaiky,BRA,DF,Almería,La Liga,18,2004,6.5,5,5,5,0,0,3,7,42.9,4,18,10,8,11,16,28,0,0,2022-2023,90.00000000000001,152.30769230769232,69.23076923076924
1335,Florian Kainz,AUT,"MF,FW",Köln,Bundesliga,29,1992,26.0,21,10,7,12,2,8,26,30.8,18,27,6,21,32,53,30,1,0,2022-2023,90.00000000000001,110.76923076923077,72.6923076923077
1336,Gaël Kakuta,COD,FW,Lens,Ligue 1,31,1991,0.2,0,0,0,0,0,0,0,0.0,0,0,0,0,0,0,1,0,0,2022-2023,90.0,0.0,0.0
1337,Sasa Kalajdzic,AUT,FW,Wolves,Premier League,25,1997,0.5,0,0,0,0,0,0,0,0.0,0,0,0,0,1,1,0,0,0,2022-2023,90.0,180.0,0.0
1338,Sasa Kalajdzic,AUT,FW,Stuttgart,Bundesliga,25,1997,2.6,3,2,0,1,2,1,3,33.3,2,1,0,1,0,3,0,0,0,2022-2023,90.0,0.0,103.84615384615384
1339,Arnaud Kalimuendo,FRA,FW,Rennes,Ligue 1,20,2002,20.5,15,8,3,6,6,5,20,25.0,15,15,2,13,2,17,9,0,0,2022-2023,90.0,8.78048780487805,65.85365853658537
1340,Yayah Kallon,SLE,"MF,FW",Hellas Verona,Serie A,21,2001,9.6,14,10,5,4,5,7,12,58.3,5,10,0,10,8,22,5,0,0,2022-2023,90.0,75.0,131.25
1341,Gedeon Kalulu,COD,DF,Lorient,Ligue 1,24,1997,27.1,64,34,43,14,7,30,48,62.5,18,32,3,29,28,92,79,2,0,2022-2023,90.0,92.98892988929889,212.5461254612546
1342,Pierre Kalulu,FRA,DF,Milan,Serie A,22,2000,28.3,57,39,33,21,3,28,42,66.7,14,41,17,24,41,98,56,1,0,2022-2023,90.0,130.3886925795053,181.2720848056537
1343,Justin-Noël Kalumba,FRA,DF,Angers,Ligue 1,17,2004,6.1,9,5,5,2,2,5,16,31.3,11,4,1,3,4,13,5,0,0,2022-2023,90.0,59.016393442622956,132.78688524590166
1344,Daichi Kamada,JPN,MF,Eint Frankfurt,Bundesliga,25,1996,25.2,51,31,10,37,4,31,57,54.4,26,31,2,29,16,67,17,1,0,2022-2023,90.0,57.142857142857146,182.14285714285717
1345,Waren Kamanzi,NOR,DF,Toulouse,Ligue 1,21,2000,7.4,16,9,9,5,2,13,19,68.4,6,8,2,6,8,24,9,0,0,2022-2023,90.0,97.29729729729729,194.59459459459458
1346,Bingourou Kamara,SEN,GK,Montpellier,Ligue 1,25,1996,4.5,0,0,0,0,0,0,0,0.0,0,0,0,0,0,0,2,0,0,2022-2023,90.0,0.0,0.0
1347,Boubacar Kamara,FRA,MF,Aston Villa,Premier League,22,1999,19.7,58,25,25,23,10,27,56,48.2,29,38,12,26,19,77,24,3,0,2022-2023,90.0,86.80203045685279,264.9746192893401
1348,Jakub Kamiński,POL,"FW,DF",Wolfsburg,Bundesliga,20,2002,22.9,36,25,15,13,8,20,40,50.0,20,37,2,35,8,44,15,0,0,2022-2023,90.0,31.4410480349345,141.48471615720524
1349,Marcin Kamiński,POL,DF,Schalke 04,Bundesliga,30,1992,7.0,6,4,4,0,2,2,4,50.0,2,8,7,1,9,15,28,0,0,2022-2023,90.0,115.71428571428571,77.14285714285714
1350,Kevin Kampl,SVN,MF,RB Leipzig,Bundesliga,31,1990,15.2,21,11,6,14,1,6,27,22.2,21,26,9,17,22,43,11,0,0,2022-2023,90.0,130.26315789473685,124.34210526315789
Rk,Player,Nation,Pos,Squad,Comp,0,0,90.0,0,0,3,3,3,Tkl,0,0.0,0,0,0,0,0,0,0,0,0,2022-2023,90.0,0.0,0.0
1351,Nordine Kandil,FRA,"MF,FW",Strasbourg,Ligue 1,20,2001,1.1,3,2,1,2,0,0,3,0.0,3,2,0,2,1,4,1,0,0,2022-2023,90.0,81.81818181818181,245.45454545454544
1352,Harry Kane,ENG,FW,Tottenham,Premier League,29,1993,37.8,15,12,1,6,8,7,21,33.3,14,27,7,20,2,17,18,0,0,2022-2023,90.0,4.761904761904762,35.714285714285715
1353,Lee Kang-in,KOR,"MF,FW",Mallorca,La Liga,21,2001,31.4,42,24,10,22,10,18,61,29.5,43,25,2,23,11,53,7,0,0,2022-2023,90.0,31.52866242038217,120.38216560509555
1354,Wilfried Kanga,CIV,FW,Hertha BSC,Bundesliga,24,1998,15.7,5,4,2,1,2,2,4,50.0,2,14,3,11,2,7,13,0,0,2022-2023,90.0,11.464968152866243,28.662420382165607
1355,N'Golo Kanté,FRA,MF,Chelsea,Premier League,31,1991,5.8,16,10,4,10,2,4,8,50.0,4,11,0,11,6,22,2,0,0,2022-2023,90.0,93.10344827586206,248.27586206896552
1356,Kenan Karaman,TUR,FW,Schalke 04,Bundesliga,28,1994,10.8,11,8,3,5,3,3,12,25.0,9,9,1,8,3,14,9,0,0,2022-2023,90.0,24.999999999999996,91.66666666666666
1357,Yann Karamoh,FRA,"MF,FW",Torino,Serie A,24,1998,8.0,5,2,3,2,0,1,5,20.0,4,5,0,5,0,5,2,1,0,2022-2023,90.0,0.0,56.25
1358,Atakan Karazor,GER,MF,Stuttgart,Bundesliga,25,1996,21.8,49,30,18,25,6,24,47,51.1,23,39,11,28,31,80,44,0,0,2022-2023,90.0,127.98165137614679,202.29357798165137
1359,Ayman Kari,FRA,"MF,DF",Lorient,Ligue 1,17,2004,1.1,0,0,0,0,0,0,0,0.0,0,4,0,4,3,3,0,0,0,2022-2023,90.0,245.45454545454544,0.0
1360,Jon Karrikaburu,ESP,FW,Real Sociedad,La Liga,19,2002,1.0,1,0,0,1,0,0,0,0.0,0,2,0,2,0,1,0,0,0,2022-2023,90.0,0.0,90.0
1361,Rick Karsdorp,NED,DF,Roma,Serie A,27,1995,7.9,21,13,11,7,3,13,22,59.1,9,0,0,0,7,28,15,1,0,2022-2023,90.0,79.74683544303797,239.24050632911388
1362,Denso Kasius,NED,DF,Bologna,Serie A,19,2002,3.8,12,6,7,4,1,8,10,80.0,2,6,3,3,3,15,6,0,0,2022-2023,90.0,71.05263157894737,284.2105263157895
1363,Thomas Kastanaras,GRE,"FW,DF",Stuttgart,Bundesliga,19,2003,0.8,0,0,0,0,0,0,0,0.0,0,1,0,1,0,0,0,0,0,2022-2023,90.0,0.0,0.0
1364,Grigoris Kastanos,CYP,"MF,DF",Salernitana,Serie A,24,1998,14.3,39,23,18,19,2,16,40,40.0,24,20,6,14,8,47,8,0,0,2022-2023,90.0,50.349650349650354,245.45454545454547
1365,Silas Katompa,COD,"FW,MF",Stuttgart,Bundesliga,23,1998,22.1,25,17,5,14,6,6,20,30.0,14,17,2,15,8,33,1,0,0,2022-2023,90.0,32.57918552036199,101.80995475113122
1366,Moise Kean,ITA,FW,Juventus,Serie A,22,2000,11.1,8,6,2,5,1,3,7,42.9,4,4,0,4,5,13,2,0,0,2022-2023,90.0,40.54054054054055,64.86486486486487
1367,Michael Keane,ENG,DF,Everton,Premier League,29,1993,10.9,7,4,5,2,0,5,8,62.5,3,12,7,5,14,21,55,1,0,2022-2023,90.0,115.59633027522935,57.798165137614674
1368,Neeskens Kebano,COD,FW,Fulham,Premier League,30,1992,8.5,17,9,8,6,3,9,18,50.0,9,14,0,14,1,18,8,0,0,2022-2023,90.0,10.588235294117647,180.0
1369,Kévin Keben Biakolo,CMR,DF,Toulouse,Ligue 1,18,2004,4.0,3,2,2,0,1,0,4,0.0,4,1,0,1,5,8,9,0,0,2022-2023,90.0,112.5,67.5
1370,Thilo Kehrer,GER,DF,West Ham,Premier League,25,1996,24.8,43,24,25,14,4,21,45,46.7,24,16,6,10,34,77,76,1,0,2022-2023,90.0,123.38709677419355,156.0483870967742
1371,Check Keita,FRA,DF,Reims,Ligue 1,19,2003,7.6,12,9,9,3,0,4,9,44.4,5,6,5,1,5,17,24,1,0,2022-2023,90.0,59.21052631578947,142.10526315789474
1372,Naby Keïta,GUI,MF,Liverpool,Premier League,27,1995,3.3,5,4,2,3,0,1,4,25.0,3,1,0,1,2,7,3,0,0,2022-2023,90.0,54.54545454545455,136.36363636363637
1373,Yannik Keitel,GER,MF,Freiburg,Bundesliga,22,2000,7.6,11,7,4,6,1,3,5,60.0,2,6,3,3,13,24,8,0,0,2022-2023,90.0,153.94736842105263,130.26315789473685
1374,Caoimhín Kelleher,IRL,GK,Liverpool,Premier League,23,1998,1.0,0,0,0,0,0,0,0,0.0,0,0,0,0,0,0,0,0,0,2022-2023,90.0,0.0,0.0
1375,Lloyd Kelly,ENG,DF,Bournemouth,Premier League,23,1998,22.7,33,18,23,9,1,13,19,68.4,6,26,15,11,26,59,101,1,0,2022-2023,89.99999999999999,103.08370044052863,130.83700440528634
Rk,Player,Nation,Pos,Squad,Comp,0,0,90.0,0,0,3,3,3,Tkl,0,0.0,0,0,0,0,0,0,0,0,0,2022-2023,90.0,0.0,0.0
1376,Marc-Oliver Kempf,GER,DF,Hertha BSC,Bundesliga,27,1995,30.1,44,27,29,14,1,16,22,72.7,6,42,32,10,51,95,143,0,0,2022-2023,90.00000000000001,152.49169435215947,131.56146179401995
1377,Kenedy,BRA,"FW,DF",Valladolid,La Liga,26,1996,3.1,6,2,3,3,0,2,4,50.0,2,2,0,2,1,7,0,0,0,2022-2023,90.0,29.032258064516128,174.19354838709677
1378,Jonjoe Kenny,ENG,DF,Hertha BSC,Bundesliga,25,1997,24.9,46,34,27,16,3,24,42,57.1,18,38,9,29,46,92,74,0,0,2022-2023,90.0,166.26506024096386,166.26506024096386
1379,Franck Kessié,CIV,MF,Barcelona,La Liga,25,1996,11.0,15,9,6,6,3,8,18,44.4,10,10,2,8,12,27,11,2,0,2022-2023,90.0,98.18181818181819,122.72727272727273
1380,Saîf-Eddine Khaoui,TUN,MF,Clermont Foot,Ligue 1,27,1995,22.5,47,28,14,25,8,15,47,31.9,32,17,2,15,33,80,8,0,0,2022-2023,90.0,132.0,188.0
1381,Wahbi Khazri,TUN,"FW,MF",Montpellier,Ligue 1,31,1991,18.2,26,13,13,7,6,6,25,24.0,19,17,1,16,9,35,20,0,0,2022-2023,90.0,44.505494505494504,128.57142857142858
1382,Rani Khedira,GER,MF,Union Berlin,Bundesliga,28,1994,32.0,60,33,21,32,7,25,50,50.0,25,33,10,23,40,100,33,0,0,2022-2023,90.0,112.5,168.75
1383,Anthony Khelifa,FRA,DF,Ajaccio,Ligue 1,16,2005,0.1,0,0,0,0,0,0,0,0.0,0,0,0,0,0,0,0,0,0,2022-2023,90.0,0.0,0.0
1384,Kiké,ESP,FW,Osasuna,La Liga,32,1989,11.3,6,3,0,4,2,2,5,40.0,3,6,1,5,1,7,13,0,0,2022-2023,90.0,7.964601769911504,47.78761061946903
1385,Luca Kilian,GER,DF,Köln,Bundesliga,22,1999,12.5,22,16,14,7,1,12,21,57.1,9,16,8,8,11,33,48,0,0,2022-2023,90.0,79.2,158.4
1386,Max Kilman,ENG,DF,Wolves,Premier League,25,1997,36.7,36,20,26,9,1,16,30,53.3,14,70,42,28,19,55,164,1,0,2022-2023,90.0,46.59400544959128,88.283378746594
1387,Joshua Kimmich,GER,MF,Bayern Munich,Bundesliga,27,1995,31.2,78,49,24,46,8,38,72,52.8,34,36,7,29,41,119,39,2,0,2022-2023,90.0,118.26923076923076,225.0
1388,Presnel Kimpembe,FRA,DF,Paris S-G,Ligue 1,26,1995,8.1,17,8,9,6,2,9,13,69.2,4,12,7,5,13,30,9,1,0,2022-2023,90.0,144.44444444444446,188.88888888888889
1389,Jakub Kiwior,POL,DF,Arsenal,Premier League,22,2000,4.7,7,5,6,1,0,5,8,62.5,3,5,3,2,6,13,10,0,0,2022-2023,90.0,114.89361702127658,134.04255319148936
1390,Jakub Kiwior,POL,DF,Spezia,Serie A,22,2000,16.0,22,17,15,7,0,6,24,25.0,18,26,18,8,24,46,71,1,0,2022-2023,90.0,135.0,123.75
1391,Simon Kjær,DEN,DF,Milan,Serie A,33,1989,11.2,15,8,9,6,0,7,11,63.6,4,14,11,3,9,24,35,1,0,2022-2023,90.0,72.32142857142857,120.53571428571429
1392,Pascal Klemens,GER,DF,Hertha BSC,Bundesliga,17,2005,1.0,0,0,0,0,0,0,1,0.0,1,1,0,1,1,1,3,0,0,2022-2023,90.0,90.0,0.0
1393,Mateusz Klich,POL,"MF,FW",Leeds United,Premier League,32,1990,3.1,12,8,3,4,5,7,13,53.8,6,4,0,4,0,12,1,0,0,2022-2023,90.0,0.0,348.38709677419354
1394,Lukas Klostermann,GER,DF,RB Leipzig,Bundesliga,26,1996,10.1,16,8,7,9,0,8,15,53.3,7,6,3,3,13,29,31,0,0,2022-2023,90.0,115.84158415841584,142.5742574257426
1395,Justin Kluivert,NED,"FW,MF",Valencia,La Liga,23,1999,16.1,17,14,7,4,6,6,12,50.0,6,4,0,4,7,24,4,0,0,2022-2023,90.0,39.130434782608695,95.03105590062111
1396,Ansgar Knauff,GER,DF,Eint Frankfurt,Bundesliga,20,2002,14.3,36,25,22,11,3,15,34,44.1,19,19,1,18,15,51,26,0,0,2022-2023,90.0,94.40559440559441,226.5734265734266
1397,Robin Knoche,GER,DF,Union Berlin,Bundesliga,30,1992,31.9,45,29,29,12,4,24,47,51.1,23,35,18,17,38,83,140,0,0,2022-2023,90.0,107.21003134796238,126.95924764890282
1398,Gregor Kobel,SUI,GK,Dortmund,Bundesliga,24,1997,27.0,0,0,0,0,0,0,1,0.0,1,1,0,1,0,0,7,2,0,2022-2023,90.0,0.0,0.0
1399,Robin Koch,GER,DF,Leeds United,Premier League,26,1996,35.3,53,30,32,16,5,24,56,42.9,32,44,21,23,43,96,152,1,0,2022-2023,90.0,109.63172804532579,135.12747875354108
1400,Samuel Koeberlé,FRA,MF,Reims,Ligue 1,17,2004,0.0,0,0,0,0,0,0,0,0.0,0,0,0,0,0,0,0,0,0,2022-2023,,,
Rk,Player,Nation,Pos,Squad,Comp,0,0,90.0,0,0,3,3,3,Tkl,0,0.0,0,0,0,0,0,0,0,0,0,2022-2023,90.0,0.0,0.0
1401,Rudy Kohon,FRA,DF,Troyes,Ligue 1,18,2004,0.7,4,3,4,0,0,2,2,100.0,0,1,0,1,1,5,2,0,0,2022-2023,90.0,128.57142857142858,514.2857142857143
1402,Dominik Kohr,GER,MF,Mainz 05,Bundesliga,28,1994,25.5,59,33,23,31,5,29,61,47.5,32,46,9,37,34,93,26,1,0,2022-2023,90.0,120.0,208.23529411764707
1403,Koke,ESP,MF,Atlético Madrid,La Liga,30,1992,28.3,55,38,23,25,7,28,72,38.9,44,35,13,22,20,75,19,0,0,2022-2023,90.0,63.60424028268551,174.91166077738515
1404,Sead Kolašinac,BIH,DF,Marseille,Ligue 1,29,1993,24.6,52,36,24,22,6,24,37,64.9,13,19,2,17,43,95,35,1,0,2022-2023,89.99999999999999,157.31707317073167,190.24390243902437
1405,Luca Koleosho,ITA,"FW,DF",Espanyol,La Liga,17,2004,0.7,2,2,0,0,2,1,2,50.0,1,1,0,1,0,2,0,0,0,2022-2023,90.0,0.0,257.14285714285717
1406,Randal Kolo Muani,FRA,FW,Eint Frankfurt,Bundesliga,23,1998,29.2,14,10,3,3,8,1,9,11.1,8,19,2,17,3,17,13,0,0,2022-2023,90.0,9.246575342465754,43.15068493150685
1407,Timothée Kolodziejczak,FRA,DF,Schalke 04,Bundesliga,30,1991,0.3,0,0,0,0,0,0,1,0.0,1,0,0,0,1,1,1,0,0,2022-2023,90.0,300.0,0.0
1408,Cheick Konaté,MLI,DF,Clermont Foot,Ligue 1,18,2004,6.4,19,12,10,7,2,13,22,59.1,9,7,1,6,13,32,8,1,0,2022-2023,90.0,182.8125,267.1875
1409,Ibrahima Konaté,FRA,DF,Liverpool,Premier League,23,1999,17.2,38,26,25,13,0,16,27,59.3,11,12,5,7,26,64,61,4,0,2022-2023,90.0,136.046511627907,198.8372093023256
1410,Geoffrey Kondogbia,CTA,MF,Atlético Madrid,La Liga,29,1993,11.2,40,23,19,20,1,17,25,68.0,8,9,1,8,26,66,12,1,0,2022-2023,90.0,208.92857142857144,321.42857142857144
1411,Ibrahima Koné,MLI,FW,Lorient,Ligue 1,23,1999,17.5,24,13,3,13,8,5,11,45.5,6,13,0,13,4,28,18,0,0,2022-2023,90.0,20.57142857142857,123.42857142857143
1412,Manu Koné,FRA,MF,Gladbach,Bundesliga,21,2001,29.0,74,39,37,33,4,24,47,51.1,23,44,12,32,32,106,21,0,0,2022-2023,90.0,99.3103448275862,229.65517241379308
1413,Youssouf Koné,MLI,DF,Ajaccio,Ligue 1,27,1995,10.2,28,19,24,4,0,18,25,72.0,7,9,2,7,12,40,32,1,0,2022-2023,90.0,105.88235294117648,247.05882352941177
1414,Ezri Konsa,ENG,DF,Aston Villa,Premier League,24,1997,36.9,42,20,25,15,2,18,26,69.2,8,41,23,18,26,68,120,3,0,2022-2023,90.0,63.41463414634147,102.43902439024392
1415,Teun Koopmeiners,NED,MF,Atalanta,Serie A,24,1998,31.8,46,26,15,24,7,28,55,50.9,27,41,5,36,19,65,36,2,0,2022-2023,90.0,53.77358490566038,130.18867924528303
1416,Odilon Kossonou,CIV,DF,Leverkusen,Bundesliga,21,2001,16.9,21,14,12,7,2,8,16,50.0,8,26,11,15,24,45,58,1,0,2022-2023,90.0,127.81065088757397,111.83431952662723
1417,Filip Kostić,SRB,"DF,FW",Juventus,Serie A,29,1992,28.5,41,26,17,20,4,21,47,44.7,26,30,4,26,16,57,32,0,0,2022-2023,90.0,50.526315789473685,129.47368421052633
1418,Filip Kostić,SRB,"DF,MF",Eint Frankfurt,Bundesliga,29,1992,0.8,2,0,1,1,0,0,0,0.0,0,0,0,0,1,3,0,0,0,2022-2023,90.0,112.5,225.0
1419,Christian Kouamé,CIV,FW,Fiorentina,Serie A,24,1997,20.7,27,18,8,10,9,7,14,50.0,7,15,3,12,12,39,8,0,0,2022-2023,90.0,52.173913043478265,117.3913043478261
1420,Rominigue Kouamé,MLI,MF,Troyes,Ligue 1,25,1996,29.6,44,27,28,14,2,17,41,41.5,24,32,11,21,49,93,46,1,0,2022-2023,90.0,148.98648648648648,133.78378378378378
1421,Tomáš Koubek,CZE,GK,Augsburg,Bundesliga,29,1992,11.0,0,0,0,0,0,0,0,0.0,0,0,0,0,0,0,7,0,0,2022-2023,90.0,0.0,0.0
1422,Kalidou Koulibaly,SEN,DF,Chelsea,Premier League,31,1991,20.0,45,31,34,8,3,26,40,65.0,14,30,13,17,29,74,77,0,0,2022-2023,90.0,130.5,202.5
1423,Jules Koundé,FRA,DF,Barcelona,La Liga,23,1998,27.0,37,23,18,13,6,21,31,67.7,10,24,9,15,19,56,61,3,0,2022-2023,90.0,63.333333333333336,123.33333333333334
1424,Boubakar Kouyaté,MLI,DF,Montpellier,Ligue 1,25,1997,14.0,31,18,18,11,2,19,35,54.3,16,24,14,10,34,65,73,1,0,2022-2023,90.0,218.57142857142856,199.28571428571428
1425,Cheikhou Kouyaté,SEN,MF,Nott'ham Forest,Premier League,32,1989,9.8,29,21,18,8,3,9,13,69.2,4,14,2,12,10,39,24,0,0,2022-2023,90.0,91.83673469387755,266.3265306122449
Rk,Player,Nation,Pos,Squad,Comp,0,0,90.0,0,0,3,3,3,Tkl,0,0.0,0,0,0,0,0,0,0,0,0,2022-2023,90.0,0.0,0.0
1426,Mateo Kovačić,CRO,MF,Chelsea,Premier League,28,1994,19.0,36,24,16,14,6,14,36,38.9,22,10,1,9,19,55,16,0,0,2022-2023,90.0,90.0,170.52631578947367
1427,Viktor Kovalenko,UKR,MF,Spezia,Serie A,26,1996,6.1,9,5,1,6,2,5,8,62.5,3,11,2,9,4,13,7,0,0,2022-2023,90.0,59.016393442622956,132.78688524590166
1428,Soichiro Kozuki,JPN,"FW,MF",Schalke 04,Bundesliga,21,2000,4.2,6,4,3,3,0,4,6,66.7,2,5,0,5,3,9,3,0,0,2022-2023,90.0,64.28571428571428,128.57142857142856
1429,Emil Krafth,SWE,DF,Newcastle Utd,Premier League,27,1994,0.0,0,0,0,0,0,0,0,0.0,0,0,0,0,0,0,0,0,0,2022-2023,,,
1430,Alex Král,CZE,MF,Schalke 04,Bundesliga,24,1998,26.2,34,24,10,22,2,17,37,45.9,20,31,6,25,17,51,53,0,0,2022-2023,90.0,58.396946564885496,116.79389312977099
1431,Andrej Kramarić,CRO,"MF,FW",Hoffenheim,Bundesliga,31,1991,26.5,5,2,2,1,2,1,11,9.1,10,14,2,12,6,11,13,0,0,2022-2023,90.0,20.37735849056604,16.9811320754717
1432,Christoph Kramer,GER,MF,Gladbach,Bundesliga,31,1991,24.7,44,33,24,15,5,22,55,40.0,33,34,2,32,17,61,40,0,0,2022-2023,90.0,61.94331983805668,160.32388663967612
1433,Tom Krauß,GER,MF,Schalke 04,Bundesliga,21,2001,27.9,112,68,39,62,11,51,100,51.0,49,39,6,33,36,148,35,0,0,2022-2023,90.0,116.12903225806451,361.2903225806452
1434,Rasmus Kristensen,DEN,DF,Leeds United,Premier League,25,1997,21.8,62,35,35,21,6,42,76,55.3,34,32,14,18,35,97,61,0,0,2022-2023,90.0,144.4954128440367,255.96330275229357
1435,Julian Kristoffersen,NOR,FW,Salernitana,Serie A,25,1997,0.2,0,0,0,0,0,0,0,0.0,0,1,0,1,0,0,0,0,0,2022-2023,90.0,0.0,0.0
1436,Raimonds Krollis,LVA,"FW,DF",Spezia,Serie A,20,2001,0.4,1,1,0,0,1,0,1,0.0,1,0,0,0,0,1,0,0,0,2022-2023,90.0,0.0,225.0
1437,Toni Kroos,GER,MF,Real Madrid,La Liga,32,1990,23.9,51,32,16,33,2,23,69,33.3,46,23,4,19,24,75,11,0,0,2022-2023,90.0,90.3765690376569,192.05020920502093
1438,Rade Krunić,BIH,MF,Milan,Serie A,28,1993,18.4,40,28,18,18,4,16,50,32.0,34,31,11,20,16,56,21,0,0,2022-2023,90.0,78.26086956521739,195.6521739130435
1439,Max Kruse,GER,"MF,FW",Wolfsburg,Bundesliga,34,1988,3.0,1,1,0,1,0,0,1,0.0,1,2,1,1,0,1,1,0,0,2022-2023,90.0,0.0,30.0
1440,Lukas Kübler,GER,DF,Freiburg,Bundesliga,29,1992,18.2,37,25,24,9,4,18,30,60.0,12,25,11,14,29,66,50,0,0,2022-2023,90.0,143.4065934065934,182.96703296703296
1441,Takefusa Kubo,JPN,"FW,MF",Real Sociedad,La Liga,21,2001,27.1,44,26,18,16,10,16,38,42.1,22,29,1,28,9,53,4,0,0,2022-2023,90.0,29.88929889298893,146.12546125461256
1442,Dejan Kulusevski,SWE,"MF,FW",Tottenham,Premier League,22,2000,23.0,38,15,23,7,8,16,44,36.4,28,19,0,19,13,51,7,0,0,2022-2023,90.0,50.86956521739131,148.69565217391306
1443,Sael Kumbedi,FRA,DF,Lyon,Ligue 1,17,2005,14.7,47,27,27,13,7,20,38,52.6,18,23,7,16,10,57,16,0,0,2022-2023,90.0,61.224489795918366,287.7551020408163
1444,Marash Kumbulla,ALB,DF,Roma,Serie A,22,2000,2.9,4,4,2,2,0,2,3,66.7,1,2,1,1,4,8,6,0,0,2022-2023,90.0,124.13793103448276,124.13793103448276
1445,Pierre Kunde,CMR,"MF,FW",Bochum,Bundesliga,27,1995,4.2,12,6,3,8,1,6,14,42.9,8,7,1,6,7,19,9,0,0,2022-2023,90.0,150.0,257.1428571428571
1446,Alou Kuol,AUS,FW,Stuttgart,Bundesliga,21,2000,0.1,0,0,0,0,0,0,0,0.0,0,0,0,0,0,0,0,0,0,2022-2023,90.0,0.0,0.0
1447,Layvin Kurzawa,FRA,DF,Fulham,Premier League,29,1992,1.5,3,2,1,1,1,3,3,100.0,0,1,1,0,2,5,4,0,0,2022-2023,90.0,120.0,180.0
1448,Khvicha Kvaratskhelia,GEO,FW,Napoli,Serie A,21,2001,28.0,43,23,12,8,23,17,43,39.5,26,20,0,20,5,48,6,1,0,2022-2023,90.0,16.07142857142857,138.21428571428572
1449,Grejohn Kyei,FRA,FW,Clermont Foot,Ligue 1,26,1995,24.8,16,7,2,9,5,4,13,30.8,9,14,3,11,6,22,22,0,0,2022-2023,90.0,21.774193548387096,58.064516129032256
1450,Daniel Kyereh,GHA,"MF,FW",Freiburg,Bundesliga,26,1996,6.2,6,4,2,4,0,3,6,50.0,3,4,0,4,2,8,6,0,0,2022-2023,90.0,29.032258064516128,87.09677419354838
Rk,Player,Nation,Pos,Squad,Comp,0,0,90.0,0,0,3,3,3,Tkl,0,0.0,0,0,0,0,0,0,0,0,0,2022-2023,90.0,0.0,0.0
1451,Giorgos Kyriakopoulos,GRE,"DF,FW",Bologna,Serie A,26,1996,7.8,13,6,4,5,4,10,23,43.5,13,14,2,12,4,17,10,0,0,2022-2023,90.0,46.15384615384615,150.0
1452,Giorgos Kyriakopoulos,GRE,"FW,DF",Sassuolo,Serie A,26,1996,8.5,21,8,7,9,5,10,14,71.4,4,7,1,6,11,32,12,1,0,2022-2023,90.0,116.47058823529412,222.35294117647058
1453,César de la Hoz,ESP,MF,Almería,La Liga,30,1992,18.6,37,20,17,18,2,19,37,51.4,18,26,6,20,13,50,37,0,0,2022-2023,90.0,62.9032258064516,179.0322580645161
1454,Luca de la Torre,USA,MF,Celta Vigo,La Liga,24,1998,16.5,28,19,11,14,3,12,32,37.5,20,22,1,21,9,37,6,0,0,2022-2023,90.0,49.09090909090909,152.72727272727275
1455,Rémy Labeau Lascary,GLP,"FW,MF",Lens,Ligue 1,19,2003,1.4,4,2,4,0,0,0,0,0.0,0,4,0,4,1,5,0,0,0,2022-2023,90.0,64.28571428571429,257.14285714285717
1456,Gaëtan Laborde,FRA,FW,Nice,Ligue 1,28,1994,27.8,45,25,13,17,15,18,40,45.0,22,27,2,25,9,54,13,0,0,2022-2023,90.0,29.136690647482016,145.68345323741008
1457,Gaëtan Laborde,FRA,FW,Rennes,Ligue 1,28,1994,2.8,1,1,1,0,0,0,1,0.0,1,1,0,1,0,1,1,0,0,2022-2023,90.0,0.0,32.142857142857146
1458,Alexandre Lacazette,FRA,FW,Lyon,Ligue 1,31,1991,32.5,43,23,7,17,19,10,29,34.5,19,23,3,20,15,58,4,0,0,2022-2023,90.0,41.53846153846154,119.07692307692308
1459,Qazim Laçi,ALB,MF,Ajaccio,Ligue 1,26,1996,2.4,6,3,2,3,1,4,9,44.4,5,5,0,5,2,8,3,0,0,2022-2023,90.0,75.0,225.00000000000003
1460,Maxence Lacroix,FRA,DF,Wolfsburg,Bundesliga,22,2000,18.1,22,13,15,7,0,8,16,50.0,8,22,11,11,26,48,85,0,0,2022-2023,90.0,129.2817679558011,109.39226519337015
1461,Alban Lafont,FRA,GK,Nantes,Ligue 1,23,1999,37.0,0,0,0,0,0,0,1,0.0,1,0,0,0,0,0,20,4,0,2022-2023,90.0,0.0,0.0
1462,Aïssa Laïdouni,TUN,MF,Union Berlin,Bundesliga,25,1996,9.7,14,7,6,8,0,5,17,29.4,12,22,4,18,9,23,3,0,0,2022-2023,90.0,83.50515463917527,129.89690721649487
1463,Konrad Laimer,AUT,MF,RB Leipzig,Bundesliga,25,1997,16.3,60,31,23,30,7,30,54,55.6,24,31,4,27,18,78,8,0,0,2022-2023,90.0,99.38650306748467,331.28834355828224
1464,Stefan Lainer,AUT,DF,Gladbach,Bundesliga,29,1992,9.1,16,8,10,5,1,10,23,43.5,13,8,1,7,14,30,34,1,0,2022-2023,90.0,138.46153846153845,158.24175824175825
1465,Kenny Lala,MAD,DF,Brest,Ligue 1,30,1991,15.7,36,19,19,15,2,22,38,57.9,16,15,5,10,21,57,28,0,0,2022-2023,90.0,120.38216560509555,206.36942675159239
1466,Adam Lallana,ENG,"MF,FW",Brighton,Premier League,34,1988,8.0,9,4,6,2,1,0,7,0.0,7,6,0,6,2,11,1,0,0,2022-2023,90.0,22.5,101.25
1467,Vassilis Lambropoulos,GRE,DF,Bochum,Bundesliga,32,1990,7.0,10,8,7,3,0,6,9,66.7,3,5,3,2,13,23,41,0,0,2022-2023,90.0,167.14285714285714,128.57142857142856
1468,Érik Lamela,ARG,"FW,MF",Sevilla,La Liga,30,1992,20.5,46,27,14,16,16,12,34,35.3,22,26,2,24,7,53,3,0,0,2022-2023,90.0,30.73170731707317,201.95121951219514
1469,Mohamed Lamine Bayo,GUI,"FW,MF",Lille,Ligue 1,24,1998,7.2,3,3,0,2,1,0,12,0.0,12,3,1,2,0,3,1,0,0,2022-2023,90.0,0.0,37.5
1470,Sam Lammers,NED,FW,Sampdoria,Serie A,25,1997,12.2,12,5,2,7,3,6,15,40.0,9,10,3,7,6,18,11,0,0,2022-2023,90.0,44.26229508196722,88.52459016393443
1471,Sam Lammers,NED,FW,Empoli,Serie A,25,1997,9.8,20,10,5,9,6,7,11,63.6,4,4,1,3,3,23,8,0,0,2022-2023,90.0,27.551020408163264,183.6734693877551
1472,Tariq Lamptey,GHA,DF,Brighton,Premier League,21,2000,5.0,11,6,6,4,1,5,7,71.4,2,7,3,4,7,18,2,0,0,2022-2023,90.0,126.0,198.0
1473,Manuel Lanzini,ARG,"MF,FW",West Ham,Premier League,29,1993,2.8,2,2,1,1,0,2,6,33.3,4,2,0,2,2,4,0,0,0,2022-2023,90.0,64.28571428571429,64.28571428571429
1474,Aymeric Laporte,ESP,DF,Manchester City,Premier League,28,1994,11.0,11,8,6,4,1,7,11,63.6,4,10,4,6,3,14,30,1,0,2022-2023,90.0,24.545454545454547,90.0
1475,Julien Laporte,FRA,DF,Lorient,Ligue 1,28,1993,18.4,22,16,18,3,1,16,22,72.7,6,33,27,6,18,40,108,2,0,2022-2023,90.0,88.04347826086958,107.60869565217392
Rk,Player,Nation,Pos,Squad,Comp,0,0,90.0,0,0,3,3,3,Tkl,0,0.0,0,0,0,0,0,0,0,0,0,2022-2023,90.0,0.0,0.0
1476,Cyle Larin,CAN,FW,Valladolid,La Liga,27,1995,16.3,9,3,2,4,3,3,7,42.9,4,6,3,3,0,9,15,0,0,2022-2023,90.0,0.0,49.693251533742334
1477,Juan Larios,ESP,DF,Southampton,Premier League,18,2004,1.7,7,6,6,1,0,5,5,100.0,0,2,0,2,3,10,4,0,0,2022-2023,90.0,158.8235294117647,370.5882352941176
1478,Yasser Larouci,ALG,"DF,MF",Troyes,Ligue 1,21,2001,20.0,23,13,13,8,2,15,24,62.5,9,15,1,14,26,49,46,0,0,2022-2023,90.0,117.0,103.5
1479,Jordan Larsson,SWE,"FW,MF",Schalke 04,Bundesliga,25,1997,5.1,8,5,1,7,0,2,9,22.2,7,9,0,9,4,12,3,0,0,2022-2023,90.0,70.58823529411765,141.1764705882353
1480,Kevin Lasagna,ITA,"FW,MF",Hellas Verona,Serie A,29,1992,17.5,12,6,7,3,2,6,14,42.9,8,17,1,16,5,17,13,0,0,2022-2023,90.0,25.714285714285715,61.714285714285715
1481,Jamaal Lascelles,ENG,DF,Newcastle Utd,Premier League,28,1993,2.4,1,0,1,0,0,1,1,100.0,0,3,2,1,0,1,17,0,0,2022-2023,90.0,0.0,37.5
1482,Juanmi Latasa,ESP,FW,Getafe,La Liga,21,2001,5.0,5,4,2,0,3,1,1,100.0,0,3,1,2,1,6,8,0,0,2022-2023,90.0,18.0,90.0
1483,Toni Lato,ESP,"DF,MF",Valencia,La Liga,24,1997,10.2,23,11,9,12,2,9,21,42.9,12,10,1,9,6,29,14,0,0,2022-2023,90.0,52.94117647058824,202.94117647058823
1484,Danny Latza,GER,MF,Schalke 04,Bundesliga,32,1989,9.5,17,13,8,8,1,5,17,29.4,12,16,1,15,5,22,15,0,0,2022-2023,90.0,47.36842105263158,161.05263157894737
1485,Armand Lauriente,FRA,FW,Sassuolo,Serie A,23,1998,24.2,21,15,5,7,9,8,21,38.1,13,20,0,20,12,33,8,0,0,2022-2023,90.0,44.628099173553714,78.099173553719
1486,Armand Lauriente,FRA,FW,Lorient,Ligue 1,23,1998,3.0,8,7,3,4,1,3,7,42.9,4,5,1,4,4,12,1,0,0,2022-2023,90.0,120.0,240.0
1487,Roméo Lavia,BEL,MF,Southampton,Premier League,18,2004,24.7,60,35,27,29,4,21,53,39.6,32,47,11,36,33,93,23,1,0,2022-2023,90.0,120.24291497975709,218.6234817813765
1488,Lázaro,BRA,"FW,MF",Almería,La Liga,20,2002,8.0,4,3,3,0,1,3,15,20.0,12,16,1,15,2,6,1,0,0,2022-2023,90.0,22.5,45.0
1489,Valentino Lazaro,AUT,DF,Torino,Serie A,26,1996,15.3,10,5,6,0,4,6,14,42.9,8,16,3,13,3,13,29,0,0,2022-2023,90.0,17.64705882352941,58.8235294117647
1490,Marko Lazetić,SRB,FW,Milan,Serie A,18,2004,0.1,0,0,0,0,0,0,0,0.0,0,0,0,0,0,0,0,0,0,2022-2023,90.0,0.0,0.0
1491,Darko Lazović,SRB,"MF,DF",Hellas Verona,Serie A,31,1990,24.9,24,13,9,12,3,13,29,44.8,16,14,3,11,16,40,19,0,0,2022-2023,90.0,57.83132530120482,86.74698795180723
1492,Manuel Lazzari,ITA,DF,Lazio,Serie A,28,1993,20.9,33,21,13,14,6,21,36,58.3,15,20,6,14,18,51,36,1,0,2022-2023,90.0,77.51196172248804,142.10526315789474
1493,Théo Le Bris,FRA,"MF,DF",Lorient,Ligue 1,19,2002,16.1,31,19,17,11,3,15,33,45.5,18,21,2,19,18,49,31,0,0,2022-2023,90.0,100.62111801242236,173.2919254658385
1494,Julien Le Cardinal,FRA,DF,Lens,Ligue 1,24,1997,1.8,6,4,5,0,1,4,6,66.7,2,3,0,3,2,8,5,0,0,2022-2023,90.0,100.0,300.0
1495,Jérémy Le Douaron,FRA,"MF,FW",Brest,Ligue 1,24,1998,23.0,15,9,5,9,1,3,27,11.1,24,29,2,27,11,26,30,0,0,2022-2023,90.0,43.04347826086957,58.69565217391305
1496,Enzo Le Fée,FRA,MF,Lorient,Ligue 1,22,2000,33.6,108,64,52,40,16,43,113,38.1,70,50,5,45,34,142,38,1,0,2022-2023,90.0,91.07142857142857,289.2857142857143
1497,Vincent Le Goff,FRA,DF,Lorient,Ligue 1,32,1989,37.0,75,32,56,16,3,45,62,72.6,17,29,9,20,41,116,105,1,0,2022-2023,90.0,99.72972972972974,182.43243243243245
1498,Maxime Le Marchand,FRA,DF,Strasbourg,Ligue 1,32,1989,22.4,39,24,23,14,2,19,31,61.3,12,22,14,8,37,76,74,0,0,2022-2023,90.0,148.66071428571428,156.69642857142858
1499,Robin Le Normand,ESP,DF,Real Sociedad,La Liga,25,1996,31.1,36,23,25,9,2,14,27,51.9,13,22,14,8,33,69,93,0,0,2022-2023,90.0,95.49839228295819,104.18006430868166
1500,Rafael Leão,POR,"FW,MF",Milan,Serie A,23,1999,26.9,8,7,2,3,3,6,14,42.9,8,9,2,7,15,23,8,0,0,2022-2023,90.0,50.18587360594796,26.765799256505577
Rk,Player,Nation,Pos,Squad,Comp,0,0,90.0,0,0,3,3,3,Tkl,0,0.0,0,0,0,0,0,0,0,0,0,2022-2023,90.0,0.0,0.0
1501,Paolo Lebas,FRA,MF,Ajaccio,Ligue 1,19,2003,0.6,0,0,0,0,0,0,0,0.0,0,0,0,0,0,0,0,0,0,2022-2023,90.0,0.0,0.0
1502,Jean-Louis Leca,FRA,GK,Lens,Ligue 1,36,1985,1.0,0,0,0,0,0,0,0,0.0,0,0,0,0,0,0,0,1,0,2022-2023,90.0,0.0,0.0
1503,Benjamin Lecomte,FRA,GK,Espanyol,La Liga,31,1991,10.0,0,0,0,0,0,0,0,0.0,0,0,0,0,0,0,3,2,0,2022-2023,90.0,0.0,0.0
1504,Benjamin Lecomte,FRA,GK,Montpellier,Ligue 1,31,1991,19.0,0,0,0,0,0,0,2,0.0,2,0,0,0,0,0,6,0,0,2022-2023,90.0,0.0,0.0
1505,Jeremías Ledesma,ARG,GK,Cádiz,La Liga,29,1993,34.0,3,2,3,0,0,3,7,42.9,4,1,0,1,2,5,23,3,0,2022-2023,90.0,5.294117647058823,7.9411764705882355
1506,Pierre Lees-Melou,FRA,MF,Brest,Ligue 1,29,1993,30.7,97,55,55,37,5,57,123,46.3,66,48,13,35,52,149,46,1,0,2022-2023,90.0,152.44299674267103,284.36482084690556
1507,Diogo Leite,POR,DF,Union Berlin,Bundesliga,23,1999,25.0,35,20,21,14,0,21,34,61.8,13,23,14,9,26,61,99,1,0,2022-2023,90.0,93.6,126.0
1508,Maxim Leitsch,GER,DF,Mainz 05,Bundesliga,24,1998,7.4,9,7,6,3,0,4,5,80.0,1,7,4,3,18,27,26,1,0,2022-2023,90.0,218.9189189189189,109.45945945945945
1509,Florian Lejeune,FRA,DF,Rayo Vallecano,La Liga,31,1991,28.5,28,17,19,8,1,17,25,68.0,8,24,16,8,15,43,123,0,0,2022-2023,90.0,47.36842105263158,88.42105263157895
1510,Iñigo Lekue,ESP,DF,Athletic Club,La Liga,29,1993,14.7,24,17,20,4,0,12,19,63.2,7,16,2,14,13,37,31,1,0,2022-2023,90.0,79.59183673469389,146.9387755102041
1511,Thomas Lemar,FRA,MF,Atlético Madrid,La Liga,26,1995,13.9,30,18,10,13,7,10,28,35.7,18,12,3,9,7,37,12,0,0,2022-2023,90.0,45.32374100719424,194.24460431654677
1512,Félix Lemaréchal,FRA,MF,Brest,Ligue 1,18,2003,3.2,5,5,2,1,2,0,3,0.0,3,6,0,6,1,6,2,0,0,2022-2023,90.0,28.125,140.625
1513,Dexter Lembikisa,JAM,DF,Wolves,Premier League,18,2003,0.3,0,0,0,0,0,0,0,0.0,0,0,0,0,0,0,0,0,0,2022-2023,90.0,0.0,0.0
1514,Mario Lemina,GAB,MF,Wolves,Premier League,28,1993,14.4,38,24,22,13,3,20,38,52.6,18,26,8,18,14,52,24,1,0,2022-2023,90.0,87.5,237.5
1515,Mario Lemina,GAB,"MF,DF",Nice,Ligue 1,28,1993,9.3,32,21,11,14,7,12,18,66.7,6,13,5,8,11,43,20,0,0,2022-2023,90.0,106.4516129032258,309.67741935483866
1516,Tim Lemperle,GER,"FW,MF",Köln,Bundesliga,20,2002,1.5,6,4,3,1,2,3,5,60.0,2,5,0,5,1,7,4,0,0,2022-2023,90.0,60.0,360.0
1517,Clément Lenglet,FRA,DF,Tottenham,Premier League,27,1995,22.4,38,23,18,15,5,16,34,47.1,18,26,11,15,18,56,68,2,0,2022-2023,90.0,72.32142857142857,152.67857142857144
1518,Bernd Leno,GER,GK,Fulham,Premier League,30,1992,36.0,0,0,0,0,0,0,3,0.0,3,0,0,0,0,0,18,1,0,2022-2023,90.0,0.0,0.0
1519,Christopher Lenz,GER,DF,Eint Frankfurt,Bundesliga,27,1994,14.3,29,21,17,7,5,16,37,43.2,21,16,3,13,21,50,34,0,0,2022-2023,90.0,132.16783216783216,182.51748251748253
1520,Donovan Léon,GUF,GK,Auxerre,Ligue 1,29,1992,2.0,0,0,0,0,0,0,0,0.0,0,0,0,0,0,0,1,0,0,2022-2023,90.0,0.0,0.0
1521,Sergio León,ESP,FW,Valladolid,La Liga,33,1989,14.8,6,4,0,4,2,3,6,50.0,3,6,0,6,0,6,4,0,0,2022-2023,90.0,0.0,36.486486486486484
1522,Johann Lepenant,FRA,MF,Lyon,Ligue 1,19,2002,21.5,58,34,24,27,7,32,86,37.2,54,29,5,24,28,86,17,3,0,2022-2023,90.0,117.20930232558139,242.7906976744186
1523,Mehdi Léris,ALG,"MF,DF",Sampdoria,Serie A,24,1998,27.3,63,46,30,24,9,23,55,41.8,32,38,6,32,27,90,34,0,0,2022-2023,90.0,89.01098901098901,207.69230769230768
1524,Jefferson Lerma,COL,MF,Bournemouth,Premier League,27,1994,36.1,50,30,23,23,4,20,45,44.4,25,32,15,17,47,97,91,2,0,2022-2023,90.0,117.17451523545705,124.65373961218836
1525,Benjamin Leroy,FRA,GK,Ajaccio,Ligue 1,33,1989,31.1,0,0,0,0,0,0,2,0.0,2,0,0,0,1,1,16,2,0,2022-2023,90.0,2.8938906752411575,0.0
Rk,Player,Nation,Pos,Squad,Comp,0,0,90.0,0,0,3,3,3,Tkl,0,0.0,0,0,0,0,0,0,0,0,0,2022-2023,90.0,0.0,0.0
1526,Léo Leroy,FRA,MF,Montpellier,Ligue 1,22,2000,13.2,53,38,24,26,3,31,57,54.4,26,25,2,23,14,67,8,0,0,2022-2023,90.0,95.45454545454545,361.3636363636364
1527,Alexandre Letellier,FRA,GK,Paris S-G,Ligue 1,31,1990,0.1,0,0,0,0,0,0,0,0.0,0,0,0,0,0,0,0,0,0,2022-2023,90.0,0.0,0.0
1528,Ruan Levine,BRA,"MF,FW",Ajaccio,Ligue 1,23,1999,0.3,2,2,1,1,0,0,0,0.0,0,1,0,1,2,4,0,0,0,2022-2023,90.0,600.0,600.0
1529,Robert Lewandowski,POL,FW,Barcelona,La Liga,33,1988,31.6,17,11,2,5,10,7,14,50.0,7,20,0,20,2,19,14,0,0,2022-2023,90.0,5.696202531645569,48.417721518987335
1530,Jamie Leweling,GER,"FW,MF",Union Berlin,Bundesliga,21,2001,2.9,5,3,2,2,1,3,5,60.0,2,3,0,3,1,6,0,0,0,2022-2023,90.0,31.03448275862069,155.17241379310346
1531,Jamal Lewis,NIR,"DF,FW",Newcastle Utd,Premier League,24,1998,0.1,0,0,0,0,0,0,0,0.0,0,0,0,0,0,0,0,0,0,2022-2023,90.0,0.0,0.0
1532,Rico Lewis,ENG,"DF,MF",Manchester City,Premier League,17,2004,10.0,16,9,9,5,2,6,11,54.5,5,8,4,4,6,22,13,1,0,2022-2023,90.0,54.0,144.0
1533,Keane Lewis-Potter,ENG,"FW,MF",Brentford,Premier League,21,2001,3.6,1,0,0,1,0,0,0,0.0,0,5,1,4,0,1,2,0,0,2022-2023,90.0,0.0,25.0
1534,Dimitri Liénard,FRA,"DF,MF",Strasbourg,Ligue 1,34,1988,17.1,46,29,20,18,8,34,57,59.6,23,28,4,24,16,62,24,0,0,2022-2023,90.0,84.21052631578948,242.10526315789474
1535,Philipp Lienhart,AUT,DF,Freiburg,Bundesliga,26,1996,27.8,29,18,19,10,0,13,27,48.1,14,29,15,14,35,64,97,0,0,2022-2023,90.0,113.30935251798562,93.88489208633094
1536,Matthijs de Ligt,NED,DF,Bayern Munich,Bundesliga,22,1999,26.7,32,23,15,16,1,15,24,62.5,9,31,20,11,23,55,85,0,0,2022-2023,90.00000000000001,77.52808988764046,107.86516853932585
1537,Dimitris Limnios,GRE,FW,Köln,Bundesliga,24,1998,0.4,0,0,0,0,0,0,0,0.0,0,0,0,0,1,1,0,0,0,2022-2023,90.0,225.0,0.0
1538,Victor Lindelöf,SWE,DF,Manchester Utd,Premier League,28,1994,15.2,22,17,10,9,3,9,17,52.9,8,18,9,9,21,43,63,1,0,2022-2023,90.0,124.34210526315789,130.26315789473685
1539,Jesper Lindstrøm,DEN,"MF,FW",Eint Frankfurt,Bundesliga,22,2000,18.7,26,11,15,7,4,7,22,31.8,15,25,3,22,9,35,9,0,0,2022-2023,90.0,43.31550802139037,125.13368983957218
1540,Karol Linetty,POL,MF,Torino,Serie A,27,1995,21.0,32,17,7,22,3,13,25,52.0,12,28,8,20,19,51,25,0,0,2022-2023,90.0,81.42857142857143,137.14285714285714
1541,Jesse Lingard,ENG,"FW,MF",Nott'ham Forest,Premier League,29,1992,10.3,4,4,2,2,0,1,7,14.3,6,11,0,11,5,9,4,0,0,2022-2023,90.0,43.689320388349515,34.95145631067961
1542,Samuel Lino,BRA,"FW,MF",Valencia,La Liga,22,1999,32.1,66,43,17,37,12,26,72,36.1,46,34,0,34,18,84,16,0,0,2022-2023,90.0,50.467289719626166,185.0467289719626
1543,Pol Lirola,ESP,DF,Elche,La Liga,24,1997,7.0,13,6,9,3,1,8,13,61.5,5,3,2,1,7,20,16,0,0,2022-2023,90.0,90.0,167.14285714285714
1544,Mateusz Lis,POL,GK,Troyes,Ligue 1,25,1997,8.3,0,0,0,0,0,0,1,0.0,1,1,0,1,0,0,3,0,0,2022-2023,90.0,0.0,0.0
1545,Marcin Listkowski,POL,"MF,FW",Lecce,Serie A,24,1998,0.9,0,0,0,0,0,0,0,0.0,0,0,0,0,3,3,2,0,0,2022-2023,90.0,300.0,0.0
1546,Valentino Livramento,ENG,"DF,FW",Southampton,Premier League,19,2002,0.3,2,1,2,0,0,0,0,0.0,0,0,0,0,2,4,3,0,0,2022-2023,90.0,600.0,600.0
1547,Dejan Ljubicic,AUT,"MF,FW",Köln,Bundesliga,24,1997,19.0,25,14,7,14,4,13,40,32.5,27,20,1,19,8,33,8,1,0,2022-2023,90.0,37.89473684210526,118.42105263157895
1548,Javier Llabrés,ESP,FW,Mallorca,La Liga,19,2002,0.2,0,0,0,0,0,0,0,0.0,0,0,0,0,0,0,1,0,0,2022-2023,90.0,0.0,0.0
1549,Diego Llorente,ESP,DF,Leeds United,Premier League,28,1993,7.2,13,10,8,5,0,4,8,50.0,4,6,2,4,15,28,24,2,0,2022-2023,90.0,187.5,162.5
1550,Diego Llorente,ESP,DF,Roma,Serie A,28,1993,6.4,10,5,6,4,0,5,12,41.7,7,4,2,2,11,21,20,0,0,2022-2023,90.0,154.6875,140.625
Rk,Player,Nation,Pos,Squad,Comp,0,0,90.0,0,0,3,3,3,Tkl,0,0.0,0,0,0,0,0,0,0,0,0,2022-2023,90.0,0.0,0.0
1551,Marcos Llorente,ESP,"MF,DF",Atlético Madrid,La Liga,27,1995,18.9,32,15,16,10,6,17,30,56.7,13,26,2,24,17,49,19,0,0,2022-2023,90.0,80.95238095238095,152.38095238095238
1552,Hugo Lloris,FRA,GK,Tottenham,Premier League,35,1986,24.5,1,1,1,0,0,1,3,33.3,2,0,0,0,1,2,13,5,0,2022-2023,90.00000000000001,3.6734693877551026,3.6734693877551026
1553,Giovani Lo Celso,ARG,"MF,FW",Villarreal,La Liga,26,1996,12.5,32,28,7,15,10,12,21,57.1,9,14,2,12,6,38,5,0,0,2022-2023,90.0,43.199999999999996,230.39999999999998
1554,Stanislav Lobotka,SVK,MF,Napoli,Serie A,27,1994,34.5,83,44,35,35,13,43,73,58.9,30,29,7,22,23,106,16,0,0,2022-2023,90.0,59.99999999999999,216.52173913043478
1555,Manuel Locatelli,ITA,MF,Juventus,Serie A,24,1998,27.2,59,33,26,23,10,30,53,56.6,23,50,22,28,27,86,59,0,0,2022-2023,90.0,89.33823529411765,195.22058823529412
1556,Luka Lochoshvili,GEO,DF,Cremonese,Serie A,24,1998,20.4,45,19,30,11,4,22,31,71.0,9,31,10,21,22,67,89,0,0,2022-2023,90.0,97.05882352941177,198.52941176470588
1557,Bradley Locko,FRA,DF,Reims,Ligue 1,20,2002,11.8,31,16,21,4,6,15,27,55.6,12,17,4,13,20,51,21,0,0,2022-2023,90.0,152.54237288135593,236.44067796610167
1558,Bradley Locko,FRA,DF,Brest,Ligue 1,20,2002,3.0,4,3,2,1,1,2,3,66.7,1,4,0,4,2,6,13,0,0,2022-2023,90.0,60.0,120.0
1559,Renan Lodi,BRA,DF,Nott'ham Forest,Premier League,24,1998,24.6,52,39,38,8,6,33,66,50.0,33,25,6,19,33,85,74,0,0,2022-2023,89.99999999999999,120.73170731707316,190.24390243902437
1560,Ruben Loftus-Cheek,ENG,"MF,DF",Chelsea,Premier League,26,1996,17.1,25,14,8,14,3,12,22,54.5,10,15,2,13,12,37,23,0,0,2022-2023,90.0,63.1578947368421,131.57894736842104
1561,Sean Longstaff,ENG,MF,Newcastle Utd,Premier League,24,1997,28.0,42,21,16,20,6,20,52,38.5,32,35,8,27,16,58,23,0,0,2022-2023,90.0,51.42857142857143,135.0
1562,Ademola Lookman,NGA,"FW,MF",Atalanta,Serie A,24,1997,19.2,13,5,2,6,5,3,15,20.0,12,18,0,18,4,17,1,0,0,2022-2023,90.0,18.75,60.93750000000001
1563,Anthony Lopes,POR,GK,Lyon,Ligue 1,31,1990,31.3,1,0,1,0,0,1,4,25.0,3,0,0,0,3,4,10,0,0,2022-2023,90.0,8.626198083067091,2.8753993610223643
1564,Rony Lopes,POR,"MF,FW",Troyes,Ligue 1,26,1995,26.1,24,12,6,15,3,7,31,22.6,24,14,2,12,9,33,10,0,0,2022-2023,90.0,31.034482758620687,82.75862068965516
1565,David López,ESP,DF,Girona,La Liga,32,1989,18.4,31,18,17,13,1,19,27,70.4,8,29,19,10,14,45,64,1,0,2022-2023,90.0,68.47826086956522,151.63043478260872
1566,Diego López,ESP,GK,Rayo Vallecano,La Liga,40,1981,1.1,0,0,0,0,0,0,0,0.0,0,0,0,0,0,0,0,1,0,2022-2023,90.0,0.0,0.0
1567,Diego López,ESP,"FW,MF",Valencia,La Liga,20,2002,5.0,2,2,1,1,0,2,15,13.3,13,9,0,9,3,5,5,0,0,2022-2023,90.0,54.0,36.0
1568,Maxime Lopez,FRA,MF,Sassuolo,Serie A,24,1997,25.5,42,18,26,12,4,16,56,28.6,40,24,6,18,22,64,21,0,0,2022-2023,90.0,77.64705882352942,148.23529411764707
1569,Pau López,ESP,GK,Marseille,Ligue 1,27,1994,32.5,0,0,0,0,0,0,1,0.0,1,0,0,0,0,0,5,1,0,2022-2023,90.0,0.0,0.0
1570,Unai López,ESP,MF,Rayo Vallecano,La Liga,26,1995,13.9,32,20,10,17,5,13,37,35.1,24,12,1,11,15,47,6,1,0,2022-2023,90.0,97.12230215827338,207.19424460431657
1571,Dion Lopy,SEN,MF,Reims,Ligue 1,20,2002,15.3,45,24,22,16,7,23,62,37.1,39,27,3,24,22,67,18,0,0,2022-2023,90.0,129.41176470588235,264.70588235294116
1572,Anthony Losilla,FRA,MF,Bochum,Bundesliga,36,1986,30.2,76,49,32,34,10,38,77,49.4,39,39,12,27,37,113,67,0,0,2022-2023,90.0,110.26490066225166,226.49006622516558
1573,Jordan Lotomba,SUI,DF,Nice,Ligue 1,23,1998,27.3,65,38,33,24,8,31,48,64.6,17,38,11,27,32,97,53,0,0,2022-2023,90.0,105.49450549450549,214.28571428571428
1574,Matteo Lovato,ITA,DF,Salernitana,Serie A,22,2000,9.0,17,14,14,3,0,10,25,40.0,15,8,5,3,13,30,33,2,0,2022-2023,90.0,130.0,170.0
1575,Dejan Lovren,CRO,DF,Lyon,Ligue 1,33,1989,16.2,25,19,20,5,0,20,29,69.0,9,20,10,10,26,51,70,1,0,2022-2023,90.0,144.44444444444446,138.88888888888889
Rk,Player,Nation,Pos,Squad,Comp,0,0,90.0,0,0,3,3,3,Tkl,0,0.0,0,0,0,0,0,0,0,0,0,2022-2023,90.0,0.0,0.0
1576,Sandi Lovrić,SVN,MF,Udinese,Serie A,24,1998,25.9,40,18,16,16,8,25,43,58.1,18,25,2,23,26,66,21,0,0,2022-2023,90.0,90.34749034749036,138.99613899613902
1577,Jamal Lowe,JAM,"MF,FW",Bournemouth,Premier League,28,1994,0.1,0,0,0,0,0,0,0,0.0,0,0,0,0,0,0,0,0,0,2022-2023,90.0,0.0,0.0
1578,Anthony Lozano,HON,FW,Cádiz,La Liga,29,1993,16.0,6,4,1,4,1,1,7,14.3,6,12,1,11,3,9,17,0,0,2022-2023,90.0,16.875,33.75
1579,Hirving Lozano,MEX,FW,Napoli,Serie A,27,1995,17.8,24,13,10,6,8,9,21,42.9,12,31,0,31,15,39,6,0,0,2022-2023,90.0,75.84269662921348,121.34831460674158
1580,Pol Lozano,ESP,MF,Espanyol,La Liga,22,1999,0.2,0,0,0,0,0,0,0,0.0,0,1,0,1,0,0,1,0,0,2022-2023,90.0,0.0,0.0
1581,Jean Lucas,BRA,MF,Monaco,Ligue 1,24,1998,3.2,9,5,3,5,1,6,12,50.0,6,2,1,1,4,13,2,0,0,2022-2023,90.0,112.5,253.125
1582,Jhon Lucumí,COL,DF,Bologna,Serie A,24,1998,32.2,53,37,39,13,1,24,43,55.8,19,43,26,17,35,88,100,1,0,2022-2023,90.0,97.82608695652173,148.1366459627329
1583,José Luis Gayà,ESP,DF,Valencia,La Liga,27,1995,30.1,80,46,61,16,3,43,74,58.1,31,28,9,19,23,103,48,0,0,2022-2023,90.00000000000001,68.77076411960132,239.20265780730898
1584,José Luis Morales,ESP,"FW,MF",Villarreal,La Liga,35,1987,13.5,7,6,1,2,4,5,17,29.4,12,12,1,11,2,9,2,0,0,2022-2023,90.0,13.333333333333334,46.66666666666667
1585,José Luis Palomino,ARG,DF,Atalanta,Serie A,32,1990,8.4,23,14,16,7,0,11,19,57.9,8,11,4,7,28,51,20,0,0,2022-2023,90.0,300.0,246.42857142857142
1586,Douglas Luiz,BRA,MF,Aston Villa,Premier League,24,1998,32.5,72,42,31,32,9,29,63,46.0,34,36,7,29,40,112,27,2,0,2022-2023,90.0,110.76923076923077,199.3846153846154
1587,Romelu Lukaku,BEL,FW,Inter,Serie A,29,1993,18.4,3,1,1,0,2,2,5,40.0,3,3,1,2,0,3,16,0,0,2022-2023,90.0,0.0,14.673913043478262
1588,Castello Lukeba,FRA,DF,Lyon,Ligue 1,19,2002,33.2,39,23,27,8,4,21,31,67.7,10,42,24,18,75,114,105,1,0,2022-2023,90.0,203.31325301204816,105.72289156626505
1589,Dodi Lukebakio,BEL,"FW,MF",Hertha BSC,Bundesliga,24,1997,26.6,18,11,7,8,3,6,27,22.2,21,23,5,18,13,31,17,0,0,2022-2023,90.0,43.984962406015036,60.90225563909774
1590,Saša Lukić,SRB,MF,Fulham,Premier League,25,1996,4.6,8,3,1,4,3,3,7,42.9,4,6,2,4,5,13,3,0,0,2022-2023,90.0,97.82608695652175,156.52173913043478
1591,Saša Lukić,SRB,MF,Torino,Serie A,25,1996,13.3,21,14,10,10,1,9,15,60.0,6,17,7,10,13,34,10,0,0,2022-2023,90.0,87.96992481203007,142.10526315789474
1592,Andriy Lunin,UKR,GK,Real Madrid,La Liga,23,1999,7.0,0,0,0,0,0,0,0,0.0,0,0,0,0,0,0,1,0,0,2022-2023,90.0,0.0,0.0
1593,Andrey Lunyov,RUS,GK,Leverkusen,Bundesliga,30,1991,1.0,0,0,0,0,0,0,0,0.0,0,0,0,0,0,0,0,0,0,2022-2023,90.0,0.0,0.0
1594,Sebastiano Luperto,ITA,DF,Empoli,Serie A,25,1996,34.8,33,18,24,8,1,9,20,45.0,11,54,42,12,43,76,163,1,0,2022-2023,90.0,111.20689655172414,85.3448275862069
1595,Lyanco,BRA,DF,Southampton,Premier League,25,1997,13.1,24,16,15,9,0,12,18,66.7,6,30,25,5,20,44,65,2,0,2022-2023,90.0,137.40458015267177,164.8854961832061
1596,Charalambos Lykogiannis,GRE,DF,Bologna,Serie A,28,1993,12.3,16,8,5,6,5,5,13,38.5,8,9,4,5,15,31,30,0,0,2022-2023,89.99999999999999,109.75609756097559,117.07317073170731
1597,Youssouf M'Changama,COM,MF,Auxerre,Ligue 1,31,1990,12.0,22,11,7,12,3,7,13,53.8,6,6,0,6,15,37,6,1,0,2022-2023,90.0,112.5,165.0
1598,Awer Mabil,AUS,"MF,FW",Cádiz,La Liga,26,1995,1.8,2,0,0,1,1,1,3,33.3,2,1,1,0,0,2,1,0,0,2022-2023,90.0,0.0,100.0
1599,Alexis Mac Allister,ARG,MF,Brighton,Premier League,23,1998,32.1,70,39,22,40,8,34,71,47.9,37,26,2,24,22,92,10,1,0,2022-2023,90.0,61.6822429906542,196.26168224299064
1600,Deiver Machado,COL,"DF,MF",Lens,Ligue 1,28,1993,24.3,45,26,18,20,7,21,34,61.8,13,21,4,17,21,66,27,0,0,2022-2023,90.0,77.77777777777777,166.66666666666666
Rk,Player,Nation,Pos,Squad,Comp,0,0,90.0,0,0,3,3,3,Tkl,0,0.0,0,0,0,0,0,0,0,0,0,2022-2023,90.0,0.0,0.0
1601,Darwin Machís,VEN,FW,Valladolid,La Liga,29,1993,6.7,3,2,0,2,1,1,8,12.5,7,5,0,5,3,6,4,0,0,2022-2023,90.0,40.298507462686565,40.298507462686565
1602,James Maddison,ENG,"MF,FW",Leicester City,Premier League,25,1996,27.6,51,26,25,19,7,19,50,38.0,31,19,1,18,13,64,6,1,0,2022-2023,90.0,42.391304347826086,166.30434782608694
1603,Noni Madueke,ENG,FW,Chelsea,Premier League,20,2002,7.1,12,8,5,4,3,6,13,46.2,7,13,2,11,4,16,7,0,0,2022-2023,90.0,50.70422535211268,152.11267605633805
1604,Pablo Maffeo,ESP,DF,Mallorca,La Liga,25,1997,33.1,75,46,54,16,5,45,78,57.7,33,38,11,27,26,101,76,0,0,2022-2023,90.0,70.69486404833836,203.92749244712988
1605,Gabriel Magalhães,BRA,DF,Arsenal,Premier League,24,1997,37.9,48,30,29,15,4,18,27,66.7,9,49,26,23,32,80,125,3,0,2022-2023,90.0,75.98944591029024,113.98416886543536
1606,Lisandro Magallán,ARG,DF,Elche,La Liga,28,1993,10.0,19,11,11,5,3,10,12,83.3,2,14,5,9,13,32,30,1,0,2022-2023,90.0,117.0,171.0
1607,Soungoutou Magassa,FRA,MF,Monaco,Ligue 1,18,2003,0.9,4,1,2,2,0,2,4,50.0,2,3,0,3,1,5,1,0,0,2022-2023,90.0,100.0,400.0
1608,Giulio Maggiore,ITA,MF,Salernitana,Serie A,24,1998,9.9,20,8,11,6,3,10,21,47.6,11,19,4,15,8,28,10,0,0,2022-2023,90.0,72.72727272727273,181.8181818181818
1609,Giangiacomo Magnani,ITA,DF,Hellas Verona,Serie A,26,1995,17.0,33,22,20,11,2,19,25,76.0,6,20,15,5,21,54,76,0,0,2022-2023,90.0,111.17647058823529,174.7058823529412
1610,Hugo Magnetti,FRA,MF,Brest,Ligue 1,24,1998,18.8,43,27,18,23,2,23,63,36.5,40,21,1,20,25,68,12,0,0,2022-2023,90.0,119.68085106382978,205.85106382978722
1611,Yohann Magnin,FRA,MF,Clermont Foot,Ligue 1,25,1997,26.7,89,54,37,45,7,54,106,50.9,52,50,12,38,25,114,46,0,0,2022-2023,90.00000000000001,84.26966292134833,300.00000000000006
1612,Harry Maguire,ENG,DF,Manchester Utd,Premier League,29,1993,8.5,8,6,6,1,1,4,5,80.0,1,18,11,7,13,21,41,0,0,2022-2023,90.0,137.64705882352942,84.70588235294117
1613,Jon Magunacelaya,ESP,"MF,FW",Real Sociedad,La Liga,22,2000,0.7,1,0,0,0,1,0,2,0.0,2,0,0,0,0,1,1,0,0,2022-2023,90.0,0.0,128.57142857142858
1614,Riyad Mahrez,ALG,"FW,MF",Manchester City,Premier League,31,1991,21.3,30,14,8,13,9,13,39,33.3,26,27,1,26,9,39,5,0,0,2022-2023,90.0,38.028169014084504,126.7605633802817
1615,Arne Maier,GER,MF,Augsburg,Bundesliga,23,1999,21.8,31,22,17,11,3,10,18,55.6,8,21,0,21,15,46,22,0,0,2022-2023,90.0,61.92660550458715,127.98165137614679
1616,Mike Maignan,FRA,GK,Milan,Serie A,27,1995,22.0,1,0,1,0,0,1,1,100.0,0,0,0,0,1,2,10,1,0,2022-2023,90.0,4.090909090909091,4.090909090909091
1617,Linton Maina,GER,"FW,MF",Köln,Bundesliga,23,1999,24.9,18,12,5,11,2,7,30,23.3,23,19,0,19,5,23,9,0,0,2022-2023,90.0,18.072289156626507,65.06024096385542
1618,Kobbie Mainoo,ENG,MF,Manchester Utd,Premier League,17,2005,0.1,0,0,0,0,0,0,0,0.0,0,1,1,0,0,0,0,0,0,2022-2023,90.0,0.0,0.0
1619,Ainsley Maitland-Niles,ENG,"DF,MF",Southampton,Premier League,24,1997,15.6,45,24,23,18,4,28,44,63.6,16,28,7,21,22,67,45,1,0,2022-2023,90.0,126.92307692307692,259.6153846153846
1620,Jordan Majchrzak,POL,FW,Roma,Serie A,17,2004,0.2,0,0,0,0,0,0,0,0.0,0,0,0,0,0,0,0,0,0,2022-2023,90.0,0.0,0.0
1621,Lovro Majer,CRO,"MF,FW",Rennes,Ligue 1,24,1998,18.5,34,23,16,13,5,8,29,27.6,21,21,1,20,21,55,5,1,0,2022-2023,90.0,102.16216216216216,165.40540540540542
1622,Jean-Victor Makengo,FRA,MF,Udinese,Serie A,24,1998,8.9,16,13,7,7,2,5,9,55.6,4,8,2,6,9,25,3,0,0,2022-2023,90.0,91.01123595505618,161.79775280898878
1623,Jean-Victor Makengo,FRA,MF,Lorient,Ligue 1,24,1998,11.8,16,8,5,10,1,6,20,30.0,14,8,5,3,10,26,13,1,0,2022-2023,90.0,76.27118644067797,122.03389830508473
1624,Béni Makouana,CGO,"FW,MF",Montpellier,Ligue 1,19,2002,2.2,1,0,0,1,0,0,2,0.0,2,3,1,2,0,1,1,0,0,2022-2023,90.0,0.0,40.90909090909091
1625,Nemanja Maksimović,SRB,MF,Getafe,La Liga,27,1995,22.8,41,30,17,18,6,19,32,59.4,13,36,14,22,34,75,27,0,0,2022-2023,90.0,134.21052631578945,161.8421052631579
Rk,Player,Nation,Pos,Squad,Comp,0,0,90.0,0,0,3,3,3,Tkl,0,0.0,0,0,0,0,0,0,0,0,0,2022-2023,90.0,0.0,0.0
1626,Tyrell Malacia,NED,DF,Manchester Utd,Premier League,22,1999,15.5,46,33,33,12,1,14,25,56.0,11,13,3,10,25,71,49,0,0,2022-2023,90.0,145.16129032258064,267.0967741935484
1627,Lorenzo Malagrida,ITA,"MF,DF",Sampdoria,Serie A,18,2003,1.2,1,0,0,0,1,1,3,33.3,2,1,0,1,0,1,1,0,0,2022-2023,90.0,0.0,75.0
1628,Daniel Maldini,ITA,"FW,MF",Spezia,Serie A,20,2001,7.0,12,5,3,4,5,4,11,36.4,7,9,0,9,1,13,8,0,0,2022-2023,90.0,12.857142857142858,154.28571428571428
1629,Youssef Maleh,MAR,MF,Fiorentina,Serie A,23,1998,3.3,3,1,0,3,0,0,4,0.0,4,5,0,5,1,4,3,0,0,2022-2023,90.0,27.272727272727273,81.81818181818181
1630,Youssef Maleh,MAR,MF,Lecce,Serie A,23,1998,7.5,17,8,3,7,7,6,14,42.9,8,20,1,19,5,22,10,0,0,2022-2023,90.0,60.0,204.0
1631,Donyell Malen,NED,FW,Dortmund,Bundesliga,23,1999,19.0,13,5,3,4,6,5,12,41.7,7,14,1,13,4,17,11,0,0,2022-2023,90.0,18.94736842105263,61.578947368421055
1632,Ruslan Malinovskyi,UKR,"MF,FW",Atalanta,Serie A,29,1993,6.1,14,8,5,6,3,6,17,35.3,11,8,1,7,5,19,2,0,0,2022-2023,90.0,73.7704918032787,206.55737704918036
1633,Ruslan Malinovskyi,UKR,"MF,FW",Marseille,Ligue 1,29,1993,13.6,21,11,3,12,6,10,26,38.5,16,13,1,12,3,24,9,0,0,2022-2023,90.0,19.852941176470587,138.97058823529412
1634,Hugo Mallo,ESP,DF,Celta Vigo,La Liga,31,1991,24.0,53,29,34,14,5,28,42,66.7,14,28,7,21,24,77,73,0,0,2022-2023,90.0,90.0,198.75
1635,Mickael Malsa,MTQ,MF,Valladolid,La Liga,26,1995,0.8,2,2,1,1,0,1,4,25.0,3,1,1,0,2,4,3,0,0,2022-2023,90.0,225.0,225.0
1636,Giorgi Mamardashvili,GEO,GK,Valencia,La Liga,21,2000,38.0,0,0,0,0,0,0,0,0.0,0,0,0,0,1,1,11,4,0,2022-2023,90.0,2.3684210526315788,0.0
1637,Hianga Mananga Mbock,FRA,MF,Brest,Ligue 1,22,1999,0.2,0,0,0,0,0,0,1,0.0,1,0,0,0,0,0,0,0,0,2022-2023,90.0,0.0,0.0
1638,Gianluca Mancini,ITA,DF,Roma,Serie A,26,1996,31.8,37,19,27,9,1,18,34,52.9,16,38,17,21,46,83,67,0,0,2022-2023,90.0,130.18867924528303,104.71698113207547
1639,Steve Mandanda,FRA,GK,Rennes,Ligue 1,37,1985,33.5,0,0,0,0,0,0,2,0.0,2,0,0,0,0,0,9,3,0,2022-2023,90.0,0.0,0.0
1640,Reinildo Mandava,MOZ,DF,Atlético Madrid,La Liga,28,1994,20.6,66,43,46,19,1,38,49,77.6,11,27,12,15,30,96,59,0,0,2022-2023,90.0,131.06796116504853,288.34951456310677
1641,Aïssa Mandi,ALG,DF,Villarreal,La Liga,30,1991,16.2,18,10,14,3,1,6,12,50.0,6,19,14,5,21,39,58,0,0,2022-2023,90.0,116.66666666666667,100.0
1642,Rolando Mandragora,ITA,MF,Fiorentina,Serie A,25,1997,21.7,42,24,12,22,8,23,52,44.2,29,25,3,22,16,58,21,0,0,2022-2023,90.0,66.3594470046083,174.19354838709677
1643,Sadio Mané,SEN,"FW,MF",Bayern Munich,Bundesliga,30,1992,15.8,11,5,3,3,5,1,9,11.1,8,15,2,13,0,11,4,0,0,2022-2023,90.0,0.0,62.658227848101255
1644,Orel Mangala,BEL,MF,Nott'ham Forest,Premier League,24,1998,17.2,28,20,16,10,2,12,29,41.4,17,21,7,14,23,51,15,0,0,2022-2023,90.0,120.34883720930233,146.51162790697677
1645,Thomas Mangani,FRA,MF,Ajaccio,Ligue 1,35,1987,14.8,32,17,14,15,3,18,47,38.3,29,22,3,19,24,56,22,1,0,2022-2023,90.0,145.94594594594594,194.59459459459458
1646,Vito Mannone,ITA,GK,Lorient,Ligue 1,34,1988,17.9,0,0,0,0,0,0,0,0.0,0,0,0,0,0,0,4,3,0,2022-2023,90.0,0.0,0.0
1647,Javier Manquillo,ESP,DF,Newcastle Utd,Premier League,28,1994,0.4,3,2,2,1,0,2,2,100.0,0,1,0,1,1,4,1,0,0,2022-2023,90.0,225.0,675.0
1648,Myziane Maolida,COM,"MF,FW",Reims,Ligue 1,23,1999,2.6,8,3,2,5,1,5,12,41.7,7,1,0,1,2,10,0,0,0,2022-2023,90.0,69.23076923076923,276.9230769230769
1649,Myziane Maolida,COM,"FW,MF",Hertha BSC,Bundesliga,23,1999,1.1,1,1,1,0,0,1,2,50.0,1,0,0,0,0,1,1,0,0,2022-2023,90.0,0.0,81.81818181818181
1650,Faitout Maouassa,FRA,"FW,DF",Montpellier,Ligue 1,24,1998,21.4,52,32,26,20,6,18,41,43.9,23,31,3,28,20,72,23,0,0,2022-2023,90.0,84.11214953271029,218.69158878504675
Rk,Player,Nation,Pos,Squad,Comp,0,0,90.0,0,0,3,3,3,Tkl,0,0.0,0,0,0,0,0,0,0,0,0,2022-2023,90.0,0.0,0.0
1651,Sekou Mara,FRA,"FW,MF",Southampton,Premier League,20,2002,6.2,14,10,5,8,1,3,9,33.3,6,11,0,11,1,15,5,0,0,2022-2023,90.0,14.516129032258064,203.2258064516129
1652,Marcão,BRA,DF,Sevilla,La Liga,26,1996,4.2,2,2,1,1,0,1,1,100.0,0,3,3,0,6,8,14,0,0,2022-2023,90.0,128.57142857142856,42.857142857142854
1653,Solly March,ENG,"FW,DF",Brighton,Premier League,28,1994,30.2,53,31,16,17,20,8,28,28.6,20,34,3,31,24,77,32,0,0,2022-2023,90.0,71.52317880794702,157.94701986754967
1654,Agustín Marchesín,ARG,GK,Celta Vigo,La Liga,34,1988,19.0,0,0,0,0,0,0,1,0.0,1,0,0,0,0,0,7,0,0,2022-2023,90.0,0.0,0.0
1655,Federico Marchetti,ITA,GK,Spezia,Serie A,39,1983,0.7,0,0,0,0,0,0,0,0.0,0,0,0,0,0,0,0,0,0,2022-2023,90.0,0.0,0.0
1656,Vincent Marchetti,FRA,MF,Ajaccio,Ligue 1,25,1997,27.2,55,26,29,19,7,25,68,36.8,43,23,3,20,19,74,31,0,0,2022-2023,90.0,62.86764705882353,181.98529411764704
1657,Riccardo Marchizza,ITA,DF,Sassuolo,Serie A,24,1998,3.1,2,2,1,1,0,2,4,50.0,2,2,0,2,2,4,8,0,0,2022-2023,90.0,58.064516129032256,58.064516129032256
1658,Gian Marco Ferrari,ITA,DF,Sassuolo,Serie A,30,1992,24.7,23,16,11,10,2,10,17,58.8,7,29,20,9,23,46,81,4,0,2022-2023,90.0,83.80566801619433,83.80566801619433
1659,Emiliano Marcondes,DEN,MF,Bournemouth,Premier League,27,1995,0.1,0,0,0,0,0,0,0,0.0,0,0,0,0,0,0,1,0,0,2022-2023,90.0,0.0,0.0
1660,Óscar de Marcos,ESP,DF,Athletic Club,La Liga,33,1989,31.3,67,33,34,22,11,40,76,52.6,36,42,6,36,29,96,59,0,0,2022-2023,90.0,83.38658146964856,192.65175718849838
1661,Alberto Marí,ESP,"FW,MF",Valencia,La Liga,21,2001,1.0,0,0,0,0,0,0,2,0.0,2,0,0,0,0,0,1,0,0,2022-2023,90.0,0.0,0.0
1662,José Mari,ESP,MF,Cádiz,La Liga,34,1987,4.4,16,7,12,3,1,10,16,62.5,6,3,1,2,5,21,9,0,0,2022-2023,90.0,102.27272727272727,327.27272727272725
1663,Pablo Marí,ESP,DF,Monza,Serie A,28,1993,27.6,37,19,29,7,1,17,26,65.4,9,22,14,8,31,68,111,3,0,2022-2023,90.0,101.08695652173913,120.65217391304347
1664,José María Giménez,URU,DF,Atlético Madrid,La Liga,27,1995,26.9,43,25,28,14,1,24,35,68.6,11,37,17,20,24,67,138,1,0,2022-2023,90.0,80.29739776951673,143.86617100371748
1665,Mariano,DOM,FW,Real Madrid,La Liga,28,1993,1.7,1,0,0,1,0,0,0,0.0,0,1,0,1,0,1,0,0,0,2022-2023,90.0,0.0,52.94117647058823
1666,Pablo Marín,ESP,"MF,FW",Real Sociedad,La Liga,19,2003,4.0,10,5,5,4,1,2,7,28.6,5,1,0,1,4,14,2,0,0,2022-2023,90.0,90.0,225.0
1667,Răzvan Marin,ROU,MF,Empoli,Serie A,26,1996,28.2,44,22,22,21,1,19,40,47.5,21,29,11,18,14,58,33,0,0,2022-2023,89.99999999999999,44.680851063829785,140.4255319148936
1668,Diego Mariño,ESP,GK,Almería,La Liga,32,1990,0.5,0,0,0,0,0,0,0,0.0,0,0,0,0,0,0,0,0,0,2022-2023,90.0,0.0,0.0
1669,Guillermo Maripán,CHI,DF,Monaco,Ligue 1,28,1994,24.0,46,26,26,20,0,17,33,51.5,16,39,27,12,38,84,87,0,0,2022-2023,90.0,142.5,172.5
1670,Marlon,BRA,DF,Monza,Serie A,26,1995,17.7,35,21,20,14,1,15,29,51.7,14,13,4,9,18,53,50,0,0,2022-2023,90.0,91.52542372881356,177.96610169491527
1671,Omar Marmoush,EGY,FW,Wolfsburg,Bundesliga,23,1999,16.4,16,10,8,2,6,4,16,25.0,12,21,1,20,7,23,4,0,0,2022-2023,90.0,38.41463414634147,87.8048780487805
1672,Marquinhos,BRA,MF,Arsenal,Premier League,19,2003,0.0,0,0,0,0,0,0,0,0.0,0,0,0,0,0,0,0,0,0,2022-2023,,,
1673,Marquinhos,BRA,DF,Paris S-G,Ligue 1,28,1994,30.2,33,25,18,12,3,18,26,69.2,8,43,27,16,23,56,83,2,0,2022-2023,90.0,68.54304635761589,98.34437086092716
1674,Luca Marrone,ITA,DF,Monza,Serie A,32,1990,1.5,0,0,0,0,0,0,2,0.0,2,2,2,0,0,0,4,1,0,2022-2023,90.0,0.0,0.0
1675,Eric Martel,GER,MF,Köln,Bundesliga,20,2002,22.4,66,41,29,30,7,30,60,50.0,30,29,9,20,33,99,49,0,0,2022-2023,90.0,132.58928571428572,265.17857142857144
Rk,Player,Nation,Pos,Squad,Comp,0,0,90.0,0,0,3,3,3,Tkl,0,0.0,0,0,0,0,0,0,0,0,0,2022-2023,90.0,0.0,0.0
1676,Roger Martí,ESP,FW,Elche,La Liga,31,1991,7.3,5,2,3,2,0,1,5,20.0,4,4,0,4,1,6,7,0,0,2022-2023,90.0,12.328767123287673,61.64383561643836
1677,Roger Martí,ESP,FW,Cádiz,La Liga,31,1991,7.1,6,4,2,3,1,1,8,12.5,7,7,0,7,2,8,7,0,0,2022-2023,90.0,25.35211267605634,76.05633802816902
1678,Anthony Martial,FRA,FW,Manchester Utd,Premier League,26,1995,10.9,5,3,0,2,3,1,4,25.0,3,11,2,9,1,6,4,0,0,2022-2023,90.0,8.256880733944953,41.28440366972477
1679,Aarón Martín,ESP,DF,Mainz 05,Bundesliga,25,1997,20.5,42,27,25,11,6,21,40,52.5,19,22,1,21,15,57,31,0,0,2022-2023,90.0,65.85365853658537,184.39024390243904
1680,Ander Martin,ESP,"MF,FW",Real Sociedad,La Liga,21,2000,0.5,2,2,1,1,0,1,4,25.0,3,0,0,0,0,2,1,0,0,2022-2023,90.0,0.0,360.0
1681,Andrés Martín,ESP,"FW,MF",Rayo Vallecano,La Liga,23,1999,2.3,4,2,2,1,1,3,5,60.0,2,2,0,2,1,5,2,0,0,2022-2023,90.0,39.130434782608695,156.52173913043478
1682,Carlos Martín,ESP,"FW,MF",Atlético Madrid,La Liga,20,2002,0.3,2,2,0,2,0,2,3,66.7,1,0,0,0,1,3,0,0,0,2022-2023,90.0,300.0,600.0
1683,Iván Martín,ESP,MF,Girona,La Liga,23,1999,17.6,9,7,4,4,1,8,23,34.8,15,12,0,12,9,18,12,0,0,2022-2023,90.0,46.02272727272727,46.02272727272727
1684,Jonas Martin,FRA,MF,Lille,Ligue 1,32,1990,3.1,9,7,4,5,0,5,14,35.7,9,3,1,2,7,16,3,0,0,2022-2023,90.0,203.2258064516129,261.2903225806452
1685,Gabriel Martinelli,BRA,FW,Arsenal,Premier League,21,2001,31.0,31,18,13,12,6,9,22,40.9,13,24,1,23,9,40,14,0,0,2022-2023,90.0,26.129032258064516,90.0
1686,Arnau Martinez,ESP,DF,Girona,La Liga,19,2003,30.4,69,45,41,19,9,38,85,44.7,47,44,10,34,25,94,54,2,0,2022-2023,90.0,74.01315789473684,204.27631578947367
1687,Emiliano Martínez,ARG,GK,Aston Villa,Premier League,29,1992,34.9,0,0,0,0,0,0,2,0.0,2,0,0,0,1,1,23,1,0,2022-2023,90.0,2.5787965616045847,0.0
1688,Iñigo Martínez,ESP,DF,Athletic Club,La Liga,31,1991,14.9,18,8,11,7,0,6,9,66.7,3,17,11,6,18,36,55,0,0,2022-2023,90.0,108.72483221476509,108.72483221476509
1689,Lautaro Martínez,ARG,FW,Inter,Serie A,24,1997,28.6,25,14,3,15,7,7,23,30.4,16,31,1,30,13,38,16,1,0,2022-2023,90.0,40.909090909090914,78.67132867132867
1690,Lisandro Martínez,ARG,DF,Manchester Utd,Premier League,24,1998,23.5,54,28,33,18,3,30,43,69.8,13,51,27,24,33,87,103,0,0,2022-2023,90.0,126.38297872340425,206.80851063829786
1691,Lucas Martínez Quarta,ARG,DF,Fiorentina,Serie A,26,1996,24.1,80,48,44,32,4,42,61,68.9,19,41,19,22,48,128,78,1,0,2022-2023,90.0,179.253112033195,298.7551867219917
1692,Roger Martínez,ESP,DF,Espanyol,La Liga,18,2004,0.1,0,0,0,0,0,0,0,0.0,0,0,0,0,0,0,0,0,0,2022-2023,90.0,0.0,0.0
1693,Gelson Martins,POR,"MF,FW",Monaco,Ligue 1,27,1995,3.8,15,8,6,4,5,4,13,30.8,9,4,1,3,3,18,2,0,0,2022-2023,90.0,71.05263157894737,355.2631578947368
1694,Adam Marušić,MNE,DF,Lazio,Serie A,29,1992,30.7,41,30,23,14,4,25,39,64.1,14,20,6,14,38,79,63,1,0,2022-2023,90.0,111.40065146579805,120.19543973941369
1695,Omar Mascarell,EQG,"MF,DF",Elche,La Liga,29,1993,27.2,53,26,32,19,2,31,64,48.4,33,51,19,32,45,98,54,1,0,2022-2023,90.0,148.89705882352942,175.36764705882354
1696,Adam Masina,MAR,DF,Udinese,Serie A,28,1994,8.8,10,7,7,3,0,6,15,40.0,9,11,4,7,10,20,28,1,0,2022-2023,90.0,102.27272727272727,102.27272727272727
1697,Jordi Masip,ESP,GK,Valladolid,La Liga,33,1989,27.9,0,0,0,0,0,0,2,0.0,2,0,0,0,1,1,3,2,0,2022-2023,90.0,3.2258064516129035,0.0
1698,Erhan Mašović,SRB,"DF,MF",Bochum,Bundesliga,23,1998,24.2,50,31,28,21,1,30,51,58.8,21,30,14,16,27,77,79,0,0,2022-2023,90.0,100.41322314049586,185.9504132231405
1699,Han-Noah Massengo,FRA,MF,Auxerre,Ligue 1,21,2001,12.4,27,15,10,15,2,7,16,43.8,9,12,3,9,14,41,7,0,0,2022-2023,90.0,101.61290322580645,195.96774193548387
1700,Yanis Massolin,FRA,MF,Clermont Foot,Ligue 1,19,2002,0.7,2,1,1,0,1,0,1,0.0,1,1,0,1,2,4,0,0,0,2022-2023,90.0,257.14285714285717,257.14285714285717
Rk,Player,Nation,Pos,Squad,Comp,0,0,90.0,0,0,3,3,3,Tkl,0,0.0,0,0,0,0,0,0,0,0,0,2022-2023,90.0,0.0,0.0
1701,Jaime Mata,ESP,"FW,MF",Getafe,La Liga,33,1988,4.9,13,10,4,5,4,7,22,31.8,15,7,2,5,3,16,6,0,0,2022-2023,90.0,55.10204081632653,238.77551020408163
1702,Pape Matar Sarr,SEN,"MF,FW",Tottenham,Premier League,19,2002,2.4,7,6,4,2,1,4,8,50.0,4,3,2,1,6,13,6,0,0,2022-2023,90.0,225.00000000000003,262.5
1703,Eliot Matazo,BEL,MF,Monaco,Ligue 1,20,2002,13.1,26,12,11,13,2,11,26,42.3,15,18,4,14,15,41,11,1,0,2022-2023,90.0,103.05343511450383,178.6259541984733
1704,Jean-Philippe Mateta,FRA,FW,Crystal Palace,Premier League,25,1997,8.6,7,1,2,4,1,1,3,33.3,2,3,1,2,3,10,18,0,0,2022-2023,90.0,31.395348837209305,73.25581395348838
1705,Nemanja Matić,SRB,MF,Roma,Serie A,33,1988,20.6,47,27,24,19,4,19,33,57.6,14,27,7,20,25,72,21,1,0,2022-2023,90.0,109.22330097087378,205.3398058252427
1706,Joël Matip,CMR,DF,Liverpool,Premier League,30,1991,12.1,14,8,12,2,0,11,23,47.8,12,8,3,5,21,35,45,3,0,2022-2023,90.0,156.198347107438,104.13223140495867
1707,Henning Matriciani,GER,DF,Schalke 04,Bundesliga,22,2000,20.7,43,23,28,12,3,26,60,43.3,34,28,11,17,23,66,57,1,0,2022-2023,90.0,100.00000000000001,186.95652173913044
1708,Chrislain Matsima,FRA,"DF,MF",Lorient,Ligue 1,20,2002,2.5,0,0,0,0,0,0,0,0.0,0,3,3,0,2,2,7,0,0,2022-2023,90.0,72.0,0.0
1709,Chrislain Matsima,FRA,DF,Monaco,Ligue 1,20,2002,5.0,11,6,7,2,2,4,7,57.1,3,5,5,0,9,20,16,0,0,2022-2023,90.0,162.0,198.0
1710,Jean Mattéo Bahoya,FRA,"FW,MF",Angers,Ligue 1,17,2005,3.0,7,3,1,3,3,4,7,57.1,3,4,0,4,0,7,0,0,0,2022-2023,90.0,0.0,210.0
1711,Azor Matusiwa,NED,MF,Reims,Ligue 1,24,1998,27.6,66,41,30,29,7,36,61,59.0,25,37,11,26,46,112,52,0,0,2022-2023,90.0,149.99999999999997,215.2173913043478
1712,Neal Maupay,FRA,FW,Everton,Premier League,25,1996,12.4,11,5,3,4,4,2,4,50.0,2,8,0,8,5,16,0,0,0,2022-2023,90.0,36.29032258064516,79.83870967741936
1713,Aïman Maurer,MAR,MF,Clermont Foot,Ligue 1,17,2004,5.6,2,1,1,1,0,1,10,10.0,9,1,0,1,3,5,5,0,0,2022-2023,90.0,48.214285714285715,32.142857142857146
1714,Stephy Mavididi,ENG,FW,Montpellier,Ligue 1,24,1998,14.3,24,19,12,8,4,13,27,48.1,14,21,1,20,4,28,10,0,0,2022-2023,90.0,25.174825174825177,151.04895104895104
1715,Konstantinos Mavropanos,GRE,DF,Stuttgart,Bundesliga,24,1997,25.4,50,27,32,15,3,28,38,73.7,10,39,18,21,63,113,99,0,0,2022-2023,90.0,223.22834645669292,177.16535433070868
1716,Christian Mawissa,FRA,DF,Toulouse,Ligue 1,17,2005,1.1,2,0,1,1,0,1,3,33.3,2,0,0,0,3,5,1,0,0,2022-2023,90.0,245.45454545454544,163.63636363636363
1717,Philipp Max,GER,DF,Eint Frankfurt,Bundesliga,28,1993,7.7,12,9,4,7,1,5,16,31.3,11,10,2,8,3,15,11,0,0,2022-2023,90.0,35.064935064935064,140.25974025974025
1718,Eric Maxim Choupo-Moting,CMR,FW,Bayern Munich,Bundesliga,33,1989,12.4,10,7,2,6,2,1,2,50.0,1,8,0,8,0,10,5,0,0,2022-2023,90.0,0.0,72.58064516129032
1719,Luís Maximiano,POR,GK,Lazio,Serie A,23,1999,0.1,0,0,0,0,0,0,0,0.0,0,0,0,0,0,0,0,0,0,2022-2023,90.0,0.0,0.0
1720,Keke Maximilian Topp,GER,FW,Schalke 04,Bundesliga,18,2004,0.2,0,0,0,0,0,0,0,0.0,0,0,0,0,1,1,0,0,0,2022-2023,90.0,450.0,0.0
1721,Fernand Mayembo,CGO,DF,Ajaccio,Ligue 1,26,1996,7.9,8,5,6,2,0,4,9,44.4,5,2,0,2,11,19,36,0,0,2022-2023,90.0,125.31645569620251,91.1392405063291
1722,Borja Mayoral,ESP,FW,Getafe,La Liga,25,1997,30.7,9,4,7,2,0,5,31,16.1,26,18,0,18,3,12,10,0,0,2022-2023,90.0,8.794788273615636,26.38436482084691
1723,Ibrahim Maza,GER,"MF,FW",Hertha BSC,Bundesliga,16,2005,0.8,1,1,1,0,0,0,1,0.0,1,2,0,2,0,1,1,0,0,2022-2023,90.0,0.0,112.5
1724,Derek Mazou-Sacko,FRA,MF,Troyes,Ligue 1,17,2004,0.2,0,0,0,0,0,0,1,0.0,1,1,0,1,1,1,1,0,0,2022-2023,90.0,450.0,0.0
1725,Noussair Mazraoui,MAR,DF,Bayern Munich,Bundesliga,24,1997,11.9,29,21,9,9,11,15,24,62.5,9,13,2,11,10,39,25,0,0,2022-2023,90.00000000000001,75.63025210084034,219.32773109243698
Rk,Player,Nation,Pos,Squad,Comp,0,0,90.0,0,0,3,3,3,Tkl,0,0.0,0,0,0,0,0,0,0,0,0,2022-2023,90.0,0.0,0.0
1726,Pasquale Mazzocchi,ITA,DF,Salernitana,Serie A,27,1995,21.8,32,18,21,5,6,17,37,45.9,20,10,2,8,10,42,37,2,0,2022-2023,90.0,41.28440366972477,132.11009174311926
1727,Kevin Mbabu,SUI,"DF,FW",Fulham,Premier League,27,1995,1.6,3,2,2,1,0,1,3,33.3,2,2,0,2,3,6,3,0,0,2022-2023,90.0,168.75,168.75
1728,Noah Mbamba,BEL,MF,Leverkusen,Bundesliga,17,2005,0.0,0,0,0,0,0,0,0,0.0,0,0,0,0,0,0,0,0,0,2022-2023,,,
1729,Kylian Mbappé,FRA,FW,Paris S-G,Ligue 1,23,1998,31.3,10,4,0,5,5,5,16,31.3,11,5,0,5,5,15,6,0,0,2022-2023,90.0,14.37699680511182,28.75399361022364
1730,Mamadou Mbaye,SEN,DF,Cádiz,La Liga,24,1998,8.4,10,7,7,3,0,6,8,75.0,2,10,8,2,7,17,50,1,0,2022-2023,90.0,75.0,107.14285714285714
1731,Chancel Mbemba,COD,DF,Marseille,Ligue 1,27,1994,31.7,43,26,24,17,2,22,31,71.0,9,25,12,13,42,85,89,0,0,2022-2023,90.0,119.2429022082019,122.08201892744479
1732,Bryan Mbeumo,CMR,FW,Brentford,Premier League,22,1999,32.3,26,18,5,13,8,8,42,19.0,34,24,1,23,13,39,21,0,0,2022-2023,90.0,36.22291021671827,72.44582043343654
1733,Jason Mbock,FRA,"MF,FW",Angers,Ligue 1,22,1999,0.3,0,0,0,0,0,0,0,0.0,0,0,0,0,0,0,0,0,0,2022-2023,90.0,0.0,0.0
1734,Jean-Manuel Mbom,GER,MF,Werder Bremen,Bundesliga,22,2000,0.1,0,0,0,0,0,0,1,0.0,1,0,0,0,0,0,0,0,0,2022-2023,90.0,0.0,0.0
1735,Nathanael Mbuku,FRA,"FW,MF",Reims,Ligue 1,20,2002,0.7,2,1,2,0,0,2,2,100.0,0,0,0,0,0,2,0,0,0,2022-2023,90.0,0.0,257.14285714285717
1736,Nathanael Mbuku,FRA,"MF,FW",Augsburg,Bundesliga,20,2002,0.4,1,0,0,1,0,0,0,0.0,0,0,0,0,0,1,0,0,0,2022-2023,90.0,0.0,225.0
1737,James McArthur,SCO,MF,Crystal Palace,Premier League,34,1987,0.6,1,1,1,0,0,1,1,100.0,0,2,1,1,1,2,2,0,0,2022-2023,90.0,150.0,150.0
1738,Alex McCarthy,ENG,GK,Southampton,Premier League,32,1989,6.0,0,0,0,0,0,0,1,0.0,1,0,0,0,1,1,3,1,0,2022-2023,90.0,15.0,0.0
1739,John McGinn,SCO,"MF,FW",Aston Villa,Premier League,27,1994,29.9,66,36,27,29,10,34,71,47.9,37,43,4,39,24,90,19,0,0,2022-2023,90.0,72.24080267558529,198.66220735785956
1740,Scott McKenna,SCO,DF,Nott'ham Forest,Premier League,25,1996,17.5,12,7,7,3,2,6,10,60.0,4,20,14,6,12,24,85,1,0,2022-2023,90.0,61.714285714285715,61.714285714285715
1741,Weston McKennie,USA,MF,Leeds United,Premier League,23,1998,16.0,30,13,5,18,7,10,29,34.5,19,22,3,19,22,52,26,0,0,2022-2023,90.0,123.75,168.75
1742,Weston McKennie,USA,"MF,DF",Juventus,Serie A,23,1998,11.7,14,5,3,9,2,5,8,62.5,3,15,4,11,11,25,15,1,0,2022-2023,89.99999999999999,84.61538461538461,107.6923076923077
1743,Dwight McNeil,ENG,"FW,MF",Everton,Premier League,22,1999,27.8,64,41,35,14,15,27,65,41.5,38,46,7,39,31,95,41,0,0,2022-2023,90.0,100.35971223021583,207.19424460431657
1744,Scott McTominay,SCO,MF,Manchester Utd,Premier League,25,1996,12.9,32,19,16,10,6,13,22,59.1,9,15,6,9,14,46,45,1,0,2022-2023,90.0,97.67441860465115,223.25581395348837
1745,Gary Medel,CHI,"MF,DF",Bologna,Serie A,34,1987,16.4,25,15,16,7,2,9,16,56.3,7,17,10,7,28,53,34,0,0,2022-2023,90.0,153.65853658536588,137.19512195121953
1746,Facundo Medina,ARG,DF,Lens,Ligue 1,23,1999,30.9,31,20,16,15,0,13,35,37.1,22,25,9,16,26,57,62,1,0,2022-2023,90.0,75.72815533980582,90.29126213592234
1747,Fernando Medrano,ESP,DF,Celta Vigo,La Liga,22,2000,0.1,2,1,2,0,0,1,1,100.0,0,0,0,0,1,3,1,0,0,2022-2023,90.0,900.0,1800.0
1748,Ben Mee,ENG,DF,Brentford,Premier League,32,1989,36.3,45,24,28,13,4,20,37,54.1,17,54,42,12,48,93,122,2,0,2022-2023,90.0,119.00826446280992,111.5702479338843
1749,Bamo Meïté,CIV,DF,Lorient,Ligue 1,20,2001,16.7,18,8,13,4,1,7,16,43.8,9,33,23,10,16,34,70,0,0,2022-2023,90.0,86.22754491017965,97.0059880239521
1750,Soualiho Meïté,FRA,MF,Cremonese,Serie A,28,1994,26.3,47,31,25,15,7,22,46,47.8,24,27,6,21,27,74,36,0,0,2022-2023,90.0,92.39543726235742,160.83650190114068
Rk,Player,Nation,Pos,Squad,Comp,0,0,90.0,0,0,3,3,3,Tkl,0,0.0,0,0,0,0,0,0,0,0,0,2022-2023,90.0,0.0,0.0
1751,Farid El Melali,ALG,"DF,FW",Angers,Ligue 1,25,1997,9.0,21,12,7,12,2,11,22,50.0,11,16,0,16,8,29,7,0,0,2022-2023,90.0,80.0,210.0
1752,Gonzalo Melero,ESP,MF,Almería,La Liga,28,1994,20.6,32,16,9,18,5,11,39,28.2,28,23,2,21,7,39,19,1,0,2022-2023,90.0,30.582524271844658,139.80582524271844
1753,Birger Meling,NOR,DF,Rennes,Ligue 1,27,1994,13.4,24,15,9,12,3,12,25,48.0,13,18,2,16,23,47,26,0,0,2022-2023,90.0,154.4776119402985,161.19402985074626
1754,Memphis,NED,FW,Atlético Madrid,La Liga,28,1994,3.0,1,0,0,0,1,0,1,0.0,1,0,0,0,0,1,0,0,0,2022-2023,90.0,0.0,30.0
1755,Memphis,NED,FW,Barcelona,La Liga,28,1994,1.3,1,1,1,0,0,0,1,0.0,1,0,0,0,0,1,0,0,0,2022-2023,90.0,0.0,69.23076923076923
1756,Houboulang Mendes,GNB,DF,Almería,La Liga,24,1998,9.8,19,11,16,3,0,11,27,40.7,16,12,2,10,7,26,23,1,0,2022-2023,90.0,64.28571428571428,174.48979591836735
1757,Nuno Mendes,POR,DF,Paris S-G,Ligue 1,20,2002,17.2,45,30,29,12,4,30,41,73.2,11,19,3,16,17,62,18,0,0,2022-2023,90.0,88.95348837209303,235.4651162790698
1758,Pedro Mendes,POR,DF,Montpellier,Ligue 1,31,1990,0.1,0,0,0,0,0,0,0,0.0,0,0,0,0,0,0,0,1,0,2022-2023,90.0,0.0,0.0
1759,Thiago Mendes,BRA,"MF,DF",Lyon,Ligue 1,30,1992,22.9,48,27,24,21,3,30,40,75.0,10,28,8,20,47,95,51,4,0,2022-2023,90.0,184.7161572052402,188.646288209607
1760,Brais Méndez,ESP,MF,Real Sociedad,La Liga,25,1997,26.7,58,34,18,30,10,24,64,37.5,40,27,3,24,12,70,14,1,0,2022-2023,90.00000000000001,40.449438202247194,195.50561797752812
1761,Diego Méndez,ESP,MF,Rayo Vallecano,La Liga,18,2003,0.0,0,0,0,0,0,0,0,0.0,0,0,0,0,1,1,0,0,0,2022-2023,,inf,
1762,Antoine Mendy,FRA,DF,Nice,Ligue 1,18,2004,5.8,22,13,16,5,1,9,15,60.0,6,6,1,5,2,24,16,0,0,2022-2023,90.0,31.03448275862069,341.3793103448276
1763,Arial Mendy,SEN,DF,Clermont Foot,Ligue 1,27,1994,2.5,4,2,3,0,1,2,2,100.0,0,2,0,2,4,8,4,0,0,2022-2023,90.0,144.0,144.0
1764,Batista Mendy,FRA,"MF,DF",Angers,Ligue 1,22,2000,31.8,70,30,34,28,8,37,53,69.8,16,38,6,32,21,91,29,2,0,2022-2023,90.0,59.43396226415094,198.11320754716982
1765,Edouard Mendy,SEN,GK,Chelsea,Premier League,30,1992,9.5,0,0,0,0,0,0,0,0.0,0,0,0,0,0,0,3,3,0,2022-2023,90.0,0.0,0.0
1766,Ferland Mendy,FRA,DF,Real Madrid,La Liga,27,1995,15.0,21,12,14,6,1,12,20,60.0,8,7,2,5,14,35,16,0,0,2022-2023,90.0,84.0,126.0
1767,Nampalys Mendy,SEN,MF,Leicester City,Premier League,30,1992,8.4,13,9,7,6,0,8,15,53.3,7,20,4,16,13,26,2,0,0,2022-2023,90.0,139.28571428571428,139.28571428571428
1768,Gideon Mensah,GHA,DF,Auxerre,Ligue 1,24,1998,25.1,80,44,43,32,5,44,77,57.1,33,33,10,23,38,118,41,0,0,2022-2023,90.0,136.25498007968127,286.85258964143424
1769,Chris Mepham,WAL,DF,Bournemouth,Premier League,24,1997,24.4,45,22,37,8,0,19,30,63.3,11,40,27,13,30,75,152,0,0,2022-2023,90.0,110.65573770491804,165.98360655737707
1770,Jorge Meré,ESP,DF,Cádiz,La Liga,25,1997,6.7,11,7,9,2,0,5,8,62.5,3,9,6,3,6,17,32,0,0,2022-2023,90.0,80.59701492537313,147.76119402985074
1771,Alex Meret,ITA,GK,Napoli,Serie A,25,1997,34.0,0,0,0,0,0,0,0,0.0,0,0,0,0,0,0,6,1,0,2022-2023,90.0,0.0,0.0
1772,Mikel Merino,ESP,MF,Real Sociedad,La Liga,26,1996,27.7,77,49,28,33,16,31,62,50.0,31,38,8,30,20,97,51,1,0,2022-2023,90.0,64.98194945848375,250.18050541516246
1773,Quentin Merlin,FRA,DF,Nantes,Ligue 1,20,2002,19.9,31,19,19,8,4,18,38,47.4,20,27,4,23,24,55,30,0,0,2022-2023,90.0,108.5427135678392,140.20100502512565
1774,Yıldırım Mert Çetin,TUR,DF,Lecce,Serie A,25,1997,0.2,1,0,1,0,0,0,0,0.0,0,0,0,0,1,2,1,0,0,2022-2023,90.0,450.0,450.0
1775,Roque Mesa,ESP,MF,Valladolid,La Liga,33,1989,18.0,27,15,16,10,1,12,38,31.6,26,16,4,12,13,40,18,0,0,2022-2023,90.0,65.0,135.0
Rk,Player,Nation,Pos,Squad,Comp,0,0,90.0,0,0,3,3,3,Tkl,0,0.0,0,0,0,0,0,0,0,0,0,2022-2023,90.0,0.0,0.0
1776,Illan Meslier,FRA,GK,Leeds United,Premier League,22,2000,34.0,2,1,2,0,0,2,4,50.0,2,0,0,0,1,3,30,3,0,2022-2023,90.0,2.6470588235294117,5.294117647058823
1777,Lionel Messi,ARG,"FW,MF",Paris S-G,Ligue 1,35,1987,31.5,26,18,1,13,12,11,27,40.7,16,11,0,11,2,28,0,0,0,2022-2023,90.0,5.714285714285714,74.28571428571429
1778,Junior Messias,BRA,"FW,DF",Milan,Serie A,31,1991,16.6,24,18,9,9,6,5,19,26.3,14,20,4,16,7,31,28,0,0,2022-2023,90.0,37.951807228915655,130.12048192771084
1779,Amine Messoussa,FRA,FW,Lille,Ligue 1,17,2004,0.0,0,0,0,0,0,0,0,0.0,0,0,0,0,0,0,0,0,0,2022-2023,,,
1780,Thomas Meunier,BEL,DF,Dortmund,Bundesliga,30,1991,6.5,16,7,8,5,3,10,17,58.8,7,7,2,5,9,25,16,0,0,2022-2023,90.00000000000001,124.61538461538463,221.53846153846155
1781,Alexander Meyer,GER,GK,Dortmund,Bundesliga,31,1991,7.0,0,0,0,0,0,0,1,0.0,1,0,0,0,0,0,1,0,0,2022-2023,90.0,0.0,0.0
1782,Sven Michel,GER,"FW,MF",Union Berlin,Bundesliga,32,1990,5.5,9,5,1,5,3,4,8,50.0,4,5,1,4,0,9,4,0,0,2022-2023,90.0,0.0,147.27272727272728
1783,Alex Mighten,ENG,FW,Nott'ham Forest,Premier League,20,2002,0.1,0,0,0,0,0,0,1,0.0,1,0,0,0,0,0,0,0,0,2022-2023,90.0,0.0,0.0
1784,Tommaso Milanese,ITA,MF,Cremonese,Serie A,20,2002,0.3,0,0,0,0,0,0,0,0.0,0,1,1,0,0,0,0,0,0,2022-2023,90.0,0.0,0.0
1785,Nikola Milenković,SRB,DF,Fiorentina,Serie A,24,1997,23.7,40,25,20,17,3,18,27,66.7,9,27,14,13,22,62,72,0,0,2022-2023,90.0,83.54430379746836,151.8987341772152
1786,Lewis Miley,ENG,MF,Newcastle Utd,Premier League,16,2006,0.2,0,0,0,0,0,0,0,0.0,0,1,0,1,0,0,0,0,0,2022-2023,90.0,0.0,0.0
1787,Arkadiusz Milik,POL,FW,Juventus,Serie A,28,1994,17.6,12,8,2,8,2,2,8,25.0,6,10,1,9,1,13,14,0,0,2022-2023,90.0,5.113636363636363,61.36363636363636
1788,Arkadiusz Milik,POL,FW,Marseille,Ligue 1,28,1994,1.4,1,1,0,0,1,0,1,0.0,1,0,0,0,0,1,2,0,0,2022-2023,90.0,0.0,64.28571428571429
1789,Sergej Milinković-Savić,SRB,MF,Lazio,Serie A,27,1995,33.6,58,35,22,23,13,24,67,35.8,43,50,12,38,28,86,49,0,0,2022-2023,90.0,75.0,155.35714285714286
1790,Vanja Milinković-Savić,SRB,GK,Torino,Serie A,25,1997,38.0,2,1,2,0,0,2,2,100.0,0,0,0,0,1,3,19,1,0,2022-2023,90.0,2.3684210526315788,4.7368421052631575
1791,Éder Militão,BRA,DF,Real Madrid,La Liga,24,1998,30.0,46,32,25,18,3,26,33,78.8,7,67,39,28,42,88,104,2,0,2022-2023,90.0,126.0,138.0
1792,Luka Milivojević,SRB,MF,Crystal Palace,Premier League,31,1991,5.7,13,7,7,4,2,7,10,70.0,3,13,4,9,12,25,10,1,0,2022-2023,90.0,189.4736842105263,205.26315789473682
1793,Luis Milla,ESP,MF,Getafe,La Liga,27,1994,20.6,48,30,21,18,9,19,44,43.2,25,13,1,12,32,80,25,1,0,2022-2023,90.0,139.80582524271844,209.70873786407768
1794,Pere Milla,ESP,"FW,MF",Elche,La Liga,29,1992,20.5,31,20,18,8,5,14,41,34.1,27,18,3,15,9,40,19,1,0,2022-2023,90.0,39.51219512195122,136.09756097560975
1795,Enzo Millot,FRA,MF,Stuttgart,Bundesliga,20,2002,9.9,23,16,9,10,4,12,19,63.2,7,20,3,17,12,35,7,0,0,2022-2023,90.0,109.0909090909091,209.0909090909091
1796,James Milner,ENG,"MF,DF",Liverpool,Premier League,36,1986,10.1,26,16,11,11,4,15,34,44.1,19,14,2,12,12,38,15,0,0,2022-2023,90.0,106.93069306930693,231.68316831683168
1797,Marko Milovanović,SRB,FW,Almería,La Liga,18,2003,0.2,0,0,0,0,0,0,0,0.0,0,0,0,0,0,0,0,0,0,2022-2023,90.0,0.0,0.0
1798,Kim Min-jae,KOR,DF,Napoli,Serie A,25,1996,33.9,55,30,32,22,1,25,29,86.2,4,36,26,10,41,96,123,1,0,2022-2023,90.0,108.8495575221239,146.01769911504425
1799,Yerry Mina,COL,DF,Everton,Premier League,27,1994,6.6,15,8,9,6,0,9,11,81.8,2,7,4,3,6,21,28,0,0,2022-2023,90.0,81.81818181818181,204.54545454545453
1800,Takumi Minamino,JPN,"MF,FW",Monaco,Ligue 1,27,1995,8.0,15,8,5,7,3,7,35,20.0,28,14,0,14,6,21,4,0,0,2022-2023,90.0,67.5,168.75
Rk,Player,Nation,Pos,Squad,Comp,0,0,90.0,0,0,3,3,3,Tkl,0,0.0,0,0,0,0,0,0,0,0,0,2022-2023,90.0,0.0,0.0
1801,Tyrone Mings,ENG,DF,Aston Villa,Premier League,29,1993,35.0,15,7,10,5,0,9,20,45.0,11,40,21,19,54,69,163,2,0,2022-2023,90.0,138.85714285714286,38.57142857142857
1802,Óscar Mingueza,ESP,DF,Celta Vigo,La Liga,23,1999,14.3,37,21,27,9,1,25,32,78.1,7,10,4,6,12,49,25,0,0,2022-2023,90.0,75.52447552447552,232.86713286713288
1803,Rafa Mir,ESP,FW,Sevilla,La Liga,25,1997,14.4,8,2,2,4,2,2,5,40.0,3,5,1,4,4,12,11,0,0,2022-2023,90.0,25.0,50.0
1804,Aleksei Miranchuk,RUS,MF,Torino,Serie A,26,1995,23.2,11,5,3,4,4,3,11,27.3,8,11,0,11,2,13,5,0,0,2022-2023,90.0,7.758620689655173,42.67241379310345
1805,Juan Miranda,ESP,DF,Betis,La Liga,22,2000,16.4,23,16,16,6,1,14,29,48.3,15,20,7,13,20,43,63,0,0,2022-2023,90.0,109.75609756097562,126.21951219512196
1806,Antonio Mirante,ITA,GK,Milan,Serie A,39,1983,0.0,0,0,0,0,0,0,0,0.0,0,0,0,0,0,0,0,0,0,2022-2023,,,
1807,Fabio Miretti,ITA,"MF,FW",Juventus,Serie A,18,2003,13.7,24,11,15,6,3,12,29,41.4,17,20,1,19,4,28,11,0,0,2022-2023,90.0,26.277372262773724,157.66423357664235
1808,Filippo Missori,ITA,DF,Roma,Serie A,18,2004,2.0,4,3,3,0,1,3,6,50.0,3,0,0,0,3,7,5,0,0,2022-2023,90.0,135.0,180.0
1809,Tyrick Mitchell,ENG,DF,Crystal Palace,Premier League,22,1999,32.1,71,49,43,23,5,30,53,56.6,23,48,11,37,42,113,78,0,0,2022-2023,90.0,117.75700934579439,199.06542056074764
1810,Kaoru Mitoma,JPN,"FW,MF",Brighton,Premier League,25,1997,25.8,44,27,15,16,13,20,41,48.8,21,25,0,25,17,61,10,0,0,2022-2023,90.0,59.302325581395344,153.48837209302326
1811,Aleksandar Mitrović,SRB,FW,Fulham,Premier League,27,1994,22.3,14,7,8,4,2,5,12,41.7,7,22,5,17,3,17,20,1,0,2022-2023,90.0,12.107623318385649,56.502242152466366
1812,Stefan Mitrović,SRB,DF,Getafe,La Liga,32,1990,18.7,14,6,12,2,0,7,11,63.6,4,12,10,2,17,31,90,2,0,2022-2023,90.0,81.81818181818181,67.37967914438502
1813,Maximilian Mittelstädt,GER,"DF,MF",Hertha BSC,Bundesliga,25,1997,9.4,39,20,31,6,2,17,39,43.6,22,13,2,11,26,65,27,0,0,2022-2023,90.0,248.93617021276594,373.4042553191489
1814,Henrikh Mkhitaryan,ARM,MF,Inter,Serie A,33,1989,22.1,41,26,13,22,6,14,41,34.1,27,27,4,23,21,62,18,0,0,2022-2023,90.0,85.52036199095022,166.9683257918552
1815,Anthony Modeste,FRA,FW,Dortmund,Bundesliga,34,1988,9.0,4,4,2,0,2,2,5,40.0,3,7,0,7,2,6,22,0,0,2022-2023,90.0,20.0,40.0
1816,Luka Modrić,CRO,MF,Real Madrid,La Liga,36,1985,19.4,19,9,6,6,7,10,25,40.0,15,15,5,10,10,29,7,0,0,2022-2023,90.0,46.39175257731959,88.14432989690722
1817,Terem Moffi,NGA,FW,Nice,Ligue 1,23,1999,14.8,12,6,0,6,6,2,12,16.7,10,3,0,3,2,14,5,0,0,2022-2023,90.0,12.162162162162161,72.97297297297297
1818,Terem Moffi,NGA,FW,Lorient,Ligue 1,23,1999,15.4,8,5,1,4,3,3,5,60.0,2,11,3,8,3,11,10,0,0,2022-2023,90.0,17.532467532467532,46.753246753246756
1819,Mostafa Mohamed,EGY,FW,Nantes,Ligue 1,24,1997,21.5,18,13,5,7,6,9,20,45.0,11,23,1,22,10,28,33,0,0,2022-2023,90.0,41.860465116279066,75.34883720930232
1820,Tobias Mohr,GER,"DF,MF",Schalke 04,Bundesliga,26,1995,9.3,8,5,3,5,0,2,7,28.6,5,14,5,9,8,16,19,0,0,2022-2023,90.0,77.41935483870967,77.41935483870967
1821,Johan Mojica,COL,DF,Villarreal,La Liga,29,1992,7.1,13,9,9,3,1,5,9,55.6,4,8,3,5,4,17,14,1,0,2022-2023,90.0,50.70422535211268,164.7887323943662
1822,Johan Mojica,COL,"DF,MF",Elche,La Liga,29,1992,3.0,6,3,5,1,0,2,3,66.7,1,3,2,1,4,10,5,0,0,2022-2023,90.0,120.0,180.0
1823,Clinton Mola,ENG,DF,Stuttgart,Bundesliga,21,2001,0.2,3,1,2,1,0,1,1,100.0,0,1,1,0,1,4,2,0,0,2022-2023,90.0,450.0,1350.0
1824,Nahuel Molina,ARG,DF,Atlético Madrid,La Liga,24,1998,31.9,69,43,38,18,13,39,91,42.9,52,38,7,31,18,87,63,1,0,2022-2023,90.0,50.78369905956113,194.67084639498432
1825,Salvatore Molina,ITA,DF,Monza,Serie A,30,1992,2.5,6,5,2,4,0,4,5,80.0,1,4,2,2,1,7,2,0,0,2022-2023,90.0,36.0,216.0
Rk,Player,Nation,Pos,Squad,Comp,0,0,90.0,0,0,3,3,3,Tkl,0,0.0,0,0,0,0,0,0,0,0,0,2022-2023,90.0,0.0,0.0
1826,Florent Mollet,FRA,MF,Nantes,Ligue 1,30,1991,12.1,14,6,5,4,5,7,24,29.2,17,12,1,11,10,24,11,0,0,2022-2023,90.0,74.3801652892562,104.13223140495867
1827,Florent Mollet,FRA,MF,Schalke 04,Bundesliga,30,1991,4.6,4,1,0,4,0,2,7,28.6,5,7,1,6,1,5,1,0,0,2022-2023,90.0,19.565217391304348,78.26086956521739
1828,Jon Moncayola,ESP,"MF,DF",Osasuna,La Liga,24,1998,27.2,55,39,24,22,9,30,76,39.5,46,37,5,32,17,72,32,2,0,2022-2023,90.0,56.25,181.98529411764704
1829,Monchu,ESP,MF,Valladolid,La Liga,22,1999,22.6,50,29,20,21,9,19,46,41.3,27,28,11,17,18,68,22,1,0,2022-2023,90.0,71.68141592920354,199.1150442477876
1830,César Montes,MEX,DF,Espanyol,La Liga,25,1997,17.7,17,9,10,7,0,10,18,55.6,8,19,12,7,14,31,101,0,0,2022-2023,90.0,71.1864406779661,86.4406779661017
1831,Daniele Montevago,ITA,FW,Sampdoria,Serie A,19,2003,2.6,1,0,0,0,1,0,1,0.0,1,2,1,1,0,1,1,0,0,2022-2023,90.0,0.0,34.61538461538461
1832,Gonzalo Montiel,ARG,DF,Sevilla,La Liga,25,1997,16.9,26,15,12,14,0,15,29,51.7,14,25,7,18,19,45,38,0,0,2022-2023,90.0,101.18343195266273,138.46153846153848
1833,Lorenzo Montipò,ITA,GK,Hellas Verona,Serie A,26,1996,37.0,1,0,1,0,0,0,3,0.0,3,1,0,1,0,1,26,3,0,2022-2023,90.0,0.0,2.4324324324324325
1834,Martín Montoya,ESP,DF,Betis,La Liga,31,1991,5.0,13,8,9,4,0,10,12,83.3,2,6,1,5,9,22,14,1,0,2022-2023,90.0,162.0,234.0
1835,Kieffer Moore,WAL,FW,Bournemouth,Premier League,29,1992,14.2,14,11,2,9,3,5,16,31.3,11,12,5,7,1,15,26,0,0,2022-2023,90.0,6.338028169014085,88.73239436619718
1836,Andrew Moran,IRL,FW,Brighton,Premier League,18,2003,0.1,0,0,0,0,0,0,0,0.0,0,1,0,1,0,0,0,0,0,2022-2023,90.0,0.0,0.0
1837,Álvaro Morata,ESP,FW,Atlético Madrid,La Liga,29,1992,21.1,16,11,4,8,4,3,8,37.5,5,11,3,8,0,16,23,0,0,2022-2023,90.0,0.0,68.24644549763033
1838,Jon Morcillo,ESP,"FW,MF",Athletic Club,La Liga,23,1998,0.8,1,0,1,0,0,0,1,0.0,1,0,0,0,1,2,0,0,0,2022-2023,90.0,112.5,112.5
1839,Alberto Moreno,ESP,DF,Villarreal,La Liga,30,1992,14.4,23,12,10,10,3,11,24,45.8,13,12,1,11,23,46,26,0,0,2022-2023,90.0,143.75,143.75
1840,Álex Moreno,ESP,DF,Aston Villa,Premier League,29,1993,14.8,23,14,15,5,3,13,36,36.1,23,18,3,15,7,30,37,2,0,2022-2023,90.0,42.567567567567565,139.86486486486487
1841,Álex Moreno,ESP,DF,Betis,La Liga,29,1993,15.0,29,22,19,10,0,18,36,50.0,18,17,4,13,17,46,39,0,0,2022-2023,90.0,102.0,174.0
1842,Diego Moreno,ESP,DF,Osasuna,La Liga,21,2001,7.1,4,4,2,2,0,3,8,37.5,5,7,4,3,5,9,21,0,0,2022-2023,90.0,63.38028169014085,50.70422535211268
1843,Gerard Moreno,ESP,FW,Villarreal,La Liga,30,1992,13.7,11,6,0,6,5,3,6,50.0,3,6,2,4,5,16,10,0,0,2022-2023,90.0,32.846715328467155,72.26277372262774
1844,Marlos Moreno,COL,"MF,DF",Troyes,Ligue 1,25,1996,0.1,2,2,2,0,0,2,3,66.7,1,1,1,0,0,2,0,0,0,2022-2023,90.0,0.0,1800.0
1845,Tete Morente,ESP,"MF,DF",Elche,La Liga,25,1996,23.0,33,21,18,13,2,15,36,41.7,21,23,3,20,25,58,28,0,0,2022-2023,90.0,97.82608695652175,129.13043478260872
1846,Ilaix Moriba,GUI,MF,Valencia,La Liga,19,2003,11.2,35,16,14,17,4,14,24,58.3,10,11,1,10,4,39,12,0,0,2022-2023,90.0,32.142857142857146,281.25
1847,Manu Morlanes,ESP,MF,Villarreal,La Liga,23,1999,1.8,3,2,2,1,0,3,3,100.0,0,3,2,1,1,4,2,0,0,2022-2023,90.0,50.0,150.0
1848,Manu Morlanes,ESP,MF,Mallorca,La Liga,23,1999,7.8,22,9,12,8,2,13,24,54.2,11,10,5,5,5,27,9,0,0,2022-2023,90.0,57.69230769230769,253.84615384615384
1849,Nikola Moro,CRO,MF,Bologna,Serie A,24,1998,13.6,32,21,11,15,6,14,36,38.9,22,15,2,13,8,40,18,0,0,2022-2023,90.0,52.94117647058823,211.76470588235293
1850,Loren Morón,ESP,FW,Betis,La Liga,28,1993,0.2,2,2,0,1,1,0,0,0.0,0,0,0,0,0,2,1,0,0,2022-2023,90.0,0.0,900.0
Rk,Player,Nation,Pos,Squad,Comp,0,0,90.0,0,0,3,3,3,Tkl,0,0.0,0,0,0,0,0,0,0,0,0,2022-2023,90.0,0.0,0.0
1851,Cristhian Mosquera,ESP,DF,Valencia,La Liga,18,2004,1.6,4,2,3,1,0,4,5,80.0,1,1,0,1,1,5,5,0,0,2022-2023,90.0,56.25,225.0
1852,Dany Mota,POR,"FW,MF",Monza,Serie A,24,1998,21.2,8,7,1,3,4,2,10,20.0,8,5,1,4,6,14,25,0,0,2022-2023,90.0,25.471698113207548,33.9622641509434
1853,Lebo Mothiba,RSA,"FW,MF",Strasbourg,Ligue 1,26,1996,4.8,1,0,1,0,0,0,1,0.0,1,6,1,5,0,1,4,0,0,2022-2023,90.0,0.0,18.75
1854,Youssoufa Moukoko,GER,FW,Dortmund,Bundesliga,17,2004,12.7,13,7,3,6,4,3,6,50.0,3,9,0,9,2,15,1,0,0,2022-2023,90.0,14.173228346456694,92.1259842519685
1855,Steve Mounié,BEN,FW,Brest,Ligue 1,27,1994,18.4,13,5,1,7,5,5,14,35.7,9,18,7,11,3,16,20,0,0,2022-2023,90.0,14.673913043478262,63.58695652173913
1856,Mason Mount,ENG,"MF,FW",Chelsea,Premier League,23,1999,18.3,33,19,6,16,11,14,27,51.9,13,24,6,18,8,41,9,0,0,2022-2023,90.0,39.34426229508197,162.29508196721312
1857,Lucas Moura,BRA,"MF,DF",Tottenham,Premier League,29,1992,1.7,8,5,1,3,4,1,4,25.0,3,0,0,0,2,10,1,1,0,2022-2023,90.0,105.88235294117646,423.52941176470586
1858,Bevic Moussiti-Oko,CGO,FW,Ajaccio,Ligue 1,27,1995,7.8,3,1,1,1,1,1,2,50.0,1,5,3,2,2,5,8,0,0,2022-2023,90.0,23.076923076923077,34.61538461538461
1859,João Moutinho,POR,MF,Wolves,Premier League,35,1986,19.8,51,30,24,21,6,19,46,41.3,27,22,6,16,18,69,20,0,0,2022-2023,90.0,81.81818181818181,231.8181818181818
1860,João Moutinho,POR,"DF,FW",Spezia,Serie A,24,1998,0.6,7,1,5,1,1,3,4,75.0,1,1,1,0,0,7,0,0,0,2022-2023,90.0,0.0,1050.0
1861,Samuel Moutoussamy,COD,MF,Nantes,Ligue 1,25,1996,26.7,64,34,27,28,9,26,76,34.2,50,23,2,21,24,88,15,0,0,2022-2023,90.00000000000001,80.89887640449439,215.7303370786517
1862,Divin Mubama,ENG,FW,West Ham,Premier League,17,2004,0.4,1,1,1,0,0,0,0,0.0,0,0,0,0,0,1,0,0,0,2022-2023,90.0,0.0,225.0
1863,Mykhailo Mudryk,UKR,"FW,MF",Chelsea,Premier League,21,2001,7.3,11,9,2,4,5,4,13,30.8,9,7,1,6,0,11,3,0,0,2022-2023,90.0,0.0,135.6164383561644
1864,François Mughe,CMR,MF,Marseille,Ligue 1,18,2004,0.1,0,0,0,0,0,0,0,0.0,0,0,0,0,0,0,0,0,0,2022-2023,90.0,0.0,0.0
1865,Nordi Mukiele,FRA,DF,Paris S-G,Ligue 1,24,1997,12.6,31,23,16,6,9,19,29,65.5,10,22,9,13,14,45,16,0,0,2022-2023,90.0,100.00000000000001,221.42857142857144
1866,Mert Müldür,TUR,"FW,DF",Sassuolo,Serie A,23,1999,0.1,0,0,0,0,0,0,0,0.0,0,0,0,0,0,0,0,0,0,2022-2023,90.0,0.0,0.0
1867,Florian Müller,GER,GK,Stuttgart,Bundesliga,24,1997,19.0,0,0,0,0,0,0,0,0.0,0,0,0,0,0,0,7,4,0,2022-2023,90.0,0.0,0.0
1868,Thomas Müller,GER,"FW,MF",Bayern Munich,Bundesliga,32,1989,18.5,21,12,5,9,7,6,16,37.5,10,19,3,16,4,25,16,0,0,2022-2023,90.0,19.45945945945946,102.16216216216216
1869,Abdul Mumin,GHA,DF,Rayo Vallecano,La Liga,24,1998,10.2,11,9,5,6,0,3,7,42.9,4,13,5,8,9,20,36,2,0,2022-2023,90.0,79.41176470588236,97.05882352941177
1870,Marshall Munetsi,ZIM,MF,Reims,Ligue 1,26,1996,30.0,58,27,13,31,14,20,48,41.7,28,37,11,26,26,84,41,1,0,2022-2023,90.0,78.0,174.0
1871,Iker Muniain,ESP,"MF,FW",Athletic Club,La Liga,29,1992,18.8,21,16,7,11,3,6,17,35.3,11,10,1,9,4,25,2,0,0,2022-2023,90.0,19.148936170212764,100.53191489361701
1872,Aihen Muñoz,ESP,DF,Real Sociedad,La Liga,24,1997,19.5,38,23,17,17,4,22,47,46.8,25,26,5,21,9,47,38,0,0,2022-2023,90.0,41.53846153846154,175.3846153846154
1873,Álvaro Muñoz,URU,FW,Real Madrid,La Liga,18,2004,0.9,2,1,1,0,1,1,1,100.0,0,0,0,0,0,2,1,0,0,2022-2023,90.0,0.0,200.0
1874,Iker Muñoz,ESP,MF,Osasuna,La Liga,19,2002,2.8,1,0,0,1,0,0,3,0.0,3,2,1,1,3,4,8,0,0,2022-2023,90.0,96.42857142857143,32.142857142857146
1875,Pablo Muñoz,ESP,MF,Rayo Vallecano,La Liga,18,2003,0.1,0,0,0,0,0,0,1,0.0,1,0,0,0,0,0,0,0,0,2022-2023,90.0,0.0,0.0
Rk,Player,Nation,Pos,Squad,Comp,0,0,90.0,0,0,3,3,3,Tkl,0,0.0,0,0,0,0,0,0,0,0,0,2022-2023,90.0,0.0,0.0
1876,Luis Muriel,COL,"FW,MF",Atalanta,Serie A,31,1991,11.9,9,6,2,3,4,5,16,31.3,11,9,0,9,2,11,2,0,0,2022-2023,90.00000000000001,15.126050420168069,68.0672268907563
1877,Jeison Murillo,COL,DF,Sampdoria,Serie A,30,1992,11.7,22,11,16,6,0,17,26,65.4,9,22,14,8,8,30,39,0,0,2022-2023,89.99999999999999,61.53846153846153,169.23076923076923
1878,Vedat Muriqi,KVX,FW,Mallorca,La Liga,28,1994,32.6,12,7,4,7,1,3,13,23.1,10,19,7,12,12,24,73,0,0,2022-2023,90.0,33.12883435582822,33.12883435582822
1879,Jacob Murphy,ENG,FW,Newcastle Utd,Premier League,27,1995,13.9,15,7,3,8,4,8,20,40.0,12,17,0,17,7,22,3,0,0,2022-2023,90.0,45.32374100719424,97.12230215827338
1880,Nicola Murru,ITA,DF,Sampdoria,Serie A,27,1994,8.7,24,14,15,8,1,7,13,53.8,6,17,7,10,10,34,21,0,0,2022-2023,90.0,103.44827586206897,248.27586206896552
1881,Yunus Musah,USA,MF,Valencia,La Liga,19,2002,23.4,48,35,17,23,8,20,30,66.7,10,20,1,19,11,59,16,2,0,2022-2023,89.99999999999999,42.30769230769231,184.6153846153846
1882,Jamal Musiala,GER,"MF,FW",Bayern Munich,Bundesliga,19,2003,24.4,34,23,9,16,9,13,35,37.1,22,30,3,27,19,53,3,0,0,2022-2023,90.0,70.08196721311477,125.40983606557378
1883,Juan Musso,ARG,GK,Atalanta,Serie A,28,1994,23.1,1,1,1,0,0,1,1,100.0,0,0,0,0,0,1,11,1,0,2022-2023,89.99999999999999,0.0,3.8961038961038956
1884,Marlon Mustapha,AUT,"FW,MF",Mainz 05,Bundesliga,21,2001,0.8,2,2,0,2,0,0,0,0.0,0,4,0,4,0,2,0,0,0,2022-2023,90.0,0.0,225.0
1885,Yvon Mvogo,SUI,GK,Lorient,Ligue 1,28,1994,20.1,0,0,0,0,0,0,0,0.0,0,0,0,0,2,2,6,3,0,2022-2023,90.0,8.955223880597014,0.0
1886,Enock Mwepu,ZAM,"FW,MF",Brighton,Premier League,24,1998,2.4,10,5,1,6,3,3,4,75.0,1,3,1,2,1,11,1,0,0,2022-2023,90.0,37.5,375.0
1887,Francisco Mwepu,ZAM,FW,Cádiz,La Liga,22,2000,0.2,1,0,0,1,0,0,0,0.0,0,0,0,0,0,1,0,0,0,2022-2023,90.0,0.0,450.0
1888,Vitaliy Mykolenko,UKR,DF,Everton,Premier League,23,1999,29.5,58,34,36,19,3,28,51,54.9,23,50,16,34,46,104,99,0,0,2022-2023,90.0,140.33898305084745,176.94915254237287
1889,Joakim Mæhle,DEN,"DF,MF",Atalanta,Serie A,25,1997,24.5,32,18,12,7,13,22,39,56.4,17,29,6,23,24,56,26,0,0,2022-2023,90.00000000000001,88.16326530612245,117.55102040816328
1890,Obite N'Dicka,CIV,DF,Eint Frankfurt,Bundesliga,22,1999,29.9,25,18,10,11,4,18,32,56.3,14,47,19,28,31,56,150,0,0,2022-2023,90.0,93.31103678929766,75.25083612040135
1891,Nathan N'Goumou,FRA,FW,Toulouse,Ligue 1,22,2000,1.0,3,2,2,1,0,1,1,100.0,0,2,0,2,2,5,0,0,0,2022-2023,90.0,180.0,270.0
1892,Nathan N'Goumou,FRA,FW,Gladbach,Bundesliga,22,2000,7.7,11,5,5,5,1,7,13,53.8,6,9,0,9,1,12,4,0,0,2022-2023,90.0,11.688311688311689,128.57142857142858
1893,Stanley N'Soki,FRA,DF,Hoffenheim,Bundesliga,23,1999,14.3,22,13,14,7,1,12,22,54.5,10,22,5,17,24,46,34,0,0,2022-2023,90.0,151.04895104895104,138.46153846153845
1894,Herculano Nabian,POR,MF,Empoli,Serie A,18,2004,0.0,0,0,0,0,0,0,0,0.0,0,0,0,0,0,0,0,0,0,2022-2023,,,
1895,Nacho,ESP,DF,Real Madrid,La Liga,32,1990,18.2,24,16,17,5,2,12,29,41.4,17,11,6,5,18,42,37,0,0,2022-2023,90.0,89.01098901098901,118.68131868131869
1896,Nikolas Nartey,DEN,"DF,MF",Stuttgart,Bundesliga,22,2000,5.3,11,6,7,3,1,5,9,55.6,4,9,0,9,4,15,12,0,0,2022-2023,90.0,67.9245283018868,186.7924528301887
1897,Juanjo Narváez,COL,"MF,FW",Valladolid,La Liga,27,1995,1.6,1,1,1,0,0,1,1,100.0,0,2,0,2,0,1,0,0,0,2022-2023,90.0,0.0,56.25
1898,Matija Nastasić,SRB,DF,Mallorca,La Liga,29,1993,10.1,10,8,7,1,2,3,6,50.0,3,11,4,7,18,28,43,1,0,2022-2023,90.0,160.3960396039604,89.10891089108911
1899,Roberto Navarro,ESP,"MF,FW",Real Sociedad,La Liga,20,2002,3.9,5,4,4,0,1,1,2,50.0,1,7,0,7,2,7,2,0,0,2022-2023,90.0,46.15384615384615,115.38461538461539
1900,Jesús Navas,ESP,"DF,FW",Sevilla,La Liga,36,1985,22.0,19,12,8,3,8,11,22,50.0,11,18,7,11,22,41,52,1,0,2022-2023,90.0,90.0,77.72727272727273
Rk,Player,Nation,Pos,Squad,Comp,0,0,90.0,0,0,3,3,3,Tkl,0,0.0,0,0,0,0,0,0,0,0,0,2022-2023,90.0,0.0,0.0
1901,Keylor Navas,CRC,GK,Nott'ham Forest,Premier League,35,1986,17.0,0,0,0,0,0,0,0,0.0,0,0,0,0,1,1,11,2,0,2022-2023,90.0,5.294117647058823,0.0
1902,Michel Ndary Adopo,FRA,"MF,DF",Torino,Serie A,22,2000,2.9,7,2,4,2,1,1,3,33.3,2,2,2,0,1,8,4,0,0,2022-2023,90.0,31.03448275862069,217.24137931034483
1903,Youssouf Ndayishimiye,BDI,"MF,DF",Nice,Ligue 1,23,1998,6.3,13,9,8,5,0,6,11,54.5,5,8,5,3,12,25,22,1,0,2022-2023,90.0,171.42857142857144,185.71428571428572
1904,Papa Ndiaga Yade,MTN,"DF,MF",Troyes,Ligue 1,22,2000,6.3,10,6,6,2,2,7,22,31.8,15,10,2,8,8,18,10,0,0,2022-2023,90.0,114.28571428571429,142.85714285714286
1905,Wilfred Ndidi,NGA,MF,Leicester City,Premier League,25,1996,18.7,61,42,34,24,3,17,43,39.5,26,32,14,18,38,99,48,3,0,2022-2023,90.0,182.88770053475935,293.58288770053474
1906,Tanguy Ndombele,FRA,MF,Napoli,Serie A,25,1996,9.0,14,8,4,8,2,4,7,57.1,3,10,1,9,7,21,7,1,0,2022-2023,90.0,70.0,140.0
1907,Álvaro Negredo,ESP,FW,Cádiz,La Liga,36,1985,8.4,5,4,1,2,2,2,2,100.0,0,4,1,3,0,5,8,0,0,2022-2023,90.0,0.0,53.57142857142857
1908,Reiss Nelson,ENG,FW,Arsenal,Premier League,22,1999,2.4,4,1,2,1,1,2,4,50.0,2,3,0,3,0,4,4,0,0,2022-2023,90.0,0.0,150.0
1909,Ilija Nestorovski,MKD,"FW,MF",Udinese,Serie A,32,1990,7.1,7,3,2,1,4,5,11,45.5,6,6,1,5,2,9,10,0,0,2022-2023,90.0,25.35211267605634,88.73239436619718
1910,Neto,BRA,GK,Bournemouth,Premier League,33,1989,26.5,3,1,3,0,0,3,3,100.0,0,0,0,0,0,3,10,3,0,2022-2023,90.0,0.0,10.18867924528302
1911,Pedro Neto,POR,"FW,MF",Wolves,Premier League,22,2000,10.7,11,6,4,2,5,7,17,41.2,10,5,1,4,4,15,4,0,0,2022-2023,90.0,33.64485981308412,92.52336448598132
1912,Luca Netz,GER,DF,Gladbach,Bundesliga,19,2003,7.8,25,13,19,3,3,19,32,59.4,13,5,1,4,6,31,27,0,0,2022-2023,90.0,69.23076923076923,288.46153846153845
1913,Manuel Neuer,GER,GK,Bayern Munich,Bundesliga,36,1986,12.0,0,0,0,0,0,0,0,0.0,0,0,0,0,0,0,4,1,0,2022-2023,90.0,0.0,0.0
1914,Florian Neuhaus,GER,MF,Gladbach,Bundesliga,25,1997,15.6,19,9,9,5,5,8,27,29.6,19,20,3,17,12,31,5,0,0,2022-2023,90.0,69.23076923076923,109.61538461538461
1915,Rúben Neves,POR,MF,Wolves,Premier League,25,1997,33.5,79,43,31,33,15,32,76,42.1,44,59,22,37,50,129,85,1,0,2022-2023,90.0,134.32835820895522,212.23880597014926
1916,Neymar,BRA,"MF,FW",Paris S-G,Ligue 1,30,1992,17.2,22,14,6,9,7,9,19,47.4,10,7,1,6,4,26,1,1,0,2022-2023,90.0,20.930232558139537,115.11627906976746
1917,Jessic Ngankam,GER,"FW,MF",Hertha BSC,Bundesliga,22,2000,9.2,14,9,7,4,3,6,14,42.9,8,6,1,5,1,15,4,0,0,2022-2023,90.0,9.782608695652174,136.95652173913044
1918,Cyril Ngonge,BEL,"MF,FW",Hellas Verona,Serie A,22,2000,8.3,7,3,2,2,3,3,11,27.3,8,7,0,7,6,13,4,0,0,2022-2023,90.0,65.06024096385542,75.90361445783131
1919,Moussa Niakhate,SEN,DF,Nott'ham Forest,Premier League,26,1996,12.9,18,9,15,3,0,11,22,50.0,11,18,8,10,19,37,60,0,0,2022-2023,90.0,132.5581395348837,125.5813953488372
1920,Ibrahima Niane,SEN,FW,Angers,Ligue 1,23,1999,12.6,6,2,1,4,1,1,6,16.7,5,8,2,6,1,7,9,0,0,2022-2023,90.0,7.142857142857143,42.85714285714286
1921,M'Baye Niang,SEN,FW,Auxerre,Ligue 1,27,1994,16.5,13,7,1,8,4,3,13,23.1,10,22,1,21,1,14,20,0,0,2022-2023,90.0,5.454545454545455,70.90909090909092
1922,Tanguy Nianzou,FRA,DF,Sevilla,La Liga,20,2002,15.2,20,15,10,9,1,8,11,72.7,3,8,5,3,16,36,44,3,0,2022-2023,90.0,94.73684210526315,118.42105263157895
1923,Rasmus Nicolaisen,DEN,DF,Toulouse,Ligue 1,25,1997,33.3,48,21,34,14,0,29,46,63.0,17,58,45,13,50,98,152,0,0,2022-2023,90.0,135.13513513513513,129.72972972972974
1924,Hans Nicolussi Caviglia,ITA,MF,Salernitana,Serie A,22,2000,6.5,15,6,5,8,2,9,15,60.0,6,9,0,9,7,22,7,1,0,2022-2023,90.00000000000001,96.92307692307693,207.6923076923077
1925,Florian Niederlechner,GER,"FW,MF",Augsburg,Bundesliga,31,1990,10.1,10,5,5,4,1,4,7,57.1,3,16,2,14,1,11,9,0,0,2022-2023,90.0,8.910891089108912,89.10891089108911
Rk,Player,Nation,Pos,Squad,Comp,0,0,90.0,0,0,3,3,3,Tkl,0,0.0,0,0,0,0,0,0,0,0,0,2022-2023,90.0,0.0,0.0
1926,Florian Niederlechner,GER,FW,Hertha BSC,Bundesliga,31,1990,8.7,9,7,2,4,3,2,8,25.0,6,7,0,7,3,12,10,0,0,2022-2023,90.0,31.03448275862069,93.10344827586206
1927,Saúl Ñíguez,ESP,"MF,DF",Atlético Madrid,La Liga,27,1994,12.2,42,27,18,18,6,22,37,59.5,15,27,5,22,15,57,29,0,0,2022-2023,90.0,110.65573770491804,309.83606557377055
1928,Dimitris Nikolaou,GRE,DF,Spezia,Serie A,23,1998,32.9,45,32,31,10,4,25,37,67.6,12,41,26,15,27,72,82,0,0,2022-2023,90.0,73.86018237082068,123.10030395136779
1929,Fernando Niño,ESP,"MF,FW",Villarreal,La Liga,21,2000,0.2,0,0,0,0,0,0,0,0.0,0,0,0,0,0,0,0,0,0,2022-2023,90.0,0.0,0.0
1930,Justin Njinmah,GER,FW,Dortmund,Bundesliga,21,2000,0.2,0,0,0,0,0,0,0,0.0,0,0,0,0,0,0,0,0,0,2022-2023,90.0,0.0,0.0
1931,Eddie Nketiah,ENG,FW,Arsenal,Premier League,23,1999,12.1,13,9,6,2,5,2,10,20.0,8,7,1,6,1,14,7,0,0,2022-2023,90.0,7.43801652892562,96.69421487603306
1932,Christopher Nkunku,FRA,"FW,MF",RB Leipzig,Bundesliga,24,1997,21.1,6,4,2,1,3,1,6,16.7,5,8,3,5,8,14,11,0,0,2022-2023,90.0,34.12322274881517,25.592417061611375
1933,Felix Nmecha,GER,MF,Wolfsburg,Bundesliga,21,2000,20.4,41,24,11,23,7,16,34,47.1,18,26,10,16,25,66,31,0,0,2022-2023,90.0,110.29411764705883,180.8823529411765
1934,Lukas Nmecha,GER,FW,Wolfsburg,Bundesliga,23,1998,10.0,5,3,0,2,3,3,3,100.0,0,5,1,4,3,8,4,0,0,2022-2023,90.0,27.0,45.0
1935,Arnaud Nordin,FRA,FW,Montpellier,Ligue 1,24,1998,26.7,26,14,10,12,4,12,28,42.9,16,19,1,18,14,40,7,0,0,2022-2023,90.00000000000001,47.19101123595506,87.64044943820225
1936,Riad Nouri,FRA,"MF,FW",Ajaccio,Ligue 1,37,1985,18.8,21,12,7,10,4,12,29,41.4,17,8,1,7,15,36,11,0,0,2022-2023,90.0,71.80851063829786,100.53191489361701
1937,Hugo Novoa,ESP,"DF,FW",RB Leipzig,Bundesliga,19,2003,2.0,8,2,1,3,4,4,7,57.1,3,4,0,4,1,9,0,0,0,2022-2023,90.0,45.0,360.0
1938,Samuel Ntanda,BEL,MF,Sampdoria,Serie A,17,2005,0.0,0,0,0,0,0,0,0,0.0,0,0,0,0,0,0,0,0,0,2022-2023,,,
1939,Randy Nteka,ANG,"FW,MF",Elche,La Liga,24,1997,8.1,15,10,7,6,2,2,11,18.2,9,15,3,12,4,19,9,0,0,2022-2023,90.0,44.44444444444444,166.66666666666669
1940,Randy Nteka,ANG,"FW,MF",Rayo Vallecano,La Liga,24,1997,1.3,4,2,2,2,0,1,1,100.0,0,2,0,2,2,6,3,0,0,2022-2023,90.0,138.46153846153845,276.9230769230769
1941,Alexander Nübel,GER,GK,Monaco,Ligue 1,25,1996,38.0,0,0,0,0,0,0,1,0.0,1,0,0,0,1,1,10,3,0,2022-2023,90.0,2.3684210526315788,0.0
1942,Matheus Nunes,POR,MF,Wolves,Premier League,23,1998,27.4,67,43,36,22,9,28,61,45.9,33,35,4,31,16,83,35,2,0,2022-2023,90.0,52.55474452554745,220.07299270072994
1943,Darwin Núñez,URU,FW,Liverpool,Premier League,23,1999,18.8,11,5,2,4,5,4,17,23.5,13,10,0,10,3,14,13,0,0,2022-2023,90.0,14.361702127659573,52.659574468085104
1944,Unai Núñez,ESP,DF,Celta Vigo,La Liga,25,1997,35.0,47,35,29,15,3,18,34,52.9,16,27,17,10,72,119,135,1,0,2022-2023,90.0,185.14285714285714,120.85714285714286
1945,Bram Nuytinck,NED,DF,Udinese,Serie A,32,1990,4.3,7,4,3,4,0,4,8,50.0,4,6,6,0,5,12,22,0,0,2022-2023,90.0,104.65116279069768,146.51162790697677
1946,Bram Nuytinck,NED,DF,Sampdoria,Serie A,32,1990,16.6,54,38,33,21,0,23,34,67.6,11,36,21,15,23,77,84,0,0,2022-2023,90.0,124.69879518072288,292.77108433734935
1947,Ethan Nwaneri,ENG,FW,Arsenal,Premier League,15,2007,0.0,0,0,0,0,0,0,0,0.0,0,1,0,1,0,0,0,0,0,2022-2023,,,
1948,Gerzino Nyamsi,FRA,DF,Strasbourg,Ligue 1,25,1997,17.5,28,20,14,12,2,10,12,83.3,2,19,11,8,10,38,63,1,0,2022-2023,90.0,51.42857142857143,144.0
1949,Ørjan Nyland,NOR,GK,RB Leipzig,Bundesliga,31,1990,2.0,0,0,0,0,0,0,0,0.0,0,0,0,0,0,0,0,0,0,2022-2023,90.0,0.0,0.0
1950,M'Bala Nzola,ANG,FW,Spezia,Serie A,25,1996,29.5,12,5,0,6,6,3,9,33.3,6,20,6,14,7,19,21,0,0,2022-2023,90.0,21.35593220338983,36.610169491525426
Rk,Player,Nation,Pos,Squad,Comp,0,0,90.0,0,0,3,3,3,Tkl,0,0.0,0,0,0,0,0,0,0,0,0,2022-2023,90.0,0.0,0.0
1951,Christian Nørgaard,DEN,MF,Brentford,Premier League,28,1994,19.6,52,30,21,29,2,18,48,37.5,30,32,9,23,34,86,41,2,0,2022-2023,90.0,156.12244897959184,238.77551020408163
1952,Lewis O'Brien,ENG,MF,Nott'ham Forest,Premier League,23,1998,6.5,16,9,4,11,1,6,12,50.0,6,13,2,11,5,21,9,0,0,2022-2023,90.00000000000001,69.23076923076924,221.53846153846155
1953,Pedro Obiang,EQG,MF,Sassuolo,Serie A,30,1992,9.7,26,17,12,12,2,10,18,55.6,8,12,2,10,8,34,15,0,0,2022-2023,90.0,74.22680412371135,241.23711340206188
1954,Jan Oblak,SVN,GK,Atlético Madrid,La Liga,29,1993,27.7,0,0,0,0,0,0,0,0.0,0,0,0,0,1,1,8,0,0,2022-2023,90.0,3.2490974729241877,0.0
1955,Brian Ocampo,URU,"MF,FW",Cádiz,La Liga,23,1999,12.4,18,15,12,5,1,8,21,38.1,13,13,0,13,3,21,3,0,0,2022-2023,90.0,21.774193548387096,130.6451612903226
1956,Lucas Ocampos,ARG,"FW,MF",Sevilla,La Liga,28,1994,12.9,22,14,9,9,4,8,31,25.8,23,17,2,15,8,30,5,0,0,2022-2023,90.0,55.81395348837209,153.48837209302326
1957,Guillermo Ochoa,MEX,GK,Salernitana,Serie A,37,1985,20.0,0,0,0,0,0,0,2,0.0,2,0,0,0,0,0,9,1,0,2022-2023,90.0,0.0,0.0
1958,Wilson Odobert,FRA,"MF,FW",Troyes,Ligue 1,17,2004,19.6,20,14,10,7,3,9,25,36.0,16,11,0,11,15,35,5,0,0,2022-2023,90.0,68.87755102040816,91.83673469387755
1959,Álvaro Odriozola,ESP,DF,Real Madrid,La Liga,26,1995,0.4,0,0,0,0,0,0,0,0.0,0,0,0,0,0,0,0,0,0,2022-2023,90.0,0.0,0.0
1960,Tim Oermann,GER,DF,Bochum,Bundesliga,18,2003,2.2,2,1,2,0,0,1,1,100.0,0,3,2,1,1,3,8,1,0,2022-2023,90.0,40.90909090909091,81.81818181818181
1961,Odeluga Offiah,ENG,DF,Brighton,Premier League,19,2002,0.3,1,1,1,0,0,0,2,0.0,2,0,0,0,0,1,1,0,0,2022-2023,90.0,0.0,300.0
1962,Angelo Ogbonna,ITA,DF,West Ham,Premier League,34,1988,13.7,11,4,7,4,0,5,10,50.0,5,11,7,4,17,28,74,1,0,2022-2023,90.0,111.67883211678833,72.26277372262774
1963,Florent Ogier,FRA,DF,Clermont Foot,Ligue 1,33,1989,18.9,33,16,20,12,1,22,39,56.4,17,22,13,9,18,51,64,1,0,2022-2023,90.0,85.71428571428572,157.14285714285714
1964,Marios Oikonomou,GRE,DF,Sampdoria,Serie A,29,1992,2.4,3,2,3,0,0,1,3,33.3,2,5,4,1,4,7,13,0,0,2022-2023,90.0,150.0,112.50000000000001
1965,David Okereke,NGA,"FW,MF",Cremonese,Serie A,24,1997,25.2,12,8,4,5,3,3,16,18.8,13,23,3,20,10,22,12,0,0,2022-2023,90.0,35.714285714285715,42.85714285714286
1966,Caleb Okoli,ITA,DF,Atalanta,Serie A,21,2001,10.7,21,17,14,6,1,10,25,40.0,15,10,5,5,30,51,44,3,0,2022-2023,90.0,252.33644859813086,176.6355140186916
1967,Olasagasti,ESP,"MF,DF",Real Sociedad,La Liga,21,2000,0.7,4,4,1,2,1,1,2,50.0,1,2,0,2,0,4,1,0,0,2022-2023,90.0,0.0,514.2857142857143
1968,Lucas Olaza,URU,DF,Valladolid,La Liga,28,1994,16.6,24,14,12,10,2,17,26,65.4,9,20,8,12,14,38,34,0,0,2022-2023,90.0,75.90361445783131,130.12048192771084
1969,Finn Ole Becker,GER,MF,Hoffenheim,Bundesliga,22,2000,5.7,10,2,4,6,0,4,7,57.1,3,4,0,4,5,15,8,0,0,2022-2023,90.0,78.94736842105263,157.89473684210526
1970,Mathias Olesen,LUX,MF,Köln,Bundesliga,21,2001,5.3,10,5,4,4,2,5,8,62.5,3,6,1,5,2,12,3,0,0,2022-2023,90.0,33.9622641509434,169.811320754717
1971,Michael Olise,FRA,"FW,MF",Crystal Palace,Premier League,20,2001,30.5,58,34,28,26,4,25,60,41.7,35,46,1,45,26,84,17,0,0,2022-2023,90.0,76.72131147540983,171.14754098360655
1972,Brian Oliván,ESP,DF,Espanyol,La Liga,28,1994,26.7,47,27,30,12,5,17,26,65.4,9,26,6,20,22,69,67,0,0,2022-2023,90.00000000000001,74.15730337078652,158.42696629213484
1973,Lucas Oliveira Rosa,BRA,DF,Valladolid,La Liga,22,2000,10.3,39,18,23,10,6,12,20,60.0,8,12,2,10,15,54,24,0,0,2022-2023,90.0,131.06796116504853,340.77669902912623
1974,Mathías Olivera,URU,DF,Napoli,Serie A,24,1997,18.3,39,23,16,16,7,22,43,51.2,21,28,2,26,22,61,26,0,0,2022-2023,90.0,108.1967213114754,191.80327868852459
1975,Dani Olmo,ESP,"MF,FW",RB Leipzig,Bundesliga,24,1998,14.2,15,9,1,10,4,6,14,42.9,8,15,0,15,6,21,6,0,0,2022-2023,90.0,38.02816901408451,95.07042253521128
Rk,Player,Nation,Pos,Squad,Comp,0,0,90.0,0,0,3,3,3,Tkl,0,0.0,0,0,0,0,0,0,0,0,0,2022-2023,90.0,0.0,0.0
1976,Jan Olschowsky,GER,GK,Gladbach,Bundesliga,20,2001,4.0,0,0,0,0,0,0,1,0.0,1,1,0,1,0,0,1,0,0,2022-2023,90.0,0.0,0.0
1977,Robin Olsen,SWE,GK,Aston Villa,Premier League,32,1990,3.1,0,0,0,0,0,0,2,0.0,2,0,0,0,0,0,1,0,0,2022-2023,90.0,0.0,0.0
1978,Warmed Omari,FRA,DF,Rennes,Ligue 1,22,2000,15.1,20,11,14,6,0,14,28,50.0,14,13,7,6,17,37,43,1,0,2022-2023,90.0,101.32450331125828,119.20529801324504
1979,Jonas Omlin,SUI,GK,Montpellier,Ligue 1,28,1994,13.0,1,0,1,0,0,0,0,0.0,0,0,0,0,0,1,8,1,0,2022-2023,90.00000000000001,0.0,6.923076923076923
1980,Jonas Omlin,SUI,GK,Gladbach,Bundesliga,28,1994,14.3,1,1,1,0,0,1,3,33.3,2,1,0,1,0,1,9,1,0,2022-2023,90.0,0.0,6.293706293706294
1981,Ado Onaiwu,JPN,FW,Toulouse,Ligue 1,26,1995,12.0,11,6,4,4,3,5,13,38.5,8,5,1,4,2,13,5,0,0,2022-2023,90.0,15.0,82.5
1982,Amadou Onana,BEL,MF,Everton,Premier League,20,2001,27.6,72,43,24,42,6,30,42,71.4,12,25,6,19,37,109,39,0,0,2022-2023,90.0,120.65217391304347,234.78260869565216
1983,André Onana,CMR,GK,Inter,Serie A,26,1996,24.0,0,0,0,0,0,0,1,0.0,1,0,0,0,0,0,5,0,0,2022-2023,90.0,0.0,0.0
1984,Jean Onana,CMR,"MF,DF",Lens,Ligue 1,22,2000,9.0,28,17,8,17,3,10,22,45.5,12,15,5,10,18,46,20,0,0,2022-2023,90.0,180.0,280.0
1985,Karim Onisiwo,AUT,"FW,MF",Mainz 05,Bundesliga,30,1992,28.2,19,12,3,10,6,4,21,19.0,17,19,0,19,2,21,7,0,0,2022-2023,89.99999999999999,6.382978723404255,60.638297872340424
1986,Josh Onomah,ENG,MF,Fulham,Premier League,25,1997,0.2,1,0,1,0,0,0,0,0.0,0,1,0,1,0,1,0,0,0,2022-2023,90.0,0.0,450.0
1987,Paul Onuachu,NGA,FW,Southampton,Premier League,28,1994,4.5,3,2,1,1,1,1,3,33.3,2,4,1,3,0,3,4,0,0,2022-2023,90.0,0.0,60.0
1988,Frank Onyeka,NGA,MF,Brentford,Premier League,24,1998,9.4,19,14,11,7,1,10,25,40.0,15,16,3,13,10,29,16,0,0,2022-2023,90.0,95.74468085106382,181.91489361702128
1989,Loïs Openda,BEL,FW,Lens,Ligue 1,22,2000,28.0,11,9,2,6,3,2,13,15.4,11,9,0,9,2,13,6,0,0,2022-2023,90.0,6.428571428571429,35.357142857142854
1990,Willi Orban,HUN,DF,RB Leipzig,Bundesliga,29,1992,32.8,51,30,33,18,0,26,43,60.5,17,42,24,18,39,90,129,1,0,2022-2023,90.0,107.01219512195124,139.93902439024393
1991,Ivan Ordets,UKR,DF,Bochum,Bundesliga,30,1992,27.2,31,19,21,9,1,16,28,57.1,12,34,17,17,57,88,139,0,0,2022-2023,90.0,188.60294117647058,102.57352941176471
1992,Divock Origi,BEL,FW,Milan,Serie A,27,1995,11.4,10,5,4,3,3,5,10,50.0,5,6,2,4,0,10,13,0,0,2022-2023,90.0,0.0,78.94736842105263
1993,Aimar Oroz,ESP,"MF,FW",Osasuna,La Liga,20,2001,22.4,26,14,8,10,8,8,30,26.7,22,24,1,23,24,50,6,0,0,2022-2023,90.0,96.42857142857143,104.46428571428572
1994,Mislav Oršić,CRO,MF,Southampton,Premier League,29,1992,0.1,1,1,1,0,0,0,0,0.0,0,0,0,0,0,1,0,0,0,2022-2023,90.0,0.0,900.0
1995,Riccardo Orsolini,ITA,FW,Bologna,Serie A,25,1997,23.6,30,19,15,10,5,17,41,41.5,24,29,3,26,8,38,18,0,0,2022-2023,90.0,30.508474576271183,114.40677966101694
1996,Stefan Ortega,GER,GK,Manchester City,Premier League,29,1992,3.0,0,0,0,0,0,0,0,0.0,0,0,0,0,0,0,0,0,0,2022-2023,90.0,0.0,0.0
1997,Pedro Ortiz,ESP,MF,Sevilla,La Liga,21,2000,0.0,0,0,0,0,0,0,0,0.0,0,0,0,0,0,0,0,0,0,2022-2023,,,
1998,Jordi Osei-Tutu,ENG,"DF,FW",Bochum,Bundesliga,23,1998,8.3,23,18,13,5,5,12,23,52.2,11,12,5,7,10,33,8,0,0,2022-2023,90.0,108.43373493975902,249.39759036144576
1999,Victor Osimhen,NGA,FW,Napoli,Serie A,23,1998,28.5,10,6,1,2,7,0,7,0.0,7,6,1,5,6,16,29,0,0,2022-2023,90.0,18.947368421052634,31.578947368421055
2000,Patrick Osterhage,GER,MF,Bochum,Bundesliga,22,2000,11.4,20,17,8,10,2,11,16,68.8,5,17,6,11,12,32,25,0,0,2022-2023,90.0,94.73684210526315,157.89473684210526
Rk,Player,Nation,Pos,Squad,Comp,0,0,90.0,0,0,3,3,3,Tkl,0,0.0,0,0,0,0,0,0,0,0,0,2022-2023,90.0,0.0,0.0
2001,Paulo Otávio,BRA,DF,Wolfsburg,Bundesliga,27,1994,22.7,72,46,46,17,9,44,66,66.7,22,42,6,36,30,102,70,1,0,2022-2023,89.99999999999999,118.94273127753303,285.4625550660793
2002,Dango Ouattara,BFA,"MF,FW",Bournemouth,Premier League,20,2002,13.8,28,15,20,6,2,13,32,40.6,19,20,3,17,13,41,29,1,0,2022-2023,90.0,84.78260869565217,182.6086956521739
2003,Dango Ouattara,BFA,"FW,MF",Lorient,Ligue 1,20,2002,17.2,41,26,20,11,10,15,28,53.6,13,24,6,18,19,60,21,0,0,2022-2023,90.0,99.4186046511628,214.53488372093025
2004,Remi Oudin,FRA,"FW,MF",Lecce,Serie A,25,1996,14.7,25,13,9,12,4,10,23,43.5,13,16,2,14,29,54,23,0,0,2022-2023,90.0,177.55102040816328,153.06122448979593
2005,Zinédine Ould Khaled,FRA,"MF,FW",Angers,Ligue 1,22,2000,0.6,1,1,0,1,0,0,1,0.0,1,0,0,0,2,3,0,0,0,2022-2023,90.0,300.0,150.0
2006,Azzedine Ounahi,MAR,"MF,FW",Marseille,Ligue 1,22,2000,1.3,2,1,1,1,0,0,2,0.0,2,1,0,1,0,2,0,0,0,2022-2023,90.0,0.0,138.46153846153845
2007,Azzedine Ounahi,MAR,"MF,FW",Angers,Ligue 1,22,2000,12.5,19,8,5,13,1,10,20,50.0,10,8,0,8,15,34,4,1,0,2022-2023,90.0,108.0,136.79999999999998
2008,Adam Ounas,ALG,FW,Napoli,Serie A,25,1996,0.2,0,0,0,0,0,0,0,0.0,0,0,0,0,1,1,0,0,0,2022-2023,90.0,450.0,0.0
2009,Adam Ounas,ALG,"FW,MF",Lille,Ligue 1,25,1996,11.8,20,11,4,10,6,8,13,61.5,5,16,0,16,7,27,5,0,0,2022-2023,90.0,53.389830508474574,152.54237288135593
2010,Thomas Ouwejan,NED,DF,Schalke 04,Bundesliga,25,1996,10.0,20,8,13,5,2,6,10,60.0,4,17,4,13,13,33,27,0,0,2022-2023,90.0,117.0,180.0
2011,Reece Oxford,ENG,DF,Augsburg,Bundesliga,23,1998,1.0,1,1,1,0,0,0,0,0.0,0,4,3,1,1,2,5,0,0,2022-2023,90.0,90.0,90.0
2012,Alex Oxlade-Chamberlain,ENG,"FW,MF",Liverpool,Premier League,28,1993,3.7,5,4,1,2,2,1,5,20.0,4,5,2,3,1,6,4,0,0,2022-2023,90.0,24.324324324324323,121.62162162162161
2013,Mikel Oyarzabal,ESP,"FW,MF",Real Sociedad,La Liga,25,1997,13.5,13,7,5,3,5,5,19,26.3,14,14,4,10,3,16,5,0,0,2022-2023,90.0,20.0,86.66666666666667
2014,Salih Özcan,TUR,MF,Dortmund,Bundesliga,24,1998,17.5,31,18,10,16,5,16,39,41.0,23,24,2,22,28,59,19,1,0,2022-2023,90.0,144.0,159.42857142857142
2015,Cenk Özkacar,TUR,DF,Valencia,La Liga,21,2000,15.2,27,20,17,10,0,14,19,73.7,5,14,2,12,12,39,47,4,0,2022-2023,90.0,71.05263157894737,159.86842105263156
2016,David Ozoh,ENG,FW,Crystal Palace,Premier League,17,2005,0.0,0,0,0,0,0,0,0,0.0,0,0,0,0,0,0,0,0,0,2022-2023,,,
2017,Levin Öztunalı,GER,MF,Union Berlin,Bundesliga,26,1996,0.1,0,0,0,0,0,0,1,0.0,1,0,0,0,0,0,0,0,0,2022-2023,90.0,0.0,0.0
2018,Fernando Pacheco,ESP,GK,Almería,La Liga,30,1992,1.0,0,0,0,0,0,0,0,0.0,0,0,0,0,0,0,1,0,0,2022-2023,90.0,0.0,0.0
2019,Fernando Pacheco,ESP,GK,Espanyol,La Liga,30,1992,16.0,0,0,0,0,0,0,1,0.0,1,0,0,0,1,1,11,0,0,2022-2023,90.0,5.625,0.0
2020,Jon Pacheco,ESP,DF,Real Sociedad,La Liga,21,2001,13.3,16,10,10,6,0,6,10,60.0,4,9,6,3,12,28,37,1,0,2022-2023,90.0,81.203007518797,108.27067669172932
2021,Gonçalo Paciência,POR,"FW,MF",Celta Vigo,La Liga,27,1994,7.4,8,5,0,5,3,2,7,28.6,5,9,1,8,0,8,4,0,0,2022-2023,90.0,0.0,97.29729729729729
2022,Simone Pafundi,ITA,"MF,FW",Udinese,Serie A,16,2006,0.9,8,5,1,5,2,2,4,50.0,2,0,0,0,1,9,0,0,0,2022-2023,90.0,100.0,800.0
2023,Exequiel Palacios,ARG,MF,Leverkusen,Bundesliga,23,1998,18.4,59,36,20,33,6,29,48,60.4,19,29,2,27,33,92,28,0,0,2022-2023,90.0,161.41304347826087,288.5869565217391
2024,Helibelton Palacios,COL,DF,Elche,La Liga,29,1993,21.3,38,20,21,15,2,19,26,73.1,7,26,12,14,20,58,55,0,0,2022-2023,90.0,84.50704225352112,160.56338028169014
2025,Ante Palaversa,CRO,MF,Troyes,Ligue 1,22,2000,0.3,1,1,1,0,0,0,0,0.0,0,0,0,0,1,2,0,0,0,2022-2023,90.0,300.0,300.0
Rk,Player,Nation,Pos,Squad,Comp,0,0,90.0,0,0,3,3,3,Tkl,0,0.0,0,0,0,0,0,0,0,0,0,2022-2023,90.0,0.0,0.0
2026,Isaac Palazón Camacho,ESP,"FW,MF",Rayo Vallecano,La Liga,27,1994,32.9,45,30,11,23,11,24,66,36.4,42,42,3,39,17,62,30,0,0,2022-2023,90.0,46.50455927051672,123.10030395136779
2027,João Palhinha,POR,MF,Fulham,Premier League,27,1995,34.5,148,83,59,65,24,71,135,52.6,64,48,5,43,46,194,61,2,0,2022-2023,90.0,119.99999999999999,386.0869565217391
2028,Nicolas Pallois,FRA,DF,Nantes,Ligue 1,34,1987,24.6,69,44,51,16,2,42,70,60.0,28,35,18,17,30,99,131,2,0,2022-2023,89.99999999999999,109.75609756097559,252.43902439024387
2029,Cole Palmer,ENG,"MF,FW",Manchester City,Premier League,20,2002,4.1,5,1,0,3,2,3,5,60.0,2,2,1,1,1,6,2,0,0,2022-2023,90.0,21.951219512195124,109.75609756097562
2030,Erik Palmer-Brown,USA,DF,Troyes,Ligue 1,25,1997,35.5,42,27,31,10,1,18,33,54.5,15,56,29,27,26,68,166,1,0,2022-2023,90.0,65.91549295774648,106.47887323943662
2031,Emerson Palmieri,ITA,DF,West Ham,Premier League,27,1994,14.7,26,14,9,15,2,12,24,50.0,12,17,4,13,15,41,36,0,0,2022-2023,90.0,91.83673469387756,159.18367346938777
2032,Miloš Pantović,SRB,MF,Union Berlin,Bundesliga,26,1996,2.3,4,2,4,0,0,3,5,60.0,2,3,0,3,0,4,5,0,0,2022-2023,90.0,0.0,156.52173913043478
2033,Flavio Paoletti,ITA,MF,Sampdoria,Serie A,19,2003,3.2,2,2,0,2,0,1,5,20.0,4,1,0,1,5,7,9,0,0,2022-2023,90.0,140.625,56.25
2034,Antonios Papadopoulos,GER,DF,Dortmund,Bundesliga,22,1999,0.1,0,0,0,0,0,0,0,0.0,0,0,0,0,1,1,0,0,0,2022-2023,90.0,900.0,0.0
2035,Lucas Paquetá,BRA,MF,West Ham,Premier League,24,1997,23.9,71,53,23,36,12,27,68,39.7,41,41,4,37,16,87,31,0,0,2022-2023,90.0,60.25104602510461,267.3640167364017
2036,Lucas Paquetá,BRA,MF,Lyon,Ligue 1,24,1997,1.8,5,4,0,5,0,1,3,33.3,2,2,0,2,1,6,3,0,0,2022-2023,90.0,50.0,250.0
2037,Aitor Paredes,ESP,DF,Athletic Club,La Liga,22,2000,9.5,7,6,4,2,1,6,11,54.5,5,11,7,4,14,21,26,0,0,2022-2023,90.0,132.6315789473684,66.3157894736842
2038,Kevin Paredes,USA,"FW,MF",Wolfsburg,Bundesliga,19,2003,5.9,13,9,6,3,4,9,12,75.0,3,7,0,7,6,19,8,0,0,2022-2023,90.0,91.52542372881355,198.30508474576268
2039,Leandro Paredes,ARG,MF,Juventus,Serie A,28,1994,10.9,19,13,7,11,1,10,22,45.5,12,8,0,8,17,36,22,0,0,2022-2023,90.0,140.36697247706422,156.88073394495413
2040,Leandro Paredes,ARG,MF,Paris S-G,Ligue 1,28,1994,0.6,1,1,1,0,0,1,1,100.0,0,2,1,1,1,2,0,0,0,2022-2023,90.0,150.0,150.0
2041,Daniel Parejo,ESP,MF,Villarreal,La Liga,33,1989,36.5,71,40,32,23,16,30,75,40.0,45,40,12,28,29,100,31,2,0,2022-2023,90.0,71.5068493150685,175.06849315068493
2042,Fabiano Parisi,ITA,DF,Empoli,Serie A,21,2000,31.4,65,35,37,21,7,30,72,41.7,42,51,16,35,41,106,91,0,0,2022-2023,90.0,117.515923566879,186.30573248407646
2043,Moises Parra Gutierrez,ESP,FW,Getafe,La Liga,20,2002,0.1,1,0,0,1,0,0,0,0.0,0,0,0,0,0,1,0,0,0,2022-2023,90.0,0.0,900.0
2044,Raúl Parra,ESP,DF,Cádiz,La Liga,22,1999,3.4,4,2,4,0,0,4,9,44.4,5,5,3,2,1,5,9,0,0,2022-2023,90.0,26.470588235294116,105.88235294117646
2045,Thomas Partey,GHA,MF,Arsenal,Premier League,29,1993,27.6,70,40,20,35,15,25,52,48.1,27,26,5,21,28,98,41,1,0,2022-2023,90.0,91.30434782608695,228.26086956521738
2046,Marco Pašalić,CRO,MF,Dortmund,Bundesliga,21,2000,0.1,0,0,0,0,0,0,0,0.0,0,0,0,0,0,0,0,0,0,2022-2023,90.0,0.0,0.0
2047,Mario Pašalić,CRO,"MF,FW",Atalanta,Serie A,27,1995,19.7,22,10,6,14,2,6,23,26.1,17,22,4,18,21,43,13,0,0,2022-2023,90.0,95.93908629441624,100.50761421319797
2048,Pascu,ESP,"DF,FW",Villarreal,La Liga,19,2003,0.1,0,0,0,0,0,0,0,0.0,0,0,0,0,0,0,0,0,0,2022-2023,90.0,0.0,0.0
2049,Felix Passlack,GER,DF,Dortmund,Bundesliga,24,1998,0.7,4,3,0,4,0,1,1,100.0,0,1,1,0,0,4,1,0,0,2022-2023,90.0,0.0,514.2857142857143
2050,Javier Pastore,ARG,MF,Elche,La Liga,33,1989,0.1,0,0,0,0,0,0,0,0.0,0,0,0,0,0,0,0,0,0,2022-2023,90.0,0.0,0.0
Rk,Player,Nation,Pos,Squad,Comp,0,0,90.0,0,0,3,3,3,Tkl,0,0.0,0,0,0,0,0,0,0,0,0,2022-2023,90.0,0.0,0.0
2051,Patric,ESP,DF,Lazio,Serie A,29,1993,15.7,17,11,12,3,2,11,16,68.8,5,17,12,5,11,28,53,1,0,2022-2023,90.0,63.05732484076434,97.45222929936307
2052,Rui Patrício,POR,GK,Roma,Serie A,34,1988,35.0,1,1,1,0,0,1,1,100.0,0,0,0,0,2,3,6,3,0,2022-2023,90.0,5.142857142857142,2.571428571428571
2053,Nathan Patterson,SCO,"DF,MF",Everton,Premier League,20,2001,14.2,49,24,32,13,4,29,54,53.7,25,24,4,20,15,64,45,0,0,2022-2023,90.0,95.07042253521128,310.5633802816902
2054,Paulinho,BRA,FW,Leverkusen,Bundesliga,22,2000,0.9,0,0,0,0,0,0,0,0.0,0,1,0,1,0,0,2,0,0,2022-2023,90.0,0.0,0.0
2055,Gabriel Paulista,BRA,DF,Valencia,La Liga,31,1990,16.7,17,9,13,4,0,13,19,68.4,6,22,14,8,32,49,79,2,0,2022-2023,90.0,172.4550898203593,91.61676646706587
2056,Benjamin Pavard,FRA,DF,Bayern Munich,Bundesliga,26,1996,27.0,70,41,36,26,8,36,48,75.0,12,35,16,19,44,114,83,0,0,2022-2023,90.0,146.66666666666669,233.33333333333334
2057,Jiří Pavlenka,CZE,GK,Werder Bremen,Bundesliga,30,1992,32.3,1,0,1,0,0,1,5,20.0,4,1,0,1,3,4,21,1,0,2022-2023,90.0,8.359133126934985,2.7863777089783284
2058,Dimitri Payet,FRA,"MF,FW",Marseille,Ligue 1,35,1987,9.3,6,4,2,2,2,3,11,27.3,8,4,0,4,0,6,4,0,0,2022-2023,90.0,0.0,58.06451612903225
2059,Ben Pearson,ENG,MF,Bournemouth,Premier League,27,1995,3.2,7,3,3,3,1,1,3,33.3,2,4,0,4,2,9,6,0,0,2022-2023,90.0,56.25,196.875
2060,Kristian Pedersen,DEN,DF,Köln,Bundesliga,27,1994,3.1,5,4,4,1,0,0,2,0.0,2,3,0,3,6,11,17,0,0,2022-2023,90.0,174.19354838709677,145.16129032258064
2061,Mads Pedersen,DEN,"DF,MF",Augsburg,Bundesliga,25,1996,20.4,44,23,31,11,2,22,33,66.7,11,32,9,23,20,64,41,1,0,2022-2023,90.0,88.23529411764706,194.11764705882354
2062,Alfonso Pedraza,ESP,DF,Villarreal,La Liga,26,1996,18.1,35,26,20,10,5,19,29,65.5,10,19,1,18,18,53,31,0,0,2022-2023,90.0,89.50276243093921,174.0331491712707
2063,Pedri,ESP,MF,Barcelona,La Liga,19,2002,22.0,39,22,15,17,7,13,45,28.9,32,27,0,27,13,52,8,1,0,2022-2023,90.0,53.18181818181819,159.54545454545456
2064,Pedro,ESP,FW,Lazio,Serie A,35,1987,21.1,35,24,14,10,11,11,30,36.7,19,18,2,16,6,41,4,1,0,2022-2023,90.0,25.592417061611375,149.28909952606634
2065,Adrià Pedrosa,ESP,"DF,MF",Espanyol,La Liga,24,1998,2.5,5,1,5,0,0,4,7,57.1,3,1,1,0,5,10,3,0,0,2022-2023,90.0,180.0,180.0
2066,Jordan Pefok,USA,FW,Union Berlin,Bundesliga,26,1996,15.1,15,7,3,4,8,2,17,11.8,15,17,5,12,4,19,15,0,0,2022-2023,90.0,23.841059602649008,89.40397350993378
2067,Gianluca Pegolo,ITA,GK,Sassuolo,Serie A,41,1981,2.0,0,0,0,0,0,0,1,0.0,1,0,0,0,0,0,1,0,0,2022-2023,90.0,0.0,0.0
2068,Dženan Pejčinović,GER,FW,Wolfsburg,Bundesliga,17,2005,0.1,0,0,0,0,0,0,0,0.0,0,0,0,0,0,0,0,0,0,2022-2023,90.0,0.0,0.0
2069,Peter Pekarík,SVK,DF,Hertha BSC,Bundesliga,35,1986,2.3,4,3,4,0,0,4,6,66.7,2,6,2,4,4,8,7,0,0,2022-2023,90.0,156.52173913043478,156.52173913043478
2070,Pietro Pellegri,ITA,FW,Torino,Serie A,21,2001,5.2,6,2,1,3,2,2,3,66.7,1,5,1,4,0,6,4,0,0,2022-2023,90.0,0.0,103.84615384615384
2071,Lorenzo Pellegrini,ITA,MF,Roma,Serie A,26,1996,28.3,52,29,24,24,4,22,48,45.8,26,27,4,23,26,78,22,0,0,2022-2023,90.0,82.68551236749116,165.3710247349823
2072,Luca Pellegrini,ITA,DF,Lazio,Serie A,23,1999,2.0,1,0,0,1,0,1,4,25.0,3,3,0,3,7,8,4,0,0,2022-2023,90.0,315.0,45.0
2073,Luca Pellegrini,ITA,DF,Eint Frankfurt,Bundesliga,23,1999,6.2,13,8,10,3,0,8,8,100.0,0,8,2,6,7,20,11,1,0,2022-2023,90.0,101.61290322580645,188.70967741935485
2074,Théo Pellenard,FRA,DF,Auxerre,Ligue 1,28,1994,1.1,1,0,1,0,0,1,1,100.0,0,3,1,2,2,3,2,0,0,2022-2023,90.0,163.63636363636363,81.81818181818181
2075,Facundo Pellistri,URU,"FW,MF",Manchester Utd,Premier League,20,2001,0.7,1,1,0,1,0,0,0,0.0,0,0,0,0,0,1,3,0,0,2022-2023,90.0,0.0,128.57142857142858
Rk,Player,Nation,Pos,Squad,Comp,0,0,90.0,0,0,3,3,3,Tkl,0,0.0,0,0,0,0,0,0,0,0,0,2022-2023,90.0,0.0,0.0
2076,Timothee Pembele,FRA,DF,Paris S-G,Ligue 1,19,2002,2.9,5,5,3,1,1,2,4,50.0,2,2,0,2,4,9,2,0,0,2022-2023,90.0,124.13793103448276,155.17241379310346
2077,Iñaki Peña,ESP,GK,Barcelona,La Liga,23,1999,0.8,0,0,0,0,0,0,0,0.0,0,0,0,0,0,0,0,1,0,2022-2023,90.0,0.0,0.0
2078,Rubén Peña,ESP,"DF,MF",Osasuna,La Liga,31,1991,14.2,32,18,10,18,4,20,41,48.8,21,23,8,15,17,49,31,0,0,2022-2023,90.0,107.74647887323944,202.81690140845072
2079,Patrick Pentz,AUT,GK,Reims,Ligue 1,25,1997,7.0,0,0,0,0,0,0,0,0.0,0,0,0,0,0,0,1,0,0,2022-2023,90.0,0.0,0.0
2080,Nicolas Pépé,CIV,"FW,MF",Nice,Ligue 1,27,1995,16.6,25,13,14,5,6,11,25,44.0,14,17,0,17,3,28,1,0,0,2022-2023,90.0,16.265060240963855,135.5421686746988
2081,Ricardo Pepi,USA,FW,Augsburg,Bundesliga,19,2003,1.1,1,1,1,0,0,1,1,100.0,0,1,0,1,0,1,1,0,0,2022-2023,90.0,0.0,81.81818181818181
2082,Pepín,EQG,MF,Monza,Serie A,25,1996,12.5,28,19,10,11,7,9,27,33.3,18,14,3,11,13,41,17,0,0,2022-2023,90.0,93.6,201.6
2083,Alberto Perea,ESP,MF,Cádiz,La Liga,31,1990,0.5,2,0,2,0,0,0,0,0.0,0,2,0,2,0,2,0,0,0,2022-2023,90.0,0.0,360.0
2084,Juan Perea,COL,FW,Stuttgart,Bundesliga,22,2000,4.6,5,4,0,2,3,2,4,50.0,2,2,1,1,1,6,3,0,0,2022-2023,90.0,19.565217391304348,97.82608695652175
2085,Andreas Pereira,BRA,MF,Fulham,Premier League,26,1996,29.9,18,9,3,6,9,8,34,23.5,26,21,3,18,6,24,8,0,0,2022-2023,90.0,18.06020066889632,54.180602006688964
2086,Brayann Pereira,FRA,DF,Auxerre,Ligue 1,19,2003,2.0,6,5,5,1,0,1,5,20.0,4,2,2,0,2,8,8,1,0,2022-2023,90.0,90.0,270.0
2087,Danilo Pereira,POR,"DF,MF",Paris S-G,Ligue 1,30,1991,26.8,32,17,15,14,3,19,26,73.1,7,26,19,7,36,68,59,1,0,2022-2023,90.0,120.89552238805969,107.46268656716417
2088,Mathias Pereira Lage,POR,"MF,FW",Brest,Ligue 1,25,1996,14.0,20,7,5,14,1,11,29,37.9,18,10,1,9,14,34,12,0,0,2022-2023,90.0,90.0,128.57142857142856
2089,Ricardo Pereira,POR,"DF,MF",Leicester City,Premier League,28,1993,5.0,11,7,8,3,0,7,17,41.2,10,8,2,6,4,15,20,0,0,2022-2023,90.0,72.0,198.0
2090,Roberto Pereyra,ARG,"DF,MF",Udinese,Serie A,31,1991,31.3,36,20,21,12,3,16,44,36.4,28,20,5,15,16,52,28,0,0,2022-2023,90.0,46.00638977635783,103.51437699680511
2091,Ayoze Pérez,ESP,"MF,FW",Leicester City,Premier League,29,1993,4.2,11,8,5,4,2,8,19,42.1,11,6,0,6,2,13,3,0,0,2022-2023,90.0,42.857142857142854,235.7142857142857
2092,Ayoze Pérez,ESP,"FW,MF",Betis,La Liga,29,1993,15.4,31,15,9,16,6,10,40,25.0,30,22,0,22,13,44,5,0,0,2022-2023,90.0,75.97402597402598,181.1688311688312
2093,Carles Pérez,ESP,"MF,FW",Celta Vigo,La Liga,24,1998,23.8,39,23,12,17,10,22,66,33.3,44,29,3,26,6,45,9,0,0,2022-2023,90.00000000000001,22.689075630252102,147.47899159663868
2094,Francisco Perez,ESP,"FW,MF",Valencia,La Liga,19,2002,1.6,1,1,1,0,0,0,3,0.0,3,0,0,0,0,1,1,0,0,2022-2023,90.0,0.0,56.25
2095,Kike Pérez,ESP,MF,Valladolid,La Liga,25,1997,25.6,67,33,30,32,5,25,68,36.8,43,26,7,19,20,87,28,0,0,2022-2023,90.0,70.3125,235.546875
2096,Lucas Pérez,ESP,FW,Cádiz,La Liga,33,1988,7.0,3,2,2,1,0,1,3,33.3,2,2,0,2,1,4,3,0,0,2022-2023,90.0,12.857142857142858,38.57142857142857
2097,Luis Pérez,ESP,DF,Valladolid,La Liga,27,1995,13.5,44,24,26,12,6,27,38,71.1,11,13,4,9,16,60,29,0,0,2022-2023,90.0,106.66666666666667,293.33333333333337
2098,Nehuén Pérez,ARG,DF,Udinese,Serie A,22,2000,31.3,77,40,54,20,3,39,55,70.9,16,53,23,30,35,112,106,1,0,2022-2023,90.0,100.63897763578274,221.40575079872204
2099,Simone Perilli,ITA,GK,Hellas Verona,Serie A,27,1995,1.0,0,0,0,0,0,0,0,0.0,0,0,0,0,0,0,0,0,0,2022-2023,90.0,0.0,0.0
2100,Mattia Perin,ITA,GK,Juventus,Serie A,29,1992,10.5,0,0,0,0,0,0,0,0.0,0,0,0,0,0,0,0,0,0,2022-2023,90.0,0.0,0.0
Rk,Player,Nation,Pos,Squad,Comp,0,0,90.0,0,0,3,3,3,Tkl,0,0.0,0,0,0,0,0,0,0,0,0,2022-2023,90.0,0.0,0.0
2101,Samuele Perisan,ITA,GK,Empoli,Serie A,24,1997,7.0,0,0,0,0,0,0,0,0.0,0,0,0,0,0,0,2,0,0,2022-2023,90.0,0.0,0.0
2102,Ivan Perišić,CRO,"DF,MF",Tottenham,Premier League,33,1989,23.4,42,24,25,10,7,27,47,57.4,20,29,7,22,22,64,49,1,0,2022-2023,89.99999999999999,84.61538461538461,161.53846153846152
2103,Romain Perraud,FRA,DF,Southampton,Premier League,24,1997,20.4,54,33,23,23,8,28,52,53.8,24,24,6,18,20,74,42,0,0,2022-2023,90.0,88.23529411764706,238.23529411764707
2104,Gaëtan Perrin,FRA,"MF,FW",Auxerre,Ligue 1,26,1996,15.5,17,8,5,6,6,8,30,26.7,22,15,0,15,10,27,9,0,0,2022-2023,90.0,58.064516129032256,98.70967741935483
2105,Lucas Perrin,FRA,DF,Strasbourg,Ligue 1,23,1998,19.6,44,27,28,14,2,25,49,51.0,24,13,5,8,36,80,53,0,0,2022-2023,90.0,165.30612244897958,202.0408163265306
2106,Máximo Perrone,ARG,MF,Manchester City,Premier League,19,2003,0.2,0,0,0,0,0,0,0,0.0,0,1,0,1,0,0,0,0,0,2022-2023,90.0,0.0,0.0
2107,Matteo Pessina,ITA,MF,Monza,Serie A,25,1997,32.6,57,36,28,21,8,26,62,41.9,36,50,15,35,37,94,33,1,0,2022-2023,90.0,102.14723926380368,157.36196319018404
2108,Andrea Petagna,ITA,FW,Monza,Serie A,27,1995,18.5,7,5,2,3,2,3,6,50.0,3,16,4,12,3,10,18,0,0,2022-2023,90.0,14.594594594594595,34.054054054054056
2109,Nils Petersen,GER,FW,Freiburg,Bundesliga,33,1988,3.1,6,4,0,3,3,2,5,40.0,3,11,2,9,1,7,6,0,0,2022-2023,90.0,29.032258064516128,174.19354838709677
2110,Lukas Petkov,BUL,"MF,FW",Augsburg,Bundesliga,21,2000,1.6,5,1,4,1,0,2,3,66.7,1,4,1,3,1,6,0,0,0,2022-2023,90.0,56.25,281.25
2111,Cameron Peupion,AUS,MF,Brighton,Premier League,19,2002,0.1,0,0,0,0,0,0,0,0.0,0,0,0,0,0,0,0,0,0,2022-2023,90.0,0.0,0.0
2112,Germán Pezzella,ARG,DF,Betis,La Liga,31,1991,27.9,41,28,32,9,0,26,38,68.4,12,32,15,17,50,91,129,1,0,2022-2023,90.0,161.29032258064515,132.25806451612902
2113,Giuseppe Pezzella,ITA,DF,Lecce,Serie A,24,1997,10.2,21,9,16,2,3,9,16,56.3,7,11,3,8,8,29,31,1,0,2022-2023,90.0,70.58823529411765,185.29411764705884
2114,Luca Pfeiffer,GER,FW,Stuttgart,Bundesliga,25,1996,7.8,1,1,1,0,0,0,1,0.0,1,4,0,4,1,2,5,0,0,2022-2023,90.0,11.538461538461538,11.538461538461538
2115,Maximilian Philipp,GER,FW,Wolfsburg,Bundesliga,28,1994,1.3,2,1,1,1,0,1,1,100.0,0,1,0,1,0,2,0,0,0,2022-2023,90.0,0.0,138.46153846153845
2116,Maximilian Philipp,GER,"FW,MF",Werder Bremen,Bundesliga,28,1994,4.9,6,5,3,2,1,1,9,11.1,8,7,1,6,3,9,4,0,0,2022-2023,90.0,55.10204081632653,110.20408163265306
2117,Kalvin Phillips,ENG,MF,Manchester City,Premier League,26,1995,3.3,6,4,3,3,0,2,10,20.0,8,7,3,4,5,11,10,0,0,2022-2023,90.0,136.36363636363637,163.63636363636363
2118,Nathaniel Phillips,ENG,DF,Liverpool,Premier League,25,1997,0.7,2,1,0,2,0,2,2,100.0,0,0,0,0,2,4,1,0,0,2022-2023,90.0,257.14285714285717,257.14285714285717
2119,Krzysztof Piątek,POL,FW,Salernitana,Serie A,27,1995,23.8,18,11,3,9,6,5,21,23.8,16,17,4,13,2,20,39,0,0,2022-2023,90.00000000000001,7.563025210084034,68.0672268907563
2120,Roberto Piccoli,ITA,FW,Hellas Verona,Serie A,21,2001,2.1,1,0,1,0,0,0,2,0.0,2,2,0,2,0,1,2,0,0,2022-2023,90.0,0.0,42.857142857142854
2121,Roberto Piccoli,ITA,FW,Empoli,Serie A,21,2001,5.7,1,1,1,0,0,0,3,0.0,3,4,1,3,1,2,9,0,0,2022-2023,90.0,15.789473684210526,15.789473684210526
2122,Charles Pickel,COD,MF,Cremonese,Serie A,25,1997,27.6,55,23,25,26,4,32,57,56.1,25,37,5,32,24,79,36,1,0,2022-2023,90.0,78.26086956521738,179.3478260869565
2123,Jordan Pickford,ENG,GK,Everton,Premier League,28,1994,37.0,0,0,0,0,0,0,1,0.0,1,0,0,0,4,4,15,3,0,2022-2023,90.0,9.72972972972973,0.0
2124,Amos Pieper,GER,DF,Werder Bremen,Bundesliga,24,1998,21.7,46,28,25,19,2,24,40,60.0,16,23,11,12,30,76,94,1,0,2022-2023,90.0,124.42396313364056,190.78341013824885
2125,Ronaël Pierre-Gabriel,FRA,DF,Espanyol,La Liga,24,1998,2.6,17,9,12,4,1,5,11,45.5,6,5,2,3,9,26,11,0,0,2022-2023,90.0,311.5384615384615,588.4615384615385
Rk,Player,Nation,Pos,Squad,Comp,0,0,90.0,0,0,3,3,3,Tkl,0,0.0,0,0,0,0,0,0,0,0,0,2022-2023,90.0,0.0,0.0
2126,Ronaël Pierre-Gabriel,FRA,DF,Strasbourg,Ligue 1,24,1998,7.3,25,18,11,12,2,15,17,88.2,2,16,3,13,9,34,22,0,0,2022-2023,90.0,110.95890410958904,308.2191780821918
2127,Andrea Pinamonti,ITA,FW,Sassuolo,Serie A,23,1999,24.0,10,7,0,5,5,3,7,42.9,4,19,2,17,2,12,11,0,0,2022-2023,90.0,7.5,37.5
2128,Ethan Pinnock,JAM,DF,Brentford,Premier League,29,1993,30.0,52,28,33,12,7,18,24,75.0,6,41,31,10,35,87,215,2,0,2022-2023,90.0,105.0,156.0
2129,Yeremi Pino,ESP,"FW,MF",Villarreal,La Liga,19,2002,27.2,62,38,25,20,17,21,56,37.5,35,41,4,37,15,77,36,0,0,2022-2023,90.0,49.63235294117647,205.14705882352942
2130,Gerard Piqué,ESP,DF,Barcelona,La Liga,35,1987,4.3,5,4,1,4,0,4,4,100.0,0,2,1,1,2,7,19,0,0,2022-2023,90.0,41.86046511627907,104.65116279069768
2131,Lorenzo Pirola,ITA,DF,Salernitana,Serie A,20,2002,21.6,33,29,18,14,1,19,27,70.4,8,50,35,15,30,63,85,1,0,2022-2023,90.0,124.99999999999999,137.5
2132,Niccolò Pisilli,ITA,MF,Roma,Serie A,17,2004,0.0,0,0,0,0,0,0,0,0.0,0,0,0,0,0,0,0,0,0,2022-2023,,,
2133,Marko Pjaca,CRO,"MF,FW",Empoli,Serie A,27,1995,5.8,4,3,3,1,0,3,5,60.0,2,3,0,3,3,7,3,0,0,2022-2023,90.0,46.55172413793103,62.06896551724138
2134,Óscar Plano,ESP,"FW,MF",Valladolid,La Liga,31,1991,22.6,40,25,9,17,14,12,37,32.4,25,26,2,24,29,69,23,0,0,2022-2023,90.0,115.48672566371681,159.2920353982301
2135,Gonzalo Plata,ECU,FW,Valladolid,La Liga,21,2000,25.6,66,35,31,24,11,23,70,32.9,47,40,0,40,12,78,10,1,0,2022-2023,90.0,42.1875,232.03125
2136,Marvin Plattenhardt,GER,DF,Hertha BSC,Bundesliga,30,1992,26.7,43,33,24,15,4,29,47,61.7,18,25,11,14,15,58,82,0,0,2022-2023,90.00000000000001,50.56179775280899,144.9438202247191
2137,Alassane Pléa,FRA,FW,Gladbach,Bundesliga,29,1993,19.7,16,8,5,7,4,8,26,30.8,18,23,3,20,12,28,14,0,0,2022-2023,90.0,54.82233502538071,73.09644670050761
2138,Tommaso Pobega,ITA,MF,Milan,Serie A,23,1999,9.8,27,16,8,15,4,13,20,65.0,7,12,4,8,9,36,11,0,0,2022-2023,90.0,82.65306122448979,247.95918367346937
2139,Daniel Podence,POR,"FW,MF",Wolves,Premier League,26,1995,19.7,27,17,13,9,5,6,32,18.8,26,19,0,19,7,34,6,0,0,2022-2023,90.0,31.97969543147208,123.3502538071066
2140,Paul Pogba,FRA,"MF,FW",Juventus,Serie A,29,1993,1.2,0,0,0,0,0,0,1,0.0,1,0,0,0,0,0,2,0,0,2022-2023,90.0,0.0,0.0
2141,Joel Pohjanpalo,FIN,"FW,MF",Leverkusen,Bundesliga,27,1994,0.0,0,0,0,0,0,0,0,0.0,0,0,0,0,0,0,0,0,0,2022-2023,,,
2142,Matteo Politano,ITA,FW,Napoli,Serie A,28,1993,13.0,18,9,9,5,4,11,25,44.0,14,6,0,6,7,25,7,0,0,2022-2023,90.00000000000001,48.46153846153847,124.61538461538463
2143,Sebastian Polter,GER,FW,Schalke 04,Bundesliga,31,1991,7.0,4,3,0,4,0,1,4,25.0,3,4,0,4,1,5,6,0,0,2022-2023,90.0,12.857142857142858,51.42857142857143
2144,Ezequiel Ponce,ARG,"FW,MF",Elche,La Liga,25,1997,12.5,9,7,0,6,3,0,7,0.0,7,6,1,5,1,10,13,0,0,2022-2023,90.0,7.199999999999999,64.8
2145,Julien Ponceau,FRA,MF,Lorient,Ligue 1,21,2000,18.4,28,19,10,14,4,10,32,31.3,22,27,3,24,14,42,12,0,0,2022-2023,90.0,68.47826086956522,136.95652173913044
2146,Marin Pongračić,CRO,DF,Lecce,Serie A,24,1997,8.8,16,14,8,7,1,5,7,71.4,2,4,3,1,16,32,31,0,0,2022-2023,90.0,163.63636363636363,163.63636363636363
2147,Nick Pope,ENG,GK,Newcastle Utd,Premier League,30,1992,36.2,1,0,1,0,0,1,3,33.3,2,0,0,0,0,1,27,2,0,2022-2023,90.0,0.0,2.486187845303867
2148,Łukasz Poręba,POL,MF,Lens,Ligue 1,22,2000,2.9,5,4,2,1,2,2,3,66.7,1,3,0,3,4,9,2,0,0,2022-2023,90.0,124.13793103448276,155.17241379310346
2149,Jackson Porozo,ECU,DF,Troyes,Ligue 1,21,2000,18.0,32,20,24,7,1,13,31,41.9,18,24,17,7,33,65,75,0,0,2022-2023,90.0,165.0,160.0
2150,Pedro Porro,ESP,"DF,MF",Tottenham,Premier League,22,1999,12.6,25,16,8,15,2,14,39,35.9,25,25,2,23,15,40,24,1,0,2022-2023,90.0,107.14285714285715,178.57142857142858
Rk,Player,Nation,Pos,Squad,Comp,0,0,90.0,0,0,3,3,3,Tkl,0,0.0,0,0,0,0,0,0,0,0,0,2022-2023,90.0,0.0,0.0
2151,Francisco Portillo,ESP,"MF,FW",Almería,La Liga,32,1990,8.0,13,6,4,5,4,3,16,18.8,13,7,1,6,7,20,8,0,0,2022-2023,90.0,78.75,146.25
2152,Portu,ESP,"MF,DF",Getafe,La Liga,30,1992,19.7,28,21,14,10,4,18,42,42.9,24,23,3,20,17,45,20,1,0,2022-2023,90.0,77.66497461928934,127.91878172588832
2153,Stefan Posch,AUT,DF,Bologna,Serie A,25,1997,28.1,81,43,41,29,11,44,75,58.7,31,44,15,29,35,116,69,0,0,2022-2023,90.0,112.09964412811388,259.4306049822064
2154,Stefan Posch,AUT,DF,Hoffenheim,Bundesliga,25,1997,0.2,0,0,0,0,0,0,0,0.0,0,0,0,0,0,0,0,0,0,2022-2023,90.0,0.0,0.0
2155,Yussuf Poulsen,DEN,FW,RB Leipzig,Bundesliga,28,1994,4.6,6,4,1,4,1,2,5,40.0,3,3,1,2,0,6,5,0,0,2022-2023,90.0,0.0,117.3913043478261
2156,José Pozo,ESP,"MF,FW",Rayo Vallecano,La Liga,26,1996,1.0,2,2,0,2,0,0,0,0.0,0,0,0,0,1,3,1,0,0,2022-2023,90.0,90.0,180.0
2157,Manuel Pozo,ESP,FW,Valladolid,La Liga,20,2001,0.2,0,0,0,0,0,0,0,0.0,0,2,0,2,2,2,0,0,0,2022-2023,90.0,900.0,0.0
2158,Alejandro Pozo Pozo,ESP,DF,Almería,La Liga,23,1999,20.9,37,19,17,17,3,27,53,50.9,26,30,5,25,26,63,45,1,0,2022-2023,90.0,111.96172248803828,159.33014354066987
2159,Dennis Praet,BEL,"MF,FW",Leicester City,Premier League,28,1994,7.2,12,9,5,6,1,6,11,54.5,5,12,2,10,5,17,6,0,0,2022-2023,90.0,62.5,150.0
2160,Abdón Prats,ESP,"FW,MF",Mallorca,La Liga,29,1992,4.6,1,0,1,0,0,0,0,0.0,0,5,0,5,0,1,2,0,0,2022-2023,90.0,0.0,19.565217391304348
2161,Sanjin Prcić,BIH,MF,Strasbourg,Ligue 1,28,1993,18.1,27,12,6,16,5,19,31,61.3,12,22,7,15,25,52,22,0,0,2022-2023,90.0,124.30939226519335,134.25414364640883
2162,Isaac Price,NIR,MF,Everton,Premier League,18,2003,0.4,0,0,0,0,0,0,1,0.0,1,1,1,0,0,0,0,0,0,2022-2023,90.0,0.0,0.0
2163,Grischa Prömel,GER,MF,Hoffenheim,Bundesliga,27,1995,16.2,27,19,14,11,2,9,25,36.0,16,22,4,18,8,35,23,0,0,2022-2023,90.0,44.44444444444444,150.0
2164,Ivan Provedel,ITA,GK,Lazio,Serie A,28,1994,37.9,1,0,1,0,0,0,0,0.0,0,0,0,0,0,1,15,1,0,2022-2023,90.0,0.0,2.37467018469657
2165,Javi Puado,ESP,"FW,MF",Espanyol,La Liga,24,1998,26.0,20,11,12,5,3,12,28,42.9,16,12,2,10,10,30,14,0,0,2022-2023,90.00000000000001,34.61538461538462,69.23076923076924
2166,Mehdi Puch-Herrantz,FRA,MF,Ajaccio,Ligue 1,18,2004,0.5,2,2,0,1,1,1,2,50.0,1,1,0,1,3,5,0,0,0,2022-2023,90.0,540.0,360.0
2167,Tymoteusz Puchacz,POL,DF,Union Berlin,Bundesliga,23,1999,0.6,1,0,1,0,0,0,0,0.0,0,0,0,0,0,1,1,0,0,2022-2023,90.0,0.0,150.0
2168,Arnau Puigmal,ESP,"MF,FW",Almería,La Liga,21,2001,8.5,22,14,10,7,5,12,17,70.6,5,7,0,7,11,33,6,0,0,2022-2023,90.0,116.47058823529412,232.94117647058823
2169,Christian Pulisic,USA,"FW,DF",Chelsea,Premier League,23,1998,9.1,11,6,3,6,2,3,5,60.0,2,8,1,7,4,15,4,0,0,2022-2023,90.0,39.56043956043956,108.79120879120879
2170,Ignacio Pussetto,ARG,"MF,DF",Sampdoria,Serie A,26,1995,1.7,6,3,2,3,1,3,4,75.0,1,4,0,4,0,6,3,0,0,2022-2023,90.0,0.0,317.6470588235294
2171,Niklas Pyyhtiä,FIN,MF,Bologna,Serie A,18,2003,1.2,1,0,0,1,0,0,1,0.0,1,1,1,0,1,2,4,0,0,2022-2023,90.0,75.0,75.0
2172,Fabio Quagliarella,ITA,FW,Sampdoria,Serie A,39,1983,8.9,2,1,1,1,0,1,7,14.3,6,5,1,4,0,2,9,0,0,2022-2023,90.0,0.0,20.224719101123597
2173,Giacomo Quagliata,ITA,DF,Cremonese,Serie A,22,2000,7.8,10,8,7,1,2,5,11,45.5,6,7,2,5,11,21,8,0,0,2022-2023,90.0,126.92307692307692,115.38461538461539
2174,Eduardo Quaresma,POR,DF,Hoffenheim,Bundesliga,20,2002,1.0,5,3,3,2,0,1,3,33.3,2,3,2,1,0,5,3,0,0,2022-2023,90.0,0.0,450.0
2175,Joshua Quarshie,GER,MF,Hoffenheim,Bundesliga,18,2004,0.0,0,0,0,0,0,0,0,0.0,0,0,0,0,0,0,0,0,0,2022-2023,,,
Rk,Player,Nation,Pos,Squad,Comp,0,0,90.0,0,0,3,3,3,Tkl,0,0.0,0,0,0,0,0,0,0,0,0,2022-2023,90.0,0.0,0.0
2176,Ghjuvanni Quilichini,FRA,GK,Ajaccio,Ligue 1,19,2002,0.9,0,0,0,0,0,0,0,0.0,0,0,0,0,0,0,1,0,0,2022-2023,90.0,0.0,0.0
2177,Domingos Quina,POR,MF,Elche,La Liga,22,1999,3.1,3,2,2,1,0,1,3,33.3,2,5,0,5,3,6,1,0,0,2022-2023,90.0,87.09677419354838,87.09677419354838
2178,Rubén Quintanilla,ESP,DF,Mallorca,La Liga,20,2002,0.0,0,0,0,0,0,0,0,0.0,0,1,0,1,0,0,0,0,0,2022-2023,,,
2179,Adrien Rabiot,FRA,MF,Juventus,Serie A,27,1995,30.5,65,35,31,23,11,30,57,52.6,27,37,7,30,26,91,44,1,0,2022-2023,90.0,76.72131147540983,191.80327868852459
2180,Nemanja Radonjić,SRB,"MF,FW",Torino,Serie A,26,1996,16.2,2,1,2,0,0,0,4,0.0,4,3,0,3,2,4,4,0,0,2022-2023,90.0,11.11111111111111,11.11111111111111
2181,Ivan Radovanović,SRB,"MF,DF",Salernitana,Serie A,33,1988,7.5,12,4,8,4,0,4,10,40.0,6,9,3,6,7,19,9,1,0,2022-2023,90.0,84.0,144.0
2182,Ionuț Radu,ROU,GK,Cremonese,Serie A,25,1997,9.0,0,0,0,0,0,0,0,0.0,0,0,0,0,0,0,1,3,0,2022-2023,90.0,0.0,0.0
2183,Ionuț Radu,ROU,GK,Auxerre,Ligue 1,25,1997,17.0,0,0,0,0,0,0,0,0.0,0,0,0,0,0,0,3,3,0,2022-2023,90.0,0.0,0.0
2184,Ștefan Radu,ROU,FW,Lazio,Serie A,35,1986,0.0,0,0,0,0,0,0,0,0.0,0,0,0,0,0,0,0,0,0,2022-2023,,,
2185,Antonio Raillo,ESP,DF,Mallorca,La Liga,30,1991,30.7,34,21,23,11,0,10,15,66.7,5,38,29,9,31,65,158,1,0,2022-2023,90.0,90.87947882736157,99.6742671009772
2186,Antonio Raimondo,ITA,FW,Bologna,Serie A,18,2004,0.2,0,0,0,0,0,0,0,0.0,0,0,0,0,0,0,1,0,0,2022-2023,90.0,0.0,0.0
2187,Predrag Rajković,SRB,GK,Mallorca,La Liga,26,1995,36.0,0,0,0,0,0,0,2,0.0,2,0,0,0,0,0,16,1,0,2022-2023,90.0,0.0,0.0
2188,Ivan Rakitić,CRO,MF,Sevilla,La Liga,34,1988,19.9,37,26,10,18,9,19,40,47.5,21,21,1,20,27,64,20,0,0,2022-2023,90.0,122.1105527638191,167.33668341708545
2189,Diant Ramaj,GER,GK,Eint Frankfurt,Bundesliga,20,2001,1.0,0,0,0,0,0,0,0,0.0,0,0,0,0,0,0,1,0,0,2022-2023,90.0,0.0,0.0
2190,Largie Ramazani,BEL,"FW,MF",Almería,La Liga,21,2001,15.6,15,9,6,3,6,8,27,29.6,19,11,0,11,15,30,10,0,0,2022-2023,90.0,86.53846153846153,86.53846153846153
2191,Simon Ramet,FRA,DF,Lille,Ligue 1,19,2003,0.0,0,0,0,0,0,0,0,0.0,0,0,0,0,0,0,0,0,0,2022-2023,,,
2192,Adil Rami,FRA,DF,Troyes,Ligue 1,36,1985,17.7,19,14,13,5,1,17,32,53.1,15,23,16,7,25,44,75,3,0,2022-2023,90.0,127.11864406779662,96.61016949152543
2193,Chris Ramos,ESP,FW,Cádiz,La Liga,25,1997,7.9,12,9,2,7,3,4,11,36.4,7,8,3,5,1,13,19,0,0,2022-2023,90.0,11.392405063291138,136.70886075949366
2194,Sergio Ramos,ESP,DF,Paris S-G,Ligue 1,36,1986,30.0,34,26,14,18,2,23,44,52.3,21,29,13,16,34,68,93,3,0,2022-2023,90.0,102.0,102.0
2195,Aaron Ramsdale,ENG,GK,Arsenal,Premier League,24,1998,38.0,1,1,1,0,0,1,1,100.0,0,0,0,0,0,1,20,6,0,2022-2023,90.0,0.0,2.3684210526315788
2196,Aaron Ramsey,WAL,MF,Nice,Ligue 1,31,1990,17.6,47,25,18,19,10,16,39,41.0,23,25,4,21,17,64,18,1,0,2022-2023,90.0,86.93181818181817,240.34090909090907
2197,Jacob Ramsey,ENG,"MF,FW",Aston Villa,Premier League,21,2001,29.3,69,39,23,35,11,32,69,46.4,37,48,8,40,23,92,34,0,0,2022-2023,90.0,70.64846416382252,211.94539249146757
2198,Luca Ranieri,ITA,DF,Fiorentina,Serie A,23,1999,5.6,9,4,6,3,0,6,9,66.7,3,5,3,2,11,20,15,1,0,2022-2023,90.0,176.78571428571428,144.64285714285714
2199,Andrea Ranocchia,ITA,DF,Monza,Serie A,34,1988,0.5,3,1,1,2,0,3,4,75.0,1,5,5,0,0,3,7,0,0,2022-2023,90.0,0.0,540.0
2200,Filippo Ranocchia,ITA,MF,Monza,Serie A,21,2001,5.9,11,6,5,4,2,4,12,33.3,8,5,1,4,4,15,7,0,0,2022-2023,90.0,61.01694915254237,167.79661016949152
Rk,Player,Nation,Pos,Squad,Comp,0,0,90.0,0,0,3,3,3,Tkl,0,0.0,0,0,0,0,0,0,0,0,0,2022-2023,90.0,0.0,0.0
2201,Lilian Raolisoa,FRA,"DF,MF",Angers,Ligue 1,22,2000,1.9,11,9,6,3,2,7,10,70.0,3,3,1,2,3,14,5,0,0,2022-2023,90.0,142.10526315789474,521.0526315789474
2202,Raphinha,BRA,FW,Barcelona,La Liga,25,1996,23.0,29,19,10,7,12,11,31,35.5,20,33,1,32,14,43,11,1,0,2022-2023,90.0,54.78260869565218,113.47826086956523
2203,Nicolai Rapp,GER,"MF,DF",Werder Bremen,Bundesliga,25,1996,0.8,3,1,3,0,0,0,3,0.0,3,0,0,0,0,3,1,0,0,2022-2023,90.0,0.0,337.5
2204,Elba Rashani,KVX,"MF,FW",Clermont Foot,Ligue 1,29,1993,24.0,39,26,13,19,7,13,39,33.3,26,27,2,25,21,60,19,0,0,2022-2023,90.0,78.75,146.25
2205,Marcus Rashford,ENG,FW,Manchester Utd,Premier League,24,1997,32.0,20,10,7,8,5,9,24,37.5,15,31,4,27,7,27,14,0,0,2022-2023,90.0,19.6875,56.25
2206,Giacomo Raspadori,ITA,FW,Sassuolo,Serie A,22,2000,0.5,0,0,0,0,0,0,0,0.0,0,0,0,0,0,0,0,0,0,2022-2023,90.0,0.0,0.0
2207,Giacomo Raspadori,ITA,"FW,MF",Napoli,Serie A,22,2000,10.1,10,8,0,6,4,4,10,40.0,6,9,0,9,4,14,4,0,0,2022-2023,90.0,35.64356435643565,89.10891089108911
2208,Rafael Ratão,BRA,"FW,MF",Toulouse,Ligue 1,26,1995,20.6,52,36,29,16,7,27,73,37.0,46,34,0,34,21,73,7,0,0,2022-2023,90.0,91.74757281553399,227.18446601941747
2209,David Raum,GER,"DF,MF",RB Leipzig,Bundesliga,24,1998,18.7,39,25,23,12,4,17,29,58.6,12,24,6,18,16,55,26,1,0,2022-2023,90.0,77.00534759358288,187.70053475935828
2210,Nicola Ravaglia,ITA,GK,Sampdoria,Serie A,33,1988,9.0,0,0,0,0,0,0,1,0.0,1,0,0,0,0,0,7,0,0,2022-2023,90.0,0.0,0.0
2211,Rayan Raveloson,MAD,"DF,MF",Auxerre,Ligue 1,25,1997,27.0,38,23,21,16,1,23,33,69.7,10,43,12,31,39,77,70,0,0,2022-2023,90.0,130.0,126.66666666666667
2212,David Raya,ESP,GK,Brentford,Premier League,26,1995,38.0,0,0,0,0,0,0,2,0.0,2,1,0,1,1,1,10,3,0,2022-2023,90.0,2.3684210526315788,0.0
2213,Tim Ream,USA,DF,Fulham,Premier League,34,1987,32.2,30,16,15,12,3,13,26,50.0,13,45,24,21,41,71,116,3,0,2022-2023,90.0,114.59627329192546,83.85093167701862
2214,Ante Rebić,CRO,"FW,MF",Milan,Serie A,28,1993,10.9,10,8,1,3,6,3,11,27.3,8,6,1,5,1,11,5,0,0,2022-2023,90.0,8.256880733944953,82.56880733944953
2215,Arkadiusz Reca,POL,DF,Spezia,Serie A,27,1995,24.1,44,28,22,12,10,19,32,59.4,13,21,5,16,24,68,54,0,0,2022-2023,90.0,89.6265560165975,164.31535269709542
2216,Nathan Redmond,ENG,DF,Southampton,Premier League,28,1994,0.0,0,0,0,0,0,0,0,0.0,0,0,0,0,0,0,0,0,0,2022-2023,,,
2217,Harrison Reed,ENG,MF,Fulham,Premier League,27,1995,31.8,44,27,17,21,6,16,51,31.4,35,54,12,42,19,63,36,0,0,2022-2023,90.0,53.77358490566038,124.52830188679245
2218,Sergio Reguilón,ESP,DF,Atlético Madrid,La Liga,25,1996,3.4,7,5,5,2,0,5,7,71.4,2,3,0,3,2,9,4,0,0,2022-2023,90.0,52.94117647058823,185.2941176470588
2219,Bobby Reid,JAM,"FW,DF",Fulham,Premier League,29,1993,27.5,42,24,14,14,14,16,36,44.4,20,25,3,22,20,62,28,1,0,2022-2023,89.99999999999999,65.45454545454545,137.45454545454544
2220,Pepe Reina,ESP,GK,Villarreal,La Liga,39,1982,22.0,0,0,0,0,0,0,1,0.0,1,0,0,0,1,1,4,4,0,2022-2023,90.0,4.090909090909091,0.0
2221,Jeff Reine-Adélaïde,FRA,MF,Troyes,Ligue 1,24,1998,2.6,3,2,2,1,0,1,2,50.0,1,2,0,2,2,5,1,0,0,2022-2023,90.0,69.23076923076923,103.84615384615384
2222,Jeff Reine-Adélaïde,FRA,MF,Lyon,Ligue 1,24,1998,3.7,8,5,1,5,2,5,9,55.6,4,4,0,4,6,14,0,0,0,2022-2023,90.0,145.94594594594594,194.59459459459458
2223,Reinier,BRA,"MF,FW",Girona,La Liga,20,2002,7.2,12,10,7,3,2,2,8,25.0,6,6,0,6,5,17,4,0,0,2022-2023,90.0,62.5,150.0
2224,Rocco Reitz,GER,MF,Gladbach,Bundesliga,20,2002,0.0,0,0,0,0,0,0,0,0.0,0,0,0,0,0,0,0,0,0,2022-2023,,,
2225,Karim Rekik,NED,DF,Sevilla,La Liga,27,1994,13.1,11,5,8,3,0,4,5,80.0,1,12,5,7,10,21,24,0,0,2022-2023,90.0,68.70229007633588,75.57251908396947
Rk,Player,Nation,Pos,Squad,Comp,0,0,90.0,0,0,3,3,3,Tkl,0,0.0,0,0,0,0,0,0,0,0,0,2022-2023,90.0,0.0,0.0
2226,Álex Remiro,ESP,GK,Real Sociedad,La Liga,27,1995,38.0,1,1,1,0,0,1,3,33.3,2,0,0,0,0,1,17,3,0,2022-2023,90.0,0.0,2.3684210526315788
2227,Panagiotis Retsos,GRE,DF,Hellas Verona,Serie A,23,1998,1.4,5,4,2,2,1,3,3,100.0,0,4,1,3,2,7,3,0,0,2022-2023,90.0,128.57142857142858,321.42857142857144
2228,Marco Reus,GER,"MF,FW",Dortmund,Bundesliga,33,1989,15.0,30,17,12,14,4,7,24,29.2,17,12,4,8,8,38,8,0,0,2022-2023,90.0,48.0,180.0
2229,Alejandro Revuelta Montero,ESP,DF,Getafe,La Liga,22,2000,0.0,0,0,0,0,0,0,0,0.0,0,0,0,0,0,0,1,0,0,2022-2023,,,
2230,Elvis Rexhbeçaj,GER,MF,Augsburg,Bundesliga,24,1997,28.0,51,30,18,24,9,29,59,49.2,30,39,12,27,17,68,40,0,0,2022-2023,90.0,54.64285714285714,163.92857142857142
2231,Gio Reyna,USA,"FW,MF",Dortmund,Bundesliga,19,2002,6.9,14,7,2,5,7,5,10,50.0,5,8,2,6,3,17,5,0,0,2022-2023,90.0,39.13043478260869,182.6086956521739
2232,Chadi Riad,MAR,MF,Barcelona,La Liga,19,2003,0.0,0,0,0,0,0,0,0,0.0,0,0,0,0,0,0,0,0,0,2022-2023,,,
2233,Nico Ribaudo,ESP,"MF,FW",Espanyol,La Liga,21,2001,13.9,18,13,5,9,4,11,30,36.7,19,19,1,18,5,23,1,0,0,2022-2023,90.0,32.37410071942446,116.54676258992806
2234,Alexsandro Ribeiro,BRA,DF,Lille,Ligue 1,22,1999,17.9,32,18,24,7,1,19,28,67.9,9,11,2,9,25,57,59,1,0,2022-2023,90.0,125.69832402234638,160.89385474860336
2235,Franck Ribéry,FRA,MF,Salernitana,Serie A,39,1983,0.4,0,0,0,0,0,0,0,0.0,0,1,0,1,0,0,0,0,0,2022-2023,90.0,0.0,0.0
2236,Samuele Ricci,ITA,MF,Torino,Serie A,20,2001,23.0,32,21,17,10,5,18,23,78.3,5,20,5,15,17,49,29,1,0,2022-2023,90.0,66.52173913043478,125.21739130434784
2237,Declan Rice,ENG,MF,West Ham,Premier League,23,1999,36.4,79,38,44,31,4,31,50,62.0,19,45,15,30,63,142,58,0,0,2022-2023,90.0,155.76923076923077,195.32967032967034
2238,Chris Richards,USA,DF,Crystal Palace,Premier League,22,2000,5.0,9,6,8,1,0,5,7,71.4,2,10,1,9,8,17,31,0,0,2022-2023,90.0,144.0,162.0
2239,Richarlison,BRA,"MF,FW",Tottenham,Premier League,25,1997,11.2,21,16,13,5,3,12,27,44.4,15,14,1,13,5,26,10,0,0,2022-2023,90.0,40.17857142857143,168.75
2240,Marco Richter,GER,"MF,FW",Hertha BSC,Bundesliga,24,1997,20.4,43,23,18,17,8,19,48,39.6,29,29,2,27,24,67,25,0,0,2022-2023,90.0,105.88235294117648,189.7058823529412
2241,Diego Rico,ESP,DF,Real Sociedad,La Liga,29,1993,18.3,35,21,17,11,7,12,27,44.4,15,18,5,13,20,55,51,1,0,2022-2023,90.0,98.36065573770492,172.1311475409836
2242,Jaïro Riedewald,NED,"DF,MF",Crystal Palace,Premier League,25,1996,0.7,2,1,2,0,0,0,1,0.0,1,2,0,2,0,2,4,0,0,2022-2023,90.0,0.0,257.14285714285717
2243,Manuel Riemann,GER,GK,Bochum,Bundesliga,33,1988,34.0,3,2,3,0,0,3,5,60.0,2,1,0,1,5,8,23,7,0,2022-2023,90.0,13.23529411764706,7.9411764705882355
2244,Tomás Rincón,VEN,MF,Sampdoria,Serie A,34,1988,28.4,56,27,22,26,8,29,61,47.5,32,37,7,30,30,86,18,0,0,2022-2023,90.0,95.07042253521128,177.46478873239437
2245,Rémy Riou,FRA,GK,Lyon,Ligue 1,34,1987,6.7,1,0,1,0,0,1,1,100.0,0,0,0,0,0,1,3,0,0,2022-2023,90.0,0.0,13.432835820895521
2246,Renaud Ripart,FRA,"FW,MF",Troyes,Ligue 1,29,1993,14.7,40,23,14,20,6,19,52,36.5,33,29,2,27,7,47,5,0,0,2022-2023,90.0,42.85714285714286,244.89795918367346
2247,Rodrigo Riquelme,ESP,"MF,FW",Girona,La Liga,22,2000,24.2,20,8,8,8,4,9,35,25.7,26,16,0,16,11,31,5,0,0,2022-2023,90.0,40.90909090909091,74.3801652892562
2248,Matt Ritchie,SCO,"FW,MF",Newcastle Utd,Premier League,32,1989,0.4,1,1,0,1,0,1,3,33.3,2,0,0,0,1,2,0,0,0,2022-2023,90.0,225.0,225.0
2249,Sergi Roberto,ESP,"DF,MF",Barcelona,La Liga,30,1992,14.5,22,15,12,6,4,7,18,38.9,11,15,7,8,11,33,16,0,0,2022-2023,90.0,68.27586206896551,136.55172413793102
2250,Lucas Robertone,ARG,MF,Almería,La Liga,25,1997,31.6,50,28,20,21,9,28,64,43.8,36,45,7,38,46,96,46,1,0,2022-2023,90.0,131.01265822784808,142.40506329113921
Rk,Player,Nation,Pos,Squad,Comp,0,0,90.0,0,0,3,3,3,Tkl,0,0.0,0,0,0,0,0,0,0,0,0,2022-2023,90.0,0.0,0.0
2251,Andrew Robertson,SCO,DF,Liverpool,Premier League,28,1994,28.7,38,21,12,16,10,21,41,51.2,20,32,5,27,18,56,50,3,0,2022-2023,90.0,56.44599303135889,119.1637630662021
2252,Antonee Robinson,USA,DF,Fulham,Premier League,24,1997,34.3,62,38,43,15,4,44,65,67.7,21,49,13,36,53,115,83,3,0,2022-2023,90.0,139.06705539358603,162.68221574344025
2253,Joel Robles,ESP,GK,Leeds United,Premier League,32,1990,4.0,0,0,0,0,0,0,1,0.0,1,0,0,0,0,0,2,1,0,2022-2023,90.0,0.0,0.0
2254,Joel Roca,ESP,"MF,FW",Girona,La Liga,17,2005,0.9,2,2,2,0,0,2,5,40.0,3,1,1,0,0,2,1,0,0,2022-2023,90.0,0.0,200.0
2255,Marc Roca,ESP,MF,Leeds United,Premier League,25,1996,25.7,66,40,27,34,5,20,65,30.8,45,34,10,24,23,89,24,2,0,2022-2023,90.0,80.54474708171206,231.1284046692607
2256,Enzo Roco,CHI,DF,Elche,La Liga,29,1992,18.4,33,13,23,10,0,15,24,62.5,9,22,15,7,17,50,63,1,0,2022-2023,90.0,83.15217391304348,161.41304347826087
2257,Marek Rodák,SVK,GK,Fulham,Premier League,25,1996,2.0,0,0,0,0,0,0,0,0.0,0,0,0,0,0,0,1,1,0,2022-2023,90.0,0.0,0.0
2258,Sebastian Rode,GER,MF,Eint Frankfurt,Bundesliga,31,1990,15.7,38,24,7,28,3,14,45,31.1,31,18,2,16,16,54,12,0,0,2022-2023,90.0,91.71974522292994,217.8343949044586
2259,Joe Rodon,WAL,DF,Rennes,Ligue 1,24,1997,15.7,11,7,9,2,0,4,10,40.0,6,16,12,4,9,20,54,1,0,2022-2023,90.0,51.592356687898096,63.05732484076434
2260,Rodri,ESP,MF,Manchester City,Premier League,26,1996,32.3,67,41,28,28,11,26,53,49.1,27,40,14,26,33,100,43,1,0,2022-2023,90.0,91.95046439628483,186.687306501548
2261,Rodri,ESP,"FW,MF",Betis,La Liga,22,2000,17.8,16,11,5,9,2,8,17,47.1,9,10,0,10,13,29,2,0,0,2022-2023,90.0,65.73033707865169,80.89887640449439
2262,Rodrigo,ESP,"FW,MF",Leeds United,Premier League,31,1991,21.5,24,10,2,15,7,8,19,42.1,11,16,4,12,6,30,21,1,0,2022-2023,90.0,25.11627906976744,100.46511627906976
2263,Ángel Rodríguez,ESP,"FW,MF",Mallorca,La Liga,35,1987,4.4,1,1,0,1,0,0,2,0.0,2,3,0,3,1,2,1,0,0,2022-2023,90.0,20.454545454545453,20.454545454545453
2264,Óscar Rodríguez Arnaiz,ESP,MF,Celta Vigo,La Liga,24,1998,19.7,32,25,12,15,5,13,28,46.4,15,16,2,14,24,56,15,0,0,2022-2023,90.0,109.64467005076142,146.19289340101523
2265,Dani Rodríguez,ESP,MF,Mallorca,La Liga,34,1988,23.3,42,23,18,22,2,21,46,45.7,25,31,8,23,21,63,14,0,0,2022-2023,90.0,81.11587982832619,162.23175965665237
2266,Guido Rodríguez,ARG,MF,Betis,La Liga,28,1994,31.9,115,75,59,50,6,54,101,53.5,47,58,14,44,42,157,76,1,0,2022-2023,90.0,118.49529780564264,324.4514106583072
2267,Miguel Rodríguez,ESP,"MF,FW",Celta Vigo,La Liga,19,2003,2.8,7,5,4,3,0,4,11,36.4,7,6,0,6,1,8,3,0,0,2022-2023,90.0,32.142857142857146,225.0
2268,Pablo Rodríguez,ESP,"FW,MF",Lecce,Serie A,20,2001,0.6,2,1,2,0,0,0,2,0.0,2,3,0,3,0,2,0,0,0,2022-2023,90.0,0.0,300.0
2269,Ricardo Rodríguez,SUI,DF,Torino,Serie A,29,1992,29.7,54,33,30,17,7,28,42,66.7,14,30,15,15,38,92,61,0,0,2022-2023,90.0,115.15151515151514,163.63636363636363
2270,Rodrygo,BRA,"FW,MF",Real Madrid,La Liga,21,2001,26.4,17,10,3,7,7,4,23,17.4,19,23,0,23,8,25,5,0,0,2022-2023,90.0,27.272727272727273,57.95454545454545
2271,Mads Roerslev,DEN,DF,Brentford,Premier League,23,1999,12.3,22,12,19,3,0,16,33,48.5,17,14,5,9,9,31,38,0,0,2022-2023,89.99999999999999,65.85365853658536,160.97560975609753
2272,Agustín Rogel,URU,DF,Hertha BSC,Bundesliga,24,1997,15.8,18,9,13,5,0,11,17,64.7,6,15,8,7,11,29,74,1,0,2022-2023,90.0,62.658227848101255,102.53164556962024
2273,Rogério,BRA,DF,Sassuolo,Serie A,24,1998,33.3,37,21,22,8,7,17,35,48.6,18,32,9,23,37,74,70,0,0,2022-2023,90.0,100.0,100.0
2274,Merlin Röhl,GER,"MF,FW",Freiburg,Bundesliga,20,2002,0.6,1,0,1,0,0,0,0,0.0,0,0,0,0,0,1,1,0,0,2022-2023,90.0,0.0,150.0
2275,Tony Rölke,GER,FW,Hertha BSC,Bundesliga,19,2003,0.2,0,0,0,0,0,0,0,0.0,0,1,0,1,0,0,1,0,0,2022-2023,90.0,0.0,0.0
Rk,Player,Nation,Pos,Squad,Comp,0,0,90.0,0,0,3,3,3,Tkl,0,0.0,0,0,0,0,0,0,0,0,0,2022-2023,90.0,0.0,0.0
2276,Filippo Romagna,ITA,DF,Sassuolo,Serie A,25,1997,0.5,0,0,0,0,0,0,0,0.0,0,1,1,0,0,0,2,0,0,2022-2023,90.0,0.0,0.0
2277,Alessio Romagnoli,ITA,DF,Lazio,Serie A,27,1995,32.5,33,15,19,14,0,11,22,50.0,11,33,26,7,38,71,108,0,0,2022-2023,90.0,105.23076923076923,91.38461538461539
2278,Simone Romagnoli,ITA,DF,Lecce,Serie A,32,1990,1.9,6,5,3,3,0,2,2,100.0,0,4,1,3,1,7,11,0,0,2022-2023,90.0,47.368421052631575,284.2105263157895
2279,Leo Román,ESP,GK,Mallorca,La Liga,22,2000,1.0,0,0,0,0,0,0,0,0.0,0,0,0,0,0,0,0,0,0,2022-2023,90.0,0.0,0.0
2280,Cristian Romero,ARG,DF,Tottenham,Premier League,24,1998,26.3,68,36,42,24,2,29,46,63.0,17,40,18,22,44,112,102,3,0,2022-2023,90.0,150.5703422053232,232.69961977186313
2281,Iván Romero,ESP,MF,Sevilla,La Liga,21,2001,0.1,0,0,0,0,0,0,0,0.0,0,0,0,0,0,0,0,0,0,2022-2023,90.0,0.0,0.0
2282,Luka Romero,ARG,FW,Lazio,Serie A,17,2004,1.7,0,0,0,0,0,0,3,0.0,3,4,0,4,3,3,1,0,0,2022-2023,90.0,158.8235294117647,0.0
2283,Oriol Romeu,ESP,MF,Southampton,Premier League,30,1991,0.8,1,0,0,1,0,0,0,0.0,0,1,0,1,1,2,1,0,0,2022-2023,90.0,112.5,112.5
2284,Oriol Romeu,ESP,MF,Girona,La Liga,30,1991,32.8,70,38,36,26,8,26,51,51.0,25,48,10,38,37,107,54,0,0,2022-2023,90.0,101.52439024390245,192.07317073170734
2285,Cristiano Ronaldo,POR,FW,Manchester Utd,Premier League,37,1985,5.8,2,2,1,0,1,1,2,50.0,1,0,0,0,1,3,9,0,0,2022-2023,90.0,15.517241379310345,31.03448275862069
2286,Connor Ronan,IRL,MF,Wolves,Premier League,24,1998,0.0,0,0,0,0,0,0,0,0.0,0,0,0,0,0,0,0,0,0,2022-2023,,,
2287,Salomón Rondón,VEN,FW,Everton,Premier League,32,1989,1.2,0,0,0,0,0,0,0,0.0,0,1,1,0,0,0,0,0,0,2022-2023,90.0,0.0,0.0
2288,Valentin Rongier,FRA,MF,Marseille,Ligue 1,27,1994,33.7,93,59,33,47,13,41,77,53.2,36,50,11,39,54,147,38,1,0,2022-2023,90.0,144.21364985163203,248.36795252225517
2289,Marten de Roon,NED,MF,Atalanta,Serie A,31,1991,32.9,77,39,37,35,5,37,81,45.7,44,37,4,33,36,113,58,0,0,2022-2023,90.0,98.48024316109424,210.63829787234044
2290,Pablo Rosario,NED,"MF,DF",Nice,Ligue 1,25,1997,19.6,46,26,22,20,4,18,34,52.9,16,15,5,10,23,69,32,1,0,2022-2023,90.0,105.61224489795917,211.22448979591834
2291,Francesco Rossi,ITA,GK,Atalanta,Serie A,31,1991,0.0,0,0,0,0,0,0,0,0.0,0,0,0,0,0,0,0,0,0,2022-2023,,,
2292,Tom Rothe,GER,DF,Dortmund,Bundesliga,17,2004,0.3,1,1,0,1,0,1,1,100.0,0,0,0,0,1,2,2,0,0,2022-2023,90.0,300.0,300.0
2293,Joe Rothwell,ENG,MF,Bournemouth,Premier League,27,1995,11.3,20,13,7,12,1,7,21,33.3,14,14,3,11,9,29,7,0,0,2022-2023,90.0,71.68141592920354,159.2920353982301
2294,Anthony Rouault,FRA,DF,Toulouse,Ligue 1,21,2001,36.8,66,37,54,10,2,30,58,51.7,28,52,26,26,56,122,126,4,0,2022-2023,90.0,136.95652173913044,161.41304347826087
2295,Jérôme Roussillon,FRA,"MF,DF",Wolfsburg,Bundesliga,29,1993,0.2,0,0,0,0,0,0,0,0.0,0,0,0,0,0,0,0,0,0,2022-2023,90.0,0.0,0.0
2296,Jérôme Roussillon,FRA,DF,Union Berlin,Bundesliga,29,1993,10.6,16,9,6,8,2,8,12,66.7,4,7,2,5,4,20,22,0,0,2022-2023,90.0,33.9622641509434,135.8490566037736
2297,Nicolò Rovella,ITA,MF,Monza,Serie A,20,2001,19.3,45,29,22,21,2,13,36,36.1,23,20,1,19,40,85,17,0,0,2022-2023,90.0,186.5284974093264,209.84455958549222
2298,Nicolò Rovella,ITA,MF,Juventus,Serie A,20,2001,0.3,1,1,0,1,0,1,1,100.0,0,0,0,0,0,1,0,0,0,2022-2023,90.0,0.0,300.0
2299,Amir Rrahmani,KVX,DF,Napoli,Serie A,28,1994,27.2,33,18,20,13,0,17,26,65.4,9,36,20,16,14,47,79,1,0,2022-2023,90.0,46.3235294117647,109.19117647058823
2300,Ruan,BRA,DF,Sassuolo,Serie A,23,1999,19.0,38,26,25,12,1,19,29,65.5,10,29,17,12,24,62,80,3,0,2022-2023,90.0,113.6842105263158,180.0
Rk,Player,Nation,Pos,Squad,Comp,0,0,90.0,0,0,3,3,3,Tkl,0,0.0,0,0,0,0,0,0,0,0,0,2022-2023,90.0,0.0,0.0
2301,Rubén,ESP,"DF,MF",Espanyol,La Liga,21,2001,9.9,30,15,18,9,3,20,29,69.0,9,14,4,10,18,48,18,0,0,2022-2023,90.0,163.63636363636363,272.72727272727275
2302,Antonio Rüdiger,GER,DF,Real Madrid,La Liga,29,1993,26.8,18,16,12,5,1,14,23,60.9,9,23,13,10,19,37,74,0,0,2022-2023,90.0,63.805970149253724,60.447761194029844
2303,Sebastian Rudy,GER,MF,Hoffenheim,Bundesliga,32,1990,8.8,26,12,10,16,0,13,27,48.1,14,27,7,20,11,37,13,0,0,2022-2023,90.0,112.5,265.9090909090909
2304,Daniele Rugani,ITA,DF,Juventus,Serie A,28,1994,6.3,7,0,6,1,0,4,4,100.0,0,7,5,2,7,14,32,0,0,2022-2023,90.0,100.00000000000001,100.00000000000001
2305,Matteo Ruggeri,ITA,"DF,MF",Atalanta,Serie A,20,2002,9.2,17,12,5,9,3,8,16,50.0,8,14,3,11,12,29,16,0,0,2022-2023,90.0,117.3913043478261,166.30434782608697
2306,Mário Rui,POR,DF,Napoli,Serie A,31,1991,19.4,34,22,17,13,4,20,41,48.8,21,17,4,13,15,49,24,1,0,2022-2023,90.0,69.5876288659794,157.73195876288662
2307,Aitor Ruibal,ESP,"DF,FW",Betis,La Liga,26,1996,16.2,47,29,35,9,3,31,58,53.4,27,17,2,15,24,71,41,0,0,2022-2023,90.0,133.33333333333334,261.11111111111114
2308,Kays Ruiz Atil,FRA,MF,Auxerre,Ligue 1,19,2002,0.7,1,1,1,0,0,0,1,0.0,1,2,1,1,3,4,0,0,0,2022-2023,90.0,385.7142857142857,128.57142857142858
2309,Fabián Ruiz Peña,ESP,MF,Paris S-G,Ligue 1,26,1996,21.0,62,28,25,30,7,43,79,54.4,36,24,1,23,18,80,23,1,0,2022-2023,90.0,77.14285714285714,265.7142857142857
2310,Víctor Ruiz,ESP,DF,Betis,La Liga,33,1989,6.2,5,3,3,2,0,3,3,100.0,0,10,7,3,6,11,34,0,0,2022-2023,90.0,87.09677419354838,72.58064516129032
2311,Gerónimo Rulli,ARG,GK,Villarreal,La Liga,30,1992,14.0,0,0,0,0,0,0,0,0.0,0,1,0,1,1,1,6,2,0,2022-2023,90.0,6.428571428571429,0.0
2312,Alessandro Russo,ITA,GK,Sassuolo,Serie A,21,2001,1.0,0,0,0,0,0,0,0,0.0,0,0,0,0,0,0,1,1,0,2022-2023,90.0,0.0,0.0
2313,Franco Russo,ARG,DF,Mallorca,La Liga,27,1994,1.6,2,1,2,0,0,0,1,0.0,1,5,0,5,3,5,5,0,0,2022-2023,90.0,168.75,112.5
2314,Georginio Rutter,FRA,"FW,MF",Leeds United,Premier League,20,2002,3.0,10,9,5,3,2,5,8,62.5,3,5,0,5,3,13,3,0,0,2022-2023,90.0,90.0,300.0
2315,Georginio Rutter,FRA,FW,Hoffenheim,Bundesliga,20,2002,11.2,7,4,1,4,2,1,3,33.3,2,10,2,8,5,12,6,0,0,2022-2023,90.0,40.17857142857143,56.25
2316,Julian Ryerson,NOR,DF,Union Berlin,Bundesliga,24,1997,11.5,28,17,17,10,1,15,25,60.0,10,15,3,12,12,40,19,0,0,2022-2023,90.0,93.91304347826087,219.13043478260872
2317,Julian Ryerson,NOR,DF,Dortmund,Bundesliga,24,1997,15.7,27,15,17,7,3,19,37,51.4,18,13,2,11,8,35,28,0,0,2022-2023,90.0,45.85987261146497,154.77707006369428
2318,Frederik Rønnow,DEN,GK,Union Berlin,Bundesliga,29,1992,29.0,0,0,0,0,0,0,5,0.0,5,0,0,0,0,0,9,1,0,2022-2023,90.0,0.0,0.0
2319,José Sá,POR,GK,Wolves,Premier League,29,1993,36.0,1,0,1,0,0,1,1,100.0,0,0,0,0,0,1,10,6,0,2022-2023,90.0,0.0,2.5
2320,Youssouf Sabaly,SEN,DF,Betis,La Liga,29,1993,18.7,45,23,29,14,2,22,33,66.7,11,35,8,27,19,64,52,1,0,2022-2023,90.0,91.44385026737967,216.57754010695186
2321,Halid Šabanović,BIH,DF,Angers,Ligue 1,22,1999,7.1,8,6,7,1,0,6,8,75.0,2,8,2,6,8,16,12,0,0,2022-2023,90.0,101.40845070422536,101.40845070422536
2322,Abdelhamid Sabiri,MAR,"MF,FW",Sampdoria,Serie A,25,1996,11.9,18,7,5,9,4,4,13,30.8,9,18,4,14,2,20,5,0,0,2022-2023,90.00000000000001,15.126050420168069,136.1344537815126
2323,Marcel Sabitzer,AUT,MF,Manchester Utd,Premier League,28,1994,7.0,12,8,3,8,1,2,11,18.2,9,6,2,4,8,20,11,0,0,2022-2023,90.0,102.85714285714286,154.28571428571428
2324,Marcel Sabitzer,AUT,MF,Bayern Munich,Bundesliga,28,1994,7.0,27,14,11,10,6,10,17,58.8,7,3,0,3,10,37,9,0,0,2022-2023,90.0,128.57142857142856,347.1428571428571
2325,Falaye Sacko,MLI,DF,Montpellier,Ligue 1,27,1995,28.7,46,25,25,15,6,32,51,62.7,19,43,14,29,33,79,75,1,0,2022-2023,90.0,103.48432055749129,144.25087108013938
Rk,Player,Nation,Pos,Squad,Comp,0,0,90.0,0,0,3,3,3,Tkl,0,0.0,0,0,0,0,0,0,0,0,0,2022-2023,90.0,0.0,0.0
2326,Umar Sadiq,NGA,FW,Almería,La Liga,25,1997,2.7,0,0,0,0,0,0,1,0.0,1,2,0,2,0,0,3,0,0,2022-2023,90.0,0.0,0.0
2327,Umar Sadiq,NGA,FW,Real Sociedad,La Liga,25,1997,0.9,1,1,0,0,1,0,1,0.0,1,2,0,2,0,1,0,0,0,2022-2023,90.0,0.0,100.0
2328,Alexis Saelemaekers,BEL,"FW,DF",Milan,Serie A,23,1999,15.6,31,20,12,16,3,19,41,46.3,22,13,1,12,19,50,11,0,0,2022-2023,90.0,109.61538461538461,178.84615384615384
2329,Wesley Saïd,FRA,"FW,MF",Lens,Ligue 1,27,1995,7.2,4,1,1,2,1,2,6,33.3,4,4,0,4,1,5,2,0,0,2022-2023,90.0,12.5,50.0
2330,Allan Saint-Maximin,FRA,FW,Newcastle Utd,Premier League,25,1997,12.4,10,3,3,6,1,2,11,18.2,9,4,0,4,5,15,2,0,0,2022-2023,90.0,36.29032258064516,72.58064516129032
2331,Théo Sainte-Luce,FRA,DF,Montpellier,Ligue 1,23,1998,5.9,13,11,8,5,0,7,14,50.0,7,7,2,5,10,23,11,0,0,2022-2023,90.0,152.54237288135593,198.30508474576268
2332,Samuel Sáiz,ESP,MF,Girona,La Liga,31,1991,2.7,2,2,0,2,0,1,2,50.0,1,3,0,3,0,2,1,1,0,2022-2023,90.0,0.0,66.66666666666666
2333,Bukayo Saka,ENG,FW,Arsenal,Premier League,20,2001,35.3,63,34,22,15,26,20,44,45.5,24,38,0,38,14,77,19,0,0,2022-2023,90.0,35.69405099150142,160.62322946175638
2334,Hamza Sakhi,FRA,MF,Auxerre,Ligue 1,26,1996,18.4,44,22,22,17,5,22,42,52.4,20,16,1,15,25,69,9,0,0,2022-2023,90.0,122.28260869565219,215.21739130434784
2335,Mamadou Sakho,FRA,DF,Montpellier,Ligue 1,32,1990,8.5,9,5,4,5,0,3,5,60.0,2,17,12,5,8,17,35,1,0,2022-2023,90.0,84.70588235294117,95.29411764705883
2336,Jacopo Sala,ITA,MF,Spezia,Serie A,30,1991,1.2,1,0,1,0,0,0,2,0.0,2,2,0,2,1,2,2,0,0,2022-2023,90.0,75.0,75.0
2337,Ibrahim Salah,MAR,"FW,MF",Rennes,Ligue 1,20,2001,2.5,8,1,5,3,0,2,15,13.3,13,3,0,3,2,10,0,0,0,2022-2023,90.0,72.0,288.0
2338,Mohamed Salah,EGY,FW,Liverpool,Premier League,30,1992,36.6,21,12,4,5,12,10,26,38.5,16,21,0,21,6,27,4,0,0,2022-2023,90.0,14.754098360655737,51.63934426229508
2339,Amine Salama,FRA,"FW,MF",Angers,Ligue 1,22,2000,13.9,11,9,3,7,1,2,12,16.7,10,8,2,6,10,21,2,0,0,2022-2023,90.0,64.74820143884892,71.22302158273382
2340,Kike Salas,ESP,DF,Sevilla,La Liga,20,2002,4.1,1,1,1,0,0,0,0,0.0,0,4,3,1,5,6,23,0,0,2022-2023,90.0,109.75609756097562,21.951219512195124
2341,William Saliba,FRA,DF,Arsenal,Premier League,21,2001,26.8,34,20,23,9,2,15,18,83.3,3,13,10,3,19,53,85,4,0,2022-2023,90.0,63.805970149253724,114.17910447761193
2342,Dikeni-Rafid Salifou,TOG,MF,Werder Bremen,Bundesliga,19,2003,0.0,0,0,0,0,0,0,0,0.0,0,0,0,0,0,0,0,0,0,2022-2023,,,
2343,Mohammed Salisu,GHA,DF,Southampton,Premier League,23,1999,21.9,52,29,34,16,2,24,34,70.6,10,56,25,31,30,82,122,1,0,2022-2023,90.0,123.28767123287672,213.6986301369863
2344,Roland Sallai,HUN,"MF,FW",Freiburg,Bundesliga,25,1997,11.1,11,8,4,3,4,4,10,40.0,6,7,1,6,2,13,11,0,0,2022-2023,90.0,16.216216216216218,89.1891891891892
2345,Yoann Salmier,GUF,DF,Troyes,Ligue 1,29,1992,29.4,51,29,34,12,5,21,35,60.0,14,34,19,15,39,90,124,0,0,2022-2023,90.0,119.38775510204081,156.12244897959184
2346,Salvi,ESP,"FW,MF",Rayo Vallecano,La Liga,31,1991,5.4,13,8,5,5,3,2,8,25.0,6,0,0,0,2,15,2,0,0,2022-2023,90.0,33.33333333333333,216.66666666666666
2347,Lazar Samardzic,SRB,MF,Udinese,Serie A,20,2002,20.5,33,16,9,20,4,17,43,39.5,26,13,0,13,11,44,16,0,0,2022-2023,90.0,48.29268292682927,144.8780487804878
2348,Diadie Samassékou,MLI,"MF,FW",Hoffenheim,Bundesliga,26,1996,0.4,1,0,0,1,0,0,1,0.0,1,0,0,0,0,1,0,0,0,2022-2023,90.0,0.0,225.0
2349,Mama Samba Baldé,GNB,FW,Troyes,Ligue 1,26,1995,29.6,46,21,14,21,11,13,28,46.4,15,30,3,27,10,56,13,0,0,2022-2023,90.0,30.405405405405403,139.86486486486487
2350,Brice Samba,FRA,GK,Lens,Ligue 1,28,1994,37.0,1,0,1,0,0,1,2,50.0,1,1,0,1,0,1,12,2,0,2022-2023,90.0,0.0,2.4324324324324325
Rk,Player,Nation,Pos,Squad,Comp,0,0,90.0,0,0,3,3,3,Tkl,0,0.0,0,0,0,0,0,0,0,0,0,2022-2023,90.0,0.0,0.0
2351,Albert Sambi Lokonga,BEL,MF,Arsenal,Premier League,22,1999,2.2,1,1,0,0,1,0,2,0.0,2,1,0,1,5,6,2,0,0,2022-2023,90.0,204.54545454545453,40.90909090909091
2352,Albert Sambi Lokonga,BEL,MF,Crystal Palace,Premier League,22,1999,6.0,13,10,7,4,2,8,12,66.7,4,8,3,5,7,20,10,0,0,2022-2023,90.0,105.0,195.0
2353,Junior Sambia,FRA,DF,Salernitana,Serie A,25,1996,7.7,12,5,7,4,1,6,10,60.0,4,9,3,6,8,20,16,1,0,2022-2023,90.0,93.50649350649351,140.25974025974025
2354,Fede San Emeterio,ESP,MF,Cádiz,La Liga,25,1997,20.5,41,22,23,16,2,22,46,47.8,24,34,14,20,17,58,28,0,0,2022-2023,90.0,74.63414634146342,180.0
2355,Antonio Sanabria,PAR,FW,Torino,Serie A,26,1996,27.0,11,5,3,3,5,1,7,14.3,6,9,2,7,4,15,7,0,0,2022-2023,90.0,13.333333333333334,36.66666666666667
2356,Leandro Sanca,GNB,"FW,MF",Spezia,Serie A,22,2000,0.4,1,1,0,0,1,1,1,100.0,0,0,0,0,0,1,0,0,0,2022-2023,90.0,0.0,225.0
2357,Oihan Sancet,ESP,MF,Athletic Club,La Liga,22,2000,28.1,27,16,2,19,6,11,37,29.7,26,10,0,10,4,31,9,1,0,2022-2023,90.0,12.811387900355871,86.47686832740213
2358,Renato Sanches,POR,MF,Paris S-G,Ligue 1,24,1997,8.0,8,1,1,3,4,5,14,35.7,9,13,3,10,9,17,4,0,0,2022-2023,90.0,101.25,90.0
2359,Alexis Sánchez,CHI,"FW,MF",Marseille,Ligue 1,33,1988,29.8,27,17,5,16,6,3,24,12.5,21,14,0,14,5,32,6,0,0,2022-2023,90.0,15.100671140939596,81.54362416107382
2360,Antonio Sánchez,ESP,"MF,DF",Mallorca,La Liga,25,1997,12.0,19,8,13,4,2,10,34,29.4,24,18,0,18,22,41,14,1,0,2022-2023,90.0,165.0,142.5
2361,Davinson Sánchez,COL,DF,Tottenham,Premier League,26,1996,9.5,24,11,17,6,1,14,20,70.0,6,16,10,6,12,36,41,0,0,2022-2023,90.0,113.6842105263158,227.3684210526316
2362,Iván Sánchez,ESP,"MF,FW",Valladolid,La Liga,29,1992,12.8,20,14,8,8,4,10,27,37.0,17,14,1,13,8,28,4,0,0,2022-2023,90.0,56.25,140.625
2363,Javi Sánchez,ESP,DF,Valladolid,La Liga,25,1997,26.6,43,26,27,15,1,17,26,65.4,9,32,22,10,46,89,116,0,0,2022-2023,90.0,155.6390977443609,145.48872180451127
2364,Manu Sánchez,ESP,DF,Osasuna,La Liga,21,2000,23.6,51,35,35,9,7,33,63,52.4,30,33,5,28,14,65,51,0,0,2022-2023,90.0,53.389830508474574,194.4915254237288
2365,Robert Sánchez,ESP,GK,Brighton,Premier League,24,1997,23.0,1,0,1,0,0,0,0,0.0,0,0,0,0,3,4,9,2,0,2022-2023,90.0,11.73913043478261,3.91304347826087
2366,Jadon Sancho,ENG,"FW,MF",Manchester Utd,Premier League,22,2000,18.7,16,10,7,5,4,8,28,28.6,20,25,2,23,7,23,6,0,0,2022-2023,90.0,33.68983957219251,77.00534759358288
2367,Alex Sandro,BRA,DF,Juventus,Serie A,31,1991,19.9,35,20,16,16,3,15,22,68.2,7,27,10,17,15,50,64,1,0,2022-2023,90.0,67.8391959798995,158.29145728643218
2368,Leroy Sané,GER,"MF,FW",Bayern Munich,Bundesliga,26,1996,22.3,38,30,11,19,8,18,36,50.0,18,11,1,10,3,41,1,2,0,2022-2023,90.0,12.107623318385649,153.36322869955157
2369,Sidi Sané,GER,FW,Schalke 04,Bundesliga,19,2003,0.3,1,1,1,0,0,1,1,100.0,0,0,0,0,0,1,0,0,0,2022-2023,90.0,0.0,300.0
2370,Morgan Sanson,FRA,MF,Aston Villa,Premier League,27,1994,0.1,2,1,1,1,0,1,1,100.0,0,0,0,0,0,2,0,0,0,2022-2023,90.0,0.0,1800.0
2371,Morgan Sanson,FRA,MF,Strasbourg,Ligue 1,27,1994,15.8,36,25,10,16,10,17,56,30.4,39,21,1,20,22,58,9,0,0,2022-2023,90.0,125.31645569620251,205.06329113924048
2372,Nicola Sansone,ITA,FW,Bologna,Serie A,30,1991,8.2,12,4,6,4,2,5,10,50.0,5,0,0,0,0,12,4,0,0,2022-2023,90.0,0.0,131.70731707317074
2373,Baptiste Santamaria,FRA,MF,Rennes,Ligue 1,27,1995,20.1,41,22,13,23,5,21,41,51.2,20,21,5,16,21,62,23,0,0,2022-2023,90.0,94.02985074626865,183.58208955223878
2374,Riccardo Saponara,ITA,FW,Fiorentina,Serie A,30,1991,13.4,10,5,3,6,1,5,9,55.6,4,7,1,6,5,15,9,1,0,2022-2023,90.0,33.582089552238806,67.16417910447761
2375,Pablo Sarabia,ESP,"FW,MF",Wolves,Premier League,30,1992,8.5,12,6,4,5,3,6,15,40.0,9,7,0,7,2,14,4,0,0,2022-2023,90.0,21.176470588235293,127.05882352941177
Rk,Player,Nation,Pos,Squad,Comp,0,0,90.0,0,0,3,3,3,Tkl,0,0.0,0,0,0,0,0,0,0,0,0,2022-2023,90.0,0.0,0.0
2376,Pablo Sarabia,ESP,"FW,MF",Paris S-G,Ligue 1,30,1992,4.1,5,4,2,2,1,1,7,14.3,6,3,0,3,2,7,0,0,0,2022-2023,90.0,43.90243902439025,109.75609756097562
2377,Jeremy Sarmiento,ECU,MF,Brighton,Premier League,20,2002,2.0,6,3,4,1,1,2,5,40.0,3,2,0,2,1,7,0,0,0,2022-2023,90.0,45.0,270.0
2378,Amin Sarr,SWE,FW,Lyon,Ligue 1,21,2001,6.0,9,6,1,4,4,1,4,25.0,3,2,0,2,0,9,4,0,0,2022-2023,90.0,0.0,135.0
2379,Bouna Sarr,SEN,FW,Bayern Munich,Bundesliga,30,1992,0.0,0,0,0,0,0,0,0,0.0,0,0,0,0,0,0,0,0,0,2022-2023,,,
2380,Malang Sarr,FRA,DF,Monaco,Ligue 1,23,1999,8.0,6,3,5,1,0,1,5,20.0,4,11,7,4,15,21,29,2,0,2022-2023,90.0,168.75,67.5
2381,Mamadou Sarr,FRA,MF,Lyon,Ligue 1,16,2005,0.1,0,0,0,0,0,0,0,0.0,0,0,0,0,0,0,0,0,0,2022-2023,90.0,0.0,0.0
2382,Mouhamadou Sarr,SEN,GK,Cremonese,Serie A,25,1997,2.0,0,0,0,0,0,0,0,0.0,0,0,0,0,0,0,2,0,0,2022-2023,90.0,0.0,0.0
2383,Martin Satriano,URU,FW,Empoli,Serie A,21,2001,18.9,13,8,5,6,2,6,14,42.9,8,5,0,5,3,16,22,0,0,2022-2023,90.0,14.285714285714286,61.904761904761905
2384,Téji Savanier,FRA,MF,Montpellier,Ligue 1,30,1991,28.3,46,30,16,19,11,23,70,32.9,47,30,2,28,30,76,12,1,0,2022-2023,90.0,95.40636042402826,146.28975265017667
2385,Esteban Saveljich,MNE,FW,Rayo Vallecano,La Liga,31,1991,0.0,0,0,0,0,0,0,0,0.0,0,0,0,0,0,0,0,0,0,2022-2023,,,
2386,Stefan Savić,MNE,DF,Atlético Madrid,La Liga,31,1991,21.6,39,26,29,7,3,26,39,66.7,13,17,8,9,33,72,67,2,0,2022-2023,90.0,137.5,162.5
2387,Joe Scally,USA,DF,Gladbach,Bundesliga,19,2002,24.5,31,20,25,5,1,24,31,77.4,7,17,6,11,8,39,61,0,0,2022-2023,90.00000000000001,29.38775510204082,113.87755102040818
2388,Giorgio Scalvini,ITA,DF,Atalanta,Serie A,18,2003,25.9,54,29,30,18,6,29,55,52.7,26,36,13,23,56,110,57,2,0,2022-2023,90.0,194.5945945945946,187.64478764478767
2389,Gianluca Scamacca,ITA,FW,West Ham,Premier League,23,1999,10.3,10,5,1,3,6,2,2,100.0,0,3,0,3,4,14,5,0,0,2022-2023,90.0,34.95145631067961,87.37864077669903
2390,Gustavo Scarpa,BRA,"MF,FW",Nott'ham Forest,Premier League,28,1994,2.0,5,2,3,1,1,2,5,40.0,3,4,0,4,0,5,3,0,0,2022-2023,90.0,0.0,225.0
2391,Kevin Schade,GER,FW,Brentford,Premier League,20,2001,8.1,12,8,7,2,3,5,10,50.0,5,7,0,7,4,16,6,0,0,2022-2023,90.0,44.44444444444444,133.33333333333334
2392,Kevin Schade,GER,"FW,MF",Freiburg,Bundesliga,20,2001,2.0,6,4,3,2,1,3,5,60.0,2,0,0,0,0,6,2,0,0,2022-2023,90.0,0.0,270.0
2393,András Schäfer,HUN,MF,Union Berlin,Bundesliga,23,1999,9.6,21,9,7,12,2,6,14,42.9,8,12,2,10,4,25,11,0,0,2022-2023,90.0,37.5,196.875
2394,Fabian Schär,SUI,DF,Newcastle Utd,Premier League,30,1991,35.6,47,22,31,13,3,24,39,61.5,15,34,19,15,52,99,139,0,0,2022-2023,90.0,131.46067415730337,118.82022471910112
2395,Derry Scherhant,GER,"FW,MF",Hertha BSC,Bundesliga,19,2002,3.2,7,6,3,3,1,4,8,50.0,4,3,0,3,0,7,5,0,0,2022-2023,90.0,0.0,196.875
2396,Patrik Schick,CZE,FW,Leverkusen,Bundesliga,26,1996,10.5,0,0,0,0,0,0,1,0.0,1,4,1,3,1,1,7,0,0,2022-2023,90.0,8.571428571428571,0.0
2397,Kingsley Schindler,GHA,"DF,MF",Köln,Bundesliga,29,1993,12.1,23,12,13,8,2,18,28,64.3,10,14,2,12,15,38,24,0,0,2022-2023,90.0,111.57024793388429,171.07438016528926
2398,Xaver Schlager,AUT,MF,RB Leipzig,Bundesliga,24,1997,16.7,41,24,13,26,2,20,43,46.5,23,19,2,17,17,58,23,0,0,2022-2023,90.0,91.61676646706587,220.95808383233532
2399,Keven Schlotterbeck,GER,DF,Freiburg,Bundesliga,25,1997,0.2,0,0,0,0,0,0,0,0.0,0,1,1,0,2,2,2,0,0,2022-2023,90.0,900.0,0.0
2400,Keven Schlotterbeck,GER,DF,Bochum,Bundesliga,25,1997,8.2,17,9,12,5,0,9,11,81.8,2,11,5,6,14,31,49,0,0,2022-2023,90.0,153.65853658536588,186.58536585365854
Rk,Player,Nation,Pos,Squad,Comp,0,0,90.0,0,0,3,3,3,Tkl,0,0.0,0,0,0,0,0,0,0,0,0,2022-2023,90.0,0.0,0.0
2401,Nico Schlotterbeck,GER,DF,Dortmund,Bundesliga,22,1999,25.0,59,34,34,24,1,37,53,69.8,16,38,21,17,32,91,71,1,0,2022-2023,90.0,115.19999999999999,212.39999999999998
2402,Jeffrey Schlupp,GHA,"MF,FW",Crystal Palace,Premier League,29,1992,28.1,66,46,28,29,9,22,43,51.2,21,39,8,31,23,89,38,0,0,2022-2023,90.0,73.66548042704626,211.3879003558719
2403,Kasper Schmeichel,DEN,GK,Nice,Ligue 1,35,1986,36.0,1,0,1,0,0,1,4,25.0,3,1,0,1,1,2,11,1,0,2022-2023,90.0,2.5,2.5
2404,Jonathan Schmid,FRA,DF,Freiburg,Bundesliga,32,1990,0.5,1,1,1,0,0,0,0,0.0,0,1,0,1,1,2,1,1,0,2022-2023,90.0,180.0,180.0
2405,Romano Schmid,AUT,"MF,FW",Werder Bremen,Bundesliga,22,2000,16.9,24,15,5,13,6,10,22,45.5,12,21,3,18,7,31,12,0,0,2022-2023,90.0,37.278106508875744,127.81065088757397
2406,Kenneth Schmidt,GER,DF,Freiburg,Bundesliga,20,2002,2.8,6,3,4,2,0,5,6,83.3,1,4,2,2,0,6,2,0,0,2022-2023,90.0,0.0,192.85714285714286
2407,Niklas Schmidt,GER,MF,Werder Bremen,Bundesliga,24,1998,12.1,25,10,12,11,2,13,28,46.4,15,10,0,10,5,30,12,0,0,2022-2023,90.0,37.1900826446281,185.9504132231405
2408,Benno Schmitz,GER,DF,Köln,Bundesliga,27,1994,26.9,64,42,31,28,5,42,82,51.2,40,34,4,30,26,90,57,0,0,2022-2023,90.0,86.98884758364312,214.12639405204462
2409,Jerdy Schouten,NED,MF,Bologna,Serie A,25,1997,27.9,63,38,28,33,2,27,49,55.1,22,40,17,23,40,103,43,1,0,2022-2023,90.0,129.03225806451613,203.2258064516129
2410,Perr Schuurs,NED,DF,Torino,Serie A,22,1999,25.8,51,25,29,17,5,14,26,53.8,12,28,16,12,28,79,102,0,0,2022-2023,90.0,97.67441860465115,177.90697674418604
2411,Marvin Schwäbe,GER,GK,Köln,Bundesliga,27,1995,34.0,1,0,1,0,0,1,1,100.0,0,0,0,0,2,3,8,2,0,2022-2023,90.0,5.294117647058823,2.6470588235294117
2412,Alexander Schwolow,GER,GK,Schalke 04,Bundesliga,30,1992,22.6,0,0,0,0,0,0,2,0.0,2,0,0,0,1,1,6,3,0,2022-2023,90.0,3.982300884955752,0.0
2413,Demba Seck,SEN,"MF,FW",Torino,Serie A,21,2001,5.8,5,2,3,2,0,2,3,66.7,1,3,1,2,1,6,1,0,0,2022-2023,90.0,15.517241379310345,77.58620689655173
2414,Haris Seferović,SUI,FW,Celta Vigo,La Liga,30,1992,9.9,6,3,1,4,1,3,8,37.5,5,7,1,6,1,7,6,1,0,2022-2023,90.0,9.090909090909092,54.54545454545455
2415,Telasco Segovia,VEN,MF,Sampdoria,Serie A,19,2003,0.0,0,0,0,0,0,0,0,0.0,0,0,0,0,0,0,0,0,0,2022-2023,,,
2416,Jacopo Segre,ITA,DF,Torino,Serie A,25,1997,0.2,0,0,0,0,0,0,0,0.0,0,0,0,0,0,0,0,0,0,2022-2023,90.0,0.0,0.0
2417,Paul Seguin,GER,MF,Union Berlin,Bundesliga,27,1995,7.7,17,8,9,4,4,8,18,44.4,10,6,0,6,6,23,7,0,0,2022-2023,90.0,70.12987012987013,198.7012987012987
2418,Alidu Seidu,GHA,DF,Clermont Foot,Ligue 1,22,2000,27.3,52,31,35,14,3,31,51,60.8,20,28,14,14,52,104,50,2,0,2022-2023,90.0,171.42857142857142,171.42857142857142
2419,Davie Selke,GER,FW,Hertha BSC,Bundesliga,27,1995,3.1,2,1,1,1,0,0,1,0.0,1,3,1,2,1,3,5,0,0,2022-2023,90.0,29.032258064516128,58.064516129032256
2420,Davie Selke,GER,FW,Köln,Bundesliga,27,1995,9.7,0,0,0,0,0,0,4,0.0,4,4,1,3,0,0,11,0,0,2022-2023,90.0,0.0,0.0
2421,Matz Sels,BEL,GK,Strasbourg,Ligue 1,30,1992,38.0,4,3,4,0,0,4,4,100.0,0,0,0,0,4,8,23,0,0,2022-2023,90.0,9.473684210526315,9.473684210526315
2422,Nélson Semedo,POR,DF,Wolves,Premier League,28,1993,29.2,71,42,48,19,4,33,64,51.6,31,42,15,27,29,100,83,2,0,2022-2023,90.0,89.38356164383562,218.83561643835617
2423,Vivaldo Semedo,POR,"FW,MF",Udinese,Serie A,17,2005,0.4,0,0,0,0,0,0,0,0.0,0,1,0,1,0,0,1,0,0,2022-2023,90.0,0.0,0.0
2424,Antoine Semenyo,GHA,"FW,MF",Bournemouth,Premier League,22,2000,2.9,1,0,0,0,1,1,6,16.7,5,10,1,9,2,3,4,0,0,2022-2023,90.0,62.06896551724138,31.03448275862069
2425,Marvin Senaya,TOG,DF,Strasbourg,Ligue 1,21,2001,0.1,0,0,0,0,0,0,1,0.0,1,1,0,1,0,0,1,0,0,2022-2023,90.0,0.0,0.0
Rk,Player,Nation,Pos,Squad,Comp,0,0,90.0,0,0,3,3,3,Tkl,0,0.0,0,0,0,0,0,0,0,0,0,2022-2023,90.0,0.0,0.0
2426,Marcos Senesi,ARG,DF,Bournemouth,Premier League,25,1997,27.7,50,35,28,22,0,23,44,52.3,21,38,20,18,43,93,146,2,0,2022-2023,90.0,139.71119133574007,162.4548736462094
2427,Stefano Sensi,ITA,MF,Monza,Serie A,26,1995,18.0,41,26,25,13,3,18,48,37.5,30,13,3,10,20,61,4,0,0,2022-2023,90.0,100.0,205.0
2428,Jaime Seoane,ESP,"MF,FW",Getafe,La Liga,25,1997,3.6,10,4,3,4,3,2,8,25.0,6,7,3,4,1,11,2,0,0,2022-2023,90.0,25.0,250.0
2429,Luigi Sepe,ITA,GK,Salernitana,Serie A,31,1991,17.0,0,0,0,0,0,0,1,0.0,1,0,0,0,0,0,0,0,0,2022-2023,90.0,0.0,0.0
2430,Suat Serdar,GER,MF,Hertha BSC,Bundesliga,25,1997,22.5,51,23,14,30,7,20,41,48.8,21,48,12,36,29,80,24,0,0,2022-2023,90.0,116.0,204.0
2431,Leonardo Sernicola,ITA,DF,Cremonese,Serie A,25,1997,25.7,45,33,25,13,7,29,43,67.4,14,23,6,17,38,83,55,0,0,2022-2023,90.0,133.0739299610895,157.5875486381323
2432,Ryan Sessegnon,ENG,DF,Tottenham,Premier League,22,2000,9.0,16,11,9,7,0,6,12,50.0,6,8,1,7,6,22,17,1,0,2022-2023,90.0,60.0,160.0
2433,Stephan El Shaarawy,ITA,"DF,MF",Roma,Serie A,29,1992,16.9,21,9,8,10,3,6,22,27.3,16,11,1,10,15,36,11,0,0,2022-2023,90.0,79.88165680473374,111.83431952662723
2434,Eniss Shabani,ALB,MF,Mainz 05,Bundesliga,19,2003,0.1,0,0,0,0,0,0,0,0.0,0,0,0,0,0,0,0,0,0,2022-2023,90.0,0.0,0.0
2435,Luke Shaw,ENG,DF,Manchester Utd,Premier League,27,1995,28.4,55,36,31,22,2,32,46,69.6,14,51,17,34,36,91,55,2,0,2022-2023,90.0,114.08450704225353,174.29577464788733
2436,Jonjo Shelvey,ENG,MF,Newcastle Utd,Premier League,30,1992,0.4,1,0,1,0,0,0,1,0.0,1,1,0,1,0,1,0,0,0,2022-2023,90.0,0.0,225.0
2437,Jonjo Shelvey,ENG,MF,Nott'ham Forest,Premier League,30,1992,6.0,2,1,0,1,1,1,9,11.1,8,7,2,5,5,7,10,1,0,2022-2023,90.0,75.0,30.0
2438,Eldor Shomurodov,UZB,FW,Spezia,Serie A,27,1995,9.0,5,5,3,1,1,2,11,18.2,9,5,1,4,3,8,4,0,0,2022-2023,90.0,30.0,50.0
2439,Eldor Shomurodov,UZB,FW,Roma,Serie A,27,1995,1.3,1,0,1,0,0,0,2,0.0,2,1,0,1,1,2,0,0,0,2022-2023,90.0,69.23076923076923,69.23076923076923
2440,Kaj Sierhuis,NED,"FW,MF",Reims,Ligue 1,24,1998,2.4,3,3,1,0,2,0,5,0.0,5,3,1,2,1,4,2,0,0,2022-2023,90.0,37.5,112.50000000000001
2441,Vincent Sierro,SUI,MF,Toulouse,Ligue 1,26,1995,7.4,19,11,9,9,1,11,29,37.9,18,12,3,9,4,23,11,1,0,2022-2023,90.0,48.648648648648646,231.08108108108107
2442,Kiliann Sildillia,FRA,"DF,MF",Freiburg,Bundesliga,20,2002,22.0,33,20,10,19,4,18,30,60.0,12,24,9,15,21,54,47,1,0,2022-2023,90.0,85.9090909090909,135.0
2443,André Silva,POR,FW,RB Leipzig,Bundesliga,26,1995,19.3,12,6,2,5,5,3,8,37.5,5,11,1,10,3,15,3,0,0,2022-2023,90.0,13.98963730569948,55.95854922279792
2444,Bernardo Silva,POR,"MF,FW",Manchester City,Premier League,27,1994,24.5,44,23,11,25,8,18,45,40.0,27,23,6,17,16,60,6,0,0,2022-2023,90.00000000000001,58.77551020408164,161.63265306122452
2445,Caio Henrique Oliveira Silva,BRA,DF,Monaco,Ligue 1,25,1997,32.2,74,51,42,28,4,44,76,57.9,32,28,8,20,26,100,68,1,0,2022-2023,90.0,72.67080745341615,206.83229813664596
2446,David Silva,ESP,MF,Real Sociedad,La Liga,36,1986,21.5,36,21,11,18,7,11,19,57.9,8,17,2,15,15,51,16,0,0,2022-2023,90.0,62.7906976744186,150.69767441860463
2447,Rui Silva,POR,GK,Betis,La Liga,28,1994,26.0,4,1,4,0,0,4,4,100.0,0,0,0,0,0,4,12,1,0,2022-2023,90.00000000000001,0.0,13.846153846153847
2448,Thiago Silva,BRA,DF,Chelsea,Premier League,37,1984,26.1,41,27,24,17,0,21,31,67.7,10,38,29,9,34,75,111,3,0,2022-2023,90.0,117.24137931034481,141.37931034482756
2449,Marco Silvestri,ITA,GK,Udinese,Serie A,31,1991,38.0,2,1,2,0,0,2,3,66.7,1,0,0,0,1,3,15,1,0,2022-2023,90.0,2.3684210526315788,4.7368421052631575
2450,Abdallah Sima,SEN,FW,Angers,Ligue 1,21,2001,20.4,22,13,4,15,3,7,19,36.8,12,8,0,8,4,26,19,0,0,2022-2023,90.0,17.647058823529413,97.05882352941177
Rk,Player,Nation,Pos,Squad,Comp,0,0,90.0,0,0,3,3,3,Tkl,0,0.0,0,0,0,0,0,0,0,0,0,2022-2023,90.0,0.0,0.0
2451,Mohamed Simakan,FRA,DF,RB Leipzig,Bundesliga,22,2000,16.2,21,14,12,5,4,14,21,66.7,7,21,4,17,16,37,55,0,0,2022-2023,90.0,88.88888888888889,116.66666666666667
2452,Giovanni Simeone,ARG,FW,Napoli,Serie A,27,1995,4.5,12,3,3,5,4,3,8,37.5,5,2,1,1,1,13,4,0,0,2022-2023,90.0,20.0,240.0
2453,Ellis Simms,ENG,FW,Everton,Premier League,21,2001,2.5,0,0,0,0,0,0,0,0.0,0,0,0,0,0,0,1,0,0,2022-2023,90.0,0.0,0.0
2454,Simo,ESP,DF,Espanyol,La Liga,17,2005,1.6,3,1,3,0,0,2,3,66.7,1,5,4,1,0,3,3,0,0,2022-2023,90.0,0.0,168.75
2455,Moses Simon,NGA,"FW,MF",Nantes,Ligue 1,27,1995,26.1,18,9,6,7,5,7,15,46.7,8,14,1,13,11,29,3,0,0,2022-2023,90.0,37.93103448275862,62.068965517241374
2456,Unai Simón,ESP,GK,Athletic Club,La Liga,25,1997,30.5,2,0,2,0,0,1,1,100.0,0,1,0,1,0,2,9,3,0,2022-2023,90.0,0.0,5.9016393442622945
2457,Lassine Sinayoko,MLI,"MF,FW",Auxerre,Ligue 1,22,1999,17.4,33,15,14,12,7,21,40,52.5,19,12,0,12,18,51,17,0,0,2022-2023,90.0,93.10344827586206,170.6896551724138
2458,Wilfried Singo,CIV,DF,Torino,Serie A,21,2000,22.7,27,17,14,10,3,12,19,63.2,7,15,2,13,12,39,33,1,0,2022-2023,89.99999999999999,47.57709251101321,107.04845814977973
2459,Luis Sinisterra,COL,FW,Leeds United,Premier League,23,1999,9.6,21,14,8,9,4,11,18,61.1,7,11,1,10,8,29,2,0,0,2022-2023,90.0,75.0,196.875
2460,Daley Sinkgraven,NED,"DF,MF",Leverkusen,Bundesliga,27,1995,3.8,10,7,7,3,0,7,9,77.8,2,8,4,4,5,15,7,0,0,2022-2023,90.0,118.42105263157895,236.8421052631579
2461,Tobias Sippel,GER,GK,Gladbach,Bundesliga,34,1988,5.7,0,0,0,0,0,0,0,0.0,0,0,0,0,0,0,1,1,0,2022-2023,90.0,0.0,0.0
2462,Hugo Siquet,BEL,DF,Freiburg,Bundesliga,20,2002,0.2,2,2,2,0,0,2,2,100.0,0,1,0,1,0,2,0,0,0,2022-2023,90.0,0.0,900.0
2463,Salvatore Sirigu,ITA,GK,Fiorentina,Serie A,35,1987,1.0,0,0,0,0,0,0,0,0.0,0,0,0,0,0,0,1,0,0,2022-2023,90.0,0.0,0.0
2464,Ibrahima Sissoko,MLI,MF,Strasbourg,Ligue 1,24,1997,14.6,40,22,18,17,5,22,42,52.4,20,20,6,14,10,50,19,0,0,2022-2023,90.0,61.64383561643836,246.57534246575344
2465,Moussa Sissoko,FRA,MF,Nantes,Ligue 1,32,1989,21.3,26,16,16,7,3,12,18,66.7,6,22,5,17,16,42,17,0,0,2022-2023,90.0,67.6056338028169,109.85915492957747
2466,Tim Skarke,GER,"DF,MF",Union Berlin,Bundesliga,25,1996,0.6,1,1,0,0,1,0,0,0.0,0,1,0,1,0,1,0,0,0,2022-2023,90.0,0.0,150.0
2467,Tim Skarke,GER,"FW,MF",Schalke 04,Bundesliga,25,1996,4.9,13,7,3,8,2,8,11,72.7,3,5,0,5,0,13,4,0,0,2022-2023,90.0,0.0,238.77551020408163
2468,Ellyes Skhiri,TUN,MF,Köln,Bundesliga,27,1995,31.7,79,44,29,42,8,26,66,39.4,40,52,12,40,56,135,48,0,0,2022-2023,90.0,158.99053627760253,224.2902208201893
2469,Oliver Skipp,ENG,MF,Tottenham,Premier League,21,2000,16.6,34,17,18,15,1,16,33,48.5,17,17,8,9,17,51,19,1,0,2022-2023,90.0,92.16867469879517,184.33734939759034
2470,Leo Skiri Østigård,NOR,DF,Napoli,Serie A,22,1999,4.7,4,1,3,1,0,1,1,100.0,0,3,3,0,6,10,18,1,0,2022-2023,90.0,114.89361702127658,76.59574468085106
2471,Łukasz Skorupski,POL,GK,Bologna,Serie A,31,1991,37.0,2,1,2,0,0,1,2,50.0,1,0,0,0,0,2,19,2,0,2022-2023,90.0,0.0,4.864864864864865
2472,Robert Skov,DEN,DF,Hoffenheim,Bundesliga,26,1996,15.0,22,11,14,7,1,10,26,38.5,16,22,8,14,8,30,20,2,0,2022-2023,90.0,48.0,132.0
2473,Milan Škriniar,SVK,DF,Inter,Serie A,27,1995,19.7,29,18,14,11,4,18,32,56.3,14,18,13,5,13,42,46,3,0,2022-2023,90.0,59.390862944162436,132.48730964467006
2474,Naatan Skyttä,FIN,MF,Toulouse,Ligue 1,20,2002,0.3,0,0,0,0,0,0,0,0.0,0,0,0,0,1,1,0,0,0,2022-2023,90.0,300.0,0.0
2475,Islam Slimani,ALG,FW,Brest,Ligue 1,34,1988,11.0,5,3,2,2,1,0,3,0.0,3,2,0,2,1,6,11,0,0,2022-2023,90.0,8.181818181818182,40.909090909090914
Rk,Player,Nation,Pos,Squad,Comp,0,0,90.0,0,0,3,3,3,Tkl,0,0.0,0,0,0,0,0,0,0,0,0,2022-2023,90.0,0.0,0.0
2476,Chris Smalling,ENG,DF,Roma,Serie A,32,1989,31.2,26,15,16,10,0,13,21,61.9,8,51,36,15,43,69,123,0,0,2022-2023,90.0,124.03846153846153,75.0
2477,Adam Smith,ENG,DF,Bournemouth,Premier League,31,1991,32.7,49,29,27,19,3,29,60,48.3,31,30,13,17,25,74,81,1,0,2022-2023,90.0,68.80733944954129,134.8623853211009
2478,Emile Smith Rowe,ENG,"MF,FW",Arsenal,Premier League,22,2000,1.9,1,1,1,0,0,1,3,33.3,2,1,0,1,0,1,2,0,0,2022-2023,90.0,0.0,47.368421052631575
2479,Hrvoje Smolčić,CRO,DF,Eint Frankfurt,Bundesliga,21,2000,5.2,8,7,6,2,0,5,10,50.0,5,11,4,7,6,14,38,0,0,2022-2023,90.0,103.84615384615384,138.46153846153845
2480,Cédric Soares,POR,DF,Arsenal,Premier League,30,1991,0.3,0,0,0,0,0,0,1,0.0,1,1,0,1,0,0,1,0,0,2022-2023,90.0,0.0,0.0
2481,Cédric Soares,POR,DF,Fulham,Premier League,30,1991,2.2,8,5,4,3,1,3,3,100.0,0,3,1,2,1,9,5,0,0,2022-2023,90.0,40.90909090909091,327.27272727272725
2482,Danilo Soares,BRA,DF,Bochum,Bundesliga,30,1991,19.6,72,46,42,23,7,43,72,59.7,29,29,6,23,30,102,56,1,0,2022-2023,90.0,137.75510204081633,330.61224489795916
2483,Eduard Sobol,UKR,DF,Strasbourg,Ligue 1,27,1995,9.7,19,10,10,6,3,9,13,69.2,4,10,1,9,8,27,19,0,0,2022-2023,90.0,74.22680412371135,176.28865979381445
2484,Rubén Sobrino,ESP,"MF,FW",Cádiz,La Liga,30,1992,27.4,55,37,29,17,9,23,56,41.1,33,33,3,30,24,79,20,1,0,2022-2023,90.0,78.83211678832117,180.65693430656935
2485,Alex Sola,ESP,DF,Real Sociedad,La Liga,23,1999,3.9,18,9,14,3,1,7,10,70.0,3,7,2,5,7,25,10,0,0,2022-2023,90.0,161.53846153846152,415.38461538461536
2486,Dominic Solanke,ENG,"FW,MF",Bournemouth,Premier League,24,1997,31.8,15,9,8,3,4,5,22,22.7,17,26,7,19,6,21,46,0,0,2022-2023,90.0,16.9811320754717,42.45283018867924
2487,Augusto Solari,ARG,MF,Celta Vigo,La Liga,30,1992,2.9,10,6,6,3,1,3,11,27.3,8,5,0,5,4,14,3,0,0,2022-2023,90.0,124.13793103448276,310.3448275862069
2488,Ola Solbakken,NOR,"MF,FW",Roma,Serie A,23,1998,5.6,2,2,1,1,0,2,7,28.6,5,2,0,2,2,4,8,0,0,2022-2023,90.0,32.142857142857146,32.142857142857146
2489,Nikola Soldo,CRO,DF,Köln,Bundesliga,21,2001,6.6,15,9,8,7,0,7,11,63.6,4,7,6,1,7,22,28,0,0,2022-2023,90.0,95.45454545454545,204.54545454545453
2490,Carlos Soler,ESP,MF,Valencia,La Liga,25,1997,2.7,2,0,0,1,1,2,3,66.7,1,1,0,1,0,2,2,0,0,2022-2023,90.0,0.0,66.66666666666666
2491,Carlos Soler,ESP,MF,Paris S-G,Ligue 1,25,1997,13.2,20,12,6,10,4,10,19,52.6,9,12,4,8,4,24,6,0,0,2022-2023,90.0,27.272727272727273,136.36363636363637
2492,François-Joseph Sollacaro,FRA,GK,Ajaccio,Ligue 1,28,1994,6.0,0,0,0,0,0,0,0,0.0,0,0,0,0,0,0,2,2,0,2022-2023,90.0,0.0,0.0
2493,Manor Solomon,ISR,FW,Fulham,Premier League,23,1999,6.4,20,12,12,6,2,9,16,56.3,7,8,0,8,5,25,3,0,0,2022-2023,90.0,70.3125,281.25
2494,Yann Sommer,SUI,GK,Gladbach,Bundesliga,33,1988,10.0,1,0,1,0,0,1,1,100.0,0,0,0,0,0,1,8,0,0,2022-2023,90.0,0.0,9.0
2495,Yann Sommer,SUI,GK,Bayern Munich,Bundesliga,33,1988,19.0,0,0,0,0,0,0,0,0.0,0,0,0,0,1,1,5,1,0,2022-2023,90.0,4.7368421052631575,0.0
2496,Brandon Soppy,FRA,DF,Udinese,Serie A,20,2002,1.0,1,1,0,1,0,0,0,0.0,0,4,0,4,1,2,1,0,0,2022-2023,90.0,90.0,90.0
2497,Brandon Soppy,FRA,DF,Atalanta,Serie A,20,2002,7.1,8,5,4,4,0,3,9,33.3,6,10,0,10,3,11,7,0,0,2022-2023,90.0,38.02816901408451,101.40845070422536
2498,David Soria,ESP,GK,Getafe,La Liga,29,1993,38.0,0,0,0,0,0,0,1,0.0,1,0,0,0,1,1,20,4,0,2022-2023,90.0,2.3684210526315788,0.0
2499,Roberto Soriano,ITA,"FW,MF",Bologna,Serie A,31,1991,14.7,31,16,9,16,6,13,25,52.0,12,23,2,21,6,37,14,0,0,2022-2023,90.0,36.734693877551024,189.79591836734693
2500,Borna Sosa,CRO,DF,Stuttgart,Bundesliga,24,1998,21.7,27,21,18,8,1,21,32,65.6,11,20,5,15,19,46,37,0,0,2022-2023,90.0,78.80184331797236,111.9815668202765
Rk,Player,Nation,Pos,Squad,Comp,0,0,90.0,0,0,3,3,3,Tkl,0,0.0,0,0,0,0,0,0,0,0,0,2022-2023,90.0,0.0,0.0
2501,Joaquin Sosa,URU,DF,Bologna,Serie A,20,2002,7.6,6,2,5,1,0,4,18,22.2,14,5,3,2,6,12,31,0,0,2022-2023,90.0,71.05263157894737,71.05263157894737
2502,Hugo Sotelo,ESP,MF,Celta Vigo,La Liga,18,2003,0.2,0,0,0,0,0,0,0,0.0,0,0,0,0,0,0,0,0,0,2022-2023,90.0,0.0,0.0
2503,Florian Sotoca,FRA,"MF,FW",Lens,Ligue 1,31,1990,33.9,39,19,11,17,11,15,40,37.5,25,41,2,39,29,68,51,0,0,2022-2023,90.0,76.99115044247787,103.53982300884957
2504,Riccardo Sottil,ITA,FW,Fiorentina,Serie A,23,1999,9.3,4,3,2,0,2,2,5,40.0,3,2,0,2,0,4,0,0,0,2022-2023,90.0,0.0,38.70967741935483
2505,Tomáš Souček,CZE,MF,West Ham,Premier League,27,1995,31.3,77,37,41,29,7,28,58,48.3,30,42,17,25,53,130,71,3,0,2022-2023,90.0,152.3961661341853,221.40575079872204
2506,Matìas Soulé,ARG,"MF,FW",Juventus,Serie A,19,2003,4.7,7,4,3,2,2,5,7,71.4,2,7,1,6,3,10,3,0,0,2022-2023,90.0,57.44680851063829,134.04255319148936
2507,Moussa Soumano,FRA,FW,Ajaccio,Ligue 1,17,2005,5.5,2,2,0,1,1,0,6,0.0,6,2,0,2,0,2,0,0,0,2022-2023,90.0,0.0,32.72727272727273
2508,Adama Soumaoro,FRA,DF,Bologna,Serie A,30,1992,20.7,25,17,11,12,2,5,7,71.4,2,18,13,5,15,40,75,1,0,2022-2023,90.0,65.21739130434783,108.69565217391305
2509,Boubakary Soumaré,FRA,MF,Leicester City,Premier League,23,1999,18.1,57,34,29,26,2,23,44,52.3,21,15,4,11,33,90,27,1,0,2022-2023,90.0,164.08839779005524,283.42541436464086
2510,Arnaud Souquet,FRA,"DF,FW",Montpellier,Ligue 1,30,1992,4.0,22,16,13,7,2,11,14,78.6,3,8,3,5,4,26,4,0,0,2022-2023,90.0,90.0,495.0
2511,Dyego Sousa,POR,FW,Almería,La Liga,32,1989,5.9,10,6,5,4,1,4,5,80.0,1,4,2,2,1,11,14,0,0,2022-2023,90.0,15.254237288135592,152.54237288135593
2512,Harry Souttar,AUS,DF,Leicester City,Premier League,23,1998,11.0,15,9,10,5,0,7,18,38.9,11,16,12,4,12,27,45,0,0,2022-2023,90.0,98.18181818181819,122.72727272727273
2513,Vinicius Souza,BRA,MF,Espanyol,La Liga,23,1999,27.0,99,66,41,45,13,33,59,55.9,26,31,14,17,48,147,50,1,0,2022-2023,90.0,160.0,330.0
2514,Djibril Sow,SUI,MF,Eint Frankfurt,Bundesliga,25,1997,29.4,41,25,13,25,3,22,44,50.0,22,22,4,18,28,69,23,0,0,2022-2023,90.0,85.71428571428572,125.51020408163265
2515,Çağlar Söyüncü,TUR,DF,Leicester City,Premier League,26,1996,5.9,14,9,10,4,0,7,10,70.0,3,9,8,1,7,21,30,0,0,2022-2023,90.0,106.77966101694915,213.5593220338983
2516,Kevin Spadanuda,SUI,"MF,FW",Ajaccio,Ligue 1,25,1997,11.8,29,18,15,9,5,12,33,36.4,21,18,0,18,11,40,5,0,0,2022-2023,90.0,83.89830508474576,221.1864406779661
2517,Djed Spence,ENG,"FW,DF",Tottenham,Premier League,21,2000,0.1,0,0,0,0,0,0,0,0.0,0,0,0,0,0,0,0,0,0,2022-2023,90.0,0.0,0.0
2518,Djed Spence,ENG,DF,Rennes,Ligue 1,21,2000,6.4,14,6,8,2,4,11,18,61.1,7,10,3,7,4,18,15,0,0,2022-2023,90.0,56.25,196.875
2519,Stijn Spierings,NED,MF,Toulouse,Ligue 1,26,1996,34.7,95,67,37,49,9,43,101,42.6,58,49,11,38,53,148,44,0,0,2022-2023,90.0,137.46397694524495,246.39769452449565
2520,Leonardo Spinazzola,ITA,DF,Roma,Serie A,29,1993,18.4,15,8,7,6,2,8,23,34.8,15,13,3,10,9,24,25,0,0,2022-2023,90.0,44.02173913043479,73.36956521739131
2521,Marco Sportiello,ITA,GK,Atalanta,Serie A,30,1992,14.9,1,0,1,0,0,1,3,33.3,2,0,0,0,0,1,2,0,0,2022-2023,90.0,0.0,6.040268456375839
2522,Jack Stacey,ENG,DF,Bournemouth,Premier League,26,1996,3.3,5,4,3,1,1,2,5,40.0,3,3,1,2,5,10,15,0,0,2022-2023,90.0,136.36363636363637,136.36363636363637
2523,Anton Stach,GER,MF,Mainz 05,Bundesliga,23,1998,23.0,27,21,10,15,2,16,38,42.1,22,28,2,26,41,68,25,0,0,2022-2023,90.0,160.43478260869566,105.65217391304348
2524,Kostas Stafylidis,GRE,"DF,MF",Bochum,Bundesliga,28,1993,11.6,27,16,13,8,6,10,24,41.7,14,21,8,13,20,47,31,1,0,2022-2023,90.0,155.17241379310346,209.48275862068965
2525,Jens Stage,DEN,MF,Werder Bremen,Bundesliga,25,1996,20.6,34,17,15,18,1,10,37,27.0,27,34,11,23,16,50,37,0,0,2022-2023,90.0,69.90291262135922,148.54368932038835
Rk,Player,Nation,Pos,Squad,Comp,0,0,90.0,0,0,3,3,3,Tkl,0,0.0,0,0,0,0,0,0,0,0,0,2022-2023,90.0,0.0,0.0
2526,Veit Stange,GER,MF,Hertha BSC,Bundesliga,18,2004,0.1,1,1,1,0,0,1,1,100.0,0,0,0,0,0,1,0,0,0,2022-2023,90.0,0.0,900.0
2527,Josip Stanišić,CRO,DF,Bayern Munich,Bundesliga,22,2000,6.4,19,11,14,2,3,12,17,70.6,5,9,1,8,7,26,11,3,0,2022-2023,90.0,98.4375,267.1875
2528,Junior Stanislas,ENG,MF,Bournemouth,Premier League,32,1989,0.7,0,0,0,0,0,0,0,0.0,0,2,1,1,0,0,0,0,0,2022-2023,90.0,0.0,0.0
2529,Jay Stansfield,ENG,FW,Fulham,Premier League,19,2002,1.0,0,0,0,0,0,0,2,0.0,2,4,1,3,1,1,1,0,0,2022-2023,90.0,90.0,0.0
2530,Niklas Stark,GER,DF,Werder Bremen,Bundesliga,27,1995,23.1,56,36,29,24,3,27,42,64.3,15,24,13,11,37,93,110,0,0,2022-2023,89.99999999999999,144.15584415584414,218.18181818181816
2531,Jason Steele,ENG,GK,Brighton,Premier League,31,1990,15.0,0,0,0,0,0,0,1,0.0,1,0,0,0,0,0,6,1,0,2022-2023,90.0,0.0,0.0
2532,Calvin Stengs,NED,FW,Nice,Ligue 1,23,1998,2.4,2,2,1,0,1,1,2,50.0,1,0,0,0,0,2,0,0,0,2022-2023,90.0,0.0,75.0
2533,Pascal Stenzel,GER,DF,Stuttgart,Bundesliga,26,1996,3.7,12,8,8,4,0,5,9,55.6,4,9,2,7,5,17,6,0,0,2022-2023,90.0,121.62162162162161,291.8918918918919
2534,Jack Stephens,ENG,DF,Southampton,Premier League,28,1994,0.5,2,2,2,0,0,1,1,100.0,0,1,1,0,1,3,2,0,0,2022-2023,90.0,180.0,360.0
2535,Jack Stephens,ENG,DF,Bournemouth,Premier League,28,1994,13.0,15,11,10,4,1,6,10,60.0,4,23,16,7,16,31,53,0,0,2022-2023,90.00000000000001,110.76923076923077,103.84615384615385
2536,Raheem Sterling,ENG,"FW,MF",Chelsea,Premier League,27,1994,21.0,18,10,5,4,9,8,14,57.1,6,17,0,17,2,20,5,0,0,2022-2023,90.0,8.571428571428571,77.14285714285714
2537,Angelo Stiller,GER,MF,Hoffenheim,Bundesliga,21,2001,7.8,26,12,9,13,4,8,12,66.7,4,12,2,10,10,36,14,0,0,2022-2023,90.0,115.38461538461539,300.0
2538,Lars Stindl,GER,"FW,MF",Gladbach,Bundesliga,33,1988,19.3,24,14,4,17,3,10,28,35.7,18,24,5,19,11,35,19,0,0,2022-2023,90.0,51.295336787564764,111.91709844559584
2539,Kevin Stöger,AUT,MF,Bochum,Bundesliga,28,1993,28.9,84,45,38,32,14,31,94,33.0,63,27,4,23,26,110,21,1,0,2022-2023,90.00000000000001,80.9688581314879,261.59169550173016
2540,Petar Stojanović,SVN,DF,Empoli,Serie A,26,1995,17.0,42,22,28,10,4,26,43,60.5,17,17,5,12,11,53,55,0,0,2022-2023,90.0,58.23529411764706,222.35294117647058
2541,John Stones,ENG,"DF,MF",Manchester City,Premier League,28,1994,20.5,23,13,11,8,4,7,10,70.0,3,17,10,7,9,32,40,0,0,2022-2023,90.0,39.51219512195122,100.97560975609757
2542,Jørgen Strand Larsen,NOR,FW,Celta Vigo,La Liga,22,2000,18.9,15,7,3,5,7,7,30,23.3,23,14,5,9,3,18,24,0,0,2022-2023,90.0,14.285714285714286,71.42857142857143
2543,Tony Strata,FRA,"MF,DF",Ajaccio,Ligue 1,17,2004,1.5,4,3,4,0,0,4,5,80.0,1,2,0,2,1,5,7,0,0,2022-2023,90.0,60.0,240.0
2544,Gabriel Strefezza,BRA,"FW,MF",Lecce,Serie A,25,1997,27.1,50,24,18,20,12,27,53,50.9,26,36,3,33,16,66,15,0,0,2022-2023,90.0,53.13653136531365,166.05166051660518
2545,Dávid Strelec,SVK,FW,Spezia,Serie A,21,2001,1.9,2,2,0,1,1,2,2,100.0,0,0,0,0,0,2,0,0,0,2022-2023,90.0,0.0,94.73684210526315
2546,Pascal Struijk,NED,DF,Leeds United,Premier League,22,1999,24.4,84,57,43,31,10,49,75,65.3,26,32,12,20,32,116,70,1,0,2022-2023,90.0,118.03278688524591,309.83606557377055
2547,Cristhian Stuani,URU,FW,Girona,La Liga,35,1986,12.1,13,6,2,7,4,5,14,35.7,9,10,0,10,2,15,5,0,0,2022-2023,90.0,14.87603305785124,96.69421487603306
2548,Damián Suárez,URU,"DF,MF",Getafe,La Liga,34,1988,21.6,49,33,23,19,7,26,48,54.2,22,40,0,40,15,64,36,0,0,2022-2023,90.0,62.49999999999999,204.16666666666666
2549,Denis Suárez,ESP,"MF,FW",Espanyol,La Liga,28,1994,10.5,26,20,12,12,2,13,45,28.9,32,11,1,10,5,31,4,0,0,2022-2023,90.0,42.857142857142854,222.85714285714286
2550,Mario Suárez,ESP,"MF,DF",Rayo Vallecano,La Liga,35,1987,0.1,0,0,0,0,0,0,0,0.0,0,1,0,1,0,0,0,0,0,2022-2023,90.0,0.0,0.0
Rk,Player,Nation,Pos,Squad,Comp,0,0,90.0,0,0,3,3,3,Tkl,0,0.0,0,0,0,0,0,0,0,0,0,2022-2023,90.0,0.0,0.0
2551,Gabriel Suazo,CHI,DF,Toulouse,Ligue 1,24,1997,14.0,38,22,20,15,3,29,63,46.0,34,21,5,16,22,60,24,1,0,2022-2023,90.0,141.42857142857142,244.28571428571428
2552,Isaac Success,NGA,FW,Udinese,Serie A,26,1996,20.2,8,4,2,5,1,3,8,37.5,5,13,2,11,4,12,18,0,0,2022-2023,90.0,17.821782178217823,35.64356435643565
2553,Niklas Süle,GER,DF,Dortmund,Bundesliga,26,1995,23.5,25,19,18,3,4,14,23,60.9,9,28,19,9,17,42,53,0,0,2022-2023,90.0,65.1063829787234,95.74468085106382
2554,Ibrahim Sulemana,GHA,MF,Hellas Verona,Serie A,19,2003,7.2,19,13,10,7,2,6,12,50.0,6,8,2,6,14,33,15,0,0,2022-2023,90.0,175.0,237.5
2555,Kamaldeen Sulemana,GHA,"FW,MF",Southampton,Premier League,20,2002,10.7,15,9,4,7,4,4,14,28.6,10,16,0,16,6,21,6,0,0,2022-2023,90.0,50.46728971962617,126.16822429906543
2556,Kamaldeen Sulemana,GHA,"FW,MF",Rennes,Ligue 1,20,2002,3.6,6,3,1,4,1,1,5,20.0,4,2,0,2,4,10,2,0,0,2022-2023,90.0,100.0,150.0
2557,Crysencio Summerville,NED,FW,Leeds United,Premier League,20,2001,15.8,30,20,14,14,2,11,23,47.8,12,20,2,18,13,43,11,0,0,2022-2023,90.0,74.0506329113924,170.88607594936707
2558,Ivan Šunjić,CRO,MF,Hertha BSC,Bundesliga,25,1996,11.0,38,20,16,21,1,16,24,66.7,8,17,5,12,13,51,19,1,0,2022-2023,90.0,106.36363636363637,310.90909090909093
2559,Sam Surridge,ENG,FW,Nott'ham Forest,Premier League,24,1998,3.6,5,0,1,3,1,1,4,25.0,3,5,2,3,0,5,7,0,0,2022-2023,90.0,0.0,125.0
2560,Suso,ESP,"MF,FW",Sevilla,La Liga,28,1993,11.8,16,10,5,7,4,10,22,45.5,12,7,1,6,2,18,3,0,0,2022-2023,90.0,15.254237288135592,122.03389830508473
2561,Yuito Suzuki,JPN,"FW,MF",Strasbourg,Ligue 1,20,2001,0.4,0,0,0,0,0,0,0,0.0,0,3,0,3,0,0,0,0,0,2022-2023,90.0,0.0,0.0
2562,Mattias Svanberg,SWE,"MF,FW",Wolfsburg,Bundesliga,23,1999,20.4,25,16,8,16,1,10,30,33.3,20,27,5,22,21,46,25,1,0,2022-2023,90.0,92.64705882352942,110.29411764705883
2563,Mile Svilar,SRB,GK,Roma,Serie A,22,1999,3.0,0,0,0,0,0,0,0,0.0,0,0,0,0,0,0,1,0,0,2022-2023,90.0,0.0,0.0
2564,Williot Swedberg,SWE,MF,Celta Vigo,La Liga,18,2004,0.6,3,1,1,0,2,0,0,0.0,0,2,0,2,0,3,1,0,0,2022-2023,90.0,0.0,450.00000000000006
2565,Issiaga Sylla,GUI,DF,Montpellier,Ligue 1,28,1994,14.5,28,16,19,8,1,15,31,48.4,16,19,3,16,32,60,35,0,0,2022-2023,90.0,198.6206896551724,173.79310344827584
2566,Issiaga Sylla,GUI,DF,Toulouse,Ligue 1,28,1994,15.2,28,15,14,9,5,15,34,44.1,19,15,5,10,38,66,38,0,0,2022-2023,90.0,225.0,165.78947368421052
2567,Wojciech Szczęsny,POL,GK,Juventus,Serie A,32,1990,27.5,1,0,1,0,0,0,1,0.0,1,0,0,0,0,1,7,0,0,2022-2023,89.99999999999999,0.0,3.2727272727272725
2568,Dominik Szoboszlai,HUN,"MF,FW",RB Leipzig,Bundesliga,21,2000,27.2,45,28,12,20,13,17,42,40.5,25,43,2,41,17,62,27,0,0,2022-2023,90.0,56.25,148.89705882352942
2569,Alexander Sørloth,NOR,FW,Real Sociedad,La Liga,26,1995,26.5,18,9,3,6,9,7,14,50.0,7,15,1,14,2,20,26,1,0,2022-2023,90.0,6.792452830188679,61.13207547169811
2570,Alexander Sørloth,NOR,FW,RB Leipzig,Bundesliga,26,1995,0.1,0,0,0,0,0,0,0,0.0,0,0,0,0,0,0,0,0,0,2022-2023,90.0,0.0,0.0
2571,Nicolás Tagliafico,ARG,DF,Lyon,Ligue 1,29,1992,33.2,91,53,36,41,14,50,78,64.1,28,45,11,34,57,148,47,0,0,2022-2023,90.0,154.5180722891566,246.68674698795178
2572,Jonathan Tah,GER,DF,Leverkusen,Bundesliga,26,1996,27.6,25,12,21,4,0,12,18,66.7,6,30,18,12,40,65,118,0,0,2022-2023,90.0,130.43478260869563,81.52173913043477
2573,Benjamin Tahirovic,BIH,MF,Roma,Serie A,19,2003,3.9,8,5,5,2,1,4,12,33.3,8,9,4,5,3,11,3,0,0,2022-2023,90.0,69.23076923076923,184.6153846153846
2574,Waniss Taibi,FRA,MF,Angers,Ligue 1,20,2002,2.1,9,5,4,4,1,2,4,50.0,2,1,0,1,2,11,2,0,0,2022-2023,90.0,85.71428571428571,385.7142857142857
2575,Flavien Tait,FRA,MF,Rennes,Ligue 1,29,1993,18.7,30,15,8,17,5,19,42,45.2,23,16,4,12,20,50,12,0,0,2022-2023,90.0,96.2566844919786,144.3850267379679
Rk,Player,Nation,Pos,Squad,Comp,0,0,90.0,0,0,3,3,3,Tkl,0,0.0,0,0,0,0,0,0,0,0,0,2022-2023,90.0,0.0,0.0
2576,Montassar Talbi,TUN,DF,Lorient,Ligue 1,24,1998,38.0,53,25,40,13,0,22,35,62.9,13,55,34,21,40,93,190,3,0,2022-2023,90.0,94.73684210526316,125.52631578947368
2577,Thibault Tamas,FRA,DF,Montpellier,Ligue 1,21,2001,0.1,0,0,0,0,0,0,0,0.0,0,0,0,0,1,1,0,0,0,2022-2023,90.0,900.0,0.0
2578,Adrien Tameze,CMR,MF,Hellas Verona,Serie A,28,1994,33.7,51,30,21,26,4,28,63,44.4,35,51,14,37,37,88,55,2,0,2022-2023,90.0,98.81305637982196,136.20178041543025
2579,Japhet Tanganga,ENG,DF,Tottenham,Premier League,23,1999,1.6,3,2,3,0,0,1,5,20.0,4,1,0,1,2,5,8,0,0,2022-2023,90.0,112.5,168.75
2580,Renato Tapia,PER,"MF,DF",Celta Vigo,La Liga,27,1995,16.1,47,25,21,21,5,18,37,48.6,19,29,11,18,19,66,37,0,0,2022-2023,90.0,106.21118012422359,262.7329192546584
2581,Edmond Tapsoba,BFA,DF,Leverkusen,Bundesliga,23,1999,31.9,51,30,35,12,4,30,42,71.4,12,40,17,23,36,87,109,1,0,2022-2023,90.0,101.56739811912226,143.8871473354232
2582,Florian Tardieu,FRA,MF,Troyes,Ligue 1,30,1992,11.2,31,20,19,12,0,12,31,38.7,19,19,4,15,23,54,15,0,0,2022-2023,90.0,184.82142857142858,249.10714285714286
2583,Matt Targett,ENG,DF,Newcastle Utd,Premier League,26,1995,6.8,13,10,8,3,2,9,24,37.5,15,8,3,5,9,22,16,0,0,2022-2023,90.0,119.11764705882352,172.05882352941177
2584,James Tarkowski,ENG,DF,Everton,Premier League,29,1992,38.0,51,26,36,13,2,20,39,51.3,19,99,78,21,51,102,201,3,0,2022-2023,90.0,120.78947368421052,120.78947368421052
2585,Ciprian Tătărușanu,ROU,GK,Milan,Serie A,36,1986,16.0,0,0,0,0,0,0,0,0.0,0,0,0,0,1,1,2,0,0,2022-2023,90.0,5.625,0.0
2586,Niklas Tauer,GER,"DF,MF",Mainz 05,Bundesliga,21,2001,1.0,2,1,2,0,0,1,3,33.3,2,2,1,1,2,4,4,0,0,2022-2023,90.0,180.0,180.0
2587,Nuno Tavares,POR,"DF,MF",Marseille,Ligue 1,22,2000,26.1,56,30,19,24,13,28,56,50.0,28,32,4,28,15,71,25,0,0,2022-2023,90.0,51.72413793103448,193.10344827586204
2588,Marcus Tavernier,ENG,"MF,FW",Bournemouth,Premier League,23,1999,19.4,33,22,19,11,3,11,33,33.3,22,25,4,21,9,42,23,0,0,2022-2023,90.0,41.75257731958764,153.09278350515467
2589,Enzo Tchato,CMR,DF,Montpellier,Ligue 1,19,2002,12.2,26,17,14,11,1,13,22,59.1,9,17,2,15,7,33,33,0,0,2022-2023,90.0,51.63934426229509,191.8032786885246
2590,Aurélien Tchouaméni,FRA,MF,Real Madrid,La Liga,22,2000,23.5,64,40,23,36,5,23,38,60.5,15,20,6,14,49,113,50,0,0,2022-2023,90.0,187.65957446808508,245.1063829787234
2591,Mathys Tel,FRA,FW,Bayern Munich,Bundesliga,17,2005,4.6,2,2,0,1,1,1,1,100.0,0,5,1,4,0,2,2,0,0,2022-2023,90.0,0.0,39.130434782608695
2592,Semir Telalovic,GER,"MF,FW",Gladbach,Bundesliga,22,1999,0.1,0,0,0,0,0,0,0,0.0,0,0,0,0,0,0,0,0,0,2022-2023,90.0,0.0,0.0
2593,Alex Telles,BRA,DF,Sevilla,La Liga,29,1992,15.9,21,13,15,6,0,13,25,52.0,12,17,5,12,20,41,38,0,0,2022-2023,90.0,113.20754716981132,118.86792452830188
2594,Marc-André ter Stegen,GER,GK,Barcelona,La Liga,30,1992,37.2,0,0,0,0,0,0,0,0.0,0,0,0,0,1,1,7,3,0,2022-2023,90.0,2.419354838709677,0.0
2595,Simon Terodde,GER,FW,Schalke 04,Bundesliga,34,1988,20.3,15,8,4,7,4,3,14,21.4,11,6,2,4,6,21,9,0,0,2022-2023,90.0,26.600985221674875,66.50246305418719
2596,Filippo Terracciano,ITA,"DF,MF",Hellas Verona,Serie A,19,2003,9.1,20,13,11,7,2,15,20,75.0,5,7,4,3,10,30,14,0,0,2022-2023,90.0,98.9010989010989,197.8021978021978
2597,Pietro Terracciano,ITA,GK,Fiorentina,Serie A,32,1990,29.0,2,1,2,0,0,2,3,66.7,1,0,0,0,1,3,14,0,0,2022-2023,90.0,3.103448275862069,6.206896551724138
2598,Ramón Terrats,ESP,MF,Villarreal,La Liga,21,2000,9.1,15,10,3,8,4,9,17,52.9,8,11,4,7,8,23,6,2,0,2022-2023,90.0,79.12087912087912,148.35164835164835
2599,Ramón Terrats,ESP,MF,Girona,La Liga,21,2000,2.4,4,2,1,3,0,2,6,33.3,4,6,2,4,3,7,3,1,0,2022-2023,90.0,112.50000000000001,150.0
2600,Martin Terrier,FRA,"FW,MF",Rennes,Ligue 1,25,1997,14.7,25,11,7,9,9,13,24,54.2,11,15,2,13,14,39,6,0,0,2022-2023,90.0,85.71428571428572,153.06122448979593
Rk,Player,Nation,Pos,Squad,Comp,0,0,90.0,0,0,3,3,3,Tkl,0,0.0,0,0,0,0,0,0,0,0,0,2022-2023,90.0,0.0,0.0
2601,Aleksa Terzić,SRB,DF,Fiorentina,Serie A,22,1999,10.4,16,9,9,4,3,11,21,52.4,10,13,4,9,5,21,16,0,0,2022-2023,90.0,43.26923076923077,138.46153846153845
2602,Tetê,BRA,FW,Leicester City,Premier League,22,2000,8.2,14,8,5,7,2,6,21,28.6,15,9,0,9,2,16,3,0,0,2022-2023,90.0,21.951219512195124,153.65853658536588
2603,Tetê,BRA,"FW,MF",Lyon,Ligue 1,22,2000,12.3,21,10,8,5,8,10,19,52.6,9,9,0,9,13,34,2,0,0,2022-2023,89.99999999999999,95.12195121951218,153.65853658536582
2604,Kenny Tete,NED,DF,Fulham,Premier League,26,1995,28.5,83,46,41,29,13,38,51,74.5,13,48,17,31,52,135,81,1,0,2022-2023,90.0,164.21052631578948,262.10526315789474
2605,Florian Thauvin,FRA,"FW,MF",Udinese,Serie A,29,1993,6.1,2,1,0,2,0,2,13,15.4,11,5,0,5,2,4,2,0,0,2022-2023,90.0,29.508196721311478,29.508196721311478
2606,Arthur Theate,BEL,DF,Rennes,Ligue 1,22,2000,34.7,29,19,17,8,4,17,30,56.7,13,26,14,12,30,59,114,3,0,2022-2023,90.0,77.80979827089337,75.21613832853025
2607,Malick Thiaw,GER,DF,Milan,Serie A,20,2001,15.1,31,26,22,9,0,11,20,55.0,9,11,5,6,12,43,65,1,0,2022-2023,90.0,71.52317880794702,184.7682119205298
2608,Malick Thiaw,GER,DF,Schalke 04,Bundesliga,20,2001,3.0,3,1,2,1,0,1,2,50.0,1,4,3,1,9,12,24,1,0,2022-2023,90.0,270.0,90.0
2609,Jan Thielmann,GER,FW,Köln,Bundesliga,20,2002,9.7,9,8,3,4,2,2,11,18.2,9,16,3,13,9,18,7,0,0,2022-2023,90.0,83.50515463917527,83.50515463917527
2610,Sada Thioub,SEN,"DF,FW",Angers,Ligue 1,27,1995,11.8,19,10,9,8,2,8,17,47.1,9,13,0,13,7,26,5,1,0,2022-2023,90.0,53.389830508474574,144.9152542372881
2611,Luke Thomas,ENG,DF,Leicester City,Premier League,21,2001,11.9,23,19,15,5,3,15,32,46.9,17,20,4,16,27,50,35,0,0,2022-2023,90.00000000000001,204.20168067226894,173.9495798319328
2612,Adrien Thomasson,FRA,MF,Strasbourg,Ligue 1,28,1993,10.4,19,9,8,6,5,9,30,30.0,21,18,0,18,3,22,2,0,0,2022-2023,90.0,25.96153846153846,164.4230769230769
2613,Adrien Thomasson,FRA,"MF,FW",Lens,Ligue 1,28,1993,14.2,24,17,8,11,5,12,45,26.7,33,25,2,23,4,28,17,0,0,2022-2023,90.0,25.35211267605634,152.11267605633805
2614,Morten Thorsby,NOR,MF,Union Berlin,Bundesliga,26,1996,9.3,22,10,9,11,2,13,21,61.9,8,11,5,6,3,25,20,0,0,2022-2023,90.0,29.032258064516125,212.9032258064516
2615,Kristian Thorstvedt,NOR,MF,Sassuolo,Serie A,23,1999,12.6,16,7,4,9,3,6,17,35.3,11,19,5,14,14,30,13,0,0,2022-2023,90.0,100.00000000000001,114.28571428571429
2616,Khéphren Thuram,FRA,MF,Nice,Ligue 1,21,2001,28.3,51,25,22,23,6,19,43,44.2,24,33,13,20,38,89,34,0,0,2022-2023,90.0,120.84805653710247,162.19081272084804
2617,Marcus Thuram,FRA,FW,Gladbach,Bundesliga,24,1997,27.9,14,7,3,6,5,6,13,46.2,7,20,3,17,6,20,22,0,0,2022-2023,90.0,19.35483870967742,45.16129032258065
2618,Alexis Tibidi,FRA,"FW,MF",Troyes,Ligue 1,18,2003,0.8,1,1,1,0,0,0,0,0.0,0,0,0,0,0,1,0,0,0,2022-2023,90.0,0.0,112.5
2619,Youri Tielemans,BEL,MF,Leicester City,Premier League,25,1997,26.0,66,39,27,30,9,23,62,37.1,39,35,8,27,28,94,24,1,0,2022-2023,90.00000000000001,96.92307692307693,228.46153846153848
2620,Kieran Tierney,SCO,DF,Arsenal,Premier League,25,1997,8.8,20,11,9,9,2,12,16,75.0,4,8,2,6,11,31,25,0,0,2022-2023,90.0,112.5,204.54545454545453
2621,Steffen Tigges,GER,FW,Köln,Bundesliga,24,1998,17.7,12,7,1,8,3,4,14,28.6,10,13,2,11,8,20,17,0,0,2022-2023,90.0,40.67796610169492,61.016949152542374
2622,Jean-Clair Todibo,FRA,DF,Nice,Ligue 1,22,1999,31.9,76,48,54,19,3,41,56,73.2,15,41,19,22,41,117,110,2,0,2022-2023,90.0,115.67398119122257,214.42006269592477
2623,Harry Toffolo,ENG,DF,Nott'ham Forest,Premier League,26,1995,10.4,17,8,10,4,3,10,14,71.4,4,16,8,8,10,27,33,0,0,2022-2023,90.0,86.53846153846153,147.1153846153846
2624,Umut Tohumcu,GER,"MF,DF",Hoffenheim,Bundesliga,17,2004,3.0,10,5,4,5,1,3,9,33.3,6,4,0,4,2,12,8,0,0,2022-2023,90.0,60.0,300.0
2625,Karl Toko Ekambi,CMR,"FW,MF",Rennes,Ligue 1,29,1992,10.8,3,1,1,1,1,3,9,33.3,6,5,0,5,9,12,3,0,0,2022-2023,90.0,75.0,24.999999999999996
Rk,Player,Nation,Pos,Squad,Comp,0,0,90.0,0,0,3,3,3,Tkl,0,0.0,0,0,0,0,0,0,0,0,0,2022-2023,90.0,0.0,0.0
2626,Karl Toko Ekambi,CMR,"FW,MF",Lyon,Ligue 1,29,1992,15.0,9,9,2,4,3,4,15,26.7,11,12,2,10,9,18,6,0,0,2022-2023,90.0,54.0,54.0
2627,Corentin Tolisso,FRA,MF,Lyon,Ligue 1,27,1994,22.6,44,27,16,23,5,25,66,37.9,41,25,5,20,24,68,23,1,0,2022-2023,90.0,95.57522123893806,175.2212389380531
2628,Jeremy Toljan,GER,DF,Sassuolo,Serie A,27,1994,29.7,36,23,17,14,5,22,33,66.7,11,31,14,17,18,54,60,1,0,2022-2023,90.0,54.54545454545454,109.09090909090908
2629,Rafael Tolói,ITA,DF,Atalanta,Serie A,31,1990,30.9,69,44,37,32,0,35,64,54.7,29,42,18,24,57,126,88,1,0,2022-2023,90.0,166.01941747572815,200.97087378640776
2630,Raúl de Tomás,ESP,FW,Rayo Vallecano,La Liga,27,1994,8.9,3,2,0,1,2,2,6,33.3,4,4,0,4,0,3,6,0,0,2022-2023,90.0,0.0,30.337078651685395
2631,Tiago Tomás,POR,"FW,MF",Stuttgart,Bundesliga,20,2002,14.3,10,4,2,4,4,8,13,61.5,5,9,2,7,1,11,5,0,0,2022-2023,90.0,6.293706293706294,62.93706293706294
2632,Takehiro Tomiyasu,JPN,DF,Arsenal,Premier League,23,1998,7.4,27,18,12,10,5,13,18,72.2,5,7,0,7,14,41,15,1,0,2022-2023,90.0,170.27027027027026,328.3783783783784
2633,James Tomkins,ENG,DF,Crystal Palace,Premier League,33,1989,3.8,4,2,2,1,1,1,3,33.3,2,3,2,1,5,9,19,0,0,2022-2023,90.0,118.42105263157895,94.73684210526315
2634,Fikayo Tomori,ENG,DF,Milan,Serie A,24,1997,30.7,70,34,44,25,1,22,34,64.7,12,46,25,21,29,99,88,1,0,2022-2023,90.0,85.01628664495115,205.21172638436482
2635,Sandro Tonali,ITA,MF,Milan,Serie A,22,2000,30.1,64,41,35,24,5,27,44,61.4,17,34,9,25,25,89,26,1,0,2022-2023,90.00000000000001,74.75083056478405,191.36212624584718
2636,Lorenzo Tonelli,ITA,DF,Empoli,Serie A,32,1990,0.2,0,0,0,0,0,0,1,0.0,1,0,0,0,0,0,0,0,0,2022-2023,90.0,0.0,0.0
2637,Ivan Toney,ENG,FW,Brentford,Premier League,26,1996,32.8,23,13,4,9,10,7,23,30.4,16,24,9,15,14,37,36,0,0,2022-2023,90.0,38.41463414634147,63.10975609756098
2638,Pablo Torre,ESP,"FW,MF",Barcelona,La Liga,19,2003,1.6,2,1,0,1,1,2,4,50.0,2,1,0,1,2,4,1,0,0,2022-2023,90.0,112.5,112.5
2639,David Torres,ESP,DF,Valladolid,La Liga,19,2003,4.3,1,1,0,1,0,1,1,100.0,0,4,2,2,3,4,8,0,0,2022-2023,90.0,62.79069767441861,20.930232558139537
2640,Ferrán Torres,ESP,"FW,MF",Barcelona,La Liga,22,2000,15.5,13,7,4,5,4,5,20,25.0,15,11,2,9,3,16,5,0,0,2022-2023,90.0,17.419354838709676,75.48387096774194
2641,Óliver Torres,ESP,"MF,FW",Sevilla,La Liga,27,1994,23.7,39,23,12,13,14,18,59,30.5,41,26,5,21,10,49,10,0,0,2022-2023,90.0,37.9746835443038,148.10126582278482
2642,Pau Torres,ESP,DF,Villarreal,La Liga,25,1997,33.9,43,25,25,13,5,23,36,63.9,13,36,27,9,13,56,146,3,0,2022-2023,90.0,34.51327433628319,114.15929203539824
2643,Roberto Torres,ESP,"FW,MF",Osasuna,La Liga,33,1989,0.1,0,0,0,0,0,0,0,0.0,0,0,0,0,0,0,0,0,0,2022-2023,90.0,0.0,0.0
2644,Lucas Torró,ESP,MF,Osasuna,La Liga,28,1994,27.5,48,32,28,15,5,18,42,42.9,24,24,3,21,42,90,64,1,0,2022-2023,89.99999999999999,137.45454545454544,157.09090909090907
2645,Nabil Touaizi,MAR,MF,Espanyol,La Liga,21,2001,0.0,0,0,0,0,0,0,0,0.0,0,0,0,0,0,0,0,0,0,2022-2023,,,
2646,Almamy Touré,MLI,DF,Eint Frankfurt,Bundesliga,26,1996,4.4,13,7,7,5,1,5,9,55.6,4,9,2,7,10,23,8,0,0,2022-2023,90.0,204.54545454545453,265.9090909090909
2647,Birama Touré,MLI,MF,Auxerre,Ligue 1,30,1992,37.8,80,47,35,35,10,34,93,36.6,59,54,9,45,67,147,49,0,0,2022-2023,90.0,159.52380952380952,190.47619047619048
2648,Mohamed Toure,AUS,"FW,MF",Reims,Ligue 1,18,2004,0.3,0,0,0,0,0,0,0,0.0,0,0,0,0,0,0,0,0,0,2022-2023,90.0,0.0,0.0
2649,Souleymane Touré,FRA,DF,Marseille,Ligue 1,19,2003,0.8,2,1,1,1,0,1,2,50.0,1,1,0,1,0,2,5,0,0,2022-2023,90.0,0.0,225.0
2650,Souleymane Touré,FRA,DF,Auxerre,Ligue 1,19,2003,17.6,29,13,19,9,1,16,20,80.0,4,32,12,20,26,55,56,1,0,2022-2023,90.0,132.95454545454544,148.29545454545453
Rk,Player,Nation,Pos,Squad,Comp,0,0,90.0,0,0,3,3,3,Tkl,0,0.0,0,0,0,0,0,0,0,0,0,2022-2023,90.0,0.0,0.0
2651,Lucas Tousart,FRA,MF,Hertha BSC,Bundesliga,25,1997,32.7,73,38,35,28,10,27,60,45.0,33,42,6,36,48,121,75,1,0,2022-2023,90.0,132.11009174311926,200.91743119266056
2652,Yoann Touzghar,TUN,FW,Ajaccio,Ligue 1,35,1986,5.0,3,2,0,2,1,0,1,0.0,1,0,0,0,0,3,1,0,0,2022-2023,90.0,0.0,54.0
2653,Adama Traoré,ESP,"FW,MF",Wolves,Premier League,26,1996,16.6,14,7,7,4,3,4,9,44.4,5,8,1,7,3,17,17,0,0,2022-2023,90.0,16.265060240963855,75.90361445783131
2654,Bertrand Traoré,BFA,"FW,MF",Aston Villa,Premier League,26,1995,2.6,1,1,1,0,0,1,4,25.0,3,5,0,5,2,3,0,0,0,2022-2023,90.0,69.23076923076923,34.61538461538461
2655,Boubacar Traoré,MLI,MF,Wolves,Premier League,20,2001,4.6,12,5,4,5,3,3,7,42.9,4,4,2,2,7,19,1,0,0,2022-2023,90.0,136.95652173913044,234.7826086956522
2656,Charles Traore,MLI,DF,Nantes,Ligue 1,30,1992,5.4,8,5,5,2,1,5,7,71.4,2,9,2,7,10,18,12,0,0,2022-2023,90.0,166.66666666666666,133.33333333333331
2657,Hamari Traoré,MLI,DF,Rennes,Ligue 1,30,1992,28.1,48,32,26,15,7,28,52,53.8,24,33,7,26,38,86,64,0,0,2022-2023,90.0,121.70818505338077,153.73665480427044
2658,Kevin Trapp,GER,GK,Eint Frankfurt,Bundesliga,32,1990,33.0,1,1,1,0,0,0,2,0.0,2,2,0,2,0,1,10,0,0,2022-2023,90.0,0.0,2.7272727272727275
2659,Mark Travers,IRL,GK,Bournemouth,Premier League,23,1999,11.5,0,0,0,0,0,0,0,0.0,0,1,0,1,0,0,6,0,0,2022-2023,90.0,0.0,0.0
2660,Óscar Trejo,ARG,"MF,FW",Rayo Vallecano,La Liga,34,1988,23.8,48,32,12,23,13,9,44,20.5,35,31,3,28,8,56,8,1,0,2022-2023,90.00000000000001,30.252100840336137,181.51260504201682
2661,Manu Trigueros,ESP,MF,Villarreal,La Liga,30,1991,9.2,20,14,9,5,6,9,22,40.9,13,9,2,7,5,25,4,0,0,2022-2023,90.0,48.913043478260875,195.6521739130435
2662,Christopher Trimmel,AUT,DF,Union Berlin,Bundesliga,35,1987,20.1,31,16,16,12,3,20,31,64.5,11,14,1,13,25,56,48,0,0,2022-2023,90.0,111.94029850746267,138.8059701492537
2663,Théo Trinker,FRA,MF,Nice,Ligue 1,21,2001,0.0,0,0,0,0,0,0,0,0.0,0,0,0,0,0,0,0,0,0,2022-2023,,,
2664,Kieran Trippier,ENG,DF,Newcastle Utd,Premier League,31,1990,37.1,71,49,36,27,8,46,90,51.1,44,45,15,30,43,114,84,2,0,2022-2023,90.0,104.31266846361186,172.23719676549865
2665,William Troost-Ekong,NGA,DF,Salernitana,Serie A,28,1993,4.9,11,3,7,4,0,6,7,85.7,1,7,4,3,6,17,10,0,0,2022-2023,90.0,110.20408163265306,202.0408163265306
2666,Leandro Trossard,BEL,FW,Arsenal,Premier League,27,1994,10.3,12,7,4,2,6,6,18,33.3,12,18,0,18,6,18,3,1,0,2022-2023,90.0,52.42718446601942,104.85436893203884
2667,Leandro Trossard,BEL,"FW,MF",Brighton,Premier League,27,1994,14.6,10,6,7,1,2,1,8,12.5,7,17,0,17,6,16,1,0,0,2022-2023,90.0,36.986301369863014,61.64383561643836
2668,Adrien Truffert,FRA,DF,Rennes,Ligue 1,20,2001,21.7,62,32,36,17,9,31,46,67.4,15,32,8,24,22,84,55,0,0,2022-2023,90.0,91.24423963133641,257.14285714285717
2669,Frank Tsadjout,ITA,FW,Cremonese,Serie A,23,1999,11.7,10,8,3,6,1,3,9,33.3,6,7,1,6,8,18,9,0,0,2022-2023,89.99999999999999,61.53846153846153,76.92307692307692
2670,Kostas Tsimikas,GRE,DF,Liverpool,Premier League,26,1996,8.6,14,9,10,2,2,10,16,62.5,6,8,1,7,12,26,15,0,0,2022-2023,90.0,125.58139534883722,146.51162790697677
2671,Theocharis Tsingaras,GRE,MF,Toulouse,Ligue 1,21,2000,0.1,0,0,0,0,0,0,0,0.0,0,0,0,0,0,0,0,0,0,2022-2023,90.0,0.0,0.0
2672,Viktor Tsyhankov,UKR,MF,Girona,La Liga,24,1997,16.5,8,8,5,1,2,1,14,7.1,13,13,2,11,7,15,12,0,0,2022-2023,90.0,38.18181818181819,43.63636363636364
2673,Alessandro Tuia,ITA,DF,Lecce,Serie A,32,1990,5.7,10,6,6,4,0,3,9,33.3,6,3,1,2,15,25,29,0,0,2022-2023,90.0,236.84210526315786,157.89473684210526
2674,Martin Turk,SVN,GK,Sampdoria,Serie A,18,2003,4.0,0,0,0,0,0,0,0,0.0,0,0,0,0,0,0,1,0,0,2022-2023,90.0,0.0,0.0
2675,Beñat Turrientes,ESP,"MF,FW",Real Sociedad,La Liga,20,2002,1.2,3,3,3,0,0,1,5,20.0,4,2,0,2,0,3,3,0,0,2022-2023,90.0,0.0,225.00000000000003
Rk,Player,Nation,Pos,Squad,Comp,0,0,90.0,0,0,3,3,3,Tkl,0,0.0,0,0,0,0,0,0,0,0,0,2022-2023,90.0,0.0,0.0
2676,Tuta,BRA,DF,Eint Frankfurt,Bundesliga,23,1999,30.2,53,35,27,19,7,33,57,57.9,24,47,14,33,49,102,134,2,0,2022-2023,90.0,146.02649006622516,157.94701986754967
2677,Destiny Udogie,ITA,DF,Udinese,Serie A,19,2002,30.0,71,45,42,24,5,34,59,57.6,25,34,6,28,36,107,25,0,0,2022-2023,90.0,108.0,213.0
2678,Ike Ugbo,CAN,"FW,MF",Troyes,Ligue 1,23,1998,9.9,5,2,2,2,1,3,11,27.3,8,8,2,6,2,7,4,0,0,2022-2023,90.0,18.181818181818183,45.45454545454545
2679,Lesley Ugochukwu,FRA,MF,Rennes,Ligue 1,18,2004,14.8,36,19,13,20,3,16,24,66.7,8,24,10,14,21,57,16,0,0,2022-2023,90.0,127.7027027027027,218.9189189189189
2680,Samir Ujkani,KVX,GK,Empoli,Serie A,34,1988,0.1,0,0,0,0,0,0,0,0.0,0,0,0,0,0,0,0,0,0,2022-2023,90.0,0.0,0.0
2681,Sven Ulreich,GER,GK,Bayern Munich,Bundesliga,33,1988,3.0,1,1,1,0,0,1,1,100.0,0,0,0,0,0,1,0,1,0,2022-2023,90.0,0.0,30.0
2682,Lauren Ulrich,GER,MF,Stuttgart,Bundesliga,17,2005,0.1,1,1,0,0,1,0,0,0.0,0,0,0,0,0,1,0,0,0,2022-2023,90.0,0.0,900.0
2683,Samuel Umtiti,FRA,DF,Lecce,Serie A,28,1993,23.5,52,34,25,25,2,18,26,69.2,8,26,14,12,26,78,79,0,0,2022-2023,90.0,99.57446808510637,199.14893617021275
2684,Enes Ünal,TUR,FW,Getafe,La Liga,25,1997,33.0,26,14,5,19,2,7,25,28.0,18,19,2,17,6,32,35,0,0,2022-2023,90.0,16.363636363636363,70.90909090909092
2685,Deniz Undav,GER,"FW,MF",Brighton,Premier League,26,1996,7.0,7,4,2,2,3,2,8,25.0,6,4,1,3,0,7,1,0,0,2022-2023,90.0,0.0,90.0
2686,Cengiz Ünder,TUR,"MF,DF",Marseille,Ligue 1,25,1997,27.7,37,19,15,13,9,13,34,38.2,21,18,2,16,18,55,13,0,0,2022-2023,90.0,58.48375451263538,120.21660649819495
2687,Dayot Upamecano,FRA,DF,Bayern Munich,Bundesliga,23,1998,26.1,65,37,43,22,0,28,45,62.2,17,26,6,20,27,92,71,4,0,2022-2023,90.0,93.10344827586206,224.13793103448273
2688,Filip Uremović,CRO,DF,Hertha BSC,Bundesliga,25,1997,19.2,38,23,29,8,1,14,22,63.6,8,18,13,5,36,74,88,2,0,2022-2023,90.0,168.75,178.125
2689,Oscar Ureña,DOM,MF,Girona,La Liga,19,2003,1.1,4,2,2,2,0,2,3,66.7,1,2,0,2,1,5,0,0,0,2022-2023,90.0,81.81818181818181,327.27272727272725
2690,Jere Uronen,FIN,DF,Brest,Ligue 1,28,1994,3.3,8,5,4,4,0,7,12,58.3,5,6,2,4,7,15,5,0,0,2022-2023,90.0,190.9090909090909,218.1818181818182
2691,Jere Uronen,FIN,DF,Schalke 04,Bundesliga,28,1994,7.5,14,10,6,6,2,6,10,60.0,4,5,2,3,8,22,13,0,0,2022-2023,90.0,96.0,168.0
2692,Mark Uth,GER,"MF,FW",Köln,Bundesliga,30,1991,0.5,0,0,0,0,0,0,0,0.0,0,0,0,0,0,0,0,0,0,2022-2023,90.0,0.0,0.0
2693,Josha Vagnoman,GER,DF,Stuttgart,Bundesliga,21,2000,16.4,26,15,12,11,3,15,27,55.6,12,20,2,18,8,34,29,1,0,2022-2023,90.0,43.90243902439025,142.6829268292683
2694,Diego Valencia,CHI,"MF,FW",Salernitana,Serie A,22,2000,2.6,8,5,4,2,2,2,9,22.2,7,10,1,9,1,9,2,0,0,2022-2023,90.0,34.61538461538461,276.9230769230769
2695,Óscar Valentín,ESP,MF,Rayo Vallecano,La Liga,27,1994,28.4,92,51,29,50,13,46,121,38.0,75,60,9,51,44,136,30,0,0,2022-2023,90.0,139.43661971830986,291.54929577464793
2696,Emanuele Valeri,ITA,DF,Cremonese,Serie A,23,1998,30.9,54,27,29,21,4,29,69,42.0,40,17,3,14,22,76,44,1,0,2022-2023,90.0,64.07766990291262,157.28155339805826
2697,Yan Valery,TUN,DF,Southampton,Premier League,23,1999,0.5,0,0,0,0,0,0,0,0.0,0,1,0,1,0,0,3,0,0,2022-2023,90.0,0.0,0.0
2698,Yan Valery,TUN,DF,Angers,Ligue 1,23,1999,27.7,54,39,28,20,6,20,37,54.1,17,35,15,20,34,88,82,0,0,2022-2023,90.0,110.46931407942239,175.45126353790616
2699,Martin Valjent,SVK,DF,Mallorca,La Liga,26,1995,29.5,35,27,22,12,1,19,28,67.9,9,39,21,18,29,64,137,0,0,2022-2023,90.0,88.47457627118644,106.77966101694915
2700,Jesús Vallejo,ESP,DF,Real Madrid,La Liga,25,1997,0.2,0,0,0,0,0,0,0,0.0,0,0,0,0,0,0,0,0,0,2022-2023,90.0,0.0,0.0
Rk,Player,Nation,Pos,Squad,Comp,0,0,90.0,0,0,3,3,3,Tkl,0,0.0,0,0,0,0,0,0,0,0,0,2022-2023,90.0,0.0,0.0
2701,Manu Vallejo,ESP,"FW,MF",Girona,La Liga,25,1997,2.3,4,1,1,2,1,1,6,16.7,5,2,0,2,1,5,3,0,0,2022-2023,90.0,39.130434782608695,156.52173913043478
2702,Mattia Valoti,ITA,"MF,FW",Monza,Serie A,28,1993,5.0,17,10,7,9,1,5,16,31.3,11,13,3,10,3,20,6,0,0,2022-2023,90.0,54.0,306.0
2703,Federico Valverde,URU,"MF,FW",Real Madrid,La Liga,24,1998,27.8,31,20,14,11,6,13,26,50.0,13,31,4,27,17,48,15,0,0,2022-2023,90.0,55.03597122302158,100.35971223021583
2704,Virgil van Dijk,NED,DF,Liverpool,Premier League,31,1991,31.5,27,14,13,11,3,8,19,42.1,11,24,16,8,31,58,138,3,0,2022-2023,90.0,88.57142857142858,77.14285714285715
2705,Vanderson,BRA,"DF,MF",Monaco,Ligue 1,21,2001,24.6,84,48,36,34,14,44,75,58.7,31,36,9,27,48,132,36,1,0,2022-2023,89.99999999999999,175.60975609756096,307.31707317073165
2706,Raphaël Varane,FRA,DF,Manchester Utd,Premier League,29,1993,21.2,24,9,18,6,0,7,17,41.2,10,24,17,7,11,35,91,0,0,2022-2023,90.0,46.69811320754717,101.88679245283019
2707,Jamie Vardy,ENG,FW,Leicester City,Premier League,35,1987,20.6,9,5,4,2,3,1,8,12.5,7,17,3,14,2,11,30,0,0,2022-2023,90.0,8.737864077669903,39.320388349514566
2708,Ruben Vargas,SUI,"MF,FW",Augsburg,Bundesliga,23,1998,12.6,15,7,6,7,2,5,11,45.5,6,8,2,6,6,21,16,1,0,2022-2023,90.0,42.85714285714286,107.14285714285715
2709,Johan Vásquez,MEX,DF,Cremonese,Serie A,23,1998,20.1,41,26,34,7,0,18,39,46.2,21,27,20,7,45,86,93,1,0,2022-2023,90.0,201.49253731343282,183.58208955223878
2710,Jesus Vazquez,ESP,"DF,MF",Valencia,La Liga,19,2003,3.4,13,8,9,1,3,6,11,54.5,5,4,0,4,1,14,8,0,0,2022-2023,90.0,26.470588235294116,344.11764705882354
2711,Kevin Vázquez,ESP,"DF,MF",Celta Vigo,La Liga,29,1993,4.9,13,8,5,7,1,8,12,66.7,4,4,1,3,2,15,8,0,0,2022-2023,90.0,36.73469387755102,238.77551020408163
2712,Lucas Vázquez,ESP,DF,Real Madrid,La Liga,31,1991,12.7,34,23,22,10,2,20,28,71.4,8,10,0,10,7,41,13,0,0,2022-2023,90.0,49.60629921259843,240.9448818897638
2713,Matías Vecino,URU,MF,Lazio,Serie A,30,1991,18.8,47,27,13,23,11,23,48,47.9,25,33,10,23,16,63,39,1,0,2022-2023,90.0,76.59574468085106,225.0
2714,Gabriel Veiga,ESP,MF,Celta Vigo,La Liga,20,2002,25.5,43,19,14,25,4,16,52,30.8,36,30,3,27,21,64,6,0,0,2022-2023,90.0,74.11764705882354,151.76470588235296
2715,Renato Veiga,POR,DF,Augsburg,Bundesliga,19,2003,7.1,9,6,4,3,2,7,9,77.8,2,20,6,14,7,16,29,1,0,2022-2023,90.0,88.73239436619718,114.08450704225353
2716,Miloš Veljković,SRB,DF,Werder Bremen,Bundesliga,26,1995,25.2,30,19,17,13,0,18,29,62.1,11,32,16,16,33,63,103,0,0,2022-2023,90.0,117.85714285714288,107.14285714285715
2717,Miguel Veloso,POR,MF,Hellas Verona,Serie A,36,1986,12.9,33,10,20,12,1,16,26,61.5,10,26,6,20,6,39,14,0,0,2022-2023,90.0,41.860465116279066,230.23255813953486
2718,Joël Veltman,NED,DF,Brighton,Premier League,30,1992,24.3,62,32,44,14,4,37,57,64.9,20,27,8,19,19,81,51,0,0,2022-2023,90.0,70.37037037037037,229.62962962962962
2719,Micky van de Ven,NED,DF,Wolfsburg,Bundesliga,21,2001,33.0,45,30,26,18,1,28,39,71.8,11,42,24,18,26,71,108,2,0,2022-2023,90.0,70.90909090909092,122.72727272727273
2720,Unai Vencedor Paris,ESP,MF,Athletic Club,La Liga,21,2000,2.1,3,1,0,3,0,1,6,16.7,5,5,0,5,1,4,1,0,0,2022-2023,90.0,42.857142857142854,128.57142857142856
2721,Lorenzo Venuti,ITA,DF,Fiorentina,Serie A,27,1995,10.3,18,7,6,11,1,11,18,61.1,7,7,2,5,5,23,17,2,0,2022-2023,90.0,43.689320388349515,157.28155339805826
2722,Daniele Verde,ITA,"FW,MF",Spezia,Serie A,26,1996,11.1,4,4,3,0,1,3,7,42.9,4,6,0,6,8,12,4,0,0,2022-2023,90.0,64.86486486486487,32.432432432432435
2723,Simone Verdi,ITA,"MF,FW",Hellas Verona,Serie A,30,1992,12.2,15,10,7,5,3,6,17,35.3,11,8,1,7,0,15,2,0,0,2022-2023,90.0,0.0,110.65573770491804
2724,Gonzalo Verdú,ESP,DF,Elche,La Liga,33,1988,7.8,10,5,8,2,0,4,8,50.0,4,8,6,2,10,20,33,0,0,2022-2023,90.0,115.38461538461539,115.38461538461539
2725,Jordan Veretout,FRA,MF,Marseille,Ligue 1,29,1993,31.8,56,35,17,32,7,25,53,47.2,28,22,7,15,36,92,40,2,0,2022-2023,90.0,101.88679245283019,158.49056603773585
Rk,Player,Nation,Pos,Squad,Comp,0,0,90.0,0,0,3,3,3,Tkl,0,0.0,0,0,0,0,0,0,0,0,0,2022-2023,90.0,0.0,0.0
2726,Marco Verratti,ITA,MF,Paris S-G,Ligue 1,29,1992,24.4,76,49,34,36,6,38,89,42.7,51,42,6,36,27,103,11,3,0,2022-2023,90.0,99.59016393442624,280.32786885245906
2727,Valerio Verre,ITA,MF,Sampdoria,Serie A,28,1994,7.5,14,7,6,5,3,8,17,47.1,9,9,1,8,9,23,3,0,0,2022-2023,90.0,108.0,168.0
2728,Mikel Vesga,ESP,MF,Athletic Club,La Liga,29,1993,28.6,57,35,21,31,5,25,68,36.8,43,39,8,31,36,93,39,3,0,2022-2023,90.0,113.2867132867133,179.3706293706294
2729,Guglielmo Vicario,ITA,GK,Empoli,Serie A,25,1996,30.9,1,1,1,0,0,1,2,50.0,1,0,0,0,0,1,15,2,0,2022-2023,90.0,0.0,2.912621359223301
2730,João Victor,BRA,DF,Nantes,Ligue 1,24,1998,9.4,19,11,9,7,3,12,22,54.5,10,11,1,10,15,34,30,0,0,2022-2023,90.0,143.61702127659572,181.91489361702128
2731,Aleix Vidal,ESP,"MF,FW",Espanyol,La Liga,32,1989,11.4,11,5,6,3,2,4,22,18.2,18,21,2,19,15,26,14,0,0,2022-2023,90.0,118.42105263157893,86.84210526315789
2732,Clément Vidal,FRA,"DF,MF",Ajaccio,Ligue 1,22,2000,21.1,25,15,14,11,0,18,38,47.4,20,27,16,11,27,52,73,1,0,2022-2023,90.0,115.16587677725119,106.63507109004739
2733,Nacho Vidal,ESP,DF,Osasuna,La Liga,27,1995,13.9,27,14,16,6,5,17,32,53.1,15,17,4,13,19,46,33,1,0,2022-2023,90.0,123.02158273381295,174.8201438848921
2734,Gabriel Vidovic,CRO,FW,Bayern Munich,Bundesliga,18,2003,0.2,0,0,0,0,0,0,0,0.0,0,0,0,0,0,0,0,0,0,2022-2023,90.0,0.0,0.0
2735,Fabio Vieira,POR,"MF,FW",Arsenal,Premier League,22,2000,5.7,6,4,3,0,3,3,5,60.0,2,5,0,5,4,10,2,0,0,2022-2023,90.0,63.1578947368421,94.73684210526315
2736,Ronaldo Vieira,ENG,MF,Torino,Serie A,24,1998,0.2,1,0,0,1,0,1,1,100.0,0,0,0,0,0,1,2,0,0,2022-2023,90.0,0.0,450.0
2737,Ronaldo Vieira,ENG,MF,Sampdoria,Serie A,24,1998,9.1,18,10,4,12,2,10,13,76.9,3,15,5,10,13,31,10,2,0,2022-2023,90.0,128.57142857142858,178.02197802197801
2738,Emanuel Vignato,ITA,"MF,FW",Bologna,Serie A,21,2000,2.7,4,4,2,2,0,2,4,50.0,2,2,0,2,3,7,0,0,0,2022-2023,90.0,99.99999999999999,133.33333333333331
2739,Emanuel Vignato,ITA,"MF,FW",Empoli,Serie A,21,2000,0.6,2,0,2,0,0,0,0,0.0,0,0,0,0,0,2,1,0,0,2022-2023,90.0,0.0,300.0
2740,Samuele Vignato,ITA,"MF,FW",Monza,Serie A,18,2004,0.7,0,0,0,0,0,0,0,0.0,0,1,0,1,0,0,0,0,0,2022-2023,90.0,0.0,0.0
2741,Tonny Vilhena,NED,MF,Salernitana,Serie A,27,1995,25.2,44,22,16,23,5,20,50,40.0,30,17,7,10,18,62,21,0,0,2022-2023,90.0,64.28571428571429,157.14285714285717
2742,Toni Villa,ESP,MF,Valladolid,La Liga,27,1995,1.0,6,3,2,3,1,4,9,44.4,5,0,0,0,0,6,0,0,0,2022-2023,90.0,0.0,540.0
2743,Toni Villa,ESP,"MF,FW",Girona,La Liga,27,1995,9.9,25,18,9,11,5,10,23,43.5,13,8,0,8,8,33,3,0,0,2022-2023,90.0,72.72727272727273,227.27272727272728
2744,Asier Villalibre,ESP,FW,Athletic Club,La Liga,24,1997,1.1,0,0,0,0,0,0,0,0.0,0,0,0,0,0,0,1,0,0,2022-2023,90.0,0.0,0.0
2745,Gonzalo Villar,ESP,MF,Sampdoria,Serie A,24,1998,7.7,13,7,4,8,1,7,15,46.7,8,11,3,8,4,17,9,1,0,2022-2023,90.0,46.753246753246756,151.94805194805195
2746,Gonzalo Villar,ESP,MF,Getafe,La Liga,24,1998,5.1,10,5,1,6,3,6,14,42.9,8,9,2,7,6,16,5,0,0,2022-2023,90.0,105.88235294117648,176.47058823529412
2747,Iván Villar,ESP,GK,Celta Vigo,La Liga,25,1997,19.0,0,0,0,0,0,0,1,0.0,1,0,0,0,0,0,7,0,0,2022-2023,90.0,0.0,0.0
2748,Matías Viña,URU,DF,Bournemouth,Premier League,24,1997,5.1,19,11,9,8,2,14,30,46.7,16,13,1,12,4,23,22,0,0,2022-2023,90.0,70.58823529411765,335.29411764705884
2749,Matías Viña,URU,DF,Roma,Serie A,24,1997,0.6,3,1,1,1,1,1,3,33.3,2,5,1,4,2,5,5,0,0,2022-2023,90.0,300.0,450.00000000000006
2750,Rúben Vinagre,POR,"DF,MF",Everton,Premier League,23,1999,0.3,2,2,1,1,0,1,2,50.0,1,0,0,0,0,2,1,0,0,2022-2023,90.0,0.0,600.0
Rk,Player,Nation,Pos,Squad,Comp,0,0,90.0,0,0,3,3,3,Tkl,0,0.0,0,0,0,0,0,0,0,0,0,2022-2023,90.0,0.0,0.0
2751,Carlos Vinícius,BRA,FW,Fulham,Premier League,27,1995,12.3,4,1,0,2,2,0,4,0.0,4,7,0,7,0,4,10,0,0,2022-2023,89.99999999999999,0.0,29.268292682926827
2752,Alan Virginius,FRA,FW,Lille,Ligue 1,19,2003,2.9,3,2,1,1,1,0,4,0.0,4,0,0,0,2,5,1,0,0,2022-2023,90.0,62.06896551724138,93.10344827586206
2753,Mattia Viti,ITA,DF,Nice,Ligue 1,20,2002,7.0,4,2,1,1,2,2,5,40.0,3,9,3,6,8,12,22,0,0,2022-2023,90.0,102.85714285714286,51.42857142857143
2754,Vitinha,POR,FW,Marseille,Ligue 1,22,2000,5.2,15,7,0,6,9,3,11,27.3,8,3,0,3,2,17,6,0,0,2022-2023,90.0,34.61538461538461,259.6153846153846
2755,Vitinha,POR,MF,Paris S-G,Ligue 1,22,2000,27.2,58,25,21,27,10,27,83,32.5,56,27,4,23,25,83,15,0,0,2022-2023,90.0,82.72058823529412,191.91176470588235
2756,Daniel Vivian,ESP,DF,Athletic Club,La Liga,23,1999,26.4,57,32,36,16,5,36,45,80.0,9,27,14,13,24,81,90,3,0,2022-2023,90.0,81.81818181818181,194.3181818181818
2757,Dušan Vlahović,SRB,FW,Juventus,Serie A,22,2000,21.4,11,6,0,7,4,4,10,40.0,6,10,3,7,3,14,8,1,0,2022-2023,90.0,12.616822429906543,46.26168224299066
2758,Nikola Vlašić,CRO,"MF,FW",Torino,Serie A,24,1997,30.3,32,21,9,16,7,15,34,44.1,19,25,2,23,10,42,14,0,0,2022-2023,90.0,29.702970297029704,95.04950495049505
2759,Joel Voelkerling Persson,SWE,"FW,MF",Lecce,Serie A,19,2003,1.1,1,1,0,0,1,0,1,0.0,1,1,0,1,0,1,0,0,0,2022-2023,90.0,0.0,81.81818181818181
2760,Kevin Vogt,GER,DF,Hoffenheim,Bundesliga,30,1991,19.7,15,10,10,5,0,9,22,40.9,13,18,11,7,26,41,67,0,0,2022-2023,90.0,118.78172588832487,68.52791878172589
2761,Mërgim Vojvoda,KVX,DF,Torino,Serie A,27,1995,19.1,22,12,15,6,1,12,24,50.0,12,14,2,12,10,32,31,1,0,2022-2023,90.0,47.12041884816754,103.66492146596859
2762,Kevin Volland,GER,"FW,MF",Monaco,Ligue 1,30,1992,7.1,8,4,1,5,2,2,8,25.0,6,8,0,8,2,10,0,0,0,2022-2023,90.0,25.35211267605634,101.40845070422536
2763,Cristian Volpato,ITA,MF,Roma,Serie A,18,2003,2.5,3,2,1,1,1,0,2,0.0,2,2,0,2,2,5,0,0,0,2022-2023,90.0,72.0,108.0
2764,Lukáš Vorlický,CZE,"MF,FW",Atalanta,Serie A,20,2002,0.3,0,0,0,0,0,0,0,0.0,0,0,0,0,1,1,0,0,0,2022-2023,90.0,300.0,0.0
2765,Aster Vranckx,BEL,MF,Milan,Serie A,19,2002,2.7,3,2,0,2,1,2,7,28.6,5,3,1,2,2,5,1,0,0,2022-2023,90.0,66.66666666666666,99.99999999999999
2766,Aster Vranckx,BEL,MF,Wolfsburg,Bundesliga,19,2002,0.1,0,0,0,0,0,0,0,0.0,0,0,0,0,0,0,1,0,0,2022-2023,90.0,0.0,0.0
2767,Stefan de Vrij,NED,DF,Inter,Serie A,30,1992,21.6,28,18,19,9,0,8,14,57.1,6,18,10,8,40,68,80,0,0,2022-2023,90.0,166.66666666666666,116.66666666666666
2768,Robert Wagner,GER,MF,Freiburg,Bundesliga,19,2003,0.4,0,0,0,0,0,0,0,0.0,0,2,0,2,0,0,2,0,0,2022-2023,90.0,0.0,0.0
2769,Elye Wahi,FRA,FW,Montpellier,Ligue 1,19,2003,27.9,9,3,2,3,4,5,14,35.7,9,14,2,12,3,12,5,0,0,2022-2023,90.0,9.67741935483871,29.032258064516128
2770,Walace,BRA,MF,Udinese,Serie A,27,1995,35.4,82,39,42,31,9,41,90,45.6,49,47,12,35,51,133,51,1,0,2022-2023,90.0,129.66101694915255,208.47457627118646
2771,Theo Walcott,ENG,"FW,MF",Southampton,Premier League,33,1989,12.5,13,6,8,4,1,8,27,29.6,19,8,1,7,9,22,7,0,0,2022-2023,90.0,64.8,93.6
2772,Luca Waldschmidt,GER,"FW,MF",Wolfsburg,Bundesliga,26,1996,5.8,5,2,2,1,2,2,10,20.0,8,6,0,6,3,8,5,0,0,2022-2023,90.0,46.55172413793103,77.58620689655173
2773,Kyle Walker,ENG,DF,Manchester City,Premier League,32,1990,21.8,13,9,8,5,0,4,24,16.7,20,12,2,10,18,31,22,0,0,2022-2023,90.0,74.31192660550458,53.6697247706422
2774,Kyle Walker-Peters,ENG,DF,Southampton,Premier League,25,1997,29.4,61,32,34,24,3,22,43,51.2,21,47,8,39,27,88,52,0,0,2022-2023,90.0,82.6530612244898,186.73469387755102
2775,Sebastian Walukiewicz,POL,DF,Empoli,Serie A,22,2000,6.7,9,6,7,2,0,4,6,66.7,2,10,9,1,7,16,30,0,0,2022-2023,90.0,94.02985074626865,120.89552238805969
Rk,Player,Nation,Pos,Squad,Comp,0,0,90.0,0,0,3,3,3,Tkl,0,0.0,0,0,0,0,0,0,0,0,0,2022-2023,90.0,0.0,0.0
2776,Aaron Wan-Bissaka,ENG,DF,Manchester Utd,Premier League,24,1997,15.9,40,25,20,17,3,23,25,92.0,2,24,8,16,22,62,41,0,0,2022-2023,90.0,124.52830188679245,226.41509433962264
2777,Paul Wanner,GER,MF,Bayern Munich,Bundesliga,16,2005,0.3,3,1,1,2,0,1,1,100.0,0,0,0,0,0,3,1,0,0,2022-2023,90.0,0.0,900.0000000000001
2778,Danny Ward,WAL,GK,Leicester City,Premier League,29,1993,26.0,1,1,1,0,0,1,3,33.3,2,0,0,0,0,1,14,2,0,2022-2023,90.00000000000001,0.0,3.4615384615384617
2779,Joel Ward,ENG,DF,Crystal Palace,Premier League,32,1989,25.1,50,36,30,11,9,30,41,73.2,11,32,16,16,25,75,80,1,0,2022-2023,90.0,89.6414342629482,179.2828685258964
2780,James Ward-Prowse,ENG,MF,Southampton,Premier League,27,1994,37.5,65,37,31,27,7,21,61,34.4,40,30,10,20,55,120,48,0,0,2022-2023,90.0,132.0,156.0
2781,Ollie Watkins,ENG,FW,Aston Villa,Premier League,26,1995,34.7,19,13,3,13,3,10,27,37.0,17,21,4,17,10,29,39,0,0,2022-2023,90.0,25.936599423631122,49.27953890489913
2782,Timothy Weah,USA,"DF,FW",Lille,Ligue 1,22,2000,19.4,24,14,13,9,2,16,29,55.2,13,17,3,14,23,47,18,0,0,2022-2023,90.0,106.70103092783506,111.34020618556703
2783,Adam Webster,ENG,DF,Brighton,Premier League,27,1995,22.1,22,12,10,9,3,11,19,57.9,8,30,19,11,19,41,55,4,0,2022-2023,90.0,77.37556561085972,89.59276018099547
2784,Wout Weghorst,NED,"FW,MF",Manchester Utd,Premier League,29,1992,8.9,11,5,6,1,4,2,9,22.2,7,7,2,5,7,18,9,0,0,2022-2023,90.0,70.78651685393258,111.23595505617978
2785,Julian Weigl,GER,MF,Gladbach,Bundesliga,26,1995,21.0,43,16,21,21,1,23,41,56.1,18,23,2,21,18,61,32,0,0,2022-2023,90.0,77.14285714285714,184.28571428571428
2786,Nelson Weiper,GER,"FW,DF",Mainz 05,Bundesliga,17,2005,1.1,2,0,0,0,2,1,3,33.3,2,2,0,2,0,2,1,0,0,2022-2023,90.0,0.0,163.63636363636363
2787,Mitchell Weiser,GER,"DF,FW",Werder Bremen,Bundesliga,28,1994,28.0,71,43,38,24,9,38,75,50.7,37,50,7,43,28,99,38,1,0,2022-2023,90.0,90.0,228.21428571428572
2788,Noah Weißhaupt,GER,"MF,DF",Freiburg,Bundesliga,20,2001,4.7,11,6,3,7,1,2,7,28.6,5,4,0,4,6,17,8,0,0,2022-2023,90.0,114.89361702127658,210.63829787234042
2789,Shon Weissman,ISR,FW,Valladolid,La Liga,26,1996,8.3,2,1,1,1,0,0,4,0.0,4,8,0,8,1,3,7,0,0,2022-2023,90.0,10.843373493975902,21.686746987951803
2790,Danny Welbeck,ENG,FW,Brighton,Premier League,31,1990,20.6,15,7,0,7,8,4,11,36.4,7,24,2,22,5,20,20,0,0,2022-2023,90.0,21.844660194174757,65.53398058252426
2791,Marcel Wenig,GER,MF,Eint Frankfurt,Bundesliga,18,2004,0.0,0,0,0,0,0,0,0,0.0,0,0,0,0,0,0,0,0,0,2022-2023,,,
2792,Axel Werner,ARG,GK,Elche,La Liga,26,1996,2.0,0,0,0,0,0,0,1,0.0,1,0,0,0,0,0,0,0,0,2022-2023,90.0,0.0,0.0
2793,Timo Werner,GER,"FW,MF",RB Leipzig,Bundesliga,26,1996,21.5,10,5,4,3,3,4,12,33.3,8,12,0,12,7,17,5,0,0,2022-2023,90.0,29.302325581395348,41.860465116279066
2794,Ben White,ENG,DF,Arsenal,Premier League,24,1997,33.9,60,31,23,30,7,42,70,60.0,28,47,11,36,22,82,79,1,0,2022-2023,90.0,58.4070796460177,159.2920353982301
2795,Harvey White,ENG,MF,Tottenham,Premier League,20,2001,0.1,0,0,0,0,0,0,1,0.0,1,0,0,0,0,0,0,0,0,2022-2023,90.0,0.0,0.0
2796,Joseph Whitworth,ENG,GK,Crystal Palace,Premier League,18,2004,2.0,0,0,0,0,0,0,0,0.0,0,0,0,0,0,0,1,0,0,2022-2023,90.0,0.0,0.0
2797,Silvan Widmer,SUI,DF,Mainz 05,Bundesliga,29,1993,18.8,26,17,15,10,1,20,39,51.3,19,22,8,14,31,57,28,0,0,2022-2023,90.0,148.40425531914892,124.46808510638297
2798,Mateusz Wieteska,POL,DF,Clermont Foot,Ligue 1,25,1997,34.6,41,23,28,13,0,19,33,57.6,14,44,28,16,56,97,97,4,0,2022-2023,90.0,145.66473988439304,106.64739884393063
2799,Georginio Wijnaldum,NED,MF,Roma,Serie A,31,1990,8.5,4,3,1,3,0,0,2,0.0,2,7,1,6,2,6,3,0,0,2022-2023,90.0,21.176470588235293,42.35294117647059
2800,Iñaki Williams,GHA,FW,Athletic Club,La Liga,28,1994,31.5,22,16,5,14,3,9,24,37.5,15,18,3,15,7,29,34,0,0,2022-2023,90.0,20.0,62.85714285714286
Rk,Player,Nation,Pos,Squad,Comp,0,0,90.0,0,0,3,3,3,Tkl,0,0.0,0,0,0,0,0,0,0,0,0,2022-2023,90.0,0.0,0.0
2801,Neco Williams,WAL,DF,Nott'ham Forest,Premier League,21,2001,20.9,72,47,49,17,6,38,71,53.5,33,33,8,25,33,105,48,0,0,2022-2023,90.0,142.10526315789474,310.04784688995215
2802,Nico Williams,ESP,FW,Athletic Club,La Liga,20,2002,29.5,31,16,10,15,6,19,41,46.3,22,40,2,38,8,39,14,1,0,2022-2023,90.0,24.406779661016948,94.57627118644068
2803,Willian,BRA,FW,Fulham,Premier League,33,1988,23.6,13,8,8,3,2,7,25,28.0,18,13,0,13,9,22,9,0,0,2022-2023,90.0,34.32203389830508,49.57627118644067
2804,Joe Willock,ENG,MF,Newcastle Utd,Premier League,22,1999,28.4,51,30,13,26,12,25,58,43.1,33,54,8,46,25,76,17,0,0,2022-2023,90.0,79.22535211267606,161.61971830985917
2805,Callum Wilson,ENG,FW,Newcastle Utd,Premier League,30,1992,20.9,9,3,0,8,1,0,3,0.0,3,8,0,8,1,10,5,0,0,2022-2023,90.0,4.30622009569378,38.75598086124402
2806,Harry Wilson,WAL,FW,Fulham,Premier League,25,1997,12.2,21,13,9,9,3,8,18,44.4,10,17,2,15,6,27,14,0,0,2022-2023,90.0,44.26229508196722,154.91803278688528
2807,Patrick Wimmer,AUT,"FW,MF",Wolfsburg,Bundesliga,21,2001,18.3,39,26,18,11,10,12,38,31.6,26,27,2,25,15,54,15,0,0,2022-2023,90.0,73.77049180327869,191.80327868852459
2808,Jonas Wind,DEN,FW,Wolfsburg,Bundesliga,23,1999,14.3,14,6,2,7,5,5,10,50.0,5,14,4,10,1,15,10,0,0,2022-2023,90.0,6.293706293706294,88.11188811188812
2809,Harry Winks,ENG,MF,Sampdoria,Serie A,26,1996,19.1,27,12,7,18,2,14,43,32.6,29,14,8,6,24,51,24,0,0,2022-2023,90.0,113.08900523560209,127.22513089005236
2810,Frederik Winther,DEN,DF,Augsburg,Bundesliga,21,2001,1.0,2,2,1,1,0,0,2,0.0,2,1,1,0,0,2,7,0,0,2022-2023,90.0,0.0,180.0
2811,Florian Wirtz,GER,"FW,MF",Leverkusen,Bundesliga,19,2003,12.1,18,10,9,7,2,8,16,50.0,8,15,1,14,1,19,6,0,0,2022-2023,90.0,7.43801652892562,133.88429752066116
2812,Przemysław Wiśniewski,POL,DF,Spezia,Serie A,24,1998,11.1,13,6,7,6,0,6,18,33.3,12,16,8,8,11,24,66,0,0,2022-2023,90.0,89.1891891891892,105.40540540540542
2813,Yoane Wissa,COD,FW,Brentford,Premier League,25,1996,17.8,17,12,4,7,6,6,13,46.2,7,10,0,10,6,23,15,0,0,2022-2023,90.0,30.337078651685395,85.95505617977528
2814,Axel Witsel,BEL,"DF,MF",Atlético Madrid,La Liga,33,1989,25.1,36,22,22,11,3,17,31,54.8,14,20,11,9,23,59,76,0,0,2022-2023,90.0,82.47011952191234,129.0836653386454
2815,Maximilian Wöber,AUT,DF,Leeds United,Premier League,24,1998,14.1,25,18,9,15,1,16,24,66.7,8,32,14,18,27,52,67,1,0,2022-2023,89.99999999999999,172.3404255319149,159.57446808510636
2816,Hannes Wolf,AUT,FW,Gladbach,Bundesliga,23,1999,5.0,11,8,4,5,2,5,13,38.5,8,3,0,3,3,14,9,0,0,2022-2023,90.0,54.0,198.0
2817,Marius Wolf,GER,DF,Dortmund,Bundesliga,27,1995,17.4,25,18,9,12,4,16,29,55.2,13,40,10,30,18,43,22,1,0,2022-2023,90.0,93.10344827586206,129.31034482758622
2818,Jeong Woo-yeong,KOR,"MF,FW",Freiburg,Bundesliga,22,1999,7.3,7,3,4,2,1,2,5,40.0,3,7,1,6,1,8,7,0,0,2022-2023,90.0,12.328767123287673,86.3013698630137
2819,Chris Wood,NZL,FW,Newcastle Utd,Premier League,30,1991,5.0,5,4,0,3,2,3,5,60.0,2,2,2,0,1,6,7,0,0,2022-2023,90.0,18.0,90.0
2820,Chris Wood,NZL,FW,Nott'ham Forest,Premier League,30,1991,4.1,0,0,0,0,0,0,1,0.0,1,2,1,1,1,1,2,0,0,2022-2023,90.0,21.951219512195124,0.0
2821,Christopher Wooh,CMR,DF,Rennes,Ligue 1,20,2001,11.2,16,7,8,8,0,9,11,81.8,2,11,5,6,6,22,49,0,0,2022-2023,90.0,48.214285714285715,128.57142857142858
2822,Christopher Wooh,CMR,MF,Lens,Ligue 1,20,2001,0.0,0,0,0,0,0,0,1,0.0,1,0,0,0,0,0,1,0,0,2022-2023,,,
2823,Joe Worrall,ENG,DF,Nott'ham Forest,Premier League,25,1997,24.7,53,25,39,12,2,25,35,71.4,10,33,23,10,26,79,111,1,0,2022-2023,90.0,94.73684210526316,193.1174089068826
2824,Xeka,POR,MF,Rennes,Ligue 1,27,1994,6.1,10,3,6,3,1,7,16,43.8,9,11,2,9,6,16,8,0,0,2022-2023,90.0,88.52459016393443,147.5409836065574
2825,Granit Xhaka,SUI,MF,Arsenal,Premier League,29,1992,33.3,34,27,11,18,5,16,41,39.0,25,28,10,18,15,49,45,1,0,2022-2023,90.0,40.54054054054054,91.89189189189189
Rk,Player,Nation,Pos,Squad,Comp,0,0,90.0,0,0,3,3,3,Tkl,0,0.0,0,0,0,0,0,0,0,0,0,2022-2023,90.0,0.0,0.0
2826,Lamine Yamal,ESP,FW,Barcelona,La Liga,15,2007,0.1,0,0,0,0,0,0,0,0.0,0,0,0,0,0,0,0,0,0,2022-2023,90.0,0.0,0.0
2827,Jawad El Yamiq,MAR,DF,Valladolid,La Liga,30,1992,17.9,17,11,10,7,0,6,11,54.5,5,27,19,8,37,54,101,0,0,2022-2023,90.0,186.03351955307264,85.47486033519554
2828,Ryan Yates,ENG,MF,Nott'ham Forest,Premier League,24,1997,20.4,38,19,19,16,3,14,22,63.6,8,26,8,18,10,48,44,0,0,2022-2023,90.0,44.11764705882353,167.64705882352942
2829,Yusuf Yazıcı,TUR,MF,Lille,Ligue 1,25,1997,2.2,0,0,0,0,0,0,0,0.0,0,2,0,2,0,0,1,0,0,2022-2023,90.0,0.0,0.0
2830,Kelvin Yeboah,ITA,"FW,MF",Augsburg,Bundesliga,22,2000,3.9,6,4,2,4,0,2,5,40.0,3,7,0,7,1,7,2,0,0,2022-2023,90.0,23.076923076923077,138.46153846153845
2831,Gerard Yepes,ESP,MF,Sampdoria,Serie A,19,2002,2.2,5,3,2,3,0,1,3,33.3,2,3,0,3,4,9,3,0,0,2022-2023,90.0,163.63636363636363,204.54545454545453
2832,Darlin Yongwa,CMR,DF,Lorient,Ligue 1,21,2000,8.7,13,11,7,5,1,4,15,26.7,11,13,1,12,5,18,11,0,0,2022-2023,90.0,51.724137931034484,134.48275862068965
2833,Leny Yoro,FRA,DF,Lille,Ligue 1,16,2005,8.5,11,5,8,3,0,4,9,44.4,5,6,1,5,18,29,27,1,0,2022-2023,90.0,190.58823529411765,116.47058823529412
2834,Maya Yoshida,JPN,DF,Schalke 04,Bundesliga,33,1988,28.4,34,22,19,13,2,18,29,62.1,11,40,29,11,46,80,132,2,0,2022-2023,90.0,145.77464788732397,107.74647887323944
2835,Ashley Young,ENG,DF,Aston Villa,Premier League,37,1985,22.6,50,27,34,15,1,37,50,74.0,13,25,11,14,21,71,65,0,0,2022-2023,90.0,83.6283185840708,199.1150442477876
2836,Mohamed Youssouf,COM,DF,Ajaccio,Ligue 1,34,1988,27.3,72,44,41,24,7,38,61,62.3,23,32,8,24,65,137,70,0,0,2022-2023,90.0,214.28571428571428,237.36263736263734
2837,Illia Zabarnyi,UKR,DF,Bournemouth,Premier League,19,2002,3.3,4,2,4,0,0,3,7,42.9,4,7,2,5,3,7,14,0,0,2022-2023,90.0,81.81818181818181,109.0909090909091
2838,Mattia Zaccagni,ITA,FW,Lazio,Serie A,27,1995,30.8,42,28,16,18,8,14,38,36.8,24,37,3,34,21,63,10,1,0,2022-2023,90.0,61.36363636363637,122.72727272727273
2839,Dan-Axel Zagadou,FRA,DF,Stuttgart,Bundesliga,23,1999,14.1,14,9,10,4,0,5,14,35.7,9,19,16,3,21,35,81,1,0,2022-2023,89.99999999999999,134.04255319148936,89.36170212765957
2840,Wilfried Zaha,CIV,"FW,MF",Crystal Palace,Premier League,29,1992,25.4,32,20,12,12,8,8,21,38.1,13,21,1,20,16,48,9,0,0,2022-2023,90.0,56.69291338582678,113.38582677165356
2841,Warren Zaïre-Emery,FRA,"MF,DF",Paris S-G,Ligue 1,16,2006,10.3,17,10,5,10,2,8,29,27.6,21,11,0,11,12,29,17,0,0,2022-2023,90.0,104.85436893203884,148.54368932038835
2842,Denis Zakaria,SUI,MF,Chelsea,Premier League,25,1996,4.6,9,5,5,2,2,2,8,25.0,6,4,1,3,3,12,10,0,0,2022-2023,90.0,58.69565217391305,176.08695652173915
2843,Denis Zakaria,SUI,MF,Juventus,Serie A,25,1996,1.4,6,3,1,4,1,2,2,100.0,0,2,0,2,2,8,1,0,0,2022-2023,90.0,128.57142857142858,385.7142857142857
2844,Rodrigo Zalazar,URU,"MF,FW",Schalke 04,Bundesliga,22,1999,14.7,16,8,5,9,2,9,24,37.5,15,16,1,15,7,23,13,0,0,2022-2023,90.0,42.85714285714286,97.95918367346938
2845,Joseba Zaldúa,ESP,DF,Cádiz,La Liga,30,1992,7.1,15,8,10,4,1,7,10,70.0,3,4,2,2,11,26,22,0,0,2022-2023,90.0,139.43661971830986,190.14084507042256
2846,Nicola Zalewski,POL,DF,Roma,Serie A,20,2002,24.4,45,26,25,15,5,22,71,31.0,49,27,1,26,31,76,23,0,0,2022-2023,90.0,114.34426229508198,165.98360655737707
2847,Andre-Frank Zambo Anguissa,CMR,MF,Napoli,Serie A,26,1995,33.9,53,32,16,29,8,16,64,25.0,48,50,4,46,49,102,25,0,0,2022-2023,90.0,130.08849557522123,140.70796460176993
2848,Oliver Zandén,SWE,"DF,MF",Toulouse,Ligue 1,20,2001,1.6,2,1,1,0,1,2,5,40.0,3,0,0,0,1,3,7,0,0,2022-2023,90.0,56.25,112.5
2849,Luca Zanimacchia,ITA,"MF,FW",Cremonese,Serie A,24,1998,8.3,21,13,11,6,4,8,21,38.1,13,9,0,9,9,30,5,0,0,2022-2023,90.0,97.59036144578312,227.71084337349396
2850,Nicolò Zaniolo,ITA,"MF,FW",Roma,Serie A,23,1999,9.9,7,5,2,4,1,2,7,28.6,5,11,0,11,2,9,0,0,0,2022-2023,90.0,18.181818181818183,63.63636363636363
Rk,Player,Nation,Pos,Squad,Comp,0,0,90.0,0,0,3,3,3,Tkl,0,0.0,0,0,0,0,0,0,0,0,0,2022-2023,90.0,0.0,0.0
2851,Alessandro Zanoli,ITA,DF,Sampdoria,Serie A,21,2000,17.1,22,14,14,6,2,8,17,47.1,9,19,15,4,12,34,39,0,0,2022-2023,90.0,63.1578947368421,115.78947368421052
2852,Alessandro Zanoli,ITA,DF,Napoli,Serie A,21,2000,0.1,1,0,0,1,0,0,0,0.0,0,0,0,0,0,1,1,0,0,2022-2023,90.0,0.0,900.0
2853,Mattia Zanotti,ITA,DF,Inter,Serie A,19,2003,0.3,0,0,0,0,0,0,1,0.0,1,2,0,2,0,0,0,0,0,2022-2023,90.0,0.0,0.0
2854,Duván Zapata,COL,FW,Atalanta,Serie A,31,1991,15.4,8,4,1,3,4,3,5,60.0,2,6,2,4,4,12,17,1,0,2022-2023,90.0,23.376623376623378,46.753246753246756
2855,Davide Zappacosta,ITA,DF,Atalanta,Serie A,30,1992,16.3,34,18,17,12,5,15,22,68.2,7,23,2,21,9,43,16,0,0,2022-2023,90.0,49.693251533742334,187.73006134969324
2856,Oier Zarraga,ESP,MF,Athletic Club,La Liga,23,1999,9.5,14,9,5,7,2,8,20,40.0,12,7,0,7,10,24,5,0,0,2022-2023,90.0,94.73684210526316,132.6315789473684
2857,Akim Zedadka,ALG,DF,Auxerre,Ligue 1,27,1995,17.8,35,21,21,10,4,18,32,56.3,14,17,3,14,23,58,51,1,0,2022-2023,90.0,116.29213483146067,176.96629213483146
2858,Akim Zedadka,ALG,"DF,MF",Lille,Ligue 1,27,1995,3.9,1,1,1,0,0,0,2,0.0,2,3,0,3,2,3,6,0,0,2022-2023,90.0,46.15384615384615,23.076923076923077
2859,Karim Zedadka,FRA,FW,Napoli,Serie A,22,2000,0.2,0,0,0,0,0,0,0,0.0,0,0,0,0,0,0,1,0,0,2022-2023,90.0,0.0,0.0
2860,Deyovaisio Zeefuik,NED,DF,Hellas Verona,Serie A,24,1998,0.1,1,1,0,1,0,0,0,0.0,0,0,0,0,0,1,0,0,0,2022-2023,90.0,0.0,900.0
2861,Marvin Zeegelaar,NED,DF,Udinese,Serie A,31,1990,3.9,8,4,6,2,0,3,4,75.0,1,2,0,2,3,11,5,0,0,2022-2023,90.0,69.23076923076923,184.6153846153846
2862,Mehdi Zeffane,ALG,"DF,MF",Clermont Foot,Ligue 1,30,1992,7.3,12,7,5,7,0,4,21,19.0,17,14,6,8,22,34,12,0,0,2022-2023,90.0,271.2328767123288,147.94520547945206
2863,Aaron Zehnter,GER,DF,Augsburg,Bundesliga,17,2004,0.0,0,0,0,0,0,0,1,0.0,1,0,0,0,1,1,0,0,0,2022-2023,,inf,
2864,Jordan Zemura,ZIM,DF,Bournemouth,Premier League,22,1999,16.2,39,24,24,14,1,23,44,52.3,21,31,9,22,16,55,32,0,0,2022-2023,90.0,88.88888888888889,216.66666666666669
2865,Arber Zeneli,KVX,"FW,MF",Reims,Ligue 1,27,1995,11.1,9,3,3,3,3,5,12,41.7,7,8,0,8,2,11,2,0,0,2022-2023,90.0,16.216216216216218,72.97297297297298
2866,Robin Zentner,GER,GK,Mainz 05,Bundesliga,27,1994,26.0,0,0,0,0,0,0,4,0.0,4,0,0,0,0,0,17,1,0,2022-2023,90.00000000000001,0.0,0.0
2867,Alessio Zerbin,ITA,FW,Napoli,Serie A,23,1999,2.2,10,5,4,5,1,4,8,50.0,4,2,0,2,2,12,2,0,0,2022-2023,90.0,81.81818181818181,409.09090909090907
2868,Michael Zetterer,GER,GK,Werder Bremen,Bundesliga,27,1995,1.7,0,0,0,0,0,0,0,0.0,0,0,0,0,0,0,1,0,0,2022-2023,90.0,0.0,0.0
2869,Nathan Zeze,FRA,DF,Nantes,Ligue 1,17,2005,0.7,3,2,2,1,0,1,1,100.0,0,0,0,0,0,3,1,0,0,2022-2023,90.0,0.0,385.7142857142857
2870,Edon Zhegrova,KVX,"FW,MF",Lille,Ligue 1,23,1999,11.7,18,12,6,7,5,12,20,60.0,8,9,0,9,2,20,2,0,0,2022-2023,89.99999999999999,15.384615384615383,138.46153846153845
2871,Piotr Zieliński,POL,MF,Napoli,Serie A,28,1994,25.4,17,10,1,11,5,12,25,48.0,13,16,5,11,14,31,7,0,0,2022-2023,90.0,49.60629921259843,60.23622047244095
2872,David Zima,CZE,DF,Torino,Serie A,21,2000,4.5,9,5,5,4,0,3,4,75.0,1,7,2,5,9,18,11,2,0,2022-2023,90.0,180.0,180.0
2873,Oleksandr Zinchenko,UKR,DF,Arsenal,Premier League,25,1996,23.5,40,18,14,17,9,21,40,52.5,19,20,2,18,22,62,38,2,0,2022-2023,90.0,84.25531914893617,153.1914893617021
2874,Joshua Zirkzee,NED,FW,Bologna,Serie A,21,2001,9.1,4,2,1,1,2,2,7,28.6,5,4,1,3,4,8,4,0,0,2022-2023,90.0,39.56043956043956,39.56043956043956
2875,Hakim Ziyech,MAR,"FW,MF",Chelsea,Premier League,29,1993,7.3,20,12,12,5,3,4,9,44.4,5,8,0,8,5,25,5,1,0,2022-2023,90.0,61.64383561643836,246.57534246575344
Rk,Player,Nation,Pos,Squad,Comp,0,0,90.0,0,0,3,3,3,Tkl,0,0.0,0,0,0,0,0,0,0,0,0,2022-2023,90.0,0.0,0.0
2876,Jeroen Zoet,NED,GK,Spezia,Serie A,31,1991,3.7,1,1,1,0,0,1,1,100.0,0,0,0,0,0,1,1,0,0,2022-2023,90.0,0.0,24.324324324324323
2877,Simon Zoller,GER,FW,Bochum,Bundesliga,31,1991,16.2,11,4,2,8,1,4,12,33.3,8,14,1,13,6,17,21,0,0,2022-2023,90.0,33.333333333333336,61.111111111111114
2878,Nadir Zortea,ITA,"DF,MF",Atalanta,Serie A,23,1999,2.5,10,5,3,7,0,3,4,75.0,1,4,0,4,0,10,4,0,0,2022-2023,90.0,0.0,360.0
2879,Nadir Zortea,ITA,DF,Sassuolo,Serie A,23,1999,7.3,15,8,12,2,1,9,14,64.3,5,10,4,6,4,19,21,0,0,2022-2023,90.0,49.31506849315069,184.93150684931507
2880,Tanguy Zoukrou,FRA,DF,Troyes,Ligue 1,19,2003,5.7,14,7,8,6,0,10,14,71.4,4,18,11,7,2,16,24,0,0,2022-2023,90.0,31.57894736842105,221.05263157894734
2881,Kurt Zouma,FRA,DF,West Ham,Premier League,27,1994,22.1,9,4,4,5,0,5,8,62.5,3,17,14,3,30,39,120,1,0,2022-2023,90.0,122.17194570135746,36.65158371040724
2882,Petar Zovko,BIH,GK,Spezia,Serie A,20,2002,0.8,1,0,1,0,0,1,1,100.0,0,0,0,0,0,1,0,0,0,2022-2023,90.0,0.0,112.5
2883,Igor Zubeldia,ESP,DF,Real Sociedad,La Liga,25,1997,28.2,35,18,28,7,0,25,35,71.4,10,23,17,6,21,56,93,0,0,2022-2023,89.99999999999999,67.02127659574468,111.70212765957446
2884,Martín Zubimendi,ESP,MF,Real Sociedad,La Liga,23,1999,34.5,59,33,23,30,6,24,45,53.3,21,44,17,27,37,96,55,4,0,2022-2023,90.0,96.52173913043478,153.91304347826085
2885,Szymon Żurkowski,POL,MF,Fiorentina,Serie A,24,1997,0.4,0,0,0,0,0,0,0,0.0,0,0,0,0,0,0,0,0,0,2022-2023,90.0,0.0,0.0
2886,Szymon Żurkowski,POL,MF,Spezia,Serie A,24,1997,4.7,9,3,4,4,1,2,15,13.3,13,9,2,7,4,13,6,0,0,2022-2023,90.0,76.59574468085106,172.3404255319149
2887,Martin Ødegaard,NOR,MF,Arsenal,Premier League,23,1998,34.7,36,23,12,14,10,14,47,29.8,33,20,5,15,6,42,12,1,0,2022-2023,90.0,15.561959654178672,93.37175792507203
2888,Milan Đurić,BIH,FW,Hellas Verona,Serie A,32,1990,15.2,2,1,1,0,1,1,3,33.3,2,7,4,3,1,3,24,0,0,2022-2023,90.0,5.921052631578947,11.842105263157894
2889,Filip Đuričić,SRB,"MF,FW",Sampdoria,Serie A,30,1992,24.1,43,22,18,20,5,14,32,43.8,18,19,6,13,7,50,8,0,0,2022-2023,90.0,26.141078838174273,160.58091286307052
1,Max Aarons,ENG,DF,Bournemouth,Premier League,23,2000,13.7,29,19,20,7,2,20,34,58.8,14,9,5,4,8,37,27,0,0,2023-2024,90.0,52.55474452554745,190.5109489051095
2,Brenden Aaronson,USA,"MF,FW",Union Berlin,Bundesliga,22,2000,14.1,32,18,13,13,6,16,32,50.0,16,26,1,25,2,34,4,0,0,2023-2024,89.99999999999999,12.76595744680851,204.25531914893617
3,Paxten Aaronson,USA,MF,Eint Frankfurt,Bundesliga,19,2003,1.1,2,2,1,1,0,1,1,100.0,0,2,0,2,0,2,0,0,0,2023-2024,90.0,0.0,163.63636363636363
4,Keyliane Abdallah,FRA,FW,Marseille,Ligue 1,17,2006,0.0,0,0,0,0,0,0,0,0.0,0,0,0,0,0,0,0,0,0,2023-2024,,,
5,Yunis Abdelhamid,MAR,DF,Reims,Ligue 1,35,1987,30.9,64,35,36,23,5,26,45,57.8,19,51,32,19,39,103,109,2,0,2023-2024,90.0,113.59223300970874,186.40776699029126
6,Salis Abdul Samed,GHA,MF,Lens,Ligue 1,23,2000,16.9,21,14,8,10,3,8,18,44.4,10,12,1,11,12,33,18,0,0,2023-2024,90.0,63.905325443786985,111.83431952662723
7,Nabil Aberdin,FRA,DF,Getafe,La Liga,20,2002,2.0,0,0,0,0,0,0,1,0.0,1,0,0,0,0,0,4,0,0,2023-2024,90.0,0.0,0.0
8,Laurent Abergel,FRA,MF,Lorient,Ligue 1,30,1993,31.8,85,52,43,34,8,38,96,39.6,58,29,6,23,61,146,61,3,0,2023-2024,90.0,172.64150943396226,240.56603773584905
9,Matthis Abline,FRA,FW,Nantes,Ligue 1,20,2003,11.6,9,4,4,3,2,3,8,37.5,5,3,0,3,3,12,5,0,0,2023-2024,90.0,23.275862068965516,69.82758620689656
10,Abner,BRA,DF,Betis,La Liga,23,2000,15.6,25,19,15,9,1,17,34,50.0,17,23,5,18,15,40,62,0,0,2023-2024,90.0,86.53846153846153,144.23076923076923
11,Zakaria Aboukhlal,MAR,"MF,FW",Toulouse,Ligue 1,23,2000,8.4,9,8,1,5,3,3,12,25.0,9,9,1,8,1,10,2,0,0,2023-2024,90.0,10.714285714285714,96.42857142857143
12,Abdel Abqar,MAR,DF,Alavés,La Liga,24,1999,25.7,35,19,28,5,2,21,35,60.0,14,31,26,5,23,58,115,0,0,2023-2024,90.0,80.54474708171206,122.568093385214
13,Tammy Abraham,ENG,FW,Roma,Serie A,25,1997,2.7,3,1,0,1,2,0,0,0.0,0,1,0,1,0,3,4,0,0,2023-2024,90.0,0.0,99.99999999999999
14,Francesco Acerbi,ITA,DF,Inter,Serie A,35,1988,26.5,22,13,16,6,0,11,14,78.6,3,20,13,7,32,54,77,1,0,2023-2024,90.0,108.67924528301886,74.71698113207547
15,Joshua Acheampong,ENG,DF,Chelsea,Premier League,17,2006,0.1,0,0,0,0,0,0,0,0.0,0,3,3,0,0,0,0,0,0,2023-2024,90.0,0.0,0.0
16,Marcos Acuña,ARG,DF,Sevilla,La Liga,31,1991,14.4,33,21,20,12,1,9,14,64.3,5,12,2,10,4,37,25,0,0,2023-2024,90.0,25.0,206.25
17,Bénie Adama Traore,CIV,"FW,MF",Sheffield Utd,Premier League,20,2002,4.3,4,2,1,2,1,0,4,0.0,4,4,1,3,1,5,1,0,0,2023-2024,90.0,20.930232558139537,83.72093023255815
18,Bénie Adama Traore,CIV,"FW,MF",Nantes,Ligue 1,20,2002,5.6,8,4,2,5,1,3,7,42.9,4,3,0,3,1,9,1,0,0,2023-2024,90.0,16.071428571428573,128.57142857142858
19,Akor Adams,NGA,FW,Montpellier,Ligue 1,23,2000,25.0,12,4,3,4,5,3,7,42.9,4,9,2,7,5,17,11,0,0,2023-2024,90.0,18.0,43.199999999999996
20,Tyler Adams,USA,MF,Bournemouth,Premier League,24,1999,1.3,4,3,1,3,0,2,3,66.7,1,2,0,2,4,8,2,0,0,2023-2024,90.0,276.9230769230769,276.9230769230769
21,Junior Adamu,AUT,"FW,MF",Freiburg,Bundesliga,22,2001,1.2,5,1,1,2,2,1,2,50.0,1,1,0,1,0,5,2,0,0,2023-2024,90.0,0.0,375.0
22,Sargis Adamyan,ARM,"FW,MF",Köln,Bundesliga,30,1993,8.9,14,9,2,9,3,6,11,54.5,5,16,1,15,5,19,7,0,0,2023-2024,90.0,50.56179775280899,141.57303370786516
23,Tosin Adarabioyo,ENG,DF,Fulham,Premier League,25,1997,18.0,21,11,16,5,0,12,21,57.1,9,16,11,5,25,46,80,0,0,2023-2024,90.0,125.0,105.0
24,Elijah Adebayo,ENG,FW,Luton Town,Premier League,25,1998,15.8,4,1,1,0,3,1,12,8.3,11,13,2,11,6,10,25,0,0,2023-2024,90.0,34.177215189873415,22.784810126582276
25,Karim Adeyemi,GER,"FW,MF",Dortmund,Bundesliga,21,2002,10.1,16,14,9,4,3,8,20,40.0,12,11,0,11,3,19,5,0,0,2023-2024,90.0,26.73267326732673,142.5742574257426
Rk,Player,Nation,Pos,Squad,Comp,0,0,90.0,0,0,3,3,3,Tkl,0,0.0,0,0,0,0,0,0,0,0,0,2023-2024,90.0,0.0,0.0
26,Simon Adingra,CIV,FW,Brighton,Premier League,21,2002,24.7,45,20,23,11,11,19,42,45.2,23,31,1,30,19,64,22,0,0,2023-2024,90.0,69.23076923076923,163.9676113360324
27,Nathaniel Adjei,GHA,DF,Lorient,Ligue 1,20,2002,13.8,13,9,8,3,2,6,7,85.7,1,15,8,7,18,31,64,1,0,2023-2024,90.0,117.39130434782608,84.78260869565217
28,Amine Adli,MAR,"MF,FW",Leverkusen,Bundesliga,23,2000,10.0,16,7,2,10,4,7,17,41.2,10,10,2,8,6,22,5,0,0,2023-2024,90.0,54.0,144.0
29,Yacine Adli,FRA,MF,Milan,Serie A,23,2000,15.6,34,17,17,13,4,13,35,37.1,22,22,8,14,20,54,15,1,0,2023-2024,90.0,115.38461538461539,196.15384615384616
30,Adryelson,BRA,"DF,FW",Lyon,Ligue 1,25,1998,0.1,0,0,0,0,0,0,0,0.0,0,0,0,0,1,1,3,0,0,2023-2024,90.0,900.0,0.0
31,Adson,BRA,"MF,FW",Nantes,Ligue 1,22,2000,2.6,7,6,1,6,0,2,2,100.0,0,5,0,5,2,9,2,0,0,2023-2024,90.0,69.23076923076923,242.3076923076923
32,Michel Aebischer,SUI,MF,Bologna,Serie A,26,1997,24.8,35,20,9,20,6,15,34,44.1,19,28,6,22,12,47,22,0,0,2023-2024,90.0,43.54838709677419,127.01612903225806
33,Emmanuel Agbadou,CIV,DF,Reims,Ligue 1,26,1997,28.8,65,41,38,23,4,44,64,68.8,20,47,25,22,55,120,116,1,0,2023-2024,90.0,171.875,203.125
34,Julen Agirrezabala,ESP,GK,Athletic Club,La Liga,22,2000,2.6,0,0,0,0,0,0,0,0.0,0,0,0,0,0,0,0,0,0,2023-2024,90.0,0.0,0.0
35,Lucien Agoume,FRA,MF,Inter,Serie A,21,2002,0.1,0,0,0,0,0,0,0,0.0,0,0,0,0,0,0,0,0,0,2023-2024,90.0,0.0,0.0
36,Lucien Agoume,FRA,MF,Sevilla,La Liga,21,2002,8.6,23,18,7,14,2,9,12,75.0,3,6,1,5,7,30,8,0,0,2023-2024,90.0,73.25581395348838,240.69767441860466
37,Felix Agu,GER,"DF,MF",Werder Bremen,Bundesliga,23,1999,17.9,45,29,28,13,4,29,41,70.7,12,27,7,20,13,58,41,0,0,2023-2024,90.0,65.36312849162012,226.2569832402235
38,Nayef Aguerd,MAR,DF,West Ham,Premier League,27,1996,20.6,26,14,19,7,0,16,22,72.7,6,33,24,9,17,43,85,2,0,2023-2024,90.0,74.27184466019418,113.59223300970874
39,Ruben Aguilar,FRA,DF,Lens,Ligue 1,30,1993,21.4,53,31,27,23,3,27,45,60.0,18,35,5,30,26,79,46,0,0,2023-2024,90.0,109.34579439252337,222.89719626168227
40,Brandon Aguilera,CRC,FW,Nott'ham Forest,Premier League,20,2003,0.1,0,0,0,0,0,0,0,0.0,0,0,0,0,0,0,0,0,0,2023-2024,90.0,0.0,0.0
41,Naouirou Ahamada,FRA,"MF,FW",Crystal Palace,Premier League,21,2002,3.9,13,9,5,6,2,8,17,47.1,9,3,0,3,2,15,4,0,0,2023-2024,90.0,46.15384615384615,300.0
42,Anel Ahmedhodžić,BIH,DF,Sheffield Utd,Premier League,24,1999,29.4,64,36,48,14,2,30,49,61.2,19,43,26,17,35,99,137,2,0,2023-2024,90.0,107.14285714285714,195.91836734693877
43,Joseph Aidoo,GHA,DF,Celta Vigo,La Liga,27,1995,4.5,8,3,6,2,0,4,8,50.0,4,3,1,2,4,12,28,0,0,2023-2024,90.0,80.0,160.0
44,Ola Aina,NGA,DF,Nott'ham Forest,Premier League,26,1996,18.8,47,31,31,12,4,29,41,70.7,12,19,3,16,18,65,51,1,0,2023-2024,90.0,86.17021276595744,225.0
45,Rayan Aït-Nouri,ALG,"DF,MF",Wolves,Premier League,22,2001,25.9,71,44,41,23,7,28,49,57.1,21,32,6,26,15,86,38,0,0,2023-2024,90.0,52.12355212355213,246.71814671814676
46,Tosin Aiyegun,BEN,"MF,FW",Lorient,Ligue 1,25,1998,10.0,6,4,2,3,1,3,9,33.3,6,4,1,3,2,8,8,0,0,2023-2024,90.0,18.0,54.0
47,Kristoffer Ajer,NOR,DF,Brentford,Premier League,25,1998,20.4,38,21,25,9,4,23,36,63.9,13,26,11,15,25,63,79,1,0,2023-2024,90.0,110.29411764705883,167.64705882352942
48,Ludovic Ajorque,FRA,FW,Mainz 05,Bundesliga,29,1994,15.1,3,2,1,2,0,2,11,18.2,9,6,2,4,4,7,11,0,0,2023-2024,90.0,23.841059602649008,17.880794701986755
49,Manuel Akanji,SUI,"DF,MF",Manchester City,Premier League,28,1995,27.9,42,28,16,18,8,22,39,56.4,17,28,12,16,23,65,70,3,0,2023-2024,90.0,74.19354838709677,135.48387096774195
50,Marley Aké,FRA,FW,Udinese,Serie A,22,2001,0.1,0,0,0,0,0,0,0,0.0,0,0,0,0,0,0,0,0,0,2023-2024,90.0,0.0,0.0
Rk,Player,Nation,Pos,Squad,Comp,0,0,90.0,0,0,3,3,3,Tkl,0,0.0,0,0,0,0,0,0,0,0,0,2023-2024,90.0,0.0,0.0
51,Nathan Aké,NED,DF,Manchester City,Premier League,28,1995,22.7,26,16,15,8,3,13,20,65.0,7,17,2,15,14,40,54,0,0,2023-2024,89.99999999999999,55.50660792951542,103.08370044052863
52,Ilias Akhomach,MAR,"MF,FW",Villarreal,La Liga,19,2004,16.8,36,21,11,16,9,10,20,50.0,10,10,2,8,13,49,13,0,0,2023-2024,90.0,69.64285714285714,192.85714285714286
53,Sergio Akieme,ESP,DF,Almería,La Liga,25,1997,18.6,27,15,18,7,2,13,16,81.3,3,14,4,10,10,37,34,0,0,2023-2024,90.0,48.387096774193544,130.64516129032256
54,Sergio Akieme,ESP,DF,Reims,Ligue 1,25,1997,9.1,11,5,6,3,2,8,11,72.7,3,9,3,6,10,21,25,0,0,2023-2024,90.0,98.9010989010989,108.79120879120879
55,Ebenezer Akinsanmiro,NGA,MF,Inter,Serie A,18,2004,0.2,0,0,0,0,0,0,1,0.0,1,0,0,0,0,0,0,0,0,2023-2024,90.0,0.0,0.0
56,Maghnes Akliouche,FRA,"MF,FW",Monaco,Ligue 1,21,2002,17.9,37,23,12,20,5,12,36,33.3,24,21,0,21,9,46,3,0,0,2023-2024,90.0,45.2513966480447,186.03351955307264
57,Paul Akouokou,CIV,MF,Betis,La Liga,25,1997,0.3,5,3,0,2,3,3,3,100.0,0,3,1,2,1,6,1,0,0,2023-2024,90.0,300.0,1500.0
58,Paul Akouokou,CIV,MF,Lyon,Ligue 1,25,1997,3.4,14,9,2,10,2,6,7,85.7,1,5,1,4,6,20,11,0,0,2023-2024,90.0,158.8235294117647,370.5882352941176
59,Jean-Daniel Akpa-Akpro,CIV,MF,Monza,Serie A,30,1992,7.8,20,11,14,4,2,3,9,33.3,6,10,4,6,12,32,15,1,0,2023-2024,90.0,138.46153846153845,230.76923076923077
60,David Akpan Ankeye,NGA,FW,Genoa,Serie A,21,2002,0.6,1,0,0,1,0,0,1,0.0,1,1,0,1,0,1,0,0,0,2023-2024,90.0,0.0,150.0
61,Kevin Akpoguma,NGA,DF,Hoffenheim,Bundesliga,28,1995,12.2,35,18,22,12,1,26,35,74.3,9,28,8,20,18,53,32,0,0,2023-2024,90.0,132.78688524590166,258.1967213114754
62,David Alaba,AUT,DF,Real Madrid,La Liga,31,1992,12.8,13,9,7,5,1,4,8,50.0,4,10,7,3,15,28,34,0,0,2023-2024,90.0,105.46875,91.40625
63,Luis Alberto,ESP,MF,Lazio,Serie A,30,1992,25.7,35,20,16,12,7,15,53,28.3,38,34,4,30,7,42,13,0,0,2023-2024,90.0,24.5136186770428,122.568093385214
64,Raúl Albiol,ESP,DF,Villarreal,La Liga,37,1985,22.6,25,14,15,9,1,18,27,66.7,9,31,24,7,16,41,102,0,0,2023-2024,90.0,63.716814159292035,99.5575221238938
65,Thiago Alcántara,ESP,MF,Liverpool,Premier League,32,1991,0.1,0,0,0,0,0,0,0,0.0,0,0,0,0,0,0,0,0,0,2023-2024,90.0,0.0,0.0
66,Carlos Alcaraz,ARG,MF,Juventus,Serie A,20,2002,4.2,6,6,0,6,0,5,10,50.0,5,5,2,3,5,11,4,0,0,2023-2024,90.0,107.14285714285714,128.57142857142856
67,Rubén Alcaraz,ESP,MF,Cádiz,La Liga,32,1991,34.8,97,59,39,52,6,50,121,41.3,71,60,14,46,33,130,55,2,0,2023-2024,90.0,85.3448275862069,250.86206896551724
68,Omar Alderete,PAR,DF,Getafe,La Liga,26,1996,24.4,28,21,15,13,0,19,35,54.3,16,30,18,12,13,41,111,0,0,2023-2024,90.0,47.95081967213115,103.27868852459018
69,Iván Alejo,ESP,MF,Cádiz,La Liga,28,1995,18.8,40,23,23,11,6,17,57,29.8,40,20,0,20,7,47,17,0,0,2023-2024,90.0,33.51063829787234,191.48936170212764
70,Carles Aleñá,ESP,MF,Getafe,La Liga,25,1998,11.3,24,8,7,14,3,10,24,41.7,14,14,3,11,4,28,13,0,0,2023-2024,90.0,31.858407079646017,191.1504424778761
71,Trent Alexander-Arnold,ENG,DF,Liverpool,Premier League,24,1998,23.9,39,26,26,11,2,27,87,31.0,60,22,2,20,31,70,48,5,0,2023-2024,90.0,116.73640167364017,146.86192468619248
72,Aboubacar Ali,FRA,"MF,FW",Strasbourg,Ligue 1,17,2006,1.4,2,0,0,2,0,0,0,0.0,0,1,0,1,1,3,2,0,0,2023-2024,90.0,64.28571428571429,128.57142857142858
73,Mohamed Ali Cho,FRA,"FW,MF",Real Sociedad,La Liga,19,2004,2.8,4,3,3,1,0,2,7,28.6,5,6,0,6,1,5,1,0,0,2023-2024,90.0,32.142857142857146,128.57142857142858
74,Mohamed Ali Cho,FRA,FW,Nice,Ligue 1,19,2004,9.6,12,9,4,7,1,3,11,27.3,8,10,0,10,3,15,6,0,0,2023-2024,90.0,28.125000000000004,112.50000000000001
75,Faride Alidou,GER,"FW,MF",Köln,Bundesliga,22,2001,14.2,10,4,3,6,1,4,18,22.2,14,23,2,21,8,18,15,1,0,2023-2024,90.0,50.70422535211268,63.38028169014085
Rk,Player,Nation,Pos,Squad,Comp,0,0,90.0,0,0,3,3,3,Tkl,0,0.0,0,0,0,0,0,0,0,0,0,2023-2024,90.0,0.0,0.0
76,Nabil Alioui,FRA,"MF,FW",Le Havre,Ligue 1,24,1999,11.2,3,2,2,1,0,2,4,50.0,2,6,1,5,3,6,4,0,0,2023-2024,90.0,24.107142857142858,24.107142857142858
77,Alisson,BRA,GK,Liverpool,Premier League,30,1992,28.0,0,0,0,0,0,0,1,0.0,1,0,0,0,0,0,11,4,0,2023-2024,90.0,0.0,0.0
78,Tadeo Allende,ARG,"MF,FW",Celta Vigo,La Liga,24,1999,3.7,6,1,3,2,1,4,6,66.7,2,3,0,3,3,9,3,0,0,2023-2024,90.0,72.97297297297297,145.94594594594594
79,Jim Allevinah,GAB,"MF,DF",Clermont Foot,Ligue 1,28,1995,20.7,30,18,11,14,5,14,35,40.0,21,20,3,17,13,43,30,0,0,2023-2024,90.0,56.52173913043479,130.43478260869566
80,Domingos André Ribeiro Almeida,POR,"FW,MF",Valencia,La Liga,23,2000,10.7,25,15,9,12,4,9,19,47.4,10,13,1,12,6,31,5,0,0,2023-2024,90.0,50.46728971962617,210.28037383177573
81,Miguel Almirón,PAR,FW,Newcastle Utd,Premier League,29,1994,21.5,36,24,13,15,8,11,29,37.9,18,29,2,27,10,46,13,0,0,2023-2024,90.0,41.860465116279066,150.69767441860463
82,Pontus Almqvist,SWE,"FW,MF",Lecce,Serie A,24,1999,23.4,45,29,16,22,7,23,51,45.1,28,21,2,19,14,59,10,0,0,2023-2024,89.99999999999999,53.84615384615385,173.07692307692307
83,Marcos Alonso,ESP,DF,Barcelona,La Liga,32,1990,2.8,5,3,2,3,0,3,4,75.0,1,2,0,2,4,9,6,0,0,2023-2024,90.0,128.57142857142858,160.71428571428572
84,Adrià Altimira,ESP,"DF,MF",Villarreal,La Liga,22,2001,8.6,16,7,9,6,1,9,24,37.5,15,18,5,13,5,21,18,0,0,2023-2024,90.0,52.32558139534884,167.4418604651163
85,Sergi Altimira,ESP,MF,Betis,La Liga,21,2001,6.3,15,8,8,6,1,11,23,47.8,12,12,1,11,9,24,10,0,0,2023-2024,90.0,128.57142857142858,214.2857142857143
86,Edson Álvarez,MEX,MF,West Ham,Premier League,25,1997,26.4,80,39,47,26,7,31,66,47.0,35,59,20,39,42,122,81,0,0,2023-2024,90.0,143.1818181818182,272.72727272727275
87,Gastón Álvarez,URU,DF,Getafe,La Liga,23,2000,28.2,68,37,43,20,5,37,57,64.9,20,40,11,29,35,103,80,0,0,2023-2024,89.99999999999999,111.70212765957446,217.02127659574467
88,Hugo Álvarez,ESP,"MF,DF",Celta Vigo,La Liga,20,2003,8.5,14,9,8,3,3,9,20,45.0,11,4,1,3,5,19,9,0,0,2023-2024,90.0,52.94117647058824,148.23529411764707
89,Julián Álvarez,ARG,"MF,FW",Manchester City,Premier League,23,2000,29.4,24,13,5,8,11,8,32,25.0,24,30,0,30,2,26,14,1,0,2023-2024,90.0,6.122448979591836,73.46938775510205
90,Yeray Álvarez,ESP,DF,Athletic Club,La Liga,28,1995,12.8,18,9,15,3,0,12,19,63.2,7,8,5,3,11,29,34,1,0,2023-2024,90.0,77.34375,126.5625
91,Skelly Alvero,FRA,MF,Lyon,Ligue 1,21,2002,4.7,8,7,5,2,1,2,9,22.2,7,5,1,4,2,10,5,0,0,2023-2024,90.0,38.29787234042553,153.1914893617021
92,Skelly Alvero,FRA,MF,Werder Bremen,Bundesliga,21,2002,1.4,6,4,1,5,0,3,3,100.0,0,3,1,2,1,7,1,0,0,2023-2024,90.0,64.28571428571429,385.7142857142857
93,Papa Amadou Diallo,SEN,FW,Metz,Ligue 1,19,2004,9.9,18,8,10,7,1,7,21,33.3,14,11,1,10,11,29,16,0,0,2023-2024,90.0,100.0,163.63636363636363
94,Selim Amallah,MAR,"FW,MF",Valencia,La Liga,26,1996,6.7,17,12,7,7,3,3,9,33.3,6,13,0,13,11,28,6,0,0,2023-2024,90.0,147.76119402985074,228.35820895522386
95,Amath,SEN,"FW,MF",Mallorca,La Liga,27,1996,4.4,9,6,7,2,0,2,10,20.0,8,2,0,2,3,12,6,0,0,2023-2024,90.0,61.36363636363636,184.0909090909091
96,Lorenzo Amatucci,ITA,MF,Fiorentina,Serie A,19,2004,0.2,0,0,0,0,0,0,0,0.0,0,0,0,0,0,0,0,0,0,2023-2024,90.0,0.0,0.0
97,Jordan Amavi,FRA,DF,Brest,Ligue 1,29,1994,1.0,1,1,0,1,0,1,3,33.3,2,2,1,1,3,4,2,0,0,2023-2024,90.0,270.0,90.0
98,Zeki Amdouni,SUI,FW,Burnley,Premier League,22,2000,21.7,27,18,1,15,11,7,25,28.0,18,23,10,13,9,36,10,0,0,2023-2024,90.0,37.327188940092164,111.9815668202765
99,Kelvin Amian,FRA,DF,Nantes,Ligue 1,25,1998,8.9,16,7,12,4,0,11,15,73.3,4,6,0,6,7,23,28,0,0,2023-2024,90.0,70.78651685393258,161.79775280898878
100,Bruno Amione,ARG,DF,Hellas Verona,Serie A,21,2002,6.4,11,3,9,2,0,4,5,80.0,1,4,2,2,9,20,19,2,0,2023-2024,90.0,126.5625,154.6875
Rk,Player,Nation,Pos,Squad,Comp,0,0,90.0,0,0,3,3,3,Tkl,0,0.0,0,0,0,0,0,0,0,0,0,2023-2024,90.0,0.0,0.0
101,Michael Amir Murillo,PAN,DF,Marseille,Ligue 1,27,1996,11.1,23,11,13,6,4,15,23,65.2,8,9,2,7,11,34,34,2,0,2023-2024,90.0,89.1891891891892,186.4864864864865
102,Nadiem Amiri,GER,MF,Mainz 05,Bundesliga,26,1996,14.6,22,14,8,10,4,13,19,68.4,6,16,2,14,14,36,18,0,0,2023-2024,90.0,86.3013698630137,135.6164383561644
103,Nadiem Amiri,GER,MF,Leverkusen,Bundesliga,26,1996,1.0,4,2,0,3,1,0,3,0.0,3,0,0,0,0,4,1,0,0,2023-2024,90.0,0.0,360.0
104,Kofi Amoako,GER,MF,Wolfsburg,Bundesliga,18,2005,0.0,0,0,0,0,0,0,0,0.0,0,0,0,0,0,0,0,0,0,2023-2024,,,
105,Sofyan Amrabat,MAR,"MF,DF",Manchester Utd,Premier League,26,1996,10.4,27,16,17,8,2,17,31,54.8,14,20,7,13,8,35,19,2,0,2023-2024,90.0,69.23076923076923,233.65384615384613
106,Joachim Andersen,DEN,DF,Crystal Palace,Premier League,27,1996,37.9,56,35,33,21,2,29,39,74.4,10,33,18,15,41,97,207,1,0,2023-2024,90.0,97.36147757255937,132.9815303430079
107,Elliot Anderson,SCO,"MF,FW",Newcastle Utd,Premier League,20,2002,11.4,24,18,12,9,3,15,29,51.7,14,23,4,19,8,32,23,0,0,2023-2024,90.0,63.1578947368421,189.4736842105263
108,Felipe Anderson,BRA,"FW,MF",Lazio,Serie A,30,1993,30.8,78,45,32,33,13,34,90,37.8,56,45,3,42,27,105,23,0,0,2023-2024,90.0,78.8961038961039,227.92207792207793
109,Benjamin André,FRA,MF,Lille,Ligue 1,32,1990,28.6,89,49,39,45,5,43,81,53.1,38,34,5,29,35,124,60,0,0,2023-2024,90.0,110.13986013986015,280.0699300699301
110,Komnen Andrić,SRB,FW,Clermont Foot,Ligue 1,28,1995,1.9,2,1,0,1,1,0,4,0.0,4,2,0,2,0,2,1,0,0,2023-2024,90.0,0.0,94.73684210526315
111,Robert Andrich,GER,"MF,DF",Leverkusen,Bundesliga,28,1994,18.8,30,18,8,14,8,13,24,54.2,11,15,4,11,20,50,17,0,0,2023-2024,90.0,95.74468085106382,143.61702127659572
112,Miguel Ángel Rubio,ESP,DF,Granada,La Liga,25,1998,17.3,20,12,14,6,0,14,21,66.7,7,31,18,13,28,48,74,2,0,2023-2024,90.0,145.66473988439304,104.04624277456647
113,Angeliño,ESP,DF,Roma,Serie A,26,1997,12.7,21,11,12,6,3,11,19,57.9,8,11,5,6,12,33,37,1,0,2023-2024,90.0,85.03937007874016,148.8188976377953
114,Fabrizio Angileri,ARG,"DF,MF",Getafe,La Liga,29,1994,1.8,1,1,1,0,0,1,3,33.3,2,0,0,0,4,5,8,0,0,2023-2024,90.0,200.0,50.0
115,Jaidon Anthony,ENG,FW,Bournemouth,Premier League,23,1999,1.7,3,1,1,0,2,1,7,14.3,6,3,0,3,1,4,3,0,0,2023-2024,90.0,52.94117647058823,158.8235294117647
116,Waldemar Anton,GER,DF,Stuttgart,Bundesliga,27,1996,32.1,39,25,21,16,2,23,42,54.8,19,33,20,13,40,79,150,1,0,2023-2024,90.0,112.14953271028037,109.34579439252336
117,Michail Antonio,JAM,FW,West Ham,Premier League,33,1990,18.8,15,8,5,6,4,3,11,27.3,8,16,3,13,4,19,4,0,0,2023-2024,90.0,19.148936170212764,71.80851063829786
118,Antony,BRA,FW,Manchester Utd,Premier League,23,2000,14.7,40,21,15,19,6,20,40,50.0,20,29,1,28,12,52,9,0,0,2023-2024,90.0,73.46938775510205,244.89795918367346
119,Christopher Antwi-Adjei,GHA,"FW,MF",Bochum,Bundesliga,29,1994,13.5,21,12,10,6,5,12,22,54.5,10,13,2,11,2,23,11,1,0,2023-2024,90.0,13.333333333333334,140.0
120,Houssem Aouar,ALG,"MF,FW",Roma,Serie A,25,1998,8.4,16,11,4,10,2,3,12,25.0,9,5,0,5,4,20,2,1,0,2023-2024,90.0,42.857142857142854,171.42857142857142
121,Stredair Appuah,FRA,"FW,MF",Nantes,Ligue 1,19,2004,0.9,0,0,0,0,0,0,3,0.0,3,0,0,0,1,1,1,0,0,2023-2024,90.0,100.0,0.0
122,Mauro Arambarri,URU,MF,Getafe,La Liga,27,1995,3.8,6,2,3,2,1,1,6,16.7,5,1,0,1,2,8,7,0,0,2023-2024,90.0,47.368421052631575,142.10526315789474
123,Jon Aramburu,VEN,DF,Real Sociedad,La Liga,21,2002,6.0,24,15,12,10,2,15,25,60.0,10,8,3,5,7,31,17,0,0,2023-2024,90.0,105.0,360.0
124,Asaf Arania,ISR,MF,Darmstadt 98,Bundesliga,17,2005,0.1,0,0,0,0,0,0,0,0.0,0,0,0,0,0,0,0,0,0,2023-2024,90.0,0.0,0.0
125,Julian Araujo,MEX,DF,Las Palmas,La Liga,21,2001,16.2,41,22,29,7,5,23,33,69.7,10,23,16,7,10,51,52,1,0,2023-2024,90.0,55.55555555555556,227.7777777777778
Rk,Player,Nation,Pos,Squad,Comp,0,0,90.0,0,0,3,3,3,Tkl,0,0.0,0,0,0,0,0,0,0,0,0,2023-2024,90.0,0.0,0.0
126,Ronald Araújo,URU,DF,Barcelona,La Liga,24,1999,22.2,27,22,11,15,1,12,17,70.6,5,20,11,9,12,39,66,2,0,2023-2024,90.0,48.64864864864865,109.45945945945947
127,Oliver Arblaster,ENG,MF,Sheffield Utd,Premier League,19,2004,10.5,23,14,11,8,4,7,15,46.7,8,17,7,10,15,38,9,0,0,2023-2024,90.0,128.57142857142856,197.14285714285714
128,Cameron Archer,ENG,"FW,MF",Sheffield Utd,Premier League,22,2001,20.4,18,13,6,6,6,8,18,44.4,10,22,3,19,1,19,11,0,0,2023-2024,90.0,4.411764705882353,79.41176470588236
129,Cameron Archer,ENG,MF,Aston Villa,Premier League,22,2001,0.1,0,0,0,0,0,0,0,0.0,0,0,0,0,0,0,0,0,0,2023-2024,90.0,0.0,0.0
130,Alphonse Areola,FRA,GK,West Ham,Premier League,30,1993,30.0,1,1,1,0,0,1,3,33.3,2,0,0,0,1,2,16,0,0,2023-2024,90.0,3.0,3.0
131,Adu Ares,ESP,FW,Athletic Club,La Liga,21,2001,2.9,8,4,4,2,2,2,3,66.7,1,1,0,1,1,9,0,0,0,2023-2024,90.0,31.03448275862069,248.27586206896552
132,Jesús Areso,ESP,DF,Osasuna,La Liga,24,1999,29.6,45,24,25,13,7,31,38,81.6,7,36,15,21,18,63,58,0,0,2023-2024,90.0,54.729729729729726,136.82432432432432
133,Simone Aresti,ITA,GK,Cagliari,Serie A,37,1986,0.0,0,0,0,0,0,0,0,0.0,0,0,0,0,0,0,0,0,0,2023-2024,,,
134,Matias Arezo,URU,FW,Granada,La Liga,20,2002,4.1,7,3,2,5,0,1,5,20.0,4,4,1,3,1,8,4,0,0,2023-2024,90.0,21.951219512195124,153.65853658536588
135,Iñigo Arguibide,ESP,DF,Osasuna,La Liga,18,2005,0.2,1,0,0,1,0,0,0,0.0,0,0,0,0,0,1,1,0,0,2023-2024,90.0,0.0,450.0
136,Yoël Armougom,FRA,"DF,MF",Clermont Foot,Ligue 1,25,1998,2.6,3,3,2,0,1,2,3,66.7,1,1,0,1,1,4,3,0,0,2023-2024,90.0,34.61538461538461,103.84615384615384
137,José Arnaiz,ESP,"FW,MF",Osasuna,La Liga,28,1995,10.3,14,8,6,4,4,6,21,28.6,15,11,2,9,3,17,2,0,0,2023-2024,90.0,26.21359223300971,122.33009708737863
138,Hákon Arnar Haraldsson,ISL,"FW,MF",Lille,Ligue 1,20,2003,14.3,12,8,4,7,1,5,21,23.8,16,7,2,5,3,15,5,0,0,2023-2024,90.0,18.88111888111888,75.52447552447552
139,Marko Arnautović,AUT,FW,Inter,Serie A,34,1989,8.9,10,4,3,5,2,4,7,57.1,3,8,1,7,5,15,5,0,0,2023-2024,90.0,50.56179775280899,101.12359550561798
140,Maximilian Arnold,GER,MF,Wolfsburg,Bundesliga,29,1994,27.8,51,31,15,27,9,28,57,49.1,29,23,4,19,24,75,60,0,0,2023-2024,90.0,77.6978417266187,165.10791366906474
141,Mohamed El Arouch,FRA,FW,Lyon,Ligue 1,19,2004,0.0,0,0,0,0,0,0,0,0.0,0,0,0,0,0,0,0,0,0,2023-2024,,,
142,Sergio Arribas,ESP,"MF,FW",Almería,La Liga,21,2001,22.7,34,17,16,17,1,14,31,45.2,17,20,1,19,16,50,8,1,0,2023-2024,89.99999999999999,63.43612334801762,134.80176211453744
143,Kepa Arrizabalaga,ESP,GK,Real Madrid,La Liga,28,1994,13.3,0,0,0,0,0,0,1,0.0,1,0,0,0,0,0,4,0,0,2023-2024,90.0,0.0,0.0
144,Arthur,BRA,DF,Leverkusen,Bundesliga,20,2003,2.0,4,3,2,0,2,2,2,100.0,0,1,1,0,0,4,7,0,0,2023-2024,90.0,0.0,180.0
145,Takuma Asano,JPN,"FW,MF",Bochum,Bundesliga,28,1994,22.1,17,6,2,9,6,7,23,30.4,16,17,3,14,4,21,11,0,0,2023-2024,90.0,16.289592760180994,69.23076923076923
146,Marco Asensio,ESP,"MF,FW",Paris S-G,Ligue 1,27,1996,12.4,12,10,4,7,1,4,13,30.8,9,7,0,7,5,17,2,0,0,2023-2024,90.0,36.29032258064516,87.09677419354838
147,Kristjan Asllani,ALB,MF,Inter,Serie A,21,2002,8.7,7,2,3,4,0,2,11,18.2,9,9,3,6,11,18,8,0,0,2023-2024,90.0,113.79310344827586,72.41379310344827
148,Joel Asoro,SWE,"FW,MF",Metz,Ligue 1,24,1999,9.4,13,9,7,6,0,3,10,30.0,7,7,1,6,6,19,9,0,0,2023-2024,90.0,57.44680851063829,124.46808510638297
149,Jonathan Asp Jensen,DEN,FW,Bayern Munich,Bundesliga,17,2006,0.0,0,0,0,0,0,0,0,0.0,0,0,0,0,0,0,1,0,0,2023-2024,,,
150,Iago Aspas,ESP,FW,Celta Vigo,La Liga,35,1987,30.1,11,6,4,6,1,1,15,6.7,14,23,3,20,10,21,8,0,0,2023-2024,90.00000000000001,29.900332225913623,32.89036544850499
Rk,Player,Nation,Pos,Squad,Comp,0,0,90.0,0,0,3,3,3,Tkl,0,0.0,0,0,0,0,0,0,0,0,0,2023-2024,90.0,0.0,0.0
151,Lorenz Assignon,TOG,DF,Burnley,Premier League,23,2000,13.7,35,17,18,13,4,14,27,51.9,13,22,7,15,19,54,43,1,0,2023-2024,90.0,124.8175182481752,229.9270072992701
152,Lorenz Assignon,TOG,DF,Rennes,Ligue 1,23,2000,11.2,24,12,12,8,4,9,24,37.5,15,9,4,5,9,33,27,1,0,2023-2024,90.0,72.32142857142857,192.85714285714286
153,Youcef Atal,ALG,DF,Nice,Ligue 1,27,1996,4.0,9,3,6,2,1,6,8,75.0,2,7,1,6,4,13,1,0,0,2023-2024,90.0,90.0,202.5
154,Valentin Atangana Edoa,FRA,MF,Reims,Ligue 1,17,2005,6.2,19,13,6,9,4,5,13,38.5,8,5,1,4,6,25,9,0,0,2023-2024,90.0,87.09677419354838,275.80645161290323
155,Arthur Atta,FRA,"MF,FW",Metz,Ligue 1,20,2003,10.3,18,14,8,7,3,8,19,42.1,11,13,3,10,10,28,23,0,0,2023-2024,90.0,87.37864077669903,157.28155339805826
156,Noah Atubolu,GER,GK,Freiburg,Bundesliga,21,2002,34.0,0,0,0,0,0,0,1,0.0,1,0,0,0,0,0,8,1,0,2023-2024,90.0,0.0,0.0
157,Pierre-Emerick Aubameyang,GAB,FW,Marseille,Ligue 1,34,1989,29.1,22,14,4,11,7,7,26,26.9,19,30,5,25,9,31,26,0,0,2023-2024,90.0,27.83505154639175,68.04123711340206
158,Emil Audero,ITA,GK,Inter,Serie A,26,1997,3.7,0,0,0,0,0,0,0,0.0,0,0,0,0,0,0,1,0,0,2023-2024,90.0,0.0,0.0
159,Tommaso Augello,ITA,DF,Cagliari,Serie A,28,1994,26.9,26,19,18,6,2,16,25,64.0,9,21,10,11,17,43,89,0,0,2023-2024,90.0,56.877323420074354,86.98884758364312
160,Carlos Augusto,BRA,DF,Inter,Serie A,24,1999,19.2,29,21,20,9,0,15,22,68.2,7,20,8,12,16,45,52,0,0,2023-2024,90.0,75.0,135.9375
161,Yann Aurel Bisseck,GER,DF,Inter,Serie A,22,2000,10.0,14,6,10,3,1,6,9,66.7,3,10,7,3,5,19,23,0,0,2023-2024,90.0,45.0,126.0
162,Serge Aurier,CIV,"DF,MF",Nott'ham Forest,Premier League,30,1992,9.3,20,14,9,11,0,5,11,45.5,6,10,3,7,9,29,36,1,0,2023-2024,90.0,87.09677419354837,193.54838709677418
163,Ezequiel Ávila,ARG,"FW,MF",Osasuna,La Liga,29,1994,9.6,3,2,1,1,1,3,11,27.3,8,14,0,14,4,7,8,0,0,2023-2024,90.0,37.5,28.125000000000004
164,Ezequiel Ávila,ARG,FW,Betis,La Liga,29,1994,3.3,2,1,0,2,0,1,3,33.3,2,2,0,2,1,3,4,0,0,2023-2024,90.0,27.272727272727273,54.54545454545455
165,Taiwo Awoniyi,NGA,FW,Nott'ham Forest,Premier League,25,1997,11.6,9,7,1,4,4,1,2,50.0,1,7,2,5,1,10,9,0,0,2023-2024,90.0,7.758620689655173,69.82758620689656
166,André Ayew,GHA,FW,Le Havre,Ligue 1,33,1989,12.3,15,11,7,6,2,6,9,66.7,3,8,3,5,2,17,11,0,0,2023-2024,89.99999999999999,14.634146341463413,109.75609756097559
167,Jordan Ayew,GHA,"FW,MF",Crystal Palace,Premier League,31,1991,28.3,65,36,23,28,14,21,42,50.0,21,43,2,41,16,81,15,0,0,2023-2024,90.0,50.88339222614841,206.7137809187279
168,Neil El Aynaoui,FRA,MF,Lens,Ligue 1,22,2001,17.4,37,20,13,20,4,20,46,43.5,26,20,6,14,32,69,21,1,0,2023-2024,90.0,165.51724137931035,191.3793103448276
169,Sardar Azmoun,IRN,"FW,MF",Roma,Serie A,28,1995,6.5,8,5,2,5,1,4,8,50.0,4,4,1,3,3,11,6,1,0,2023-2024,90.00000000000001,41.53846153846154,110.76923076923077
170,César Azpilicueta,ESP,DF,Atlético Madrid,La Liga,33,1989,15.8,25,14,15,9,1,12,19,63.2,7,25,6,19,16,41,46,0,0,2023-2024,90.0,91.1392405063291,142.40506329113921
171,Paulo Azzi,BRA,"DF,MF",Cagliari,Serie A,29,1994,10.6,19,11,10,6,3,9,18,50.0,9,11,2,9,16,35,23,0,0,2023-2024,90.0,135.8490566037736,161.32075471698113
172,Oussama El Azzouzi,MAR,MF,Bologna,Serie A,22,2001,6.1,12,7,4,5,3,7,14,50.0,7,8,2,6,6,18,12,0,0,2023-2024,90.0,88.52459016393443,177.04918032786887
173,Abdellah Baallal,MAR,MF,Clermont Foot,Ligue 1,18,2004,0.0,0,0,0,0,0,0,0,0.0,0,1,0,1,0,0,0,0,0,2023-2024,,,
174,Iddrisu Baba,GHA,MF,Almería,La Liga,27,1996,15.9,46,26,27,18,1,17,39,43.6,22,20,6,14,11,57,27,2,0,2023-2024,90.0,62.264150943396224,260.37735849056605
175,Srđan Babić,SRB,DF,Almería,La Liga,27,1996,1.0,2,2,0,2,0,1,1,100.0,0,1,1,0,0,2,2,0,0,2023-2024,90.0,0.0,180.0
Rk,Player,Nation,Pos,Squad,Comp,0,0,90.0,0,0,3,3,3,Tkl,0,0.0,0,0,0,0,0,0,0,0,0,2023-2024,90.0,0.0,0.0
176,Shavy Babicka,GAB,"FW,MF",Toulouse,Ligue 1,23,2000,4.1,11,8,2,7,2,2,5,40.0,3,6,1,5,0,11,2,0,0,2023-2024,90.0,0.0,241.46341463414637
177,Loïc Bade,FRA,DF,Sevilla,La Liga,23,2000,25.3,65,41,53,12,0,30,49,61.2,19,23,15,8,38,103,116,2,0,2023-2024,89.99999999999999,135.17786561264822,231.22529644268772
178,Milan Badelj,CRO,MF,Genoa,Serie A,34,1989,28.2,51,27,23,24,4,24,61,39.3,37,45,13,32,50,101,54,1,0,2023-2024,89.99999999999999,159.57446808510636,162.7659574468085
179,Matthias Bader,GER,"DF,MF",Darmstadt 98,Bundesliga,26,1997,20.0,51,25,32,11,8,33,65,50.8,32,22,4,18,25,76,20,0,0,2023-2024,90.0,112.5,229.5
180,Benoît Badiashile,FRA,DF,Chelsea,Premier League,22,2001,14.9,21,15,12,9,0,9,14,64.3,5,21,14,7,18,39,66,2,0,2023-2024,90.0,108.72483221476509,126.84563758389261
181,Alex Baena,ESP,"MF,FW",Villarreal,La Liga,22,2001,28.7,34,21,10,16,8,20,47,42.6,27,23,2,21,13,47,17,1,0,2023-2024,90.0,40.76655052264808,106.62020905923345
182,Jaime Báez,URU,"FW,MF",Frosinone,Serie A,28,1995,5.6,4,1,0,2,2,0,7,0.0,7,5,0,5,4,8,1,0,0,2023-2024,90.0,64.28571428571429,64.28571428571429
183,Nicola Bagnolini,ITA,GK,Bologna,Serie A,19,2004,0.1,0,0,0,0,0,0,0,0.0,0,0,0,0,0,0,0,0,0,2023-2024,90.0,0.0,0.0
184,Leon Bailey,JAM,"MF,FW",Aston Villa,Premier League,25,1997,23.0,13,7,7,4,2,5,20,25.0,15,18,1,17,9,22,6,0,0,2023-2024,90.0,35.21739130434783,50.86956521739131
185,Eric Bailly,CIV,DF,Villarreal,La Liga,29,1994,9.3,5,3,4,1,0,2,2,100.0,0,8,8,0,9,14,38,2,0,2023-2024,90.0,87.09677419354837,48.387096774193544
186,Stefan Bajcetic,ESP,MF,Liverpool,Premier League,18,2004,0.3,4,1,3,1,0,3,5,60.0,2,0,0,0,0,4,0,0,0,2023-2024,90.0,0.0,1200.0
187,Nedim Bajrami,ALB,"MF,FW",Sassuolo,Serie A,24,1999,14.6,13,6,6,3,4,5,13,38.5,8,5,1,4,6,19,8,0,0,2023-2024,90.0,36.986301369863014,80.13698630136987
188,Cédric Bakambu,COD,FW,Betis,La Liga,32,1991,2.2,1,0,0,1,0,0,0,0.0,0,2,0,2,0,1,0,0,0,2023-2024,90.0,0.0,40.90909090909091
189,Tiemoué Bakayoko,FRA,MF,Lorient,Ligue 1,28,1994,14.6,34,17,14,17,3,15,28,53.6,13,10,4,6,26,60,15,1,0,2023-2024,90.0,160.27397260273975,209.58904109589042
190,Mitchel Bakker,NED,DF,Atalanta,Serie A,23,2000,4.2,7,3,6,1,0,2,12,16.7,10,5,0,5,3,10,6,0,0,2023-2024,90.0,64.28571428571428,150.0
191,Ridle Baku,GER,"DF,MF",Wolfsburg,Bundesliga,25,1998,22.4,37,20,24,7,6,21,46,45.7,25,27,1,26,21,58,45,1,0,2023-2024,90.0,84.375,148.66071428571428
192,Dilane Bakwa,FRA,"FW,MF",Strasbourg,Ligue 1,20,2002,24.2,30,22,12,13,5,11,40,27.5,29,26,1,25,20,50,11,0,0,2023-2024,90.0,74.3801652892562,111.57024793388429
193,Tommaso Baldanzi,ITA,"MF,FW",Empoli,Serie A,20,2003,8.3,4,2,1,1,2,3,10,30.0,7,7,0,7,2,6,0,0,0,2023-2024,90.0,21.686746987951803,43.37349397590361
194,Tommaso Baldanzi,ITA,"FW,MF",Roma,Serie A,20,2003,5.8,9,5,3,4,2,1,1,100.0,0,2,0,2,0,9,4,0,0,2023-2024,90.0,0.0,139.6551724137931
195,Alejandro Balde,ESP,DF,Barcelona,La Liga,19,2003,15.3,20,11,11,6,3,7,11,63.6,4,14,1,13,5,25,21,1,0,2023-2024,90.0,29.41176470588235,117.6470588235294
196,Aliou Baldé,GUI,"FW,DF",Nice,Ligue 1,20,2002,0.8,4,1,0,3,1,1,1,100.0,0,2,1,1,3,7,0,0,0,2023-2024,90.0,337.5,450.0
197,George Baldock,GRE,DF,Sheffield Utd,Premier League,30,1993,10.8,18,10,10,7,1,6,15,40.0,9,14,8,6,10,28,33,0,0,2023-2024,90.0,83.33333333333333,150.0
198,Carlos Baleba,CMR,MF,Brighton,Premier League,19,2004,14.7,40,20,17,19,4,23,46,50.0,23,35,7,28,18,58,30,3,0,2023-2024,90.0,110.20408163265306,244.89795918367346
199,Carlos Baleba,CMR,MF,Lille,Ligue 1,19,2004,0.7,6,2,1,4,1,3,4,75.0,1,0,0,0,2,8,0,0,0,2023-2024,90.0,257.14285714285717,771.4285714285714
200,Leonardo Balerdi,ARG,DF,Marseille,Ligue 1,24,1999,25.2,79,50,55,23,1,49,67,73.1,18,38,15,23,51,130,91,0,0,2023-2024,90.0,182.14285714285717,282.14285714285717
Rk,Player,Nation,Pos,Squad,Comp,0,0,90.0,0,0,3,3,3,Tkl,0,0.0,0,0,0,0,0,0,0,0,0,2023-2024,90.0,0.0,0.0
201,Iván Balliu,ALB,DF,Rayo Vallecano,La Liga,31,1992,31.9,44,31,20,24,0,22,39,56.4,17,27,11,16,29,73,66,1,0,2023-2024,90.0,81.81818181818181,124.13793103448276
202,Fodé Ballo-Touré,SEN,"DF,MF",Fulham,Premier League,26,1997,0.8,4,2,1,3,0,1,2,50.0,1,1,0,1,3,7,2,0,0,2023-2024,90.0,337.5,450.0
203,Folarin Balogun,USA,FW,Monaco,Ligue 1,22,2001,18.8,12,4,3,8,1,5,13,38.5,8,10,0,10,3,15,4,0,0,2023-2024,90.0,14.361702127659573,57.44680851063829
204,Jonathan Bamba,CIV,"MF,FW",Celta Vigo,La Liga,27,1996,22.0,14,9,4,8,2,2,17,11.8,15,20,0,20,18,32,12,0,0,2023-2024,90.0,73.63636363636364,57.27272727272727
205,Mohamed Bamba,CIV,FW,Lorient,Ligue 1,21,2001,12.6,14,9,3,8,3,4,10,40.0,6,7,1,6,2,16,3,0,0,2023-2024,90.0,14.285714285714286,100.00000000000001
206,Samuel Bamba,GER,FW,Dortmund,Bundesliga,19,2004,0.5,1,1,1,0,0,1,2,50.0,1,0,0,0,0,1,1,0,0,2023-2024,90.0,0.0,180.0
207,Lameck Banda,ZAM,FW,Lecce,Serie A,22,2001,15.0,27,23,11,12,4,7,21,33.3,14,18,0,18,3,30,7,0,0,2023-2024,90.0,18.0,162.0
208,Daniel Bandeira,POR,MF,Hellas Verona,Serie A,23,2000,5.0,6,5,1,4,1,3,7,42.9,4,3,0,3,3,9,9,0,0,2023-2024,90.0,54.0,108.0
209,Mamady Bangré,BFA,"FW,MF",Toulouse,Ligue 1,22,2001,1.1,4,2,2,2,0,3,4,75.0,1,0,0,0,4,8,3,0,0,2023-2024,90.0,327.27272727272725,327.27272727272725
210,Mattia Bani,ITA,DF,Genoa,Serie A,29,1993,25.6,26,10,18,7,1,11,22,50.0,11,51,31,20,22,48,116,1,0,2023-2024,90.0,77.34375,91.40625
211,Léo Baptistão,BRA,FW,Almería,La Liga,30,1992,20.4,25,16,12,8,5,9,25,36.0,16,13,1,12,11,36,22,0,0,2023-2024,90.0,48.529411764705884,110.29411764705883
212,Shandon Baptiste,GRN,MF,Brentford,Premier League,25,1998,2.5,4,4,2,2,0,1,5,20.0,4,5,1,4,3,7,6,0,0,2023-2024,90.0,108.0,144.0
213,Antonín Barák,CZE,"MF,FW",Fiorentina,Serie A,28,1994,9.0,6,2,1,3,2,3,7,42.9,4,5,0,5,2,8,4,0,0,2023-2024,90.0,20.0,60.0
214,Valentín Barco,ARG,"DF,FW",Brighton,Premier League,19,2004,3.4,11,5,4,5,2,6,8,75.0,2,3,0,3,4,15,3,1,0,2023-2024,90.0,105.88235294117646,291.1764705882353
215,Bradley Barcola,FRA,FW,Lyon,Ligue 1,20,2002,3.0,5,2,0,2,3,1,7,14.3,6,4,0,4,2,7,0,0,0,2023-2024,90.0,60.0,150.0
216,Bradley Barcola,FRA,"FW,MF",Paris S-G,Ligue 1,20,2002,15.2,34,16,12,13,9,7,25,28.0,18,27,2,25,10,44,13,1,0,2023-2024,90.0,59.21052631578947,201.3157894736842
217,Melvin Bard,FRA,DF,Nice,Ligue 1,22,2000,29.5,69,38,28,30,11,37,63,58.7,26,46,12,34,42,111,46,0,0,2023-2024,90.0,128.135593220339,210.5084745762712
218,Nicolò Barella,ITA,MF,Inter,Serie A,26,1997,31.6,46,30,17,20,9,19,63,30.2,44,31,1,30,10,56,12,1,0,2023-2024,90.0,28.481012658227844,131.01265822784808
219,Kike Barja,ESP,"FW,MF",Osasuna,La Liga,26,1997,3.4,6,2,2,2,2,3,8,37.5,5,2,1,1,2,8,2,0,0,2023-2024,90.0,52.94117647058823,158.8235294117647
220,Ross Barkley,ENG,MF,Luton Town,Premier League,29,1993,29.1,47,19,16,21,10,11,48,22.9,37,25,9,16,25,72,51,2,0,2023-2024,90.0,77.31958762886597,145.36082474226802
221,Aymen Barkok,MAR,"MF,FW",Mainz 05,Bundesliga,25,1998,3.6,9,5,2,6,1,3,6,50.0,3,7,0,7,2,11,1,0,0,2023-2024,90.0,50.0,225.0
222,Harvey Barnes,ENG,"FW,MF",Newcastle Utd,Premier League,25,1997,8.9,6,1,3,2,1,1,2,50.0,1,1,0,1,5,11,3,0,0,2023-2024,90.0,50.56179775280899,60.67415730337079
223,Leandro Barreiro Martins,LUX,MF,Mainz 05,Bundesliga,23,2000,29.0,65,40,19,37,9,30,50,60.0,20,45,16,29,36,101,53,0,0,2023-2024,90.0,111.72413793103448,201.72413793103448
224,Enzo Barrenechea,ARG,MF,Frosinone,Serie A,22,2001,31.2,65,42,28,29,8,28,70,40.0,42,47,12,35,27,92,61,2,0,2023-2024,90.0,77.88461538461539,187.5
225,Ander Barrenetxea,ESP,"FW,MF",Real Sociedad,La Liga,21,2001,15.9,32,21,7,16,9,10,26,38.5,16,18,1,17,6,38,5,0,0,2023-2024,90.0,33.9622641509434,181.1320754716981
Rk,Player,Nation,Pos,Squad,Comp,0,0,90.0,0,0,3,3,3,Tkl,0,0.0,0,0,0,0,0,0,0,0,0,2023-2024,90.0,0.0,0.0
226,Pablo Barrios,ESP,MF,Atlético Madrid,La Liga,20,2003,17.3,45,25,15,29,1,19,40,47.5,21,20,3,17,28,73,24,2,0,2023-2024,90.0,145.66473988439304,234.10404624277456
227,Davide Bartesaghi,ITA,"DF,MF",Milan,Serie A,17,2005,0.9,2,0,1,1,0,2,4,50.0,2,1,1,0,0,2,7,0,0,2023-2024,90.0,0.0,200.0
228,Marc Bartra,ESP,DF,Betis,La Liga,32,1991,2.5,4,3,3,1,0,4,5,80.0,1,3,1,2,3,7,10,0,0,2023-2024,90.0,108.0,144.0
229,Federico Baschirotto,ITA,DF,Lecce,Serie A,26,1996,36.6,21,12,16,5,0,8,15,53.3,7,42,26,16,23,44,144,1,0,2023-2024,90.0,56.557377049180324,51.63934426229508
230,Steven Baseya,FRA,DF,Strasbourg,Ligue 1,18,2005,0.1,2,1,1,1,0,1,1,100.0,0,0,0,0,0,2,1,0,0,2023-2024,90.0,0.0,1800.0
231,Chris Basham,ENG,"DF,MF",Sheffield Utd,Premier League,35,1988,3.6,7,2,4,3,0,2,9,22.2,7,9,4,5,5,12,17,0,0,2023-2024,90.0,125.0,175.0
232,Toma Bašić,CRO,MF,Salernitana,Serie A,26,1996,12.9,20,13,10,9,1,10,27,37.0,17,18,6,12,14,34,29,0,0,2023-2024,90.0,97.67441860465115,139.53488372093022
233,Calvin Bassey,NGA,DF,Fulham,Premier League,23,1999,25.6,49,29,33,15,1,21,29,72.4,8,32,11,21,28,77,84,4,0,2023-2024,90.0,98.4375,172.265625
234,Alessandro Bastoni,ITA,DF,Inter,Serie A,24,1999,25.2,46,33,31,12,3,26,40,65.0,14,25,11,14,23,69,48,1,0,2023-2024,90.0,82.14285714285715,164.2857142857143
235,Simone Bastoni,ITA,"MF,DF",Empoli,Serie A,26,1996,8.3,22,13,12,7,3,11,22,50.0,11,8,0,8,11,33,18,0,0,2023-2024,90.0,119.27710843373492,238.55421686746985
236,Augusto Batalla,ARG,GK,Granada,La Liga,27,1996,17.0,0,0,0,0,0,0,1,0.0,1,0,0,0,0,0,10,2,0,2023-2024,90.0,0.0,0.0
237,Daniel Batz,GER,GK,Mainz 05,Bundesliga,32,1991,4.0,0,0,0,0,0,0,0,0.0,0,0,0,0,0,0,3,0,0,2023-2024,90.0,0.0,0.0
238,Maximilian Bauer,GER,DF,Augsburg,Bundesliga,23,2000,9.0,19,12,13,4,2,9,17,52.9,8,14,8,6,11,30,30,1,0,2023-2024,90.0,110.0,190.0
239,Elias Baum,GER,"DF,MF",Eint Frankfurt,Bundesliga,17,2005,0.3,1,0,0,0,1,0,0,0.0,0,3,2,1,0,1,1,0,0,2023-2024,90.0,0.0,300.0
240,Oliver Baumann,GER,GK,Hoffenheim,Bundesliga,33,1990,34.0,1,1,1,0,0,1,2,50.0,1,0,0,0,0,1,19,2,0,2023-2024,90.0,0.0,2.6470588235294117
241,Christoph Baumgartner,AUT,"MF,FW",RB Leipzig,Bundesliga,23,1999,12.9,26,13,10,12,4,14,38,36.8,24,20,1,19,5,31,14,0,0,2023-2024,90.0,34.883720930232556,181.3953488372093
242,Bebé,CPV,"MF,FW",Rayo Vallecano,La Liga,33,1990,2.4,2,2,1,1,0,1,5,20.0,4,1,0,1,0,2,0,0,0,2023-2024,90.0,0.0,75.0
243,Ihlas Bebou,TOG,"FW,DF",Hoffenheim,Bundesliga,29,1994,18.2,22,12,10,8,4,8,16,50.0,8,13,2,11,14,36,15,0,0,2023-2024,90.0,69.23076923076923,108.79120879120879
244,Mohamed Bechikh,FRA,"FW,MF",Strasbourg,Ligue 1,18,2005,0.2,0,0,0,0,0,0,0,0.0,0,0,0,0,0,0,0,0,0,2023-2024,90.0,0.0,0.0
245,Adrian Beck,GER,"MF,FW",Heidenheim,Bundesliga,26,1997,10.8,22,13,8,12,2,9,24,37.5,15,17,0,17,4,26,15,0,0,2023-2024,90.0,33.33333333333333,183.33333333333331
246,Owen Beck,WAL,DF,Liverpool,Premier League,20,2002,0.1,2,1,1,1,0,0,0,0.0,0,0,0,0,0,2,1,0,0,2023-2024,90.0,0.0,1800.0
247,Sheraldo Becker,SUR,"FW,MF",Real Sociedad,La Liga,28,1995,8.6,2,2,0,2,0,0,1,0.0,1,3,0,3,1,3,0,0,0,2023-2024,90.0,10.465116279069768,20.930232558139537
248,Sheraldo Becker,SUR,"FW,MF",Union Berlin,Bundesliga,28,1995,7.2,3,3,0,2,1,0,2,0.0,2,2,0,2,0,3,2,0,0,2023-2024,90.0,0.0,37.5
249,Chris Bedia,CIV,"FW,MF",Union Berlin,Bundesliga,27,1996,1.6,2,1,0,2,0,0,1,0.0,1,3,0,3,0,2,2,0,0,2023-2024,90.0,0.0,112.5
250,Donny van de Beek,NED,DF,Manchester Utd,Premier League,26,1997,0.0,0,0,0,0,0,0,0,0.0,0,1,0,1,0,0,0,0,0,2023-2024,,,
Rk,Player,Nation,Pos,Squad,Comp,0,0,90.0,0,0,3,3,3,Tkl,0,0.0,0,0,0,0,0,0,0,0,0,2023-2024,90.0,0.0,0.0
251,Donny van de Beek,NED,"MF,FW",Eint Frankfurt,Bundesliga,26,1997,4.0,8,3,3,3,2,3,7,42.9,4,5,1,4,3,11,1,0,0,2023-2024,90.0,67.5,180.0
252,Yanis Begraoui,MAR,"FW,MF",Toulouse,Ligue 1,22,2001,3.3,5,3,1,3,1,3,9,33.3,6,4,0,4,5,10,5,0,0,2023-2024,90.0,136.36363636363637,136.36363636363637
253,Kevin Behrens,GER,FW,Wolfsburg,Bundesliga,32,1991,6.8,2,1,0,1,1,0,2,0.0,2,9,0,9,3,5,6,0,0,2023-2024,90.0,39.705882352941174,26.470588235294116
254,Kevin Behrens,GER,FW,Union Berlin,Bundesliga,32,1991,14.0,13,10,3,7,3,1,4,25.0,3,7,2,5,6,19,19,0,0,2023-2024,90.0,38.57142857142857,83.57142857142857
255,Maximilian Beier,GER,"FW,MF",Hoffenheim,Bundesliga,20,2002,26.9,20,12,5,11,4,4,19,21.1,15,21,1,20,9,29,12,0,0,2023-2024,90.0,30.111524163568774,66.91449814126395
256,Jérémie Bela,ANG,"MF,FW",Clermont Foot,Ligue 1,30,1993,2.3,1,1,0,1,0,1,3,33.3,2,1,0,1,0,1,1,0,0,2023-2024,90.0,0.0,39.130434782608695
257,Reda Belahyane,FRA,MF,Hellas Verona,Serie A,19,2004,1.0,1,1,0,1,0,1,1,100.0,0,0,0,0,1,2,0,0,0,2023-2024,90.0,90.0,90.0
258,Reda Belahyane,FRA,MF,Nice,Ligue 1,19,2004,0.3,1,0,0,1,0,1,1,100.0,0,0,0,0,0,1,0,0,0,2023-2024,90.0,0.0,300.0
259,Amari'i Bell,JAM,DF,Luton Town,Premier League,29,1994,19.1,50,33,30,19,1,22,35,62.9,13,33,15,18,25,75,60,1,0,2023-2024,90.0,117.80104712041884,235.6020942408377
260,Stefan Bell,GER,DF,Mainz 05,Bundesliga,31,1991,7.4,8,8,7,1,0,4,8,50.0,4,7,5,2,6,14,30,0,0,2023-2024,90.0,72.97297297297297,97.29729729729729
261,Alaa Bellaarouch,MAR,GK,Strasbourg,Ligue 1,21,2002,15.0,0,0,0,0,0,0,0,0.0,0,0,0,0,1,1,11,2,0,2023-2024,90.0,6.0,0.0
262,Raoul Bellanova,ITA,DF,Torino,Serie A,23,2000,33.8,36,26,15,17,4,18,31,58.1,13,21,4,17,15,51,36,3,0,2023-2024,90.0,39.94082840236687,95.85798816568048
263,Jean-Ricner Bellegarde,FRA,"MF,FW",Wolves,Premier League,25,1998,10.6,17,10,9,6,2,7,15,46.7,8,18,2,16,8,25,14,0,0,2023-2024,90.0,67.9245283018868,144.33962264150944
264,Jean-Ricner Bellegarde,FRA,"MF,FW",Strasbourg,Ligue 1,25,1998,3.0,5,3,3,2,0,3,6,50.0,3,4,0,4,4,9,0,0,0,2023-2024,90.0,120.0,150.0
265,Héctor Bellerín,ESP,DF,Betis,La Liga,28,1995,19.0,34,22,14,16,4,20,53,37.7,33,13,5,8,22,56,40,1,0,2023-2024,90.0,104.21052631578948,161.05263157894737
266,Jude Bellingham,ENG,MF,Real Madrid,La Liga,20,2003,25.7,42,34,14,18,10,12,36,33.3,24,55,5,50,21,63,17,0,0,2023-2024,90.0,73.5408560311284,147.0817120622568
267,Jeanuël Belocian,FRA,DF,Rennes,Ligue 1,18,2005,16.1,32,22,23,8,1,22,28,78.6,6,18,10,8,13,45,49,0,0,2023-2024,90.0,72.67080745341615,178.88198757763973
268,Andrea Belotti,ITA,FW,Fiorentina,Serie A,29,1993,10.5,8,3,1,5,2,5,12,41.7,7,8,1,7,2,10,3,0,0,2023-2024,90.0,17.142857142857142,68.57142857142857
269,Andrea Belotti,ITA,FW,Roma,Serie A,29,1993,7.5,8,4,2,3,3,3,6,50.0,3,7,0,7,2,10,3,0,0,2023-2024,90.0,24.0,96.0
270,Fran Beltrán,ESP,MF,Celta Vigo,La Liga,24,1999,27.0,56,32,22,23,11,24,63,38.1,39,28,2,26,18,74,34,0,0,2023-2024,90.0,60.0,186.66666666666669
271,Lucas Beltrán,ARG,"FW,MF",Fiorentina,Serie A,22,2001,18.8,27,14,4,18,5,11,20,55.0,9,29,3,26,2,29,11,0,0,2023-2024,90.0,9.574468085106382,129.25531914893617
272,Eliesse Ben Seghir,MAR,"MF,FW",Monaco,Ligue 1,18,2005,4.8,9,6,2,5,2,3,7,42.9,4,6,0,6,2,11,2,0,0,2023-2024,90.0,37.5,168.75
273,Anis Ben Slimane,TUN,MF,Sheffield Utd,Premier League,22,2001,4.7,11,6,5,2,4,4,10,40.0,6,7,1,6,5,16,7,0,0,2023-2024,90.0,95.74468085106382,210.63829787234042
274,Wissam Ben Yedder,FRA,FW,Monaco,Ligue 1,32,1990,25.7,4,3,1,2,1,1,11,9.1,10,18,0,18,8,12,1,0,0,2023-2024,90.0,28.01556420233463,14.007782101167315
275,Carlos Benavídez,URU,MF,Alavés,La Liga,25,1998,12.6,56,35,19,26,11,19,34,55.9,15,13,5,8,19,75,31,0,0,2023-2024,90.0,135.71428571428572,400.00000000000006
Rk,Player,Nation,Pos,Squad,Comp,0,0,90.0,0,0,3,3,3,Tkl,0,0.0,0,0,0,0,0,0,0,0,0,2023-2024,90.0,0.0,0.0
276,Ismaël Bennacer,ALG,MF,Milan,Serie A,25,1997,12.8,29,19,11,16,2,11,22,50.0,11,12,4,8,12,41,9,2,0,2023-2024,90.0,84.375,203.90625
277,Saïd Benrahma,ALG,"FW,MF",West Ham,Premier League,27,1995,6.9,8,4,5,3,0,4,15,26.7,11,8,0,8,5,13,7,0,0,2023-2024,90.0,65.21739130434781,104.34782608695652
278,Saïd Benrahma,ALG,"FW,MF",Lyon,Ligue 1,27,1995,8.6,9,7,1,6,2,5,7,71.4,2,7,0,7,1,10,3,0,0,2023-2024,90.0,10.465116279069768,94.18604651162792
279,Ramy Bensebaini,ALG,DF,Dortmund,Bundesliga,28,1995,11.5,34,21,21,11,2,24,34,70.6,10,22,7,15,16,50,37,0,0,2023-2024,90.0,125.21739130434784,266.0869565217391
280,Nabil Bentaleb,ALG,MF,Lille,Ligue 1,28,1994,21.9,49,32,29,18,2,22,43,51.2,21,33,12,21,37,86,33,0,0,2023-2024,90.0,152.05479452054794,201.36986301369865
281,Rodrigo Bentancur,URU,MF,Tottenham,Premier League,26,1997,11.2,23,15,10,11,2,10,24,41.7,14,15,4,11,17,40,16,1,0,2023-2024,90.0,136.60714285714286,184.82142857142858
282,Daniel Bentley,ENG,GK,Wolves,Premier League,30,1993,4.3,0,0,0,0,0,0,1,0.0,1,0,0,0,0,0,1,0,0,2023-2024,90.0,0.0,0.0
283,Lucas Beraldo,BRA,DF,Paris S-G,Ligue 1,19,2003,11.2,22,14,14,8,0,10,25,40.0,15,15,6,9,20,42,25,0,0,2023-2024,90.0,160.71428571428572,176.78571428571428
284,Domenico Berardi,ITA,FW,Sassuolo,Serie A,28,1994,15.9,17,8,7,9,1,2,21,9.5,19,17,0,17,13,30,9,0,0,2023-2024,90.0,73.58490566037736,96.22641509433963
285,Yuri Berchiche,ESP,DF,Athletic Club,La Liga,33,1990,21.4,33,25,13,14,6,19,33,57.6,14,28,9,19,20,53,62,0,0,2023-2024,90.0,84.11214953271029,138.78504672897196
286,Álex Berenguer,ESP,FW,Athletic Club,La Liga,28,1995,17.7,23,14,9,9,5,7,24,29.2,17,23,0,23,5,28,13,0,0,2023-2024,90.0,25.423728813559322,116.94915254237289
287,Bartosz Bereszyński,POL,DF,Empoli,Serie A,31,1992,19.6,41,25,25,13,3,24,40,60.0,16,22,10,12,21,62,52,0,0,2023-2024,90.0,96.42857142857142,188.26530612244898
288,Jóhann Berg Guðmundsson,ISL,"MF,FW",Burnley,Premier League,32,1990,13.2,13,4,6,5,2,7,16,43.8,9,14,0,14,16,29,16,0,0,2023-2024,90.0,109.0909090909091,88.63636363636364
289,Sander Berge,NOR,MF,Burnley,Premier League,25,1998,33.4,76,46,35,36,5,34,58,58.6,24,49,20,29,23,99,60,2,0,2023-2024,90.0,61.97604790419162,204.79041916167665
290,Etrit Berisha,ALB,GK,Empoli,Serie A,34,1989,14.0,0,0,0,0,0,0,1,0.0,1,0,0,0,0,0,7,1,0,2023-2024,90.0,0.0,0.0
291,Medon Berisha,ALB,"FW,MF",Lecce,Serie A,19,2003,2.3,3,1,3,0,0,0,2,0.0,2,2,2,0,1,4,0,0,0,2023-2024,90.0,39.130434782608695,117.3913043478261
292,Mergim Berisha,GER,FW,Hoffenheim,Bundesliga,25,1998,1.6,0,0,0,0,0,0,0,0.0,0,2,1,1,0,0,0,0,0,2023-2024,90.0,0.0,0.0
293,Mergim Berisha,GER,FW,Augsburg,Bundesliga,25,1998,1.4,0,0,0,0,0,0,0,0.0,0,1,0,1,0,0,3,0,0,2023-2024,90.0,0.0,0.0
294,Bernardo,BRA,DF,Bochum,Bundesliga,28,1995,32.5,99,58,56,35,8,45,69,65.2,24,66,30,36,55,154,120,1,0,2023-2024,90.0,152.30769230769232,274.15384615384613
295,Victor Bernth Kristiansen,DEN,DF,Bologna,Serie A,20,2002,25.6,52,34,23,22,7,20,35,57.1,15,35,8,27,12,64,45,1,0,2023-2024,90.0,42.1875,182.8125
296,Matúš Bero,SVK,"MF,FW",Bochum,Bundesliga,27,1995,18.5,32,22,13,12,7,13,32,40.6,19,24,3,21,12,44,26,0,0,2023-2024,90.0,58.37837837837838,155.67567567567568
297,Luke Berry,ENG,"MF,DF",Luton Town,Premier League,31,1992,3.6,7,2,2,4,1,2,3,66.7,1,6,1,5,0,7,3,0,0,2023-2024,90.0,0.0,175.0
298,Dimitry Bertaud,COD,GK,Montpellier,Ligue 1,25,1998,4.0,0,0,0,0,0,0,0,0.0,0,0,0,0,0,0,0,0,0,2023-2024,90.0,0.0,0.0
299,Jan-Niklas Beste,GER,"FW,MF",Heidenheim,Bundesliga,24,1999,28.9,77,49,35,24,18,28,55,50.9,27,48,1,47,18,95,31,0,0,2023-2024,90.00000000000001,56.05536332179931,239.79238754325263
300,Beto,GNB,FW,Everton,Premier League,25,1998,10.6,14,6,1,6,7,4,12,33.3,8,11,0,11,1,15,14,0,0,2023-2024,90.0,8.49056603773585,118.8679245283019
Rk,Player,Nation,Pos,Squad,Comp,0,0,90.0,0,0,3,3,3,Tkl,0,0.0,0,0,0,0,0,0,0,0,0,2023-2024,90.0,0.0,0.0
301,Beto,GNB,FW,Udinese,Serie A,25,1998,0.8,1,0,0,0,1,0,0,0.0,0,0,0,0,0,1,0,0,0,2023-2024,90.0,0.0,112.5
302,Davide Bettella,ITA,MF,Monza,Serie A,23,2000,0.0,0,0,0,0,0,0,0,0.0,0,0,0,0,0,0,0,0,0,2023-2024,,,
303,Sam Beukema,NED,DF,Bologna,Serie A,24,1998,28.3,27,11,14,11,2,16,25,64.0,9,35,21,14,15,42,99,2,0,2023-2024,90.0,47.70318021201413,85.86572438162544
304,Jordan Beyer,GER,DF,Burnley,Premier League,23,2000,13.7,35,20,22,12,1,14,24,58.3,10,22,15,7,16,51,68,1,0,2023-2024,90.0,105.1094890510949,229.9270072992701
305,Pep Biel,ESP,"MF,FW",Augsburg,Bundesliga,26,1996,3.2,4,3,0,2,2,1,3,33.3,2,2,1,1,2,6,2,0,0,2023-2024,90.0,56.25,112.5
306,Jaka Bijol,SVN,DF,Udinese,Serie A,24,1999,23.2,43,27,34,9,0,22,35,62.9,13,36,21,15,23,66,140,1,0,2023-2024,90.0,89.22413793103449,166.81034482758622
307,El Bilal Touré,MLI,FW,Atalanta,Serie A,21,2001,4.4,1,1,0,1,0,0,1,0.0,1,0,0,0,1,2,2,0,0,2023-2024,90.0,20.454545454545453,20.454545454545453
308,Philip Billing,DEN,MF,Bournemouth,Premier League,27,1996,15.5,33,16,7,22,4,9,27,33.3,18,31,5,26,20,53,28,1,0,2023-2024,90.0,116.12903225806451,191.61290322580646
309,Cristiano Biraghi,ITA,DF,Fiorentina,Serie A,30,1992,26.2,47,28,20,24,3,28,52,53.8,24,30,5,25,14,61,43,0,0,2023-2024,90.0,48.091603053435115,161.45038167938932
310,Davide Biraschi,ITA,DF,Genoa,Serie A,29,1994,1.0,3,3,1,2,0,1,3,33.3,2,0,0,0,2,5,5,0,0,2023-2024,90.0,180.0,270.0
311,Samuele Birindelli,ITA,DF,Monza,Serie A,24,1999,22.4,28,19,16,7,5,14,25,56.0,11,30,11,19,18,46,48,0,0,2023-2024,90.0,72.32142857142857,112.5
312,Tom Bischof,GER,"MF,FW",Hoffenheim,Bundesliga,18,2005,2.0,8,4,6,1,1,2,9,22.2,7,3,0,3,1,9,2,0,0,2023-2024,90.0,45.0,360.0
313,Yves Bissouma,MLI,MF,Tottenham,Premier League,26,1996,23.0,80,52,32,36,12,41,61,67.2,20,28,5,23,37,117,43,3,0,2023-2024,90.0,144.7826086956522,313.04347826086956
314,Leonardo Bittencourt,GER,MF,Werder Bremen,Bundesliga,29,1993,17.5,42,18,20,17,5,15,39,38.5,24,18,1,17,13,55,6,0,0,2023-2024,90.0,66.85714285714286,216.0
315,Marco Bizot,NED,GK,Brest,Ligue 1,32,1991,32.0,0,0,0,0,0,0,1,0.0,1,0,0,0,0,0,18,3,0,2023-2024,90.0,0.0,0.0
316,Antonio Blanco,ESP,MF,Alavés,La Liga,23,2000,27.0,61,36,29,27,5,31,86,36.0,55,25,2,23,35,96,30,0,0,2023-2024,90.0,116.66666666666667,203.33333333333334
317,Rubén Blanco,ESP,GK,Marseille,Ligue 1,28,1995,1.3,0,0,0,0,0,0,0,0.0,0,0,0,0,0,0,0,0,0,2023-2024,90.0,0.0,0.0
318,Hendry Blank,GER,DF,Dortmund,Bundesliga,18,2004,0.5,1,0,1,0,0,1,1,100.0,0,1,0,1,0,1,4,0,0,2023-2024,90.0,0.0,180.0
319,Ludovic Blas,FRA,"FW,MF",Rennes,Ligue 1,25,1997,17.4,30,14,16,13,1,12,28,42.9,16,13,1,12,6,36,9,0,0,2023-2024,90.0,31.03448275862069,155.17241379310346
320,Janis Blaswich,GER,GK,RB Leipzig,Bundesliga,32,1991,21.0,1,1,1,0,0,0,0,0.0,0,0,0,0,0,1,7,3,0,2023-2024,90.0,0.0,4.285714285714286
321,Alexis Blin,FRA,MF,Lecce,Serie A,26,1996,18.2,33,19,11,19,3,15,43,34.9,28,16,2,14,22,55,39,0,0,2023-2024,90.0,108.79120879120879,163.1868131868132
322,Daley Blind,NED,DF,Girona,La Liga,33,1990,33.0,47,21,33,13,1,29,47,61.7,18,37,19,18,21,68,113,0,0,2023-2024,90.0,57.27272727272727,128.1818181818182
323,Myron Boadu,NED,FW,Monaco,Ligue 1,22,2001,0.9,2,2,0,1,1,1,2,50.0,1,2,0,2,0,2,0,0,0,2023-2024,90.0,0.0,200.0
324,Benicio Boaitey,ENG,"FW,DF",Brighton,Premier League,19,2004,0.4,0,0,0,0,0,0,1,0.0,1,1,0,1,0,0,2,0,0,2023-2024,90.0,0.0,0.0
325,Jérôme Boateng,GER,DF,Salernitana,Serie A,34,1988,2.6,0,0,0,0,0,0,0,0.0,0,6,5,1,4,4,21,0,0,2023-2024,90.0,138.46153846153845,0.0
Rk,Player,Nation,Pos,Squad,Comp,0,0,90.0,0,0,3,3,3,Tkl,0,0.0,0,0,0,0,0,0,0,0,0,2023-2024,90.0,0.0,0.0
326,Oscar Bobb,NOR,"FW,MF",Manchester City,Premier League,20,2003,3.4,7,3,1,2,4,2,4,50.0,2,4,0,4,5,12,1,0,0,2023-2024,90.0,132.35294117647058,185.2941176470588
327,Sacha Boey,FRA,DF,Bayern Munich,Bundesliga,22,2000,1.2,2,0,2,0,0,1,2,50.0,1,1,0,1,1,3,2,0,0,2023-2024,90.0,75.0,150.0
328,Jeremie Boga,CIV,FW,Nice,Ligue 1,26,1997,22.2,18,7,6,10,2,10,20,50.0,10,26,2,24,8,26,4,0,0,2023-2024,90.0,32.432432432432435,72.97297297297298
329,Jayden Bogle,ENG,DF,Sheffield Utd,Premier League,23,2000,31.0,66,36,43,21,2,35,70,50.0,35,42,11,31,32,98,97,0,0,2023-2024,90.0,92.90322580645162,191.61290322580646
330,Emil Bohinen,NOR,MF,Genoa,Serie A,24,1999,0.6,1,1,0,1,0,0,0,0.0,0,1,0,1,0,1,3,0,0,2023-2024,90.0,0.0,150.0
331,Emil Bohinen,NOR,MF,Salernitana,Serie A,24,1999,5.9,8,6,5,3,0,2,10,20.0,8,8,2,6,14,22,6,1,0,2023-2024,90.0,213.5593220338983,122.03389830508473
332,Adama Bojang,GAM,FW,Reims,Ligue 1,19,2004,0.9,2,1,1,0,1,0,0,0.0,0,2,1,1,1,3,0,0,0,2023-2024,90.0,100.0,200.0
333,Daniel Boloca,ROU,MF,Sassuolo,Serie A,24,1998,22.5,48,33,18,25,5,27,46,58.7,19,23,13,10,14,62,33,2,0,2023-2024,90.0,56.0,192.0
334,Willy Boly,CIV,DF,Nott'ham Forest,Premier League,32,1991,16.0,46,29,36,9,1,22,40,55.0,18,32,21,11,25,71,90,0,0,2023-2024,90.0,140.625,258.75
335,Giacomo Bonaventura,ITA,MF,Fiorentina,Serie A,33,1989,25.3,26,13,6,10,10,9,21,42.9,12,16,1,15,14,40,10,0,0,2023-2024,89.99999999999999,49.80237154150197,92.4901185770751
336,Federico Bonazzoli,ITA,"FW,MF",Hellas Verona,Serie A,26,1997,11.3,4,1,1,3,0,1,8,12.5,7,9,1,8,3,7,3,0,0,2023-2024,90.0,23.893805309734514,31.858407079646017
337,Warren Bondo,FRA,MF,Monza,Serie A,19,2003,16.4,29,22,16,10,3,13,17,76.5,4,13,3,10,6,35,13,0,0,2023-2024,90.0,32.926829268292686,159.14634146341464
338,Giovanni Bonfanti,ITA,DF,Atalanta,Serie A,20,2003,1.0,4,2,2,2,0,2,3,66.7,1,1,1,0,1,5,1,0,0,2023-2024,90.0,90.0,360.0
339,Victor Boniface,NGA,FW,Leverkusen,Bundesliga,22,2000,17.2,6,4,0,1,5,1,4,25.0,3,6,1,5,0,6,13,0,0,2023-2024,90.0,0.0,31.395348837209305
340,Kevin Bonifazi,ITA,DF,Bologna,Serie A,27,1996,1.0,4,0,0,4,0,1,2,50.0,1,0,0,0,0,4,7,1,0,2023-2024,90.0,0.0,360.0
341,Kevin Bonifazi,ITA,DF,Frosinone,Serie A,27,1996,3.4,5,3,2,3,0,2,3,66.7,1,1,0,1,3,8,9,0,0,2023-2024,90.0,79.41176470588235,132.35294117647058
342,Leonardo Bonucci,ITA,DF,Union Berlin,Bundesliga,36,1987,5.1,6,5,2,4,0,4,4,100.0,0,5,3,2,7,13,16,0,0,2023-2024,90.0,123.52941176470588,105.88235294117648
343,Ângelo Borges,BRA,"FW,MF",Strasbourg,Ligue 1,18,2004,12.2,24,11,9,7,8,11,31,35.5,20,18,0,18,9,33,2,0,0,2023-2024,90.0,66.39344262295083,177.04918032786887
344,Neto Borges,BRA,DF,Clermont Foot,Ligue 1,26,1996,28.0,48,24,25,18,5,28,63,44.4,35,28,6,22,57,105,84,0,0,2023-2024,90.0,183.21428571428572,154.28571428571428
345,Yvandro Borges Sanches,LUX,"MF,FW",Gladbach,Bundesliga,19,2004,0.2,0,0,0,0,0,0,0,0.0,0,0,0,0,0,0,0,0,0,2023-2024,90.0,0.0,0.0
346,Sebastiaan Bornauw,BEL,DF,Wolfsburg,Bundesliga,24,1999,15.9,26,12,19,7,0,13,19,68.4,6,21,12,9,18,44,81,0,0,2023-2024,90.0,101.88679245283019,147.16981132075472
347,Rafael Borré,COL,FW,Werder Bremen,Bundesliga,27,1995,11.0,10,7,2,4,4,5,16,31.3,11,8,2,6,2,12,10,0,0,2023-2024,90.0,16.363636363636363,81.81818181818183
348,Gennaro Borrelli,ITA,FW,Frosinone,Serie A,23,2000,0.3,0,0,0,0,0,0,0,0.0,0,0,0,0,0,0,0,0,0,2023-2024,90.0,0.0,0.0
349,Adri Bosch,ESP,DF,Granada,La Liga,22,2001,0.3,1,1,1,0,0,0,0,0.0,0,0,0,0,0,1,1,0,0,2023-2024,90.0,0.0,300.0
350,Erik Botheim,NOR,"FW,MF",Salernitana,Serie A,23,2000,3.5,2,0,2,0,0,0,1,0.0,1,3,0,3,0,2,2,0,0,2023-2024,90.0,0.0,51.42857142857143
Rk,Player,Nation,Pos,Squad,Comp,0,0,90.0,0,0,3,3,3,Tkl,0,0.0,0,0,0,0,0,0,0,0,0,2023-2024,90.0,0.0,0.0
351,Sven Botman,NED,DF,Newcastle Utd,Premier League,23,2000,15.3,20,13,14,6,0,8,13,61.5,5,20,16,4,9,29,61,3,0,2023-2024,90.0,52.94117647058823,117.6470588235294
352,Saïmon Bouabré,FRA,MF,Monaco,Ligue 1,17,2006,0.5,2,2,0,2,0,1,2,50.0,1,1,0,1,0,2,0,0,0,2023-2024,90.0,0.0,360.0
353,Ayyoub Bouaddi,FRA,MF,Lille,Ligue 1,15,2007,1.5,6,2,6,0,0,2,5,40.0,3,2,0,2,1,7,3,0,0,2023-2024,90.0,60.0,360.0
354,Badredine Bouanani,ALG,FW,Nice,Ligue 1,18,2004,1.8,3,2,1,1,1,3,4,75.0,1,5,0,5,3,6,0,0,0,2023-2024,90.0,150.0,150.0
355,Badredine Bouanani,ALG,MF,Lorient,Ligue 1,18,2004,4.9,4,2,1,1,2,2,4,50.0,2,3,0,3,2,6,3,0,0,2023-2024,90.0,36.73469387755102,73.46938775510203
356,Mohamed Bouchenna,FRA,"MF,FW",Clermont Foot,Ligue 1,17,2006,0.3,1,0,1,0,0,0,0,0.0,0,0,0,0,0,1,0,0,0,2023-2024,90.0,0.0,300.0
357,Hicham Boudaoui,ALG,MF,Nice,Ligue 1,23,1999,17.9,41,19,16,22,3,21,30,70.0,9,15,1,14,11,52,15,0,0,2023-2024,90.0,55.30726256983241,206.14525139664806
358,Yassine Bounou,MAR,GK,Sevilla,La Liga,32,1991,1.0,0,0,0,0,0,0,0,0.0,0,0,0,0,0,0,0,0,0,2023-2024,90.0,0.0,0.0
359,Mehdi Bourabia,MAR,MF,Frosinone,Serie A,31,1991,2.2,5,4,1,4,0,2,4,50.0,2,3,0,3,0,5,4,0,0,2023-2024,90.0,0.0,204.54545454545453
360,Benjamin Bourigeaud,FRA,"MF,FW",Rennes,Ligue 1,29,1994,26.9,31,18,14,9,8,13,44,29.5,31,31,2,29,22,53,39,2,0,2023-2024,90.0,73.60594795539033,103.71747211895911
361,Bilal Boutobba,FRA,"FW,MF",Clermont Foot,Ligue 1,24,1998,10.3,22,12,6,10,6,10,23,43.5,13,9,0,9,8,30,3,0,0,2023-2024,90.0,69.90291262135922,192.23300970873785
362,Hugo Boutsingkham,FRA,"MF,FW",Nantes,Ligue 1,20,2003,0.1,0,0,0,0,0,0,0,0.0,0,0,0,0,0,0,1,0,0,2023-2024,90.0,0.0,0.0
363,Edoardo Bove,ITA,MF,Roma,Serie A,21,2002,19.8,60,31,16,31,13,27,46,58.7,19,21,1,20,11,71,11,1,0,2023-2024,90.0,50.0,272.72727272727275
364,Jarrod Bowen,ENG,FW,West Ham,Premier League,26,1996,33.5,42,28,14,14,14,13,35,37.1,22,37,5,32,19,61,14,0,0,2023-2024,90.0,51.04477611940298,112.83582089552239
365,Lucas Boyé,ARG,FW,Granada,La Liga,27,1996,28.2,50,25,14,25,11,14,34,41.2,20,35,5,30,10,60,46,0,0,2023-2024,89.99999999999999,31.914893617021274,159.57446808510636
366,Domagoj Bradarić,CRO,DF,Salernitana,Serie A,23,1999,30.5,29,20,13,10,6,15,25,60.0,10,22,7,15,32,61,62,1,0,2023-2024,90.0,94.42622950819671,85.57377049180327
367,Conor Bradley,NIR,DF,Liverpool,Premier League,20,2003,8.4,33,25,14,12,7,24,38,63.2,14,17,1,16,10,43,14,0,0,2023-2024,90.0,107.14285714285714,353.57142857142856
368,Bilal Brahimi,ALG,FW,Nice,Ligue 1,23,2000,0.1,0,0,0,0,0,0,1,0.0,1,0,0,0,0,0,0,0,0,2023-2024,90.0,0.0,0.0
369,Bilal Brahimi,ALG,"FW,MF",Brest,Ligue 1,23,2000,2.5,0,0,0,0,0,0,3,0.0,3,3,0,3,0,0,0,0,0,2023-2024,90.0,0.0,0.0
370,Julian Brandt,GER,"MF,FW",Dortmund,Bundesliga,27,1996,24.7,17,14,8,8,1,10,27,37.0,17,20,3,17,8,25,18,0,0,2023-2024,90.0,29.149797570850204,61.94331983805668
371,Jarrad Branthwaite,ENG,DF,Everton,Premier League,21,2002,34.6,66,32,42,22,2,45,62,72.6,17,51,36,15,50,116,163,2,0,2023-2024,90.0,130.05780346820808,171.67630057803467
372,Darko Brašanac,SRB,MF,Osasuna,La Liga,31,1992,0.5,1,0,1,0,0,1,1,100.0,0,1,0,1,0,1,0,0,0,2023-2024,90.0,0.0,180.0
373,Lilian Brassier,FRA,DF,Brest,Ligue 1,23,1999,29.7,31,18,18,13,0,12,24,50.0,12,28,21,7,41,72,93,0,0,2023-2024,90.0,124.24242424242424,93.93939393939394
374,Brau,ESP,DF,Granada,La Liga,21,2001,0.3,1,0,1,0,0,1,1,100.0,0,0,0,0,0,1,2,0,0,2023-2024,90.0,0.0,300.0
375,Claudio Bravo,CHI,GK,Betis,La Liga,40,1983,7.0,0,0,0,0,0,0,1,0.0,1,0,0,0,0,0,2,0,0,2023-2024,90.0,0.0,0.0
Rk,Player,Nation,Pos,Squad,Comp,0,0,90.0,0,0,3,3,3,Tkl,0,0.0,0,0,0,0,0,0,0,0,0,2023-2024,90.0,0.0,0.0
376,Fabian Bredlow,GER,GK,Stuttgart,Bundesliga,28,1995,4.0,0,0,0,0,0,0,1,0.0,1,0,0,0,0,0,3,0,0,2023-2024,90.0,0.0,0.0
377,Tim Breithaupt,GER,MF,Augsburg,Bundesliga,21,2002,7.0,20,11,11,9,0,13,21,61.9,8,15,3,12,8,28,10,0,0,2023-2024,90.0,102.85714285714286,257.1428571428571
378,Josip Brekalo,CRO,FW,Fiorentina,Serie A,25,1998,7.2,8,6,6,2,0,2,11,18.2,9,7,0,7,1,9,0,0,0,2023-2024,90.0,12.5,100.0
379,Gleison Bremer,BRA,DF,Juventus,Serie A,26,1997,35.9,58,42,32,21,5,21,29,72.4,8,45,27,18,40,98,147,0,0,2023-2024,90.0,100.27855153203343,145.40389972144848
380,Brenner,BRA,"MF,FW",Udinese,Serie A,23,2000,2.1,8,7,1,5,2,4,7,57.1,3,2,0,2,0,8,2,0,0,2023-2024,90.0,0.0,342.85714285714283
381,Ben Brereton,CHI,"FW,MF",Sheffield Utd,Premier League,24,1999,12.3,9,4,4,4,1,4,10,40.0,6,9,3,6,3,12,12,0,0,2023-2024,89.99999999999999,21.95121951219512,65.85365853658536
382,Ben Brereton,CHI,"FW,MF",Villarreal,La Liga,24,1999,3.0,2,2,1,0,1,0,2,0.0,2,0,0,0,0,2,0,0,0,2023-2024,90.0,0.0,60.0
383,Marco Brescianini,ITA,MF,Frosinone,Serie A,23,2000,25.8,28,13,13,12,3,9,25,36.0,16,22,5,17,10,38,37,0,0,2023-2024,90.0,34.883720930232556,97.67441860465115
384,Maximilian Breunig,GER,FW,Freiburg,Bundesliga,22,2000,0.1,0,0,0,0,0,0,0,0.0,0,1,0,1,0,0,0,0,0,2023-2024,90.0,0.0,0.0
385,Rhian Brewster,ENG,"FW,MF",Sheffield Utd,Premier League,23,2000,3.8,5,1,1,2,2,0,2,0.0,2,2,0,2,1,6,2,0,0,2023-2024,90.0,23.684210526315788,118.42105263157895
386,Bennit Bröger,GER,FW,Wolfsburg,Bundesliga,17,2006,0.1,0,0,0,0,0,0,0,0.0,0,0,0,0,0,0,0,0,0,2023-2024,90.0,0.0,0.0
387,Armando Broja,ALB,FW,Chelsea,Premier League,21,2001,5.0,3,0,0,1,2,1,2,50.0,1,5,1,4,0,3,3,0,0,2023-2024,90.0,0.0,54.0
388,Armando Broja,ALB,FW,Fulham,Premier League,21,2001,1.0,0,0,0,0,0,0,0,0.0,0,1,0,1,0,0,0,0,0,2023-2024,90.0,0.0,0.0
389,Dylan Bronn,TUN,"DF,MF",Salernitana,Serie A,28,1995,0.6,0,0,0,0,0,0,1,0.0,1,2,0,2,0,0,4,0,0,2023-2024,90.0,0.0,0.0
390,Andre Brooks,ENG,"MF,DF",Sheffield Utd,Premier League,19,2003,10.4,22,13,7,11,4,9,21,42.9,12,13,1,12,14,36,20,0,0,2023-2024,90.0,121.15384615384615,190.38461538461536
391,David Brooks,WAL,"FW,MF",Bournemouth,Premier League,26,1997,3.1,5,4,2,1,2,2,4,50.0,2,3,0,3,2,7,2,0,0,2023-2024,90.0,58.064516129032256,145.16129032258064
392,John Brooks,USA,DF,Hoffenheim,Bundesliga,30,1993,17.1,28,15,17,10,1,15,30,50.0,15,29,17,12,27,55,109,1,0,2023-2024,90.0,142.10526315789474,147.3684210526316
393,Moritz Broschinski,GER,FW,Bochum,Bundesliga,22,2000,13.9,11,7,2,5,4,2,8,25.0,6,11,2,9,0,11,6,0,0,2023-2024,90.0,0.0,71.22302158273382
394,Jacob Brown,SCO,"MF,FW",Luton Town,Premier League,25,1998,11.3,19,12,7,7,5,7,18,38.9,11,20,1,19,8,27,22,0,0,2023-2024,90.0,63.716814159292035,151.32743362831857
395,Josh Brownhill,ENG,MF,Burnley,Premier League,27,1995,25.0,61,35,23,28,10,27,37,73.0,10,33,8,25,34,95,40,1,0,2023-2024,90.0,122.39999999999999,219.6
396,Alexander Brunst,GER,GK,Darmstadt 98,Bundesliga,28,1995,3.0,0,0,0,0,0,0,2,0.0,2,0,0,0,0,0,2,1,0,2023-2024,90.0,0.0,0.0
397,Jacob Bruun Larsen,DEN,"MF,FW",Burnley,Premier League,24,1998,13.9,9,4,4,3,2,7,21,33.3,14,16,2,14,7,16,23,0,0,2023-2024,90.0,45.32374100719424,58.27338129496403
398,Tajon Buchanan,CAN,DF,Inter,Serie A,24,1999,1.8,1,1,0,0,1,1,2,50.0,1,1,0,1,0,1,4,0,0,2023-2024,90.0,0.0,50.0
399,Ante Budimir,CRO,FW,Osasuna,La Liga,32,1991,27.1,21,15,2,11,8,5,14,35.7,9,19,5,14,5,26,18,0,0,2023-2024,90.0,16.605166051660518,69.74169741697418
400,Hugo Bueno,ESP,"DF,MF",Wolves,Premier League,20,2002,8.2,21,14,12,7,2,12,19,63.2,7,17,4,13,6,27,24,0,0,2023-2024,90.0,65.85365853658537,230.48780487804882
Rk,Player,Nation,Pos,Squad,Comp,0,0,90.0,0,0,3,3,3,Tkl,0,0.0,0,0,0,0,0,0,0,0,0,2023-2024,90.0,0.0,0.0
401,Manu Bueno,ESP,MF,Sevilla,La Liga,19,2004,1.3,4,2,4,0,0,3,3,100.0,0,3,0,3,0,4,1,0,0,2023-2024,90.0,0.0,276.9230769230769
402,Santiago Bueno,URU,DF,Wolves,Premier League,24,1998,9.1,13,7,5,7,1,5,11,45.5,6,22,12,10,6,19,33,0,0,2023-2024,90.0,59.34065934065934,128.57142857142858
403,Marius Bülter,GER,"DF,FW",Hoffenheim,Bundesliga,30,1993,15.0,18,11,9,5,4,12,23,52.2,11,17,3,14,10,28,20,0,0,2023-2024,90.0,60.0,108.0
404,Facundo Buonanotte,ARG,"FW,MF",Brighton,Premier League,18,2004,15.2,42,22,13,22,7,14,44,31.8,30,22,3,19,8,50,5,0,0,2023-2024,90.0,47.368421052631575,248.68421052631578
405,Alessandro Buongiorno,ITA,DF,Torino,Serie A,24,1999,28.1,70,39,43,24,3,24,34,70.6,10,20,12,8,69,139,131,0,0,2023-2024,90.0,220.99644128113877,224.19928825622776
406,Jonathan Burkardt,GER,"FW,MF",Mainz 05,Bundesliga,23,2000,17.1,12,8,2,6,4,4,11,36.4,7,16,3,13,3,15,2,0,0,2023-2024,90.0,15.789473684210526,63.1578947368421
407,Oliver Burke,SCO,FW,Werder Bremen,Bundesliga,26,1997,0.4,0,0,0,0,0,0,2,0.0,2,0,0,0,0,0,0,0,0,2023-2024,90.0,0.0,0.0
408,Reece Burke,ENG,DF,Luton Town,Premier League,26,1996,18.4,37,23,17,14,6,12,26,46.2,14,25,18,7,18,55,78,1,0,2023-2024,90.0,88.04347826086958,180.97826086956522
409,Dan Burn,ENG,DF,Newcastle Utd,Premier League,31,1992,30.3,61,33,37,20,4,26,61,42.6,35,55,25,30,37,98,124,1,0,2023-2024,90.0,109.9009900990099,181.1881188118812
410,Rareș-Cătălin Burnete,ROU,FW,Lecce,Serie A,19,2004,0.1,0,0,0,0,0,0,0,0.0,0,0,0,0,0,0,0,0,0,2023-2024,90.0,0.0,0.0
411,Mason Burstow,ENG,FW,Chelsea,Premier League,19,2003,0.1,0,0,0,0,0,0,0,0.0,0,0,0,0,0,0,0,0,0,2023-2024,90.0,0.0,0.0
412,Marnon Busch,GER,DF,Heidenheim,Bundesliga,28,1994,6.6,11,9,6,3,2,7,12,58.3,5,9,2,7,10,21,12,0,0,2023-2024,90.0,136.36363636363637,150.0
413,Maxime Busi,BEL,"FW,DF",Reims,Ligue 1,23,1999,1.8,2,0,0,1,1,0,2,0.0,2,6,1,5,4,6,5,0,0,2023-2024,90.0,200.0,100.0
414,Pablo Busto,ESP,DF,Betis,La Liga,17,2005,0.5,1,1,0,0,1,1,1,100.0,0,0,0,0,1,2,3,0,0,2023-2024,90.0,180.0,180.0
415,Aurélio Buta,POR,"DF,MF",Eint Frankfurt,Bundesliga,26,1997,19.4,40,25,19,16,5,21,38,55.3,17,24,5,19,15,55,36,0,0,2023-2024,90.0,69.5876288659794,185.56701030927837
416,Marcin Bułka,POL,GK,Nice,Ligue 1,23,1999,34.0,0,0,0,0,0,0,2,0.0,2,0,0,0,0,0,9,3,0,2023-2024,90.0,0.0,0.0
417,Rémy Cabella,FRA,"FW,MF",Lille,Ligue 1,33,1990,16.4,54,36,19,20,15,20,54,37.0,34,32,0,32,5,59,5,0,0,2023-2024,90.0,27.439024390243905,296.3414634146342
418,Jovane Cabral,CPV,"MF,FW",Salernitana,Serie A,25,1998,7.5,13,9,4,7,2,3,9,33.3,6,3,0,3,1,14,4,0,0,2023-2024,90.0,12.0,156.0
419,Liberato Cacace,NZL,DF,Empoli,Serie A,22,2000,21.2,40,24,24,13,3,24,38,63.2,14,23,6,17,19,59,56,0,0,2023-2024,90.0,80.66037735849056,169.811320754717
420,Anthony Caci,FRA,DF,Mainz 05,Bundesliga,26,1997,27.6,56,23,30,25,1,27,44,61.4,17,43,7,36,32,88,45,0,0,2023-2024,90.0,104.34782608695652,182.6086956521739
421,Moisés Caicedo,ECU,MF,Chelsea,Premier League,21,2001,31.8,91,46,38,42,11,36,60,60.0,24,59,25,34,37,128,44,4,0,2023-2024,90.0,104.71698113207547,257.54716981132077
422,Tom Cairney,SCO,MF,Fulham,Premier League,32,1991,16.5,24,16,10,12,2,13,25,52.0,12,16,4,12,13,37,6,0,0,2023-2024,90.0,70.90909090909092,130.9090909090909
423,Jens Cajuste,SWE,MF,Napoli,Serie A,23,1999,11.3,36,24,13,17,6,20,37,54.1,17,20,3,17,4,40,15,0,0,2023-2024,90.0,31.858407079646017,286.72566371681415
424,Davide Calabria,ITA,DF,Milan,Serie A,26,1996,24.3,70,38,38,25,7,44,72,61.1,28,26,7,19,24,94,49,1,0,2023-2024,90.0,88.88888888888889,259.25925925925924
425,Riccardo Calafiori,ITA,DF,Bologna,Serie A,21,2002,26.1,47,32,28,16,3,22,32,68.8,10,38,13,25,50,97,74,3,0,2023-2024,90.0,172.41379310344826,162.06896551724137
Rk,Player,Nation,Pos,Squad,Comp,0,0,90.0,0,0,3,3,3,Tkl,0,0.0,0,0,0,0,0,0,0,0,0,2023-2024,90.0,0.0,0.0
426,Mattia Caldara,ITA,DF,Milan,Serie A,29,1994,0.4,1,1,1,0,0,1,1,100.0,0,1,1,0,1,2,1,0,0,2023-2024,90.0,225.0,225.0
427,Luca Caldirola,ITA,DF,Monza,Serie A,32,1991,23.8,25,14,19,4,2,13,22,59.1,9,26,17,9,29,54,53,0,0,2023-2024,90.00000000000001,109.66386554621849,94.53781512605043
428,Duje Ćaleta-Car,CRO,DF,Lyon,Ligue 1,26,1996,22.1,26,11,19,6,1,18,22,81.8,4,27,14,13,18,44,94,1,0,2023-2024,90.0,73.30316742081448,105.88235294117646
429,Hakan Çalhanoğlu,TUR,MF,Inter,Serie A,29,1994,28.4,66,33,29,29,8,32,49,65.3,17,29,13,16,24,90,22,0,0,2023-2024,90.0,76.05633802816902,209.1549295774648
430,José Callejón,ESP,"MF,FW",Granada,La Liga,36,1987,8.9,13,6,10,3,0,8,22,36.4,14,7,1,6,5,18,10,0,0,2023-2024,90.0,50.56179775280899,131.46067415730337
431,Dominic Calvert-Lewin,ENG,FW,Everton,Premier League,26,1997,24.1,13,6,2,6,5,2,15,13.3,13,14,4,10,4,17,38,0,0,2023-2024,90.0,14.937759336099585,48.54771784232365
432,Lamine Camara,SEN,MF,Metz,Ligue 1,19,2004,25.1,62,42,26,30,6,24,49,49.0,25,35,2,33,28,90,34,0,0,2023-2024,90.0,100.39840637450199,222.31075697211153
433,Mahdi Camara,FRA,MF,Brest,Ligue 1,25,1998,22.4,55,39,8,40,7,20,49,40.8,29,24,1,23,27,82,19,0,0,2023-2024,90.0,108.48214285714286,220.98214285714286
434,Mohamed Camara,MLI,MF,Monaco,Ligue 1,23,2000,11.5,35,21,10,20,5,15,29,51.7,14,8,2,6,11,46,7,0,0,2023-2024,90.0,86.08695652173914,273.9130434782609
435,Francesco Camarda,ITA,FW,Milan,Serie A,15,2008,0.2,0,0,0,0,0,0,2,0.0,2,0,0,0,0,0,0,0,0,2023-2024,90.0,0.0,0.0
436,Eduardo Camavinga,FRA,"MF,DF",Real Madrid,La Liga,20,2002,20.2,76,47,39,29,8,23,39,59.0,16,36,8,28,29,105,29,1,0,2023-2024,90.0,129.2079207920792,338.61386138613864
437,Nicolò Cambiaghi,ITA,"FW,MF",Empoli,Serie A,22,2000,28.4,51,39,15,20,16,16,35,45.7,19,26,1,25,14,65,8,0,0,2023-2024,90.0,44.36619718309859,161.61971830985917
438,Andrea Cambiaso,ITA,"DF,FW",Juventus,Serie A,23,2000,26.4,47,30,23,15,9,25,43,58.1,18,28,3,25,11,58,26,1,0,2023-2024,90.0,37.5,160.22727272727272
439,Axel Camblan,FRA,FW,Brest,Ligue 1,19,2003,1.0,3,1,0,2,1,2,4,50.0,2,2,0,2,0,3,0,0,0,2023-2024,90.0,0.0,270.0
440,Sergio Camello,ESP,FW,Rayo Vallecano,La Liga,22,2001,18.5,16,5,3,10,3,6,15,40.0,9,10,2,8,3,19,15,0,0,2023-2024,90.0,14.594594594594595,77.83783783783784
441,José Campaña,ESP,MF,Las Palmas,La Liga,30,1993,1.9,2,2,1,1,0,0,2,0.0,2,3,2,1,2,4,3,0,0,2023-2024,90.0,94.73684210526315,94.73684210526315
442,Emre Can,GER,"MF,DF",Dortmund,Bundesliga,29,1994,21.7,63,45,37,23,3,28,48,58.3,20,30,7,23,22,85,41,2,0,2023-2024,90.0,91.24423963133641,261.2903225806452
443,Matteo Cancellieri,ITA,"FW,MF",Empoli,Serie A,21,2002,19.9,35,22,12,16,7,13,36,36.1,23,19,0,19,6,41,18,0,0,2023-2024,90.0,27.1356783919598,158.29145728643218
444,João Cancelo,POR,DF,Barcelona,La Liga,29,1994,27.8,64,44,35,21,8,38,58,65.5,20,35,6,29,29,93,59,1,0,2023-2024,90.0,93.88489208633094,207.19424460431657
445,Fali Candé,GNB,DF,Metz,Ligue 1,25,1998,20.5,40,19,31,9,0,20,35,57.1,15,41,28,13,20,60,107,1,0,2023-2024,90.0,87.8048780487805,175.609756097561
446,Antonio Candreva,ITA,"MF,FW",Salernitana,Serie A,36,1987,30.6,18,13,8,8,2,9,25,36.0,16,9,0,9,7,25,23,0,0,2023-2024,90.0,20.588235294117645,52.94117647058823
447,Thomas Cannon,IRL,FW,Everton,Premier League,20,2002,0.0,0,0,0,0,0,0,0,0.0,0,0,0,0,0,0,0,0,0,2023-2024,,,
448,Sergi Canós,ESP,"MF,FW",Valencia,La Liga,26,1997,13.7,23,13,7,11,5,10,24,41.7,14,14,2,12,11,34,9,0,0,2023-2024,90.0,72.26277372262774,151.09489051094891
449,Luigi Canotto,ITA,FW,Frosinone,Serie A,29,1994,0.2,0,0,0,0,0,0,0,0.0,0,0,0,0,0,0,0,0,0,2023-2024,90.0,0.0,0.0
450,Gino Caoki,FRA,MF,Lorient,Ligue 1,19,2004,0.1,0,0,0,0,0,0,1,0.0,1,0,0,0,0,0,0,0,0,2023-2024,90.0,0.0,0.0
Rk,Player,Nation,Pos,Squad,Comp,0,0,90.0,0,0,3,3,3,Tkl,0,0.0,0,0,0,0,0,0,0,0,0,2023-2024,90.0,0.0,0.0
451,Étienne Capoue,FRA,MF,Villarreal,La Liga,35,1988,16.2,32,18,17,12,3,15,22,68.2,7,20,4,16,22,54,24,1,0,2023-2024,90.0,122.22222222222223,177.77777777777777
452,Gianluca Caprari,ITA,"MF,FW",Monza,Serie A,30,1993,3.2,2,1,1,1,0,0,1,0.0,1,0,0,0,2,4,0,0,0,2023-2024,90.0,56.25,56.25
453,Elia Caprile,ITA,GK,Empoli,Serie A,21,2001,23.0,1,0,1,0,0,1,1,100.0,0,0,0,0,0,1,16,2,0,2023-2024,90.0,0.0,3.91304347826087
454,Francesco Caputo,ITA,FW,Empoli,Serie A,35,1987,14.1,2,0,0,0,2,0,1,0.0,1,4,0,4,1,3,3,0,0,2023-2024,89.99999999999999,6.382978723404255,12.76595744680851
455,Maxence Caqueret,FRA,MF,Lyon,Ligue 1,23,2000,33.6,91,64,39,37,15,38,107,35.5,69,40,9,31,48,139,26,2,0,2023-2024,90.0,128.57142857142856,243.75
456,Andrea Carboni,ITA,DF,Monza,Serie A,22,2001,16.5,38,22,24,12,2,20,31,64.5,11,23,13,10,17,55,56,1,0,2023-2024,90.0,92.72727272727273,207.27272727272728
457,Valentin Carboni,ARG,"MF,FW",Monza,Serie A,18,2005,13.0,25,15,10,12,3,8,26,30.8,18,12,1,11,7,32,4,0,0,2023-2024,90.00000000000001,48.46153846153847,173.0769230769231
458,Isaac Carcelen,ESP,DF,Cádiz,La Liga,30,1993,29.0,50,31,30,15,5,25,45,55.6,20,24,7,17,27,77,87,2,0,2023-2024,90.0,83.79310344827586,155.17241379310343
459,Cárdenas,ESP,GK,Rayo Vallecano,La Liga,26,1997,1.0,0,0,0,0,0,0,0,0.0,0,0,0,0,0,0,1,0,0,2023-2024,90.0,0.0,0.0
460,Irvin Cardona,FRA,"MF,DF",Augsburg,Bundesliga,25,1997,0.6,1,1,0,0,1,1,3,33.3,2,1,0,1,0,1,1,0,0,2023-2024,90.0,0.0,150.0
461,Marc Cardona,ESP,FW,Las Palmas,La Liga,28,1995,8.0,9,8,3,4,2,1,12,8.3,11,5,0,5,2,11,7,0,0,2023-2024,90.0,22.5,101.25
462,Sergi Cardona,ESP,DF,Las Palmas,La Liga,24,1999,31.3,90,55,52,29,9,55,96,57.3,41,45,7,38,46,136,102,0,0,2023-2024,90.0,132.26837060702874,258.7859424920128
463,Johnny Cardoso,USA,MF,Betis,La Liga,21,2001,14.8,48,29,19,24,5,22,33,66.7,11,20,5,15,32,80,31,0,0,2023-2024,90.0,194.59459459459458,291.8918918918919
464,Igor Carioca,BRA,"DF,MF",Lorient,Ligue 1,26,1996,2.9,8,6,6,1,1,4,6,66.7,2,0,0,0,3,11,6,0,0,2023-2024,90.0,93.10344827586206,248.27586206896552
465,Diego Carlos,BRA,DF,Aston Villa,Premier League,30,1993,20.2,27,16,22,4,1,13,21,61.9,8,24,19,5,13,40,78,3,0,2023-2024,90.0,57.92079207920792,120.29702970297029
466,Carmona,ESP,"DF,MF",Getafe,La Liga,21,2002,14.6,30,21,13,14,3,9,28,32.1,19,15,2,13,21,51,25,0,0,2023-2024,90.0,129.45205479452056,184.93150684931507
467,Marco Carnesecchi,ITA,GK,Atalanta,Serie A,23,2000,26.9,0,0,0,0,0,0,0,0.0,0,0,0,0,0,0,22,3,0,2023-2024,90.0,0.0,0.0
468,Yannick Carrasco,BEL,DF,Atlético Madrid,La Liga,29,1993,2.5,4,4,3,1,0,2,7,28.6,5,2,0,2,1,5,6,0,0,2023-2024,90.0,36.0,144.0
469,Álvaro Carreras,ESP,"MF,FW",Granada,La Liga,20,2003,5.3,13,8,8,4,1,5,11,45.5,6,5,1,4,7,20,9,1,0,2023-2024,90.0,118.8679245283019,220.75471698113208
470,Rasmus Carstensen,DEN,"DF,FW",Köln,Bundesliga,22,2000,18.4,47,22,23,20,4,31,56,55.4,25,38,9,29,20,67,50,2,0,2023-2024,90.0,97.82608695652175,229.8913043478261
471,Antonin Cartillier,FRA,DF,Monaco,Ligue 1,19,2004,0.1,0,0,0,0,0,0,0,0.0,0,1,0,1,0,0,0,0,0,2023-2024,90.0,0.0,0.0
472,Dani Carvajal,ESP,DF,Real Madrid,La Liga,31,1992,24.1,47,32,28,15,4,23,42,54.8,19,28,9,19,22,69,54,4,0,2023-2024,90.0,82.15767634854771,175.5186721991701
473,Fabio Carvalho,POR,MF,RB Leipzig,Bundesliga,20,2002,1.8,3,1,0,2,1,1,3,33.3,2,8,0,8,0,3,1,0,0,2023-2024,90.0,0.0,150.0
474,William Carvalho,POR,MF,Betis,La Liga,31,1992,7.6,20,12,11,7,2,10,16,62.5,6,8,1,7,8,28,9,1,0,2023-2024,90.0,94.73684210526315,236.8421052631579
475,Cesare Casadei,ITA,"FW,MF",Chelsea,Premier League,20,2003,0.9,5,3,2,1,2,2,5,40.0,3,1,0,1,0,5,4,0,0,2023-2024,90.0,0.0,500.0
Rk,Player,Nation,Pos,Squad,Comp,0,0,90.0,0,0,3,3,3,Tkl,0,0.0,0,0,0,0,0,0,0,0,0,2023-2024,90.0,0.0,0.0
476,Marc Casado,ESP,MF,Barcelona,La Liga,19,2003,0.2,1,1,1,0,0,1,1,100.0,0,0,0,0,1,2,2,0,0,2023-2024,90.0,450.0,450.0
477,Nicolò Casale,ITA,DF,Lazio,Serie A,25,1998,17.3,15,9,13,2,0,6,15,40.0,9,19,16,3,12,27,61,0,0,2023-2024,90.0,62.42774566473988,78.03468208092485
478,Casemiro,BRA,"MF,DF",Manchester Utd,Premier League,31,1992,22.0,83,56,43,32,8,51,106,48.1,55,74,33,41,18,101,71,1,0,2023-2024,90.0,73.63636363636364,339.54545454545456
479,Kaelan Casey,ENG,DF,West Ham,Premier League,18,2004,0.0,0,0,0,0,0,0,0,0.0,0,0,0,0,0,0,1,0,0,2023-2024,,,
480,Matty Cash,POL,DF,Aston Villa,Premier League,25,1997,23.8,54,31,24,24,6,29,59,49.2,30,35,14,21,18,72,59,0,0,2023-2024,90.00000000000001,68.0672268907563,204.20168067226894
481,Josué Casimir,FRA,"FW,DF",Le Havre,Ligue 1,21,2001,22.4,31,18,14,14,3,7,18,38.9,11,23,2,21,13,44,25,0,0,2023-2024,90.0,52.23214285714286,124.55357142857143
482,Giuseppe Caso,ITA,"FW,MF",Frosinone,Serie A,24,1998,4.6,4,3,2,0,2,2,3,66.7,1,0,0,0,0,4,0,0,0,2023-2024,90.0,0.0,78.26086956521739
483,Cristian Cásseres Jr.,VEN,MF,Toulouse,Ligue 1,23,2000,21.6,70,34,31,33,6,29,61,47.5,32,34,4,30,27,97,33,1,0,2023-2024,90.0,112.49999999999999,291.66666666666663
484,Timothy Castagne,BEL,DF,Fulham,Premier League,27,1995,29.3,49,24,23,16,10,26,44,59.1,18,38,10,28,38,87,69,1,0,2023-2024,90.0,116.72354948805462,150.51194539249147
485,Koen Casteels,BEL,GK,Wolfsburg,Bundesliga,31,1992,25.0,2,1,2,0,0,2,3,66.7,1,0,0,0,0,2,16,5,0,2023-2024,90.0,0.0,7.199999999999999
486,Valentín Castellanos,ARG,FW,Lazio,Serie A,24,1998,18.7,22,10,1,12,9,6,20,30.0,14,22,2,20,2,24,18,0,0,2023-2024,90.0,9.62566844919786,105.88235294117646
487,Jean-Charles Castelletto,CMR,DF,Nantes,Ligue 1,28,1995,27.4,34,26,22,10,2,18,29,62.1,11,19,10,9,32,66,81,0,0,2023-2024,90.0,105.1094890510949,111.67883211678833
488,Samu Castillejo,ESP,"FW,MF",Sassuolo,Serie A,28,1995,6.0,12,10,5,5,2,7,19,36.8,12,16,1,15,1,13,3,0,0,2023-2024,90.0,15.0,180.0
489,Jonny Castro,ESP,MF,Wolves,Premier League,29,1994,0.1,0,0,0,0,0,0,1,0.0,1,1,1,0,0,0,0,0,0,2023-2024,90.0,0.0,0.0
490,Santiago Castro,ARG,FW,Bologna,Serie A,18,2004,2.7,2,1,0,1,1,1,3,33.3,2,1,0,1,1,3,1,0,0,2023-2024,90.0,33.33333333333333,66.66666666666666
491,Gaetano Castrovilli,ITA,"FW,MF",Fiorentina,Serie A,26,1997,4.1,3,2,1,2,0,1,8,12.5,7,4,0,4,2,5,3,0,0,2023-2024,90.0,43.90243902439025,65.85365853658537
492,Danilo Cataldi,ITA,MF,Lazio,Serie A,28,1994,15.1,24,12,7,16,1,8,18,44.4,10,15,7,8,17,41,19,1,0,2023-2024,90.0,101.32450331125828,143.04635761589404
493,Catena,ESP,DF,Osasuna,La Liga,28,1994,28.2,33,18,26,6,1,19,35,54.3,16,24,15,9,15,48,119,3,0,2023-2024,89.99999999999999,47.87234042553191,105.31914893617021
494,Maximiliano Caufriez,BEL,DF,Clermont Foot,Ligue 1,26,1997,18.4,38,28,31,5,2,19,29,65.5,10,18,12,6,18,56,69,2,0,2023-2024,90.0,88.04347826086958,185.8695652173913
495,Ivan Cavaleiro,POR,FW,Lille,Ligue 1,29,1993,8.6,10,6,3,4,3,7,20,35.0,13,9,2,7,5,15,6,0,0,2023-2024,90.0,52.32558139534884,104.65116279069768
496,Dani Ceballos,ESP,"MF,FW",Real Madrid,La Liga,26,1996,6.6,10,5,4,5,1,5,14,35.7,9,9,2,7,0,10,4,1,0,2023-2024,90.0,0.0,136.36363636363637
497,Emil Ceide,NOR,"FW,MF",Sassuolo,Serie A,21,2001,2.0,2,2,1,1,0,1,1,100.0,0,6,1,5,0,2,0,0,0,2023-2024,90.0,0.0,90.0
498,Zeki Çelik,TUR,DF,Roma,Serie A,26,1997,7.5,23,16,10,10,3,14,25,56.0,11,12,5,7,8,31,25,0,0,2023-2024,90.0,96.0,276.0
499,Álex Centelles,ESP,DF,Almería,La Liga,25,1997,10.9,11,6,9,2,0,8,18,44.4,10,5,2,3,18,29,29,0,0,2023-2024,90.0,148.62385321100916,90.82568807339449
500,Fabien Centonze,FRA,DF,Hellas Verona,Serie A,27,1996,7.5,14,8,10,4,0,5,10,50.0,5,14,2,12,10,24,18,0,0,2023-2024,90.0,120.0,168.0
Rk,Player,Nation,Pos,Squad,Comp,0,0,90.0,0,0,3,3,3,Tkl,0,0.0,0,0,0,0,0,0,0,0,0,2023-2024,90.0,0.0,0.0
501,Fabien Centonze,FRA,DF,Nantes,Ligue 1,27,1996,1.0,2,1,2,0,0,2,3,66.7,1,2,1,1,0,2,1,0,0,2023-2024,90.0,0.0,180.0
502,Václav Černý,CZE,"FW,MF",Wolfsburg,Bundesliga,25,1997,10.2,8,3,3,4,1,2,14,14.3,12,13,0,13,8,16,6,0,0,2023-2024,90.0,70.58823529411765,70.58823529411765
503,Michele Cerofolini,ITA,GK,Frosinone,Serie A,24,1999,7.5,0,0,0,0,0,0,0,0.0,0,0,0,0,0,0,5,1,0,2023-2024,90.0,0.0,0.0
504,Alberto Cerri,ITA,FW,Empoli,Serie A,27,1996,6.1,3,3,1,1,1,2,5,40.0,3,3,1,2,3,6,7,0,0,2023-2024,90.0,44.26229508196722,44.26229508196722
505,Leonardo Cerri,ITA,DF,Juventus,Serie A,20,2003,0.1,0,0,0,0,0,0,0,0.0,0,0,0,0,0,0,0,0,0,2023-2024,90.0,0.0,0.0
506,Franco Cervi,ARG,"MF,DF",Celta Vigo,La Liga,29,1994,6.1,24,18,13,9,2,13,24,54.2,11,16,0,16,9,33,4,0,0,2023-2024,90.0,132.78688524590166,354.09836065573774
507,Julian Chabot,GER,DF,Köln,Bundesliga,25,1998,30.0,59,42,40,17,2,35,59,59.3,24,66,43,23,45,104,145,0,0,2023-2024,90.0,135.0,177.0
508,El Chadaille Bitshiabu,FRA,"DF,MF",RB Leipzig,Bundesliga,18,2005,0.4,1,0,1,0,0,0,0,0.0,0,0,0,0,1,2,4,0,0,2023-2024,90.0,225.0,225.0
509,Fares Chaïbi,ALG,"FW,MF",Toulouse,Ligue 1,20,2002,0.6,0,0,0,0,0,0,0,0.0,0,0,0,0,0,0,2,0,0,2023-2024,90.0,0.0,0.0
510,Fares Chaïbi,ALG,"MF,FW",Eint Frankfurt,Bundesliga,20,2002,21.2,27,17,7,12,8,8,18,44.4,10,37,1,36,5,32,19,0,0,2023-2024,90.0,21.226415094339625,114.62264150943396
511,Trevoh Chalobah,ENG,DF,Chelsea,Premier League,24,1999,10.6,16,12,10,2,4,10,15,66.7,5,8,7,1,8,24,51,0,0,2023-2024,90.0,67.9245283018868,135.8490566037736
512,Muhammed Cham,AUT,"MF,FW",Clermont Foot,Ligue 1,22,2000,28.4,25,14,10,13,2,11,27,40.7,16,20,2,18,8,33,5,1,0,2023-2024,90.0,25.35211267605634,79.22535211267606
513,Calum Chambers,ENG,"MF,DF",Aston Villa,Premier League,28,1995,1.7,3,0,3,0,0,0,1,0.0,1,2,1,1,2,5,4,0,0,2023-2024,90.0,105.88235294117646,158.8235294117647
514,Timothy Chandler,USA,"MF,DF",Eint Frankfurt,Bundesliga,33,1990,0.2,0,0,0,0,0,0,0,0.0,0,0,0,0,0,0,0,0,0,2023-2024,90.0,0.0,0.0
515,Brendan Chardonnet,FRA,DF,Brest,Ligue 1,28,1994,33.0,57,34,33,22,2,32,63,50.8,31,58,34,24,53,110,139,3,0,2023-2024,90.0,144.54545454545456,155.45454545454547
516,Charlys,BRA,MF,Hellas Verona,Serie A,19,2004,0.3,0,0,0,0,0,0,0,0.0,0,0,0,0,1,1,0,0,0,2023-2024,90.0,300.0,0.0
517,Pep Chavarría,ESP,"DF,MF",Rayo Vallecano,La Liga,25,1998,13.0,23,18,15,6,2,11,17,64.7,6,15,3,12,6,29,29,1,0,2023-2024,90.00000000000001,41.53846153846154,159.23076923076925
518,Jhoanner Chávez,ECU,DF,Lens,Ligue 1,21,2002,5.3,6,5,2,2,2,3,9,33.3,6,2,0,2,5,11,11,0,0,2023-2024,90.0,84.9056603773585,101.88679245283019
519,Walid Cheddira,MAR,FW,Frosinone,Serie A,25,1998,23.6,12,7,1,8,3,4,8,50.0,4,6,1,5,5,17,10,0,0,2023-2024,90.0,19.06779661016949,45.762711864406775
520,Rayan Cherki,FRA,"MF,FW",Lyon,Ligue 1,19,2003,19.1,28,15,4,16,8,17,46,37.0,29,13,3,10,7,35,1,0,0,2023-2024,90.0,32.98429319371728,131.9371727748691
521,Youssef Chermiti,POR,FW,Everton,Premier League,19,2004,2.3,3,2,2,1,0,1,5,20.0,4,4,1,3,1,4,2,0,0,2023-2024,90.0,39.130434782608695,117.3913043478261
522,Lucas Chevalier,FRA,GK,Lille,Ligue 1,21,2001,33.0,3,0,3,0,0,3,4,75.0,1,1,0,1,0,3,11,2,0,2023-2024,90.0,0.0,8.181818181818182
523,Fabio Chiarodia,ITA,DF,Gladbach,Bundesliga,18,2005,1.7,8,5,5,1,2,5,7,71.4,2,2,1,1,3,11,9,0,0,2023-2024,90.0,158.8235294117647,423.52941176470586
524,Federico Chiesa,ITA,FW,Juventus,Serie A,25,1997,24.4,20,10,7,6,7,3,13,23.1,10,17,1,16,6,26,4,0,0,2023-2024,90.0,22.13114754098361,73.7704918032787
525,Ben Chilwell,ENG,DF,Chelsea,Premier League,26,1996,8.4,15,10,5,9,1,5,8,62.5,3,11,3,8,4,19,19,1,0,2023-2024,90.0,42.857142857142854,160.7142857142857
Rk,Player,Nation,Pos,Squad,Comp,0,0,90.0,0,0,3,3,3,Tkl,0,0.0,0,0,0,0,0,0,0,0,0,2023-2024,90.0,0.0,0.0
526,Tawanda Chirewa,ZIM,"MF,FW",Wolves,Premier League,19,2003,1.6,7,3,3,3,1,2,3,66.7,1,0,0,0,1,8,0,0,0,2023-2024,90.0,56.25,393.75
527,Pedro Chirivella,ESP,MF,Nantes,Ligue 1,26,1997,28.8,50,28,20,29,1,30,76,39.5,46,22,5,17,31,81,28,0,0,2023-2024,90.0,96.875,156.25
528,Leon Chiwome,ENG,FW,Wolves,Premier League,17,2006,1.9,2,1,0,1,1,1,2,50.0,1,3,1,2,0,2,2,0,0,2023-2024,90.0,0.0,94.73684210526315
529,Tahith Chong,NED,"MF,FW",Luton Town,Premier League,23,1999,22.0,36,22,19,13,4,15,33,45.5,18,30,6,24,8,44,11,1,0,2023-2024,90.0,32.72727272727273,147.27272727272728
530,Joris Chotard,FRA,MF,Montpellier,Ligue 1,21,2001,28.7,81,52,45,25,11,48,96,50.0,48,47,21,26,44,125,60,0,0,2023-2024,90.0,137.97909407665506,254.00696864111498
531,Andreas Christensen,DEN,"DF,MF",Barcelona,La Liga,27,1996,22.0,23,14,7,14,2,16,28,57.1,12,23,10,13,21,44,41,0,0,2023-2024,90.0,85.9090909090909,94.0909090909091
532,Jacob Christensen,DEN,MF,Köln,Bundesliga,22,2001,2.4,10,6,7,3,0,4,7,57.1,3,8,2,6,4,14,4,0,0,2023-2024,90.0,150.0,375.0
533,Oliver Christensen,DEN,GK,Fiorentina,Serie A,24,1999,4.0,0,0,0,0,0,0,0,0.0,0,0,0,0,0,0,1,0,0,2023-2024,90.0,0.0,0.0
534,Ryan Christie,SCO,MF,Bournemouth,Premier League,28,1995,32.3,86,44,34,35,17,39,92,42.4,53,52,11,41,52,138,53,1,0,2023-2024,90.0,144.89164086687308,239.62848297213623
535,Carney Chukwuemeka,ENG,"MF,FW",Chelsea,Premier League,19,2003,2.5,6,4,3,3,0,1,3,33.3,2,1,1,0,0,6,1,0,0,2023-2024,90.0,0.0,216.0
536,Samuel Chukwueze,NGA,FW,Milan,Serie A,24,1999,11.3,18,7,11,5,2,9,17,52.9,8,3,1,2,6,24,3,0,0,2023-2024,90.0,47.78761061946903,143.36283185840708
537,Chumi,ESP,DF,Almería,La Liga,24,1999,27.0,34,22,22,12,0,16,26,61.5,10,38,23,15,14,48,107,3,0,2023-2024,90.0,46.66666666666667,113.33333333333334
538,Víctor Chust,ESP,DF,Cádiz,La Liga,23,2000,20.7,29,18,23,5,1,18,32,56.3,14,27,21,6,11,40,92,1,0,2023-2024,90.0,47.82608695652174,126.08695652173914
539,Pathé Ciss,SEN,MF,Rayo Vallecano,La Liga,29,1994,18.5,44,24,16,26,2,16,29,55.2,13,27,10,17,30,74,54,0,0,2023-2024,90.0,145.94594594594597,214.05405405405406
540,Alphadjo Cissè,ITA,FW,Hellas Verona,Serie A,16,2006,0.1,0,0,0,0,0,0,0,0.0,0,0,0,0,0,0,0,0,0,2023-2024,90.0,0.0,0.0
541,Djaoui Cissé,FRA,MF,Rennes,Ligue 1,19,2004,0.0,0,0,0,0,0,0,0,0.0,0,0,0,0,0,0,0,0,0,2023-2024,,,
542,Ibrahim Cissoko,NED,"FW,MF",Toulouse,Ligue 1,20,2003,2.7,4,3,3,1,0,1,3,33.3,2,3,0,3,1,5,0,0,0,2023-2024,90.0,33.33333333333333,133.33333333333331
543,Giorgio Cittadini,ITA,DF,Monza,Serie A,21,2002,0.2,1,1,1,0,0,1,1,100.0,0,1,1,0,0,1,0,0,0,2023-2024,90.0,0.0,450.0
544,Giorgio Cittadini,ITA,DF,Genoa,Serie A,21,2002,1.2,5,4,4,1,0,3,3,100.0,0,1,0,1,3,8,5,0,0,2023-2024,90.0,225.00000000000003,375.0
545,Patrick Ciurria,ITA,"DF,MF",Monza,Serie A,28,1995,17.8,30,18,13,13,4,13,21,61.9,8,20,5,15,9,39,28,0,0,2023-2024,90.0,45.50561797752809,151.68539325842696
546,Bobby Clark,ENG,MF,Liverpool,Premier League,18,2005,1.0,2,1,1,1,0,1,5,20.0,4,6,2,4,1,3,1,0,0,2023-2024,90.0,90.0,180.0
547,Jordan Clark,ENG,MF,Luton Town,Premier League,29,1993,14.5,30,17,14,11,5,11,39,28.2,28,24,3,21,11,41,15,1,0,2023-2024,90.0,68.27586206896551,186.20689655172413
548,Alexis Claude-Maurice,FRA,MF,Nice,Ligue 1,25,1998,5.6,12,5,3,6,3,1,5,20.0,4,4,1,3,5,17,7,0,0,2023-2024,90.0,80.35714285714286,192.85714285714286
549,Jonathan Clauss,FRA,DF,Marseille,Ligue 1,30,1992,23.0,47,20,22,19,6,26,49,53.1,23,17,3,14,36,83,46,0,0,2023-2024,90.0,140.8695652173913,183.91304347826087
550,Silvi Clúa,ESP,MF,Girona,La Liga,18,2005,0.0,2,0,2,0,0,2,2,100.0,0,1,0,1,0,2,0,0,0,2023-2024,,,inf
Rk,Player,Nation,Pos,Squad,Comp,0,0,90.0,0,0,3,3,3,Tkl,0,0.0,0,0,0,0,0,0,0,0,0,2023-2024,90.0,0.0,0.0
551,Nathaniel Clyne,ENG,DF,Crystal Palace,Premier League,32,1991,14.9,24,15,11,11,2,14,21,66.7,7,18,6,12,10,34,33,0,0,2023-2024,90.0,60.402684563758385,144.96644295302013
552,Marcus Coco,FRA,"DF,FW",Nantes,Ligue 1,27,1996,16.5,43,26,29,10,4,28,60,46.7,32,19,1,18,21,64,38,0,0,2023-2024,90.0,114.54545454545455,234.54545454545456
553,Saúl Coco,EQG,DF,Las Palmas,La Liga,24,1999,25.5,32,19,25,7,0,11,18,61.1,7,27,15,12,20,52,120,3,0,2023-2024,90.0,70.58823529411765,112.94117647058823
554,Séamus Coleman,IRL,DF,Everton,Premier League,34,1988,7.4,17,14,10,3,4,11,16,68.8,5,12,4,8,7,24,26,1,0,2023-2024,90.0,85.13513513513513,206.75675675675674
555,Maxime Colin,FRA,DF,Metz,Ligue 1,31,1991,20.4,39,23,25,7,7,16,29,55.2,13,22,7,15,20,59,71,0,0,2023-2024,90.0,88.23529411764706,172.05882352941177
556,Nathan Collins,IRL,DF,Brentford,Premier League,22,2001,29.5,38,20,24,12,2,19,29,65.5,10,46,30,16,44,82,141,4,0,2023-2024,90.0,134.23728813559322,115.9322033898305
557,Nnamdi Collins,GER,DF,Eint Frankfurt,Bundesliga,19,2004,1.0,0,0,0,0,0,0,0,0.0,0,0,0,0,2,2,4,0,0,2023-2024,90.0,180.0,0.0
558,Lorenzo Colombo,ITA,FW,Monza,Serie A,21,2002,15.1,17,12,3,9,5,8,14,57.1,6,18,5,13,0,17,14,0,0,2023-2024,90.0,0.0,101.32450331125828
559,Andrea Colpani,ITA,"MF,FW",Monza,Serie A,24,1999,29.5,25,15,6,13,6,11,20,55.0,9,11,4,7,14,39,14,0,0,2023-2024,90.0,42.71186440677966,76.27118644067797
560,Levi Colwill,ENG,DF,Chelsea,Premier League,20,2003,20.0,48,30,26,17,5,26,34,76.5,8,28,10,18,26,74,66,0,0,2023-2024,90.0,117.0,216.0
561,Kingsley Coman,FRA,FW,Bayern Munich,Bundesliga,27,1996,12.4,12,7,5,3,4,9,17,52.9,8,15,1,14,2,14,5,0,0,2023-2024,90.0,14.516129032258064,87.09677419354838
562,Eray Cömert,SUI,DF,Nantes,Ligue 1,25,1998,22.2,42,28,28,13,1,28,38,73.7,10,35,18,17,36,78,77,1,0,2023-2024,90.0,145.94594594594597,170.2702702702703
563,Santi Comesaña,ESP,MF,Villarreal,La Liga,26,1996,18.4,44,26,15,21,8,19,38,50.0,19,33,9,24,22,66,27,1,0,2023-2024,90.0,107.60869565217392,215.21739130434784
564,Pietro Comuzzo,ITA,"DF,FW",Fiorentina,Serie A,18,2005,0.5,1,1,1,0,0,1,1,100.0,0,1,0,1,1,2,2,0,0,2023-2024,90.0,180.0,180.0
565,Alois Confais,FRA,"MF,FW",Le Havre,Ligue 1,26,1996,0.1,2,2,1,1,0,1,1,100.0,0,0,0,0,0,2,0,0,0,2023-2024,90.0,0.0,1800.0
566,Andrea Consigli,ITA,GK,Sassuolo,Serie A,36,1987,35.0,0,0,0,0,0,0,0,0.0,0,1,0,1,1,1,19,1,0,2023-2024,90.0,2.571428571428571,0.0
567,Bambasé Conté,GER,"MF,FW",Hoffenheim,Bundesliga,20,2003,0.5,3,3,2,0,1,1,1,100.0,0,0,0,0,0,3,0,0,0,2023-2024,90.0,0.0,540.0
568,Nikita Contini Baranovsky,ITA,GK,Napoli,Serie A,27,1996,0.2,0,0,0,0,0,0,0,0.0,0,0,0,0,0,0,1,0,0,2023-2024,90.0,0.0,0.0
569,Lewis Cook,ENG,MF,Bournemouth,Premier League,26,1997,31.0,61,41,24,30,7,34,63,54.0,29,32,11,21,65,126,46,1,0,2023-2024,90.0,188.70967741935485,177.09677419354838
570,Copete,ESP,DF,Mallorca,La Liga,23,1999,14.8,45,27,27,17,1,30,43,69.8,13,12,6,6,32,77,47,1,0,2023-2024,90.0,194.59459459459458,273.64864864864865
571,Diego Coppola,ITA,DF,Hellas Verona,Serie A,19,2003,18.2,36,22,25,9,2,20,33,60.6,13,26,9,17,27,63,89,1,0,2023-2024,90.0,133.5164835164835,178.02197802197801
572,Francis Coquelin,FRA,MF,Villarreal,La Liga,32,1991,10.1,20,12,8,10,2,5,13,38.5,8,14,4,10,16,36,15,0,0,2023-2024,90.0,142.5742574257426,178.21782178217822
573,Tommaso Corazza,ITA,DF,Bologna,Serie A,19,2004,2.2,10,4,9,1,0,4,9,44.4,5,2,0,2,5,15,3,0,0,2023-2024,90.0,204.54545454545453,409.09090909090907
574,Theo Corbeanu,CAN,"MF,FW",Granada,La Liga,21,2002,2.0,5,2,2,3,0,1,3,33.3,2,3,0,3,3,8,2,0,0,2023-2024,90.0,135.0,225.0
575,Jeppe Corfitzen,DEN,FW,Lecce,Serie A,18,2004,0.1,1,0,0,1,0,1,1,100.0,0,0,0,0,0,1,0,0,0,2023-2024,90.0,0.0,900.0
Rk,Player,Nation,Pos,Squad,Comp,0,0,90.0,0,0,3,3,3,Tkl,0,0.0,0,0,0,0,0,0,0,0,0,2023-2024,90.0,0.0,0.0
576,Jack Cork,ENG,MF,Burnley,Premier League,34,1989,0.3,2,0,0,2,0,1,3,33.3,2,0,0,0,1,3,1,0,0,2023-2024,90.0,300.0,600.0
577,Maxwel Cornet,CIV,"MF,FW",West Ham,Premier League,26,1996,1.2,3,2,3,0,0,1,5,20.0,4,2,0,2,2,5,1,0,0,2023-2024,90.0,150.0,225.00000000000003
578,Giacomo Corona,ITA,FW,Empoli,Serie A,19,2004,0.1,0,0,0,0,0,0,0,0.0,0,0,0,0,0,0,0,0,0,2023-2024,90.0,0.0,0.0
579,Jesús Corona,MEX,"MF,DF",Sevilla,La Liga,30,1993,0.2,0,0,0,0,0,0,0,0.0,0,0,0,0,1,1,0,0,0,2023-2024,90.0,450.0,0.0
580,Ángel Correa,ARG,"FW,MF",Atlético Madrid,La Liga,28,1995,17.0,22,15,3,11,8,5,17,29.4,12,13,0,13,2,24,6,0,0,2023-2024,90.0,10.588235294117647,116.47058823529412
581,Joaquín Correa,ARG,"FW,MF",Marseille,Ligue 1,28,1994,4.8,7,5,4,2,1,0,8,0.0,8,2,0,2,1,8,1,0,0,2023-2024,90.0,18.75,131.25
582,Thierry Correia,POR,DF,Valencia,La Liga,24,1999,23.9,63,35,39,20,4,28,49,57.1,21,39,16,23,33,96,61,0,0,2023-2024,90.0,124.26778242677825,237.2384937238494
583,Oscar Cortés,COL,"FW,MF",Lens,Ligue 1,19,2003,0.5,0,0,0,0,0,0,0,0.0,0,1,0,1,0,0,0,0,0,2023-2024,90.0,0.0,0.0
584,Danny da Costa,GER,DF,Mainz 05,Bundesliga,30,1993,9.2,18,9,9,7,2,9,19,47.4,10,17,4,13,16,34,24,0,0,2023-2024,90.0,156.52173913043478,176.08695652173915
585,David Pereira da Costa,POR,MF,Lens,Ligue 1,22,2001,16.6,18,10,5,12,1,10,23,43.5,13,21,4,17,16,34,8,1,0,2023-2024,90.0,86.74698795180721,97.59036144578312
586,Jaume Costa,ESP,DF,Mallorca,La Liga,35,1988,18.7,38,22,23,10,5,18,29,62.1,11,14,4,10,16,54,35,0,0,2023-2024,90.0,77.00534759358288,182.88770053475935
587,João Costa,BRA,"MF,FW",Roma,Serie A,18,2005,0.2,0,0,0,0,0,0,0,0.0,0,0,0,0,0,0,0,0,0,2023-2024,90.0,0.0,0.0
588,Logan Costa,CPV,DF,Toulouse,Ligue 1,22,2001,29.4,40,24,31,9,0,15,24,62.5,9,42,27,15,23,63,120,1,0,2023-2024,90.0,70.40816326530613,122.44897959183673
589,Samu Costa,POR,MF,Mallorca,La Liga,22,2000,25.6,91,50,40,46,5,46,93,49.5,47,28,14,14,39,130,59,3,0,2023-2024,90.0,137.109375,319.921875
590,Benoît Costil,FRA,GK,Salernitana,Serie A,36,1987,13.0,2,1,1,1,0,2,3,66.7,1,0,0,0,0,2,5,1,0,2023-2024,90.00000000000001,0.0,13.846153846153847
591,Grégoire Coudert,FRA,GK,Brest,Ligue 1,24,1999,2.0,0,0,0,0,0,0,0,0.0,0,0,0,0,0,0,0,0,0,2023-2024,90.0,0.0,0.0
592,Vladimír Coufal,CZE,DF,West Ham,Premier League,30,1992,34.8,64,41,50,12,2,38,75,50.7,37,49,15,34,43,107,97,0,0,2023-2024,90.0,111.20689655172414,165.51724137931035
593,Lassana Coulibaly,MLI,MF,Salernitana,Serie A,27,1996,23.1,47,32,20,21,6,22,49,44.9,27,23,5,18,16,63,29,0,0,2023-2024,89.99999999999999,62.33766233766233,183.1168831168831
594,Mamadou Coulibaly,SEN,DF,Salernitana,Serie A,24,1999,0.0,0,0,0,0,0,0,0,0.0,0,0,0,0,0,0,0,0,0,2023-2024,,,
595,Mamadou Coulibaly,FRA,MF,Monaco,Ligue 1,19,2004,1.3,7,4,2,3,2,3,8,37.5,5,4,0,4,0,7,0,0,0,2023-2024,90.0,0.0,484.6153846153846
596,Tanguy Coulibaly,FRA,"FW,MF",Montpellier,Ligue 1,22,2001,6.9,13,11,8,4,1,4,9,44.4,5,11,1,10,2,15,2,0,0,2023-2024,90.0,26.08695652173913,169.56521739130434
597,Thibaut Courtois,BEL,GK,Real Madrid,La Liga,31,1992,3.7,1,0,1,0,0,0,0,0.0,0,0,0,0,0,1,0,0,0,2023-2024,90.0,0.0,24.324324324324323
598,Philippe Coutinho,BRA,"MF,FW",Aston Villa,Premier League,31,1992,0.3,0,0,0,0,0,0,1,0.0,1,0,0,0,0,0,0,0,0,2023-2024,90.0,0.0,0.0
599,Yan Couto,BRA,"DF,FW",Girona,La Liga,21,2002,24.9,45,34,25,14,6,20,40,50.0,20,14,2,12,10,55,31,1,0,2023-2024,90.0,36.144578313253014,162.65060240963854
600,Nicolas Cozza,FRA,DF,Nantes,Ligue 1,24,1999,9.9,35,23,23,10,2,17,24,70.8,7,7,0,7,14,49,32,0,0,2023-2024,90.0,127.27272727272727,318.1818181818182
Rk,Player,Nation,Pos,Squad,Comp,0,0,90.0,0,0,3,3,3,Tkl,0,0.0,0,0,0,0,0,0,0,0,0,2023-2024,90.0,0.0,0.0
601,Nicolas Cozza,FRA,DF,Wolfsburg,Bundesliga,24,1999,3.1,8,6,4,4,0,2,7,28.6,5,3,0,3,4,12,6,0,0,2023-2024,90.0,116.12903225806451,232.25806451612902
602,Alessio Cragno,ITA,GK,Sassuolo,Serie A,29,1994,3.0,0,0,0,0,0,0,0,0.0,0,0,0,0,0,0,3,1,0,2023-2024,90.0,0.0,0.0
603,Crespo,POR,MF,Rayo Vallecano,La Liga,26,1996,5.9,16,9,8,6,2,9,17,52.9,8,15,6,9,10,26,7,0,0,2023-2024,90.0,152.54237288135593,244.06779661016947
604,Aaron Cresswell,ENG,"DF,FW",West Ham,Premier League,33,1989,4.8,3,2,1,1,1,2,3,66.7,1,5,3,2,3,6,7,0,0,2023-2024,90.0,56.25000000000001,56.25000000000001
605,Bryan Cristante,ITA,"MF,DF",Roma,Serie A,28,1995,36.5,72,41,33,28,11,28,50,56.0,22,36,6,30,25,97,55,2,0,2023-2024,90.0,61.64383561643836,177.53424657534245
606,Cristian,ESP,GK,Valencia,La Liga,25,1998,0.6,0,0,0,0,0,0,0,0.0,0,0,0,0,0,0,0,0,0,2023-2024,90.0,0.0,0.0
607,Juan Cruz Armada,ESP,DF,Osasuna,La Liga,31,1992,18.5,27,15,16,10,1,17,25,68.0,8,14,7,7,12,39,39,1,0,2023-2024,90.0,58.37837837837838,131.35135135135135
608,Juan Cruz,ARG,"FW,MF",Hellas Verona,Serie A,24,1999,1.2,2,2,0,0,2,0,0,0.0,0,1,0,1,1,3,0,0,0,2023-2024,90.0,75.0,150.0
609,Juan Cruz,ESP,FW,Betis,La Liga,23,2000,0.8,0,0,0,0,0,0,1,0.0,1,0,0,0,0,0,0,0,0,2023-2024,90.0,0.0,0.0
610,Juan Cuadrado,COL,DF,Inter,Serie A,35,1988,3.0,4,3,2,2,0,3,5,60.0,2,6,1,5,1,5,2,0,0,2023-2024,90.0,30.0,120.0
611,Pau Cubarsí,ESP,DF,Barcelona,La Liga,16,2007,17.3,22,14,18,3,1,13,18,72.2,5,20,16,4,12,34,65,0,0,2023-2024,90.0,62.42774566473988,114.45086705202311
612,Marc Cucurella,ESP,DF,Chelsea,Premier League,25,1998,19.8,62,38,36,21,5,34,64,53.1,30,36,13,23,22,84,48,0,0,2023-2024,90.0,100.0,281.8181818181818
613,Iván Cuéllar,ESP,GK,Mallorca,La Liga,39,1984,1.0,0,0,0,0,0,0,0,0.0,0,0,0,0,0,0,0,0,0,2023-2024,90.0,0.0,0.0
614,Jorge Cuenca,ESP,DF,Villarreal,La Liga,23,1999,21.8,42,29,26,10,6,19,30,63.3,11,26,15,11,21,63,114,0,0,2023-2024,90.0,86.69724770642202,173.39449541284404
615,Josh Cullen,IRL,MF,Burnley,Premier League,27,1996,22.9,42,29,15,22,5,26,46,56.5,20,31,19,12,15,57,26,1,0,2023-2024,90.0,58.951965065502186,165.06550218340612
616,Matheus Cunha,BRA,"FW,MF",Wolves,Premier League,24,1999,27.1,30,16,8,17,5,13,35,37.1,22,28,7,21,13,43,21,1,0,2023-2024,90.0,43.17343173431735,99.6309963099631
617,Marvin Cuni,ALB,FW,Frosinone,Serie A,22,2001,5.9,8,3,1,3,4,3,4,75.0,1,10,1,9,1,9,0,0,0,2023-2024,90.0,15.254237288135592,122.03389830508473
618,Eric Curbelo,ESP,"DF,MF",Las Palmas,La Liga,29,1994,1.1,4,3,2,2,0,3,4,75.0,1,3,1,2,2,6,5,1,0,2023-2024,90.0,163.63636363636363,327.27272727272725
619,Sam Curtis,IRL,DF,Sheffield Utd,Premier League,17,2005,0.3,1,0,1,0,0,1,2,50.0,1,2,0,2,0,1,0,0,0,2023-2024,90.0,0.0,300.0
620,Tomáš Čvančara,CZE,FW,Gladbach,Bundesliga,22,2000,10.0,4,3,0,2,2,1,3,33.3,2,5,1,4,2,6,8,0,0,2023-2024,90.0,18.0,36.0
621,Danilo D'Ambrosio,ITA,DF,Monza,Serie A,34,1988,17.1,57,34,34,20,3,28,41,68.3,13,22,13,9,14,71,31,0,0,2023-2024,90.0,73.6842105263158,300.0
622,Alberto Dadie,ESP,MF,Real Sociedad,La Liga,21,2002,0.3,2,1,2,0,0,0,0,0.0,0,1,0,1,0,2,0,0,0,2023-2024,90.0,0.0,600.0
623,Trévis Dago,CIV,"FW,MF",Lille,Ligue 1,18,2005,0.3,0,0,0,0,0,0,0,0.0,0,0,0,0,1,1,0,0,0,2023-2024,90.0,300.0,0.0
624,Finn Dahmen,GER,GK,Augsburg,Bundesliga,25,1998,31.0,1,0,1,0,0,1,3,33.3,2,0,0,0,0,1,17,5,0,2023-2024,90.0,0.0,2.903225806451613
625,Mahmoud Dahoud,GER,MF,Brighton,Premier League,27,1996,5.0,9,4,2,4,3,3,9,33.3,6,4,1,3,1,10,5,0,0,2023-2024,90.0,18.0,162.0
Rk,Player,Nation,Pos,Squad,Comp,0,0,90.0,0,0,3,3,3,Tkl,0,0.0,0,0,0,0,0,0,0,0,0,2023-2024,90.0,0.0,0.0
626,Mahmoud Dahoud,GER,MF,Stuttgart,Bundesliga,27,1996,2.5,5,1,1,4,0,3,7,42.9,4,4,0,4,0,5,1,0,0,2023-2024,90.0,0.0,180.0
627,Ameen Al-Dakhil,BEL,DF,Burnley,Premier League,21,2002,11.7,12,5,4,7,1,1,10,10.0,9,13,6,7,12,24,38,2,0,2023-2024,89.99999999999999,92.3076923076923,92.3076923076923
628,Thijs Dallinga,NED,FW,Toulouse,Ligue 1,22,2000,27.9,29,15,6,11,12,9,15,60.0,6,11,4,7,3,32,35,0,0,2023-2024,90.0,9.67741935483871,93.54838709677419
629,Diogo Dalot,POR,DF,Manchester Utd,Premier League,24,1999,35.3,81,51,58,12,11,51,74,68.9,23,44,16,28,37,118,111,0,0,2023-2024,90.0,94.3342776203966,206.5155807365439
630,Mikkel Damsgaard,DEN,MF,Brentford,Premier League,23,2000,9.4,29,17,13,9,7,14,40,35.0,26,23,1,22,11,40,10,1,0,2023-2024,90.0,105.31914893617021,277.6595744680851
631,Flavius Daniliuc,AUT,DF,Salernitana,Serie A,22,2001,8.3,19,11,12,5,2,9,19,47.4,10,13,4,9,8,27,15,0,0,2023-2024,90.0,86.74698795180721,206.02409638554215
632,Danilo,BRA,MF,Nott'ham Forest,Premier League,22,2001,19.9,36,18,22,12,2,21,46,45.7,25,33,8,25,35,71,42,0,0,2023-2024,90.0,158.29145728643218,162.8140703517588
633,Danilo,BRA,DF,Juventus,Serie A,32,1991,27.2,60,36,38,18,4,32,48,66.7,16,34,15,19,37,97,94,0,0,2023-2024,90.0,122.42647058823529,198.52941176470588
634,Arnaut Danjuma,NED,"MF,FW",Everton,Premier League,26,1997,6.6,6,4,2,3,1,1,4,25.0,3,4,0,4,3,9,0,0,0,2023-2024,90.0,40.90909090909091,81.81818181818181
635,Jayden Danns,ENG,FW,Liverpool,Premier League,17,2006,0.1,0,0,0,0,0,0,0,0.0,0,0,0,0,0,0,0,0,0,2023-2024,90.0,0.0,0.0
636,Kevin Danso,AUT,DF,Lens,Ligue 1,24,1998,29.5,24,14,12,11,1,15,30,50.0,15,43,30,13,23,47,115,1,0,2023-2024,90.0,70.16949152542372,73.22033898305085
637,Dante,BRA,DF,Nice,Ligue 1,39,1983,31.6,62,30,44,16,2,38,52,73.1,14,43,22,21,37,99,77,2,0,2023-2024,90.0,105.37974683544303,176.58227848101265
638,Raimane Daou,COM,"DF,MF",Marseille,Ligue 1,18,2004,0.3,1,1,1,0,0,1,2,50.0,1,0,0,0,0,1,2,0,0,2023-2024,90.0,0.0,300.0
639,Mohammed Daramy,DEN,"FW,MF",Reims,Ligue 1,21,2002,18.3,10,9,4,4,2,6,16,37.5,10,5,1,4,4,14,4,0,0,2023-2024,90.0,19.672131147540984,49.18032786885246
640,Sergi Darder,ESP,MF,Mallorca,La Liga,29,1993,24.0,39,26,13,21,5,12,31,38.7,19,20,4,16,16,55,16,0,0,2023-2024,90.0,60.0,146.25
641,Achraf Dari,MAR,"DF,FW",Brest,Ligue 1,24,1999,1.3,1,1,1,0,0,0,2,0.0,2,2,0,2,5,6,9,1,0,2023-2024,90.0,346.15384615384613,69.23076923076923
642,Matteo Darmian,ITA,DF,Inter,Serie A,33,1989,26.7,48,22,23,15,10,20,53,37.7,33,27,11,16,13,61,55,0,0,2023-2024,90.00000000000001,43.82022471910113,161.79775280898878
643,Lukas Daschner,GER,"MF,FW",Bochum,Bundesliga,24,1998,6.0,9,4,2,3,4,4,9,44.4,5,7,0,7,2,11,2,0,0,2023-2024,90.0,30.0,135.0
644,Josh Dasilva,ENG,"DF,FW",Brentford,Premier League,24,1998,0.3,2,1,0,1,1,0,0,0.0,0,0,0,0,0,2,0,0,0,2023-2024,90.0,0.0,600.0
645,David Datro Fofana,CIV,FW,Burnley,Premier League,20,2002,9.8,10,5,3,5,2,3,6,50.0,3,9,3,6,1,11,2,0,0,2023-2024,90.0,9.183673469387754,91.83673469387755
646,David Datro Fofana,CIV,"FW,MF",Union Berlin,Bundesliga,20,2002,7.6,10,7,3,5,2,4,9,44.4,5,4,0,4,0,10,5,0,0,2023-2024,90.0,0.0,118.42105263157895
647,Juan David Cabal,COL,DF,Hellas Verona,Serie A,22,2001,16.6,36,27,19,14,3,18,29,62.1,11,30,9,21,26,62,55,2,0,2023-2024,90.0,140.96385542168673,195.18072289156623
648,Jonathan David,CAN,FW,Lille,Ligue 1,23,2000,29.2,26,15,6,13,7,8,26,30.8,18,16,0,16,9,35,4,0,0,2023-2024,90.0,27.73972602739726,80.13698630136987
649,Alphonso Davies,CAN,DF,Bayern Munich,Bundesliga,22,2000,22.9,47,24,29,13,5,30,53,56.6,23,30,4,26,26,73,49,1,0,2023-2024,90.0,102.18340611353713,184.7161572052402
650,Ben Davies,WAL,DF,Tottenham,Premier League,30,1993,12.1,24,17,13,8,3,16,21,76.2,5,17,15,2,10,34,35,0,0,2023-2024,90.0,74.3801652892562,178.51239669421486
Rk,Player,Nation,Pos,Squad,Comp,0,0,90.0,0,0,3,3,3,Tkl,0,0.0,0,0,0,0,0,0,0,0,0,2023-2024,90.0,0.0,0.0
651,Tom Davies,ENG,MF,Sheffield Utd,Premier League,25,1998,2.5,10,5,4,3,3,3,9,33.3,6,2,1,1,3,13,6,1,0,2023-2024,90.0,108.0,360.0
652,Keinan Davis,ENG,"FW,MF",Udinese,Serie A,25,1998,2.1,0,0,0,0,0,0,0,0.0,0,0,0,0,0,0,3,0,0,2023-2024,90.0,0.0,0.0
653,Paweł Dawidowicz,POL,DF,Hellas Verona,Serie A,28,1995,23.8,53,30,33,18,2,17,29,58.6,12,17,9,8,24,77,114,1,0,2023-2024,90.00000000000001,90.75630252100841,200.4201680672269
654,Craig Dawson,ENG,DF,Wolves,Premier League,33,1990,24.5,30,20,23,6,1,22,34,64.7,12,51,39,12,16,46,120,1,0,2023-2024,90.00000000000001,58.77551020408164,110.20408163265307
655,Kevin De Bruyne,BEL,MF,Manchester City,Premier League,32,1991,13.6,14,9,1,5,8,7,20,35.0,13,5,0,5,4,18,4,0,0,2023-2024,90.0,26.470588235294116,92.6470588235294
656,Charles De Ketelaere,BEL,"FW,MF",Atalanta,Serie A,22,2001,22.5,33,21,3,12,18,10,20,50.0,10,30,2,28,7,40,6,0,0,2023-2024,90.0,28.0,132.0
657,Rodrigo De Paul,ARG,MF,Atlético Madrid,La Liga,29,1994,23.1,31,21,11,14,6,15,38,39.5,23,28,1,27,11,42,15,2,0,2023-2024,89.99999999999999,42.85714285714285,120.77922077922076
658,Mattia De Sciglio,ITA,DF,Juventus,Serie A,30,1992,0.5,0,0,0,0,0,0,0,0.0,0,1,0,1,1,1,2,0,0,2023-2024,90.0,180.0,0.0
659,Lorenzo De Silvestri,ITA,DF,Bologna,Serie A,35,1988,7.5,10,8,5,2,3,4,7,57.1,3,9,4,5,6,16,27,0,0,2023-2024,90.0,72.0,120.0
660,Thibault De Smet,BEL,DF,Reims,Ligue 1,25,1998,20.3,56,35,36,16,4,33,59,55.9,26,25,5,20,21,77,51,1,0,2023-2024,90.0,93.10344827586206,248.2758620689655
661,Koni De Winter,BEL,DF,Genoa,Serie A,21,2002,26.4,44,25,26,13,5,21,31,67.7,10,30,10,20,21,65,78,0,0,2023-2024,90.0,71.5909090909091,150.0
662,Grégoire Defrel,MTQ,"FW,MF",Sassuolo,Serie A,32,1991,8.4,17,8,7,5,5,7,15,46.7,8,10,0,10,3,20,9,0,0,2023-2024,90.0,32.14285714285714,182.14285714285714
663,Alessandro Deiola,ITA,MF,Cagliari,Serie A,27,1995,17.9,33,19,13,16,4,18,47,38.3,29,16,6,10,9,42,37,0,0,2023-2024,90.0,45.2513966480447,165.92178770949724
664,Romain Del Castillo,FRA,FW,Brest,Ligue 1,27,1996,27.7,46,29,14,18,14,18,70,25.7,52,33,1,32,9,55,8,0,0,2023-2024,90.0,29.24187725631769,149.45848375451266
665,Thomas Delaine,FRA,"DF,MF",Strasbourg,Ligue 1,31,1992,22.7,38,19,29,8,1,20,42,47.6,22,18,2,16,17,55,51,0,0,2023-2024,89.99999999999999,67.40088105726872,150.66079295154185
666,Sacha Delaye,FRA,"MF,FW",Montpellier,Ligue 1,21,2002,1.4,7,2,2,2,3,1,6,16.7,5,2,0,2,0,7,1,0,0,2023-2024,90.0,0.0,450.0
667,Hannes Delcroix,BEL,DF,Burnley,Premier League,24,1999,6.5,10,6,6,4,0,3,4,75.0,1,9,3,6,9,19,26,0,0,2023-2024,90.00000000000001,124.61538461538463,138.46153846153848
668,Alessandro Dellavalle,ITA,DF,Torino,Serie A,19,2004,0.2,0,0,0,0,0,0,0,0.0,0,1,1,0,1,1,0,0,0,2023-2024,90.0,450.0,0.0
669,Olivier Deman,BEL,DF,Werder Bremen,Bundesliga,23,2000,15.2,28,15,21,4,3,18,38,47.4,20,24,8,16,14,42,49,1,0,2023-2024,90.0,82.89473684210526,165.78947368421052
670,Karamoko Dembélé,ENG,"MF,FW",Brest,Ligue 1,20,2003,0.2,0,0,0,0,0,0,0,0.0,0,0,0,0,0,0,0,0,0,2023-2024,90.0,0.0,0.0
671,Ousmane Dembélé,FRA,"MF,FW",Paris S-G,Ligue 1,26,1997,16.7,19,14,2,7,10,6,13,46.2,7,11,0,11,5,24,4,1,0,2023-2024,90.0,26.94610778443114,102.39520958083833
672,Jessy Deminguet,FRA,"MF,FW",Strasbourg,Ligue 1,25,1998,7.7,14,9,6,8,0,6,18,33.3,12,8,0,8,9,23,5,1,0,2023-2024,90.0,105.1948051948052,163.63636363636365
673,Ermedin Demirović,BIH,"FW,MF",Augsburg,Bundesliga,25,1998,31.9,24,14,5,16,3,12,40,30.0,28,28,2,26,11,35,26,0,0,2023-2024,90.0,31.03448275862069,67.7115987460815
674,Diego Demme,GER,MF,Napoli,Serie A,31,1991,0.8,1,1,0,1,0,0,1,0.0,1,0,0,0,0,1,0,0,0,2023-2024,90.0,0.0,112.5
675,Sepp van den Berg,NED,DF,Mainz 05,Bundesliga,21,2001,31.5,38,23,20,15,3,15,26,57.7,11,66,36,30,43,81,159,2,0,2023-2024,90.0,122.85714285714286,108.57142857142858
Rk,Player,Nation,Pos,Squad,Comp,0,0,90.0,0,0,3,3,3,Tkl,0,0.0,0,0,0,0,0,0,0,0,0,2023-2024,90.0,0.0,0.0
676,Leander Dendoncker,BEL,MF,Aston Villa,Premier League,28,1995,1.3,6,4,3,2,1,4,5,80.0,1,5,2,3,2,8,3,1,0,2023-2024,90.0,138.46153846153845,415.38461538461536
677,Leander Dendoncker,BEL,MF,Napoli,Serie A,28,1995,0.3,0,0,0,0,0,0,0,0.0,0,1,1,0,0,0,0,0,0,2023-2024,90.0,0.0,0.0
678,Rémy Descamps,FRA,GK,Nantes,Ligue 1,27,1996,6.0,0,0,0,0,0,0,0,0.0,0,0,0,0,0,0,7,0,0,2023-2024,90.0,0.0,0.0
679,Mikkel Desler,DEN,DF,Toulouse,Ligue 1,28,1995,17.2,18,12,8,7,3,9,17,52.9,8,32,13,19,19,37,38,0,0,2023-2024,90.0,99.4186046511628,94.18604651162792
680,Arthur Desmas,FRA,GK,Le Havre,Ligue 1,29,1994,33.0,0,0,0,0,0,0,2,0.0,2,0,0,0,0,0,13,1,0,2023-2024,90.0,0.0,0.0
681,Mattia Destro,ITA,"FW,MF",Empoli,Serie A,32,1991,4.1,2,1,0,2,0,1,1,100.0,0,4,0,4,2,4,3,0,0,2023-2024,90.0,43.90243902439025,43.90243902439025
682,Samuele Di Benedetto,GER,MF,Stuttgart,Bundesliga,18,2005,0.1,0,0,0,0,0,0,0,0.0,0,0,0,0,1,1,0,0,0,2023-2024,90.0,900.0,0.0
683,Federico Di Francesco,ITA,"FW,MF",Lecce,Serie A,29,1994,0.2,1,0,0,1,0,0,0,0.0,0,0,0,0,0,1,0,0,0,2023-2024,90.0,0.0,450.0
684,Raffaele Di Gennaro,ITA,GK,Inter,Serie A,29,1993,0.3,0,0,0,0,0,0,0,0.0,0,0,0,0,0,0,0,0,0,2023-2024,90.0,0.0,0.0
685,Michele Di Gregorio,ITA,GK,Monza,Serie A,26,1997,31.9,1,0,1,0,0,1,4,25.0,3,1,0,1,1,2,10,2,0,2023-2024,90.0,2.8213166144200628,2.8213166144200628
686,Giovanni Di Lorenzo,ITA,DF,Napoli,Serie A,29,1993,35.9,58,36,26,26,6,32,68,47.1,36,43,16,27,24,82,45,0,0,2023-2024,90.0,60.167130919220064,145.40389972144848
687,Alessandro Di Pardo,ITA,"DF,MF",Cagliari,Serie A,24,1999,4.0,4,1,3,0,1,0,3,0.0,3,9,2,7,5,9,7,0,0,2023-2024,90.0,112.5,90.0
688,Boulaye Dia,SEN,"FW,MF",Salernitana,Serie A,26,1996,12.7,4,2,2,2,0,1,3,33.3,2,5,0,5,3,7,7,0,0,2023-2024,90.0,21.25984251968504,28.34645669291339
689,Moussa Diaby,FRA,"FW,MF",Aston Villa,Premier League,24,1999,24.2,12,5,5,4,3,4,22,18.2,18,8,1,7,9,21,6,0,0,2023-2024,90.0,33.47107438016529,44.628099173553714
690,Lamine Diack,SEN,MF,Nantes,Ligue 1,22,2000,0.0,0,0,0,0,0,0,0,0.0,0,0,0,0,0,0,0,0,0,2023-2024,,,
691,Mouctar Diakhaby,GUI,"DF,MF",Valencia,La Liga,26,1996,11.9,18,11,9,9,0,11,13,84.6,2,17,7,10,11,29,62,0,0,2023-2024,90.00000000000001,83.19327731092437,136.1344537815126
692,Mamadou Diakhon,FRA,"FW,MF",Reims,Ligue 1,17,2005,2.3,5,3,2,1,2,3,9,33.3,6,1,0,1,1,6,1,0,0,2023-2024,90.0,39.130434782608695,195.6521739130435
693,Bafodé Diakité,FRA,DF,Lille,Ligue 1,22,2001,18.8,29,20,12,15,2,24,32,75.0,8,16,8,8,21,50,49,1,0,2023-2024,90.0,100.53191489361701,138.82978723404256
694,Ibrahim Diakité,GUI,DF,Reims,Ligue 1,19,2003,1.2,1,0,0,1,0,0,1,0.0,1,3,0,3,2,3,5,0,0,2023-2024,90.0,150.0,75.0
695,Moussa Diakité,MLI,MF,Cádiz,La Liga,19,2003,0.0,0,0,0,0,0,0,0,0.0,0,0,0,0,0,0,0,0,0,2023-2024,,,
696,Oumar Diakité,CIV,FW,Reims,Ligue 1,19,2003,17.6,25,12,10,9,6,7,21,33.3,14,13,0,13,7,32,7,0,0,2023-2024,90.0,35.79545454545455,127.84090909090908
697,Amad Diallo,CIV,"FW,MF",Manchester Utd,Premier League,21,2002,4.3,10,3,1,6,3,3,7,42.9,4,3,1,2,1,11,6,0,0,2023-2024,90.0,20.930232558139537,209.30232558139537
698,Amadou Diallo,ENG,MF,Newcastle Utd,Premier League,20,2003,0.0,0,0,0,0,0,0,0,0.0,0,0,0,0,0,0,0,0,0,2023-2024,,,
699,Assane Diao,ESP,FW,Betis,La Liga,17,2005,11.6,20,12,5,9,6,6,17,35.3,11,22,4,18,7,27,7,0,0,2023-2024,90.0,54.310344827586206,155.17241379310346
700,Habib Diarra,SEN,"MF,FW",Strasbourg,Ligue 1,19,2004,25.6,30,23,8,20,2,9,33,27.3,24,23,4,19,17,47,15,0,0,2023-2024,90.0,59.765625,105.46875
Rk,Player,Nation,Pos,Squad,Comp,0,0,90.0,0,0,3,3,3,Tkl,0,0.0,0,0,0,0,0,0,0,0,0,2023-2024,90.0,0.0,0.0
701,Moussa Diarra,MLI,DF,Toulouse,Ligue 1,22,2000,15.5,32,12,16,15,1,13,27,48.1,14,30,14,16,20,52,43,0,0,2023-2024,90.0,116.12903225806451,185.80645161290323
702,Rúben Dias,POR,DF,Manchester City,Premier League,26,1997,28.4,39,20,14,21,4,19,26,73.1,7,32,17,15,30,69,77,0,0,2023-2024,90.0,95.07042253521128,123.59154929577466
703,Krépin Diatta,SEN,"DF,FW",Monaco,Ligue 1,24,1999,13.4,37,20,17,16,4,27,49,55.1,22,17,2,15,16,53,22,0,0,2023-2024,90.0,107.46268656716417,248.50746268656715
704,Mory Diaw,SEN,GK,Clermont Foot,Ligue 1,30,1993,30.0,1,1,1,0,0,1,2,50.0,1,0,0,0,1,2,13,5,0,2023-2024,90.0,3.0,3.0
705,Mahamadou Diawara,FRA,MF,Lyon,Ligue 1,18,2005,4.0,9,6,4,5,0,3,11,27.3,8,4,1,3,4,13,4,0,0,2023-2024,90.0,90.0,202.5
706,Brahim Díaz,MAR,"FW,MF",Real Madrid,La Liga,23,1999,17.2,29,19,4,16,9,6,13,46.2,7,16,1,15,5,34,2,0,0,2023-2024,90.0,26.16279069767442,151.74418604651163
707,Luis Díaz,COL,FW,Liverpool,Premier League,26,1997,29.2,35,25,5,17,13,7,30,23.3,23,15,0,15,3,38,8,0,0,2023-2024,90.0,9.246575342465754,107.87671232876713
708,Víctor Díaz,ESP,"DF,MF",Granada,La Liga,35,1988,1.8,5,3,2,3,0,1,3,33.3,2,1,0,1,1,6,8,0,0,2023-2024,90.0,50.0,250.0
709,Famara Diedhiou,SEN,"FW,MF",Granada,La Liga,30,1992,1.0,1,1,0,1,0,0,1,0.0,1,0,0,0,0,1,2,0,0,2023-2024,90.0,0.0,90.0
710,Justin Diehl,GER,"FW,MF",Köln,Bundesliga,18,2004,1.9,0,0,0,0,0,0,0,0.0,0,1,1,0,0,0,0,1,0,2023-2024,90.0,0.0,0.0
711,Bamba Dieng,SEN,FW,Lorient,Ligue 1,23,2000,6.1,3,3,0,3,0,1,3,33.3,2,3,0,3,0,3,7,0,0,2023-2024,90.0,0.0,44.26229508196722
712,Eric Dier,ENG,DF,Tottenham,Premier League,29,1994,2.2,2,1,2,0,0,2,2,100.0,0,3,3,0,2,4,12,0,0,2023-2024,90.0,81.81818181818181,81.81818181818181
713,Eric Dier,ENG,DF,Bayern Munich,Bundesliga,29,1994,13.0,11,8,5,5,1,5,6,83.3,1,20,12,8,10,21,48,1,0,2023-2024,90.00000000000001,69.23076923076924,76.15384615384616
714,Guillaume Dietsch,FRA,GK,Metz,Ligue 1,22,2001,0.8,0,0,0,0,0,0,0,0.0,0,0,0,0,0,0,0,0,0,2023-2024,90.0,0.0,0.0
715,Florian Dietz,GER,"FW,MF",Köln,Bundesliga,24,1998,0.8,0,0,0,0,0,0,0,0.0,0,1,0,1,0,0,0,0,0,2023-2024,90.0,0.0,0.0
716,Lucas Digne,FRA,DF,Aston Villa,Premier League,30,1993,26.8,47,19,35,9,3,25,44,56.8,19,20,2,18,26,73,67,0,0,2023-2024,90.0,87.31343283582089,157.83582089552237
717,Federico Dimarco,ITA,DF,Inter,Serie A,25,1997,23.1,42,25,19,14,9,17,35,48.6,18,18,3,15,9,51,34,1,0,2023-2024,89.99999999999999,35.06493506493506,163.6363636363636
718,Stole Dimitrievski,MKD,GK,Rayo Vallecano,La Liga,29,1993,37.0,1,1,1,0,0,1,1,100.0,0,0,0,0,0,1,17,3,0,2023-2024,90.0,0.0,2.4324324324324325
719,Junior Dina Ebimbe,FRA,"MF,DF",Eint Frankfurt,Bundesliga,22,2000,21.7,44,29,15,17,12,18,41,43.9,23,28,7,21,9,53,39,1,0,2023-2024,90.0,37.327188940092164,182.48847926267283
720,Eren Dinkçi,GER,"FW,MF",Heidenheim,Bundesliga,21,2001,29.4,32,18,16,13,3,19,48,39.6,29,40,4,36,12,44,21,0,0,2023-2024,90.0,36.734693877551024,97.95918367346938
721,Sinaly Diomande,CIV,DF,Lyon,Ligue 1,22,2001,9.9,10,4,5,3,2,9,16,56.3,7,12,9,3,15,25,26,1,0,2023-2024,90.0,136.36363636363637,90.9090909090909
722,Edan Diop,FRA,"MF,DF",Monaco,Ligue 1,18,2004,1.8,10,8,6,3,1,7,9,77.8,2,3,0,3,1,11,5,0,0,2023-2024,90.0,50.0,500.0
723,Issa Diop,FRA,DF,Fulham,Premier League,26,1997,15.8,30,16,23,5,2,15,20,75.0,5,28,19,9,17,47,80,1,0,2023-2024,90.0,96.83544303797467,170.88607594936707
724,Sofiane Diop,FRA,FW,Nice,Ligue 1,23,2000,5.5,8,6,3,4,1,4,10,40.0,6,4,0,4,3,11,3,0,0,2023-2024,90.0,49.09090909090909,130.9090909090909
725,Andy Diouf,FRA,MF,Lens,Ligue 1,20,2003,14.6,28,19,12,11,5,14,22,63.6,8,13,3,10,3,31,5,1,0,2023-2024,90.0,18.493150684931507,172.6027397260274
Rk,Player,Nation,Pos,Squad,Comp,0,0,90.0,0,0,3,3,3,Tkl,0,0.0,0,0,0,0,0,0,0,0,0,2023-2024,90.0,0.0,0.0
726,Yehvann Diouf,FRA,GK,Reims,Ligue 1,23,1999,34.0,0,0,0,0,0,0,1,0.0,1,0,0,0,1,1,19,3,0,2023-2024,90.0,2.6470588235294117,0.0
727,Axel Disasi,FRA,DF,Chelsea,Premier League,25,1998,28.7,33,19,20,10,3,23,30,76.7,7,26,19,7,18,51,102,2,0,2023-2024,90.0,56.44599303135889,103.48432055749129
728,Tiago Djaló,POR,DF,Juventus,Serie A,23,2000,0.2,0,0,0,0,0,0,0,0.0,0,1,0,1,0,0,1,0,0,2023-2024,90.0,0.0,0.0
729,Chaim El Djebali,TUN,MF,Lyon,Ligue 1,19,2004,0.1,0,0,0,0,0,0,0,0.0,0,0,0,0,0,0,0,0,0,2023-2024,90.0,0.0,0.0
730,Djené,TOG,"DF,MF",Getafe,La Liga,31,1991,27.6,34,19,18,13,3,15,26,57.7,11,31,15,16,23,57,70,0,0,2023-2024,90.0,74.99999999999999,110.8695652173913
731,Koffi Djidji,CIV,DF,Torino,Serie A,30,1992,8.4,14,9,9,5,0,3,4,75.0,1,10,5,5,10,24,20,0,0,2023-2024,90.0,107.14285714285714,150.0
732,Berat Djimsiti,ALB,DF,Atalanta,Serie A,30,1993,31.5,42,24,29,12,1,19,31,61.3,12,53,33,20,57,99,100,0,0,2023-2024,90.0,162.85714285714286,120.00000000000001
733,Marko Dmitrović,SRB,GK,Sevilla,La Liga,31,1992,13.0,1,1,1,0,0,1,2,50.0,1,0,0,0,1,2,5,0,0,2023-2024,90.00000000000001,6.923076923076923,6.923076923076923
734,Ben Doak,SCO,FW,Liverpool,Premier League,17,2005,0.2,0,0,0,0,0,0,0,0.0,0,0,0,0,0,0,0,0,0,2023-2024,90.0,0.0,0.0
735,Ritsu Doan,JPN,"DF,MF",Freiburg,Bundesliga,25,1998,25.0,50,27,21,19,10,21,36,58.3,15,30,3,27,9,59,29,0,0,2023-2024,90.0,32.4,180.0
736,Lewis Dobbin,ENG,MF,Everton,Premier League,20,2003,2.6,9,7,3,5,1,5,9,55.6,4,5,1,4,1,10,0,0,0,2023-2024,90.0,34.61538461538461,311.5384615384615
737,Dodô,BRA,DF,Fiorentina,Serie A,24,1998,5.8,5,3,1,4,0,2,5,40.0,3,2,0,2,5,10,11,0,0,2023-2024,90.0,77.58620689655173,77.58620689655173
738,Danilho Doekhi,NED,DF,Union Berlin,Bundesliga,25,1998,24.0,34,23,18,16,0,15,21,71.4,6,46,25,21,38,72,111,1,0,2023-2024,90.0,142.5,127.5
739,Matt Doherty,IRL,"DF,MF",Wolves,Premier League,31,1992,12.8,31,18,17,10,4,12,23,52.2,11,15,5,10,7,38,47,0,0,2023-2024,90.0,49.21875,217.96875
740,Josh Doig,SCO,DF,Hellas Verona,Serie A,21,2002,9.2,16,9,9,7,0,13,17,76.5,4,12,3,9,4,20,17,1,0,2023-2024,90.0,39.130434782608695,156.52173913043478
741,Josh Doig,SCO,DF,Sassuolo,Serie A,21,2002,14.9,25,17,16,9,0,15,27,55.6,12,31,10,21,16,41,38,0,0,2023-2024,90.0,96.64429530201342,151.00671140939596
742,Jeremy Doku,BEL,"FW,MF",Manchester City,Premier League,21,2002,17.7,39,22,13,12,14,9,20,45.0,11,14,0,14,9,48,5,0,0,2023-2024,90.0,45.76271186440678,198.3050847457627
743,Jeremy Doku,BEL,FW,Rennes,Ligue 1,21,2002,1.2,2,2,1,0,1,1,1,100.0,0,0,0,0,0,2,0,0,0,2023-2024,90.0,0.0,150.0
744,Jaume Doménech,ESP,GK,Valencia,La Liga,32,1990,0.9,0,0,0,0,0,0,0,0.0,0,0,0,0,0,0,0,0,0,2023-2024,90.0,0.0,0.0
745,Carlos Dominguez,ESP,DF,Celta Vigo,La Liga,22,2001,17.6,33,21,17,9,7,23,37,62.2,14,24,12,12,22,55,78,0,0,2023-2024,90.0,112.5,168.75
746,Mario Dominguez,ESP,FW,Valencia,La Liga,19,2004,0.3,0,0,0,0,0,0,0,0.0,0,0,0,0,0,0,0,0,0,2023-2024,90.0,0.0,0.0
747,Nicolás Domínguez,ARG,"MF,FW",Nott'ham Forest,Premier League,25,1998,16.6,63,34,35,27,1,23,48,47.9,25,31,5,26,18,81,24,0,0,2023-2024,90.0,97.59036144578312,341.56626506024094
748,Nicolás Domínguez,ARG,MF,Bologna,Serie A,25,1998,1.1,1,0,1,0,0,0,2,0.0,2,3,0,3,0,1,2,0,0,2023-2024,90.0,0.0,81.81818181818181
749,Giulio Donati,ITA,DF,Monza,Serie A,33,1990,0.4,0,0,0,0,0,0,0,0.0,0,0,0,0,0,0,1,1,0,2023-2024,90.0,0.0,0.0
750,Jamie Donley,ENG,FW,Tottenham,Premier League,18,2005,0.0,0,0,0,0,0,0,0,0.0,0,0,0,0,0,0,3,0,0,2023-2024,,,
Rk,Player,Nation,Pos,Squad,Comp,0,0,90.0,0,0,3,3,3,Tkl,0,0.0,0,0,0,0,0,0,0,0,0,2023-2024,90.0,0.0,0.0
751,Gianluigi Donnarumma,ITA,GK,Paris S-G,Ligue 1,24,1999,24.1,0,0,0,0,0,0,0,0.0,0,0,0,0,1,1,9,4,0,2023-2024,90.0,3.7344398340248963,0.0
752,Patrick Dorgu,DEN,"DF,MF",Lecce,Serie A,18,2004,17.4,43,22,22,17,4,22,34,64.7,12,16,5,11,9,52,45,2,0,2023-2024,90.0,46.55172413793103,222.41379310344828
753,Niklas Dorsch,GER,MF,Augsburg,Bundesliga,25,1998,15.4,35,24,13,21,1,13,33,39.4,20,15,9,6,16,51,27,0,0,2023-2024,90.0,93.50649350649351,204.54545454545456
754,Alberto Dossena,ITA,DF,Cagliari,Serie A,24,1998,33.1,55,35,43,12,0,32,48,66.7,16,50,27,23,45,100,172,2,0,2023-2024,90.0,122.35649546827793,149.54682779456192
755,Carlos Dotor,ESP,MF,Celta Vigo,La Liga,22,2001,7.9,14,7,3,8,3,4,13,30.8,9,12,2,10,4,18,4,0,0,2023-2024,90.0,45.56962025316455,159.49367088607593
756,Abdoulaye Doucouré,MLI,"FW,MF",Everton,Premier League,30,1993,29.2,43,27,20,14,9,18,46,39.1,28,23,3,20,15,58,19,0,0,2023-2024,90.0,46.23287671232877,132.53424657534248
757,Cheick Doucouré,MLI,MF,Crystal Palace,Premier League,23,2000,10.2,34,17,15,13,6,18,30,60.0,12,13,2,11,20,54,12,0,0,2023-2024,90.0,176.47058823529412,300.0
758,Siriné Doucouré,MLI,FW,Lorient,Ligue 1,21,2002,4.7,8,6,0,4,4,3,3,100.0,0,4,0,4,1,9,6,0,0,2023-2024,90.0,19.148936170212764,153.1914893617021
759,Désiré Doué,FRA,"MF,FW",Rennes,Ligue 1,18,2005,18.1,32,18,11,14,7,10,33,30.3,23,30,1,29,14,46,8,0,0,2023-2024,90.0,69.61325966850828,159.1160220994475
760,Guela Doué,CIV,DF,Rennes,Ligue 1,20,2002,13.7,28,21,14,12,2,22,32,68.8,10,12,1,11,15,43,65,1,0,2023-2024,90.0,98.54014598540147,183.94160583941607
761,Alfie Doughty,ENG,DF,Luton Town,Premier League,23,1999,32.5,63,40,29,18,16,37,82,45.1,45,51,9,42,31,94,43,4,0,2023-2024,90.0,85.84615384615385,174.46153846153845
762,Douglas,BRA,MF,Nantes,Ligue 1,26,1997,19.7,70,42,34,30,6,30,59,50.8,29,22,8,14,26,96,30,0,0,2023-2024,90.0,118.78172588832487,319.79695431472084
763,Ismaël Doukouré,FRA,"MF,DF",Strasbourg,Ligue 1,20,2003,18.4,23,16,7,14,2,13,21,61.9,8,19,7,12,19,42,29,2,0,2023-2024,90.0,92.93478260869566,112.50000000000001
764,Kamory Doumbia,MLI,MF,Brest,Ligue 1,20,2003,9.8,28,18,8,10,10,10,29,34.5,19,14,0,14,9,37,6,0,0,2023-2024,90.0,82.65306122448979,257.1428571428571
765,Anastasios Douvikas,GRE,FW,Celta Vigo,La Liga,23,1999,10.1,15,7,2,6,7,3,8,37.5,5,6,3,3,2,17,9,0,0,2023-2024,90.0,17.821782178217823,133.66336633663366
766,Artem Dovbyk,UKR,FW,Girona,La Liga,26,1997,28.7,4,3,2,1,1,0,2,0.0,2,8,1,7,0,4,17,0,0,2023-2024,90.0,0.0,12.543554006968641
767,Nikola Dovedan,AUT,"MF,FW",Heidenheim,Bundesliga,29,1994,7.3,14,9,2,10,2,5,25,20.0,20,9,0,9,1,15,3,0,0,2023-2024,90.0,12.328767123287673,172.6027397260274
768,Damion Downs,USA,"FW,MF",Köln,Bundesliga,19,2004,2.0,1,1,1,0,0,1,2,50.0,1,1,0,1,0,1,1,0,0,2023-2024,90.0,0.0,45.0
769,Tommy Doyle,ENG,MF,Wolves,Premier League,21,2001,13.6,26,13,11,10,5,14,23,60.9,9,22,9,13,12,38,18,0,0,2023-2024,90.0,79.41176470588235,172.05882352941177
770,Radu Drăgușin,ROU,DF,Tottenham,Premier League,21,2002,4.8,5,3,5,0,0,3,3,100.0,0,5,4,1,8,13,19,0,0,2023-2024,90.0,150.0,93.75
771,Radu Drăgușin,ROU,DF,Genoa,Serie A,21,2002,19.0,16,11,9,6,1,8,9,88.9,1,18,12,6,21,37,87,3,0,2023-2024,90.0,99.47368421052632,75.78947368421052
772,Dion Drena Beljo,CRO,"FW,MF",Augsburg,Bundesliga,21,2002,6.5,0,0,0,0,0,0,2,0.0,2,8,1,7,1,1,4,0,0,2023-2024,90.00000000000001,13.846153846153847,0.0
773,Tim Drexler,GER,DF,Hoffenheim,Bundesliga,18,2005,6.4,16,9,12,4,0,8,17,47.1,9,12,8,4,8,24,14,0,0,2023-2024,90.0,112.5,225.0
774,Domingos Duarte,POR,DF,Getafe,La Liga,28,1995,10.1,7,4,6,0,1,5,7,71.4,2,7,5,2,8,15,27,0,0,2023-2024,90.0,71.2871287128713,62.37623762376238
775,Rubén Duarte,ESP,DF,Alavés,La Liga,27,1995,20.9,39,20,21,16,2,21,31,67.7,10,21,6,15,23,62,69,0,0,2023-2024,90.0,99.04306220095694,167.94258373205741
Rk,Player,Nation,Pos,Squad,Comp,0,0,90.0,0,0,3,3,3,Tkl,0,0.0,0,0,0,0,0,0,0,0,0,2023-2024,90.0,0.0,0.0
776,Martin Dúbravka,SVK,GK,Newcastle Utd,Premier League,34,1989,22.1,0,0,0,0,0,0,4,0.0,4,0,0,0,0,0,8,1,0,2023-2024,90.0,0.0,0.0
777,Marvin Ducksch,GER,FW,Werder Bremen,Bundesliga,29,1994,30.0,8,3,4,3,1,6,14,42.9,8,2,0,2,4,12,25,0,0,2023-2024,90.0,12.0,24.0
778,Ondrej Duda,SVK,MF,Hellas Verona,Serie A,28,1994,27.3,59,39,17,35,7,31,52,59.6,21,29,12,17,26,85,21,0,0,2023-2024,90.0,85.71428571428571,194.5054945054945
779,Denzel Dumfries,NED,DF,Inter,Serie A,27,1996,18.2,22,13,9,11,2,9,23,39.1,14,15,6,9,12,34,33,1,0,2023-2024,90.0,59.34065934065934,108.79120879120879
780,Paul Dummett,WAL,DF,Newcastle Utd,Premier League,31,1991,0.2,1,0,1,0,0,1,1,100.0,0,0,0,0,0,1,1,0,0,2023-2024,90.0,0.0,450.0
781,Alfred Duncan,GHA,MF,Fiorentina,Serie A,30,1993,21.0,35,22,13,15,7,15,35,42.9,20,27,5,22,11,46,13,0,0,2023-2024,90.0,47.14285714285714,150.0
782,Lewis Dunk,ENG,DF,Brighton,Premier League,31,1991,31.9,27,14,17,9,1,13,36,36.1,23,49,37,12,31,58,90,1,0,2023-2024,90.0,87.46081504702194,76.17554858934169
783,Jhon Durán,COL,"FW,MF",Aston Villa,Premier League,19,2003,5.3,6,5,3,1,2,1,6,16.7,5,6,0,6,1,7,10,0,0,2023-2024,90.0,16.9811320754717,101.88679245283019
784,Julien Duranville,BEL,"FW,MF",Dortmund,Bundesliga,17,2006,0.1,1,0,0,1,0,1,1,100.0,0,0,0,0,0,1,0,0,0,2023-2024,90.0,0.0,900.0
785,Hugo Duro,ESP,FW,Valencia,La Liga,23,1999,33.1,16,8,5,8,3,9,29,31.0,20,24,5,19,5,21,27,0,0,2023-2024,90.0,13.595166163141993,43.504531722054374
786,Jean-Kevin Duverne,HAI,DF,Nantes,Ligue 1,26,1997,15.0,37,19,16,17,4,18,44,40.9,26,17,5,12,18,55,34,0,0,2023-2024,90.0,108.0,222.0
787,Paulo Dybala,ARG,"FW,MF",Roma,Serie A,29,1993,21.8,22,13,3,10,9,2,18,11.1,16,12,0,12,3,25,6,1,0,2023-2024,90.0,12.38532110091743,90.82568807339449
788,Aron Dønnum,NOR,"FW,MF",Toulouse,Ligue 1,25,1998,17.7,16,10,3,8,5,7,22,31.8,15,13,0,13,8,24,16,1,0,2023-2024,90.0,40.67796610169492,81.35593220338984
789,George Earthy,ENG,FW,West Ham,Premier League,18,2004,0.4,0,0,0,0,0,0,1,0.0,1,0,0,0,1,1,0,0,0,2023-2024,90.0,225.0,0.0
790,Simon Ebonog,CMR,MF,Le Havre,Ligue 1,18,2004,0.2,1,1,0,1,0,1,1,100.0,0,1,1,0,0,1,1,0,0,2023-2024,90.0,0.0,450.0
791,Festy Ebosele,IRL,DF,Udinese,Serie A,20,2002,18.9,33,20,23,9,1,21,35,60.0,14,33,2,31,10,43,27,0,0,2023-2024,90.0,47.61904761904762,157.14285714285714
792,Enzo Ebosse,CMR,DF,Udinese,Serie A,24,1999,0.1,1,1,1,0,0,0,1,0.0,1,0,0,0,1,2,0,0,0,2023-2024,90.0,900.0,900.0
793,Tyronne Ebuehi,NGA,DF,Empoli,Serie A,27,1995,12.2,14,9,9,5,0,7,11,63.6,4,9,4,5,6,20,27,1,0,2023-2024,90.0,44.26229508196722,103.27868852459018
794,Ederson,BRA,GK,Manchester City,Premier League,29,1993,30.9,0,0,0,0,0,0,1,0.0,1,0,0,0,0,0,10,1,0,2023-2024,90.0,0.0,0.0
795,Éderson,BRA,MF,Atalanta,Serie A,24,1999,31.9,83,49,38,38,7,44,63,69.8,19,48,8,40,41,124,33,1,0,2023-2024,90.0,115.67398119122257,234.1692789968652
796,Odsonne Édouard,FRA,"FW,MF",Crystal Palace,Premier League,25,1998,17.3,24,12,8,8,8,4,19,21.1,15,17,1,16,6,30,19,0,0,2023-2024,90.0,31.21387283236994,124.85549132947976
797,John Egan,IRL,DF,Sheffield Utd,Premier League,30,1992,5.4,6,4,4,2,0,4,11,36.4,7,10,4,6,13,19,39,1,0,2023-2024,90.0,216.66666666666666,99.99999999999999
798,Maximilian Eggestein,GER,MF,Freiburg,Bundesliga,26,1996,32.4,49,24,25,19,5,15,36,41.7,21,53,19,34,28,77,40,1,0,2023-2024,90.0,77.77777777777779,136.11111111111111
799,Lilian Egloff,GER,"MF,DF",Stuttgart,Bundesliga,20,2002,1.2,4,1,3,1,0,2,4,50.0,2,3,1,2,1,5,0,0,0,2023-2024,90.0,75.0,300.0
800,Kingsley Ehizibue,NED,DF,Udinese,Serie A,28,1995,10.6,22,14,16,4,2,11,18,61.1,7,21,3,18,8,30,36,0,0,2023-2024,90.0,67.9245283018868,186.7924528301887
Rk,Player,Nation,Pos,Squad,Comp,0,0,90.0,0,0,3,3,3,Tkl,0,0.0,0,0,0,0,0,0,0,0,0,2023-2024,90.0,0.0,0.0
801,Hjalmar Ekdal,SWE,DF,Burnley,Premier League,24,1998,4.9,4,2,2,2,0,2,4,50.0,2,10,5,5,6,10,21,0,0,2023-2024,90.0,110.20408163265306,73.46938775510203
802,Hugo Ekitike,FRA,FW,Paris S-G,Ligue 1,21,2002,0.1,0,0,0,0,0,0,0,0.0,0,0,0,0,0,0,0,0,0,2023-2024,90.0,0.0,0.0
803,Hugo Ekitike,FRA,FW,Eint Frankfurt,Bundesliga,21,2002,8.0,11,7,3,6,2,4,6,66.7,2,10,0,10,2,13,4,0,0,2023-2024,90.0,22.5,123.75
804,Emmanuel Ekong,SWE,FW,Empoli,Serie A,21,2002,0.1,0,0,0,0,0,0,0,0.0,0,0,0,0,0,0,0,0,0,2023-2024,90.0,0.0,0.0
805,Caleb Ekuban,GHA,FW,Genoa,Serie A,29,1994,12.6,8,4,2,4,2,5,9,55.6,4,11,3,8,1,9,7,0,0,2023-2024,90.0,7.142857142857143,57.142857142857146
806,Anthony Elanga,SWE,"FW,MF",Nott'ham Forest,Premier League,21,2002,27.0,33,19,20,6,7,17,36,47.2,19,22,2,20,8,41,20,1,0,2023-2024,90.0,26.666666666666668,110.0
807,Simon Elisor,FRA,FW,Metz,Ligue 1,24,1999,8.5,9,2,3,2,4,2,6,33.3,4,6,1,5,0,9,9,0,0,2023-2024,90.0,0.0,95.29411764705883
808,Harvey Elliott,ENG,"MF,FW",Liverpool,Premier League,20,2003,15.0,27,17,8,14,5,10,31,32.3,21,27,0,27,6,33,7,0,0,2023-2024,90.0,36.0,162.0
809,Elif Elmas,MKD,"FW,MF",Napoli,Serie A,23,1999,3.8,4,3,1,3,0,2,2,100.0,0,2,0,2,2,6,8,0,0,2023-2024,90.0,47.368421052631575,94.73684210526315
810,Elif Elmas,MKD,"MF,FW",RB Leipzig,Bundesliga,23,1999,3.0,8,6,1,6,1,6,8,75.0,2,5,0,5,1,9,2,0,0,2023-2024,90.0,30.0,240.0
811,Mohamed Elneny,EGY,MF,Arsenal,Premier League,31,1992,0.3,0,0,0,0,0,0,1,0.0,1,0,0,0,1,1,0,0,0,2023-2024,90.0,300.0,0.0
812,Aritz Elustondo,ESP,DF,Real Sociedad,La Liga,29,1994,9.0,11,7,5,4,2,6,14,42.9,8,12,10,2,7,18,26,0,0,2023-2024,90.0,70.0,110.0
813,Nico Elvedi,SUI,DF,Gladbach,Bundesliga,26,1996,27.6,33,18,22,10,1,18,24,75.0,6,40,25,15,43,76,150,2,0,2023-2024,90.0,140.2173913043478,107.6086956521739
814,Adri Embarba,ESP,"FW,MF",Almería,La Liga,31,1992,27.5,55,37,29,15,11,26,53,49.1,27,37,1,36,15,70,12,0,0,2023-2024,89.99999999999999,49.090909090909086,179.99999999999997
815,Breel Embolo,SUI,FW,Monaco,Ligue 1,26,1997,2.0,3,3,0,2,1,1,4,25.0,3,1,0,1,1,4,2,0,0,2023-2024,90.0,45.0,135.0
816,Emanuel Emegha,NED,FW,Strasbourg,Ligue 1,20,2003,23.1,8,5,2,4,2,4,9,44.4,5,13,3,10,2,10,25,0,0,2023-2024,89.99999999999999,7.792207792207791,31.168831168831165
817,Emerson,BRA,DF,Tottenham,Premier League,24,1999,12.9,36,24,23,10,3,21,43,48.8,22,23,10,13,20,56,50,1,0,2023-2024,90.0,139.53488372093022,251.1627906976744
818,Youssef En-Nesyri,MAR,FW,Sevilla,La Liga,26,1997,28.6,10,7,3,4,3,0,10,0.0,10,9,1,8,7,17,29,1,0,2023-2024,90.0,22.02797202797203,31.46853146853147
819,Julio Enciso,PAR,"MF,FW",Brighton,Premier League,19,2004,5.3,6,2,3,2,1,2,7,28.6,5,11,0,11,0,6,3,0,0,2023-2024,90.0,0.0,101.88679245283019
820,Wataru Endo,JPN,MF,Liverpool,Premier League,30,1993,19.1,48,28,11,31,6,20,61,32.8,41,24,2,22,20,68,31,3,0,2023-2024,90.0,94.24083769633508,226.17801047120417
821,Arne Engels,BEL,"MF,DF",Augsburg,Bundesliga,19,2003,15.6,33,18,15,14,4,12,29,41.4,17,23,1,22,15,48,21,0,0,2023-2024,90.0,86.53846153846153,190.3846153846154
822,Christian Eriksen,DEN,MF,Manchester Utd,Premier League,31,1992,12.7,18,13,5,10,3,12,33,36.4,21,17,6,11,4,22,13,0,0,2023-2024,90.0,28.34645669291339,127.55905511811024
823,Martin Erlic,CRO,DF,Sassuolo,Serie A,25,1998,29.1,37,22,26,8,3,20,30,66.7,10,31,16,15,28,65,128,1,0,2023-2024,90.0,86.59793814432989,114.43298969072164
824,Gonzalo Escalante,ARG,MF,Cádiz,La Liga,30,1993,18.9,39,24,16,14,9,20,55,36.4,35,23,5,18,26,65,33,2,0,2023-2024,90.0,123.80952380952381,185.71428571428572
825,Aarón Escandell,ESP,GK,Las Palmas,La Liga,27,1995,1.7,0,0,0,0,0,0,0,0.0,0,0,0,0,0,0,1,1,0,2023-2024,90.0,0.0,0.0
Rk,Player,Nation,Pos,Squad,Comp,0,0,90.0,0,0,3,3,3,Tkl,0,0.0,0,0,0,0,0,0,0,0,0,2023-2024,90.0,0.0,0.0
826,Alfonso Espino,URU,DF,Rayo Vallecano,La Liga,31,1992,27.9,67,45,43,22,2,30,82,36.6,52,26,4,22,40,107,63,0,0,2023-2024,90.0,129.03225806451613,216.1290322580645
827,Bernardo Espinosa,COL,DF,Girona,La Liga,34,1989,0.0,1,1,1,0,0,1,1,100.0,0,0,0,0,0,1,2,0,0,2023-2024,,,inf
828,Maxime Estève,FRA,DF,Burnley,Premier League,21,2002,14.5,27,10,15,12,0,18,32,56.3,14,21,10,11,27,54,56,0,0,2023-2024,90.0,167.58620689655172,167.58620689655172
829,Maxime Estève,FRA,DF,Montpellier,Ligue 1,21,2002,11.1,16,12,11,5,0,10,15,66.7,5,13,9,4,18,34,50,0,0,2023-2024,90.0,145.94594594594597,129.72972972972974
830,Oscar Estupiñan,COL,FW,Metz,Ligue 1,26,1996,2.9,5,4,0,3,2,1,2,50.0,1,2,0,2,0,5,0,0,0,2023-2024,90.0,0.0,155.17241379310346
831,Pervis Estupiñán,ECU,DF,Brighton,Premier League,25,1998,13.8,26,13,12,11,3,14,30,46.7,16,14,4,10,21,47,20,0,0,2023-2024,90.0,136.9565217391304,169.56521739130434
832,Karl Etta,CMR,FW,Cádiz,La Liga,19,2004,0.2,1,1,0,1,0,0,0,0.0,0,0,0,0,0,1,0,0,0,2023-2024,90.0,0.0,450.0
833,Jonny Evans,NIR,DF,Manchester Utd,Premier League,35,1988,15.5,22,14,20,2,0,12,21,57.1,9,25,18,7,23,45,76,0,0,2023-2024,90.0,133.5483870967742,127.74193548387098
834,Eberechi Eze,ENG,"MF,FW",Crystal Palace,Premier League,25,1998,22.8,35,17,4,18,13,15,31,48.4,16,27,2,25,11,46,6,0,0,2023-2024,90.0,43.421052631578945,138.15789473684208
835,Abde Ezzalzouli,MAR,"FW,MF",Barcelona,La Liga,21,2001,0.8,1,1,0,0,1,0,1,0.0,1,1,0,1,0,1,0,0,0,2023-2024,90.0,0.0,112.5
836,Abde Ezzalzouli,MAR,FW,Betis,La Liga,21,2001,9.6,17,14,7,5,5,4,14,28.6,10,10,0,10,5,22,5,0,0,2023-2024,90.0,46.875,159.375
837,Giovanni Fabbian,ITA,"MF,FW",Bologna,Serie A,20,2003,11.7,17,10,9,7,1,7,12,58.3,5,5,2,3,7,24,11,0,0,2023-2024,89.99999999999999,53.84615384615385,130.76923076923077
838,Łukasz Fabiański,POL,GK,West Ham,Premier League,38,1985,8.0,1,0,1,0,0,1,2,50.0,1,0,0,0,1,2,4,0,0,2023-2024,90.0,11.25,11.25
839,Nicolò Fagioli,ITA,MF,Juventus,Serie A,22,2001,4.9,5,3,1,3,1,3,7,42.9,4,3,0,3,4,9,1,0,0,2023-2024,90.0,73.46938775510203,91.83673469387755
840,Romain Faivre,FRA,"MF,FW",Bournemouth,Premier League,25,1998,0.5,1,1,0,1,0,0,3,0.0,3,0,0,0,0,1,0,0,0,2023-2024,90.0,0.0,180.0
841,Romain Faivre,FRA,"MF,FW",Lorient,Ligue 1,25,1998,16.1,13,6,5,4,4,6,15,40.0,9,6,1,5,7,20,3,1,0,2023-2024,90.0,39.130434782608695,72.67080745341615
842,Ilhan Fakili,FRA,"MF,FW",Clermont Foot,Ligue 1,17,2006,1.0,0,0,0,0,0,0,1,0.0,1,1,0,1,1,1,0,0,0,2023-2024,90.0,90.0,0.0
843,Radamel Falcao,COL,"FW,DF",Rayo Vallecano,La Liga,37,1986,4.5,7,5,1,5,1,1,3,33.3,2,2,0,2,3,10,4,0,0,2023-2024,90.0,60.0,140.0
844,Wladimiro Falcone,ITA,GK,Lecce,Serie A,28,1995,38.0,0,0,0,0,0,0,0,0.0,0,1,0,1,1,1,21,2,0,2023-2024,90.0,2.3684210526315788,0.0
845,Fali,ESP,DF,Cádiz,La Liga,29,1993,28.3,41,26,29,11,1,21,36,58.3,15,38,24,14,27,68,120,0,0,2023-2024,90.0,85.86572438162544,130.3886925795053
846,Davide Faraoni,ITA,DF,Hellas Verona,Serie A,31,1991,6.7,13,10,5,6,2,7,10,70.0,3,9,5,4,6,19,21,0,0,2023-2024,90.0,80.59701492537313,174.62686567164178
847,Davide Faraoni,ITA,DF,Fiorentina,Serie A,31,1991,4.4,9,4,5,2,2,5,11,45.5,6,3,1,2,5,14,14,0,0,2023-2024,90.0,102.27272727272727,184.0909090909091
848,Ansu Fati,ESP,"MF,FW",Brighton,Premier League,20,2002,5.8,5,3,1,2,2,1,11,9.1,10,8,0,8,3,8,3,0,0,2023-2024,90.0,46.55172413793103,77.58620689655173
849,Ansu Fati,ESP,"MF,FW",Barcelona,La Liga,20,2002,0.6,0,0,0,0,0,0,1,0.0,1,0,0,0,0,0,0,0,0,2023-2024,90.0,0.0,0.0
850,Khalil Fayad,FRA,"FW,MF",Montpellier,Ligue 1,19,2004,11.4,28,15,17,7,4,9,22,40.9,13,15,3,12,14,42,6,0,0,2023-2024,90.0,110.52631578947367,221.05263157894734
Rk,Player,Nation,Pos,Squad,Comp,0,0,90.0,0,0,3,3,3,Tkl,0,0.0,0,0,0,0,0,0,0,0,0,2023-2024,90.0,0.0,0.0
851,Federico Fazio,ARG,DF,Salernitana,Serie A,36,1987,15.1,18,11,14,4,0,8,14,57.1,6,22,19,3,17,35,99,1,0,2023-2024,90.0,101.32450331125828,107.28476821192054
852,Jacopo Fazzini,ITA,MF,Empoli,Serie A,20,2003,13.7,49,25,27,13,9,30,53,56.6,23,21,3,18,12,61,18,0,0,2023-2024,90.0,78.83211678832117,321.8978102189781
853,Peter Federico,DOM,"MF,FW",Valencia,La Liga,21,2002,7.2,5,3,3,1,1,1,10,10.0,9,11,0,11,7,12,10,0,0,2023-2024,90.0,87.5,62.5
854,Nabil Fekir,FRA,"MF,FW",Betis,La Liga,30,1993,11.7,15,10,5,7,3,5,10,50.0,5,9,0,9,7,22,3,0,0,2023-2024,89.99999999999999,53.84615384615385,115.38461538461539
855,Felipe,BRA,DF,Nott'ham Forest,Premier League,34,1989,4.2,12,9,9,3,0,9,12,75.0,3,4,1,3,4,16,12,0,0,2023-2024,90.0,85.71428571428571,257.1428571428571
856,Luiz Felipe,ITA,DF,Betis,La Liga,26,1997,4.0,7,3,5,2,0,4,5,80.0,1,10,4,6,4,11,16,0,0,2023-2024,90.0,90.0,157.5
857,João Félix,POR,FW,Barcelona,La Liga,23,1999,17.1,22,16,9,7,6,8,22,36.4,14,14,1,13,10,32,11,0,0,2023-2024,90.0,52.63157894736842,115.78947368421052
858,Ohis Felix Uduokhai,GER,DF,Augsburg,Bundesliga,25,1997,32.5,37,21,18,14,5,16,25,64.0,9,45,35,10,46,83,178,2,0,2023-2024,90.0,127.38461538461539,102.46153846153847
859,Kiko Femenía,ESP,DF,Villarreal,La Liga,32,1991,17.6,35,25,19,13,3,19,34,55.9,15,21,6,15,31,66,45,0,0,2023-2024,90.0,158.52272727272725,178.97727272727272
860,Evan Ferguson,IRL,FW,Brighton,Premier League,18,2004,15.2,14,6,4,7,3,5,14,35.7,9,10,3,7,2,16,8,0,0,2023-2024,90.0,11.842105263157894,82.89473684210526
861,Lewis Ferguson,SCO,MF,Bologna,Serie A,23,1999,30.1,37,21,16,17,4,16,37,43.2,21,25,8,17,17,54,27,1,0,2023-2024,90.00000000000001,50.83056478405316,110.6312292358804
862,Bruno Fernandes,POR,"MF,FW",Manchester Utd,Premier League,28,1994,34.6,68,38,27,25,16,30,88,34.1,58,49,6,43,27,95,50,2,0,2023-2024,90.0,70.23121387283237,176.878612716763
863,Edimilson Fernandes,SUI,DF,Mainz 05,Bundesliga,27,1996,14.3,25,16,15,9,1,16,24,66.7,8,14,6,8,22,47,52,0,0,2023-2024,90.0,138.46153846153845,157.34265734265733
864,Aitor Fernández,ESP,GK,Osasuna,La Liga,32,1991,6.1,0,0,0,0,0,0,1,0.0,1,0,0,0,0,0,5,1,0,2023-2024,90.0,0.0,0.0
865,Álex Fernández,ESP,MF,Cádiz,La Liga,30,1992,14.3,19,9,10,9,0,11,22,50.0,11,17,5,12,15,34,30,0,0,2023-2024,90.0,94.40559440559441,119.58041958041959
866,Carlos Fernández,ESP,FW,Real Sociedad,La Liga,27,1996,4.5,11,7,3,6,2,0,2,0.0,2,4,0,4,0,11,5,0,0,2023-2024,90.0,0.0,220.0
867,Enzo Fernández,ARG,MF,Chelsea,Premier League,22,2001,24.5,50,22,22,18,10,27,65,41.5,38,36,13,23,17,67,28,0,0,2023-2024,90.00000000000001,62.44897959183674,183.67346938775512
868,Raúl Fernández,ESP,GK,Granada,La Liga,35,1988,3.1,0,0,0,0,0,0,1,0.0,1,0,0,0,0,0,1,2,0,2023-2024,90.0,0.0,0.0
869,Valery Fernández,ESP,"MF,FW",Girona,La Liga,23,1999,5.6,11,9,4,7,0,6,8,75.0,2,6,1,5,1,12,4,0,0,2023-2024,90.0,16.071428571428573,176.78571428571428
870,Fernando,ESP,GK,Almería,La Liga,33,1990,4.0,0,0,0,0,0,0,0,0.0,0,1,0,1,0,0,2,0,0,2023-2024,90.0,0.0,0.0
871,Fernando,BRA,MF,Sevilla,La Liga,36,1987,5.1,9,8,2,4,3,5,9,55.6,4,2,0,2,7,16,9,0,0,2023-2024,90.0,123.52941176470588,158.82352941176472
872,Ichem Ferrah,FRA,FW,Lille,Ligue 1,17,2005,0.0,0,0,0,0,0,0,0,0.0,0,0,0,0,0,0,0,0,0,2023-2024,,,
873,Andrea Ferraris,ITA,MF,Monza,Serie A,20,2003,0.1,1,1,1,0,0,0,0,0.0,0,0,0,0,0,1,0,0,0,2023-2024,90.0,0.0,900.0
874,André Ferreira,POR,GK,Granada,La Liga,27,1996,14.9,0,0,0,0,0,0,1,0.0,1,0,0,0,0,0,9,2,0,2023-2024,90.0,0.0,0.0
875,João Ferreira,POR,DF,Udinese,Serie A,22,2001,20.2,58,42,36,18,4,34,58,58.6,24,27,6,21,29,87,89,0,0,2023-2024,90.0,129.2079207920792,258.4158415841584
Rk,Player,Nation,Pos,Squad,Comp,0,0,90.0,0,0,3,3,3,Tkl,0,0.0,0,0,0,0,0,0,0,0,0,2023-2024,90.0,0.0,0.0
876,Jordan Ferri,FRA,MF,Montpellier,Ligue 1,31,1992,22.6,36,22,16,17,3,20,67,29.9,47,19,1,18,13,49,23,0,0,2023-2024,90.0,51.769911504424776,143.36283185840708
877,Nacho Ferri,ESP,"FW,MF",Eint Frankfurt,Bundesliga,18,2004,0.8,3,3,1,2,0,2,3,66.7,1,0,0,0,0,3,2,0,0,2023-2024,90.0,0.0,337.5
878,Rachad Fettal,MAR,FW,Almería,La Liga,18,2005,0.2,1,1,1,0,0,0,0,0.0,0,0,0,0,0,1,0,0,0,2023-2024,90.0,0.0,450.0
879,Seydou Fini,ITA,"DF,FW",Genoa,Serie A,17,2006,0.4,0,0,0,0,0,0,0,0.0,0,0,0,0,0,0,0,0,0,2023-2024,90.0,0.0,0.0
880,Max Finkgräfe,GER,"DF,FW",Köln,Bundesliga,19,2004,19.5,65,39,40,25,0,39,74,52.7,35,35,10,25,22,87,39,0,0,2023-2024,90.0,101.53846153846153,300.0
881,Vincenzo Fiorillo,ITA,GK,Salernitana,Serie A,33,1990,4.0,0,0,0,0,0,0,0,0.0,0,0,0,0,0,0,0,1,0,2023-2024,90.0,0.0,0.0
882,Kilian Fischer,GER,"DF,MF",Wolfsburg,Bundesliga,22,2000,3.2,8,6,4,3,1,2,5,40.0,3,8,1,7,1,9,12,0,0,2023-2024,90.0,28.125,225.0
883,John Fleck,SCO,"MF,DF",Sheffield Utd,Premier League,31,1991,1.0,1,0,0,1,0,0,1,0.0,1,0,0,0,0,1,1,0,0,2023-2024,90.0,0.0,90.0
884,Mark Flekken,NED,GK,Brentford,Premier League,30,1993,36.5,1,1,1,0,0,1,5,20.0,4,1,0,1,0,1,17,1,0,2023-2024,90.0,0.0,2.4657534246575343
885,Alessandro Florenzi,ITA,DF,Milan,Serie A,32,1991,19.2,43,21,26,12,5,26,48,54.2,22,16,9,7,20,63,25,1,0,2023-2024,90.0,93.75,201.5625
886,Phil Foden,ENG,"FW,MF",Manchester City,Premier League,23,2000,31.7,31,20,11,10,10,13,31,41.9,18,30,0,30,13,44,18,1,0,2023-2024,90.0,36.90851735015773,88.01261829652996
887,Wes Foderingham,ENG,GK,Sheffield Utd,Premier League,32,1991,29.4,5,3,5,0,0,5,6,83.3,1,0,0,0,0,5,18,6,0,2023-2024,90.0,0.0,15.306122448979592
888,Malick Fofana,BEL,FW,Lyon,Ligue 1,18,2005,6.2,5,4,3,1,1,4,9,44.4,5,3,0,3,5,10,9,0,0,2023-2024,90.0,72.58064516129032,72.58064516129032
889,Youssouf Fofana,FRA,MF,Monaco,Ligue 1,24,1999,30.0,61,39,19,36,6,30,66,45.5,36,35,7,28,37,98,31,1,0,2023-2024,90.0,111.0,183.0
890,Jonas Föhrenbach,GER,DF,Heidenheim,Bundesliga,27,1996,31.0,44,24,24,14,6,19,36,52.8,17,34,19,15,31,75,70,0,0,2023-2024,90.0,90.0,127.74193548387098
891,Thomas Foket,BEL,DF,Reims,Ligue 1,28,1994,20.4,32,17,21,8,3,20,45,44.4,25,34,12,22,25,57,36,0,0,2023-2024,90.0,110.29411764705883,141.1764705882353
892,Michael Folorunsho,ITA,"MF,FW",Hellas Verona,Serie A,25,1998,30.9,50,28,21,22,7,23,57,40.4,34,45,12,33,17,67,44,2,0,2023-2024,90.0,49.51456310679612,145.63106796116506
893,Tiago Fonseca Morais,POR,FW,Lille,Ligue 1,19,2003,0.5,1,1,0,1,0,0,0,0.0,0,0,0,0,1,2,0,0,0,2023-2024,90.0,180.0,180.0
894,Pablo Fornals,ESP,"MF,FW",West Ham,Premier League,27,1996,4.7,10,6,4,3,3,5,16,31.3,11,8,1,7,6,16,7,0,0,2023-2024,90.0,114.89361702127658,191.48936170212764
895,Pablo Fornals,ESP,"FW,MF",Betis,La Liga,27,1996,12.8,24,16,8,11,5,12,22,54.5,10,14,0,14,22,46,10,2,0,2023-2024,90.0,154.6875,168.75
896,Emil Forsberg,SWE,"MF,FW",RB Leipzig,Bundesliga,31,1991,5.2,7,3,2,5,0,5,12,41.7,7,7,0,7,0,7,5,0,0,2023-2024,90.0,0.0,121.15384615384615
897,Omari Forson,ENG,FW,Manchester Utd,Premier League,19,2004,0.8,2,0,0,2,0,1,1,100.0,0,0,0,0,0,2,0,0,0,2023-2024,90.0,0.0,225.0
898,Philipp Förster,GER,"MF,FW",Bochum,Bundesliga,28,1995,4.3,9,5,3,4,2,2,6,33.3,4,3,0,3,7,16,3,0,0,2023-2024,90.0,146.51162790697677,188.37209302325584
899,Héctor Fort,ESP,DF,Barcelona,La Liga,16,2006,3.5,6,5,5,1,0,4,10,40.0,6,0,0,0,2,8,4,0,0,2023-2024,90.0,51.42857142857143,154.28571428571428
900,Lyle Foster,RSA,"FW,MF",Burnley,Premier League,22,2000,21.1,19,10,5,6,8,6,17,35.3,11,13,3,10,3,22,34,0,0,2023-2024,90.0,12.796208530805687,81.04265402843602
Rk,Player,Nation,Pos,Squad,Comp,0,0,90.0,0,0,3,3,3,Tkl,0,0.0,0,0,0,0,0,0,0,0,0,2023-2024,90.0,0.0,0.0
901,Dimitri Foulquier,FRA,"DF,MF",Valencia,La Liga,30,1993,20.5,39,22,22,13,4,18,26,69.2,8,10,1,9,16,55,49,1,0,2023-2024,90.0,70.2439024390244,171.21951219512195
902,Juan Foyth,ARG,DF,Villarreal,La Liga,25,1998,11.8,26,15,18,8,0,12,27,44.4,15,17,4,13,12,38,44,0,0,2023-2024,90.0,91.52542372881355,198.30508474576268
903,Matheus França,BRA,"MF,FW",Crystal Palace,Premier League,19,2004,2.6,3,3,2,1,0,1,7,14.3,6,4,0,4,1,4,1,0,0,2023-2024,90.0,34.61538461538461,103.84615384615384
904,Bartol Franjić,CRO,MF,Darmstadt 98,Bundesliga,23,2000,13.7,15,12,4,10,1,7,28,25.0,21,12,4,8,30,45,29,2,0,2023-2024,90.0,197.08029197080293,98.54014598540147
905,Przemysław Frankowski,POL,DF,Lens,Ligue 1,28,1995,24.4,60,39,25,26,9,31,74,41.9,43,30,7,23,25,85,36,0,0,2023-2024,90.0,92.21311475409837,221.31147540983608
906,Nathan Fraser,IRL,FW,Wolves,Premier League,18,2005,2.1,5,2,2,1,2,1,3,33.3,2,2,1,1,1,6,2,0,0,2023-2024,90.0,42.857142857142854,214.28571428571428
907,Davide Frattesi,ITA,MF,Inter,Serie A,23,1999,10.6,10,6,3,7,0,4,8,50.0,4,9,3,6,5,15,19,0,0,2023-2024,90.0,42.45283018867925,84.9056603773585
908,Jean Frederic N'Guessan,CIV,"MF,FW",Metz,Ligue 1,20,2003,1.2,3,1,0,3,0,0,3,0.0,3,3,0,3,1,4,0,0,0,2023-2024,90.0,75.0,225.00000000000003
909,Morten Frendrup,DEN,MF,Genoa,Serie A,22,2001,34.9,133,72,47,70,16,55,91,60.4,36,55,14,41,51,184,42,1,0,2023-2024,90.0,131.5186246418338,342.9799426934097
910,Remo Freuler,SUI,MF,Bologna,Serie A,31,1992,29.2,78,50,41,32,5,38,69,55.1,31,37,9,28,36,114,53,2,0,2023-2024,90.0,110.95890410958904,240.4109589041096
911,Marco Friedl,AUT,DF,Werder Bremen,Bundesliga,25,1998,24.4,53,32,38,15,0,36,48,75.0,12,45,29,16,35,88,129,0,0,2023-2024,90.0,129.0983606557377,195.49180327868854
912,Marvin Friedrich,GER,DF,Gladbach,Bundesliga,27,1995,17.4,23,15,16,6,1,12,20,60.0,8,28,20,8,17,40,87,0,0,2023-2024,90.0,87.93103448275862,118.96551724137932
913,Jeremie Frimpong,NED,DF,Leverkusen,Bundesliga,22,2000,25.0,26,17,12,7,7,8,20,40.0,12,26,0,26,7,33,17,0,0,2023-2024,90.0,25.2,93.6
914,Jorge de Frutos,ESP,"FW,MF",Rayo Vallecano,La Liga,26,1997,17.2,19,8,5,8,6,7,22,31.8,15,12,0,12,7,26,18,0,0,2023-2024,90.0,36.62790697674419,99.4186046511628
915,Chris Führich,GER,"FW,MF",Stuttgart,Bundesliga,25,1998,28.5,30,19,6,14,10,16,37,43.2,21,31,0,31,7,37,7,0,0,2023-2024,90.0,22.105263157894736,94.73684210526316
916,Shiō Fukuda,JPN,"FW,MF",Gladbach,Bundesliga,19,2004,0.4,2,0,1,1,0,1,2,50.0,1,0,0,0,1,3,0,0,0,2023-2024,90.0,225.0,450.0
917,Angelo Fulgini,FRA,MF,Lens,Ligue 1,26,1996,15.3,23,14,6,13,4,11,19,57.9,8,22,1,21,8,31,11,0,0,2023-2024,90.0,47.05882352941176,135.2941176470588
918,Niclas Füllkrug,GER,FW,Werder Bremen,Bundesliga,30,1993,2.0,1,1,0,1,0,1,1,100.0,0,2,1,1,0,1,1,0,0,2023-2024,90.0,0.0,45.0
919,Niclas Füllkrug,GER,FW,Dortmund,Bundesliga,30,1993,24.6,7,2,1,6,0,2,8,25.0,6,17,4,13,2,9,25,0,0,2023-2024,89.99999999999999,7.317073170731707,25.60975609756097
920,Gerardo Fusco,ITA,FW,Salernitana,Serie A,18,2005,0.2,0,0,0,0,0,0,0,0.0,0,0,0,0,0,0,0,0,0,2023-2024,90.0,0.0,0.0
921,Daniel Fuzato,BRA,GK,Getafe,La Liga,26,1997,0.1,0,0,0,0,0,0,0,0.0,0,0,0,0,0,0,1,0,0,2023-2024,90.0,0.0,0.0
922,Matteo Gabbia,ITA,DF,Milan,Serie A,23,1999,14.2,29,20,15,13,1,18,24,75.0,6,11,6,5,10,39,48,0,0,2023-2024,90.0,63.38028169014085,183.80281690140848
923,Matteo Gabbia,ITA,DF,Villarreal,La Liga,23,1999,5.3,10,6,4,6,0,5,8,62.5,3,5,2,3,8,18,36,1,0,2023-2024,90.0,135.8490566037736,169.811320754717
924,Gianluca Gaetano,ITA,"FW,MF",Cagliari,Serie A,23,2000,8.3,7,4,0,4,3,2,7,28.6,5,4,0,4,3,10,4,0,0,2023-2024,90.0,32.53012048192771,75.90361445783131
925,Gianluca Gaetano,ITA,MF,Napoli,Serie A,23,2000,1.8,4,1,0,4,0,2,4,50.0,2,5,2,3,1,5,4,0,0,2023-2024,90.0,50.0,200.0
Rk,Player,Nation,Pos,Squad,Comp,0,0,90.0,0,0,3,3,3,Tkl,0,0.0,0,0,0,0,0,0,0,0,0,2023-2024,90.0,0.0,0.0
926,Roberto Gagliardini,ITA,"MF,DF",Monza,Serie A,29,1994,26.2,61,30,27,25,9,31,50,62.0,19,30,11,19,31,92,38,0,0,2023-2024,90.0,106.48854961832062,209.54198473282443
927,Cody Gakpo,NED,"FW,MF",Liverpool,Premier League,24,1999,18.3,27,17,8,14,5,8,25,32.0,17,21,4,17,14,41,7,0,0,2023-2024,90.0,68.85245901639344,132.78688524590163
928,Javi Galán,ESP,DF,Atlético Madrid,La Liga,28,1994,1.0,5,4,2,2,1,4,5,80.0,1,1,0,1,1,6,3,0,0,2023-2024,90.0,90.0,450.0
929,Javi Galán,ESP,DF,Real Sociedad,La Liga,28,1994,11.9,38,22,15,19,4,15,30,50.0,15,24,1,23,14,52,17,1,0,2023-2024,90.00000000000001,105.88235294117648,287.3949579831933
930,Iñigo Ruiz de Galarreta,ESP,MF,Athletic Club,La Liga,29,1993,23.2,49,31,15,26,8,24,49,49.0,25,18,5,13,12,61,17,0,0,2023-2024,90.0,46.55172413793103,190.08620689655172
931,Pablo Galdames Millán,CHI,"MF,DF",Genoa,Serie A,26,1996,0.1,0,0,0,0,0,0,0,0.0,0,1,0,1,0,0,0,0,0,2023-2024,90.0,0.0,0.0
932,Conor Gallagher,ENG,MF,Chelsea,Premier League,23,2000,34.8,85,52,37,31,17,33,77,42.9,44,50,11,39,43,128,34,0,0,2023-2024,90.0,111.20689655172414,219.82758620689657
933,Antonino Gallo,ITA,DF,Lecce,Serie A,23,2000,27.7,43,27,31,11,1,31,49,63.3,18,34,9,25,25,68,67,0,0,2023-2024,90.0,81.2274368231047,139.71119133574007
934,Cristian Gamboa,CRC,DF,Bochum,Bundesliga,33,1989,13.2,24,18,12,11,1,14,33,42.4,19,20,7,13,15,39,34,1,0,2023-2024,90.0,102.27272727272727,163.63636363636363
935,Kévin Gameiro,FRA,"FW,MF",Strasbourg,Ligue 1,36,1987,15.0,10,10,5,3,2,2,17,11.8,15,9,0,9,3,13,7,0,0,2023-2024,90.0,18.0,60.0
936,Idrissa Gana Gueye,SEN,MF,Everton,Premier League,33,1989,20.9,73,44,32,27,14,29,46,63.0,17,24,7,17,28,101,16,0,0,2023-2024,90.0,120.57416267942584,314.35406698564594
937,Ignatius Ganago,CMR,"FW,MF",Nantes,Ligue 1,24,1999,2.0,0,0,0,0,0,0,1,0.0,1,1,0,1,1,1,1,0,0,2023-2024,90.0,45.0,0.0
938,Aleix García,ESP,MF,Girona,La Liga,26,1997,35.5,49,28,17,26,6,28,54,51.9,26,45,17,28,36,85,53,3,0,2023-2024,90.0,91.26760563380282,124.22535211267606
939,Álvaro García,ESP,"FW,MF",Rayo Vallecano,La Liga,30,1992,27.5,34,25,15,10,9,7,34,20.6,27,35,0,35,36,70,33,0,0,2023-2024,89.99999999999999,117.81818181818181,111.27272727272727
940,Dani García,ESP,MF,Athletic Club,La Liga,33,1990,8.3,17,11,4,7,6,12,24,50.0,12,9,3,6,8,25,11,0,0,2023-2024,90.0,86.74698795180721,184.33734939759034
941,David García,ESP,DF,Osasuna,La Liga,29,1994,25.9,29,18,19,9,1,16,26,61.5,10,40,19,21,18,47,115,2,0,2023-2024,90.0,62.54826254826256,100.77220077220079
942,Eric García,ESP,DF,Barcelona,La Liga,22,2001,0.6,0,0,0,0,0,0,0,0.0,0,1,1,0,0,0,0,0,0,2023-2024,90.0,0.0,0.0
943,Eric García,ESP,DF,Girona,La Liga,22,2001,29.3,55,37,34,18,3,34,49,69.4,15,36,18,18,30,85,79,2,0,2023-2024,90.0,92.15017064846417,168.9419795221843
944,Fran Garcia,ESP,DF,Real Madrid,La Liga,23,1999,15.5,25,17,11,12,2,13,31,41.9,18,16,3,13,19,44,28,1,0,2023-2024,90.0,110.3225806451613,145.16129032258064
945,Francisco Jesús Crespo García,ESP,FW,Las Palmas,La Liga,27,1996,5.6,12,8,3,6,3,6,18,33.3,12,4,0,4,2,14,5,0,0,2023-2024,90.0,32.142857142857146,192.85714285714286
946,Gonzalo García,ESP,"FW,MF",Real Madrid,La Liga,19,2004,0.2,0,0,0,0,0,0,1,0.0,1,1,1,0,0,0,1,0,0,2023-2024,90.0,0.0,0.0
947,Jastin García,ESP,FW,Girona,La Liga,19,2004,0.4,1,0,0,0,1,0,0,0.0,0,0,0,0,0,1,1,0,0,2023-2024,90.0,0.0,225.0
948,Raúl García,ESP,"FW,MF",Athletic Club,La Liga,37,1986,4.7,9,6,2,4,3,4,9,44.4,5,10,1,9,3,12,9,0,0,2023-2024,90.0,57.44680851063829,172.3404255319149
949,Rubén García,ESP,"FW,MF",Osasuna,La Liga,30,1993,17.2,32,18,8,17,7,13,33,39.4,20,23,3,20,12,44,23,0,0,2023-2024,90.0,62.79069767441861,167.4418604651163
950,Santiago García,ESP,FW,Getafe,La Liga,21,2001,0.3,1,0,0,0,1,1,1,100.0,0,0,0,0,0,1,0,0,0,2023-2024,90.0,0.0,300.0
Rk,Player,Nation,Pos,Squad,Comp,0,0,90.0,0,0,3,3,3,Tkl,0,0.0,0,0,0,0,0,0,0,0,0,2023-2024,90.0,0.0,0.0
951,Ulisses Garcia,SUI,DF,Marseille,Ligue 1,27,1996,10.1,21,16,6,13,2,13,20,65.0,7,8,3,5,7,28,13,2,0,2023-2024,90.0,62.37623762376238,187.12871287128712
952,Unai García,ESP,DF,Osasuna,La Liga,31,1992,6.2,12,9,9,2,1,5,10,50.0,5,7,1,6,8,20,18,0,0,2023-2024,90.0,116.12903225806451,174.19354838709677
953,Alejandro Garnacho,ARG,FW,Manchester Utd,Premier League,19,2004,28.5,22,15,7,6,9,12,45,26.7,33,26,2,24,18,40,18,0,0,2023-2024,90.0,56.8421052631579,69.47368421052632
954,James Garner,ENG,MF,Everton,Premier League,22,2001,33.4,83,44,32,38,13,35,82,42.7,47,45,14,31,45,128,47,1,0,2023-2024,90.0,121.25748502994011,223.65269461077844
955,Luca Garritano,ITA,"MF,DF",Frosinone,Serie A,29,1994,5.4,10,5,7,2,1,5,15,33.3,10,13,0,13,4,14,8,1,0,2023-2024,90.0,66.66666666666666,166.66666666666666
956,Yarek Gasiorowski,ESP,DF,Valencia,La Liga,18,2005,8.2,22,12,14,5,3,13,19,68.4,6,15,8,7,15,37,50,1,0,2023-2024,90.0,164.63414634146343,241.46341463414637
957,Johan Gastien,FRA,MF,Clermont Foot,Ligue 1,35,1988,25.1,43,22,18,21,4,23,81,28.4,58,31,9,22,36,79,24,4,0,2023-2024,90.0,129.0836653386454,154.1832669322709
958,Federico Gatti,ITA,DF,Juventus,Serie A,25,1998,29.3,33,19,16,16,1,19,24,79.2,5,26,15,11,19,52,90,1,0,2023-2024,90.0,58.36177474402731,101.36518771331059
959,Federico Gattoni,ARG,"DF,FW",Sevilla,La Liga,24,1999,0.1,1,0,1,0,0,1,1,100.0,0,0,0,0,0,1,1,0,0,2023-2024,90.0,0.0,900.0
960,Gavi,ESP,"MF,FW",Barcelona,La Liga,18,2004,10.5,39,21,20,14,5,18,36,50.0,18,19,3,16,8,47,16,1,0,2023-2024,90.0,68.57142857142857,334.2857142857143
961,Paulo Gazzaniga,ARG,GK,Girona,La Liga,31,1992,38.0,2,2,2,0,0,2,4,50.0,2,0,0,0,0,2,12,1,0,2023-2024,90.0,0.0,4.7368421052631575
962,Yann Gboho,FRA,"MF,FW",Toulouse,Ligue 1,22,2001,13.3,14,4,6,6,2,8,23,34.8,15,21,1,20,4,18,2,0,0,2023-2024,90.0,27.06766917293233,94.73684210526315
963,Dennis Geiger,GER,MF,Hoffenheim,Bundesliga,25,1998,0.7,1,0,1,0,0,0,0,0.0,0,1,1,0,0,1,0,0,0,2023-2024,90.0,0.0,128.57142857142858
964,Gelabert,ESP,"MF,FW",Toulouse,Ligue 1,22,2000,8.4,14,8,5,6,3,7,20,35.0,13,8,2,6,5,19,8,0,0,2023-2024,90.0,53.57142857142857,150.0
965,Francesco Gelli,ITA,"MF,DF",Frosinone,Serie A,26,1996,17.3,19,13,8,4,7,10,24,41.7,14,19,3,16,11,30,27,1,0,2023-2024,90.0,57.22543352601156,98.84393063583815
966,Luca Gemello,ITA,GK,Torino,Serie A,23,2000,2.0,0,0,0,0,0,0,1,0.0,1,0,0,0,0,0,1,1,0,2023-2024,90.0,0.0,0.0
967,Valentin Gendrey,FRA,DF,Lecce,Serie A,23,2000,33.8,55,33,35,16,4,30,46,65.2,16,40,11,29,35,90,99,0,0,2023-2024,90.0,93.19526627218936,146.44970414201185
968,Denis Genreau,AUS,"MF,FW",Toulouse,Ligue 1,24,1999,5.2,12,9,6,6,0,8,15,53.3,7,8,1,7,6,18,8,0,0,2023-2024,90.0,103.84615384615384,207.69230769230768
969,Yannick Gerhardt,GER,"MF,DF",Wolfsburg,Bundesliga,29,1994,18.1,31,20,16,12,3,9,32,28.1,23,15,2,13,7,38,35,0,0,2023-2024,90.0,34.80662983425414,154.14364640883977
970,Anwar El Ghazi,NED,"MF,DF",Mainz 05,Bundesliga,28,1995,0.6,0,0,0,0,0,0,1,0.0,1,0,0,0,0,0,0,0,0,2023-2024,90.0,0.0,0.0
971,Farés Ghedjemis,FRA,"FW,MF",Frosinone,Serie A,20,2002,2.0,2,0,1,0,1,0,2,0.0,2,2,0,2,1,3,2,0,0,2023-2024,90.0,45.0,90.0
972,Saman Ghoddos,IRN,DF,Brentford,Premier League,29,1993,8.2,28,19,19,7,2,17,31,54.8,14,9,2,7,5,33,12,0,0,2023-2024,90.0,54.87804878048781,307.31707317073176
973,Lautaro Gianetti,ARG,DF,Udinese,Serie A,29,1993,7.0,9,4,7,2,0,4,5,80.0,1,10,6,4,19,28,39,0,0,2023-2024,90.0,244.28571428571428,115.71428571428571
974,Morgan Gibbs-White,ENG,"MF,FW",Nott'ham Forest,Premier League,23,2000,35.1,36,24,6,20,10,14,33,42.4,19,31,8,23,17,53,21,0,0,2023-2024,90.0,43.58974358974359,92.3076923076923
975,Samuel Gigot,FRA,DF,Marseille,Ligue 1,29,1993,19.2,33,22,16,13,4,13,19,68.4,6,28,18,10,25,58,93,1,0,2023-2024,90.0,117.18750000000001,154.6875
Rk,Player,Nation,Pos,Squad,Comp,0,0,90.0,0,0,3,3,3,Tkl,0,0.0,0,0,0,0,0,0,0,0,0,2023-2024,90.0,0.0,0.0
976,Bryan Gil,ESP,"FW,MF",Tottenham,Premier League,22,2001,2.3,1,0,0,0,1,1,4,25.0,3,3,0,3,3,4,4,0,0,2023-2024,90.0,117.3913043478261,39.130434782608695
977,David Gil,ESP,GK,Cádiz,La Liga,29,1994,4.1,0,0,0,0,0,0,1,0.0,1,0,0,0,0,0,3,0,0,2023-2024,90.0,0.0,0.0
978,Mario Gila,ESP,DF,Lazio,Serie A,22,2000,20.1,32,14,23,8,1,19,34,55.9,15,27,14,13,20,52,69,0,0,2023-2024,90.0,89.55223880597013,143.28358208955223
979,Alfie Gilchrist,ENG,DF,Chelsea,Premier League,19,2003,2.3,4,0,4,0,0,2,5,40.0,3,6,3,3,3,7,11,0,0,2023-2024,90.0,117.3913043478261,156.52173913043478
980,Billy Gilmour,SCO,MF,Brighton,Premier League,22,2001,23.6,26,16,14,10,2,11,35,31.4,24,23,9,14,11,37,14,1,0,2023-2024,90.0,41.94915254237288,99.15254237288134
981,Benedikt Gimber,GER,DF,Heidenheim,Bundesliga,26,1997,22.5,40,24,25,14,1,19,35,54.3,16,27,17,10,16,56,101,1,0,2023-2024,90.0,64.0,160.0
982,Gvidas Gineitis,LTU,MF,Torino,Serie A,19,2004,6.0,11,7,3,8,0,4,7,57.1,3,10,4,6,4,15,9,1,0,2023-2024,90.0,60.0,165.0
983,Matthias Ginter,GER,DF,Freiburg,Bundesliga,29,1994,21.3,29,15,19,9,1,16,29,55.2,13,40,26,14,16,45,93,0,0,2023-2024,90.0,67.6056338028169,122.53521126760563
984,Olivier Giroud,FRA,FW,Milan,Serie A,36,1986,26.3,17,11,6,6,5,2,14,14.3,12,14,3,11,6,23,22,0,0,2023-2024,90.0,20.53231939163498,58.17490494296578
985,Jamie Gittens,ENG,"FW,MF",Dortmund,Bundesliga,18,2004,11.8,14,7,6,7,1,2,17,11.8,15,11,2,9,4,18,7,0,0,2023-2024,90.0,30.508474576271183,106.77966101694915
986,Klaus Gjasula,ALB,"DF,MF",Darmstadt 98,Bundesliga,33,1989,15.1,44,22,18,25,1,17,30,56.7,13,26,14,12,19,63,42,2,0,2023-2024,90.0,113.24503311258279,262.25165562913907
987,Serge Gnabry,GER,"FW,MF",Bayern Munich,Bundesliga,28,1995,4.8,8,5,0,5,3,2,13,15.4,11,5,0,5,3,11,2,0,0,2023-2024,90.0,56.25000000000001,150.0
988,Ben Godfrey,ENG,DF,Everton,Premier League,25,1998,12.4,30,20,17,8,5,15,28,53.6,13,14,8,6,16,46,57,0,0,2023-2024,90.0,116.12903225806451,217.74193548387098
989,Edoardo Goldaniga,ITA,DF,Cagliari,Serie A,29,1993,11.2,12,7,9,3,0,4,10,40.0,6,11,7,4,15,27,37,1,0,2023-2024,90.0,120.53571428571429,96.42857142857143
990,Pierluigi Gollini,ITA,GK,Napoli,Serie A,28,1995,7.0,1,1,1,0,0,1,1,100.0,0,0,0,0,1,2,2,0,0,2023-2024,90.0,12.857142857142858,12.857142857142858
991,Aleksandr Golovin,RUS,"MF,FW",Monaco,Ligue 1,27,1996,23.9,42,30,14,22,6,15,42,35.7,27,37,3,34,21,63,14,0,0,2023-2024,90.0,79.0794979079498,158.1589958158996
992,André Gomes,POR,"MF,FW",Everton,Premier League,30,1993,5.6,7,4,2,3,2,3,13,23.1,10,10,1,9,3,10,4,1,0,2023-2024,90.0,48.214285714285715,112.5
993,Angel Gomes,ENG,MF,Lille,Ligue 1,22,2000,28.6,26,13,4,15,7,14,32,43.8,18,23,6,17,18,44,28,1,0,2023-2024,90.0,56.64335664335665,81.81818181818183
994,João Gomes,BRA,MF,Wolves,Premier League,22,2001,29.4,128,74,67,49,12,44,99,44.4,55,51,8,43,18,146,29,2,0,2023-2024,90.0,55.10204081632653,391.83673469387753
995,Toti Gomes,POR,DF,Wolves,Premier League,24,1999,30.8,44,25,32,8,4,24,37,64.9,13,40,19,21,26,70,93,2,0,2023-2024,90.0,75.97402597402598,128.57142857142858
996,Joe Gomez,ENG,DF,Liverpool,Premier League,26,1997,19.8,47,31,24,16,7,30,63,47.6,33,26,4,22,19,66,50,2,0,2023-2024,90.0,86.36363636363636,213.63636363636363
997,Maxi Gómez,URU,FW,Cádiz,La Liga,26,1996,12.9,6,4,2,3,1,3,5,60.0,2,8,3,5,3,9,3,0,0,2023-2024,90.0,20.930232558139533,41.860465116279066
998,Moi Gómez,ESP,"MF,FW",Osasuna,La Liga,29,1994,22.3,30,19,7,19,4,9,24,37.5,15,15,1,14,11,41,22,0,0,2023-2024,90.0,44.39461883408072,121.0762331838565
999,Papu Gómez,ARG,"MF,FW",Monza,Serie A,35,1988,0.5,0,0,0,0,0,0,2,0.0,2,0,0,0,1,1,0,0,0,2023-2024,90.0,180.0,0.0
1000,Sergio Gómez,ESP,"FW,MF",Manchester City,Premier League,22,2000,0.6,1,0,0,1,0,1,2,50.0,1,0,0,0,1,2,0,0,0,2023-2024,90.0,150.0,150.0
Rk,Player,Nation,Pos,Squad,Comp,0,0,90.0,0,0,3,3,3,Tkl,0,0.0,0,0,0,0,0,0,0,0,0,2023-2024,90.0,0.0,0.0
1001,Unai Gómez,ESP,MF,Athletic Club,La Liga,20,2003,9.7,12,10,2,6,4,5,10,50.0,5,13,2,11,2,14,9,0,0,2023-2024,90.0,18.556701030927837,111.34020618556703
1002,Iron Gomis,FRA,MF,Salernitana,Serie A,23,1999,1.5,4,1,2,2,0,0,1,0.0,1,2,0,2,2,6,2,0,0,2023-2024,90.0,120.0,240.0
1003,Maxime Gonalons,FRA,MF,Clermont Foot,Ligue 1,34,1989,14.4,47,33,14,27,6,25,57,43.9,32,18,3,15,20,67,11,0,0,2023-2024,90.0,125.0,293.75
1004,Édgar González,ESP,"DF,MF",Almería,La Liga,26,1997,28.0,45,21,22,20,3,25,49,51.0,24,48,28,20,38,83,130,3,0,2023-2024,90.0,122.14285714285714,144.64285714285714
1005,Enso Gonzalez,PAR,"MF,DF",Wolves,Premier League,18,2005,0.0,0,0,0,0,0,0,1,0.0,1,0,0,0,0,0,0,0,0,2023-2024,,,
1006,Fabio González,ESP,MF,Las Palmas,La Liga,26,1997,1.4,2,2,2,0,0,1,2,50.0,1,2,0,2,0,2,0,0,0,2023-2024,90.0,0.0,128.57142857142858
1007,Giovanni González,URU,DF,Mallorca,La Liga,28,1994,27.4,73,45,37,32,4,40,81,49.4,41,24,3,21,31,104,60,2,0,2023-2024,90.0,101.82481751824818,239.78102189781026
1008,Hugo González,ESP,"MF,FW",Valencia,La Liga,20,2003,1.0,2,1,0,2,0,0,0,0.0,0,0,0,0,0,2,0,0,0,2023-2024,90.0,0.0,180.0
1009,Iñaki González,ESP,MF,Las Palmas,La Liga,19,2004,0.1,1,0,1,0,0,0,0,0.0,0,0,0,0,0,1,1,0,0,2023-2024,90.0,0.0,900.0
1010,Joan Gonzàlez,ESP,MF,Lecce,Serie A,21,2002,14.3,31,18,16,12,3,17,28,60.7,11,20,3,17,5,36,9,0,0,2023-2024,90.0,31.46853146853147,195.10489510489512
1011,Nicolás González,ARG,FW,Fiorentina,Serie A,25,1998,21.3,28,18,15,8,5,8,28,28.6,20,26,1,25,12,40,9,0,0,2023-2024,90.0,50.70422535211268,118.30985915492958
1012,Urko González,ESP,MF,Real Sociedad,La Liga,22,2001,1.7,4,1,0,3,1,2,2,100.0,0,1,0,1,1,5,6,0,0,2023-2024,90.0,52.94117647058823,211.76470588235293
1013,Anthony Gordon,ENG,FW,Newcastle Utd,Premier League,22,2001,32.1,55,34,16,28,11,22,64,34.4,42,27,0,27,7,62,7,0,0,2023-2024,90.0,19.626168224299064,154.2056074766355
1014,Kaide Gordon,ENG,FW,Liverpool,Premier League,18,2004,0.0,0,0,0,0,0,0,0,0.0,0,0,0,0,0,0,0,0,0,2023-2024,,,
1015,Daniel Gore,ENG,MF,Manchester Utd,Premier League,18,2004,0.0,1,1,0,1,0,1,1,100.0,0,0,0,0,1,2,0,0,0,2023-2024,,inf,inf
1016,Leon Goretzka,GER,MF,Bayern Munich,Bundesliga,28,1995,24.9,41,23,18,14,9,24,54,44.4,30,44,8,36,31,72,42,1,0,2023-2024,90.0,112.04819277108433,148.19277108433735
1017,Mathieu Gorgelin,FRA,GK,Le Havre,Ligue 1,32,1990,1.0,0,0,0,0,0,0,0,0.0,0,0,0,0,0,0,0,0,0,2023-2024,90.0,0.0,0.0
1018,Andoni Gorosabel,ESP,DF,Alavés,La Liga,26,1996,31.7,62,42,40,17,5,38,75,50.7,37,24,8,16,28,90,69,0,0,2023-2024,90.0,79.49526813880126,176.02523659305993
1019,Robin Gosens,GER,"DF,MF",Union Berlin,Bundesliga,29,1994,25.4,63,44,25,31,7,30,44,68.2,14,52,9,43,36,99,75,0,0,2023-2024,90.0,127.55905511811024,223.22834645669292
1020,Mario Götze,GER,MF,Eint Frankfurt,Bundesliga,31,1992,23.0,51,34,18,25,8,28,62,45.2,34,19,3,16,14,65,10,0,0,2023-2024,90.0,54.78260869565218,199.56521739130437
1021,Amine Gouiri,ALG,"FW,MF",Rennes,Ligue 1,23,2000,23.0,20,10,4,11,5,8,19,42.1,11,18,1,17,14,34,12,0,0,2023-2024,90.0,54.78260869565218,78.26086956521739
1022,Jeffrey Gouweleeuw,NED,DF,Augsburg,Bundesliga,32,1991,28.8,35,23,13,17,5,16,25,64.0,9,44,24,20,35,70,108,0,0,2023-2024,90.0,109.375,109.375
1023,Pablo Gozalbez,ESP,"MF,FW",Valencia,La Liga,22,2001,1.1,1,0,0,0,1,1,6,16.7,5,0,0,0,1,2,2,0,0,2023-2024,90.0,81.81818181818181,81.81818181818181
1024,Jonathan Gradit,FRA,DF,Lens,Ligue 1,30,1992,23.5,32,20,15,14,3,19,35,54.3,16,30,17,13,37,69,61,0,0,2023-2024,90.0,141.70212765957447,122.5531914893617
1025,Jens Grahl,GER,GK,Eint Frankfurt,Bundesliga,34,1988,2.0,0,0,0,0,0,0,0,0.0,0,0,0,0,0,0,3,0,0,2023-2024,90.0,0.0,0.0
Rk,Player,Nation,Pos,Squad,Comp,0,0,90.0,0,0,3,3,3,Tkl,0,0.0,0,0,0,0,0,0,0,0,0,2023-2024,90.0,0.0,0.0
1026,Samuel Grandsir,FRA,"MF,FW",Le Havre,Ligue 1,26,1996,6.7,16,12,5,9,2,8,18,44.4,10,4,0,4,3,19,3,1,0,2023-2024,90.0,40.298507462686565,214.92537313432834
1027,Alberto Grassi,ITA,MF,Empoli,Serie A,28,1995,20.1,30,18,13,13,4,10,26,38.5,16,26,11,15,41,71,37,0,0,2023-2024,90.0,183.58208955223878,134.32835820895522
1028,Ryan Gravenberch,NED,MF,Liverpool,Premier League,21,2002,12.5,26,12,5,13,8,12,29,41.4,17,20,2,18,14,40,11,0,0,2023-2024,90.0,100.8,187.2
1029,Ryan Gravenberch,NED,FW,Bayern Munich,Bundesliga,21,2002,0.1,0,0,0,0,0,0,0,0.0,0,0,0,0,0,0,0,0,0,2023-2024,90.0,0.0,0.0
1030,Adrian Grbić,AUT,FW,Lorient,Ligue 1,26,1996,0.3,0,0,0,0,0,0,0,0.0,0,0,0,0,0,0,0,0,0,2023-2024,90.0,0.0,0.0
1031,Ivo Grbić,CRO,GK,Sheffield Utd,Premier League,27,1996,8.6,0,0,0,0,0,0,1,0.0,1,1,0,1,0,0,9,1,0,2023-2024,90.0,0.0,0.0
1032,Jack Grealish,ENG,"FW,MF",Manchester City,Premier League,27,1995,11.2,13,8,6,7,0,6,12,50.0,6,13,2,11,6,19,5,0,0,2023-2024,90.0,48.214285714285715,104.46428571428572
1033,Mason Greenwood,ENG,"MF,FW",Getafe,La Liga,21,2001,29.6,11,6,3,5,3,4,21,19.0,17,9,0,9,4,15,4,0,0,2023-2024,90.0,12.162162162162161,33.445945945945944
1034,Michael Gregoritsch,AUT,FW,Freiburg,Bundesliga,29,1994,18.7,16,12,8,5,3,2,14,14.3,12,17,4,13,9,25,27,0,0,2023-2024,90.0,43.31550802139037,77.00534759358288
1035,Dominik Greif,SVK,GK,Mallorca,La Liga,26,1997,1.0,0,0,0,0,0,0,0,0.0,0,0,0,0,0,0,0,0,0,2023-2024,90.0,0.0,0.0
1036,Antoine Griezmann,FRA,"FW,MF",Atlético Madrid,La Liga,32,1991,29.4,33,19,14,14,5,15,41,36.6,26,34,3,31,10,43,23,1,0,2023-2024,90.0,30.612244897959183,101.0204081632653
1037,Vincenzo Grifo,ITA,"MF,FW",Freiburg,Bundesliga,30,1993,25.8,31,20,14,11,6,14,31,45.2,17,22,1,21,15,46,20,0,0,2023-2024,90.0,52.325581395348834,108.13953488372093
1038,Florian Grillitsch,AUT,"DF,MF",Hoffenheim,Bundesliga,27,1995,25.5,54,28,31,19,4,22,54,40.7,32,41,20,21,52,106,90,2,0,2023-2024,90.0,183.52941176470588,190.58823529411765
1039,Álex Grimaldo,ESP,DF,Leverkusen,Bundesliga,27,1995,30.9,45,24,26,10,9,30,55,54.5,25,32,7,25,22,67,41,0,0,2023-2024,90.0,64.07766990291262,131.06796116504856
1040,Christian Groß,GER,"DF,MF",Werder Bremen,Bundesliga,34,1989,8.9,21,16,11,9,1,11,25,44.0,14,17,6,11,13,34,28,1,0,2023-2024,90.0,131.46067415730337,212.35955056179776
1041,Pascal Groß,GER,"MF,DF",Brighton,Premier League,32,1991,34.6,70,46,33,21,16,31,72,43.1,41,41,8,33,22,92,32,3,0,2023-2024,90.0,57.22543352601156,182.0809248554913
1042,Brajan Gruda,GER,"MF,FW",Mainz 05,Bundesliga,19,2004,18.2,22,14,5,11,6,14,24,58.3,10,15,0,15,5,27,4,0,0,2023-2024,90.0,24.725274725274726,108.79120879120879
1043,Ilia Gruev,BUL,MF,Werder Bremen,Bundesliga,23,2000,0.0,0,0,0,0,0,0,0,0.0,0,0,0,0,0,0,0,0,0,2023-2024,,,
1044,Vicente Guaita,ESP,GK,Celta Vigo,La Liga,36,1987,26.7,1,1,1,0,0,1,2,50.0,1,0,0,0,0,1,9,1,0,2023-2024,90.00000000000001,0.0,3.370786516853933
1045,Andrés Guardado,MEX,MF,Betis,La Liga,36,1986,5.0,17,12,5,9,3,7,14,50.0,7,4,2,2,6,23,5,0,0,2023-2024,90.0,108.0,306.0
1046,Sergi Guardiola,ESP,"FW,MF",Cádiz,La Liga,32,1991,5.5,10,7,2,6,2,4,9,44.4,5,10,0,10,0,10,4,0,0,2023-2024,90.0,0.0,163.63636363636365
1047,Nemanja Gudelj,SRB,"DF,MF",Sevilla,La Liga,31,1991,19.4,31,24,18,10,3,17,31,54.8,14,17,9,8,27,58,56,0,0,2023-2024,90.0,125.2577319587629,143.81443298969074
1048,Gabriel Gudmundsson,SWE,"DF,FW",Lille,Ligue 1,24,1999,14.1,22,16,7,13,2,12,20,60.0,8,14,3,11,15,37,25,0,0,2023-2024,89.99999999999999,95.74468085106382,140.4255319148936
1049,Gonçalo Guedes,POR,"FW,MF",Villarreal,La Liga,26,1996,10.6,6,4,1,2,3,2,7,28.6,5,8,0,8,2,8,3,0,0,2023-2024,90.0,16.9811320754717,50.943396226415096
1050,Axel Gueguin,FRA,"DF,FW",Montpellier,Ligue 1,18,2005,1.5,9,5,6,2,1,2,6,33.3,4,2,0,2,2,11,6,0,0,2023-2024,90.0,120.0,540.0
Rk,Player,Nation,Pos,Squad,Comp,0,0,90.0,0,0,3,3,3,Tkl,0,0.0,0,0,0,0,0,0,0,0,0,2023-2024,90.0,0.0,0.0
1051,Marc Guéhi,ENG,DF,Crystal Palace,Premier League,23,2000,22.5,28,19,21,7,0,14,24,58.3,10,22,17,5,18,46,89,1,0,2023-2024,90.0,72.0,112.0
1052,Mattéo Guendouzi,FRA,MF,Lazio,Serie A,24,1999,26.3,34,15,11,18,5,21,49,42.9,28,24,6,18,21,55,24,1,0,2023-2024,90.0,71.86311787072243,116.34980988593156
1053,Mattéo Guendouzi,FRA,MF,Marseille,Ligue 1,24,1999,0.2,0,0,0,0,0,0,0,0.0,0,1,1,0,0,0,0,0,0,2023-2024,90.0,0.0,0.0
1054,Javier Guerra,ESP,MF,Valencia,La Liga,20,2003,27.8,54,24,25,22,7,22,58,37.9,36,27,7,20,18,72,44,0,0,2023-2024,90.0,58.27338129496403,174.8201438848921
1055,Raphaël Guerreiro,POR,"DF,MF",Bayern Munich,Bundesliga,29,1993,13.2,19,16,6,9,4,9,15,60.0,6,7,1,6,15,34,5,1,0,2023-2024,90.0,102.27272727272727,129.54545454545453
1056,Axel Guessand,FRA,DF,Udinese,Serie A,18,2004,0.5,1,1,0,1,0,1,1,100.0,0,1,0,1,0,1,0,0,0,2023-2024,90.0,0.0,180.0
1057,Evann Guessand,CIV,FW,Nice,Ligue 1,22,2001,17.3,16,7,2,7,7,6,7,85.7,1,12,1,11,12,28,7,0,0,2023-2024,90.0,62.42774566473988,83.23699421965317
1058,Ander Guevara,ESP,MF,Alavés,La Liga,26,1997,32.6,59,32,28,25,6,31,64,48.4,33,34,12,22,13,72,46,1,0,2023-2024,90.0,35.88957055214724,162.88343558282207
1059,Pape Gueye,SEN,"MF,DF",Marseille,Ligue 1,24,1999,8.5,33,21,11,19,3,13,19,68.4,6,17,3,14,13,46,12,0,0,2023-2024,90.0,137.64705882352942,349.4117647058824
1060,Josuha Guilavogui,FRA,DF,Mainz 05,Bundesliga,32,1990,4.5,15,10,10,5,0,6,7,85.7,1,13,7,6,13,28,21,0,0,2023-2024,90.0,260.0,300.0
1061,Morgan Guilavogui,GUI,"FW,MF",Lens,Ligue 1,25,1998,6.3,21,10,4,12,5,5,11,45.5,6,11,2,9,4,25,7,0,0,2023-2024,90.0,57.142857142857146,300.00000000000006
1062,Frederic Guilbert,FRA,"DF,MF",Strasbourg,Ligue 1,28,1994,27.7,87,50,49,30,8,47,72,65.3,25,39,10,29,71,158,99,1,0,2023-2024,90.0,230.68592057761734,282.67148014440437
1063,Hugo Guillamón,ESP,MF,Valencia,La Liga,23,2000,14.6,24,15,7,14,3,11,17,64.7,6,8,3,5,12,36,25,2,0,2023-2024,90.0,73.97260273972603,147.94520547945206
1064,Bruno Guimarães,BRA,MF,Newcastle Utd,Premier League,25,1997,36.3,88,53,45,32,11,40,77,51.9,37,52,14,38,35,123,20,0,0,2023-2024,90.0,86.77685950413223,218.1818181818182
1065,Serhou Guirassy,GUI,FW,Stuttgart,Bundesliga,27,1996,24.5,6,3,1,4,1,2,5,40.0,3,8,1,7,6,12,29,0,0,2023-2024,90.00000000000001,22.040816326530614,22.040816326530614
1066,Marc Guiu,ESP,"FW,MF",Barcelona,La Liga,17,2006,0.8,1,0,0,1,0,0,0,0.0,0,0,0,0,0,1,0,0,0,2023-2024,90.0,0.0,112.5
1067,Péter Gulácsi,HUN,GK,RB Leipzig,Bundesliga,33,1990,13.0,0,0,0,0,0,0,0,0.0,0,0,0,0,0,0,8,1,0,2023-2024,90.00000000000001,0.0,0.0
1068,Manuel Gulde,GER,DF,Freiburg,Bundesliga,32,1991,22.7,37,23,23,13,1,17,23,73.9,6,24,14,10,25,62,82,0,0,2023-2024,89.99999999999999,99.11894273127753,146.69603524229075
1069,Arda Güler,TUR,"FW,MF",Real Madrid,La Liga,18,2005,4.2,6,4,1,3,2,5,8,62.5,3,0,0,0,2,8,5,0,0,2023-2024,90.0,42.857142857142854,128.57142857142856
1070,Gerard Gumbau,ESP,MF,Granada,La Liga,28,1994,29.7,55,34,21,30,4,23,62,37.1,39,24,5,19,25,80,30,2,0,2023-2024,90.0,75.75757575757575,166.66666666666666
1071,Robert Gumny,POL,DF,Augsburg,Bundesliga,25,1998,5.3,6,5,1,3,2,1,5,20.0,4,13,5,8,7,13,15,0,0,2023-2024,90.0,118.8679245283019,101.88679245283019
1072,İlkay Gündoğan,GER,MF,Barcelona,La Liga,32,1990,33.3,32,22,14,16,2,12,39,30.8,27,19,4,15,21,53,18,1,0,2023-2024,90.0,56.75675675675676,86.48648648648648
1073,Christian Günter,GER,DF,Freiburg,Bundesliga,30,1993,11.8,20,12,9,11,0,7,18,38.9,11,9,3,6,2,22,16,0,0,2023-2024,90.0,15.254237288135592,152.54237288135593
1074,Jon Guridi,ESP,MF,Alavés,La Liga,28,1995,29.8,42,24,10,27,5,12,45,26.7,33,23,3,20,22,64,22,0,0,2023-2024,90.0,66.44295302013423,126.84563758389261
1075,Gorka Guruzeta,ESP,FW,Athletic Club,La Liga,26,1996,24.6,34,23,6,25,3,9,30,30.0,21,36,2,34,17,51,23,0,0,2023-2024,89.99999999999999,62.195121951219505,124.39024390243901
Rk,Player,Nation,Pos,Squad,Comp,0,0,90.0,0,0,3,3,3,Tkl,0,0.0,0,0,0,0,0,0,0,0,0,2023-2024,90.0,0.0,0.0
1076,Malo Gusto,FRA,DF,Chelsea,Premier League,20,2003,19.5,55,27,34,15,6,35,52,67.3,17,28,4,24,17,72,43,1,0,2023-2024,90.0,78.46153846153845,253.84615384615384
1077,Miguel Gutiérrez,ESP,DF,Girona,La Liga,22,2001,33.7,29,18,11,14,4,13,35,37.1,22,27,11,16,22,51,66,2,0,2023-2024,90.0,58.753709198813056,77.44807121661721
1078,Albert Guðmundsson,ISL,"FW,MF",Genoa,Serie A,26,1997,33.5,23,10,8,10,5,12,44,27.3,32,15,2,13,11,34,13,0,0,2023-2024,90.0,29.55223880597015,61.7910447761194
1079,Joško Gvardiol,CRO,DF,Manchester City,Premier League,21,2002,25.9,55,33,21,24,10,21,38,55.3,17,36,12,24,27,82,37,3,0,2023-2024,90.0,93.82239382239383,191.11969111969114
1080,Emmanuel Gyasi,GHA,"DF,FW",Empoli,Serie A,29,1994,20.9,34,17,18,13,3,15,32,46.9,17,30,12,18,5,39,27,1,0,2023-2024,90.0,21.5311004784689,146.41148325358853
1081,Norbert Gyömbér,SVK,DF,Salernitana,Serie A,31,1992,19.6,36,18,30,6,0,20,26,76.9,6,33,23,10,23,59,77,2,0,2023-2024,90.0,105.61224489795917,165.30612244897958
1082,Erling Haaland,NOR,FW,Manchester City,Premier League,23,2000,28.4,6,3,0,3,3,2,3,66.7,1,11,1,10,2,8,16,0,0,2023-2024,90.0,6.338028169014085,19.014084507042256
1083,Nicolas Haas,SUI,MF,Empoli,Serie A,27,1996,1.0,5,3,1,2,2,3,3,100.0,0,1,0,1,1,6,1,0,0,2023-2024,90.0,90.0,450.0
1084,Janik Haberer,GER,"MF,DF",Union Berlin,Bundesliga,29,1994,13.6,36,24,16,13,7,22,45,48.9,23,21,4,17,12,48,18,0,0,2023-2024,90.0,79.41176470588235,238.23529411764704
1085,Robin Hack,GER,"FW,MF",Gladbach,Bundesliga,24,1998,15.0,15,8,6,7,2,4,17,23.5,13,16,0,16,14,29,21,0,0,2023-2024,90.0,84.0,90.0
1086,Antwoine Hackford,ENG,FW,Sheffield Utd,Premier League,19,2004,0.1,0,0,0,0,0,0,0,0.0,0,0,0,0,0,0,0,0,0,2023-2024,90.0,0.0,0.0
1087,Munir El Haddadi,MAR,FW,Las Palmas,La Liga,27,1995,27.2,40,27,18,17,5,17,38,44.7,21,27,1,26,11,51,16,0,0,2023-2024,90.0,36.39705882352941,132.35294117647058
1088,Jaouen Hadjam,ALG,DF,Nantes,Ligue 1,20,2003,1.2,6,4,5,1,0,1,2,50.0,1,0,0,0,3,9,2,0,0,2023-2024,90.0,225.00000000000003,450.00000000000006
1089,Ianis Hagi,ROU,"MF,FW",Alavés,La Liga,24,1998,8.9,17,12,2,14,1,5,12,41.7,7,8,0,8,5,22,4,0,0,2023-2024,90.0,50.56179775280899,171.91011235955057
1090,Amadou Haidara,MLI,MF,RB Leipzig,Bundesliga,25,1998,17.0,42,27,24,16,2,23,41,56.1,18,28,6,22,21,63,37,0,0,2023-2024,90.0,111.17647058823529,222.35294117647058
1091,Massadio Haïdara,MLI,DF,Lens,Ligue 1,30,1992,8.2,9,8,5,3,1,4,6,66.7,2,7,2,5,11,20,32,3,0,2023-2024,90.0,120.73170731707319,98.78048780487806
1092,Oualid El Hajjam,MAR,"DF,MF",Le Havre,Ligue 1,32,1991,4.4,8,7,5,2,1,2,9,22.2,7,5,1,4,6,14,10,0,0,2023-2024,90.0,122.72727272727272,163.63636363636363
1093,Achraf Hakimi,MAR,DF,Paris S-G,Ligue 1,24,1998,21.5,29,19,14,9,6,17,34,50.0,17,28,4,24,12,41,28,2,0,2023-2024,90.0,50.23255813953488,121.3953488372093
1094,Lewis Hall,ENG,DF,Newcastle Utd,Premier League,18,2004,8.7,28,18,17,10,1,17,28,60.7,11,17,2,15,12,40,22,1,0,2023-2024,90.0,124.13793103448276,289.6551724137931
1095,Sébastien Haller,CIV,FW,Dortmund,Bundesliga,29,1994,4.4,1,0,0,1,0,1,1,100.0,0,4,1,3,0,1,7,0,0,2023-2024,90.0,0.0,20.454545454545453
1096,Gustavo Hamer,NED,MF,Sheffield Utd,Premier League,26,1997,32.3,39,21,17,15,7,16,59,27.1,43,33,9,24,29,68,35,0,0,2023-2024,90.0,80.80495356037152,108.6687306501548
1097,Andreas Hanche-Olsen,NOR,DF,Mainz 05,Bundesliga,26,1997,11.0,20,12,10,8,2,10,16,62.5,6,10,4,6,11,31,41,0,0,2023-2024,90.0,90.0,163.63636363636365
1098,Isak Hansen-Aarøen,NOR,MF,Werder Bremen,Bundesliga,18,2004,0.3,0,0,0,0,0,0,1,0.0,1,1,0,1,1,1,0,0,0,2023-2024,90.0,300.0,0.0
1099,Ridgeciano Haps,SUR,DF,Genoa,Serie A,30,1993,8.6,7,6,3,2,2,5,8,62.5,3,3,0,3,6,13,11,1,0,2023-2024,90.0,62.79069767441861,73.25581395348838
1100,Genki Haraguchi,JPN,MF,Stuttgart,Bundesliga,32,1991,0.3,1,1,1,0,0,0,0,0.0,0,0,0,0,0,1,1,0,0,2023-2024,90.0,0.0,300.0
Rk,Player,Nation,Pos,Squad,Comp,0,0,90.0,0,0,3,3,3,Tkl,0,0.0,0,0,0,0,0,0,0,0,0,2023-2024,90.0,0.0,0.0
1101,Amine Harit,MAR,"MF,FW",Marseille,Ligue 1,26,1997,20.2,28,16,8,17,3,13,37,35.1,24,31,4,27,12,40,4,0,0,2023-2024,90.0,53.46534653465346,124.75247524752476
1102,Luke Harris,WAL,MF,Fulham,Premier League,18,2005,0.8,1,1,1,0,0,0,1,0.0,1,0,0,0,0,1,0,0,0,2023-2024,90.0,0.0,112.5
1103,Jack Harrison,ENG,"MF,FW",Everton,Premier League,26,1996,24.6,37,22,12,12,13,17,49,34.7,32,25,5,20,12,49,24,0,0,2023-2024,89.99999999999999,43.90243902439024,135.36585365853657
1104,Abdou Harroui,NED,"MF,FW",Frosinone,Serie A,25,1998,11.3,23,11,11,11,1,8,16,50.0,8,19,3,16,5,28,8,0,0,2023-2024,90.0,39.823008849557525,183.1858407079646
1105,Makoto Hasebe,JPN,"DF,MF",Eint Frankfurt,Bundesliga,39,1984,2.4,4,2,2,2,0,3,6,50.0,3,2,1,1,2,6,5,0,0,2023-2024,90.0,75.0,150.0
1106,Daiki Hashioka,JPN,DF,Luton Town,Premier League,24,1999,6.6,11,5,6,4,1,5,11,45.5,6,12,7,5,8,19,20,0,0,2023-2024,90.0,109.0909090909091,150.0
1107,Hans Hateboer,NED,DF,Atalanta,Serie A,29,1994,12.4,12,5,8,2,2,5,15,33.3,10,21,7,14,4,16,21,0,0,2023-2024,90.0,29.032258064516128,87.09677419354838
1108,Pantelis Hatzidiakos,GRE,DF,Cagliari,Serie A,26,1997,9.5,22,10,12,10,0,10,17,58.8,7,14,5,9,13,35,30,1,0,2023-2024,90.0,123.15789473684211,208.42105263157896
1109,Kai Havertz,GER,"MF,FW",Arsenal,Premier League,24,1999,29.3,35,15,7,21,7,14,39,35.9,25,26,1,25,20,55,22,0,0,2023-2024,90.0,61.43344709897611,107.5085324232082
1110,Thorgan Hazard,BEL,DF,Dortmund,Bundesliga,30,1993,0.1,0,0,0,0,0,0,0,0.0,0,0,0,0,0,0,0,0,0,2023-2024,90.0,0.0,0.0
1111,Jan Paul van Hecke,NED,DF,Brighton,Premier League,23,2000,26.3,47,26,25,19,3,27,45,60.0,18,49,27,22,30,77,76,4,0,2023-2024,90.0,102.66159695817491,160.83650190114068
1112,Hwang Hee-chan,KOR,"FW,MF",Wolves,Premier League,27,1996,23.5,20,10,11,8,1,9,24,37.5,15,19,1,18,10,30,9,0,0,2023-2024,90.0,38.29787234042553,76.59574468085106
1113,Silvan Hefti,SUI,"MF,DF",Genoa,Serie A,25,1997,1.3,6,1,2,3,1,4,7,57.1,3,2,0,2,0,6,1,0,0,2023-2024,90.0,0.0,415.38461538461536
1114,Silvan Hefti,SUI,"DF,FW",Montpellier,Ligue 1,25,1997,7.9,21,15,10,7,4,15,29,51.7,14,7,2,5,8,29,11,0,0,2023-2024,90.0,91.1392405063291,239.24050632911388
1115,Dominique Heintz,GER,DF,Köln,Bundesliga,29,1993,6.3,12,5,6,6,0,8,12,66.7,4,6,1,5,3,15,28,0,0,2023-2024,90.0,42.85714285714286,171.42857142857144
1116,Dean Henderson,ENG,GK,Crystal Palace,Premier League,26,1997,18.0,1,1,1,0,0,1,2,50.0,1,0,0,0,0,1,8,2,0,2023-2024,90.0,0.0,5.0
1117,Liam Henderson,SCO,MF,Empoli,Serie A,27,1996,0.1,0,0,0,0,0,0,0,0.0,0,0,0,0,0,0,0,0,0,2023-2024,90.0,0.0,0.0
1118,Benjamin Henrichs,GER,DF,RB Leipzig,Bundesliga,26,1997,28.1,68,39,32,26,10,27,58,46.6,31,49,4,45,33,101,37,0,0,2023-2024,90.0,105.69395017793595,217.7935943060498
1119,Henrique,BRA,DF,Lyon,Ligue 1,29,1994,6.7,10,6,6,4,0,6,11,54.5,5,8,2,6,10,20,3,0,0,2023-2024,90.0,134.32835820895522,134.32835820895522
1120,Luis Henrique,BRA,"FW,DF",Marseille,Ligue 1,21,2001,8.7,8,7,4,1,3,4,7,57.1,3,9,0,9,8,16,3,0,0,2023-2024,90.0,82.75862068965517,82.75862068965517
1121,Luiz Henrique,BRA,FW,Betis,La Liga,22,2001,6.8,15,11,4,10,1,9,14,64.3,5,11,0,11,5,20,8,0,0,2023-2024,90.0,66.17647058823529,198.52941176470588
1122,Matheus Henrique,BRA,MF,Sassuolo,Serie A,25,1997,27.8,43,29,21,18,4,18,43,41.9,25,18,8,10,25,68,31,6,0,2023-2024,90.0,80.93525179856115,139.20863309352518
1123,Rico Henry,ENG,DF,Brentford,Premier League,26,1997,4.5,7,5,3,3,1,6,7,85.7,1,8,3,5,5,12,5,1,0,2023-2024,90.0,100.0,140.0
1124,Thomas Henry,FRA,FW,Hellas Verona,Serie A,28,1994,3.7,0,0,0,0,0,0,0,0.0,0,0,0,0,0,0,5,0,0,2023-2024,90.0,0.0,0.0
1125,Christophe Hérelle,MTQ,DF,Metz,Ligue 1,30,1992,18.0,32,15,24,7,1,13,23,56.5,10,16,9,7,18,50,68,2,0,2023-2024,90.0,90.0,160.0
Rk,Player,Nation,Pos,Squad,Comp,0,0,90.0,0,0,3,3,3,Tkl,0,0.0,0,0,0,0,0,0,0,0,0,2023-2024,90.0,0.0,0.0
1126,Mario Hermoso,ESP,DF,Atlético Madrid,La Liga,28,1995,28.4,46,25,29,13,4,28,51,54.9,23,27,9,18,30,76,93,0,0,2023-2024,90.0,95.07042253521128,145.77464788732397
1127,Javi Hernández,ESP,DF,Cádiz,La Liga,25,1998,27.9,43,24,26,12,5,25,46,54.3,21,34,9,25,19,62,72,1,0,2023-2024,90.0,61.29032258064516,138.70967741935485
1128,Aridane Hernández,ESP,DF,Rayo Vallecano,La Liga,34,1989,18.8,10,8,5,4,1,4,11,36.4,7,19,14,5,14,24,98,1,0,2023-2024,90.0,67.02127659574468,47.87234042553191
1129,Lucas Hernández,FRA,DF,Paris S-G,Ligue 1,27,1996,21.2,52,36,28,15,9,29,50,58.0,21,21,5,16,27,79,38,0,0,2023-2024,90.0,114.62264150943396,220.75471698113208
1130,Luis Hernández,ESP,DF,Cádiz,La Liga,34,1989,8.0,7,3,4,3,0,4,8,50.0,4,3,2,1,8,15,25,0,0,2023-2024,90.0,90.0,78.75
1131,Theo Hernández,FRA,DF,Milan,Serie A,25,1997,31.0,30,17,19,11,0,11,22,50.0,11,33,13,20,23,53,42,1,0,2023-2024,90.0,66.7741935483871,87.09677419354838
1132,Jorge Herrando,ESP,DF,Osasuna,La Liga,22,2001,18.3,29,19,23,6,0,12,19,63.2,7,20,11,9,15,44,69,1,0,2023-2024,90.0,73.77049180327869,142.62295081967213
1133,Ander Herrera,ESP,MF,Athletic Club,La Liga,33,1989,11.4,44,32,11,26,7,20,36,55.6,16,16,6,10,15,59,18,1,0,2023-2024,90.0,118.42105263157893,347.36842105263156
1134,Cristian Herrera,ESP,"FW,MF",Las Palmas,La Liga,32,1991,1.8,1,1,0,1,0,1,2,50.0,1,1,0,1,0,1,2,0,0,2023-2024,90.0,0.0,50.0
1135,Sergio Herrera,ESP,GK,Osasuna,La Liga,30,1993,31.9,2,2,2,0,0,2,3,66.7,1,0,0,0,0,2,22,3,0,2023-2024,90.0,0.0,5.6426332288401255
1136,Yangel Herrera,VEN,MF,Girona,La Liga,25,1998,23.4,64,37,28,30,6,30,56,53.6,26,30,8,22,24,88,45,1,0,2023-2024,89.99999999999999,92.3076923076923,246.15384615384613
1137,Patrick Herrmann,GER,"FW,DF",Gladbach,Bundesliga,32,1991,1.0,4,4,2,1,1,2,2,100.0,0,1,0,1,1,5,2,0,0,2023-2024,90.0,90.0,360.0
1138,Juan Herzog,ESP,DF,Las Palmas,La Liga,20,2003,3.2,6,5,5,1,0,3,6,50.0,3,4,1,3,2,8,17,0,0,2023-2024,90.0,56.25,168.75
1139,Son Heung-min,KOR,FW,Tottenham,Premier League,31,1992,32.6,21,13,6,7,8,10,21,47.6,11,4,1,3,8,29,4,0,0,2023-2024,90.0,22.085889570552148,57.97546012269939
1140,Aaron Hickey,SCO,DF,Brentford,Premier League,21,2002,7.9,16,9,9,3,4,7,7,100.0,0,7,3,4,3,19,10,0,0,2023-2024,90.0,34.177215189873415,182.2784810126582
1141,Isak Hien,SWE,DF,Hellas Verona,Serie A,24,1999,9.6,17,10,10,7,0,10,19,52.6,9,12,5,7,7,24,33,1,0,2023-2024,90.0,65.625,159.375
1142,Isak Hien,SWE,DF,Atalanta,Serie A,24,1999,10.4,18,12,8,10,0,7,15,46.7,8,12,5,7,14,32,33,0,0,2023-2024,90.0,121.15384615384615,155.76923076923075
1143,James Hill,ENG,DF,Bournemouth,Premier League,21,2002,0.8,3,2,1,2,0,1,1,100.0,0,3,2,1,3,6,8,0,0,2023-2024,90.0,337.5,337.5
1144,Piero Hincapié,ECU,DF,Leverkusen,Bundesliga,21,2002,16.5,35,22,14,17,4,13,17,76.5,4,18,7,11,13,48,43,0,0,2023-2024,90.0,70.90909090909092,190.90909090909093
1145,Jack Hinshelwood,ENG,DF,Brighton,Premier League,18,2005,9.7,14,5,7,4,3,5,13,38.5,8,6,2,4,14,28,18,0,0,2023-2024,90.0,129.89690721649487,129.89690721649487
1146,Adam Hložek,CZE,"MF,FW",Leverkusen,Bundesliga,21,2002,5.1,10,4,2,4,4,3,7,42.9,4,4,1,3,2,12,1,0,0,2023-2024,90.0,35.294117647058826,176.47058823529412
1147,Nicolas Höfler,GER,MF,Freiburg,Bundesliga,33,1990,25.9,63,40,36,20,7,22,49,44.9,27,30,16,14,31,94,45,0,0,2023-2024,90.0,107.72200772200773,218.91891891891893
1148,Jonas Hofmann,GER,MF,Leverkusen,Bundesliga,31,1992,24.5,20,14,6,9,5,10,24,41.7,14,18,0,18,8,28,6,0,0,2023-2024,90.00000000000001,29.38775510204082,73.46938775510205
1149,Philipp Hofmann,GER,FW,Bochum,Bundesliga,30,1993,17.5,10,5,4,5,1,4,7,57.1,3,11,2,9,4,14,17,0,0,2023-2024,90.0,20.57142857142857,51.42857142857143
1150,Lucas Höler,GER,"FW,MF",Freiburg,Bundesliga,29,1994,25.6,32,24,14,10,8,4,23,17.4,19,19,4,15,15,47,35,0,0,2023-2024,90.0,52.734375,112.5
Rk,Player,Nation,Pos,Squad,Comp,0,0,90.0,0,0,3,3,3,Tkl,0,0.0,0,0,0,0,0,0,0,0,0,2023-2024,90.0,0.0,0.0
1151,Mason Holgate,ENG,DF,Sheffield Utd,Premier League,26,1996,7.9,12,7,5,6,1,5,12,41.7,7,12,5,7,11,23,40,0,0,2023-2024,90.0,125.31645569620251,136.70886075949366
1152,Fabian Holland,GER,"MF,DF",Darmstadt 98,Bundesliga,33,1990,20.4,47,26,18,21,8,20,37,54.1,17,22,12,10,24,71,29,0,0,2023-2024,90.0,105.88235294117648,207.3529411764706
1153,Benedict Hollerbach,GER,"FW,MF",Union Berlin,Bundesliga,22,2001,14.2,17,11,5,7,5,7,22,31.8,15,28,0,28,4,21,3,0,0,2023-2024,90.0,25.35211267605634,107.74647887323944
1154,Emil Holm,SWE,DF,Atalanta,Serie A,23,2000,10.5,28,19,17,9,2,16,36,44.4,20,25,3,22,7,35,25,0,0,2023-2024,90.0,60.0,240.0
1155,Gerrit Holtmann,PHI,"MF,FW",Darmstadt 98,Bundesliga,28,1995,4.4,8,5,3,4,1,7,10,70.0,3,7,0,7,2,10,4,1,0,2023-2024,90.0,40.90909090909091,163.63636363636363
1156,Martin Hongla,CMR,MF,Hellas Verona,Serie A,25,1998,12.0,24,13,9,13,2,8,11,72.7,3,8,3,5,7,31,24,0,0,2023-2024,90.0,52.5,180.0
1157,Martin Hongla,CMR,"MF,DF",Granada,La Liga,25,1998,6.2,7,3,2,5,0,3,9,33.3,6,6,3,3,6,13,13,1,0,2023-2024,90.0,87.09677419354838,101.61290322580645
1158,Franck Honorat,FRA,"DF,FW",Gladbach,Bundesliga,26,1996,26.1,25,13,13,10,2,11,20,55.0,9,22,3,19,9,34,35,1,0,2023-2024,90.0,31.034482758620687,86.20689655172413
1159,Mathias Honsak,AUT,"FW,MF",Darmstadt 98,Bundesliga,26,1996,11.3,14,7,7,6,1,6,20,30.0,14,14,2,12,8,22,25,0,0,2023-2024,90.0,63.716814159292035,111.50442477876106
1160,Sydney van Hooijdonk,NED,FW,Bologna,Serie A,23,2000,2.4,3,0,0,2,1,1,2,50.0,1,1,1,0,1,4,4,0,0,2023-2024,90.0,37.5,112.50000000000001
1161,Fraser Hornby,SCO,"FW,MF",Darmstadt 98,Bundesliga,23,1999,2.4,0,0,0,0,0,0,1,0.0,1,2,1,1,0,0,4,0,0,2023-2024,90.0,0.0,0.0
1162,Lukáš Hrádecký,FIN,GK,Leverkusen,Bundesliga,33,1989,33.0,0,0,0,0,0,0,1,0.0,1,1,0,1,0,0,10,2,0,2023-2024,90.0,0.0,0.0
1163,Xabier Huarte Armendáriz,ESP,MF,Osasuna,La Liga,22,2001,0.1,0,0,0,0,0,0,0,0.0,0,0,0,0,0,0,0,0,0,2023-2024,90.0,0.0,0.0
1164,Timo Hübers,GER,DF,Köln,Bundesliga,27,1996,30.9,68,47,51,14,3,49,80,61.3,31,54,28,26,63,131,168,1,0,2023-2024,90.0,183.49514563106797,198.05825242718447
1165,Callum Hudson-Odoi,ENG,"FW,MF",Nott'ham Forest,Premier League,22,2000,20.6,18,8,4,5,9,7,28,25.0,21,16,1,15,7,25,12,1,0,2023-2024,90.0,30.582524271844658,78.64077669902913
1166,Will Hughes,ENG,MF,Crystal Palace,Premier League,28,1995,21.0,61,33,30,20,11,24,48,50.0,24,36,14,22,21,82,25,0,0,2023-2024,90.0,90.0,261.42857142857144
1167,Dean Huijsen,ESP,DF,Roma,Serie A,18,2005,5.7,10,5,5,5,0,1,4,25.0,3,7,4,3,4,14,26,2,0,2023-2024,90.0,63.1578947368421,157.89473684210526
1168,Dean Huijsen,ESP,DF,Juventus,Serie A,18,2005,0.1,0,0,0,0,0,0,0,0.0,0,0,0,0,0,0,1,0,0,2023-2024,90.0,0.0,0.0
1169,Mats Hummels,GER,DF,Dortmund,Bundesliga,34,1988,17.6,52,34,34,12,6,30,53,56.6,23,33,11,22,33,85,82,0,0,2023-2024,90.0,168.75,265.9090909090909
1170,Denis Huseinbasic,BIH,MF,Köln,Bundesliga,22,2001,18.1,38,18,17,15,6,20,31,64.5,11,26,1,25,13,51,14,0,0,2023-2024,90.0,64.64088397790054,188.9502762430939
1171,Elseid Hysaj,ALB,DF,Lazio,Serie A,29,1994,13.3,24,14,8,13,3,15,24,62.5,9,16,6,10,17,41,31,0,0,2023-2024,90.0,115.0375939849624,162.406015037594
1172,Pierre Højbjerg,DEN,MF,Tottenham,Premier League,27,1995,14.6,32,18,13,17,2,13,34,38.2,21,21,7,14,19,51,30,3,0,2023-2024,90.0,117.12328767123289,197.26027397260276
1173,Rasmus Højlund,DEN,FW,Manchester Utd,Premier League,20,2003,24.0,11,7,2,3,6,5,13,38.5,8,9,1,8,1,12,19,0,0,2023-2024,90.0,3.75,41.25
1174,Iago,BRA,DF,Augsburg,Bundesliga,26,1997,18.0,36,17,22,10,4,17,33,51.5,16,39,8,31,18,54,43,0,0,2023-2024,90.0,90.0,180.0
1175,Pablo Ibáñez,ESP,MF,Osasuna,La Liga,24,1998,12.8,18,9,5,7,6,5,21,23.8,16,26,3,23,9,27,17,0,0,2023-2024,90.0,63.28125,126.5625
Rk,Player,Nation,Pos,Squad,Comp,0,0,90.0,0,0,3,3,3,Tkl,0,0.0,0,0,0,0,0,0,0,0,0,2023-2024,90.0,0.0,0.0
1176,Arijon Ibrahimović,GER,"FW,DF",Frosinone,Serie A,17,2005,5.3,7,6,4,2,1,1,9,11.1,8,4,0,4,1,8,3,0,0,2023-2024,90.0,16.9811320754717,118.8679245283019
1177,Iglesias,ESP,"DF,FW",Getafe,La Liga,25,1998,15.7,41,22,25,11,5,21,33,63.6,12,18,7,11,16,57,53,0,0,2023-2024,90.0,91.71974522292994,235.031847133758
1178,Borja Iglesias,ESP,FW,Betis,La Liga,30,1993,4.5,0,0,0,0,0,0,3,0.0,3,0,0,0,2,2,2,0,0,2023-2024,90.0,40.0,0.0
1179,Borja Iglesias,ESP,FW,Leverkusen,Bundesliga,30,1993,2.8,1,0,0,1,0,0,1,0.0,1,2,0,2,1,2,1,0,0,2023-2024,90.0,32.142857142857146,32.142857142857146
1180,Igor,BRA,DF,Brighton,Premier League,25,1998,18.2,25,18,7,16,2,17,29,58.6,12,22,9,13,14,39,52,1,0,2023-2024,90.0,69.23076923076923,123.62637362637363
1181,Jonathan Ikone,FRA,FW,Fiorentina,Serie A,25,1998,18.7,22,11,7,9,6,10,17,58.8,7,12,0,12,3,25,8,0,0,2023-2024,90.0,14.43850267379679,105.88235294117646
1182,Chukwubuikem Ikwuemesi,NGA,FW,Salernitana,Serie A,21,2001,11.8,3,1,0,2,1,2,6,33.3,4,1,1,0,1,4,8,0,0,2023-2024,90.0,7.627118644067796,22.881355932203387
1183,Andrej Ilic,SRB,FW,Lille,Ligue 1,23,2000,0.1,0,0,0,0,0,0,0,0.0,0,0,0,0,0,0,0,0,0,2023-2024,90.0,0.0,0.0
1184,Ivan Ilić,SRB,MF,Torino,Serie A,22,2001,23.3,22,8,9,10,3,13,27,48.1,14,20,7,13,20,42,31,0,0,2023-2024,90.0,77.25321888412017,84.97854077253218
1185,Samuel Iling-Junior,ENG,"DF,MF",Juventus,Serie A,19,2003,9.0,23,13,9,11,3,11,18,61.1,7,17,5,12,6,29,19,0,0,2023-2024,90.0,60.0,230.0
1186,Imanol,ESP,DF,Athletic Club,La Liga,23,2000,5.8,7,5,1,5,1,5,18,27.8,13,6,0,6,7,14,15,0,0,2023-2024,90.0,108.62068965517241,108.62068965517241
1187,Joel Imasuen,USA,FW,Werder Bremen,Bundesliga,18,2004,0.0,0,0,0,0,0,0,0,0.0,0,0,0,0,0,0,0,0,0,2023-2024,,,
1188,Ciro Immobile,ITA,FW,Lazio,Serie A,33,1990,18.4,11,9,2,5,4,3,14,21.4,11,9,3,6,5,16,11,0,0,2023-2024,90.0,24.456521739130437,53.80434782608696
1189,Gino Infantino,ARG,MF,Fiorentina,Serie A,20,2003,1.1,1,1,0,1,0,0,1,0.0,1,4,0,4,3,4,1,0,0,2023-2024,90.0,245.45454545454544,81.81818181818181
1190,Danny Ings,ENG,FW,West Ham,Premier League,31,1992,4.5,6,2,0,6,0,4,13,30.8,9,4,1,3,3,9,7,0,0,2023-2024,90.0,60.0,120.0
1191,Bonke Innocent,NGA,MF,Lorient,Ligue 1,27,1996,2.3,6,4,2,2,2,2,9,22.2,7,2,1,1,4,10,2,0,0,2023-2024,90.0,156.52173913043478,234.7826086956522
1192,Tim Iroegbunam,ENG,MF,Aston Villa,Premier League,20,2003,1.8,7,5,4,2,1,4,9,44.4,5,3,0,3,2,9,3,0,0,2023-2024,90.0,100.0,350.0
1193,Alexander Isak,SWE,FW,Newcastle Utd,Premier League,23,1999,25.1,5,0,2,1,2,2,8,25.0,6,16,1,15,6,11,13,0,0,2023-2024,90.0,21.51394422310757,17.92828685258964
1194,Gustav Isaksen,DEN,FW,Lazio,Serie A,22,2001,11.9,4,3,2,1,1,1,9,11.1,8,11,1,10,4,8,4,0,0,2023-2024,90.00000000000001,30.252100840336137,30.252100840336137
1195,Isco,ESP,MF,Betis,La Liga,31,1992,25.8,41,27,15,21,5,14,38,36.8,24,19,1,18,10,51,7,0,0,2023-2024,90.0,34.883720930232556,143.02325581395348
1196,Thomas Isherwood,SWE,DF,Darmstadt 98,Bundesliga,25,1998,7.1,11,5,7,3,1,5,9,55.6,4,10,7,3,10,21,34,0,0,2023-2024,90.0,126.7605633802817,139.43661971830986
1197,Ismaily,BRA,DF,Lille,Ligue 1,33,1990,27.4,72,47,34,25,13,31,60,51.7,29,33,6,27,32,104,77,0,0,2023-2024,90.0,105.1094890510949,236.49635036496355
1198,Ardian Ismajli,ALB,DF,Empoli,Serie A,26,1996,22.7,26,16,18,6,2,18,23,78.3,5,28,17,11,23,49,126,1,0,2023-2024,89.99999999999999,91.18942731277532,103.08370044052863
1199,Yanis Issoufou,FRA,MF,Montpellier,Ligue 1,16,2006,0.1,0,0,0,0,0,0,0,0.0,0,0,0,0,0,0,0,0,0,2023-2024,90.0,0.0,0.0
1200,Ko Itakura,JPN,"DF,MF",Gladbach,Bundesliga,26,1997,17.7,34,21,17,15,2,16,26,61.5,10,32,18,14,22,56,62,0,0,2023-2024,90.0,111.86440677966102,172.8813559322034
Rk,Player,Nation,Pos,Squad,Comp,0,0,90.0,0,0,3,3,3,Tkl,0,0.0,0,0,0,0,0,0,0,0,0,2023-2024,90.0,0.0,0.0
1201,Hiroki Ito,JPN,DF,Stuttgart,Bundesliga,24,1999,24.8,19,18,13,6,0,11,26,42.3,15,29,17,12,29,48,86,2,0,2023-2024,90.0,105.24193548387098,68.95161290322581
1202,Junya Ito,JPN,"FW,MF",Reims,Ligue 1,30,1993,30.2,33,15,11,14,8,10,36,27.8,26,23,1,22,14,47,7,0,0,2023-2024,90.0,41.72185430463576,98.34437086092716
1203,Diego Iturralde,ESP,DF,Sevilla,La Liga,20,2003,0.4,0,0,0,0,0,0,0,0.0,0,1,1,0,0,0,2,0,0,2023-2024,90.0,0.0,0.0
1204,Alex Iwobi,NGA,MF,Everton,Premier League,27,1996,1.6,2,0,1,0,1,2,3,66.7,1,2,0,2,1,3,0,0,0,2023-2024,90.0,56.25,112.5
1205,Alex Iwobi,NGA,"FW,MF",Fulham,Premier League,27,1996,24.4,29,18,12,15,2,12,25,48.0,13,16,0,16,14,43,9,0,0,2023-2024,90.0,51.63934426229509,106.96721311475412
1206,Armando Izzo,ITA,DF,Monza,Serie A,31,1992,18.3,27,17,17,9,1,16,27,59.3,11,20,16,4,27,54,49,1,0,2023-2024,90.0,132.78688524590163,132.78688524590163
1207,Nicolas Jackson,SEN,FW,Chelsea,Premier League,22,2001,31.1,21,13,5,8,8,5,24,20.8,19,20,5,15,4,25,17,0,0,2023-2024,90.0,11.57556270096463,60.771704180064305
1208,Jérémy Jacquet,FRA,MF,Rennes,Ligue 1,18,2005,0.1,1,1,1,0,0,0,1,0.0,1,0,0,0,1,2,0,0,0,2023-2024,90.0,900.0,900.0
1209,Jérémy Jacquet,FRA,DF,Clermont Foot,Ligue 1,18,2005,2.8,4,3,4,0,0,3,3,100.0,0,7,3,4,6,10,10,0,0,2023-2024,90.0,192.85714285714286,128.57142857142858
1210,Lee Jae-sung,KOR,"MF,FW",Mainz 05,Bundesliga,30,1992,23.5,33,20,11,16,6,13,39,33.3,26,22,2,20,27,60,23,0,0,2023-2024,90.0,103.40425531914893,126.38297872340425
1211,Paul Jaeckel,GER,DF,Union Berlin,Bundesliga,25,1998,2.6,7,2,4,3,0,5,9,55.6,4,3,2,1,4,11,7,0,0,2023-2024,90.0,138.46153846153845,242.3076923076923
1212,Filip Jagiełło,POL,MF,Genoa,Serie A,25,1997,0.4,0,0,0,0,0,0,1,0.0,1,1,1,0,1,1,0,0,0,2023-2024,90.0,225.0,0.0
1213,Kristijan Jakić,CRO,MF,Augsburg,Bundesliga,26,1997,11.7,28,14,14,10,4,15,33,45.5,18,13,1,12,20,48,15,0,0,2023-2024,89.99999999999999,153.84615384615384,215.3846153846154
1214,Kristijan Jakić,CRO,"MF,FW",Eint Frankfurt,Bundesliga,26,1997,2.2,3,3,1,2,0,1,3,33.3,2,1,0,1,2,5,2,0,0,2023-2024,90.0,81.81818181818181,122.72727272727272
1215,Ismail Jakobs,SEN,DF,Monaco,Ligue 1,23,1999,16.3,57,41,27,21,9,29,47,61.7,18,19,2,17,11,68,40,0,0,2023-2024,90.0,60.736196319018404,314.7239263803681
1216,Ablie Jallow,GAM,"MF,FW",Metz,Ligue 1,24,1998,10.2,8,5,2,3,3,3,5,60.0,2,4,0,4,8,16,3,0,0,2023-2024,90.0,70.58823529411765,70.58823529411765
1217,Reece James,ENG,DF,Chelsea,Premier League,23,1999,4.7,14,9,10,3,1,8,10,80.0,2,4,4,0,3,17,7,1,0,2023-2024,90.0,57.44680851063829,268.0851063829787
1218,Vitaly Janelt,GER,"MF,DF",Brentford,Premier League,25,1998,33.9,63,38,29,25,9,32,64,50.0,32,35,9,26,36,99,64,3,0,2023-2024,90.0,95.57522123893806,167.2566371681416
1219,Jakub Jankto,CZE,"MF,FW",Cagliari,Serie A,27,1996,9.7,12,9,9,1,2,8,20,40.0,12,5,1,4,5,17,20,0,0,2023-2024,90.0,46.39175257731959,111.34020618556703
1220,Tony Jantschke,GER,"DF,MF",Gladbach,Bundesliga,33,1990,0.3,1,1,1,0,0,1,1,100.0,0,2,2,0,1,2,4,0,0,2023-2024,90.0,300.0,300.0
1221,Adnan Januzaj,BEL,"FW,MF",Sevilla,La Liga,28,1995,2.1,3,3,2,0,1,0,1,0.0,1,2,0,2,1,4,0,0,0,2023-2024,90.0,42.857142857142854,128.57142857142856
1222,Nuha Jatta,GAM,FW,RB Leipzig,Bundesliga,17,2006,0.0,0,0,0,0,0,0,0,0.0,0,0,0,0,0,0,0,0,0,2023-2024,,,
1223,Mikel Jauregizar,ESP,MF,Athletic Club,La Liga,19,2003,1.7,0,0,0,0,0,0,6,0.0,6,5,0,5,0,0,2,0,0,2023-2024,90.0,0.0,0.0
1224,Luis Javier Suárez,COL,FW,Almería,La Liga,25,1997,10.2,7,5,2,5,0,2,6,33.3,4,11,0,11,0,7,13,0,0,2023-2024,90.0,0.0,61.76470588235294
1225,Danley Jean-Jacques,HAI,MF,Metz,Ligue 1,23,2000,29.8,54,28,24,21,9,19,56,33.9,37,48,7,41,44,98,44,0,0,2023-2024,90.0,132.88590604026845,163.08724832214764
Rk,Player,Nation,Pos,Squad,Comp,0,0,90.0,0,0,3,3,3,Tkl,0,0.0,0,0,0,0,0,0,0,0,0,2023-2024,90.0,0.0,0.0
1226,Salim El Jebari,MAR,MF,Atlético Madrid,La Liga,19,2004,0.1,1,0,0,1,0,0,0,0.0,0,0,0,0,0,1,1,0,0,2023-2024,90.0,0.0,900.0
1227,Daniel Jebbison,ENG,FW,Sheffield Utd,Premier League,19,2003,0.2,0,0,0,0,0,0,0,0.0,0,1,0,1,0,0,0,0,0,2023-2024,90.0,0.0,0.0
1228,Jeffinho,BRA,"FW,MF",Lyon,Ligue 1,23,1999,3.4,11,4,3,5,3,4,11,36.4,7,1,0,1,0,11,0,0,0,2023-2024,90.0,0.0,291.1764705882353
1229,Fredrik Jensen,FIN,"MF,FW",Augsburg,Bundesliga,25,1997,14.9,23,11,9,8,6,14,28,50.0,14,30,1,29,12,35,21,0,0,2023-2024,90.0,72.48322147651007,138.92617449664428
1230,Mathias Jensen,DEN,MF,Brentford,Premier League,27,1996,24.5,54,32,25,22,7,26,95,27.4,69,41,6,35,23,77,25,1,0,2023-2024,90.00000000000001,84.48979591836735,198.36734693877554
1231,Moritz Jenz,GER,DF,Wolfsburg,Bundesliga,24,1999,19.4,34,24,21,11,2,14,21,66.7,7,29,17,12,26,60,94,0,0,2023-2024,90.0,120.61855670103094,157.73195876288662
1232,Gabriel Jesus,BRA,FW,Arsenal,Premier League,26,1997,16.4,24,17,11,5,8,5,18,27.8,13,23,1,22,13,37,12,0,0,2023-2024,90.0,71.34146341463415,131.70731707317074
1233,Juan Jesus,BRA,DF,Napoli,Serie A,32,1991,23.5,42,19,28,12,2,23,33,69.7,10,23,12,11,23,65,67,1,0,2023-2024,90.0,88.08510638297872,160.85106382978722
1234,Alejandro Jiménez,ESP,DF,Milan,Serie A,18,2005,0.8,2,1,2,0,0,2,5,40.0,3,0,0,0,0,2,4,0,0,2023-2024,90.0,0.0,225.0
1235,Raúl Jiménez,MEX,FW,Fulham,Premier League,32,1991,15.5,18,12,4,8,6,7,20,35.0,13,11,3,8,4,22,13,0,0,2023-2024,90.0,23.225806451612904,104.51612903225806
1236,João Pedro,BRA,"FW,MF",Brighton,Premier League,21,2001,22.7,31,14,10,13,8,14,24,58.3,10,15,2,13,11,42,28,0,0,2023-2024,89.99999999999999,43.61233480176211,122.90748898678413
1237,Joelinton,BRA,"MF,FW",Newcastle Utd,Premier League,26,1996,14.2,39,27,21,15,3,14,38,36.8,24,23,7,16,19,58,11,1,0,2023-2024,90.0,120.42253521126761,247.1830985915493
1238,Ryan John Giles,ENG,"DF,MF",Luton Town,Premier League,23,2000,5.6,8,6,4,3,1,2,7,28.6,5,2,0,2,4,12,22,0,0,2023-2024,90.0,64.28571428571429,128.57142857142858
1239,Ben Johnson,ENG,"DF,FW",West Ham,Premier League,23,2000,6.0,11,7,7,3,1,9,14,64.3,5,2,1,1,5,16,14,0,0,2023-2024,90.0,75.0,165.0
1240,Brennan Johnson,WAL,FW,Tottenham,Premier League,22,2001,23.2,26,15,14,5,7,12,31,38.7,19,37,1,36,10,36,12,1,0,2023-2024,90.0,38.793103448275865,100.86206896551724
1241,Brennan Johnson,WAL,"FW,MF",Nott'ham Forest,Premier League,22,2001,2.6,4,1,1,1,2,2,4,50.0,2,4,1,3,0,4,0,0,0,2023-2024,90.0,0.0,138.46153846153845
1242,Joseph Johnson,ENG,DF,Luton Town,Premier League,17,2006,0.9,0,0,0,0,0,0,1,0.0,1,0,0,0,0,0,0,0,0,2023-2024,90.0,0.0,0.0
1243,Sam Johnstone,ENG,GK,Crystal Palace,Premier League,30,1993,20.0,1,0,1,0,0,1,1,100.0,0,0,0,0,1,2,5,0,0,2023-2024,90.0,4.5,4.5
1244,Curtis Jones,ENG,MF,Liverpool,Premier League,22,2001,13.0,27,14,12,12,3,10,23,43.5,13,22,0,22,7,34,8,0,0,2023-2024,90.00000000000001,48.46153846153847,186.92307692307693
1245,Frenkie de Jong,NED,MF,Barcelona,La Liga,26,1997,18.2,43,26,14,23,6,8,19,42.1,11,18,8,10,14,57,28,1,0,2023-2024,90.0,69.23076923076923,212.63736263736263
1246,Joan Jordán,ESP,MF,Sevilla,La Liga,29,1994,4.2,8,7,3,3,2,7,15,46.7,8,4,2,2,4,12,2,0,0,2023-2024,90.0,85.71428571428571,171.42857142857142
1247,Jordi,ESP,"MF,DF",Getafe,La Liga,22,2001,6.4,16,11,3,11,2,7,15,46.7,8,7,2,5,8,24,7,0,0,2023-2024,90.0,112.5,225.0
1248,Jeremy Jorge,ESP,FW,Getafe,La Liga,20,2003,0.0,0,0,0,0,0,0,0,0.0,0,0,0,0,0,0,0,0,0,2023-2024,,,
1249,Kaio Jorge,BRA,FW,Frosinone,Serie A,21,2002,9.0,6,4,0,1,5,3,4,75.0,1,6,0,6,1,7,0,0,0,2023-2024,90.0,10.0,60.0
1250,Jorginho,ITA,MF,Arsenal,Premier League,31,1991,10.2,24,10,6,10,8,11,23,47.8,12,17,1,16,12,36,7,1,0,2023-2024,90.0,105.88235294117648,211.76470588235296
Rk,Player,Nation,Pos,Squad,Comp,0,0,90.0,0,0,3,3,3,Tkl,0,0.0,0,0,0,0,0,0,0,0,0,2023-2024,90.0,0.0,0.0
1251,Willian José,BRA,FW,Betis,La Liga,31,1991,21.9,7,3,1,2,4,2,5,40.0,3,8,2,6,2,9,15,0,0,2023-2024,90.0,8.219178082191782,28.767123287671236
1252,Joselu,ESP,FW,Real Madrid,La Liga,33,1990,18.7,6,3,1,4,1,0,7,0.0,7,11,1,10,6,12,11,0,0,2023-2024,90.0,28.87700534759358,28.87700534759358
1253,Diogo Jota,POR,FW,Liverpool,Premier League,26,1996,12.7,23,13,6,13,4,10,23,43.5,13,9,1,8,7,30,4,0,0,2023-2024,90.0,49.60629921259843,162.99212598425197
1254,Antoine Joujou,FRA,"FW,MF",Le Havre,Ligue 1,20,2003,8.7,20,12,7,7,6,11,21,52.4,10,11,2,9,7,27,5,0,0,2023-2024,90.0,72.41379310344827,206.89655172413794
1255,Luka Jović,SRB,FW,Milan,Serie A,25,1997,9.7,6,4,0,3,3,4,6,66.7,2,3,0,3,1,7,9,0,0,2023-2024,90.0,9.278350515463918,55.67010309278351
1256,Kamil Jóźwiak,POL,MF,Granada,La Liga,25,1998,6.3,13,10,4,6,3,9,17,52.9,8,4,0,4,2,15,6,0,0,2023-2024,90.0,28.571428571428573,185.71428571428572
1257,Juanmi,ESP,FW,Cádiz,La Liga,30,1993,9.7,9,4,2,7,0,2,9,22.2,7,6,0,6,6,15,3,0,0,2023-2024,90.0,55.67010309278351,83.50515463917527
1258,Juanpe,ESP,DF,Girona,La Liga,32,1991,8.3,11,8,8,3,0,9,10,90.0,1,17,11,6,7,18,50,1,0,2023-2024,90.0,75.90361445783131,119.27710843373492
1259,Mads Juel Andersen,DEN,DF,Luton Town,Premier League,25,1997,4.4,6,5,4,2,0,4,4,100.0,0,9,6,3,8,14,29,0,0,2023-2024,90.0,163.63636363636363,122.72727272727272
1260,Christopher Jullien,FRA,DF,Montpellier,Ligue 1,30,1993,13.7,16,12,11,5,0,6,17,35.3,11,25,20,5,12,28,106,2,0,2023-2024,90.0,78.83211678832117,105.1094890510949
1261,Anthony Jung,GER,DF,Werder Bremen,Bundesliga,31,1991,28.7,37,23,21,14,2,18,33,54.5,15,39,17,22,24,61,102,0,0,2023-2024,90.0,75.26132404181185,116.02787456445994
1262,Eli Junior Kroupi,FRA,"FW,MF",Lorient,Ligue 1,17,2006,12.0,7,4,2,2,3,1,9,11.1,8,6,0,6,10,17,5,0,0,2023-2024,90.0,75.0,52.5
1263,Hamed Junior Traorè,CIV,MF,Bournemouth,Premier League,23,2000,0.5,1,0,1,0,0,1,3,33.3,2,3,0,3,0,1,0,0,0,2023-2024,90.0,0.0,180.0
1264,Hamed Junior Traorè,CIV,MF,Napoli,Serie A,23,2000,4.2,4,2,2,0,2,1,6,16.7,5,3,0,3,2,6,1,1,0,2023-2024,90.0,42.857142857142854,85.71428571428571
1265,Vinicius Júnior,BRA,FW,Real Madrid,La Liga,23,2000,20.7,18,13,5,5,8,3,12,25.0,9,13,0,13,1,19,3,2,0,2023-2024,90.0,4.347826086956522,78.26086956521739
1266,Josip Juranović,CRO,DF,Union Berlin,Bundesliga,27,1995,14.4,20,14,11,7,2,10,21,47.6,11,17,3,14,12,32,27,1,0,2023-2024,90.0,75.0,125.0
1267,David Jurásek,CZE,DF,Hoffenheim,Bundesliga,22,2000,5.5,14,11,13,1,0,7,17,41.2,10,7,2,5,3,17,22,1,0,2023-2024,90.0,49.09090909090909,229.0909090909091
1268,Julian Justvan,GER,"FW,MF",Hoffenheim,Bundesliga,25,1998,0.5,1,0,1,0,0,1,2,50.0,1,1,0,1,0,1,0,0,0,2023-2024,90.0,0.0,180.0
1269,Julian Justvan,GER,"MF,FW",Darmstadt 98,Bundesliga,25,1998,11.4,10,4,2,7,1,3,17,17.6,14,12,2,10,11,21,6,1,0,2023-2024,90.0,86.84210526315789,78.94736842105263
1270,Filip Jørgensen,DEN,GK,Villarreal,La Liga,21,2002,36.0,3,1,3,0,0,3,4,75.0,1,0,0,0,2,5,10,3,0,2023-2024,90.0,5.0,7.5
1271,Mathias Jørgensen,DEN,DF,Brentford,Premier League,33,1990,12.1,17,12,15,1,1,11,19,57.9,8,9,5,4,12,29,40,0,0,2023-2024,90.0,89.25619834710743,126.44628099173553
1272,Mohamed Kaba,FRA,MF,Lecce,Serie A,21,2001,15.3,39,23,15,16,8,17,34,50.0,17,22,4,18,12,51,13,0,0,2023-2024,90.0,70.58823529411764,229.41176470588235
1273,Sory Kaba,GUI,FW,Las Palmas,La Liga,28,1995,8.0,2,0,0,2,0,0,5,0.0,5,6,0,6,0,2,9,0,0,2023-2024,90.0,0.0,22.5
1274,Ozan Kabak,TUR,DF,Hoffenheim,Bundesliga,23,2000,25.4,48,35,32,14,2,19,33,57.6,14,43,21,22,46,94,106,2,0,2023-2024,90.0,162.99212598425197,170.07874015748033
1275,Christian Kabasele,BEL,DF,Udinese,Serie A,32,1991,9.6,10,7,4,5,1,2,11,18.2,9,15,9,6,12,22,56,0,0,2023-2024,90.0,112.50000000000001,93.75
Rk,Player,Nation,Pos,Squad,Comp,0,0,90.0,0,0,3,3,3,Tkl,0,0.0,0,0,0,0,0,0,0,0,0,2023-2024,90.0,0.0,0.0
1276,Issa Kaboré,BFA,DF,Luton Town,Premier League,22,2001,19.2,52,28,23,21,8,24,45,53.3,21,22,11,11,16,68,56,2,0,2023-2024,90.0,75.0,243.75000000000003
1277,Abdoul Kader Bamba,FRA,"FW,MF",Nantes,Ligue 1,29,1994,6.8,10,7,2,5,3,5,15,33.3,10,4,0,4,4,14,4,1,0,2023-2024,90.0,52.94117647058823,132.35294117647058
1278,Yaya Kader Fofana,MLI,"MF,DF",Reims,Ligue 1,19,2004,0.4,3,3,1,1,1,0,1,0.0,1,0,0,0,1,4,0,0,0,2023-2024,90.0,225.0,675.0
1279,Pavel Kadeřábek,CZE,"DF,FW",Hoffenheim,Bundesliga,31,1992,26.8,31,19,10,15,6,18,40,45.0,22,22,8,14,23,54,68,0,0,2023-2024,90.0,77.23880597014924,104.10447761194028
1280,Tino Kadewere,ZIM,"FW,MF",Lyon,Ligue 1,27,1996,3.3,1,1,0,1,0,1,5,20.0,4,3,1,2,5,6,7,0,0,2023-2024,90.0,136.36363636363637,27.272727272727273
1281,Tino Kadewere,ZIM,"FW,MF",Nantes,Ligue 1,27,1996,8.7,9,4,3,3,3,6,11,54.5,5,10,1,9,10,19,8,0,0,2023-2024,90.0,103.44827586206897,93.10344827586206
1282,Kaiky,BRA,DF,Almería,La Liga,19,2004,5.8,7,4,6,0,1,3,6,50.0,3,9,7,2,3,10,29,1,0,2023-2024,90.0,46.55172413793103,108.62068965517241
1283,Florian Kainz,AUT,"MF,FW",Köln,Bundesliga,30,1992,24.4,28,20,8,13,7,17,39,43.6,22,20,6,14,13,41,23,1,0,2023-2024,90.0,47.95081967213115,103.27868852459018
1284,Sasa Kalajdzic,AUT,FW,Wolves,Premier League,26,1997,1.8,6,2,3,2,1,1,2,50.0,1,3,0,3,1,7,6,0,0,2023-2024,90.0,50.0,300.0
1285,Sasa Kalajdzic,AUT,FW,Eint Frankfurt,Bundesliga,26,1997,3.6,2,2,0,2,0,0,0,0.0,0,2,2,0,2,4,6,0,0,2023-2024,90.0,50.0,50.0
1286,Arnaud Kalimuendo,FRA,FW,Rennes,Ligue 1,21,2002,23.8,5,4,2,2,1,2,5,40.0,3,13,2,11,4,9,4,0,0,2023-2024,90.00000000000001,15.126050420168069,18.907563025210084
1287,Yayah Kallon,SLE,FW,Hellas Verona,Serie A,22,2001,0.0,0,0,0,0,0,0,0,0.0,0,0,0,0,0,0,0,0,0,2023-2024,,,
1288,Gedeon Kalulu,COD,DF,Lorient,Ligue 1,25,1997,10.8,23,17,13,8,2,12,22,54.5,10,18,2,16,5,28,30,0,0,2023-2024,90.0,41.666666666666664,191.66666666666666
1289,Pierre Kalulu,FRA,DF,Milan,Serie A,23,2000,4.2,5,1,2,3,0,1,2,50.0,1,4,3,1,1,6,12,1,0,2023-2024,90.0,21.428571428571427,107.14285714285714
1290,Daichi Kamada,JPN,MF,Lazio,Serie A,26,1996,17.2,53,36,22,22,9,28,52,53.8,24,24,5,19,18,71,7,0,0,2023-2024,90.0,94.18604651162792,277.3255813953489
1291,Waren Kamanzi,NOR,"DF,FW",Toulouse,Ligue 1,22,2000,13.2,36,24,16,16,4,13,23,56.5,10,11,3,8,9,45,35,0,0,2023-2024,90.0,61.36363636363637,245.45454545454547
1292,Boubacar Kamara,FRA,MF,Aston Villa,Premier League,23,1999,18.4,43,29,16,21,6,24,47,51.1,23,21,7,14,21,64,16,0,0,2023-2024,90.0,102.71739130434783,210.32608695652175
1293,Hassane Kamara,CIV,DF,Udinese,Serie A,29,1994,24.7,45,32,26,13,6,25,38,65.8,13,29,2,27,26,71,66,0,0,2023-2024,90.0,94.73684210526316,163.9676113360324
1294,Willy Kambwala,FRA,DF,Manchester Utd,Premier League,18,2004,3.7,3,1,1,2,0,1,3,33.3,2,6,3,3,4,7,14,1,0,2023-2024,90.0,97.29729729729729,72.97297297297297
1295,Jakub Kamiński,POL,"FW,MF",Wolfsburg,Bundesliga,21,2002,5.3,14,5,12,2,0,3,6,50.0,3,3,0,3,2,16,5,0,0,2023-2024,90.0,33.9622641509434,237.7358490566038
1296,Thomas Kaminski,BEL,GK,Luton Town,Premier League,30,1992,37.8,2,1,2,0,0,2,6,33.3,4,1,0,1,0,2,14,2,0,2023-2024,90.0,0.0,4.761904761904762
1297,Kevin Kampl,SVN,MF,RB Leipzig,Bundesliga,32,1990,15.1,19,8,8,9,2,10,21,47.6,11,19,7,12,11,30,14,1,0,2023-2024,90.0,65.56291390728477,113.24503311258279
1298,Harry Kane,ENG,FW,Bayern Munich,Bundesliga,30,1993,31.5,13,9,4,4,5,6,18,33.3,12,12,4,8,6,19,14,0,0,2023-2024,90.0,17.142857142857142,37.142857142857146
1299,Lee Kang-in,KOR,"FW,MF",Paris S-G,Ligue 1,22,2001,16.3,26,13,7,9,10,15,36,41.7,21,7,0,7,6,32,3,0,0,2023-2024,90.0,33.12883435582822,143.55828220858896
1300,Yann Karamoh,FRA,"MF,FW",Torino,Serie A,25,1998,1.8,1,0,0,0,1,0,0,0.0,0,0,0,0,0,1,1,0,0,2023-2024,90.0,0.0,50.0
Rk,Player,Nation,Pos,Squad,Comp,0,0,90.0,0,0,3,3,3,Tkl,0,0.0,0,0,0,0,0,0,0,0,0,2023-2024,90.0,0.0,0.0
1301,Yann Karamoh,FRA,"FW,MF",Montpellier,Ligue 1,25,1998,3.2,1,0,0,0,1,1,2,50.0,1,3,0,3,0,1,0,0,0,2023-2024,90.0,0.0,28.125
1302,Atakan Karazor,GER,MF,Stuttgart,Bundesliga,26,1996,29.1,72,44,23,38,11,29,60,48.3,31,37,8,29,27,99,43,0,0,2023-2024,90.0,83.50515463917525,222.680412371134
1303,Ayman Kari,FRA,MF,Lorient,Ligue 1,18,2004,9.9,18,14,9,9,0,12,19,63.2,7,19,2,17,6,24,9,1,0,2023-2024,90.0,54.54545454545455,163.63636363636363
1304,Emir Karic,AUT,DF,Darmstadt 98,Bundesliga,26,1997,19.8,45,27,23,14,8,21,33,63.6,12,42,11,31,13,58,43,0,0,2023-2024,90.0,59.09090909090909,204.54545454545453
1305,Loris Karius,GER,GK,Newcastle Utd,Premier League,30,1993,1.0,0,0,0,0,0,0,0,0.0,0,0,0,0,0,0,1,0,0,2023-2024,90.0,0.0,0.0
1306,Jesper Karlsson,SWE,FW,Bologna,Serie A,25,1998,3.8,3,3,2,1,0,2,8,25.0,6,4,0,4,4,7,1,0,0,2023-2024,90.0,94.73684210526315,71.05263157894737
1307,Jon Karrikaburu,ESP,"MF,FW",Alavés,La Liga,20,2002,0.2,0,0,0,0,0,0,0,0.0,0,0,0,0,0,0,0,0,0,2023-2024,90.0,0.0,0.0
1308,Rick Karsdorp,NED,DF,Roma,Serie A,28,1995,13.2,25,18,11,8,6,16,24,66.7,8,13,4,9,9,34,16,0,0,2023-2024,90.0,61.36363636363637,170.45454545454547
1309,Grigoris Kastanos,CYP,"MF,DF",Salernitana,Serie A,25,1998,16.4,23,14,8,9,6,9,20,45.0,11,13,4,9,8,31,9,0,0,2023-2024,90.0,43.90243902439025,126.21951219512196
1310,Silas Katompa,COD,"FW,MF",Stuttgart,Bundesliga,24,1998,10.0,5,3,3,2,0,3,12,25.0,9,9,0,9,0,5,4,0,0,2023-2024,90.0,0.0,45.0
1311,Panos Katseris,GRE,DF,Lorient,Ligue 1,22,2001,11.6,26,20,16,8,2,16,25,64.0,9,20,4,16,8,34,18,0,0,2023-2024,90.0,62.06896551724138,201.72413793103448
1312,Mikkel Kaufmann,DEN,FW,Union Berlin,Bundesliga,22,2001,5.4,6,3,2,3,1,3,10,30.0,7,12,0,12,1,7,4,0,0,2023-2024,90.0,16.666666666666664,99.99999999999999
1313,Michael Kayode,ITA,DF,Fiorentina,Serie A,19,2004,22.9,53,30,27,15,11,35,48,72.9,13,25,12,13,18,71,46,2,0,2023-2024,90.0,70.74235807860262,208.29694323144108
1314,Moise Kean,ITA,FW,Juventus,Serie A,23,2000,7.3,7,4,3,2,2,1,3,33.3,2,4,1,3,2,9,5,0,0,2023-2024,90.0,24.657534246575345,86.3013698630137
1315,Michael Keane,ENG,DF,Everton,Premier League,30,1993,4.9,7,3,3,3,1,1,7,14.3,6,5,4,1,5,12,18,1,0,2023-2024,90.0,91.83673469387755,128.57142857142856
1316,Ibrahima Kebe,MLI,MF,Girona,La Liga,22,2000,0.1,1,1,0,1,0,0,0,0.0,0,1,0,1,1,2,0,0,0,2023-2024,90.0,900.0,900.0
1317,Kévin Keben Biakolo,CMR,DF,Toulouse,Ligue 1,19,2004,5.8,4,2,4,0,0,3,6,50.0,3,7,0,7,8,12,17,0,0,2023-2024,90.0,124.13793103448276,62.06896551724138
1318,Yassine Kechta,MAR,MF,Le Havre,Ligue 1,21,2002,20.5,46,24,24,19,3,31,73,42.5,42,20,3,17,23,69,16,1,0,2023-2024,90.0,100.97560975609757,201.95121951219514
1319,Thilo Kehrer,GER,"DF,MF",West Ham,Premier League,26,1996,0.2,1,1,0,1,0,0,0,0.0,0,2,2,0,0,1,0,0,0,2023-2024,90.0,0.0,450.0
1320,Thilo Kehrer,GER,DF,Monaco,Ligue 1,26,1996,14.7,32,22,22,7,3,22,39,56.4,17,18,6,12,30,62,55,0,0,2023-2024,90.0,183.67346938775512,195.91836734693877
1321,Habib Keita,MLI,MF,Clermont Foot,Ligue 1,21,2002,14.2,34,19,14,15,5,17,28,60.7,11,27,10,17,29,63,30,0,0,2023-2024,90.0,183.80281690140848,215.49295774647888
1322,Naby Keïta,GUI,"MF,DF",Werder Bremen,Bundesliga,28,1995,1.2,1,1,1,0,0,0,1,0.0,1,2,0,2,2,3,1,0,0,2023-2024,90.0,150.0,75.0
1323,Yannik Keitel,GER,"DF,MF",Freiburg,Bundesliga,23,2000,10.2,20,15,14,5,1,10,15,66.7,5,17,8,9,12,32,44,3,0,2023-2024,90.0,105.88235294117648,176.47058823529412
1324,Caoimhín Kelleher,IRL,GK,Liverpool,Premier League,24,1998,10.0,0,0,0,0,0,0,0,0.0,0,0,0,0,0,0,4,1,0,2023-2024,90.0,0.0,0.0
1325,Thomas Keller,GER,"MF,FW",Heidenheim,Bundesliga,23,1999,0.0,0,0,0,0,0,0,0,0.0,0,0,0,0,0,0,0,0,0,2023-2024,,,
Rk,Player,Nation,Pos,Squad,Comp,0,0,90.0,0,0,3,3,3,Tkl,0,0.0,0,0,0,0,0,0,0,0,0,2023-2024,90.0,0.0,0.0
1326,Lloyd Kelly,ENG,DF,Bournemouth,Premier League,24,1998,17.3,24,19,10,9,5,14,25,56.0,11,22,12,10,13,37,67,0,0,2023-2024,90.0,67.6300578034682,124.85549132947976
1327,Omari Kellyman,ENG,FW,Aston Villa,Premier League,17,2005,0.4,1,0,0,1,0,1,2,50.0,1,0,0,0,0,1,0,0,0,2023-2024,90.0,0.0,225.0
1328,Aljoscha Kemlein,GER,MF,Union Berlin,Bundesliga,18,2004,0.3,0,0,0,0,0,0,3,0.0,3,1,0,1,0,0,0,0,0,2023-2024,90.0,0.0,0.0
1329,Tobias Kempe,GER,MF,Darmstadt 98,Bundesliga,34,1989,15.0,20,13,9,8,3,8,24,33.3,16,16,4,12,9,29,12,0,0,2023-2024,90.0,54.0,120.0
1330,Milos Kerkez,HUN,DF,Bournemouth,Premier League,19,2003,21.9,47,26,31,13,3,30,42,71.4,12,31,11,20,20,67,60,2,0,2023-2024,90.0,82.19178082191782,193.15068493150687
1331,Kaine Kesler-Hayden,ENG,"MF,DF",Aston Villa,Premier League,20,2002,0.1,0,0,0,0,0,0,0,0.0,0,0,0,0,0,0,0,0,0,2023-2024,90.0,0.0,0.0
1332,Reda Khadra,GER,"FW,MF",Reims,Ligue 1,22,2001,15.2,16,10,5,4,7,8,20,40.0,12,8,2,6,3,19,13,0,0,2023-2024,90.0,17.763157894736842,94.73684210526315
1333,Wahbi Khazri,TUN,FW,Montpellier,Ligue 1,32,1991,12.6,24,17,8,12,4,14,35,40.0,21,10,0,10,3,27,7,0,0,2023-2024,90.0,21.42857142857143,171.42857142857144
1334,Rani Khedira,GER,MF,Union Berlin,Bundesliga,29,1994,14.9,35,22,15,19,1,17,26,65.4,9,12,5,7,22,57,38,0,0,2023-2024,90.0,132.88590604026845,211.40939597315435
1335,Abdukodir Khusanov,UZB,DF,Lens,Ligue 1,19,2004,9.0,21,12,13,8,0,9,17,52.9,8,13,8,5,13,34,32,2,0,2023-2024,90.0,130.0,210.0
1336,Kiké,ESP,"FW,MF",Alavés,La Liga,33,1989,15.8,8,4,2,3,3,4,9,44.4,5,16,5,11,1,9,12,0,0,2023-2024,90.0,5.696202531645569,45.56962025316455
1337,Luca Kilian,GER,DF,Köln,Bundesliga,23,1999,7.1,16,9,15,1,0,9,14,64.3,5,12,5,7,7,23,28,0,0,2023-2024,90.0,88.73239436619718,202.81690140845072
1338,Max Kilman,ENG,DF,Wolves,Premier League,26,1997,38.0,47,21,40,6,1,24,32,75.0,8,64,37,27,39,86,182,4,0,2023-2024,90.0,92.36842105263158,111.3157894736842
1339,Joshua Kimmich,GER,"MF,DF",Bayern Munich,Bundesliga,28,1995,24.2,45,33,25,15,5,26,39,66.7,13,32,4,28,14,59,28,1,0,2023-2024,90.0,52.06611570247934,167.35537190082644
1340,Jakub Kiwior,POL,DF,Arsenal,Premier League,23,2000,10.5,20,12,11,8,1,14,19,73.7,5,11,3,8,8,28,28,1,0,2023-2024,90.0,68.57142857142857,171.42857142857142
1341,Simon Kjær,DEN,DF,Milan,Serie A,34,1989,13.0,24,15,11,11,2,14,22,63.6,8,22,16,6,14,38,46,2,0,2023-2024,90.00000000000001,96.92307692307693,166.15384615384616
1342,Davy Klaassen,NED,MF,Inter,Serie A,30,1993,2.3,4,2,0,4,0,1,3,33.3,2,5,1,4,3,7,4,0,0,2023-2024,90.0,117.3913043478261,156.52173913043478
1343,Christoph Klarer,AUT,DF,Darmstadt 98,Bundesliga,23,2000,26.2,37,22,30,4,3,24,36,66.7,12,31,20,11,21,58,94,1,0,2023-2024,90.0,72.13740458015268,127.09923664122138
1344,Tim Kleindienst,GER,FW,Heidenheim,Bundesliga,27,1995,31.9,21,12,6,11,4,7,25,28.0,18,32,8,24,12,33,58,0,0,2023-2024,90.0,33.85579937304075,59.24764890282132
1345,Lukas Klostermann,GER,DF,RB Leipzig,Bundesliga,27,1996,16.0,15,10,7,7,1,4,13,30.8,9,25,12,13,13,28,64,1,0,2023-2024,90.0,73.125,84.375
1346,Justin Kluivert,NED,"MF,FW",Bournemouth,Premier League,24,1999,21.3,28,14,5,12,11,8,30,26.7,22,16,1,15,8,36,11,0,0,2023-2024,90.0,33.80281690140845,118.30985915492958
1347,Ansgar Knauff,GER,"MF,DF",Eint Frankfurt,Bundesliga,21,2002,23.4,43,26,17,16,10,17,31,54.8,14,40,3,37,20,63,15,0,0,2023-2024,89.99999999999999,76.92307692307692,165.3846153846154
1348,Robin Knoche,GER,DF,Union Berlin,Bundesliga,31,1992,21.3,34,22,27,7,0,19,30,63.3,11,27,19,8,13,47,73,0,0,2023-2024,90.0,54.929577464788736,143.66197183098592
1349,Gregor Kobel,SUI,GK,Dortmund,Bundesliga,25,1997,26.3,0,0,0,0,0,0,1,0.0,1,0,0,0,0,0,11,0,0,2023-2024,90.0,0.0,0.0
1350,Robin Koch,GER,DF,Eint Frankfurt,Bundesliga,27,1996,30.4,38,23,26,12,0,17,27,63.0,10,33,24,9,32,70,136,2,0,2023-2024,90.0,94.73684210526315,112.5
Rk,Player,Nation,Pos,Squad,Comp,0,0,90.0,0,0,3,3,3,Tkl,0,0.0,0,0,0,0,0,0,0,0,0,2023-2024,90.0,0.0,0.0
1351,Philipp Köhn,SUI,GK,Monaco,Ligue 1,25,1998,22.0,1,1,1,0,0,1,1,100.0,0,0,0,0,1,2,5,3,0,2023-2024,90.0,4.090909090909091,4.090909090909091
1352,Dominik Kohr,GER,"DF,MF",Mainz 05,Bundesliga,29,1994,24.3,65,42,36,25,4,36,57,63.2,21,27,6,21,43,108,58,0,0,2023-2024,90.0,159.25925925925924,240.74074074074073
1353,Koke,ESP,MF,Atlético Madrid,La Liga,31,1992,27.7,66,44,27,32,7,36,79,45.6,43,37,12,25,16,82,34,1,0,2023-2024,90.0,51.985559566787,214.4404332129964
1354,Sead Kolašinac,BIH,DF,Atalanta,Serie A,30,1993,24.2,44,32,23,19,2,30,49,61.2,19,22,9,13,21,65,47,0,0,2023-2024,90.0,78.099173553719,163.63636363636363
1355,Luca Koleosho,ITA,"MF,FW",Burnley,Premier League,18,2004,10.8,7,4,2,5,0,2,10,20.0,8,13,0,13,2,9,0,0,0,2023-2024,90.0,16.666666666666664,58.33333333333333
1356,Randal Kolo Muani,FRA,"FW,MF",Paris S-G,Ligue 1,24,1998,14.1,10,8,5,3,2,5,13,38.5,8,5,0,5,4,14,10,0,0,2023-2024,89.99999999999999,25.53191489361702,63.82978723404255
1357,Randal Kolo Muani,FRA,FW,Eint Frankfurt,Bundesliga,24,1998,1.7,0,0,0,0,0,0,0,0.0,0,0,0,0,0,0,1,0,0,2023-2024,90.0,0.0,0.0
1358,Mert Kömür,GER,"MF,DF",Augsburg,Bundesliga,18,2005,1.3,3,3,3,0,0,3,5,60.0,2,0,0,0,0,3,1,0,0,2023-2024,90.0,0.0,207.69230769230768
1359,Cheick Konaté,MLI,DF,Clermont Foot,Ligue 1,19,2004,11.9,26,15,17,9,0,20,36,55.6,16,16,2,14,13,39,21,0,0,2023-2024,90.00000000000001,98.31932773109244,196.6386554621849
1360,Ibrahima Konaté,FRA,DF,Liverpool,Premier League,24,1999,17.5,36,22,22,13,1,18,24,75.0,6,18,12,6,20,56,51,1,0,2023-2024,90.0,102.85714285714286,185.14285714285714
1361,Geoffrey Kondogbia,CTA,MF,Marseille,Ligue 1,30,1993,16.3,48,31,18,25,5,13,32,40.6,19,21,4,17,30,78,25,0,0,2023-2024,90.0,165.64417177914112,265.03067484662574
1362,Abdoul Koné,FRA,DF,Reims,Ligue 1,18,2005,2.1,7,7,5,2,0,4,11,36.4,7,2,0,2,2,9,9,0,0,2023-2024,90.0,85.71428571428571,300.0
1363,Amadou Koné,MLI,MF,Reims,Ligue 1,18,2005,5.3,13,8,11,2,0,6,10,60.0,4,8,3,5,10,23,10,0,0,2023-2024,90.0,169.811320754717,220.75471698113208
1364,Ibrahima Koné,MLI,FW,Almería,La Liga,24,1999,3.1,1,0,1,0,0,1,1,100.0,0,1,0,1,0,1,4,0,0,2023-2024,90.0,0.0,29.032258064516128
1365,Ibrahima Koné,MLI,FW,Lorient,Ligue 1,24,1999,0.4,0,0,0,0,0,0,1,0.0,1,0,0,0,0,0,0,0,0,2023-2024,90.0,0.0,0.0
1366,Manu Koné,FRA,MF,Gladbach,Bundesliga,22,2001,17.3,45,26,20,20,5,17,25,68.0,8,22,1,21,15,60,16,1,0,2023-2024,90.0,78.03468208092485,234.10404624277456
1367,Ezri Konsa,ENG,DF,Aston Villa,Premier League,25,1997,34.1,54,32,28,23,3,23,27,85.2,4,36,20,16,28,82,73,3,0,2023-2024,90.0,73.90029325513197,142.52199413489737
1368,Teun Koopmeiners,NED,MF,Atalanta,Serie A,25,1998,29.2,39,24,12,22,5,17,50,34.0,33,33,3,30,10,49,35,0,0,2023-2024,90.0,30.82191780821918,120.2054794520548
1369,Odilon Kossonou,CIV,DF,Leverkusen,Bundesliga,22,2001,20.1,30,20,11,12,7,15,26,57.7,11,27,3,24,27,57,43,1,0,2023-2024,90.0,120.89552238805969,134.32835820895522
1370,Filip Kostić,SRB,DF,Juventus,Serie A,30,1992,20.2,37,23,20,13,4,17,33,51.5,16,29,8,21,9,46,43,0,0,2023-2024,90.0,40.0990099009901,164.85148514851485
1371,Christian Kouamé,CIV,FW,Fiorentina,Serie A,25,1997,12.1,13,4,7,6,0,6,10,60.0,4,16,0,16,2,15,10,0,0,2023-2024,90.0,14.87603305785124,96.69421487603306
1372,Rominigue Kouamé,MLI,MF,Cádiz,La Liga,26,1996,9.1,14,9,6,7,1,7,15,46.7,8,10,2,8,13,27,10,1,0,2023-2024,90.0,128.57142857142858,138.46153846153845
1373,Koffi Kouao,CIV,DF,Metz,Ligue 1,25,1998,9.6,20,13,12,7,1,11,17,64.7,6,9,6,3,13,33,38,1,0,2023-2024,90.0,121.87500000000001,187.5
1374,Tomáš Koubek,CZE,GK,Augsburg,Bundesliga,30,1992,3.0,0,0,0,0,0,0,0,0.0,0,0,0,0,0,0,1,1,0,2023-2024,90.0,0.0,0.0
1375,Therence Koudou,FRA,DF,Reims,Ligue 1,18,2004,3.5,2,2,1,1,0,0,2,0.0,2,4,3,1,4,6,9,0,0,2023-2024,90.0,102.85714285714286,51.42857142857143
Rk,Player,Nation,Pos,Squad,Comp,0,0,90.0,0,0,3,3,3,Tkl,0,0.0,0,0,0,0,0,0,0,0,0,2023-2024,90.0,0.0,0.0
1376,Jules Koundé,FRA,DF,Barcelona,La Liga,24,1998,32.2,37,23,22,10,5,28,51,54.9,23,32,12,20,25,62,83,5,0,2023-2024,90.0,69.87577639751552,103.41614906832298
1377,Boubakar Kouyaté,MLI,DF,Montpellier,Ligue 1,26,1997,21.4,49,30,39,8,2,28,51,54.9,23,31,20,11,29,78,123,1,0,2023-2024,90.0,121.96261682242992,206.0747663551402
1378,Cheikhou Kouyaté,SEN,MF,Nott'ham Forest,Premier League,33,1989,2.4,8,5,3,3,2,1,4,25.0,3,4,1,3,2,10,10,0,0,2023-2024,90.0,75.0,300.0
1379,Mateo Kovačić,CRO,MF,Manchester City,Premier League,29,1994,17.2,36,25,16,15,5,18,28,64.3,10,23,1,22,10,46,10,0,0,2023-2024,90.0,52.32558139534884,188.37209302325584
1380,Viktor Kovalenko,UKR,MF,Empoli,Serie A,27,1996,6.8,5,2,2,2,1,2,8,25.0,6,12,2,10,1,6,7,0,0,2023-2024,90.0,13.235294117647058,66.17647058823529
1381,Matej Kovar,CZE,GK,Leverkusen,Bundesliga,23,2000,1.0,0,0,0,0,0,0,0,0.0,0,0,0,0,0,0,0,0,0,2023-2024,90.0,0.0,0.0
1382,Dawid Kownacki,POL,FW,Werder Bremen,Bundesliga,26,1997,4.2,1,1,1,0,0,1,4,25.0,3,3,1,2,0,1,1,0,0,2023-2024,90.0,0.0,21.428571428571427
1383,Emil Krafth,SWE,DF,Newcastle Utd,Premier League,28,1994,10.1,21,14,10,7,4,12,25,48.0,13,8,3,5,9,30,21,0,0,2023-2024,90.0,80.1980198019802,187.12871287128712
1384,Alex Král,CZE,MF,Union Berlin,Bundesliga,25,1998,15.2,19,14,7,10,2,8,20,40.0,12,15,4,11,11,30,30,0,0,2023-2024,90.0,65.13157894736842,112.5
1385,Andrej Kramarić,CRO,"MF,FW",Hoffenheim,Bundesliga,32,1991,24.4,11,2,5,4,2,6,13,46.2,7,14,2,12,10,21,12,2,0,2023-2024,90.0,36.88524590163935,40.57377049180328
1386,Christoph Kramer,GER,MF,Gladbach,Bundesliga,32,1991,2.8,10,5,5,5,0,2,14,14.3,12,7,1,6,4,14,6,0,0,2023-2024,90.0,128.57142857142858,321.42857142857144
1387,Frans Krätzig,GER,DF,Bayern Munich,Bundesliga,20,2003,0.6,2,0,2,0,0,1,2,50.0,1,0,0,0,0,2,0,0,0,2023-2024,90.0,0.0,300.0
1388,Tom Krauß,GER,MF,Mainz 05,Bundesliga,22,2001,15.0,57,33,22,31,4,21,58,36.2,37,33,4,29,17,74,28,0,0,2023-2024,90.0,102.0,342.0
1389,Rasmus Kristensen,DEN,DF,Roma,Serie A,26,1997,19.4,36,19,25,8,3,28,50,56.0,22,27,7,20,8,44,50,0,0,2023-2024,90.0,37.11340206185567,167.01030927835055
1390,Thomas Kristensen,DEN,DF,Udinese,Serie A,21,2002,23.3,35,24,25,10,0,21,33,63.6,12,29,20,9,29,64,118,0,0,2023-2024,90.0,112.01716738197425,135.1931330472103
1391,Toni Kroos,GER,MF,Real Madrid,La Liga,33,1990,23.6,53,34,19,25,9,24,59,40.7,35,22,4,18,17,70,11,1,0,2023-2024,90.0,64.83050847457626,202.1186440677966
1392,Nikola Krstović,MNE,FW,Lecce,Serie A,23,2000,26.4,17,6,3,9,5,6,10,60.0,4,12,4,8,4,21,22,0,0,2023-2024,90.0,13.636363636363637,57.95454545454545
1393,Rade Krunić,BIH,MF,Milan,Serie A,29,1993,7.6,10,8,3,6,1,4,9,44.4,5,7,3,4,11,21,14,0,0,2023-2024,90.0,130.26315789473685,118.42105263157895
1394,Lukas Kübler,GER,DF,Freiburg,Bundesliga,30,1992,20.5,50,24,35,13,2,26,42,61.9,16,36,14,22,37,87,57,1,0,2023-2024,90.0,162.4390243902439,219.51219512195124
1395,Takefusa Kubo,JPN,"FW,MF",Real Sociedad,La Liga,22,2001,23.9,26,17,15,6,5,9,23,39.1,14,21,2,19,11,37,8,1,0,2023-2024,90.0,41.42259414225941,97.90794979079499
1396,Mahmut Kücüksahin,,MF,Augsburg,Bundesliga,19,2004,0.0,0,0,0,0,0,0,0,0.0,0,0,0,0,0,0,0,0,0,2023-2024,,,
1397,Mohammed Kudus,GHA,"FW,MF",West Ham,Premier League,22,2000,27.6,65,47,27,27,11,20,40,50.0,20,25,0,25,11,76,9,1,0,2023-2024,90.0,35.8695652173913,211.9565217391304
1398,Christian Kühlwetter,GER,MF,Heidenheim,Bundesliga,27,1996,0.1,0,0,0,0,0,0,0,0.0,0,0,0,0,0,0,0,0,0,2023-2024,90.0,0.0,0.0
1399,Dejan Kulusevski,SWE,"FW,MF",Tottenham,Premier League,23,2000,30.7,62,33,19,20,23,25,67,37.3,42,24,1,23,18,80,2,1,0,2023-2024,90.0,52.76872964169382,181.75895765472313
1400,Sael Kumbedi,FRA,DF,Lyon,Ligue 1,18,2005,10.3,30,20,14,12,4,9,22,40.9,13,12,3,9,14,44,18,2,0,2023-2024,90.0,122.33009708737863,262.13592233009706
Rk,Player,Nation,Pos,Squad,Comp,0,0,90.0,0,0,3,3,3,Tkl,0,0.0,0,0,0,0,0,0,0,0,0,2023-2024,90.0,0.0,0.0
1401,Marash Kumbulla,ALB,DF,Sassuolo,Serie A,23,2000,4.0,3,2,2,1,0,1,2,50.0,1,8,6,2,0,3,22,0,0,2023-2024,90.0,0.0,67.5
1402,Justin Kumi,ITA,FW,Sassuolo,Serie A,19,2004,0.0,0,0,0,0,0,0,0,0.0,0,0,0,0,0,0,0,0,0,2023-2024,,,
1403,Layvin Kurzawa,FRA,DF,Paris S-G,Ligue 1,30,1992,0.1,0,0,0,0,0,0,0,0.0,0,0,0,0,0,0,0,0,0,2023-2024,90.0,0.0,0.0
1404,Berkan Kutlu,TUR,MF,Genoa,Serie A,25,1998,2.2,6,4,5,1,0,3,6,50.0,3,3,0,3,4,10,5,0,0,2023-2024,90.0,163.63636363636363,245.45454545454544
1405,Daler Kuzyaev,RUS,MF,Le Havre,Ligue 1,30,1993,23.2,34,19,11,13,10,15,43,34.9,28,18,5,13,22,56,18,1,0,2023-2024,90.0,85.3448275862069,131.89655172413794
1406,Khvicha Kvaratskhelia,GEO,FW,Napoli,Serie A,22,2001,30.4,42,21,11,19,12,15,49,30.6,34,15,1,14,13,55,9,0,0,2023-2024,90.0,38.48684210526316,124.34210526315789
1407,Giorgi Kvernadze,GEO,"FW,DF",Frosinone,Serie A,20,2003,0.7,3,0,2,0,1,2,2,100.0,0,1,0,1,1,4,0,0,0,2023-2024,90.0,128.57142857142858,385.7142857142857
1408,Moritz-Broni Kwarteng,GHA,FW,Bochum,Bundesliga,25,1998,3.1,3,0,0,3,0,1,7,14.3,6,4,0,4,2,5,0,0,0,2023-2024,90.0,58.064516129032256,87.09677419354838
1409,Grejohn Kyei,FRA,FW,Clermont Foot,Ligue 1,27,1995,11.4,6,4,2,2,2,2,3,66.7,1,5,1,4,1,7,10,0,0,2023-2024,90.0,7.894736842105263,47.368421052631575
1410,Giorgos Kyriakopoulos,GRE,DF,Monza,Serie A,27,1996,19.0,19,10,16,3,0,11,24,45.8,13,18,1,17,13,32,28,0,0,2023-2024,90.0,61.578947368421055,90.0
1411,Luca de la Torre,USA,MF,Celta Vigo,La Liga,25,1998,21.7,39,21,12,22,5,22,43,51.2,21,23,4,19,12,51,17,0,0,2023-2024,90.0,49.76958525345622,161.75115207373273
1412,Gaëtan Laborde,FRA,"FW,MF",Nice,Ligue 1,29,1994,21.2,18,12,8,4,6,11,30,36.7,19,20,2,18,6,24,8,1,0,2023-2024,90.0,25.471698113207548,76.41509433962264
1413,Alexandre Lacazette,FRA,FW,Lyon,Ligue 1,32,1991,25.5,19,12,8,9,2,5,17,29.4,12,22,3,19,8,27,9,0,0,2023-2024,90.0,28.235294117647058,67.05882352941177
1414,Maxence Lacroix,FRA,DF,Wolfsburg,Bundesliga,23,2000,26.2,48,29,28,18,2,29,41,70.7,12,35,12,23,24,72,121,0,0,2023-2024,90.0,82.44274809160305,164.8854961832061
1415,Alban Lafont,FRA,GK,Nantes,Ligue 1,24,1999,27.7,0,0,0,0,0,0,2,0.0,2,0,0,0,0,0,14,0,0,2023-2024,90.0,0.0,0.0
1416,Yoel Lago,ESP,DF,Celta Vigo,La Liga,19,2004,1.0,2,0,2,0,0,0,0,0.0,0,1,0,1,0,2,2,0,0,2023-2024,90.0,0.0,180.0
1417,Aïssa Laïdouni,TUN,MF,Union Berlin,Bundesliga,26,1996,11.9,21,12,4,12,5,4,12,33.3,8,26,2,24,12,33,14,2,0,2023-2024,90.00000000000001,90.75630252100841,158.82352941176472
1418,Konrad Laimer,AUT,"DF,MF",Bayern Munich,Bundesliga,26,1997,19.7,56,36,25,20,11,22,52,42.3,30,42,6,36,18,74,13,2,0,2023-2024,90.0,82.23350253807106,255.83756345177665
1419,Stefan Lainer,AUT,"DF,MF",Gladbach,Bundesliga,30,1992,8.3,23,16,15,8,0,14,24,58.3,10,13,6,7,5,28,28,0,0,2023-2024,90.0,54.21686746987951,249.39759036144576
1420,Kenny Lala,MAD,DF,Brest,Ligue 1,31,1991,33.0,78,51,39,28,11,30,56,53.6,26,27,6,21,28,106,75,1,0,2023-2024,90.0,76.36363636363637,212.72727272727275
1421,Adam Lallana,ENG,"MF,FW",Brighton,Premier League,35,1988,9.4,8,3,4,4,0,0,4,0.0,4,2,1,1,3,11,1,0,0,2023-2024,90.0,28.723404255319146,76.59574468085106
1422,Mathis Lambourde,FRA,FW,Rennes,Ligue 1,17,2006,0.1,0,0,0,0,0,0,1,0.0,1,1,0,1,0,0,1,0,0,2023-2024,90.0,0.0,0.0
1423,Érik Lamela,ARG,"FW,MF",Sevilla,La Liga,31,1992,5.1,21,14,4,10,7,10,15,66.7,5,12,0,12,1,22,5,0,0,2023-2024,90.0,17.647058823529413,370.5882352941177
1424,Mohamed Lamine Bayo,GUI,FW,Le Havre,Ligue 1,25,1998,15.4,13,5,2,5,6,2,10,20.0,8,8,1,7,2,15,11,0,0,2023-2024,90.0,11.688311688311689,75.97402597402598
1425,Didier Lamkel Zé,CMR,"FW,MF",Metz,Ligue 1,26,1996,6.1,7,2,2,4,1,2,5,40.0,3,4,0,4,0,7,11,0,0,2023-2024,90.0,0.0,103.27868852459018
Rk,Player,Nation,Pos,Squad,Comp,0,0,90.0,0,0,3,3,3,Tkl,0,0.0,0,0,0,0,0,0,0,0,0,2023-2024,90.0,0.0,0.0
1426,Tariq Lamptey,GHA,"DF,FW",Brighton,Premier League,22,2000,10.2,21,14,14,5,2,13,22,59.1,9,7,3,4,6,27,6,0,0,2023-2024,90.0,52.94117647058824,185.29411764705884
1427,Bruno Langa,MOZ,DF,Almería,La Liga,25,1997,9.1,17,12,10,5,2,6,14,42.9,8,11,4,7,4,21,33,2,0,2023-2024,90.0,39.56043956043956,168.13186813186815
1428,Gianluca Lapadula,PER,FW,Cagliari,Serie A,33,1990,13.4,1,1,0,0,1,1,10,10.0,9,2,1,1,2,3,5,0,0,2023-2024,90.0,13.432835820895521,6.716417910447761
1429,Aymeric Laporte,ESP,DF,Manchester City,Premier League,29,1994,0.1,0,0,0,0,0,0,0,0.0,0,1,1,0,0,0,1,0,0,2023-2024,90.0,0.0,0.0
1430,Julien Laporte,FRA,DF,Lorient,Ligue 1,29,1993,20.2,23,14,15,7,1,16,36,44.4,20,36,26,10,11,34,116,1,0,2023-2024,90.0,49.00990099009901,102.47524752475248
1431,Cyle Larin,CAN,FW,Mallorca,La Liga,28,1995,20.3,17,8,6,4,7,2,7,28.6,5,16,5,11,3,20,17,0,0,2023-2024,90.0,13.300492610837438,75.36945812807882
1432,Yasser Larouci,ALG,DF,Sheffield Utd,Premier League,22,2001,5.9,17,9,10,5,2,10,14,71.4,4,6,1,5,7,24,20,1,0,2023-2024,90.0,106.77966101694915,259.32203389830505
1433,Hugo Larsson,SWE,MF,Eint Frankfurt,Bundesliga,19,2004,21.0,32,18,18,10,4,15,28,53.6,13,34,7,27,29,61,30,1,0,2023-2024,90.0,124.28571428571428,137.14285714285714
1434,Jamaal Lascelles,ENG,DF,Newcastle Utd,Premier League,29,1993,12.0,14,9,7,7,0,6,11,54.5,5,17,12,5,5,19,42,0,0,2023-2024,90.0,37.5,105.0
1435,Juanmi Latasa,ESP,FW,Getafe,La Liga,22,2001,17.3,9,7,0,6,3,1,11,9.1,10,9,0,9,4,13,21,0,0,2023-2024,90.0,20.809248554913292,46.82080924855491
1436,Toni Lato,ESP,DF,Mallorca,La Liga,25,1997,17.2,38,23,19,13,6,16,27,59.3,11,17,3,14,17,55,27,0,0,2023-2024,90.0,88.95348837209303,198.8372093023256
1437,Armand Lauriente,FRA,FW,Sassuolo,Serie A,24,1998,32.3,31,20,8,14,9,13,44,29.5,31,29,4,25,15,46,11,0,0,2023-2024,90.0,41.795665634674926,86.37770897832817
1438,Roméo Lavia,BEL,MF,Chelsea,Premier League,19,2004,0.4,1,0,0,1,0,0,0,0.0,0,0,0,0,0,1,1,0,0,2023-2024,90.0,0.0,225.0
1439,Lázaro,BRA,"FW,MF",Almería,La Liga,21,2002,3.2,4,1,2,0,2,2,8,25.0,6,4,0,4,1,5,1,0,0,2023-2024,90.0,28.125,112.5
1440,Valentino Lazaro,AUT,"DF,MF",Torino,Serie A,27,1996,22.2,18,11,7,9,2,13,19,68.4,6,14,1,13,8,26,29,0,0,2023-2024,90.0,32.432432432432435,72.97297297297298
1441,Darko Lazović,SRB,"FW,MF",Hellas Verona,Serie A,32,1990,21.4,26,16,11,6,9,16,31,51.6,15,10,1,9,6,32,14,0,0,2023-2024,90.0,25.233644859813086,109.34579439252337
1442,Manuel Lazzari,ITA,DF,Lazio,Serie A,29,1993,18.6,26,18,13,10,3,18,28,64.3,10,20,4,16,12,38,37,1,0,2023-2024,90.0,58.06451612903225,125.8064516129032
1443,Théo Le Bris,FRA,"DF,MF",Lorient,Ligue 1,20,2002,16.8,35,22,25,7,3,19,40,47.5,21,24,3,21,12,47,42,0,0,2023-2024,90.0,64.28571428571428,187.5
1444,Julien Le Cardinal,FRA,DF,Brest,Ligue 1,25,1997,5.3,19,11,11,7,1,8,12,66.7,4,6,3,3,13,32,26,0,0,2023-2024,90.0,220.75471698113208,322.64150943396226
1445,Julien Le Cardinal,FRA,DF,Lens,Ligue 1,25,1997,0.6,6,2,4,2,0,4,9,44.4,5,2,1,1,0,6,0,0,0,2023-2024,90.0,0.0,900.0000000000001
1446,Jérémy Le Douaron,FRA,FW,Brest,Ligue 1,25,1998,18.0,21,10,7,9,5,11,26,42.3,15,14,1,13,2,23,10,0,0,2023-2024,90.0,10.0,105.0
1447,Enzo Le Fée,FRA,MF,Rennes,Ligue 1,23,2000,17.0,50,35,23,17,10,23,47,48.9,24,17,3,14,19,69,20,0,0,2023-2024,90.0,100.58823529411765,264.70588235294116
1448,Vincent Le Goff,FRA,"DF,MF",Lorient,Ligue 1,33,1989,6.0,5,0,4,0,1,4,8,50.0,4,11,3,8,3,8,10,0,0,2023-2024,90.0,45.0,75.0
1449,Robin Le Normand,ESP,DF,Real Sociedad,La Liga,26,1996,27.4,31,22,16,15,0,17,30,56.7,13,26,15,11,28,59,96,1,0,2023-2024,90.0,91.97080291970804,101.82481751824818
1450,Nicola Leali,ITA,GK,Genoa,Serie A,30,1993,2.0,0,0,0,0,0,0,0,0.0,0,0,0,0,0,0,0,0,0,2023-2024,90.0,0.0,0.0
Rk,Player,Nation,Pos,Squad,Comp,0,0,90.0,0,0,3,3,3,Tkl,0,0.0,0,0,0,0,0,0,0,0,0,2023-2024,90.0,0.0,0.0
1451,Rafael Leão,POR,FW,Milan,Serie A,24,1999,27.9,16,10,3,8,5,8,13,61.5,5,15,1,14,9,25,19,0,0,2023-2024,90.0,29.032258064516128,51.612903225806456
1452,Adrien Lebeau,FRA,"MF,FW",Brest,Ligue 1,24,1999,0.6,0,0,0,0,0,0,3,0.0,3,2,1,1,0,0,1,0,0,2023-2024,90.0,0.0,0.0
1453,Jean-Louis Leca,FRA,GK,Lens,Ligue 1,37,1985,1.0,0,0,0,0,0,0,0,0.0,0,0,0,0,0,0,1,0,0,2023-2024,90.0,0.0,0.0
1454,Benjamin Lecomte,FRA,GK,Montpellier,Ligue 1,32,1991,30.0,0,0,0,0,0,0,1,0.0,1,0,0,0,0,0,16,1,0,2023-2024,90.0,0.0,0.0
1455,Jeremías Ledesma,ARG,GK,Cádiz,La Liga,30,1993,33.9,1,1,1,0,0,1,4,25.0,3,0,0,0,0,1,15,3,0,2023-2024,90.0,0.0,2.6548672566371683
1456,Pierre Lees-Melou,FRA,MF,Brest,Ligue 1,30,1993,28.0,96,67,51,41,4,49,129,38.0,80,61,11,50,43,139,64,3,0,2023-2024,90.0,138.21428571428572,308.57142857142856
1457,Diogo Leite,POR,DF,Union Berlin,Bundesliga,24,1999,30.0,52,36,31,15,6,25,51,49.0,26,48,22,26,47,99,155,1,0,2023-2024,90.0,141.0,156.0
1458,Maxim Leitsch,GER,DF,Mainz 05,Bundesliga,25,1998,4.2,6,3,5,1,0,3,6,50.0,3,2,0,2,4,10,13,0,0,2023-2024,90.0,85.71428571428571,128.57142857142856
1459,Florian Lejeune,FRA,DF,Rayo Vallecano,La Liga,32,1991,37.0,39,25,26,11,2,19,30,63.3,11,33,18,15,23,62,155,1,0,2023-2024,90.0,55.94594594594595,94.86486486486487
1460,Stefan Lekovic,SRB,DF,Villarreal,La Liga,19,2004,0.3,0,0,0,0,0,0,0,0.0,0,1,1,0,0,0,1,0,0,2023-2024,90.0,0.0,0.0
1461,Iñigo Lekue,ESP,DF,Athletic Club,La Liga,30,1993,22.2,40,22,25,10,5,27,53,50.9,26,24,6,18,15,55,50,0,0,2023-2024,90.0,60.810810810810814,162.1621621621622
1462,Thomas Lemar,FRA,MF,Atlético Madrid,La Liga,27,1995,1.8,3,1,2,1,0,1,2,50.0,1,0,0,0,0,3,0,0,0,2023-2024,90.0,0.0,150.0
1463,Mario Lemina,GAB,MF,Wolves,Premier League,29,1993,33.0,90,58,46,33,11,25,47,53.2,22,36,9,27,41,131,64,0,0,2023-2024,90.0,111.81818181818183,245.45454545454547
1464,Álvaro Lemos,ESP,DF,Las Palmas,La Liga,30,1993,2.8,4,1,1,3,0,0,2,0.0,2,3,1,2,2,6,4,0,0,2023-2024,90.0,64.28571428571429,128.57142857142858
1465,Ruben Lendinez,ESP,DF,Valencia,La Liga,20,2003,0.1,2,2,0,2,0,1,1,100.0,0,0,0,0,0,2,1,0,0,2023-2024,90.0,0.0,1800.0
1466,Clément Lenglet,FRA,DF,Aston Villa,Premier League,28,1995,12.8,13,9,7,5,1,7,13,53.8,6,19,11,8,7,20,47,1,0,2023-2024,90.0,49.21875,91.40625
1467,Bernd Leno,GER,GK,Fulham,Premier League,31,1992,38.0,0,0,0,0,0,0,0,0.0,0,0,0,0,0,0,14,1,0,2023-2024,90.0,0.0,0.0
1468,Christopher Lenz,GER,"DF,MF",RB Leipzig,Bundesliga,28,1994,0.5,2,1,2,0,0,1,1,100.0,0,0,0,0,2,4,2,0,0,2023-2024,90.0,360.0,360.0
1469,Christopher Lenz,GER,DF,Eint Frankfurt,Bundesliga,28,1994,0.1,1,1,0,1,0,1,1,100.0,0,0,0,0,0,1,1,0,0,2023-2024,90.0,0.0,900.0
1470,Johann Lepenant,FRA,MF,Lyon,Ligue 1,20,2002,2.8,4,3,2,2,0,1,8,12.5,7,5,0,5,4,8,0,0,0,2023-2024,90.0,128.57142857142858,128.57142857142858
1471,Jefferson Lerma,COL,"MF,DF",Crystal Palace,Premier League,28,1994,26.7,42,25,15,23,4,19,40,47.5,21,31,12,19,36,78,72,0,0,2023-2024,90.00000000000001,121.34831460674158,141.5730337078652
1472,Léo Leroy,FRA,MF,Montpellier,Ligue 1,23,2000,5.5,19,10,8,8,3,6,21,28.6,15,12,3,9,7,26,8,0,0,2023-2024,90.0,114.54545454545455,310.90909090909093
1473,Robert Lewandowski,POL,FW,Barcelona,La Liga,34,1988,30.6,8,5,0,6,2,4,12,33.3,8,13,4,9,9,17,18,0,0,2023-2024,90.0,26.470588235294116,23.52941176470588
1474,Jamie Leweling,GER,"FW,MF",Stuttgart,Bundesliga,22,2001,16.9,18,10,4,6,8,5,17,29.4,12,21,1,20,5,23,13,0,0,2023-2024,90.0,26.627218934911244,95.85798816568048
1475,Rico Lewis,ENG,"DF,MF",Manchester City,Premier League,18,2004,9.0,10,7,4,4,2,3,7,42.9,4,7,1,6,4,14,6,0,0,2023-2024,90.0,40.0,100.0
Rk,Player,Nation,Pos,Squad,Comp,0,0,90.0,0,0,3,3,3,Tkl,0,0.0,0,0,0,0,0,0,0,0,0,2023-2024,90.0,0.0,0.0
1476,Keane Lewis-Potter,ENG,"FW,DF",Brentford,Premier League,22,2001,16.0,17,7,5,11,1,7,15,46.7,8,10,2,8,7,24,23,0,0,2023-2024,90.0,39.375,95.625
1477,Philipp Lienhart,AUT,DF,Freiburg,Bundesliga,27,1996,14.1,20,13,14,5,1,13,23,56.5,10,18,11,7,14,34,51,0,0,2023-2024,89.99999999999999,89.36170212765957,127.6595744680851
1478,Matthijs de Ligt,NED,DF,Bayern Munich,Bundesliga,23,1999,15.4,15,12,4,8,3,6,11,54.5,5,14,10,4,19,34,52,0,0,2023-2024,90.0,111.03896103896105,87.66233766233766
1479,Victor Lindelöf,SWE,DF,Manchester Utd,Premier League,29,1994,14.8,15,10,8,7,0,5,13,38.5,8,18,9,9,12,27,40,1,0,2023-2024,90.0,72.97297297297297,91.21621621621621
1480,Jesper Lindstrøm,DEN,"FW,MF",Napoli,Serie A,23,2000,4.8,8,3,2,3,3,4,8,50.0,4,3,0,3,2,10,6,0,0,2023-2024,90.0,37.5,150.0
1481,Jesper Lindstrøm,DEN,FW,Eint Frankfurt,Bundesliga,23,2000,0.9,1,1,1,0,0,0,0,0.0,0,0,0,0,0,1,0,0,0,2023-2024,90.0,0.0,100.0
1482,Karol Linetty,POL,MF,Torino,Serie A,28,1995,20.6,30,21,9,20,1,9,29,31.0,20,24,8,16,23,53,27,1,0,2023-2024,90.0,100.48543689320388,131.06796116504853
1483,Samuel Lino,BRA,"DF,MF",Atlético Madrid,La Liga,23,1999,23.1,61,34,32,17,12,35,70,50.0,35,37,1,36,14,75,27,0,0,2023-2024,89.99999999999999,54.54545454545454,237.66233766233762
1484,Luca Lipani,ITA,MF,Sassuolo,Serie A,18,2005,4.3,9,7,4,3,2,3,11,27.3,8,9,2,7,6,15,7,0,0,2023-2024,90.0,125.58139534883722,188.37209302325584
1485,Pol Lirola,ESP,DF,Frosinone,Serie A,25,1997,17.1,30,18,14,15,1,17,35,48.6,18,12,1,11,19,49,41,1,0,2023-2024,90.0,100.0,157.89473684210526
1486,Marcin Listkowski,POL,FW,Lecce,Serie A,25,1998,0.1,0,0,0,0,0,0,0,0.0,0,0,0,0,0,0,0,0,0,2023-2024,90.0,0.0,0.0
1487,Valentino Livramento,ENG,DF,Newcastle Utd,Premier League,20,2002,14.6,23,13,15,6,2,10,21,47.6,11,16,7,9,25,48,41,1,0,2023-2024,90.0,154.1095890410959,141.78082191780823
1488,Dejan Ljubicic,AUT,"MF,FW",Köln,Bundesliga,25,1997,22.8,43,27,20,18,5,20,43,46.5,23,22,2,20,18,61,11,0,0,2023-2024,90.0,71.05263157894736,169.73684210526315
1489,Javier Llabrés,ESP,"MF,FW",Mallorca,La Liga,20,2002,2.7,3,1,1,1,1,1,2,50.0,1,1,0,1,3,6,4,0,0,2023-2024,90.0,99.99999999999999,99.99999999999999
1490,Diego Llorente,ESP,DF,Roma,Serie A,29,1993,24.1,31,19,20,10,1,11,24,45.8,13,40,27,13,22,53,79,0,0,2023-2024,90.0,82.15767634854771,115.76763485477179
1491,Marcos Llorente,ESP,"MF,DF",Atlético Madrid,La Liga,28,1995,28.5,40,23,18,17,5,16,44,36.4,28,36,11,25,14,54,35,0,0,2023-2024,90.0,44.21052631578947,126.31578947368422
1492,Gautier Lloris,FRA,DF,Le Havre,Ligue 1,28,1995,30.9,50,28,40,9,1,28,42,66.7,14,50,30,20,32,82,142,1,0,2023-2024,90.0,93.20388349514563,145.63106796116506
1493,Abou Lô,SEN,"MF,DF",Metz,Ligue 1,23,2000,2.2,3,1,2,1,0,1,4,25.0,3,5,2,3,4,7,8,0,0,2023-2024,90.0,163.63636363636363,122.72727272727272
1494,Giovani Lo Celso,ARG,MF,Tottenham,Premier League,27,1996,5.6,22,13,10,8,4,9,14,64.3,5,4,1,3,5,27,2,0,0,2023-2024,90.0,80.35714285714286,353.57142857142856
1495,Stanislav Lobotka,SVK,MF,Napoli,Serie A,28,1994,36.5,61,39,18,30,13,24,60,40.0,36,30,8,22,30,91,29,0,0,2023-2024,90.0,73.97260273972603,150.41095890410958
1496,Manuel Locatelli,ITA,MF,Juventus,Serie A,25,1998,33.4,69,43,24,35,10,31,58,53.4,27,43,17,26,25,94,65,0,0,2023-2024,90.0,67.36526946107784,185.92814371257484
1497,Bradley Locko,FRA,DF,Brest,Ligue 1,21,2002,32.9,97,55,57,34,6,47,80,58.8,33,28,1,27,40,137,69,0,0,2023-2024,90.0,109.42249240121582,265.34954407294833
1498,Tom Lockyer,WAL,DF,Luton Town,Premier League,28,1994,13.0,25,16,17,6,2,15,22,68.2,7,23,13,10,23,48,68,0,0,2023-2024,90.00000000000001,159.23076923076925,173.0769230769231
1499,Renan Lodi,BRA,DF,Marseille,Ligue 1,25,1998,13.7,24,16,8,13,3,13,21,61.9,8,7,2,5,16,40,35,0,0,2023-2024,90.0,105.1094890510949,157.66423357664235
1500,Ruben Loftus-Cheek,ENG,MF,Milan,Serie A,27,1996,23.0,28,18,7,14,7,15,27,55.6,12,24,12,12,9,37,10,1,0,2023-2024,90.0,35.21739130434783,109.56521739130436
Rk,Player,Nation,Pos,Squad,Comp,0,0,90.0,0,0,3,3,3,Tkl,0,0.0,0,0,0,0,0,0,0,0,0,2023-2024,90.0,0.0,0.0
1501,Andy Logbo,FRA,FW,Le Havre,Ligue 1,19,2004,2.8,0,0,0,0,0,0,3,0.0,3,7,3,4,0,0,2,0,0,2023-2024,90.0,0.0,0.0
1502,Enzo Loiodice,FRA,MF,Las Palmas,La Liga,22,2000,19.9,62,35,15,34,13,20,42,47.6,22,20,2,18,12,74,16,1,0,2023-2024,90.0,54.2713567839196,280.4020100502513
1503,Sean Longstaff,ENG,MF,Newcastle Utd,Premier League,25,1997,30.5,54,30,17,29,8,24,63,38.1,39,43,7,36,17,71,23,0,0,2023-2024,90.0,50.1639344262295,159.34426229508196
1504,Ademola Lookman,NGA,"FW,MF",Atalanta,Serie A,25,1997,21.0,20,15,2,11,7,8,22,36.4,14,19,0,19,9,29,0,1,0,2023-2024,90.0,38.57142857142857,85.71428571428571
1505,Noah Loosli,SUI,DF,Bochum,Bundesliga,26,1997,3.8,10,7,6,4,0,7,14,50.0,7,7,1,6,7,17,18,0,0,2023-2024,90.0,165.78947368421052,236.8421052631579
1506,Anthony Lopes,POR,GK,Lyon,Ligue 1,32,1990,31.0,0,0,0,0,0,0,0,0.0,0,0,0,0,0,0,16,0,0,2023-2024,90.0,0.0,0.0
1507,David López,ESP,DF,Girona,La Liga,33,1989,21.8,33,20,21,12,0,17,22,77.3,5,28,19,9,20,53,63,4,0,2023-2024,90.0,82.56880733944953,136.23853211009174
1508,Diego López,ESP,"MF,FW",Valencia,La Liga,21,2002,29.5,37,25,14,16,7,13,56,23.2,43,23,1,22,20,57,12,0,0,2023-2024,90.0,61.016949152542374,112.88135593220339
1509,Fermin López,ESP,"MF,FW",Barcelona,La Liga,20,2003,16.1,41,21,15,18,8,14,40,35.0,26,14,1,13,4,45,9,0,0,2023-2024,90.0,22.360248447204967,229.1925465838509
1510,Javi López,ESP,DF,Alavés,La Liga,21,2002,26.5,23,12,11,9,3,15,26,57.7,11,25,9,16,10,33,77,1,0,2023-2024,90.0,33.9622641509434,78.11320754716981
1511,Maxime Lopez,FRA,MF,Fiorentina,Serie A,25,1997,8.9,18,9,5,10,3,6,12,50.0,6,3,1,2,7,25,6,0,0,2023-2024,90.0,70.78651685393258,182.02247191011236
1512,Maxime Lopez,FRA,MF,Sassuolo,Serie A,25,1997,1.6,2,1,1,1,0,1,2,50.0,1,1,1,0,2,4,0,0,0,2023-2024,90.0,112.5,112.5
1513,Pau López,ESP,GK,Marseille,Ligue 1,28,1994,32.7,0,0,0,0,0,0,2,0.0,2,0,0,0,0,0,10,1,0,2023-2024,90.0,0.0,0.0
1514,Unai López,ESP,MF,Rayo Vallecano,La Liga,27,1995,23.4,48,24,18,23,7,21,53,39.6,32,24,3,21,16,64,15,2,0,2023-2024,89.99999999999999,61.53846153846153,184.6153846153846
1515,Dion Lopy,SEN,MF,Almería,La Liga,21,2002,21.3,62,37,36,20,6,17,44,38.6,27,23,5,18,15,77,22,2,0,2023-2024,90.0,63.38028169014085,261.9718309859155
1516,Anthony Losilla,FRA,MF,Bochum,Bundesliga,37,1986,28.6,63,37,15,40,8,23,51,45.1,28,37,8,29,25,88,51,0,0,2023-2024,90.0,78.67132867132867,198.25174825174827
1517,Jordan Lotomba,SUI,DF,Nice,Ligue 1,24,1998,20.0,36,28,18,9,9,25,35,71.4,10,30,9,21,16,52,26,1,0,2023-2024,90.0,72.0,162.0
1518,Tom Louchet,FRA,"MF,DF",Nice,Ligue 1,20,2003,4.5,14,5,6,6,2,7,11,63.6,4,7,3,4,3,17,9,0,0,2023-2024,90.0,60.0,280.0
1519,Imran Louza,MAR,MF,Lorient,Ligue 1,24,1999,9.6,13,7,2,8,3,2,8,25.0,6,8,1,7,9,22,4,0,0,2023-2024,90.0,84.375,121.87500000000001
1520,Matteo Lovato,ITA,DF,Torino,Serie A,23,2000,6.0,10,7,5,5,0,4,5,80.0,1,9,5,4,13,23,10,0,0,2023-2024,90.0,195.0,150.0
1521,Matteo Lovato,ITA,DF,Salernitana,Serie A,23,2000,10.5,27,14,17,8,2,16,24,66.7,8,14,7,7,18,45,41,1,0,2023-2024,90.0,154.28571428571428,231.42857142857142
1522,Dejan Lovren,CRO,DF,Lyon,Ligue 1,34,1989,8.0,9,7,6,3,0,3,7,42.9,4,6,5,1,12,21,37,0,0,2023-2024,90.0,135.0,101.25
1523,Sandi Lovrić,SVN,MF,Udinese,Serie A,25,1998,22.1,25,12,9,11,5,9,23,39.1,14,21,2,19,21,46,24,0,0,2023-2024,90.0,85.52036199095022,101.80995475113122
1524,Max Lowe,ENG,"DF,MF",Sheffield Utd,Premier League,26,1997,5.6,21,10,13,5,3,8,15,53.3,7,10,4,6,5,26,15,0,0,2023-2024,90.0,80.35714285714286,337.5
1525,Anthony Lozano,HON,"MF,FW",Getafe,La Liga,30,1993,1.0,0,0,0,0,0,0,1,0.0,1,0,0,0,0,0,1,0,0,2023-2024,90.0,0.0,0.0
Rk,Player,Nation,Pos,Squad,Comp,0,0,90.0,0,0,3,3,3,Tkl,0,0.0,0,0,0,0,0,0,0,0,0,2023-2024,90.0,0.0,0.0
1526,Anthony Lozano,HON,FW,Almería,La Liga,30,1993,8.6,7,5,2,5,0,4,7,57.1,3,6,1,5,2,9,12,0,0,2023-2024,90.0,20.930232558139537,73.25581395348838
1527,Lucas,BRA,DF,Cádiz,La Liga,22,2001,17.1,47,27,32,11,4,32,55,58.2,23,27,4,23,17,64,45,0,0,2023-2024,90.0,89.47368421052632,247.3684210526316
1528,Lorenzo Lucca,ITA,FW,Udinese,Serie A,22,2000,28.8,19,11,4,11,4,5,20,25.0,15,18,3,15,3,22,36,1,0,2023-2024,90.0,9.375,59.375
1529,Jhon Lucumí,COL,DF,Bologna,Serie A,25,1998,24.6,48,29,31,17,0,27,36,75.0,9,32,17,15,16,64,68,2,0,2023-2024,89.99999999999999,58.536585365853654,175.60975609756096
1530,José Luis Gayà,ESP,DF,Valencia,La Liga,28,1995,19.9,71,36,44,23,4,43,67,64.2,24,18,3,15,11,82,42,0,0,2023-2024,90.0,49.74874371859297,321.105527638191
1531,José Luis Morales,ESP,"FW,MF",Villarreal,La Liga,36,1987,11.6,5,3,1,4,0,3,13,23.1,10,9,1,8,7,12,4,0,0,2023-2024,90.0,54.310344827586206,38.793103448275865
1532,José Luis Palomino,ARG,DF,Atalanta,Serie A,33,1990,0.3,2,1,1,1,0,1,1,100.0,0,2,1,1,1,3,6,0,0,2023-2024,90.0,300.0,600.0
1533,Douglas Luiz,BRA,MF,Aston Villa,Premier League,25,1998,33.3,58,38,21,27,10,25,53,47.2,28,32,8,24,23,81,18,2,0,2023-2024,90.0,62.16216216216216,156.75675675675677
1534,Romelu Lukaku,BEL,FW,Roma,Serie A,30,1993,29.3,6,5,1,2,3,2,4,50.0,2,7,1,6,0,6,19,1,0,2023-2024,90.0,0.0,18.430034129692835
1535,Castello Lukeba,FRA,DF,RB Leipzig,Bundesliga,20,2002,24.3,19,12,10,9,0,10,12,83.3,2,35,13,22,12,31,94,2,0,2023-2024,90.0,44.44444444444444,70.37037037037037
1536,Dodi Lukebakio,BEL,"FW,MF",Sevilla,La Liga,25,1997,12.5,5,2,2,2,1,1,6,16.7,5,9,2,7,2,7,5,0,0,2023-2024,90.0,14.399999999999999,36.0
1537,Saša Lukić,SRB,MF,Fulham,Premier League,26,1996,12.5,33,19,9,17,7,18,39,46.2,21,18,5,13,16,49,19,1,0,2023-2024,90.0,115.19999999999999,237.6
1538,Karlo Lulić,CRO,MF,Frosinone,Serie A,27,1996,0.2,0,0,0,0,0,0,0,0.0,0,1,0,1,1,1,0,0,0,2023-2024,90.0,450.0,0.0
1539,Andriy Lunin,UKR,GK,Real Madrid,La Liga,24,1999,21.0,0,0,0,0,0,0,1,0.0,1,0,0,0,0,0,15,1,0,2023-2024,90.0,0.0,0.0
1540,Sebastiano Luperto,ITA,DF,Empoli,Serie A,26,1996,37.8,37,26,25,10,2,15,24,62.5,9,46,35,11,32,69,157,1,0,2023-2024,90.0,76.19047619047619,88.0952380952381
1541,Mateus Lusuardi,BRA,DF,Frosinone,Serie A,19,2004,2.4,2,1,1,1,0,1,3,33.3,2,4,2,2,4,6,8,0,0,2023-2024,90.0,150.0,75.0
1542,Andreas Luthe,GER,GK,Bochum,Bundesliga,36,1987,1.0,0,0,0,0,0,0,0,0.0,0,0,0,0,0,0,1,0,0,2023-2024,90.0,0.0,0.0
1543,Zito Luvumbo,ANG,"FW,MF",Cagliari,Serie A,21,2002,21.6,9,6,5,2,2,4,15,26.7,11,19,0,19,1,10,2,0,0,2023-2024,90.0,4.166666666666666,37.5
1544,Charalambos Lykogiannis,GRE,DF,Bologna,Serie A,29,1993,10.0,10,6,5,4,1,5,10,50.0,5,15,5,10,5,15,30,0,0,2023-2024,90.0,45.0,90.0
1545,Senne Lynen,BEL,MF,Werder Bremen,Bundesliga,24,1999,20.0,64,38,33,27,4,30,70,42.9,40,41,8,33,41,105,56,0,0,2023-2024,90.0,184.5,288.0
1546,Joshua M'Bahia,CIV,MF,Clermont Foot,Ligue 1,18,2005,0.2,0,0,0,0,0,0,0,0.0,0,0,0,0,0,0,0,0,0,2023-2024,90.0,0.0,0.0
1547,Othmane Maamma,FRA,FW,Montpellier,Ligue 1,17,2005,1.0,3,3,2,0,1,1,1,100.0,0,3,0,3,0,3,0,0,0,2023-2024,90.0,0.0,270.0
1548,Ian Maatsen,NED,"FW,MF",Chelsea,Premier League,21,2002,2.3,3,2,1,1,1,0,4,0.0,4,4,0,4,3,6,10,0,0,2023-2024,90.0,117.3913043478261,117.3913043478261
1549,Ian Maatsen,NED,DF,Dortmund,Bundesliga,21,2002,14.0,30,22,15,9,6,16,30,53.3,14,22,4,18,13,43,26,0,0,2023-2024,90.0,83.57142857142857,192.85714285714286
1550,Alexis Mac Allister,ARG,MF,Liverpool,Premier League,24,1998,28.9,99,55,35,50,14,59,125,47.2,66,65,8,57,35,134,25,1,0,2023-2024,90.00000000000001,108.99653979238755,308.3044982698962
Rk,Player,Nation,Pos,Squad,Comp,0,0,90.0,0,0,3,3,3,Tkl,0,0.0,0,0,0,0,0,0,0,0,0,2023-2024,90.0,0.0,0.0
1551,Deiver Machado,COL,DF,Lens,Ligue 1,29,1993,12.5,24,18,10,10,4,15,20,75.0,5,13,2,11,7,31,8,0,0,2023-2024,90.0,50.4,172.79999999999998
1552,Darwin Machís,VEN,MF,Cádiz,La Liga,30,1993,8.7,23,14,7,9,7,13,24,54.2,11,8,1,7,4,27,2,0,0,2023-2024,90.0,41.37931034482759,237.93103448275863
1553,James Maddison,ENG,MF,Tottenham,Premier League,26,1996,23.7,33,19,5,18,10,15,29,51.7,14,15,3,12,13,46,10,1,0,2023-2024,90.0,49.367088607594944,125.31645569620254
1554,Noni Madueke,ENG,FW,Chelsea,Premier League,21,2002,11.7,16,10,8,4,4,11,34,32.4,23,11,0,11,4,20,14,0,0,2023-2024,89.99999999999999,30.769230769230766,123.07692307692307
1555,Pablo Maffeo,ESP,DF,Mallorca,La Liga,26,1997,16.2,35,22,18,13,4,23,40,57.5,17,12,2,10,10,45,23,0,0,2023-2024,90.0,55.55555555555556,194.44444444444446
1556,Gabriel Magalhães,BRA,DF,Arsenal,Premier League,25,1997,33.8,48,28,24,22,2,17,22,77.3,5,44,33,11,31,79,100,1,0,2023-2024,90.0,82.54437869822486,127.81065088757397
1557,Soungoutou Magassa,FRA,"DF,MF",Monaco,Ligue 1,19,2003,15.0,56,26,22,32,2,26,48,54.2,22,21,4,17,21,77,36,2,0,2023-2024,90.0,126.0,336.0
1558,Giulio Maggiore,ITA,MF,Salernitana,Serie A,25,1998,20.0,49,29,26,22,1,20,42,47.6,22,27,5,22,24,73,38,0,0,2023-2024,90.0,108.0,220.5
1559,Matej Maglica,CRO,DF,Darmstadt 98,Bundesliga,24,1998,18.9,35,21,25,10,0,22,36,61.1,14,29,11,18,22,57,92,5,0,2023-2024,90.0,104.76190476190476,166.66666666666669
1560,Giangiacomo Magnani,ITA,DF,Hellas Verona,Serie A,27,1995,27.2,33,18,23,10,0,15,25,60.0,10,50,28,22,45,78,118,0,0,2023-2024,90.0,148.89705882352942,109.19117647058823
1561,Hugo Magnetti,FRA,MF,Brest,Ligue 1,25,1998,26.0,49,27,18,26,5,24,58,41.4,34,19,1,18,18,67,18,0,0,2023-2024,90.00000000000001,62.307692307692314,169.61538461538464
1562,Yohann Magnin,FRA,MF,Clermont Foot,Ligue 1,26,1997,18.7,49,31,12,32,5,22,47,46.8,25,38,13,25,19,68,26,1,0,2023-2024,90.0,91.44385026737967,235.82887700534758
1563,Frank Magri,CMR,"FW,MF",Toulouse,Ligue 1,23,1999,16.0,22,14,5,12,5,15,21,71.4,6,16,4,12,4,26,17,0,0,2023-2024,90.0,22.5,123.75
1564,Harry Maguire,ENG,DF,Manchester Utd,Premier League,30,1993,18.4,24,17,14,10,0,12,22,54.5,10,33,24,9,25,49,83,1,0,2023-2024,90.0,122.28260869565219,117.3913043478261
1565,Jon Magunacelaya,ESP,"FW,MF",Real Sociedad,La Liga,23,2000,1.3,5,3,2,3,0,4,8,50.0,4,3,0,3,0,5,2,0,0,2023-2024,90.0,0.0,346.15384615384613
1566,Adel Mahamoud,COM,FW,Nantes,Ligue 1,20,2003,0.1,0,0,0,0,0,0,1,0.0,1,0,0,0,0,0,0,0,0,2023-2024,90.0,0.0,0.0
1567,Arne Maier,GER,MF,Augsburg,Bundesliga,24,1999,11.1,14,9,5,8,1,5,14,35.7,9,19,2,17,6,20,11,0,0,2023-2024,90.0,48.64864864864865,113.51351351351353
1568,Habib Maïga,CIV,"MF,FW",Metz,Ligue 1,27,1996,1.6,2,2,1,0,1,1,3,33.3,2,2,0,2,4,6,2,0,0,2023-2024,90.0,225.0,112.5
1569,Mike Maignan,FRA,GK,Milan,Serie A,28,1995,29.0,1,0,1,0,0,1,1,100.0,0,1,0,1,1,2,4,3,0,2023-2024,90.0,3.103448275862069,3.103448275862069
1570,Linton Maina,GER,"FW,MF",Köln,Bundesliga,24,1999,21.1,18,15,11,5,2,9,28,32.1,19,12,1,11,6,24,12,0,0,2023-2024,90.0,25.592417061611375,76.77725118483411
1571,Patrick Mainka,GER,DF,Heidenheim,Bundesliga,28,1994,34.0,85,49,58,24,3,38,74,51.4,36,66,32,34,49,134,158,1,0,2023-2024,90.0,129.7058823529412,225.0
1572,Kobbie Mainoo,ENG,MF,Manchester Utd,Premier League,18,2005,21.4,47,27,20,16,11,21,45,46.7,24,20,12,8,22,69,30,1,0,2023-2024,90.0,92.52336448598132,197.66355140186917
1573,Ainsley Maitland-Niles,ENG,"DF,MF",Lyon,Ligue 1,25,1997,15.9,34,18,12,14,8,19,37,51.4,18,16,6,10,17,51,29,1,0,2023-2024,90.0,96.22641509433963,192.45283018867926
1574,Radosław Majecki,POL,GK,Monaco,Ligue 1,23,1999,12.0,0,0,0,0,0,0,0,0.0,0,1,0,1,0,0,5,1,0,2023-2024,90.0,0.0,0.0
1575,Lovro Majer,CRO,MF,Rennes,Ligue 1,25,1998,0.2,0,0,0,0,0,0,0,0.0,0,0,0,0,0,0,1,0,0,2023-2024,90.0,0.0,0.0
Rk,Player,Nation,Pos,Squad,Comp,0,0,90.0,0,0,3,3,3,Tkl,0,0.0,0,0,0,0,0,0,0,0,0,2023-2024,90.0,0.0,0.0
1576,Lovro Majer,CRO,"MF,FW",Wolfsburg,Bundesliga,25,1998,23.4,39,18,17,22,0,12,31,38.7,19,20,1,19,12,51,13,0,0,2023-2024,89.99999999999999,46.15384615384615,150.0
1577,Jean-Victor Makengo,FRA,"MF,FW",Lorient,Ligue 1,25,1998,5.3,5,4,3,2,0,2,6,33.3,4,12,1,11,8,13,5,0,0,2023-2024,90.0,135.8490566037736,84.9056603773585
1578,Jordy Makengo,FRA,DF,Freiburg,Bundesliga,21,2001,11.4,17,11,11,5,1,6,10,60.0,4,16,4,12,11,28,37,0,0,2023-2024,90.0,86.84210526315789,134.21052631578945
1579,Antoine Makoumbou,CGO,MF,Cagliari,Serie A,25,1998,30.0,41,24,21,15,5,15,30,50.0,15,23,4,19,16,57,27,2,0,2023-2024,90.0,48.0,123.0
1580,Nemanja Maksimović,SRB,MF,Getafe,La Liga,28,1995,36.3,65,43,26,31,8,23,41,56.1,18,56,23,33,46,111,61,0,0,2023-2024,90.0,114.04958677685951,161.15702479338844
1581,Julián Malatini,ARG,DF,Werder Bremen,Bundesliga,22,2001,6.7,18,13,12,3,3,16,24,66.7,8,8,1,7,13,31,26,0,0,2023-2024,90.0,174.62686567164178,241.79104477611938
1582,Daniel Maldini,ITA,"MF,FW",Monza,Serie A,21,2001,3.7,3,2,0,2,1,3,6,50.0,3,2,0,2,2,5,1,0,0,2023-2024,90.0,48.648648648648646,72.97297297297297
1583,Daniel Maldini,ITA,"FW,MF",Empoli,Serie A,21,2001,2.9,4,2,0,2,2,2,2,100.0,0,5,0,5,2,6,2,0,0,2023-2024,90.0,62.06896551724138,124.13793103448276
1584,Youssef Maleh,MAR,MF,Empoli,Serie A,24,1998,28.9,74,48,30,36,8,23,52,44.2,29,62,7,55,25,99,29,0,0,2023-2024,90.00000000000001,77.85467128027683,230.4498269896194
1585,Donyell Malen,NED,"FW,MF",Dortmund,Bundesliga,24,1999,19.8,11,7,5,3,3,2,6,33.3,4,11,4,7,2,13,8,0,0,2023-2024,90.0,9.090909090909092,50.0
1586,Ruslan Malinovskyi,UKR,MF,Genoa,Serie A,30,1993,17.2,35,20,18,11,6,17,41,41.5,24,22,8,14,5,40,16,0,0,2023-2024,90.0,26.16279069767442,183.13953488372096
1587,Lennard Maloney,USA,MF,Heidenheim,Bundesliga,23,1999,25.4,43,26,14,24,5,25,59,42.4,34,33,9,24,25,68,88,0,0,2023-2024,90.0,88.58267716535434,152.36220472440945
1588,Aaron Malouda,FRA,FW,Lille,Ligue 1,17,2005,0.0,0,0,0,0,0,0,0,0.0,0,0,0,0,0,0,0,0,0,2023-2024,,,
1589,Giorgi Mamardashvili,GEO,GK,Valencia,La Liga,22,2000,36.5,4,3,4,0,0,4,4,100.0,0,1,0,1,2,6,22,2,0,2023-2024,90.0,4.931506849315069,9.863013698630137
1590,David Mamutovic,GER,"FW,DF",Mainz 05,Bundesliga,22,2000,0.1,1,1,0,1,0,1,1,100.0,0,0,0,0,0,1,0,0,0,2023-2024,90.0,0.0,900.0
1591,Wilson Manafá,POR,"DF,MF",Granada,La Liga,29,1994,2.7,6,4,3,2,1,4,7,57.1,3,1,0,1,1,7,4,1,0,2023-2024,90.0,33.33333333333333,199.99999999999997
1592,Hianga Mananga Mbock,FRA,"MF,FW",Brest,Ligue 1,23,1999,0.1,1,0,0,0,1,1,2,50.0,1,0,0,0,1,2,0,0,0,2023-2024,90.0,900.0,900.0
1593,Gianluca Mancini,ITA,DF,Roma,Serie A,27,1996,31.9,34,20,21,11,2,11,27,40.7,16,38,26,12,36,70,77,1,0,2023-2024,90.0,101.56739811912226,95.92476489028213
1594,Marco Mancosu,ITA,"MF,FW",Cagliari,Serie A,34,1988,1.7,3,0,0,2,1,1,2,50.0,1,0,0,0,0,3,0,0,0,2023-2024,90.0,0.0,158.8235294117647
1595,Steve Mandanda,FRA,GK,Rennes,Ligue 1,38,1985,34.0,2,0,2,0,0,2,4,50.0,2,0,0,0,0,2,6,1,0,2023-2024,90.0,0.0,5.294117647058823
1596,Christos Mandas,GRE,GK,Lazio,Serie A,21,2001,8.0,0,0,0,0,0,0,1,0.0,1,0,0,0,1,1,3,1,0,2023-2024,90.0,11.25,0.0
1597,Reinildo Mandava,MOZ,DF,Atlético Madrid,La Liga,29,1994,8.1,30,22,16,11,3,19,22,86.4,3,10,2,8,15,45,21,0,0,2023-2024,90.0,166.66666666666669,333.33333333333337
1598,Aïssa Mandi,ALG,DF,Villarreal,La Liga,31,1991,12.4,13,8,8,5,0,7,14,50.0,7,10,7,3,8,21,41,0,0,2023-2024,90.0,58.064516129032256,94.35483870967742
1599,Rolando Mandragora,ITA,MF,Fiorentina,Serie A,26,1997,17.6,26,11,8,13,5,10,22,45.5,12,14,3,11,9,35,18,1,0,2023-2024,90.0,46.02272727272727,132.95454545454544
1600,Orel Mangala,BEL,MF,Nott'ham Forest,Premier League,25,1998,17.4,27,13,16,10,1,14,29,48.3,15,12,6,6,26,53,32,0,0,2023-2024,90.0,134.48275862068965,139.6551724137931
Rk,Player,Nation,Pos,Squad,Comp,0,0,90.0,0,0,3,3,3,Tkl,0,0.0,0,0,0,0,0,0,0,0,0,2023-2024,90.0,0.0,0.0
1601,Orel Mangala,BEL,MF,Lyon,Ligue 1,25,1998,4.4,5,3,0,2,3,1,3,33.3,2,3,2,1,5,10,6,0,0,2023-2024,90.0,102.27272727272727,102.27272727272727
1602,Vito Mannone,ITA,GK,Lille,Ligue 1,35,1988,1.0,0,0,0,0,0,0,0,0.0,0,0,0,0,0,0,0,0,0,2023-2024,90.0,0.0,0.0
1603,Kostas Manolas,GRE,DF,Salernitana,Serie A,32,1991,5.4,9,5,6,3,0,6,8,75.0,2,10,7,3,2,11,20,0,0,2023-2024,90.0,33.33333333333333,150.0
1604,Javier Manquillo,ESP,"DF,MF",Celta Vigo,La Liga,29,1994,8.3,15,11,6,5,4,8,15,53.3,7,14,3,11,3,18,17,0,0,2023-2024,90.0,32.53012048192771,162.65060240963854
1605,Braydon Manu,GHA,MF,Darmstadt 98,Bundesliga,26,1997,1.9,2,0,0,1,1,0,0,0.0,0,1,0,1,0,2,0,0,0,2023-2024,90.0,0.0,94.73684210526315
1606,Benson Manuel,ANG,"MF,FW",Burnley,Premier League,26,1997,1.3,3,2,2,1,0,0,0,0.0,0,1,0,1,0,3,0,0,0,2023-2024,90.0,0.0,207.69230769230768
1607,Faitout Maouassa,FRA,"DF,MF",Granada,La Liga,25,1998,2.5,8,5,6,1,1,4,5,80.0,1,6,0,6,1,9,3,0,0,2023-2024,90.0,36.0,288.0
1608,Faitout Maouassa,FRA,"MF,DF",Lens,Ligue 1,25,1998,0.8,1,1,1,0,0,1,1,100.0,0,1,0,1,0,1,3,0,0,2023-2024,90.0,0.0,112.5
1609,Marcão,BRA,DF,Sevilla,La Liga,27,1996,3.9,9,6,5,4,0,6,10,60.0,4,8,6,2,4,13,11,1,0,2023-2024,90.0,92.3076923076923,207.69230769230768
1610,Solly March,ENG,"FW,DF",Brighton,Premier League,29,1994,6.2,19,14,9,7,3,8,14,57.1,6,5,0,5,11,30,8,0,0,2023-2024,90.0,159.67741935483872,275.80645161290323
1611,Riccardo Marchizza,ITA,DF,Frosinone,Serie A,25,1998,12.8,7,6,4,3,0,3,13,23.1,10,10,2,8,7,14,33,0,0,2023-2024,90.0,49.21875,49.21875
1612,Gian Marco Ferrari,ITA,DF,Sassuolo,Serie A,31,1992,25.2,22,10,11,11,0,12,18,66.7,6,28,17,11,25,47,76,0,0,2023-2024,90.0,89.28571428571429,78.57142857142858
1613,Óscar de Marcos,ESP,DF,Athletic Club,La Liga,34,1989,25.1,56,39,26,24,6,42,71,59.2,29,28,6,22,15,71,44,0,0,2023-2024,90.0,53.78486055776892,200.79681274900398
1614,Alberto Marí,ESP,FW,Valencia,La Liga,22,2001,3.1,4,2,0,1,3,1,1,100.0,0,3,0,3,0,4,5,0,0,2023-2024,90.0,0.0,116.12903225806451
1615,José Mari,ESP,"MF,FW",Cádiz,La Liga,35,1987,0.2,2,1,0,2,0,1,2,50.0,1,0,0,0,0,2,0,0,0,2023-2024,90.0,0.0,900.0
1616,Pablo Marí,ESP,DF,Monza,Serie A,29,1993,29.1,41,25,34,7,0,22,34,64.7,12,40,25,15,37,78,115,1,0,2023-2024,90.0,114.43298969072164,126.8041237113402
1617,José María Giménez,URU,DF,Atlético Madrid,La Liga,28,1995,14.7,18,10,10,7,1,5,16,31.3,11,16,12,4,10,28,95,0,0,2023-2024,90.0,61.224489795918366,110.20408163265306
1618,Mariano,DOM,"FW,MF",Sevilla,La Liga,29,1993,2.7,1,1,0,1,0,0,1,0.0,1,1,0,1,0,1,2,0,0,2023-2024,90.0,0.0,33.33333333333333
1619,Mirko Marić,CRO,FW,Monza,Serie A,28,1995,3.2,4,0,2,1,1,0,2,0.0,2,4,0,4,2,6,3,0,0,2023-2024,90.0,56.25,112.5
1620,Rafa Marín,ESP,DF,Alavés,La Liga,21,2002,27.1,32,20,23,9,0,14,27,51.9,13,34,21,13,33,65,129,2,0,2023-2024,90.0,109.5940959409594,106.2730627306273
1621,Răzvan Marin,ROU,MF,Empoli,Serie A,27,1996,20.2,40,22,13,23,4,19,29,65.5,10,16,4,12,6,46,30,2,0,2023-2024,90.0,26.73267326732673,178.21782178217822
1622,Diego Mariño,ESP,GK,Almería,La Liga,33,1990,1.0,0,0,0,0,0,0,0,0.0,0,0,0,0,0,0,1,0,0,2023-2024,90.0,0.0,0.0
1623,Guillermo Maripán,CHI,DF,Monaco,Ligue 1,29,1994,19.6,22,8,15,6,1,10,27,37.0,17,26,13,13,30,52,106,4,0,2023-2024,90.0,137.75510204081633,101.0204081632653
1624,Mika Màrmol,ESP,DF,Las Palmas,La Liga,21,2002,35.3,70,42,44,24,2,35,53,66.0,18,39,19,20,44,114,147,2,0,2023-2024,90.0,112.18130311614732,178.4702549575071
1625,Omar Marmoush,EGY,"FW,MF",Eint Frankfurt,Bundesliga,24,1999,25.6,21,11,7,8,6,6,16,37.5,10,13,0,13,11,32,7,0,0,2023-2024,90.0,38.671875,73.828125
Rk,Player,Nation,Pos,Squad,Comp,0,0,90.0,0,0,3,3,3,Tkl,0,0.0,0,0,0,0,0,0,0,0,0,2023-2024,90.0,0.0,0.0
1626,Marquinhos,BRA,"FW,MF",Nantes,Ligue 1,20,2003,1.7,3,2,2,0,1,1,4,25.0,3,7,2,5,6,9,1,0,0,2023-2024,90.0,317.6470588235294,158.8235294117647
1627,Marquinhos,BRA,DF,Paris S-G,Ligue 1,29,1994,17.1,19,11,10,7,2,11,17,64.7,6,29,19,10,17,36,58,1,0,2023-2024,90.0,89.47368421052632,100.0
1628,Unai Marrero,ESP,GK,Real Sociedad,La Liga,21,2001,1.6,0,0,0,0,0,0,0,0.0,0,0,0,0,0,0,0,0,0,2023-2024,90.0,0.0,0.0
1629,Agustín Martegani,ARG,MF,Salernitana,Serie A,23,2000,8.1,13,7,7,3,3,6,18,33.3,12,4,1,3,4,17,7,1,0,2023-2024,90.0,44.44444444444444,144.44444444444446
1630,Eric Martel,GER,MF,Köln,Bundesliga,21,2002,27.3,70,43,32,34,4,37,67,55.2,30,65,19,46,43,113,80,0,0,2023-2024,90.0,141.75824175824175,230.76923076923077
1631,Roger Martí,ESP,FW,Cádiz,La Liga,32,1991,15.1,12,6,1,9,2,2,7,28.6,5,16,1,15,7,19,4,0,0,2023-2024,90.0,41.72185430463576,71.52317880794702
1632,Anthony Martial,FRA,FW,Manchester Utd,Premier League,27,1995,5.0,4,1,1,1,2,1,1,100.0,0,4,0,4,0,4,3,0,0,2023-2024,90.0,0.0,72.0
1633,Aarón Martín,ESP,DF,Genoa,Serie A,26,1997,15.3,21,10,7,10,4,9,22,40.9,13,12,4,8,9,30,15,0,0,2023-2024,90.0,52.94117647058823,123.52941176470587
1634,Iván Martín,ESP,MF,Girona,La Liga,24,1999,30.3,44,25,22,15,7,22,57,38.6,35,25,3,22,21,65,14,0,0,2023-2024,90.0,62.37623762376238,130.69306930693068
1635,Jon Martin,ESP,DF,Real Sociedad,La Liga,17,2006,0.3,0,0,0,0,0,0,0,0.0,0,0,0,0,0,0,3,0,0,2023-2024,90.0,0.0,0.0
1636,Jonas Martin,FRA,MF,Brest,Ligue 1,33,1990,13.4,43,27,17,24,2,21,36,58.3,15,16,2,14,9,52,28,2,0,2023-2024,90.0,60.447761194029844,288.8059701492537
1637,Mario Martín,ESP,MF,Real Madrid,La Liga,19,2004,0.2,5,1,0,2,3,3,4,75.0,1,2,1,1,0,5,0,0,0,2023-2024,90.0,0.0,2250.0
1638,Gabriel Martinelli,BRA,FW,Arsenal,Premier League,22,2001,22.4,30,24,9,12,9,13,32,40.6,19,23,1,22,5,35,9,1,0,2023-2024,90.0,20.089285714285715,120.53571428571429
1639,Tommaso Martinelli,ITA,GK,Fiorentina,Serie A,17,2006,1.0,0,0,0,0,0,,0,0.0,0,0,0,0,0,0,0,0,0,2023-2024,90.0,0.0,0.0
1640,Arnau Martinez,ESP,DF,Girona,La Liga,20,2003,13.8,25,16,17,6,2,15,32,46.9,17,15,5,10,10,35,41,3,0,2023-2024,90.0,65.21739130434781,163.04347826086953
1641,Emiliano Martínez,ARG,GK,Aston Villa,Premier League,30,1992,33.5,0,0,0,0,0,0,0,0.0,0,0,0,0,0,0,12,3,0,2023-2024,90.0,0.0,0.0
1642,Iñigo Martínez,ESP,DF,Barcelona,La Liga,32,1991,14.4,10,7,9,1,0,6,8,75.0,2,13,10,3,11,21,50,0,0,2023-2024,90.0,68.75,62.5
1643,Josep Martinez,ESP,GK,Genoa,Serie A,25,1998,36.0,0,0,0,0,0,0,0,0.0,0,0,0,0,1,1,21,3,0,2023-2024,90.0,2.5,0.0
1644,Lautaro Martínez,ARG,FW,Inter,Serie A,25,1997,29.5,22,16,4,13,5,4,19,21.1,15,30,1,29,20,42,10,0,0,2023-2024,90.0,61.016949152542374,67.11864406779661
1645,Lisandro Martínez,ARG,DF,Manchester Utd,Premier League,25,1998,7.2,12,8,8,4,0,5,12,41.7,7,10,8,2,5,17,26,0,0,2023-2024,90.0,62.5,150.0
1646,Marc Martínez,ESP,GK,Granada,La Liga,33,1990,3.0,0,0,0,0,0,0,1,0.0,1,0,0,0,0,0,1,0,0,2023-2024,90.0,0.0,0.0
1647,Lucas Martínez Quarta,ARG,DF,Fiorentina,Serie A,27,1996,25.5,75,47,43,28,4,36,54,66.7,18,38,14,24,30,105,69,4,0,2023-2024,90.0,105.88235294117648,264.70588235294116
1648,Adam Marušić,MNE,DF,Lazio,Serie A,30,1992,34.4,45,31,24,19,2,27,49,55.1,22,27,7,20,29,74,63,2,0,2023-2024,90.0,75.87209302325581,117.7325581395349
1649,Marvin,ESP,"FW,DF",Las Palmas,La Liga,23,2000,20.6,39,25,18,17,4,18,36,50.0,18,28,2,26,14,53,18,1,0,2023-2024,90.0,61.165048543689316,170.38834951456312
1650,Omar Mascarell,EQG,MF,Mallorca,La Liga,30,1993,17.5,33,16,16,17,0,18,35,51.4,17,24,8,16,31,64,30,1,0,2023-2024,90.0,159.42857142857142,169.71428571428572
Rk,Player,Nation,Pos,Squad,Comp,0,0,90.0,0,0,3,3,3,Tkl,0,0.0,0,0,0,0,0,0,0,0,0,2023-2024,90.0,0.0,0.0
1651,Adam Masina,MAR,DF,Udinese,Serie A,29,1994,0.7,4,0,2,2,0,2,4,50.0,2,2,1,1,2,6,5,0,0,2023-2024,90.0,257.14285714285717,514.2857142857143
1652,Adam Masina,MAR,DF,Torino,Serie A,29,1994,11.4,17,12,8,8,1,5,20,25.0,15,12,6,6,11,28,30,0,0,2023-2024,90.0,86.84210526315789,134.21052631578945
1653,Erhan Mašović,SRB,"DF,MF",Bochum,Bundesliga,24,1998,24.7,64,40,37,22,5,37,70,52.9,33,32,10,22,25,89,75,2,0,2023-2024,90.0,91.09311740890689,233.19838056680163
1654,Han-Noah Massengo,FRA,"MF,DF",Burnley,Premier League,22,2001,0.2,1,1,1,0,0,0,0,0.0,0,1,0,1,0,1,0,0,0,2023-2024,90.0,0.0,450.0
1655,Roberto Massimo,GER,"FW,DF",Stuttgart,Bundesliga,22,2000,0.9,1,0,1,0,0,1,2,50.0,1,0,0,0,0,1,1,0,0,2023-2024,90.0,0.0,100.0
1656,Clinton Mata,ANG,DF,Lyon,Ligue 1,30,1992,24.7,43,24,29,8,6,23,40,57.5,17,35,16,19,40,83,61,0,0,2023-2024,90.0,145.74898785425103,156.68016194331983
1657,Jaime Mata,ESP,"FW,MF",Getafe,La Liga,34,1988,19.9,24,15,12,8,4,11,26,42.3,15,18,1,17,17,41,31,0,0,2023-2024,90.0,76.88442211055278,108.5427135678392
1658,Pape Matar Sarr,SEN,MF,Tottenham,Premier League,20,2002,23.0,34,24,11,17,6,15,36,41.7,21,21,5,16,31,65,28,1,0,2023-2024,90.0,121.30434782608697,133.04347826086956
1659,Eliot Matazo,BEL,MF,Monaco,Ligue 1,21,2002,1.1,3,1,0,3,0,2,4,50.0,2,1,1,0,3,6,0,0,0,2023-2024,90.0,245.45454545454544,245.45454545454544
1660,Jean-Philippe Mateta,FRA,FW,Crystal Palace,Premier League,26,1997,25.4,22,15,4,11,7,6,10,60.0,4,13,4,9,4,26,14,0,0,2023-2024,90.0,14.173228346456694,77.95275590551182
1661,Nemanja Matić,SRB,MF,Rennes,Ligue 1,34,1988,11.4,19,10,7,9,3,9,12,75.0,3,15,7,8,27,46,19,0,0,2023-2024,90.0,213.15789473684208,150.0
1662,Nemanja Matić,SRB,MF,Lyon,Ligue 1,34,1988,13.9,17,11,8,7,2,9,19,47.4,10,17,6,11,16,33,17,1,0,2023-2024,90.0,103.59712230215828,110.07194244604317
1663,Joël Matip,CMR,DF,Liverpool,Premier League,31,1991,8.7,12,6,7,4,1,8,12,66.7,4,16,12,4,9,21,43,0,0,2023-2024,90.0,93.10344827586206,124.13793103448276
1664,Alex Matos,ENG,MF,Chelsea,Premier League,18,2004,0.0,0,0,0,0,0,0,0,0.0,0,0,0,0,0,0,0,0,0,2023-2024,,,
1665,Chrislain Matsima,FRA,DF,Clermont Foot,Ligue 1,21,2002,13.1,18,11,11,7,0,10,18,55.6,8,14,10,4,13,31,74,1,0,2023-2024,90.0,89.31297709923665,123.66412213740459
1666,Chrislain Matsima,FRA,DF,Monaco,Ligue 1,21,2002,3.3,9,7,5,3,1,2,7,28.6,5,4,1,3,4,13,4,0,0,2023-2024,90.0,109.0909090909091,245.45454545454547
1667,Jean Mattéo Bahoya,FRA,"MF,FW",Eint Frankfurt,Bundesliga,18,2005,2.0,3,1,0,3,0,1,4,25.0,3,2,0,2,1,4,1,0,0,2023-2024,90.0,45.0,135.0
1668,Remi Matthews,ENG,GK,Crystal Palace,Premier League,29,1994,0.0,0,0,0,0,0,0,0,0.0,0,0,0,0,0,0,1,0,0,2023-2024,,,
1669,Alan Matturro,URU,DF,Genoa,Serie A,18,2004,1.2,1,1,1,0,0,1,1,100.0,0,6,3,3,2,3,4,0,0,2023-2024,90.0,150.0,75.0
1670,Azor Matusiwa,NED,MF,Reims,Ligue 1,25,1998,15.4,39,27,17,19,3,22,32,68.8,10,21,3,18,33,72,32,1,0,2023-2024,90.0,192.85714285714286,227.92207792207793
1671,Azor Matusiwa,NED,MF,Rennes,Ligue 1,25,1998,8.8,7,3,3,4,0,4,7,57.1,3,9,2,7,11,18,17,0,0,2023-2024,90.0,112.5,71.5909090909091
1672,Neal Maupay,FRA,FW,Brentford,Premier League,26,1996,14.7,10,7,4,5,1,3,13,23.1,10,11,0,11,2,12,3,0,0,2023-2024,90.0,12.244897959183673,61.224489795918366
1673,Neal Maupay,FRA,FW,Everton,Premier League,26,1996,1.2,0,0,0,0,0,0,1,0.0,1,2,0,2,0,0,1,0,0,2023-2024,90.0,0.0,0.0
1674,Aïman Maurer,MAR,"MF,FW",Clermont Foot,Ligue 1,18,2004,0.6,1,1,1,0,0,1,3,33.3,2,0,0,0,0,1,0,0,0,2023-2024,90.0,0.0,150.0
1675,Konstantinos Mavropanos,GRE,DF,West Ham,Premier League,25,1997,16.7,28,16,17,9,2,17,21,81.0,4,21,13,8,23,51,79,3,0,2023-2024,90.0,123.95209580838323,150.89820359281438
Rk,Player,Nation,Pos,Squad,Comp,0,0,90.0,0,0,3,3,3,Tkl,0,0.0,0,0,0,0,0,0,0,0,0,2023-2024,90.0,0.0,0.0
1676,Christian Mawissa,FRA,DF,Toulouse,Ligue 1,18,2005,12.4,22,15,14,4,4,9,23,39.1,14,22,11,11,22,44,41,1,0,2023-2024,90.0,159.67741935483872,159.67741935483872
1677,Philipp Max,GER,DF,Eint Frankfurt,Bundesliga,29,1993,15.0,26,17,6,18,2,19,26,73.1,7,18,1,17,7,33,18,2,0,2023-2024,90.0,42.0,156.0
1678,Eric Maxim Choupo-Moting,CMR,"MF,FW",Bayern Munich,Bundesliga,34,1989,8.0,17,12,8,5,4,6,14,42.9,8,5,0,5,7,24,7,0,0,2023-2024,90.0,78.75,191.25
1679,Luís Maximiano,POR,GK,Almería,La Liga,24,1999,33.0,0,0,0,0,0,0,1,0.0,1,0,0,0,0,0,19,2,0,2023-2024,90.0,0.0,0.0
1680,Noam Mayoka-Tika,BEL,MF,Marseille,Ligue 1,19,2003,0.0,0,0,0,0,0,0,0,0.0,0,0,0,0,0,0,0,0,0,2023-2024,,,
1681,Borja Mayoral,ESP,FW,Getafe,La Liga,26,1997,23.9,9,5,2,2,5,5,22,22.7,17,7,0,7,4,13,16,0,0,2023-2024,90.0,15.062761506276152,33.89121338912134
1682,Senny Mayulu,FRA,"FW,MF",Paris S-G,Ligue 1,17,2006,3.6,13,8,6,6,1,6,7,85.7,1,1,0,1,3,16,0,0,0,2023-2024,90.0,75.0,325.0
1683,Youssef Maziz,FRA,"FW,MF",Metz,Ligue 1,25,1998,1.4,0,0,0,0,0,0,2,0.0,2,1,0,1,1,1,2,0,0,2023-2024,90.0,64.28571428571429,0.0
1684,Noussair Mazraoui,MAR,DF,Bayern Munich,Bundesliga,25,1997,13.3,32,21,14,11,7,13,21,61.9,8,14,1,13,20,52,27,1,0,2023-2024,90.0,135.33834586466165,216.54135338345864
1685,Luca Mazzitelli,ITA,MF,Frosinone,Serie A,27,1995,24.6,45,23,15,24,6,26,49,53.1,23,23,7,16,19,64,62,0,0,2023-2024,89.99999999999999,69.51219512195121,164.63414634146338
1686,Pasquale Mazzocchi,ITA,DF,Salernitana,Serie A,28,1995,14.1,25,19,14,10,1,16,29,55.2,13,14,6,8,5,30,31,0,0,2023-2024,89.99999999999999,31.914893617021274,159.57446808510636
1687,Pasquale Mazzocchi,ITA,DF,Napoli,Serie A,28,1995,4.8,5,2,1,2,2,2,3,66.7,1,5,1,4,1,6,13,0,0,2023-2024,90.0,18.75,93.75
1688,Kevin Mbabu,SUI,DF,Augsburg,Bundesliga,28,1995,22.7,51,39,25,18,8,23,40,57.5,17,29,9,20,24,75,48,0,0,2023-2024,89.99999999999999,95.15418502202643,202.20264317180616
1689,Noah Mbamba,BEL,MF,Leverkusen,Bundesliga,18,2005,0.2,0,0,0,0,0,0,0,0.0,0,0,0,0,1,1,0,0,0,2023-2024,90.0,450.0,0.0
1690,Ethan Mbappé,FRA,"MF,DF",Paris S-G,Ligue 1,16,2006,0.5,0,0,0,0,0,0,2,0.0,2,1,0,1,0,0,0,0,0,2023-2024,90.0,0.0,0.0
1691,Kylian Mbappé,FRA,FW,Paris S-G,Ligue 1,24,1998,24.0,4,1,1,1,2,4,9,44.4,5,4,0,4,2,6,2,0,0,2023-2024,90.0,7.5,15.0
1692,Malick Mbaye,SEN,"MF,FW",Metz,Ligue 1,19,2004,1.7,5,1,0,1,4,1,2,50.0,1,1,0,1,1,6,2,0,0,2023-2024,90.0,52.94117647058823,264.70588235294116
1693,Mamadou Mbaye,SEN,DF,Cádiz,La Liga,25,1998,3.2,6,3,3,3,0,2,5,40.0,3,10,7,3,5,11,26,0,0,2023-2024,90.0,140.625,168.75
1694,Chancel Mbemba,COD,DF,Marseille,Ligue 1,28,1994,24.5,33,21,25,7,1,17,30,56.7,13,21,13,8,13,46,95,1,0,2023-2024,90.00000000000001,47.75510204081633,121.22448979591837
1695,Nolan Mbemba,CGO,MF,Le Havre,Ligue 1,28,1995,0.2,2,1,0,1,1,1,2,50.0,1,0,0,0,0,2,0,0,0,2023-2024,90.0,0.0,900.0
1696,Bryan Mbeumo,CMR,FW,Brentford,Premier League,23,1999,21.8,15,10,6,6,3,5,19,26.3,14,26,2,24,7,22,13,0,0,2023-2024,90.0,28.899082568807337,61.92660550458715
1697,Christ Mbondi,FRA,FW,Reims,Ligue 1,18,2004,0.0,1,1,1,0,0,1,1,100.0,0,0,0,0,0,1,0,0,0,2023-2024,,,inf
1698,Jordi Mboula,ESP,"FW,MF",Hellas Verona,Serie A,24,1999,3.4,4,4,1,2,1,4,7,57.1,3,4,1,3,1,5,0,0,0,2023-2024,90.0,26.470588235294116,105.88235294117646
1699,Nathanael Mbuku,FRA,FW,Augsburg,Bundesliga,21,2002,0.1,0,0,0,0,0,0,0,0.0,0,1,0,1,0,0,0,0,0,2023-2024,90.0,0.0,0.0
1700,James Mcatee,ENG,"MF,FW",Sheffield Utd,Premier League,20,2002,20.2,32,21,9,13,10,13,33,39.4,20,20,0,20,11,43,18,0,0,2023-2024,90.0,49.00990099009901,142.5742574257426
Rk,Player,Nation,Pos,Squad,Comp,0,0,90.0,0,0,3,3,3,Tkl,0,0.0,0,0,0,0,0,0,0,0,0,2023-2024,90.0,0.0,0.0
1701,James Mcatee,ENG,MF,Manchester City,Premier League,20,2002,0.0,0,0,0,0,0,0,0,0.0,0,1,0,1,0,0,0,0,0,2023-2024,,,
1702,Oliver McBurnie,SCO,FW,Sheffield Utd,Premier League,27,1996,14.2,17,7,4,7,6,5,12,41.7,7,18,2,16,5,22,28,0,0,2023-2024,90.0,31.690140845070424,107.74647887323944
1703,James McConnell,ENG,MF,Liverpool,Premier League,18,2004,0.0,0,0,0,0,0,0,0,0.0,0,1,0,1,1,1,0,0,0,2023-2024,,inf,
1704,John McGinn,SCO,"MF,FW",Aston Villa,Premier League,28,1994,33.3,59,35,18,34,7,32,77,41.6,45,33,4,29,21,80,21,0,0,2023-2024,90.0,56.75675675675676,159.45945945945945
1705,Scott McKenna,SCO,DF,Nott'ham Forest,Premier League,26,1996,4.6,4,0,3,1,0,2,3,66.7,1,6,4,2,5,9,27,0,0,2023-2024,90.0,97.82608695652175,78.26086956521739
1706,Weston McKennie,USA,"MF,DF",Juventus,Serie A,24,1998,28.8,48,29,31,11,6,17,27,63.0,10,28,7,21,18,66,69,0,0,2023-2024,90.0,56.25,150.0
1707,Dwight McNeil,ENG,"MF,FW",Everton,Premier League,23,1999,32.1,44,27,16,14,14,24,55,43.6,31,44,7,37,22,66,37,0,0,2023-2024,90.0,61.6822429906542,123.3644859813084
1708,Scott McTominay,SCO,"MF,FW",Manchester Utd,Premier League,26,1996,21.1,49,25,23,24,2,22,33,66.7,11,34,12,22,14,63,54,0,0,2023-2024,90.0,59.71563981042654,209.0047393364929
1709,Facundo Medina,ARG,DF,Lens,Ligue 1,24,1999,30.2,64,38,25,31,8,44,69,63.8,25,38,13,25,24,88,59,2,0,2023-2024,90.0,71.52317880794702,190.72847682119206
1710,Ben Mee,ENG,DF,Brentford,Premier League,33,1989,14.1,26,15,12,12,2,17,22,77.3,5,21,13,8,13,39,63,1,0,2023-2024,89.99999999999999,82.97872340425532,165.95744680851064
1711,Marvin Mehlem,GER,MF,Darmstadt 98,Bundesliga,25,1997,16.5,28,21,10,14,4,11,27,40.7,16,21,2,19,33,61,15,0,0,2023-2024,90.0,180.0,152.72727272727275
1712,Bamo Meïté,CIV,DF,Marseille,Ligue 1,21,2001,7.1,16,10,13,3,0,8,12,66.7,4,11,5,6,11,27,35,0,0,2023-2024,90.0,139.43661971830986,202.81690140845072
1713,Bamo Meïté,CIV,DF,Lorient,Ligue 1,21,2001,1.6,2,1,2,0,0,0,1,0.0,1,3,2,1,3,5,9,0,0,2023-2024,90.0,168.75,112.5
1714,Hannibal Mejbri,TUN,"MF,FW",Manchester Utd,Premier League,20,2003,1.5,3,3,1,2,0,1,3,33.3,2,1,1,0,0,3,0,0,0,2023-2024,90.0,0.0,180.0
1715,Hannibal Mejbri,TUN,MF,Sevilla,La Liga,20,2003,1.2,3,3,1,2,0,0,1,0.0,1,1,0,1,0,3,0,0,0,2023-2024,90.0,0.0,225.00000000000003
1716,Óscar Melendo,ESP,"MF,FW",Granada,La Liga,25,1997,12.5,14,6,4,10,0,4,12,33.3,8,13,0,13,5,19,4,1,0,2023-2024,90.0,36.0,100.8
1717,Gonzalo Melero,ESP,"MF,FW",Almería,La Liga,29,1994,12.3,14,8,7,5,2,7,19,36.8,12,12,4,8,4,18,11,0,0,2023-2024,89.99999999999999,29.268292682926827,102.43902439024389
1718,Birger Meling,NOR,DF,Rennes,Ligue 1,28,1994,0.2,1,1,1,0,0,1,1,100.0,0,1,0,1,0,1,0,0,0,2023-2024,90.0,0.0,450.0
1719,Arthur Melo,BRA,MF,Fiorentina,Serie A,26,1996,22.1,45,30,17,24,4,26,42,61.9,16,27,3,24,18,63,8,0,0,2023-2024,90.0,73.30316742081448,183.2579185520362
1720,Memphis,NED,FW,Atlético Madrid,La Liga,29,1994,9.9,5,2,0,3,2,3,6,50.0,3,2,0,2,1,6,0,0,0,2023-2024,90.0,9.090909090909092,45.45454545454545
1721,Houboulang Mendes,GNB,DF,Almería,La Liga,25,1998,4.4,16,13,11,5,0,8,16,50.0,8,4,2,2,1,17,17,1,0,2023-2024,90.0,20.454545454545453,327.27272727272725
1722,Nuno Mendes,POR,DF,Paris S-G,Ligue 1,21,2002,3.0,5,5,4,1,0,4,7,57.1,3,4,0,4,4,9,2,0,0,2023-2024,90.0,120.0,150.0
1723,Tomás Mendes,ESP,MF,Alavés,La Liga,18,2004,0.1,0,0,0,0,0,0,0,0.0,0,0,0,0,0,0,0,0,0,2023-2024,90.0,0.0,0.0
1724,Brais Méndez,ESP,"MF,FW",Real Sociedad,La Liga,26,1997,26.8,42,28,13,20,9,15,43,34.9,28,23,4,19,12,54,21,0,0,2023-2024,90.0,40.298507462686565,141.04477611940297
1725,Bruno Méndez,URU,DF,Granada,La Liga,23,1999,14.8,36,17,19,12,5,21,37,56.8,16,24,6,18,26,62,45,0,0,2023-2024,90.0,158.1081081081081,218.9189189189189
Rk,Player,Nation,Pos,Squad,Comp,0,0,90.0,0,0,3,3,3,Tkl,0,0.0,0,0,0,0,0,0,0,0,0,2023-2024,90.0,0.0,0.0
1726,Diego Méndez,ESP,MF,Rayo Vallecano,La Liga,19,2003,0.1,1,1,1,0,0,1,1,100.0,0,0,0,0,1,2,0,0,0,2023-2024,90.0,900.0,900.0
1727,Leonardo Mendicino,ITA,MF,Atalanta,Serie A,17,2006,0.0,0,0,0,0,0,0,0,0.0,0,0,0,0,0,0,0,0,0,2023-2024,,,
1728,Antoine Mendy,FRA,DF,Nice,Ligue 1,19,2004,4.6,7,5,4,3,0,3,7,42.9,4,4,1,3,8,15,16,0,0,2023-2024,90.0,156.52173913043478,136.95652173913044
1729,Benjamin Mendy,FRA,DF,Lorient,Ligue 1,29,1994,7.9,3,1,2,1,0,1,5,20.0,4,8,2,6,7,10,20,0,0,2023-2024,90.0,79.74683544303797,34.177215189873415
1730,Ferland Mendy,FRA,DF,Real Madrid,La Liga,28,1995,19.1,15,10,12,2,1,11,14,78.6,3,12,2,10,13,28,26,1,0,2023-2024,90.0,61.2565445026178,70.68062827225131
1731,Formose Mendy,SEN,DF,Lorient,Ligue 1,22,2001,14.0,33,19,24,8,1,20,33,60.6,13,23,12,11,20,53,59,1,0,2023-2024,90.0,128.57142857142856,212.14285714285714
1732,Nampalys Mendy,SEN,MF,Lens,Ligue 1,31,1992,11.7,29,18,10,13,6,16,20,80.0,4,11,4,7,14,43,14,1,0,2023-2024,89.99999999999999,107.6923076923077,223.07692307692307
1733,Teden Mengi,ENG,DF,Luton Town,Premier League,21,2002,27.4,54,22,33,20,1,19,30,63.3,11,39,27,12,57,111,140,1,0,2023-2024,90.0,187.22627737226279,177.37226277372264
1734,Chris Mepham,WAL,DF,Bournemouth,Premier League,25,1997,6.9,12,11,9,3,0,9,14,64.3,5,13,6,7,7,19,30,1,0,2023-2024,90.0,91.30434782608695,156.52173913043475
1735,Jorge Meré,ESP,DF,Cádiz,La Liga,26,1997,7.5,8,7,6,2,0,4,7,57.1,3,5,3,2,8,16,33,0,0,2023-2024,90.0,96.0,96.0
1736,Alex Meret,ITA,GK,Napoli,Serie A,26,1997,30.8,1,0,1,0,0,1,2,50.0,1,0,0,0,0,1,10,1,0,2023-2024,90.0,0.0,2.9220779220779223
1737,Mikel Merino,ESP,MF,Real Sociedad,La Liga,27,1996,27.6,77,43,25,34,18,22,48,45.8,26,36,11,25,16,93,55,3,0,2023-2024,90.0,52.17391304347826,251.0869565217391
1738,Quentin Merlin,FRA,DF,Marseille,Ligue 1,21,2002,7.8,13,12,7,5,1,8,20,40.0,12,4,0,4,6,19,14,0,0,2023-2024,90.0,69.23076923076923,150.0
1739,Quentin Merlin,FRA,DF,Nantes,Ligue 1,21,2002,14.3,29,20,15,12,2,16,25,64.0,9,22,1,21,18,47,22,0,0,2023-2024,90.0,113.2867132867133,182.51748251748253
1740,Junior Messias,BRA,"MF,DF",Genoa,Serie A,32,1991,11.7,26,20,19,5,2,8,19,42.1,11,9,1,8,5,31,22,0,0,2023-2024,89.99999999999999,38.46153846153846,200.0
1741,Thomas Meunier,BEL,DF,Dortmund,Bundesliga,31,1991,6.5,5,1,3,2,0,3,13,23.1,10,8,2,6,4,9,22,0,0,2023-2024,90.00000000000001,55.38461538461539,69.23076923076924
1742,Bastien Meupiyou,FRA,DF,Nantes,Ligue 1,17,2006,0.1,0,0,0,0,0,0,0,0.0,0,0,0,0,0,0,1,0,0,2023-2024,90.0,0.0,0.0
1743,Alexander Meyer,GER,GK,Dortmund,Bundesliga,32,1991,7.7,1,1,1,0,0,1,1,100.0,0,0,0,0,0,1,2,1,0,2023-2024,90.0,0.0,11.688311688311689
1744,Omenuke Mfulu,COD,"MF,FW",Las Palmas,La Liga,29,1994,0.9,4,3,3,1,0,0,1,0.0,1,1,1,0,2,6,5,0,0,2023-2024,90.0,200.0,400.0
1745,Lucas Michal,FRA,FW,Monaco,Ligue 1,18,2005,0.1,0,0,0,0,0,0,0,0.0,0,0,0,0,0,0,0,0,0,2023-2024,90.0,0.0,0.0
1746,Sven Michel,GER,"FW,MF",Augsburg,Bundesliga,33,1990,6.5,7,5,2,1,4,2,7,28.6,5,1,0,1,0,7,4,0,0,2023-2024,90.00000000000001,0.0,96.92307692307693
1747,Miguel,ESP,"FW,MF",Alavés,La Liga,23,1999,0.7,0,0,0,0,0,0,0,0.0,0,2,0,2,0,0,0,0,0,2023-2024,90.0,0.0,0.0
1748,Georges Mikautadze,GEO,FW,Metz,Ligue 1,22,2000,19.4,4,3,1,2,1,0,9,0.0,9,11,0,11,8,12,3,0,0,2023-2024,90.0,37.11340206185567,18.556701030927837
1749,Nikola Milenković,SRB,DF,Fiorentina,Serie A,25,1997,27.9,41,21,24,14,3,22,36,61.1,14,22,14,8,27,68,95,1,0,2023-2024,90.0,87.09677419354838,132.25806451612902
1750,Lewis Miley,ENG,MF,Newcastle Utd,Premier League,17,2006,13.4,33,21,6,20,7,15,32,46.9,17,20,3,17,8,41,18,2,0,2023-2024,90.0,53.731343283582085,221.64179104477608
Rk,Player,Nation,Pos,Squad,Comp,0,0,90.0,0,0,3,3,3,Tkl,0,0.0,0,0,0,0,0,0,0,0,0,2023-2024,90.0,0.0,0.0
1751,Arkadiusz Milik,POL,FW,Juventus,Serie A,29,1994,10.2,9,5,2,5,2,3,5,60.0,2,7,1,6,5,14,3,0,0,2023-2024,90.0,44.11764705882353,79.41176470588236
1752,Vanja Milinković-Savić,SRB,GK,Torino,Serie A,26,1997,36.0,1,0,1,0,0,1,1,100.0,0,0,0,0,1,2,14,4,0,2023-2024,90.0,2.5,2.5
1753,Éder Militão,BRA,DF,Real Madrid,La Liga,25,1998,5.5,7,3,4,3,0,6,9,66.7,3,4,3,1,4,11,19,1,0,2023-2024,90.0,65.45454545454545,114.54545454545455
1754,Luis Milla,ESP,MF,Getafe,La Liga,28,1994,23.5,57,33,19,28,10,28,47,59.6,19,20,1,19,32,89,10,0,0,2023-2024,90.0,122.5531914893617,218.29787234042553
1755,Enzo Millot,FRA,"MF,FW",Stuttgart,Bundesliga,21,2002,24.9,40,22,9,21,10,18,39,46.2,21,24,2,22,16,56,7,1,0,2023-2024,90.0,57.83132530120482,144.57831325301206
1756,James Milner,ENG,"DF,MF",Brighton,Premier League,37,1986,8.6,20,14,9,10,1,9,14,64.3,5,9,0,9,8,28,16,0,0,2023-2024,90.0,83.72093023255815,209.30232558139537
1757,Jovan Milošević,SRB,"FW,MF",Stuttgart,Bundesliga,18,2005,0.3,0,0,0,0,0,0,0,0.0,0,0,0,0,0,0,0,0,0,2023-2024,90.0,0.0,0.0
1758,Marko Milovanović,SRB,"FW,MF",Almería,La Liga,19,2003,3.4,4,4,1,3,0,2,4,50.0,2,2,0,2,0,4,5,0,0,2023-2024,90.0,0.0,105.88235294117646
1759,Kim Min-jae,KOR,DF,Bayern Munich,Bundesliga,26,1996,21.9,37,24,21,11,5,12,24,50.0,12,29,19,10,45,82,70,2,0,2023-2024,90.0,184.93150684931507,152.05479452054794
1760,Yerry Mina,COL,"DF,MF",Fiorentina,Serie A,28,1994,0.5,1,1,1,0,0,1,2,50.0,1,0,0,0,0,1,2,0,0,2023-2024,90.0,0.0,180.0
1761,Yerry Mina,COL,DF,Cagliari,Serie A,28,1994,13.5,20,13,14,6,0,13,19,68.4,6,23,14,9,4,24,77,0,0,2023-2024,90.0,26.666666666666668,133.33333333333334
1762,Takumi Minamino,JPN,MF,Monaco,Ligue 1,28,1995,23.5,34,17,10,13,11,16,54,29.6,38,29,1,28,11,45,8,0,0,2023-2024,90.0,42.12765957446808,130.2127659574468
1763,Lucas Mincarelli,FRA,"DF,MF",Montpellier,Ligue 1,19,2004,10.9,29,16,19,6,4,17,34,50.0,17,17,4,13,8,37,27,0,0,2023-2024,90.0,66.05504587155963,239.44954128440367
1764,Tyrone Mings,ENG,DF,Aston Villa,Premier League,30,1993,0.3,0,0,0,0,0,0,0,0.0,0,0,0,0,1,1,1,0,0,2023-2024,90.0,300.0,0.0
1765,Óscar Mingueza,ESP,"DF,MF",Celta Vigo,La Liga,24,1999,33.3,62,38,44,11,7,37,80,46.3,43,38,7,31,17,79,49,2,0,2023-2024,90.0,45.945945945945944,167.56756756756758
1766,Ignasi Miquel,ESP,DF,Granada,La Liga,30,1992,33.2,47,30,39,6,2,23,40,57.5,17,32,16,16,45,92,132,4,0,2023-2024,90.0,121.9879518072289,127.40963855421685
1767,Rafa Mir,ESP,"FW,MF",Sevilla,La Liga,26,1997,4.3,2,2,1,1,0,1,2,50.0,1,2,0,2,1,3,1,0,0,2023-2024,90.0,20.930232558139537,41.86046511627907
1768,Ignacio Miramon,ARG,MF,Lille,Ligue 1,20,2003,0.4,1,0,0,1,0,0,1,0.0,1,1,0,1,0,1,0,0,0,2023-2024,90.0,0.0,225.0
1769,Aleksei Miranchuk,RUS,"MF,FW",Atalanta,Serie A,27,1995,13.1,12,6,6,4,2,5,13,38.5,8,6,1,5,2,14,5,1,0,2023-2024,90.0,13.740458015267176,82.44274809160305
1770,Juan Miranda,ESP,DF,Betis,La Liga,23,2000,20.6,38,24,21,13,4,17,31,54.8,14,31,6,25,19,57,62,0,0,2023-2024,90.0,83.00970873786407,166.01941747572815
1771,Kevin Miranda,ITA,DF,Sassuolo,Serie A,20,2003,0.2,0,0,0,0,0,0,0,0.0,0,0,0,0,0,0,1,0,0,2023-2024,90.0,0.0,0.0
1772,Antonio Mirante,ITA,GK,Milan,Serie A,40,1983,2.0,0,0,0,0,0,0,0,0.0,0,0,0,0,0,0,1,0,0,2023-2024,90.0,0.0,0.0
1773,Fabio Miretti,ITA,MF,Juventus,Serie A,19,2003,12.3,18,14,6,8,4,10,26,38.5,16,10,1,9,7,25,6,0,0,2023-2024,89.99999999999999,51.21951219512194,131.7073170731707
1774,Filippo Missori,ITA,DF,Sassuolo,Serie A,19,2004,3.0,6,3,2,4,0,4,11,36.4,7,3,2,1,4,10,8,0,0,2023-2024,90.0,120.0,180.0
1775,Tyrick Mitchell,ENG,"DF,MF",Crystal Palace,Premier League,23,1999,35.6,105,60,75,21,9,43,60,71.7,17,63,10,53,26,131,104,0,0,2023-2024,90.0,65.73033707865169,265.4494382022472
Rk,Player,Nation,Pos,Squad,Comp,0,0,90.0,0,0,3,3,3,Tkl,0,0.0,0,0,0,0,0,0,0,0,0,2023-2024,90.0,0.0,0.0
1776,Kaoru Mitoma,JPN,FW,Brighton,Premier League,26,1997,16.5,13,6,3,7,3,5,19,26.3,14,15,1,14,5,18,12,0,0,2023-2024,90.0,27.272727272727273,70.90909090909092
1777,Aleksandar Mitrović,SRB,FW,Fulham,Premier League,28,1994,0.4,0,0,0,0,0,0,0,0.0,0,0,0,0,0,0,0,0,0,2023-2024,90.0,0.0,0.0
1778,Stefan Mitrović,SRB,"FW,MF",Hellas Verona,Serie A,20,2002,4.3,6,3,0,5,1,2,5,40.0,3,6,1,5,0,6,4,0,0,2023-2024,90.0,0.0,125.58139534883722
1779,Stefan Mitrović,SRB,DF,Getafe,La Liga,33,1990,7.8,9,3,7,2,0,4,8,50.0,4,3,2,1,6,15,26,0,0,2023-2024,90.0,69.23076923076923,103.84615384615384
1780,Maximilian Mittelstädt,GER,DF,Stuttgart,Bundesliga,26,1997,23.4,91,51,46,39,6,53,89,59.6,36,36,6,30,46,137,65,0,0,2023-2024,89.99999999999999,176.9230769230769,350.0
1781,Henrikh Mkhitaryan,ARM,MF,Inter,Serie A,34,1989,30.9,62,34,18,35,9,24,49,49.0,25,23,4,19,29,91,43,0,0,2023-2024,90.0,84.46601941747574,180.58252427184468
1782,Marko Mladenović,SRB,MF,Eint Frankfurt,Bundesliga,18,2005,0.1,0,0,0,0,0,0,0,0.0,0,0,0,0,0,0,0,0,0,2023-2024,90.0,0.0,0.0
1783,Jakub Moder,POL,"MF,DF",Brighton,Premier League,24,1999,6.9,19,10,9,5,5,9,18,50.0,9,8,2,6,2,21,12,0,0,2023-2024,90.0,26.08695652173913,247.82608695652172
1784,Luka Modrić,CRO,MF,Real Madrid,La Liga,37,1985,18.8,22,15,10,6,6,9,25,36.0,16,13,4,9,21,43,9,0,0,2023-2024,90.0,100.53191489361701,105.31914893617021
1785,Max Moerstedt,GER,"DF,FW",Hoffenheim,Bundesliga,0,0,0.1,0,0,0,0,0,0,1,0.0,1,0,0,0,0,0,0,0,0,2023-2024,90.0,0.0,0.0
1786,Terem Moffi,NGA,FW,Nice,Ligue 1,24,1999,21.7,7,4,0,5,2,3,12,25.0,9,14,1,13,3,10,15,0,0,2023-2024,90.0,12.442396313364055,29.032258064516128
1787,Mostafa Mohamed,EGY,FW,Nantes,Ligue 1,25,1997,22.2,21,14,7,11,3,6,28,21.4,22,21,5,16,12,33,29,0,0,2023-2024,90.0,48.64864864864865,85.13513513513514
1788,Dion Moise Sahi,CIV,"MF,FW",Strasbourg,Ligue 1,21,2001,7.0,5,5,1,2,2,0,3,0.0,3,11,1,10,1,6,7,0,0,2023-2024,90.0,12.857142857142858,64.28571428571428
1789,Johan Mojica,COL,DF,Osasuna,La Liga,30,1992,22.7,30,22,11,15,4,16,25,64.0,9,15,2,13,21,51,40,2,0,2023-2024,89.99999999999999,83.25991189427312,118.94273127753303
1790,Alberto Moleiro,ESP,"FW,MF",Las Palmas,La Liga,19,2003,20.0,15,6,4,7,4,6,30,20.0,24,11,0,11,7,22,10,0,0,2023-2024,90.0,31.5,67.5
1791,Nahuel Molina,ARG,DF,Atlético Madrid,La Liga,25,1998,20.6,38,22,16,18,4,26,54,48.1,28,19,3,16,9,47,36,1,0,2023-2024,90.0,39.320388349514566,166.01941747572815
1792,Florent Mollet,FRA,"MF,FW",Nantes,Ligue 1,31,1991,23.1,18,11,8,6,4,10,31,32.3,21,18,5,13,13,31,17,0,0,2023-2024,89.99999999999999,50.64935064935064,70.12987012987011
1793,Jon Moncayola,ESP,MF,Osasuna,La Liga,25,1998,20.0,27,18,14,10,3,17,42,40.5,25,31,5,26,15,42,21,0,0,2023-2024,90.0,67.5,121.5
1794,Enzo Mongo,FRA,DF,Nantes,Ligue 1,18,2005,0.1,1,1,1,0,0,1,2,50.0,1,1,1,0,1,2,0,0,0,2023-2024,90.0,900.0,900.0
1795,Ilario Monterisi,ITA,DF,Frosinone,Serie A,21,2001,16.3,23,13,14,7,2,12,26,46.2,14,22,18,4,8,31,63,0,0,2023-2024,90.0,44.171779141104295,126.99386503067484
1796,César Montes,MEX,DF,Almería,La Liga,26,1997,19.9,22,13,13,9,0,9,18,50.0,9,21,9,12,11,33,94,0,0,2023-2024,90.0,49.74874371859297,99.49748743718594
1797,Gonzalo Montiel,ARG,DF,Nott'ham Forest,Premier League,26,1997,8.9,22,19,12,8,2,16,29,55.2,13,8,3,5,9,31,31,1,0,2023-2024,90.0,91.01123595505618,222.47191011235955
1798,Lorenzo Montipò,ITA,GK,Hellas Verona,Serie A,27,1996,37.0,1,1,1,0,0,1,3,33.3,2,0,0,0,0,1,25,2,0,2023-2024,90.0,0.0,2.4324324324324325
1799,Kieffer Moore,WAL,"FW,MF",Bournemouth,Premier League,30,1992,1.2,0,0,0,0,0,0,0,0.0,0,0,0,0,0,0,0,0,0,2023-2024,90.0,0.0,0.0
1800,Mikey Moore,ENG,MF,Tottenham,Premier League,15,2007,0.0,0,0,0,0,0,0,0,0.0,0,0,0,0,0,0,1,0,0,2023-2024,,,
Rk,Player,Nation,Pos,Squad,Comp,0,0,90.0,0,0,3,3,3,Tkl,0,0.0,0,0,0,0,0,0,0,0,0,2023-2024,90.0,0.0,0.0
1801,Álvaro Morata,ESP,FW,Atlético Madrid,La Liga,30,1992,21.2,16,10,4,7,5,3,5,60.0,2,18,3,15,1,17,26,0,0,2023-2024,90.0,4.245283018867925,67.9245283018868
1802,Diego Moreira,POR,"FW,MF",Lyon,Ligue 1,18,2004,3.0,0,0,0,0,0,0,3,0.0,3,3,0,3,2,2,5,0,0,2023-2024,90.0,60.0,0.0
1803,Alberto Moreno,ESP,DF,Villarreal,La Liga,31,1992,16.5,31,21,19,10,2,10,30,33.3,20,12,2,10,24,55,33,0,0,2023-2024,90.0,130.9090909090909,169.0909090909091
1804,Álex Moreno,ESP,DF,Aston Villa,Premier League,30,1993,11.5,18,12,18,0,0,12,19,63.2,7,11,2,9,13,31,37,0,0,2023-2024,90.0,101.73913043478262,140.8695652173913
1805,Gerard Moreno,ESP,FW,Villarreal,La Liga,31,1992,24.6,25,12,10,7,8,11,25,44.0,14,24,7,17,9,34,24,0,0,2023-2024,89.99999999999999,32.92682926829268,91.46341463414633
1806,Jorge Moreno,ESP,DF,Osasuna,La Liga,22,2001,0.2,0,0,0,0,0,0,0,0.0,0,1,0,1,0,0,3,0,0,2023-2024,90.0,0.0,0.0
1807,Mateu Morey,ESP,DF,Dortmund,Bundesliga,23,2000,1.2,2,2,1,1,0,2,4,50.0,2,3,1,2,1,3,3,0,0,2023-2024,90.0,75.0,150.0
1808,Ilaix Moriba,GUI,"MF,FW",Getafe,La Liga,20,2003,6.7,20,11,3,11,6,4,9,44.4,5,3,1,2,4,24,10,0,0,2023-2024,90.0,53.731343283582085,268.65671641791045
1809,Manu Morlanes,ESP,MF,Mallorca,La Liga,24,1999,17.9,50,29,23,26,1,23,53,43.4,30,13,1,12,20,70,21,0,0,2023-2024,90.0,100.5586592178771,251.39664804469277
1810,Nikola Moro,CRO,MF,Bologna,Serie A,25,1998,9.3,21,16,8,12,1,8,15,53.3,7,14,1,13,7,28,10,0,0,2023-2024,90.0,67.74193548387096,203.22580645161287
1811,Carlton Morris,ENG,"FW,MF",Luton Town,Premier League,27,1995,31.8,15,8,4,6,5,9,15,60.0,6,24,5,19,1,16,53,0,0,2023-2024,90.0,2.830188679245283,42.45283018867924
1812,Cristhian Mosquera,ESP,DF,Valencia,La Liga,19,2004,34.2,57,34,36,18,3,25,39,64.1,14,42,23,19,36,93,137,2,0,2023-2024,90.0,94.73684210526315,150.0
1813,Yerson Mosquera,COL,DF,Villarreal,La Liga,22,2001,13.7,27,13,18,7,2,12,15,80.0,3,12,2,10,17,44,65,0,0,2023-2024,90.0,111.67883211678833,177.37226277372264
1814,Dany Mota,POR,"FW,MF",Monza,Serie A,25,1998,22.8,13,7,2,5,6,8,17,47.1,9,4,1,3,2,15,18,0,0,2023-2024,90.0,7.894736842105263,51.315789473684205
1815,Lebo Mothiba,RSA,FW,Strasbourg,Ligue 1,27,1996,6.9,5,2,1,4,0,3,4,75.0,1,6,1,5,0,5,11,0,0,2023-2024,90.0,0.0,65.21739130434781
1816,Youssoufa Moukoko,GER,FW,Dortmund,Bundesliga,18,2004,6.9,4,1,2,2,0,3,7,42.9,4,4,1,3,2,6,4,0,0,2023-2024,90.0,26.08695652173913,52.17391304347826
1817,Steve Mounié,BEN,FW,Brest,Ligue 1,28,1994,19.7,8,7,0,3,5,3,11,27.3,8,13,3,10,2,10,18,0,0,2023-2024,90.0,9.137055837563452,36.54822335025381
1818,Mason Mount,ENG,"MF,FW",Manchester Utd,Premier League,24,1999,5.7,22,14,6,10,6,6,16,37.5,10,6,1,5,6,28,3,0,0,2023-2024,90.0,94.73684210526315,347.36842105263156
1819,Samuel Moutoussamy,COD,MF,Nantes,Ligue 1,26,1996,12.3,38,20,14,17,7,17,37,45.9,20,16,3,13,11,49,13,0,0,2023-2024,89.99999999999999,80.48780487804876,278.04878048780483
1820,Loris Mouyokolo,FRA,DF,Lorient,Ligue 1,22,2001,1.0,4,1,4,0,0,1,1,100.0,0,1,0,1,0,4,3,0,0,2023-2024,90.0,0.0,360.0
1821,Divin Mubama,ENG,FW,West Ham,Premier League,18,2004,0.9,0,0,0,0,0,0,0,0.0,0,0,0,0,0,0,0,0,0,2023-2024,90.0,0.0,0.0
1822,Mykhailo Mudryk,UKR,FW,Chelsea,Premier League,22,2001,17.5,21,12,9,7,5,10,32,31.3,22,14,1,13,9,30,9,0,0,2023-2024,90.0,46.285714285714285,108.0
1823,François Mughe,CMR,"MF,DF",Marseille,Ligue 1,19,2004,2.0,0,0,0,0,0,0,3,0.0,3,2,0,2,1,1,1,0,0,2023-2024,90.0,45.0,0.0
1824,Nordi Mukiele,FRA,DF,Paris S-G,Ligue 1,25,1997,8.8,12,8,6,5,1,8,15,53.3,7,17,4,13,14,26,28,0,0,2023-2024,90.0,143.1818181818182,122.72727272727272
1825,Samuele Mulattieri,ITA,"FW,MF",Sassuolo,Serie A,22,2000,5.1,1,1,0,0,1,1,2,50.0,1,7,2,5,1,2,2,0,0,2023-2024,90.0,17.647058823529413,17.647058823529413
Rk,Player,Nation,Pos,Squad,Comp,0,0,90.0,0,0,3,3,3,Tkl,0,0.0,0,0,0,0,0,0,0,0,0,2023-2024,90.0,0.0,0.0
1826,Andreas Müller,GER,MF,Darmstadt 98,Bundesliga,23,2000,3.9,14,9,8,5,1,4,9,44.4,5,5,2,3,4,18,5,0,0,2023-2024,90.0,92.3076923076923,323.07692307692304
1827,Jannik Müller,GER,"DF,MF",Darmstadt 98,Bundesliga,29,1994,12.6,33,16,21,9,3,16,27,59.3,11,24,12,12,17,50,39,1,0,2023-2024,90.0,121.42857142857144,235.71428571428575
1828,Kevin Müller,GER,GK,Heidenheim,Bundesliga,32,1991,34.0,3,0,3,0,0,3,5,60.0,2,0,0,0,0,3,6,1,0,2023-2024,90.0,0.0,7.9411764705882355
1829,Marcus Müller,GER,MF,Mainz 05,Bundesliga,20,2002,0.2,0,0,0,0,0,0,0,0.0,0,0,0,0,0,0,0,0,0,2023-2024,90.0,0.0,0.0
1830,Thomas Müller,GER,"MF,FW",Bayern Munich,Bundesliga,33,1989,18.4,26,16,5,10,11,13,35,37.1,22,22,0,22,3,29,6,0,0,2023-2024,90.0,14.673913043478262,127.17391304347827
1831,Abdul Mumin,GHA,DF,Rayo Vallecano,La Liga,25,1998,18.8,19,10,13,4,2,8,10,80.0,2,27,19,8,22,41,82,1,0,2023-2024,90.0,105.31914893617021,90.95744680851064
1832,Marshall Munetsi,ZIM,MF,Reims,Ligue 1,27,1996,24.1,61,39,18,34,9,33,61,54.1,28,21,7,14,14,75,33,0,0,2023-2024,90.0,52.28215767634855,227.80082987551867
1833,Iker Muniain,ESP,"MF,FW",Athletic Club,La Liga,30,1992,6.6,5,1,2,3,0,1,3,33.3,2,4,1,3,0,5,0,0,0,2023-2024,90.0,0.0,68.18181818181819
1834,Rodrigo Muniz,BRA,FW,Fulham,Premier League,22,2001,17.7,7,3,1,5,1,1,6,16.7,5,9,3,6,6,13,20,0,0,2023-2024,90.0,30.508474576271187,35.59322033898305
1835,Aihen Muñoz,ESP,DF,Real Sociedad,La Liga,25,1997,12.5,36,21,20,10,6,24,35,68.6,11,16,8,8,9,45,33,0,0,2023-2024,90.0,64.8,259.2
1836,Álvaro Muñoz,URU,FW,Real Madrid,La Liga,19,2004,0.0,0,0,0,0,0,0,0,0.0,0,0,0,0,0,0,1,0,0,2023-2024,,,
1837,Daniel Muñoz,COL,"DF,MF",Crystal Palace,Premier League,27,1996,16.0,55,35,31,14,10,19,38,50.0,19,29,7,22,24,79,47,0,0,2023-2024,90.0,135.0,309.375
1838,Iker Muñoz,ESP,MF,Osasuna,La Liga,20,2002,20.6,32,18,13,17,2,15,31,48.4,16,16,5,11,11,43,50,0,0,2023-2024,90.0,48.05825242718446,139.80582524271844
1839,Javier Muñoz,ESP,MF,Las Palmas,La Liga,28,1995,29.3,42,23,14,22,6,16,44,36.4,28,40,4,36,20,62,29,1,0,2023-2024,90.0,61.43344709897611,129.01023890784984
1840,Finley Munroe,ENG,MF,Aston Villa,Premier League,18,2005,0.0,0,0,0,0,0,0,0,0.0,0,0,0,0,0,0,0,0,0,2023-2024,,,
1841,Arijanet Muric,KVX,GK,Burnley,Premier League,24,1998,10.0,1,1,1,0,0,1,1,100.0,0,0,0,0,0,1,10,4,0,2023-2024,90.0,0.0,9.0
1842,Luis Muriel,COL,"FW,MF",Atalanta,Serie A,32,1991,4.5,3,2,0,2,1,1,1,100.0,0,4,0,4,1,4,0,0,0,2023-2024,90.0,20.0,60.0
1843,Murillo,BRA,DF,Nott'ham Forest,Premier League,21,2002,31.0,50,31,36,13,1,19,33,57.6,14,41,24,17,37,87,188,0,0,2023-2024,90.0,107.41935483870968,145.16129032258064
1844,Vedat Muriqi,KVX,FW,Mallorca,La Liga,29,1994,25.9,11,6,4,3,4,2,14,14.3,12,11,4,7,6,17,26,0,0,2023-2024,90.0,20.849420849420852,38.22393822393823
1845,Alex Murphy,IRL,"DF,FW",Newcastle Utd,Premier League,19,2004,0.1,1,1,0,1,0,1,2,50.0,1,1,0,1,1,2,0,0,0,2023-2024,90.0,900.0,900.0
1846,Jacob Murphy,ENG,"FW,DF",Newcastle Utd,Premier League,28,1995,13.2,20,10,8,4,8,12,26,46.2,14,17,0,17,6,26,16,0,0,2023-2024,90.0,40.90909090909091,136.36363636363637
1847,Yunus Musah,USA,"MF,FW",Milan,Serie A,20,2002,16.4,25,14,15,6,4,8,15,53.3,7,18,4,14,10,35,16,1,0,2023-2024,90.0,54.87804878048781,137.19512195121953
1848,Jamal Musiala,GER,"MF,FW",Bayern Munich,Bundesliga,20,2003,19.5,40,25,9,21,10,14,36,38.9,22,25,1,24,16,56,5,0,0,2023-2024,90.0,73.84615384615384,184.6153846153846
1849,Florent Muslija,KVX,"MF,FW",Freiburg,Bundesliga,25,1998,1.2,5,4,3,2,0,2,5,40.0,3,1,0,1,0,5,2,0,0,2023-2024,90.0,0.0,375.0
1850,Juan Musso,ARG,GK,Atalanta,Serie A,29,1994,11.0,1,0,1,0,0,1,1,100.0,0,0,0,0,0,1,6,0,0,2023-2024,90.0,0.0,8.181818181818182
Rk,Player,Nation,Pos,Squad,Comp,0,0,90.0,0,0,3,3,3,Tkl,0,0.0,0,0,0,0,0,0,0,0,0,2023-2024,90.0,0.0,0.0
1851,Kingstone Mutandwa,ZAM,"FW,MF",Cagliari,Serie A,20,2003,0.4,1,0,1,0,0,1,4,25.0,3,1,0,1,0,1,2,0,0,2023-2024,90.0,0.0,225.0
1852,Yvon Mvogo,SUI,GK,Lorient,Ligue 1,29,1994,34.0,0,0,0,0,0,0,1,0.0,1,0,0,0,0,0,15,3,0,2023-2024,90.0,0.0,0.0
1853,Joel Mvuka,NOR,"DF,FW",Lorient,Ligue 1,20,2002,2.2,5,3,3,1,1,3,7,42.9,4,1,0,1,2,7,1,0,0,2023-2024,90.0,81.81818181818181,204.54545454545453
1854,Junior Mwanga,FRA,"MF,FW",Strasbourg,Ligue 1,20,2003,16.1,40,20,23,12,5,12,24,50.0,12,20,5,15,18,58,19,0,0,2023-2024,90.0,100.62111801242236,223.60248447204967
1855,Phillipp Mwene,AUT,DF,Mainz 05,Bundesliga,29,1994,22.2,34,15,15,16,3,16,33,48.5,17,27,3,24,17,51,47,0,0,2023-2024,90.0,68.91891891891892,137.83783783783784
1856,Vitaliy Mykolenko,UKR,DF,Everton,Premier League,24,1999,27.4,69,38,46,21,2,41,66,62.1,25,36,11,25,36,105,92,0,0,2023-2024,90.0,118.24817518248177,226.64233576642337
1857,Joakim Mæhle,DEN,"DF,MF",Wolfsburg,Bundesliga,26,1997,27.2,62,39,33,18,11,41,64,64.1,23,43,5,38,29,91,65,0,0,2023-2024,90.0,95.95588235294117,205.14705882352942
1858,Obite N'Dicka,CIV,DF,Roma,Serie A,23,1999,24.1,32,18,12,19,1,12,20,60.0,8,30,16,14,16,48,75,0,0,2023-2024,90.0,59.75103734439834,119.50207468879668
1859,Kévin N'Doram,FRA,MF,Metz,Ligue 1,27,1996,17.8,31,22,20,9,2,17,38,44.7,21,17,8,9,27,58,38,0,0,2023-2024,90.0,136.51685393258427,156.74157303370788
1860,Nathan N'Goumou,FRA,"FW,MF",Gladbach,Bundesliga,23,2000,15.4,37,22,17,18,2,16,34,47.1,18,22,0,22,5,42,17,1,0,2023-2024,90.0,29.22077922077922,216.23376623376623
1861,Stanley N'Soki,FRA,DF,Hoffenheim,Bundesliga,24,1999,7.0,21,10,12,8,1,17,29,58.6,12,13,2,11,8,29,33,0,0,2023-2024,90.0,102.85714285714286,270.0
1862,Nacho,ESP,DF,Real Madrid,La Liga,33,1990,19.4,18,10,9,7,2,6,13,46.2,7,23,13,10,18,36,56,0,0,2023-2024,90.0,83.50515463917527,83.50515463917527
1863,Bilal Nadir,FRA,"MF,FW",Marseille,Ligue 1,19,2003,1.3,4,3,2,2,0,1,2,50.0,1,0,0,0,2,6,2,0,0,2023-2024,90.0,138.46153846153845,276.9230769230769
1864,Mahamadou Nagida,CMR,DF,Rennes,Ligue 1,18,2005,1.2,1,1,0,0,1,0,2,0.0,2,2,1,1,4,5,0,0,0,2023-2024,90.0,300.0,75.0
1865,Marvelous Nakamba,ZIM,MF,Luton Town,Premier League,29,1994,12.6,40,24,24,14,2,24,42,57.1,18,23,6,17,11,51,11,1,0,2023-2024,90.0,78.57142857142858,285.7142857142857
1866,Keito Nakamura,JPN,"FW,MF",Reims,Ligue 1,23,2000,15.3,28,11,9,10,9,17,37,45.9,20,15,2,13,6,34,7,0,0,2023-2024,90.0,35.29411764705882,164.70588235294116
1867,Nahitan Nández,URU,"MF,DF",Cagliari,Serie A,27,1995,26.0,59,40,27,23,9,27,64,42.2,37,25,2,23,19,78,32,0,0,2023-2024,90.00000000000001,65.76923076923077,204.23076923076925
1868,Matija Nastasić,SRB,DF,Mallorca,La Liga,30,1993,25.1,35,17,26,9,0,24,32,75.0,8,33,20,13,29,64,114,0,0,2023-2024,90.0,103.98406374501991,125.49800796812748
1869,Natan,BRA,DF,Napoli,Serie A,22,2001,10.6,14,10,10,3,1,5,10,50.0,5,12,9,3,8,22,32,0,0,2023-2024,90.0,67.9245283018868,118.8679245283019
1870,Lapo Nava,ITA,GK,Milan,Serie A,19,2004,0.0,0,0,0,0,0,0,0,0.0,0,0,0,0,0,0,0,0,0,2023-2024,,,
1871,Roberto Navarro,ESP,"MF,FW",Cádiz,La Liga,21,2002,21.0,46,29,20,21,5,22,43,51.2,21,33,0,33,19,65,7,1,0,2023-2024,90.0,81.42857142857143,197.14285714285714
1872,Jesús Navas,ESP,DF,Sevilla,La Liga,37,1985,22.3,37,27,21,14,2,22,40,55.0,18,15,7,8,22,59,48,0,0,2023-2024,90.0,88.78923766816143,149.3273542600897
1873,Keylor Navas,CRC,GK,Paris S-G,Ligue 1,36,1986,4.0,0,0,0,0,0,0,0,0.0,0,0,0,0,0,0,2,0,0,2023-2024,90.0,0.0,0.0
1874,Michel Ndary Adopo,FRA,MF,Atalanta,Serie A,23,2000,1.2,4,3,0,3,1,1,1,100.0,0,0,0,0,0,4,2,1,0,2023-2024,90.0,0.0,300.0
1875,Youssouf Ndayishimiye,BDI,"MF,DF",Nice,Ligue 1,24,1998,19.0,31,20,17,12,2,12,23,52.2,11,19,11,8,12,43,47,1,0,2023-2024,90.0,56.8421052631579,146.8421052631579
Rk,Player,Nation,Pos,Squad,Comp,0,0,90.0,0,0,3,3,3,Tkl,0,0.0,0,0,0,0,0,0,0,0,0,2023-2024,90.0,0.0,0.0
1876,Bassirou Ndiaye,SEN,FW,Lorient,Ligue 1,21,2002,1.7,5,2,2,2,1,3,5,60.0,2,1,1,0,1,6,0,0,0,2023-2024,90.0,52.94117647058823,264.70588235294116
1877,Iliman Ndiaye,SEN,"FW,MF",Marseille,Ligue 1,23,2000,18.0,21,18,5,11,5,11,29,37.9,18,14,2,12,6,27,6,0,0,2023-2024,90.0,30.0,105.0
1878,Massamba Ndiaye,SEN,GK,Clermont Foot,Ligue 1,21,2001,4.0,0,0,0,0,0,0,0,0.0,0,0,0,0,0,0,2,0,0,2023-2024,90.0,0.0,0.0
1879,Rassoul Ndiaye,SEN,"MF,FW",Le Havre,Ligue 1,21,2001,5.8,25,17,8,16,1,12,24,50.0,12,2,1,1,4,29,5,0,0,2023-2024,90.0,62.06896551724138,387.9310344827586
1880,Michael Ndiweni,ENG,FW,Newcastle Utd,Premier League,19,2003,0.0,0,0,0,0,0,0,0,0.0,0,0,0,0,0,0,0,0,0,2023-2024,,,
1881,Cher Ndour,ITA,MF,Paris S-G,Ligue 1,19,2004,0.3,2,2,0,2,0,1,2,50.0,1,0,0,0,0,2,0,0,0,2023-2024,90.0,0.0,600.0
1882,Dan Ndoye,SUI,"FW,MF",Bologna,Serie A,22,2000,19.7,30,15,17,11,2,17,39,43.6,22,20,1,19,10,40,14,0,0,2023-2024,90.0,45.68527918781726,137.05583756345177
1883,Joseph Nduquidi,FRA,"MF,DF",Metz,Ligue 1,18,2004,8.3,11,4,6,3,2,1,9,11.1,8,11,3,8,11,22,15,1,0,2023-2024,90.0,119.27710843373492,119.27710843373492
1884,Loïc Nego,HUN,"DF,MF",Le Havre,Ligue 1,32,1991,17.3,37,26,21,12,4,18,30,60.0,12,12,2,10,16,53,17,0,0,2023-2024,90.0,83.23699421965317,192.48554913294797
1885,Álvaro Negredo,ESP,"FW,MF",Cádiz,La Liga,37,1985,0.6,0,0,0,0,0,0,0,0.0,0,1,0,1,1,1,0,0,0,2023-2024,90.0,150.0,0.0
1886,Reiss Nelson,ENG,FW,Arsenal,Premier League,23,1999,3.0,9,6,5,1,3,8,10,80.0,2,5,1,4,1,10,5,0,0,2023-2024,90.0,30.0,270.0
1887,Zack Nelson,ENG,"MF,DF",Luton Town,Premier League,18,2004,0.1,1,0,1,0,0,0,0,0.0,0,0,0,0,0,1,0,0,0,2023-2024,90.0,0.0,900.0
1888,Neto,BRA,GK,Bournemouth,Premier League,34,1989,32.0,0,0,0,0,0,0,0,0.0,0,1,0,1,1,1,12,3,0,2023-2024,90.0,2.8125,0.0
1889,Pedro Neto,POR,"FW,MF",Wolves,Premier League,23,2000,16.8,7,3,3,2,2,5,15,33.3,10,5,1,4,5,12,2,0,0,2023-2024,90.0,26.785714285714285,37.5
1890,Luca Netz,GER,DF,Gladbach,Bundesliga,20,2003,24.7,38,22,19,16,3,23,43,53.5,20,36,10,26,22,60,76,1,0,2023-2024,90.0,80.16194331983806,138.46153846153845
1891,Manuel Neuer,GER,GK,Bayern Munich,Bundesliga,37,1986,22.8,1,1,1,0,0,0,0,0.0,0,0,0,0,0,1,14,3,0,2023-2024,90.0,0.0,3.9473684210526314
1892,Florian Neuhaus,GER,MF,Gladbach,Bundesliga,26,1997,13.6,15,12,7,8,0,8,26,30.8,18,8,6,2,14,29,8,0,0,2023-2024,90.0,92.6470588235294,99.26470588235294
1893,Carlos Neva,ESP,DF,Granada,La Liga,27,1996,35.0,32,21,22,9,1,17,40,42.5,23,39,14,25,30,62,108,2,0,2023-2024,90.0,77.14285714285714,82.28571428571428
1894,Jessic Ngankam,GER,"FW,MF",Mainz 05,Bundesliga,23,2000,2.0,1,1,0,1,0,0,0,0.0,0,3,1,2,3,4,0,0,0,2023-2024,90.0,135.0,45.0
1895,Jessic Ngankam,GER,FW,Eint Frankfurt,Bundesliga,23,2000,3.1,3,2,1,1,1,0,0,0.0,0,0,0,0,0,3,1,0,0,2023-2024,90.0,0.0,87.09677419354838
1896,Cyril Ngonge,BEL,"FW,MF",Hellas Verona,Serie A,23,2000,15.9,14,9,5,3,6,5,14,35.7,9,7,1,6,4,18,10,0,0,2023-2024,90.0,22.641509433962263,79.24528301886792
1897,Cyril Ngonge,BEL,FW,Napoli,Serie A,23,2000,3.5,5,3,1,4,0,2,2,100.0,0,2,0,2,0,5,2,0,0,2023-2024,90.0,0.0,128.57142857142856
1898,Steve Ngoura,FRA,"FW,MF",Le Havre,Ligue 1,18,2005,2.5,2,1,1,1,0,1,4,25.0,3,0,0,0,0,2,3,0,0,2023-2024,90.0,0.0,72.0
1899,Moussa Niakhate,SEN,DF,Nott'ham Forest,Premier League,27,1996,16.2,42,25,33,9,0,20,25,80.0,5,19,12,7,14,56,51,0,0,2023-2024,90.0,77.77777777777779,233.33333333333334
1900,M'Baye Niang,SEN,FW,Empoli,Serie A,28,1994,7.9,3,1,0,1,2,0,6,0.0,6,7,1,6,3,6,10,0,0,2023-2024,90.0,34.177215189873415,34.177215189873415
Rk,Player,Nation,Pos,Squad,Comp,0,0,90.0,0,0,3,3,3,Tkl,0,0.0,0,0,0,0,0,0,0,0,0,2023-2024,90.0,0.0,0.0
1901,Tanguy Nianzou,FRA,DF,Sevilla,La Liga,21,2002,3.5,12,8,9,2,1,8,11,72.7,3,2,0,2,3,15,9,1,0,2023-2024,90.0,77.14285714285714,308.57142857142856
1902,Shamar Nicholson,JAM,FW,Clermont Foot,Ligue 1,26,1997,16.5,6,2,0,4,2,1,4,25.0,3,6,2,4,0,6,15,0,0,2023-2024,90.0,0.0,32.72727272727273
1903,Rasmus Nicolaisen,DEN,DF,Toulouse,Ligue 1,26,1997,32.5,50,30,39,11,0,26,44,59.1,18,44,33,11,42,92,158,1,0,2023-2024,90.0,116.3076923076923,138.46153846153845
1904,Moritz Nicolas,GER,GK,Gladbach,Bundesliga,25,1997,27.0,1,0,1,0,0,1,3,33.3,2,0,0,0,0,1,12,5,0,2023-2024,90.0,0.0,3.3333333333333335
1905,Hans Nicolussi Caviglia,ITA,MF,Juventus,Serie A,23,2000,3.0,5,2,1,3,1,4,6,66.7,2,5,1,4,0,5,2,0,0,2023-2024,90.0,0.0,150.0
1906,Saúl Ñíguez,ESP,MF,Atlético Madrid,La Liga,28,1994,15.3,64,39,29,29,6,30,49,61.2,19,36,9,27,14,78,56,0,0,2023-2024,90.0,82.35294117647058,376.4705882352941
1907,Justin Njinmah,GER,FW,Werder Bremen,Bundesliga,22,2000,11.3,5,1,2,2,1,3,9,33.3,6,9,1,8,2,7,6,0,0,2023-2024,90.0,15.929203539823009,39.823008849557525
1908,Eddie Nketiah,ENG,FW,Arsenal,Premier League,24,1999,12.0,12,7,2,6,4,2,7,28.6,5,11,0,11,4,16,4,0,0,2023-2024,90.0,30.0,90.0
1909,Niels Nkounkou,FRA,"DF,MF",Eint Frankfurt,Bundesliga,22,2000,14.5,54,30,34,17,3,29,64,45.3,35,30,2,28,16,70,30,0,0,2023-2024,90.0,99.3103448275862,335.17241379310343
1910,Christopher Nkunku,FRA,"FW,MF",Chelsea,Premier League,25,1997,4.9,5,4,0,4,1,1,2,50.0,1,4,1,3,2,7,4,0,0,2023-2024,90.0,36.73469387755102,91.83673469387755
1911,Felix Nmecha,GER,MF,Dortmund,Bundesliga,22,2000,11.3,19,13,7,8,4,11,22,50.0,11,18,5,13,11,30,19,0,0,2023-2024,90.0,87.61061946902655,151.32743362831857
1912,Lukas Nmecha,GER,FW,Wolfsburg,Bundesliga,24,1998,0.5,1,1,0,0,1,0,0,0.0,0,1,0,1,0,1,0,0,0,2023-2024,90.0,0.0,180.0
1913,Peru Nolaskoain,ESP,"DF,MF",Athletic Club,La Liga,24,1998,0.1,1,1,1,0,0,1,1,100.0,0,0,0,0,0,1,1,0,0,2023-2024,90.0,0.0,900.0
1914,Joseph Nonge,BEL,MF,Juventus,Serie A,18,2005,0.3,0,0,0,0,0,0,0,0.0,0,0,0,0,0,0,1,0,0,2023-2024,90.0,0.0,0.0
1915,Jonathan Norbye,NOR,MF,RB Leipzig,Bundesliga,16,2007,0.0,0,0,0,0,0,0,0,0.0,0,0,0,0,0,0,0,0,0,2023-2024,,,
1916,Arnaud Nordin,FRA,"FW,MF",Montpellier,Ligue 1,25,1998,13.8,12,6,3,5,4,6,16,37.5,10,11,0,11,2,14,10,0,0,2023-2024,90.0,13.043478260869565,78.26086956521738
1917,Rhys Norrington-Davies,WAL,DF,Sheffield Utd,Premier League,24,1999,1.2,1,1,1,0,0,0,1,0.0,1,2,0,2,1,2,2,0,0,2023-2024,90.0,75.0,75.0
1918,Oliver Norwood,NIR,MF,Sheffield Utd,Premier League,32,1991,16.0,41,26,18,18,5,20,47,42.6,27,24,9,15,21,62,39,0,0,2023-2024,90.0,118.125,230.625
1919,Tijjani Noslin,NED,"FW,MF",Hellas Verona,Serie A,24,1999,14.9,18,8,5,7,6,6,16,37.5,10,17,2,15,2,20,14,0,0,2023-2024,90.0,12.080536912751677,108.72483221476509
1920,Randy Nteka,ANG,"FW,MF",Rayo Vallecano,La Liga,25,1997,6.4,11,4,1,6,4,4,10,40.0,6,6,1,5,2,13,11,1,0,2023-2024,90.0,28.125,154.6875
1921,Ernest Nuamah,GHA,"FW,MF",Lyon,Ligue 1,19,2003,20.4,28,14,18,6,4,12,38,31.6,26,15,1,14,8,36,9,0,0,2023-2024,90.0,35.294117647058826,123.52941176470588
1922,Alexander Nübel,GER,GK,Stuttgart,Bundesliga,26,1996,30.0,2,2,2,0,0,2,4,50.0,2,0,0,0,0,2,13,4,0,2023-2024,90.0,0.0,6.0
1923,Kasim Nuhu,GHA,DF,Hoffenheim,Bundesliga,28,1995,0.1,0,0,0,0,0,0,0,0.0,0,0,0,0,0,0,0,0,0,2023-2024,90.0,0.0,0.0
1924,Matheus Nunes,POR,MF,Wolves,Premier League,24,1998,2.0,3,1,3,0,0,2,6,33.3,4,0,0,0,6,9,1,0,0,2023-2024,90.0,270.0,135.0
1925,Matheus Nunes,POR,MF,Manchester City,Premier League,24,1998,7.3,10,4,1,7,2,5,16,31.3,11,7,1,6,1,11,8,1,0,2023-2024,90.0,12.328767123287673,123.28767123287672
Rk,Player,Nation,Pos,Squad,Comp,0,0,90.0,0,0,3,3,3,Tkl,0,0.0,0,0,0,0,0,0,0,0,0,2023-2024,90.0,0.0,0.0
1926,Darwin Núñez,URU,FW,Liverpool,Premier League,24,1999,22.7,22,12,2,10,10,11,23,47.8,12,18,6,12,3,25,9,0,0,2023-2024,89.99999999999999,11.894273127753303,87.22466960352422
1927,Unai Núñez,ESP,DF,Celta Vigo,La Liga,26,1997,31.1,51,28,30,19,2,23,49,46.9,26,38,24,14,52,103,153,3,0,2023-2024,90.0,150.4823151125402,147.58842443729904
1928,Fabian Nürnberger,GER,"DF,MF",Darmstadt 98,Bundesliga,24,1999,16.8,29,22,22,6,1,22,41,53.7,19,11,1,10,17,46,26,0,0,2023-2024,90.0,91.07142857142857,155.35714285714286
1929,Ethan Nwaneri,ENG,FW,Arsenal,Premier League,16,2007,0.2,0,0,0,0,0,0,0,0.0,0,1,0,1,0,0,0,0,0,2023-2024,90.0,0.0,0.0
1930,Simeon Nwankwo,NGA,FW,Salernitana,Serie A,31,1992,7.6,6,3,0,2,4,1,3,33.3,2,7,0,7,0,6,4,0,0,2023-2024,90.0,0.0,71.05263157894737
1931,Gerzino Nyamsi,FRA,DF,Strasbourg,Ligue 1,26,1997,12.1,18,14,13,5,0,12,18,66.7,6,19,11,8,10,28,43,0,0,2023-2024,90.0,74.3801652892562,133.88429752066116
1932,Ørjan Nyland,NOR,GK,Sevilla,La Liga,32,1990,24.0,0,0,0,0,0,0,1,0.0,1,0,0,0,0,0,9,1,0,2023-2024,90.0,0.0,0.0
1933,Rabby Nzingoula,CGO,"MF,FW",Strasbourg,Ligue 1,17,2005,1.5,3,3,0,3,0,3,4,75.0,1,4,0,4,5,8,0,0,0,2023-2024,90.0,300.0,180.0
1934,M'Bala Nzola,ANG,FW,Fiorentina,Serie A,26,1996,17.2,11,8,1,4,6,6,7,85.7,1,10,1,9,0,11,22,0,0,2023-2024,90.0,0.0,57.55813953488373
1935,Christian Nørgaard,DEN,MF,Brentford,Premier League,29,1994,27.8,81,50,42,31,8,32,87,36.8,55,48,6,42,54,135,50,0,0,2023-2024,90.0,174.8201438848921,262.23021582733816
1936,Jake O'Brien,IRL,DF,Lyon,Ligue 1,22,2001,26.3,22,16,16,5,1,14,20,70.0,6,23,18,5,12,34,98,1,0,2023-2024,90.0,41.06463878326996,75.2851711026616
1937,Mark O'Mahony,IRL,FW,Brighton,Premier League,18,2005,0.7,1,0,1,0,0,1,2,50.0,1,2,1,1,0,1,1,0,0,2023-2024,90.0,0.0,128.57142857142858
1938,Dara O'Shea,IRL,DF,Burnley,Premier League,24,1999,32.1,39,20,22,14,3,11,26,42.3,15,41,30,11,35,74,158,2,0,2023-2024,90.0,98.13084112149532,109.34579439252336
1939,Michael Obafemi,IRL,"FW,MF",Burnley,Premier League,23,2000,0.2,0,0,0,0,0,0,0,0.0,0,1,0,1,0,0,0,0,0,2023-2024,90.0,0.0,0.0
1940,Adam Obert,SVK,DF,Cagliari,Serie A,20,2002,10.5,17,9,8,8,1,8,17,47.1,9,13,7,6,21,38,41,1,0,2023-2024,90.0,180.0,145.71428571428572
1941,Pedro Obiang,EQG,MF,Sassuolo,Serie A,31,1992,5.0,8,4,3,4,1,2,10,20.0,8,6,4,2,8,16,10,0,0,2023-2024,90.0,144.0,144.0
1942,Jan Oblak,SVN,GK,Atlético Madrid,La Liga,30,1993,38.0,0,0,0,0,0,0,0,0.0,0,0,0,0,0,0,10,0,0,2023-2024,90.0,0.0,0.0
1943,Brian Ocampo,URU,"MF,FW",Cádiz,La Liga,24,1999,2.8,4,3,1,3,0,2,5,40.0,3,4,0,4,3,7,0,0,0,2023-2024,90.0,96.42857142857143,128.57142857142858
1944,Lucas Ocampos,ARG,"FW,MF",Sevilla,La Liga,29,1994,31.9,66,47,22,27,17,29,58,50.0,29,34,1,33,21,87,29,0,0,2023-2024,90.0,59.24764890282132,186.20689655172413
1945,Guillermo Ochoa,MEX,GK,Salernitana,Serie A,38,1985,21.0,0,0,0,0,0,0,1,0.0,1,0,0,0,0,0,9,1,0,2023-2024,90.0,0.0,0.0
1946,Jens Odgaard,DEN,"FW,MF",Bologna,Serie A,24,1999,4.8,4,4,1,1,2,1,3,33.3,2,9,0,9,1,5,3,0,0,2023-2024,90.0,18.75,75.0
1947,Wilson Odobert,FRA,"MF,FW",Burnley,Premier League,18,2004,23.3,17,13,8,5,4,6,22,27.3,16,26,2,24,6,23,14,0,0,2023-2024,90.0,23.175965665236053,65.66523605150215
1948,Álvaro Odriozola,ESP,DF,Real Sociedad,La Liga,27,1995,4.4,9,7,7,1,1,5,5,100.0,0,2,1,1,8,17,7,0,0,2023-2024,90.0,163.63636363636363,184.0909090909091
1949,Tim Oermann,GER,DF,Bochum,Bundesliga,19,2003,7.9,19,11,11,4,4,9,14,64.3,5,15,6,9,2,21,22,0,0,2023-2024,90.0,22.784810126582276,216.4556962025316
1950,Odeluga Offiah,ENG,DF,Brighton,Premier League,20,2002,1.4,1,0,1,0,0,1,1,100.0,0,0,0,0,1,2,0,0,0,2023-2024,90.0,64.28571428571429,64.28571428571429
Rk,Player,Nation,Pos,Squad,Comp,0,0,90.0,0,0,3,3,3,Tkl,0,0.0,0,0,0,0,0,0,0,0,0,2023-2024,90.0,0.0,0.0
1951,Chiedozie Ogbene,IRL,"MF,DF",Luton Town,Premier League,26,1997,22.2,17,10,10,7,0,12,22,54.5,10,14,3,11,7,24,34,2,0,2023-2024,90.0,28.378378378378383,68.91891891891892
1952,Angelo Ogbonna,ITA,DF,West Ham,Premier League,35,1988,7.1,11,5,9,2,0,6,7,85.7,1,13,10,3,3,14,29,0,0,2023-2024,90.0,38.02816901408451,139.43661971830986
1953,Florent Ogier,FRA,DF,Clermont Foot,Ligue 1,34,1989,10.5,19,9,13,6,0,11,18,61.1,7,25,19,6,9,28,35,3,0,2023-2024,90.0,77.14285714285714,162.85714285714286
1954,Noah Okafor,SUI,"FW,MF",Milan,Serie A,23,2000,9.9,6,4,1,4,1,3,10,30.0,7,8,1,7,0,6,10,0,0,2023-2024,90.0,0.0,54.54545454545455
1955,David Okereke,NGA,"FW,MF",Torino,Serie A,25,1997,2.8,3,1,1,1,1,0,3,0.0,3,2,0,2,1,4,0,0,0,2023-2024,90.0,32.142857142857146,96.42857142857143
1956,Caleb Okoli,ITA,DF,Frosinone,Serie A,22,2001,32.4,56,34,33,22,1,29,44,65.9,15,48,32,16,29,85,156,4,0,2023-2024,90.0,80.55555555555556,155.55555555555557
1957,Maduka Okoye,NGA,GK,Udinese,Serie A,23,1999,21.0,0,0,0,0,0,0,0,0.0,0,0,0,0,1,1,4,2,0,2023-2024,90.0,4.285714285714286,0.0
1958,Masaya Okugawa,JPN,"FW,DF",Augsburg,Bundesliga,27,1996,0.4,0,0,0,0,0,0,0,0.0,0,0,0,0,0,0,2,0,0,2023-2024,90.0,0.0,0.0
1959,Joseph Okumu,KEN,DF,Reims,Ligue 1,26,1997,19.4,44,28,28,14,2,24,38,63.2,14,27,19,8,35,79,112,2,0,2023-2024,90.0,162.37113402061857,204.1237113402062
1960,Aingeru Olabarrieta,ESP,FW,Athletic Club,La Liga,17,2005,0.1,0,0,0,0,0,0,0,0.0,0,0,0,0,0,0,0,0,0,2023-2024,90.0,0.0,0.0
1961,Michael Olakigbe,ENG,"DF,FW",Brentford,Premier League,19,2004,0.7,3,0,2,1,0,2,4,50.0,2,7,0,7,1,4,0,1,0,2023-2024,90.0,128.57142857142858,385.7142857142857
1962,Olasagasti,ESP,MF,Real Sociedad,La Liga,22,2000,4.0,16,13,4,7,5,5,8,62.5,3,2,0,2,3,19,5,1,0,2023-2024,90.0,67.5,360.0
1963,Finn Ole Becker,GER,MF,Hoffenheim,Bundesliga,23,2000,6.7,10,9,8,2,0,4,17,23.5,13,9,1,8,1,11,10,0,0,2023-2024,90.0,13.432835820895521,134.32835820895522
1964,Mathias Olesen,LUX,"MF,FW",Köln,Bundesliga,22,2001,1.2,0,0,0,0,0,0,0,0.0,0,0,0,0,2,2,2,0,0,2023-2024,90.0,150.0,0.0
1965,Michael Olise,FRA,"FW,MF",Crystal Palace,Premier League,21,2001,14.2,19,10,7,10,2,8,24,33.3,16,21,0,21,11,30,9,0,0,2023-2024,90.0,69.71830985915493,120.42253521126761
1966,Mathías Olivera,URU,DF,Napoli,Serie A,25,1997,17.4,50,29,29,15,6,23,39,59.0,16,35,6,29,20,70,25,0,0,2023-2024,90.0,103.44827586206897,258.62068965517244
1967,Dani Olmo,ESP,MF,RB Leipzig,Bundesliga,25,1998,16.1,26,18,14,8,4,10,22,45.5,12,7,0,7,13,39,12,1,0,2023-2024,90.0,72.67080745341615,145.3416149068323
1968,Robin Olsen,SWE,GK,Aston Villa,Premier League,33,1990,4.5,0,0,0,0,0,0,0,0.0,0,0,0,0,0,0,1,0,0,2023-2024,90.0,0.0,0.0
1969,Warmed Omari,FRA,DF,Rennes,Ligue 1,23,2000,23.0,32,19,23,7,2,16,28,57.1,12,30,20,10,33,65,77,2,0,2023-2024,90.0,129.13043478260872,125.21739130434784
1970,Becir Omeragic,SUI,"DF,MF",Montpellier,Ligue 1,21,2002,25.7,48,29,31,13,4,20,33,60.6,13,51,29,22,27,75,65,0,0,2023-2024,90.0,94.55252918287937,168.09338521400778
1971,Jonas Omlin,SUI,GK,Gladbach,Bundesliga,29,1994,7.0,1,0,1,0,0,1,1,100.0,0,0,0,0,0,1,3,0,0,2023-2024,90.0,0.0,12.857142857142858
1972,Andrew Omobamidele,IRL,DF,Nott'ham Forest,Premier League,21,2002,8.7,10,3,9,1,0,5,8,62.5,3,12,8,4,13,23,42,1,0,2023-2024,90.0,134.48275862068965,103.44827586206897
1973,Samu Omorodion,ESP,FW,Alavés,La Liga,19,2004,21.3,6,3,1,4,1,0,4,0.0,4,11,2,9,1,7,14,0,0,2023-2024,90.0,4.225352112676056,25.35211267605634
1974,Samu Omorodion,ESP,FW,Granada,La Liga,19,2004,0.9,1,1,0,1,0,1,1,100.0,0,0,0,0,0,1,0,0,0,2023-2024,90.0,0.0,100.0
1975,Amadou Onana,BEL,MF,Everton,Premier League,21,2001,23.2,71,38,32,31,8,21,42,50.0,21,25,6,19,21,92,31,0,0,2023-2024,90.0,81.46551724137932,275.4310344827586
Rk,Player,Nation,Pos,Squad,Comp,0,0,90.0,0,0,3,3,3,Tkl,0,0.0,0,0,0,0,0,0,0,0,0,2023-2024,90.0,0.0,0.0
1976,André Onana,CMR,GK,Manchester Utd,Premier League,27,1996,38.0,2,0,2,0,0,2,2,100.0,0,0,0,0,0,2,11,2,0,2023-2024,90.0,0.0,4.7368421052631575
1977,Jean Onana,CMR,MF,Marseille,Ligue 1,23,2000,6.3,23,14,6,14,3,13,25,52.0,12,10,2,8,11,34,11,1,0,2023-2024,90.0,157.14285714285717,328.5714285714286
1978,Ryan One,SCO,FW,Sheffield Utd,Premier League,17,2006,0.1,0,0,0,0,0,0,0,0.0,0,0,0,0,0,0,0,0,0,2023-2024,90.0,0.0,0.0
1979,Karim Onisiwo,AUT,"FW,MF",Mainz 05,Bundesliga,31,1992,16.6,17,8,4,6,7,6,11,54.5,5,18,4,14,2,19,7,0,0,2023-2024,90.0,10.843373493975902,92.16867469879517
1980,Tyler Onyango,ENG,MF,Everton,Premier League,20,2003,0.0,0,0,0,0,0,0,0,0.0,0,0,0,0,0,0,0,0,0,2023-2024,,,
1981,Fred Onyedinma,ENG,"DF,MF",Luton Town,Premier League,26,1996,4.5,10,6,7,3,0,5,12,41.7,7,3,0,3,1,11,13,0,0,2023-2024,90.0,20.0,200.0
1982,Frank Onyeka,NGA,MF,Brentford,Premier League,25,1998,12.9,37,24,9,23,5,16,29,55.2,13,15,7,8,23,60,17,0,0,2023-2024,90.0,160.46511627906975,258.1395348837209
1983,Loïs Openda,BEL,FW,RB Leipzig,Bundesliga,23,2000,30.0,3,3,0,1,2,0,6,0.0,6,19,3,16,5,8,14,0,0,2023-2024,90.0,15.0,9.0
1984,Royce Openda Owaga,GAB,FW,Lorient,Ligue 1,21,2002,0.2,0,0,0,0,0,0,0,0.0,0,0,0,0,0,0,0,0,0,2023-2024,90.0,0.0,0.0
1985,Christopher Operi,CIV,DF,Le Havre,Ligue 1,26,1997,27.2,55,36,37,15,3,32,59,54.2,27,45,7,38,35,90,68,1,0,2023-2024,90.0,115.80882352941177,181.98529411764704
1986,Leon Opitz,GER,"FW,DF",Werder Bremen,Bundesliga,18,2005,0.2,2,2,1,1,0,2,3,66.7,1,0,0,0,0,2,0,0,0,2023-2024,90.0,0.0,900.0
1987,Gift Orban,NGA,FW,Lyon,Ligue 1,21,2002,5.3,4,3,0,1,3,1,4,25.0,3,2,0,2,1,5,2,1,0,2023-2024,90.0,16.9811320754717,67.9245283018868
1988,Willi Orban,HUN,DF,RB Leipzig,Bundesliga,30,1992,17.6,20,12,8,10,2,9,18,50.0,9,22,13,9,16,36,76,1,0,2023-2024,90.0,81.81818181818181,102.27272727272727
1989,Ivan Ordets,UKR,DF,Bochum,Bundesliga,31,1992,20.9,19,14,11,6,2,10,17,58.8,7,41,29,12,31,50,130,0,0,2023-2024,90.0,133.4928229665072,81.81818181818181
1990,Divock Origi,BEL,FW,Nott'ham Forest,Premier League,28,1995,6.7,6,4,5,0,1,0,0,0.0,0,6,0,6,2,8,4,0,0,2023-2024,90.0,26.865671641791042,80.59701492537313
1991,Gaetano Oristanio,ITA,"FW,MF",Cagliari,Serie A,20,2002,12.3,20,10,5,14,1,5,17,29.4,12,11,0,11,9,29,8,0,0,2023-2024,89.99999999999999,65.85365853658536,146.34146341463412
1992,Aimar Oroz,ESP,MF,Osasuna,La Liga,21,2001,26.0,43,26,18,20,5,13,37,35.1,24,27,2,25,16,59,11,0,0,2023-2024,90.00000000000001,55.38461538461539,148.84615384615387
1993,Riccardo Orsolini,ITA,"FW,MF",Bologna,Serie A,26,1997,19.9,23,14,13,4,6,9,30,30.0,21,25,3,22,8,31,19,1,0,2023-2024,90.0,36.18090452261307,104.02010050251258
1994,Stefan Ortega,GER,GK,Manchester City,Premier League,30,1992,7.1,0,0,0,0,0,0,0,0.0,0,0,0,0,0,0,2,1,0,2023-2024,90.0,0.0,0.0
1995,Eneko Ortiz,ESP,DF,Alavés,La Liga,20,2003,0.2,0,0,0,0,0,0,0,0.0,0,0,0,0,0,0,0,0,0,2023-2024,90.0,0.0,0.0
1996,Asier Osambela,ESP,MF,Osasuna,La Liga,19,2004,0.1,2,1,0,1,1,0,0,0.0,0,0,0,0,0,2,0,0,0,2023-2024,90.0,0.0,1800.0
1997,Ben Osborn,ENG,"DF,MF",Sheffield Utd,Premier League,28,1994,15.2,22,9,11,9,2,8,17,47.1,9,18,2,16,8,30,30,0,0,2023-2024,90.0,47.368421052631575,130.26315789473685
1998,Gabriel Osho,NGA,DF,Luton Town,Premier League,24,1998,20.5,41,22,21,19,1,16,27,59.3,11,37,20,17,31,72,92,0,0,2023-2024,90.0,136.09756097560975,180.0
1999,Victor Osimhen,NGA,FW,Napoli,Serie A,24,1998,22.0,9,5,0,4,5,2,4,50.0,2,5,1,4,2,11,18,0,0,2023-2024,90.0,8.181818181818182,36.81818181818182
2000,Milutin Osmajić,MNE,MF,Cádiz,La Liga,24,1999,0.1,0,0,0,0,0,0,0,0.0,0,0,0,0,0,0,0,0,0,2023-2024,90.0,0.0,0.0
Rk,Player,Nation,Pos,Squad,Comp,0,0,90.0,0,0,3,3,3,Tkl,0,0.0,0,0,0,0,0,0,0,0,0,2023-2024,90.0,0.0,0.0
2001,Patrick Osterhage,GER,MF,Bochum,Bundesliga,23,2000,20.7,38,26,14,23,1,17,36,47.2,19,36,9,27,27,65,32,1,0,2023-2024,90.0,117.3913043478261,165.21739130434784
2002,William Osula,DEN,FW,Sheffield Utd,Premier League,19,2003,8.7,2,2,1,0,1,1,2,50.0,1,3,1,2,2,4,9,0,0,2023-2024,90.0,20.689655172413794,20.689655172413794
2003,Dango Ouattara,BFA,"FW,DF",Bournemouth,Premier League,21,2002,13.7,45,27,22,11,12,19,34,55.9,15,18,3,15,22,67,35,0,0,2023-2024,90.0,144.52554744525548,295.6204379562044
2004,Kassoum Ouattara,FRA,"DF,FW",Monaco,Ligue 1,18,2004,7.1,17,12,8,5,4,9,20,45.0,11,11,0,11,13,30,20,0,0,2023-2024,90.0,164.7887323943662,215.49295774647888
2005,Remi Oudin,FRA,"MF,FW",Lecce,Serie A,26,1996,20.2,26,14,12,12,2,12,19,63.2,7,13,1,12,20,46,22,0,0,2023-2024,90.0,89.10891089108911,115.84158415841584
2006,Alexandre Oukidja,ALG,GK,Metz,Ligue 1,35,1988,33.2,2,1,2,0,0,1,2,50.0,1,1,0,1,3,5,24,3,0,2023-2024,90.0,8.132530120481928,5.421686746987951
2007,Azzedine Ounahi,MAR,MF,Marseille,Ligue 1,23,2000,13.4,25,11,9,14,2,11,32,34.4,21,6,1,5,11,36,8,0,0,2023-2024,90.0,73.88059701492537,167.910447761194
2008,Adam Ounas,ALG,FW,Lille,Ligue 1,26,1996,4.6,4,3,2,2,0,2,7,28.6,5,2,0,2,6,10,1,0,0,2023-2024,90.0,117.3913043478261,78.26086956521739
2009,Patrick Ouotro,CIV,FW,Strasbourg,Ligue 1,17,2005,0.1,0,0,0,0,0,0,0,0.0,0,0,0,0,0,0,0,0,0,2023-2024,90.0,0.0,0.0
2010,Aiham Ousou,SYR,DF,Cádiz,La Liga,23,2000,4.8,8,5,6,2,0,5,5,100.0,0,1,0,1,7,15,15,0,0,2023-2024,90.0,131.25,150.0
2011,Jesús Owono,EQG,GK,Alavés,La Liga,22,2001,4.0,0,0,0,0,0,0,0,0.0,0,0,0,0,0,0,3,0,0,2023-2024,90.0,0.0,0.0
2012,Mikel Oyarzabal,ESP,"FW,MF",Real Sociedad,La Liga,26,1997,24.0,23,18,7,11,5,7,21,33.3,14,25,4,21,4,27,12,0,0,2023-2024,90.0,15.0,86.25
2013,Anthony Oyono,GAB,DF,Frosinone,Serie A,22,2001,13.3,37,26,21,14,2,23,34,67.6,11,17,3,14,9,46,32,0,0,2023-2024,90.0,60.90225563909774,250.37593984962405
2014,Salih Özcan,TUR,MF,Dortmund,Bundesliga,25,1998,13.2,20,12,11,8,1,10,18,55.6,8,28,3,25,17,37,18,1,0,2023-2024,90.0,115.9090909090909,136.36363636363637
2015,Cenk Özkacar,TUR,DF,Valencia,La Liga,22,2000,17.8,26,15,22,4,0,15,23,65.2,8,18,7,11,18,44,84,1,0,2023-2024,90.0,91.01123595505618,131.46067415730337
2016,David Ozoh,ENG,"MF,DF",Crystal Palace,Premier League,18,2005,1.7,10,6,3,6,1,5,6,83.3,1,2,0,2,0,10,2,0,0,2023-2024,90.0,0.0,529.4117647058823
2017,Jon Pacheco,ESP,DF,Real Sociedad,La Liga,22,2001,17.0,25,15,21,4,0,14,22,63.6,8,17,6,11,10,35,53,1,0,2023-2024,90.0,52.94117647058824,132.35294117647058
2018,Willian Pacho,ECU,DF,Eint Frankfurt,Bundesliga,21,2001,33.0,62,37,38,23,1,31,53,58.5,22,51,22,29,47,109,152,2,0,2023-2024,90.0,128.1818181818182,169.0909090909091
2019,Gonçalo Paciência,POR,"FW,MF",Bochum,Bundesliga,28,1994,7.2,8,4,2,2,4,3,6,50.0,3,5,0,5,0,8,7,0,0,2023-2024,90.0,0.0,100.0
2020,Simone Pafundi,ITA,MF,Udinese,Serie A,17,2006,0.1,0,0,0,0,0,0,0,0.0,0,0,0,0,0,0,0,0,0,2023-2024,90.0,0.0,0.0
2021,Riccardo Pagano,ITA,"MF,DF",Roma,Serie A,18,2004,0.6,2,2,1,1,0,0,6,0.0,6,3,2,1,0,2,2,0,0,2023-2024,90.0,0.0,300.0
2022,Pablo Pagis,FRA,MF,Lorient,Ligue 1,20,2002,1.8,10,6,5,4,1,6,10,60.0,4,2,0,2,3,13,1,0,0,2023-2024,90.0,150.0,500.0
2023,Exequiel Palacios,ARG,MF,Leverkusen,Bundesliga,24,1998,20.3,60,34,28,26,6,26,53,49.1,27,24,0,24,29,89,20,2,0,2023-2024,90.0,128.57142857142856,266.00985221674875
2024,Isaac Palazón Camacho,ESP,"MF,FW",Rayo Vallecano,La Liga,28,1994,31.0,46,25,16,21,9,20,58,34.5,38,29,2,27,16,62,41,0,0,2023-2024,90.0,46.45161290322581,133.5483870967742
2025,João Palhinha,POR,MF,Fulham,Premier League,28,1995,30.0,152,75,80,60,12,103,152,67.8,49,57,9,48,46,198,58,0,0,2023-2024,90.0,138.0,456.0
Rk,Player,Nation,Pos,Squad,Comp,0,0,90.0,0,0,3,3,3,Tkl,0,0.0,0,0,0,0,0,0,0,0,0,2023-2024,90.0,0.0,0.0
2026,Nicolas Pallois,FRA,DF,Nantes,Ligue 1,35,1987,17.7,34,19,21,11,2,19,35,54.3,16,37,26,11,26,60,111,0,0,2023-2024,90.0,132.20338983050848,172.8813559322034
2027,Cole Palmer,ENG,"FW,MF",Chelsea,Premier League,21,2002,29.0,23,12,9,6,8,8,19,42.1,11,20,2,18,20,43,13,2,0,2023-2024,90.0,62.068965517241374,71.37931034482759
2028,Cole Palmer,ENG,MF,Manchester City,Premier League,21,2002,0.1,0,0,0,0,0,0,0,0.0,0,0,0,0,0,0,0,0,0,2023-2024,90.0,0.0,0.0
2029,Emerson Palmieri,ITA,DF,West Ham,Premier League,28,1994,34.9,106,68,48,42,16,57,90,63.3,33,47,15,32,43,149,96,0,0,2023-2024,90.0,110.88825214899714,273.352435530086
2030,Joaquín Panichelli,ARG,"FW,MF",Alavés,La Liga,20,2002,2.5,3,3,1,1,1,1,2,50.0,1,1,0,1,1,4,4,0,0,2023-2024,90.0,36.0,108.0
2031,Miloš Pantović,SRB,MF,Union Berlin,Bundesliga,27,1996,0.2,0,0,0,0,0,0,0,0.0,0,0,0,0,0,0,0,0,0,2023-2024,90.0,0.0,0.0
2032,Antonios Papadopoulos,GER,DF,Dortmund,Bundesliga,23,1999,1.3,6,3,6,0,0,6,7,85.7,1,3,2,1,2,8,7,0,0,2023-2024,90.0,138.46153846153845,415.38461538461536
2033,Christos Papadopoulos,GRE,FW,Genoa,Serie A,18,2004,0.0,0,0,0,0,0,0,1,0.0,1,0,0,0,0,0,0,0,0,2023-2024,,,
2034,Sokratis Papastathopoulos,GRE,DF,Betis,La Liga,35,1988,12.6,21,14,16,5,0,13,17,76.5,4,15,9,6,6,27,60,0,0,2023-2024,90.0,42.85714285714286,150.00000000000003
2035,Merveille Papela,GER,"MF,DF",Mainz 05,Bundesliga,22,2001,2.9,5,4,2,3,0,0,4,0.0,4,1,0,1,4,9,2,0,0,2023-2024,90.0,124.13793103448276,155.17241379310346
2036,Leart Paqarada,KVX,DF,Köln,Bundesliga,28,1994,11.9,21,11,9,9,3,11,22,50.0,11,17,5,12,10,31,30,1,0,2023-2024,90.00000000000001,75.63025210084034,158.82352941176472
2037,Lucas Paquetá,BRA,"FW,MF",West Ham,Premier League,25,1997,29.1,71,48,38,26,7,25,52,48.1,27,28,1,27,21,92,28,2,0,2023-2024,90.0,64.94845360824742,219.58762886597935
2038,Victor Parada,ESP,"FW,MF",Alavés,La Liga,21,2002,0.0,1,1,0,1,0,1,1,100.0,0,0,0,0,0,1,0,0,0,2023-2024,,,inf
2039,Aitor Paredes,ESP,DF,Athletic Club,La Liga,23,2000,30.0,20,11,11,9,0,7,14,50.0,7,23,11,12,33,53,104,0,0,2023-2024,90.0,99.0,60.0
2040,Kevin Paredes,USA,"FW,MF",Wolfsburg,Bundesliga,20,2003,15.9,42,21,22,13,7,20,34,58.8,14,27,2,25,23,65,26,0,0,2023-2024,90.0,130.18867924528303,237.73584905660377
2041,Leandro Paredes,ARG,MF,Roma,Serie A,29,1994,29.3,57,36,30,22,5,33,77,42.9,44,26,7,19,29,86,43,1,0,2023-2024,90.0,89.07849829351537,175.08532423208192
2042,Daniel Parejo,ESP,MF,Villarreal,La Liga,34,1989,28.7,43,30,16,21,6,20,46,43.5,26,25,9,16,21,64,29,3,0,2023-2024,90.0,65.85365853658537,134.8432055749129
2043,Fabiano Parisi,ITA,DF,Fiorentina,Serie A,22,2000,16.2,30,15,11,12,7,15,26,57.7,11,21,5,16,17,47,26,0,0,2023-2024,90.0,94.44444444444444,166.66666666666669
2044,Ben Parkinson,ENG,FW,Newcastle Utd,Premier League,18,2005,0.3,0,0,0,0,0,0,0,0.0,0,1,0,1,0,0,1,0,0,2023-2024,90.0,0.0,0.0
2045,Thomas Partey,GHA,"MF,DF",Arsenal,Premier League,30,1993,8.8,14,11,9,4,1,5,10,50.0,5,9,3,6,11,25,9,0,0,2023-2024,90.0,112.5,143.1818181818182
2046,Mario Pašalić,CRO,MF,Atalanta,Serie A,28,1995,22.8,28,17,9,18,1,14,31,45.2,17,29,6,23,16,44,34,0,0,2023-2024,90.0,63.1578947368421,110.52631578947367
2047,Triantafyllos Pasaridīs,GRE,DF,Salernitana,Serie A,27,1996,5.0,11,7,9,2,0,9,14,64.3,5,7,3,4,3,14,19,0,0,2023-2024,90.0,54.0,198.0
2048,Pascu,ESP,FW,Villarreal,La Liga,20,2003,0.2,0,0,0,0,0,0,0,0.0,0,0,0,0,0,0,0,0,0,2023-2024,90.0,0.0,0.0
2049,Felix Passlack,GER,DF,Bochum,Bundesliga,25,1998,10.7,21,14,9,10,2,14,24,58.3,10,13,2,11,10,31,21,0,0,2023-2024,90.0,84.11214953271029,176.6355140186916
2050,Patric,ESP,DF,Lazio,Serie A,30,1993,17.9,13,8,10,3,0,8,18,44.4,10,15,9,6,6,19,44,0,0,2023-2024,90.0,30.167597765363134,65.36312849162012
Rk,Player,Nation,Pos,Squad,Comp,0,0,90.0,0,0,3,3,3,Tkl,0,0.0,0,0,0,0,0,0,0,0,0,2023-2024,90.0,0.0,0.0
2051,Rui Patrício,POR,GK,Roma,Serie A,35,1988,23.0,0,0,0,0,0,0,1,0.0,1,1,0,1,0,0,3,1,0,2023-2024,90.0,0.0,0.0
2052,Nathan Patterson,SCO,DF,Everton,Premier League,21,2001,11.2,34,24,21,11,2,14,37,37.8,23,14,3,11,9,43,33,0,0,2023-2024,90.0,72.32142857142857,273.2142857142857
2053,Gabriel Paulista,BRA,DF,Atlético Madrid,La Liga,32,1990,4.5,7,5,4,3,0,3,4,75.0,1,5,3,2,4,11,27,0,0,2023-2024,90.0,80.0,140.0
2054,Gabriel Paulista,BRA,DF,Valencia,La Liga,32,1990,15.5,10,7,8,2,0,6,11,54.5,5,15,7,8,24,34,78,0,0,2023-2024,90.0,139.3548387096774,58.064516129032256
2055,Benjamin Pavard,FRA,DF,Inter,Serie A,27,1996,18.6,34,21,21,11,2,20,24,83.3,4,25,15,10,32,66,44,1,0,2023-2024,90.0,154.83870967741933,164.51612903225805
2056,Jiří Pavlenka,CZE,GK,Werder Bremen,Bundesliga,31,1992,7.0,0,0,0,0,0,0,0,0.0,0,0,0,0,0,0,2,0,0,2023-2024,90.0,0.0,0.0
2057,Aleksandar Pavlovic,GER,MF,Bayern Munich,Bundesliga,19,2004,13.6,28,16,10,14,4,17,33,51.5,16,13,3,10,17,45,12,0,0,2023-2024,90.0,112.5,185.2941176470588
2058,Leonardo Pavoletti,ITA,FW,Cagliari,Serie A,34,1988,7.0,1,1,0,0,1,0,1,0.0,1,2,1,1,0,1,7,0,0,2023-2024,90.0,0.0,12.857142857142858
2059,Martín Payero,ARG,MF,Udinese,Serie A,24,1998,20.0,54,32,28,19,7,19,46,41.3,27,25,7,18,15,69,21,0,0,2023-2024,90.0,67.5,243.0
2060,Nicolás Paz,ARG,"MF,FW",Real Madrid,La Liga,18,2004,0.3,0,0,0,0,0,0,0,0.0,0,2,0,2,1,1,0,0,0,2023-2024,90.0,300.0,0.0
2061,Myles Peart-Harris,ENG,"DF,MF",Brentford,Premier League,20,2002,0.1,0,0,0,0,0,0,0,0.0,0,0,0,0,0,0,1,0,0,2023-2024,90.0,0.0,0.0
2062,Sydie Peck,ENG,MF,Sheffield Utd,Premier League,18,2004,0.1,0,0,0,0,0,0,0,0.0,0,0,0,0,0,0,0,0,0,2023-2024,90.0,0.0,0.0
2063,Mads Pedersen,DEN,DF,Augsburg,Bundesliga,26,1996,19.8,64,39,31,27,6,24,44,54.5,20,20,3,17,19,83,46,0,0,2023-2024,90.0,86.36363636363636,290.90909090909093
2064,Marcus Pedersen,NOR,DF,Sassuolo,Serie A,23,2000,17.9,36,24,25,5,6,21,25,84.0,4,19,5,14,10,46,51,0,0,2023-2024,90.0,50.27932960893855,181.0055865921788
2065,Alfonso Pedraza,ESP,DF,Villarreal,La Liga,27,1996,12.4,25,9,18,5,2,9,17,52.9,8,16,7,9,13,38,19,0,0,2023-2024,90.0,94.35483870967742,181.4516129032258
2066,Pedri,ESP,"MF,FW",Barcelona,La Liga,20,2002,16.4,33,24,16,13,4,8,27,29.6,19,27,3,24,14,47,10,0,0,2023-2024,90.0,76.82926829268294,181.09756097560978
2067,Pedro,ESP,"FW,MF",Lazio,Serie A,36,1987,9.1,16,12,5,7,4,3,12,25.0,9,16,2,14,3,19,1,0,0,2023-2024,90.0,29.67032967032967,158.24175824175825
2068,Adrià Pedrosa,ESP,DF,Sevilla,La Liga,25,1998,19.5,46,26,28,14,4,23,34,67.6,11,26,6,20,15,61,54,0,0,2023-2024,90.0,69.23076923076923,212.3076923076923
2069,Jordan Pefok,USA,FW,Gladbach,Bundesliga,27,1996,15.8,10,4,0,8,2,3,8,37.5,5,12,3,9,5,15,28,0,0,2023-2024,90.0,28.481012658227844,56.96202531645569
2070,Jordan Pefok,USA,FW,Union Berlin,Bundesliga,27,1996,0.3,0,0,0,0,0,0,0,0.0,0,1,1,0,0,0,0,0,0,2023-2024,90.0,0.0,0.0
2071,Dženan Pejčinović,GER,FW,Wolfsburg,Bundesliga,18,2005,0.4,0,0,0,0,0,0,0,0.0,0,1,0,1,0,0,0,0,0,2023-2024,90.0,0.0,0.0
2072,Pietro Pellegri,ITA,FW,Torino,Serie A,22,2001,8.4,5,1,1,4,0,1,5,20.0,4,4,1,3,2,7,3,0,0,2023-2024,90.0,21.428571428571427,53.57142857142857
2073,Lorenzo Pellegrini,ITA,MF,Roma,Serie A,27,1996,20.7,35,20,14,16,5,17,51,33.3,34,28,5,23,20,55,22,0,0,2023-2024,90.0,86.95652173913044,152.17391304347828
2074,Luca Pellegrini,ITA,DF,Lazio,Serie A,24,1999,8.7,18,13,7,10,1,9,17,52.9,8,7,3,4,9,27,20,0,0,2023-2024,90.0,93.10344827586206,186.20689655172413
2075,Marco Pellegrino,,DF,Salernitana,Serie A,0,0,6.1,8,6,4,3,1,5,10,50.0,5,11,6,5,10,18,28,0,0,2023-2024,90.0,147.5409836065574,118.03278688524591
Rk,Player,Nation,Pos,Squad,Comp,0,0,90.0,0,0,3,3,3,Tkl,0,0.0,0,0,0,0,0,0,0,0,0,2023-2024,90.0,0.0,0.0
2076,Marco Pellegrino,,DF,Milan,Serie A,0,0,0.8,1,1,0,0,1,0,2,0.0,2,1,1,0,1,2,2,0,0,2023-2024,90.0,112.5,112.5
2077,Facundo Pellistri,URU,"FW,MF",Manchester Utd,Premier League,21,2001,1.9,5,3,4,1,0,1,3,33.3,2,7,1,6,1,6,5,0,0,2023-2024,90.0,47.368421052631575,236.8421052631579
2078,Facundo Pellistri,URU,"MF,FW",Granada,La Liga,21,2001,13.7,29,19,12,10,7,6,21,28.6,15,18,0,18,4,33,7,0,0,2023-2024,90.0,26.277372262773724,190.5109489051095
2079,Andy Pelmard,FRA,DF,Clermont Foot,Ligue 1,23,2000,33.2,51,38,41,9,1,32,40,80.0,8,37,20,17,33,84,99,2,0,2023-2024,90.0,89.4578313253012,138.25301204819274
2080,Aurélien Pelon,FRA,DF,Lorient,Ligue 1,19,2004,1.0,1,0,1,0,0,0,2,0.0,2,2,2,0,0,1,7,0,0,2023-2024,90.0,0.0,90.0
2081,Faris Pemi Moumbagna,CMR,FW,Marseille,Ligue 1,23,2000,6.1,2,1,0,2,0,0,3,0.0,3,4,0,4,3,5,1,0,0,2023-2024,90.0,44.26229508196722,29.508196721311478
2082,Iñaki Peña,ESP,GK,Barcelona,La Liga,24,1999,10.0,0,0,0,0,0,0,1,0.0,1,0,0,0,0,0,5,1,0,2023-2024,90.0,0.0,0.0
2083,Marcos Peña,ESP,MF,Almería,La Liga,18,2005,4.9,19,14,12,7,0,6,12,50.0,6,9,3,6,13,32,8,0,0,2023-2024,90.0,238.77551020408163,348.9795918367347
2084,Rubén Peña,ESP,"DF,FW",Osasuna,La Liga,32,1991,23.2,47,25,22,18,7,20,49,40.8,29,37,8,29,30,77,39,3,0,2023-2024,90.0,116.37931034482759,182.32758620689657
2085,Pepín,EQG,"MF,FW",Monza,Serie A,26,1996,2.7,6,1,1,4,1,2,4,50.0,2,5,2,3,0,6,6,0,0,2023-2024,90.0,0.0,199.99999999999997
2086,Alberto Perea,ESP,"MF,FW",Granada,La Liga,32,1990,0.0,0,0,0,0,0,0,2,0.0,2,0,0,0,0,0,0,0,0,2023-2024,,,
2087,Andreas Pereira,BRA,MF,Fulham,Premier League,27,1996,29.0,25,12,4,12,9,11,41,26.8,30,16,2,14,4,29,12,0,0,2023-2024,90.0,12.413793103448276,77.58620689655172
2088,Danilo Pereira,POR,DF,Paris S-G,Ligue 1,31,1991,22.2,22,12,14,6,2,9,17,52.9,8,29,26,3,23,45,100,1,0,2023-2024,90.0,93.24324324324326,89.1891891891892
2089,Mathias Pereira Lage,POR,"FW,MF",Brest,Ligue 1,26,1996,13.2,21,15,7,8,6,7,28,25.0,21,14,5,9,10,31,13,0,0,2023-2024,90.0,68.18181818181819,143.1818181818182
2090,Pedro Pereira,POR,DF,Monza,Serie A,25,1998,9.3,19,13,14,4,1,9,17,52.9,8,15,2,13,4,23,18,0,0,2023-2024,90.0,38.70967741935483,183.87096774193546
2091,Daniel Peretz,ISR,GK,Bayern Munich,Bundesliga,23,2000,0.2,0,0,0,0,0,0,0,0.0,0,0,0,0,0,0,0,0,0,2023-2024,90.0,0.0,0.0
2092,Roberto Pereyra,ARG,"FW,MF",Udinese,Serie A,32,1991,20.6,19,9,11,5,3,11,29,37.9,18,20,4,16,7,26,18,0,0,2023-2024,90.0,30.582524271844658,83.00970873786407
2093,Ayoze Pérez,ESP,FW,Betis,La Liga,30,1993,25.5,59,32,16,33,10,21,49,42.9,28,42,4,38,22,81,18,0,0,2023-2024,90.0,77.64705882352942,208.23529411764707
2094,Carles Pérez,ESP,"MF,DF",Celta Vigo,La Liga,25,1998,8.6,13,5,6,5,2,7,18,38.9,11,14,1,13,5,18,8,0,0,2023-2024,90.0,52.32558139534884,136.046511627907
2095,Francisco Perez,ESP,"MF,FW",Valencia,La Liga,20,2002,22.8,30,17,10,14,6,15,44,34.1,29,19,0,19,14,44,5,0,0,2023-2024,90.0,55.263157894736835,118.42105263157893
2096,Kike Pérez,ESP,"MF,FW",Rayo Vallecano,La Liga,26,1997,9.3,27,11,11,15,1,11,23,47.8,12,11,0,11,8,35,6,0,0,2023-2024,90.0,77.41935483870967,261.2903225806451
2097,Nehuén Pérez,ARG,DF,Udinese,Serie A,23,2000,36.0,72,48,42,28,2,39,48,81.3,9,53,26,27,45,117,158,1,0,2023-2024,90.0,112.5,180.0
2098,Matteo Perez Vinlöf,SWE,FW,Bayern Munich,Bundesliga,17,2005,0.2,0,0,0,0,0,0,0,0.0,0,0,0,0,1,1,0,0,0,2023-2024,90.0,450.0,0.0
2099,Simone Perilli,ITA,GK,Hellas Verona,Serie A,28,1995,1.0,0,0,0,0,0,0,0,0.0,0,0,0,0,0,0,0,0,0,2023-2024,90.0,0.0,0.0
2100,Mattia Perin,ITA,GK,Juventus,Serie A,30,1992,2.5,0,0,0,0,0,0,0,0.0,0,0,0,0,0,0,1,0,0,2023-2024,90.0,0.0,0.0
Rk,Player,Nation,Pos,Squad,Comp,0,0,90.0,0,0,3,3,3,Tkl,0,0.0,0,0,0,0,0,0,0,0,0,2023-2024,90.0,0.0,0.0
2101,Samuele Perisan,ITA,GK,Empoli,Serie A,25,1997,1.0,0,0,0,0,0,0,0,0.0,0,0,0,0,0,0,0,0,0,2023-2024,90.0,0.0,0.0
2102,Ivan Perišić,CRO,FW,Tottenham,Premier League,34,1989,1.1,3,2,1,1,1,3,5,60.0,2,1,0,1,2,5,1,0,0,2023-2024,90.0,163.63636363636363,245.45454545454544
2103,Romain Perraud,FRA,"DF,FW",Nice,Ligue 1,25,1997,4.1,7,6,5,1,1,4,11,36.4,7,4,0,4,6,13,15,1,0,2023-2024,90.0,131.70731707317074,153.65853658536588
2104,Lucas Perrin,FRA,DF,Strasbourg,Ligue 1,24,1998,30.3,47,30,33,14,0,28,46,60.9,18,45,32,13,28,75,113,0,0,2023-2024,90.0,83.16831683168317,139.6039603960396
2105,Máximo Perrone,ARG,MF,Las Palmas,La Liga,20,2003,18.0,42,21,17,22,3,19,39,48.7,20,27,4,23,24,66,21,0,0,2023-2024,90.0,120.0,210.0
2106,Pavao Pervan,AUT,GK,Wolfsburg,Bundesliga,35,1987,9.0,0,0,0,0,0,0,0,0.0,0,0,0,0,0,0,4,0,0,2023-2024,90.0,0.0,0.0
2107,Matteo Pessina,ITA,MF,Monza,Serie A,26,1997,35.8,44,25,20,20,4,23,49,46.9,26,29,11,18,27,71,46,1,0,2023-2024,90.0,67.87709497206704,110.61452513966482
2108,Andrea Petagna,ITA,FW,Cagliari,Serie A,28,1995,11.1,4,2,1,0,3,1,2,50.0,1,6,3,3,1,5,4,0,0,2023-2024,90.0,8.108108108108109,32.432432432432435
2109,Denis Petrić,SRB,GK,Nantes,Ligue 1,35,1988,0.3,0,0,0,0,0,0,0,0.0,0,0,0,0,0,0,0,0,0,2023-2024,90.0,0.0,0.0
2110,Njegoš Petrović,SRB,"MF,FW",Granada,La Liga,24,1999,1.7,5,2,4,1,0,2,3,66.7,1,2,0,2,1,6,3,0,0,2023-2024,90.0,52.94117647058823,264.70588235294116
2111,Đorđe Petrović,SRB,GK,Chelsea,Premier League,23,1999,22.1,0,0,0,0,0,0,0,0.0,0,0,0,0,0,0,12,3,0,2023-2024,90.0,0.0,0.0
2112,Jens Petter Hauge,NOR,"MF,FW",Eint Frankfurt,Bundesliga,23,1999,1.6,2,1,1,0,1,2,7,28.6,5,5,1,4,0,2,1,0,0,2023-2024,90.0,0.0,112.5
2113,Germán Pezzella,ARG,DF,Betis,La Liga,32,1991,30.7,34,24,24,10,0,23,38,60.5,15,31,18,13,31,65,150,0,0,2023-2024,90.0,90.87947882736157,99.6742671009772
2114,Giuseppe Pezzella,ITA,DF,Empoli,Serie A,25,1997,12.1,25,14,19,5,1,20,28,71.4,8,17,6,11,2,27,35,0,0,2023-2024,90.0,14.87603305785124,185.9504132231405
2115,Luca Pfeiffer,GER,"FW,MF",Darmstadt 98,Bundesliga,26,1996,18.0,11,6,2,6,3,5,11,45.5,6,5,1,4,2,13,21,0,0,2023-2024,90.0,10.0,55.0
2116,Patric Pfeiffer,GER,DF,Augsburg,Bundesliga,23,1999,5.7,11,7,6,4,1,5,6,83.3,1,10,6,4,11,22,21,0,0,2023-2024,90.0,173.68421052631578,173.68421052631578
2117,Maximilian Philipp,GER,"FW,MF",Freiburg,Bundesliga,29,1994,3.6,8,5,4,4,0,1,6,16.7,5,7,0,7,1,9,3,0,0,2023-2024,90.0,25.0,200.0
2118,Kalvin Phillips,ENG,MF,West Ham,Premier League,27,1995,3.4,11,6,2,8,1,5,9,55.6,4,4,1,3,4,15,2,1,0,2023-2024,90.0,105.88235294117646,291.1764705882353
2119,Kalvin Phillips,ENG,MF,Manchester City,Premier League,27,1995,1.0,3,3,1,1,1,0,0,0.0,0,0,0,0,2,5,2,0,0,2023-2024,90.0,180.0,270.0
2120,Jaden Philogene Bidace,ENG,FW,Aston Villa,Premier League,21,2002,0.0,0,0,0,0,0,0,0,0.0,0,0,0,0,0,0,0,0,0,2023-2024,,,
2121,Kamil Piątkowski,POL,DF,Granada,La Liga,23,2000,5.6,18,10,16,1,1,10,14,71.4,4,6,5,1,8,26,28,1,0,2023-2024,90.0,128.57142857142858,289.2857142857143
2122,Roberto Piccoli,ITA,FW,Empoli,Serie A,22,2001,0.4,1,1,0,0,1,1,1,100.0,0,0,0,0,0,1,0,0,0,2023-2024,90.0,0.0,225.0
2123,Roberto Piccoli,ITA,FW,Lecce,Serie A,22,2001,15.3,10,6,3,5,2,1,4,25.0,3,17,1,16,4,14,16,0,0,2023-2024,90.0,23.52941176470588,58.8235294117647
2124,Florian Pick,GER,"MF,FW",Heidenheim,Bundesliga,27,1995,3.6,4,4,3,0,1,2,3,66.7,1,2,0,2,2,6,2,0,0,2023-2024,90.0,50.0,100.0
2125,Jordan Pickford,ENG,GK,Everton,Premier League,29,1994,38.0,1,0,1,0,0,1,1,100.0,0,3,0,3,0,1,19,1,0,2023-2024,90.0,0.0,2.3684210526315788
Rk,Player,Nation,Pos,Squad,Comp,0,0,90.0,0,0,3,3,3,Tkl,0,0.0,0,0,0,0,0,0,0,0,0,2023-2024,90.0,0.0,0.0
2126,Amos Pieper,GER,DF,Werder Bremen,Bundesliga,25,1998,6.6,14,11,8,6,0,7,13,53.8,6,12,7,5,9,23,36,1,0,2023-2024,90.0,122.72727272727273,190.9090909090909
2127,Marvin Pieringer,GER,"MF,FW",Heidenheim,Bundesliga,23,1999,16.8,19,12,5,11,3,8,20,40.0,12,28,4,24,12,31,21,0,0,2023-2024,90.0,64.28571428571428,101.78571428571428
2128,Santiago Pierotti,ARG,"MF,FW",Lecce,Serie A,22,2001,2.2,8,8,2,5,1,2,8,25.0,6,5,0,5,1,9,0,0,0,2023-2024,90.0,40.90909090909091,327.27272727272725
2129,Niccolò Pierozzi,ITA,DF,Salernitana,Serie A,21,2001,9.7,17,11,13,4,0,11,22,50.0,11,24,7,17,11,28,36,0,0,2023-2024,90.0,102.0618556701031,157.73195876288662
2130,Ronaël Pierre-Gabriel,FRA,DF,Nantes,Ligue 1,25,1998,6.6,15,9,12,2,1,5,7,71.4,2,13,4,9,8,23,25,0,0,2023-2024,90.0,109.0909090909091,204.54545454545453
2131,Andrea Pinamonti,ITA,FW,Sassuolo,Serie A,24,1999,34.2,13,8,1,6,6,5,22,22.7,17,19,2,17,1,14,40,0,0,2023-2024,90.0,2.6315789473684212,34.21052631578947
2132,Ethan Pinnock,JAM,DF,Brentford,Premier League,30,1993,28.0,35,23,22,13,0,9,20,45.0,11,40,24,16,43,78,170,3,0,2023-2024,90.0,138.21428571428572,112.5
2133,Yeremi Pino,ESP,"MF,FW",Villarreal,La Liga,20,2002,5.3,25,18,12,10,3,9,18,50.0,9,11,1,10,5,30,5,0,0,2023-2024,90.0,84.9056603773585,424.52830188679246
2134,Carlo Pinsoglio,ITA,GK,Juventus,Serie A,33,1990,0.5,0,0,0,0,0,0,0,0.0,0,0,0,0,0,0,0,0,0,2023-2024,90.0,0.0,0.0
2135,Lorenzo Pirola,ITA,DF,Salernitana,Serie A,21,2002,22.1,39,23,25,14,0,15,28,53.6,13,46,30,16,25,64,93,1,0,2023-2024,90.0,101.80995475113122,158.8235294117647
2136,Niccolò Pisilli,ITA,MF,Roma,Serie A,18,2004,0.1,0,0,0,0,0,0,0,0.0,0,0,0,0,0,0,0,0,0,2023-2024,90.0,0.0,0.0
2137,Alassane Pléa,FRA,"FW,MF",Gladbach,Bundesliga,30,1993,21.3,17,7,5,8,4,7,15,46.7,8,11,0,11,2,19,6,0,0,2023-2024,90.0,8.450704225352112,71.83098591549296
2138,Tommaso Pobega,ITA,MF,Milan,Serie A,24,1999,3.5,16,9,11,5,0,6,13,46.2,7,10,2,8,6,22,7,0,0,2023-2024,90.0,154.28571428571428,411.42857142857144
2139,Paul Pogba,FRA,MF,Juventus,Serie A,30,1993,0.6,1,1,0,1,0,1,1,100.0,0,0,0,0,1,2,1,0,0,2023-2024,90.0,150.0,150.0
2140,Ole Pohlmann,GER,MF,Dortmund,Bundesliga,22,2001,0.6,1,0,0,1,0,1,2,50.0,1,0,0,0,0,1,1,0,0,2023-2024,90.0,0.0,150.0
2141,Matteo Politano,ITA,FW,Napoli,Serie A,29,1993,26.2,19,8,8,7,4,11,34,32.4,23,9,1,8,15,34,11,1,0,2023-2024,90.0,51.526717557251914,65.2671755725191
2142,Sebastian Polter,GER,FW,Darmstadt 98,Bundesliga,32,1991,5.0,1,0,1,0,0,0,1,0.0,1,5,1,4,0,1,4,0,0,2023-2024,90.0,0.0,18.0
2143,Julien Ponceau,FRA,MF,Lorient,Ligue 1,22,2000,24.9,32,15,12,14,6,9,30,30.0,21,22,1,21,19,51,20,0,0,2023-2024,90.0,68.67469879518072,115.66265060240964
2144,Marin Pongračić,CRO,DF,Lecce,Serie A,25,1997,35.8,43,30,22,20,1,19,25,76.0,6,37,26,11,51,94,130,1,0,2023-2024,90.0,128.2122905027933,108.1005586592179
2145,Nick Pope,ENG,GK,Newcastle Utd,Premier League,31,1992,14.9,0,0,0,0,0,0,1,0.0,1,0,0,0,0,0,7,2,0,2023-2024,90.0,0.0,0.0
2146,Pedro Porro,ESP,DF,Tottenham,Premier League,23,1999,34.3,91,63,43,34,14,62,120,51.7,58,63,18,45,34,125,102,3,0,2023-2024,90.0,89.2128279883382,238.77551020408166
2147,Portu,ESP,FW,Getafe,La Liga,31,1992,1.1,5,3,4,0,1,5,6,83.3,1,0,0,0,0,5,0,0,0,2023-2024,90.0,0.0,409.09090909090907
2148,Portu,ESP,"MF,FW",Girona,La Liga,31,1992,13.2,18,13,3,10,5,3,18,16.7,15,9,1,8,4,22,6,0,0,2023-2024,90.0,27.272727272727273,122.72727272727273
2149,Stefan Posch,AUT,DF,Bologna,Serie A,26,1997,26.8,77,46,35,38,4,49,88,55.7,39,27,8,19,18,95,72,0,0,2023-2024,90.0,60.447761194029844,258.58208955223876
2150,Yussuf Poulsen,DEN,FW,RB Leipzig,Bundesliga,29,1994,13.5,13,8,1,9,3,4,14,28.6,10,13,3,10,4,17,15,0,0,2023-2024,90.0,26.666666666666668,86.66666666666667
Rk,Player,Nation,Pos,Squad,Comp,0,0,90.0,0,0,3,3,3,Tkl,0,0.0,0,0,0,0,0,0,0,0,0,2023-2024,90.0,0.0,0.0
2151,José Pozo,ESP,MF,Rayo Vallecano,La Liga,27,1996,0.2,1,1,0,1,0,1,1,100.0,0,1,0,1,0,1,0,0,0,2023-2024,90.0,0.0,450.0
2152,Alejandro Pozo Pozo,ESP,"DF,MF",Almería,La Liga,24,1999,10.8,19,12,11,6,2,12,20,60.0,8,14,4,10,7,26,21,0,0,2023-2024,90.0,58.33333333333333,158.33333333333331
2153,Beñat Prados,ESP,"MF,DF",Athletic Club,La Liga,22,2001,16.1,45,28,11,23,11,23,42,54.8,19,32,5,27,23,68,27,0,0,2023-2024,90.0,128.57142857142856,251.5527950310559
2154,Matteo Prati,ITA,MF,Cagliari,Serie A,19,2003,21.9,45,25,15,27,3,26,42,61.9,16,29,6,23,15,60,26,1,0,2023-2024,90.0,61.64383561643836,184.93150684931507
2155,Abdón Prats,ESP,"FW,MF",Mallorca,La Liga,30,1992,14.1,6,4,2,2,2,3,5,60.0,2,6,3,3,2,8,12,0,0,2023-2024,89.99999999999999,12.76595744680851,38.29787234042553
2156,Sanjin Prcić,BIH,MF,Strasbourg,Ligue 1,29,1993,1.0,0,0,0,0,0,0,1,0.0,1,2,1,1,3,3,1,0,0,2023-2024,90.0,270.0,0.0
2157,Grischa Prömel,GER,MF,Hoffenheim,Bundesliga,28,1995,23.8,32,18,11,15,6,14,32,43.8,18,22,6,16,22,54,36,0,0,2023-2024,90.00000000000001,83.19327731092437,121.00840336134455
2158,Ivan Provedel,ITA,GK,Lazio,Serie A,29,1994,30.0,1,0,1,0,0,1,3,33.3,2,0,0,0,0,1,12,1,0,2023-2024,90.0,0.0,3.0
2159,Marc Pubill,ESP,DF,Almería,La Liga,20,2003,20.9,47,23,35,8,4,22,39,56.4,17,20,8,12,15,62,83,1,0,2023-2024,90.0,64.5933014354067,202.39234449760767
2160,Gustavo Puerta,COL,"DF,MF",Leverkusen,Bundesliga,20,2003,0.5,5,3,2,2,1,1,2,50.0,1,2,0,2,0,5,0,0,0,2023-2024,90.0,0.0,900.0
2161,Antonio Puertas,ESP,"MF,FW",Granada,La Liga,31,1992,8.1,12,8,6,5,1,6,15,40.0,9,5,0,5,6,18,4,0,0,2023-2024,90.0,66.66666666666667,133.33333333333334
2162,Arnau Puigmal,ESP,"FW,DF",Almería,La Liga,22,2001,2.8,2,1,1,1,0,1,3,33.3,2,3,0,3,3,5,2,0,0,2023-2024,90.0,96.42857142857143,64.28571428571429
2163,Christian Pulisic,USA,"FW,MF",Milan,Serie A,24,1998,28.9,35,26,14,11,10,17,30,56.7,13,20,1,19,10,45,10,1,0,2023-2024,90.00000000000001,31.14186851211073,108.99653979238755
2164,George Pușcaș,ROU,FW,Genoa,Serie A,27,1996,2.1,0,0,0,0,0,0,3,0.0,3,1,0,1,0,0,1,0,0,2023-2024,90.0,0.0,0.0
2165,Jarell Quansah,ENG,DF,Liverpool,Premier League,20,2003,13.2,25,22,17,7,1,14,20,70.0,6,16,8,8,17,42,39,1,0,2023-2024,90.0,115.9090909090909,170.45454545454547
2166,Domingos Quina,POR,MF,Udinese,Serie A,23,1999,0.1,1,1,1,0,0,0,0,0.0,0,0,0,0,0,1,0,0,0,2023-2024,90.0,0.0,900.0
2167,Adrien Rabiot,FRA,MF,Juventus,Serie A,28,1995,29.5,58,39,22,30,6,30,45,66.7,15,26,6,20,25,83,34,0,0,2023-2024,90.0,76.27118644067797,176.94915254237287
2168,Uroš Račić,SRB,MF,Sassuolo,Serie A,25,1998,9.1,10,4,6,4,0,0,9,0.0,9,16,7,9,7,17,22,0,0,2023-2024,90.0,69.23076923076923,98.9010989010989
2169,Nemanja Radonjić,SRB,"MF,FW",Torino,Serie A,27,1996,4.2,1,1,0,0,1,1,3,33.3,2,3,0,3,0,1,0,0,0,2023-2024,90.0,0.0,21.428571428571427
2170,Nemanja Radonjić,SRB,"MF,DF",Mallorca,La Liga,27,1996,3.9,4,2,1,3,0,1,4,25.0,3,2,0,2,3,7,3,0,0,2023-2024,90.0,69.23076923076923,92.3076923076923
2171,Aleksandar Radovanović,SRB,DF,Almería,La Liga,29,1993,6.3,8,7,7,1,0,6,6,100.0,0,8,8,0,11,19,48,0,0,2023-2024,90.0,157.14285714285717,114.28571428571429
2172,Ionuț Radu,ROU,GK,Bournemouth,Premier League,26,1997,2.0,0,0,0,0,0,0,0,0.0,0,0,0,0,0,0,0,0,0,2023-2024,90.0,0.0,0.0
2173,Boris Radunović,SRB,GK,Cagliari,Serie A,27,1996,7.0,0,0,0,0,0,0,0,0.0,0,0,0,0,1,1,1,2,0,2023-2024,90.0,12.857142857142858,0.0
2174,Hamza Rafia,TUN,MF,Lecce,Serie A,24,1999,13.4,44,31,13,27,4,13,30,43.3,17,27,1,26,11,55,13,0,0,2023-2024,90.0,73.88059701492537,295.5223880597015
2175,Abdellah Raihani,MAR,FW,Atlético Madrid,La Liga,19,2004,0.1,0,0,0,0,0,0,1,0.0,1,0,0,0,0,0,0,0,0,2023-2024,90.0,0.0,0.0
Rk,Player,Nation,Pos,Squad,Comp,0,0,90.0,0,0,3,3,3,Tkl,0,0.0,0,0,0,0,0,0,0,0,0,2023-2024,90.0,0.0,0.0
2176,Antonio Raillo,ESP,DF,Mallorca,La Liga,31,1991,24.4,30,23,18,12,0,17,23,73.9,6,44,30,14,37,67,104,2,0,2023-2024,90.0,136.47540983606558,110.65573770491804
2177,Luca Raimund,GER,"FW,MF",Stuttgart,Bundesliga,18,2005,0.3,3,1,2,1,0,0,0,0.0,0,2,0,2,0,3,0,0,0,2023-2024,90.0,0.0,900.0000000000001
2178,Predrag Rajković,SRB,GK,Mallorca,La Liga,27,1995,36.0,2,1,2,0,0,2,2,100.0,0,0,0,0,0,2,14,0,0,2023-2024,90.0,0.0,5.0
2179,Jesurun Rak Sakyi,ENG,"MF,FW",Crystal Palace,Premier League,20,2002,1.5,4,1,3,1,0,2,3,66.7,1,2,0,2,3,7,1,0,0,2023-2024,90.0,180.0,240.0
2180,Ivan Rakitić,CRO,MF,Sevilla,La Liga,35,1988,15.8,30,16,9,12,9,11,19,57.9,8,16,5,11,14,44,12,0,0,2023-2024,90.0,79.74683544303797,170.88607594936707
2181,Ylber Ramadani,ALB,MF,Lecce,Serie A,27,1996,33.0,68,41,32,29,7,37,96,38.5,59,54,13,41,44,112,44,0,0,2023-2024,90.0,120.00000000000001,185.45454545454547
2182,Largie Ramazani,BEL,"FW,MF",Almería,La Liga,22,2001,17.3,12,7,5,6,1,6,26,23.1,20,16,2,14,34,46,10,0,0,2023-2024,90.0,176.878612716763,62.42774566473988
2183,Benito Ramírez,ESP,"FW,MF",Las Palmas,La Liga,28,1995,4.3,5,3,2,3,0,3,6,50.0,3,7,1,6,3,8,0,0,0,2023-2024,90.0,62.79069767441861,104.65116279069768
2184,Sandro Ramírez,ESP,FW,Las Palmas,La Liga,28,1995,20.1,12,8,4,6,2,6,15,40.0,9,13,1,12,4,16,14,1,0,2023-2024,90.0,17.91044776119403,53.731343283582085
2185,Chris Ramos,ESP,"FW,MF",Cádiz,La Liga,26,1997,29.0,28,15,9,15,4,8,27,29.6,19,23,7,16,9,37,44,0,0,2023-2024,90.0,27.93103448275862,86.89655172413792
2186,Gonçalo Ramos,POR,FW,Paris S-G,Ligue 1,22,2001,15.8,25,15,4,12,9,6,20,30.0,14,12,2,10,5,30,16,0,0,2023-2024,90.0,28.481012658227844,142.40506329113921
2187,Sergio Ramos,ESP,DF,Sevilla,La Liga,37,1986,28.0,45,30,32,11,2,27,40,67.5,13,35,30,5,41,86,156,0,0,2023-2024,90.0,131.78571428571428,144.64285714285714
2188,Aaron Ramsdale,ENG,GK,Arsenal,Premier League,25,1998,6.0,0,0,0,0,0,0,0,0.0,0,0,0,0,0,0,3,2,0,2023-2024,90.0,0.0,0.0
2189,Aaron Ramsey,ENG,"MF,FW",Burnley,Premier League,20,2003,5.9,17,14,7,5,5,8,16,50.0,8,11,2,9,1,18,10,0,0,2023-2024,90.0,15.254237288135592,259.32203389830505
2190,Jacob Ramsey,ENG,"FW,MF",Aston Villa,Premier League,22,2001,9.5,16,8,7,6,3,5,15,33.3,10,15,2,13,3,19,8,0,0,2023-2024,90.0,28.42105263157895,151.57894736842104
2191,Luca Ranieri,ITA,DF,Fiorentina,Serie A,24,1999,22.9,14,10,11,1,2,8,13,61.5,5,25,11,14,29,43,64,0,0,2023-2024,90.0,113.97379912663757,55.02183406113538
2192,Filippo Ranocchia,ITA,"MF,DF",Empoli,Serie A,22,2001,5.3,16,11,7,9,0,7,16,43.8,9,9,1,8,3,19,14,0,0,2023-2024,90.0,50.943396226415096,271.6981132075472
2193,Grant Ranos,ARM,"MF,FW",Gladbach,Bundesliga,20,2003,0.5,1,0,0,0,1,0,0,0.0,0,0,0,0,0,1,0,0,0,2023-2024,90.0,0.0,180.0
2194,Raphinha,BRA,"FW,MF",Barcelona,La Liga,26,1996,15.2,14,8,6,6,2,4,18,22.2,14,17,1,16,13,27,11,0,0,2023-2024,90.0,76.97368421052632,82.89473684210526
2195,Nicolai Rapp,GER,DF,Werder Bremen,Bundesliga,26,1996,0.8,3,2,2,1,0,2,2,100.0,0,2,0,2,2,5,8,0,0,2023-2024,90.0,225.0,337.5
2196,Elba Rashani,KVX,"MF,FW",Clermont Foot,Ligue 1,30,1993,13.1,30,18,4,17,9,11,24,45.8,13,17,3,14,12,42,15,0,0,2023-2024,90.0,82.44274809160305,206.10687022900765
2197,Marcus Rashford,ENG,FW,Manchester Utd,Premier League,25,1997,25.2,19,12,9,4,6,9,26,34.6,17,15,1,14,4,23,21,0,0,2023-2024,90.0,14.285714285714286,67.85714285714286
2198,Giacomo Raspadori,ITA,"FW,MF",Napoli,Serie A,23,2000,17.6,21,10,6,10,5,6,15,40.0,9,15,1,14,3,24,7,0,0,2023-2024,90.0,15.34090909090909,107.38636363636363
2199,Andrei Ratiu,ROU,"DF,MF",Rayo Vallecano,La Liga,25,1998,7.0,12,4,6,5,1,8,15,53.3,7,4,1,3,0,12,12,0,0,2023-2024,90.0,0.0,154.28571428571428
2200,Raúl,ESP,FW,Osasuna,La Liga,22,2000,15.1,10,4,4,2,4,2,10,20.0,8,9,1,8,5,15,11,0,0,2023-2024,90.0,29.80132450331126,59.60264900662252
Rk,Player,Nation,Pos,Squad,Comp,0,0,90.0,0,0,3,3,3,Tkl,0,0.0,0,0,0,0,0,0,0,0,0,2023-2024,90.0,0.0,0.0
2201,David Raum,GER,DF,RB Leipzig,Bundesliga,25,1998,30.4,58,35,24,29,5,34,58,58.6,24,51,9,42,27,85,82,2,0,2023-2024,90.0,79.93421052631578,171.71052631578948
2202,Federico Ravaglia,ITA,GK,Bologna,Serie A,23,1999,5.9,0,0,0,0,0,0,0,0.0,0,0,0,0,0,0,2,0,0,2023-2024,90.0,0.0,0.0
2203,David Raya,ESP,GK,Arsenal,Premier League,27,1995,32.0,1,1,1,0,0,1,1,100.0,0,0,0,0,0,1,8,5,0,2023-2024,90.0,0.0,2.8125
2204,Tim Ream,USA,DF,Fulham,Premier League,35,1987,16.7,20,9,13,5,2,9,18,50.0,9,23,15,8,25,45,61,2,0,2023-2024,90.0,134.7305389221557,107.78443113772455
2205,Abderrahman Rebbach,ALG,"FW,MF",Alavés,La Liga,24,1998,8.0,9,5,4,2,3,5,15,33.3,10,10,1,9,3,12,7,0,0,2023-2024,90.0,33.75,101.25
2206,Nathan Redmond,ENG,"FW,MF",Burnley,Premier League,29,1994,1.6,2,1,0,0,2,1,4,25.0,3,1,0,1,0,2,3,0,0,2023-2024,90.0,0.0,112.5
2207,Harrison Reed,ENG,MF,Fulham,Premier League,28,1995,14.7,29,18,9,17,3,13,31,41.9,18,19,9,10,11,40,24,0,0,2023-2024,90.0,67.34693877551021,177.55102040816328
2208,Sergio Reguilón,ESP,DF,Manchester Utd,Premier League,26,1996,4.6,13,8,6,2,5,8,17,47.1,9,10,0,10,5,18,7,0,0,2023-2024,90.0,97.82608695652175,254.34782608695653
2209,Sergio Reguilón,ESP,DF,Brentford,Premier League,26,1996,12.4,45,20,26,18,1,24,40,60.0,16,23,6,17,16,61,41,1,0,2023-2024,90.0,116.12903225806451,326.61290322580646
2210,Bobby Reid,JAM,FW,Fulham,Premier League,30,1993,15.8,22,14,5,15,2,4,16,25.0,12,24,2,22,5,27,14,0,0,2023-2024,90.0,28.481012658227844,125.31645569620251
2211,Tijjani Reijnders,NED,MF,Milan,Serie A,25,1998,31.3,46,25,10,31,5,21,43,48.8,22,26,8,18,18,64,26,0,0,2023-2024,90.0,51.757188498402556,132.26837060702874
2212,Pepe Reina,ESP,GK,Villarreal,La Liga,40,1982,2.0,0,0,0,0,0,0,0,0.0,0,0,0,0,0,0,1,0,0,2023-2024,90.0,0.0,0.0
2213,Reinier,BRA,"MF,FW",Frosinone,Serie A,21,2002,11.8,21,10,6,12,3,5,17,29.4,12,24,4,20,10,31,5,0,0,2023-2024,90.0,76.27118644067797,160.16949152542372
2214,Rocco Reitz,GER,MF,Gladbach,Bundesliga,21,2002,23.7,61,36,28,29,4,28,55,50.9,27,61,20,41,44,105,31,1,0,2023-2024,90.0,167.08860759493672,231.64556962025318
2215,Álex Remiro,ESP,GK,Real Sociedad,La Liga,28,1995,36.4,0,0,0,0,0,0,0,0.0,0,0,0,0,0,0,24,2,0,2023-2024,90.0,0.0,0.0
2216,Guillaume Restes,FRA,GK,Toulouse,Ligue 1,18,2005,34.0,0,0,0,0,0,0,3,0.0,3,0,0,0,0,0,19,1,0,2023-2024,90.0,0.0,0.0
2217,Mateo Retegui,ITA,FW,Genoa,Serie A,24,1999,24.6,17,9,7,8,2,6,20,30.0,14,18,2,16,0,17,30,0,0,2023-2024,89.99999999999999,0.0,62.195121951219505
2218,Marco Reus,GER,"MF,FW",Dortmund,Bundesliga,34,1989,17.8,37,25,20,14,3,12,27,44.4,15,17,2,15,5,42,18,0,0,2023-2024,90.0,25.280898876404496,187.07865168539325
2219,Elvis Rexhbeçaj,GER,MF,Augsburg,Bundesliga,25,1997,22.1,30,19,14,13,3,18,36,50.0,18,32,7,25,20,50,20,0,0,2023-2024,90.0,81.44796380090497,122.17194570135746
2220,Gio Reyna,USA,"FW,MF",Nott'ham Forest,Premier League,20,2002,2.6,7,3,4,0,3,3,6,50.0,3,3,0,3,2,9,0,0,0,2023-2024,90.0,69.23076923076923,242.3076923076923
2221,Gio Reyna,USA,"MF,FW",Dortmund,Bundesliga,20,2002,3.1,9,6,3,4,2,2,5,40.0,3,5,1,4,2,11,5,0,0,2023-2024,90.0,58.064516129032256,261.2903225806452
2222,Chadi Riad,MAR,DF,Betis,La Liga,20,2003,24.0,35,24,17,18,0,17,27,63.0,10,23,14,9,23,58,108,0,0,2023-2024,90.0,86.25,131.25
2223,Alexsandro Ribeiro,BRA,DF,Lille,Ligue 1,23,1999,24.7,32,22,24,8,0,16,31,51.6,15,25,15,10,35,67,116,5,0,2023-2024,90.0,127.53036437246963,116.59919028340082
2224,Rodrigo Ribeiro,POR,"MF,FW",Nott'ham Forest,Premier League,18,2005,0.2,0,0,0,0,0,0,1,0.0,1,1,0,1,1,1,0,0,0,2023-2024,90.0,450.0,0.0
2225,Samuele Ricci,ITA,MF,Torino,Serie A,21,2001,26.6,33,18,17,12,4,15,23,65.2,8,21,3,18,27,60,25,0,0,2023-2024,90.0,91.35338345864662,111.65413533834585
Rk,Player,Nation,Pos,Squad,Comp,0,0,90.0,0,0,3,3,3,Tkl,0,0.0,0,0,0,0,0,0,0,0,0,2023-2024,90.0,0.0,0.0
2226,Declan Rice,ENG,MF,Arsenal,Premier League,24,1999,35.8,83,51,37,38,8,32,57,56.1,25,37,11,26,44,127,52,0,0,2023-2024,90.0,110.61452513966482,208.659217877095
2227,Chris Richards,USA,"DF,MF",Crystal Palace,Premier League,23,2000,23.3,46,28,21,22,3,20,30,66.7,10,32,12,20,27,73,109,0,0,2023-2024,90.0,104.29184549356223,177.6824034334764
2228,Amir Richardson,MAR,MF,Reims,Ligue 1,21,2002,15.0,33,23,12,18,3,10,22,45.5,12,26,5,21,15,48,30,0,0,2023-2024,90.0,90.0,198.0
2229,Richarlison,BRA,FW,Tottenham,Premier League,26,1997,16.6,16,11,4,8,4,2,10,20.0,8,32,6,26,8,24,23,0,0,2023-2024,90.0,43.37349397590361,86.74698795180721
2230,Marco Richter,GER,"MF,FW",Mainz 05,Bundesliga,25,1997,8.0,10,4,5,3,2,4,11,36.4,7,9,0,9,2,12,1,0,0,2023-2024,90.0,22.5,112.5
2231,Diego Rico,ESP,DF,Getafe,La Liga,30,1993,28.2,64,48,32,23,9,41,76,53.9,35,25,8,17,41,105,76,0,0,2023-2024,89.99999999999999,130.85106382978722,204.25531914893617
2232,Clemens Riedel,GER,DF,Darmstadt 98,Bundesliga,20,2003,8.4,22,13,16,5,1,15,24,62.5,9,11,3,8,11,33,26,0,0,2023-2024,90.0,117.85714285714285,235.7142857142857
2233,Fabian Rieder,SUI,MF,Rennes,Ligue 1,21,2002,4.1,13,7,2,9,2,6,11,54.5,5,3,1,2,5,18,2,0,0,2023-2024,90.0,109.75609756097562,285.3658536585366
2234,Jaïro Riedewald,NED,"MF,FW",Crystal Palace,Premier League,26,1996,2.6,9,3,2,4,3,3,6,50.0,3,0,0,0,2,11,2,0,0,2023-2024,90.0,69.23076923076923,311.5384615384615
2235,Manuel Riemann,GER,GK,Bochum,Bundesliga,34,1988,33.0,2,1,2,0,0,2,4,50.0,2,0,0,0,1,3,25,1,0,2023-2024,90.0,2.7272727272727275,5.454545454545455
2236,Luis Rioja,ESP,"FW,MF",Alavés,La Liga,29,1993,27.8,27,19,10,12,5,14,43,32.6,29,28,1,27,16,43,28,0,0,2023-2024,90.0,51.79856115107914,87.41007194244605
2237,Rémy Riou,FRA,GK,Lyon,Ligue 1,35,1987,3.0,0,0,0,0,0,0,1,0.0,1,0,0,0,0,0,1,1,0,2023-2024,90.0,0.0,0.0
2238,Rodrigo Riquelme,ESP,"DF,MF",Atlético Madrid,La Liga,23,2000,17.0,30,19,18,4,8,18,46,39.1,28,19,0,19,9,39,20,0,0,2023-2024,90.0,47.64705882352941,158.8235294117647
2239,Alberto Risco,ESP,MF,Getafe,La Liga,17,2005,1.5,2,2,1,1,0,0,4,0.0,4,0,0,0,0,2,1,0,0,2023-2024,90.0,0.0,120.0
2240,Mihailo Ristić,SRB,"DF,MF",Celta Vigo,La Liga,27,1995,9.0,15,9,9,6,0,9,12,75.0,3,9,2,7,10,25,23,0,0,2023-2024,90.0,100.0,150.0
2241,Matt Ritchie,SCO,"FW,MF",Newcastle Utd,Premier League,33,1989,1.4,5,3,2,2,1,2,4,50.0,2,3,2,1,1,6,5,0,0,2023-2024,90.0,64.28571428571429,321.42857142857144
2242,Gorka Rivera Alonso,ESP,DF,Getafe,La Liga,18,2004,0.0,0,0,0,0,0,0,0,0.0,0,0,0,0,0,0,0,0,0,2023-2024,,,
2243,Sergi Roberto,ESP,"MF,DF",Barcelona,La Liga,31,1992,9.6,15,10,4,10,1,3,11,27.3,8,7,2,5,8,23,7,1,0,2023-2024,90.0,75.0,140.625
2244,Lucas Robertone,ARG,MF,Almería,La Liga,26,1997,26.5,61,33,28,23,10,25,50,50.0,25,43,9,34,51,112,43,0,0,2023-2024,90.0,173.2075471698113,207.16981132075472
2245,Connor Roberts,WAL,DF,Burnley,Premier League,27,1995,9.1,12,5,6,4,2,8,17,47.1,9,8,6,2,4,16,25,2,0,2023-2024,90.0,39.56043956043956,118.68131868131869
2246,Andrew Robertson,SCO,DF,Liverpool,Premier League,29,1994,18.8,35,24,21,11,3,26,43,60.5,17,20,6,14,13,48,40,0,0,2023-2024,90.0,62.234042553191486,167.5531914893617
2247,Antonee Robinson,USA,DF,Fulham,Premier League,25,1997,36.3,93,58,60,26,7,52,110,47.3,58,56,8,48,80,173,117,3,0,2023-2024,90.0,198.34710743801654,230.5785123966942
2248,Jack Robinson,ENG,DF,Sheffield Utd,Premier League,29,1993,32.1,43,28,29,14,0,25,39,64.1,14,49,33,16,33,76,132,2,0,2023-2024,90.0,92.5233644859813,120.5607476635514
2249,Marc Roca,ESP,MF,Betis,La Liga,26,1996,22.0,52,36,17,29,6,30,53,56.6,23,29,6,23,17,69,23,1,0,2023-2024,90.0,69.54545454545455,212.72727272727275
2250,Sebastian Rode,GER,MF,Eint Frankfurt,Bundesliga,32,1990,0.7,6,4,0,5,1,4,6,66.7,2,0,0,0,1,7,1,0,0,2023-2024,90.0,128.57142857142858,771.4285714285714
Rk,Player,Nation,Pos,Squad,Comp,0,0,90.0,0,0,3,3,3,Tkl,0,0.0,0,0,0,0,0,0,0,0,0,2023-2024,90.0,0.0,0.0
2251,Sergio Rodelas,ESP,"FW,DF",Granada,La Liga,18,2004,1.4,3,2,1,0,2,0,3,0.0,3,0,0,0,0,3,0,0,0,2023-2024,90.0,0.0,192.85714285714286
2252,Rodri,ESP,MF,Manchester City,Premier League,27,1996,32.6,70,43,25,33,12,29,60,48.3,31,32,8,24,26,96,41,4,0,2023-2024,90.0,71.77914110429448,193.25153374233128
2253,Rodri,ESP,"FW,MF",Betis,La Liga,23,2000,11.7,17,10,6,7,4,8,21,38.1,13,11,0,11,8,25,2,0,0,2023-2024,89.99999999999999,61.53846153846153,130.76923076923077
2254,Óscar Rodríguez Arnaiz,ESP,"MF,FW",Getafe,La Liga,25,1998,10.7,24,13,2,15,7,9,15,60.0,6,12,1,11,5,29,5,0,0,2023-2024,90.0,42.056074766355145,201.8691588785047
2255,Damián Rodríguez,ESP,MF,Celta Vigo,La Liga,20,2003,2.9,6,3,1,3,2,1,3,33.3,2,4,2,2,1,7,2,0,0,2023-2024,90.0,31.03448275862069,186.20689655172413
2256,Dani Rodríguez,ESP,MF,Mallorca,La Liga,35,1988,29.1,47,24,21,20,6,21,45,46.7,24,34,5,29,15,62,21,0,0,2023-2024,90.0,46.391752577319586,145.36082474226802
2257,Guido Rodríguez,ARG,MF,Betis,La Liga,29,1994,20.5,53,30,21,24,8,34,55,61.8,21,27,6,21,29,82,44,0,0,2023-2024,90.0,127.3170731707317,232.6829268292683
2258,Jay Rodriguez,ENG,FW,Burnley,Premier League,34,1989,9.1,14,9,7,4,3,7,13,53.8,6,11,1,10,1,15,8,0,0,2023-2024,90.0,9.89010989010989,138.46153846153845
2259,Kirian Rodríguez,ESP,MF,Las Palmas,La Liga,27,1996,35.7,52,32,22,25,5,24,67,35.8,43,39,3,36,28,80,23,1,0,2023-2024,90.0,70.58823529411764,131.0924369747899
2260,Miguel Rodríguez,ESP,MF,Celta Vigo,La Liga,20,2003,3.3,6,3,3,1,2,3,9,33.3,6,8,0,8,4,10,0,0,0,2023-2024,90.0,109.0909090909091,163.63636363636363
2261,Ricardo Rodríguez,SUI,DF,Torino,Serie A,30,1992,30.8,45,26,21,22,2,28,45,62.2,17,22,9,13,24,69,64,2,0,2023-2024,90.0,70.12987012987013,131.4935064935065
2262,Rodrygo,BRA,FW,Real Madrid,La Liga,22,2001,26.4,16,15,2,9,5,5,19,26.3,14,14,0,14,8,24,6,0,0,2023-2024,90.0,27.272727272727273,54.54545454545455
2263,Mads Roerslev,DEN,DF,Brentford,Premier League,24,1999,22.1,48,31,34,9,5,27,54,50.0,27,15,3,12,19,67,71,0,0,2023-2024,90.0,77.37556561085972,195.47511312217193
2264,Rogério,BRA,DF,Wolfsburg,Bundesliga,25,1998,10.1,14,6,7,5,2,10,14,71.4,4,16,5,11,5,19,23,1,0,2023-2024,90.0,44.554455445544555,124.75247524752476
2265,Morgan Rogers,ENG,"MF,FW",Aston Villa,Premier League,21,2002,7.1,8,1,3,2,3,2,11,18.2,9,11,0,11,3,11,11,0,0,2023-2024,90.0,38.02816901408451,101.40845070422536
2266,Merlin Röhl,GER,"MF,FW",Freiburg,Bundesliga,21,2002,16.4,21,13,10,9,2,8,21,38.1,13,27,3,24,9,30,22,0,0,2023-2024,90.0,49.39024390243903,115.24390243902441
2267,Alessio Romagnoli,ITA,DF,Lazio,Serie A,28,1995,26.8,25,18,14,11,0,16,24,66.7,8,29,17,12,29,54,115,0,0,2023-2024,90.0,97.38805970149252,83.955223880597
2268,Simone Romagnoli,ITA,DF,Frosinone,Serie A,33,1990,30.2,35,15,23,11,1,15,20,75.0,5,51,36,15,29,64,147,0,0,2023-2024,90.0,86.42384105960265,104.30463576158941
2269,Carlos Romero,ESP,DF,Villarreal,La Liga,21,2001,2.9,11,5,8,1,2,7,12,58.3,5,3,0,3,1,12,11,0,0,2023-2024,90.0,31.03448275862069,341.3793103448276
2270,Cristian Romero,ARG,DF,Tottenham,Premier League,25,1998,31.0,66,40,35,25,6,32,44,72.7,12,46,22,24,44,110,106,1,0,2023-2024,90.0,127.74193548387098,191.61290322580646
2271,Isaac Romero,ESP,FW,Sevilla,La Liga,23,2000,11.5,6,3,2,2,2,5,9,55.6,4,12,0,12,0,6,11,0,0,2023-2024,90.0,0.0,46.95652173913044
2272,Luka Romero,ARG,"FW,MF",Milan,Serie A,18,2004,1.0,0,0,0,0,0,0,3,0.0,3,2,0,2,0,0,0,0,0,2023-2024,90.0,0.0,0.0
2273,Luka Romero,ARG,FW,Almería,La Liga,18,2004,4.9,5,1,2,3,0,2,4,50.0,2,12,1,11,1,6,2,1,0,2023-2024,90.0,18.36734693877551,91.83673469387755
2274,Oriol Romeu,ESP,MF,Barcelona,La Liga,31,1991,10.4,34,20,17,14,3,13,24,54.2,11,12,2,10,10,44,18,0,0,2023-2024,90.0,86.53846153846153,294.2307692307692
2275,Valentin Rongier,FRA,MF,Marseille,Ligue 1,28,1994,9.5,23,12,9,12,2,14,26,53.8,12,16,4,12,15,38,18,0,0,2023-2024,90.0,142.10526315789474,217.89473684210526
Rk,Player,Nation,Pos,Squad,Comp,0,0,90.0,0,0,3,3,3,Tkl,0,0.0,0,0,0,0,0,0,0,0,0,2023-2024,90.0,0.0,0.0
2276,Frank Ronstadt,GER,"DF,MF",Darmstadt 98,Bundesliga,26,1997,0.8,1,0,0,1,0,0,1,0.0,1,1,0,1,1,2,3,0,0,2023-2024,90.0,112.5,112.5
2277,Marten de Roon,NED,"MF,DF",Atalanta,Serie A,32,1991,28.9,80,43,36,32,12,35,82,42.7,47,36,10,26,40,120,54,0,0,2023-2024,90.00000000000001,124.56747404844292,249.13494809688584
2278,Unai Ropero,ESP,MF,Alavés,La Liga,21,2001,0.1,0,0,0,0,0,0,0,0.0,0,0,0,0,0,0,0,0,0,2023-2024,90.0,0.0,0.0
2279,Vitor Roque,BRA,FW,Barcelona,La Liga,18,2005,3.6,3,2,2,0,1,0,2,0.0,2,3,0,3,0,3,5,0,0,2023-2024,90.0,0.0,75.0
2280,Pablo Rosario,NED,"MF,DF",Nice,Ligue 1,26,1997,22.3,36,25,15,16,5,23,34,67.6,11,27,13,14,29,65,39,0,0,2023-2024,90.0,117.04035874439461,145.29147982062779
2281,Valentin Rosier,FRA,"DF,MF",Nice,Ligue 1,26,1996,0.6,1,0,1,0,0,0,0,0.0,0,1,0,1,2,3,5,0,0,2023-2024,90.0,300.0,150.0
2282,Francesco Rossi,ITA,GK,Atalanta,Serie A,32,1991,0.1,0,0,0,0,0,0,0,0.0,0,0,0,0,0,0,0,0,0,2023-2024,90.0,0.0,0.0
2283,Joe Rothwell,ENG,MF,Bournemouth,Premier League,28,1995,4.3,7,2,4,2,1,2,8,25.0,6,4,2,2,3,10,2,0,0,2023-2024,90.0,62.79069767441861,146.51162790697677
2284,Anthony Rouault,FRA,DF,Stuttgart,Bundesliga,22,2001,11.2,21,12,14,5,2,13,21,61.9,8,14,8,6,8,29,28,0,0,2023-2024,90.0,64.28571428571429,168.75
2285,Jérôme Roussillon,FRA,DF,Union Berlin,Bundesliga,30,1993,8.4,16,9,6,7,3,8,12,66.7,4,13,4,9,5,21,26,0,0,2023-2024,90.0,53.57142857142857,171.42857142857142
2286,Nicolò Rovella,ITA,MF,Lazio,Serie A,21,2001,14.6,46,28,25,17,4,16,36,44.4,20,27,6,21,23,69,29,0,0,2023-2024,90.0,141.78082191780823,283.56164383561645
2287,Amir Rrahmani,KVX,DF,Napoli,Serie A,29,1994,28.9,33,27,17,14,2,16,32,50.0,16,24,10,14,20,53,90,0,0,2023-2024,90.00000000000001,62.28373702422146,102.7681660899654
2288,Ruan,BRA,DF,Sassuolo,Serie A,24,1999,16.8,25,15,11,10,4,10,18,55.6,8,18,15,3,24,49,68,2,0,2023-2024,90.0,128.57142857142856,133.92857142857142
2289,Pelly Ruddock Mpanzu,COD,MF,Luton Town,Premier League,30,1993,12.2,13,5,6,6,1,5,9,55.6,4,15,7,8,9,22,16,3,0,2023-2024,90.0,66.39344262295083,95.9016393442623
2290,Antonio Rüdiger,GER,DF,Real Madrid,La Liga,30,1993,30.1,26,15,18,4,4,16,20,80.0,4,27,20,7,11,37,89,0,0,2023-2024,90.00000000000001,32.89036544850499,77.74086378737542
2291,Fabian Rüdlin,GER,MF,Freiburg,Bundesliga,26,1997,0.1,1,0,0,0,1,0,0,0.0,0,0,0,0,0,1,0,0,0,2023-2024,90.0,0.0,900.0
2292,Javier Rueda Garcia,ESP,"MF,DF",Celta Vigo,La Liga,21,2002,0.2,0,0,0,0,0,0,0,0.0,0,0,0,0,0,0,0,0,0,2023-2024,90.0,0.0,0.0
2293,Daniele Rugani,ITA,DF,Juventus,Serie A,29,1994,13.2,11,9,7,3,1,4,5,80.0,1,11,4,7,9,20,42,0,0,2023-2024,90.0,61.36363636363637,75.0
2294,Matteo Ruggeri,ITA,DF,Atalanta,Serie A,21,2002,27.2,29,15,14,7,8,16,30,53.3,14,46,4,42,23,52,44,0,0,2023-2024,90.0,76.1029411764706,95.95588235294117
2295,Mário Rui,POR,DF,Napoli,Serie A,32,1991,13.4,27,15,17,5,5,14,21,66.7,7,17,2,15,15,42,19,0,0,2023-2024,90.0,100.74626865671641,181.34328358208953
2296,Aitor Ruibal,ESP,"DF,FW",Betis,La Liga,27,1996,11.3,46,27,28,13,5,32,59,54.2,27,12,1,11,14,60,33,1,0,2023-2024,90.0,111.50442477876106,366.3716814159292
2297,Fabián Ruiz Peña,ESP,MF,Paris S-G,Ligue 1,27,1996,13.3,34,23,17,14,3,23,42,54.8,19,8,2,6,11,45,21,2,0,2023-2024,90.0,74.4360902255639,230.0751879699248
2298,Sergio Ruiz,ESP,MF,Granada,La Liga,28,1994,27.7,83,46,43,36,4,38,84,45.2,46,24,6,18,28,111,43,1,0,2023-2024,90.0,90.97472924187726,269.6750902527076
2299,Julian Ryerson,NOR,DF,Dortmund,Bundesliga,25,1997,19.6,41,23,26,11,4,27,47,57.4,20,31,7,24,10,51,35,3,0,2023-2024,90.0,45.91836734693877,188.26530612244898
2300,Frederik Rønnow,DEN,GK,Union Berlin,Bundesliga,30,1992,33.0,1,1,1,0,0,0,0,0.0,0,0,0,0,1,2,20,2,0,2023-2024,90.0,2.7272727272727275,2.7272727272727275
Rk,Player,Nation,Pos,Squad,Comp,0,0,90.0,0,0,3,3,3,Tkl,0,0.0,0,0,0,0,0,0,0,0,0,2023-2024,90.0,0.0,0.0
2301,José Sá,POR,GK,Wolves,Premier League,30,1993,33.7,0,0,0,0,0,0,1,0.0,1,3,0,3,0,0,21,5,0,2023-2024,90.0,0.0,0.0
2302,Youssouf Sabaly,SEN,DF,Betis,La Liga,30,1993,11.6,16,11,12,3,1,8,12,66.7,4,6,3,3,11,27,27,0,0,2023-2024,90.0,85.3448275862069,124.13793103448276
2303,Emmanuel Sabbi,USA,"FW,MF",Le Havre,Ligue 1,25,1997,17.6,38,19,15,15,8,16,39,41.0,23,26,2,24,19,57,7,0,0,2023-2024,90.0,97.1590909090909,194.3181818181818
2304,Stefano Sabelli,ITA,DF,Genoa,Serie A,30,1993,27.0,50,24,28,19,3,15,46,32.6,31,27,6,21,23,73,35,0,0,2023-2024,90.0,76.66666666666667,166.66666666666669
2305,Marcel Sabitzer,AUT,MF,Dortmund,Bundesliga,29,1994,21.8,39,24,18,20,1,23,42,54.8,19,31,12,19,12,51,34,0,0,2023-2024,90.0,49.54128440366972,161.0091743119266
2306,Falaye Sacko,MLI,DF,Montpellier,Ligue 1,28,1995,15.4,28,16,13,10,5,21,32,65.6,11,19,7,12,24,52,37,0,0,2023-2024,90.0,140.25974025974025,163.63636363636365
2307,Dominic Sadi,ENG,FW,Bournemouth,Premier League,19,2003,0.0,0,0,0,0,0,0,0,0.0,0,0,0,0,0,0,0,0,0,2023-2024,,,
2308,Umar Sadiq,NGA,FW,Real Sociedad,La Liga,26,1997,12.0,15,10,2,8,5,4,8,50.0,4,9,0,9,0,15,10,0,0,2023-2024,90.0,0.0,112.5
2309,Alexis Saelemaekers,BEL,"FW,MF",Bologna,Serie A,24,1999,21.0,32,22,13,14,5,12,27,44.4,15,13,1,12,13,45,10,1,0,2023-2024,90.0,55.714285714285715,137.14285714285714
2310,Pablo Saenz,ESP,MF,Granada,La Liga,22,2001,0.2,3,3,2,0,1,1,3,33.3,2,0,0,0,0,3,0,0,0,2023-2024,90.0,0.0,1350.0
2311,Modibo Sagnan,MLI,DF,Montpellier,Ligue 1,24,1999,11.7,34,22,23,9,2,15,25,60.0,10,13,9,4,15,49,67,0,0,2023-2024,89.99999999999999,115.38461538461539,261.53846153846155
2312,Wesley Saïd,FRA,"FW,MF",Lens,Ligue 1,28,1995,11.3,8,4,1,2,5,2,9,22.2,7,4,0,4,4,12,3,0,0,2023-2024,90.0,31.858407079646017,63.716814159292035
2313,Théo Sainte-Luce,FRA,DF,Montpellier,Ligue 1,24,1998,3.8,17,7,10,6,1,11,19,57.9,8,9,4,5,3,20,15,0,0,2023-2024,90.0,71.05263157894737,402.6315789473684
2314,Bukayo Saka,ENG,FW,Arsenal,Premier League,21,2001,32.4,66,35,22,24,20,26,59,44.1,33,43,2,41,15,81,24,1,0,2023-2024,90.0,41.66666666666667,183.33333333333334
2315,Mamadou Sakho,FRA,DF,Montpellier,Ligue 1,33,1990,0.1,1,1,1,0,0,1,1,100.0,0,0,0,0,0,1,1,0,0,2023-2024,90.0,0.0,900.0
2316,Ibrahim Salah,MAR,"FW,MF",Rennes,Ligue 1,21,2001,5.8,15,7,5,6,4,11,18,61.1,7,4,0,4,10,25,5,0,0,2023-2024,90.0,155.17241379310346,232.75862068965517
2317,Mohamed Salah,EGY,FW,Liverpool,Premier League,31,1992,28.2,17,11,1,8,8,6,21,28.6,15,19,1,18,2,19,1,0,0,2023-2024,89.99999999999999,6.382978723404255,54.25531914893617
2318,Amine Salama,FRA,FW,Reims,Ligue 1,23,2000,3.5,0,0,0,0,0,0,0,0.0,0,1,0,1,1,1,1,0,0,2023-2024,90.0,25.714285714285715,0.0
2319,Kike Salas,ESP,DF,Sevilla,La Liga,21,2002,17.8,41,23,26,12,3,22,36,61.1,14,25,14,11,26,67,91,1,0,2023-2024,90.0,131.46067415730337,207.30337078651687
2320,William Saliba,FRA,DF,Arsenal,Premier League,22,2001,38.0,41,26,28,12,1,20,27,74.1,7,32,17,15,29,70,81,3,0,2023-2024,90.0,68.6842105263158,97.10526315789474
2321,Mohammed Salisu,GHA,DF,Monaco,Ligue 1,24,1999,11.5,27,12,11,13,3,17,26,65.4,9,21,12,9,22,49,44,0,0,2023-2024,90.0,172.17391304347828,211.30434782608697
2322,Roland Sallai,HUN,"MF,FW",Freiburg,Bundesliga,26,1997,20.4,17,10,5,5,7,8,20,40.0,12,21,1,20,6,23,23,0,0,2023-2024,90.0,26.47058823529412,75.0
2323,Yoann Salmier,GUF,DF,Le Havre,Ligue 1,30,1992,17.4,22,10,13,6,3,13,20,65.0,7,21,15,6,21,43,57,0,0,2023-2024,90.0,108.62068965517241,113.79310344827586
2324,Salvi,ESP,MF,Rayo Vallecano,La Liga,32,1991,0.3,0,0,0,0,0,0,4,0.0,4,0,0,0,1,1,0,0,0,2023-2024,90.0,300.0,0.0
2325,Lazar Samardzic,SRB,MF,Udinese,Serie A,21,2002,26.4,40,19,18,18,4,16,39,41.0,23,26,6,20,10,50,25,0,0,2023-2024,90.0,34.09090909090909,136.36363636363637
Rk,Player,Nation,Pos,Squad,Comp,0,0,90.0,0,0,3,3,3,Tkl,0,0.0,0,0,0,0,0,0,0,0,0,2023-2024,90.0,0.0,0.0
2326,Diadie Samassékou,MLI,MF,Cádiz,La Liga,27,1996,1.0,5,3,2,2,1,5,6,83.3,1,0,0,0,3,8,1,0,0,2023-2024,90.0,270.0,450.0
2327,Diadie Samassékou,MLI,MF,Hoffenheim,Bundesliga,27,1996,0.0,0,0,0,0,0,0,0,0.0,0,0,0,0,1,1,0,0,0,2023-2024,,inf,
2328,Mama Samba Baldé,GNB,"FW,MF",Lyon,Ligue 1,27,1995,6.1,8,5,1,2,5,3,9,33.3,6,0,0,0,3,11,1,1,0,2023-2024,90.0,44.26229508196722,118.03278688524591
2329,Brice Samba,FRA,GK,Lens,Ligue 1,29,1994,33.0,1,1,1,0,0,1,1,100.0,0,0,0,0,0,1,10,3,0,2023-2024,90.0,0.0,2.7272727272727275
2330,Albert Sambi Lokonga,BEL,MF,Luton Town,Premier League,23,1999,14.5,29,18,14,12,3,17,24,70.8,7,23,13,10,11,40,14,0,0,2023-2024,90.0,68.27586206896551,180.0
2331,Junior Sambia,FRA,"DF,MF",Salernitana,Serie A,26,1996,11.5,12,5,8,1,3,6,11,54.5,5,15,7,8,11,23,28,0,0,2023-2024,90.0,86.08695652173914,93.91304347826087
2332,Fede San Emeterio,ESP,MF,Cádiz,La Liga,26,1997,1.7,3,2,2,1,0,1,4,25.0,3,3,2,1,2,5,1,0,0,2023-2024,90.0,105.88235294117646,158.8235294117647
2333,Antonio Sanabria,PAR,"FW,MF",Torino,Serie A,27,1996,23.7,18,15,5,9,4,4,9,44.4,5,7,1,6,6,24,12,0,0,2023-2024,90.0,22.78481012658228,68.35443037974684
2334,Oihan Sancet,ESP,MF,Athletic Club,La Liga,23,2000,21.9,19,11,3,10,6,8,21,38.1,13,5,1,4,10,29,5,0,0,2023-2024,90.0,41.09589041095891,78.08219178082193
2335,Renato Sanches,POR,MF,Roma,Serie A,25,1997,1.6,2,1,1,1,0,2,3,66.7,1,2,0,2,0,2,1,0,0,2023-2024,90.0,0.0,112.5
2336,Ricard Sánchez,ESP,DF,Granada,La Liga,23,2000,25.5,29,18,15,8,6,12,24,50.0,12,32,4,28,13,42,64,0,0,2023-2024,90.0,45.88235294117647,102.3529411764706
2337,Alexis Sánchez,CHI,"FW,MF",Inter,Serie A,34,1988,8.5,7,6,0,5,2,1,4,25.0,3,4,1,3,1,8,3,0,0,2023-2024,90.0,10.588235294117647,74.11764705882354
2338,Antonio Sánchez,ESP,MF,Mallorca,La Liga,26,1997,16.1,25,11,13,10,2,11,32,34.4,21,24,5,19,13,38,13,0,0,2023-2024,90.0,72.67080745341615,139.75155279503105
2339,Davinson Sánchez,COL,DF,Tottenham,Premier League,27,1996,0.9,0,0,0,0,0,0,0,0.0,0,3,2,1,1,1,2,0,0,2023-2024,90.0,100.0,0.0
2340,Juanlu Sánchez,ESP,DF,Sevilla,La Liga,19,2003,13.1,56,35,34,18,4,34,58,58.6,24,24,7,17,12,68,36,0,0,2023-2024,90.0,82.44274809160305,384.7328244274809
2341,Manu Sánchez,ESP,"DF,MF",Celta Vigo,La Liga,22,2000,19.7,54,28,21,25,8,31,55,56.4,24,23,3,20,19,73,65,0,0,2023-2024,90.0,86.80203045685279,246.7005076142132
2342,Robert Sánchez,ESP,GK,Chelsea,Premier League,25,1997,15.9,0,0,0,0,0,0,0,0.0,0,0,0,0,0,0,11,3,0,2023-2024,90.0,0.0,0.0
2343,Jadon Sancho,ENG,"FW,MF",Manchester Utd,Premier League,23,2000,0.9,1,0,1,0,0,1,3,33.3,2,1,0,1,1,2,0,0,0,2023-2024,90.0,100.0,100.0
2344,Jadon Sancho,ENG,"FW,MF",Dortmund,Bundesliga,23,2000,10.5,5,4,1,3,1,0,4,0.0,4,11,0,11,4,9,6,0,0,2023-2024,90.0,34.285714285714285,42.857142857142854
2345,Alex Sandro,BRA,DF,Juventus,Serie A,32,1991,8.0,13,7,7,6,0,4,5,80.0,1,13,7,6,15,28,23,0,0,2023-2024,90.0,168.75,146.25
2346,Ibou Sané,SEN,"MF,FW",Metz,Ligue 1,18,2005,1.4,6,4,2,1,3,2,2,100.0,0,3,0,3,1,7,2,0,0,2023-2024,90.0,64.28571428571429,385.7142857142857
2347,Leroy Sané,GER,FW,Bayern Munich,Bundesliga,27,1996,23.7,15,8,6,6,3,4,19,21.1,15,12,0,12,7,22,3,0,0,2023-2024,90.0,26.58227848101266,56.9620253164557
2348,Sadibou Sané,SEN,DF,Metz,Ligue 1,19,2004,9.4,19,12,16,2,1,6,7,85.7,1,14,9,5,8,27,64,0,0,2023-2024,90.0,76.59574468085106,181.91489361702128
2349,Arouna Sangante,SEN,DF,Le Havre,Ligue 1,21,2002,29.9,53,33,27,23,3,24,40,60.0,16,35,18,17,66,119,93,2,0,2023-2024,90.0,198.66220735785956,159.53177257525084
2350,Ibrahim Sangaré,CIV,MF,Nott'ham Forest,Premier League,25,1997,11.5,42,23,25,13,4,12,29,41.4,17,24,7,17,16,58,21,0,0,2023-2024,90.0,125.21739130434784,328.69565217391306
Rk,Player,Nation,Pos,Squad,Comp,0,0,90.0,0,0,3,3,3,Tkl,0,0.0,0,0,0,0,0,0,0,0,0,2023-2024,90.0,0.0,0.0
2351,Morgan Sanson,FRA,MF,Nice,Ligue 1,28,1994,21.8,26,19,12,7,7,12,31,38.7,19,34,5,29,20,46,16,0,0,2023-2024,90.0,82.56880733944953,107.3394495412844
2352,Nicola Sansone,ITA,"FW,MF",Lecce,Serie A,31,1991,8.5,11,6,6,2,3,5,16,31.3,11,7,1,6,4,15,5,2,0,2023-2024,90.0,42.35294117647059,116.47058823529412
2353,Baptiste Santamaria,FRA,MF,Rennes,Ligue 1,28,1995,21.4,52,33,21,25,6,29,46,63.0,17,15,6,9,34,86,33,1,0,2023-2024,90.0,142.99065420560748,218.69158878504675
2354,Jesús Santiago,ESP,MF,Getafe,La Liga,19,2004,7.3,17,8,8,5,4,4,7,57.1,3,3,0,3,0,17,8,0,0,2023-2024,90.0,0.0,209.58904109589042
2355,Andrey Santos,BRA,MF,Nott'ham Forest,Premier League,19,2004,0.1,0,0,0,0,0,0,0,0.0,0,1,0,1,0,0,0,0,0,2023-2024,90.0,0.0,0.0
2356,Andrey Santos,BRA,MF,Strasbourg,Ligue 1,19,2004,9.2,29,18,15,13,1,17,26,65.4,9,8,0,8,10,39,11,1,0,2023-2024,90.0,97.82608695652175,283.69565217391306
2357,Tiago Santos,POR,DF,Lille,Ligue 1,21,2002,26.3,63,42,31,19,13,30,52,57.7,22,24,5,19,15,78,37,0,0,2023-2024,90.0,51.330798479087456,215.58935361216732
2358,Paco Sanz,ESP,DF,Almería,La Liga,18,2004,0.3,0,0,0,0,0,0,1,0.0,1,0,0,0,0,0,4,0,0,2023-2024,90.0,0.0,0.0
2359,Riccardo Saponara,ITA,"FW,MF",Hellas Verona,Serie A,31,1991,3.8,3,1,2,0,1,1,7,14.3,6,4,0,4,0,3,2,0,0,2023-2024,90.0,0.0,71.05263157894737
2360,Pablo Sarabia,ESP,"MF,FW",Wolves,Premier League,31,1992,19.4,20,13,8,8,4,12,36,33.3,24,17,1,16,10,30,9,0,0,2023-2024,90.0,46.39175257731959,92.78350515463919
2361,Amin Sarr,SWE,"FW,MF",Lyon,Ligue 1,22,2001,1.1,1,0,0,1,0,0,0,0.0,0,1,0,1,0,1,1,0,0,2023-2024,90.0,0.0,81.81818181818181
2362,Amin Sarr,SWE,"FW,MF",Wolfsburg,Bundesliga,22,2001,4.3,3,2,1,2,0,1,2,50.0,1,6,1,5,2,5,1,0,0,2023-2024,90.0,41.86046511627907,62.79069767441861
2363,Bouna Sarr,SEN,DF,Bayern Munich,Bundesliga,31,1992,1.2,2,0,1,1,0,2,2,100.0,0,3,0,3,0,2,1,0,0,2023-2024,90.0,0.0,150.0
2364,Ismaila Sarr,SEN,"FW,MF",Marseille,Ligue 1,25,1998,16.1,14,8,2,10,2,6,17,35.3,11,21,6,15,13,27,11,0,0,2023-2024,90.0,72.67080745341615,78.26086956521739
2365,Mamadou Sarr,FRA,DF,Lyon,Ligue 1,17,2005,0.1,0,0,0,0,0,0,0,0.0,0,0,0,0,0,0,0,0,0,2023-2024,90.0,0.0,0.0
2366,Martin Satriano,URU,FW,Brest,Ligue 1,22,2001,20.7,24,16,6,13,5,10,25,40.0,15,19,7,12,7,31,28,0,0,2023-2024,90.0,30.434782608695656,104.34782608695653
2367,Téji Savanier,FRA,MF,Montpellier,Ligue 1,31,1991,30.7,37,20,16,15,6,14,63,22.2,49,36,8,28,33,70,28,1,0,2023-2024,90.0,96.742671009772,108.46905537459284
2368,Stefan Savić,MNE,DF,Atlético Madrid,La Liga,32,1991,18.1,27,19,16,7,4,15,30,50.0,15,29,15,14,27,54,61,1,0,2023-2024,90.0,134.25414364640883,134.25414364640883
2369,Sávio,BRA,"FW,MF",Girona,La Liga,19,2004,33.1,42,25,14,22,6,16,28,57.1,12,34,0,34,18,60,11,1,0,2023-2024,90.0,48.94259818731118,114.19939577039274
2370,Zanos Savva,CYP,"DF,MF",Torino,Serie A,17,2005,0.3,1,1,0,1,0,1,3,33.3,2,0,0,0,0,1,1,0,0,2023-2024,90.0,0.0,300.0
2371,Saba Sazonov,GEO,DF,Torino,Serie A,21,2002,4.0,9,7,4,5,0,3,3,100.0,0,8,5,3,3,12,22,0,0,2023-2024,90.0,67.5,202.5
2372,Joe Scally,USA,DF,Gladbach,Bundesliga,20,2002,24.8,41,28,21,17,3,23,40,57.5,17,31,11,20,18,59,78,2,0,2023-2024,90.0,65.3225806451613,148.79032258064515
2373,Giorgio Scalvini,ITA,DF,Atalanta,Serie A,19,2003,28.3,53,33,29,19,5,19,40,47.5,21,44,17,27,59,112,71,0,0,2023-2024,90.0,187.63250883392226,168.55123674911658
2374,Gianluca Scamacca,ITA,FW,Atalanta,Serie A,24,1999,16.1,15,9,4,5,6,7,14,50.0,7,7,1,6,4,19,9,0,0,2023-2024,90.0,22.360248447204967,83.85093167701862
2375,Dane Scarlett,ENG,FW,Tottenham,Premier League,19,2004,0.2,1,1,0,0,1,0,1,0.0,1,0,0,0,0,1,0,0,0,2023-2024,90.0,0.0,450.0
Rk,Player,Nation,Pos,Squad,Comp,0,0,90.0,0,0,3,3,3,Tkl,0,0.0,0,0,0,0,0,0,0,0,0,2023-2024,90.0,0.0,0.0
2376,Kevin Schade,GER,"FW,MF",Brentford,Premier League,21,2001,3.7,3,1,1,2,0,0,5,0.0,5,2,0,2,1,4,4,0,0,2023-2024,90.0,24.324324324324323,72.97297297297297
2377,András Schäfer,HUN,MF,Union Berlin,Bundesliga,24,1999,13.5,29,16,9,15,5,11,20,55.0,9,25,4,21,20,49,25,0,0,2023-2024,90.0,133.33333333333334,193.33333333333334
2378,Fabian Schär,SUI,DF,Newcastle Utd,Premier League,31,1991,33.9,42,24,27,13,2,18,40,45.0,22,50,38,12,36,78,133,1,0,2023-2024,90.0,95.57522123893806,111.50442477876106
2379,Patrik Schick,CZE,FW,Leverkusen,Bundesliga,27,1996,11.8,6,4,0,3,3,1,5,20.0,4,2,0,2,1,7,7,0,0,2023-2024,90.0,7.627118644067796,45.762711864406775
2380,Stefan Schimmer,GER,"MF,FW",Heidenheim,Bundesliga,29,1994,1.7,1,1,0,1,0,0,3,0.0,3,2,0,2,1,2,6,0,0,2023-2024,90.0,52.94117647058823,52.94117647058823
2381,Xaver Schlager,AUT,MF,RB Leipzig,Bundesliga,25,1997,27.5,81,50,35,38,8,21,53,39.6,32,41,8,33,19,100,27,0,0,2023-2024,89.99999999999999,62.18181818181818,265.09090909090907
2382,Keven Schlotterbeck,GER,DF,Bochum,Bundesliga,26,1997,24.3,42,22,26,14,2,25,30,83.3,5,33,23,10,33,75,104,2,0,2023-2024,90.0,122.22222222222221,155.55555555555554
2383,Nico Schlotterbeck,GER,DF,Dortmund,Bundesliga,23,1999,31.8,70,50,36,27,7,41,65,63.1,24,52,25,27,45,115,101,3,0,2023-2024,90.0,127.35849056603773,198.11320754716982
2384,Jeffrey Schlupp,GHA,"FW,MF",Crystal Palace,Premier League,30,1992,15.0,38,24,14,16,8,9,18,50.0,9,13,2,11,8,46,24,0,0,2023-2024,90.0,48.0,228.0
2385,Romano Schmid,AUT,"MF,FW",Werder Bremen,Bundesliga,23,2000,28.9,35,20,7,22,6,14,46,30.4,32,36,7,29,11,46,17,2,0,2023-2024,90.00000000000001,34.256055363321806,108.99653979238755
2386,Kenneth Schmidt,GER,DF,Freiburg,Bundesliga,21,2002,0.8,2,2,2,0,0,2,4,50.0,2,1,0,1,1,3,2,0,0,2023-2024,90.0,112.5,225.0
2387,Niklas Schmidt,GER,MF,Toulouse,Ligue 1,25,1998,14.1,36,21,13,19,4,16,33,48.5,17,14,7,7,4,40,13,0,0,2023-2024,89.99999999999999,25.53191489361702,229.78723404255317
2388,Benno Schmitz,GER,DF,Köln,Bundesliga,28,1994,12.8,27,15,20,7,0,17,34,50.0,17,19,4,15,7,34,29,0,0,2023-2024,90.0,49.21875,189.84375
2389,Fabian Schnellhardt,GER,MF,Darmstadt 98,Bundesliga,29,1994,2.6,4,1,2,1,1,1,3,33.3,2,1,0,1,4,8,5,0,0,2023-2024,90.0,138.46153846153845,138.46153846153845
2390,Jan Schöppner,GER,MF,Heidenheim,Bundesliga,24,1999,22.2,48,26,26,20,2,21,42,50.0,21,37,7,30,26,74,57,0,0,2023-2024,90.0,105.40540540540542,194.5945945945946
2391,Marcel Schuhen,GER,GK,Darmstadt 98,Bundesliga,30,1993,31.0,1,0,1,0,0,1,3,33.3,2,0,0,0,2,3,11,4,0,2023-2024,90.0,5.806451612903226,2.903225806451613
2392,Perr Schuurs,NED,DF,Torino,Serie A,23,1999,8.6,20,12,11,8,1,3,9,33.3,6,10,2,8,9,29,23,0,0,2023-2024,90.0,94.18604651162792,209.30232558139537
2393,Marvin Schwäbe,GER,GK,Köln,Bundesliga,28,1995,34.0,1,0,1,0,0,1,1,100.0,0,0,0,0,0,1,10,1,0,2023-2024,90.0,0.0,2.6470588235294117
2394,Alexander Schwolow,GER,GK,Union Berlin,Bundesliga,31,1992,1.0,0,0,0,0,0,0,0,0.0,0,0,0,0,0,0,2,0,0,2023-2024,90.0,0.0,0.0
2395,Alex Scott,ENG,MF,Bournemouth,Premier League,19,2003,11.3,24,15,8,10,6,12,28,42.9,16,14,4,10,12,36,18,2,0,2023-2024,90.0,95.57522123893806,191.1504424778761
2396,Simone Scuffet,ITA,GK,Cagliari,Serie A,27,1996,31.0,1,0,1,0,0,1,2,50.0,1,1,0,1,1,2,9,0,0,2023-2024,90.0,2.903225806451613,2.903225806451613
2397,Jérémy Sebas,MTQ,"FW,MF",Strasbourg,Ligue 1,20,2003,4.4,7,1,2,3,2,3,5,60.0,2,3,1,2,1,8,1,0,0,2023-2024,90.0,20.454545454545453,143.1818181818182
2398,Demba Seck,SEN,MF,Torino,Serie A,22,2001,4.7,5,3,1,4,0,3,4,75.0,1,1,0,1,1,6,0,0,0,2023-2024,90.0,19.148936170212764,95.74468085106382
2399,Demba Seck,SEN,"FW,MF",Frosinone,Serie A,22,2001,3.3,7,4,2,3,2,4,5,80.0,1,3,0,3,1,8,1,0,0,2023-2024,90.0,27.272727272727273,190.9090909090909
2400,Aleksandar Sedlar,SRB,DF,Alavés,La Liga,31,1991,10.5,14,10,10,4,0,10,16,62.5,6,8,4,4,13,27,43,0,0,2023-2024,90.0,111.42857142857143,120.0
Rk,Player,Nation,Pos,Squad,Comp,0,0,90.0,0,0,3,3,3,Tkl,0,0.0,0,0,0,0,0,0,0,0,0,2023-2024,90.0,0.0,0.0
2401,Alidu Seidu,GHA,DF,Rennes,Ligue 1,23,2000,6.6,21,9,17,3,1,14,19,73.7,5,11,3,8,10,31,13,0,0,2023-2024,90.0,136.36363636363637,286.3636363636364
2402,Alidu Seidu,GHA,DF,Clermont Foot,Ligue 1,23,2000,12.6,32,24,17,15,0,24,31,77.4,7,15,7,8,25,57,37,0,0,2023-2024,90.0,178.57142857142858,228.57142857142858
2403,Nicolas Seiwald,AUT,MF,RB Leipzig,Bundesliga,22,2001,8.0,33,18,16,15,2,16,25,64.0,9,12,2,10,8,41,15,0,0,2023-2024,90.0,90.0,371.25
2404,Nikola Sekulov,ITA,FW,Juventus,Serie A,21,2002,0.1,0,0,0,0,0,0,0,0.0,0,0,0,0,0,0,0,0,0,2023-2024,90.0,0.0,0.0
2405,Davie Selke,GER,FW,Köln,Bundesliga,28,1995,14.1,4,2,1,3,0,0,2,0.0,2,5,3,2,0,4,20,0,0,2023-2024,89.99999999999999,0.0,25.53191489361702
2406,Matz Sels,BEL,GK,Nott'ham Forest,Premier League,31,1992,16.0,0,0,0,0,0,0,0,0.0,0,0,0,0,0,0,11,1,0,2023-2024,90.0,0.0,0.0
2407,Matz Sels,BEL,GK,Strasbourg,Ligue 1,31,1992,19.0,0,0,0,0,0,0,0,0.0,0,2,0,2,0,0,13,1,0,2023-2024,90.0,0.0,0.0
2408,Nélson Semedo,POR,"DF,MF",Wolves,Premier League,29,1993,34.3,79,48,52,19,8,38,64,59.4,26,44,8,36,36,115,85,1,0,2023-2024,90.0,94.46064139941691,207.28862973760934
2409,Vivaldo Semedo,POR,FW,Udinese,Serie A,18,2005,0.1,0,0,0,0,0,0,0,0.0,0,0,0,0,0,0,0,0,0,2023-2024,90.0,0.0,0.0
2410,Antoine Semenyo,GHA,FW,Bournemouth,Premier League,23,2000,23.4,24,17,7,9,8,9,27,33.3,18,39,2,37,6,30,21,0,0,2023-2024,89.99999999999999,23.076923076923077,92.3076923076923
2411,Marvin Senaya,TOG,"DF,MF",Strasbourg,Ligue 1,22,2001,23.8,72,53,38,25,9,42,68,61.8,26,40,13,27,41,113,68,0,0,2023-2024,90.00000000000001,155.0420168067227,272.2689075630252
2412,Marcos Senesi,ARG,DF,Bournemouth,Premier League,26,1997,24.9,55,32,28,23,4,24,56,42.9,32,50,23,27,35,90,109,1,0,2023-2024,90.0,126.50602409638554,198.79518072289156
2413,Stefano Sensi,ITA,MF,Inter,Serie A,27,1995,0.5,1,1,0,1,0,1,3,33.3,2,1,0,1,1,2,0,0,0,2023-2024,90.0,180.0,180.0
2414,Suat Serdar,GER,MF,Hellas Verona,Serie A,26,1997,18.4,51,39,24,23,4,22,45,48.9,23,29,7,22,20,71,25,1,0,2023-2024,90.0,97.82608695652175,249.45652173913047
2415,Benjamin Šeško,SVN,FW,RB Leipzig,Bundesliga,20,2003,17.0,13,5,2,7,4,2,9,22.2,7,23,2,21,3,16,27,0,0,2023-2024,90.0,15.882352941176471,68.82352941176471
2416,Kevin Sessa,GER,"MF,FW",Heidenheim,Bundesliga,23,2000,11.2,17,10,9,6,2,7,16,43.8,9,12,1,11,4,21,17,0,0,2023-2024,90.0,32.142857142857146,136.60714285714286
2417,Aaron Seydel,GER,FW,Darmstadt 98,Bundesliga,27,1996,6.9,3,2,0,2,1,0,3,0.0,3,8,2,6,1,4,9,0,0,2023-2024,90.0,13.043478260869565,39.13043478260869
2418,Andres Sfait,ROU,"DF,MF",Salernitana,Serie A,18,2004,0.3,1,1,1,0,0,1,2,50.0,1,0,0,0,0,1,0,0,0,2023-2024,90.0,0.0,300.0
2419,Stephan El Shaarawy,ITA,"FW,DF",Roma,Serie A,30,1992,19.3,21,13,14,4,3,6,15,40.0,9,11,4,7,13,34,15,2,0,2023-2024,90.0,60.62176165803108,97.92746113989637
2420,Luke Shaw,ENG,DF,Manchester Utd,Premier League,28,1995,10.7,11,8,7,3,1,9,15,60.0,6,18,11,7,6,17,39,0,0,2023-2024,90.0,50.46728971962617,92.52336448598132
2421,James Shea,ENG,GK,Luton Town,Premier League,32,1991,0.2,0,0,0,0,0,0,0,0.0,0,0,0,0,0,0,2,0,0,2023-2024,90.0,0.0,0.0
2422,Eldor Shomurodov,UZB,"FW,MF",Cagliari,Serie A,28,1995,10.4,11,4,2,6,3,6,10,60.0,4,5,0,5,4,15,4,0,0,2023-2024,90.0,34.61538461538461,95.19230769230768
2423,Steven Shpendi,ALB,"FW,MF",Empoli,Serie A,20,2003,4.6,0,0,0,0,0,0,4,0.0,4,2,1,1,1,1,0,0,0,2023-2024,90.0,19.565217391304348,0.0
2424,Sofiane Sidi Ali,FRA,MF,Marseille,Ligue 1,28,1995,0.2,2,0,0,2,0,1,2,50.0,1,1,0,1,2,4,0,0,0,2023-2024,90.0,900.0,900.0
2425,Vincent Sierro,SUI,MF,Toulouse,Ligue 1,27,1995,25.1,41,24,15,20,6,27,77,35.1,50,37,13,24,27,68,33,0,0,2023-2024,90.0,96.81274900398405,147.01195219123505
Rk,Player,Nation,Pos,Squad,Comp,0,0,90.0,0,0,3,3,3,Tkl,0,0.0,0,0,0,0,0,0,0,0,0,2023-2024,90.0,0.0,0.0
2426,Tim Siersleben,GER,DF,Heidenheim,Bundesliga,23,2000,10.1,27,11,21,6,0,8,20,40.0,12,16,10,6,21,48,29,1,0,2023-2024,90.0,187.12871287128712,240.59405940594058
2427,Kiliann Sildillia,FRA,DF,Freiburg,Bundesliga,21,2002,20.1,43,19,28,8,7,26,42,61.9,16,33,15,18,22,65,64,0,0,2023-2024,90.0,98.50746268656715,192.5373134328358
2428,André Silva,POR,FW,Real Sociedad,La Liga,27,1995,8.1,2,2,0,0,2,0,4,0.0,4,3,0,3,1,3,3,0,0,2023-2024,90.0,11.11111111111111,22.22222222222222
2429,Bernardo Silva,POR,"MF,FW",Manchester City,Premier League,28,1994,28.6,51,23,13,25,13,25,57,43.9,32,32,4,28,17,68,15,1,0,2023-2024,90.0,53.4965034965035,160.48951048951048
2430,Caio Henrique Oliveira Silva,BRA,DF,Monaco,Ligue 1,26,1997,6.9,13,7,3,7,3,6,9,66.7,3,8,2,6,6,19,9,0,0,2023-2024,90.0,78.26086956521738,169.56521739130434
2431,Fábio Silva,POR,FW,Wolves,Premier League,21,2002,2.9,7,4,3,4,0,2,3,66.7,1,1,0,1,2,9,0,0,0,2023-2024,90.0,62.06896551724138,217.24137931034483
2432,Rui Silva,POR,GK,Betis,La Liga,29,1994,27.5,0,0,0,0,0,0,3,0.0,3,0,0,0,1,1,13,1,0,2023-2024,89.99999999999999,3.2727272727272725,0.0
2433,Thiago Silva,BRA,DF,Chelsea,Premier League,38,1984,28.1,29,15,22,6,1,20,34,58.8,14,33,24,9,26,55,153,4,0,2023-2024,90.0,83.27402135231317,92.88256227758006
2434,Marco Silvestri,ITA,GK,Udinese,Serie A,32,1991,17.0,0,0,0,0,0,0,3,0.0,3,1,0,1,0,0,5,3,0,2023-2024,90.0,0.0,0.0
2435,Mohamed Simakan,FRA,DF,RB Leipzig,Bundesliga,23,2000,23.8,48,29,28,19,1,32,44,72.7,12,36,14,22,29,77,69,0,0,2023-2024,90.00000000000001,109.66386554621849,181.51260504201682
2436,Giovanni Simeone,ARG,FW,Napoli,Serie A,28,1995,8.9,12,4,1,3,8,3,12,25.0,9,11,0,11,1,13,7,0,0,2023-2024,90.0,10.112359550561798,121.34831460674158
2437,Giuliano Simeone,ARG,FW,Alavés,La Liga,20,2002,7.0,7,5,2,3,2,5,17,29.4,12,10,0,10,5,12,3,0,0,2023-2024,90.0,64.28571428571428,90.0
2438,Jan-Carlo Simic,SRB,DF,Milan,Serie A,18,2005,1.6,1,1,1,0,0,0,0,0.0,0,5,4,1,0,1,3,0,0,2023-2024,90.0,0.0,56.25
2439,Moses Simon,NGA,"FW,MF",Nantes,Ligue 1,28,1995,19.9,7,5,2,5,0,2,8,25.0,6,9,1,8,3,10,5,1,0,2023-2024,90.0,13.5678391959799,31.658291457286435
2440,Unai Simón,ESP,GK,Athletic Club,La Liga,26,1997,35.4,2,1,1,1,0,2,3,66.7,1,0,0,0,1,3,9,0,0,2023-2024,90.0,2.5423728813559325,5.084745762711865
2441,Xavi Simons,NED,MF,RB Leipzig,Bundesliga,20,2003,29.5,30,17,10,11,9,15,31,48.4,16,23,0,23,16,46,4,0,0,2023-2024,90.0,48.813559322033896,91.52542372881356
2442,Wilfried Singo,CIV,DF,Monaco,Ligue 1,22,2000,24.3,34,25,18,14,2,17,26,65.4,9,27,14,13,51,85,81,2,0,2023-2024,90.0,188.88888888888889,125.92592592592592
2443,Luis Sinisterra,COL,"FW,MF",Bournemouth,Premier League,24,1999,7.8,23,12,9,10,4,9,16,56.3,7,18,0,18,8,31,4,0,0,2023-2024,90.0,92.3076923076923,265.38461538461536
2444,Daley Sinkgraven,NED,DF,Las Palmas,La Liga,28,1995,4.3,11,5,6,5,0,2,8,25.0,6,5,3,2,6,17,9,0,0,2023-2024,90.0,125.58139534883722,230.23255813953492
2445,Jailson Siqueira,BRA,"DF,MF",Celta Vigo,La Liga,27,1995,10.0,27,18,22,5,0,13,24,54.2,11,13,5,8,12,39,32,0,0,2023-2024,90.0,108.0,243.0
2446,Ayanda Sishuba,BEL,"MF,FW",Lens,Ligue 1,18,2005,0.7,3,1,0,2,1,1,2,50.0,1,1,0,1,0,3,0,0,0,2023-2024,90.0,0.0,385.7142857142857
2447,Ibrahima Sissoko,MLI,MF,Strasbourg,Ligue 1,25,1997,18.2,47,33,13,25,9,23,30,76.7,7,21,8,13,19,66,30,0,0,2023-2024,90.0,93.95604395604396,232.41758241758242
2448,Moussa Sissoko,FRA,MF,Nantes,Ligue 1,33,1989,20.2,27,16,13,8,6,12,25,48.0,13,8,2,6,12,39,31,0,0,2023-2024,90.0,53.46534653465346,120.29702970297029
2449,Antonio Sivera,ESP,GK,Alavés,La Liga,26,1996,34.0,0,0,0,0,0,0,1,0.0,1,0,0,0,0,0,17,1,0,2023-2024,90.0,0.0,0.0
2450,Tim Skarke,GER,"FW,DF",Darmstadt 98,Bundesliga,26,1996,26.7,26,16,12,10,4,10,28,35.7,18,25,2,23,6,32,20,0,0,2023-2024,90.00000000000001,20.224719101123597,87.64044943820225
Rk,Player,Nation,Pos,Squad,Comp,0,0,90.0,0,0,3,3,3,Tkl,0,0.0,0,0,0,0,0,0,0,0,0,2023-2024,90.0,0.0,0.0
2451,Ellyes Skhiri,TUN,MF,Eint Frankfurt,Bundesliga,28,1995,24.1,44,24,18,19,7,19,36,52.8,17,33,4,29,39,83,47,2,0,2023-2024,90.0,145.64315352697096,164.31535269709542
2452,Oliver Skipp,ENG,"MF,DF",Tottenham,Premier League,22,2000,7.9,18,12,9,6,3,11,18,61.1,7,12,1,11,3,21,9,0,0,2023-2024,90.0,34.177215189873415,205.06329113924048
2453,Leo Skiri Østigård,NOR,DF,Napoli,Serie A,23,1999,18.1,24,12,13,10,1,6,11,54.5,5,18,12,6,16,40,65,0,0,2023-2024,90.0,79.55801104972375,119.33701657458562
2454,Łukasz Skorupski,POL,GK,Bologna,Serie A,32,1991,32.0,2,2,2,0,0,2,3,66.7,1,0,0,0,1,3,11,3,0,2023-2024,90.0,2.8125,5.625
2455,Robert Skov,DEN,"DF,FW",Hoffenheim,Bundesliga,27,1996,14.0,24,16,15,8,1,17,36,47.2,19,17,4,13,10,34,23,1,0,2023-2024,90.0,64.28571428571428,154.28571428571428
2456,Milan Škriniar,SVK,DF,Paris S-G,Ligue 1,28,1995,18.1,24,18,17,7,0,14,22,63.6,8,19,10,9,12,36,51,2,0,2023-2024,90.0,59.66850828729281,119.33701657458562
2457,Naatan Skyttä,FIN,"MF,FW",Toulouse,Ligue 1,21,2002,1.3,4,4,2,1,1,1,1,100.0,0,0,0,0,0,4,0,0,0,2023-2024,90.0,0.0,276.9230769230769
2458,Chris Smalling,ENG,DF,Roma,Serie A,33,1989,4.3,1,1,1,0,0,1,4,25.0,3,6,5,1,5,6,8,0,0,2023-2024,90.0,104.65116279069768,20.930232558139537
2459,Adam Smith,ENG,DF,Bournemouth,Premier League,32,1991,23.9,37,23,18,11,8,19,39,48.7,20,28,11,17,21,58,62,0,0,2023-2024,90.0,79.0794979079498,139.3305439330544
2460,Emile Smith Rowe,ENG,MF,Arsenal,Premier League,23,2000,3.9,4,1,2,2,0,2,4,50.0,2,3,1,2,3,7,1,0,0,2023-2024,90.0,69.23076923076923,92.3076923076923
2461,Hrvoje Smolčić,CRO,DF,Eint Frankfurt,Bundesliga,22,2000,3.9,7,3,7,0,0,4,5,80.0,1,3,1,2,6,13,23,1,0,2023-2024,90.0,138.46153846153845,161.53846153846152
2462,Cédric Soares,POR,DF,Arsenal,Premier League,31,1991,0.7,0,0,0,0,0,0,0,0.0,0,0,0,0,0,0,0,0,0,2023-2024,90.0,0.0,0.0
2463,Danilo Soares,BRA,DF,Bochum,Bundesliga,31,1991,3.9,10,6,5,3,2,5,8,62.5,3,6,0,6,7,17,11,0,0,2023-2024,90.0,161.53846153846152,230.76923076923077
2464,Eduard Sobol,UKR,DF,Strasbourg,Ligue 1,28,1995,0.3,0,0,0,0,0,0,0,0.0,0,0,0,0,0,0,1,0,0,2023-2024,90.0,0.0,0.0
2465,Rubén Sobrino,ESP,"MF,FW",Cádiz,La Liga,31,1992,18.3,52,28,18,26,8,22,51,43.1,29,26,2,24,16,68,18,0,0,2023-2024,90.0,78.68852459016394,255.7377049180328
2466,Andrea Sodero,ITA,MF,Empoli,Serie A,18,2004,0.1,0,0,0,0,0,0,0,0.0,0,0,0,0,0,0,0,0,0,2023-2024,90.0,0.0,0.0
2467,Emran Soglo,ENG,"MF,DF",Marseille,Ligue 1,18,2005,1.2,2,1,0,2,0,1,3,33.3,2,6,0,6,1,3,3,0,0,2023-2024,90.0,75.0,150.0
2468,Alex Sola,ESP,"FW,MF",Alavés,La Liga,24,1999,14.0,27,15,11,9,7,14,26,53.8,12,18,2,16,11,38,16,0,0,2023-2024,90.0,70.71428571428571,173.57142857142856
2469,Alex Sola,ESP,"DF,MF",Real Sociedad,La Liga,24,1999,0.3,0,0,0,0,0,0,0,0.0,0,0,0,0,1,1,2,0,0,2023-2024,90.0,300.0,0.0
2470,Dominic Solanke,ENG,FW,Bournemouth,Premier League,25,1997,36.9,23,11,3,13,7,10,29,34.5,19,24,5,19,7,30,43,0,0,2023-2024,90.0,17.073170731707318,56.09756097560976
2471,Ola Solbakken,NOR,FW,Roma,Serie A,24,1998,0.3,0,0,0,0,0,0,0,0.0,0,0,0,0,0,0,0,0,0,2023-2024,90.0,0.0,0.0
2472,Carlos Soler,ESP,"MF,DF",Paris S-G,Ligue 1,26,1997,12.1,15,10,9,2,4,6,21,28.6,15,10,3,7,5,20,11,1,0,2023-2024,90.0,37.1900826446281,111.57024793388429
2473,Jhon Solis,COL,MF,Girona,La Liga,18,2004,4.3,10,8,4,5,1,4,12,33.3,8,8,3,5,8,18,7,1,0,2023-2024,90.0,167.4418604651163,209.30232558139537
2474,Manor Solomon,ISR,FW,Tottenham,Premier League,24,1999,2.2,3,3,1,1,1,1,2,50.0,1,4,0,4,3,6,2,0,0,2023-2024,90.0,122.72727272727272,122.72727272727272
2475,Daniele Sommariva,ITA,GK,Genoa,Serie A,26,1997,0.1,0,0,0,0,0,0,0,0.0,0,0,0,0,0,0,0,0,0,2023-2024,90.0,0.0,0.0
Rk,Player,Nation,Pos,Squad,Comp,0,0,90.0,0,0,3,3,3,Tkl,0,0.0,0,0,0,0,0,0,0,0,0,2023-2024,90.0,0.0,0.0
2476,Yann Sommer,SUI,GK,Inter,Serie A,34,1988,34.0,2,1,2,0,0,2,2,100.0,0,1,0,1,0,2,7,1,0,2023-2024,90.0,0.0,5.294117647058823
2477,Brandon Soppy,FRA,DF,Torino,Serie A,21,2002,2.0,2,2,1,1,0,2,6,33.3,4,2,0,2,0,2,3,1,0,2023-2024,90.0,0.0,90.0
2478,David Soria,ESP,GK,Getafe,La Liga,30,1993,37.9,0,0,0,0,0,0,2,0.0,2,0,0,0,0,0,21,6,0,2023-2024,90.0,0.0,0.0
2479,Alberto Soro,ESP,MF,Granada,La Liga,24,1999,0.1,0,0,0,0,0,0,0,0.0,0,0,0,0,0,0,0,0,0,2023-2024,90.0,0.0,0.0
2480,Alessandro Sorrentino,ITA,GK,Monza,Serie A,21,2002,6.1,0,0,0,0,0,0,0,0.0,0,0,0,0,0,0,0,0,0,2023-2024,90.0,0.0,0.0
2481,Borna Sosa,CRO,"FW,DF",Stuttgart,Bundesliga,25,1998,0.5,0,0,0,0,0,0,1,0.0,1,0,0,0,0,0,0,0,0,2023-2024,90.0,0.0,0.0
2482,Hugo Sotelo,ESP,MF,Celta Vigo,La Liga,19,2003,8.0,19,17,3,13,3,8,20,40.0,12,7,1,6,2,21,5,0,0,2023-2024,90.0,22.5,213.75
2483,Florian Sotoca,FRA,"MF,FW",Lens,Ligue 1,32,1990,28.9,33,22,9,21,3,17,38,44.7,21,41,4,37,20,53,34,0,0,2023-2024,90.00000000000001,62.28373702422146,102.7681660899654
2484,Riccardo Sottil,ITA,FW,Fiorentina,Serie A,24,1999,12.3,10,5,5,1,4,3,8,37.5,5,12,0,12,2,12,2,0,0,2023-2024,89.99999999999999,14.634146341463413,73.17073170731706
2485,Tomáš Souček,CZE,MF,West Ham,Premier League,28,1995,31.9,53,35,24,26,3,21,47,44.7,26,55,28,27,37,90,109,0,0,2023-2024,90.0,104.38871473354232,149.52978056426332
2486,Matìas Soulé,ARG,"FW,MF",Frosinone,Serie A,20,2003,34.7,41,27,12,14,15,19,40,47.5,21,38,4,34,18,59,9,0,0,2023-2024,90.0,46.685878962536016,106.3400576368876
2487,Boubakary Soumaré,FRA,MF,Sevilla,La Liga,24,1999,25.4,39,28,24,14,1,14,26,53.8,12,25,7,18,26,65,20,1,0,2023-2024,90.0,92.1259842519685,138.18897637795277
2488,Issa Soumaré,SEN,"FW,MF",Le Havre,Ligue 1,22,2000,2.6,2,0,2,0,0,0,4,0.0,4,0,0,0,0,2,2,0,0,2023-2024,90.0,0.0,69.23076923076923
2489,Vinicius Souza,BRA,MF,Sheffield Utd,Premier League,24,1999,29.6,125,76,59,51,15,41,74,55.4,33,57,17,40,32,157,75,1,0,2023-2024,90.0,97.29729729729729,380.06756756756755
2490,Djibril Sow,SUI,MF,Sevilla,La Liga,26,1997,16.2,28,21,15,8,5,9,25,36.0,16,20,3,17,17,45,8,1,0,2023-2024,90.0,94.44444444444444,155.55555555555557
2491,Saidou Sow,GUI,DF,Strasbourg,Ligue 1,21,2002,8.0,20,12,17,3,0,9,13,69.2,4,7,4,3,12,32,36,3,0,2023-2024,90.0,135.0,225.0
2492,Çağlar Söyüncü,TUR,DF,Atlético Madrid,La Liga,27,1996,1.3,1,1,1,0,0,0,0,0.0,0,1,0,1,1,2,7,0,0,2023-2024,90.0,69.23076923076923,69.23076923076923
2493,Djed Spence,ENG,DF,Genoa,Serie A,22,2000,9.5,16,10,12,4,0,8,10,80.0,2,20,5,15,8,24,28,0,0,2023-2024,90.0,75.78947368421052,151.57894736842104
2494,Stijn Spierings,NED,MF,Toulouse,Ligue 1,27,1996,16.8,53,40,26,20,7,29,52,55.8,23,22,5,17,26,79,32,0,0,2023-2024,90.0,139.28571428571428,283.9285714285714
2495,Stijn Spierings,NED,MF,Lens,Ligue 1,27,1996,1.3,1,0,0,1,0,1,1,100.0,0,2,1,1,2,3,1,0,0,2023-2024,90.0,138.46153846153845,69.23076923076923
2496,Leonardo Spinazzola,ITA,DF,Roma,Serie A,30,1993,14.6,15,7,10,5,0,8,18,44.4,10,8,2,6,3,18,15,0,0,2023-2024,90.0,18.493150684931507,92.46575342465754
2497,Marco Sportiello,ITA,GK,Milan,Serie A,31,1992,7.0,0,0,0,0,0,0,0,0.0,0,0,0,0,0,0,2,0,0,2023-2024,90.0,0.0,0.0
2498,Anton Stach,GER,MF,Hoffenheim,Bundesliga,24,1998,25.8,73,42,40,27,6,33,63,52.4,30,38,12,26,72,145,67,1,0,2023-2024,90.0,251.1627906976744,254.65116279069767
2499,Anton Stach,GER,MF,Mainz 05,Bundesliga,24,1998,1.9,3,0,2,0,1,2,4,50.0,2,5,0,5,2,5,5,0,0,2023-2024,90.0,94.73684210526315,142.10526315789474
2500,Jens Stage,DEN,MF,Werder Bremen,Bundesliga,26,1996,25.9,52,22,21,23,8,18,50,36.0,32,42,23,19,23,75,55,0,0,2023-2024,90.0,79.92277992277994,180.69498069498073
Rk,Player,Nation,Pos,Squad,Comp,0,0,90.0,0,0,3,3,3,Tkl,0,0.0,0,0,0,0,0,0,0,0,0,2023-2024,90.0,0.0,0.0
2501,Benjamin Stambouli,FRA,MF,Reims,Ligue 1,32,1990,3.2,9,7,3,5,1,6,11,54.5,5,3,1,2,2,11,8,0,0,2023-2024,90.0,56.25,253.125
2502,Josip Stanišić,CRO,DF,Leverkusen,Bundesliga,23,2000,14.0,38,20,19,13,6,22,33,66.7,11,18,3,15,9,47,26,0,0,2023-2024,90.0,57.857142857142854,244.28571428571428
2503,Carl Starfelt,SWE,DF,Celta Vigo,La Liga,28,1995,24.6,36,30,30,5,1,19,28,67.9,9,35,28,7,34,70,159,2,0,2023-2024,89.99999999999999,124.39024390243901,131.7073170731707
2504,Niklas Stark,GER,DF,Werder Bremen,Bundesliga,28,1995,12.1,26,15,13,11,2,12,18,66.7,6,14,7,7,19,45,61,1,0,2023-2024,90.0,141.32231404958677,193.38842975206612
2505,Jason Steele,ENG,GK,Brighton,Premier League,32,1990,17.0,0,0,0,0,0,0,3,0.0,3,0,0,0,0,0,8,1,0,2023-2024,90.0,0.0,0.0
2506,Pascal Stenzel,GER,DF,Stuttgart,Bundesliga,27,1996,11.8,18,8,7,9,2,10,30,33.3,20,22,8,14,15,33,26,0,0,2023-2024,90.0,114.40677966101694,137.28813559322032
2507,Leonidas Stergiou,SUI,DF,Stuttgart,Bundesliga,21,2002,6.6,15,8,7,7,1,9,13,69.2,4,8,1,7,5,20,13,0,0,2023-2024,90.0,68.18181818181819,204.54545454545453
2508,Raheem Sterling,ENG,"FW,MF",Chelsea,Premier League,28,1994,22.0,21,10,7,8,6,12,26,46.2,14,13,0,13,13,34,9,1,0,2023-2024,90.0,53.18181818181819,85.9090909090909
2509,Trivante Stewart,JAM,"FW,MF",Salernitana,Serie A,23,2000,1.1,0,0,0,0,0,0,0,0.0,0,1,0,1,0,0,0,0,0,2023-2024,90.0,0.0,0.0
2510,Angelo Stiller,GER,MF,Hoffenheim,Bundesliga,22,2001,0.9,0,0,0,0,0,0,1,0.0,1,2,0,2,0,0,3,0,0,2023-2024,90.0,0.0,0.0
2511,Angelo Stiller,GER,MF,Stuttgart,Bundesliga,22,2001,29.9,55,33,15,34,6,24,42,57.1,18,41,13,28,28,83,25,2,0,2023-2024,90.0,84.28093645484951,165.55183946488296
2512,Kevin Stöger,AUT,MF,Bochum,Bundesliga,29,1993,29.6,49,30,21,21,7,25,63,39.7,38,46,4,42,19,68,18,0,0,2023-2024,90.0,57.77027027027027,148.98648648648648
2513,Filip Stojilković,SUI,"FW,MF",Darmstadt 98,Bundesliga,23,2000,1.7,1,1,0,0,1,0,0,0.0,0,0,0,0,0,1,1,0,0,2023-2024,90.0,0.0,52.94117647058823
2514,John Stones,ENG,"DF,MF",Manchester City,Premier League,29,1994,11.8,2,1,1,0,1,0,3,0.0,3,11,7,4,10,12,21,0,0,2023-2024,90.0,76.27118644067797,15.254237288135592
2515,Thomas Strakosha,ALB,GK,Brentford,Premier League,28,1995,1.5,0,0,0,0,0,0,0,0.0,0,0,0,0,0,0,0,0,0,2023-2024,90.0,0.0,0.0
2516,Jørgen Strand Larsen,NOR,FW,Celta Vigo,La Liga,23,2000,31.8,21,11,1,15,5,8,38,21.1,30,15,1,14,5,26,17,0,0,2023-2024,90.0,14.150943396226415,59.43396226415094
2517,Gabriel Strefezza,BRA,FW,Lecce,Serie A,26,1997,12.4,24,17,8,7,9,14,20,70.0,6,17,0,17,7,31,11,0,0,2023-2024,90.0,50.806451612903224,174.19354838709677
2518,Kevin Strootman,NED,MF,Genoa,Serie A,33,1990,13.4,34,19,13,18,3,15,31,48.4,16,20,6,14,7,41,22,0,0,2023-2024,90.0,47.014925373134325,228.35820895522386
2519,Cristhian Stuani,URU,FW,Girona,La Liga,36,1986,8.9,14,11,4,6,4,4,7,57.1,3,9,2,7,5,19,13,0,0,2023-2024,90.0,50.56179775280899,141.57303370786516
2520,Álex Suárez,ESP,DF,Las Palmas,La Liga,30,1993,28.5,53,36,33,15,5,31,37,83.8,6,33,14,19,18,71,84,0,0,2023-2024,90.0,56.8421052631579,167.3684210526316
2521,Damián Suárez,URU,DF,Getafe,La Liga,35,1988,14.4,36,21,16,16,4,26,45,57.8,19,13,3,10,10,46,31,0,0,2023-2024,90.0,62.5,225.0
2522,Denis Suárez,ESP,"MF,FW",Villarreal,La Liga,29,1994,1.5,0,0,0,0,0,0,2,0.0,2,2,2,0,0,0,4,0,0,2023-2024,90.0,0.0,0.0
2523,Gabriel Suazo,CHI,DF,Toulouse,Ligue 1,25,1997,26.2,66,32,40,19,7,38,86,44.2,48,37,4,33,26,92,33,0,0,2023-2024,90.0,89.31297709923665,226.7175572519084
2524,Isaac Success,NGA,"FW,MF",Udinese,Serie A,27,1996,9.8,6,4,0,5,1,1,3,33.3,2,6,1,5,2,8,11,0,0,2023-2024,90.0,18.36734693877551,55.10204081632653
2525,Niklas Süle,GER,DF,Dortmund,Bundesliga,27,1995,16.8,18,10,14,3,1,11,16,68.8,5,25,14,11,25,43,58,2,0,2023-2024,90.0,133.92857142857142,96.42857142857143
Rk,Player,Nation,Pos,Squad,Comp,0,0,90.0,0,0,3,3,3,Tkl,0,0.0,0,0,0,0,0,0,0,0,0,2023-2024,90.0,0.0,0.0
2526,Ibrahim Sulemana,GHA,MF,Cagliari,Serie A,20,2003,14.9,36,14,15,15,6,17,27,63.0,10,24,5,19,7,43,23,0,0,2023-2024,90.0,42.28187919463087,217.44966442953017
2527,Tomáš Suslov,SVK,"MF,FW",Hellas Verona,Serie A,21,2002,23.2,42,30,11,22,9,15,47,31.9,32,15,0,15,6,48,8,0,0,2023-2024,90.0,23.275862068965516,162.93103448275863
2528,Suso,ESP,"MF,FW",Sevilla,La Liga,29,1993,16.9,24,17,14,8,2,8,28,28.6,20,9,0,9,5,29,4,0,0,2023-2024,90.0,26.627218934911244,127.81065088757397
2529,Mattias Svanberg,SWE,MF,Wolfsburg,Bundesliga,24,1999,19.1,37,17,8,19,10,12,38,31.6,26,25,5,20,21,58,28,0,0,2023-2024,90.0,98.95287958115183,174.3455497382199
2530,Max Svensson,ESP,FW,Osasuna,La Liga,0,0,0.0,1,0,0,0,1,0,0,0.0,0,0,0,0,0,1,0,0,0,2023-2024,,,inf
2531,Mile Svilar,SRB,GK,Roma,Serie A,23,1999,15.0,0,0,0,0,0,0,0,0.0,0,0,0,0,0,0,2,1,0,2023-2024,90.0,0.0,0.0
2532,Williot Swedberg,SWE,"FW,MF",Celta Vigo,La Liga,19,2004,4.9,9,4,3,6,0,5,8,62.5,3,11,1,10,0,9,4,0,0,2023-2024,90.0,0.0,165.30612244897958
2533,Karol Świderski,POL,"FW,MF",Hellas Verona,Serie A,26,1997,5.6,7,3,1,3,3,2,3,66.7,1,6,4,2,1,8,8,0,0,2023-2024,90.0,16.071428571428573,112.5
2534,Abakar Sylla,CIV,DF,Strasbourg,Ligue 1,20,2002,19.9,54,23,30,19,5,29,40,72.5,11,40,11,29,26,80,70,2,0,2023-2024,90.0,117.58793969849248,244.2211055276382
2535,Dembo Sylla,GUI,DF,Lorient,Ligue 1,20,2002,0.5,1,1,0,1,0,0,0,0.0,0,0,0,0,1,2,2,0,0,2023-2024,90.0,180.0,180.0
2536,Issiaga Sylla,GUI,"DF,FW",Montpellier,Ligue 1,29,1994,16.2,28,17,20,6,2,16,34,47.1,18,21,7,14,23,51,53,0,0,2023-2024,90.0,127.77777777777779,155.55555555555557
2537,Mamadou Sylla,SEN,"FW,MF",Alavés,La Liga,29,1994,0.2,0,0,0,0,0,0,0,0.0,0,1,1,0,0,0,1,0,0,2023-2024,90.0,0.0,0.0
2538,Attila Szalai,HUN,DF,Hoffenheim,Bundesliga,25,1998,3.2,3,1,3,0,0,1,4,25.0,3,6,2,4,1,4,7,0,0,2023-2024,90.0,28.125,84.375
2539,Attila Szalai,HUN,DF,Freiburg,Bundesliga,25,1998,1.1,1,1,1,0,0,1,2,50.0,1,5,2,3,1,2,11,1,0,2023-2024,90.0,81.81818181818181,81.81818181818181
2540,Wojciech Szczęsny,POL,GK,Juventus,Serie A,33,1990,35.0,0,0,0,0,0,0,0,0.0,0,0,0,0,1,1,11,2,0,2023-2024,90.0,2.571428571428571,0.0
2541,Dominik Szoboszlai,HUN,MF,Liverpool,Premier League,22,2000,23.4,32,19,12,12,8,16,50,32.0,34,37,2,35,15,47,16,1,0,2023-2024,89.99999999999999,57.69230769230769,123.07692307692307
2542,Przemysław Szymiński,POL,MF,Frosinone,Serie A,29,1994,0.1,0,0,0,0,0,0,0,0.0,0,1,1,0,0,0,0,0,0,2023-2024,90.0,0.0,0.0
2543,Alexander Sørloth,NOR,FW,Villarreal,La Liga,27,1995,27.7,6,3,1,2,3,2,6,33.3,4,9,4,5,0,6,26,0,0,2023-2024,90.0,0.0,19.494584837545126
2544,Musa Al-Taamari,JOR,FW,Montpellier,Ligue 1,26,1997,21.4,20,16,10,5,5,9,21,42.9,12,18,2,16,4,24,5,0,0,2023-2024,90.0,16.82242990654206,84.11214953271029
2545,Nicolás Tagliafico,ARG,DF,Lyon,Ligue 1,30,1992,23.6,54,34,23,22,9,22,49,44.9,27,25,8,17,28,82,43,0,0,2023-2024,90.0,106.77966101694915,205.93220338983048
2546,Jonathan Tah,GER,DF,Leverkusen,Bundesliga,27,1996,29.2,19,9,10,7,2,5,16,31.3,11,28,23,5,23,42,97,1,0,2023-2024,90.0,70.89041095890411,58.561643835616444
2547,Montassar Talbi,TUN,DF,Lorient,Ligue 1,25,1998,24.5,38,22,23,13,2,19,32,59.4,13,39,23,16,32,70,114,0,0,2023-2024,90.00000000000001,117.55102040816328,139.59183673469389
2548,Yassin Tallal,ESP,FW,Getafe,La Liga,18,2005,0.0,0,0,0,0,0,0,0,0.0,0,0,0,0,0,0,0,0,0,2023-2024,,,
2549,Adrien Tameze,CMR,"DF,MF",Torino,Serie A,29,1994,23.8,35,16,13,18,4,18,37,48.6,19,24,11,13,47,82,25,2,0,2023-2024,90.00000000000001,177.7310924369748,132.3529411764706
2550,Renato Tapia,PER,"MF,DF",Celta Vigo,La Liga,28,1995,14.9,41,29,19,19,3,14,25,56.0,11,31,7,24,21,62,50,1,0,2023-2024,90.0,126.84563758389261,247.65100671140937
Rk,Player,Nation,Pos,Squad,Comp,0,0,90.0,0,0,3,3,3,Tkl,0,0.0,0,0,0,0,0,0,0,0,0,2023-2024,90.0,0.0,0.0
2551,Edmond Tapsoba,BFA,DF,Leverkusen,Bundesliga,24,1999,23.2,34,25,17,15,2,17,24,70.8,7,21,10,11,24,58,52,3,0,2023-2024,90.0,93.10344827586206,131.89655172413794
2552,Matt Targett,ENG,DF,Newcastle Utd,Premier League,27,1995,0.9,2,0,1,1,0,1,1,100.0,0,1,0,1,0,2,2,0,0,2023-2024,90.0,0.0,200.0
2553,Oussama Targhalline,MAR,MF,Le Havre,Ligue 1,21,2002,11.4,23,11,16,7,0,15,25,60.0,10,9,3,6,20,43,14,2,0,2023-2024,90.0,157.89473684210526,181.57894736842104
2554,James Tarkowski,ENG,DF,Everton,Premier League,30,1992,38.0,61,42,46,14,1,27,48,56.3,21,82,56,26,56,117,191,2,0,2023-2024,90.0,132.6315789473684,144.47368421052633
2555,César Tárrega,ESP,DF,Valencia,La Liga,21,2002,0.1,0,0,0,0,0,0,0,0.0,0,0,0,0,0,0,2,0,0,2023-2024,90.0,0.0,0.0
2556,Jimi Tauriainen,ENG,FW,Chelsea,Premier League,19,2004,0.0,0,0,0,0,0,0,0,0.0,0,0,0,0,0,0,0,0,0,2023-2024,,,
2557,Nuno Tavares,POR,DF,Nott'ham Forest,Premier League,23,2000,5.1,11,7,9,1,1,8,9,88.9,1,6,0,6,1,12,21,0,0,2023-2024,90.0,17.647058823529413,194.11764705882354
2558,Marcus Tavernier,ENG,FW,Bournemouth,Premier League,24,1999,23.5,53,34,25,22,6,26,48,54.2,22,31,3,28,5,58,23,0,0,2023-2024,90.0,19.148936170212764,202.9787234042553
2559,Elayis Tavsan,NED,"MF,FW",Hellas Verona,Serie A,22,2001,0.6,0,0,0,0,0,0,1,0.0,1,0,0,0,0,0,1,0,0,2023-2024,90.0,0.0,0.0
2560,Charlie Taylor,ENG,DF,Burnley,Premier League,29,1993,25.9,35,20,19,14,2,17,35,48.6,18,27,11,16,19,54,78,0,0,2023-2024,90.0,66.02316602316603,121.62162162162164
2561,Marciano Tchami,GNB,"FW,MF",Almería,La Liga,19,2004,0.5,0,0,0,0,0,0,0,0.0,0,0,0,0,0,0,0,0,0,2023-2024,90.0,0.0,0.0
2562,Loum Tchaouna,FRA,"FW,MF",Salernitana,Serie A,19,2003,23.3,20,10,5,13,2,10,20,50.0,10,20,1,19,4,24,16,1,0,2023-2024,90.0,15.450643776824034,77.25321888412017
2563,Jackson Tchatchoua,CMR,DF,Hellas Verona,Serie A,21,2001,19.2,39,26,25,12,2,23,48,47.9,25,17,7,10,23,62,49,2,0,2023-2024,90.0,107.81250000000001,182.8125
2564,Enzo Tchato,CMR,DF,Montpellier,Ligue 1,20,2002,12.5,26,17,18,4,4,11,25,44.0,14,20,7,13,11,37,25,0,0,2023-2024,90.0,79.2,187.2
2565,Aurélien Tchouaméni,FRA,"MF,DF",Real Madrid,La Liga,23,2000,22.1,38,23,19,17,2,9,18,50.0,9,21,13,8,28,66,52,1,0,2023-2024,90.0,114.02714932126696,154.75113122171945
2566,Mathys Tel,FRA,"FW,MF",Bayern Munich,Bundesliga,18,2005,11.7,12,2,3,4,5,4,6,66.7,2,11,0,11,6,18,6,0,0,2023-2024,89.99999999999999,46.15384615384615,92.3076923076923
2567,Nathan Tella,NGA,"DF,MF",Leverkusen,Bundesliga,24,1999,9.1,13,8,6,5,2,5,10,50.0,5,10,0,10,3,16,8,0,0,2023-2024,90.0,29.67032967032967,128.57142857142858
2568,Nahuel Tenaglia,ARG,DF,Alavés,La Liga,27,1996,12.7,29,19,22,4,3,16,28,57.1,12,14,8,6,12,41,59,0,0,2023-2024,90.0,85.03937007874016,205.51181102362204
2569,Arnau Tenas,ESP,GK,Paris S-G,Ligue 1,22,2001,5.9,0,0,0,0,0,0,0,0.0,0,0,0,0,0,0,0,0,0,2023-2024,90.0,0.0,0.0
2570,Marc-André ter Stegen,GER,GK,Barcelona,La Liga,31,1992,28.0,0,0,0,0,0,0,0,0.0,0,0,0,0,0,0,3,3,0,2023-2024,90.0,0.0,0.0
2571,Filippo Terracciano,ITA,DF,Hellas Verona,Serie A,20,2003,14.4,30,19,23,6,1,17,31,54.8,14,24,6,18,20,50,17,0,0,2023-2024,90.0,125.0,187.5
2572,Filippo Terracciano,ITA,"DF,FW",Milan,Serie A,20,2003,0.8,2,2,1,1,0,1,3,33.3,2,3,0,3,0,2,1,0,0,2023-2024,90.0,0.0,225.0
2573,Pietro Terracciano,ITA,GK,Fiorentina,Serie A,33,1990,33.0,1,1,1,0,0,1,3,33.3,2,1,0,1,0,1,8,0,0,2023-2024,90.0,0.0,2.7272727272727275
2574,Ramón Terrats,ESP,"MF,DF",Villarreal,La Liga,22,2000,8.7,17,13,8,8,1,7,15,46.7,8,11,1,10,3,20,9,0,0,2023-2024,90.0,31.03448275862069,175.86206896551724
2575,Martin Terrier,FRA,"FW,MF",Rennes,Ligue 1,26,1997,17.0,14,9,3,8,3,6,14,42.9,8,21,4,17,9,23,17,0,0,2023-2024,90.0,47.64705882352941,74.11764705882354
Rk,Player,Nation,Pos,Squad,Comp,0,0,90.0,0,0,3,3,3,Tkl,0,0.0,0,0,0,0,0,0,0,0,0,2023-2024,90.0,0.0,0.0
2576,Kenny Tete,NED,DF,Fulham,Premier League,27,1995,9.6,27,17,19,6,2,11,19,57.9,8,10,3,7,16,43,35,0,0,2023-2024,90.0,150.0,253.12500000000003
2577,Benjamin Tetteh,GHA,"FW,MF",Metz,Ligue 1,26,1997,3.1,6,6,1,5,0,4,7,57.1,3,0,0,0,0,6,1,0,0,2023-2024,90.0,0.0,174.19354838709677
2578,Teddy Teuma,MLT,MF,Reims,Ligue 1,29,1993,23.5,54,36,19,21,14,25,62,40.3,37,33,4,29,20,74,6,0,0,2023-2024,90.0,76.59574468085106,206.80851063829786
2579,Florian Thauvin,FRA,FW,Udinese,Serie A,30,1993,19.0,7,4,2,4,1,4,13,30.8,9,9,1,8,3,10,2,0,0,2023-2024,90.0,14.210526315789474,33.1578947368421
2580,Arthur Theate,BEL,DF,Rennes,Ligue 1,23,2000,25.5,30,17,19,6,5,24,37,64.9,13,40,23,17,31,61,90,2,0,2023-2024,90.0,109.41176470588236,105.88235294117648
2581,Norman Theuerkauf,GER,"MF,DF",Heidenheim,Bundesliga,36,1987,14.0,24,16,13,7,4,13,22,59.1,9,16,6,10,14,38,21,0,0,2023-2024,90.0,90.0,154.28571428571428
2582,Malick Thiaw,GER,DF,Milan,Serie A,21,2001,18.0,34,17,15,17,2,12,25,48.0,13,23,13,10,13,47,55,0,0,2023-2024,90.0,65.0,170.0
2583,Jan Thielmann,GER,"FW,DF",Köln,Bundesliga,21,2002,17.5,28,18,13,9,6,12,24,50.0,12,31,6,25,8,36,28,0,0,2023-2024,90.0,41.14285714285714,144.0
2584,Denis Thomalla,GER,"MF,FW",Heidenheim,Bundesliga,30,1992,5.0,9,6,4,4,1,5,11,45.5,6,3,2,1,4,13,13,0,0,2023-2024,90.0,72.0,162.0
2585,Luke Thomas,ENG,DF,Sheffield Utd,Premier League,22,2001,10.2,20,9,13,6,1,8,14,57.1,6,23,5,18,10,30,27,0,0,2023-2024,90.0,88.23529411764706,176.47058823529412
2586,Adrien Thomasson,FRA,MF,Lens,Ligue 1,29,1993,13.3,25,14,4,16,5,11,34,32.4,23,14,0,14,9,34,10,1,0,2023-2024,90.0,60.90225563909774,169.17293233082705
2587,Morten Thorsby,NOR,MF,Genoa,Serie A,27,1996,12.9,19,11,9,8,2,7,14,50.0,7,21,5,16,4,23,20,0,0,2023-2024,90.0,27.906976744186046,132.5581395348837
2588,Kristian Thorstvedt,NOR,MF,Sassuolo,Serie A,24,1999,26.6,40,22,7,28,5,22,44,50.0,22,25,9,16,21,61,36,0,0,2023-2024,90.0,71.05263157894737,135.33834586466165
2589,Khéphren Thuram,FRA,MF,Nice,Ligue 1,22,2001,23.4,42,29,13,23,6,20,40,50.0,20,21,10,11,18,60,37,0,0,2023-2024,89.99999999999999,69.23076923076923,161.53846153846152
2590,Marcus Thuram,FRA,FW,Inter,Serie A,25,1997,29.9,23,15,9,9,5,4,13,30.8,9,26,3,23,4,27,19,0,0,2023-2024,90.0,12.040133779264215,69.23076923076924
2591,Cheikh Tidiane Sabaly,SEN,"FW,MF",Metz,Ligue 1,24,1999,15.3,40,20,23,12,5,16,40,40.0,24,19,2,17,10,50,14,0,0,2023-2024,90.0,58.8235294117647,235.2941176470588
2592,Youri Tielemans,BEL,"MF,FW",Aston Villa,Premier League,26,1997,18.0,41,20,17,18,6,16,40,40.0,24,23,3,20,15,56,9,0,0,2023-2024,90.0,75.0,205.0
2593,Kieran Tierney,SCO,DF,Real Sociedad,La Liga,26,1997,13.8,37,24,16,18,3,18,27,66.7,9,22,8,14,10,47,45,0,0,2023-2024,90.0,65.21739130434781,241.30434782608694
2594,Phillip Tietz,GER,FW,Augsburg,Bundesliga,26,1997,26.5,23,14,7,13,3,6,15,40.0,9,17,3,14,6,29,35,0,0,2023-2024,90.0,20.37735849056604,78.11320754716981
2595,Steffen Tigges,GER,FW,Köln,Bundesliga,25,1998,8.1,10,6,4,5,1,3,7,42.9,4,4,2,2,1,11,12,0,0,2023-2024,90.0,11.11111111111111,111.11111111111111
2596,Antonio Tikvić,CRO,DF,Udinese,Serie A,19,2004,0.0,0,0,0,0,0,0,0,0.0,0,0,0,0,0,0,0,0,0,2023-2024,,,
2597,Jurriën Timber,NED,DF,Arsenal,Premier League,22,2001,0.8,2,2,1,1,0,0,0,0.0,0,1,0,1,0,2,1,0,0,2023-2024,90.0,0.0,225.0
2598,Jean-Clair Todibo,FRA,DF,Nice,Ligue 1,23,1999,29.5,58,28,35,17,6,34,56,60.7,22,34,15,19,38,96,97,1,0,2023-2024,90.0,115.9322033898305,176.94915254237287
2599,Harry Toffolo,ENG,DF,Nott'ham Forest,Premier League,27,1995,16.2,26,14,20,6,0,15,24,62.5,9,34,13,21,14,40,49,0,0,2023-2024,90.0,77.77777777777779,144.44444444444446
2600,Umut Tohumcu,GER,MF,Hoffenheim,Bundesliga,18,2004,11.2,16,12,9,7,0,6,19,31.6,13,11,1,10,6,22,12,0,0,2023-2024,90.0,48.214285714285715,128.57142857142858
Rk,Player,Nation,Pos,Squad,Comp,0,0,90.0,0,0,3,3,3,Tkl,0,0.0,0,0,0,0,0,0,0,0,0,2023-2024,90.0,0.0,0.0
2601,Corentin Tolisso,FRA,MF,Lyon,Ligue 1,28,1994,19.3,33,21,13,11,9,14,33,42.4,19,26,9,17,10,43,18,0,0,2023-2024,90.0,46.6321243523316,153.8860103626943
2602,Jeremy Toljan,GER,DF,Sassuolo,Serie A,28,1994,23.1,13,10,8,4,1,9,15,60.0,6,17,5,12,16,29,49,1,0,2023-2024,89.99999999999999,62.33766233766233,50.64935064935064
2603,Rafael Tolói,ITA,DF,Atalanta,Serie A,32,1990,10.7,20,9,7,8,5,14,27,51.9,13,9,4,5,13,33,29,0,0,2023-2024,90.0,109.34579439252337,168.22429906542058
2604,Raúl de Tomás,ESP,FW,Rayo Vallecano,La Liga,28,1994,14.1,9,5,4,3,2,3,6,50.0,3,3,0,3,1,10,8,0,0,2023-2024,89.99999999999999,6.382978723404255,57.44680851063829
2605,Tiago Tomás,POR,"FW,MF",Wolfsburg,Bundesliga,21,2002,11.5,5,2,3,0,2,1,6,16.7,5,13,0,13,3,8,9,0,0,2023-2024,90.0,23.47826086956522,39.130434782608695
2606,Takehiro Tomiyasu,JPN,DF,Arsenal,Premier League,24,1998,12.8,20,9,15,4,1,11,18,61.1,7,10,4,6,18,38,33,0,0,2023-2024,90.0,126.5625,140.625
2607,James Tomkins,ENG,DF,Crystal Palace,Premier League,34,1989,0.1,0,0,0,0,0,0,0,0.0,0,0,0,0,1,1,0,0,0,2023-2024,90.0,900.0,0.0
2608,Fikayo Tomori,ENG,DF,Milan,Serie A,25,1997,23.6,42,24,29,10,3,18,29,62.1,11,34,23,11,26,68,75,1,0,2023-2024,90.0,99.15254237288134,160.16949152542372
2609,Sandro Tonali,ITA,MF,Newcastle Utd,Premier League,23,2000,4.9,7,7,4,2,1,3,9,33.3,6,3,0,3,2,9,4,0,0,2023-2024,90.0,36.73469387755102,128.57142857142856
2610,Ivan Toney,ENG,FW,Brentford,Premier League,27,1996,16.1,15,5,2,7,6,6,14,42.9,8,5,1,4,10,25,18,0,0,2023-2024,90.0,55.90062111801242,83.85093167701862
2611,Pablo Torre,ESP,"MF,FW",Girona,La Liga,20,2003,7.8,5,2,0,5,0,4,10,40.0,6,10,2,8,4,9,6,1,0,2023-2024,90.0,46.15384615384615,57.69230769230769
2612,Raúl Torrente,ESP,DF,Granada,La Liga,21,2001,13.9,29,16,20,9,0,17,22,77.3,5,16,10,6,11,40,68,2,0,2023-2024,90.0,71.22302158273382,187.76978417266187
2613,Ferrán Torres,ESP,FW,Barcelona,La Liga,23,2000,13.5,9,6,1,6,2,5,16,31.3,11,7,1,6,5,14,6,0,0,2023-2024,90.0,33.333333333333336,60.0
2614,Óliver Torres,ESP,MF,Sevilla,La Liga,28,1994,18.0,37,22,17,15,5,22,57,38.6,35,40,4,36,6,43,6,0,0,2023-2024,90.0,30.0,185.0
2615,Pau Torres,ESP,DF,Aston Villa,Premier League,26,1997,27.4,29,18,17,11,1,14,30,46.7,16,28,12,16,14,43,75,0,0,2023-2024,90.0,45.98540145985402,95.25547445255475
2616,Lucas Torró,ESP,MF,Osasuna,La Liga,29,1994,19.9,25,15,11,8,6,11,28,39.3,17,10,2,8,33,58,37,0,0,2023-2024,90.0,149.2462311557789,113.06532663316584
2617,Fabio Torsiello,ITA,"FW,DF",Darmstadt 98,Bundesliga,18,2005,1.7,1,0,1,0,0,1,8,12.5,7,1,0,1,1,2,1,0,0,2023-2024,90.0,52.94117647058823,52.94117647058823
2618,Ahmed Touba,ALG,DF,Lecce,Serie A,25,1998,3.1,6,4,3,3,0,3,4,75.0,1,4,3,1,7,13,20,0,0,2023-2024,90.0,203.2258064516129,174.19354838709677
2619,Abdoulaye Touré,GUI,MF,Le Havre,Ligue 1,29,1994,25.4,47,28,22,22,3,30,60,50.0,30,30,8,22,25,72,33,0,0,2023-2024,90.0,88.58267716535434,166.53543307086616
2620,Souleymane Touré,FRA,DF,Lorient,Ligue 1,20,2003,22.8,25,12,16,9,0,8,14,57.1,6,38,20,18,36,61,101,2,0,2023-2024,90.0,142.1052631578947,98.68421052631578
2621,Lucas Tousart,FRA,MF,Union Berlin,Bundesliga,26,1997,17.5,35,20,14,17,4,17,37,45.9,20,32,9,23,25,60,41,0,0,2023-2024,90.0,128.57142857142856,180.0
2622,Andros Townsend,ENG,"MF,FW",Luton Town,Premier League,32,1991,13.4,21,13,11,2,8,13,27,48.1,14,12,0,12,5,26,10,0,0,2023-2024,90.0,33.582089552238806,141.04477611940297
2623,James Trafford,ENG,GK,Burnley,Premier League,20,2002,28.0,2,1,2,0,0,2,2,100.0,0,0,0,0,1,3,18,1,0,2023-2024,90.0,3.2142857142857144,6.428571428571429
2624,Adama Traoré,ESP,"FW,MF",Fulham,Premier League,27,1996,4.2,4,3,1,2,1,3,6,50.0,3,2,0,2,1,5,2,0,0,2023-2024,90.0,21.428571428571427,85.71428571428571
2625,Bertrand Traoré,BFA,"DF,FW",Aston Villa,Premier League,27,1995,0.1,1,1,1,0,0,0,0,0.0,0,0,0,0,0,1,1,0,0,2023-2024,90.0,0.0,900.0
Rk,Player,Nation,Pos,Squad,Comp,0,0,90.0,0,0,3,3,3,Tkl,0,0.0,0,0,0,0,0,0,0,0,0,2023-2024,90.0,0.0,0.0
2626,Bertrand Traoré,BFA,MF,Villarreal,La Liga,27,1995,6.3,5,4,2,1,2,1,4,25.0,3,6,0,6,1,6,2,0,0,2023-2024,90.0,14.285714285714286,71.42857142857143
2627,Boubacar Traoré,MLI,MF,Wolves,Premier League,21,2001,9.1,35,23,16,17,2,9,21,42.9,12,12,2,10,5,40,7,0,0,2023-2024,90.0,49.45054945054945,346.15384615384613
2628,Chaka Traorè,CIV,FW,Milan,Serie A,18,2004,0.2,2,1,2,0,0,1,2,50.0,1,1,1,0,0,2,0,0,0,2023-2024,90.0,0.0,900.0
2629,Daouda Traoré,FRA,MF,Nice,Ligue 1,17,2006,0.2,0,0,0,0,0,0,0,0.0,0,0,0,0,0,0,0,0,0,2023-2024,90.0,0.0,0.0
2630,Hamari Traoré,MLI,DF,Real Sociedad,La Liga,31,1992,25.5,44,19,24,17,3,25,43,58.1,18,27,8,19,24,68,59,2,0,2023-2024,90.0,84.70588235294117,155.29411764705884
2631,Ismaël Traoré,CIV,DF,Metz,Ligue 1,36,1986,24.7,19,12,13,6,0,8,21,38.1,13,33,20,13,30,49,86,0,0,2023-2024,90.0,109.31174089068826,69.23076923076923
2632,Omar Traoré,GER,DF,Heidenheim,Bundesliga,25,1998,27.5,60,33,33,21,6,32,56,57.1,24,32,7,25,40,100,54,1,0,2023-2024,89.99999999999999,130.9090909090909,196.36363636363635
2633,Kevin Trapp,GER,GK,Eint Frankfurt,Bundesliga,33,1990,32.0,0,0,0,0,0,0,0,0.0,0,0,0,0,1,1,9,1,0,2023-2024,90.0,2.8125,0.0
2634,Mark Travers,IRL,GK,Bournemouth,Premier League,24,1999,4.0,0,0,0,0,0,0,0,0.0,0,0,0,0,0,0,2,0,0,2023-2024,90.0,0.0,0.0
2635,Óscar Trejo,ARG,"FW,MF",Rayo Vallecano,La Liga,35,1988,15.3,27,15,11,9,7,13,21,61.9,8,21,1,20,5,32,9,0,0,2023-2024,90.0,29.41176470588235,158.8235294117647
2636,Mike Trésor,BEL,"FW,MF",Burnley,Premier League,24,1999,4.7,10,6,9,1,0,8,18,44.4,10,5,0,5,1,11,1,0,0,2023-2024,90.0,19.148936170212764,191.48936170212764
2637,Manu Trigueros,ESP,MF,Villarreal,La Liga,31,1991,3.4,7,5,6,1,0,4,10,40.0,6,1,1,0,3,10,9,0,0,2023-2024,90.0,79.41176470588235,185.2941176470588
2638,Christopher Trimmel,AUT,DF,Union Berlin,Bundesliga,36,1987,18.3,23,15,12,10,1,13,33,39.4,20,16,3,13,13,36,57,0,0,2023-2024,90.0,63.9344262295082,113.11475409836065
2639,Kieran Trippier,ENG,DF,Newcastle Utd,Premier League,32,1990,24.8,57,27,30,16,11,37,77,48.1,40,41,8,33,24,81,57,3,0,2023-2024,90.0,87.09677419354838,206.8548387096774
2640,Leandro Trossard,BEL,"FW,MF",Arsenal,Premier League,28,1994,18.3,27,16,8,9,10,9,25,36.0,16,27,1,26,8,35,6,0,0,2023-2024,90.0,39.34426229508197,132.78688524590163
2641,Adrien Truffert,FRA,DF,Rennes,Ligue 1,21,2001,23.8,39,21,23,10,6,25,40,62.5,15,31,5,26,19,58,49,0,0,2023-2024,90.00000000000001,71.84873949579833,147.47899159663868
2642,Auston Trusty,USA,DF,Sheffield Utd,Premier League,24,1998,28.6,47,30,31,13,3,21,43,48.8,22,41,22,19,35,82,153,3,0,2023-2024,90.0,110.13986013986015,147.9020979020979
2643,Kostas Tsimikas,GRE,DF,Liverpool,Premier League,27,1996,7.5,19,13,9,6,4,9,15,60.0,6,9,1,8,6,25,10,0,0,2023-2024,90.0,72.0,228.0
2644,Viktor Tsyhankov,UKR,"MF,FW",Girona,La Liga,25,1997,22.8,29,20,11,13,5,14,26,53.8,12,18,1,17,12,41,24,0,0,2023-2024,90.0,47.368421052631575,114.4736842105263
2645,Stefano Turati,ITA,GK,Frosinone,Serie A,21,2001,30.5,0,0,0,0,0,0,0,0.0,0,0,0,0,0,0,6,3,0,2023-2024,90.0,0.0,0.0
2646,Matt Turner,USA,GK,Nott'ham Forest,Premier League,29,1994,17.0,0,0,0,0,0,0,0,0.0,0,0,0,0,0,0,8,4,0,2023-2024,90.0,0.0,0.0
2647,Beñat Turrientes,ESP,MF,Real Sociedad,La Liga,21,2002,18.7,31,17,6,20,5,13,30,43.3,17,19,8,11,6,37,17,0,0,2023-2024,90.0,28.87700534759358,149.19786096256684
2648,Tuta,BRA,DF,Eint Frankfurt,Bundesliga,24,1999,28.9,63,33,38,19,6,39,59,66.1,20,29,12,17,36,99,99,0,0,2023-2024,90.00000000000001,112.11072664359862,196.1937716262976
2649,Destiny Udogie,ITA,DF,Tottenham,Premier League,20,2002,26.6,68,33,41,16,11,27,49,55.1,22,27,8,19,37,105,80,5,0,2023-2024,90.0,125.18796992481202,230.0751879699248
2650,Matthieu Udol,FRA,DF,Metz,Ligue 1,27,1996,30.0,55,37,38,12,5,38,56,67.9,18,62,16,46,50,105,108,0,0,2023-2024,90.0,150.0,165.0
Rk,Player,Nation,Pos,Squad,Comp,0,0,90.0,0,0,3,3,3,Tkl,0,0.0,0,0,0,0,0,0,0,0,0,2023-2024,90.0,0.0,0.0
2651,Manuel Ugarte Ribeiro,URU,MF,Paris S-G,Ligue 1,22,2001,21.5,98,57,39,43,16,43,89,48.3,46,27,6,21,40,138,25,2,0,2023-2024,90.0,167.44186046511626,410.2325581395349
2652,Lesley Ugochukwu,FRA,MF,Chelsea,Premier League,19,2004,3.3,14,10,4,8,2,4,10,40.0,6,6,2,4,1,15,5,0,0,2023-2024,90.0,27.272727272727273,381.8181818181818
2653,Lukas Ullrich,GER,"DF,FW",Gladbach,Bundesliga,19,2004,0.5,1,0,1,0,0,1,4,25.0,3,0,0,0,0,1,1,0,0,2023-2024,90.0,0.0,180.0
2654,Sven Ulreich,GER,GK,Bayern Munich,Bundesliga,34,1988,11.0,1,0,1,0,0,1,1,100.0,0,0,0,0,0,1,3,2,0,2023-2024,90.0,0.0,8.181818181818182
2655,Samuel Umtiti,FRA,DF,Lille,Ligue 1,29,1993,2.1,1,1,0,1,0,1,4,25.0,3,0,0,0,2,3,4,0,0,2023-2024,90.0,85.71428571428571,42.857142857142854
2656,Enes Ünal,TUR,"FW,MF",Bournemouth,Premier League,26,1997,3.6,6,4,2,3,1,2,5,40.0,3,4,2,2,1,7,6,0,0,2023-2024,90.0,25.0,150.0
2657,Enes Ünal,TUR,"FW,MF",Getafe,La Liga,26,1997,1.6,0,0,0,0,0,0,0,0.0,0,1,0,1,0,0,2,0,0,2023-2024,90.0,0.0,0.0
2658,Deniz Undav,GER,"FW,MF",Stuttgart,Bundesliga,27,1996,23.2,28,13,6,8,14,4,15,26.7,11,17,0,17,6,34,5,0,0,2023-2024,90.0,23.275862068965516,108.62068965517241
2659,Dayot Upamecano,FRA,DF,Bayern Munich,Bundesliga,24,1998,19.6,34,21,21,11,2,15,29,51.7,14,19,7,12,19,53,56,3,0,2023-2024,90.0,87.24489795918367,156.12244897959184
2660,Kacper Urbanski,POL,"MF,FW",Bologna,Serie A,18,2004,10.3,16,10,5,10,1,6,13,46.2,7,15,1,14,4,20,14,0,0,2023-2024,90.0,34.95145631067961,139.80582524271844
2661,Mark Uth,GER,"MF,FW",Köln,Bundesliga,31,1991,4.1,8,4,2,3,3,4,12,33.3,8,6,0,6,1,9,2,0,0,2023-2024,90.0,21.951219512195124,175.609756097561
2662,Myrto Uzuni,ALB,FW,Granada,La Liga,28,1995,27.2,18,14,8,7,3,6,27,22.2,21,19,3,16,4,22,7,0,0,2023-2024,90.0,13.235294117647058,59.55882352941176
2663,Josha Vagnoman,GER,DF,Stuttgart,Bundesliga,22,2000,13.1,28,18,15,11,2,15,30,50.0,15,11,5,6,2,30,16,1,0,2023-2024,90.0,13.740458015267176,192.36641221374046
2664,Óscar Valentín,ESP,MF,Rayo Vallecano,La Liga,28,1994,29.9,107,66,39,62,6,46,101,45.5,55,62,10,52,35,142,52,1,0,2023-2024,90.0,105.35117056856188,322.07357859531777
2665,Emanuele Valeri,ITA,DF,Frosinone,Serie A,24,1998,13.1,19,16,10,5,4,10,21,47.6,11,14,3,11,9,28,22,0,0,2023-2024,90.0,61.832061068702295,130.5343511450382
2666,Martin Valjent,SVK,DF,Mallorca,La Liga,27,1995,26.1,34,18,19,13,2,18,30,60.0,12,26,11,15,29,63,112,1,0,2023-2024,90.0,99.99999999999999,117.24137931034481
2667,Jesús Vallejo,ESP,DF,Granada,La Liga,26,1997,1.2,3,1,1,2,0,2,2,100.0,0,3,2,1,0,3,1,1,0,2023-2024,90.0,0.0,225.00000000000003
2668,Álvaro Vallés,ESP,GK,Las Palmas,La Liga,26,1997,36.3,3,2,3,0,0,3,8,37.5,5,0,0,0,0,3,40,1,0,2023-2024,90.0,0.0,7.43801652892562
2669,Federico Valverde,URU,MF,Real Madrid,La Liga,25,1998,32.3,47,34,22,13,12,24,42,57.1,18,39,2,37,43,90,40,0,0,2023-2024,90.0,119.81424148606811,130.95975232198143
2670,Kévin Van Den Kerkhof,ALG,"FW,MF",Metz,Ligue 1,27,1996,21.3,31,24,11,13,7,13,32,40.6,19,15,2,13,11,42,32,1,0,2023-2024,90.0,46.47887323943662,130.98591549295776
2671,Siebe Van Der Heyden,BEL,DF,Mallorca,La Liga,25,1998,3.2,9,2,7,2,0,4,6,66.7,2,1,1,0,7,16,12,0,0,2023-2024,90.0,196.875,253.125
2672,Virgil van Dijk,NED,DF,Liverpool,Premier League,32,1991,35.3,40,23,24,13,3,12,14,85.7,2,47,34,13,39,79,144,0,0,2023-2024,90.0,99.43342776203967,101.9830028328612
2673,Vanderson,BRA,DF,Monaco,Ligue 1,22,2001,18.2,60,41,20,30,10,32,70,45.7,38,29,2,27,35,95,37,1,0,2023-2024,90.0,173.07692307692307,296.7032967032967
2674,Raphaël Varane,FRA,DF,Manchester Utd,Premier League,30,1993,15.3,18,11,10,7,1,10,14,71.4,4,23,18,5,15,33,88,0,0,2023-2024,90.0,88.23529411764706,105.88235294117646
2675,Ruben Vargas,SUI,"MF,FW",Augsburg,Bundesliga,24,1998,21.8,23,10,6,10,7,10,25,40.0,15,19,4,15,7,30,17,0,0,2023-2024,90.0,28.899082568807337,94.95412844036697
Rk,Player,Nation,Pos,Squad,Comp,0,0,90.0,0,0,3,3,3,Tkl,0,0.0,0,0,0,0,0,0,0,0,0,2023-2024,90.0,0.0,0.0
2676,Johan Vásquez,MEX,DF,Genoa,Serie A,24,1998,31.7,51,33,38,11,2,32,50,64.0,18,50,26,24,45,96,113,0,0,2023-2024,90.0,127.7602523659306,144.79495268138803
2677,José Luis García Vayá,ESP,MF,Valencia,La Liga,24,1998,36.7,78,53,36,36,6,37,71,52.1,34,41,10,31,49,127,71,0,0,2023-2024,90.0,120.16348773841962,191.28065395095368
2678,Borja Vázquez,ESP,FW,Cádiz,La Liga,18,2005,0.0,1,0,1,0,0,1,1,100.0,0,0,0,0,0,1,1,0,0,2023-2024,,,inf
2679,Jesus Vazquez,ESP,"DF,MF",Valencia,La Liga,20,2003,8.0,24,12,13,8,3,10,16,62.5,6,17,4,13,3,27,24,0,0,2023-2024,90.0,33.75,270.0
2680,Kevin Vázquez,ESP,DF,Celta Vigo,La Liga,30,1993,7.8,15,13,7,7,1,12,21,57.1,9,11,3,8,5,20,25,0,0,2023-2024,90.0,57.69230769230769,173.07692307692307
2681,Lucas Vázquez,ESP,DF,Real Madrid,La Liga,32,1991,15.8,37,25,22,14,1,18,25,72.0,7,27,5,22,12,49,36,0,0,2023-2024,90.0,68.35443037974683,210.75949367088606
2682,Matías Vecino,URU,MF,Lazio,Serie A,31,1991,12.8,32,17,12,20,0,20,31,64.5,11,17,5,12,12,44,21,0,0,2023-2024,90.0,84.375,225.0
2683,Gabriel Veiga,ESP,FW,Celta Vigo,La Liga,21,2002,0.2,0,0,0,0,0,0,0,0.0,0,0,0,0,0,0,0,0,0,2023-2024,90.0,0.0,0.0
2684,Alejo Véliz,ARG,FW,Tottenham,Premier League,19,2003,0.6,1,0,1,0,0,0,0,0.0,0,0,0,0,0,1,0,0,0,2023-2024,90.0,0.0,150.0
2685,Alejo Véliz,ARG,FW,Sevilla,La Liga,19,2003,0.4,1,0,0,1,0,1,2,50.0,1,0,0,0,0,1,1,0,0,2023-2024,90.0,0.0,225.0
2686,Miloš Veljković,SRB,DF,Werder Bremen,Bundesliga,27,1995,21.3,31,15,17,13,1,16,31,51.6,15,31,20,11,17,48,57,0,0,2023-2024,90.0,71.83098591549296,130.98591549295776
2687,Joël Veltman,NED,DF,Brighton,Premier League,31,1992,17.6,54,41,32,17,5,39,58,67.2,19,17,7,10,18,72,57,1,0,2023-2024,90.0,92.04545454545455,276.1363636363636
2688,Micky van de Ven,NED,DF,Tottenham,Premier League,22,2001,26.0,49,35,34,12,3,24,33,72.7,9,25,15,10,18,67,78,1,0,2023-2024,90.00000000000001,62.307692307692314,169.61538461538464
2689,Lorenzo Venuti,ITA,DF,Lecce,Serie A,28,1995,4.0,6,4,5,1,0,6,10,60.0,4,4,3,1,5,11,14,0,0,2023-2024,90.0,112.5,135.0
2690,Bart Verbruggen,NED,GK,Brighton,Premier League,20,2002,21.0,1,1,1,0,0,1,2,50.0,1,0,0,0,0,1,11,3,0,2023-2024,90.0,0.0,4.285714285714286
2691,Simone Verdi,ITA,FW,Torino,Serie A,31,1992,0.0,0,0,0,0,0,0,0,0.0,0,0,0,0,0,0,0,0,0,2023-2024,,,
2692,Jordan Veretout,FRA,MF,Marseille,Ligue 1,30,1993,24.3,38,22,19,13,6,18,39,46.2,21,20,4,16,13,51,25,0,0,2023-2024,90.0,48.148148148148145,140.74074074074073
2693,Arthur Vermeeren,BEL,MF,Atlético Madrid,La Liga,18,2005,1.8,1,0,0,1,0,0,1,0.0,1,5,0,5,6,7,2,0,0,2023-2024,90.0,300.0,50.0
2694,Yorbe Vertessen,BEL,"FW,MF",Union Berlin,Bundesliga,22,2001,6.6,3,2,0,3,0,1,4,25.0,3,8,0,8,1,4,3,0,0,2023-2024,90.0,13.636363636363637,40.90909090909091
2695,Mikel Vesga,ESP,MF,Athletic Club,La Liga,30,1993,17.0,40,20,11,23,6,19,49,38.8,30,19,7,12,32,72,35,1,0,2023-2024,90.0,169.41176470588235,211.76470588235296
2696,Guglielmo Vicario,ITA,GK,Tottenham,Premier League,26,1996,38.0,0,0,0,0,0,0,1,0.0,1,0,0,0,1,1,31,2,0,2023-2024,90.0,2.3684210526315788,0.0
2697,Carlos Vicente,ESP,FW,Alavés,La Liga,24,1999,12.4,16,6,7,7,2,10,25,40.0,15,4,0,4,4,20,9,0,0,2023-2024,90.0,29.032258064516128,116.12903225806451
2698,Nacho Vidal,ESP,"DF,FW",Osasuna,La Liga,28,1995,1.1,5,4,2,2,1,2,5,40.0,3,2,0,2,0,5,6,0,0,2023-2024,90.0,0.0,409.09090909090907
2699,Nacho Vidal,ESP,DF,Mallorca,La Liga,28,1995,4.6,12,5,4,5,3,6,13,46.2,7,5,2,3,3,15,9,0,0,2023-2024,90.0,58.69565217391305,234.7826086956522
2700,Fabio Vieira,POR,"MF,FW",Arsenal,Premier League,23,2000,3.3,3,2,2,0,1,3,3,100.0,0,0,0,0,2,5,2,0,0,2023-2024,90.0,54.54545454545455,81.81818181818181
Rk,Player,Nation,Pos,Squad,Comp,0,0,90.0,0,0,3,3,3,Tkl,0,0.0,0,0,0,0,0,0,0,0,0,2023-2024,90.0,0.0,0.0
2701,Fran Vieites,ESP,GK,Betis,La Liga,24,1999,3.5,1,0,1,0,0,1,1,100.0,0,0,0,0,0,1,2,1,0,2023-2024,90.0,0.0,25.714285714285715
2702,Jonathan Viera,ESP,"MF,FW",Las Palmas,La Liga,33,1989,6.9,6,3,1,2,3,1,9,11.1,8,0,0,0,0,6,1,0,0,2023-2024,90.0,0.0,78.26086956521738
2703,Jonathan Viera,ESP,MF,Almería,La Liga,33,1989,10.1,19,9,6,9,4,10,19,52.6,9,4,0,4,4,23,1,0,0,2023-2024,90.0,35.64356435643565,169.30693069306932
2704,Emanuel Vignato,ITA,"MF,FW",Salernitana,Serie A,22,2000,3.5,10,7,4,5,1,5,6,83.3,1,1,0,1,1,11,7,0,0,2023-2024,90.0,25.714285714285715,257.1428571428571
2705,Samuele Vignato,ITA,"MF,FW",Monza,Serie A,19,2004,3.8,6,4,2,3,1,2,3,66.7,1,2,0,2,1,7,1,0,0,2023-2024,90.0,23.684210526315788,142.10526315789474
2706,Oscar Vilhelmsson,SWE,"FW,MF",Darmstadt 98,Bundesliga,19,2003,15.3,13,6,3,7,3,7,10,70.0,3,15,5,10,3,16,19,0,0,2023-2024,90.0,17.64705882352941,76.47058823529412
2707,Toni Villa,ESP,FW,Girona,La Liga,28,1995,0.1,0,0,0,0,0,0,0,0.0,0,0,0,0,0,0,0,0,0,2023-2024,90.0,0.0,0.0
2708,Asier Villalibre,ESP,FW,Athletic Club,La Liga,25,1997,5.7,2,1,0,0,2,2,2,100.0,0,2,1,1,0,2,6,0,0,2023-2024,90.0,0.0,31.57894736842105
2709,Gonzalo Villar,ESP,MF,Granada,La Liga,25,1998,20.0,51,33,26,20,5,26,41,63.4,15,32,10,22,6,57,26,1,0,2023-2024,90.0,27.0,229.5
2710,Iván Villar,ESP,GK,Celta Vigo,La Liga,26,1997,11.3,0,0,0,0,0,0,1,0.0,1,0,0,0,0,0,6,0,0,2023-2024,90.0,0.0,0.0
2711,Matías Viña,URU,DF,Sassuolo,Serie A,25,1997,11.3,34,21,22,7,5,20,36,55.6,16,12,2,10,9,43,34,0,0,2023-2024,90.0,71.68141592920354,270.79646017699116
2712,Rúben Vinagre,POR,"DF,FW",Hellas Verona,Serie A,24,1999,3.1,4,2,1,1,2,3,4,75.0,1,6,3,3,1,5,4,0,0,2023-2024,90.0,29.032258064516128,116.12903225806451
2713,Carlos Vinícius,BRA,FW,Fulham,Premier League,28,1995,3.5,3,2,0,1,2,0,4,0.0,4,4,0,4,0,3,1,0,0,2023-2024,90.0,0.0,77.14285714285714
2714,Nicolas Viola,ITA,"MF,FW",Cagliari,Serie A,33,1989,13.4,13,9,2,8,3,7,17,41.2,10,9,0,9,2,15,6,0,0,2023-2024,90.0,13.432835820895521,87.31343283582089
2715,Alan Virginius,FRA,FW,Lille,Ligue 1,20,2003,0.8,1,1,1,0,0,0,1,0.0,1,0,0,0,0,1,0,0,0,2023-2024,90.0,0.0,112.5
2716,Alan Virginius,FRA,FW,Clermont Foot,Ligue 1,20,2003,10.4,9,5,4,4,1,4,11,36.4,7,7,0,7,3,12,7,0,0,2023-2024,90.0,25.96153846153846,77.88461538461537
2717,Ricardo Visus,ESP,DF,Betis,La Liga,22,2001,1.8,2,2,1,1,0,2,2,100.0,0,2,2,0,2,4,9,1,0,2023-2024,90.0,100.0,100.0
2718,Mattia Viti,ITA,DF,Sassuolo,Serie A,21,2002,10.9,24,15,14,7,3,10,22,45.5,12,20,10,10,10,34,44,0,0,2023-2024,90.0,82.56880733944953,198.16513761467888
2719,Vitinha,POR,"FW,MF",Genoa,Serie A,23,2000,3.2,2,2,1,0,1,1,2,50.0,1,2,0,2,0,2,2,0,0,2023-2024,90.0,0.0,56.25
2720,Vitinha,POR,FW,Marseille,Ligue 1,23,2000,10.3,14,8,3,5,6,3,12,25.0,9,11,2,9,5,19,8,0,0,2023-2024,90.0,43.689320388349515,122.33009708737863
2721,Vitinha,POR,MF,Paris S-G,Ligue 1,23,2000,23.6,39,24,12,16,11,16,48,33.3,32,29,11,18,23,62,30,2,0,2023-2024,90.0,87.71186440677965,148.72881355932202
2722,Vitinho,BRA,"DF,MF",Burnley,Premier League,24,1999,25.7,64,34,36,22,6,43,86,50.0,43,44,6,38,12,76,47,4,0,2023-2024,90.0,42.023346303501945,224.12451361867704
2723,Daniel Vivian,ESP,DF,Athletic Club,La Liga,24,1999,32.0,42,28,29,11,2,28,45,62.2,17,49,25,24,31,73,104,0,0,2023-2024,90.0,87.1875,118.125
2724,Odisseas Vlachodimos,GRE,GK,Nott'ham Forest,Premier League,29,1994,5.0,0,0,0,0,0,0,1,0.0,1,0,0,0,0,0,1,0,0,2023-2024,90.0,0.0,0.0
2725,Dušan Vlahović,SRB,FW,Juventus,Serie A,23,2000,25.6,9,5,0,6,3,4,11,36.4,7,4,2,2,1,10,11,0,0,2023-2024,90.0,3.515625,31.640625
Rk,Player,Nation,Pos,Squad,Comp,0,0,90.0,0,0,3,3,3,Tkl,0,0.0,0,0,0,0,0,0,0,0,0,2023-2024,90.0,0.0,0.0
2726,Nikola Vlašić,CRO,"MF,FW",Torino,Serie A,25,1997,29.0,28,16,6,14,8,4,30,13.3,26,26,7,19,11,39,16,0,0,2023-2024,90.0,34.137931034482754,86.89655172413792
2727,Alessandro Vogliacco,ITA,DF,Genoa,Serie A,24,1998,13.0,23,15,14,8,1,12,15,80.0,3,16,10,6,30,53,40,1,0,2023-2024,90.00000000000001,207.6923076923077,159.23076923076925
2728,Kevin Vogt,GER,DF,Hoffenheim,Bundesliga,31,1991,14.7,14,10,7,7,0,8,13,61.5,5,16,13,3,9,23,54,0,0,2023-2024,90.0,55.10204081632653,85.71428571428572
2729,Kevin Vogt,GER,DF,Union Berlin,Bundesliga,31,1991,14.7,10,9,6,4,0,6,12,50.0,6,22,15,7,7,17,72,2,0,2023-2024,90.0,42.85714285714286,61.224489795918366
2730,Mërgim Vojvoda,KVX,DF,Torino,Serie A,28,1995,15.3,17,8,7,6,4,11,16,68.8,5,12,2,10,13,30,28,0,0,2023-2024,90.0,76.47058823529412,99.99999999999999
2731,Kevin Volland,GER,"FW,MF",Union Berlin,Bundesliga,31,1992,14.9,22,9,8,8,6,8,20,40.0,12,8,0,8,6,28,12,0,0,2023-2024,90.0,36.241610738255034,132.88590604026845
2732,Cristian Volpato,ITA,"MF,FW",Sassuolo,Serie A,19,2003,7.2,16,8,9,6,1,9,25,36.0,16,7,0,7,1,17,5,0,0,2023-2024,90.0,12.5,200.0
2733,Aster Vranckx,BEL,MF,Wolfsburg,Bundesliga,20,2002,12.8,32,15,11,11,10,15,28,53.6,13,17,6,11,14,46,29,0,0,2023-2024,90.0,98.4375,225.0
2734,Stefan de Vrij,NED,DF,Inter,Serie A,31,1992,17.6,18,13,13,4,1,8,15,53.3,7,22,10,12,24,42,51,0,0,2023-2024,90.0,122.72727272727272,92.04545454545455
2735,Elye Wahi,FRA,FW,Montpellier,Ligue 1,20,2003,0.2,0,0,0,0,0,0,0,0.0,0,0,0,0,0,0,0,0,0,2023-2024,90.0,0.0,0.0
2736,Elye Wahi,FRA,FW,Lens,Ligue 1,20,2003,18.8,6,4,1,3,2,2,10,20.0,8,5,1,4,3,9,3,0,0,2023-2024,90.0,14.361702127659573,28.723404255319146
2737,Walace,BRA,MF,Udinese,Serie A,28,1995,36.0,66,43,40,26,0,36,77,46.8,41,43,6,37,43,109,66,1,0,2023-2024,90.0,107.5,165.0
2738,Luca Waldschmidt,GER,"MF,FW",Köln,Bundesliga,27,1996,12.7,19,12,4,12,3,5,16,31.3,11,18,3,15,6,25,8,1,0,2023-2024,90.0,42.51968503937008,134.64566929133858
2739,Kyle Walker,ENG,DF,Manchester City,Premier League,33,1990,30.7,38,24,19,17,2,19,39,48.7,20,19,6,13,27,65,40,1,0,2023-2024,90.0,79.15309446254072,111.40065146579805
2740,Sebastian Walukiewicz,POL,DF,Empoli,Serie A,23,2000,22.8,39,28,33,6,0,28,41,68.3,13,50,31,19,15,54,121,0,0,2023-2024,90.0,59.210526315789465,153.94736842105263
2741,Aaron Wan-Bissaka,ENG,DF,Manchester Utd,Premier League,25,1997,19.8,42,25,18,20,4,19,26,73.1,7,29,15,14,41,83,68,1,0,2023-2024,90.0,186.36363636363637,190.9090909090909
2742,Joel Ward,ENG,DF,Crystal Palace,Premier League,33,1989,22.0,45,28,26,18,1,30,47,63.8,17,17,10,7,14,59,94,1,0,2023-2024,90.0,57.27272727272727,184.0909090909091
2743,James Ward-Prowse,ENG,MF,West Ham,Premier League,28,1994,33.3,45,29,14,23,8,18,44,40.9,26,31,9,22,38,83,49,0,0,2023-2024,90.0,102.70270270270271,121.62162162162163
2744,Lewis Warrington,ENG,FW,Everton,Premier League,20,2002,0.0,0,0,0,0,0,0,0,0.0,0,0,0,0,0,0,0,0,0,2023-2024,,,
2745,Deivid Washington,BRA,"DF,FW",Chelsea,Premier League,18,2005,0.1,1,1,1,0,0,0,1,0.0,1,0,0,0,0,1,0,0,0,2023-2024,90.0,0.0,900.0
2746,Kjell-Arik Wätjen,GER,"MF,FW",Dortmund,Bundesliga,17,2006,1.2,3,2,2,1,0,2,5,40.0,3,1,1,0,0,3,3,0,0,2023-2024,90.0,0.0,225.00000000000003
2747,Ollie Watkins,ENG,FW,Aston Villa,Premier League,27,1995,35.7,12,7,0,5,7,5,11,45.5,6,26,4,22,4,16,20,0,0,2023-2024,90.0,10.084033613445376,30.25210084033613
2748,Timothy Weah,USA,"DF,FW",Juventus,Serie A,23,2000,14.0,27,20,16,8,3,15,20,75.0,5,12,1,11,5,32,15,0,0,2023-2024,90.0,32.14285714285714,173.57142857142856
2749,Adam Webster,ENG,DF,Brighton,Premier League,28,1995,12.7,14,12,8,5,1,6,18,33.3,12,16,12,4,16,30,43,1,0,2023-2024,90.0,113.38582677165356,99.21259842519686
2750,Wout Weghorst,NED,FW,Hoffenheim,Bundesliga,30,1992,22.0,13,6,4,7,2,9,15,60.0,6,25,8,17,6,19,24,0,0,2023-2024,90.0,24.545454545454547,53.18181818181819
Rk,Player,Nation,Pos,Squad,Comp,0,0,90.0,0,0,3,3,3,Tkl,0,0.0,0,0,0,0,0,0,0,0,0,2023-2024,90.0,0.0,0.0
2751,Julian Weigl,GER,MF,Gladbach,Bundesliga,27,1995,30.7,66,40,28,32,6,41,67,61.2,26,47,14,33,48,114,61,1,0,2023-2024,90.0,140.71661237785017,193.485342019544
2752,Nelson Weiper,GER,"FW,MF",Mainz 05,Bundesliga,18,2005,1.4,2,1,2,0,0,2,3,66.7,1,1,0,1,1,3,0,0,0,2023-2024,90.0,64.28571428571429,128.57142857142858
2753,Mitchell Weiser,GER,"DF,MF",Werder Bremen,Bundesliga,29,1994,29.3,64,38,29,25,10,31,53,58.5,22,36,6,30,20,84,43,0,0,2023-2024,90.0,61.43344709897611,196.58703071672355
2754,Noah Weißhaupt,GER,"DF,FW",Freiburg,Bundesliga,21,2001,8.4,9,4,6,0,3,5,11,45.5,6,8,1,7,8,17,12,0,0,2023-2024,90.0,85.71428571428571,96.42857142857143
2755,Shon Weissman,ISR,"FW,DF",Salernitana,Serie A,27,1996,5.5,4,3,2,0,2,0,4,0.0,4,2,1,1,3,7,4,0,0,2023-2024,90.0,49.09090909090909,65.45454545454545
2756,Shon Weissman,ISR,FW,Granada,La Liga,27,1996,0.9,1,1,0,0,1,1,4,25.0,3,3,0,3,0,1,1,0,0,2023-2024,90.0,0.0,100.0
2757,Danny Welbeck,ENG,"FW,MF",Brighton,Premier League,32,1990,18.8,35,17,9,17,9,10,17,58.8,7,12,0,12,9,44,17,1,0,2023-2024,90.0,43.08510638297872,167.5531914893617
2758,Timo Werner,GER,FW,Tottenham,Premier League,27,1996,9.0,7,4,3,4,0,5,18,27.8,13,12,0,12,3,10,2,0,0,2023-2024,90.0,30.0,70.0
2759,Timo Werner,GER,"FW,MF",RB Leipzig,Bundesliga,27,1996,2.3,2,1,0,1,1,0,0,0.0,0,1,0,1,1,3,0,0,0,2023-2024,90.0,39.130434782608695,78.26086956521739
2760,Adam Wharton,ENG,MF,Crystal Palace,Premier League,19,2004,14.4,48,32,18,22,8,23,46,50.0,23,17,3,14,20,68,24,1,0,2023-2024,90.0,125.0,300.0
2761,Ethan Wheatley,ENG,FW,Manchester Utd,Premier League,17,2006,0.2,1,1,0,1,0,1,1,100.0,0,2,0,2,2,3,0,0,0,2023-2024,90.0,900.0,450.0
2762,Ben White,ENG,DF,Arsenal,Premier League,25,1997,33.2,48,28,20,22,6,26,58,44.8,32,48,22,26,32,80,77,1,0,2023-2024,90.0,86.74698795180721,130.12048192771084
2763,Joe White,ENG,MF,Newcastle Utd,Premier League,20,2002,0.1,1,1,1,0,0,0,0,0.0,0,0,0,0,0,1,0,0,0,2023-2024,90.0,0.0,900.0
2764,Silvan Widmer,SUI,DF,Mainz 05,Bundesliga,30,1993,13.8,23,10,12,8,3,17,28,60.7,11,18,5,13,16,39,37,0,0,2023-2024,90.0,104.34782608695652,149.99999999999997
2765,Mateusz Wieteska,POL,DF,Cagliari,Serie A,26,1997,10.7,14,11,9,3,2,3,10,30.0,7,10,5,5,14,28,48,0,0,2023-2024,90.0,117.7570093457944,117.7570093457944
2766,Mateusz Wieteska,POL,DF,Clermont Foot,Ligue 1,26,1997,1.9,4,1,3,1,0,3,5,60.0,2,4,2,2,5,9,8,0,0,2023-2024,90.0,236.8421052631579,189.4736842105263
2767,Iñaki Williams,GHA,FW,Athletic Club,La Liga,29,1994,31.6,24,17,6,8,10,13,34,38.2,21,42,8,34,14,38,29,0,0,2023-2024,90.0,39.87341772151898,68.35443037974683
2768,Neco Williams,WAL,DF,Nott'ham Forest,Premier League,22,2001,18.2,69,40,42,18,9,35,56,62.5,21,44,13,31,22,91,53,0,0,2023-2024,90.0,108.79120879120879,341.20879120879124
2769,Nico Williams,ESP,FW,Athletic Club,La Liga,21,2002,25.1,31,12,9,15,7,13,36,36.1,23,18,2,16,3,34,4,1,0,2023-2024,90.0,10.756972111553784,111.15537848605577
2770,Willian,BRA,FW,Fulham,Premier League,34,1988,22.8,18,11,6,7,5,3,21,14.3,18,13,0,13,9,27,12,1,0,2023-2024,90.0,35.52631578947368,71.05263157894736
2771,Joe Willock,ENG,MF,Newcastle Utd,Premier League,23,1999,4.7,13,7,7,6,0,4,11,36.4,7,7,0,7,1,14,1,0,0,2023-2024,90.0,19.148936170212764,248.93617021276594
2772,Callum Wilson,ENG,FW,Newcastle Utd,Premier League,31,1992,11.0,5,3,0,2,3,0,4,0.0,4,6,0,6,2,7,4,0,0,2023-2024,90.0,16.363636363636363,40.909090909090914
2773,Harry Wilson,WAL,FW,Fulham,Premier League,26,1997,18.0,21,14,9,8,4,11,28,39.3,17,27,3,24,10,31,12,0,0,2023-2024,90.0,50.0,105.0
2774,Josh Wilson-Esbrand,ENG,"DF,MF",Reims,Ligue 1,20,2002,5.1,5,4,2,3,0,2,8,25.0,6,5,2,3,6,11,7,0,0,2023-2024,90.0,105.88235294117648,88.23529411764706
2775,Patrick Wimmer,AUT,"FW,MF",Wolfsburg,Bundesliga,22,2001,6.5,14,5,5,5,4,8,18,44.4,10,14,0,14,3,17,7,0,0,2023-2024,90.00000000000001,41.53846153846154,193.84615384615387
Rk,Player,Nation,Pos,Squad,Comp,0,0,90.0,0,0,3,3,3,Tkl,0,0.0,0,0,0,0,0,0,0,0,0,2023-2024,90.0,0.0,0.0
2776,Jonas Wind,DEN,FW,Wolfsburg,Bundesliga,24,1999,29.5,13,10,4,6,3,7,17,41.2,10,13,4,9,3,16,21,0,0,2023-2024,90.0,9.152542372881356,39.66101694915254
2777,Florian Wirtz,GER,MF,Leverkusen,Bundesliga,20,2003,26.4,27,18,7,14,6,9,29,31.0,20,36,2,34,9,36,3,0,0,2023-2024,90.0,30.681818181818183,92.04545454545455
2778,Yoane Wissa,COD,FW,Brentford,Premier League,26,1996,27.7,28,16,13,10,5,5,20,25.0,15,24,3,21,9,37,15,0,0,2023-2024,90.0,29.24187725631769,90.97472924187726
2779,Axel Witsel,BEL,DF,Atlético Madrid,La Liga,34,1989,30.9,35,21,23,12,0,17,24,70.8,7,40,21,19,16,51,119,0,0,2023-2024,90.0,46.601941747572816,101.94174757281554
2780,Maximilian Wittek,GER,"DF,FW",Bochum,Bundesliga,27,1995,11.9,23,17,9,11,3,13,21,61.9,8,12,1,11,18,41,23,0,0,2023-2024,90.00000000000001,136.1344537815126,173.9495798319328
2781,Maximilian Wöber,AUT,DF,Gladbach,Bundesliga,25,1998,23.0,66,31,40,25,1,31,53,58.5,22,47,26,21,38,104,111,0,0,2023-2024,90.0,148.69565217391306,258.26086956521743
2782,Marius Wolf,GER,DF,Dortmund,Bundesliga,28,1995,13.0,20,12,8,11,1,11,23,47.8,12,12,2,10,8,28,20,0,0,2023-2024,90.00000000000001,55.38461538461539,138.46153846153848
2783,Nick Woltemade,GER,"FW,MF",Werder Bremen,Bundesliga,21,2002,13.2,34,23,7,20,7,15,21,71.4,6,12,0,12,5,39,17,0,0,2023-2024,90.0,34.09090909090909,231.8181818181818
2784,Jeong Woo-yeong,KOR,"MF,FW",Stuttgart,Bundesliga,23,1999,7.0,15,9,6,8,1,6,8,75.0,2,5,0,5,7,22,5,0,0,2023-2024,90.0,90.0,192.85714285714286
2785,Chris Wood,NZL,FW,Nott'ham Forest,Premier League,31,1991,20.1,7,4,1,4,2,3,9,33.3,6,11,3,8,1,8,26,0,0,2023-2024,90.0,4.477611940298507,31.343283582089548
2786,Cauley Woodrow,ENG,"FW,MF",Luton Town,Premier League,28,1994,4.7,16,10,8,4,4,9,16,56.3,7,7,1,6,1,17,14,0,0,2023-2024,90.0,19.148936170212764,306.3829787234042
2787,Christopher Wooh,CMR,DF,Rennes,Ligue 1,21,2001,15.4,18,12,12,6,0,8,15,53.3,7,19,9,10,18,36,51,0,0,2023-2024,90.0,105.1948051948052,105.1948051948052
2788,Joe Worrall,ENG,DF,Nott'ham Forest,Premier League,26,1997,4.9,7,5,6,1,0,3,6,50.0,3,5,4,1,3,10,32,1,0,2023-2024,90.0,55.10204081632653,128.57142857142856
2789,Xeber,ESP,"FW,MF",Alavés,La Liga,26,1997,3.4,5,5,3,2,0,3,7,42.9,4,2,1,1,1,6,2,0,0,2023-2024,90.0,26.470588235294116,132.35294117647058
2790,Granit Xhaka,SUI,MF,Leverkusen,Bundesliga,30,1992,31.3,29,21,11,14,4,9,30,30.0,21,29,8,21,19,48,42,0,0,2023-2024,90.0,54.632587859424916,83.38658146964856
2791,Antal Yaakobishvili,HUN,DF,Girona,La Liga,19,2004,0.7,2,1,1,1,0,1,1,100.0,0,0,0,0,3,5,3,0,0,2023-2024,90.0,385.7142857142857,257.14285714285717
2792,Lamine Yamal,ESP,FW,Barcelona,La Liga,16,2007,24.5,61,37,32,15,14,18,48,37.5,30,32,0,32,19,80,11,0,0,2023-2024,90.00000000000001,69.79591836734694,224.08163265306123
2793,Roman Yaremchuk,UKR,FW,Valencia,La Liga,27,1995,10.3,5,2,1,2,2,3,6,50.0,3,4,0,4,1,6,9,0,0,2023-2024,90.0,8.737864077669903,43.689320388349515
2794,Yehor Yarmoliuk,UKR,MF,Brentford,Premier League,19,2004,7.6,17,11,6,8,3,7,17,41.2,10,17,4,13,6,23,5,0,0,2023-2024,90.0,71.05263157894737,201.3157894736842
2795,Ryan Yates,ENG,MF,Nott'ham Forest,Premier League,25,1997,22.1,66,39,39,21,6,19,34,55.9,15,42,15,27,21,87,44,1,0,2023-2024,90.0,85.52036199095022,268.7782805429864
2796,Yusuf Yazıcı,TUR,"MF,FW",Lille,Ligue 1,26,1997,14.6,19,11,6,9,4,4,15,26.7,11,10,1,9,5,24,5,0,0,2023-2024,90.0,30.82191780821918,117.12328767123289
2797,Kelvin Yeboah,ITA,FW,Montpellier,Ligue 1,23,2000,3.1,4,2,2,2,0,1,3,33.3,2,3,2,1,1,5,3,0,0,2023-2024,90.0,29.032258064516128,116.12903225806451
2798,Bertuğ Yıldırım,TUR,FW,Rennes,Ligue 1,21,2002,5.2,7,5,2,3,2,3,8,37.5,5,8,0,8,0,7,4,0,0,2023-2024,90.0,0.0,121.15384615384615
2799,Kenan Yıldız,TUR,"FW,MF",Juventus,Serie A,18,2005,10.6,13,9,5,6,2,4,8,50.0,4,6,0,6,1,14,4,0,0,2023-2024,90.0,8.49056603773585,110.37735849056604
2800,Darlin Yongwa,CMR,DF,Lorient,Ligue 1,22,2000,12.9,30,23,17,11,2,14,25,56.0,11,14,2,12,15,45,36,0,0,2023-2024,90.0,104.65116279069767,209.30232558139534
Rk,Player,Nation,Pos,Squad,Comp,0,0,90.0,0,0,3,3,3,Tkl,0,0.0,0,0,0,0,0,0,0,0,0,2023-2024,90.0,0.0,0.0
2801,Leny Yoro,FRA,DF,Lille,Ligue 1,17,2005,29.7,36,25,27,7,2,17,31,54.8,14,20,14,6,36,72,97,1,0,2023-2024,90.0,109.09090909090908,109.09090909090908
2802,Ashley Young,ENG,"DF,MF",Everton,Premier League,38,1985,25.3,53,38,28,19,6,30,54,55.6,24,24,6,18,22,75,50,3,0,2023-2024,89.99999999999999,78.26086956521738,188.5375494071146
2803,Etienne Youte Kinkoue,FRA,DF,Le Havre,Ligue 1,21,2002,21.6,15,9,13,2,0,7,11,63.6,4,21,16,5,44,59,104,0,0,2023-2024,90.0,183.33333333333331,62.49999999999999
2804,Illia Zabarnyi,UKR,DF,Bournemouth,Premier League,20,2002,37.0,59,32,29,29,1,23,50,46.0,27,53,34,19,33,92,143,4,0,2023-2024,90.0,80.27027027027027,143.51351351351352
2805,Mattia Zaccagni,ITA,"FW,MF",Lazio,Serie A,28,1995,21.7,27,16,11,15,1,9,21,42.9,12,26,2,24,21,48,15,0,0,2023-2024,90.0,87.09677419354838,111.9815668202765
2806,Dan-Axel Zagadou,FRA,DF,Stuttgart,Bundesliga,24,1999,16.1,21,14,16,5,0,4,8,50.0,4,23,18,5,20,41,78,1,0,2023-2024,90.0,111.80124223602483,117.39130434782608
2807,Yoram Zague,FRA,DF,Paris S-G,Ligue 1,17,2006,4.1,18,8,11,4,3,11,24,45.8,13,3,0,3,4,22,9,1,0,2023-2024,90.0,87.8048780487805,395.12195121951225
2808,Warren Zaïre-Emery,FRA,"MF,DF",Paris S-G,Ligue 1,17,2006,21.8,51,28,18,24,9,28,51,54.9,23,32,8,24,15,66,22,2,0,2023-2024,90.0,61.92660550458715,210.55045871559633
2809,Denis Zakaria,SUI,"MF,DF",Monaco,Ligue 1,26,1996,23.7,38,27,11,20,7,12,30,40.0,18,39,13,26,47,85,41,0,0,2023-2024,90.0,178.48101265822785,144.30379746835445
2810,Arsen Zakharyan,RUS,"MF,FW",Real Sociedad,La Liga,20,2003,13.6,22,15,8,11,3,9,22,40.9,13,16,0,16,4,26,10,0,0,2023-2024,90.0,26.470588235294116,145.58823529411765
2811,Joseba Zaldúa,ESP,DF,Cádiz,La Liga,31,1992,7.8,20,12,17,2,1,13,21,61.9,8,6,4,2,2,22,20,0,0,2023-2024,90.0,23.076923076923077,230.76923076923077
2812,Nicola Zalewski,POL,"DF,FW",Roma,Serie A,21,2002,10.8,20,14,10,9,1,8,22,36.4,14,12,4,8,9,29,17,0,0,2023-2024,90.0,75.0,166.66666666666666
2813,Andre-Frank Zambo Anguissa,CMR,MF,Napoli,Serie A,27,1995,31.0,61,33,21,29,11,34,69,49.3,35,40,5,35,28,89,19,1,0,2023-2024,90.0,81.29032258064517,177.09677419354838
2814,Nicolò Zaniolo,ITA,"FW,MF",Aston Villa,Premier League,24,1999,9.3,19,9,10,7,2,9,17,52.9,8,13,0,13,1,20,11,0,0,2023-2024,90.0,9.677419354838708,183.87096774193546
2815,Alessandro Zanoli,ITA,DF,Salernitana,Serie A,22,2000,10.2,16,13,9,7,0,7,12,58.3,5,10,2,8,1,17,17,0,0,2023-2024,90.0,8.823529411764707,141.1764705882353
2816,Alessandro Zanoli,ITA,"DF,FW",Napoli,Serie A,22,2000,0.6,1,1,1,0,0,0,0,0.0,0,0,0,0,1,2,1,0,0,2023-2024,90.0,150.0,150.0
2817,Duván Zapata,COL,FW,Torino,Serie A,32,1991,32.0,18,7,9,2,7,3,12,25.0,9,20,6,14,7,25,26,0,0,2023-2024,90.0,19.6875,50.625
2818,Duván Zapata,COL,FW,Atalanta,Serie A,32,1991,1.2,0,0,0,0,0,0,1,0.0,1,0,0,0,0,0,1,0,0,2023-2024,90.0,0.0,0.0
2819,Gabriele Zappa,ITA,DF,Cagliari,Serie A,23,1999,28.5,54,31,29,16,9,29,41,70.7,12,29,5,24,20,74,75,2,0,2023-2024,90.0,63.15789473684211,170.5263157894737
2820,Davide Zappacosta,ITA,DF,Atalanta,Serie A,31,1992,20.7,30,20,15,10,5,16,34,47.1,18,29,4,25,5,35,19,0,0,2023-2024,90.0,21.73913043478261,130.43478260869566
2821,Bryan Zaragoza,ESP,"MF,FW",Granada,La Liga,22,2001,18.2,18,9,8,6,4,8,23,34.8,15,9,0,9,3,21,3,0,0,2023-2024,90.0,14.835164835164836,89.01098901098901
2822,Bryan Zaragoza,ESP,"FW,MF",Bayern Munich,Bundesliga,22,2001,2.0,4,4,2,1,1,3,3,100.0,0,0,0,0,2,6,0,0,0,2023-2024,90.0,90.0,180.0
2823,Anass Zaroury,MAR,"FW,MF",Burnley,Premier League,22,2000,1.7,1,0,1,0,0,0,4,0.0,4,2,0,2,0,1,1,1,0,2023-2024,90.0,0.0,52.94117647058823
2824,Oier Zarraga,ESP,MF,Udinese,Serie A,24,1999,4.5,3,3,2,1,0,1,5,20.0,4,5,2,3,5,8,16,1,0,2023-2024,90.0,100.0,60.0
2825,Mehdi Zeffane,ALG,"DF,MF",Clermont Foot,Ligue 1,31,1992,13.7,31,20,17,11,3,17,34,50.0,17,14,3,11,16,47,34,0,0,2023-2024,90.0,105.1094890510949,203.64963503649636
Rk,Player,Nation,Pos,Squad,Comp,0,0,90.0,0,0,3,3,3,Tkl,0,0.0,0,0,0,0,0,0,0,0,0,2023-2024,90.0,0.0,0.0
2826,Jordan Zemura,ZIM,DF,Udinese,Serie A,23,1999,11.5,24,16,13,7,4,11,19,57.9,8,5,1,4,13,37,21,0,0,2023-2024,90.0,101.73913043478262,187.82608695652175
2827,Robin Zentner,GER,GK,Mainz 05,Bundesliga,28,1994,30.0,2,2,2,0,0,2,5,40.0,3,1,0,1,1,3,19,1,0,2023-2024,90.0,3.0,6.0
2828,Alessio Zerbin,ITA,"DF,FW",Monza,Serie A,24,1999,7.6,18,10,13,2,3,4,13,30.8,9,16,3,13,3,21,5,0,0,2023-2024,90.0,35.526315789473685,213.1578947368421
2829,Alessio Zerbin,ITA,"FW,DF",Napoli,Serie A,24,1999,1.7,5,2,1,3,1,2,7,28.6,5,1,0,1,0,5,0,0,0,2023-2024,90.0,0.0,264.70588235294116
2830,Kevin Zeroli,ITA,MF,Milan,Serie A,18,2005,0.3,1,1,1,0,0,0,0,0.0,0,1,0,1,0,1,1,0,0,2023-2024,90.0,0.0,300.0
2831,Cedric Zesiger,SUI,DF,Wolfsburg,Bundesliga,25,1998,18.2,19,9,13,4,2,10,22,45.5,12,32,21,11,15,34,88,1,0,2023-2024,90.0,74.17582417582418,93.95604395604396
2832,Michael Zetterer,GER,GK,Werder Bremen,Bundesliga,28,1995,27.0,3,1,3,0,0,3,3,100.0,0,0,0,0,0,3,7,3,0,2023-2024,90.0,0.0,10.0
2833,Nathan Zeze,FRA,DF,Nantes,Ligue 1,18,2005,11.4,11,6,9,2,0,7,14,50.0,7,12,3,9,12,23,47,1,0,2023-2024,90.0,94.73684210526315,86.84210526315789
2834,Edon Zhegrova,KVX,FW,Lille,Ligue 1,24,1999,25.4,32,18,9,15,8,14,36,38.9,22,17,1,16,8,40,8,0,0,2023-2024,90.0,28.34645669291339,113.38582677165356
2835,Piotr Zieliński,POL,MF,Napoli,Serie A,29,1994,21.4,23,15,6,13,4,12,24,50.0,12,12,1,11,9,32,15,0,0,2023-2024,90.0,37.85046728971963,96.72897196261682
2836,David Zima,CZE,DF,Torino,Serie A,22,2000,1.0,1,1,1,0,0,0,0,0.0,0,0,0,0,3,4,7,0,0,2023-2024,90.0,270.0,90.0
2837,Christoph Zimmermann,GER,DF,Darmstadt 98,Bundesliga,30,1993,13.6,33,21,26,7,0,19,39,48.7,20,21,14,7,21,54,66,1,0,2023-2024,90.0,138.97058823529412,218.38235294117646
2838,Oleksandr Zinchenko,UKR,DF,Arsenal,Premier League,26,1996,19.1,50,30,19,24,7,35,52,67.3,17,18,3,15,20,70,26,2,0,2023-2024,90.0,94.24083769633508,235.6020942408377
2839,Joshua Zirkzee,NED,FW,Bologna,Serie A,22,2001,30.7,32,20,8,15,9,13,24,54.2,11,25,2,23,3,35,36,0,0,2023-2024,90.0,8.794788273615636,93.81107491856679
2840,Luc Zogbé,CIV,DF,Brest,Ligue 1,18,2005,0.1,0,0,0,0,0,0,1,0.0,1,1,1,0,1,1,0,0,0,2023-2024,90.0,900.0,0.0
2841,Simon Zoller,GER,"FW,MF",Bochum,Bundesliga,32,1991,0.5,0,0,0,0,0,0,0,0.0,0,1,0,1,0,0,0,0,0,2023-2024,90.0,0.0,0.0
2842,Nadir Zortea,ITA,DF,Frosinone,Serie A,24,1999,14.0,21,14,8,13,0,10,22,45.5,12,13,5,8,4,25,29,1,0,2023-2024,90.0,25.714285714285715,135.0
2843,Nadir Zortea,ITA,DF,Atalanta,Serie A,24,1999,1.7,5,4,3,1,1,1,4,25.0,3,2,0,2,1,6,3,0,0,2023-2024,90.0,52.94117647058823,264.70588235294116
2844,Kurt Zouma,FRA,DF,West Ham,Premier League,28,1994,31.5,23,17,14,9,0,10,16,62.5,6,38,28,10,29,52,160,0,0,2023-2024,90.0,82.85714285714286,65.71428571428572
2845,Igor Zubeldia,ESP,DF,Real Sociedad,La Liga,26,1997,28.0,32,25,20,10,2,19,26,73.1,7,28,19,9,32,64,97,3,0,2023-2024,90.0,102.85714285714286,102.85714285714286
2846,Martín Zubimendi,ESP,MF,Real Sociedad,La Liga,24,1999,29.5,49,27,18,29,2,23,42,54.8,19,33,9,24,37,86,54,0,0,2023-2024,90.0,112.88135593220339,149.4915254237288
2847,Szymon Żurkowski,POL,MF,Empoli,Serie A,25,1997,9.6,15,6,5,8,2,5,15,33.3,10,5,1,4,6,21,11,0,0,2023-2024,90.0,56.25000000000001,140.625
2848,Lovro Zvonarek,CRO,"FW,MF",Bayern Munich,Bundesliga,18,2005,1.8,0,0,0,0,0,0,5,0.0,5,3,0,3,0,0,2,0,0,2023-2024,90.0,0.0,0.0
2849,Martin Ødegaard,NOR,MF,Arsenal,Premier League,24,1998,34.3,49,17,18,21,10,17,58,29.3,41,23,1,22,15,64,5,0,0,2023-2024,90.0,39.358600583090386,128.57142857142858
2850,Milan Đurić,BIH,FW,Hellas Verona,Serie A,33,1990,13.4,1,0,0,0,1,0,3,0.0,3,0,0,0,1,2,13,0,0,2023-2024,90.0,6.716417910447761,6.716417910447761
Rk,Player,Nation,Pos,Squad,Comp,0,0,90.0,0,0,3,3,3,Tkl,0,0.0,0,0,0,0,0,0,0,0,0,2023-2024,90.0,0.0,0.0
2851,Milan Đurić,BIH,FW,Monza,Serie A,33,1990,14.0,5,5,0,5,0,2,4,50.0,2,6,2,4,0,5,27,0,0,2023-2024,90.0,0.0,32.14285714285714
2852,Mateusz Łęgowski,POL,MF,Salernitana,Serie A,20,2003,12.7,23,12,8,12,3,11,26,42.3,15,13,2,11,7,30,16,0,0,2023-2024,90.0,49.60629921259843,162.99212598425197
